name,realm,rating,cls,spec,play,win,lose
Rahbekius,kazzak,1519,deathknight,blood,225,103,122
Эваер,blackscar,1506,deathknight,blood,60,29,31
Hoggster,kazzak,1416,deathknight,blood,75,28,47
Maylined,antonidas,1316,deathknight,blood,36,16,20
Horrorda,defias-brotherhood,1265,deathknight,blood,44,24,20
Nîghtmáre,ravencrest,1180,deathknight,blood,35,20,15
Ducados,forscherliga,952,deathknight,blood,24,12,12
Minoporc,archimonde,916,deathknight,blood,39,14,25
Wickedgray,outland,672,deathknight,blood,12,7,5
Schiva,eredar,607,deathknight,blood,23,7,16
Smalldk,silvermoon,574,deathknight,blood,18,6,12
Оосака,gordunni,573,deathknight,blood,24,6,18
Downtoclown,argent-dawn,480,deathknight,blood,12,5,7
Bloodzin,frostwhisper,480,deathknight,blood,12,5,7
Helixnc,silvermoon,480,deathknight,blood,12,5,7
Schwuischädl,eredar,479,deathknight,blood,12,5,7
Zdan,sylvanas,476,deathknight,blood,12,5,7
Akamechân,frostmourne,382,deathknight,blood,6,4,2
Hellcrosser,blackrock,381,deathknight,blood,12,4,8
Airok,proudmoore,381,deathknight,blood,12,4,8
Pinkish,argent-dawn,379,deathknight,blood,12,4,8
Барагган,thermaplugg,288,deathknight,blood,6,3,3
Кмамехочу,howling-fjord,288,deathknight,blood,18,3,15
Oxcidium,archimonde,287,deathknight,blood,6,3,3
Pechugona,zuljin,287,deathknight,blood,24,3,21
Dromadeus,sylvanas,286,deathknight,blood,12,3,9
Calculated,spinebreaker,192,deathknight,blood,6,2,4
Rakia,defias-brotherhood,191,deathknight,blood,12,2,10
Fixmybones,frostmane,96,deathknight,blood,6,1,5
Maradk,drakthul,96,deathknight,blood,6,1,5
Нишимба,soulflayer,2121,deathknight,unholy,90,46,44
Страхолит,soulflayer,2107,deathknight,unholy,179,89,90
Хайвейтухэлл,soulflayer,2098,deathknight,unholy,96,48,48
Conqueròr,tarren-mill,2083,deathknight,unholy,94,46,48
Кромгона,soulflayer,2023,deathknight,unholy,136,83,53
Bíllÿ,kazzak,2003,deathknight,unholy,104,56,48
Storhøf,sanguino,1982,deathknight,unholy,108,61,47
Bedstemoor,ravencrest,1982,deathknight,unholy,120,63,57
Elite,xavius,1977,deathknight,unholy,74,39,35
Leónid,kazzak,1962,deathknight,unholy,72,36,36
Enzy,drakthul,1948,deathknight,unholy,42,26,16
Hotcherryx,dun-modr,1946,deathknight,unholy,192,97,95
Дайтоолгоун,gordunni,1937,deathknight,unholy,113,56,57
Leomordf,doomhammer,1919,deathknight,unholy,244,136,108
Murky,kazzak,1918,deathknight,unholy,262,129,133
Bøby,kul-tiras,1917,deathknight,unholy,60,31,29
Shadowdeathj,kazzak,1913,deathknight,unholy,54,27,27
Vakü,burning-legion,1907,deathknight,unholy,558,275,283
Worlviuz,argent-dawn,1905,deathknight,unholy,141,70,71
Шайбовёрт,gordunni,1884,deathknight,unholy,130,66,64
Валькейн,blackscar,1883,deathknight,unholy,60,32,28
Fxckingmad,ravencrest,1883,deathknight,unholy,72,37,35
Yazga,blackmoore,1883,deathknight,unholy,65,32,33
Akaliz,die-aldor,1876,deathknight,unholy,66,35,31
Ipanic,argent-dawn,1875,deathknight,unholy,228,120,108
Eyyoo,blackmoore,1875,deathknight,unholy,70,35,35
Necrølyte,sylvanas,1874,deathknight,unholy,120,64,56
Bóby,ravencrest,1873,deathknight,unholy,297,140,157
Narali,argent-dawn,1859,deathknight,unholy,72,34,38
Likewise,twisting-nether,1853,deathknight,unholy,48,20,28
Vallenhal,twisting-nether,1850,deathknight,unholy,48,23,25
Azüla,ysondre,1848,deathknight,unholy,66,30,36
Fabricius,blackrock,1847,deathknight,unholy,66,36,30
Меланндрис,gordunni,1845,deathknight,unholy,60,44,16
Лордпафос,blackscar,1844,deathknight,unholy,66,37,29
Øtherànóther,stormscale,1843,deathknight,unholy,54,30,24
Ezlyy,ravencrest,1843,deathknight,unholy,114,60,54
Кромгон,soulflayer,1843,deathknight,unholy,61,30,31
Amnésyx,ysondre,1842,deathknight,unholy,64,32,32
Frege,tarren-mill,1839,deathknight,unholy,84,43,41
Nómòre,ravencrest,1839,deathknight,unholy,60,30,30
Mockingbirdo,sanguino,1836,deathknight,unholy,36,24,12
Fennro,ysondre,1836,deathknight,unholy,300,147,153
Аронас,blackscar,1833,deathknight,unholy,83,42,41
Lilshiet,stormreaver,1831,deathknight,unholy,66,30,36
Namzera,draenor,1827,deathknight,unholy,114,70,44
Undeadcell,ravencrest,1826,deathknight,unholy,60,34,26
Quizon,tarren-mill,1826,deathknight,unholy,84,39,45
Oj,darkspear,1825,deathknight,unholy,211,112,99
Zokko,blackrock,1820,deathknight,unholy,59,31,28
Cealdris,blackmoore,1819,deathknight,unholy,30,20,10
Обледенение,gordunni,1819,deathknight,unholy,36,19,17
Bigdickdk,ragnaros,1819,deathknight,unholy,58,27,31
Bephomet,onyxia,1819,deathknight,unholy,111,50,61
Lutcher,hellfire,1818,deathknight,unholy,36,20,16
Rankor,grim-batol,1816,deathknight,unholy,66,36,30
Necrofear,grim-batol,1816,deathknight,unholy,126,62,64
Змейняша,soulflayer,1814,deathknight,unholy,121,62,59
Aifam,twisting-nether,1813,deathknight,unholy,116,59,57
Andreàs,silvermoon,1813,deathknight,unholy,60,30,30
Брексиен,gordunni,1813,deathknight,unholy,54,20,34
Aryash,silvermoon,1812,deathknight,unholy,66,31,35
Amyntasz,twisting-nether,1812,deathknight,unholy,54,23,31
Sélyne,dalaran,1811,deathknight,unholy,60,27,33
Unhóly,tarren-mill,1810,deathknight,unholy,127,72,55
Аоепупс,gordunni,1809,deathknight,unholy,57,28,29
Allmawt,argent-dawn,1808,deathknight,unholy,89,51,38
Oscman,silvermoon,1805,deathknight,unholy,123,65,58
Køley,draenor,1804,deathknight,unholy,53,30,23
Annabolik,ravencrest,1804,deathknight,unholy,36,19,17
Icegrin,silvermoon,1803,deathknight,unholy,150,81,69
Butthurtx,stormscale,1802,deathknight,unholy,46,27,19
Бургер,soulflayer,1802,deathknight,unholy,78,33,45
Exoflake,kazzak,1801,deathknight,unholy,64,36,28
Inflex,silvermoon,1800,deathknight,unholy,102,51,51
Grepetta,argent-dawn,1800,deathknight,unholy,243,121,122
Sanlex,twisting-nether,1800,deathknight,unholy,139,67,72
Mirídiuss,silvermoon,1798,deathknight,unholy,58,31,27
Ðavy,silvermoon,1793,deathknight,unholy,60,29,31
Verminosis,stormscale,1791,deathknight,unholy,78,31,47
Jesûsx,ravencrest,1787,deathknight,unholy,130,69,61
Дайтоолгоун,deathguard,1783,deathknight,unholy,69,38,31
Дэхон,gordunni,1777,deathknight,unholy,85,45,40
Argonat,silvermoon,1775,deathknight,unholy,132,72,60
Péterpain,antonidas,1771,deathknight,unholy,102,49,53
Shanariel,khaz-modan,1761,deathknight,unholy,114,65,49
Crenshawx,twisting-nether,1761,deathknight,unholy,165,81,84
Deathgrab,twisting-nether,1758,deathknight,unholy,74,40,34
Фростинг,gordunni,1757,deathknight,unholy,42,23,19
Apacstanya,ragnaros,1757,deathknight,unholy,60,25,35
Zektal,thrall,1753,deathknight,unholy,66,32,34
Darkknights,archimonde,1749,deathknight,unholy,85,48,37
Ampdk,ravencrest,1748,deathknight,unholy,48,28,20
Sendurd,ragnaros,1747,deathknight,unholy,66,27,39
Happsor,eredar,1746,deathknight,unholy,77,35,42
Elyth,kazzak,1740,deathknight,unholy,58,33,25
Сантамо,soulflayer,1738,deathknight,unholy,110,59,51
Кромгак,soulflayer,1738,deathknight,unholy,68,35,33
Sakiko,thrall,1736,deathknight,unholy,42,23,19
Неондк,eversong,1734,deathknight,unholy,134,65,69
Slade,blackrock,1734,deathknight,unholy,60,23,37
Zerachy,blackmoore,1733,deathknight,unholy,30,19,11
Вовчан,howling-fjord,1733,deathknight,unholy,92,42,50
Deathmonsta,auchindoun,1731,deathknight,unholy,84,39,45
Râke,teldrassil,1729,deathknight,unholy,54,25,29
Motvinden,stormscale,1724,deathknight,unholy,100,54,46
Рыжаяпедаль,soulflayer,1723,deathknight,unholy,42,27,15
Darkertimes,ragnaros,1723,deathknight,unholy,189,92,97
Skulm,twisting-nether,1722,deathknight,unholy,48,20,28
Inâste,thrall,1719,deathknight,unholy,48,26,22
Вирко,eversong,1719,deathknight,unholy,184,96,88
Ghostreign,tarren-mill,1719,deathknight,unholy,68,33,35
Кулькулегал,ashenvale,1717,deathknight,unholy,66,34,32
Лордэскорт,gordunni,1717,deathknight,unholy,114,52,62
Nazgül,drakthul,1716,deathknight,unholy,122,68,54
Itreachesout,ravencrest,1716,deathknight,unholy,137,67,70
Тхиро,gordunni,1716,deathknight,unholy,95,38,57
Koranderx,argent-dawn,1713,deathknight,unholy,30,18,12
Alti,blackmoore,1705,deathknight,unholy,118,65,53
Triffdich,blackrock,1704,deathknight,unholy,120,62,58
Wôrgenator,kazzak,1704,deathknight,unholy,48,18,30
Alessia,alonsus,1701,deathknight,unholy,36,21,15
Ràiven,blackmoore,1701,deathknight,unholy,65,31,34
Évìl,stormscale,1700,deathknight,unholy,45,24,21
Sprangers,ravencrest,1699,deathknight,unholy,36,18,18
Enzÿ,drakthul,1698,deathknight,unholy,54,29,25
Raziee,twisting-nether,1698,deathknight,unholy,96,50,46
Альдафьод,howling-fjord,1696,deathknight,unholy,30,19,11
Эриданс,gordunni,1696,deathknight,unholy,142,79,63
Èvíl,stormscale,1695,deathknight,unholy,42,23,19
Fraeya,sunstrider,1695,deathknight,unholy,213,107,106
Doozz,draenor,1692,deathknight,unholy,87,34,53
Vainajala,die-aldor,1691,deathknight,unholy,77,46,31
Arizon,drakthul,1691,deathknight,unholy,98,40,58
Necrotic,blackrock,1690,deathknight,unholy,53,30,23
Deathlog,silvermoon,1690,deathknight,unholy,138,71,67
Impey,kazzak,1689,deathknight,unholy,30,18,12
Reidemorte,minahonda,1689,deathknight,unholy,140,81,59
Моровой,blackscar,1685,deathknight,unholy,70,35,35
Ronsôn,terrordar,1685,deathknight,unholy,54,27,27
Gladiadk,ysondre,1684,deathknight,unholy,53,21,32
Ûñhølýðéåthj,tarren-mill,1683,deathknight,unholy,59,28,31
Mammacitaa,argent-dawn,1682,deathknight,unholy,47,28,19
ßankoedno,stormscale,1681,deathknight,unholy,120,62,58
Аркёт,howling-fjord,1681,deathknight,unholy,84,42,42
Sang,deathwing,1680,deathknight,unholy,44,24,20
Stely,alonsus,1678,deathknight,unholy,36,21,15
Wombo,dentarg,1677,deathknight,unholy,57,30,27
Lovroo,silvermoon,1677,deathknight,unholy,93,43,50
Sanuky,blackrock,1677,deathknight,unholy,42,18,24
Nurekindk,argent-dawn,1676,deathknight,unholy,125,65,60
Vatø,tarren-mill,1676,deathknight,unholy,60,27,33
Sangíus,blackmoore,1673,deathknight,unholy,353,171,182
Femilista,dun-modr,1671,deathknight,unholy,42,23,19
Faznik,twisting-nether,1671,deathknight,unholy,124,61,63
Адэлина,soulflayer,1669,deathknight,unholy,36,22,14
Nèrfx,ragnaros,1669,deathknight,unholy,78,37,41
Senkingodx,ravencrest,1668,deathknight,unholy,60,20,40
Zugzugdecay,kazzak,1665,deathknight,unholy,42,23,19
Synthwave,tarren-mill,1665,deathknight,unholy,99,46,53
Олинф,deathguard,1664,deathknight,unholy,62,26,36
Blazeberg,blackrock,1662,deathknight,unholy,58,33,25
Geraltbg,twisting-nether,1661,deathknight,unholy,42,18,24
Dräpârn,sylvanas,1660,deathknight,unholy,93,50,43
Økah,outland,1659,deathknight,unholy,54,25,29
Zdi,tarren-mill,1657,deathknight,unholy,47,23,24
Thezftw,kazzak,1656,deathknight,unholy,71,30,41
Средозавр,howling-fjord,1655,deathknight,unholy,48,31,17
Heyä,ysondre,1655,deathknight,unholy,54,25,29
Dasvidania,ragnaros,1651,deathknight,unholy,30,18,12
Тыпидо,howling-fjord,1650,deathknight,unholy,72,41,31
Reann,argent-dawn,1649,deathknight,unholy,55,31,24
Кидер,blackscar,1647,deathknight,unholy,53,29,24
Äyrenn,draenor,1645,deathknight,unholy,61,35,26
Mávé,tarren-mill,1645,deathknight,unholy,64,31,33
Leanâdle,hyjal,1644,deathknight,unholy,134,66,68
Смердонос,grom,1642,deathknight,unholy,209,116,93
Джонаджеймсн,soulflayer,1642,deathknight,unholy,42,21,21
Ayra,nethersturm,1641,deathknight,unholy,35,24,11
Creatar,kazzak,1639,deathknight,unholy,53,31,22
Sugarcakedk,blackrock,1638,deathknight,unholy,89,44,45
Çruél,silvermoon,1638,deathknight,unholy,48,21,27
Garrinchá,stormscale,1636,deathknight,unholy,48,21,27
Jiodythyy,archimonde,1634,deathknight,unholy,60,27,33
Дрогдош,howling-fjord,1633,deathknight,unholy,48,29,19
Акамахи,ashenvale,1631,deathknight,unholy,42,23,19
Гронташ,howling-fjord,1631,deathknight,unholy,71,36,35
Uvros,bloodhoof,1630,deathknight,unholy,48,23,25
Лапочки,gordunni,1628,deathknight,unholy,84,49,35
Khalifamia,alonsus,1628,deathknight,unholy,54,26,28
Zariia,twisting-nether,1627,deathknight,unholy,126,72,54
Herumor,nerzhul,1627,deathknight,unholy,60,32,28
Yusehz,kazzak,1627,deathknight,unholy,51,25,26
Dejkå,silvermoon,1627,deathknight,unholy,66,30,36
Deadlyorca,tarren-mill,1625,deathknight,unholy,42,18,24
Castlevanía,ravencrest,1623,deathknight,unholy,115,58,57
Сгеатог,gordunni,1623,deathknight,unholy,36,17,19
Smallbaboon,stormreaver,1623,deathknight,unholy,42,17,25
Ghoulish,outland,1622,deathknight,unholy,187,92,95
Apacsom,ragnaros,1621,deathknight,unholy,30,17,13
Quetza,twisting-nether,1621,deathknight,unholy,36,17,19
Кокосоус,gordunni,1618,deathknight,unholy,36,18,18
Xenfos,tarren-mill,1618,deathknight,unholy,54,23,31
Baltersa,blackhand,1618,deathknight,unholy,60,25,35
Rottenpete,grim-batol,1617,deathknight,unholy,36,20,16
Pandahapci,ragnaros,1617,deathknight,unholy,54,23,31
Qtxi,nozdormu,1614,deathknight,unholy,183,98,85
Линфео,galakrond,1614,deathknight,unholy,54,22,32
Jollíe,tarren-mill,1613,deathknight,unholy,53,33,20
Aeneriah,tarren-mill,1613,deathknight,unholy,91,50,41
Lurkkiss,ravencrest,1613,deathknight,unholy,48,22,26
Pellizquitas,sanguino,1612,deathknight,unholy,30,17,13
Dk,tarren-mill,1612,deathknight,unholy,48,20,28
Инлакеш,howling-fjord,1611,deathknight,unholy,57,25,32
Stinglelz,chogall,1610,deathknight,unholy,30,19,11
Bokrak,norgannon,1610,deathknight,unholy,123,73,50
Deathvid,ravencrest,1610,deathknight,unholy,78,43,35
Lichbørn,ragnaros,1610,deathknight,unholy,102,50,52
Giandam,draenor,1610,deathknight,unholy,48,19,29
Анзорини,gordunni,1609,deathknight,unholy,48,19,29
Garasu,eredar,1609,deathknight,unholy,54,21,33
Halez,antonidas,1607,deathknight,unholy,186,96,90
Sxyd,silvermoon,1607,deathknight,unholy,66,27,39
Вондум,howling-fjord,1606,deathknight,unholy,42,18,24
Orktra,stormscale,1604,deathknight,unholy,42,22,20
Шуршаня,blackscar,1604,deathknight,unholy,54,22,32
Sølîta,archimonde,1603,deathknight,unholy,89,47,42
Krisigaped,blackhand,1603,deathknight,unholy,36,17,19
Маххес,howling-fjord,1601,deathknight,unholy,101,48,53
Aceléss,drakthul,1600,deathknight,unholy,42,20,22
Nasxsy,blackmoore,1599,deathknight,unholy,36,18,18
Branchë,stormscale,1599,deathknight,unholy,111,55,56
Maxto,outland,1596,deathknight,unholy,36,19,17
Deathcaller,zuljin,1594,deathknight,unholy,65,32,33
Zoree,draenor,1588,deathknight,unholy,119,64,55
Yagoora,silvermoon,1588,deathknight,unholy,74,29,45
Kwc,kazzak,1586,deathknight,unholy,117,54,63
Ахелекус,blackscar,1584,deathknight,unholy,36,21,15
Raizhen,ragnaros,1582,deathknight,unholy,36,17,19
Bredox,ravencrest,1582,deathknight,unholy,63,27,36
Linuzbunny,zenedar,1580,deathknight,unholy,30,18,12
Skórm,burning-legion,1580,deathknight,unholy,36,17,19
Vexxed,magtheridon,1576,deathknight,unholy,99,55,44
Spøøk,defias-brotherhood,1575,deathknight,unholy,48,22,26
Слендер,howling-fjord,1572,deathknight,unholy,119,57,62
Judin,kazzak,1570,deathknight,unholy,36,19,17
Ктунец,blackscar,1570,deathknight,unholy,36,19,17
Ahilus,bladefist,1570,deathknight,unholy,67,33,34
Prekliatylad,burning-blade,1570,deathknight,unholy,60,26,34
Gødofredo,dun-modr,1568,deathknight,unholy,96,55,41
Megdeath,silvermoon,1568,deathknight,unholy,108,54,54
Jäätynyt,zenedar,1568,deathknight,unholy,350,170,180
Söttguetsi,blackrock,1566,deathknight,unholy,41,23,18
Lockhead,stormscale,1566,deathknight,unholy,126,66,60
Nysaia,blackmoore,1564,deathknight,unholy,60,27,33
Körthazz,hyjal,1563,deathknight,unholy,55,27,28
Хорссэ,soulflayer,1562,deathknight,unholy,37,22,15
Винерас,soulflayer,1562,deathknight,unholy,66,31,35
Oweiowei,blackrock,1558,deathknight,unholy,30,18,12
Ghaloob,draenor,1557,deathknight,unholy,54,24,30
Gushik,twisting-nether,1555,deathknight,unholy,52,30,22
Хассандра,galakrond,1554,deathknight,unholy,117,58,59
Smörj,aggramar,1554,deathknight,unholy,88,38,50
Feministi,stormreaver,1552,deathknight,unholy,108,51,57
Aleejha,draenor,1551,deathknight,unholy,70,39,31
Капустас,gordunni,1551,deathknight,unholy,90,45,45
Yamisukehiro,drakthul,1551,deathknight,unholy,60,28,32
Utyr,ragnaros,1550,deathknight,unholy,60,31,29
Emphendk,twisting-nether,1550,deathknight,unholy,120,55,65
Рамкар,howling-fjord,1550,deathknight,unholy,38,17,21
Hellguy,draenor,1548,deathknight,unholy,263,124,139
Gargalon,drakthul,1547,deathknight,unholy,72,37,35
Turboface,kazzak,1546,deathknight,unholy,60,34,26
Apoikos,argent-dawn,1546,deathknight,unholy,36,19,17
Abomination,emeriss,1546,deathknight,unholy,49,20,29
Misazabanshi,blackrock,1543,deathknight,unholy,42,26,16
Сванхильда,grom,1543,deathknight,unholy,124,61,63
Элекна,deepholm,1541,deathknight,unholy,48,24,24
Juliean,blackmoore,1540,deathknight,unholy,42,20,22
Ganessha,sanguino,1538,deathknight,unholy,49,29,20
Abcdk,sargeras,1535,deathknight,unholy,56,31,25
Metalmanethé,tarren-mill,1534,deathknight,unholy,242,120,122
Segrim,drakthul,1533,deathknight,unholy,95,52,43
Вурдулакх,gordunni,1533,deathknight,unholy,114,56,58
Pawcio,argent-dawn,1527,deathknight,unholy,135,74,61
Dzemoo,drakthul,1527,deathknight,unholy,59,31,28
Алсидис,gordunni,1527,deathknight,unholy,72,29,43
Руин,blackscar,1526,deathknight,unholy,48,26,22
Huekun,draenor,1524,deathknight,unholy,29,18,11
Арцевус,gordunni,1524,deathknight,unholy,115,59,56
Полонит,gordunni,1523,deathknight,unholy,76,38,38
Nauser,kazzak,1522,deathknight,unholy,53,28,25
Dörfl,antonidas,1521,deathknight,unholy,87,42,45
Олинфия,soulflayer,1521,deathknight,unholy,36,16,20
Panorboy,tarren-mill,1521,deathknight,unholy,36,16,20
Gripbroblem,nemesis,1521,deathknight,unholy,42,16,26
Woddey,blackrock,1520,deathknight,unholy,72,39,33
Yousaindk,blackrock,1519,deathknight,unholy,60,29,31
Deadroses,tarren-mill,1517,deathknight,unholy,78,49,29
Gharzhul,xavius,1517,deathknight,unholy,32,18,14
Goreshovel,stormscale,1517,deathknight,unholy,72,39,33
Торедх,howling-fjord,1516,deathknight,unholy,66,27,39
Athanatøs,archimonde,1514,deathknight,unholy,98,43,55
Greymarker,kirin-tor,1513,deathknight,unholy,66,37,29
Cleverb,silvermoon,1512,deathknight,unholy,33,18,15
Cayliadk,tarren-mill,1512,deathknight,unholy,86,46,40
Ехтрим,howling-fjord,1512,deathknight,unholy,65,30,35
Raust,xavius,1512,deathknight,unholy,74,33,41
Manego,eredar,1511,deathknight,unholy,30,18,12
Дерайв,gordunni,1511,deathknight,unholy,114,55,59
Катаринья,howling-fjord,1511,deathknight,unholy,53,24,29
Grendul,blackmoore,1510,deathknight,unholy,60,26,34
Anathela,dalaran,1508,deathknight,unholy,85,40,45
Трибунальщик,gordunni,1508,deathknight,unholy,60,27,33
Apoikia,argent-dawn,1507,deathknight,unholy,42,19,23
Руариди,gordunni,1504,deathknight,unholy,36,18,18
Salezians,drakthul,1503,deathknight,unholy,107,59,48
Numnuts,alakir,1502,deathknight,unholy,36,21,15
Lavonobatas,kazzak,1502,deathknight,unholy,54,27,27
Deathcam,emerald-dream,1502,deathknight,unholy,95,45,50
Derfitt,sanguino,1502,deathknight,unholy,96,45,51
Ezlar,silvermoon,1501,deathknight,unholy,49,29,20
Unchaindk,outland,1500,deathknight,unholy,136,68,68
Bertonilo,burning-legion,1500,deathknight,unholy,84,39,45
Dklékata,archimonde,1499,deathknight,unholy,43,20,23
Veçh,turalyon,1497,deathknight,unholy,58,25,33
Nødder,ragnaros,1496,deathknight,unholy,60,32,28
Anaralien,ravencrest,1494,deathknight,unholy,107,50,57
Babsyknight,wildhammer,1494,deathknight,unholy,114,52,62
Промештейн,gordunni,1493,deathknight,unholy,93,44,49
Apolyio,outland,1493,deathknight,unholy,53,21,32
Recoil,blackrock,1490,deathknight,unholy,26,17,9
Gegham,ravencrest,1490,deathknight,unholy,46,26,20
Rizzlerdk,blackhand,1489,deathknight,unholy,114,49,65
Axram,ravencrest,1487,deathknight,unholy,60,30,30
Goùlag,culte-de-la-rive-noire,1487,deathknight,unholy,87,34,53
Kérmít,tarren-mill,1486,deathknight,unholy,100,58,42
Кадавров,gordunni,1486,deathknight,unholy,140,76,64
Majlus,outland,1486,deathknight,unholy,50,24,26
Dharniman,sylvanas,1485,deathknight,unholy,46,21,25
Riceeater,kazzak,1483,deathknight,unholy,59,29,30
Агереро,howling-fjord,1482,deathknight,unholy,71,37,34
Blízna,kazzak,1481,deathknight,unholy,122,58,64
Erodevil,kazzak,1481,deathknight,unholy,54,22,32
Nellath,kazzak,1481,deathknight,unholy,42,16,26
Zff,hyjal,1480,deathknight,unholy,42,25,17
Teljujad,sanguino,1480,deathknight,unholy,98,49,49
Брюшина,gordunni,1480,deathknight,unholy,42,19,23
Calina,frostwolf,1480,deathknight,unholy,72,26,46
Ullefuz,silvermoon,1479,deathknight,unholy,42,25,17
Лекъса,gordunni,1477,deathknight,unholy,217,109,108
Polimeh,draenor,1473,deathknight,unholy,78,42,36
Yandeäth,chants-éternels,1470,deathknight,unholy,209,102,107
Nommad,archimonde,1469,deathknight,unholy,137,62,75
Ультерис,deathguard,1468,deathknight,unholy,24,17,7
Sorostew,twisting-nether,1467,deathknight,unholy,42,23,19
Arxelas,sylvanas,1467,deathknight,unholy,115,60,55
Frags,arathor,1467,deathknight,unholy,66,31,35
Moko,defias-brotherhood,1467,deathknight,unholy,54,25,29
Bloodraynee,twisting-nether,1467,deathknight,unholy,48,19,29
Протосеня,soulflayer,1465,deathknight,unholy,78,35,43
Manovar,archimonde,1462,deathknight,unholy,137,65,72
Bärdk,forscherliga,1461,deathknight,unholy,95,47,48
Шифычдк,howling-fjord,1460,deathknight,unholy,60,27,33
Hawkthuglife,dun-modr,1459,deathknight,unholy,90,42,48
Nospets,kazzak,1459,deathknight,unholy,54,25,29
Fýhr,silvermoon,1458,deathknight,unholy,54,29,25
Gethunts,drakthul,1457,deathknight,unholy,42,25,17
Deusmort,ravencrest,1457,deathknight,unholy,66,26,40
Thecurator,ragnaros,1456,deathknight,unholy,72,32,40
Барагган,thermaplugg,1455,deathknight,unholy,96,47,49
Hordak,stormscale,1455,deathknight,unholy,45,16,29
Ceranto,frostwolf,1453,deathknight,unholy,77,46,31
Моорта,soulflayer,1453,deathknight,unholy,182,94,88
Kebabpizza,argent-dawn,1452,deathknight,unholy,85,42,43
Tölp,ravencrest,1452,deathknight,unholy,95,46,49
Skèltòn,rexxar,1451,deathknight,unholy,73,47,26
Форнителли,howling-fjord,1451,deathknight,unholy,54,19,35
Ohsevèn,ravencrest,1450,deathknight,unholy,65,36,29
Sathmayla,silvermoon,1448,deathknight,unholy,53,32,21
Arkaris,blackmoore,1447,deathknight,unholy,32,21,11
Шинратенсеи,howling-fjord,1447,deathknight,unholy,50,29,21
Demrior,hellfire,1447,deathknight,unholy,66,27,39
Ilius,kelthuzad,1445,deathknight,unholy,99,50,49
Dekayo,blackrock,1445,deathknight,unholy,38,19,19
Ithis,zuljin,1445,deathknight,unholy,126,60,66
Борнтудай,borean-tundra,1445,deathknight,unholy,48,17,31
Quantumshift,ravencrest,1444,deathknight,unholy,36,23,13
Дкшрёдингера,gordunni,1444,deathknight,unholy,30,16,14
Unholy,ragnaros,1444,deathknight,unholy,38,20,18
Sîck,bladefist,1444,deathknight,unholy,78,29,49
Рэндрей,gordunni,1443,deathknight,unholy,39,21,18
Сенкрул,gordunni,1440,deathknight,unholy,72,48,24
Logoz,dun-modr,1440,deathknight,unholy,30,17,13
Exoduss,dunemaul,1439,deathknight,unholy,78,38,40
Notsyndra,nemesis,1437,deathknight,unholy,49,25,24
Mîîkkaa,blackhand,1435,deathknight,unholy,42,15,27
Дедхо,soulflayer,1434,deathknight,unholy,62,28,34
Chrispbacøn,ragnaros,1433,deathknight,unholy,40,19,21
Кристер,lich-king,1433,deathknight,unholy,36,16,20
Спавни,blackscar,1432,deathknight,unholy,153,71,82
Таможникс,soulflayer,1431,deathknight,unholy,29,18,11
Reezeer,stormscale,1431,deathknight,unholy,35,17,18
Grubbins,kul-tiras,1427,deathknight,unholy,55,29,26
Apatheia,stormscale,1426,deathknight,unholy,28,16,12
Zandruq,twisting-nether,1426,deathknight,unholy,88,47,41
Gøretterog,ysondre,1425,deathknight,unholy,24,15,9
Shabiri,twisting-nether,1425,deathknight,unholy,97,52,45
Шейзо,soulflayer,1424,deathknight,unholy,39,22,17
Анихиме,howling-fjord,1424,deathknight,unholy,75,37,38
Zeghor,ragnaros,1424,deathknight,unholy,78,32,46
Ardros,eredar,1422,deathknight,unholy,84,38,46
Späwn,ysondre,1422,deathknight,unholy,64,24,40
Астартэс,deathguard,1421,deathknight,unholy,30,19,11
Discochoppa,blackmoore,1421,deathknight,unholy,36,15,21
Tenzøftw,archimonde,1420,deathknight,unholy,30,15,15
Ðiesel,stormscale,1420,deathknight,unholy,111,45,66
Maradk,drakthul,1419,deathknight,unholy,166,82,84
Анкара,ashenvale,1419,deathknight,unholy,83,41,42
Ínví,aegwynn,1418,deathknight,unholy,96,47,49
Wallenschøld,kazzak,1418,deathknight,unholy,36,15,21
Аирфрост,howling-fjord,1416,deathknight,unholy,54,25,29
Epoch,azjolnerub,1416,deathknight,unholy,103,47,56
Arxelas,stormscale,1416,deathknight,unholy,72,30,42
Pavkata,outland,1415,deathknight,unholy,154,74,80
Mìa,kragjin,1415,deathknight,unholy,73,33,40
Exanex,ragnaros,1413,deathknight,unholy,24,15,9
Cheethdoom,ragnaros,1413,deathknight,unholy,30,15,15
Sorcc,burning-legion,1413,deathknight,unholy,76,36,40
Десхоб,soulflayer,1413,deathknight,unholy,163,66,97
Empiu,blackhand,1409,deathknight,unholy,36,23,13
Terren,ravencrest,1409,deathknight,unholy,52,29,23
Xirra,tarren-mill,1409,deathknight,unholy,67,33,34
Hêalz,ungoro,1408,deathknight,unholy,66,34,32
Assgripper,hyjal,1406,deathknight,unholy,42,26,16
Вирзерагна,howling-fjord,1406,deathknight,unholy,48,29,19
Negzul,blackmoore,1406,deathknight,unholy,73,39,34
Walkeni,defias-brotherhood,1405,deathknight,unholy,78,35,43
Estoico,ragnaros,1404,deathknight,unholy,66,32,34
Кланки,soulflayer,1404,deathknight,unholy,76,34,42
Ðaserka,blackrock,1403,deathknight,unholy,23,15,8
Deathlïght,nemesis,1399,deathknight,unholy,77,41,36
Fosswire,stormscale,1399,deathknight,unholy,36,18,18
Sonofalích,aerie-peak,1397,deathknight,unholy,43,24,19
Draforce,quelthalas,1396,deathknight,unholy,63,35,28
Judythegreat,silvermoon,1396,deathknight,unholy,53,23,30
Xado,frostwolf,1395,deathknight,unholy,96,51,45
Ecoya,blackrock,1395,deathknight,unholy,35,16,19
Lorvetis,malorne,1395,deathknight,unholy,42,19,23
Frostmommy,argent-dawn,1394,deathknight,unholy,87,37,50
Skøurge,silvermoon,1392,deathknight,unholy,186,93,93
Dzwiadke,burning-legion,1392,deathknight,unholy,122,56,66
Zegaan,kazzak,1391,deathknight,unholy,90,43,47
Blorin,sylvanas,1391,deathknight,unholy,91,41,50
Unholycard,argent-dawn,1389,deathknight,unholy,72,37,35
Reapocalypse,blackhand,1389,deathknight,unholy,244,118,126
Darhma,archimonde,1389,deathknight,unholy,56,19,37
Gaurk,aggra-português,1382,deathknight,unholy,42,24,18
Jalapeñofan,tarren-mill,1382,deathknight,unholy,75,36,39
Мурмадонище,soulflayer,1380,deathknight,unholy,32,21,11
Анфалагон,gordunni,1380,deathknight,unholy,102,49,53
Сивкабурка,fordragon,1380,deathknight,unholy,42,16,26
Fixmybones,frostmane,1378,deathknight,unholy,54,22,32
Дядьдим,soulflayer,1377,deathknight,unholy,39,18,21
Flawstmourne,kazzak,1374,deathknight,unholy,35,15,20
Нарилуне,blackscar,1373,deathknight,unholy,394,194,200
Мёрдерфэйсх,soulflayer,1373,deathknight,unholy,132,63,69
Bloodbane,burning-blade,1371,deathknight,unholy,66,29,37
Ziuziu,twisting-nether,1371,deathknight,unholy,48,15,33
Dkbladet,ravencrest,1370,deathknight,unholy,81,41,40
Roaredrick,draenor,1370,deathknight,unholy,93,44,49
Tyvra,blackhand,1369,deathknight,unholy,47,17,30
Nilodk,nemesis,1367,deathknight,unholy,332,170,162
Oßitø,ravencrest,1365,deathknight,unholy,31,17,14
Metalist,ravencrest,1362,deathknight,unholy,78,37,41
Sveinnhran,kazzak,1361,deathknight,unholy,194,95,99
Bloodkatana,drakthul,1359,deathknight,unholy,60,24,36
Arthrex,twisting-nether,1358,deathknight,unholy,36,21,15
Veyrøn,kazzak,1358,deathknight,unholy,54,29,25
Ridire,saurfang,1358,deathknight,unholy,53,27,26
Fishtruction,tarren-mill,1357,deathknight,unholy,210,111,99
Morinosei,twisting-nether,1351,deathknight,unholy,89,48,41
Nekote,silvermoon,1350,deathknight,unholy,33,17,16
Dunklerlord,malfurion,1348,deathknight,unholy,36,17,19
Gûuts,archimonde,1347,deathknight,unholy,253,129,124
Xênôrr,archimonde,1347,deathknight,unholy,30,15,15
Petardodupy,burning-legion,1344,deathknight,unholy,44,20,24
Хейткрю,howling-fjord,1342,deathknight,unholy,48,21,27
Zóur,rajaxx,1338,deathknight,unholy,60,31,29
Томиганн,grom,1336,deathknight,unholy,48,23,25
Züg,draenor,1336,deathknight,unholy,120,56,64
Aesthaetik,draenor,1332,deathknight,unholy,28,16,12
Scotty,ravencrest,1330,deathknight,unholy,30,14,16
Jöndas,drakthul,1329,deathknight,unholy,48,25,23
Evelys,kazzak,1329,deathknight,unholy,34,17,17
Тумм,howling-fjord,1329,deathknight,unholy,30,14,16
Fizzdk,pozzo-delleternità,1329,deathknight,unholy,54,24,30
Kalantii,draenor,1326,deathknight,unholy,36,19,17
Gengàr,tarren-mill,1325,deathknight,unholy,24,14,10
Fentanil,elune,1325,deathknight,unholy,229,116,113
Зибак,soulflayer,1322,deathknight,unholy,51,24,27
Teflonphobos,stormreaver,1320,deathknight,unholy,18,14,4
Dunkàn,silvermoon,1318,deathknight,unholy,48,32,16
Darkhallow,thrall,1318,deathknight,unholy,142,76,66
Zarad,scarshield-legion,1318,deathknight,unholy,30,15,15
Prænklý,blackrock,1316,deathknight,unholy,60,28,32
Detrah,argent-dawn,1315,deathknight,unholy,52,27,25
Ahlat,blackmoore,1306,deathknight,unholy,89,53,36
Алкеокол,soulflayer,1301,deathknight,unholy,33,15,18
Defeated,thrall,1301,deathknight,unholy,81,36,45
Akelæ,draenor,1300,deathknight,unholy,70,35,35
Persefal,nemesis,1300,deathknight,unholy,48,18,30
Mojodango,outland,1299,deathknight,unholy,26,15,11
Fluffínator,kazzak,1298,deathknight,unholy,88,45,43
Крикед,soulflayer,1297,deathknight,unholy,102,55,47
Роземайер,ashenvale,1297,deathknight,unholy,60,29,31
Msvine,kazzak,1294,deathknight,unholy,72,39,33
Táli,tarren-mill,1294,deathknight,unholy,33,14,19
Asakim,tarren-mill,1291,deathknight,unholy,29,14,15
Альмон,howling-fjord,1290,deathknight,unholy,42,19,23
Ничер,thermaplugg,1289,deathknight,unholy,24,14,10
Jihm,silvermoon,1286,deathknight,unholy,141,72,69
Бреч,gordunni,1285,deathknight,unholy,42,14,28
Xawias,ulduar,1283,deathknight,unholy,26,15,11
Sictir,stormscale,1280,deathknight,unholy,236,113,123
Endlesspain,burning-legion,1280,deathknight,unholy,58,24,34
Âlîce,culte-de-la-rive-noire,1277,deathknight,unholy,36,19,17
Galayn,burning-legion,1277,deathknight,unholy,33,14,19
Kratagon,thrall,1276,deathknight,unholy,72,25,47
Zracul,nordrassil,1272,deathknight,unholy,85,41,44
Джайвана,soulflayer,1270,deathknight,unholy,227,114,113
Reportmeplz,ragnaros,1270,deathknight,unholy,48,22,26
Necrozy,aggra-português,1269,deathknight,unholy,84,43,41
Necrocancerr,twisting-nether,1269,deathknight,unholy,116,55,61
Lobotomia,burning-blade,1266,deathknight,unholy,49,25,24
Kaletorn,ragnaros,1265,deathknight,unholy,84,41,43
Undtot,azshara,1264,deathknight,unholy,36,16,20
Pjthedk,lightbringer,1263,deathknight,unholy,42,21,21
Drenodur,amanthul,1261,deathknight,unholy,24,14,10
Superere,hyjal,1261,deathknight,unholy,36,17,19
Mamanica,sanguino,1261,deathknight,unholy,30,14,16
Heyabigail,wildhammer,1258,deathknight,unholy,72,29,43
Fineral,argent-dawn,1256,deathknight,unholy,48,21,27
Tesasd,silvermoon,1255,deathknight,unholy,58,26,32
Sarkasm,malganis,1248,deathknight,unholy,66,31,35
Chocopeanut,ravencrest,1246,deathknight,unholy,25,15,10
Taylorswiftz,tarren-mill,1246,deathknight,unholy,30,13,17
Ластофас,gordunni,1242,deathknight,unholy,30,13,17
Elíta,draenor,1242,deathknight,unholy,36,15,21
Schweezlord,tarren-mill,1241,deathknight,unholy,24,13,11
Патриаррх,gordunni,1240,deathknight,unholy,47,25,22
Flinsen,blackmoore,1239,deathknight,unholy,86,47,39
Kéréos,hyjal,1238,deathknight,unholy,24,13,11
Turkknight,outland,1236,deathknight,unholy,30,13,17
Obstwald,blackrock,1235,deathknight,unholy,49,26,23
Zelbørk,medivh,1235,deathknight,unholy,42,21,21
Khorag,lordaeron,1235,deathknight,unholy,30,13,17
Rimewraith,argent-dawn,1232,deathknight,unholy,32,15,17
Funds,kazzak,1230,deathknight,unholy,30,13,17
Дэбон,howling-fjord,1229,deathknight,unholy,138,63,75
Аданаэль,howling-fjord,1228,deathknight,unholy,47,21,26
Крус,blackscar,1227,deathknight,unholy,89,39,50
Serelis,argent-dawn,1226,deathknight,unholy,36,13,23
Younix,silvermoon,1221,deathknight,unholy,48,16,32
Варделон,gordunni,1219,deathknight,unholy,18,13,5
Halohuntress,outland,1219,deathknight,unholy,42,18,24
Zpartan,ragnaros,1216,deathknight,unholy,48,17,31
Tanenoss,kazzak,1213,deathknight,unholy,54,21,33
Gothenburger,darksorrow,1212,deathknight,unholy,48,24,24
Razzvy,darkspear,1209,deathknight,unholy,69,30,39
Thedx,blades-edge,1208,deathknight,unholy,52,20,32
Деркхаус,soulflayer,1206,deathknight,unholy,24,15,9
Tyranus,quelthalas,1203,deathknight,unholy,156,69,87
Sigarå,twisting-nether,1191,deathknight,unholy,36,16,20
Mayaya,malganis,1190,deathknight,unholy,28,14,14
Bitdead,doomhammer,1184,deathknight,unholy,30,15,15
Darkqüeen,sanguino,1180,deathknight,unholy,30,14,16
Homoforsluts,silvermoon,1178,deathknight,unholy,24,15,9
Abnormus,tarren-mill,1175,deathknight,unholy,45,19,26
Tarfu,kazzak,1168,deathknight,unholy,42,20,22
Ezreo,neptulon,1167,deathknight,unholy,31,14,17
Eltorro,ravencrest,1165,deathknight,unholy,42,14,28
Микелон,gordunni,1164,deathknight,unholy,22,13,9
Dezzi,azuremyst,1160,deathknight,unholy,62,31,31
Дэдушка,gordunni,1159,deathknight,unholy,23,13,10
Radan,stormscale,1152,deathknight,unholy,24,12,12
Fyrkadk,aegwynn,1151,deathknight,unholy,24,12,12
Qmy,outland,1151,deathknight,unholy,46,17,29
Tharassian,chamber-of-aspects,1150,deathknight,unholy,24,12,12
Dklol,dun-morogh,1150,deathknight,unholy,36,14,22
Numnutz,alakir,1149,deathknight,unholy,25,13,12
Usbdock,stormscale,1149,deathknight,unholy,24,12,12
Auru,tarren-mill,1149,deathknight,unholy,63,31,32
Larrydk,tarren-mill,1147,deathknight,unholy,24,12,12
Mawdrym,twisting-nether,1146,deathknight,unholy,24,12,12
Micaiah,dun-modr,1146,deathknight,unholy,30,12,18
Клиссанг,razuvious,1146,deathknight,unholy,42,12,30
Slawtér,arathor,1145,deathknight,unholy,24,12,12
Trialist,dun-modr,1143,deathknight,unholy,24,12,12
Roykoopa,hyjal,1143,deathknight,unholy,42,19,23
Rûnâr,proudmoore,1141,deathknight,unholy,21,13,8
Mãshi,hyjal,1140,deathknight,unholy,59,26,33
Leipä,scarshield-legion,1140,deathknight,unholy,30,12,18
Grezak,defias-brotherhood,1139,deathknight,unholy,24,12,12
Scareanger,argent-dawn,1139,deathknight,unholy,29,14,15
Nestia,emerald-dream,1139,deathknight,unholy,49,22,27
Gùra,sanguino,1139,deathknight,unholy,36,13,23
Sevatar,zuljin,1137,deathknight,unholy,18,12,6
Kailara,draenor,1133,deathknight,unholy,29,12,17
Niex,destromath,1133,deathknight,unholy,30,12,18
Jowân,blackmoore,1131,deathknight,unholy,24,13,11
Dêku,aegwynn,1130,deathknight,unholy,79,44,35
Lilyxtulle,tarren-mill,1128,deathknight,unholy,131,64,67
Asakurai,grim-batol,1126,deathknight,unholy,42,22,20
Feekus,deathwing,1123,deathknight,unholy,18,12,6
Mellowqt,aegwynn,1120,deathknight,unholy,53,25,28
Kazay,madmortem,1119,deathknight,unholy,24,12,12
Артушадк,soulflayer,1118,deathknight,unholy,60,31,29
Híruzen,blackrock,1115,deathknight,unholy,30,15,15
Zdan,sylvanas,1114,deathknight,unholy,30,15,15
Ârtjom,aegwynn,1106,deathknight,unholy,28,12,16
Saromón,ravencrest,1101,deathknight,unholy,30,18,12
Zathron,blackmoore,1087,deathknight,unholy,35,15,20
Gowther,blackmoore,1086,deathknight,unholy,66,37,29
Skeggjold,drakthul,1083,deathknight,unholy,24,12,12
Narrua,die-aldor,1082,deathknight,unholy,47,17,30
Orochimaruo,stormscale,1080,deathknight,unholy,36,15,21
Diatriss,argent-dawn,1078,deathknight,unholy,63,27,36
Highmelli,ambossar,1070,deathknight,unholy,78,27,51
Ennigmá,stormscale,1066,deathknight,unholy,24,13,11
Flytomoon,argent-dawn,1062,deathknight,unholy,23,13,10
Фиджибро,soulflayer,1060,deathknight,unholy,44,17,27
Grisig,twisting-nether,1057,deathknight,unholy,30,18,12
Bigblackgrip,hyjal,1056,deathknight,unholy,24,11,13
Fuzzyofc,draenor,1054,deathknight,unholy,24,11,13
Synchronic,stormscale,1053,deathknight,unholy,24,11,13
Regniér,frostwolf,1050,deathknight,unholy,18,11,7
Некронн,grom,1050,deathknight,unholy,23,13,10
Mefhesto,tarren-mill,1049,deathknight,unholy,30,11,19
Pamplemouse,burning-blade,1046,deathknight,unholy,85,40,45
Нуурргл,howling-fjord,1046,deathknight,unholy,48,19,29
Shakour,argent-dawn,1044,deathknight,unholy,18,11,7
Rammsteïn,ravencrest,1042,deathknight,unholy,33,12,21
Ilovegouàng,khaz-modan,1041,deathknight,unholy,36,15,21
Eibon,drakthul,1037,deathknight,unholy,18,11,7
Порнпанда,gordunni,1037,deathknight,unholy,24,11,13
Волграл,howling-fjord,1036,deathknight,unholy,18,11,7
Jixcore,draenor,1034,deathknight,unholy,36,11,25
Охъламон,soulflayer,1030,deathknight,unholy,100,43,57
Beinlausi,dalaran,1026,deathknight,unholy,21,12,9
Мокраявода,soulflayer,1026,deathknight,unholy,94,49,45
Kixx,bloodfeather,1026,deathknight,unholy,88,37,51
Larvalîs,blackmoore,1025,deathknight,unholy,48,24,24
Karalun,nagrand,1024,deathknight,unholy,66,32,34
Taylorswiift,tarren-mill,1023,deathknight,unholy,17,11,6
Icyplague,ravencrest,1018,deathknight,unholy,20,12,8
Малп,gordunni,1018,deathknight,unholy,42,24,18
Assasínator,tarren-mill,1017,deathknight,unholy,205,105,100
Kaldhan,nemesis,1017,deathknight,unholy,30,13,17
Scorbion,kilrogg,1015,deathknight,unholy,24,11,13
Рэкставр,soulflayer,1014,deathknight,unholy,64,33,31
Takåtry,archimonde,1004,deathknight,unholy,30,14,16
Kisenth,doomhammer,1000,deathknight,unholy,48,28,20
Tyrannus,earthen-ring,1000,deathknight,unholy,23,13,10
Braastad,sylvanas,989,deathknight,unholy,66,35,31
Hqxdd,twisting-nether,982,deathknight,unholy,87,37,50
Gathalion,the-maelstrom,980,deathknight,unholy,48,28,20
Ashlëy,kaelthas,978,deathknight,unholy,156,74,82
Квашонка,howling-fjord,972,deathknight,unholy,84,28,56
Kaliro,sylvanas,960,deathknight,unholy,18,10,8
Бешенсство,soulflayer,960,deathknight,unholy,18,10,8
Julezer,malganis,960,deathknight,unholy,24,10,14
Кромгондк,soulflayer,960,deathknight,unholy,24,10,14
Spom,elune,960,deathknight,unholy,30,10,20
Feelmyfuri,mazrigos,959,deathknight,unholy,18,10,8
Olriklol,dentarg,959,deathknight,unholy,18,10,8
Silvergreed,kazzak,959,deathknight,unholy,24,10,14
Скизм,howling-fjord,959,deathknight,unholy,24,10,14
Drogba,burning-blade,958,deathknight,unholy,18,10,8
Bølvar,zuljin,958,deathknight,unholy,18,10,8
Rimda,twisting-nether,958,deathknight,unholy,18,10,8
Fpsrvg,minahonda,956,deathknight,unholy,53,23,30
Restodrowd,tarren-mill,955,deathknight,unholy,57,29,28
Syncros,blackrock,955,deathknight,unholy,24,10,14
Puppétmastér,kazzak,954,deathknight,unholy,24,10,14
Bämbämpewpew,ravencrest,954,deathknight,unholy,24,10,14
Nickolass,skullcrusher,953,deathknight,unholy,48,22,26
Azrìal,agamaggan,951,deathknight,unholy,24,10,14
Aguroh,khaz-modan,937,deathknight,unholy,36,16,20
Dreamgirl,sylvanas,931,deathknight,unholy,24,14,10
Gravetitan,shattrath,931,deathknight,unholy,85,33,52
Jess,blackhand,926,deathknight,unholy,65,33,32
Rognvald,les-sentinelles,921,deathknight,unholy,47,23,24
Valeriania,burning-legion,919,deathknight,unholy,21,11,10
Thyrandre,khaz-modan,905,deathknight,unholy,56,20,36
Rayliegh,silvermoon,891,deathknight,unholy,17,10,7
Лордэнергон,gordunni,888,deathknight,unholy,16,10,6
Unzul,twisting-nether,869,deathknight,unholy,18,10,8
Orcborg,zuljin,868,deathknight,unholy,25,10,15
Gáïà,blackmoore,864,deathknight,unholy,12,9,3
Deathcaller,dun-modr,864,deathknight,unholy,12,9,3
Diabeticus,the-maelstrom,864,deathknight,unholy,18,9,9
Fringles,twisting-nether,864,deathknight,unholy,18,9,9
Charlytango,archimonde,864,deathknight,unholy,18,9,9
Catloaf,silvermoon,864,deathknight,unholy,24,9,15
Mateusz,lightbringer,863,deathknight,unholy,12,9,3
Darknemesis,nemesis,863,deathknight,unholy,18,9,9
Styxdk,blackhand,863,deathknight,unholy,18,9,9
Elliipirelli,doomhammer,863,deathknight,unholy,18,9,9
Ecormcpz,eredar,863,deathknight,unholy,24,9,15
Frostplague,aegwynn,863,deathknight,unholy,24,9,15
Oxxöw,draenor,863,deathknight,unholy,24,9,15
Råyzen,draenor,863,deathknight,unholy,24,9,15
Dimania,the-maelstrom,863,deathknight,unholy,30,9,21
Plagueherald,ravencrest,862,deathknight,unholy,18,9,9
Vrez,argent-dawn,862,deathknight,unholy,24,9,15
Alroc,blackrock,862,deathknight,unholy,30,9,21
Izanagii,exodar,861,deathknight,unholy,18,9,9
Valanaari,argent-dawn,861,deathknight,unholy,24,9,15
Тзинч,soulflayer,859,deathknight,unholy,18,9,9
Dzahnecro,archimonde,858,deathknight,unholy,18,9,9
Booneuh,kazzak,858,deathknight,unholy,24,9,15
Кмамехочу,howling-fjord,857,deathknight,unholy,12,9,3
Grubyr,burning-legion,857,deathknight,unholy,24,9,15
Джагат,gordunni,856,deathknight,unholy,30,12,18
Dalenn,kazzak,856,deathknight,unholy,24,9,15
Marcianorock,dalaran,850,deathknight,unholy,18,9,9
Deathcleave,burning-legion,845,deathknight,unholy,23,9,14
Lastdragon,dun-modr,840,deathknight,unholy,42,16,26
Oldu,haomarush,836,deathknight,unholy,63,28,35
Жекабыкует,borean-tundra,836,deathknight,unholy,38,14,24
Fidaii,sylvanas,833,deathknight,unholy,18,9,9
Civilredevil,ravencrest,830,deathknight,unholy,23,9,14
Cryistyx,draenor,828,deathknight,unholy,14,10,4
Zot,twisting-nether,814,deathknight,unholy,18,10,8
Flúrrý,ravencrest,799,deathknight,unholy,17,9,8
Angalor,argent-dawn,798,deathknight,unholy,17,9,8
Шмуркич,gordunni,798,deathknight,unholy,23,10,13
Alielib,eredar,794,deathknight,unholy,70,22,48
Марактус,gordunni,768,deathknight,unholy,12,8,4
Wórzzag,arygos,768,deathknight,unholy,12,8,4
Psychopathz,tarren-mill,768,deathknight,unholy,12,8,4
Barnëylord,argent-dawn,768,deathknight,unholy,12,8,4
Ravencraft,azjolnerub,768,deathknight,unholy,12,8,4
Aladonreith,zenedar,768,deathknight,unholy,12,8,4
Critycal,draenor,768,deathknight,unholy,12,8,4
Preddktwo,twisting-nether,768,deathknight,unholy,12,8,4
Шадоудез,gordunni,768,deathknight,unholy,12,8,4
Fatøumatata,archimonde,768,deathknight,unholy,18,8,10
Glower,burning-blade,768,deathknight,unholy,18,8,10
Xisaark,blackrock,768,deathknight,unholy,18,8,10
Zatrina,blackrock,768,deathknight,unholy,24,8,16
Dariusgrip,kazzak,768,deathknight,unholy,24,8,16
Мионеелол,goldrinn,768,deathknight,unholy,24,8,16
Dreshtarg,draenor,768,deathknight,unholy,24,8,16
Quazy,draenor,768,deathknight,unholy,30,8,22
Amelia,ambossar,767,deathknight,unholy,12,8,4
Deathpaladin,blackmoore,767,deathknight,unholy,12,8,4
Bonethugg,burning-legion,767,deathknight,unholy,18,8,10
Thanatus,aggra-português,767,deathknight,unholy,18,8,10
Apocalypse,ravencrest,767,deathknight,unholy,18,8,10
Goblinslayer,zuljin,767,deathknight,unholy,18,8,10
Shewoman,stormreaver,767,deathknight,unholy,18,8,10
Blácklíght,silvermoon,767,deathknight,unholy,18,8,10
Kàrásu,eredar,767,deathknight,unholy,18,8,10
Cyliandra,silvermoon,767,deathknight,unholy,27,9,18
Nuadar,outland,767,deathknight,unholy,24,8,16
Kaeyz,blackmoore,767,deathknight,unholy,24,8,16
Payat,aegwynn,766,deathknight,unholy,12,8,4
Auggee,ravencrest,766,deathknight,unholy,18,8,10
Krinoe,dalaran,766,deathknight,unholy,18,8,10
Zombienatíon,silvermoon,766,deathknight,unholy,24,8,16
Juicyjayho,stormscale,765,deathknight,unholy,24,8,16
Appdeath,azjolnerub,764,deathknight,unholy,12,8,4
Trigárdon,antonidas,764,deathknight,unholy,58,28,30
Darkeron,dun-modr,764,deathknight,unholy,18,8,10
Zanretxd,outland,764,deathknight,unholy,20,8,12
Mjölnir,sanguino,764,deathknight,unholy,24,8,16
Жупело,gordunni,762,deathknight,unholy,12,8,4
Latindvergur,sylvanas,762,deathknight,unholy,18,8,10
Olm,guldan,761,deathknight,unholy,12,8,4
Kazagoth,draenor,761,deathknight,unholy,18,8,10
Badbrian,draenor,760,deathknight,unholy,12,8,4
Unsuspected,kazzak,758,deathknight,unholy,24,8,16
Homunculas,twisting-nether,750,deathknight,unholy,17,8,9
Bhishma,blades-edge,749,deathknight,unholy,12,8,4
Ricardiob,argent-dawn,748,deathknight,unholy,16,9,7
Morssal,outland,748,deathknight,unholy,17,8,9
Kahp,tarren-mill,738,deathknight,unholy,21,9,12
Aldramil,gorgonnash,726,deathknight,unholy,24,9,15
Holîx,kazzak,714,deathknight,unholy,21,9,12
Deathuss,silvermoon,702,deathknight,unholy,22,8,14
Karisteur,azuremyst,672,deathknight,unholy,12,7,5
Moonpoxdk,nerathor,672,deathknight,unholy,12,7,5
Cervä,kazzak,672,deathknight,unholy,12,7,5
Gosuhat,kazzak,672,deathknight,unholy,12,7,5
Wolfyy,antonidas,672,deathknight,unholy,12,7,5
Vorrén,tarren-mill,672,deathknight,unholy,12,7,5
Vaalur,dalaran,672,deathknight,unholy,12,7,5
Диджейфрау,deathguard,672,deathknight,unholy,12,7,5
Hyperflexz,blackrock,672,deathknight,unholy,14,7,7
Wttdmg,kazzak,672,deathknight,unholy,18,7,11
Soulchaos,ravencrest,672,deathknight,unholy,18,7,11
Sythuss,argent-dawn,672,deathknight,unholy,18,7,11
Чумазная,howling-fjord,672,deathknight,unholy,18,7,11
Никнейм,gordunni,672,deathknight,unholy,18,7,11
Unholykebab,defias-brotherhood,672,deathknight,unholy,18,7,11
Darkarthás,aegwynn,672,deathknight,unholy,18,7,11
Gadres,aegwynn,672,deathknight,unholy,18,7,11
Keet,turalyon,672,deathknight,unholy,21,8,13
Падшийрыцарь,gordunni,671,deathknight,unholy,12,7,5
Lùrtzz,frostwolf,671,deathknight,unholy,12,7,5
Theamine,silvermoon,671,deathknight,unholy,12,7,5
Smightydk,kazzak,671,deathknight,unholy,12,7,5
Моргаррок,soulflayer,671,deathknight,unholy,12,7,5
Cmonbruvv,outland,671,deathknight,unholy,12,7,5
Дезентирия,soulflayer,671,deathknight,unholy,15,7,8
Корольбич,soulflayer,671,deathknight,unholy,18,7,11
Lìlïth,kazzak,671,deathknight,unholy,18,7,11
Creepzor,tarren-mill,671,deathknight,unholy,18,7,11
Mcrune,ravencrest,671,deathknight,unholy,18,7,11
Shiryú,ravencrest,671,deathknight,unholy,24,7,17
Ráisy,outland,671,deathknight,unholy,24,7,17
Crudelias,aegwynn,670,deathknight,unholy,12,7,5
Думсдэйи,gordunni,670,deathknight,unholy,12,7,5
Дуонза,blackscar,670,deathknight,unholy,12,7,5
Планус,booty-bay,670,deathknight,unholy,12,7,5
Amencore,kazzak,670,deathknight,unholy,14,7,7
Kranker,thrall,670,deathknight,unholy,18,7,11
Sulf,burning-legion,670,deathknight,unholy,18,7,11
Deathclapp,twisting-nether,670,deathknight,unholy,18,7,11
Akuji,dragonmaw,669,deathknight,unholy,12,7,5
Gothral,doomhammer,665,deathknight,unholy,12,7,5
Redzone,ravencrest,639,deathknight,unholy,23,7,16
Ogomegee,ravencrest,638,deathknight,unholy,16,7,9
Arthursq,stormscale,627,deathknight,unholy,82,30,52
Cremefresh,ragnaros,624,deathknight,unholy,15,7,8
Дкмонт,deathguard,623,deathknight,unholy,17,7,10
Moartèa,blackhand,622,deathknight,unholy,23,7,16
Kazagul,blackrock,620,deathknight,unholy,21,7,14
Ashgôrath,defias-brotherhood,607,deathknight,unholy,20,7,13
Vargass,darksorrow,598,deathknight,unholy,14,7,7
Uqrdk,twisting-nether,576,deathknight,unholy,12,6,6
Mêlian,blackmoore,576,deathknight,unholy,12,6,6
Kurían,burning-legion,576,deathknight,unholy,12,6,6
Ymirzo,outland,576,deathknight,unholy,12,6,6
Babs,sylvanas,576,deathknight,unholy,12,6,6
Duriel,stormscale,576,deathknight,unholy,12,6,6
Tombkeeper,silvermoon,576,deathknight,unholy,12,6,6
Merekx,emerald-dream,576,deathknight,unholy,12,6,6
Huxleeyys,draenor,576,deathknight,unholy,12,6,6
Swordkill,drakthul,576,deathknight,unholy,12,6,6
Янатащи,gordunni,576,deathknight,unholy,12,6,6
Petergrippin,dragonblight,576,deathknight,unholy,12,6,6
Myeltior,kazzak,576,deathknight,unholy,12,6,6
Фалькра,soulflayer,576,deathknight,unholy,12,6,6
Lemain,drakthul,576,deathknight,unholy,12,6,6
Gigadk,ragnaros,576,deathknight,unholy,12,6,6
Kyusuke,blackhand,576,deathknight,unholy,12,6,6
Ketnissq,blackrock,576,deathknight,unholy,12,6,6
Nephalêm,thrall,576,deathknight,unholy,12,6,6
Sfintter,uldum,576,deathknight,unholy,12,6,6
Dextroyersx,sanguino,576,deathknight,unholy,12,6,6
Venexia,kazzak,576,deathknight,unholy,12,6,6
Critgødx,draenor,576,deathknight,unholy,13,6,7
Pestikus,thrall,576,deathknight,unholy,18,6,12
Elisaron,silvermoon,576,deathknight,unholy,18,6,12
Bubbledeath,tarren-mill,576,deathknight,unholy,18,6,12
Deathboost,archimonde,576,deathknight,unholy,18,6,12
Armanelo,stormscale,576,deathknight,unholy,18,6,12
Itokawa,tarren-mill,576,deathknight,unholy,18,6,12
Exult,twisting-nether,576,deathknight,unholy,18,6,12
Tyranuse,kazzak,576,deathknight,unholy,24,6,18
Nefertitï,kazzak,576,deathknight,unholy,30,6,24
Pangen,ravencrest,576,deathknight,unholy,36,6,30
Havi,thunderhorn,575,deathknight,unholy,12,6,6
Archdemonio,wildhammer,575,deathknight,unholy,12,6,6
Arrakìs,nemesis,575,deathknight,unholy,12,6,6
Oldiseas,grim-batol,575,deathknight,unholy,12,6,6
Squeeze,drakthul,575,deathknight,unholy,12,6,6
Zegò,silvermoon,575,deathknight,unholy,12,6,6
Mosscraciun,kazzak,575,deathknight,unholy,12,6,6
Feugen,hyjal,575,deathknight,unholy,12,6,6
Zúrg,stormscale,575,deathknight,unholy,12,6,6
Deathmaiden,outland,575,deathknight,unholy,12,6,6
Dekatos,twisting-nether,575,deathknight,unholy,12,6,6
Namfuuh,blackrock,575,deathknight,unholy,24,6,18
Luciferyan,twisting-nether,574,deathknight,unholy,12,6,6
Nephenty,der-rat-von-dalaran,574,deathknight,unholy,12,6,6
Fortinateur,dalaran,573,deathknight,unholy,12,6,6
Cervanteso,uldum,571,deathknight,unholy,12,6,6
Kirkster,terokkar,570,deathknight,unholy,18,6,12
Hailandher,nemesis,565,deathknight,unholy,12,6,6
Lifetakergr,sylvanas,544,deathknight,unholy,16,6,10
Keltòr,antonidas,539,deathknight,unholy,17,6,11
Laobeef,twisting-nether,527,deathknight,unholy,11,6,5
Даркслэш,howling-fjord,522,deathknight,unholy,23,8,15
Deadpòól,twisting-nether,521,deathknight,unholy,33,7,26
Nirna,argent-dawn,514,deathknight,unholy,39,6,33
Vrark,forscherliga,512,deathknight,unholy,10,6,4
Seal,lightnings-blade,511,deathknight,unholy,26,9,17
Necrotickiss,frostwolf,480,deathknight,unholy,6,5,1
Roids,twisting-nether,480,deathknight,unholy,6,5,1
Sarconis,quelthalas,480,deathknight,unholy,6,5,1
Dromor,echsenkessel,480,deathknight,unholy,6,5,1
Náthrakh,argent-dawn,480,deathknight,unholy,6,5,1
Roundoné,kazzak,480,deathknight,unholy,6,5,1
Phrek,outland,480,deathknight,unholy,12,5,7
Boreghar,drakthul,480,deathknight,unholy,12,5,7
Gigacow,outland,480,deathknight,unholy,12,5,7
Шэйп,fordragon,480,deathknight,unholy,12,5,7
Deathkanta,antonidas,480,deathknight,unholy,12,5,7
Gorruk,malorne,480,deathknight,unholy,12,5,7
Тидог,ashenvale,480,deathknight,unholy,12,5,7
Dêeath,madmortem,480,deathknight,unholy,12,5,7
Миракл,howling-fjord,480,deathknight,unholy,12,5,7
Емтвоюкиску,soulflayer,480,deathknight,unholy,12,5,7
Cipisza,drakthul,480,deathknight,unholy,12,5,7
Morgianà,argent-dawn,480,deathknight,unholy,12,5,7
Clérora,argent-dawn,480,deathknight,unholy,12,5,7
Unholybezerk,darkspear,480,deathknight,unholy,12,5,7
Kaenor,sporeggar,480,deathknight,unholy,12,5,7
Frostich,ragnaros,480,deathknight,unholy,12,5,7
Luciferon,zenedar,480,deathknight,unholy,12,5,7
Stipemiocic,nemesis,480,deathknight,unholy,12,5,7
Zyknight,silvermoon,480,deathknight,unholy,12,5,7
Sipsip,tarren-mill,480,deathknight,unholy,12,5,7
Zhugzug,ragnaros,480,deathknight,unholy,12,5,7
Хенстор,gordunni,480,deathknight,unholy,12,5,7
Gripshiftr,kazzak,480,deathknight,unholy,12,5,7
Christldeath,blackrock,480,deathknight,unholy,12,5,7
Cbalife,ragnaros,480,deathknight,unholy,12,5,7
Rêxaks,dun-modr,480,deathknight,unholy,12,5,7
Painrune,nordrassil,480,deathknight,unholy,12,5,7
Kelebglin,silvermoon,480,deathknight,unholy,12,5,7
Skylerblack,kazzak,480,deathknight,unholy,12,5,7
Leyir,shendralar,480,deathknight,unholy,13,5,8
Shining,blackrock,480,deathknight,unholy,21,6,15
Xad,blackrock,480,deathknight,unholy,18,5,13
Necroslap,blackhand,480,deathknight,unholy,18,5,13
Тоши,fordragon,480,deathknight,unholy,18,5,13
Frostbone,ravencrest,480,deathknight,unholy,18,5,13
Helixsdk,outland,480,deathknight,unholy,20,5,15
Maxïmus,argent-dawn,480,deathknight,unholy,24,5,19
Rafuki,stormscale,479,deathknight,unholy,12,6,6
Mennal,the-maelstrom,479,deathknight,unholy,12,5,7
Crostrike,kazzak,479,deathknight,unholy,12,5,7
Мордаворот,gordunni,479,deathknight,unholy,12,5,7
Еххел,soulflayer,479,deathknight,unholy,12,5,7
Kraken,aerie-peak,479,deathknight,unholy,18,5,13
Jonyo,silvermoon,479,deathknight,unholy,24,5,19
Hacknorris,aegwynn,478,deathknight,unholy,12,5,7
Mailasse,dalaran,476,deathknight,unholy,10,6,4
Jarhèad,grim-batol,476,deathknight,unholy,22,7,15
Kavour,tarren-mill,447,deathknight,unholy,8,6,2
Calhoun,teldrassil,447,deathknight,unholy,11,5,6
Shadowgohst,dun-morogh,440,deathknight,unholy,14,6,8
Eli,dalaran,431,deathknight,unholy,11,5,6
Yggrauthr,argent-dawn,384,deathknight,unholy,6,4,2
Mangemicro,archimonde,384,deathknight,unholy,6,4,2
Redduck,silvermoon,384,deathknight,unholy,6,4,2
Kalhyst,archimonde,384,deathknight,unholy,6,4,2
Neph,sanguino,384,deathknight,unholy,6,4,2
Dragamanca,shendralar,384,deathknight,unholy,6,4,2
Енваки,gordunni,384,deathknight,unholy,6,4,2
Zyôs,blackmoore,384,deathknight,unholy,6,4,2
Helmich,frostmane,384,deathknight,unholy,6,4,2
Радиосмерти,gordunni,384,deathknight,unholy,6,4,2
Runeblade,shattered-hand,384,deathknight,unholy,6,4,2
Cówboylayla,stormscale,384,deathknight,unholy,6,4,2
Tigros,burning-legion,384,deathknight,unholy,6,4,2
Rabbijacob,ysondre,384,deathknight,unholy,6,4,2
Buldog,laughing-skull,384,deathknight,unholy,6,4,2
Budgetarthas,arthas,384,deathknight,unholy,6,4,2
Shlongripper,silvermoon,384,deathknight,unholy,6,4,2
Soulrender,kirin-tor,384,deathknight,unholy,6,4,2
Copium,hyjal,384,deathknight,unholy,6,4,2
Deathfrqst,ysondre,384,deathknight,unholy,6,4,2
Stepknìght,draenor,384,deathknight,unholy,6,4,2
Lichkunt,stormscale,384,deathknight,unholy,6,4,2
Yerssinia,sylvanas,384,deathknight,unholy,6,4,2
Kãzan,archimonde,384,deathknight,unholy,6,4,2
Zd,ghostlands,384,deathknight,unholy,6,4,2
Servein,stormscale,384,deathknight,unholy,12,4,8
Derimathras,stormscale,384,deathknight,unholy,12,4,8
Skypowerxx,darkspear,384,deathknight,unholy,12,4,8
Dreadmind,blackrock,384,deathknight,unholy,12,4,8
Volkovitch,archimonde,384,deathknight,unholy,12,4,8
Брейвз,gordunni,384,deathknight,unholy,12,4,8
Rouskkoff,hyjal,384,deathknight,unholy,12,4,8
Виндрукс,soulflayer,384,deathknight,unholy,12,4,8
Trashdk,blackrock,384,deathknight,unholy,12,4,8
Nathriel,stormscale,384,deathknight,unholy,12,4,8
Kachie,stormscale,384,deathknight,unholy,12,4,8
Razdig,dun-modr,384,deathknight,unholy,12,4,8
Vezthel,stormscale,384,deathknight,unholy,12,4,8
Fatuglyrat,kazzak,384,deathknight,unholy,12,4,8
Wlcrealworld,ravencrest,384,deathknight,unholy,12,4,8
Puzikovatr,tarren-mill,384,deathknight,unholy,12,4,8
Amesz,tarren-mill,384,deathknight,unholy,12,4,8
Лордтемар,howling-fjord,384,deathknight,unholy,12,4,8
Cervâ,twisting-nether,384,deathknight,unholy,12,4,8
Mustakäsi,ravencrest,384,deathknight,unholy,12,4,8
Sekkah,tarren-mill,384,deathknight,unholy,12,4,8
Thoir,ahnqiraj,384,deathknight,unholy,12,4,8
Колхозник,howling-fjord,384,deathknight,unholy,12,4,8
Szayestra,draenor,384,deathknight,unholy,12,4,8
Хлопайпопой,howling-fjord,384,deathknight,unholy,12,4,8
Superpotatoh,silvermoon,384,deathknight,unholy,12,4,8
Pängei,frostwolf,384,deathknight,unholy,12,4,8
Freakabiceps,draenor,384,deathknight,unholy,18,4,14
Blòópy,silvermoon,384,deathknight,unholy,18,4,14
Brurf,ysondre,384,deathknight,unholy,18,4,14
Pottifar,tarren-mill,384,deathknight,unholy,18,4,14
Rades,sanguino,384,deathknight,unholy,18,4,14
Madseason,burning-legion,384,deathknight,unholy,18,4,14
Luzifear,bloodscalp,384,deathknight,unholy,18,4,14
Dizin,ravencrest,384,deathknight,unholy,19,4,15
Bargane,twilights-hammer,383,deathknight,unholy,6,4,2
Zoombie,draenor,383,deathknight,unholy,6,4,2
Flippmo,argent-dawn,383,deathknight,unholy,9,5,4
Хворной,howling-fjord,383,deathknight,unholy,12,4,8
Aczheron,argent-dawn,383,deathknight,unholy,12,4,8
Украшение,galakrond,383,deathknight,unholy,12,4,8
Darkangelina,aggra-português,378,deathknight,unholy,12,4,8
Варрлнишнс,soulflayer,367,deathknight,unholy,11,4,7
Millknight,norgannon,341,deathknight,unholy,15,6,9
Väkü,silvermoon,336,deathknight,unholy,9,5,4
Ikarack,twisting-nether,319,deathknight,unholy,8,4,4
Randomdkxd,ravencrest,304,deathknight,unholy,13,4,9
Saryn,burning-steppes,304,deathknight,unholy,13,4,9
Darkeolos,twisting-nether,303,deathknight,unholy,7,4,3
Amentet,anetheron,288,deathknight,unholy,10,5,5
Krozzytwo,draenor,288,deathknight,unholy,6,3,3
Fredriksend,argent-dawn,288,deathknight,unholy,6,3,3
Spliddy,ravencrest,288,deathknight,unholy,6,3,3
Knoxhult,kazzak,288,deathknight,unholy,6,3,3
Masakryczny,burning-legion,288,deathknight,unholy,6,3,3
Døddrukken,ragnaros,288,deathknight,unholy,6,3,3
Dëmise,ravencrest,288,deathknight,unholy,6,3,3
Uridk,sanguino,288,deathknight,unholy,6,3,3
Darkrolexx,blackhand,288,deathknight,unholy,6,3,3
Kalenis,nemesis,288,deathknight,unholy,6,3,3
Smalldk,silvermoon,288,deathknight,unholy,6,3,3
Soseiuchi,sargeras,288,deathknight,unholy,6,3,3
Joyt,argent-dawn,288,deathknight,unholy,6,3,3
Galgalí,blackmoore,288,deathknight,unholy,6,3,3
Gbdk,xavius,288,deathknight,unholy,6,3,3
Hasbullagødx,blackrock,288,deathknight,unholy,6,3,3
Krookidk,archimonde,288,deathknight,unholy,6,3,3
Unholyspîrît,outland,288,deathknight,unholy,6,3,3
Rävjakt,twisting-nether,288,deathknight,unholy,6,3,3
Dktyro,ravencrest,288,deathknight,unholy,6,3,3
Løz,kazzak,288,deathknight,unholy,6,3,3
Hurubur,ravencrest,288,deathknight,unholy,6,3,3
Zêlëph,archimonde,288,deathknight,unholy,6,3,3
Zathy,twisting-nether,288,deathknight,unholy,6,3,3
Небишоп,howling-fjord,288,deathknight,unholy,6,3,3
Heresjohny,stormrage,288,deathknight,unholy,6,3,3
Wpízdu,aegwynn,288,deathknight,unholy,6,3,3
Vip,argent-dawn,288,deathknight,unholy,6,3,3
Salzalara,draenor,288,deathknight,unholy,6,3,3
Dakyforfun,ravencrest,288,deathknight,unholy,6,3,3
Тряпьё,galakrond,288,deathknight,unholy,6,3,3
Grippyb,tarren-mill,288,deathknight,unholy,6,3,3
Mocca,aegwynn,288,deathknight,unholy,6,3,3
Sonervous,hyjal,288,deathknight,unholy,6,3,3
Cyphîllyth,auchindoun,288,deathknight,unholy,6,3,3
Bigbaboon,stormreaver,288,deathknight,unholy,6,3,3
Израф,soulflayer,288,deathknight,unholy,6,3,3
Cortessá,rexxar,288,deathknight,unholy,6,3,3
Jénga,ghostlands,288,deathknight,unholy,6,3,3
Zfeuda,azshara,288,deathknight,unholy,6,3,3
Карвалан,eversong,288,deathknight,unholy,6,3,3
Nmedk,grim-batol,288,deathknight,unholy,15,4,11
Ecatholicus,silvermoon,288,deathknight,unholy,12,3,9
Drraugrinn,tarren-mill,288,deathknight,unholy,12,3,9
Ipanicfart,argent-dawn,288,deathknight,unholy,12,3,9
Plaguebones,ravencrest,288,deathknight,unholy,12,3,9
Морталес,azuregos,288,deathknight,unholy,12,3,9
Whiskine,aggramar,288,deathknight,unholy,12,3,9
Worldwiynd,ravencrest,288,deathknight,unholy,12,3,9
Эвессом,goldrinn,288,deathknight,unholy,12,3,9
Mizrael,burning-blade,288,deathknight,unholy,12,3,9
Infamousmobb,archimonde,288,deathknight,unholy,12,3,9
Zixcommixx,hyjal,288,deathknight,unholy,12,3,9
Lewro,drakthul,288,deathknight,unholy,12,3,9
Benetleilax,bronzebeard,288,deathknight,unholy,12,3,9
Hexenköníg,frostmourne,288,deathknight,unholy,12,3,9
Alakiah,khaz-modan,288,deathknight,unholy,12,3,9
Dagë,twisting-nether,288,deathknight,unholy,12,3,9
Adlian,twisting-nether,288,deathknight,unholy,12,3,9
Gongroosh,blackrock,288,deathknight,unholy,12,3,9
Smurm,stormscale,288,deathknight,unholy,12,3,9
Demonium,twisting-nether,288,deathknight,unholy,12,3,9
Chains,sanguino,288,deathknight,unholy,12,3,9
Lair,shendralar,288,deathknight,unholy,12,3,9
Naerys,ysondre,287,deathknight,unholy,6,3,3
Atakan,nemesis,287,deathknight,unholy,6,3,3
Ideath,executus,287,deathknight,unholy,6,3,3
Euphorius,azuremyst,287,deathknight,unholy,6,3,3
Ahin,antonidas,287,deathknight,unholy,6,3,3
Каскадёрка,howling-fjord,287,deathknight,unholy,12,3,9
Mámmôn,malygos,287,deathknight,unholy,13,3,10
Abyad,dalaran,285,deathknight,unholy,12,3,9
Hateem,sylvanas,255,deathknight,unholy,11,3,8
Miruvar,tarren-mill,240,deathknight,unholy,9,3,6
Difestia,silvermoon,239,deathknight,unholy,5,3,2
Gogeta,zirkel-des-cenarius,239,deathknight,unholy,5,3,2
Fearax,terenas,239,deathknight,unholy,5,3,2
Charai,blackhand,234,deathknight,unholy,14,4,10
Erector,norgannon,232,deathknight,unholy,11,5,6
Xerone,turalyon,223,deathknight,unholy,8,3,5
Nexium,outland,192,deathknight,unholy,4,3,1
Varogo,drakthul,192,deathknight,unholy,6,2,4
Urukaye,silvermoon,192,deathknight,unholy,6,2,4
Fdkgotbuffed,tarren-mill,192,deathknight,unholy,6,2,4
Dilbil,tarren-mill,192,deathknight,unholy,6,2,4
Njor,twisting-nether,192,deathknight,unholy,6,2,4
Doubledead,the-maelstrom,192,deathknight,unholy,6,2,4
Barnalord,dentarg,192,deathknight,unholy,6,2,4
Mangalitsa,twisting-nether,192,deathknight,unholy,6,2,4
Norux,alonsus,192,deathknight,unholy,6,2,4
Hemopathy,tarren-mill,192,deathknight,unholy,6,2,4
Гнилец,soulflayer,192,deathknight,unholy,6,2,4
Eigrin,argent-dawn,192,deathknight,unholy,6,2,4
Draghonis,argent-dawn,192,deathknight,unholy,6,2,4
Binknight,argent-dawn,192,deathknight,unholy,6,2,4
Lén,malygos,192,deathknight,unholy,6,2,4
Iziqroi,archimonde,192,deathknight,unholy,6,2,4
Mustapha,kazzak,192,deathknight,unholy,6,2,4
Имбазомбарь,howling-fjord,192,deathknight,unholy,6,2,4
Postura,kazzak,192,deathknight,unholy,6,2,4
Woltorme,archimonde,192,deathknight,unholy,6,2,4
Аэрит,howling-fjord,192,deathknight,unholy,6,2,4
Kaysto,blackrock,192,deathknight,unholy,6,2,4
Letudra,outland,192,deathknight,unholy,6,2,4
Oxcidium,archimonde,192,deathknight,unholy,6,2,4
Unholyysteel,silvermoon,192,deathknight,unholy,6,2,4
Engelinä,ysondre,192,deathknight,unholy,6,2,4
Mcdreamy,grim-batol,192,deathknight,unholy,6,2,4
Буризан,blackscar,192,deathknight,unholy,6,2,4
Kromas,silvermoon,192,deathknight,unholy,6,2,4
Горосов,gordunni,192,deathknight,unholy,6,2,4
Nihilistyx,blackrock,192,deathknight,unholy,6,2,4
Zehahaha,defias-brotherhood,192,deathknight,unholy,6,2,4
Dk,earthen-ring,192,deathknight,unholy,6,2,4
Firebladesa,ravencrest,192,deathknight,unholy,6,2,4
Haeydez,draenor,192,deathknight,unholy,6,2,4
Shackles,ravencrest,192,deathknight,unholy,6,2,4
Bårêlýgød,blackmoore,192,deathknight,unholy,6,2,4
Kacpèr,burning-legion,192,deathknight,unholy,6,2,4
Rektsohard,ravencrest,192,deathknight,unholy,6,2,4
Thryndiel,ravencrest,192,deathknight,unholy,6,2,4
Homelándér,blackmoore,192,deathknight,unholy,6,2,4
Feldøøm,nemesis,192,deathknight,unholy,6,2,4
Hoggster,kazzak,192,deathknight,unholy,6,2,4
Alameda,nathrezim,192,deathknight,unholy,6,2,4
Clipe,sanguino,192,deathknight,unholy,6,2,4
Ghary,blackhand,192,deathknight,unholy,6,2,4
Lastprophet,drakthul,192,deathknight,unholy,6,2,4
Valkion,nemesis,192,deathknight,unholy,6,2,4
Goochtickler,kazzak,192,deathknight,unholy,6,2,4
Elendren,blackrock,192,deathknight,unholy,6,2,4
Lithics,blades-edge,192,deathknight,unholy,6,2,4
Vahllas,blackhand,192,deathknight,unholy,6,2,4
Kane,destromath,192,deathknight,unholy,7,2,5
ßambøøzle,draenor,192,deathknight,unholy,13,3,10
Majkântês,drakthul,192,deathknight,unholy,12,2,10
Sénta,tarren-mill,192,deathknight,unholy,12,2,10
Goldins,doomhammer,192,deathknight,unholy,12,2,10
Demonicaltar,dalaran,192,deathknight,unholy,12,2,10
Lumerix,drakthul,192,deathknight,unholy,12,2,10
Carnificis,nefarian,192,deathknight,unholy,12,2,10
Vîrus,kazzak,192,deathknight,unholy,12,2,10
Arthaslegend,magtheridon,192,deathknight,unholy,12,2,10
Azrail,alonsus,192,deathknight,unholy,12,2,10
Гадиния,soulflayer,191,deathknight,unholy,4,3,1
Whitedead,destromath,191,deathknight,unholy,6,2,4
Àragørn,blackrock,191,deathknight,unholy,6,2,4
Narancha,haomarush,191,deathknight,unholy,6,2,4
Ândi,alleria,190,deathknight,unholy,12,2,10
Strigoih,argent-dawn,190,deathknight,unholy,12,2,10
Mupak,drakthul,159,deathknight,unholy,5,2,3
Hokdk,voljin,159,deathknight,unholy,17,2,15
Dødsmanna,twisting-nether,144,deathknight,unholy,9,2,7
Jodure,silvermoon,138,deathknight,unholy,17,3,14
Sämäël,outland,137,deathknight,unholy,8,3,5
Auto,hyjal,128,deathknight,unholy,4,2,2
Inmau,sanguino,96,deathknight,unholy,3,2,1
Lothqgar,burning-legion,96,deathknight,unholy,3,2,1
Deathdayben,kazzak,96,deathknight,unholy,6,1,5
Unholygunnds,ravencrest,96,deathknight,unholy,6,1,5
Гачимучий,soulflayer,96,deathknight,unholy,6,1,5
Itrailblazer,turalyon,96,deathknight,unholy,6,1,5
Имерсий,gordunni,96,deathknight,unholy,6,1,5
Rongos,norgannon,96,deathknight,unholy,6,1,5
Erezar,burning-legion,96,deathknight,unholy,6,1,5
Antexdk,drakthul,96,deathknight,unholy,6,1,5
Gdubet,kazzak,96,deathknight,unholy,6,1,5
Инфлюминс,soulflayer,96,deathknight,unholy,6,1,5
Lieven,tarren-mill,96,deathknight,unholy,6,1,5
Úñçháíñéd,kazzak,96,deathknight,unholy,6,1,5
Madsgrip,tarren-mill,96,deathknight,unholy,6,1,5
Grimgôr,kazzak,96,deathknight,unholy,6,1,5
Wavemaker,kazzak,96,deathknight,unholy,6,1,5
Axemastery,draenor,96,deathknight,unholy,6,1,5
Tsoupunisher,ravencrest,96,deathknight,unholy,6,1,5
Dextèr,stormreaver,96,deathknight,unholy,6,1,5
Drfatnuts,kazzak,96,deathknight,unholy,6,1,5
Asarth,silvermoon,96,deathknight,unholy,6,1,5
Shadowevil,silvermoon,96,deathknight,unholy,6,1,5
Bytedk,aggra-português,96,deathknight,unholy,6,1,5
Brotén,grim-batol,96,deathknight,unholy,6,1,5
Sìrmooalot,twisting-nether,96,deathknight,unholy,6,1,5
Eívór,garrosh,96,deathknight,unholy,6,1,5
Муунрок,howling-fjord,96,deathknight,unholy,6,1,5
Cameltôe,frostwolf,96,deathknight,unholy,6,1,5
Beliall,draenor,96,deathknight,unholy,6,1,5
Routasydän,outland,96,deathknight,unholy,6,1,5
Veleran,blackrock,96,deathknight,unholy,6,1,5
Искрос,gordunni,96,deathknight,unholy,6,1,5
Zagoôo,outland,96,deathknight,unholy,6,1,5
Ôcb,marécage-de-zangar,96,deathknight,unholy,6,1,5
Джеттар,howling-fjord,96,deathknight,unholy,6,1,5
Cowsoup,stormscale,96,deathknight,unholy,6,1,5
Natanio,area-52,96,deathknight,unholy,6,1,5
Abusedk,archimonde,96,deathknight,unholy,6,1,5
Yagashi,stormscale,96,deathknight,unholy,6,1,5
Orrengo,blackrock,96,deathknight,unholy,6,1,5
Dumbclass,wildhammer,96,deathknight,unholy,6,1,5
Armax,stormscale,96,deathknight,unholy,6,1,5
Melicia,anubarak,96,deathknight,unholy,6,1,5
Nyzak,stormscale,96,deathknight,unholy,6,1,5
Verssatus,archimonde,96,deathknight,unholy,6,1,5
Skrati,das-syndikat,96,deathknight,unholy,6,1,5
Диманекротик,blackscar,96,deathknight,unholy,6,1,5
Gruzzaghkull,azuremyst,96,deathknight,unholy,6,1,5
Кернесса,blackscar,96,deathknight,unholy,6,1,5
Коилкоилкоил,blackscar,96,deathknight,unholy,6,1,5
Gosting,kirin-tor,96,deathknight,unholy,12,1,11
Fenixflexin,ravencrest,96,deathknight,unholy,12,1,11
Plaguecloud,kazzak,96,deathknight,unholy,12,1,11
Brasith,outland,96,deathknight,unholy,12,1,11
Depleterus,blackrock,96,deathknight,unholy,12,1,11
Darkarnø,chants-éternels,96,deathknight,unholy,12,1,11
Peiie,ravencrest,96,deathknight,unholy,12,1,11
Buzknight,twisting-nether,96,deathknight,unholy,12,1,11
Bestiaccia,nemesis,95,deathknight,unholy,6,1,5
Beurkbeurk,la-croisade-écarlate,95,deathknight,unholy,12,1,11
Necromedes,kazzak,64,deathknight,unholy,4,1,3
Errøar,aegwynn,31,deathknight,unholy,2,1,1
Шарабум,howling-fjord,16,deathknight,unholy,7,1,6
Никнейм,gordunni,2123,deathknight,frost,102,55,47
Имерсий,gordunni,2104,deathknight,frost,72,43,29
Fdkgotbuffed,tarren-mill,2071,deathknight,frost,78,39,39
Nellion,kazzak,2060,deathknight,frost,84,38,46
Garrinchá,stormscale,2040,deathknight,frost,60,36,24
Anotherdkx,ravencrest,2002,deathknight,frost,66,39,27
Igetmount,draenor,1993,deathknight,frost,48,27,21
Murbastic,draenor,1981,deathknight,frost,251,127,124
Viuff,kazzak,1894,deathknight,frost,42,23,19
Diogenisis,arthas,1834,deathknight,frost,94,43,51
Jeanice,blackhand,1833,deathknight,frost,42,23,19
Малтель,howling-fjord,1828,deathknight,frost,54,28,26
Эриданс,gordunni,1806,deathknight,frost,48,32,16
Картафилиус,soulflayer,1804,deathknight,frost,66,28,38
Дарргг,ashenvale,1750,deathknight,frost,144,72,72
Duriel,stormscale,1736,deathknight,frost,168,90,78
Ayro,aegwynn,1732,deathknight,frost,66,34,32
Kisyhrâ,aegwynn,1728,deathknight,frost,36,21,15
Mikagoddess,argent-dawn,1723,deathknight,frost,118,61,57
Arrèsted,aegwynn,1696,deathknight,frost,45,20,25
Moreau,eredar,1682,deathknight,frost,93,47,46
Sonnedeath,tarren-mill,1676,deathknight,frost,34,21,13
Rêxaks,dun-modr,1661,deathknight,frost,60,28,32
Zektal,thrall,1652,deathknight,frost,48,19,29
Xolaani,outland,1632,deathknight,frost,72,32,40
Ниффер,deathguard,1627,deathknight,frost,34,18,16
Geunieve,ysondre,1621,deathknight,frost,60,23,37
Espatula,ravencrest,1619,deathknight,frost,48,23,25
Frace,tyrande,1619,deathknight,frost,84,38,46
Cyliandra,silvermoon,1615,deathknight,frost,48,27,21
Banishabomb,ragnaros,1615,deathknight,frost,78,39,39
Vidofnir,argent-dawn,1611,deathknight,frost,56,31,25
Raylenx,uldaman,1609,deathknight,frost,75,39,36
Arxelas,stormscale,1607,deathknight,frost,68,42,26
Diatriss,argent-dawn,1600,deathknight,frost,121,70,51
Deucàlyqt,nemesis,1589,deathknight,frost,64,28,36
Selena,blackmoore,1587,deathknight,frost,30,17,13
Arxelas,sylvanas,1580,deathknight,frost,172,89,83
Chakko,ravencrest,1579,deathknight,frost,57,26,31
Клиссанг,razuvious,1572,deathknight,frost,30,19,11
Dexterlul,blackmoore,1564,deathknight,frost,42,19,23
Винкис,gordunni,1561,deathknight,frost,106,56,50
Hatriox,outland,1551,deathknight,frost,153,84,69
Maryø,drakthul,1543,deathknight,frost,42,18,24
Deucalyqt,nemesis,1538,deathknight,frost,66,31,35
Wrathlich,tyrande,1534,deathknight,frost,41,21,20
Лордтемар,howling-fjord,1530,deathknight,frost,54,25,29
Dripgrip,ravencrest,1529,deathknight,frost,77,36,41
Tenzøftw,archimonde,1527,deathknight,frost,31,17,14
Frostlux,archimonde,1524,deathknight,frost,539,257,282
Kailara,draenor,1519,deathknight,frost,78,40,38
Fallenjaina,kazzak,1513,deathknight,frost,203,101,102
Gauloupin,lightnings-blade,1509,deathknight,frost,57,28,29
Маклайкнайт,gordunni,1508,deathknight,frost,152,76,76
Wildsword,sylvanas,1507,deathknight,frost,57,32,25
Brawlerbabe,stormscale,1502,deathknight,frost,126,56,70
Darlyn,grim-batol,1501,deathknight,frost,36,24,12
Leónid,kazzak,1486,deathknight,frost,33,17,16
Геннош,howling-fjord,1486,deathknight,frost,60,30,30
Obliterate,frostmourne,1469,deathknight,frost,52,28,24
Murky,kazzak,1467,deathknight,frost,36,16,20
Катаринья,howling-fjord,1461,deathknight,frost,69,33,36
Gorobijec,drakthul,1460,deathknight,frost,173,78,95
Desolatiøn,ravencrest,1441,deathknight,frost,48,24,24
Madseason,burning-legion,1441,deathknight,frost,42,20,22
Akril,tarren-mill,1429,deathknight,frost,90,43,47
Dktroll,blackmoore,1428,deathknight,frost,151,67,84
Кулькулегал,ashenvale,1424,deathknight,frost,24,15,9
Regniér,frostwolf,1423,deathknight,frost,206,97,109
Neitoperho,frostmane,1422,deathknight,frost,36,15,21
Frege,tarren-mill,1420,deathknight,frost,30,15,15
Асаала,soulflayer,1419,deathknight,frost,27,19,8
Kooklynn,aggra-português,1418,deathknight,frost,48,25,23
Prokszii,turalyon,1416,deathknight,frost,35,21,14
Abadonn,archimonde,1412,deathknight,frost,36,15,21
Lylíth,archimonde,1411,deathknight,frost,60,31,29
Frostymel,ravencrest,1411,deathknight,frost,54,21,33
Drkok,blackmoore,1409,deathknight,frost,30,16,14
Furleyc,argent-dawn,1405,deathknight,frost,60,34,26
Jumbogrip,tarren-mill,1405,deathknight,frost,37,19,18
Arthaslegend,magtheridon,1403,deathknight,frost,66,27,39
Stevensdk,darkspear,1399,deathknight,frost,42,19,23
Angalor,argent-dawn,1399,deathknight,frost,44,18,26
Blácked,draenor,1397,deathknight,frost,36,18,18
Düksito,dun-modr,1392,deathknight,frost,63,32,31
Skorice,dalaran,1389,deathknight,frost,48,19,29
Mocca,aegwynn,1385,deathknight,frost,58,25,33
Scørn,thrall,1383,deathknight,frost,84,39,45
Флаттершайдк,booty-bay,1383,deathknight,frost,37,16,21
Reapocalypse,blackhand,1376,deathknight,frost,36,16,20
Фростмаран,soulflayer,1373,deathknight,frost,96,45,51
Mcrune,ravencrest,1364,deathknight,frost,44,22,22
Cdp,ragnaros,1361,deathknight,frost,42,26,16
Keronaterol,blackhand,1361,deathknight,frost,78,43,35
Orcborg,zuljin,1360,deathknight,frost,54,30,24
Ðeucaly,nemesis,1357,deathknight,frost,66,30,36
Arthasuk,dun-modr,1356,deathknight,frost,153,84,69
Reezeer,stormscale,1351,deathknight,frost,30,15,15
Neorteriona,argent-dawn,1328,deathknight,frost,34,17,17
Superere,hyjal,1326,deathknight,frost,150,80,70
Comehere,norgannon,1321,deathknight,frost,30,19,11
Tofin,dunemaul,1320,deathknight,frost,38,18,20
Wintersons,tarren-mill,1317,deathknight,frost,36,17,19
Buldog,laughing-skull,1309,deathknight,frost,58,25,33
Zoree,draenor,1307,deathknight,frost,42,15,27
Wlcrealworld,ravencrest,1303,deathknight,frost,54,24,30
Sinabre,eitrigg,1302,deathknight,frost,30,14,16
Deucalygodx,nemesis,1301,deathknight,frost,60,22,38
Deathknight,spinebreaker,1300,deathknight,frost,50,22,28
Âlîce,culte-de-la-rive-noire,1297,deathknight,frost,54,26,28
Kãra,ysondre,1288,deathknight,frost,85,42,43
Кроуфрост,gordunni,1285,deathknight,frost,60,29,31
Dzengiskhan,draenor,1285,deathknight,frost,66,27,39
Ubiystvo,kazzak,1284,deathknight,frost,60,31,29
Soulrender,kirin-tor,1283,deathknight,frost,36,15,21
Unchaindk,outland,1282,deathknight,frost,60,31,29
Barathéøn,les-sentinelles,1282,deathknight,frost,53,19,34
Касуляпвнз,gordunni,1271,deathknight,frost,51,26,25
Ihatelife,frostwolf,1271,deathknight,frost,102,49,53
Spøøk,defias-brotherhood,1268,deathknight,frost,217,104,113
Sukadino,ragnaros,1264,deathknight,frost,60,31,29
Døuffy,hyjal,1248,deathknight,frost,149,72,77
Elendren,blackrock,1247,deathknight,frost,24,13,11
Düks,dun-modr,1238,deathknight,frost,87,39,48
Leonis,arthas,1237,deathknight,frost,35,13,22
Hî,malganis,1234,deathknight,frost,67,35,32
Iaccidens,stormscale,1232,deathknight,frost,99,45,54
Krasny,hyjal,1231,deathknight,frost,108,59,49
Dükss,dun-modr,1230,deathknight,frost,42,22,20
Morgouse,kazzak,1225,deathknight,frost,107,49,58
Satyriasis,twisting-nether,1224,deathknight,frost,28,16,12
Frostmommy,argent-dawn,1214,deathknight,frost,41,16,25
Moosbirne,blackhand,1213,deathknight,frost,36,15,21
Belía,blackmoore,1204,deathknight,frost,56,26,30
Monkeydclaus,arathor,1202,deathknight,frost,60,31,29
Êbøla,sanguino,1202,deathknight,frost,66,28,38
Exodiuss,dalaran,1195,deathknight,frost,40,20,20
Fixmybones,frostmane,1183,deathknight,frost,54,27,27
Gageth,shadowsong,1180,deathknight,frost,45,15,30
Twardobaba,burning-legion,1176,deathknight,frost,56,25,31
Cayliadk,tarren-mill,1174,deathknight,frost,167,76,91
Môrgøth,nemesis,1171,deathknight,frost,54,20,34
Bari,the-venture-co,1166,deathknight,frost,36,15,21
Zandruq,twisting-nether,1162,deathknight,frost,58,24,34
Clàymax,kazzak,1161,deathknight,frost,45,17,28
Селес,ashenvale,1151,deathknight,frost,24,12,12
Aceléss,drakthul,1150,deathknight,frost,18,12,6
Ziuziu,twisting-nether,1149,deathknight,frost,34,16,18
Разлажение,gordunni,1147,deathknight,frost,66,33,33
Leyc,argent-dawn,1146,deathknight,frost,24,12,12
Nôsferatú,amanthul,1145,deathknight,frost,78,39,39
Rektsohard,ravencrest,1144,deathknight,frost,20,12,8
Darkchas,silvermoon,1144,deathknight,frost,24,12,12
Erbugul,uldum,1143,deathknight,frost,30,12,18
Zerodude,silvermoon,1142,deathknight,frost,60,30,30
Azrador,frostwolf,1140,deathknight,frost,54,21,33
Grendul,blackmoore,1139,deathknight,frost,24,12,12
Sipsip,tarren-mill,1139,deathknight,frost,24,12,12
Thenrys,culte-de-la-rive-noire,1139,deathknight,frost,80,32,48
Polimeh,draenor,1132,deathknight,frost,66,38,28
Zuggandk,tarren-mill,1132,deathknight,frost,24,13,11
Mattesøs,drakthul,1130,deathknight,frost,36,13,23
Wardrickxdd,ravencrest,1128,deathknight,frost,24,12,12
Nîghtmáre,ravencrest,1117,deathknight,frost,23,12,11
Dkruffos,draenor,1114,deathknight,frost,60,24,36
Dämäger,proudmoore,1113,deathknight,frost,77,36,41
Alastoras,nemesis,1108,deathknight,frost,37,19,18
Akantras,blackmoore,1106,deathknight,frost,59,28,31
Collinná,aegwynn,1104,deathknight,frost,36,13,23
Posinkautta,silvermoon,1103,deathknight,frost,18,13,5
Woddey,blackrock,1101,deathknight,frost,60,29,31
Archa,shendralar,1097,deathknight,frost,48,20,28
Nelahh,the-maelstrom,1093,deathknight,frost,30,15,15
Abnormus,tarren-mill,1089,deathknight,frost,107,53,54
Regys,argent-dawn,1080,deathknight,frost,28,12,16
Zioan,jaedenar,1079,deathknight,frost,62,33,29
Angôs,sanguino,1075,deathknight,frost,36,18,18
Вафельнаяфея,blackscar,1073,deathknight,frost,43,17,26
Порция,greymane,1058,deathknight,frost,54,32,22
Khelthalas,teldrassil,1053,deathknight,frost,25,18,7
Unaxito,sanguino,1052,deathknight,frost,24,11,13
Merdraut,alakir,1037,deathknight,frost,18,11,7
Папичдк,gordunni,1031,deathknight,frost,23,13,10
Ivik,the-maelstrom,1024,deathknight,frost,62,35,27
Krylow,draenor,1020,deathknight,frost,42,17,25
Deathcardos,die-aldor,1013,deathknight,frost,30,11,19
Quantumshift,ravencrest,1004,deathknight,frost,17,11,6
Sooran,blackhand,994,deathknight,frost,24,16,8
Gravehammer,sylvanas,991,deathknight,frost,18,11,7
Nathriel,stormscale,985,deathknight,frost,23,11,12
Dakyforfun,ravencrest,960,deathknight,frost,12,10,2
Flúrrý,kazzak,960,deathknight,frost,24,10,14
Re,stormrage,959,deathknight,frost,18,10,8
Adär,kazzak,958,deathknight,frost,18,10,8
Kerastrell,doomhammer,957,deathknight,frost,24,10,14
Nifllheimr,outland,954,deathknight,frost,18,10,8
Dursall,thrall,951,deathknight,frost,154,75,79
Scorbion,kilrogg,947,deathknight,frost,33,16,17
Zaouros,silvermoon,946,deathknight,frost,36,10,26
Grumpykathi,blackmoore,945,deathknight,frost,18,10,8
Íbossit,doomhammer,940,deathknight,frost,18,10,8
Mauryr,drakthul,900,deathknight,frost,72,26,46
Нифер,deathguard,894,deathknight,frost,20,10,10
Карвалан,eversong,884,deathknight,frost,36,18,18
Kixx,bloodfeather,873,deathknight,frost,53,13,40
Assasínator,tarren-mill,872,deathknight,frost,49,24,25
Fareast,nerathor,865,deathknight,frost,78,36,42
Mellion,ragnaros,864,deathknight,frost,12,9,3
Løz,kazzak,864,deathknight,frost,18,9,9
ßambøøzle,draenor,864,deathknight,frost,18,9,9
Ñogg,kazzak,864,deathknight,frost,24,9,15
Asphyxias,alleria,863,deathknight,frost,18,9,9
Nymfo,tirion,862,deathknight,frost,12,9,3
Zhigan,ravencrest,862,deathknight,frost,18,9,9
Gringly,tarren-mill,862,deathknight,frost,18,9,9
Vîrus,kazzak,859,deathknight,frost,18,9,9
Triddion,sylvanas,857,deathknight,frost,18,9,9
Rogerwaterz,twisting-nether,855,deathknight,frost,12,9,3
Deadkilla,stormreaver,851,deathknight,frost,18,9,9
Dànté,eitrigg,848,deathknight,frost,18,10,8
Peachvajz,turalyon,845,deathknight,frost,87,43,44
Guillemet,turalyon,830,deathknight,frost,16,10,6
Elbaqwan,the-shatar,827,deathknight,frost,30,13,17
Craftmaker,eonar,816,deathknight,frost,44,19,25
Sunwrath,magtheridon,816,deathknight,frost,24,9,15
Leahthebad,sylvanas,803,deathknight,frost,26,10,16
Tenzøjr,archimonde,768,deathknight,frost,12,8,4
Salaahadin,darkspear,768,deathknight,frost,18,8,10
Eynoway,blackmoore,768,deathknight,frost,18,8,10
Deathvarg,argent-dawn,768,deathknight,frost,18,8,10
Khagra,ravencrest,767,deathknight,frost,18,8,10
Jollíe,tarren-mill,767,deathknight,frost,24,8,16
Истинна,grom,766,deathknight,frost,18,8,10
Zombíe,laughing-skull,765,deathknight,frost,12,8,4
Дрогдош,howling-fjord,765,deathknight,frost,24,8,16
Арнорос,lich-king,764,deathknight,frost,12,8,4
Fullbusterr,hyjal,761,deathknight,frost,12,8,4
Aegwynnêr,blackmoore,760,deathknight,frost,19,9,10
Zerdon,frostmane,756,deathknight,frost,13,8,5
Afadk,kazzak,752,deathknight,frost,72,27,45
Darklich,blackmoore,745,deathknight,frost,18,8,10
Lichfils,chogall,745,deathknight,frost,27,8,19
Odaijini,archimonde,719,deathknight,frost,17,8,9
Inaëlys,medivh,713,deathknight,frost,15,9,6
Импостик,blackscar,672,deathknight,frost,12,7,5
Gorefiend,kazzak,672,deathknight,frost,12,7,5
Mâxî,hyjal,672,deathknight,frost,12,7,5
Veneera,emeriss,672,deathknight,frost,12,7,5
Primø,malganis,671,deathknight,frost,16,8,8
Halohuntress,outland,671,deathknight,frost,18,7,11
Vampire,ahnqiraj,671,deathknight,frost,18,7,11
Holîx,kazzak,671,deathknight,frost,30,7,23
Karthor,teldrassil,670,deathknight,frost,12,7,5
Blurek,lordaeron,670,deathknight,frost,12,7,5
Uthn,outland,670,deathknight,frost,24,7,17
Меланндрис,gordunni,669,deathknight,frost,15,8,7
Annecanos,ravencrest,668,deathknight,frost,12,7,5
Menacê,ravencrest,662,deathknight,frost,18,7,11
Aczheron,argent-dawn,660,deathknight,frost,24,7,17
Antîlâ,antonidas,658,deathknight,frost,12,7,5
Dreadnight,sanguino,639,deathknight,frost,14,8,6
Narali,argent-dawn,576,deathknight,frost,12,6,6
Flúrry,ravencrest,576,deathknight,frost,12,6,6
Sødax,sanguino,576,deathknight,frost,12,6,6
Doping,eredar,576,deathknight,frost,12,6,6
Volestral,emeriss,576,deathknight,frost,12,6,6
Планус,booty-bay,576,deathknight,frost,12,6,6
Liija,blackrock,576,deathknight,frost,12,6,6
Rubbann,ravencrest,576,deathknight,frost,12,6,6
Pandahapci,ragnaros,576,deathknight,frost,12,6,6
Silvergreed,kazzak,576,deathknight,frost,12,6,6
Orangatang,dalaran,576,deathknight,frost,12,6,6
Xeliora,ragnaros,576,deathknight,frost,15,7,8
Qus,twisting-nether,576,deathknight,frost,18,6,12
Oj,darkspear,576,deathknight,frost,18,6,12
Worlviuz,argent-dawn,576,deathknight,frost,18,6,12
Deathmike,steamwheedle-cartel,576,deathknight,frost,18,6,12
Parayysite,eredar,576,deathknight,frost,18,6,12
Rompå,ravencrest,576,deathknight,frost,18,6,12
Gotendk,draenor,575,deathknight,frost,12,6,6
Fatbutdead,malganis,575,deathknight,frost,12,6,6
Tugarinzmey,tarren-mill,575,deathknight,frost,18,6,12
Ahnuk,aggra-português,574,deathknight,frost,12,6,6
Trogkhar,blackrock,574,deathknight,frost,12,6,6
Фламмивир,gordunni,572,deathknight,frost,12,6,6
Izanagii,exodar,572,deathknight,frost,12,6,6
Tyranuse,kazzak,527,deathknight,frost,17,6,11
Фэйлстрайк,azuregos,510,deathknight,frost,14,6,8
Grimmoth,argent-dawn,480,deathknight,frost,6,5,1
Deckbulle,blackhand,480,deathknight,frost,6,5,1
Goring,confrérie-du-thorium,480,deathknight,frost,6,5,1
Thebangman,ravencrest,480,deathknight,frost,9,6,3
Дэвайна,gordunni,480,deathknight,frost,12,5,7
Ларкусдк,howling-fjord,480,deathknight,frost,12,5,7
Hemopathy,tarren-mill,480,deathknight,frost,12,5,7
Руин,blackscar,480,deathknight,frost,12,5,7
Feelmyfuri,mazrigos,480,deathknight,frost,12,5,7
Khnïshou,silvermoon,480,deathknight,frost,12,5,7
Ûñhølýðéåthj,tarren-mill,480,deathknight,frost,12,5,7
Nommad,archimonde,480,deathknight,frost,12,5,7
Goochtickler,kazzak,480,deathknight,frost,12,5,7
Urzza,ysondre,480,deathknight,frost,12,5,7
Justaniceguy,silvermoon,480,deathknight,frost,12,5,7
Runepride,argent-dawn,480,deathknight,frost,12,5,7
Pestilerous,draenor,480,deathknight,frost,18,5,13
Hellcrosser,blackrock,479,deathknight,frost,12,5,7
Jowân,blackmoore,479,deathknight,frost,12,5,7
Sindó,blackrock,479,deathknight,frost,12,5,7
Xtream,blackmoore,479,deathknight,frost,12,5,7
Смердонос,grom,479,deathknight,frost,12,5,7
Ostridz,grim-batol,479,deathknight,frost,12,5,7
Talge,sylvanas,479,deathknight,frost,12,5,7
Deadpòól,twisting-nether,479,deathknight,frost,18,5,13
Merà,antonidas,479,deathknight,frost,18,5,13
Bigspider,aggramar,479,deathknight,frost,24,5,19
Copium,hyjal,477,deathknight,frost,12,5,7
Fishtruction,tarren-mill,476,deathknight,frost,12,5,7
Kejpo,drakthul,473,deathknight,frost,12,5,7
Predatormkdd,ravencrest,429,deathknight,frost,11,5,6
Dunkàn,silvermoon,384,deathknight,frost,6,4,2
Gozuryu,kazzak,384,deathknight,frost,6,4,2
Smardacus,silvermoon,384,deathknight,frost,6,4,2
Lemmegetuuh,chogall,384,deathknight,frost,6,4,2
Wuurzaag,twisting-nether,384,deathknight,frost,6,4,2
Oldiseas,grim-batol,384,deathknight,frost,6,4,2
Wpízdu,aegwynn,384,deathknight,frost,6,4,2
Indrette,archimonde,384,deathknight,frost,6,4,2
Letumnex,tarren-mill,384,deathknight,frost,6,4,2
Namzera,draenor,384,deathknight,frost,6,4,2
Reann,argent-dawn,384,deathknight,frost,6,4,2
Enzy,drakthul,384,deathknight,frost,6,4,2
Necrølyte,sylvanas,384,deathknight,frost,6,4,2
Вирко,eversong,384,deathknight,frost,9,5,4
Дедвбане,gordunni,384,deathknight,frost,8,4,4
Anasûrimbor,tarren-mill,384,deathknight,frost,12,4,8
Maxmo,twilights-hammer,384,deathknight,frost,12,4,8
Apraxia,ravencrest,384,deathknight,frost,12,4,8
Джайвана,soulflayer,384,deathknight,frost,12,4,8
Æew,kazzak,384,deathknight,frost,12,4,8
Doodcraft,tarren-mill,384,deathknight,frost,12,4,8
Xenake,kazzak,384,deathknight,frost,12,4,8
Pawnzqtie,stormscale,384,deathknight,frost,12,4,8
Leahthemad,sylvanas,384,deathknight,frost,12,4,8
Raihor,outland,384,deathknight,frost,14,4,10
Кокосоус,gordunni,384,deathknight,frost,17,4,13
Hordak,stormscale,384,deathknight,frost,18,4,14
Dextroyersx,sanguino,384,deathknight,frost,18,4,14
Beherith,sunstrider,383,deathknight,frost,6,4,2
Tÿnak,der-mithrilorden,383,deathknight,frost,9,4,5
Breeze,xavius,383,deathknight,frost,12,4,8
Eckodk,aggra-português,383,deathknight,frost,12,4,8
Гадиния,soulflayer,383,deathknight,frost,12,4,8
Arond,arygos,383,deathknight,frost,12,4,8
Kivo,marécage-de-zangar,383,deathknight,frost,12,4,8
Бранс,gordunni,383,deathknight,frost,12,4,8
Belâam,archimonde,383,deathknight,frost,24,4,20
Mahfel,twisting-nether,382,deathknight,frost,6,4,2
Группер,gordunni,382,deathknight,frost,6,4,2
Дневнои,howling-fjord,382,deathknight,frost,12,4,8
Dødsgud,khaz-modan,382,deathknight,frost,12,4,8
Dekagramcz,drakthul,382,deathknight,frost,12,4,8
Vicoperian,stormscale,382,deathknight,frost,12,4,8
Poaka,outland,380,deathknight,frost,12,4,8
Iikarus,eredar,376,deathknight,frost,18,4,14
Душанерзула,howling-fjord,330,deathknight,frost,18,6,12
Vín,silvermoon,319,deathknight,frost,10,4,6
Cptneverdie,stormscale,288,deathknight,frost,6,3,3
Vaanor,draenor,288,deathknight,frost,6,3,3
Neptunium,archimonde,288,deathknight,frost,6,3,3
Necrozy,aggra-português,288,deathknight,frost,6,3,3
Persefal,nemesis,288,deathknight,frost,6,3,3
Moohammood,argent-dawn,288,deathknight,frost,6,3,3
Ogomegee,ravencrest,288,deathknight,frost,6,3,3
Шэйп,fordragon,288,deathknight,frost,6,3,3
Xanthic,ravencrest,288,deathknight,frost,6,3,3
Darxiera,drakthul,288,deathknight,frost,6,3,3
Whippy,ravencrest,288,deathknight,frost,6,3,3
Микелон,gordunni,288,deathknight,frost,6,3,3
Dêeath,madmortem,288,deathknight,frost,6,3,3
Джеттар,howling-fjord,288,deathknight,frost,6,3,3
Keridíin,twisting-nether,288,deathknight,frost,6,3,3
Cyphîllyth,auchindoun,288,deathknight,frost,6,3,3
Трибунальщик,gordunni,288,deathknight,frost,6,3,3
Modelo,twisting-nether,288,deathknight,frost,6,3,3
Madsgrip,tarren-mill,288,deathknight,frost,6,3,3
Fallén,stormrage,288,deathknight,frost,6,3,3
Tómér,outland,288,deathknight,frost,6,3,3
Merdenhall,argent-dawn,288,deathknight,frost,6,3,3
Petardodupy,burning-legion,288,deathknight,frost,6,3,3
Loorda,kazzak,288,deathknight,frost,6,3,3
Jjayker,kazzak,288,deathknight,frost,6,3,3
Shicheria,blackrock,288,deathknight,frost,6,3,3
Moko,defias-brotherhood,288,deathknight,frost,6,3,3
Гурий,ashenvale,288,deathknight,frost,6,3,3
Hellcrusher,kazzak,288,deathknight,frost,6,3,3
Nasxsy,blackmoore,288,deathknight,frost,6,3,3
Myzouth,silvermoon,288,deathknight,frost,6,3,3
Husarz,kazzak,288,deathknight,frost,6,3,3
Lair,shendralar,288,deathknight,frost,6,3,3
Vexxed,magtheridon,288,deathknight,frost,6,3,3
Nazgül,drakthul,288,deathknight,frost,6,3,3
Kèén,kazzak,288,deathknight,frost,6,3,3
Desulól,tarren-mill,288,deathknight,frost,9,4,5
Nexxel,blackhand,288,deathknight,frost,11,3,8
Râke,teldrassil,288,deathknight,frost,12,3,9
Milchimhaus,dun-morogh,288,deathknight,frost,12,3,9
Prekliatylad,burning-blade,288,deathknight,frost,12,3,9
Thedk,voljin,288,deathknight,frost,12,3,9
Тенелла,gordunni,288,deathknight,frost,12,3,9
Obstwald,blackrock,288,deathknight,frost,12,3,9
Discochoppa,blackmoore,288,deathknight,frost,12,3,9
Powerlifting,los-errantes,288,deathknight,frost,12,3,9
Ezlar,silvermoon,288,deathknight,frost,12,3,9
Thilior,silvermoon,288,deathknight,frost,12,3,9
Chifuyu,azjolnerub,288,deathknight,frost,12,3,9
Emielf,silvermoon,288,deathknight,frost,12,3,9
Balekouille,eldrethalas,287,deathknight,frost,6,3,3
Rakhash,antonidas,287,deathknight,frost,6,3,3
Sawishere,sanguino,287,deathknight,frost,12,3,9
Eisentorte,nerathor,287,deathknight,frost,20,3,17
Whitedead,destromath,286,deathknight,frost,6,3,3
Housemeyster,antonidas,286,deathknight,frost,12,3,9
Tiunping,silvermoon,286,deathknight,frost,12,3,9
Venthyrgwa,kazzak,284,deathknight,frost,7,5,2
Rubyblood,aggra-português,271,deathknight,frost,11,3,8
ßæst,archimonde,208,deathknight,frost,7,3,4
Dimania,the-maelstrom,192,deathknight,frost,4,3,1
Ratge,hyjal,192,deathknight,frost,6,2,4
Bàbarus,dun-morogh,192,deathknight,frost,6,2,4
Ikarack,twisting-nether,192,deathknight,frost,6,2,4
Køley,draenor,192,deathknight,frost,6,2,4
Ullefuz,silvermoon,192,deathknight,frost,6,2,4
Leomordf,doomhammer,192,deathknight,frost,6,2,4
Unholz,kazzak,192,deathknight,frost,6,2,4
Likell,argent-dawn,192,deathknight,frost,6,2,4
Doozz,draenor,192,deathknight,frost,6,2,4
Archdemonio,wildhammer,192,deathknight,frost,6,2,4
Babsyknight,wildhammer,192,deathknight,frost,6,2,4
Darkarthás,aegwynn,192,deathknight,frost,6,2,4
Nergål,sanguino,192,deathknight,frost,6,2,4
Scárebear,outland,192,deathknight,frost,6,2,4
Pandahapcii,ragnaros,192,deathknight,frost,6,2,4
Nèrfx,ragnaros,192,deathknight,frost,6,2,4
Tyró,ravencrest,192,deathknight,frost,6,2,4
Аирфрост,howling-fjord,192,deathknight,frost,6,2,4
Ilaenu,ravencrest,192,deathknight,frost,6,2,4
Lemonhazebg,stormscale,192,deathknight,frost,6,2,4
Fentanil,elune,192,deathknight,frost,6,2,4
Ilovegouàng,khaz-modan,192,deathknight,frost,6,2,4
Эвессом,goldrinn,192,deathknight,frost,6,2,4
Bedstemoor,ravencrest,192,deathknight,frost,6,2,4
Сивкабурка,fordragon,192,deathknight,frost,6,2,4
Mennal,the-maelstrom,192,deathknight,frost,6,2,4
Ghaloob,draenor,192,deathknight,frost,6,2,4
Doubledead,the-maelstrom,192,deathknight,frost,6,2,4
Abomination,emeriss,192,deathknight,frost,6,2,4
Notstacy,dragonblight,192,deathknight,frost,6,2,4
Dreadmind,blackrock,192,deathknight,frost,6,2,4
Necrossis,stormscale,192,deathknight,frost,6,2,4
Vaffe,tarren-mill,192,deathknight,frost,6,2,4
Toffy,anetheron,192,deathknight,frost,6,2,4
Darksoulk,frostmane,192,deathknight,frost,6,2,4
Kane,destromath,192,deathknight,frost,6,2,4
Royalcrown,stormscale,192,deathknight,frost,6,2,4
Ваатерло,soulflayer,192,deathknight,frost,6,2,4
Seasonfive,arathor,192,deathknight,frost,6,2,4
Капустас,gordunni,192,deathknight,frost,6,2,4
Deadlygnome,silvermoon,192,deathknight,frost,12,2,10
Lillekas,outland,192,deathknight,frost,12,2,10
Adreak,defias-brotherhood,192,deathknight,frost,12,2,10
Narrua,die-aldor,192,deathknight,frost,12,2,10
Dklékata,archimonde,192,deathknight,frost,12,2,10
Бахлыщ,soulflayer,192,deathknight,frost,12,2,10
Freeks,die-aldor,192,deathknight,frost,12,2,10
Tüsa,exodar,192,deathknight,frost,18,2,16
Moograine,anachronos,191,deathknight,frost,6,2,4
Lithirion,ysondre,191,deathknight,frost,6,2,4
Ренкус,grom,191,deathknight,frost,6,2,4
Arthursq,stormscale,190,deathknight,frost,12,2,10
Брейвз,gordunni,159,deathknight,frost,5,2,3
Endlesspain,burning-legion,138,deathknight,frost,8,3,5
Tzunâ,blackmoore,138,deathknight,frost,21,3,18
Gigadk,ragnaros,96,deathknight,frost,6,1,5
Dïkcite,archimonde,96,deathknight,frost,6,1,5
Gotbaked,outland,96,deathknight,frost,6,1,5
Pavkata,outland,96,deathknight,frost,6,1,5
Rudysek,dunemaul,96,deathknight,frost,6,1,5
Буризан,blackscar,96,deathknight,frost,6,1,5
Thirtyfour,aegwynn,96,deathknight,frost,6,1,5
Armanelo,stormscale,96,deathknight,frost,6,1,5
Thryndiel,ravencrest,96,deathknight,frost,6,1,5
Syncros,blackrock,96,deathknight,frost,6,1,5
Hydross,archimonde,96,deathknight,frost,6,1,5
Thínkk,ysondre,96,deathknight,frost,6,1,5
Brurf,ysondre,96,deathknight,frost,6,1,5
Reyu,ambossar,96,deathknight,frost,6,1,5
Veçh,turalyon,96,deathknight,frost,6,1,5
Dreodis,der-mithrilorden,96,deathknight,frost,6,1,5
Cleverb,silvermoon,96,deathknight,frost,6,1,5
Mizrael,burning-blade,96,deathknight,frost,6,1,5
Jenkk,drakthul,96,deathknight,frost,6,1,5
Urukaye,silvermoon,96,deathknight,frost,6,1,5
Sokkara,silvermoon,96,deathknight,frost,6,1,5
Thyrandre,khaz-modan,96,deathknight,frost,6,1,5
Feddk,stormscale,96,deathknight,frost,6,1,5
Umadßroh,sanguino,96,deathknight,frost,6,1,5
Дкшрёдингера,gordunni,96,deathknight,frost,6,1,5
Slimez,magtheridon,96,deathknight,frost,6,1,5
Kaeyz,blackmoore,96,deathknight,frost,6,1,5
Ischozâr,blackmoore,96,deathknight,frost,6,1,5
Кунимэнгус,soulflayer,96,deathknight,frost,9,1,8
Shaturi,antonidas,96,deathknight,frost,12,1,11
Burebistà,eonar,96,deathknight,frost,12,1,11
Nirna,argent-dawn,96,deathknight,frost,18,1,17
Deadorcy,kazzak,95,deathknight,frost,3,2,1
Infamousmobb,archimonde,79,deathknight,frost,5,1,4
Assølid,arathor,42,deathknight,frost,11,2,9
Greiz,aggramar,16,deathknight,frost,7,1,6
Norgan,die-aldor,2339,demonhunter,havoc,153,85,68
Íllìðåñgøðx,twisting-nether,2337,demonhunter,havoc,136,72,64
Elswavé,kazzak,2290,demonhunter,havoc,156,91,65
Glìmpsêgøðx,twisting-nether,2288,demonhunter,havoc,131,71,60
Itsdampbaby,kazzak,2211,demonhunter,havoc,115,62,53
Guësswho,twisting-nether,2201,demonhunter,havoc,105,54,51
Norgàn,die-aldor,2178,demonhunter,havoc,81,44,37
Zslebaans,dun-modr,2173,demonhunter,havoc,266,134,132
Ðesz,sanguino,2153,demonhunter,havoc,95,52,43
Betterevoker,outland,2134,demonhunter,havoc,198,112,86
Wibez,twisting-nether,2131,demonhunter,havoc,120,74,46
Enysia,twisting-nether,2127,demonhunter,havoc,122,62,60
Badtime,malganis,2126,demonhunter,havoc,218,117,101
Zuklio,ysondre,2125,demonhunter,havoc,146,74,72
Hellwynne,archimonde,2117,demonhunter,havoc,134,78,56
Melan,sanguino,2116,demonhunter,havoc,108,54,54
Évø,silvermoon,2114,demonhunter,havoc,107,54,53
Лфгхиро,soulflayer,2101,demonhunter,havoc,65,37,28
Razzagall,elune,2101,demonhunter,havoc,54,30,24
Boostbydh,archimonde,2101,demonhunter,havoc,219,115,104
Paschli,tarren-mill,2100,demonhunter,havoc,228,122,106
Konydh,outland,2067,demonhunter,havoc,59,39,20
Heatx,ysondre,2043,demonhunter,havoc,180,98,82
Satånist,outland,2033,demonhunter,havoc,268,145,123
Battlebruh,ghostlands,2032,demonhunter,havoc,83,39,44
Demonalpha,stormscale,2018,demonhunter,havoc,61,34,27
Nèvér,silvermoon,2014,demonhunter,havoc,143,74,69
Bxdh,outland,2004,demonhunter,havoc,93,46,47
Illíllìllî,twisting-nether,1998,demonhunter,havoc,60,33,27
Smydi,blackmoore,1991,demonhunter,havoc,112,82,30
Ææçëñ,ravencrest,1990,demonhunter,havoc,82,46,36
Læsy,antonidas,1990,demonhunter,havoc,151,77,74
Ewynadh,die-aldor,1990,demonhunter,havoc,84,42,42
Veon,ravencrest,1988,demonhunter,havoc,281,136,145
Истребитель,blackscar,1978,demonhunter,havoc,288,160,128
Tórstenstøck,ravencrest,1975,demonhunter,havoc,65,46,19
Aiean,ravencrest,1974,demonhunter,havoc,264,132,132
Anabbele,kazzak,1968,demonhunter,havoc,96,52,44
Gilletteabdi,argent-dawn,1966,demonhunter,havoc,115,58,57
Ohseri,defias-brotherhood,1963,demonhunter,havoc,180,87,93
Depure,blackrock,1955,demonhunter,havoc,96,45,51
Мортрэд,gordunni,1950,demonhunter,havoc,66,39,27
Pipeandy,kazzak,1946,demonhunter,havoc,95,52,43
Майотх,gordunni,1943,demonhunter,havoc,211,109,102
Yúki,blackrock,1939,demonhunter,havoc,66,32,34
Scubaman,tarren-mill,1936,demonhunter,havoc,84,44,40
Battlebruuh,ghostlands,1935,demonhunter,havoc,66,27,39
Iryut,onyxia,1932,demonhunter,havoc,84,45,39
Delanoss,blackmoore,1922,demonhunter,havoc,133,72,61
Майвэйх,soulflayer,1922,demonhunter,havoc,124,62,62
Cydh,auchindoun,1917,demonhunter,havoc,90,45,45
Wibergdh,kazzak,1915,demonhunter,havoc,54,30,24
Damatche,outland,1910,demonhunter,havoc,136,68,68
Brawndow,draenor,1908,demonhunter,havoc,164,83,81
Carritoscrm,outland,1906,demonhunter,havoc,36,20,16
Dripcatchér,ravencrest,1904,demonhunter,havoc,48,29,19
Gíftig,ravencrest,1900,demonhunter,havoc,95,50,45
Avye,tichondrius,1892,demonhunter,havoc,66,34,32
Rvnx,archimonde,1890,demonhunter,havoc,281,154,127
Yarrøck,silvermoon,1890,demonhunter,havoc,84,46,38
Хэллшок,eversong,1890,demonhunter,havoc,96,49,47
Моигваза,soulflayer,1890,demonhunter,havoc,59,30,29
Ïfï,archimonde,1887,demonhunter,havoc,171,90,81
Perojeina,draenor,1885,demonhunter,havoc,41,22,19
Skywålker,stormscale,1882,demonhunter,havoc,81,41,40
Schrewneil,twisting-nether,1882,demonhunter,havoc,72,30,42
Ïîï,archimonde,1880,demonhunter,havoc,85,38,47
Nøbodyx,tarren-mill,1879,demonhunter,havoc,72,36,36
Walkmyshoes,twisting-nether,1877,demonhunter,havoc,102,51,51
Boxssabanned,archimonde,1875,demonhunter,havoc,137,67,70
Elipireli,doomhammer,1874,demonhunter,havoc,54,27,27
Mazöku,ravencrest,1873,demonhunter,havoc,86,51,35
Lassudan,stormreaver,1873,demonhunter,havoc,53,28,25
Donkeydh,tarren-mill,1868,demonhunter,havoc,54,36,18
Anerana,malganis,1868,demonhunter,havoc,102,48,54
Oldforwow,outland,1865,demonhunter,havoc,174,91,83
Зарах,gordunni,1862,demonhunter,havoc,54,33,21
Pulsefuzzy,burning-legion,1861,demonhunter,havoc,59,34,25
Jincksdh,kazzak,1861,demonhunter,havoc,61,29,32
Brolafsen,ravencrest,1859,demonhunter,havoc,66,32,34
Cuddlypeanut,argent-dawn,1859,demonhunter,havoc,207,96,111
Apfelbaum,die-aldor,1857,demonhunter,havoc,60,40,20
Carboen,tarren-mill,1856,demonhunter,havoc,96,52,44
Kebabidin,kazzak,1856,demonhunter,havoc,66,30,36
Itadora,antonidas,1854,demonhunter,havoc,77,40,37
Mädchen,blackhand,1854,demonhunter,havoc,48,23,25
Wàýztøpgx,ravencrest,1854,demonhunter,havoc,65,27,38
Демонблэйдс,gordunni,1853,demonhunter,havoc,66,36,30
Dasein,tarren-mill,1852,demonhunter,havoc,54,29,25
Natosyywaor,dun-modr,1850,demonhunter,havoc,41,21,20
Notlars,chamber-of-aspects,1847,demonhunter,havoc,65,37,28
Mips,ghostlands,1847,demonhunter,havoc,60,30,30
Аркантт,soulflayer,1847,demonhunter,havoc,183,88,95
Flyingwhale,terokkar,1846,demonhunter,havoc,75,43,32
Çøððøøððøøðð,blackmoore,1846,demonhunter,havoc,222,113,109
Grimjow,arthas,1843,demonhunter,havoc,73,34,39
Клопобойка,gordunni,1842,demonhunter,havoc,69,37,32
Bloodwatcher,twisting-nether,1842,demonhunter,havoc,54,27,27
Neunelfturbo,ravencrest,1839,demonhunter,havoc,48,32,16
Çrymemøre,dun-modr,1839,demonhunter,havoc,120,63,57
Rxor,eredar,1838,demonhunter,havoc,120,66,54
Màuul,ravencrest,1838,demonhunter,havoc,201,99,102
Fotmdehatwo,blackrock,1837,demonhunter,havoc,61,32,29
Ilovelilith,zuljin,1837,demonhunter,havoc,129,67,62
Xarôth,eredar,1837,demonhunter,havoc,66,32,34
Скинр,soulflayer,1836,demonhunter,havoc,78,47,31
Smoothbraiin,ravencrest,1836,demonhunter,havoc,137,76,61
Illislan,darksorrow,1836,demonhunter,havoc,251,126,125
Whøo,stormscale,1835,demonhunter,havoc,26,24,2
Minifranger,archimonde,1835,demonhunter,havoc,87,47,40
Ðoksy,archimonde,1835,demonhunter,havoc,60,31,29
Zkrdh,kazzak,1835,demonhunter,havoc,65,33,32
Mavorz,blackhand,1834,demonhunter,havoc,42,25,17
Нэйтиси,soulflayer,1834,demonhunter,havoc,68,36,32
Mittÿ,tarren-mill,1833,demonhunter,havoc,77,36,41
Evilidan,hyjal,1833,demonhunter,havoc,48,22,26
Dânÿ,elune,1831,demonhunter,havoc,66,35,31
Zeroques,frostmane,1831,demonhunter,havoc,66,33,33
Сасун,galakrond,1831,demonhunter,havoc,69,32,37
Supay,rexxar,1830,demonhunter,havoc,58,31,27
Shattre,silvermoon,1830,demonhunter,havoc,41,20,21
Mür,nordrassil,1830,demonhunter,havoc,59,26,33
Charteryo,eredar,1829,demonhunter,havoc,60,35,25
Bogren,sylvanas,1829,demonhunter,havoc,48,25,23
Sofun,stormscale,1829,demonhunter,havoc,228,110,118
Yamehd,stormreaver,1827,demonhunter,havoc,42,26,16
Pogdh,silvermoon,1827,demonhunter,havoc,81,46,35
Sayph,hyjal,1826,demonhunter,havoc,54,30,24
Chxpo,twisting-nether,1826,demonhunter,havoc,89,47,42
Leýara,blackmoore,1825,demonhunter,havoc,56,35,21
Camtoe,ravencrest,1825,demonhunter,havoc,216,121,95
Сибу,soulflayer,1825,demonhunter,havoc,48,21,27
Imslapping,draenor,1824,demonhunter,havoc,96,57,39
Mürh,nordrassil,1824,demonhunter,havoc,54,25,29
Дантеллиан,gordunni,1823,demonhunter,havoc,135,77,58
Cuirnoir,ravencrest,1823,demonhunter,havoc,54,30,24
Malignantx,ragnaros,1823,demonhunter,havoc,56,31,25
Barneeéy,tarren-mill,1823,demonhunter,havoc,113,62,51
Bojestvena,twisting-nether,1823,demonhunter,havoc,180,89,91
Dizbi,argent-dawn,1822,demonhunter,havoc,63,43,20
Zireáel,stormscale,1822,demonhunter,havoc,56,33,23
Hopéless,aggra-português,1821,demonhunter,havoc,42,23,19
Khétí,tarren-mill,1821,demonhunter,havoc,101,53,48
Uldren,defias-brotherhood,1821,demonhunter,havoc,200,102,98
Элизар,howling-fjord,1821,demonhunter,havoc,120,61,59
Dadøw,dun-modr,1820,demonhunter,havoc,72,34,38
Onof,hyjal,1820,demonhunter,havoc,96,43,53
Empúsa,stormscale,1819,demonhunter,havoc,72,39,33
Razex,kazzak,1819,demonhunter,havoc,111,59,52
Stickidan,malganis,1819,demonhunter,havoc,72,36,36
Krm,dun-modr,1818,demonhunter,havoc,38,23,15
Amnésysx,ysondre,1818,demonhunter,havoc,72,35,37
Luwayne,blackmoore,1818,demonhunter,havoc,47,21,26
Dreamslash,tarren-mill,1817,demonhunter,havoc,52,29,23
Zhadrom,ragnaros,1817,demonhunter,havoc,72,31,41
Perna,ghostlands,1814,demonhunter,havoc,74,34,40
Faufilé,garona,1813,demonhunter,havoc,163,85,78
Unseenshadow,ragnaros,1813,demonhunter,havoc,60,25,35
Írony,draenor,1812,demonhunter,havoc,50,25,25
Yukiz,ravencrest,1812,demonhunter,havoc,48,24,24
Найтшифт,blackscar,1811,demonhunter,havoc,46,29,17
Vexanic,chamber-of-aspects,1811,demonhunter,havoc,93,49,44
Eyasluna,twisting-nether,1811,demonhunter,havoc,66,30,36
Djratatouill,kazzak,1810,demonhunter,havoc,42,27,15
Хменчик,soulflayer,1809,demonhunter,havoc,97,47,50
Mandariâ,blackmoore,1808,demonhunter,havoc,60,32,28
Jumpmeister,ragnaros,1806,demonhunter,havoc,42,25,17
Rabæ,blackhand,1806,demonhunter,havoc,102,54,48
Gøat,nemesis,1804,demonhunter,havoc,96,55,41
Турбосвинья,gordunni,1804,demonhunter,havoc,210,115,95
Jawohunt,rexxar,1803,demonhunter,havoc,108,49,59
Stràt,ysondre,1803,demonhunter,havoc,72,31,41
Shtahuntna,tarren-mill,1802,demonhunter,havoc,210,124,86
Мэйзиквин,howling-fjord,1802,demonhunter,havoc,123,66,57
Phesxdh,sylvanas,1801,demonhunter,havoc,122,77,45
Kindablind,aggramar,1801,demonhunter,havoc,95,46,49
Barbarinjo,silvermoon,1800,demonhunter,havoc,36,22,14
Jimfromsales,argent-dawn,1800,demonhunter,havoc,36,19,17
Kardyö,archimonde,1800,demonhunter,havoc,108,50,58
Jco,kazzak,1800,demonhunter,havoc,50,23,27
Миелион,gordunni,1800,demonhunter,havoc,65,29,36
Badtimes,malganis,1799,demonhunter,havoc,243,120,123
Icekissl,hyjal,1797,demonhunter,havoc,40,20,20
Mongoose,drakthul,1796,demonhunter,havoc,154,78,76
Камуи,gordunni,1796,demonhunter,havoc,90,45,45
Finwe,outland,1795,demonhunter,havoc,51,31,20
Дэн,blackscar,1792,demonhunter,havoc,72,37,35
Гвинович,blackscar,1792,demonhunter,havoc,130,66,64
Fiveyearques,sylvanas,1792,demonhunter,havoc,111,51,60
Dpsspec,draenor,1792,demonhunter,havoc,60,27,33
Hunee,kazzak,1790,demonhunter,havoc,69,43,26
Funkiller,stormscale,1790,demonhunter,havoc,64,34,30
Mazeeken,kazzak,1790,demonhunter,havoc,75,38,37
Zedxx,kazzak,1787,demonhunter,havoc,105,54,51
Kostiq,kazzak,1787,demonhunter,havoc,59,30,29
Ted,frostwolf,1785,demonhunter,havoc,66,31,35
Amatèrasú,kazzak,1784,demonhunter,havoc,58,29,29
Найтбладия,gordunni,1783,demonhunter,havoc,66,38,28
Anubias,ravencrest,1777,demonhunter,havoc,72,34,38
Temac,magtheridon,1776,demonhunter,havoc,60,32,28
Врежимеэтти,soulflayer,1776,demonhunter,havoc,70,37,33
Gnarpump,emeriss,1776,demonhunter,havoc,42,21,21
Cláw,ravencrest,1774,demonhunter,havoc,102,50,52
Demonmatheo,stormscale,1771,demonhunter,havoc,54,31,23
Автокикер,soulflayer,1771,demonhunter,havoc,60,34,26
Possomhd,kazzak,1767,demonhunter,havoc,149,84,65
Daemonax,ragnaros,1767,demonhunter,havoc,60,29,31
Exoqt,blackhand,1766,demonhunter,havoc,66,34,32
Edh,dalaran,1765,demonhunter,havoc,101,54,47
Сосочков,soulflayer,1763,demonhunter,havoc,193,100,93
Ðemøñsåy,blackrock,1763,demonhunter,havoc,174,87,87
Бабкамопед,howling-fjord,1760,demonhunter,havoc,45,26,19
Lelaniae,blackhand,1759,demonhunter,havoc,48,20,28
Rïmðh,haomarush,1758,demonhunter,havoc,41,22,19
Nørðìç,nordrassil,1756,demonhunter,havoc,36,21,15
Haldin,kazzak,1755,demonhunter,havoc,83,44,39
Wyna,aggra-português,1755,demonhunter,havoc,160,80,80
Bokajr,ragnaros,1754,demonhunter,havoc,48,28,20
Shanaplow,hyjal,1754,demonhunter,havoc,72,33,39
Mønkeyx,kazzak,1753,demonhunter,havoc,38,25,13
Airelidari,tyrande,1753,demonhunter,havoc,203,101,102
Dhgoddess,kazzak,1752,demonhunter,havoc,42,21,21
Eurobeat,dun-modr,1751,demonhunter,havoc,120,67,53
Primolover,outland,1751,demonhunter,havoc,66,33,33
Eréthrus,ravencrest,1751,demonhunter,havoc,61,28,33
Calloww,kazzak,1750,demonhunter,havoc,37,19,18
Sailen,blackmoore,1748,demonhunter,havoc,59,28,31
Felom,garona,1746,demonhunter,havoc,78,43,35
Ehrin,lightbringer,1746,demonhunter,havoc,100,49,51
Xotourlife,stormscale,1744,demonhunter,havoc,36,22,14
Batik,blackmoore,1744,demonhunter,havoc,178,88,90
Lagseven,ravencrest,1744,demonhunter,havoc,63,31,32
Merelini,twisting-nether,1743,demonhunter,havoc,40,22,18
Billyhassan,kazzak,1742,demonhunter,havoc,48,31,17
Brunhity,twisting-nether,1739,demonhunter,havoc,47,21,26
Mojothejojo,ravencrest,1738,demonhunter,havoc,79,42,37
Zerinitý,outland,1737,demonhunter,havoc,54,29,25
Viced,kazzak,1737,demonhunter,havoc,54,24,30
Jeannedäsh,archimonde,1736,demonhunter,havoc,48,24,24
Susanoø,eredar,1735,demonhunter,havoc,213,116,97
Фавлав,ashenvale,1734,demonhunter,havoc,56,29,27
Belákor,twisting-nether,1734,demonhunter,havoc,235,120,115
Shadyblady,nemesis,1731,demonhunter,havoc,142,72,70
Йактон,soulflayer,1731,demonhunter,havoc,42,20,22
Xenits,kazzak,1730,demonhunter,havoc,75,38,37
Ewlyna,stormscale,1730,demonhunter,havoc,48,22,26
Elsynn,dalaran,1729,demonhunter,havoc,96,47,49
Donipwnz,blackrock,1729,demonhunter,havoc,89,38,51
Weez,kilrogg,1727,demonhunter,havoc,162,80,82
Азместь,howling-fjord,1727,demonhunter,havoc,42,20,22
Trashcarlitô,eredar,1726,demonhunter,havoc,56,30,26
Badreal,sylvanas,1726,demonhunter,havoc,54,25,29
Shadowjambo,twisting-nether,1725,demonhunter,havoc,81,45,36
Alundil,ravencrest,1725,demonhunter,havoc,60,32,28
Kinstak,sanguino,1725,demonhunter,havoc,54,27,27
Balberith,twisting-nether,1724,demonhunter,havoc,87,47,40
Luunz,argent-dawn,1724,demonhunter,havoc,119,58,61
Çôæ,twisting-nether,1723,demonhunter,havoc,163,81,82
Immørtaldh,tarren-mill,1723,demonhunter,havoc,48,23,25
Nagatobimaru,tarren-mill,1721,demonhunter,havoc,48,26,22
Felpsita,kazzak,1721,demonhunter,havoc,60,30,30
Simshady,stormscale,1720,demonhunter,havoc,54,34,20
Felski,outland,1720,demonhunter,havoc,61,29,32
Enjøybrah,nemesis,1718,demonhunter,havoc,55,34,21
Âspen,archimonde,1717,demonhunter,havoc,84,52,32
Cheetòs,blackmoore,1717,demonhunter,havoc,57,33,24
Periphere,eredar,1715,demonhunter,havoc,42,22,20
Maevê,frostmourne,1712,demonhunter,havoc,37,19,18
Культсмерти,howling-fjord,1712,demonhunter,havoc,78,31,47
Kezumå,tarren-mill,1710,demonhunter,havoc,84,42,42
Alythes,stormscale,1709,demonhunter,havoc,115,62,53
Лизарин,gordunni,1708,demonhunter,havoc,101,46,55
Bestro,tarren-mill,1706,demonhunter,havoc,62,31,31
Zy,ahnqiraj,1705,demonhunter,havoc,35,20,15
Jolyh,nemesis,1704,demonhunter,havoc,53,34,19
Chàk,marécage-de-zangar,1704,demonhunter,havoc,126,54,72
Neralith,ravencrest,1703,demonhunter,havoc,119,62,57
Авилолз,gordunni,1702,demonhunter,havoc,48,25,23
Enfy,twisting-nether,1701,demonhunter,havoc,71,35,36
Dantert,zuljin,1699,demonhunter,havoc,36,21,15
Киттигоплей,soulflayer,1699,demonhunter,havoc,90,46,44
Tanjero,stormscale,1696,demonhunter,havoc,53,36,17
Anzz,kazzak,1695,demonhunter,havoc,48,25,23
Purpleturtle,blackrock,1695,demonhunter,havoc,48,25,23
Máédhros,ravencrest,1695,demonhunter,havoc,46,21,25
Yousaindh,blackrock,1694,demonhunter,havoc,66,29,37
Malabala,grim-batol,1693,demonhunter,havoc,29,19,10
Indral,argent-dawn,1693,demonhunter,havoc,77,43,34
Márcin,burning-legion,1693,demonhunter,havoc,64,31,33
Tyssra,argent-dawn,1692,demonhunter,havoc,335,161,174
Yerla,burning-legion,1691,demonhunter,havoc,42,20,22
Shabalda,dun-morogh,1690,demonhunter,havoc,58,29,29
Mâdzylîa,archimonde,1688,demonhunter,havoc,41,19,22
Dxæn,archimonde,1687,demonhunter,havoc,41,24,17
Spheria,outland,1687,demonhunter,havoc,135,65,70
Mêgumi,kirin-tor,1686,demonhunter,havoc,178,94,84
Deehâ,eredar,1686,demonhunter,havoc,48,25,23
Demobob,tarren-mill,1686,demonhunter,havoc,48,23,25
Valarauk,ravencrest,1685,demonhunter,havoc,192,112,80
Demonkata,twisting-nether,1684,demonhunter,havoc,80,46,34
Slutkitten,ravencrest,1684,demonhunter,havoc,48,21,27
Burchulica,sylvanas,1683,demonhunter,havoc,42,24,18
Soizis,drakthul,1682,demonhunter,havoc,42,23,19
Emurid,les-sentinelles,1682,demonhunter,havoc,54,26,28
Míàkhãlîfâýð,stormscale,1682,demonhunter,havoc,62,26,36
Инферналка,howling-fjord,1681,demonhunter,havoc,42,27,15
Ячмо,gordunni,1681,demonhunter,havoc,29,18,11
Demonichanta,azjolnerub,1681,demonhunter,havoc,196,101,95
Aethinos,sylvanas,1678,demonhunter,havoc,42,27,15
Asmonsmash,twisting-nether,1678,demonhunter,havoc,56,27,29
Eyecandy,scarshield-legion,1677,demonhunter,havoc,67,34,33
Депрессивдед,gordunni,1677,demonhunter,havoc,48,24,24
Kïallz,hyjal,1676,demonhunter,havoc,337,175,162
Ryänåir,ravencrest,1675,demonhunter,havoc,78,45,33
Hcsgötze,dalaran,1674,demonhunter,havoc,64,39,25
Ráiku,ravencrest,1674,demonhunter,havoc,48,22,26
Шахдан,howling-fjord,1673,demonhunter,havoc,76,43,33
Twopumpchump,twisting-nether,1673,demonhunter,havoc,98,48,50
Demoncyka,twisting-nether,1673,demonhunter,havoc,60,22,38
Hialdoo,sylvanas,1672,demonhunter,havoc,66,29,37
Neverdance,ravencrest,1669,demonhunter,havoc,48,22,26
Fruchtzwerg,tarren-mill,1667,demonhunter,havoc,60,33,27
Smâshêd,stormscale,1666,demonhunter,havoc,75,43,32
Bestboytoy,ravencrest,1666,demonhunter,havoc,41,22,19
Wojtall,silvermoon,1666,demonhunter,havoc,236,122,114
Âyro,ravencrest,1665,demonhunter,havoc,54,33,21
Thingawoop,tarren-mill,1664,demonhunter,havoc,67,33,34
Ranked,drakthul,1664,demonhunter,havoc,129,55,74
Gwoodza,archimonde,1664,demonhunter,havoc,48,20,28
Lasaka,stormscale,1663,demonhunter,havoc,99,61,38
Brodor,alakir,1663,demonhunter,havoc,42,22,20
Nyalah,eredar,1662,demonhunter,havoc,48,24,24
Nepthýs,blackhand,1662,demonhunter,havoc,57,25,32
Nillrogthedh,stormscale,1661,demonhunter,havoc,132,81,51
Koiskdh,tarren-mill,1661,demonhunter,havoc,52,28,24
Солфдх,fordragon,1661,demonhunter,havoc,42,19,23
Nisirae,argent-dawn,1659,demonhunter,havoc,138,80,58
Havocer,burning-legion,1659,demonhunter,havoc,78,44,34
Lilydrop,varimathras,1659,demonhunter,havoc,51,20,31
Kékw,stormscale,1658,demonhunter,havoc,123,74,49
Уполномочен,howling-fjord,1658,demonhunter,havoc,42,23,19
Barny,skullcrusher,1658,demonhunter,havoc,102,51,51
Anayihh,dun-modr,1658,demonhunter,havoc,48,22,26
Nøvillain,blackrock,1657,demonhunter,havoc,102,59,43
Nyalaah,eredar,1657,demonhunter,havoc,42,23,19
Кейтпрнстарс,howling-fjord,1657,demonhunter,havoc,100,53,47
Ðêmønìnsìðê,blackmoore,1656,demonhunter,havoc,30,19,11
Èfiie,culte-de-la-rive-noire,1656,demonhunter,havoc,53,24,29
Солевыеглефы,gordunni,1655,demonhunter,havoc,30,22,8
Tamtheone,silvermoon,1652,demonhunter,havoc,102,55,47
Broglaive,sylvanas,1652,demonhunter,havoc,42,21,21
Slaanaesh,kazzak,1652,demonhunter,havoc,68,27,41
Oniramqt,aegwynn,1651,demonhunter,havoc,48,22,26
Xalgalor,silvermoon,1650,demonhunter,havoc,48,29,19
Ethína,kazzak,1649,demonhunter,havoc,48,23,25
Speedførce,antonidas,1647,demonhunter,havoc,126,59,67
Gigasloth,outland,1646,demonhunter,havoc,30,23,7
Амбату,howling-fjord,1646,demonhunter,havoc,56,38,18
Lhya,tarren-mill,1645,demonhunter,havoc,60,32,28
Lilfly,twisting-nether,1645,demonhunter,havoc,36,19,17
Aofaye,aegwynn,1645,demonhunter,havoc,77,29,48
Ekaõs,les-sentinelles,1644,demonhunter,havoc,53,28,25
Rylqt,blackmoore,1644,demonhunter,havoc,67,33,34
Benihimee,twisting-nether,1644,demonhunter,havoc,72,35,37
Kâsúxôxô,ravencrest,1643,demonhunter,havoc,34,19,15
Broilerx,balnazzar,1643,demonhunter,havoc,48,22,26
Killia,lothar,1642,demonhunter,havoc,42,24,18
Azaleia,archimonde,1642,demonhunter,havoc,142,74,68
Felen,zuljin,1642,demonhunter,havoc,136,64,72
Davidastt,drakthul,1641,demonhunter,havoc,65,30,35
Razrsolo,tarren-mill,1640,demonhunter,havoc,53,30,23
Loucee,blackhand,1639,demonhunter,havoc,90,47,43
Ðârksìðê,stormscale,1638,demonhunter,havoc,30,20,10
Bizl,arygos,1638,demonhunter,havoc,30,19,11
Ðisgraze,argent-dawn,1637,demonhunter,havoc,156,82,74
Zayláh,ravencrest,1637,demonhunter,havoc,93,46,47
Picpouc,archimonde,1637,demonhunter,havoc,54,24,30
Prepared,kaelthas,1637,demonhunter,havoc,45,20,25
Rezer,stormscale,1637,demonhunter,havoc,66,29,37
Destinado,aggra-português,1636,demonhunter,havoc,48,28,20
Róxor,twisting-nether,1636,demonhunter,havoc,48,21,27
Batx,ravencrest,1636,demonhunter,havoc,48,20,28
Øctågøñ,blackrock,1635,demonhunter,havoc,98,50,48
ßerdína,tarren-mill,1635,demonhunter,havoc,81,41,40
Xekaul,tarren-mill,1635,demonhunter,havoc,258,124,134
Riptos,blackhand,1635,demonhunter,havoc,46,22,24
Azraethx,ravencrest,1633,demonhunter,havoc,60,35,25
Djdeathsweep,blackrock,1633,demonhunter,havoc,36,19,17
Смутсайбот,howling-fjord,1633,demonhunter,havoc,48,22,26
Lanadelbae,teldrassil,1631,demonhunter,havoc,115,58,57
Azmodían,silvermoon,1631,demonhunter,havoc,59,28,31
Blæm,archimonde,1630,demonhunter,havoc,48,25,23
Velysaría,guldan,1630,demonhunter,havoc,97,50,47
Fullsënd,ragnaros,1630,demonhunter,havoc,146,71,75
Shadoss,ravencrest,1629,demonhunter,havoc,78,41,37
Molntuss,ravencrest,1629,demonhunter,havoc,80,36,44
Великаямыша,blackscar,1628,demonhunter,havoc,56,33,23
Reckqt,eredar,1628,demonhunter,havoc,30,17,13
Mentalìst,blackmoore,1628,demonhunter,havoc,93,50,43
Юзлескласс,gordunni,1627,demonhunter,havoc,36,20,16
Felbannedguy,twisting-nether,1627,demonhunter,havoc,42,23,19
Dinastye,archimonde,1627,demonhunter,havoc,168,90,78
Tdh,sanguino,1627,demonhunter,havoc,36,19,17
Оригамушка,gordunni,1627,demonhunter,havoc,48,23,25
Крикадский,howling-fjord,1626,demonhunter,havoc,90,54,36
Xetalar,burning-legion,1626,demonhunter,havoc,144,84,60
Omegapump,ravencrest,1626,demonhunter,havoc,36,19,17
Unkqt,dalaran,1625,demonhunter,havoc,36,20,16
Jumboo,tarren-mill,1625,demonhunter,havoc,53,29,24
Nolitara,exodar,1625,demonhunter,havoc,86,44,42
Stazó,drakthul,1625,demonhunter,havoc,145,71,74
Nuxzhell,tarren-mill,1625,demonhunter,havoc,246,119,127
Sonreye,kazzak,1625,demonhunter,havoc,41,18,23
Brainlessdmg,ragnaros,1624,demonhunter,havoc,24,17,7
Lindzor,frostmane,1624,demonhunter,havoc,47,32,15
Zahadius,silvermoon,1624,demonhunter,havoc,47,30,17
Drmanaburn,ravencrest,1624,demonhunter,havoc,30,17,13
Quazr,outland,1624,demonhunter,havoc,205,116,89
Onecho,ragnaros,1623,demonhunter,havoc,30,18,12
Despèradø,archimonde,1623,demonhunter,havoc,140,74,66
Koomaliha,outland,1623,demonhunter,havoc,85,42,43
Бельторо,soulflayer,1622,demonhunter,havoc,123,68,55
Cptncucumber,blackmoore,1622,demonhunter,havoc,108,54,54
Garoteromani,draenor,1621,demonhunter,havoc,96,57,39
Kolísenn,drakthul,1621,demonhunter,havoc,58,31,27
Ilidrax,hyjal,1621,demonhunter,havoc,48,23,25
Calcïum,archimonde,1621,demonhunter,havoc,68,28,40
Nowhereturun,stormscale,1619,demonhunter,havoc,36,20,16
Dragontwist,sylvanas,1619,demonhunter,havoc,42,22,20
Alcóhon,ravencrest,1619,demonhunter,havoc,41,21,20
Ferihokurva,outland,1619,demonhunter,havoc,48,22,26
Nerronaxd,silvermoon,1618,demonhunter,havoc,96,47,49
Fazero,silvermoon,1618,demonhunter,havoc,84,40,44
Пибзянка,howling-fjord,1616,demonhunter,havoc,36,20,16
Ботология,gordunni,1616,demonhunter,havoc,78,37,41
Aroxos,draenor,1616,demonhunter,havoc,64,29,35
Maytherel,blackhand,1616,demonhunter,havoc,126,52,74
Crappyftw,ravencrest,1615,demonhunter,havoc,370,193,177
Xenca,ravencrest,1614,demonhunter,havoc,113,66,47
Фэсс,soulflayer,1613,demonhunter,havoc,65,35,30
Zakaji,blackmoore,1613,demonhunter,havoc,38,20,18
Demonmancer,ravencrest,1613,demonhunter,havoc,258,133,125
Felwinter,ravencrest,1613,demonhunter,havoc,168,80,88
Chïbrøne,archimonde,1613,demonhunter,havoc,48,17,31
Venatica,twisting-nether,1612,demonhunter,havoc,108,62,46
Evil,uldum,1612,demonhunter,havoc,137,72,65
Tachala,khaz-modan,1612,demonhunter,havoc,39,20,19
Kéftëmé,ravencrest,1612,demonhunter,havoc,84,43,41
Thedudex,dunemaul,1612,demonhunter,havoc,44,21,23
Sekørm,ragnaros,1612,demonhunter,havoc,48,21,27
Sepdy,draenor,1611,demonhunter,havoc,92,48,44
Netherim,twisting-nether,1611,demonhunter,havoc,122,52,70
Азелира,gordunni,1610,demonhunter,havoc,84,47,37
Gündüzgezen,silvermoon,1610,demonhunter,havoc,59,30,29
Дайкиаомине,soulflayer,1609,demonhunter,havoc,36,19,17
Enthia,antonidas,1607,demonhunter,havoc,119,65,54
Râindra,twisting-nether,1607,demonhunter,havoc,168,87,81
Jórúnn,twisting-nether,1607,demonhunter,havoc,48,22,26
Kayzel,argent-dawn,1606,demonhunter,havoc,183,93,90
Майкелелекек,gordunni,1606,demonhunter,havoc,36,17,19
Kins,dun-modr,1606,demonhunter,havoc,66,29,37
Firebringer,silvermoon,1605,demonhunter,havoc,36,21,15
Höllymedx,blackmoore,1605,demonhunter,havoc,30,17,13
Ifeeldirty,draenor,1605,demonhunter,havoc,37,20,17
ßerdíná,tarren-mill,1605,demonhunter,havoc,60,31,29
Sturmovik,ravencrest,1604,demonhunter,havoc,30,19,11
Èstefany,stormscale,1604,demonhunter,havoc,90,49,41
Zevsa,ravencrest,1604,demonhunter,havoc,48,25,23
Nixzon,thrall,1604,demonhunter,havoc,78,31,47
Trashclass,draenor,1603,demonhunter,havoc,34,18,16
Kekburagól,kazzak,1602,demonhunter,havoc,39,21,18
Wintalker,nemesis,1602,demonhunter,havoc,60,31,29
Krmâ,blackrock,1602,demonhunter,havoc,48,20,28
Zoyle,blackrock,1602,demonhunter,havoc,54,22,32
Alithy,kazzak,1600,demonhunter,havoc,132,79,53
Ícéìnmývèins,stormscale,1600,demonhunter,havoc,45,20,25
Кельдарк,soulflayer,1598,demonhunter,havoc,192,97,95
Ignasei,archimonde,1598,demonhunter,havoc,69,31,38
Cappaowx,ravencrest,1597,demonhunter,havoc,30,21,9
Ðêmønìç,area-52,1597,demonhunter,havoc,42,25,17
Рейз,howling-fjord,1597,demonhunter,havoc,138,67,71
Illidarisi,auchindoun,1597,demonhunter,havoc,66,32,34
Illidankxx,sylvanas,1596,demonhunter,havoc,61,36,25
Antidevil,kazzak,1596,demonhunter,havoc,129,73,56
Мэртольятти,soulflayer,1596,demonhunter,havoc,67,34,33
Zamassu,kazzak,1596,demonhunter,havoc,42,21,21
Glayvie,kazzak,1593,demonhunter,havoc,69,32,37
Sebyk,doomhammer,1592,demonhunter,havoc,60,35,25
Dominik,the-maelstrom,1592,demonhunter,havoc,132,75,57
Турботашш,soulflayer,1592,demonhunter,havoc,35,17,18
Bhairav,silvermoon,1591,demonhunter,havoc,36,21,15
Gonextbg,tarren-mill,1590,demonhunter,havoc,120,66,54
Shaihulud,sanguino,1590,demonhunter,havoc,217,115,102
Akkita,ravencrest,1590,demonhunter,havoc,120,63,57
Alareey,antonidas,1590,demonhunter,havoc,141,68,73
Boozlike,tarren-mill,1588,demonhunter,havoc,78,42,36
Lghdtv,ravencrest,1587,demonhunter,havoc,78,40,38
Coolpizzaguy,twisting-nether,1587,demonhunter,havoc,42,19,23
Schejtan,blackmoore,1586,demonhunter,havoc,48,30,18
Släshes,kazzak,1584,demonhunter,havoc,46,21,25
Pibzya,ravencrest,1583,demonhunter,havoc,45,22,23
Kividari,dun-modr,1583,demonhunter,havoc,44,21,23
Трукейт,gordunni,1582,demonhunter,havoc,56,33,23
Junkai,echsenkessel,1581,demonhunter,havoc,54,30,24
Guáca,draenor,1579,demonhunter,havoc,51,26,25
Ydrael,terokkar,1578,demonhunter,havoc,54,29,25
Gïzmó,tarren-mill,1578,demonhunter,havoc,60,30,30
Мишаметапамп,grom,1578,demonhunter,havoc,38,19,19
Ryuwar,dun-modr,1577,demonhunter,havoc,83,44,39
Геммула,howling-fjord,1575,demonhunter,havoc,144,70,74
Shylaría,blackhand,1573,demonhunter,havoc,42,20,22
Muyoni,eredar,1573,demonhunter,havoc,42,18,24
Хингарский,deathguard,1571,demonhunter,havoc,44,25,19
Urukguy,silvermoon,1569,demonhunter,havoc,30,20,10
Ноубрейндыха,gordunni,1569,demonhunter,havoc,263,135,128
Przemson,mazrigos,1568,demonhunter,havoc,71,35,36
Драксх,gordunni,1566,demonhunter,havoc,54,26,28
Dhqoo,blackrock,1565,demonhunter,havoc,42,18,24
Exact,throkferoth,1564,demonhunter,havoc,71,38,33
Solarae,silvermoon,1564,demonhunter,havoc,127,67,60
Цезарий,gordunni,1563,demonhunter,havoc,162,83,79
Winxclub,ravencrest,1562,demonhunter,havoc,95,54,41
Crylater,twisting-nether,1561,demonhunter,havoc,30,20,10
Phudi,tarren-mill,1561,demonhunter,havoc,139,71,68
Jaquees,stormscale,1561,demonhunter,havoc,36,18,18
Vorbis,twisting-nether,1561,demonhunter,havoc,108,53,55
Akaria,blackrock,1559,demonhunter,havoc,82,53,29
Onebuttonxd,ravencrest,1559,demonhunter,havoc,48,29,19
Imsickleavme,draenor,1557,demonhunter,havoc,82,42,40
Deathe,kilrogg,1556,demonhunter,havoc,54,24,30
Синнэрлити,soulflayer,1555,demonhunter,havoc,42,18,24
Shivarræ,stormreaver,1554,demonhunter,havoc,30,17,13
Zintu,draenor,1554,demonhunter,havoc,108,53,55
Thkingragnar,sanguino,1553,demonhunter,havoc,36,23,13
Dhzor,twisting-nether,1552,demonhunter,havoc,64,32,32
Shylea,ravencrest,1551,demonhunter,havoc,126,66,60
Этмер,soulflayer,1550,demonhunter,havoc,48,27,21
Fellespont,hellscream,1550,demonhunter,havoc,87,39,48
Demøniac,ravencrest,1549,demonhunter,havoc,90,51,39
Самадиэль,soulflayer,1549,demonhunter,havoc,59,30,29
Safedaddy,silvermoon,1548,demonhunter,havoc,33,18,15
Terrminator,darksorrow,1547,demonhunter,havoc,29,19,10
Ashcan,tarren-mill,1547,demonhunter,havoc,70,37,33
Гивюрхартми,gordunni,1547,demonhunter,havoc,42,17,25
Däshgødx,stormscale,1543,demonhunter,havoc,54,31,23
Usaïnbolts,archimonde,1543,demonhunter,havoc,36,17,19
Telarris,twisting-nether,1542,demonhunter,havoc,195,110,85
Snibsxdh,silvermoon,1542,demonhunter,havoc,42,19,23
Testôdh,blackrock,1542,demonhunter,havoc,48,17,31
Kïng,frostmane,1541,demonhunter,havoc,30,20,10
Бананчикус,gordunni,1541,demonhunter,havoc,54,23,31
Khray,archimonde,1540,demonhunter,havoc,36,18,18
Чанпэн,soulflayer,1539,demonhunter,havoc,128,68,60
Шэдоуштормх,soulflayer,1538,demonhunter,havoc,78,48,30
Duffin,doomhammer,1538,demonhunter,havoc,138,69,69
Thorno,argent-dawn,1538,demonhunter,havoc,48,17,31
Hallando,draenor,1537,demonhunter,havoc,232,122,110
Opmuch,eonar,1537,demonhunter,havoc,58,29,29
Omegasyx,dun-modr,1537,demonhunter,havoc,40,19,21
Roaf,twisting-nether,1536,demonhunter,havoc,99,48,51
Flys,doomhammer,1534,demonhunter,havoc,32,19,13
Méruème,hyjal,1534,demonhunter,havoc,43,22,21
Ambudh,kazzak,1533,demonhunter,havoc,30,16,14
Глефавочко,gordunni,1533,demonhunter,havoc,36,16,20
Bichmicher,earthen-ring,1533,demonhunter,havoc,54,19,35
Thorair,ravenholdt,1532,demonhunter,havoc,72,33,39
Nuitrayer,hyjal,1531,demonhunter,havoc,56,37,19
Felthunder,twisting-nether,1530,demonhunter,havoc,30,16,14
Padalecki,blackmoore,1530,demonhunter,havoc,30,16,14
Цэрри,soulflayer,1525,demonhunter,havoc,66,34,32
Ruíko,dun-morogh,1525,demonhunter,havoc,72,37,35
Geauxinue,archimonde,1525,demonhunter,havoc,36,16,20
Крикетчсв,soulflayer,1524,demonhunter,havoc,42,23,19
Glímpse,ravencrest,1524,demonhunter,havoc,66,32,34
Геннитиро,deathguard,1523,demonhunter,havoc,34,20,14
Snitchezz,blackmoore,1523,demonhunter,havoc,102,55,47
Yeedhlol,blackmoore,1523,demonhunter,havoc,30,16,14
Вскрыша,soulflayer,1522,demonhunter,havoc,30,16,14
Shyuk,sanguino,1521,demonhunter,havoc,24,16,8
Szexypopsi,ragnaros,1521,demonhunter,havoc,65,35,30
Shiefwiggum,aegwynn,1521,demonhunter,havoc,42,22,20
Гневлуны,lich-king,1521,demonhunter,havoc,66,31,35
Ashiharademo,twilights-hammer,1520,demonhunter,havoc,78,42,36
Ranzerg,tarren-mill,1519,demonhunter,havoc,24,17,7
Drphillidan,tarren-mill,1518,demonhunter,havoc,38,17,21
Doomcake,emeriss,1516,demonhunter,havoc,30,17,13
Jesana,argent-dawn,1515,demonhunter,havoc,126,67,59
Azzïnoth,sargeras,1515,demonhunter,havoc,36,17,19
Mephîsto,sylvanas,1514,demonhunter,havoc,78,41,37
Мужичок,soulflayer,1514,demonhunter,havoc,131,68,63
Sokal,dun-modr,1514,demonhunter,havoc,62,30,32
Эльгастон,howling-fjord,1514,demonhunter,havoc,54,26,28
Аитерия,gordunni,1513,demonhunter,havoc,24,18,6
Vênedri,eredar,1511,demonhunter,havoc,45,26,19
Cynmatic,kargath,1511,demonhunter,havoc,48,23,25
Blacklidan,blackrock,1509,demonhunter,havoc,40,17,23
Øhka,outland,1509,demonhunter,havoc,60,24,36
Faytundh,kult-der-verdammten,1508,demonhunter,havoc,36,16,20
Geashy,blackmoore,1507,demonhunter,havoc,52,31,21
Nanana,doomhammer,1507,demonhunter,havoc,72,37,35
Ceyye,blackrock,1507,demonhunter,havoc,54,26,28
Mâlefiz,blackmoore,1507,demonhunter,havoc,48,22,26
Pinkberry,outland,1506,demonhunter,havoc,30,16,14
Theaisbae,twisting-nether,1506,demonhunter,havoc,54,25,29
Сложныйдх,howling-fjord,1505,demonhunter,havoc,48,29,19
Talamacus,outland,1505,demonhunter,havoc,36,21,15
Дрэгонборн,howling-fjord,1504,demonhunter,havoc,60,29,31
Brawngodx,draenor,1503,demonhunter,havoc,25,17,8
Штормдоттэр,howling-fjord,1503,demonhunter,havoc,36,19,17
Sidekiq,silvermoon,1503,demonhunter,havoc,52,26,26
Kanabiz,outland,1502,demonhunter,havoc,246,127,119
Incanator,tarren-mill,1502,demonhunter,havoc,83,40,43
Lòsâng,sanguino,1501,demonhunter,havoc,99,42,57
Мужна,grom,1500,demonhunter,havoc,40,22,18
Apokalypsra,blackmoore,1500,demonhunter,havoc,73,37,36
Íllìðåñgøðx,antonidas,1500,demonhunter,havoc,118,57,61
Bippsy,zuljin,1499,demonhunter,havoc,44,28,16
Mikezilla,drakthul,1498,demonhunter,havoc,48,24,24
Arnokia,kazzak,1498,demonhunter,havoc,114,56,58
Insaneomg,blackmoore,1497,demonhunter,havoc,40,16,24
Hauntedseoul,grim-batol,1496,demonhunter,havoc,90,54,36
Sonnefel,tarren-mill,1495,demonhunter,havoc,65,32,33
Gullveîg,archimonde,1494,demonhunter,havoc,42,25,17
Persio,sanguino,1493,demonhunter,havoc,95,48,47
Kalr,silvermoon,1492,demonhunter,havoc,35,22,13
Aenirá,tarren-mill,1492,demonhunter,havoc,77,37,40
Draxie,turalyon,1492,demonhunter,havoc,70,33,37
Hornyhexy,stormscale,1489,demonhunter,havoc,72,35,37
Échô,tarren-mill,1489,demonhunter,havoc,40,18,22
Headlessdh,ragnaros,1488,demonhunter,havoc,42,23,19
Métakagoule,ysondre,1488,demonhunter,havoc,87,43,44
Kolrex,ragnaros,1488,demonhunter,havoc,59,29,30
Läderjoel,ravencrest,1488,demonhunter,havoc,71,34,37
Cantseêyou,blackmoore,1487,demonhunter,havoc,78,42,36
Ziltush,archimonde,1487,demonhunter,havoc,137,69,68
Sweetpety,tarren-mill,1486,demonhunter,havoc,105,53,52
Împd,ravencrest,1485,demonhunter,havoc,96,47,49
Zumei,stormreaver,1484,demonhunter,havoc,56,31,25
Покахонта,soulflayer,1484,demonhunter,havoc,100,54,46
Myztiko,hellscream,1484,demonhunter,havoc,170,87,83
Dhsheesh,draenor,1484,demonhunter,havoc,42,21,21
Эинхерия,soulflayer,1484,demonhunter,havoc,57,25,32
Pvpabuser,ravencrest,1483,demonhunter,havoc,47,27,20
Smoochygodx,antonidas,1483,demonhunter,havoc,96,54,42
Onlytwokeys,dun-modr,1483,demonhunter,havoc,96,48,48
Cumbayá,draenor,1482,demonhunter,havoc,30,17,13
Oonn,outland,1482,demonhunter,havoc,45,21,24
Monkeypox,twisting-nether,1481,demonhunter,havoc,94,47,47
Misli,stormscale,1480,demonhunter,havoc,54,29,25
Grimberg,tarren-mill,1480,demonhunter,havoc,108,57,51
Emerelle,die-aldor,1479,demonhunter,havoc,126,60,66
Кирсена,gordunni,1479,demonhunter,havoc,41,19,22
Tenawees,blackmoore,1478,demonhunter,havoc,48,27,21
Fumbiidhx,thrall,1478,demonhunter,havoc,48,25,23
Oggidanbuu,tarren-mill,1478,demonhunter,havoc,49,22,27
Olddemon,ravencrest,1477,demonhunter,havoc,59,40,19
Æä,draenor,1477,demonhunter,havoc,54,26,28
Lastactiondh,dun-morogh,1475,demonhunter,havoc,30,21,9
Iphanaa,frostmane,1475,demonhunter,havoc,91,44,47
Баттлрэп,soulflayer,1473,demonhunter,havoc,74,36,38
Thehûnt,outland,1472,demonhunter,havoc,101,55,46
Tylleröwittu,grim-batol,1471,demonhunter,havoc,30,16,14
Parmesano,tyrande,1470,demonhunter,havoc,48,31,17
Treehunter,ravencrest,1470,demonhunter,havoc,30,16,14
Valkorion,chamber-of-aspects,1470,demonhunter,havoc,39,20,19
Ардатйякши,borean-tundra,1470,demonhunter,havoc,98,39,59
Zitx,ravencrest,1467,demonhunter,havoc,138,71,67
Szopóvadász,ragnaros,1466,demonhunter,havoc,36,17,19
Frevee,outland,1464,demonhunter,havoc,113,63,50
Убийца,soulflayer,1463,demonhunter,havoc,53,29,24
Рэгес,howling-fjord,1463,demonhunter,havoc,30,16,14
Saisahan,archimonde,1462,demonhunter,havoc,41,23,18
Kéøn,ravencrest,1462,demonhunter,havoc,30,16,14
Baball,kazzak,1460,demonhunter,havoc,93,50,43
Wirsing,azshara,1460,demonhunter,havoc,54,22,32
Kvye,archimonde,1459,demonhunter,havoc,30,16,14
Blîndmaster,ravencrest,1459,demonhunter,havoc,130,65,65
Feluron,silvermoon,1457,demonhunter,havoc,30,24,6
Syonis,archimonde,1457,demonhunter,havoc,25,17,8
Actuallytrol,argent-dawn,1457,demonhunter,havoc,59,27,32
Фумиан,soulflayer,1457,demonhunter,havoc,64,28,36
Yugsiturath,drakthul,1456,demonhunter,havoc,66,33,33
Vexblade,silvermoon,1454,demonhunter,havoc,78,48,30
Toonsdh,kazzak,1453,demonhunter,havoc,79,46,33
Шалдарон,howling-fjord,1453,demonhunter,havoc,34,18,16
Trinchensdh,blackhand,1453,demonhunter,havoc,48,23,25
Ayö,draenor,1452,demonhunter,havoc,121,66,55
Morskivuk,draenor,1451,demonhunter,havoc,38,22,16
Ülquiorrä,kazzak,1450,demonhunter,havoc,53,34,19
Аянамирейко,blackscar,1450,demonhunter,havoc,60,36,24
Dibo,blackmoore,1448,demonhunter,havoc,99,48,51
Хорбелий,deathguard,1446,demonhunter,havoc,84,42,42
Guccibaby,silvermoon,1445,demonhunter,havoc,72,33,39
Knùbbz,ravencrest,1444,demonhunter,havoc,63,29,34
Tursal,dun-morogh,1442,demonhunter,havoc,39,22,17
Níghtwing,wildhammer,1441,demonhunter,havoc,47,25,22
Дашажмимету,blackscar,1439,demonhunter,havoc,32,16,16
Chotzbrocke,blackhand,1438,demonhunter,havoc,24,15,9
Blizdliksk,outland,1437,demonhunter,havoc,42,22,20
Onlyfangodx,antonidas,1436,demonhunter,havoc,30,15,15
Sturmimon,arthas,1436,demonhunter,havoc,36,15,21
Netrisha,ravencrest,1436,demonhunter,havoc,72,28,44
Джастх,howling-fjord,1435,demonhunter,havoc,24,15,9
Carablue,hyjal,1435,demonhunter,havoc,30,15,15
Erzàuwu,silvermoon,1435,demonhunter,havoc,36,15,21
Maskinegoðx,tarren-mill,1433,demonhunter,havoc,30,15,15
Shõ,twisting-nether,1433,demonhunter,havoc,42,15,27
Sabe,ravencrest,1432,demonhunter,havoc,29,20,9
Ashrena,ysondre,1431,demonhunter,havoc,48,32,16
Остроухйй,blackscar,1430,demonhunter,havoc,66,30,36
Nvampire,draenor,1429,demonhunter,havoc,24,17,7
Øbsessiøn,kazzak,1429,demonhunter,havoc,107,53,54
Bhaz,tichondrius,1428,demonhunter,havoc,30,16,14
Ûro,dun-modr,1428,demonhunter,havoc,42,15,27
Ultîma,hyjal,1427,demonhunter,havoc,36,15,21
Brisingamen,outland,1426,demonhunter,havoc,60,29,31
Муими,soulflayer,1426,demonhunter,havoc,36,15,21
Kîrîto,nethersturm,1426,demonhunter,havoc,47,16,31
Afuwarrior,doomhammer,1425,demonhunter,havoc,57,31,26
Древиал,gordunni,1424,demonhunter,havoc,50,27,23
Deponiajkm,dun-modr,1424,demonhunter,havoc,30,15,15
Malakbel,nemesis,1424,demonhunter,havoc,193,95,98
Slaanesh,xavius,1423,demonhunter,havoc,23,16,7
Baileeh,blackmoore,1423,demonhunter,havoc,30,19,11
Adapterinput,auchindoun,1423,demonhunter,havoc,114,62,52
Philona,die-aldor,1423,demonhunter,havoc,158,83,75
Culywurly,silvermoon,1423,demonhunter,havoc,60,28,32
Nyxxeria,drakthul,1423,demonhunter,havoc,39,16,23
Тарапынька,gordunni,1422,demonhunter,havoc,128,72,56
Obitum,burning-legion,1422,demonhunter,havoc,101,56,45
Lawus,blackhand,1422,demonhunter,havoc,30,15,15
Enhtailo,draenor,1421,demonhunter,havoc,24,15,9
Azaeel,blackhand,1421,demonhunter,havoc,30,15,15
Tayo,dun-modr,1421,demonhunter,havoc,71,35,36
Cheethless,ragnaros,1420,demonhunter,havoc,54,29,25
Келадор,soulflayer,1420,demonhunter,havoc,95,44,51
Ibeem,dentarg,1419,demonhunter,havoc,57,37,20
Иллиферрат,blackscar,1419,demonhunter,havoc,104,53,51
Эллий,blackscar,1419,demonhunter,havoc,36,15,21
Aphulucky,kazzak,1418,demonhunter,havoc,48,21,27
Biü,tarren-mill,1418,demonhunter,havoc,42,16,26
Ihløøx,minahonda,1416,demonhunter,havoc,60,30,30
Jazhz,dalaran,1415,demonhunter,havoc,36,17,19
Alury,blackrock,1414,demonhunter,havoc,78,41,37
Felcaller,sylvanas,1414,demonhunter,havoc,65,34,31
Sarrabulho,magtheridon,1414,demonhunter,havoc,48,25,23
Demogen,sylvanas,1413,demonhunter,havoc,78,44,34
Havocnslash,ragnaros,1411,demonhunter,havoc,42,23,19
Illiada,spinebreaker,1411,demonhunter,havoc,30,15,15
Itàchì,kazzak,1410,demonhunter,havoc,24,15,9
Knmdemon,draenor,1407,demonhunter,havoc,30,15,15
Luzifer,ambossar,1406,demonhunter,havoc,147,77,70
Kanéki,sylvanas,1405,demonhunter,havoc,29,22,7
Demonade,ravencrest,1404,demonhunter,havoc,42,21,21
Choclatballs,stormscale,1404,demonhunter,havoc,125,59,66
Saleny,blackrock,1404,demonhunter,havoc,36,15,21
Garretos,senjin,1403,demonhunter,havoc,31,22,9
Cayssaelle,argent-dawn,1403,demonhunter,havoc,30,15,15
Кейсимег,soulflayer,1402,demonhunter,havoc,50,25,25
Vaynahi,grim-batol,1401,demonhunter,havoc,72,36,36
Albunico,draenor,1400,demonhunter,havoc,141,73,68
Дикаяособа,howling-fjord,1400,demonhunter,havoc,63,32,31
Mareen,pozzo-delleternità,1400,demonhunter,havoc,42,21,21
Tapio,burning-legion,1400,demonhunter,havoc,42,16,26
Деструкцыя,howling-fjord,1399,demonhunter,havoc,45,24,21
Тириола,howling-fjord,1398,demonhunter,havoc,36,20,16
Åelita,burning-legion,1398,demonhunter,havoc,34,17,17
Экселия,howling-fjord,1397,demonhunter,havoc,60,32,28
Razziyel,ragnaros,1396,demonhunter,havoc,41,21,20
Дартарин,gordunni,1395,demonhunter,havoc,62,34,28
Aååááååââåâå,arygos,1394,demonhunter,havoc,24,15,9
Jedbrazander,ragnaros,1394,demonhunter,havoc,30,15,15
Ämi,blackmoore,1394,demonhunter,havoc,112,55,57
Immune,aegwynn,1394,demonhunter,havoc,36,17,19
Бичерезх,soulflayer,1393,demonhunter,havoc,48,27,21
Харольд,deepholm,1392,demonhunter,havoc,76,38,38
Demonsqueezy,nemesis,1389,demonhunter,havoc,34,21,13
Thugrøse,blackrock,1389,demonhunter,havoc,126,63,63
Skyborn,tarren-mill,1386,demonhunter,havoc,27,16,11
Коньх,goldrinn,1386,demonhunter,havoc,71,31,40
Tyhaxx,ravencrest,1384,demonhunter,havoc,54,24,30
Hatemrankone,outland,1383,demonhunter,havoc,51,23,28
Toddsnuggles,thrall,1382,demonhunter,havoc,42,25,17
Cptxo,tarren-mill,1382,demonhunter,havoc,35,16,19
Äzräël,dun-modr,1382,demonhunter,havoc,54,22,32
Darrkdemon,kazzak,1381,demonhunter,havoc,258,125,133
Ziplar,tarren-mill,1379,demonhunter,havoc,60,30,30
Imlegalblind,ragnaros,1378,demonhunter,havoc,85,37,48
Keanujeeves,dentarg,1376,demonhunter,havoc,60,33,27
Daemonai,neptulon,1376,demonhunter,havoc,66,35,31
Дэйнни,blackscar,1374,demonhunter,havoc,48,21,27
Adalya,stormrage,1373,demonhunter,havoc,82,35,47
Даблкорк,soulflayer,1372,demonhunter,havoc,119,68,51
Sayee,drakthul,1371,demonhunter,havoc,30,19,11
Pówèr,ravencrest,1371,demonhunter,havoc,54,29,25
Tkr,zuljin,1371,demonhunter,havoc,108,56,52
Flaybalbooll,ragnaros,1371,demonhunter,havoc,191,97,94
Anstict,kazzak,1371,demonhunter,havoc,48,22,26
Bloodconte,darksorrow,1369,demonhunter,havoc,28,17,11
Error,ravencrest,1369,demonhunter,havoc,34,16,18
Súrinox,blackrock,1367,demonhunter,havoc,83,48,35
Icelucard,argent-dawn,1367,demonhunter,havoc,75,38,37
Seyran,silvermoon,1367,demonhunter,havoc,30,15,15
Dbolmami,twisting-nether,1366,demonhunter,havoc,22,15,7
Sakumi,azshara,1366,demonhunter,havoc,169,75,94
Poutanaola,twisting-nether,1365,demonhunter,havoc,30,15,15
Shirra,shadowsong,1364,demonhunter,havoc,32,15,17
Ikari,neptulon,1363,demonhunter,havoc,47,28,19
Алькирена,howling-fjord,1363,demonhunter,havoc,30,16,14
Nezruslfive,dun-modr,1361,demonhunter,havoc,36,18,18
Dyamo,sylvanas,1361,demonhunter,havoc,425,206,219
Adraelia,archimonde,1360,demonhunter,havoc,51,29,22
Флеркенкот,galakrond,1360,demonhunter,havoc,220,124,96
Easywaay,kazzak,1358,demonhunter,havoc,79,40,39
Stellarvore,nemesis,1358,demonhunter,havoc,90,39,51
Wrakdh,archimonde,1355,demonhunter,havoc,56,34,22
Coniras,dun-morogh,1355,demonhunter,havoc,36,15,21
Byakugaan,drakthul,1353,demonhunter,havoc,48,29,19
Impatìence,tarren-mill,1351,demonhunter,havoc,36,15,21
Kamaz,twisting-nether,1350,demonhunter,havoc,45,22,23
Агрочика,borean-tundra,1349,demonhunter,havoc,36,16,20
Natazia,eredar,1345,demonhunter,havoc,84,45,39
Thalamis,kazzak,1345,demonhunter,havoc,75,33,42
Flowen,stormreaver,1343,demonhunter,havoc,54,25,29
Ларэгар,azuregos,1343,demonhunter,havoc,70,28,42
Moonbeàm,kazzak,1343,demonhunter,havoc,48,18,30
Varedisa,kazzak,1342,demonhunter,havoc,59,27,32
Illídana,azjolnerub,1340,demonhunter,havoc,62,32,30
Itheos,kazzak,1339,demonhunter,havoc,178,88,90
Rehagen,ysondre,1339,demonhunter,havoc,36,14,22
Baddxd,ragnaros,1338,demonhunter,havoc,26,15,11
Нейроуз,howling-fjord,1338,demonhunter,havoc,154,82,72
Сильверган,soulflayer,1337,demonhunter,havoc,192,100,92
Dhogge,emerald-dream,1337,demonhunter,havoc,36,14,22
Miscóde,twisting-nether,1336,demonhunter,havoc,30,14,16
Aryuna,frostwolf,1335,demonhunter,havoc,36,21,15
Balsza,burning-legion,1335,demonhunter,havoc,54,26,28
Kainenn,silvermoon,1335,demonhunter,havoc,60,26,34
Hawoc,chamber-of-aspects,1334,demonhunter,havoc,42,26,16
Sadzari,burning-legion,1333,demonhunter,havoc,24,14,10
Freylis,burning-legion,1332,demonhunter,havoc,26,14,12
Orochimaruu,kargath,1332,demonhunter,havoc,63,22,41
Irenzy,twisting-nether,1331,demonhunter,havoc,30,14,16
Beerseewälk,ragnaros,1331,demonhunter,havoc,76,34,42
Notcrashy,eredar,1329,demonhunter,havoc,35,22,13
Checakore,argent-dawn,1329,demonhunter,havoc,66,34,32
Ðraudræm,ravencrest,1329,demonhunter,havoc,83,39,44
Иланари,gordunni,1328,demonhunter,havoc,23,16,7
Maryjane,nordrassil,1328,demonhunter,havoc,60,39,21
Шмальнуть,gordunni,1327,demonhunter,havoc,57,25,32
Kiirtach,dun-modr,1326,demonhunter,havoc,21,15,6
Naïtipa,arathi,1326,demonhunter,havoc,36,14,22
Adroenz,twisting-nether,1325,demonhunter,havoc,48,22,26
Dirtydoggy,dun-modr,1324,demonhunter,havoc,30,14,16
Егордемон,soulflayer,1323,demonhunter,havoc,46,25,21
Iaml,ravencrest,1323,demonhunter,havoc,67,32,35
Aedilles,ravencrest,1322,demonhunter,havoc,24,14,10
Destructs,sylvanas,1321,demonhunter,havoc,67,33,34
Kâtsulol,ysondre,1321,demonhunter,havoc,30,14,16
Tharysan,sanguino,1320,demonhunter,havoc,48,31,17
Séphrióth,frostwolf,1320,demonhunter,havoc,30,14,16
Bohchín,zuljin,1319,demonhunter,havoc,24,14,10
Demonpun,the-venture-co,1318,demonhunter,havoc,40,22,18
Valendriel,archimonde,1318,demonhunter,havoc,54,29,25
Ragnirok,deathwing,1318,demonhunter,havoc,138,66,72
Felleaf,ragnaros,1318,demonhunter,havoc,58,24,34
Watchmepoop,stormscale,1315,demonhunter,havoc,24,15,9
Yäkku,drakthul,1315,demonhunter,havoc,66,26,40
Seedor,archimonde,1314,demonhunter,havoc,68,32,36
Yvrig,eredar,1313,demonhunter,havoc,24,14,10
Бропинг,soulflayer,1313,demonhunter,havoc,123,66,57
Obey,exodar,1312,demonhunter,havoc,47,22,25
Délyria,blackhand,1311,demonhunter,havoc,54,32,22
Jayhan,chamber-of-aspects,1311,demonhunter,havoc,68,37,31
Bestdemon,tarren-mill,1311,demonhunter,havoc,39,20,19
Demozzer,ravencrest,1310,demonhunter,havoc,61,34,27
Ilyerias,twisting-nether,1310,demonhunter,havoc,78,32,46
Мицлейн,gordunni,1309,demonhunter,havoc,57,21,36
Ricmorphis,grim-batol,1309,demonhunter,havoc,41,14,27
Sinninse,blackmoore,1308,demonhunter,havoc,30,18,12
Zephyrê,blackrock,1308,demonhunter,havoc,96,47,49
Slowcuzclick,stormscale,1307,demonhunter,havoc,85,44,41
Luckertwo,tarren-mill,1307,demonhunter,havoc,109,55,54
Дисофи,soulflayer,1307,demonhunter,havoc,64,29,35
Thëos,argent-dawn,1305,demonhunter,havoc,91,46,45
Breezzdh,twisting-nether,1305,demonhunter,havoc,29,14,15
Lexim,khaz-modan,1303,demonhunter,havoc,66,36,30
Каралас,soulflayer,1301,demonhunter,havoc,36,21,15
Demonguard,draenor,1299,demonhunter,havoc,64,35,29
Bläckdëvïl,uldum,1298,demonhunter,havoc,49,30,19
Demonicrage,burning-legion,1297,demonhunter,havoc,26,15,11
Bicskas,ragnaros,1296,demonhunter,havoc,45,19,26
Muharaar,ravencrest,1295,demonhunter,havoc,22,15,7
Ávto,stormscale,1294,demonhunter,havoc,59,37,22
Сумърак,grom,1294,demonhunter,havoc,84,40,44
Soca,ysondre,1294,demonhunter,havoc,66,29,37
Demonk,nemesis,1290,demonhunter,havoc,75,40,35
Coltender,drakthul,1290,demonhunter,havoc,73,34,39
Chaosfist,blackrock,1288,demonhunter,havoc,48,21,27
Féileacán,kazzak,1286,demonhunter,havoc,48,20,28
Momochi,silvermoon,1285,demonhunter,havoc,24,14,10
Wauway,ragnaros,1285,demonhunter,havoc,44,21,23
Тонниданза,howling-fjord,1284,demonhunter,havoc,220,110,110
Billidan,eredar,1282,demonhunter,havoc,54,25,29
Ozeey,draenor,1280,demonhunter,havoc,29,14,15
Symbul,blackrock,1279,demonhunter,havoc,42,19,23
Cassitä,chogall,1278,demonhunter,havoc,48,24,24
Полетела,gordunni,1278,demonhunter,havoc,30,15,15
Antrixa,ravencrest,1278,demonhunter,havoc,29,14,15
Khalestya,shendralar,1278,demonhunter,havoc,90,39,51
Kaizzy,twisting-nether,1276,demonhunter,havoc,119,62,57
Juha,bronze-dragonflight,1274,demonhunter,havoc,45,28,17
Manga,aegwynn,1274,demonhunter,havoc,60,25,35
Gwx,draenor,1274,demonhunter,havoc,54,20,34
Pleskdh,malganis,1272,demonhunter,havoc,54,23,31
Louloulou,aegwynn,1271,demonhunter,havoc,123,65,58
Illidanio,xavius,1271,demonhunter,havoc,30,14,16
Konoth,kirin-tor,1268,demonhunter,havoc,42,23,19
Scotcheggs,argent-dawn,1267,demonhunter,havoc,38,16,22
Minutte,twisting-nether,1265,demonhunter,havoc,48,27,21
Gamaö,khaz-modan,1265,demonhunter,havoc,41,16,25
Sua,outland,1264,demonhunter,havoc,85,42,43
Gurvan,kazzak,1263,demonhunter,havoc,71,35,36
Никкэс,gordunni,1263,demonhunter,havoc,30,14,16
Æroa,antonidas,1262,demonhunter,havoc,35,19,16
Schonevrouw,aszune,1261,demonhunter,havoc,48,29,19
Khamzath,blackhand,1261,demonhunter,havoc,48,27,21
Ðarckjojo,hyjal,1260,demonhunter,havoc,41,18,23
Hirbs,silvermoon,1257,demonhunter,havoc,78,35,43
Chapzi,ragnaros,1256,demonhunter,havoc,51,26,25
Жемчужинка,eversong,1256,demonhunter,havoc,35,16,19
Lùcîfer,hellfire,1255,demonhunter,havoc,77,38,39
Nasghul,drakthul,1255,demonhunter,havoc,54,23,31
Száraz,ragnaros,1254,demonhunter,havoc,42,14,28
Hellboii,kilrogg,1253,demonhunter,havoc,63,39,24
Lozakum,draenor,1252,demonhunter,havoc,114,55,59
Schahmiran,kargath,1252,demonhunter,havoc,30,14,16
Jahannam,ysondre,1251,demonhunter,havoc,66,31,35
Anödyth,kirin-tor,1251,demonhunter,havoc,45,20,25
Norac,silvermoon,1248,demonhunter,havoc,41,16,25
Necorinex,silvermoon,1247,demonhunter,havoc,18,13,5
Rùkîbazùkï,ravencrest,1247,demonhunter,havoc,18,13,5
Abuelodosaka,dun-modr,1247,demonhunter,havoc,24,13,11
Nstea,cthun,1247,demonhunter,havoc,24,13,11
Нереалочка,blackscar,1247,demonhunter,havoc,24,13,11
Fróstdh,ravencrest,1247,demonhunter,havoc,30,13,17
Тэлэсык,gordunni,1247,demonhunter,havoc,36,15,21
Embruixada,sanguino,1246,demonhunter,havoc,58,34,24
Zernoid,kazzak,1246,demonhunter,havoc,24,13,11
Weback,ravencrest,1246,demonhunter,havoc,30,13,17
Saehila,kirin-tor,1246,demonhunter,havoc,53,21,32
Illidrax,outland,1245,demonhunter,havoc,36,13,23
Jotaros,ravencrest,1245,demonhunter,havoc,36,13,23
Dedemøn,ysondre,1243,demonhunter,havoc,24,13,11
Kimberleh,doomhammer,1243,demonhunter,havoc,24,13,11
Asmedios,twisting-nether,1243,demonhunter,havoc,416,211,205
Demonpegasus,draenor,1243,demonhunter,havoc,30,13,17
Allosa,argent-dawn,1243,demonhunter,havoc,30,13,17
Håssan,ravencrest,1242,demonhunter,havoc,24,13,11
Meleidar,kazzak,1242,demonhunter,havoc,30,13,17
Порядокх,soulflayer,1240,demonhunter,havoc,24,14,10
Mooty,drekthar,1240,demonhunter,havoc,24,13,11
Nidorino,aegwynn,1240,demonhunter,havoc,30,13,17
Блъя,gordunni,1240,demonhunter,havoc,30,13,17
Kãzïn,archimonde,1240,demonhunter,havoc,30,13,17
Кавайтити,howling-fjord,1239,demonhunter,havoc,24,13,11
Waviel,burning-legion,1239,demonhunter,havoc,29,14,15
Zejza,ragnaros,1238,demonhunter,havoc,43,19,24
Jugøbænned,blackrock,1236,demonhunter,havoc,18,13,5
Xellnaga,twisting-nether,1236,demonhunter,havoc,38,18,20
Полутемный,howling-fjord,1235,demonhunter,havoc,24,13,11
Nekkëtsu,archimonde,1235,demonhunter,havoc,24,13,11
Maltok,ysondre,1235,demonhunter,havoc,49,25,24
Demonjay,stormscale,1233,demonhunter,havoc,28,14,14
Эридали,gordunni,1233,demonhunter,havoc,90,42,48
Goatcorpse,blackmoore,1233,demonhunter,havoc,30,14,16
Titanslayyer,azjolnerub,1233,demonhunter,havoc,30,13,17
Даргсайд,gordunni,1230,demonhunter,havoc,77,34,43
Lydaro,malganis,1229,demonhunter,havoc,18,13,5
Djaris,ghostlands,1228,demonhunter,havoc,18,13,5
Isp,kazzak,1227,demonhunter,havoc,36,14,22
Mojois,ravenholdt,1225,demonhunter,havoc,81,46,35
Даудаев,gordunni,1225,demonhunter,havoc,36,19,17
Sindweller,arathi,1225,demonhunter,havoc,36,14,22
Shreddern,ragnaros,1224,demonhunter,havoc,31,14,17
Zyasea,blackmoore,1223,demonhunter,havoc,60,21,39
Кайриель,gordunni,1222,demonhunter,havoc,24,13,11
Dârhma,archimonde,1221,demonhunter,havoc,29,18,11
Лолбичьпро,blackscar,1221,demonhunter,havoc,30,16,14
Овецловец,deathguard,1220,demonhunter,havoc,24,13,11
Реалистик,deathweaver,1219,demonhunter,havoc,79,33,46
Giace,drakthul,1219,demonhunter,havoc,60,25,35
Нксин,howling-fjord,1218,demonhunter,havoc,30,14,16
Dmgchris,sylvanas,1218,demonhunter,havoc,36,13,23
Quakes,pozzo-delleternità,1217,demonhunter,havoc,36,19,17
Осхимс,deathguard,1215,demonhunter,havoc,36,21,15
Fruttidimare,frostwolf,1214,demonhunter,havoc,93,41,52
Betråyêr,draenor,1213,demonhunter,havoc,38,15,23
Heàvic,outland,1210,demonhunter,havoc,57,32,25
Kladius,skullcrusher,1210,demonhunter,havoc,27,15,12
Medievils,silvermoon,1209,demonhunter,havoc,60,22,38
Jyzu,festung-der-stürme,1209,demonhunter,havoc,36,13,23
Chancelvie,outland,1208,demonhunter,havoc,34,14,20
Bessus,aggra-português,1207,demonhunter,havoc,48,24,24
Ìllídán,ravencrest,1205,demonhunter,havoc,80,41,39
Demonzeus,sylvanas,1203,demonhunter,havoc,56,30,26
Trekxx,ragnaros,1203,demonhunter,havoc,36,16,20
Bøøgý,silvermoon,1202,demonhunter,havoc,54,24,30
Isila,alakir,1202,demonhunter,havoc,89,33,56
Самуройд,gordunni,1199,demonhunter,havoc,42,18,24
Camilysu,perenolde,1199,demonhunter,havoc,35,13,22
Vozol,stormscale,1195,demonhunter,havoc,30,20,10
Shytan,tarren-mill,1195,demonhunter,havoc,33,14,19
Hellarious,ragnaros,1195,demonhunter,havoc,72,30,42
Demonronin,the-maelstrom,1194,demonhunter,havoc,74,38,36
Nanocsika,twisting-nether,1194,demonhunter,havoc,131,63,68
Дитяхаоса,howling-fjord,1194,demonhunter,havoc,60,24,36
Dämokröte,ambossar,1192,demonhunter,havoc,36,21,15
Stringsz,ragnaros,1190,demonhunter,havoc,70,43,27
Kélida,dun-modr,1190,demonhunter,havoc,33,13,20
Danedemlia,magtheridon,1189,demonhunter,havoc,55,25,30
Aûrelian,kragjin,1189,demonhunter,havoc,33,15,18
Marmotaa,ragnaros,1188,demonhunter,havoc,67,31,36
Leloine,trollbane,1185,demonhunter,havoc,51,30,21
Hawek,madmortem,1184,demonhunter,havoc,58,33,25
Claere,blackhand,1184,demonhunter,havoc,87,45,42
Dämonbumm,blackmoore,1183,demonhunter,havoc,22,13,9
Demonligos,draenor,1183,demonhunter,havoc,72,36,36
Artexxen,kazzak,1182,demonhunter,havoc,42,14,28
Uthinare,silvermoon,1179,demonhunter,havoc,32,14,18
Tokoloshë,ragnaros,1177,demonhunter,havoc,54,27,27
Øutsider,blackmoore,1174,demonhunter,havoc,78,34,44
Munja,hyjal,1173,demonhunter,havoc,208,106,102
Эндимэн,soulflayer,1172,demonhunter,havoc,44,24,20
Моуровани,eversong,1172,demonhunter,havoc,30,16,14
Самфор,soulflayer,1172,demonhunter,havoc,84,41,43
Änyä,ravencrest,1171,demonhunter,havoc,28,13,15
Гневныймомон,soulflayer,1168,demonhunter,havoc,76,38,38
Kiriall,blackmoore,1166,demonhunter,havoc,78,36,42
Oxydh,ravencrest,1165,demonhunter,havoc,28,13,15
Люцифэйль,gordunni,1165,demonhunter,havoc,50,23,27
Shizá,burning-legion,1165,demonhunter,havoc,86,39,47
Lagordin,aggramar,1161,demonhunter,havoc,18,14,4
Athoribos,silvermoon,1160,demonhunter,havoc,60,32,28
Letidyr,ravencrest,1158,demonhunter,havoc,54,17,37
Zayl,defias-brotherhood,1157,demonhunter,havoc,38,13,25
Wréckful,ravencrest,1155,demonhunter,havoc,48,17,31
Itsukix,stormscale,1153,demonhunter,havoc,36,21,15
Folygale,outland,1152,demonhunter,havoc,18,12,6
Sarissa,dun-modr,1152,demonhunter,havoc,30,16,14
Аоешный,howling-fjord,1152,demonhunter,havoc,24,12,12
Makri,outland,1151,demonhunter,havoc,52,26,26
Vaiprix,ragnaros,1151,demonhunter,havoc,24,12,12
Hagana,tirion,1151,demonhunter,havoc,24,12,12
Ricedh,blackhand,1151,demonhunter,havoc,24,12,12
Onlyw,ravencrest,1150,demonhunter,havoc,17,13,4
Azzinoth,outland,1150,demonhunter,havoc,57,20,37
Kerog,blackmoore,1149,demonhunter,havoc,18,12,6
Seleverkauft,antonidas,1149,demonhunter,havoc,18,12,6
Spankoproof,kazzak,1149,demonhunter,havoc,18,12,6
Bigboychaos,twisting-nether,1149,demonhunter,havoc,36,19,17
Teoma,hyjal,1149,demonhunter,havoc,146,77,69
Bignugs,ravencrest,1149,demonhunter,havoc,30,12,18
Schøck,blackhand,1148,demonhunter,havoc,18,12,6
Maøu,hyjal,1147,demonhunter,havoc,24,12,12
Хирако,booty-bay,1147,demonhunter,havoc,24,12,12
Mèlfurion,hyjal,1147,demonhunter,havoc,97,42,55
Exceltor,sanguino,1147,demonhunter,havoc,36,12,24
Cielis,outland,1146,demonhunter,havoc,24,12,12
Satanmanna,twisting-nether,1145,demonhunter,havoc,30,12,18
Джигурдинец,gordunni,1144,demonhunter,havoc,30,17,13
Allalina,draenor,1144,demonhunter,havoc,60,33,27
Themen,ragnaros,1143,demonhunter,havoc,18,12,6
Viridisignis,silvermoon,1143,demonhunter,havoc,80,43,37
Téthis,uldaman,1143,demonhunter,havoc,78,34,44
Xellidan,dun-modr,1142,demonhunter,havoc,30,14,16
Ræko,sanguino,1142,demonhunter,havoc,30,12,18
Anandria,blutkessel,1140,demonhunter,havoc,71,42,29
Azn,twisting-nether,1140,demonhunter,havoc,24,12,12
Yuka,earthen-ring,1140,demonhunter,havoc,42,20,22
Azkerash,draenor,1140,demonhunter,havoc,54,20,34
Сангвиннус,howling-fjord,1139,demonhunter,havoc,23,13,10
Lilithxz,blackmoore,1139,demonhunter,havoc,24,12,12
Fotmfgt,eredar,1139,demonhunter,havoc,24,12,12
Dreggath,doomhammer,1139,demonhunter,havoc,59,29,30
Тушино,lich-king,1135,demonhunter,havoc,18,12,6
Гарражж,howling-fjord,1135,demonhunter,havoc,24,12,12
Basiliskus,argent-dawn,1134,demonhunter,havoc,30,12,18
Pichkachu,sylvanas,1129,demonhunter,havoc,24,12,12
Gurthalak,alakir,1129,demonhunter,havoc,35,14,21
Giboo,emerald-dream,1127,demonhunter,havoc,18,12,6
Liisza,blackhand,1124,demonhunter,havoc,18,12,6
Picotea,argent-dawn,1124,demonhunter,havoc,18,12,6
Vio,jaedenar,1124,demonhunter,havoc,60,36,24
Арат,ashenvale,1122,demonhunter,havoc,18,12,6
Jnfd,outland,1118,demonhunter,havoc,32,13,19
Sharhan,sylvanas,1118,demonhunter,havoc,42,16,26
Vaenil,hyjal,1118,demonhunter,havoc,41,14,27
Aloii,kazzak,1116,demonhunter,havoc,30,13,17
Youjosenki,magtheridon,1111,demonhunter,havoc,23,15,8
Zulthealbino,tarren-mill,1110,demonhunter,havoc,20,13,7
Zengor,twilights-hammer,1109,demonhunter,havoc,28,14,14
Мотек,howling-fjord,1109,demonhunter,havoc,120,57,63
Tatsukiyuzu,hyjal,1107,demonhunter,havoc,48,32,16
Roostidh,shattered-hand,1103,demonhunter,havoc,54,30,24
Metadel,outland,1103,demonhunter,havoc,163,86,77
Shadowkick,archimonde,1103,demonhunter,havoc,204,102,102
Нохелет,deepholm,1102,demonhunter,havoc,181,94,87
Mcsmackface,hellfire,1102,demonhunter,havoc,54,19,35
Scarebearz,outland,1100,demonhunter,havoc,66,34,32
Айвэнгос,thermaplugg,1097,demonhunter,havoc,61,35,26
Twistyy,drakthul,1097,demonhunter,havoc,72,41,31
Glavesong,burning-legion,1096,demonhunter,havoc,21,13,8
Darkustos,blackrock,1096,demonhunter,havoc,26,14,12
Biànca,outland,1096,demonhunter,havoc,34,13,21
Petefile,kazzak,1094,demonhunter,havoc,24,13,11
Зографос,fordragon,1094,demonhunter,havoc,25,13,12
Аллилания,fordragon,1092,demonhunter,havoc,50,32,18
Kebiz,ragnaros,1090,demonhunter,havoc,23,12,11
Eranduur,draenor,1088,demonhunter,havoc,24,13,11
Âkazza,archimonde,1086,demonhunter,havoc,26,12,14
Marsterkush,malygos,1086,demonhunter,havoc,36,16,20
Fikyx,draenor,1086,demonhunter,havoc,50,20,30
Илизарнный,gordunni,1085,demonhunter,havoc,30,13,17
Azazelkw,ragnaros,1084,demonhunter,havoc,66,34,32
Thegamesucks,ravencrest,1084,demonhunter,havoc,214,104,110
Дронкрылатый,soulflayer,1084,demonhunter,havoc,36,15,21
Дэрзлорд,fordragon,1082,demonhunter,havoc,23,12,11
Iaozh,culte-de-la-rive-noire,1082,demonhunter,havoc,30,12,18
Stonebanker,turalyon,1079,demonhunter,havoc,23,14,9
Typhoonxq,tarren-mill,1078,demonhunter,havoc,41,21,20
Lögan,uldum,1078,demonhunter,havoc,36,16,20
Sgravo,nemesis,1077,demonhunter,havoc,18,12,6
Dadicek,drakthul,1069,demonhunter,havoc,18,12,6
Asporos,pozzo-delleternità,1067,demonhunter,havoc,31,12,19
Scurenzio,outland,1065,demonhunter,havoc,42,24,18
Sombessat,tarren-mill,1064,demonhunter,havoc,24,12,12
Venøøm,eldrethalas,1064,demonhunter,havoc,108,49,59
Gabquist,argent-dawn,1063,demonhunter,havoc,47,25,22
Yousif,stormscale,1062,demonhunter,havoc,61,29,32
Noctilucent,executus,1061,demonhunter,havoc,90,49,41
Стрепа,grom,1061,demonhunter,havoc,29,15,14
Grazilo,outland,1061,demonhunter,havoc,32,13,19
Aamonath,tarren-mill,1060,demonhunter,havoc,36,20,16
Makkivar,terenas,1060,demonhunter,havoc,36,15,21
Prismio,ysondre,1059,demonhunter,havoc,21,12,9
Alkann,chogall,1057,demonhunter,havoc,29,15,14
Happykx,draenor,1056,demonhunter,havoc,12,11,1
Диджейвжух,gordunni,1056,demonhunter,havoc,18,11,7
Ayyo,agamaggan,1056,demonhunter,havoc,24,11,13
Véin,stormscale,1056,demonhunter,havoc,30,11,19
Dhlee,ravencrest,1055,demonhunter,havoc,18,11,7
Kakashî,darksorrow,1055,demonhunter,havoc,18,11,7
Draqula,ravencrest,1055,demonhunter,havoc,24,11,13
Onizukadh,archimonde,1055,demonhunter,havoc,24,11,13
Newgens,kazzak,1055,demonhunter,havoc,24,11,13
Suitcåséguy,ravencrest,1055,demonhunter,havoc,30,11,19
Skippydemon,nozdormu,1055,demonhunter,havoc,30,11,19
Кайренсс,howling-fjord,1055,demonhunter,havoc,30,11,19
Ohshietwadap,twisting-nether,1055,demonhunter,havoc,30,11,19
Шизванаденс,gordunni,1054,demonhunter,havoc,18,11,7
Mcfitty,stormscale,1054,demonhunter,havoc,18,11,7
Deocleo,draenor,1054,demonhunter,havoc,21,12,9
Mårcxb,blackhand,1054,demonhunter,havoc,24,11,13
Përry,archimonde,1054,demonhunter,havoc,24,11,13
Verybigdps,aegwynn,1054,demonhunter,havoc,24,11,13
Lyzzra,blackmoore,1054,demonhunter,havoc,24,11,13
Сочняга,gordunni,1054,demonhunter,havoc,30,11,19
Спииртт,blackscar,1054,demonhunter,havoc,36,11,25
Turbomenak,drakthul,1053,demonhunter,havoc,18,11,7
Fredoo,sylvanas,1053,demonhunter,havoc,20,11,9
Бистлайк,soulflayer,1053,demonhunter,havoc,24,11,13
Darktérror,silvermoon,1053,demonhunter,havoc,30,11,19
Никельдон,howling-fjord,1052,demonhunter,havoc,54,33,21
Шавермье,gordunni,1052,demonhunter,havoc,36,11,25
Bud,lightnings-blade,1051,demonhunter,havoc,18,11,7
Demonbean,stormscale,1051,demonhunter,havoc,22,12,10
Jyrpä,stormscale,1051,demonhunter,havoc,29,12,17
Squan,blackmoore,1050,demonhunter,havoc,20,12,8
Vìdhar,tarren-mill,1049,demonhunter,havoc,24,11,13
Zamp,deathwing,1049,demonhunter,havoc,30,11,19
Posterboy,tarren-mill,1048,demonhunter,havoc,18,11,7
Clexa,thrall,1047,demonhunter,havoc,24,11,13
Blisdon,argent-dawn,1046,demonhunter,havoc,60,27,33
Aminféryadi,twisting-nether,1046,demonhunter,havoc,30,11,19
Dèathless,pozzo-delleternità,1044,demonhunter,havoc,42,15,27
Calthmon,shattrath,1043,demonhunter,havoc,24,11,13
Badgyalriri,hyjal,1042,demonhunter,havoc,24,11,13
Yiùna,hyjal,1039,demonhunter,havoc,36,16,20
Estarloco,blackmoore,1038,demonhunter,havoc,36,19,17
Kaitlyyn,norgannon,1038,demonhunter,havoc,30,11,19
Sintoraz,amanthul,1035,demonhunter,havoc,50,30,20
Haýuken,kazzak,1035,demonhunter,havoc,24,13,11
Lightkick,archimonde,1034,demonhunter,havoc,36,23,13
Vaterdenke,defias-brotherhood,1032,demonhunter,havoc,18,11,7
Électrâs,archimonde,1032,demonhunter,havoc,50,21,29
Cirino,defias-brotherhood,1027,demonhunter,havoc,30,13,17
Ascanius,nemesis,1026,demonhunter,havoc,59,31,28
Aggerpain,draenor,1026,demonhunter,havoc,68,24,44
Aruzar,twisting-nether,1025,demonhunter,havoc,30,11,19
Cobayashi,der-mithrilorden,1023,demonhunter,havoc,38,21,17
Gigipletosu,ravencrest,1018,demonhunter,havoc,30,11,19
Sorowas,tichondrius,1015,demonhunter,havoc,30,17,13
Увиден,eversong,1015,demonhunter,havoc,92,44,48
Shirakava,quelthalas,1014,demonhunter,havoc,76,29,47
Milkeyes,ravencrest,1011,demonhunter,havoc,66,32,34
Nelairia,tarren-mill,1010,demonhunter,havoc,24,12,12
Aelita,twisting-nether,1006,demonhunter,havoc,96,53,43
Demontripo,silvermoon,1005,demonhunter,havoc,81,43,38
Solrosfrön,stormscale,1005,demonhunter,havoc,23,11,12
Delfee,twisting-nether,1005,demonhunter,havoc,54,25,29
Нотреди,howling-fjord,1004,demonhunter,havoc,30,17,13
Demonhyan,chants-éternels,1003,demonhunter,havoc,61,30,31
Pismanik,drakthul,1002,demonhunter,havoc,24,15,9
Ilidas,frostwolf,999,demonhunter,havoc,24,11,13
Vaco,la-croisade-écarlate,996,demonhunter,havoc,30,13,17
Nehmarath,doomhammer,995,demonhunter,havoc,36,11,25
Гарнаш,howling-fjord,993,demonhunter,havoc,60,30,30
Hunterston,twisting-nether,992,demonhunter,havoc,68,38,30
Siscia,outland,991,demonhunter,havoc,54,28,26
Zlett,draenor,990,demonhunter,havoc,22,11,11
Ànavar,twisting-nether,990,demonhunter,havoc,35,15,20
Piloudh,dalaran,989,demonhunter,havoc,22,11,11
Demonzeus,archimonde,985,demonhunter,havoc,25,12,13
Straizo,malganis,984,demonhunter,havoc,26,11,15
Silan,kiljaeden,972,demonhunter,havoc,29,16,13
Ladj,blackmoore,969,demonhunter,havoc,24,12,12
Огнод,gordunni,968,demonhunter,havoc,42,21,21
Êvê,blackmoore,962,demonhunter,havoc,22,12,10
Johncoffèy,ragnaros,960,demonhunter,havoc,12,10,2
Дианист,gordunni,960,demonhunter,havoc,16,11,5
Reckqqt,eredar,960,demonhunter,havoc,18,10,8
Izzidan,magtheridon,960,demonhunter,havoc,18,10,8
Antrix,ravencrest,960,demonhunter,havoc,18,10,8
Keýrañe,ragnaros,960,demonhunter,havoc,18,10,8
Narkiza,tarren-mill,960,demonhunter,havoc,18,10,8
Анхардх,gordunni,960,demonhunter,havoc,18,10,8
Ragefighterr,ragnaros,960,demonhunter,havoc,36,16,20
Krvckhead,hyjal,960,demonhunter,havoc,24,10,14
Iíïììïiíïìïï,alakir,960,demonhunter,havoc,24,10,14
Íamprepared,tarren-mill,960,demonhunter,havoc,30,10,20
Fishmicksh,twisting-nether,959,demonhunter,havoc,12,10,2
Völkswagen,dun-modr,959,demonhunter,havoc,18,10,8
Lucianloco,dun-morogh,959,demonhunter,havoc,18,10,8
Гранкрю,blackscar,959,demonhunter,havoc,18,10,8
Soysoyum,draenor,959,demonhunter,havoc,18,10,8
Qqski,kazzak,959,demonhunter,havoc,18,10,8
Катякрылышки,gordunni,959,demonhunter,havoc,18,10,8
Vayshi,turalyon,959,demonhunter,havoc,24,10,14
Demonicat,twisting-nether,959,demonhunter,havoc,24,10,14
Mollamaija,defias-brotherhood,959,demonhunter,havoc,24,10,14
Yumhip,dun-modr,959,demonhunter,havoc,24,10,14
Táti,blackrock,959,demonhunter,havoc,24,10,14
Darnke,silvermoon,959,demonhunter,havoc,30,10,20
Gandzsä,ragnaros,959,demonhunter,havoc,30,10,20
Sephiris,argent-dawn,958,demonhunter,havoc,19,11,8
Elenôy,malganis,958,demonhunter,havoc,18,10,8
Demonetized,blackrock,958,demonhunter,havoc,24,10,14
Дэйзиджонсон,soulflayer,958,demonhunter,havoc,24,10,14
Охотникн,howling-fjord,958,demonhunter,havoc,24,10,14
Critlerman,blackmoore,957,demonhunter,havoc,16,11,5
Skarvy,bronze-dragonflight,957,demonhunter,havoc,18,10,8
Kenzaii,aegwynn,957,demonhunter,havoc,24,10,14
Sèptember,draenor,957,demonhunter,havoc,30,10,20
Bobdh,twisting-nether,957,demonhunter,havoc,35,10,25
Nightglaives,twisting-nether,956,demonhunter,havoc,12,10,2
Drilloz,ravencrest,956,demonhunter,havoc,18,10,8
Такетомии,gordunni,956,demonhunter,havoc,24,10,14
Версомния,gordunni,956,demonhunter,havoc,24,10,14
Morphiyy,tarren-mill,955,demonhunter,havoc,18,10,8
Shadowweaver,earthen-ring,955,demonhunter,havoc,18,10,8
Morvash,nemesis,954,demonhunter,havoc,18,10,8
Noitradh,zuljin,954,demonhunter,havoc,21,11,10
Anklàr,blackrock,954,demonhunter,havoc,24,10,14
Карнавалыч,gordunni,954,demonhunter,havoc,96,35,61
Argnils,tarren-mill,953,demonhunter,havoc,12,10,2
Nuriia,arthas,953,demonhunter,havoc,54,30,24
Эфемерид,howling-fjord,953,demonhunter,havoc,18,10,8
Ravier,baelgun,953,demonhunter,havoc,75,39,36
Greedsmoke,kazzak,952,demonhunter,havoc,18,10,8
Цейн,azuregos,952,demonhunter,havoc,39,15,24
Илайора,galakrond,952,demonhunter,havoc,30,10,20
Pijvijie,shattrath,951,demonhunter,havoc,30,10,20
Годиксгёрл,gordunni,950,demonhunter,havoc,12,10,2
Иллидал,greymane,949,demonhunter,havoc,18,10,8
Alandrisz,argent-dawn,949,demonhunter,havoc,30,10,20
Mamazboy,lightnings-blade,946,demonhunter,havoc,18,10,8
Максаналл,soulflayer,944,demonhunter,havoc,18,10,8
Hannipham,silvermoon,944,demonhunter,havoc,21,11,10
Thorskinius,ravencrest,944,demonhunter,havoc,32,11,21
Jemoer,twisting-nether,942,demonhunter,havoc,25,15,10
Талона,fordragon,942,demonhunter,havoc,18,10,8
Nylaria,dethecus,940,demonhunter,havoc,18,10,8
Shishiro,alakir,937,demonhunter,havoc,24,10,14
Rockymarcia,archimonde,930,demonhunter,havoc,18,11,7
Winnztlol,chamber-of-aspects,927,demonhunter,havoc,36,17,19
Devilmonkey,ambossar,927,demonhunter,havoc,54,16,38
Zermut,culte-de-la-rive-noire,925,demonhunter,havoc,17,10,7
Byah,kazzak,924,demonhunter,havoc,115,48,67
Flamme,amanthul,923,demonhunter,havoc,30,16,14
Maßik,terokkar,922,demonhunter,havoc,21,11,10
Sinthetyx,quelthalas,917,demonhunter,havoc,36,19,17
Noire,zuljin,917,demonhunter,havoc,29,10,19
Фирулия,goldrinn,914,demonhunter,havoc,108,52,56
Andij,frostwolf,913,demonhunter,havoc,29,11,18
Taliaa,drakthul,911,demonhunter,havoc,21,10,11
Аллидариан,howling-fjord,910,demonhunter,havoc,23,10,13
Skylinex,dentarg,909,demonhunter,havoc,66,33,33
Манапарда,howling-fjord,909,demonhunter,havoc,35,10,25
Sìnbad,khaz-modan,908,demonhunter,havoc,24,14,10
Hicgidik,outland,905,demonhunter,havoc,24,11,13
Ataddcay,outland,901,demonhunter,havoc,45,16,29
Ejder,anubarak,900,demonhunter,havoc,66,26,40
Maurî,tarren-mill,895,demonhunter,havoc,26,10,16
Kroepoeks,mazrigos,894,demonhunter,havoc,30,16,14
Jamule,dun-morogh,889,demonhunter,havoc,36,15,21
Braserol,archimonde,881,demonhunter,havoc,38,12,26
Amionisiken,amanthul,873,demonhunter,havoc,25,10,15
Legionek,burning-blade,866,demonhunter,havoc,20,11,9
Lorcanmar,draenor,866,demonhunter,havoc,63,26,37
Paiz,grim-batol,864,demonhunter,havoc,12,9,3
Illidiangød,sanguino,864,demonhunter,havoc,12,9,3
Лфгнехиро,soulflayer,864,demonhunter,havoc,12,9,3
Fizzpep,eredar,864,demonhunter,havoc,12,9,3
Ittas,archimonde,864,demonhunter,havoc,18,9,9
Sghemon,pozzo-delleternità,864,demonhunter,havoc,18,9,9
Realtrance,sanguino,864,demonhunter,havoc,18,9,9
Toschadh,blackmoore,864,demonhunter,havoc,18,9,9
Saene,ravencrest,864,demonhunter,havoc,18,9,9
Raïley,archimonde,864,demonhunter,havoc,18,9,9
Notapistol,outland,864,demonhunter,havoc,18,9,9
Эридари,blackscar,864,demonhunter,havoc,18,9,9
Zophý,ragnaros,864,demonhunter,havoc,18,9,9
Thulânn,twisting-nether,864,demonhunter,havoc,18,9,9
Chosabreka,zuljin,864,demonhunter,havoc,18,9,9
Albdh,kazzak,864,demonhunter,havoc,24,9,15
Djaskmazi,archimonde,864,demonhunter,havoc,24,9,15
Fuseton,kazzak,864,demonhunter,havoc,24,9,15
Sunestaa,kazzak,863,demonhunter,havoc,12,9,3
Drunkendemon,frostwolf,863,demonhunter,havoc,12,9,3
Lennöx,silvermoon,863,demonhunter,havoc,13,9,4
Ììîîííììîîíí,tarren-mill,863,demonhunter,havoc,18,9,9
Сихая,howling-fjord,863,demonhunter,havoc,18,9,9
Neomicha,blackmoore,863,demonhunter,havoc,18,9,9
Illidaia,ravencrest,863,demonhunter,havoc,18,9,9
Sutures,ravencrest,863,demonhunter,havoc,18,9,9
Õmen,ravencrest,863,demonhunter,havoc,18,9,9
Lodjay,hyjal,863,demonhunter,havoc,18,9,9
Asylèm,draenor,863,demonhunter,havoc,18,9,9
Minadng,silvermoon,863,demonhunter,havoc,18,9,9
Watermelonqt,tarren-mill,863,demonhunter,havoc,18,9,9
Integer,tarren-mill,863,demonhunter,havoc,18,9,9
Кррюкс,gordunni,863,demonhunter,havoc,18,9,9
Finstergraf,blackmoore,863,demonhunter,havoc,36,17,19
Djdhh,draenor,863,demonhunter,havoc,20,9,11
Hialdoo,bladefist,863,demonhunter,havoc,24,9,15
Ðanizâ,aegwynn,863,demonhunter,havoc,24,9,15
Slizer,draenor,863,demonhunter,havoc,24,9,15
Zappikdh,silvermoon,862,demonhunter,havoc,18,9,9
Ðhgøðx,outland,862,demonhunter,havoc,18,9,9
Illidián,chamber-of-aspects,862,demonhunter,havoc,24,9,15
Demonstorpix,drakthul,862,demonhunter,havoc,24,9,15
Aeshalla,blackmoore,862,demonhunter,havoc,24,9,15
Tzklkn,sylvanas,861,demonhunter,havoc,12,9,3
Selénhe,silvermoon,861,demonhunter,havoc,18,9,9
Selcan,archimonde,861,demonhunter,havoc,18,9,9
Тэниан,gordunni,861,demonhunter,havoc,24,9,15
Sinorack,sargeras,860,demonhunter,havoc,18,9,9
Wrathill,draenor,860,demonhunter,havoc,24,9,15
Doobregeesy,burning-legion,859,demonhunter,havoc,21,10,11
Deadskill,alexstrasza,858,demonhunter,havoc,54,21,33
Keiti,drakthul,856,demonhunter,havoc,36,9,27
Bhuta,aerie-peak,855,demonhunter,havoc,18,9,9
Chrititia,blackmoore,852,demonhunter,havoc,24,9,15
Butcherr,ulduar,851,demonhunter,havoc,30,11,19
Dutchmadman,aerie-peak,848,demonhunter,havoc,79,37,42
Dântés,silvermoon,845,demonhunter,havoc,30,9,21
Besnik,stormscale,844,demonhunter,havoc,30,9,21
Heemaglobin,ravencrest,843,demonhunter,havoc,42,18,24
Winchesterxx,sanguino,842,demonhunter,havoc,24,9,15
Subelsiu,alakir,840,demonhunter,havoc,63,26,37
Fckmlf,outland,839,demonhunter,havoc,21,12,9
Backflipgødx,uldaman,832,demonhunter,havoc,22,9,13
Majînßûü,ravencrest,831,demonhunter,havoc,17,9,8
Devendora,antonidas,831,demonhunter,havoc,18,9,9
Toio,nemesis,831,demonhunter,havoc,24,9,15
Дантавул,gordunni,825,demonhunter,havoc,24,9,15
Daimon,pozzo-delleternità,813,demonhunter,havoc,21,10,11
Alfazar,pozzo-delleternità,801,demonhunter,havoc,74,23,51
Kundans,antonidas,799,demonhunter,havoc,18,10,8
Illidaniellé,tarren-mill,799,demonhunter,havoc,17,9,8
Blutox,antonidas,797,demonhunter,havoc,25,11,14
Deadhuntor,daggerspine,795,demonhunter,havoc,17,9,8
Dombra,kult-der-verdammten,788,demonhunter,havoc,11,9,2
Demonakis,twisting-nether,784,demonhunter,havoc,19,9,10
Кусьзакиску,soulflayer,781,demonhunter,havoc,22,9,13
Wèx,tarren-mill,768,demonhunter,havoc,12,8,4
Qweqweasd,outland,768,demonhunter,havoc,12,8,4
Smallnik,tarren-mill,768,demonhunter,havoc,12,8,4
Gixota,silvermoon,768,demonhunter,havoc,12,8,4
Синтвеив,soulflayer,768,demonhunter,havoc,12,8,4
Judditdhx,draenor,768,demonhunter,havoc,12,8,4
Snubbeldemon,outland,768,demonhunter,havoc,12,8,4
Dhamp,kazzak,768,demonhunter,havoc,12,8,4
Viodemon,blackrock,768,demonhunter,havoc,12,8,4
Eysndh,blackrock,768,demonhunter,havoc,12,8,4
Traumadh,tarren-mill,768,demonhunter,havoc,12,8,4
Sweåfy,outland,768,demonhunter,havoc,12,8,4
Mesini,darksorrow,768,demonhunter,havoc,12,8,4
Desdh,blackmoore,768,demonhunter,havoc,18,8,10
Praisethelrd,blackrock,768,demonhunter,havoc,18,8,10
Mvqdh,stormscale,768,demonhunter,havoc,18,8,10
Thestrength,twisting-nether,768,demonhunter,havoc,18,8,10
Nthday,draenor,768,demonhunter,havoc,18,8,10
Lolliance,talnivarr,768,demonhunter,havoc,18,8,10
Рензокукеен,gordunni,768,demonhunter,havoc,18,8,10
Stinkymonkey,pozzo-delleternità,768,demonhunter,havoc,18,8,10
Вирбль,gordunni,768,demonhunter,havoc,18,8,10
Ozu,blackrock,768,demonhunter,havoc,18,8,10
Demoan,outland,768,demonhunter,havoc,24,8,16
Rõb,magtheridon,768,demonhunter,havoc,24,8,16
Lilor,aegwynn,767,demonhunter,havoc,12,8,4
Эска,razuvious,767,demonhunter,havoc,12,8,4
Крикетгодх,howling-fjord,767,demonhunter,havoc,12,8,4
Ninetzqp,tarren-mill,767,demonhunter,havoc,12,8,4
Felsbane,argent-dawn,767,demonhunter,havoc,15,9,6
Yorxdh,eredar,767,demonhunter,havoc,15,9,6
Zmasteez,ahnqiraj,767,demonhunter,havoc,18,8,10
Tòd,silvermoon,767,demonhunter,havoc,18,8,10
Lifel,nemesis,767,demonhunter,havoc,18,8,10
Kithan,zuljin,767,demonhunter,havoc,18,8,10
Bamßi,ragnaros,767,demonhunter,havoc,18,8,10
Lilitlovesme,blackmoore,767,demonhunter,havoc,18,8,10
Paindemon,outland,767,demonhunter,havoc,18,8,10
Kouloukas,ragnaros,767,demonhunter,havoc,18,8,10
Shax,hellscream,767,demonhunter,havoc,18,8,10
Calendith,arathor,767,demonhunter,havoc,21,9,12
Salamihexler,dun-morogh,767,demonhunter,havoc,23,8,15
Luceafaru,draenor,767,demonhunter,havoc,24,8,16
Mëy,thrall,767,demonhunter,havoc,30,8,22
Skrelarent,argent-dawn,766,demonhunter,havoc,12,8,4
Мейьибейьи,howling-fjord,766,demonhunter,havoc,18,8,10
Nestrae,drakthul,766,demonhunter,havoc,18,8,10
Varthag,antonidas,766,demonhunter,havoc,18,8,10
Deathblades,twisting-nether,766,demonhunter,havoc,18,8,10
Neiden,deathwing,766,demonhunter,havoc,24,8,16
Akäly,hyjal,765,demonhunter,havoc,19,9,10
Mihaliana,argent-dawn,765,demonhunter,havoc,18,8,10
Gruusha,kazzak,765,demonhunter,havoc,18,8,10
Vvdh,ravencrest,765,demonhunter,havoc,22,9,13
Aelzeran,stormscale,765,demonhunter,havoc,24,8,16
Noxxi,gorgonnash,764,demonhunter,havoc,18,8,10
Ironjòe,eredar,764,demonhunter,havoc,18,8,10
Hupon,drakthul,764,demonhunter,havoc,18,8,10
Saìras,blackhand,763,demonhunter,havoc,18,8,10
Попкасиська,eversong,763,demonhunter,havoc,47,19,28
Covidian,kilrogg,762,demonhunter,havoc,12,8,4
Velgetox,blackrock,762,demonhunter,havoc,18,8,10
Daweeo,the-maelstrom,762,demonhunter,havoc,18,8,10
Unsainted,blackhand,762,demonhunter,havoc,18,8,10
Darksink,kazzak,762,demonhunter,havoc,18,8,10
Amaterasù,alleria,761,demonhunter,havoc,18,8,10
Lovzuu,draenor,759,demonhunter,havoc,12,8,4
Shnshon,kazzak,759,demonhunter,havoc,12,8,4
Цион,soulflayer,757,demonhunter,havoc,18,8,10
Meliòdas,draenor,757,demonhunter,havoc,25,8,17
Lailat,alexstrasza,752,demonhunter,havoc,16,9,7
Quavanity,sylvanas,735,demonhunter,havoc,17,8,9
Heiltgalen,grim-batol,734,demonhunter,havoc,14,9,5
Zealdancer,veknilash,734,demonhunter,havoc,17,8,9
Gushìñgwøuñð,blackmoore,719,demonhunter,havoc,11,8,3
Bezdna,stormrage,718,demonhunter,havoc,15,8,7
Judderzz,bronze-dragonflight,717,demonhunter,havoc,18,8,10
Makiu,archimonde,717,demonhunter,havoc,21,8,13
Amylia,perenolde,711,demonhunter,havoc,21,10,11
Liondam,pozzo-delleternità,696,demonhunter,havoc,24,8,16
Yeyote,dun-modr,695,demonhunter,havoc,15,10,5
Stixxs,archimonde,691,demonhunter,havoc,14,8,6
Maddificator,silvermoon,686,demonhunter,havoc,14,8,6
Магнисс,fordragon,685,demonhunter,havoc,14,8,6
Itzrazor,ravencrest,683,demonhunter,havoc,25,8,17
Prouser,turalyon,678,demonhunter,havoc,27,9,18
Herzbann,madmortem,676,demonhunter,havoc,19,8,11
Hanuta,alleria,672,demonhunter,havoc,12,7,5
Дезлее,gordunni,672,demonhunter,havoc,12,7,5
Ðevl,blackmoore,672,demonhunter,havoc,12,7,5
Eydipha,blackmoore,672,demonhunter,havoc,12,7,5
Verrottung,blackhand,672,demonhunter,havoc,12,7,5
Esadeáth,ravencrest,672,demonhunter,havoc,12,7,5
Karpandero,stormreaver,672,demonhunter,havoc,12,7,5
Illyriel,antonidas,672,demonhunter,havoc,12,7,5
Hextechz,stormscale,672,demonhunter,havoc,12,7,5
Heimnar,frostmane,672,demonhunter,havoc,12,7,5
Damnituther,kazzak,672,demonhunter,havoc,12,7,5
Lemiisa,burning-blade,672,demonhunter,havoc,12,7,5
Zmemroo,magtheridon,672,demonhunter,havoc,12,7,5
Lirigizel,hellscream,672,demonhunter,havoc,12,7,5
Crispychick,stormscale,672,demonhunter,havoc,12,7,5
Glevenuschii,blackmoore,672,demonhunter,havoc,12,7,5
Deadmaus,stormscale,672,demonhunter,havoc,12,7,5
Ronstoppable,ravencrest,672,demonhunter,havoc,12,7,5
Pepenger,kazzak,672,demonhunter,havoc,12,7,5
Kalachiquezz,kazzak,672,demonhunter,havoc,12,7,5
Alied,burning-blade,672,demonhunter,havoc,12,7,5
Teinzy,stormscale,672,demonhunter,havoc,12,7,5
Darkshadow,turalyon,672,demonhunter,havoc,12,7,5
Itsfinee,outland,672,demonhunter,havoc,12,7,5
Atrikagodx,kazzak,672,demonhunter,havoc,12,7,5
Gorinda,twisting-nether,672,demonhunter,havoc,12,7,5
Stonedaf,ravencrest,672,demonhunter,havoc,12,7,5
Evul,blackmoore,672,demonhunter,havoc,12,7,5
Chaosknight,outland,672,demonhunter,havoc,12,7,5
Styxdh,blackhand,672,demonhunter,havoc,12,7,5
Dêyza,archimonde,672,demonhunter,havoc,12,7,5
Exoduss,ravencrest,672,demonhunter,havoc,12,7,5
Caronte,los-errantes,672,demonhunter,havoc,12,7,5
Satti,sargeras,672,demonhunter,havoc,18,7,11
Ayimprepared,ragnaros,672,demonhunter,havoc,18,7,11
Chrístíe,sanguino,672,demonhunter,havoc,18,7,11
Demondulle,kazzak,672,demonhunter,havoc,18,7,11
Grazax,lightnings-blade,672,demonhunter,havoc,18,7,11
Charleyzard,argent-dawn,672,demonhunter,havoc,18,7,11
Daekon,ahnqiraj,672,demonhunter,havoc,18,7,11
Kruthor,taerar,672,demonhunter,havoc,18,7,11
Крикетх,soulflayer,672,demonhunter,havoc,18,7,11
Veryfunhaha,ravencrest,672,demonhunter,havoc,18,7,11
Opsidaisi,tarren-mill,672,demonhunter,havoc,18,7,11
Badess,malfurion,672,demonhunter,havoc,18,7,11
Pelko,sanguino,672,demonhunter,havoc,18,7,11
Reachfight,lothar,672,demonhunter,havoc,18,7,11
Neonishh,twisting-nether,672,demonhunter,havoc,18,7,11
Келидаррия,soulflayer,672,demonhunter,havoc,18,7,11
Hatabaa,argent-dawn,672,demonhunter,havoc,18,7,11
Wrathia,rexxar,672,demonhunter,havoc,18,7,11
Êlva,alleria,672,demonhunter,havoc,18,7,11
Størmrage,sanguino,672,demonhunter,havoc,18,7,11
Abigorien,blackmoore,672,demonhunter,havoc,18,7,11
Rybn,eredar,672,demonhunter,havoc,24,7,17
Iamayaqt,nemesis,672,demonhunter,havoc,24,7,17
Jokas,archimonde,672,demonhunter,havoc,24,7,17
Illidorie,twisting-nether,672,demonhunter,havoc,24,7,17
Paîmon,hyjal,672,demonhunter,havoc,24,7,17
Inflection,ravencrest,672,demonhunter,havoc,24,7,17
Vaimustus,outland,672,demonhunter,havoc,30,7,23
Рагнос,goldrinn,672,demonhunter,havoc,30,7,23
Karakas,drakthul,671,demonhunter,havoc,12,7,5
Nerfy,silvermoon,671,demonhunter,havoc,12,7,5
Randydhunt,draenor,671,demonhunter,havoc,12,7,5
Deqthstrïke,ysondre,671,demonhunter,havoc,12,7,5
Ddvh,drakthul,671,demonhunter,havoc,12,7,5
Elfmonger,ravencrest,671,demonhunter,havoc,12,7,5
Demonjagge,tarren-mill,671,demonhunter,havoc,12,7,5
Meji,ravencrest,671,demonhunter,havoc,12,7,5
Marcellaa,ravencrest,671,demonhunter,havoc,12,7,5
Youngboost,blackrock,671,demonhunter,havoc,12,7,5
Nxmpys,sanguino,671,demonhunter,havoc,12,7,5
Mirajen,dun-modr,671,demonhunter,havoc,12,7,5
Funclass,blackrock,671,demonhunter,havoc,12,7,5
Corelly,ragnaros,671,demonhunter,havoc,18,7,11
Moojdh,malganis,671,demonhunter,havoc,18,7,11
Rebelion,dun-modr,671,demonhunter,havoc,18,7,11
Norebb,sanguino,671,demonhunter,havoc,18,7,11
Abrahêll,dun-modr,671,demonhunter,havoc,18,7,11
Wårbÿ,ravencrest,671,demonhunter,havoc,18,7,11
Gearuzaki,ghostlands,671,demonhunter,havoc,18,7,11
Abendro,twisting-nether,671,demonhunter,havoc,18,7,11
Løkil,blackrock,671,demonhunter,havoc,18,7,11
Lîllîv,wrathbringer,671,demonhunter,havoc,18,7,11
Милинайт,eversong,670,demonhunter,havoc,12,7,5
Leäf,drakthul,670,demonhunter,havoc,12,7,5
Nikkidesaint,twisting-nether,670,demonhunter,havoc,12,7,5
Xtrmhunter,ysondre,670,demonhunter,havoc,18,7,11
Hyunkél,kirin-tor,670,demonhunter,havoc,18,7,11
Felni,lightbringer,669,demonhunter,havoc,12,7,5
Nmeule,turalyon,669,demonhunter,havoc,12,7,5
Zahif,kazzak,669,demonhunter,havoc,18,7,11
Diabloman,stormscale,669,demonhunter,havoc,18,7,11
Kumoko,burning-legion,669,demonhunter,havoc,21,8,13
Necrotyle,twisting-nether,669,demonhunter,havoc,21,8,13
Valen,die-aldor,669,demonhunter,havoc,24,7,17
Katheros,garrosh,667,demonhunter,havoc,12,7,5
Дядяэл,fordragon,667,demonhunter,havoc,24,7,17
Plec,alakir,667,demonhunter,havoc,24,7,17
Farlopon,dun-modr,667,demonhunter,havoc,36,7,29
Mormefiél,twisting-nether,666,demonhunter,havoc,12,7,5
Fugma,defias-brotherhood,666,demonhunter,havoc,12,7,5
Glaiverush,alakir,666,demonhunter,havoc,12,7,5
Seeshark,thrall,665,demonhunter,havoc,16,8,8
Starlightkid,kazzak,665,demonhunter,havoc,18,7,11
Rúpél,thrall,664,demonhunter,havoc,24,7,17
Selvagg,archimonde,662,demonhunter,havoc,24,7,17
Solian,ravencrest,661,demonhunter,havoc,12,7,5
Takeshy,alleria,658,demonhunter,havoc,18,7,11
Vengeful,alonsus,655,demonhunter,havoc,11,7,4
Ёмайл,soulflayer,655,demonhunter,havoc,18,7,11
Anishara,die-nachtwache,653,demonhunter,havoc,19,8,11
Летучий,howling-fjord,638,demonhunter,havoc,14,8,6
Emmunka,drakthul,638,demonhunter,havoc,17,7,10
Lexxdh,blackmoore,637,demonhunter,havoc,14,8,6
Snelle,outland,624,demonhunter,havoc,15,7,8
Harha,stormscale,623,demonhunter,havoc,11,7,4
Подкрадунзай,soulflayer,621,demonhunter,havoc,12,9,3
Makhabunda,terokkar,618,demonhunter,havoc,28,8,20
Hyperflex,blackrock,608,demonhunter,havoc,16,7,9
Inolia,argent-dawn,608,demonhunter,havoc,16,7,9
Phalekxox,ravencrest,607,demonhunter,havoc,11,7,4
Солстрэйл,gordunni,607,demonhunter,havoc,17,7,10
Innostigma,dalaran,607,demonhunter,havoc,20,7,13
Predatrix,khaz-modan,606,demonhunter,havoc,14,7,7
Calainis,twisting-nether,606,demonhunter,havoc,14,7,7
Линдорм,deathguard,603,demonhunter,havoc,14,7,7
Nahlendris,darkmoon-faire,596,demonhunter,havoc,16,7,9
Firstwolf,twisting-nether,576,demonhunter,havoc,6,6,0
Fôns,sanguino,576,demonhunter,havoc,6,6,0
Ratho,ragnaros,576,demonhunter,havoc,6,6,0
Mímð,ravencrest,576,demonhunter,havoc,6,6,0
Alasune,twisting-nether,576,demonhunter,havoc,6,6,0
Like,shattrath,576,demonhunter,havoc,14,7,7
Friidaadh,lightbringer,576,demonhunter,havoc,12,6,6
Malethrienna,argent-dawn,576,demonhunter,havoc,12,6,6
Noovedh,ravencrest,576,demonhunter,havoc,12,6,6
Velvetrain,ravencrest,576,demonhunter,havoc,12,6,6
Peacedopice,drakthul,576,demonhunter,havoc,12,6,6
Demonzøku,ravencrest,576,demonhunter,havoc,12,6,6
Sandem,blackrock,576,demonhunter,havoc,12,6,6
Gangstaboy,nemesis,576,demonhunter,havoc,12,6,6
Kazeha,tarren-mill,576,demonhunter,havoc,12,6,6
Mendøøza,hyjal,576,demonhunter,havoc,12,6,6
Zelidh,korgall,576,demonhunter,havoc,12,6,6
Ferrero,guldan,576,demonhunter,havoc,12,6,6
Kyuzo,sanguino,576,demonhunter,havoc,12,6,6
Rhinozerg,kazzak,576,demonhunter,havoc,12,6,6
Alrashidi,ravencrest,576,demonhunter,havoc,12,6,6
Lòsêr,ravencrest,576,demonhunter,havoc,12,6,6
Mythnimue,tarren-mill,576,demonhunter,havoc,12,6,6
Bayerd,burning-legion,576,demonhunter,havoc,12,6,6
Нулевыйчел,gordunni,576,demonhunter,havoc,12,6,6
Adírael,cthun,576,demonhunter,havoc,12,6,6
Анавеллка,howling-fjord,576,demonhunter,havoc,12,6,6
Swearix,twisting-nether,576,demonhunter,havoc,12,6,6
Lanaël,kaelthas,576,demonhunter,havoc,12,6,6
Pyleá,malganis,576,demonhunter,havoc,12,6,6
Spiriteru,archimonde,576,demonhunter,havoc,12,6,6
Jaace,silvermoon,576,demonhunter,havoc,12,6,6
Ailisdmgbotx,drakthul,576,demonhunter,havoc,12,6,6
Lurtéx,kazzak,576,demonhunter,havoc,12,6,6
Länika,drakthul,576,demonhunter,havoc,12,6,6
Yarudh,blackrock,576,demonhunter,havoc,12,6,6
Вафлистикус,ashenvale,576,demonhunter,havoc,12,6,6
Tëvnic,kazzak,576,demonhunter,havoc,12,6,6
Calicó,draenor,576,demonhunter,havoc,12,6,6
Rasmekul,defias-brotherhood,576,demonhunter,havoc,12,6,6
Xyrs,draenor,576,demonhunter,havoc,12,6,6
Shotraklul,zuljin,576,demonhunter,havoc,12,6,6
Miyxcu,aegwynn,576,demonhunter,havoc,12,6,6
Qtt,arthas,576,demonhunter,havoc,12,6,6
Tetedechaise,archimonde,576,demonhunter,havoc,12,6,6
Soulmortal,draenor,576,demonhunter,havoc,12,6,6
Avadåra,stormscale,576,demonhunter,havoc,12,6,6
Stickihunt,malganis,576,demonhunter,havoc,12,6,6
Mortyb,kazzak,576,demonhunter,havoc,12,6,6
Брилаброви,soulflayer,576,demonhunter,havoc,12,6,6
Lezzo,tarren-mill,576,demonhunter,havoc,12,6,6
Hatemaker,burning-legion,576,demonhunter,havoc,15,7,8
Shreeð,blackmoore,576,demonhunter,havoc,16,7,9
Mettdaemon,ravencrest,576,demonhunter,havoc,18,6,12
Inasyndre,argent-dawn,576,demonhunter,havoc,18,6,12
Dèsdemøna,nemesis,576,demonhunter,havoc,18,6,12
Axxad,kazzak,576,demonhunter,havoc,18,6,12
Chíwas,outland,576,demonhunter,havoc,18,6,12
Pinx,archimonde,576,demonhunter,havoc,18,6,12
Riñ,twisting-nether,576,demonhunter,havoc,18,6,12
Nøøßønline,hyjal,576,demonhunter,havoc,18,6,12
Bämbøué,hyjal,576,demonhunter,havoc,18,6,12
Blueformeld,draenor,576,demonhunter,havoc,18,6,12
Shyoxdh,twisting-nether,576,demonhunter,havoc,18,6,12
Blish,blackhand,576,demonhunter,havoc,18,6,12
Alandiel,twisting-nether,576,demonhunter,havoc,18,6,12
Zaÿn,antonidas,576,demonhunter,havoc,18,6,12
Songur,blackhand,576,demonhunter,havoc,18,6,12
Pèpsì,kazzak,576,demonhunter,havoc,24,6,18
Стараятварь,thermaplugg,576,demonhunter,havoc,24,6,18
Redgi,tarren-mill,576,demonhunter,havoc,24,6,18
Shizuuli,outland,576,demonhunter,havoc,30,6,24
Devilord,sanguino,575,demonhunter,havoc,12,6,6
Saftad,outland,575,demonhunter,havoc,12,6,6
Nameerr,ragnaros,575,demonhunter,havoc,12,6,6
Spicysteve,tarren-mill,575,demonhunter,havoc,12,6,6
Extraxtreme,ravencrest,575,demonhunter,havoc,12,6,6
Instinctivee,sylvanas,575,demonhunter,havoc,12,6,6
Kramixx,thrall,575,demonhunter,havoc,12,6,6
Lailâh,blackmoore,575,demonhunter,havoc,12,6,6
Nerudas,blackhand,575,demonhunter,havoc,12,6,6
Davdavdh,tarren-mill,575,demonhunter,havoc,12,6,6
Jimlast,eredar,575,demonhunter,havoc,12,6,6
Nassou,hyjal,575,demonhunter,havoc,12,6,6
Valshatt,sanguino,575,demonhunter,havoc,12,6,6
Arløw,archimonde,575,demonhunter,havoc,16,7,9
Brolycoly,stormscale,575,demonhunter,havoc,16,6,10
Нокаруру,gordunni,575,demonhunter,havoc,18,6,12
Зедю,howling-fjord,575,demonhunter,havoc,18,6,12
Joezus,draenor,575,demonhunter,havoc,18,6,12
Kaylaz,eredar,575,demonhunter,havoc,18,6,12
Candylicks,kazzak,575,demonhunter,havoc,18,6,12
Julmia,dragonblight,575,demonhunter,havoc,24,6,18
Sangita,tarren-mill,574,demonhunter,havoc,12,6,6
Mdåll,chogall,574,demonhunter,havoc,12,6,6
Ôlowain,blackmoore,574,demonhunter,havoc,18,6,12
Talwen,guldan,573,demonhunter,havoc,12,6,6
Klave,argent-dawn,573,demonhunter,havoc,18,6,12
Elindoria,dalaran,572,demonhunter,havoc,12,6,6
Kaletoq,ragnaros,572,demonhunter,havoc,16,6,10
Arxaxe,sanguino,571,demonhunter,havoc,12,6,6
Hamssterek,magtheridon,571,demonhunter,havoc,18,6,12
Caria,twisting-nether,570,demonhunter,havoc,12,6,6
Bahmut,argent-dawn,569,demonhunter,havoc,12,6,6
Ysanix,drakthul,568,demonhunter,havoc,12,6,6
Dàrkinette,archimonde,566,demonhunter,havoc,12,6,6
Glerog,ragnaros,558,demonhunter,havoc,10,7,3
Kranta,blackmoore,544,demonhunter,havoc,16,8,8
Tzigonline,silvermoon,542,demonhunter,havoc,17,6,11
Foxylama,stormscale,528,demonhunter,havoc,15,7,8
Panejo,drakthul,528,demonhunter,havoc,15,6,9
Хисаго,gordunni,522,demonhunter,havoc,15,7,8
Beraxulus,aegwynn,522,demonhunter,havoc,16,7,9
Алистреель,gordunni,521,demonhunter,havoc,13,7,6
Gnjurac,outland,511,demonhunter,havoc,14,6,8
Asperity,antonidas,511,demonhunter,havoc,18,6,12
Cmi,tarren-mill,511,demonhunter,havoc,22,6,16
Неффкодх,howling-fjord,496,demonhunter,havoc,13,6,7
Illidancz,thunderhorn,488,demonhunter,havoc,13,6,7
Lesamaritain,ysondre,480,demonhunter,havoc,6,5,1
Эрнерион,soulflayer,480,demonhunter,havoc,6,5,1
Nanába,draenor,480,demonhunter,havoc,6,5,1
Avavidh,blackmoore,480,demonhunter,havoc,6,5,1
Guziel,kazzak,480,demonhunter,havoc,6,5,1
Ismelldemons,silvermoon,480,demonhunter,havoc,6,5,1
Bruxdh,colinas-pardas,480,demonhunter,havoc,6,5,1
Demongodxx,twisting-nether,480,demonhunter,havoc,6,5,1
Mouga,hyjal,480,demonhunter,havoc,6,5,1
Monion,defias-brotherhood,480,demonhunter,havoc,6,5,1
Нсэнс,soulflayer,480,demonhunter,havoc,6,5,1
Marrie,area-52,480,demonhunter,havoc,6,5,1
Morrion,blackmoore,480,demonhunter,havoc,6,5,1
Miscodedh,ravencrest,480,demonhunter,havoc,9,6,3
Подэхилла,galakrond,480,demonhunter,havoc,10,6,4
Superchocowo,sanguino,480,demonhunter,havoc,12,5,7
Revérse,stormscale,480,demonhunter,havoc,12,5,7
Tatoos,bronze-dragonflight,480,demonhunter,havoc,12,5,7
Dzikalocha,burning-legion,480,demonhunter,havoc,12,5,7
Tomkis,ravencrest,480,demonhunter,havoc,12,5,7
Ukumeqt,kazzak,480,demonhunter,havoc,12,5,7
Atlizzdh,twisting-nether,480,demonhunter,havoc,12,5,7
Tozpak,sylvanas,480,demonhunter,havoc,12,5,7
Huntoverkill,hyjal,480,demonhunter,havoc,12,5,7
Thelyan,ravencrest,480,demonhunter,havoc,12,5,7
Tastyblades,blackmoore,480,demonhunter,havoc,12,5,7
Ourius,blackmoore,480,demonhunter,havoc,12,5,7
Thrina,blackmoore,480,demonhunter,havoc,12,5,7
Spitface,aegwynn,480,demonhunter,havoc,12,5,7
Eibemme,alleria,480,demonhunter,havoc,12,5,7
Диртхамен,blackscar,480,demonhunter,havoc,12,5,7
Zunada,ragnaros,480,demonhunter,havoc,12,5,7
Takad,twisting-nether,480,demonhunter,havoc,12,5,7
Caøtix,blackrock,480,demonhunter,havoc,12,5,7
Khenetai,silvermoon,480,demonhunter,havoc,12,5,7
Actarüs,hyjal,480,demonhunter,havoc,12,5,7
Lyanadh,blackhand,480,demonhunter,havoc,12,5,7
Zumbly,silvermoon,480,demonhunter,havoc,12,5,7
Nagh,archimonde,480,demonhunter,havoc,12,5,7
Kukulkanx,tarren-mill,480,demonhunter,havoc,12,5,7
Véspé,naxxramas,480,demonhunter,havoc,12,5,7
Blind,kazzak,480,demonhunter,havoc,12,5,7
Dhaosh,nemesis,480,demonhunter,havoc,12,5,7
Пупчански,howling-fjord,480,demonhunter,havoc,12,5,7
Atômik,drakthul,480,demonhunter,havoc,12,5,7
Darrkmoff,sylvanas,480,demonhunter,havoc,12,5,7
Алекзей,gordunni,480,demonhunter,havoc,12,5,7
Максимлолпро,howling-fjord,480,demonhunter,havoc,12,5,7
Trickstero,ragnaros,480,demonhunter,havoc,12,5,7
Hakakuri,ravencrest,480,demonhunter,havoc,12,5,7
Topg,bladefist,480,demonhunter,havoc,12,5,7
Glìmpsêgøðx,antonidas,480,demonhunter,havoc,12,5,7
Tthic,shadowsong,480,demonhunter,havoc,12,5,7
Demondusk,silvermoon,480,demonhunter,havoc,12,5,7
Natzú,ravencrest,480,demonhunter,havoc,12,5,7
Шликшлик,blackscar,480,demonhunter,havoc,12,5,7
Malzehar,tarren-mill,480,demonhunter,havoc,12,5,7
Giftìg,ravencrest,480,demonhunter,havoc,12,5,7
Freddh,blackrock,480,demonhunter,havoc,12,5,7
Филеровщик,deathguard,480,demonhunter,havoc,12,5,7
Noether,blackrock,480,demonhunter,havoc,12,5,7
Дракомуфлон,gordunni,480,demonhunter,havoc,12,5,7
Ferndejar,draenor,480,demonhunter,havoc,12,5,7
Korrupt,draenor,480,demonhunter,havoc,12,5,7
Блэйэмих,gordunni,480,demonhunter,havoc,12,5,7
Kiwicrash,tarren-mill,480,demonhunter,havoc,15,6,9
Shyynedh,grim-batol,480,demonhunter,havoc,15,6,9
Dübler,gorgonnash,480,demonhunter,havoc,18,5,13
Natarásh,blackmoore,480,demonhunter,havoc,18,5,13
Разагеш,gordunni,480,demonhunter,havoc,18,5,13
Crushidemon,draenor,480,demonhunter,havoc,18,5,13
Wajoglaive,blackhand,480,demonhunter,havoc,18,5,13
Gagfordaddy,ravencrest,480,demonhunter,havoc,18,5,13
Lovesong,the-shatar,480,demonhunter,havoc,18,5,13
Aelina,area-52,480,demonhunter,havoc,18,5,13
Talyrîs,aegwynn,480,demonhunter,havoc,18,5,13
Dharuel,cthun,480,demonhunter,havoc,18,5,13
Zimmerdin,blackmoore,480,demonhunter,havoc,18,5,13
Каталейна,howling-fjord,480,demonhunter,havoc,24,5,19
Dontrunaway,tarren-mill,479,demonhunter,havoc,6,5,1
Кевалат,gordunni,479,demonhunter,havoc,6,5,1
Sholon,kiljaeden,479,demonhunter,havoc,6,5,1
Ridweng,ravenholdt,479,demonhunter,havoc,7,5,2
Cindras,turalyon,479,demonhunter,havoc,12,5,7
Макай,deathguard,479,demonhunter,havoc,12,5,7
Jonasdh,antonidas,479,demonhunter,havoc,12,5,7
Shekny,sanguino,479,demonhunter,havoc,12,5,7
Mandemz,nagrand,479,demonhunter,havoc,12,5,7
Dedaronnes,hyjal,479,demonhunter,havoc,12,5,7
Gryphory,ravencrest,479,demonhunter,havoc,12,5,7
Merilidan,blackrock,479,demonhunter,havoc,12,5,7
Demontevz,outland,479,demonhunter,havoc,12,5,7
Approxis,archimonde,479,demonhunter,havoc,12,5,7
Rtz,malfurion,479,demonhunter,havoc,12,5,7
Bluespe,twisting-nether,479,demonhunter,havoc,12,5,7
Chàuvequipeu,dalaran,479,demonhunter,havoc,12,5,7
Demonwithin,nerathor,479,demonhunter,havoc,18,5,13
Thilanea,emeriss,478,demonhunter,havoc,12,5,7
Deasdh,tarren-mill,478,demonhunter,havoc,12,5,7
Скудайвер,gordunni,478,demonhunter,havoc,12,5,7
Karxarias,silvermoon,478,demonhunter,havoc,12,5,7
Greyfel,blackhand,478,demonhunter,havoc,20,7,13
Samurase,kazzak,477,demonhunter,havoc,12,5,7
Kairidemon,eredar,477,demonhunter,havoc,12,5,7
Гёнке,gordunni,477,demonhunter,havoc,22,6,16
Гачирабыня,lich-king,477,demonhunter,havoc,30,5,25
Vincbengt,tarren-mill,476,demonhunter,havoc,12,5,7
Sorgnarol,dalaran,475,demonhunter,havoc,12,5,7
Cometofloki,outland,475,demonhunter,havoc,12,5,7
Hellforce,nemesis,474,demonhunter,havoc,12,5,7
Illikan,stormscale,474,demonhunter,havoc,12,5,7
Etraidor,turalyon,473,demonhunter,havoc,12,5,7
Кислотна,borean-tundra,471,demonhunter,havoc,13,5,8
Cameclc,hyjal,448,demonhunter,havoc,16,5,11
Shaundead,drakthul,447,demonhunter,havoc,11,5,6
Илнари,soulflayer,447,demonhunter,havoc,11,5,6
Shironeko,ysondre,447,demonhunter,havoc,11,5,6
Иллианэль,howling-fjord,432,demonhunter,havoc,9,5,4
Акамамба,gordunni,431,demonhunter,havoc,11,5,6
Buttslapper,silvermoon,426,demonhunter,havoc,20,6,14
Bertori,dun-modr,416,demonhunter,havoc,10,5,5
Jïsoo,blackhand,416,demonhunter,havoc,16,5,11
Çhïñêséðëmøñ,draenor,384,demonhunter,havoc,6,4,2
Niellarsc,ravencrest,384,demonhunter,havoc,6,4,2
Spacedance,silvermoon,384,demonhunter,havoc,6,4,2
Nelathas,twisting-nether,384,demonhunter,havoc,6,4,2
Diagonol,ragnaros,384,demonhunter,havoc,6,4,2
Puppygf,ravencrest,384,demonhunter,havoc,6,4,2
Милифесена,gordunni,384,demonhunter,havoc,6,4,2
Rageglaive,ragnaros,384,demonhunter,havoc,6,4,2
Mýg,ravencrest,384,demonhunter,havoc,6,4,2
Mäxo,frostwolf,384,demonhunter,havoc,6,4,2
Lemondehunta,twisting-nether,384,demonhunter,havoc,6,4,2
Adexi,twisting-nether,384,demonhunter,havoc,6,4,2
Dimonhunta,tarren-mill,384,demonhunter,havoc,6,4,2
Tzs,blackrock,384,demonhunter,havoc,6,4,2
Талисзора,gordunni,384,demonhunter,havoc,6,4,2
Nxtpls,silvermoon,384,demonhunter,havoc,6,4,2
Onkwang,twisting-nether,384,demonhunter,havoc,6,4,2
Kriszidan,arathor,384,demonhunter,havoc,6,4,2
Fiduci,archimonde,384,demonhunter,havoc,6,4,2
Apsodemon,twisting-nether,384,demonhunter,havoc,6,4,2
Soulstacker,outland,384,demonhunter,havoc,6,4,2
Khrtdh,silvermoon,384,demonhunter,havoc,6,4,2
Atti,the-maelstrom,384,demonhunter,havoc,6,4,2
Vidagín,blackmoore,384,demonhunter,havoc,6,4,2
Akaniiaa,blackmoore,384,demonhunter,havoc,6,4,2
Iken,ragnaros,384,demonhunter,havoc,6,4,2
Klerikerin,blackmoore,384,demonhunter,havoc,6,4,2
Bartoshek,auchindoun,384,demonhunter,havoc,6,4,2
Liladan,sylvanas,384,demonhunter,havoc,6,4,2
Falanar,ysondre,384,demonhunter,havoc,6,4,2
Morthorr,grim-batol,384,demonhunter,havoc,6,4,2
Ðéstrøz,draenor,384,demonhunter,havoc,6,4,2
Demoncalle,the-maelstrom,384,demonhunter,havoc,6,4,2
Docos,genjuros,384,demonhunter,havoc,6,4,2
Dakydh,ravencrest,384,demonhunter,havoc,6,4,2
Sickdoci,kazzak,384,demonhunter,havoc,6,4,2
Exerzaria,twisting-nether,384,demonhunter,havoc,6,4,2
Timitär,mazrigos,384,demonhunter,havoc,6,4,2
Lëtho,colinas-pardas,384,demonhunter,havoc,6,4,2
Shinsen,archimonde,384,demonhunter,havoc,6,4,2
Деирдевил,blackscar,384,demonhunter,havoc,6,4,2
Blankdh,outland,384,demonhunter,havoc,6,4,2
Varonx,drakthul,384,demonhunter,havoc,6,4,2
Garra,chants-éternels,384,demonhunter,havoc,6,4,2
Manybuttons,tarren-mill,384,demonhunter,havoc,6,4,2
Anwenox,argent-dawn,384,demonhunter,havoc,6,4,2
Shïca,sanguino,384,demonhunter,havoc,6,4,2
Avnanof,draenor,384,demonhunter,havoc,6,4,2
Gotwings,sunstrider,384,demonhunter,havoc,6,4,2
Bosskuw,kazzak,384,demonhunter,havoc,6,4,2
Maupau,ravencrest,384,demonhunter,havoc,6,4,2
Wuzzabi,darksorrow,384,demonhunter,havoc,6,4,2
Valdrake,burning-legion,384,demonhunter,havoc,6,4,2
Jennyßright,sargeras,384,demonhunter,havoc,6,4,2
Memedhbtw,outland,384,demonhunter,havoc,6,4,2
Imprøve,ravencrest,384,demonhunter,havoc,9,5,4
Darmash,ambossar,384,demonhunter,havoc,9,5,4
Freakerzoid,kazzak,384,demonhunter,havoc,11,4,7
Cutforshred,zenedar,384,demonhunter,havoc,12,4,8
Illidarios,blackhand,384,demonhunter,havoc,12,4,8
Gorilla,korgall,384,demonhunter,havoc,12,4,8
Saikamango,blackhand,384,demonhunter,havoc,12,4,8
Rivy,magtheridon,384,demonhunter,havoc,12,4,8
Arkta,kazzak,384,demonhunter,havoc,12,4,8
Bratti,kazzak,384,demonhunter,havoc,12,4,8
Rúllio,rexxar,384,demonhunter,havoc,12,4,8
Хреньещёта,booty-bay,384,demonhunter,havoc,12,4,8
Mempaan,magtheridon,384,demonhunter,havoc,12,4,8
Leylas,nagrand,384,demonhunter,havoc,12,4,8
Лупидолх,soulflayer,384,demonhunter,havoc,12,4,8
Becknárn,sylvanas,384,demonhunter,havoc,12,4,8
Ascindra,kazzak,384,demonhunter,havoc,12,4,8
Артёмблэйдх,blackscar,384,demonhunter,havoc,12,4,8
Jabuzi,drakthul,384,demonhunter,havoc,12,4,8
Akkixy,die-aldor,384,demonhunter,havoc,12,4,8
Betterdk,twilights-hammer,384,demonhunter,havoc,12,4,8
Exodlia,silvermoon,384,demonhunter,havoc,12,4,8
Братилидана,gordunni,384,demonhunter,havoc,12,4,8
Xendrina,blackrock,384,demonhunter,havoc,12,4,8
Fbh,stormscale,384,demonhunter,havoc,12,4,8
Lenuna,frostmourne,384,demonhunter,havoc,12,4,8
Mouz,thrall,384,demonhunter,havoc,12,4,8
Алмантиус,gordunni,384,demonhunter,havoc,12,4,8
Хокану,gordunni,384,demonhunter,havoc,12,4,8
Одзангейра,blackscar,384,demonhunter,havoc,12,4,8
Graffyre,eonar,384,demonhunter,havoc,12,4,8
Папичгодх,borean-tundra,384,demonhunter,havoc,12,4,8
Voicechat,tarren-mill,384,demonhunter,havoc,12,4,8
Pokálen,drakthul,384,demonhunter,havoc,12,4,8
Demondik,aggramar,384,demonhunter,havoc,12,4,8
Ninjantiz,antonidas,384,demonhunter,havoc,12,4,8
Floridaboy,ravencrest,384,demonhunter,havoc,12,4,8
Koger,twisting-nether,384,demonhunter,havoc,12,4,8
Frostidh,ysondre,384,demonhunter,havoc,12,4,8
Drædløcks,ysondre,384,demonhunter,havoc,12,4,8
Alleyezønme,outland,384,demonhunter,havoc,12,4,8
Hatred,argent-dawn,384,demonhunter,havoc,12,4,8
Deadrawdh,aegwynn,384,demonhunter,havoc,12,4,8
Mamio,chogall,384,demonhunter,havoc,12,4,8
Maeltus,hyjal,384,demonhunter,havoc,12,4,8
Deathbydeaf,terenas,384,demonhunter,havoc,12,4,8
Nephylon,draenor,384,demonhunter,havoc,12,4,8
Blüëräin,draenor,384,demonhunter,havoc,12,4,8
Innocuouss,twisting-nether,384,demonhunter,havoc,12,4,8
Ågøny,outland,384,demonhunter,havoc,12,4,8
Dannyp,ravencrest,384,demonhunter,havoc,12,4,8
Ázârìûs,draenor,384,demonhunter,havoc,12,4,8
Stormshred,stormscale,384,demonhunter,havoc,13,4,9
Asukakazama,twisting-nether,384,demonhunter,havoc,15,4,11
Skajlan,burning-legion,384,demonhunter,havoc,18,4,14
Gouteça,la-croisade-écarlate,384,demonhunter,havoc,18,4,14
Sazukè,blackmoore,384,demonhunter,havoc,18,4,14
Ekhlipz,ysondre,384,demonhunter,havoc,18,4,14
Dìus,blackmoore,384,demonhunter,havoc,18,4,14
Linea,jaedenar,384,demonhunter,havoc,18,4,14
Poliex,khaz-modan,383,demonhunter,havoc,6,4,2
Tiucciah,kirin-tor,383,demonhunter,havoc,6,4,2
Némesîs,cthun,383,demonhunter,havoc,6,4,2
Rouzi,defias-brotherhood,383,demonhunter,havoc,6,4,2
Yocolo,sinstralis,383,demonhunter,havoc,6,4,2
Zaeros,archimonde,383,demonhunter,havoc,6,4,2
Vengatoria,cthun,383,demonhunter,havoc,12,4,8
Elenastar,kazzak,383,demonhunter,havoc,12,4,8
Thelanora,zirkel-des-cenarius,383,demonhunter,havoc,12,4,8
Сязекть,goldrinn,383,demonhunter,havoc,12,4,8
Chaordic,turalyon,383,demonhunter,havoc,12,4,8
Шоеррей,gordunni,383,demonhunter,havoc,12,4,8
Lillinète,archimonde,383,demonhunter,havoc,18,4,14
Demoncancer,kazzak,382,demonhunter,havoc,6,4,2
Nazzan,destromath,382,demonhunter,havoc,6,4,2
Rijsel,dalaran,382,demonhunter,havoc,6,4,2
Séleister,khaz-modan,382,demonhunter,havoc,12,4,8
Deathniresa,argent-dawn,379,demonhunter,havoc,12,4,8
Åáäàáåàáäàáå,dun-modr,377,demonhunter,havoc,15,6,9
Elldarion,blackhand,367,demonhunter,havoc,11,4,7
Deamo,stormscale,367,demonhunter,havoc,11,4,7
Блэйденрифтс,soulflayer,351,demonhunter,havoc,11,4,7
Fläsktorped,stormscale,335,demonhunter,havoc,11,4,7
Zavoc,the-maelstrom,319,demonhunter,havoc,8,4,4
Felwaifu,tarren-mill,319,demonhunter,havoc,8,4,4
Squarty,wrathbringer,316,demonhunter,havoc,8,4,4
Froog,frostmane,288,demonhunter,havoc,6,3,3
Imvnrcvr,dalaran,288,demonhunter,havoc,6,3,3
Joeybadass,aegwynn,288,demonhunter,havoc,6,3,3
Nightfly,twisting-nether,288,demonhunter,havoc,6,3,3
Fantabolous,ragnaros,288,demonhunter,havoc,6,3,3
Yelans,twisting-nether,288,demonhunter,havoc,6,3,3
Qualron,twisting-nether,288,demonhunter,havoc,6,3,3
Aoeshu,wildhammer,288,demonhunter,havoc,6,3,3
Indominus,pozzo-delleternità,288,demonhunter,havoc,6,3,3
Extitan,twisting-nether,288,demonhunter,havoc,6,3,3
Kyart,nemesis,288,demonhunter,havoc,6,3,3
Чубрик,howling-fjord,288,demonhunter,havoc,6,3,3
Zsídakabra,ragnaros,288,demonhunter,havoc,6,3,3
Uranoth,nemesis,288,demonhunter,havoc,6,3,3
Cursedblade,archimonde,288,demonhunter,havoc,6,3,3
Батявздане,soulflayer,288,demonhunter,havoc,6,3,3
Резако,soulflayer,288,demonhunter,havoc,6,3,3
Андрюхадх,soulflayer,288,demonhunter,havoc,6,3,3
Bunzi,sylvanas,288,demonhunter,havoc,6,3,3
Шрэдэр,thermaplugg,288,demonhunter,havoc,6,3,3
Lonedh,sylvanas,288,demonhunter,havoc,6,3,3
Ксен,howling-fjord,288,demonhunter,havoc,6,3,3
Норилайнн,gordunni,288,demonhunter,havoc,6,3,3
Тиктокденсер,gordunni,288,demonhunter,havoc,6,3,3
Ашерис,deathguard,288,demonhunter,havoc,6,3,3
Akhyra,ysondre,288,demonhunter,havoc,6,3,3
Mephilax,stormscale,288,demonhunter,havoc,6,3,3
Coca,stormreaver,288,demonhunter,havoc,6,3,3
Marilu,nathrezim,288,demonhunter,havoc,6,3,3
Vtoriavgust,silvermoon,288,demonhunter,havoc,6,3,3
Morow,die-ewige-wacht,288,demonhunter,havoc,6,3,3
Divia,anubarak,288,demonhunter,havoc,6,3,3
Kritflake,blackrock,288,demonhunter,havoc,6,3,3
Älger,archimonde,288,demonhunter,havoc,6,3,3
Youngfelrush,blackrock,288,demonhunter,havoc,6,3,3
Ailis,drakthul,288,demonhunter,havoc,6,3,3
Cienlowczyni,silvermoon,288,demonhunter,havoc,6,3,3
Killaden,ravenholdt,288,demonhunter,havoc,6,3,3
Schwitte,tichondrius,288,demonhunter,havoc,6,3,3
Xocotl,blackmoore,288,demonhunter,havoc,6,3,3
Crueldo,silvermoon,288,demonhunter,havoc,6,3,3
Vqqxx,stormreaver,288,demonhunter,havoc,6,3,3
Hyonzyyesh,silvermoon,288,demonhunter,havoc,6,3,3
Fredhy,tarren-mill,288,demonhunter,havoc,6,3,3
Jörgböhme,blackhand,288,demonhunter,havoc,6,3,3
Neony,blackmoore,288,demonhunter,havoc,6,3,3
Damenhunter,malganis,288,demonhunter,havoc,6,3,3
Xénôns,archimonde,288,demonhunter,havoc,6,3,3
Dadagodx,kazzak,288,demonhunter,havoc,6,3,3
Tåkotsubo,archimonde,288,demonhunter,havoc,6,3,3
Aaryaa,archimonde,288,demonhunter,havoc,6,3,3
Factcox,magtheridon,288,demonhunter,havoc,6,3,3
Demonsushi,tarren-mill,288,demonhunter,havoc,6,3,3
Leïaprincess,hyjal,288,demonhunter,havoc,6,3,3
Hellboi,dun-modr,288,demonhunter,havoc,6,3,3
Jellyjoker,malganis,288,demonhunter,havoc,6,3,3
Cánoo,blackhand,288,demonhunter,havoc,6,3,3
Luciferio,quelthalas,288,demonhunter,havoc,6,3,3
Vlexsuave,stormscale,288,demonhunter,havoc,6,3,3
Dàrknight,azjolnerub,288,demonhunter,havoc,6,3,3
Shaadraz,stormscale,288,demonhunter,havoc,6,3,3
Ortä,sanguino,288,demonhunter,havoc,6,3,3
Hárald,sanguino,288,demonhunter,havoc,6,3,3
Grifht,zuljin,288,demonhunter,havoc,6,3,3
Mephedroni,kazzak,288,demonhunter,havoc,6,3,3
Catchmebaby,sanguino,288,demonhunter,havoc,6,3,3
Nneverx,bladefist,288,demonhunter,havoc,6,3,3
Cnbâckbb,archimonde,288,demonhunter,havoc,6,3,3
Sionar,kazzak,288,demonhunter,havoc,6,3,3
Demonyz,hyjal,288,demonhunter,havoc,6,3,3
Ravae,burning-legion,288,demonhunter,havoc,6,3,3
Rehaell,burning-legion,288,demonhunter,havoc,6,3,3
Sfguild,kazzak,288,demonhunter,havoc,6,3,3
Makwah,kazzak,288,demonhunter,havoc,6,3,3
Naargof,outland,288,demonhunter,havoc,6,3,3
Crasyface,kazzak,288,demonhunter,havoc,6,3,3
Deschacke,eredar,288,demonhunter,havoc,6,3,3
Ostosbigego,ravencrest,288,demonhunter,havoc,6,3,3
Meserani,eredar,288,demonhunter,havoc,6,3,3
Kyoukaii,kazzak,288,demonhunter,havoc,6,3,3
Hogidan,hellscream,288,demonhunter,havoc,6,3,3
Âstræa,antonidas,288,demonhunter,havoc,6,3,3
Cydonia,medivh,288,demonhunter,havoc,6,3,3
Blizó,tarren-mill,288,demonhunter,havoc,6,3,3
Lundí,tarren-mill,288,demonhunter,havoc,6,3,3
Tígél,argent-dawn,288,demonhunter,havoc,6,3,3
Richielou,outland,288,demonhunter,havoc,6,3,3
Terboven,outland,288,demonhunter,havoc,6,3,3
Tire,draenor,288,demonhunter,havoc,6,3,3
Na,conseil-des-ombres,288,demonhunter,havoc,6,3,3
Myuøu,hyjal,288,demonhunter,havoc,6,3,3
Bossmac,mugthol,288,demonhunter,havoc,6,3,3
Shinnu,antonidas,288,demonhunter,havoc,6,3,3
Rustedchurl,draenor,288,demonhunter,havoc,6,3,3
Archadric,ravencrest,288,demonhunter,havoc,6,3,3
Annaboliik,ravencrest,288,demonhunter,havoc,6,3,3
Kätarïnas,confrérie-du-thorium,288,demonhunter,havoc,6,3,3
Ravael,archimonde,288,demonhunter,havoc,6,3,3
Nephthyis,draenor,288,demonhunter,havoc,6,3,3
Filthyape,ravencrest,288,demonhunter,havoc,6,3,3
Alfaa,outland,288,demonhunter,havoc,6,3,3
Wildest,blackmoore,288,demonhunter,havoc,9,4,5
Aethilios,silvermoon,288,demonhunter,havoc,11,3,8
Ðèvìllìà,ragnaros,288,demonhunter,havoc,12,3,9
Metaman,archimonde,288,demonhunter,havoc,12,3,9
Valø,malganis,288,demonhunter,havoc,12,3,9
Neiìf,blackhand,288,demonhunter,havoc,12,3,9
Bosque,ragnaros,288,demonhunter,havoc,12,3,9
Artwar,stormscale,288,demonhunter,havoc,12,3,9
Silandara,grim-batol,288,demonhunter,havoc,12,3,9
Blacklance,ravencrest,288,demonhunter,havoc,12,3,9
Fullinaretta,archimonde,288,demonhunter,havoc,12,3,9
Vulcaan,ravencrest,288,demonhunter,havoc,12,3,9
Gpk,argent-dawn,288,demonhunter,havoc,12,3,9
Bernhoftdh,ravencrest,288,demonhunter,havoc,12,3,9
Tødø,nemesis,288,demonhunter,havoc,12,3,9
Sazzox,blackrock,288,demonhunter,havoc,12,3,9
Ambodh,thrall,288,demonhunter,havoc,12,3,9
Donstyle,anachronos,288,demonhunter,havoc,12,3,9
Nightwalk,blackmoore,288,demonhunter,havoc,12,3,9
Cptgmiasbria,eredar,288,demonhunter,havoc,12,3,9
Naturalis,die-todeskrallen,288,demonhunter,havoc,12,3,9
Domiinator,sylvanas,288,demonhunter,havoc,12,3,9
Râny,blackmoore,288,demonhunter,havoc,12,3,9
Fleshes,draenor,288,demonhunter,havoc,12,3,9
Vänöx,dun-modr,288,demonhunter,havoc,12,3,9
Välhöll,kirin-tor,288,demonhunter,havoc,12,3,9
Milanto,antonidas,288,demonhunter,havoc,12,3,9
Tuffêli,turalyon,288,demonhunter,havoc,12,3,9
Wheelchairdh,twisting-nether,288,demonhunter,havoc,12,3,9
Vrekur,sanguino,288,demonhunter,havoc,12,3,9
Tenaebris,silvermoon,288,demonhunter,havoc,12,3,9
Ïvø,sargeras,288,demonhunter,havoc,12,3,9
Арвулфик,eversong,288,demonhunter,havoc,12,3,9
Rurt,sanguino,288,demonhunter,havoc,12,3,9
Laurana,argent-dawn,288,demonhunter,havoc,12,3,9
Corvox,argent-dawn,288,demonhunter,havoc,12,3,9
Феяужаса,soulflayer,288,demonhunter,havoc,12,3,9
Mordaer,twisting-nether,288,demonhunter,havoc,12,3,9
Гелиосса,soulflayer,288,demonhunter,havoc,12,3,9
Rapp,nemesis,288,demonhunter,havoc,12,3,9
Bengleng,draenor,288,demonhunter,havoc,12,3,9
Хемах,howling-fjord,288,demonhunter,havoc,12,3,9
Vandazza,argent-dawn,288,demonhunter,havoc,12,3,9
Deathsnote,marécage-de-zangar,288,demonhunter,havoc,12,3,9
Lamello,nemesis,288,demonhunter,havoc,12,3,9
Néèdgirly,malfurion,288,demonhunter,havoc,15,3,12
Lasthija,dun-modr,288,demonhunter,havoc,18,3,15
Devildust,ravencrest,288,demonhunter,havoc,18,3,15
Jimdh,quelthalas,288,demonhunter,havoc,18,3,15
Menutzdh,tarren-mill,287,demonhunter,havoc,6,3,3
Saturnein,stormscale,287,demonhunter,havoc,6,3,3
Elfitoloco,sanguino,287,demonhunter,havoc,6,3,3
Dethlyn,twisting-nether,287,demonhunter,havoc,6,3,3
Dimonanta,grim-batol,287,demonhunter,havoc,6,3,3
Gêliôs,kazzak,271,demonhunter,havoc,11,3,8
Dexterzx,stormscale,240,demonhunter,havoc,9,3,6
Nithraim,kazzak,240,demonhunter,havoc,9,3,6
Xaro,quelthalas,239,demonhunter,havoc,5,3,2
Itskarmax,outland,239,demonhunter,havoc,5,3,2
Herax,drakthul,239,demonhunter,havoc,5,3,2
Ponn,blackmoore,239,demonhunter,havoc,5,3,2
Джерегумо,howling-fjord,234,demonhunter,havoc,10,4,6
Ñítøryù,ravencrest,234,demonhunter,havoc,10,4,6
Munamasa,archimonde,234,demonhunter,havoc,11,4,7
Лэймрисх,gordunni,223,demonhunter,havoc,14,3,11
Demoqt,ragnaros,192,demonhunter,havoc,4,3,1
Erenyeagerr,kazzak,192,demonhunter,havoc,4,3,1
Kiô,drakthul,192,demonhunter,havoc,9,3,6
Brolafsen,ragnaros,192,demonhunter,havoc,6,2,4
Маскитол,soulflayer,192,demonhunter,havoc,6,2,4
Razzàl,sinstralis,192,demonhunter,havoc,6,2,4
Lixxersmeta,stormscale,192,demonhunter,havoc,6,2,4
Roxxis,mazrigos,192,demonhunter,havoc,6,2,4
Lexdh,blackrock,192,demonhunter,havoc,6,2,4
Cøldlean,ravencrest,192,demonhunter,havoc,6,2,4
Sñüîîâ,kazzak,192,demonhunter,havoc,6,2,4
Schakalèn,ragnaros,192,demonhunter,havoc,6,2,4
Ybou,archimonde,192,demonhunter,havoc,6,2,4
Kibiri,rajaxx,192,demonhunter,havoc,6,2,4
Heidihauge,silvermoon,192,demonhunter,havoc,6,2,4
Barocs,antonidas,192,demonhunter,havoc,6,2,4
Draecis,twisting-nether,192,demonhunter,havoc,6,2,4
Люблюмеф,gordunni,192,demonhunter,havoc,6,2,4
Ellatriel,blackrock,192,demonhunter,havoc,6,2,4
Mythisa,blackrock,192,demonhunter,havoc,6,2,4
Scarath,eredar,192,demonhunter,havoc,6,2,4
Khrum,rajaxx,192,demonhunter,havoc,6,2,4
Alervius,blackrock,192,demonhunter,havoc,6,2,4
Bananabritta,aegwynn,192,demonhunter,havoc,6,2,4
Omegahunterx,ravencrest,192,demonhunter,havoc,6,2,4
Dayo,archimonde,192,demonhunter,havoc,6,2,4
Martøsdh,uldum,192,demonhunter,havoc,6,2,4
Drahîna,khaz-modan,192,demonhunter,havoc,6,2,4
Лилэйв,gordunni,192,demonhunter,havoc,6,2,4
Деорру,gordunni,192,demonhunter,havoc,6,2,4
Nörsedh,sanguino,192,demonhunter,havoc,6,2,4
Hykoolique,arakarahm,192,demonhunter,havoc,6,2,4
Yataganac,draenor,192,demonhunter,havoc,6,2,4
Sârgan,khaz-modan,192,demonhunter,havoc,6,2,4
Kakovicz,gorgonnash,192,demonhunter,havoc,6,2,4
Haveadad,outland,192,demonhunter,havoc,6,2,4
Datejust,archimonde,192,demonhunter,havoc,6,2,4
Anekk,kazzak,192,demonhunter,havoc,6,2,4
Gendó,twisting-nether,192,demonhunter,havoc,6,2,4
Chaeeri,twisting-nether,192,demonhunter,havoc,6,2,4
Haragazu,blackrock,192,demonhunter,havoc,6,2,4
Draneka,argent-dawn,192,demonhunter,havoc,6,2,4
Czl,silvermoon,192,demonhunter,havoc,6,2,4
Янгфрукт,howling-fjord,192,demonhunter,havoc,6,2,4
Zenô,antonidas,192,demonhunter,havoc,6,2,4
Opvoksterxx,sylvanas,192,demonhunter,havoc,6,2,4
Siio,antonidas,192,demonhunter,havoc,6,2,4
Neimfel,outland,192,demonhunter,havoc,6,2,4
Fèll,silvermoon,192,demonhunter,havoc,6,2,4
Disconecting,outland,192,demonhunter,havoc,6,2,4
Chlorel,arthas,192,demonhunter,havoc,6,2,4
Demontoolz,outland,192,demonhunter,havoc,6,2,4
Tacodhx,ravencrest,192,demonhunter,havoc,6,2,4
Sephy,argent-dawn,192,demonhunter,havoc,6,2,4
Kaelisi,argent-dawn,192,demonhunter,havoc,6,2,4
Lucziane,blackmoore,192,demonhunter,havoc,6,2,4
Alcadejas,pozzo-delleternità,192,demonhunter,havoc,6,2,4
Andariell,sylvanas,192,demonhunter,havoc,6,2,4
Nairra,blackmoore,192,demonhunter,havoc,6,2,4
Emkogødx,outland,192,demonhunter,havoc,6,2,4
Кеиичи,howling-fjord,192,demonhunter,havoc,6,2,4
Mayzhi,hyjal,192,demonhunter,havoc,6,2,4
Qúkn,tarren-mill,192,demonhunter,havoc,6,2,4
Harrah,archimonde,192,demonhunter,havoc,6,2,4
Аврорамур,howling-fjord,192,demonhunter,havoc,6,2,4
Shockzzyydh,ravencrest,192,demonhunter,havoc,6,2,4
Cíondra,aegwynn,192,demonhunter,havoc,6,2,4
Тэнсу,borean-tundra,192,demonhunter,havoc,6,2,4
Zxcjklcasdlk,sylvanas,192,demonhunter,havoc,6,2,4
Riveén,blackhand,192,demonhunter,havoc,6,2,4
Tabsen,sanguino,192,demonhunter,havoc,6,2,4
Беатриз,soulflayer,192,demonhunter,havoc,6,2,4
Grinchdemon,nagrand,192,demonhunter,havoc,6,2,4
Kibikari,nemesis,192,demonhunter,havoc,6,2,4
Остинджейн,soulflayer,192,demonhunter,havoc,6,2,4
Wolfex,hellfire,192,demonhunter,havoc,6,2,4
Stifeur,archimonde,192,demonhunter,havoc,6,2,4
Linkôs,aegwynn,192,demonhunter,havoc,6,2,4
Khinn,tyrande,192,demonhunter,havoc,6,2,4
Dionyz,magtheridon,192,demonhunter,havoc,6,2,4
Gnaget,the-maelstrom,192,demonhunter,havoc,6,2,4
Dhslayer,magtheridon,192,demonhunter,havoc,6,2,4
Мэлифсб,blackscar,192,demonhunter,havoc,6,2,4
Palaurx,kazzak,192,demonhunter,havoc,6,2,4
Neulgød,zuljin,192,demonhunter,havoc,6,2,4
Pablino,darksorrow,192,demonhunter,havoc,6,2,4
Aerkex,kazzak,192,demonhunter,havoc,6,2,4
Thefightergz,terokkar,192,demonhunter,havoc,6,2,4
Ragnarak,amanthul,192,demonhunter,havoc,6,2,4
Mîlîm,silvermoon,192,demonhunter,havoc,6,2,4
Топдекдх,howling-fjord,192,demonhunter,havoc,6,2,4
Saphira,laughing-skull,192,demonhunter,havoc,6,2,4
Kryshan,burning-legion,192,demonhunter,havoc,6,2,4
Холегдх,gordunni,192,demonhunter,havoc,6,2,4
Aggrodíte,antonidas,192,demonhunter,havoc,6,2,4
Дабллди,soulflayer,192,demonhunter,havoc,6,2,4
Артесдх,gordunni,192,demonhunter,havoc,6,2,4
Sälexz,ysondre,192,demonhunter,havoc,6,2,4
Zarkhyl,malygos,192,demonhunter,havoc,6,2,4
Williamgrant,alonsus,192,demonhunter,havoc,6,2,4
Tvé,ravencrest,192,demonhunter,havoc,6,2,4
Generaaloo,ragnaros,192,demonhunter,havoc,6,2,4
Шоксенсацияя,howling-fjord,192,demonhunter,havoc,6,2,4
Juicyglaives,ragnaros,192,demonhunter,havoc,6,2,4
Флайрин,blackscar,192,demonhunter,havoc,6,2,4
Dikcitx,archimonde,192,demonhunter,havoc,6,2,4
Fellout,burning-legion,192,demonhunter,havoc,6,2,4
Hicke,burning-legion,192,demonhunter,havoc,6,2,4
Лорберн,soulflayer,192,demonhunter,havoc,6,2,4
Ôdhyn,hyjal,192,demonhunter,havoc,6,2,4
Malkyor,ysondre,192,demonhunter,havoc,6,2,4
Hârambe,stormscale,192,demonhunter,havoc,12,3,9
Врадость,soulflayer,192,demonhunter,havoc,8,2,6
Zaydra,the-maelstrom,192,demonhunter,havoc,12,2,10
Thenangel,alleria,192,demonhunter,havoc,12,2,10
Qweasda,stormscale,192,demonhunter,havoc,12,2,10
Парагони,gordunni,192,demonhunter,havoc,12,2,10
Esseline,outland,192,demonhunter,havoc,12,2,10
Spideymon,ragnaros,192,demonhunter,havoc,12,2,10
Kandres,ragnaros,192,demonhunter,havoc,12,2,10
Aygael,archimonde,192,demonhunter,havoc,12,2,10
Enygamy,frostmane,192,demonhunter,havoc,12,2,10
Язамясо,gordunni,192,demonhunter,havoc,12,2,10
Ayido,xavius,192,demonhunter,havoc,12,2,10
Abalim,nemesis,192,demonhunter,havoc,12,2,10
Sajr,twisting-nether,192,demonhunter,havoc,12,2,10
Asperatus,dalaran,192,demonhunter,havoc,12,2,10
Deehoh,twisting-nether,192,demonhunter,havoc,12,2,10
Tbomb,ragnaros,192,demonhunter,havoc,12,2,10
Aytèè,eredar,192,demonhunter,havoc,12,2,10
Dhogus,twisting-nether,192,demonhunter,havoc,12,2,10
Zynês,draenor,192,demonhunter,havoc,12,2,10
Axyo,doomhammer,192,demonhunter,havoc,12,2,10
Tôx,dalaran,192,demonhunter,havoc,12,2,10
Wruzna,shattered-halls,192,demonhunter,havoc,12,2,10
Aloera,blackmoore,192,demonhunter,havoc,12,2,10
Teletubby,blackrock,192,demonhunter,havoc,12,2,10
Synistera,trollbane,192,demonhunter,havoc,12,2,10
Drâparn,sylvanas,192,demonhunter,havoc,12,2,10
Themogar,earthen-ring,192,demonhunter,havoc,12,2,10
Fullmutter,twisting-nether,191,demonhunter,havoc,6,2,4
Anarcky,ravencrest,191,demonhunter,havoc,7,2,5
Manjirosano,blackmoore,191,demonhunter,havoc,12,2,10
Noorrd,hyjal,191,demonhunter,havoc,12,2,10
Lilarii,argent-dawn,191,demonhunter,havoc,12,2,10
Kurox,drakthul,191,demonhunter,havoc,18,2,16
Onorera,tarren-mill,160,demonhunter,havoc,10,2,8
Galafel,outland,159,demonhunter,havoc,5,2,3
Mezo,outland,144,demonhunter,havoc,3,3,0
Gucknicht,blackrock,144,demonhunter,havoc,9,2,7
Razerøø,ysondre,138,demonhunter,havoc,9,3,6
Kantklipper,ragnaros,138,demonhunter,havoc,10,3,7
Джэкмэн,soulflayer,138,demonhunter,havoc,23,4,19
Мегапташка,howling-fjord,128,demonhunter,havoc,4,2,2
Drstn,blackmoore,128,demonhunter,havoc,4,2,2
Luferite,burning-blade,127,demonhunter,havoc,8,2,6
Indagatrix,bladefist,112,demonhunter,havoc,7,2,5
Amatèrasu,burning-legion,110,demonhunter,havoc,13,2,11
Âyoôrts,archimonde,96,demonhunter,havoc,3,2,1
Kassin,dun-modr,96,demonhunter,havoc,6,1,5
Zyfu,antonidas,96,demonhunter,havoc,6,1,5
Teladar,outland,96,demonhunter,havoc,6,1,5
Ilovesabrina,dun-modr,96,demonhunter,havoc,6,1,5
Bchj,ysondre,96,demonhunter,havoc,6,1,5
Ellare,burning-blade,96,demonhunter,havoc,6,1,5
Akron,magtheridon,96,demonhunter,havoc,6,1,5
Bröwnye,dun-modr,96,demonhunter,havoc,6,1,5
Syldrae,hyjal,96,demonhunter,havoc,6,1,5
Vrazjababa,dragonmaw,96,demonhunter,havoc,6,1,5
Maikko,los-errantes,96,demonhunter,havoc,6,1,5
Hørnyßæ,drakthul,96,demonhunter,havoc,6,1,5
Reikuel,nemesis,96,demonhunter,havoc,6,1,5
Vg,blackhand,96,demonhunter,havoc,6,1,5
Cruptiq,kazzak,96,demonhunter,havoc,6,1,5
Demongorgon,arathor,96,demonhunter,havoc,6,1,5
Oob,ysondre,96,demonhunter,havoc,6,1,5
Shaelby,archimonde,96,demonhunter,havoc,6,1,5
Permachill,blackmoore,96,demonhunter,havoc,6,1,5
Rëdencounter,ravencrest,96,demonhunter,havoc,6,1,5
Stàmàzza,nemesis,96,demonhunter,havoc,6,1,5
Аззазэль,howling-fjord,96,demonhunter,havoc,6,1,5
ßaßayaga,blackhand,96,demonhunter,havoc,6,1,5
Burritodh,tarren-mill,96,demonhunter,havoc,6,1,5
Satela,azjolnerub,96,demonhunter,havoc,6,1,5
Zoer,kazzak,96,demonhunter,havoc,6,1,5
Bïquette,ysondre,96,demonhunter,havoc,6,1,5
Спокоивич,soulflayer,96,demonhunter,havoc,6,1,5
Malvax,tarren-mill,96,demonhunter,havoc,6,1,5
Teimotevey,silvermoon,96,demonhunter,havoc,6,1,5
Jiínx,kazzak,96,demonhunter,havoc,6,1,5
Ryuhayabusa,stormscale,96,demonhunter,havoc,6,1,5
Louú,blackmoore,96,demonhunter,havoc,6,1,5
Fantamazing,ragnaros,96,demonhunter,havoc,6,1,5
Esthá,argent-dawn,96,demonhunter,havoc,6,1,5
Blíndgódx,ravencrest,96,demonhunter,havoc,6,1,5
Dhgoddess,ravencrest,96,demonhunter,havoc,6,1,5
Styggve,ragnaros,96,demonhunter,havoc,6,1,5
Tenx,auchindoun,96,demonhunter,havoc,6,1,5
Найлинель,fordragon,96,demonhunter,havoc,6,1,5
Evlos,hyjal,96,demonhunter,havoc,6,1,5
Dýlän,argent-dawn,96,demonhunter,havoc,6,1,5
Stormma,kazzak,96,demonhunter,havoc,6,1,5
Anänke,twisting-nether,96,demonhunter,havoc,6,1,5
Яестьдима,howling-fjord,96,demonhunter,havoc,6,1,5
Shonal,defias-brotherhood,96,demonhunter,havoc,6,1,5
Zarafel,hyjal,96,demonhunter,havoc,6,1,5
Mlecznygolem,silvermoon,96,demonhunter,havoc,6,1,5
Ghetzlel,draenor,96,demonhunter,havoc,6,1,5
Чесденьгамии,soulflayer,96,demonhunter,havoc,6,1,5
Unk,outland,96,demonhunter,havoc,6,1,5
Bootyspread,twisting-nether,96,demonhunter,havoc,6,1,5
Wìxx,blackrock,96,demonhunter,havoc,6,1,5
Bradzdh,outland,96,demonhunter,havoc,6,1,5
Niqel,blackrock,96,demonhunter,havoc,6,1,5
Áarón,der-mithrilorden,96,demonhunter,havoc,6,1,5
Kuñkkïsh,twisting-nether,96,demonhunter,havoc,6,1,5
Azazël,turalyon,96,demonhunter,havoc,6,1,5
Laethas,twisting-nether,96,demonhunter,havoc,6,1,5
Nairu,doomhammer,96,demonhunter,havoc,6,1,5
Sgit,doomhammer,96,demonhunter,havoc,6,1,5
Annee,eredar,96,demonhunter,havoc,6,1,5
Bitex,archimonde,96,demonhunter,havoc,6,1,5
Eliyz,dalaran,96,demonhunter,havoc,6,1,5
Camotheck,stormscale,96,demonhunter,havoc,6,1,5
Pkdaemon,draenor,96,demonhunter,havoc,6,1,5
Blulake,silvermoon,96,demonhunter,havoc,6,1,5
Flasqo,eredar,96,demonhunter,havoc,6,1,5
Äzot,burning-legion,96,demonhunter,havoc,6,1,5
Askari,lothar,96,demonhunter,havoc,6,1,5
Croüp,draenor,96,demonhunter,havoc,6,1,5
Соларт,howling-fjord,96,demonhunter,havoc,6,1,5
Tricki,kelthuzad,96,demonhunter,havoc,6,1,5
Неверластх,gordunni,96,demonhunter,havoc,6,1,5
Распилил,gordunni,96,demonhunter,havoc,6,1,5
Ганстапутин,howling-fjord,96,demonhunter,havoc,6,1,5
Булёхинс,howling-fjord,96,demonhunter,havoc,6,1,5
Nvm,wrathbringer,96,demonhunter,havoc,6,1,5
Ripgodx,bronzebeard,96,demonhunter,havoc,6,1,5
Galuna,deathwing,96,demonhunter,havoc,7,1,6
Kryux,blackrock,96,demonhunter,havoc,9,1,8
Бонятяф,gordunni,96,demonhunter,havoc,12,1,11
Babyyéah,sunstrider,96,demonhunter,havoc,12,1,11
Seaburn,bronzebeard,96,demonhunter,havoc,12,1,11
Jásírá,shattrath,96,demonhunter,havoc,12,1,11
Jeandh,nerzhul,96,demonhunter,havoc,12,1,11
Ecthelionn,outland,96,demonhunter,havoc,12,1,11
Shinarei,silvermoon,95,demonhunter,havoc,6,1,5
Caluxe,blackmoore,79,demonhunter,havoc,5,1,4
Гадх,gordunni,42,demonhunter,havoc,8,2,6
Impulz,archimonde,42,demonhunter,havoc,9,2,7
Neednerf,draenor,31,demonhunter,havoc,2,1,1
Sinjinzoo,blackrock,31,demonhunter,havoc,2,1,1
Frozensoules,turalyon,31,demonhunter,havoc,8,1,7
Plagues,quelthalas,30,demonhunter,havoc,14,5,9
Sìena,ravencrest,16,demonhunter,havoc,1,1,0
Vengeancezin,frostwhisper,1910,demonhunter,vengeance,192,97,95
Strqt,archimonde,1509,demonhunter,vengeance,54,29,25
Jedidiah,aggra-português,1496,demonhunter,vengeance,110,49,61
Zarín,outland,1394,demonhunter,vengeance,78,41,37
Paindemon,outland,1315,demonhunter,vengeance,72,42,30
Enithy,twisting-nether,934,demonhunter,vengeance,18,10,8
Kubusz,ravencrest,889,demonhunter,vengeance,36,16,20
Сумърак,grom,739,demonhunter,vengeance,29,8,21
Kekburagól,kazzak,575,demonhunter,vengeance,12,6,6
Arussil,pozzo-delleternità,572,demonhunter,vengeance,18,6,12
Demonlucy,colinas-pardas,287,demonhunter,vengeance,12,3,9
Геммула,howling-fjord,192,demonhunter,vengeance,6,2,4
Camtoe,ravencrest,192,demonhunter,vengeance,6,2,4
Askari,lothar,192,demonhunter,vengeance,6,2,4
Nephthyis,draenor,192,demonhunter,vengeance,6,2,4
Myztiko,hellscream,96,demonhunter,vengeance,6,1,5
Xenits,kazzak,96,demonhunter,vengeance,6,1,5
Øß,moonglade,96,demonhunter,vengeance,6,1,5
Zarafel,hyjal,95,demonhunter,vengeance,12,1,11
Hibibi,kazzak,2257,druid,restoration,113,66,47
Pegasu,kelthuzad,2182,druid,restoration,114,66,48
Vanostboom,kazzak,2181,druid,restoration,88,50,38
Iloveher,ravencrest,2180,druid,restoration,160,89,71
Miouzy,archimonde,2156,druid,restoration,66,36,30
Kev,elune,2134,druid,restoration,209,113,96
Vinniehacker,archimonde,2129,druid,restoration,71,42,29
Årt,ravencrest,2106,druid,restoration,186,100,86
Niksidruid,grim-batol,2105,druid,restoration,58,37,21
Unohanâ,archimonde,2103,druid,restoration,108,65,43
Håbibi,kazzak,2100,druid,restoration,65,35,30
Nesedondon,stormscale,2086,druid,restoration,72,50,22
Trèes,outland,2085,druid,restoration,264,144,120
Surfingbirdx,ragnaros,2058,druid,restoration,54,28,26
Drjmy,silvermoon,2053,druid,restoration,71,54,17
Dendariottvx,sunstrider,2042,druid,restoration,73,44,29
Rives,sylvanas,2030,druid,restoration,102,60,42
Acondris,kazzak,2025,druid,restoration,222,113,109
Bambambimbim,draenor,2023,druid,restoration,84,44,40
Thotz,kazzak,2020,druid,restoration,221,113,108
Galadronìa,aegwynn,2018,druid,restoration,77,42,35
Friedbrocolí,tarren-mill,2009,druid,restoration,86,43,43
Yoogy,ravencrest,1995,druid,restoration,60,37,23
Jaytiz,ravencrest,1975,druid,restoration,65,33,32
Dokixo,kazzak,1968,druid,restoration,47,29,18
Bloomitize,ravencrest,1967,druid,restoration,78,43,35
Tjxaxa,ravencrest,1966,druid,restoration,78,38,40
Lunamimi,argent-dawn,1962,druid,restoration,368,190,178
Thysabtw,archimonde,1954,druid,restoration,99,58,41
Shinöbü,sanguino,1954,druid,restoration,87,49,38
Ovérheal,ravencrest,1953,druid,restoration,94,52,42
Sintiq,silvermoon,1949,druid,restoration,65,37,28
Mentallyill,ravencrest,1949,druid,restoration,204,106,98
Theatrex,ravencrest,1945,druid,restoration,165,100,65
Sheippi,stormreaver,1945,druid,restoration,54,31,23
Angrykejton,silvermoon,1940,druid,restoration,276,138,138
Hånukkah,outland,1929,druid,restoration,64,30,34
Threesixnìne,dun-morogh,1928,druid,restoration,246,134,112
Skrrlock,ravencrest,1923,druid,restoration,108,53,55
Kyomã,burning-legion,1915,druid,restoration,102,49,53
Syví,outland,1912,druid,restoration,59,29,30
Andr,voljin,1907,druid,restoration,102,49,53
Joksica,draenor,1903,druid,restoration,65,32,33
Afky,stormreaver,1901,druid,restoration,156,77,79
Maxpojke,ravencrest,1899,druid,restoration,148,92,56
Cplazi,kazzak,1890,druid,restoration,48,30,18
Amaré,burning-legion,1873,druid,restoration,54,28,26
Panigale,dun-modr,1872,druid,restoration,55,24,31
Ralaa,guldan,1865,druid,restoration,54,29,25
Arthéas,archimonde,1865,druid,restoration,174,89,85
Naffelle,ysondre,1862,druid,restoration,71,34,37
Druidrak,eredar,1855,druid,restoration,66,32,34
Chas,ravencrest,1852,druid,restoration,51,31,20
Leyô,archimonde,1852,druid,restoration,60,31,29
Traffix,outland,1852,druid,restoration,51,26,25
Alolexx,archimonde,1851,druid,restoration,45,27,18
Lalalime,arthas,1851,druid,restoration,64,31,33
Skrood,kazzak,1847,druid,restoration,60,31,29
Druidello,stormscale,1845,druid,restoration,52,24,28
Køngx,blackhand,1840,druid,restoration,131,68,63
Åä,ravencrest,1837,druid,restoration,32,20,12
Thebiggest,ravencrest,1836,druid,restoration,42,25,17
Myndrá,varimathras,1835,druid,restoration,66,34,32
Ammare,burning-legion,1834,druid,restoration,72,39,33
Matteps,outland,1833,druid,restoration,59,28,31
Nantou,stormscale,1833,druid,restoration,59,28,31
Chacopic,archimonde,1831,druid,restoration,168,88,80
Jmdr,silvermoon,1830,druid,restoration,71,31,40
Asøri,antonidas,1829,druid,restoration,48,21,27
Kìttÿ,dun-modr,1828,druid,restoration,66,41,25
Spamclone,draenor,1828,druid,restoration,57,30,27
Kanyevotèrx,ravencrest,1828,druid,restoration,54,25,29
Jìnró,ravencrest,1825,druid,restoration,135,66,69
Sprøut,drakthul,1825,druid,restoration,59,27,32
Gummysnake,aszune,1823,druid,restoration,42,25,17
Helløkittyßß,dun-modr,1823,druid,restoration,151,86,65
Treliuz,twilights-hammer,1823,druid,restoration,346,190,156
Zydrux,outland,1822,druid,restoration,48,36,12
Olaphy,elune,1821,druid,restoration,257,133,124
Thugzie,kazzak,1821,druid,restoration,194,92,102
Yesco,malganis,1821,druid,restoration,63,27,36
Doodlez,blackrock,1820,druid,restoration,60,27,33
Baawz,blackmoore,1820,druid,restoration,60,25,35
Aesha,los-errantes,1819,druid,restoration,54,26,28
Promethezine,tarren-mill,1818,druid,restoration,236,122,114
Metagrass,stormscale,1818,druid,restoration,129,59,70
Skadooshee,kazzak,1816,druid,restoration,36,19,17
Xvmon,draenor,1815,druid,restoration,99,45,54
Велаине,gordunni,1813,druid,restoration,240,140,100
Nediena,twisting-nether,1812,druid,restoration,48,20,28
Troc,karazhan,1811,druid,restoration,50,25,25
Sorryblya,ravencrest,1809,druid,restoration,60,26,34
Rhonir,twisting-nether,1807,druid,restoration,71,33,38
Muraglia,pozzo-delleternità,1806,druid,restoration,30,19,11
Bellatrx,darksorrow,1806,druid,restoration,56,33,23
Uñsullied,kazzak,1806,druid,restoration,57,31,26
Morkius,ravencrest,1806,druid,restoration,36,19,17
Eedaza,argent-dawn,1805,druid,restoration,134,75,59
Мафио,blackscar,1805,druid,restoration,48,25,23
Дикаякиара,blackscar,1804,druid,restoration,307,151,156
Riplilpeep,grim-batol,1803,druid,restoration,54,28,26
Gaeldeth,silvermoon,1802,druid,restoration,105,63,42
Wraithshape,stormscale,1800,druid,restoration,60,32,28
Hadok,azjolnerub,1798,druid,restoration,167,76,91
Reins,silvermoon,1795,druid,restoration,106,56,50
Кенкертайм,gordunni,1794,druid,restoration,84,43,41
Tedel,kazzak,1791,druid,restoration,53,33,20
Asklepion,twisting-nether,1785,druid,restoration,42,19,23
Orayin,ravencrest,1784,druid,restoration,166,102,64
Traickovic,antonidas,1779,druid,restoration,48,24,24
Lexopewpew,ravencrest,1779,druid,restoration,47,22,25
Афклалка,gordunni,1778,druid,restoration,42,22,20
Druu,stormscale,1778,druid,restoration,60,28,32
Panørax,archimonde,1774,druid,restoration,41,21,20
Tj,frostmane,1773,druid,restoration,52,22,30
Clone,aegwynn,1770,druid,restoration,138,73,65
Amaree,burning-legion,1770,druid,restoration,66,29,37
Heçtôr,silvermoon,1767,druid,restoration,60,27,33
Ltmx,ravencrest,1764,druid,restoration,59,25,34
Bëstwôrld,archimonde,1763,druid,restoration,76,39,37
Nastycat,magtheridon,1763,druid,restoration,221,105,116
Gøðførm,silvermoon,1758,druid,restoration,118,63,55
Wéédmâñ,ravencrest,1756,druid,restoration,45,30,15
Slayced,blackrock,1756,druid,restoration,71,34,37
Píshi,silvermoon,1754,druid,restoration,42,23,19
Asaj,argent-dawn,1754,druid,restoration,207,112,95
Maedic,outland,1753,druid,restoration,125,60,65
Hizzy,burning-legion,1751,druid,restoration,243,119,124
Loleh,ragnaros,1751,druid,restoration,59,27,32
Lamatoes,ravencrest,1750,druid,restoration,59,24,35
Qjkuug,twisting-nether,1749,druid,restoration,154,91,63
Mòzat,stormscale,1749,druid,restoration,54,28,26
Migami,nemesis,1748,druid,restoration,65,27,38
Solowlevel,ravencrest,1748,druid,restoration,60,24,36
Zonsy,twisting-nether,1747,druid,restoration,48,27,21
Weezíng,ysondre,1747,druid,restoration,73,40,33
Джелони,soulflayer,1745,druid,restoration,47,23,24
Badashellm,ravencrest,1744,druid,restoration,66,37,29
Hyggefinger,ravencrest,1741,druid,restoration,54,26,28
Улдрэйн,deathguard,1739,druid,restoration,66,38,28
Naraia,aegwynn,1739,druid,restoration,125,66,59
Drøødis,archimonde,1730,druid,restoration,54,31,23
Nasduck,ravencrest,1726,druid,restoration,184,99,85
Lúh,kazzak,1724,druid,restoration,24,19,5
Крашдру,gordunni,1724,druid,restoration,64,38,26
Филавтия,gordunni,1724,druid,restoration,60,32,28
Notsikaan,blackhand,1723,druid,restoration,71,27,44
Druidella,stormscale,1716,druid,restoration,30,18,12
Ûnsullied,kazzak,1716,druid,restoration,54,25,29
Fatøumatä,archimonde,1712,druid,restoration,60,32,28
Evílz,kazzak,1710,druid,restoration,36,21,15
Muraebbasta,pozzo-delleternità,1709,druid,restoration,42,18,24
Luhmanish,thunderhorn,1707,druid,restoration,143,74,69
Wraithmoon,stormscale,1705,druid,restoration,36,18,18
Lifelover,outland,1704,druid,restoration,54,25,29
Kittyperry,tarren-mill,1703,druid,restoration,68,34,34
Ninadobrev,ragnaros,1697,druid,restoration,57,26,31
Treeførm,ravencrest,1694,druid,restoration,36,25,11
Josedudu,twisting-nether,1692,druid,restoration,75,37,38
Moondra,outland,1688,druid,restoration,95,39,56
Erika,vashj,1684,druid,restoration,72,38,34
Hólo,blackrock,1682,druid,restoration,102,47,55
Vijaja,aegwynn,1681,druid,restoration,30,19,11
Kokanine,ravencrest,1681,druid,restoration,45,23,22
Néøu,archimonde,1681,druid,restoration,48,23,25
Praetorian,sylvanas,1680,druid,restoration,315,155,160
Synapes,outland,1680,druid,restoration,60,28,32
Traick,antonidas,1679,druid,restoration,41,18,23
Moonbee,burning-blade,1677,druid,restoration,155,82,73
Akumei,ravencrest,1676,druid,restoration,47,24,23
Bjoernbrudn,ravencrest,1674,druid,restoration,48,24,24
Fryén,archimonde,1671,druid,restoration,75,33,42
Naruhot,archimonde,1670,druid,restoration,49,27,22
Skailzdruid,hyjal,1669,druid,restoration,200,124,76
Lunglung,blutkessel,1664,druid,restoration,114,60,54
Tooclosex,outland,1663,druid,restoration,95,54,41
Elayria,blackmoore,1663,druid,restoration,36,19,17
Wernøs,archimonde,1661,druid,restoration,51,26,25
Rozi,draenor,1660,druid,restoration,48,27,21
Demerit,aegwynn,1657,druid,restoration,32,18,14
Sélia,sylvanas,1657,druid,restoration,116,57,59
Bâneth,destromath,1656,druid,restoration,60,33,27
Catgirlx,ravencrest,1652,druid,restoration,42,26,16
Øhshift,drakthul,1651,druid,restoration,47,25,22
Shufflebot,sylvanas,1650,druid,restoration,36,22,14
Fantastix,silvermoon,1649,druid,restoration,36,20,16
Чухх,howling-fjord,1649,druid,restoration,73,39,34
Nozome,draenor,1648,druid,restoration,45,22,23
Flåppers,stormscale,1645,druid,restoration,48,20,28
Pogoth,turalyon,1641,druid,restoration,72,38,34
Diolives,stormscale,1640,druid,restoration,303,159,144
Uknowwhaddup,silvermoon,1639,druid,restoration,48,19,29
Ooktharg,turalyon,1637,druid,restoration,42,22,20
Абраг,soulflayer,1637,druid,restoration,72,36,36
Trèes,draenor,1636,druid,restoration,46,22,24
Zudwa,twisting-nether,1635,druid,restoration,44,27,17
Adjaara,ravencrest,1635,druid,restoration,115,68,47
Pardus,ambossar,1635,druid,restoration,50,27,23
Kroghelf,tarren-mill,1634,druid,restoration,42,21,21
Bellhooks,blackrock,1633,druid,restoration,30,18,12
Rawri,blackmoore,1633,druid,restoration,48,26,22
Mafiasnipe,ravencrest,1630,druid,restoration,24,17,7
Cæsífer,area-52,1630,druid,restoration,71,37,34
Plsbuffdruid,ravencrest,1630,druid,restoration,40,19,21
Crownydrood,hyjal,1628,druid,restoration,42,25,17
Asga,stormscale,1628,druid,restoration,30,17,13
Estariol,auchindoun,1628,druid,restoration,36,17,19
Peterpain,grim-batol,1626,druid,restoration,30,17,13
Andromedda,twisting-nether,1626,druid,restoration,198,105,93
Trollisha,mannoroth,1626,druid,restoration,705,345,360
Ёу,soulflayer,1624,druid,restoration,161,85,76
Tropjeune,dalaran,1623,druid,restoration,36,17,19
Davorian,frostmane,1622,druid,restoration,63,35,28
Hotsnthots,elune,1622,druid,restoration,48,24,24
Jamuhlee,kult-der-verdammten,1622,druid,restoration,43,18,25
Chaboom,hyjal,1622,druid,restoration,60,25,35
Миледистайпи,gordunni,1619,druid,restoration,32,18,14
Frances,auchindoun,1618,druid,restoration,63,36,27
Bjútiful,silvermoon,1618,druid,restoration,41,23,18
Eyvimel,ravencrest,1618,druid,restoration,404,212,192
Elu,eredar,1617,druid,restoration,48,28,20
Haszard,outland,1617,druid,restoration,134,68,66
Nancey,auchindoun,1617,druid,restoration,149,75,74
Друлихаз,gordunni,1617,druid,restoration,54,20,34
Wømbat,ravencrest,1616,druid,restoration,36,17,19
Goldrax,outland,1615,druid,restoration,24,17,7
Bigdaddyshay,twisting-nether,1615,druid,restoration,42,24,18
Tåylor,laughing-skull,1615,druid,restoration,41,21,20
Sangré,suramar,1615,druid,restoration,108,52,56
Драменбейз,gordunni,1615,druid,restoration,42,20,22
Dûdûrînâ,blackrock,1614,druid,restoration,66,42,24
Skillfall,ravencrest,1614,druid,restoration,48,21,27
Nímbs,tarren-mill,1612,druid,restoration,35,20,15
Zhosy,shattrath,1612,druid,restoration,61,22,39
Zevana,tarren-mill,1611,druid,restoration,30,18,12
Funnyjoker,outland,1611,druid,restoration,142,66,76
Skipperd,blackmoore,1610,druid,restoration,42,17,25
Kaamirach,blackmoore,1609,druid,restoration,157,97,60
Xalio,ravencrest,1609,druid,restoration,161,90,71
Xoriauz,archimonde,1609,druid,restoration,78,37,41
Slaugh,zuljin,1608,druid,restoration,48,20,28
Опапенелопа,blackscar,1607,druid,restoration,39,27,12
Monatamis,kazzak,1607,druid,restoration,36,21,15
Kheazar,blackmoore,1606,druid,restoration,115,69,46
Bigmeandruid,twisting-nether,1606,druid,restoration,30,17,13
Чекхмеаскохз,gordunni,1604,druid,restoration,36,21,15
Builtdiffy,kazzak,1604,druid,restoration,249,126,123
Bîrke,blackrock,1604,druid,restoration,36,17,19
Diriculous,kazzak,1603,druid,restoration,60,20,40
Soguu,thrall,1601,druid,restoration,30,17,13
Watchmebear,stormscale,1601,druid,restoration,42,23,19
Ðarckness,kazzak,1600,druid,restoration,24,17,7
Swifte,argent-dawn,1600,druid,restoration,48,27,21
Tamburoo,tarren-mill,1600,druid,restoration,225,110,115
Akmón,tarren-mill,1600,druid,restoration,58,20,38
Dïsä,ravencrest,1599,druid,restoration,30,17,13
Mònsterz,archimonde,1599,druid,restoration,160,86,74
Mortalnight,sinstralis,1598,druid,restoration,412,205,207
Heavysmoker,emeriss,1597,druid,restoration,162,75,87
Ittei,korgall,1596,druid,restoration,120,63,57
Рамзес,gordunni,1595,druid,restoration,54,31,23
Rhapsodý,twisting-nether,1591,druid,restoration,36,19,17
Folzenqt,archimonde,1590,druid,restoration,68,27,41
Bêvêrly,ravencrest,1586,druid,restoration,70,37,33
Miyá,sylvanas,1580,druid,restoration,30,17,13
Naridruidx,eredar,1578,druid,restoration,42,26,16
Shiftway,stormscale,1573,druid,restoration,42,23,19
Pega,archimonde,1572,druid,restoration,84,39,45
Scorlok,eredar,1567,druid,restoration,68,42,26
Eaglefox,aszune,1565,druid,restoration,71,37,34
Stratocaster,blackmoore,1563,druid,restoration,30,19,11
Pawful,malganis,1562,druid,restoration,266,141,125
Kundz,dalaran,1558,druid,restoration,160,88,72
Zaelitwo,archimonde,1557,druid,restoration,30,21,9
Naturez,sylvanas,1557,druid,restoration,32,20,12
Уэсериктх,blackscar,1557,druid,restoration,45,26,19
Crïn,ravencrest,1553,druid,restoration,36,17,19
Druncha,sunstrider,1553,druid,restoration,189,74,115
Néllä,archimonde,1552,druid,restoration,36,25,11
Tunling,ravencrest,1549,druid,restoration,66,44,22
Брэвно,gordunni,1549,druid,restoration,273,145,128
Arogane,outland,1548,druid,restoration,96,51,45
Bearform,blackhand,1548,druid,restoration,48,23,25
Legyna,ravencrest,1547,druid,restoration,65,40,25
Çãm,magtheridon,1547,druid,restoration,42,25,17
Khunahype,thrall,1546,druid,restoration,88,48,40
Reinulfen,blackmoore,1545,druid,restoration,166,89,77
Deluron,malganis,1545,druid,restoration,119,63,56
Probablyahoe,ravencrest,1544,druid,restoration,36,17,19
Swisz,bronzebeard,1542,druid,restoration,78,41,37
Bammedrudu,archimonde,1541,druid,restoration,42,25,17
Ssonty,drakthul,1541,druid,restoration,54,23,31
Phelessa,silvermoon,1539,druid,restoration,54,23,31
Нубстримсс,gordunni,1538,druid,restoration,82,38,44
Tôrmêñtêd,outland,1535,druid,restoration,105,65,40
Roshaga,blackrock,1535,druid,restoration,51,25,26
Buffbloom,auchindoun,1534,druid,restoration,141,72,69
Dârkacêû,blackmoore,1534,druid,restoration,44,21,23
Директорх,blackscar,1534,druid,restoration,47,22,25
Eviscreator,stormscale,1529,druid,restoration,45,27,18
Fabsl,archimonde,1529,druid,restoration,42,18,24
Kætachy,archimonde,1529,druid,restoration,42,16,26
Cheçhy,aegwynn,1527,druid,restoration,54,26,28
Hasselhoof,eredar,1526,druid,restoration,63,26,37
Homek,eredar,1525,druid,restoration,108,58,50
Делоникс,soulflayer,1525,druid,restoration,36,16,20
Lyvuni,blackmoore,1524,druid,restoration,60,36,24
Høtbøt,ysera,1523,druid,restoration,33,19,14
Melonmanx,outland,1523,druid,restoration,30,17,13
Floka,archimonde,1523,druid,restoration,60,32,28
Ына,gordunni,1523,druid,restoration,114,60,54
Mw,dun-modr,1520,druid,restoration,71,33,38
Hatecrew,twisting-nether,1517,druid,restoration,59,33,26
Stonesight,argent-dawn,1516,druid,restoration,30,20,10
Dwaokut,ravencrest,1514,druid,restoration,47,24,23
Utopiah,ravencrest,1513,druid,restoration,80,45,35
Latêralus,silvermoon,1513,druid,restoration,67,26,41
Сладуляя,gordunni,1512,druid,restoration,53,23,30
Tînkerbèll,blackmoore,1511,druid,restoration,41,22,19
Azchuk,blackmoore,1509,druid,restoration,53,22,31
Jìnro,stormscale,1508,druid,restoration,24,16,8
Друрашка,soulflayer,1508,druid,restoration,81,43,38
Devióus,twilights-hammer,1508,druid,restoration,246,125,121
Jcpenney,xavius,1508,druid,restoration,223,109,114
Bloomies,tarren-mill,1507,druid,restoration,100,59,41
Yseraheal,drakthul,1507,druid,restoration,42,17,25
Ystalgia,sylvanas,1507,druid,restoration,42,16,26
Cyclonebroo,blackmoore,1504,druid,restoration,34,20,14
Feelstreeman,twisting-nether,1504,druid,restoration,77,42,35
Lÿter,dun-modr,1502,druid,restoration,60,27,33
Greenlips,ravencrest,1502,druid,restoration,60,23,37
Zaerox,ambossar,1501,druid,restoration,90,45,45
Kittý,terokkar,1500,druid,restoration,162,82,80
Elwenyss,outland,1498,druid,restoration,65,30,35
Блицклик,gordunni,1498,druid,restoration,82,36,46
Аренатренер,gordunni,1498,druid,restoration,90,39,51
Eeivi,argent-dawn,1497,druid,restoration,195,104,91
Нагетсмяу,howling-fjord,1496,druid,restoration,24,16,8
Trayndaras,drakthul,1495,druid,restoration,35,23,12
Kicki,outland,1494,druid,restoration,66,34,32
Маккаланн,soulflayer,1493,druid,restoration,48,30,18
Setztes,tarren-mill,1493,druid,restoration,151,79,72
Rougetreize,khaz-modan,1490,druid,restoration,30,16,14
Jtepdru,ravencrest,1490,druid,restoration,132,67,65
Peerpope,draenor,1488,druid,restoration,238,131,107
Atôtheex,kazzak,1488,druid,restoration,43,21,22
Guccicken,garona,1487,druid,restoration,173,92,81
Cptfalcony,outland,1486,druid,restoration,60,34,26
Mnine,twisting-nether,1485,druid,restoration,42,23,19
Фапдрим,howling-fjord,1480,druid,restoration,246,123,123
Noosh,thrall,1480,druid,restoration,42,20,22
Xoat,marécage-de-zangar,1479,druid,restoration,36,23,13
Атмос,deathguard,1478,druid,restoration,198,109,89
Phala,outland,1478,druid,restoration,48,20,28
Supremecat,kazzak,1477,druid,restoration,66,38,28
Pureballs,twisting-nether,1477,druid,restoration,165,93,72
Nyxxz,shattered-hand,1477,druid,restoration,36,19,17
Xôárqt,aegwynn,1477,druid,restoration,72,33,39
Maqer,argent-dawn,1476,druid,restoration,56,31,25
Kaher,ravencrest,1475,druid,restoration,48,24,24
Delviri,stormreaver,1474,druid,restoration,104,54,50
Asanaria,ravencrest,1474,druid,restoration,95,43,52
Nasgra,malganis,1473,druid,restoration,41,17,24
Halyconwings,outland,1470,druid,restoration,57,29,28
Islandbôy,blackrock,1470,druid,restoration,42,16,26
Hashtagone,ysondre,1468,druid,restoration,47,23,24
Trúdl,das-konsortium,1466,druid,restoration,24,18,6
Feyzoude,ysondre,1461,druid,restoration,40,24,16
Drbse,silvermoon,1461,druid,restoration,56,28,28
Цукерище,gordunni,1459,druid,restoration,40,25,15
Cliftshifter,outland,1458,druid,restoration,36,25,11
Styleexd,ragnaros,1458,druid,restoration,69,39,30
Маминапуська,soulflayer,1458,druid,restoration,57,32,25
Spliçe,draenor,1458,druid,restoration,42,21,21
Arlandia,drakthul,1458,druid,restoration,42,17,25
Bakicadr,sylvanas,1454,druid,restoration,27,17,10
Ööh,outland,1453,druid,restoration,48,25,23
Warami,eredar,1453,druid,restoration,54,24,30
Ивантяй,gordunni,1452,druid,restoration,137,71,66
Euskal,chogall,1451,druid,restoration,42,18,24
Deltalol,blackmoore,1450,druid,restoration,48,25,23
Dafapa,twilights-hammer,1447,druid,restoration,42,21,21
Vashiko,tarren-mill,1446,druid,restoration,83,41,42
Bearliheals,draenor,1445,druid,restoration,75,45,30
Brorsnor,ravencrest,1445,druid,restoration,86,38,48
Xyruden,kazzak,1441,druid,restoration,171,69,102
Eldi,uldum,1438,druid,restoration,30,15,15
Trõn,draenor,1436,druid,restoration,155,92,63
Síggíe,eredar,1436,druid,restoration,30,17,13
Shredzz,ravencrest,1436,druid,restoration,36,15,21
Dartdogg,sanguino,1436,druid,restoration,65,22,43
Блумха,howling-fjord,1435,druid,restoration,66,34,32
Solàryx,hyjal,1434,druid,restoration,72,38,34
Shiftycents,ravencrest,1433,druid,restoration,24,15,9
Scra,anubarak,1433,druid,restoration,107,55,52
Ráw,dun-modr,1433,druid,restoration,96,44,52
Kukisanban,stormscale,1432,druid,restoration,314,168,146
Bägira,sylvanas,1431,druid,restoration,255,135,120
Bulldócer,sanguino,1431,druid,restoration,36,15,21
Doodougie,silvermoon,1430,druid,restoration,36,15,21
Pumplt,thrall,1429,druid,restoration,54,31,23
Òniz,hyjal,1428,druid,restoration,46,30,16
Maethar,stormrage,1428,druid,restoration,111,67,44
Lindorel,khaz-modan,1428,druid,restoration,30,15,15
Analmonstret,shattered-hand,1427,druid,restoration,35,17,18
Друлёнышь,eversong,1426,druid,restoration,173,90,83
Вексиус,gordunni,1425,druid,restoration,54,26,28
Weisslogia,aegwynn,1424,druid,restoration,30,15,15
Febricyla,blackmoore,1424,druid,restoration,48,23,25
Filyina,blackrock,1424,druid,restoration,105,46,59
Wenciorek,kazzak,1423,druid,restoration,135,67,68
Georn,sylvanas,1423,druid,restoration,36,15,21
Jnzymiau,blackrock,1422,druid,restoration,58,31,27
Senoka,shattrath,1419,druid,restoration,191,101,90
Shiftyshaft,tarren-mill,1419,druid,restoration,116,56,60
Tokifong,kazzak,1419,druid,restoration,36,15,21
Twerkdabooty,azjolnerub,1416,druid,restoration,30,15,15
Yunalaa,blackmoore,1415,druid,restoration,44,25,19
Drineh,ravencrest,1415,druid,restoration,42,19,23
Ráay,blackrock,1414,druid,restoration,66,34,32
Друидсимба,howling-fjord,1413,druid,restoration,170,92,78
Rawillinen,kazzak,1413,druid,restoration,36,18,18
Кингкиса,gordunni,1412,druid,restoration,36,15,21
Kajiun,silvermoon,1411,druid,restoration,48,28,20
Antheiaa,frostmane,1411,druid,restoration,72,32,40
Theeix,silvermoon,1410,druid,restoration,66,33,33
Mortagua,kazzak,1410,druid,restoration,36,15,21
Jugaia,frostmourne,1409,druid,restoration,41,19,22
Ilyethea,earthen-ring,1408,druid,restoration,447,237,210
Lukass,drakthul,1408,druid,restoration,188,96,92
Thanom,auchindoun,1406,druid,restoration,246,124,122
Plàntz,tarren-mill,1406,druid,restoration,79,39,40
Drukae,stormscale,1406,druid,restoration,54,23,31
Làhen,ravencrest,1404,druid,restoration,225,109,116
Wooshy,kazzak,1403,druid,restoration,52,25,27
Rytmusdudu,ragnaros,1403,druid,restoration,42,19,23
Béccàbtw,draenor,1402,druid,restoration,30,16,14
Suprot,aggramar,1402,druid,restoration,106,52,54
Røxhot,archimonde,1401,druid,restoration,66,41,25
Hellofresh,silvermoon,1399,druid,restoration,54,21,33
Qri,ahnqiraj,1398,druid,restoration,36,22,14
Feinberg,stormscale,1397,druid,restoration,101,44,57
Phebzdrood,archimonde,1396,druid,restoration,45,27,18
Mindru,sylvanas,1396,druid,restoration,51,24,27
Wagoneis,grim-batol,1395,druid,restoration,58,28,30
Cesn,vashj,1395,druid,restoration,42,15,27
Sandirion,silvermoon,1394,druid,restoration,524,258,266
Papjin,blackhand,1392,druid,restoration,36,23,13
Shufflê,blackmoore,1392,druid,restoration,125,57,68
Champaa,aggra-português,1392,druid,restoration,46,16,30
Bloompuf,draenor,1391,druid,restoration,124,54,70
Zyndril,silvermoon,1390,druid,restoration,38,17,21
Leafceld,aggra-português,1388,druid,restoration,54,22,32
Катяблум,gordunni,1387,druid,restoration,84,36,48
Jikuni,ravencrest,1386,druid,restoration,42,20,22
Clovér,outland,1384,druid,restoration,77,35,42
Lestty,the-maelstrom,1383,druid,restoration,58,32,26
Gandraste,neptulon,1379,druid,restoration,24,19,5
Азя,blackscar,1379,druid,restoration,54,22,32
Scaleo,stormreaver,1377,druid,restoration,78,46,32
Kramit,ravencrest,1376,druid,restoration,48,25,23
Blacksage,dragonmaw,1376,druid,restoration,107,50,57
Fth,dethecus,1375,druid,restoration,24,16,8
Spacedout,taerar,1375,druid,restoration,61,33,28
Kooglaash,kazzak,1372,druid,restoration,103,49,54
Hideme,tarren-mill,1371,druid,restoration,78,34,44
Badbloom,ravencrest,1370,druid,restoration,46,22,24
Erebear,ravencrest,1369,druid,restoration,59,34,25
Akasuky,thrall,1369,druid,restoration,42,22,20
Saintbiose,dalaran,1368,druid,restoration,24,17,7
Sgtdrood,archimonde,1367,druid,restoration,36,17,19
Мекс,gordunni,1366,druid,restoration,23,15,8
Будклим,blackscar,1366,druid,restoration,24,15,9
Balanc,ragnaros,1366,druid,restoration,42,22,20
Avimoo,tarren-mill,1364,druid,restoration,41,22,19
Hotsexpress,aegwynn,1360,druid,restoration,42,16,26
Badbeliø,hyjal,1360,druid,restoration,82,31,51
Cörelly,ravencrest,1358,druid,restoration,187,108,79
Bronox,ragnaros,1358,druid,restoration,71,34,37
Zwierzyniec,jaedenar,1357,druid,restoration,60,27,33
Xontpos,stormscale,1356,druid,restoration,24,15,9
Sertris,kazzak,1352,druid,restoration,58,23,35
Ravenfang,dun-modr,1351,druid,restoration,54,34,20
Nayokô,grim-batol,1351,druid,restoration,66,33,33
Царапкатян,gordunni,1351,druid,restoration,212,101,111
Althei,argent-dawn,1349,druid,restoration,45,22,23
Biomat,norgannon,1348,druid,restoration,33,16,17
Kormakurr,silvermoon,1347,druid,restoration,45,24,21
Wwvwwvwwvwvw,burning-legion,1347,druid,restoration,75,27,48
Ipossible,kazzak,1347,druid,restoration,48,16,32
Hotsandpot,outland,1346,druid,restoration,36,15,21
Duharbrahud,outland,1345,druid,restoration,54,22,32
Feralgodx,quelthalas,1344,druid,restoration,27,16,11
Zaeli,archimonde,1344,druid,restoration,24,14,10
Stiffýz,archimonde,1343,druid,restoration,24,14,10
Lindémann,blackhand,1343,druid,restoration,36,19,17
Acxaryl,ravencrest,1343,druid,restoration,30,14,16
Stevedru,ravencrest,1342,druid,restoration,24,14,10
Brømberry,blackrock,1342,druid,restoration,155,75,80
Рефикс,gordunni,1340,druid,restoration,109,68,41
Rabacki,blackmoore,1339,druid,restoration,102,48,54
Bibeed,blackmoore,1339,druid,restoration,36,14,22
Woohoo,ravencrest,1338,druid,restoration,24,14,10
Cylantus,eredar,1337,druid,restoration,18,15,3
Idect,silvermoon,1337,druid,restoration,130,68,62
Ванечка,razuvious,1337,druid,restoration,36,14,22
Malacella,marécage-de-zangar,1335,druid,restoration,36,14,22
Shifthappénz,draenor,1334,druid,restoration,60,28,32
Morfer,grim-batol,1333,druid,restoration,145,77,68
Likh,das-konsortium,1332,druid,restoration,24,14,10
Yenwe,kazzak,1332,druid,restoration,185,96,89
Вакидзами,gordunni,1331,druid,restoration,48,28,20
Emodruid,sunstrider,1330,druid,restoration,24,14,10
Ekaterina,dun-morogh,1330,druid,restoration,75,42,33
Roshava,stormscale,1329,druid,restoration,46,27,19
Autoritär,gilneas,1326,druid,restoration,106,58,48
Hidras,tarren-mill,1326,druid,restoration,48,21,27
Minipilsen,outland,1325,druid,restoration,36,16,20
Milkmepls,balnazzar,1324,druid,restoration,24,14,10
Knzm,dun-modr,1323,druid,restoration,120,62,58
Teengirl,blackmoore,1323,druid,restoration,30,14,16
Blomberg,burning-legion,1321,druid,restoration,18,14,4
Panpanqcul,archimonde,1321,druid,restoration,23,17,6
Microw,ghostlands,1321,druid,restoration,111,59,52
Buckxxz,nazjatar,1320,druid,restoration,30,17,13
Exïlla,archimonde,1320,druid,restoration,30,15,15
Koemarkt,sunstrider,1319,druid,restoration,46,29,17
Endoplazmik,silvermoon,1319,druid,restoration,61,36,25
Seherbaz,ravencrest,1319,druid,restoration,30,14,16
Крайсонг,soulflayer,1316,druid,restoration,42,21,21
Didi,frostwhisper,1316,druid,restoration,86,39,47
Manuka,argent-dawn,1315,druid,restoration,88,48,40
Bigßoi,stormscale,1315,druid,restoration,108,54,54
Groundpovx,blackmoore,1315,druid,restoration,30,14,16
Snuffurious,ragnaros,1314,druid,restoration,24,14,10
Elysea,antonidas,1313,druid,restoration,66,31,35
Dortalon,outland,1313,druid,restoration,72,30,42
Kattbjörnen,ragnaros,1312,druid,restoration,207,110,97
Лэвиш,blackscar,1310,druid,restoration,24,14,10
Forzendl,twisting-nether,1310,druid,restoration,42,22,20
Mangy,xavius,1309,druid,restoration,78,39,39
Иггдрассиль,blackscar,1309,druid,restoration,30,15,15
Nuwell,arathor,1309,druid,restoration,132,62,70
Maghh,ravencrest,1307,druid,restoration,34,19,15
Closér,stormscale,1307,druid,restoration,54,27,27
Disclaimed,twisting-nether,1307,druid,restoration,36,15,21
Cultivatedz,twisting-nether,1306,druid,restoration,54,24,30
Basilethe,hyjal,1304,druid,restoration,30,17,13
Тырубльдуде,gordunni,1302,druid,restoration,51,26,25
Boomayé,archimonde,1301,druid,restoration,56,34,22
Nelffie,kazzak,1300,druid,restoration,138,74,64
Budspencebär,draenor,1300,druid,restoration,30,16,14
Benzimaax,ragnaros,1299,druid,restoration,42,21,21
Hanibalector,silvermoon,1298,druid,restoration,45,24,21
Vioboomie,blackrock,1298,druid,restoration,33,17,16
Ekologiskxx,outland,1296,druid,restoration,85,40,45
Wannabanhere,outland,1295,druid,restoration,41,16,25
Atsumåsterx,archimonde,1294,druid,restoration,46,19,27
Beesoup,blackrock,1291,druid,restoration,21,15,6
Phatbushy,silvermoon,1291,druid,restoration,35,16,19
Karodoom,twisting-nether,1290,druid,restoration,42,26,16
Flum,darksorrow,1289,druid,restoration,149,77,72
Brosephiné,stormscale,1289,druid,restoration,30,14,16
Varrdru,kazzak,1288,druid,restoration,91,42,49
Khalec,silvermoon,1287,druid,restoration,40,24,16
Bennydruid,kazzak,1286,druid,restoration,112,46,66
Хуссипусси,galakrond,1285,druid,restoration,29,14,15
Parkydru,draenor,1284,druid,restoration,24,15,9
Kattig,grim-batol,1284,druid,restoration,44,21,23
Seikoo,defias-brotherhood,1284,druid,restoration,91,41,50
Yeats,blackmoore,1283,druid,restoration,48,20,28
Paawz,stormscale,1281,druid,restoration,65,33,32
Glaskål,draenor,1281,druid,restoration,101,42,59
Кнесис,howling-fjord,1278,druid,restoration,55,31,24
Leliaen,sylvanas,1278,druid,restoration,75,39,36
Diastra,silvermoon,1278,druid,restoration,255,128,127
Cubalitis,tarren-mill,1276,druid,restoration,39,24,15
Mv,gorgonnash,1276,druid,restoration,52,27,25
Zaratras,arathor,1276,druid,restoration,79,39,40
Nøbødy,silvermoon,1276,druid,restoration,29,14,15
Exoar,ravencrest,1275,druid,restoration,59,27,32
Grololotte,dalaran,1274,druid,restoration,183,97,86
Rrayed,kazzak,1274,druid,restoration,94,47,47
Tanariel,ravencrest,1273,druid,restoration,48,24,24
Урька,blackscar,1273,druid,restoration,71,32,39
Thornat,chamber-of-aspects,1270,druid,restoration,59,32,27
Arulol,aegwynn,1270,druid,restoration,54,25,29
Wazam,kazzak,1269,druid,restoration,152,77,75
ßløøm,outland,1268,druid,restoration,44,27,17
Madshad,draenor,1268,druid,restoration,48,19,29
Julss,archimonde,1267,druid,restoration,114,58,56
Mchots,ragnaros,1267,druid,restoration,95,42,53
Walexx,kazzak,1266,druid,restoration,44,25,19
Delmond,sylvanas,1266,druid,restoration,185,93,92
Nalreaa,kazzak,1265,druid,restoration,48,27,21
Lalon,blackrock,1265,druid,restoration,48,24,24
Noxlunaire,ravencrest,1265,druid,restoration,58,25,33
Elainx,thrall,1264,druid,restoration,30,16,14
Hotto,antonidas,1263,druid,restoration,18,15,3
Cemiink,drakthul,1263,druid,restoration,42,29,13
Дюссельдорф,blackscar,1263,druid,restoration,30,19,11
Shelby,tirion,1263,druid,restoration,81,41,40
Обейрин,gordunni,1261,druid,restoration,78,40,38
Cuxorb,rexxar,1259,druid,restoration,48,21,27
Delarion,nemesis,1258,druid,restoration,36,21,15
Krizak,eredar,1258,druid,restoration,107,61,46
Orten,dun-modr,1258,druid,restoration,48,25,23
Ponytheone,burning-legion,1258,druid,restoration,36,14,22
Chinoiserie,aszune,1255,druid,restoration,209,108,101
Zadrood,rashgarroth,1254,druid,restoration,33,16,17
Närthex,kazzak,1253,druid,restoration,24,14,10
Solstrale,ravencrest,1252,druid,restoration,67,29,38
Bloomer,stormreaver,1251,druid,restoration,42,21,21
Випера,gordunni,1249,druid,restoration,36,19,17
Nizkul,dun-modr,1249,druid,restoration,80,37,43
Deltsur,stormscale,1247,druid,restoration,35,17,18
Кэлиборн,gordunni,1246,druid,restoration,53,26,27
Xomeboci,draenor,1246,druid,restoration,42,14,28
Bunzor,sylvanas,1245,druid,restoration,18,13,5
Eko,auchindoun,1245,druid,restoration,117,58,59
Hotlotta,aegwynn,1244,druid,restoration,24,13,11
Naphé,ysondre,1243,druid,restoration,18,13,5
Crep,krasus,1243,druid,restoration,30,21,9
Erdnuckèl,antonidas,1242,druid,restoration,27,18,9
Robutt,runetotem,1242,druid,restoration,40,25,15
Gnaro,ragnaros,1242,druid,restoration,76,40,36
Plantpuzzl,silvermoon,1242,druid,restoration,42,13,29
Shaelx,nethersturm,1241,druid,restoration,30,13,17
Göli,argent-dawn,1240,druid,restoration,32,16,16
Siuo,ravencrest,1240,druid,restoration,30,13,17
Amoreah,silvermoon,1239,druid,restoration,103,45,58
Ironveins,ravencrest,1238,druid,restoration,42,28,14
Malbo,archimonde,1238,druid,restoration,24,13,11
Коляскальяс,howling-fjord,1238,druid,restoration,112,43,69
Juicy,stormreaver,1237,druid,restoration,42,26,16
Irondruid,silvermoon,1236,druid,restoration,105,58,47
Artichte,archimonde,1236,druid,restoration,24,13,11
Ghaara,outland,1231,druid,restoration,49,28,21
Layzz,archimonde,1231,druid,restoration,29,13,16
Корнерит,gordunni,1229,druid,restoration,82,43,39
Ningannel,argent-dawn,1227,druid,restoration,65,26,39
Razmus,lightbringer,1226,druid,restoration,24,13,11
Vickepicke,stormreaver,1226,druid,restoration,30,16,14
Acwi,dun-morogh,1226,druid,restoration,72,36,36
Ninø,gorgonnash,1226,druid,restoration,51,25,26
Канимэ,howling-fjord,1226,druid,restoration,30,13,17
Weregoon,blackmoore,1225,druid,restoration,191,91,100
Jyggz,azshara,1224,druid,restoration,33,19,14
Mitnik,stormscale,1223,druid,restoration,128,73,55
Fettpumpad,karazhan,1221,druid,restoration,103,59,44
Harei,archimonde,1221,druid,restoration,24,13,11
Memento,kazzak,1220,druid,restoration,24,13,11
Азазиона,gordunni,1220,druid,restoration,30,13,17
Mochiløxz,tarren-mill,1219,druid,restoration,66,35,31
Liquis,outland,1219,druid,restoration,127,63,64
Siako,sanguino,1218,druid,restoration,71,32,39
Arear,frostmane,1216,druid,restoration,85,40,45
Silvyan,silvermoon,1216,druid,restoration,39,17,22
Ischumekcid,anubarak,1215,druid,restoration,24,13,11
Bonsai,terrordar,1215,druid,restoration,43,21,22
Tommix,ravencrest,1214,druid,restoration,26,14,12
Киберужас,gordunni,1214,druid,restoration,173,90,83
Ceapamatii,sylvanas,1213,druid,restoration,54,30,24
Дуггизавр,howling-fjord,1213,druid,restoration,29,13,16
Deretus,blackmoore,1213,druid,restoration,34,13,21
Lépaw,twisting-nether,1212,druid,restoration,95,46,49
Tsurío,thrall,1211,druid,restoration,108,60,48
Ýanux,aegwynn,1210,druid,restoration,22,14,8
Dreaddot,archimonde,1210,druid,restoration,24,13,11
Séyla,blackrock,1209,druid,restoration,24,13,11
Zelíx,bronzebeard,1208,druid,restoration,71,41,30
Cazzette,grim-batol,1208,druid,restoration,46,26,20
Aebí,dalaran,1208,druid,restoration,24,13,11
Shapeshafter,twisting-nether,1207,druid,restoration,114,56,58
Vícvega,ravencrest,1206,druid,restoration,52,28,24
Midnightstry,alakir,1206,druid,restoration,304,158,146
Bearinator,aggramar,1205,druid,restoration,116,63,53
Maxekaxe,sylvanas,1205,druid,restoration,47,22,25
Menolao,dun-morogh,1203,druid,restoration,62,36,26
Farodiin,blackmoore,1203,druid,restoration,138,73,65
Эверих,soulflayer,1203,druid,restoration,71,34,37
Багетлюбви,howling-fjord,1203,druid,restoration,39,18,21
Callìa,sylvanas,1203,druid,restoration,71,32,39
Bonza,agamaggan,1202,druid,restoration,84,39,45
Schwertlilie,aegwynn,1202,druid,restoration,29,13,16
Дилайт,blackscar,1201,druid,restoration,30,13,17
Saberrtooth,twisting-nether,1201,druid,restoration,66,25,41
Namenloser,azshara,1200,druid,restoration,72,39,33
Goodzychoo,silvermoon,1199,druid,restoration,36,17,19
Wtfck,outland,1199,druid,restoration,90,42,48
Weiden,twisting-nether,1199,druid,restoration,42,19,23
Telaroxx,die-nachtwache,1199,druid,restoration,36,13,23
Basajáun,dun-modr,1198,druid,restoration,60,21,39
Karlsn,ravencrest,1197,druid,restoration,25,14,11
Arazorwyn,ravencrest,1196,druid,restoration,77,45,32
Shadraw,arakarahm,1195,druid,restoration,30,13,17
Amakary,blackrock,1193,druid,restoration,42,19,23
Стенлимур,eversong,1191,druid,restoration,54,27,27
Yazari,nathrezim,1188,druid,restoration,36,14,22
Chable,hyjal,1187,druid,restoration,60,31,29
Wiyah,hyjal,1186,druid,restoration,30,14,16
Rakúsh,thrall,1184,druid,restoration,37,21,16
Jiujiteiro,tarren-mill,1184,druid,restoration,47,26,21
Baldurix,blackrock,1184,druid,restoration,32,15,17
Collîî,aegwynn,1183,druid,restoration,44,25,19
Thieane,blackhand,1183,druid,restoration,24,13,11
Kryptonîte,twisting-nether,1183,druid,restoration,28,13,15
Inkeyes,outland,1182,druid,restoration,107,45,62
Shenandoah,hyjal,1181,druid,restoration,42,25,17
Vanlise,ravencrest,1181,druid,restoration,90,42,48
Nissemand,ravencrest,1180,druid,restoration,54,28,26
Papanik,tarren-mill,1179,druid,restoration,54,30,24
Soratess,azshara,1179,druid,restoration,45,19,26
Exane,ragnaros,1178,druid,restoration,30,18,12
Mutato,draenor,1178,druid,restoration,216,118,98
Amberleaff,auchindoun,1178,druid,restoration,31,16,15
Luneriá,blackmoore,1176,druid,restoration,42,15,27
Thaldrenaar,argent-dawn,1175,druid,restoration,38,15,23
Hílarío,sanguino,1174,druid,restoration,38,13,25
Restopesto,silvermoon,1173,druid,restoration,38,22,16
Ubbeleg,kazzak,1172,druid,restoration,42,22,20
Tsuteymanga,veknilash,1172,druid,restoration,66,33,33
Digestivebis,defias-brotherhood,1170,druid,restoration,91,55,36
Shinymoomoo,tarren-mill,1169,druid,restoration,27,14,13
Mayurí,kazzak,1166,druid,restoration,30,18,12
Xdrus,argent-dawn,1166,druid,restoration,50,26,24
Вертуос,soulflayer,1166,druid,restoration,51,23,28
Halleyz,hyjal,1163,druid,restoration,135,70,65
Bynxx,antonidas,1163,druid,restoration,118,57,61
Eô,antonidas,1163,druid,restoration,30,14,16
Madschinken,malganis,1162,druid,restoration,71,28,43
Mchøt,ravencrest,1162,druid,restoration,62,23,39
Fricky,burning-blade,1161,druid,restoration,24,16,8
Forzend,twisting-nether,1161,druid,restoration,20,13,7
Дудумейстер,howling-fjord,1160,druid,restoration,144,60,84
Lethius,silvermoon,1158,druid,restoration,33,15,18
Makelsi,tarren-mill,1158,druid,restoration,36,15,21
Ушастикэ,gordunni,1157,druid,restoration,32,27,5
Бульбион,gordunni,1157,druid,restoration,133,68,65
Røsary,stormscale,1156,druid,restoration,81,43,38
Walenok,thrall,1155,druid,restoration,185,90,95
Cäsïo,khaz-modan,1154,druid,restoration,54,32,22
Corias,blackmoore,1154,druid,restoration,42,14,28
Pikkusuhnu,twisting-nether,1152,druid,restoration,30,12,18
Ÿdrassia,archimonde,1152,druid,restoration,44,17,27
Lfsecondreju,ravencrest,1151,druid,restoration,18,12,6
Dyloxe,silvermoon,1151,druid,restoration,24,12,12
Zekmvp,silvermoon,1151,druid,restoration,24,12,12
Ковамедведь,borean-tundra,1151,druid,restoration,65,27,38
Hotop,draenor,1151,druid,restoration,30,12,18
Древнина,gordunni,1150,druid,restoration,96,51,45
Rozt,ravencrest,1150,druid,restoration,24,12,12
Dreathqt,twisting-nether,1150,druid,restoration,24,12,12
Sâty,draenor,1150,druid,restoration,36,14,22
Пупсики,gordunni,1149,druid,restoration,68,29,39
Burattino,draenor,1147,druid,restoration,12,12,0
Olympïee,archimonde,1147,druid,restoration,24,12,12
Zuuhhl,ravencrest,1146,druid,restoration,18,12,6
Eluñeãdore,silvermoon,1146,druid,restoration,41,26,15
Mcneil,wrathbringer,1146,druid,restoration,36,20,16
Elmáestró,aegwynn,1146,druid,restoration,24,12,12
Hordzee,blackmoore,1146,druid,restoration,58,25,33
Фатуомуэрте,razuvious,1146,druid,restoration,30,12,18
Saimdude,blackrock,1145,druid,restoration,48,25,23
Elainia,emerald-dream,1144,druid,restoration,24,12,12
Mikshak,drakthul,1144,druid,restoration,24,12,12
Trànsformer,nemesis,1142,druid,restoration,30,12,18
Möllemäck,sylvanas,1141,druid,restoration,18,12,6
Rockyfella,alexstrasza,1141,druid,restoration,24,12,12
Lynysae,blackmoore,1141,druid,restoration,29,13,16
Ajwen,tarren-mill,1141,druid,restoration,30,12,18
Clownrad,tarren-mill,1141,druid,restoration,30,12,18
Stuu,nathrezim,1140,druid,restoration,24,12,12
Adiycrazy,outland,1138,druid,restoration,54,22,32
Hót,ravencrest,1138,druid,restoration,42,14,28
Obamos,stormscale,1136,druid,restoration,18,12,6
Golddy,hyjal,1136,druid,restoration,80,38,42
Lucael,blackmoore,1135,druid,restoration,66,24,42
Lisovamavka,draenor,1134,druid,restoration,64,32,32
Moundîr,archimonde,1134,druid,restoration,54,21,33
Lïs,the-maelstrom,1133,druid,restoration,49,29,20
Druidorie,ravencrest,1133,druid,restoration,24,12,12
Curoahojas,silvermoon,1132,druid,restoration,130,56,74
Racadruid,antonidas,1132,druid,restoration,48,17,31
Bioházard,blackrock,1130,druid,restoration,36,20,16
Neri,shattered-hand,1130,druid,restoration,24,12,12
Spacenoub,archimonde,1130,druid,restoration,24,12,12
Thunderzeus,mazrigos,1129,druid,restoration,40,20,20
Druiddingo,lightnings-blade,1127,druid,restoration,24,12,12
Sariel,saurfang,1127,druid,restoration,129,56,73
Druibe,burning-legion,1127,druid,restoration,56,23,33
Simplydrood,archimonde,1127,druid,restoration,30,12,18
Dadud,twisting-nether,1126,druid,restoration,30,18,12
Kbåkå,ravencrest,1125,druid,restoration,42,19,23
Lil,elune,1124,druid,restoration,36,12,24
Лаегмерил,gordunni,1120,druid,restoration,40,23,17
Vranz,draenor,1120,druid,restoration,67,32,35
Raysa,archimonde,1119,druid,restoration,69,35,34
Domsz,dalaran,1119,druid,restoration,75,37,38
Moonshîne,arygos,1117,druid,restoration,94,54,40
Kikinho,argent-dawn,1117,druid,restoration,24,12,12
Maryjuanita,silvermoon,1116,druid,restoration,146,64,82
Heidepaa,tichondrius,1115,druid,restoration,30,13,17
Celendiil,argent-dawn,1115,druid,restoration,103,30,73
Lïlja,tarren-mill,1113,druid,restoration,24,15,9
Ndnd,drakthul,1112,druid,restoration,82,42,40
Herbiko,turalyon,1111,druid,restoration,182,93,89
Mayhh,ragnaros,1111,druid,restoration,90,41,49
Legharta,ravencrest,1111,druid,restoration,84,31,53
Uvøgin,ragnaros,1109,druid,restoration,18,12,6
Ðelnôs,destromath,1109,druid,restoration,42,15,27
Blazor,eredar,1108,druid,restoration,52,24,28
Arfedan,kazzak,1106,druid,restoration,66,35,31
Klerosa,moonglade,1105,druid,restoration,56,24,32
Berdix,ragnaros,1103,druid,restoration,25,14,11
Thaibarian,shattered-hand,1102,druid,restoration,48,26,22
Zirkuszwei,aegwynn,1102,druid,restoration,29,14,15
Mikeisbike,ragnaros,1101,druid,restoration,21,13,8
Vertymbras,hyjal,1101,druid,restoration,44,25,19
Ankhenature,outland,1100,druid,restoration,71,40,31
Shadowmeld,stormreaver,1100,druid,restoration,32,13,19
Catkayn,stormscale,1100,druid,restoration,36,12,24
Räysa,archimonde,1098,druid,restoration,214,105,109
Solutionx,aegwynn,1096,druid,restoration,33,13,20
Ccmydcv,archimonde,1095,druid,restoration,25,13,12
Snowrk,hyjal,1093,druid,restoration,54,31,23
Tharandrél,argent-dawn,1092,druid,restoration,72,20,52
Relxc,outland,1091,druid,restoration,18,13,5
Spikill,uldaman,1091,druid,restoration,24,16,8
Тианна,razuvious,1091,druid,restoration,48,24,24
Zillo,stormscale,1091,druid,restoration,80,34,46
Ayehotx,ragnaros,1090,druid,restoration,35,15,20
Hotouck,hyjal,1089,druid,restoration,38,22,16
Mayte,ragnaros,1088,druid,restoration,23,14,9
Ganoförd,zuljin,1087,druid,restoration,19,13,6
Taatz,stormscale,1087,druid,restoration,85,33,52
Relache,twisting-nether,1086,druid,restoration,48,26,22
Alexstraza,arthas,1085,druid,restoration,49,23,26
Сваткумбрат,eversong,1084,druid,restoration,108,40,68
Jamburapro,sylvanas,1082,druid,restoration,130,69,61
Ghostbustér,emeriss,1081,druid,restoration,61,36,25
Niknoom,azjolnerub,1081,druid,restoration,110,63,47
Bazilika,argent-dawn,1080,druid,restoration,137,74,63
Georn,bladefist,1079,druid,restoration,17,12,5
Vurgyl,hyjal,1079,druid,restoration,54,33,21
Theridrax,twisting-nether,1078,druid,restoration,38,18,20
Wyngx,blackrock,1076,druid,restoration,60,34,26
Zarlaac,ravencrest,1075,druid,restoration,66,27,39
Drúídárn,talnivarr,1074,druid,restoration,54,26,28
Bloomly,tarren-mill,1073,druid,restoration,36,18,18
Jagerdog,archimonde,1072,druid,restoration,13,12,1
Кишкинахир,razuvious,1072,druid,restoration,42,22,20
Алунар,lich-king,1070,druid,restoration,84,39,45
Petitchät,archimonde,1069,druid,restoration,46,23,23
Инский,howling-fjord,1069,druid,restoration,49,24,25
Mirana,drakthul,1067,druid,restoration,39,21,18
Аматэррасу,blackscar,1067,druid,restoration,36,18,18
Betelgues,kazzak,1066,druid,restoration,132,70,62
Elanrya,argent-dawn,1066,druid,restoration,53,15,38
Gyvunas,silvermoon,1065,druid,restoration,43,25,18
Djungelgrabb,twisting-nether,1064,druid,restoration,48,22,26
Dreäms,ravencrest,1063,druid,restoration,152,83,69
Shadowcat,archimonde,1063,druid,restoration,25,12,13
Secondage,blackmoore,1057,druid,restoration,56,24,32
Shylanna,ragnaros,1057,druid,restoration,28,12,16
Kókushibò,archimonde,1056,druid,restoration,12,11,1
Justforgames,ravencrest,1056,druid,restoration,12,11,1
Degentiuso,alakir,1056,druid,restoration,30,21,9
Kobrá,ravencrest,1056,druid,restoration,18,11,7
Bananadru,stormscale,1056,druid,restoration,18,11,7
Isitbleedin,silvermoon,1056,druid,restoration,18,11,7
Noramun,alexstrasza,1056,druid,restoration,18,11,7
Лабирошка,blackscar,1056,druid,restoration,24,11,13
Хлайси,gordunni,1056,druid,restoration,24,11,13
Taurvid,outland,1056,druid,restoration,24,11,13
Bigbones,frostwolf,1056,druid,restoration,72,24,48
Happypeanut,blackmoore,1055,druid,restoration,18,11,7
Fotmrerollér,darksorrow,1055,druid,restoration,63,34,29
Chocofrijj,tarren-mill,1055,druid,restoration,24,11,13
Арбузир,howling-fjord,1055,druid,restoration,54,21,33
Ðezo,stormscale,1055,druid,restoration,30,11,19
Slimp,the-maelstrom,1055,druid,restoration,30,11,19
Oschlandor,blackmoore,1054,druid,restoration,12,11,1
Светдру,blackscar,1054,druid,restoration,24,11,13
Solern,ravencrest,1054,druid,restoration,24,11,13
Elviiradruid,tarren-mill,1053,druid,restoration,24,11,13
Lemicus,twisting-nether,1053,druid,restoration,30,11,19
Jackyblue,silvermoon,1053,druid,restoration,30,11,19
Noskillx,auchindoun,1052,druid,restoration,12,11,1
Тчаёк,gordunni,1052,druid,restoration,21,13,8
Benjosef,blackmoore,1051,druid,restoration,62,31,31
Muminoses,burning-legion,1051,druid,restoration,30,11,19
Fondü,outland,1050,druid,restoration,18,11,7
Druidenbeton,antonidas,1050,druid,restoration,24,13,11
Larlye,dun-modr,1050,druid,restoration,24,11,13
Exilia,kragjin,1050,druid,restoration,24,11,13
Spidete,sanguino,1049,druid,restoration,78,41,37
Uuni,sylvanas,1049,druid,restoration,30,11,19
Влажныйдру,soulflayer,1048,druid,restoration,24,11,13
Cigamt,kazzak,1047,druid,restoration,18,12,6
Felfran,ravencrest,1047,druid,restoration,36,13,23
Kirïllx,silvermoon,1046,druid,restoration,89,47,42
Trolléverte,archimonde,1046,druid,restoration,69,34,35
Sodamncute,ravencrest,1046,druid,restoration,24,11,13
Jehtrotull,nemesis,1046,druid,restoration,40,17,23
Pzyhlol,anetheron,1045,druid,restoration,18,11,7
Soný,aegwynn,1043,druid,restoration,24,11,13
Greengolly,argent-dawn,1042,druid,restoration,30,11,19
Luarbak,kazzak,1041,druid,restoration,18,11,7
Hypnosoad,outland,1041,druid,restoration,160,72,88
Xenva,blackmoore,1041,druid,restoration,54,24,30
Malleria,blackmoore,1041,druid,restoration,30,13,17
Spoco,defias-brotherhood,1040,druid,restoration,102,56,46
Ранок,fordragon,1040,druid,restoration,24,11,13
Жолудь,gordunni,1040,druid,restoration,66,28,38
Dfjguidfg,baelgun,1040,druid,restoration,36,13,23
Дремлин,deathguard,1038,druid,restoration,212,99,113
Kezbaniye,silvermoon,1035,druid,restoration,18,11,7
Lutzmiller,eredar,1035,druid,restoration,236,112,124
Growiêlle,ravencrest,1034,druid,restoration,30,17,13
Pakù,archimonde,1033,druid,restoration,12,11,1
Vextron,burning-legion,1030,druid,restoration,26,13,13
Xadidruîd,blackrock,1030,druid,restoration,42,11,31
Mendozä,stormscale,1029,druid,restoration,82,38,44
Hopê,burning-legion,1028,druid,restoration,108,61,47
Corrupthz,outland,1028,druid,restoration,24,11,13
Storpboom,drakthul,1028,druid,restoration,31,13,18
Chéchédroïd,marécage-de-zangar,1027,druid,restoration,64,30,34
Klørfem,draenor,1027,druid,restoration,36,13,23
Davincidru,tarren-mill,1026,druid,restoration,68,32,36
Ella,kult-der-verdammten,1024,druid,restoration,24,15,9
Raysien,doomhammer,1021,druid,restoration,24,13,11
Shanikya,argent-dawn,1021,druid,restoration,44,20,24
Elrroir,dun-modr,1021,druid,restoration,34,12,22
Zyska,outland,1020,druid,restoration,223,103,120
Baroona,kazzak,1019,druid,restoration,24,14,10
Tângo,eredar,1019,druid,restoration,31,15,16
Malandrin,khazgoroth,1019,druid,restoration,55,25,30
Jagu,blackrock,1018,druid,restoration,30,16,14
Santamonica,blackrock,1018,druid,restoration,36,13,23
Эмканегодяйк,galakrond,1016,druid,restoration,95,50,45
Омгдру,gordunni,1016,druid,restoration,117,53,64
Sfarcolacul,tarren-mill,1013,druid,restoration,90,50,40
Фераст,azuregos,1013,druid,restoration,24,11,13
Zêrg,ysondre,1012,druid,restoration,24,11,13
Komiker,ravencrest,1011,druid,restoration,47,29,18
Dobbmaster,aegwynn,1011,druid,restoration,244,121,123
Dirtyhacks,blackmoore,1010,druid,restoration,36,17,19
Флиперкэт,howling-fjord,1010,druid,restoration,36,12,24
Дендринис,gordunni,1009,druid,restoration,30,19,11
Ukri,ravencrest,1008,druid,restoration,22,11,11
Lightboxx,ravencrest,1005,druid,restoration,30,19,11
Akuda,blackrock,1004,druid,restoration,21,11,10
Фэйблуд,blackscar,1004,druid,restoration,138,72,66
Artracos,thrall,1003,druid,restoration,35,11,24
Feedbark,stormscale,1002,druid,restoration,23,13,10
Spiralout,nemesis,1000,druid,restoration,298,144,154
Spankproof,kazzak,999,druid,restoration,20,12,8
Iprex,outland,997,druid,restoration,54,31,23
Kasjuz,tarren-mill,997,druid,restoration,24,12,12
Pudseytree,doomhammer,996,druid,restoration,74,38,36
Cárnagè,stormscale,996,druid,restoration,92,40,52
Дела,eversong,994,druid,restoration,36,21,15
Jimpä,outland,991,druid,restoration,22,11,11
Sorahe,arthas,989,druid,restoration,20,12,8
Nokodo,silvermoon,988,druid,restoration,39,19,20
Sooamazing,korgall,987,druid,restoration,27,15,12
Moonfan,darkmoon-faire,986,druid,restoration,48,17,31
Aolynk,twisting-nether,986,druid,restoration,35,12,23
Yespapa,kazzak,985,druid,restoration,273,140,133
Inspiredrood,archimonde,984,druid,restoration,107,58,49
Nezruslfour,dun-modr,983,druid,restoration,18,12,6
Draneis,les-sentinelles,983,druid,restoration,68,40,28
Weremyst,outland,982,druid,restoration,32,11,21
Featherball,tarren-mill,981,druid,restoration,42,25,17
Ellismera,argent-dawn,978,druid,restoration,36,17,19
Liloè,onyxia,975,druid,restoration,48,24,24
Arydan,quelthalas,974,druid,restoration,28,11,17
Nali,arthas,972,druid,restoration,19,12,7
Sinthorasia,blackrock,972,druid,restoration,28,12,16
Ванилане,ashenvale,971,druid,restoration,66,27,39
Torawara,ragnaros,969,druid,restoration,17,11,6
Zerschmatzen,aegwynn,965,druid,restoration,75,23,52
Shaorma,ravencrest,964,druid,restoration,18,13,5
Jimmorris,eredar,964,druid,restoration,24,11,13
Greyhøund,archimonde,964,druid,restoration,37,14,23
Дазашо,soulflayer,964,druid,restoration,93,35,58
Jambonmaster,archimonde,963,druid,restoration,30,15,15
Wegian,sylvanas,962,druid,restoration,63,36,27
Прожималодру,deathguard,962,druid,restoration,66,27,39
Wolfeiy,ravenholdt,961,druid,restoration,145,77,68
Bntyx,dun-modr,960,druid,restoration,18,10,8
Foxyfeet,outland,960,druid,restoration,18,10,8
Caldino,tarren-mill,960,druid,restoration,23,11,12
Eviency,outland,960,druid,restoration,24,10,14
Crìmz,aszune,960,druid,restoration,36,10,26
Worstdruid,sanguino,959,druid,restoration,12,10,2
Treedog,ravencrest,959,druid,restoration,18,10,8
Snedden,silvermoon,959,druid,restoration,30,15,15
Tjann,darksorrow,959,druid,restoration,24,10,14
Kasugia,aegwynn,959,druid,restoration,24,10,14
Zmira,outland,959,druid,restoration,30,10,20
Bäckey,silvermoon,958,druid,restoration,12,10,2
Rînaa,ravencrest,958,druid,restoration,18,10,8
Iqfrags,silvermoon,957,druid,restoration,21,14,7
Prayx,dalaran,957,druid,restoration,30,10,20
Plúx,antonidas,956,druid,restoration,26,10,16
Элеарсия,gordunni,956,druid,restoration,42,15,27
Steuerung,twisting-nether,956,druid,restoration,30,10,20
Indann,kazzak,955,druid,restoration,24,10,14
Whiplazh,archimonde,954,druid,restoration,18,10,8
Taèzoth,terokkar,954,druid,restoration,18,10,8
Moonfetamine,silvermoon,954,druid,restoration,30,10,20
Килаф,gordunni,952,druid,restoration,18,10,8
Энчантерес,gordunni,952,druid,restoration,30,10,20
Johndru,kazzak,948,druid,restoration,71,26,45
Wrak,eonar,947,druid,restoration,18,10,8
Triplej,twisting-nether,946,druid,restoration,52,26,26
Thélon,antonidas,945,druid,restoration,69,35,34
Shaize,dalaran,943,druid,restoration,24,10,14
Muju,stormscale,942,druid,restoration,66,30,36
Talyfox,outland,941,druid,restoration,33,11,22
Svass,ragnaros,940,druid,restoration,18,10,8
Erinark,aegwynn,940,druid,restoration,42,10,32
Buffspencer,ragnaros,936,druid,restoration,107,56,51
Nimèl,argent-dawn,936,druid,restoration,42,18,24
Fubarmeep,outland,932,druid,restoration,42,22,20
Borne,aggra-português,930,druid,restoration,24,10,14
Krollix,dun-morogh,929,druid,restoration,47,25,22
Trikill,hyjal,929,druid,restoration,49,20,29
Loumpa,hyjal,928,druid,restoration,24,14,10
Maldrýn,stormscale,927,druid,restoration,17,10,7
Gribix,kazzak,927,druid,restoration,18,10,8
Ellinaki,neptulon,927,druid,restoration,84,42,42
Sinestah,ravencrest,926,druid,restoration,79,35,44
Bigborst,ravencrest,924,druid,restoration,20,11,9
Missfar,doomhammer,923,druid,restoration,42,16,26
Djclonex,archimonde,922,druid,restoration,36,16,20
Мирафлоресс,booty-bay,921,druid,restoration,88,39,49
Kaod,outland,918,druid,restoration,33,17,16
Kkriss,stormscale,918,druid,restoration,22,11,11
Avadakodavra,ravencrest,912,druid,restoration,50,14,36
Yellow,sylvanas,911,druid,restoration,21,10,11
Yam,thrall,911,druid,restoration,29,10,19
Бехеровка,grom,910,druid,restoration,58,24,34
Woodrla,sylvanas,908,druid,restoration,54,30,24
Kárél,drakthul,906,druid,restoration,24,12,12
Shokazu,blackmoore,906,druid,restoration,88,41,47
Blolzz,silvermoon,904,druid,restoration,30,14,16
Akifumi,archimonde,903,druid,restoration,35,11,24
Celéry,silvermoon,896,druid,restoration,16,10,6
Lorucka,die-nachtwache,894,druid,restoration,20,10,10
Barbesco,zuljin,892,druid,restoration,70,34,36
Arianator,culte-de-la-rive-noire,890,druid,restoration,41,21,20
Борзойрог,soulflayer,890,druid,restoration,54,23,31
Raylla,dun-modr,888,druid,restoration,24,11,13
Naturberserk,tarren-mill,887,druid,restoration,27,12,15
Feanthur,drakthul,886,druid,restoration,148,72,76
ßlackßåmßå,zuljin,886,druid,restoration,29,13,16
Nachtelf,lightbringer,881,druid,restoration,96,36,60
Arthoriana,thrall,878,druid,restoration,47,10,37
Do,alakir,876,druid,restoration,30,10,20
Khalynn,eredar,875,druid,restoration,80,28,52
Lyarx,ragnaros,873,druid,restoration,42,20,22
Bunnykiss,kazzak,873,druid,restoration,24,10,14
Merakir,dun-modr,870,druid,restoration,72,25,47
Spaartaa,blackhand,870,druid,restoration,36,10,26
Argbjörn,sylvanas,868,druid,restoration,57,23,34
Dokus,grim-batol,866,druid,restoration,30,11,19
Healbrah,burning-blade,865,druid,restoration,54,10,44
Koshai,twisting-nether,864,druid,restoration,18,9,9
Lxstcentury,stormscale,864,druid,restoration,18,9,9
Иксвовски,gordunni,864,druid,restoration,18,9,9
Kawèlz,archimonde,864,druid,restoration,18,9,9
Viggez,outland,864,druid,restoration,18,9,9
Ponardo,outland,864,druid,restoration,19,9,10
Лабирон,soulflayer,864,druid,restoration,24,9,15
Tarshish,outland,863,druid,restoration,12,9,3
Vacaleiteira,aggra-português,863,druid,restoration,18,9,9
Madmanul,draenor,863,druid,restoration,18,9,9
Místergreen,ravencrest,863,druid,restoration,18,9,9
Jtsoigne,ysondre,863,druid,restoration,40,19,21
Clonecity,ravencrest,863,druid,restoration,24,9,15
Drèamer,ravencrest,863,druid,restoration,24,9,15
Drrood,stormscale,862,druid,restoration,12,9,3
Yandris,argent-dawn,862,druid,restoration,18,9,9
Csmedruid,blackrock,862,druid,restoration,18,9,9
Pavelot,runetotem,862,druid,restoration,22,9,13
Jugai,archimonde,861,druid,restoration,18,9,9
Smucka,ragnaros,861,druid,restoration,24,9,15
Fknmad,burning-blade,860,druid,restoration,12,9,3
Thardruid,stormscale,860,druid,restoration,18,9,9
Macanbre,tarren-mill,860,druid,restoration,66,31,35
Helguard,silvermoon,860,druid,restoration,24,9,15
Suunto,blackrock,859,druid,restoration,18,9,9
Caturday,terrordar,859,druid,restoration,30,13,17
Synoe,la-croisade-écarlate,855,druid,restoration,18,9,9
Ihone,frostmane,855,druid,restoration,24,9,15
Nutzlos,azshara,855,druid,restoration,144,50,94
Aivy,boulderfist,854,druid,restoration,37,17,20
Happyhoter,blackrock,854,druid,restoration,24,9,15
Ballosh,hyjal,854,druid,restoration,24,9,15
Fajia,frostmane,854,druid,restoration,30,9,21
Nious,kazzak,853,druid,restoration,24,9,15
Lunatrixs,dun-modr,852,druid,restoration,18,9,9
Инуараши,ashenvale,851,druid,restoration,38,14,24
Baineaordur,krasus,850,druid,restoration,18,9,9
Driiptoohard,turalyon,849,druid,restoration,99,43,56
Simouch,archimonde,848,druid,restoration,124,57,67
Kattman,tarren-mill,848,druid,restoration,24,9,15
Relay,ragnaros,847,druid,restoration,24,12,12
Котанет,gordunni,847,druid,restoration,36,12,24
Jendiiss,drakthul,843,druid,restoration,22,11,11
Chujogrzmot,kazzak,843,druid,restoration,23,9,14
Seabath,kirin-tor,841,druid,restoration,24,9,15
Houwalia,archimonde,840,druid,restoration,48,22,26
Kaydjan,elune,839,druid,restoration,18,10,8
Альбигоиц,thermaplugg,837,druid,restoration,24,9,15
Clearwipe,thunderhorn,835,druid,restoration,24,9,15
Robeala,twisting-nether,832,druid,restoration,42,17,25
Rááy,blackrock,831,druid,restoration,17,9,8
Maylika,hyjal,831,druid,restoration,52,13,39
Ånåphorå,archimonde,830,druid,restoration,17,9,8
Braxxiloa,nazjatar,830,druid,restoration,18,9,9
Theguyandbea,draenor,830,druid,restoration,53,17,36
Omegaheals,scarshield-legion,826,druid,restoration,30,13,17
Nube,alonsus,826,druid,restoration,66,25,41
Catbear,kazzak,824,druid,restoration,61,28,33
Ruap,blackmoore,822,druid,restoration,20,10,10
Oyoyo,kaelthas,819,druid,restoration,20,10,10
Metaboss,ravencrest,817,druid,restoration,71,24,47
Karvapersé,argent-dawn,816,druid,restoration,24,10,14
Shakshun,draenor,813,druid,restoration,30,11,19
Ruhlide,anetheron,810,druid,restoration,23,9,14
Droodfist,khaz-modan,805,druid,restoration,54,24,30
Purple,draenor,803,druid,restoration,18,9,9
Kiadorn,stormreaver,799,druid,restoration,22,9,13
Buitonix,khaz-modan,798,druid,restoration,135,60,75
Moontriix,kazzak,798,druid,restoration,22,9,13
Trytargetme,outland,796,druid,restoration,17,9,8
Sacmycløne,draenor,786,druid,restoration,35,10,25
Gladyon,ravencrest,785,druid,restoration,24,9,15
Bidodici,nemesis,783,druid,restoration,135,57,78
Buufu,kazzak,780,druid,restoration,19,9,10
Çhuucky,khaz-modan,780,druid,restoration,71,18,53
Ratskrone,alleria,778,druid,restoration,148,66,82
Stinka,ravencrest,768,druid,restoration,12,8,4
Ecological,outland,768,druid,restoration,12,8,4
Målukah,archimonde,768,druid,restoration,12,8,4
Catdoge,thrall,768,druid,restoration,12,8,4
Justdmg,ravencrest,768,druid,restoration,12,8,4
Dablol,draenor,768,druid,restoration,12,8,4
Nohos,blackrock,768,druid,restoration,18,8,10
Xanxiety,outland,768,druid,restoration,18,8,10
Ксенона,gordunni,768,druid,restoration,18,8,10
Jin,the-venture-co,768,druid,restoration,18,8,10
Lyricx,kazzak,768,druid,restoration,18,8,10
Flensí,stormscale,768,druid,restoration,18,8,10
Huebbi,blackmoore,768,druid,restoration,18,8,10
Renewer,argent-dawn,768,druid,restoration,21,9,12
Neverfall,aegwynn,768,druid,restoration,24,10,14
Trol,malganis,768,druid,restoration,24,9,15
Skilloxus,gilneas,768,druid,restoration,105,35,70
Ajaÿ,sylvanas,768,druid,restoration,24,8,16
Lyalis,kazzak,768,druid,restoration,30,8,22
Taylrswftmnd,twisting-nether,767,druid,restoration,12,8,4
Alexialol,silvermoon,767,druid,restoration,12,8,4
Piggo,tarren-mill,767,druid,restoration,12,8,4
Liunara,nemesis,767,druid,restoration,18,8,10
Brindefolie,archimonde,767,druid,restoration,18,8,10
Quasarx,ravencrest,767,druid,restoration,18,8,10
Fanboij,kazzak,767,druid,restoration,18,8,10
Lavague,hyjal,767,druid,restoration,18,8,10
Dêrbombär,guldan,767,druid,restoration,24,8,16
Tehira,antonidas,767,druid,restoration,30,8,22
Seekx,silvermoon,766,druid,restoration,12,8,4
Ghxsty,silvermoon,766,druid,restoration,18,8,10
Uncleruccus,outland,766,druid,restoration,24,8,16
Berkalicious,frostmane,765,druid,restoration,16,9,7
Razudru,nerathor,765,druid,restoration,15,8,7
Crydotcom,aegwynn,765,druid,restoration,18,8,10
Biebear,sylvanas,765,druid,restoration,24,8,16
Wísh,stormscale,764,druid,restoration,18,8,10
Jahmandudu,ragnaros,764,druid,restoration,24,8,16
Reiss,tarren-mill,764,druid,restoration,24,8,16
Димитруа,howling-fjord,761,druid,restoration,18,8,10
Aliani,trollbane,761,druid,restoration,24,8,16
Lyndruid,sylvanas,760,druid,restoration,96,33,63
Друоид,howling-fjord,759,druid,restoration,24,8,16
Kkthanks,twisting-nether,757,druid,restoration,12,8,4
Semiflora,silvermoon,757,druid,restoration,24,8,16
Karmacowboy,ravencrest,756,druid,restoration,24,8,16
Mandy,spinebreaker,755,druid,restoration,18,8,10
Zalherbata,burning-legion,755,druid,restoration,24,8,16
Nargaí,kargath,753,druid,restoration,18,8,10
Narawenn,ysondre,753,druid,restoration,18,8,10
Hootymactoot,magtheridon,752,druid,restoration,12,8,4
Karochi,kazzak,751,druid,restoration,12,8,4
Malfis,the-maelstrom,748,druid,restoration,18,8,10
Wildblu,nemesis,748,druid,restoration,24,8,16
Bug,eredar,747,druid,restoration,12,8,4
Foyboy,ravencrest,747,druid,restoration,62,13,49
Mirreska,silvermoon,743,druid,restoration,64,17,47
Frostfox,ghostlands,741,druid,restoration,22,9,13
Haveacoffee,stormscale,739,druid,restoration,54,17,37
Skraks,ysondre,739,druid,restoration,30,8,22
Kirkey,terokkar,736,druid,restoration,82,37,45
Krayzz,tarren-mill,736,druid,restoration,28,8,20
Ivysun,auchindoun,734,druid,restoration,20,9,11
Devdude,blackrock,734,druid,restoration,22,8,14
Saxondale,aszune,729,druid,restoration,18,8,10
Allod,stormscale,728,druid,restoration,209,100,109
Лордсенка,eversong,721,druid,restoration,18,8,10
Catman,eredar,717,druid,restoration,15,9,6
Barkingdog,tarren-mill,717,druid,restoration,21,9,12
Jakeparkki,sylvanas,714,druid,restoration,26,9,17
Тремакулан,gordunni,711,druid,restoration,18,9,9
Rbosse,aszune,702,druid,restoration,14,8,6
Avemonthemus,silvermoon,701,druid,restoration,23,9,14
Sylocin,earthen-ring,699,druid,restoration,16,8,8
Itswoland,emeriss,687,druid,restoration,11,8,3
Найтед,gordunni,678,druid,restoration,17,10,7
Fòggie,silvermoon,675,druid,restoration,28,9,19
Магараганага,azuregos,675,druid,restoration,25,8,17
Pissbomb,ravencrest,672,druid,restoration,12,7,5
Ekexd,grim-batol,672,druid,restoration,12,7,5
Boomkïn,draenor,672,druid,restoration,12,7,5
Jakeffsake,stormscale,672,druid,restoration,12,7,5
Icecöld,silvermoon,672,druid,restoration,12,7,5
Innos,azshara,672,druid,restoration,12,7,5
Pll,defias-brotherhood,672,druid,restoration,12,7,5
Riddlerdruid,aegwynn,672,druid,restoration,12,7,5
Maiverdr,ravencrest,672,druid,restoration,12,7,5
Kll,defias-brotherhood,672,druid,restoration,12,7,5
Luuxiå,archimonde,672,druid,restoration,12,7,5
Антиблэк,soulflayer,672,druid,restoration,12,7,5
Druidomedio,pozzo-delleternità,672,druid,restoration,12,7,5
Bll,defias-brotherhood,672,druid,restoration,12,7,5
Buckxxz,aegwynn,672,druid,restoration,12,7,5
Krewèlla,emerald-dream,672,druid,restoration,12,7,5
Skysrex,outland,672,druid,restoration,12,7,5
Zarune,sanguino,672,druid,restoration,12,7,5
Zhényá,ravencrest,672,druid,restoration,16,8,8
Tommiz,silvermoon,672,druid,restoration,18,7,11
Smightydr,silvermoon,672,druid,restoration,18,7,11
Holybarkzqt,aegwynn,672,druid,restoration,18,7,11
Juhudy,kazzak,672,druid,restoration,18,7,11
Djalexdruid,kazzak,672,druid,restoration,18,7,11
Buzzlîghtyea,outland,672,druid,restoration,18,7,11
Darkyblood,archimonde,672,druid,restoration,18,7,11
Epicskin,kazzak,672,druid,restoration,18,7,11
Juhato,outland,672,druid,restoration,18,7,11
Eduthecat,dun-modr,672,druid,restoration,18,7,11
Stormendru,kazzak,672,druid,restoration,24,7,17
Стомпбр,gordunni,672,druid,restoration,24,7,17
Thyana,blackrock,671,druid,restoration,12,7,5
Norkenis,neptulon,671,druid,restoration,12,7,5
Lycann,burning-blade,671,druid,restoration,12,7,5
Kladdkaka,earthen-ring,671,druid,restoration,12,7,5
Тое,soulflayer,671,druid,restoration,12,7,5
Pomdöner,echsenkessel,671,druid,restoration,12,7,5
Zatarmix,sylvanas,671,druid,restoration,12,7,5
Darktigrou,archimonde,671,druid,restoration,12,7,5
Мамамышь,gordunni,671,druid,restoration,12,7,5
Hristiana,outland,671,druid,restoration,12,7,5
Гимодера,gordunni,671,druid,restoration,12,7,5
Badballance,outland,671,druid,restoration,12,7,5
Zkasnoname,archimonde,671,druid,restoration,18,7,11
Scuta,sylvanas,671,druid,restoration,18,7,11
Sandh,uldum,671,druid,restoration,18,7,11
Glückstaler,die-aldor,671,druid,restoration,18,7,11
Dridoxx,archimonde,671,druid,restoration,18,7,11
Rosskemp,tarren-mill,671,druid,restoration,18,7,11
Wizår,outland,671,druid,restoration,18,7,11
Bayerant,burning-legion,671,druid,restoration,24,7,17
Шеданна,gordunni,671,druid,restoration,24,7,17
Behemothe,dalaran,670,druid,restoration,12,7,5
Azumera,silvermoon,670,druid,restoration,12,7,5
Sarkophag,blackrock,670,druid,restoration,12,7,5
Corroboree,archimonde,670,druid,restoration,12,7,5
Blòódý,ravencrest,670,druid,restoration,12,7,5
Cerius,drakthul,670,druid,restoration,12,7,5
Bubadruid,silvermoon,670,druid,restoration,12,7,5
Elysiá,twisting-nether,670,druid,restoration,18,7,11
Driftmaster,defias-brotherhood,670,druid,restoration,18,7,11
Proxis,the-maelstrom,670,druid,restoration,18,7,11
Imissclone,outland,670,druid,restoration,18,7,11
Muffinjump,outland,670,druid,restoration,18,7,11
Gotyoufam,tarren-mill,670,druid,restoration,21,8,13
Naicy,khaz-modan,670,druid,restoration,30,7,23
Xavoths,outland,669,druid,restoration,18,7,11
Azenoir,ravencrest,669,druid,restoration,18,7,11
Derie,nazjatar,669,druid,restoration,18,7,11
Whiskers,emerald-dream,669,druid,restoration,24,8,16
Gailiûga,kazzak,669,druid,restoration,25,8,17
Druidbox,ravencrest,668,druid,restoration,12,7,5
Ultrassick,kazzak,668,druid,restoration,12,7,5
Coínlíp,drakthul,668,druid,restoration,24,7,17
Shäylä,sinstralis,667,druid,restoration,12,7,5
Thaeldres,argent-dawn,667,druid,restoration,18,7,11
Croassant,archimonde,665,druid,restoration,12,7,5
Bepanten,azshara,665,druid,restoration,18,7,11
Syre,pozzo-delleternità,664,druid,restoration,12,7,5
Druiddamage,the-maelstrom,660,druid,restoration,18,7,11
Rukashi,die-aldor,659,druid,restoration,12,7,5
Raktav,kazzak,659,druid,restoration,12,7,5
Сутулоерыгло,howling-fjord,658,druid,restoration,20,7,13
Бацна,gordunni,656,druid,restoration,24,7,17
Foaqi,aegwynn,639,druid,restoration,16,7,9
Juggmusicxd,hyjal,639,druid,restoration,20,8,12
Lyvaley,dun-modr,629,druid,restoration,28,7,21
Унаген,howling-fjord,624,druid,restoration,15,8,7
Kùrámágødx,ravencrest,624,druid,restoration,17,7,10
Нюхнимедведя,blackscar,623,druid,restoration,11,7,4
Fatdroodz,draenor,622,druid,restoration,30,8,22
Амильфийка,blackscar,617,druid,restoration,15,8,7
ßïgßúll,twisting-nether,614,druid,restoration,19,8,11
Chainbrake,sylvanas,611,druid,restoration,21,10,11
Thespanker,aggramar,608,druid,restoration,10,7,3
Yamsha,dalaran,607,druid,restoration,16,7,9
Метафрея,gordunni,605,druid,restoration,11,7,4
Horkz,frostmourne,605,druid,restoration,17,7,10
Ilovealex,blackmoore,604,druid,restoration,8,7,1
Kerataas,lightnings-blade,603,druid,restoration,17,7,10
Allagís,kul-tiras,594,druid,restoration,13,8,5
Medreas,argent-dawn,594,druid,restoration,16,7,9
Draxedin,kazzak,576,druid,restoration,6,6,0
Abercrombx,thrall,576,druid,restoration,6,6,0
Felisin,ravencrest,576,druid,restoration,12,6,6
Kyssope,chants-éternels,576,druid,restoration,12,6,6
Outformpoly,ravencrest,576,druid,restoration,12,6,6
Biggttgothgf,doomhammer,576,druid,restoration,12,6,6
Ðès,ravencrest,576,druid,restoration,12,6,6
Tashani,blackhand,576,druid,restoration,12,6,6
Bilmo,ragnaros,576,druid,restoration,12,6,6
Jhiun,ragnaros,576,druid,restoration,12,6,6
Bøømerswågxx,twisting-nether,576,druid,restoration,12,6,6
Freddyßear,draenor,576,druid,restoration,12,6,6
Lolimadudu,silvermoon,576,druid,restoration,12,6,6
Zaelithree,archimonde,576,druid,restoration,12,6,6
Thorns,blackrock,576,druid,restoration,12,6,6
Pogidruid,ragnaros,576,druid,restoration,12,6,6
Ravnac,aegwynn,576,druid,restoration,12,6,6
Vindruva,ravencrest,576,druid,restoration,12,6,6
Piñaclo,archimonde,576,druid,restoration,12,6,6
Sálty,aegwynn,576,druid,restoration,12,6,6
Sakkosækk,ravencrest,576,druid,restoration,12,6,6
Theforest,stormscale,576,druid,restoration,12,6,6
Mccarthy,archimonde,576,druid,restoration,12,6,6
Telpha,onyxia,576,druid,restoration,12,6,6
Vacuumcleanr,ravencrest,576,druid,restoration,12,6,6
Poporseven,archimonde,576,druid,restoration,12,6,6
Jincksdru,ravencrest,576,druid,restoration,12,6,6
Noramun,blackmoore,576,druid,restoration,12,6,6
Milkyheals,burning-blade,576,druid,restoration,12,6,6
Cyriaan,eredar,576,druid,restoration,12,6,6
Shumamakan,nemesis,576,druid,restoration,12,6,6
Ferraribob,ravencrest,576,druid,restoration,12,6,6
Nivcat,kazzak,576,druid,restoration,12,6,6
Worsteux,blackrock,576,druid,restoration,14,6,8
Âurum,silvermoon,576,druid,restoration,14,6,8
Ãmba,blackrock,576,druid,restoration,15,6,9
Джунали,howling-fjord,576,druid,restoration,18,6,12
Neverpanic,stormscale,576,druid,restoration,18,6,12
Critdruid,kazzak,576,druid,restoration,18,6,12
Suevlaki,ragnaros,576,druid,restoration,18,6,12
Tjillevippen,tarren-mill,576,druid,restoration,18,6,12
Animaldoh,kazzak,576,druid,restoration,18,6,12
Pölkky,argent-dawn,576,druid,restoration,18,6,12
Nellro,blackrock,576,druid,restoration,18,6,12
Doktordudu,drakthul,576,druid,restoration,18,6,12
Deazydrood,blackrock,576,druid,restoration,18,6,12
Jìkkz,aegwynn,576,druid,restoration,24,6,18
Helkondr,thrall,576,druid,restoration,24,6,18
Meall,blackmoore,575,druid,restoration,6,6,0
Karakarrtaal,silvermoon,575,druid,restoration,6,6,0
Lucidor,frostmane,575,druid,restoration,12,6,6
Mistgone,hyjal,575,druid,restoration,12,6,6
Lanmìe,malganis,575,druid,restoration,12,6,6
Geeorge,stormscale,575,druid,restoration,12,6,6
Iamsocute,silvermoon,575,druid,restoration,12,6,6
Аммазония,gordunni,575,druid,restoration,12,6,6
Garbloom,silvermoon,575,druid,restoration,12,6,6
Thiudaish,tarren-mill,575,druid,restoration,12,6,6
Wykked,outland,575,druid,restoration,12,6,6
Scarrymonsta,outland,575,druid,restoration,12,6,6
Afret,kazzak,575,druid,restoration,12,6,6
Jinxaran,culte-de-la-rive-noire,575,druid,restoration,12,6,6
Chicobullz,ysondre,575,druid,restoration,12,6,6
Берды,gordunni,575,druid,restoration,12,6,6
Марголав,gordunni,575,druid,restoration,12,6,6
Chintawaz,archimonde,575,druid,restoration,16,7,9
Docdruid,outland,575,druid,restoration,19,7,12
Drbark,blackmoore,575,druid,restoration,18,6,12
Ipiridian,kargath,575,druid,restoration,18,6,12
Avilary,tarren-mill,575,druid,restoration,18,6,12
Enggetsu,drakthul,575,druid,restoration,18,6,12
Séifér,auchindoun,575,druid,restoration,18,6,12
Sartipus,draenor,575,druid,restoration,18,6,12
Pouletqt,archimonde,575,druid,restoration,18,6,12
Урголяфа,gordunni,575,druid,restoration,18,6,12
Storfjåset,stormscale,575,druid,restoration,18,6,12
Mascraxx,earthen-ring,575,druid,restoration,18,6,12
Dorange,stormscale,575,druid,restoration,18,6,12
Fiq,silvermoon,575,druid,restoration,18,6,12
Paskixoxo,ravencrest,574,druid,restoration,12,6,6
Оксинаген,ashenvale,574,druid,restoration,12,6,6
Eriaeda,stormscale,574,druid,restoration,12,6,6
Sveoris,malganis,574,druid,restoration,12,6,6
Tsihsel,ravencrest,574,druid,restoration,12,6,6
Spritzer,tarren-mill,574,druid,restoration,12,6,6
Silverdice,thrall,574,druid,restoration,12,6,6
Ruberg,kazzak,574,druid,restoration,12,6,6
Rìften,stormscale,574,druid,restoration,18,6,12
Зервес,gordunni,574,druid,restoration,24,6,18
Goatmeal,draenor,574,druid,restoration,24,6,18
Oaky,alonsus,573,druid,restoration,12,6,6
Visurat,tarren-mill,573,druid,restoration,12,6,6
Shifts,aggramar,573,druid,restoration,18,6,12
Ragdru,twisting-nether,573,druid,restoration,24,6,18
Shadówglen,defias-brotherhood,573,druid,restoration,30,6,24
Gargasina,colinas-pardas,571,druid,restoration,16,9,7
Nøboorst,ravencrest,571,druid,restoration,12,6,6
Arenus,argent-dawn,571,druid,restoration,18,6,12
Bearshift,aggra-português,571,druid,restoration,18,6,12
Pussn,twisting-nether,570,druid,restoration,18,6,12
Kelerun,blackhand,570,druid,restoration,24,6,18
Эгерме24FA33,howling-fjord,569,druid,restoration,12,6,6
Socialphobia,draenor,569,druid,restoration,24,6,18
Essya,earthen-ring,569,druid,restoration,31,7,24
Olekh,nemesis,568,druid,restoration,12,6,6
Roséa,ravencrest,568,druid,restoration,18,6,12
Walkao,tarren-mill,566,druid,restoration,12,6,6
Panacée,dalaran,565,druid,restoration,12,6,6
Wellsie,blackmoore,565,druid,restoration,18,6,12
Rakhajan,twisting-nether,553,druid,restoration,35,6,29
Vlookup,tarren-mill,543,druid,restoration,17,6,11
Márron,blackhand,542,druid,restoration,16,7,9
Siahra,khaz-modan,534,druid,restoration,48,6,42
Quorn,pozzo-delleternità,527,druid,restoration,13,7,6
Deliveru,outland,527,druid,restoration,17,6,11
Orgazmo,archimonde,526,druid,restoration,17,6,11
Noodledru,tarren-mill,526,druid,restoration,21,6,15
Laserlars,blackrock,522,druid,restoration,13,7,6
Zagrem,antonidas,522,druid,restoration,16,7,9
Dablolo,ravencrest,521,druid,restoration,12,7,5
Shawtyx,argent-dawn,521,druid,restoration,20,7,13
Auspicer,moonglade,519,druid,restoration,16,7,9
Fuzzy,the-venture-co,511,druid,restoration,11,6,5
Sethdr,hyjal,511,druid,restoration,20,6,14
Bartoluca,twisting-nether,488,druid,restoration,40,7,33
Miskydruid,kazzak,480,druid,restoration,6,5,1
Bobthebull,ragnaros,480,druid,restoration,6,5,1
Celetik,archimonde,480,druid,restoration,6,5,1
Druidtar,burning-steppes,480,druid,restoration,6,5,1
Quadpulse,ravencrest,480,druid,restoration,6,5,1
Мегабамбук,soulflayer,480,druid,restoration,6,5,1
Mykk,ravencrest,480,druid,restoration,6,5,1
Demncow,twisting-nether,480,druid,restoration,12,5,7
Devastras,ravencrest,480,druid,restoration,12,5,7
Хекзкор,ashenvale,480,druid,restoration,12,5,7
Skirr,kelthuzad,480,druid,restoration,12,5,7
Ppr,stormscale,480,druid,restoration,12,5,7
Tokamon,blackrock,480,druid,restoration,12,5,7
Димадубощит,blackscar,480,druid,restoration,12,5,7
Horstyolo,blackrock,480,druid,restoration,12,5,7
Búse,twisting-nether,480,druid,restoration,12,5,7
Kvalitet,outland,480,druid,restoration,12,5,7
Daisyx,eredar,480,druid,restoration,12,5,7
Trashgamex,eredar,480,druid,restoration,12,5,7
Alásea,kazzak,480,druid,restoration,12,5,7
Asude,outland,480,druid,restoration,12,5,7
Bloomitizé,ravencrest,480,druid,restoration,12,5,7
Pøwêr,blackrock,480,druid,restoration,12,5,7
Billydruida,sanguino,480,druid,restoration,12,5,7
Crysís,sanguino,480,druid,restoration,12,5,7
Napsta,sylvanas,480,druid,restoration,12,5,7
Marmotini,the-maelstrom,480,druid,restoration,12,5,7
Hótty,antonidas,480,druid,restoration,12,5,7
Músclébéach,silvermoon,480,druid,restoration,12,5,7
Druidicchi,stormscale,480,druid,restoration,12,5,7
Chæmp,blackmoore,480,druid,restoration,12,5,7
Vaacku,stormreaver,480,druid,restoration,12,5,7
Cheddar,tyrande,480,druid,restoration,12,5,7
Holybarkz,aegwynn,480,druid,restoration,12,5,7
Pyctograhm,eldrethalas,480,druid,restoration,12,5,7
Nythielle,argent-dawn,480,druid,restoration,12,5,7
Oøom,stormscale,480,druid,restoration,12,5,7
Pomjo,archimonde,480,druid,restoration,12,5,7
Nightmoon,hellscream,480,druid,restoration,12,5,7
Druni,blackrock,480,druid,restoration,12,5,7
Thatzdmg,blackmoore,480,druid,restoration,12,5,7
Jenovas,argent-dawn,480,druid,restoration,12,5,7
Solonely,argent-dawn,480,druid,restoration,12,5,7
Higuys,the-maelstrom,480,druid,restoration,12,5,7
Sùmmêrz,outland,480,druid,restoration,12,5,7
Jebaitor,tarren-mill,480,druid,restoration,12,5,7
Neshalry,blackhand,480,druid,restoration,13,5,8
Øxxy,ravencrest,480,druid,restoration,18,5,13
Локотьдрева,gordunni,480,druid,restoration,18,5,13
Erelieva,silvermoon,480,druid,restoration,18,5,13
Sneedlewøødz,exodar,480,druid,restoration,18,5,13
Subu,drakthul,480,druid,restoration,18,5,13
Åzjôl,magtheridon,480,druid,restoration,18,5,13
Bigbaddream,stormscale,480,druid,restoration,18,5,13
Restaidpvs,wildhammer,480,druid,restoration,18,5,13
Patrík,twisting-nether,480,druid,restoration,18,5,13
Клиптыч,soulflayer,479,druid,restoration,6,5,1
Ashiothie,argent-dawn,479,druid,restoration,6,5,1
Rocknrollà,doomhammer,479,druid,restoration,6,5,1
Epidruid,stormrage,479,druid,restoration,12,5,7
Enzymex,burning-blade,479,druid,restoration,12,5,7
Delphina,dun-modr,479,druid,restoration,12,5,7
Salagkoydi,sylvanas,479,druid,restoration,12,5,7
Inspira,teldrassil,479,druid,restoration,12,5,7
Alfrëd,quelthalas,479,druid,restoration,12,5,7
Xaeerow,archimonde,479,druid,restoration,12,5,7
Greenthûmbs,sylvanas,479,druid,restoration,12,5,7
Shadowdury,frostwolf,479,druid,restoration,12,5,7
Sieur,archimonde,479,druid,restoration,12,5,7
Bhorumir,colinas-pardas,479,druid,restoration,12,5,7
Quiksx,blackrock,479,druid,restoration,13,5,8
Drix,frostwolf,479,druid,restoration,15,5,10
Swo,emeriss,479,druid,restoration,18,5,13
Hâyâbusa,antonidas,479,druid,restoration,18,5,13
Jemyd,aegwynn,479,druid,restoration,24,5,19
Tightaníc,sylvanas,478,druid,restoration,12,5,7
Kroshka,sylvanas,478,druid,restoration,12,5,7
Шмыгадру,eversong,478,druid,restoration,12,5,7
Lùmy,arygos,478,druid,restoration,12,5,7
Yodox,kazzak,477,druid,restoration,6,5,1
Xtrakul,bloodfeather,477,druid,restoration,6,5,1
Kodobursto,stormscale,477,druid,restoration,12,5,7
Шмору,deathguard,477,druid,restoration,12,5,7
Wybsalt,dragonblight,477,druid,restoration,18,5,13
Sýrês,malganis,475,druid,restoration,12,5,7
Томография,howling-fjord,475,druid,restoration,12,5,7
Prowlinger,silvermoon,473,druid,restoration,12,5,7
Alatie,sylvanas,473,druid,restoration,12,5,7
Voodoodrood,draenor,473,druid,restoration,30,5,25
Iamtheone,ragnaros,463,druid,restoration,17,5,12
Druidicmorr,sylvanas,447,druid,restoration,10,5,5
Flandersdru,ravencrest,447,druid,restoration,11,5,6
Dhomaris,emerald-dream,447,druid,restoration,17,5,12
Happyhippo,arathor,447,druid,restoration,17,5,12
Luaavin,madmortem,446,druid,restoration,10,5,5
Ambracer,silvermoon,444,druid,restoration,8,6,2
Исмалат,howling-fjord,429,druid,restoration,11,5,6
Pfandmalle,blackrock,426,druid,restoration,14,6,8
Smradzblech,drakthul,425,druid,restoration,16,6,10
Kotkacy,silvermoon,416,druid,restoration,10,5,5
Qjkuug,ravencrest,416,druid,restoration,10,5,5
Meridus,thrall,400,druid,restoration,13,5,8
Heathen,defias-brotherhood,384,druid,restoration,6,4,2
Asgá,stormscale,384,druid,restoration,6,4,2
Shegal,uldum,384,druid,restoration,6,4,2
Kapidrooqt,suramar,384,druid,restoration,6,4,2
Сокдобрый,gordunni,384,druid,restoration,6,4,2
Notmyfriend,sylvanas,384,druid,restoration,6,4,2
Bombiix,sanguino,384,druid,restoration,6,4,2
Tlxrdlx,archimonde,384,druid,restoration,6,4,2
Lerralol,eredar,384,druid,restoration,6,4,2
Jacksonh,blackmoore,384,druid,restoration,6,4,2
Hamilina,thunderhorn,384,druid,restoration,6,4,2
Fangornn,outland,384,druid,restoration,6,4,2
Tormentedlol,outland,384,druid,restoration,6,4,2
Xandersito,sanguino,384,druid,restoration,6,4,2
Neuroz,ravencrest,384,druid,restoration,6,4,2
Mentaldead,tarren-mill,384,druid,restoration,6,4,2
Zeroclones,the-maelstrom,384,druid,restoration,6,4,2
Феразинария,gordunni,384,druid,restoration,6,4,2
Jellyxdd,silvermoon,384,druid,restoration,6,4,2
Claptastic,magtheridon,384,druid,restoration,6,4,2
Sensisdruid,blackmoore,384,druid,restoration,6,4,2
Cykablyaster,defias-brotherhood,384,druid,restoration,6,4,2
Esmerito,tarren-mill,384,druid,restoration,6,4,2
Bearmeister,kazzak,384,druid,restoration,6,4,2
Béstfriend,uldum,384,druid,restoration,6,4,2
Ктотоизкчр,gordunni,384,druid,restoration,6,4,2
Zuzam,bladefist,384,druid,restoration,6,4,2
Koala,temple-noir,384,druid,restoration,6,4,2
Greenberry,eonar,384,druid,restoration,6,4,2
Zuldram,uldaman,384,druid,restoration,6,4,2
Cyclonebot,kazzak,384,druid,restoration,6,4,2
Jimmyjam,archimonde,384,druid,restoration,6,4,2
Bekkjin,todeswache,384,druid,restoration,6,4,2
Àrkange,hyjal,384,druid,restoration,6,4,2
Lhûne,twisting-nether,384,druid,restoration,6,4,2
Балаклаваа,soulflayer,384,druid,restoration,6,4,2
Mancy,silvermoon,384,druid,restoration,6,4,2
Híraad,blackmoore,384,druid,restoration,6,4,2
Maltøx,archimonde,384,druid,restoration,6,4,2
Druidka,grim-batol,384,druid,restoration,6,4,2
Гвенивар,soulflayer,384,druid,restoration,6,4,2
Daleen,silvermoon,384,druid,restoration,12,4,8
Cumulisama,sylvanas,384,druid,restoration,12,4,8
Jöggel,perenolde,384,druid,restoration,12,4,8
Hotundwech,blackrock,384,druid,restoration,12,4,8
Irrlycht,blackrock,384,druid,restoration,12,4,8
Crazydos,tarren-mill,384,druid,restoration,12,4,8
Dëlins,outland,384,druid,restoration,12,4,8
Àlec,silvermoon,384,druid,restoration,12,4,8
Biglet,tarren-mill,384,druid,restoration,12,4,8
Hyggef,ravencrest,384,druid,restoration,12,4,8
Farmmygold,dun-modr,384,druid,restoration,12,4,8
Koniny,drakthul,384,druid,restoration,12,4,8
Noggerglatze,blackrock,384,druid,restoration,12,4,8
Curtainscall,kazzak,384,druid,restoration,12,4,8
Pròxy,hyjal,384,druid,restoration,12,4,8
Громозилка,soulflayer,384,druid,restoration,12,4,8
Sqoopy,tarren-mill,384,druid,restoration,12,4,8
Estrogenlord,auchindoun,384,druid,restoration,12,4,8
Celtimi,antonidas,384,druid,restoration,12,4,8
Сулинея,blackscar,384,druid,restoration,12,4,8
Holdmabeer,blackmoore,384,druid,restoration,12,4,8
Toffyfee,anetheron,384,druid,restoration,12,4,8
Kobra,twilights-hammer,384,druid,restoration,12,4,8
Ravenfel,argent-dawn,384,druid,restoration,12,4,8
Baraforet,archimonde,384,druid,restoration,12,4,8
Hûibûh,eredar,384,druid,restoration,12,4,8
Wakefields,dun-modr,384,druid,restoration,12,4,8
Найадра,gordunni,384,druid,restoration,12,4,8
Meowu,twisting-nether,384,druid,restoration,12,4,8
Shapeshiptur,argent-dawn,384,druid,restoration,12,4,8
Swiftlife,blackrock,384,druid,restoration,12,4,8
Murlwywy,blackmoore,384,druid,restoration,12,4,8
Farashh,archimonde,384,druid,restoration,12,4,8
Zivela,blackrock,384,druid,restoration,12,4,8
Litany,drakthul,384,druid,restoration,13,4,9
Hrz,kazzak,384,druid,restoration,18,4,14
Nezara,kazzak,384,druid,restoration,18,4,14
Tacobender,tarren-mill,384,druid,restoration,18,4,14
Frequentist,ragnaros,384,druid,restoration,18,4,14
Yøungreidzz,blackrock,384,druid,restoration,24,4,20
Lathlas,defias-brotherhood,383,druid,restoration,6,4,2
Cmfg,blackrock,383,druid,restoration,6,4,2
Santoniq,dun-morogh,383,druid,restoration,6,4,2
Blackfür,sylvanas,383,druid,restoration,6,4,2
Бабазарулем,fordragon,383,druid,restoration,6,4,2
Jabbah,defias-brotherhood,383,druid,restoration,6,4,2
Xidenn,quelthalas,383,druid,restoration,12,4,8
Høpè,die-silberne-hand,383,druid,restoration,12,4,8
Замакибо,howling-fjord,383,druid,restoration,12,4,8
Druidguy,ghostlands,383,druid,restoration,12,4,8
Opla,nethersturm,383,druid,restoration,12,4,8
Noxndruid,blackhand,383,druid,restoration,12,4,8
Mimisiek,burning-legion,383,druid,restoration,12,4,8
Сигстейнхохо,blackscar,383,druid,restoration,12,4,8
Kuivea,the-maelstrom,383,druid,restoration,12,4,8
Arns,kazzak,383,druid,restoration,12,4,8
Semenisback,archimonde,383,druid,restoration,12,4,8
Itê,dun-morogh,383,druid,restoration,18,4,14
Leeonore,burning-legion,383,druid,restoration,18,4,14
Tyraloll,ghostlands,383,druid,restoration,18,4,14
Шикалат,howling-fjord,383,druid,restoration,24,4,20
Xele,destromath,382,druid,restoration,6,4,2
Mongetout,ravencrest,382,druid,restoration,6,4,2
Pega,nazjatar,382,druid,restoration,12,4,8
Amalou,ravencrest,381,druid,restoration,12,4,8
Nàrina,der-abyssische-rat,381,druid,restoration,12,4,8
Dolob,ragnaros,381,druid,restoration,18,4,14
Thaurus,durotan,380,druid,restoration,12,4,8
Фигоначи,soulflayer,379,druid,restoration,12,4,8
Tranquillo,outland,379,druid,restoration,12,4,8
Nøkki,draenor,367,druid,restoration,21,8,13
Jincksdru,anachronos,367,druid,restoration,11,4,7
Demerit,defias-brotherhood,351,druid,restoration,11,4,7
Biegel,ysera,351,druid,restoration,11,4,7
Fapmasterx,eredar,351,druid,restoration,23,4,19
Lyhene,outland,339,druid,restoration,32,8,24
Mymoms,stormscale,336,druid,restoration,15,4,11
Wuppii,blackmoore,329,druid,restoration,10,6,4
Swarmah,draenor,329,druid,restoration,18,5,13
Hubek,silvermoon,328,druid,restoration,8,6,2
Hairytree,outland,318,druid,restoration,14,4,10
Jirenthegrey,antonidas,318,druid,restoration,14,4,10
Mímír,frostmane,317,druid,restoration,10,4,6
Elsnorro,sylvanas,313,druid,restoration,19,5,14
Rëckiah,ysondre,304,druid,restoration,13,4,9
Pipima,kazzak,288,druid,restoration,6,3,3
Furbyz,kazzak,288,druid,restoration,6,3,3
Ullainho,stormscale,288,druid,restoration,6,3,3
Maníx,tarren-mill,288,druid,restoration,6,3,3
Koprogatos,twilights-hammer,288,druid,restoration,6,3,3
Preda,thunderhorn,288,druid,restoration,6,3,3
Nobrainopain,aegwynn,288,druid,restoration,6,3,3
Noobr,ravencrest,288,druid,restoration,6,3,3
Дробовик,soulflayer,288,druid,restoration,6,3,3
Hð,blackmoore,288,druid,restoration,6,3,3
Friyiee,stormscale,288,druid,restoration,6,3,3
Lèafy,silvermoon,288,druid,restoration,6,3,3
Ripmacmiller,grim-batol,288,druid,restoration,6,3,3
Milknosugar,tarren-mill,288,druid,restoration,6,3,3
Owldschool,blackmoore,288,druid,restoration,6,3,3
Mealann,drakthul,288,druid,restoration,6,3,3
Ærõxy,aegwynn,288,druid,restoration,6,3,3
Skrewu,silvermoon,288,druid,restoration,6,3,3
Atomanna,blackmoore,288,druid,restoration,6,3,3
Фонш,soulflayer,288,druid,restoration,6,3,3
Jonnaxø,ravencrest,288,druid,restoration,6,3,3
Whitemaine,aggramar,288,druid,restoration,6,3,3
Ipsdray,ysondre,288,druid,restoration,6,3,3
Мехнакиске,howling-fjord,288,druid,restoration,6,3,3
Whisk,ravencrest,288,druid,restoration,6,3,3
Spielmann,ravencrest,288,druid,restoration,6,3,3
Darkömwz,ysondre,288,druid,restoration,6,3,3
Fallken,burning-blade,288,druid,restoration,6,3,3
Dopadruid,ravencrest,288,druid,restoration,6,3,3
Gehrkehotter,silvermoon,288,druid,restoration,6,3,3
Танганэку,howling-fjord,288,druid,restoration,6,3,3
Астраджет,gordunni,288,druid,restoration,6,3,3
Whelpss,archimonde,288,druid,restoration,6,3,3
Сайнтификх,gordunni,288,druid,restoration,6,3,3
Sportzdruid,argent-dawn,288,druid,restoration,6,3,3
Qb,blackrock,288,druid,restoration,6,3,3
Myxa,arthas,288,druid,restoration,6,3,3
Vestor,ravencrest,288,druid,restoration,6,3,3
Nubsi,aegwynn,288,druid,restoration,6,3,3
Moonbloom,defias-brotherhood,288,druid,restoration,6,3,3
Wurzeldor,ravencrest,288,druid,restoration,6,3,3
Thecousins,ravencrest,288,druid,restoration,6,3,3
Ghøstavdruid,ravencrest,288,druid,restoration,6,3,3
Eftersmak,ravencrest,288,druid,restoration,6,3,3
Sygko,kazzak,288,druid,restoration,6,3,3
Skuhlxz,thrall,288,druid,restoration,6,3,3
Drozzie,twisting-nether,288,druid,restoration,6,3,3
Zaethul,draenor,288,druid,restoration,6,3,3
Faustîno,dun-modr,288,druid,restoration,6,3,3
Ðrøøði,dun-modr,288,druid,restoration,6,3,3
Shyni,outland,288,druid,restoration,6,3,3
Bigorkey,blackrock,288,druid,restoration,6,3,3
Bêlion,dun-modr,288,druid,restoration,6,3,3
Djdishwasher,kazzak,288,druid,restoration,6,3,3
Snowlight,der-rat-von-dalaran,288,druid,restoration,6,3,3
Healingwoods,outland,288,druid,restoration,6,3,3
Зурсага,deathguard,288,druid,restoration,6,3,3
Vellusdruid,burning-legion,288,druid,restoration,6,3,3
Magiskeforme,draenor,288,druid,restoration,6,3,3
Peaches,aerie-peak,288,druid,restoration,6,3,3
Ríkku,sargeras,288,druid,restoration,6,3,3
Jéssíé,silvermoon,288,druid,restoration,6,3,3
Qwopeiqpwoid,kazzak,288,druid,restoration,6,3,3
Houkka,doomhammer,288,druid,restoration,6,3,3
Lolaven,turalyon,288,druid,restoration,6,3,3
Myos,conseil-des-ombres,288,druid,restoration,6,3,3
Droodyàz,hyjal,288,druid,restoration,6,3,3
Shìinx,hyjal,288,druid,restoration,6,3,3
Cøwgirl,draenor,288,druid,restoration,6,3,3
Rumbus,sanguino,288,druid,restoration,7,3,4
Piñaclonada,archimonde,288,druid,restoration,9,3,6
Ilarilén,blackmoore,288,druid,restoration,10,3,7
Draawun,burning-legion,288,druid,restoration,11,3,8
Smarticle,aegwynn,288,druid,restoration,11,3,8
Shredz,destromath,288,druid,restoration,12,3,9
Sharlla,burning-legion,288,druid,restoration,12,3,9
Taugenîchts,blackmoore,288,druid,restoration,12,3,9
Toacon,destromath,288,druid,restoration,12,3,9
Takar,dalaran,288,druid,restoration,12,3,9
Ezils,silvermoon,288,druid,restoration,12,3,9
Navra,ravencrest,288,druid,restoration,12,3,9
Lukøu,blackrock,288,druid,restoration,12,3,9
Teah,darkmoon-faire,288,druid,restoration,12,3,9
Trolthelhas,chogall,288,druid,restoration,12,3,9
Кекичан,howling-fjord,288,druid,restoration,12,3,9
Fejgi,stormreaver,288,druid,restoration,12,3,9
Amstaffio,blackhand,288,druid,restoration,12,3,9
Elxa,silvermoon,288,druid,restoration,12,3,9
Xbrokeaf,eredar,288,druid,restoration,12,3,9
Harrasmoes,ravencrest,288,druid,restoration,12,3,9
Jàgër,archimonde,288,druid,restoration,12,3,9
Nebrahl,silvermoon,288,druid,restoration,12,3,9
Shiotake,hyjal,288,druid,restoration,12,3,9
Megustatu,ravencrest,288,druid,restoration,12,3,9
Chapawee,eredar,288,druid,restoration,12,3,9
Imoen,hyjal,288,druid,restoration,12,3,9
Restodruidx,ravencrest,288,druid,restoration,12,3,9
Januzo,kazzak,288,druid,restoration,12,3,9
Furía,anubarak,288,druid,restoration,12,3,9
Храмульчик,blackscar,288,druid,restoration,12,3,9
Coffeebean,twisting-nether,288,druid,restoration,12,3,9
Emeskay,ravencrest,288,druid,restoration,12,3,9
Xanánioma,ravencrest,288,druid,restoration,12,3,9
Eladhria,arakarahm,288,druid,restoration,12,3,9
Awienx,kazzak,288,druid,restoration,12,3,9
Untouchablè,outland,288,druid,restoration,12,3,9
Ajày,sylvanas,288,druid,restoration,12,3,9
Raila,pozzo-delleternità,288,druid,restoration,12,3,9
Sojiz,outland,288,druid,restoration,12,3,9
Nostigon,azshara,288,druid,restoration,12,3,9
Amazed,wildhammer,288,druid,restoration,12,3,9
Marryat,argent-dawn,288,druid,restoration,12,3,9
Areidhel,pozzo-delleternità,288,druid,restoration,12,3,9
Doup,alakir,288,druid,restoration,12,3,9
Trntydr,senjin,288,druid,restoration,12,3,9
Jàgêr,archimonde,288,druid,restoration,12,3,9
Nyha,garrosh,288,druid,restoration,18,3,15
Boomdruud,tarren-mill,288,druid,restoration,18,3,15
Денчикбратиш,soulflayer,288,druid,restoration,18,3,15
Hurutuk,ysondre,288,druid,restoration,18,3,15
Квазарм,gordunni,288,druid,restoration,18,3,15
Rakuy,thrall,288,druid,restoration,18,3,15
Taskingoman,twisting-nether,287,druid,restoration,6,3,3
Wildsoul,hyjal,287,druid,restoration,6,3,3
Kuhlheit,der-rat-von-dalaran,287,druid,restoration,6,3,3
Kuokkanen,azuremyst,287,druid,restoration,6,3,3
Youngjin,ravencrest,287,druid,restoration,6,3,3
Grimmie,frostmane,287,druid,restoration,6,3,3
Smittly,bloodhoof,287,druid,restoration,6,3,3
Huayhey,the-maelstrom,287,druid,restoration,6,3,3
Boompjeh,chamber-of-aspects,287,druid,restoration,6,3,3
Lundx,ravencrest,287,druid,restoration,6,3,3
Tombenuit,tarren-mill,287,druid,restoration,6,3,3
Aègon,ravencrest,287,druid,restoration,6,3,3
Kufcuf,eredar,287,druid,restoration,6,3,3
Xulian,exodar,287,druid,restoration,12,3,9
Лёшациклонх,deathguard,287,druid,restoration,12,3,9
Reckóning,draenor,287,druid,restoration,12,3,9
Barki,silvermoon,287,druid,restoration,12,3,9
Papalegba,kilrogg,287,druid,restoration,12,3,9
Rumjin,burning-blade,287,druid,restoration,17,4,13
Paniel,amanthul,286,druid,restoration,6,3,3
Kebanos,ravencrest,286,druid,restoration,6,3,3
Corrosion,outland,286,druid,restoration,12,3,9
Elônea,antonidas,285,druid,restoration,12,3,9
Адаладиус,howling-fjord,285,druid,restoration,42,3,39
Duduque,twisting-nether,255,druid,restoration,11,3,8
Bunga,quelthalas,255,druid,restoration,11,3,8
Kaliyuga,dalaran,255,druid,restoration,11,3,8
Yopi,stormscale,240,druid,restoration,15,3,12
Акетчи,howling-fjord,239,druid,restoration,5,3,2
Amélor,ragnaros,239,druid,restoration,5,3,2
Потнаякиса,grom,239,druid,restoration,5,3,2
Izhusky,ravencrest,234,druid,restoration,8,4,4
Lxz,blackhand,234,druid,restoration,8,4,4
Beerplusbeer,kazzak,234,druid,restoration,23,6,17
Bigdambitex,draenor,234,druid,restoration,16,4,12
Chelsealeart,frostmane,192,druid,restoration,9,3,6
Sekunden,ravencrest,192,druid,restoration,6,2,4
Clonesy,outland,192,druid,restoration,6,2,4
Jamley,tarren-mill,192,druid,restoration,6,2,4
Skavenlol,zuljin,192,druid,restoration,6,2,4
Ðon,nemesis,192,druid,restoration,6,2,4
Mooji,darksorrow,192,druid,restoration,6,2,4
Gaiaa,kilrogg,192,druid,restoration,6,2,4
Hydrochronic,ravencrest,192,druid,restoration,6,2,4
Drøda,aegwynn,192,druid,restoration,6,2,4
Trusten,nemesis,192,druid,restoration,6,2,4
Heejåe,archimonde,192,druid,restoration,6,2,4
Vandalís,garrosh,192,druid,restoration,6,2,4
Restoboi,stormscale,192,druid,restoration,6,2,4
Baldhir,nemesis,192,druid,restoration,6,2,4
Tàazz,sargeras,192,druid,restoration,6,2,4
Griminal,norgannon,192,druid,restoration,6,2,4
Zhiwé,ravencrest,192,druid,restoration,6,2,4
Vulcäin,ysondre,192,druid,restoration,6,2,4
Hotseîdank,blackrock,192,druid,restoration,6,2,4
Rtxy,hyjal,192,druid,restoration,6,2,4
Zenkillers,outland,192,druid,restoration,6,2,4
Nelfurion,twisting-nether,192,druid,restoration,6,2,4
Пикаббука,gordunni,192,druid,restoration,6,2,4
Fanso,burning-legion,192,druid,restoration,6,2,4
Xerrean,ravencrest,192,druid,restoration,6,2,4
Droodu,dun-modr,192,druid,restoration,6,2,4
Sajlol,doomhammer,192,druid,restoration,6,2,4
Kremhelt,outland,192,druid,restoration,6,2,4
Pinkpanda,arthas,192,druid,restoration,6,2,4
Wörstplayêr,archimonde,192,druid,restoration,6,2,4
Midrialis,sinstralis,192,druid,restoration,6,2,4
Lootmann,die-silberne-hand,192,druid,restoration,6,2,4
Slimsneeky,outland,192,druid,restoration,6,2,4
Адорабэль,deathguard,192,druid,restoration,6,2,4
Mjáy,tarren-mill,192,druid,restoration,6,2,4
Шокоокулист,gordunni,192,druid,restoration,6,2,4
Harryjane,antonidas,192,druid,restoration,6,2,4
Palavanus,stormscale,192,druid,restoration,6,2,4
Chrisdruid,argent-dawn,192,druid,restoration,6,2,4
Атитока,goldrinn,192,druid,restoration,6,2,4
Disney,ragnaros,192,druid,restoration,6,2,4
Jasof,sylvanas,192,druid,restoration,6,2,4
Cpt,xavius,192,druid,restoration,6,2,4
Ymöthep,archimonde,192,druid,restoration,6,2,4
Conn,ravencrest,192,druid,restoration,6,2,4
Nooz,thrall,192,druid,restoration,6,2,4
Jimboza,stormscale,192,druid,restoration,6,2,4
Smokahontas,kilrogg,192,druid,restoration,6,2,4
Sickomodê,blackmoore,192,druid,restoration,6,2,4
Morphael,ravencrest,192,druid,restoration,6,2,4
Moodee,kazzak,192,druid,restoration,6,2,4
Kkona,silvermoon,192,druid,restoration,6,2,4
Rédbullz,silvermoon,192,druid,restoration,6,2,4
Northstarx,kazzak,192,druid,restoration,6,2,4
Trollingt,draenor,192,druid,restoration,6,2,4
Príimé,kazzak,192,druid,restoration,6,2,4
Revølter,kazzak,192,druid,restoration,6,2,4
Benjiee,kazzak,192,druid,restoration,6,2,4
Speegle,kazzak,192,druid,restoration,6,2,4
Heligakatten,twisting-nether,192,druid,restoration,10,3,7
Gonco,blackrock,192,druid,restoration,8,2,6
Baracüda,draenor,192,druid,restoration,16,3,13
Shaggí,draenor,192,druid,restoration,11,2,9
Qocotte,archimonde,192,druid,restoration,12,2,10
Testomake,kazzak,192,druid,restoration,12,2,10
Piper,culte-de-la-rive-noire,192,druid,restoration,12,2,10
Màf,silvermoon,192,druid,restoration,12,2,10
Álou,dalaran,192,druid,restoration,12,2,10
Lyj,dalaran,192,druid,restoration,12,2,10
Skorpo,blackrock,192,druid,restoration,12,2,10
Helpthebear,twisting-nether,192,druid,restoration,12,2,10
Jacksonella,dun-morogh,192,druid,restoration,12,2,10
Салона,deathguard,192,druid,restoration,12,2,10
Wahahoo,la-croisade-écarlate,192,druid,restoration,12,2,10
Drâcâ,antonidas,192,druid,restoration,12,2,10
Nakkikastike,magtheridon,192,druid,restoration,12,2,10
Vertabrain,twilights-hammer,192,druid,restoration,12,2,10
Keløkss,silvermoon,192,druid,restoration,12,2,10
Kizanimagus,magtheridon,192,druid,restoration,12,2,10
Amaaja,blackmoore,192,druid,restoration,12,2,10
Blâckrök,blackhand,192,druid,restoration,12,2,10
Anníe,tarren-mill,192,druid,restoration,12,2,10
Darkstalker,arygos,192,druid,restoration,12,2,10
Imperador,tyrande,192,druid,restoration,12,2,10
Quentalius,argent-dawn,192,druid,restoration,12,2,10
Maceyx,ravencrest,192,druid,restoration,12,2,10
Tayswiftmend,defias-brotherhood,192,druid,restoration,12,2,10
Fâucon,eitrigg,192,druid,restoration,12,2,10
Bigstop,kazzak,192,druid,restoration,17,2,15
Arminíus,die-silberne-hand,192,druid,restoration,18,2,16
Quza,lightbringer,192,druid,restoration,18,2,16
Охломон,gordunni,192,druid,restoration,24,2,22
Dudu,sinstralis,191,druid,restoration,6,2,4
Bingó,blutkessel,191,druid,restoration,6,2,4
Siyoo,thrall,191,druid,restoration,6,2,4
Dahelire,shendralar,191,druid,restoration,6,2,4
Зулгасилич,howling-fjord,191,druid,restoration,6,2,4
Snifa,the-venture-co,191,druid,restoration,7,2,5
Westbeast,doomhammer,191,druid,restoration,12,2,10
Mômmôm,aggra-português,191,druid,restoration,12,2,10
Эхосна,howling-fjord,191,druid,restoration,12,2,10
Amindenes,ragnaros,191,druid,restoration,18,2,16
Charlierunkl,gorgonnash,190,druid,restoration,18,2,16
Marynlord,dalaran,175,druid,restoration,11,2,9
Wolig,tarren-mill,159,druid,restoration,5,2,3
Stkk,dun-modr,159,druid,restoration,5,2,3
Zayrok,throkferoth,159,druid,restoration,8,3,5
Сугрик,deathweaver,143,druid,restoration,15,2,13
Starcrash,amanthul,138,druid,restoration,6,3,3
Shipmaster,ravencrest,138,druid,restoration,8,3,5
Zzblaah,archimonde,138,druid,restoration,10,3,7
Chauntee,draenor,138,druid,restoration,15,3,12
Prettysavage,blackhand,138,druid,restoration,19,3,16
Lynaee,cthun,128,druid,restoration,4,2,2
Ihatewhales,ravencrest,128,druid,restoration,4,2,2
Thaiboimbyy,veknilash,127,druid,restoration,4,2,2
Razorleaf,turalyon,127,druid,restoration,8,2,6
Xneji,sylvanas,111,druid,restoration,13,2,11
Drblackus,draenor,96,druid,restoration,3,2,1
Trä,earthen-ring,96,druid,restoration,3,2,1
Пасторизсша,soulflayer,96,druid,restoration,6,1,5
Fedelmae,nagrand,96,druid,restoration,6,1,5
Bøøstèdtréè,ravencrest,96,druid,restoration,6,1,5
Nikta,trollbane,96,druid,restoration,6,1,5
Phatzoo,stormscale,96,druid,restoration,6,1,5
Tilikum,stormscale,96,druid,restoration,6,1,5
Blark,sylvanas,96,druid,restoration,6,1,5
Hefdgaharald,antonidas,96,druid,restoration,6,1,5
Sucukk,antonidas,96,druid,restoration,6,1,5
Naturaven,sylvanas,96,druid,restoration,6,1,5
Ilikecaipi,eredar,96,druid,restoration,6,1,5
Tshungubuäch,eredar,96,druid,restoration,6,1,5
Blanoz,ravencrest,96,druid,restoration,6,1,5
Zoura,ysondre,96,druid,restoration,6,1,5
Pølïna,ysondre,96,druid,restoration,6,1,5
Vicedxo,kazzak,96,druid,restoration,6,1,5
Effi,aggramar,96,druid,restoration,6,1,5
Gámóra,argent-dawn,96,druid,restoration,6,1,5
Søfiaa,argent-dawn,96,druid,restoration,6,1,5
Nanuu,sylvanas,96,druid,restoration,6,1,5
Sylindra,argent-dawn,96,druid,restoration,6,1,5
Druvian,argent-dawn,96,druid,restoration,6,1,5
Мунпраид,gordunni,96,druid,restoration,6,1,5
Druiruu,tarren-mill,96,druid,restoration,6,1,5
Druidguden,tarren-mill,96,druid,restoration,6,1,5
Heala,malganis,96,druid,restoration,6,1,5
Элнут,gordunni,96,druid,restoration,6,1,5
Secô,sylvanas,96,druid,restoration,6,1,5
Släshes,stormreaver,96,druid,restoration,6,1,5
Злодзейка,gordunni,96,druid,restoration,6,1,5
Feroxe,kazzak,96,druid,restoration,6,1,5
Deezforms,kazzak,96,druid,restoration,6,1,5
Винш,grom,96,druid,restoration,6,1,5
Nermax,kazzak,96,druid,restoration,6,1,5
Sonyk,drakthul,96,druid,restoration,6,1,5
Hecaloth,drakthul,96,druid,restoration,6,1,5
Tranduiil,drakthul,96,druid,restoration,6,1,5
Linkin,azshara,96,druid,restoration,6,1,5
Жарищка,soulflayer,96,druid,restoration,6,1,5
Sodapop,aszune,96,druid,restoration,6,1,5
Madmoss,twisting-nether,96,druid,restoration,6,1,5
Nwal,thunderhorn,96,druid,restoration,6,1,5
Haginator,twisting-nether,96,druid,restoration,6,1,5
Kisyqt,aegwynn,96,druid,restoration,6,1,5
Meisterd,aegwynn,96,druid,restoration,6,1,5
Utuabzu,grim-batol,96,druid,restoration,6,1,5
Aspegic,grim-batol,96,druid,restoration,6,1,5
Nøunøurss,dalaran,96,druid,restoration,6,1,5
Anahots,silvermoon,96,druid,restoration,6,1,5
Murma,dalaran,96,druid,restoration,6,1,5
Bgwell,archimonde,96,druid,restoration,6,1,5
Wildsoûl,kazzak,96,druid,restoration,6,1,5
Nuggetspøwa,dalaran,96,druid,restoration,6,1,5
Durlehardu,archimonde,96,druid,restoration,6,1,5
Ka,the-maelstrom,96,druid,restoration,6,1,5
Maiuna,blackhand,96,druid,restoration,6,1,5
Blodemoon,ragnaros,96,druid,restoration,6,1,5
Kerydwen,silvermoon,96,druid,restoration,6,1,5
Droodae,hyjal,96,druid,restoration,6,1,5
Taicoo,outland,96,druid,restoration,6,1,5
Chapuk,kazzak,96,druid,restoration,6,1,5
Thebartender,khaz-modan,96,druid,restoration,6,1,5
Pesza,bloodscalp,96,druid,restoration,6,1,5
Сейтил,deathguard,96,druid,restoration,6,1,5
Cevto,drakthul,96,druid,restoration,6,1,5
Enfy,lightbringer,96,druid,restoration,6,1,5
Zulk,draenor,96,druid,restoration,6,1,5
Jooblob,guldan,96,druid,restoration,6,1,5
Kweelor,der-abyssische-rat,96,druid,restoration,6,1,5
Bignunu,silvermoon,96,druid,restoration,6,1,5
Vaizier,defias-brotherhood,96,druid,restoration,6,1,5
Seekíng,blackmoore,96,druid,restoration,6,1,5
Psitol,silvermoon,96,druid,restoration,6,1,5
Dmai,burning-legion,96,druid,restoration,6,1,5
Malurith,silvermoon,96,druid,restoration,6,1,5
Winstonka,doomhammer,96,druid,restoration,6,1,5
Bartige,blackmoore,96,druid,restoration,6,1,5
Cowárd,blackmoore,96,druid,restoration,6,1,5
Nyooxix,blackmoore,96,druid,restoration,6,1,5
Oltoker,korgall,96,druid,restoration,6,1,5
Xkirtach,dun-modr,96,druid,restoration,6,1,5
Elo,dun-morogh,96,druid,restoration,6,1,5
Gintoni,dun-modr,96,druid,restoration,6,1,5
Sozu,magtheridon,96,druid,restoration,6,1,5
Thaïs,blackmoore,96,druid,restoration,6,1,5
Horadruid,silvermoon,96,druid,restoration,6,1,5
Qdrood,quelthalas,96,druid,restoration,6,1,5
Kruwkamilka,burning-legion,96,druid,restoration,6,1,5
Ymgrawl,zuljin,96,druid,restoration,6,1,5
Symba,uldum,96,druid,restoration,6,1,5
Faladriel,zirkel-des-cenarius,96,druid,restoration,7,1,6
Napukka,silvermoon,96,druid,restoration,12,1,11
Püpply,antonidas,96,druid,restoration,12,1,11
Tafs,stormscale,96,druid,restoration,12,1,11
Aisak,burning-legion,96,druid,restoration,12,1,11
Athenex,azshara,96,druid,restoration,12,1,11
Mariss25076F,chogall,96,druid,restoration,12,1,11
Anniko,garona,96,druid,restoration,12,1,11
Xilmai,darksorrow,96,druid,restoration,12,1,11
Blietmachine,ravencrest,96,druid,restoration,12,1,11
Ra,stormscale,96,druid,restoration,12,1,11
Griimmjjow,kazzak,96,druid,restoration,12,1,11
Meowmeowmeow,stormscale,96,druid,restoration,12,1,11
Nevthren,aggra-português,96,druid,restoration,12,1,11
Feminhacked,outland,96,druid,restoration,12,1,11
Kli,los-errantes,96,druid,restoration,12,1,11
Avalora,the-maelstrom,96,druid,restoration,12,1,11
Чупакамра,gordunni,96,druid,restoration,12,1,11
Natur,gorgonnash,96,druid,restoration,12,1,11
Келиса,blackscar,96,druid,restoration,12,1,11
Лапунька,gordunni,96,druid,restoration,12,1,11
Raveous,tarren-mill,96,druid,restoration,18,1,17
Lübka,amanthul,95,druid,restoration,12,1,11
Acidbrate,aegwynn,90,druid,restoration,12,3,9
Watchmymoon,blackrock,84,druid,restoration,20,4,16
Pobrica,stormscale,79,druid,restoration,5,1,4
Sealife,destromath,79,druid,restoration,5,1,4
Druidenee,hyjal,63,druid,restoration,2,2,0
Rasserdruid,runetotem,63,druid,restoration,2,2,0
Shunos,ragnaros,48,druid,restoration,9,1,8
Restouz,twisting-nether,42,druid,restoration,6,2,4
Quizdarude,draenor,42,druid,restoration,10,3,7
Therøn,dun-modr,42,druid,restoration,11,3,8
Growlithe,hellfire,42,druid,restoration,8,2,6
Eceria,the-maelstrom,42,druid,restoration,9,2,7
Feráx,doomhammer,42,druid,restoration,9,2,7
Ультраафина,gordunni,42,druid,restoration,9,2,7
Amadi,grim-batol,42,druid,restoration,9,2,7
Аллишана,howling-fjord,42,druid,restoration,10,2,8
Noxann,archimonde,42,druid,restoration,10,2,8
Onacor,stormrage,42,druid,restoration,10,2,8
Nytaleas,naxxramas,42,druid,restoration,10,2,8
Uniquz,sylvanas,42,druid,restoration,11,2,9
Vanarea,argent-dawn,42,druid,restoration,14,2,12
Druiden,the-maelstrom,31,druid,restoration,2,1,1
Девочкамиши,soulflayer,31,druid,restoration,2,1,1
Bulleyo,ysondre,1595,druid,guardian,107,58,49
Djemdruid,argent-dawn,1585,druid,guardian,42,18,24
Windythemilf,stormscale,1240,druid,guardian,195,98,97
Сверххищникк,soulflayer,1163,druid,guardian,50,20,30
Rbgbear,blackhand,1156,druid,guardian,36,15,21
Rapatera,argent-dawn,1115,druid,guardian,24,12,12
Reshifted,sunstrider,1090,druid,guardian,39,14,25
Durlehardu,archimonde,1053,druid,guardian,41,19,22
Микайо,goldrinn,986,druid,guardian,41,17,24
Avior,eonar,975,druid,guardian,106,46,60
Laracroft,the-maelstrom,953,druid,guardian,22,11,11
Bigdomas,sylvanas,833,druid,guardian,34,14,20
Renaissancee,silvermoon,823,druid,guardian,32,10,22
Avisa,blackhand,786,druid,guardian,78,30,48
Ноорру,gordunni,715,druid,guardian,11,8,3
Ксидронис,eversong,687,druid,guardian,22,8,14
Lioky,dun-modr,670,druid,guardian,12,7,5
Critter,kargath,661,druid,guardian,24,7,17
Wildsoûl,kazzak,575,druid,guardian,24,6,18
Crazydudu,tarren-mill,550,druid,guardian,27,8,19
Win,hellscream,496,druid,guardian,23,7,16
Slotheron,ravencrest,480,druid,guardian,12,5,7
Tigerbear,argent-dawn,384,druid,guardian,12,4,8
Horizonline,terokkar,350,druid,guardian,11,4,7
Фэк,eversong,288,druid,guardian,6,3,3
Icxigo,silvermoon,288,druid,guardian,6,3,3
Гохгерункянк,soulflayer,287,druid,guardian,6,3,3
Pumpick,doomhammer,285,druid,guardian,13,3,10
Kaynine,lightnings-blade,192,druid,guardian,6,2,4
Sároman,ravencrest,192,druid,guardian,6,2,4
Astralcore,stormscale,192,druid,guardian,6,2,4
Джирас,gordunni,192,druid,guardian,6,2,4
Druidyy,exodar,192,druid,guardian,6,2,4
Kárrde,balnazzar,192,druid,guardian,6,2,4
Zinister,hyjal,192,druid,guardian,6,2,4
Nwal,thunderhorn,192,druid,guardian,12,2,10
Fynvola,anubarak,192,druid,guardian,12,2,10
Beteralsjij,frostwhisper,192,druid,guardian,12,2,10
Silver,terokkar,192,druid,guardian,12,2,10
Sheâ,nemesis,191,druid,guardian,6,2,4
Pure,kul-tiras,190,druid,guardian,15,3,12
Plandros,draenor,96,druid,guardian,6,1,5
Anthlas,outland,96,druid,guardian,6,1,5
Leondir,quelthalas,96,druid,guardian,6,1,5
Almightydudu,draenor,96,druid,guardian,6,1,5
Oõ,aggra-português,96,druid,guardian,6,1,5
Жекакотик,eversong,96,druid,guardian,6,1,5
Brutaldamage,ravencrest,2271,druid,feral,119,63,56
Ktx,aegwynn,2238,druid,feral,84,50,34
Verycringe,ravencrest,2237,druid,feral,144,75,69
Twinklex,ravencrest,2186,druid,feral,185,91,94
Lïved,nemesis,2184,druid,feral,114,71,43
Xercas,outland,2166,druid,feral,65,39,26
Degmond,silvermoon,2147,druid,feral,108,61,47
Mabkferal,ravencrest,2146,druid,feral,133,67,66
Elîas,kazzak,2141,druid,feral,77,45,32
Desenlace,ravencrest,2127,druid,feral,149,82,67
Tael,elune,2119,druid,feral,120,60,60
Houmrx,ravencrest,2113,druid,feral,173,89,84
Bloodyredlyx,ysera,2112,druid,feral,90,46,44
Öøöøöøöøöøöø,anachronos,2110,druid,feral,72,47,25
Ромкабикстар,gordunni,2107,druid,feral,78,40,38
Cataferal,ravencrest,2075,druid,feral,108,57,51
Yone,blackmoore,2071,druid,feral,78,44,34
Nìm,outland,2057,druid,feral,124,60,64
Crøwnd,twisting-nether,2056,druid,feral,54,34,20
Dashfull,ravencrest,2049,druid,feral,227,122,105
Desenlace,silvermoon,2047,druid,feral,156,77,79
Tomyn,burning-legion,2033,druid,feral,72,43,29
Zøte,ravencrest,2026,druid,feral,96,47,49
Uebiwe,silvermoon,2022,druid,feral,84,48,36
Rubbershark,ravencrest,2020,druid,feral,154,99,55
Rapatera,argent-dawn,2019,druid,feral,54,30,24
Jakamx,ravencrest,2017,druid,feral,342,172,170
Mmlprox,burning-legion,2012,druid,feral,121,59,62
Vulko,lightbringer,2009,druid,feral,108,52,56
Taladruide,archimonde,2002,druid,feral,102,50,52
Lxve,tarren-mill,1999,druid,feral,66,34,32
Purgatxry,ravencrest,1989,druid,feral,443,224,219
Råñkønêbëår,ravencrest,1982,druid,feral,60,36,24
Gurranq,argent-dawn,1964,druid,feral,60,32,28
Trøüpäx,outland,1955,druid,feral,123,61,62
Iminz,ravencrest,1950,druid,feral,233,111,122
Djgírlßøssqt,argent-dawn,1941,druid,feral,126,62,64
Трэвисдог,gordunni,1936,druid,feral,59,31,28
Mutaattori,sylvanas,1931,druid,feral,61,29,32
Kaldorei,nemesis,1929,druid,feral,56,33,23
Mortality,proudmoore,1925,druid,feral,77,39,38
Cløwnferalx,argent-dawn,1921,druid,feral,54,25,29
Cåssidy,archimonde,1911,druid,feral,72,32,40
Kàraba,archimonde,1909,druid,feral,94,47,47
Noxxìe,draenor,1904,druid,feral,56,29,27
Ðevilwhite,nemesis,1902,druid,feral,36,20,16
Nîîght,ravencrest,1895,druid,feral,54,26,28
Норланда,gordunni,1884,druid,feral,60,32,28
Опакот,howling-fjord,1879,druid,feral,68,30,38
Garbagemonky,amanthul,1878,druid,feral,130,83,47
Trauller,outland,1872,druid,feral,72,30,42
Symbiosa,silvermoon,1870,druid,feral,30,20,10
Elfsu,ravencrest,1863,druid,feral,77,44,33
Obeseferal,outland,1859,druid,feral,66,31,35
Bigangrycatx,ravencrest,1859,druid,feral,68,31,37
Boostedbear,ragnaros,1848,druid,feral,65,30,35
Нимир,soulflayer,1844,druid,feral,72,34,38
Bigcrazycatx,ravencrest,1844,druid,feral,72,33,39
Kattenvoer,stormscale,1842,druid,feral,36,27,9
Alexmeow,ravencrest,1841,druid,feral,56,34,22
Calaftayou,ravencrest,1841,druid,feral,72,33,39
Ethryl,ravencrest,1837,druid,feral,90,45,45
Skatch,sylvanas,1836,druid,feral,54,28,26
Yesbody,tarren-mill,1836,druid,feral,48,24,24
Jhiun,ragnaros,1833,druid,feral,126,68,58
Mysticalmoon,ravencrest,1832,druid,feral,72,32,40
Khunahype,thrall,1829,druid,feral,42,31,11
Февти,gordunni,1828,druid,feral,59,34,25
Блюгилли,ashenvale,1826,druid,feral,86,40,46
Kaÿn,tarren-mill,1825,druid,feral,54,24,30
Jåkeferalta,outland,1824,druid,feral,81,42,39
Drbeef,sanguino,1823,druid,feral,45,28,17
Zelaron,twisting-nether,1823,druid,feral,42,22,20
Léxiny,blackrock,1822,druid,feral,29,20,9
Фейкхехе,gordunni,1822,druid,feral,48,27,21
Reward,ragnaros,1819,druid,feral,64,30,34
Rheasilvià,silvermoon,1818,druid,feral,54,31,23
Fyrkax,aegwynn,1818,druid,feral,48,26,22
Блиденг,gordunni,1818,druid,feral,81,43,38
Kroñm,dun-modr,1818,druid,feral,60,25,35
Cocaqt,nemesis,1815,druid,feral,58,35,23
Fendrïl,varimathras,1814,druid,feral,90,55,35
Nøfåmïly,silvermoon,1814,druid,feral,160,83,77
Лардиан,gordunni,1813,druid,feral,42,25,17
Nainket,ravencrest,1813,druid,feral,48,22,26
Moonkniight,ravencrest,1810,druid,feral,30,22,8
Dureka,tarren-mill,1810,druid,feral,60,38,22
Nfxdruid,argent-dawn,1810,druid,feral,90,54,36
Muckì,alleria,1808,druid,feral,48,24,24
Minaervea,antonidas,1808,druid,feral,102,47,55
Bleêds,dun-modr,1807,druid,feral,30,19,11
Coineagan,frostmourne,1807,druid,feral,46,20,26
Caprïsun,archimonde,1804,druid,feral,42,24,18
Tilikum,stormscale,1804,druid,feral,311,156,155
Mykk,ravencrest,1802,druid,feral,54,33,21
Ratsimulator,tarren-mill,1802,druid,feral,54,32,22
Skytek,silvermoon,1802,druid,feral,84,41,43
Мелталиора,soulflayer,1800,druid,feral,59,30,29
Annksunamún,ysondre,1798,druid,feral,225,124,101
Nzmdruid,burning-legion,1795,druid,feral,48,25,23
Alessathrina,argent-dawn,1783,druid,feral,192,93,99
Dzandel,silvermoon,1781,druid,feral,494,246,248
Ålleyézoffme,ravencrest,1780,druid,feral,77,43,34
Catkovic,kult-der-verdammten,1777,druid,feral,47,24,23
Отхода,gordunni,1770,druid,feral,40,22,18
Klaerke,tarren-mill,1769,druid,feral,75,32,43
Noé,aegwynn,1766,druid,feral,183,112,71
Jarethy,dun-modr,1766,druid,feral,117,55,62
Каергорн,soulflayer,1766,druid,feral,54,19,35
Селфика,gordunni,1757,druid,feral,66,21,45
Yaddas,draenor,1754,druid,feral,60,27,33
Sleepykitty,argent-dawn,1750,druid,feral,143,75,68
Fürfur,ravencrest,1749,druid,feral,48,29,19
Kikihoux,ravencrest,1747,druid,feral,41,22,19
Moldrokk,ravencrest,1739,druid,feral,52,31,21
Feralwilder,turalyon,1736,druid,feral,165,75,90
Babynaty,ravencrest,1735,druid,feral,102,48,54
Pilaf,emerald-dream,1734,druid,feral,133,63,70
Шев,blackscar,1733,druid,feral,48,23,25
Apuasaatana,stormreaver,1731,druid,feral,36,20,16
Jabbari,outland,1729,druid,feral,186,96,90
Jukeboks,silvermoon,1726,druid,feral,55,25,30
Verbxp,kazzak,1725,druid,feral,65,35,30
Buffshred,ravencrest,1721,druid,feral,24,18,6
Themartyr,tarren-mill,1721,druid,feral,30,18,12
Zechey,stormreaver,1721,druid,feral,30,18,12
Shiftydruid,thunderhorn,1718,druid,feral,206,99,107
Zaibastus,doomhammer,1718,druid,feral,72,30,42
Opresse,archimonde,1717,druid,feral,66,28,38
Melsson,stormreaver,1714,druid,feral,48,22,26
Pänthërä,ravencrest,1711,druid,feral,36,18,18
Итильтириэль,gordunni,1705,druid,feral,92,41,51
Worgenshiftr,kazzak,1697,druid,feral,48,21,27
Kouda,draenor,1696,druid,feral,74,34,40
Ottur,argent-dawn,1695,druid,feral,30,18,12
Blvckðvitchz,ravencrest,1692,druid,feral,36,18,18
Tangela,stormreaver,1689,druid,feral,48,29,19
Fückøff,ravencrest,1689,druid,feral,65,33,32
Natakis,blades-edge,1688,druid,feral,48,25,23
Doopdroo,tarren-mill,1687,druid,feral,48,20,28
Scaleo,stormreaver,1686,druid,feral,42,26,16
Facerippin,proudmoore,1683,druid,feral,40,21,19
Freyanah,argent-dawn,1682,druid,feral,111,49,62
ßgøðx,argent-dawn,1681,druid,feral,79,45,34
Arfgtdispo,hyjal,1680,druid,feral,48,23,25
Hässelhoof,ragnaros,1680,druid,feral,114,48,66
Jellytardx,outland,1675,druid,feral,75,41,34
Paranoia,outland,1675,druid,feral,94,46,48
Zifr,dalaran,1675,druid,feral,66,22,44
Thørkang,dun-modr,1674,druid,feral,59,36,23
Crazydos,tarren-mill,1671,druid,feral,57,27,30
Phenova,sargeras,1671,druid,feral,99,41,58
Adastroeolo,sanguino,1669,druid,feral,87,49,38
Aedui,tarren-mill,1668,druid,feral,38,20,18
Ðrüid,ravencrest,1668,druid,feral,72,34,38
Jgltrainer,archimonde,1666,druid,feral,53,31,22
Nøkki,draenor,1666,druid,feral,62,34,28
Silksharp,ravencrest,1663,druid,feral,60,31,29
Bernfried,silvermoon,1662,druid,feral,64,28,36
Triluxa,blackmoore,1659,druid,feral,54,28,26
Adabsurdum,kazzak,1659,druid,feral,124,55,69
Blakkowl,drakthul,1653,druid,feral,36,21,15
Bigpapad,ravencrest,1651,druid,feral,42,21,21
Indann,kazzak,1651,druid,feral,48,19,29
Nasukka,grim-batol,1648,druid,feral,103,54,49
Moskaros,turalyon,1646,druid,feral,90,41,49
Ckelf,ravencrest,1646,druid,feral,42,18,24
Nouin,twisting-nether,1643,druid,feral,154,74,80
Simdruid,stormscale,1641,druid,feral,36,19,17
Bulan,ghostlands,1638,druid,feral,66,41,25
Goodtrip,archimonde,1636,druid,feral,110,53,57
Phïl,ravencrest,1635,druid,feral,90,48,42
Emph,ravencrest,1631,druid,feral,48,28,20
Ñøpe,ravencrest,1630,druid,feral,30,17,13
Fzx,aegwynn,1629,druid,feral,30,17,13
Ddru,ravencrest,1629,druid,feral,36,20,16
Avanah,silvermoon,1626,druid,feral,72,35,37
Rami,sylvanas,1624,druid,feral,114,56,58
Паинтер,blackscar,1624,druid,feral,59,27,32
Котосапенс,howling-fjord,1623,druid,feral,42,23,19
Грязныекогти,gordunni,1622,druid,feral,65,39,26
Goldrax,outland,1621,druid,feral,48,22,26
Neyok,blackrock,1619,druid,feral,50,26,24
Злодзейка,gordunni,1619,druid,feral,105,53,52
Skypinho,blackhand,1616,druid,feral,48,22,26
Djmeowxd,blackrock,1616,druid,feral,69,30,39
Soofyan,kazzak,1615,druid,feral,54,22,32
Rayjinn,dun-modr,1613,druid,feral,36,17,19
Narunis,tarren-mill,1612,druid,feral,90,43,47
Unoseeme,outland,1610,druid,feral,95,42,53
Heyiamdan,tarren-mill,1609,druid,feral,158,88,70
Hugepepega,ravencrest,1608,druid,feral,48,27,21
Banzeye,nordrassil,1607,druid,feral,68,35,33
Feytique,aegwynn,1607,druid,feral,53,27,26
Тётявискас,howling-fjord,1606,druid,feral,42,26,16
Pitchou,karazhan,1606,druid,feral,70,35,35
Crisspurolss,ysondre,1605,druid,feral,73,38,35
Реалаг,howling-fjord,1604,druid,feral,47,20,27
Evilshade,ravencrest,1604,druid,feral,115,47,68
Акиша,deepholm,1602,druid,feral,44,21,23
Køgér,kazzak,1601,druid,feral,30,17,13
Zarc,stormreaver,1601,druid,feral,37,20,17
Chronoqtxd,ravencrest,1601,druid,feral,52,24,28
Tani,kazzak,1600,druid,feral,63,34,29
Ajwen,tarren-mill,1593,druid,feral,30,20,10
Frighton,ravencrest,1591,druid,feral,72,30,42
Drunosio,magtheridon,1588,druid,feral,78,36,42
Vëgâñgøðx,ragnaros,1582,druid,feral,170,90,80
Fluffygoon,tarren-mill,1581,druid,feral,86,41,45
Leylå,ravencrest,1578,druid,feral,42,19,23
Wucherwurzel,eredar,1576,druid,feral,107,47,60
Nédith,archimonde,1576,druid,feral,42,18,24
Sartipus,draenor,1575,druid,feral,48,24,24
Raznos,ravencrest,1572,druid,feral,83,48,35
Asçdruid,kazzak,1572,druid,feral,56,24,32
Eranor,archimonde,1569,druid,feral,152,79,73
Yongala,archimonde,1565,druid,feral,66,35,31
Stopwatching,outland,1565,druid,feral,42,18,24
Fangornn,outland,1560,druid,feral,89,40,49
Sadskia,sanguino,1559,druid,feral,42,20,22
Риама,blackscar,1558,druid,feral,78,38,40
Jasperqt,silvermoon,1556,druid,feral,30,18,12
Drylle,argent-dawn,1555,druid,feral,93,50,43
Cubswansón,outland,1550,druid,feral,79,43,36
Zhosy,shattrath,1550,druid,feral,41,17,24
Texoria,twisting-nether,1549,druid,feral,126,63,63
Chiwsy,outland,1548,druid,feral,83,42,41
Féral,hyjal,1548,druid,feral,101,48,53
Vlcák,drakthul,1547,druid,feral,202,104,98
Smuktøs,twisting-nether,1546,druid,feral,47,28,19
Lunamimi,argent-dawn,1544,druid,feral,84,55,29
Køda,blackrock,1544,druid,feral,44,19,25
Gediminas,argent-dawn,1543,druid,feral,82,29,53
Bigdaddytate,kazzak,1542,druid,feral,59,38,21
Мунпраид,gordunni,1541,druid,feral,78,39,39
Sekunden,ravencrest,1540,druid,feral,72,37,35
Retzerbil,ravencrest,1535,druid,feral,28,17,11
Kärmä,eldrethalas,1535,druid,feral,113,58,55
Baerminatør,blackrock,1535,druid,feral,72,35,37
Shyngodx,archimonde,1533,druid,feral,41,17,24
Сириль,soulflayer,1531,druid,feral,53,29,24
Maccín,draenor,1530,druid,feral,52,18,34
Epicplays,sylvanas,1526,druid,feral,84,49,35
Lenyl,dun-modr,1526,druid,feral,36,16,20
Одряя,soulflayer,1525,druid,feral,90,51,39
Оудин,blackscar,1521,druid,feral,47,23,24
Razoremperor,tarren-mill,1519,druid,feral,138,64,74
Житмедветь,booty-bay,1518,druid,feral,52,27,25
Rbgbot,ragnaros,1517,druid,feral,54,30,24
Extracssion,ysondre,1515,druid,feral,89,40,49
Unreally,drakthul,1512,druid,feral,30,18,12
Zurllyn,ravencrest,1511,druid,feral,42,18,24
Druidry,ragnaros,1506,druid,feral,54,30,24
Даркедес,gordunni,1506,druid,feral,30,16,14
Jerrybeans,ravencrest,1504,druid,feral,120,57,63
Panthéra,ravencrest,1502,druid,feral,220,110,110
Взп,gordunni,1502,druid,feral,36,18,18
Зонкс,gordunni,1501,druid,feral,92,47,45
Unlit,draenor,1499,druid,feral,54,27,27
Броодяга,razuvious,1497,druid,feral,41,18,23
Kabraxis,silvermoon,1494,druid,feral,54,25,29
Chirnaruk,ravencrest,1492,druid,feral,72,38,34
Арбузег,gordunni,1491,druid,feral,64,31,33
Hkwoaf,chants-éternels,1487,druid,feral,47,18,29
Rollozuu,blackrock,1483,druid,feral,96,46,50
Crow,saurfang,1482,druid,feral,62,34,28
Clipsy,twilights-hammer,1480,druid,feral,291,144,147
Màz,blackmoore,1480,druid,feral,140,64,76
Byet,kazzak,1478,druid,feral,42,17,25
Элисандра,gordunni,1470,druid,feral,48,31,17
Oleander,zuljin,1465,druid,feral,133,66,67
Hushorde,twisting-nether,1464,druid,feral,47,23,24
Zaethul,draenor,1460,druid,feral,30,20,10
Муумуумуу,howling-fjord,1457,druid,feral,150,69,81
Arlina,magtheridon,1454,druid,feral,57,26,31
Ripgødx,outland,1453,druid,feral,146,79,67
Christàlyst,garona,1452,druid,feral,45,23,22
Bomoth,kazzak,1451,druid,feral,36,16,20
Biffsteak,blackhand,1450,druid,feral,186,95,91
Larryburns,nathrezim,1450,druid,feral,116,57,59
Deehe,thrall,1447,druid,feral,36,18,18
Smellykitten,ravencrest,1445,druid,feral,36,18,18
Kimpine,kirin-tor,1444,druid,feral,73,41,32
Vargall,silvermoon,1441,druid,feral,29,19,10
Docmedlove,aegwynn,1437,druid,feral,36,15,21
Chromaticx,argent-dawn,1436,druid,feral,56,32,24
Dubakoo,outland,1435,druid,feral,85,46,39
Hydorn,cthun,1435,druid,feral,50,24,26
Crinji,ravencrest,1433,druid,feral,24,15,9
Boomzter,frostmane,1433,druid,feral,75,36,39
Микайо,goldrinn,1432,druid,feral,167,79,88
Margueriti,the-maelstrom,1429,druid,feral,85,38,47
Беконайзер,howling-fjord,1427,druid,feral,40,20,20
Tazdino,destromath,1427,druid,feral,48,15,33
Arilíaxo,amanthul,1426,druid,feral,18,15,3
Бобасик,fordragon,1425,druid,feral,90,43,47
Lugtedyr,draenor,1423,druid,feral,59,29,30
Алексина,fordragon,1422,druid,feral,166,90,76
Mervend,tarren-mill,1420,druid,feral,41,15,26
Ephixa,burning-legion,1419,druid,feral,47,23,24
Bagheera,archimonde,1419,druid,feral,95,45,50
Фекаллис,soulflayer,1417,druid,feral,30,15,15
Alcik,silvermoon,1417,druid,feral,54,15,39
Nå,outland,1413,druid,feral,146,70,76
Муунфаер,gordunni,1410,druid,feral,97,44,53
Mônchô,sanguino,1408,druid,feral,100,61,39
Thaelyy,drakthul,1407,druid,feral,66,27,39
Kodobursto,stormscale,1406,druid,feral,85,50,35
Эскоф,gordunni,1406,druid,feral,74,39,35
Degentiuso,alakir,1405,druid,feral,96,53,43
Furmagic,tarren-mill,1405,druid,feral,30,15,15
Enjoik,drakthul,1404,druid,feral,131,65,66
Snapzy,sylvanas,1401,druid,feral,42,27,15
Luigina,blackmoore,1400,druid,feral,30,15,15
Phesxd,sylvanas,1400,druid,feral,54,26,28
Koumma,archimonde,1395,druid,feral,91,47,44
Picatso,blackrock,1395,druid,feral,30,15,15
Seyyid,archimonde,1394,druid,feral,36,18,18
Sabertoon,argent-dawn,1393,druid,feral,165,73,92
Neshalry,blackhand,1392,druid,feral,36,16,20
Elitarian,argent-dawn,1391,druid,feral,163,81,82
Котфилин,gordunni,1389,druid,feral,78,44,34
Ponshü,hyjal,1389,druid,feral,45,24,21
Sløthy,uldum,1386,druid,feral,46,24,22
Legitx,dentarg,1385,druid,feral,43,17,26
Drudonja,silvermoon,1384,druid,feral,102,53,49
Tsopúnisher,twisting-nether,1383,druid,feral,46,20,26
Carlitto,blackmoore,1382,druid,feral,33,23,10
Crtx,blackhand,1381,druid,feral,102,60,42
Liqoú,tarren-mill,1380,druid,feral,54,31,23
Donoz,ravencrest,1378,druid,feral,42,26,16
Zhényá,ravencrest,1377,druid,feral,36,17,19
Ferøsse,hyjal,1374,druid,feral,42,21,21
Pipima,kazzak,1374,druid,feral,48,20,28
Cörelly,ravencrest,1368,druid,feral,96,48,48
Акетчи,howling-fjord,1366,druid,feral,42,24,18
Blintschiki,echsenkessel,1363,druid,feral,71,32,39
Друличч,blackscar,1361,druid,feral,61,29,32
Диаболус,gordunni,1359,druid,feral,62,32,30
Rottweiler,doomhammer,1357,druid,feral,102,46,56
Dadzeus,khaz-modan,1354,druid,feral,50,28,22
Äcajou,hyjal,1354,druid,feral,70,39,31
Manoestouro,draenor,1353,druid,feral,48,19,29
ßußßo,ravencrest,1352,druid,feral,30,24,6
Druidicmorr,sylvanas,1351,druid,feral,68,30,38
Sÿlph,sylvanas,1348,druid,feral,102,51,51
Grimgoor,burning-legion,1347,druid,feral,94,52,42
Snapeshifter,blackhand,1343,druid,feral,36,19,17
Bignik,tarren-mill,1343,druid,feral,30,14,16
Chepochem,stormscale,1341,druid,feral,38,16,22
Ефомитстерша,gordunni,1339,druid,feral,36,17,19
Тёмныйзверь,borean-tundra,1339,druid,feral,54,20,34
Snøwden,twisting-nether,1337,druid,feral,48,27,21
Фейк,howling-fjord,1337,druid,feral,36,14,22
Хэрес,gordunni,1336,druid,feral,24,14,10
Vancis,ravencrest,1335,druid,feral,69,35,34
Cheddar,tyrande,1332,druid,feral,46,22,24
Криашин,goldrinn,1331,druid,feral,63,28,35
Dijem,wildhammer,1329,druid,feral,66,39,27
Mooncarnatio,burning-legion,1329,druid,feral,42,14,28
Starliner,ravencrest,1326,druid,feral,36,14,22
Шэйпшифт,fordragon,1326,druid,feral,42,16,26
Quikahn,outland,1323,druid,feral,30,14,16
Vanhelsíng,dun-modr,1322,druid,feral,22,15,7
Turkus,draenor,1322,druid,feral,72,31,41
Basedgôd,alakir,1321,druid,feral,24,14,10
Chouan,marécage-de-zangar,1320,druid,feral,188,96,92
Drupal,argent-dawn,1319,druid,feral,36,19,17
Migajde,stormscale,1317,druid,feral,83,49,34
Lukeyferalxo,argent-dawn,1317,druid,feral,162,75,87
Балаклаваа,soulflayer,1316,druid,feral,29,18,11
Erelae,twisting-nether,1316,druid,feral,33,16,17
Hottad,tarren-mill,1313,druid,feral,132,72,60
Медверх,gordunni,1313,druid,feral,54,24,30
Enock,hyjal,1312,druid,feral,24,14,10
Лякокля,soulflayer,1312,druid,feral,78,42,36
Majokz,ravencrest,1307,druid,feral,44,23,21
Regelè,sylvanas,1305,druid,feral,86,45,41
Henessi,ragnaros,1302,druid,feral,30,14,16
Droodae,hyjal,1301,druid,feral,53,27,26
Nalaa,festung-der-stürme,1301,druid,feral,130,59,71
Paws,dun-modr,1300,druid,feral,66,33,33
Maylon,darksorrow,1294,druid,feral,48,23,25
Liya,ravencrest,1292,druid,feral,48,15,33
Kirmelastas,kazzak,1289,druid,feral,56,29,27
Chinoiserie,aszune,1287,druid,feral,48,26,22
Malfurryon,drakthul,1285,druid,feral,30,16,14
Naetsch,blackrock,1285,druid,feral,47,20,27
Carakal,outland,1284,druid,feral,53,24,29
Weydjin,garona,1278,druid,feral,30,16,14
Malfyurion,ragnaros,1276,druid,feral,114,57,57
Ghettoven,kazzak,1275,druid,feral,66,30,36
Stelthee,silvermoon,1274,druid,feral,60,27,33
Symbiosîs,stormscale,1273,druid,feral,41,17,24
Laguna,ravencrest,1271,druid,feral,41,14,27
Jxst,tarren-mill,1270,druid,feral,48,19,29
Йванныч,gordunni,1268,druid,feral,55,27,28
Owling,antonidas,1262,druid,feral,78,46,32
Jaxtn,tarren-mill,1259,druid,feral,46,24,22
Koffee,archimonde,1259,druid,feral,48,23,25
Беркамп,howling-fjord,1257,druid,feral,111,45,66
Shinshìva,twisting-nether,1255,druid,feral,205,104,101
Pepeja,doomhammer,1253,druid,feral,24,15,9
Dougi,argent-dawn,1252,druid,feral,60,28,32
Trusten,nemesis,1249,druid,feral,84,46,38
Ведмедив,blackscar,1249,druid,feral,84,36,48
Taigarus,aerie-peak,1246,druid,feral,72,34,38
Benyameow,ravencrest,1245,druid,feral,18,13,5
Loyoq,elune,1244,druid,feral,24,13,11
Weedgras,eredar,1244,druid,feral,30,13,17
Tussenfryd,draenor,1243,druid,feral,150,69,81
Shifthappens,dun-modr,1242,druid,feral,24,13,11
Tîma,blackmoore,1241,druid,feral,206,101,105
Salseo,uldum,1239,druid,feral,33,14,19
Развалустоев,blackscar,1237,druid,feral,24,13,11
Cleandc,blackhand,1234,druid,feral,34,20,14
Кеорл,gordunni,1234,druid,feral,102,43,59
Soléda,thrall,1233,druid,feral,129,60,69
Webla,blackmoore,1231,druid,feral,29,15,14
Deviantdruid,tarren-mill,1231,druid,feral,39,20,19
Bâbusch,blackmoore,1230,druid,feral,24,13,11
Катяблум,gordunni,1230,druid,feral,30,13,17
Shifabull,kazzak,1229,druid,feral,35,17,18
Andros,arathor,1229,druid,feral,42,15,27
Shaggery,stormscale,1227,druid,feral,93,39,54
Ildrin,ragnaros,1226,druid,feral,30,19,11
Whísperclaw,ravencrest,1226,druid,feral,41,21,20
Dirtyfantasy,alakir,1225,druid,feral,54,31,23
Yøløswag,naxxramas,1224,druid,feral,95,56,39
Moonglade,deathwing,1220,druid,feral,33,14,19
Jdogger,tarren-mill,1219,druid,feral,24,13,11
Garfield,uldum,1218,druid,feral,41,21,20
Ganjeez,kazzak,1218,druid,feral,30,13,17
Tyldormeow,tarren-mill,1216,druid,feral,167,74,93
Azmerloth,antonidas,1214,druid,feral,36,13,23
Defløwer,aegwynn,1213,druid,feral,36,18,18
Tàlented,aggra-português,1213,druid,feral,29,13,16
Смизм,gordunni,1209,druid,feral,38,19,19
Dudeimgodly,ravencrest,1205,druid,feral,42,13,29
Kintax,drakthul,1201,druid,feral,81,44,37
Bigscarycatx,ravencrest,1199,druid,feral,21,13,8
Storslev,stormscale,1199,druid,feral,137,55,82
Azenoir,ravencrest,1199,druid,feral,39,14,25
Liionheart,khaz-modan,1198,druid,feral,60,29,31
Devonshira,ravencrest,1198,druid,feral,36,14,22
Богарт,soulflayer,1193,druid,feral,24,14,10
Zeyne,ravencrest,1193,druid,feral,24,14,10
Lorcàn,argent-dawn,1189,druid,feral,52,22,30
Twyty,khaz-modan,1186,druid,feral,167,79,88
Herten,tarren-mill,1185,druid,feral,30,13,17
Snootxt,blackmoore,1185,druid,feral,54,23,31
Millenia,darkmoon-faire,1183,druid,feral,127,64,63
Nevercloneqt,argent-dawn,1181,druid,feral,29,13,16
Gonco,blackrock,1173,druid,feral,70,30,40
Naturalie,silvermoon,1172,druid,feral,60,19,41
Tl,archimonde,1170,druid,feral,61,28,33
Álex,anachronos,1169,druid,feral,36,16,20
Kittasek,drakthul,1167,druid,feral,36,23,13
Ivìs,nemesis,1160,druid,feral,90,38,52
Nightfáll,tarren-mill,1157,druid,feral,36,13,23
Howtonio,archimonde,1151,druid,feral,18,12,6
Katzovic,kult-der-verdammten,1151,druid,feral,18,12,6
Zbear,kazzak,1151,druid,feral,36,16,20
Sùmmèrz,ravencrest,1150,druid,feral,24,12,12
Fallken,burning-blade,1149,druid,feral,24,12,12
Treeflogger,ravencrest,1149,druid,feral,96,42,54
Arnwaald,kaelthas,1147,druid,feral,42,21,21
Frs,bladefist,1147,druid,feral,30,12,18
Trevorkki,korgall,1147,druid,feral,31,12,19
Tibozx,stormscale,1146,druid,feral,36,21,15
Mímír,frostmane,1145,druid,feral,24,12,12
Ra,stormscale,1145,druid,feral,24,12,12
Calîmerô,blackrock,1142,druid,feral,18,12,6
Veryfast,blackhand,1142,druid,feral,24,12,12
Jinxaran,culte-de-la-rive-noire,1135,druid,feral,36,12,24
Tranduiil,drakthul,1131,druid,feral,96,56,40
Käissi,blackmoore,1127,druid,feral,60,27,33
Larkos,grim-batol,1126,druid,feral,30,15,15
Кыцко,soulflayer,1124,druid,feral,24,12,12
Naheliaqt,outland,1121,druid,feral,24,12,12
Swagmode,draenor,1119,druid,feral,49,30,19
Lemmí,frostwolf,1113,druid,feral,30,13,17
Malvakten,kazzak,1112,druid,feral,25,13,12
Jaghut,burning-legion,1109,druid,feral,18,12,6
Kynji,twisting-nether,1109,druid,feral,66,28,38
Bæghira,draenor,1106,druid,feral,88,49,39
Moonpuff,kazzak,1103,druid,feral,45,22,23
Papan,sylvanas,1100,druid,feral,66,34,32
Mudpie,stormscale,1100,druid,feral,55,23,32
Zivertgodx,argent-dawn,1093,druid,feral,48,23,25
Nicos,elune,1091,druid,feral,29,13,16
Tyranderawr,ravencrest,1090,druid,feral,33,13,20
Vidlna,outland,1089,druid,feral,60,26,34
Jamaican,outland,1089,druid,feral,48,20,28
Shymä,hyjal,1088,druid,feral,91,35,56
Йонарк,gordunni,1087,druid,feral,41,20,21
Teacherr,quelthalas,1087,druid,feral,81,28,53
Greengünter,blackmoore,1086,druid,feral,22,12,10
Скагуар,blackscar,1084,druid,feral,68,25,43
Rootznloots,draenor,1082,druid,feral,48,26,22
Derzis,eonar,1081,druid,feral,66,32,34
Feraligator,sanguino,1081,druid,feral,180,84,96
Denadu,turalyon,1080,druid,feral,48,12,36
Taatz,stormscale,1079,druid,feral,30,20,10
Elenwyth,argent-dawn,1079,druid,feral,111,47,64
Exortas,kazzak,1078,druid,feral,67,27,40
Blacknight,aggramar,1073,druid,feral,39,13,26
Blazor,eredar,1072,druid,feral,58,29,29
Kageioshi,kazzak,1070,druid,feral,56,28,28
Мукару,howling-fjord,1069,druid,feral,24,13,11
Progodd,silvermoon,1064,druid,feral,72,35,37
Асония,deathguard,1056,druid,feral,24,11,13
Vahid,antonidas,1055,druid,feral,12,11,1
Yhavi,kazzak,1055,druid,feral,26,12,14
Notsad,dun-modr,1055,druid,feral,24,11,13
Weyztwo,hyjal,1055,druid,feral,24,11,13
Salviaf,silvermoon,1055,druid,feral,94,43,51
Belsebub,ravencrest,1055,druid,feral,30,11,19
Ashtral,kazzak,1054,druid,feral,24,11,13
Starasta,magtheridon,1054,druid,feral,24,11,13
Runeclaws,twisting-nether,1053,druid,feral,18,11,7
Chexdruid,silvermoon,1053,druid,feral,27,12,15
Togara,kazzak,1050,druid,feral,24,11,13
Muffinjump,outland,1049,druid,feral,65,28,37
Healníx,blackrock,1046,druid,feral,20,11,9
Maethar,stormrage,1046,druid,feral,24,11,13
Weedum,kazzak,1046,druid,feral,24,11,13
Tsajj,stormreaver,1045,druid,feral,57,31,26
Nightdruidcz,turalyon,1044,druid,feral,24,11,13
Eprophet,stormscale,1041,druid,feral,36,11,25
Zaltaruk,sanguino,1040,druid,feral,98,45,53
Battleray,twisting-nether,1040,druid,feral,57,25,32
Zokix,doomhammer,1040,druid,feral,30,12,18
Mîyukí,ravencrest,1034,druid,feral,36,15,21
Kermit,die-aldor,1032,druid,feral,81,32,49
Élmunia,ravencrest,1030,druid,feral,36,19,17
Tastyrawr,blackhand,1029,druid,feral,24,11,13
Eternas,elune,1027,druid,feral,82,37,45
Hetalia,culte-de-la-rive-noire,1025,druid,feral,24,13,11
Morfâns,ragnaros,1024,druid,feral,49,23,26
Amoonaa,kazzak,1020,druid,feral,54,28,26
Cjparker,archimonde,1020,druid,feral,26,12,14
Hönör,ysondre,1016,druid,feral,183,87,96
Арвелл,gordunni,1014,druid,feral,24,11,13
Boombassador,stormscale,1012,druid,feral,36,20,16
Phanterus,chamber-of-aspects,1012,druid,feral,24,11,13
Carldroid,sylvanas,1009,druid,feral,28,13,15
Tatabomba,archimonde,1008,druid,feral,60,30,30
Брэмблс,soulflayer,1008,druid,feral,35,15,20
Kyoshî,blackmoore,1007,druid,feral,136,64,72
Mpounia,twilights-hammer,1006,druid,feral,89,45,44
Ripndip,eredar,1006,druid,feral,94,45,49
Smittly,bloodhoof,1005,druid,feral,58,23,35
Chlambak,archimonde,1004,druid,feral,24,14,10
Канвус,gordunni,1003,druid,feral,28,11,17
Savvy,arthas,1003,druid,feral,30,11,19
Фаллендэл,gordunni,1001,druid,feral,30,17,13
Clawdiá,silvermoon,995,druid,feral,60,28,32
Terror,agamaggan,983,druid,feral,36,12,24
Спэкк,gordunni,983,druid,feral,48,15,33
Rakuy,thrall,981,druid,feral,27,11,16
Arntooth,burning-legion,978,druid,feral,42,17,25
Janjalism,silvermoon,973,druid,feral,63,34,29
Descendance,ysondre,968,druid,feral,85,42,43
Klatro,terokkar,965,druid,feral,24,13,11
Tjxaxa,ravencrest,960,druid,feral,12,10,2
Ryseqt,nemesis,960,druid,feral,12,10,2
Shylovez,aegwynn,960,druid,feral,18,10,8
Møonknight,ravencrest,960,druid,feral,18,10,8
Nîghtz,ravencrest,960,druid,feral,18,10,8
Cyborgz,archimonde,960,druid,feral,18,10,8
Flufie,alexstrasza,960,druid,feral,18,10,8
Druiidou,dalaran,960,druid,feral,30,10,20
Goodtrip,hyjal,959,druid,feral,18,10,8
Suggly,ysondre,959,druid,feral,18,10,8
Жекакотик,eversong,959,druid,feral,42,21,21
Beerista,tarren-mill,959,druid,feral,24,11,13
Hahafun,ravencrest,959,druid,feral,24,10,14
Luphrekfurry,ysondre,959,druid,feral,24,10,14
Dipz,frostwolf,958,druid,feral,18,10,8
Cyph,shadowsong,958,druid,feral,18,10,8
Nîchtsnutz,blackmoore,958,druid,feral,18,10,8
Lenzork,thrall,958,druid,feral,24,10,14
Carridwyn,argent-dawn,958,druid,feral,24,10,14
Phandris,argent-dawn,957,druid,feral,91,48,43
Zjukov,ragnaros,955,druid,feral,24,10,14
Corrupthz,outland,955,druid,feral,24,10,14
Pointlez,frostmane,954,druid,feral,24,10,14
Thecòntról,ravencrest,953,druid,feral,18,10,8
Шонгу,soulflayer,953,druid,feral,24,10,14
Ивантяй,gordunni,949,druid,feral,18,10,8
Друлевой,greymane,948,druid,feral,24,12,12
Lutis,magtheridon,947,druid,feral,72,28,44
Ультраафина,gordunni,946,druid,feral,24,10,14
Inuah,veknilash,946,druid,feral,34,12,22
Collnaris,ravencrest,944,druid,feral,18,10,8
Реептилоид,soulflayer,942,druid,feral,24,10,14
Wuzzington,outland,940,druid,feral,24,10,14
Zhabka,silvermoon,939,druid,feral,45,24,21
Hadesx,blackhand,933,druid,feral,48,23,25
Stéely,ravencrest,933,druid,feral,30,14,16
Sorron,blades-edge,926,druid,feral,36,19,17
Маветт,blackscar,925,druid,feral,63,29,34
Mordpaw,stormscale,925,druid,feral,26,11,15
Trikill,hyjal,922,druid,feral,31,10,21
Mistic,twisting-nether,918,druid,feral,25,12,13
Teddîursa,kazzak,915,druid,feral,34,10,24
Blacksagex,dragonmaw,910,druid,feral,17,10,7
Gató,kazzak,899,druid,feral,32,11,21
Lohki,eredar,895,druid,feral,21,12,9
Леминвинкс,eversong,889,druid,feral,24,13,11
Джирас,gordunni,883,druid,feral,38,14,24
Verbat,cthun,878,druid,feral,42,21,21
Mommonga,onyxia,874,druid,feral,38,14,24
Nkoyi,argent-dawn,872,druid,feral,30,10,20
Béar,arathor,871,druid,feral,64,22,42
Maräanhatähr,silvermoon,869,druid,feral,36,10,26
Maaghera,silvermoon,867,druid,feral,92,40,52
Wex,darksorrow,864,druid,feral,12,9,3
Urfi,tyrande,864,druid,feral,12,9,3
Fuzzylol,haomarush,864,druid,feral,18,9,9
Paramore,outland,864,druid,feral,18,9,9
Cocomojo,outland,864,druid,feral,18,9,9
Furrykruger,the-maelstrom,864,druid,feral,18,9,9
Aleatório,grim-batol,864,druid,feral,18,9,9
Rysejr,nemesis,864,druid,feral,18,9,9
Fyrka,aegwynn,864,druid,feral,18,9,9
Roska,archimonde,864,druid,feral,18,9,9
Sixmonthbann,ravencrest,864,druid,feral,18,9,9
Pitý,kaelthas,864,druid,feral,24,9,15
Bikiniwochen,antonidas,863,druid,feral,18,9,9
Xilmai,darksorrow,863,druid,feral,18,9,9
Mònókox,eredar,863,druid,feral,18,9,9
Rbg,dun-modr,863,druid,feral,22,10,12
Aendy,tarren-mill,863,druid,feral,23,10,13
Àzà,dun-modr,863,druid,feral,21,9,12
Пиггипоп,soulflayer,863,druid,feral,24,9,15
Sethread,ragnaros,863,druid,feral,24,9,15
Олежасутра,howling-fjord,863,druid,feral,30,9,21
Aggoth,drakthul,862,druid,feral,12,9,3
Мунфайр,galakrond,862,druid,feral,18,9,9
Dilleydank,ravencrest,862,druid,feral,18,9,9
Кецян,gordunni,862,druid,feral,19,9,10
Эверблуми,howling-fjord,862,druid,feral,30,9,21
Exïlla,archimonde,861,druid,feral,18,9,9
Буйныйкот,gordunni,861,druid,feral,24,9,15
Bäkø,dun-modr,861,druid,feral,27,10,17
Caèlas,outland,859,druid,feral,18,9,9
Minaye,hyjal,859,druid,feral,18,9,9
Nalreaa,kazzak,859,druid,feral,18,9,9
Golddy,hyjal,859,druid,feral,19,9,10
Cøcøpøpsmøke,archimonde,859,druid,feral,30,12,18
Hadespool,sanguino,859,druid,feral,24,9,15
Бруан,gordunni,859,druid,feral,24,9,15
Плагиат,grom,858,druid,feral,36,10,26
Wathen,argent-dawn,857,druid,feral,34,12,22
Toaa,antonidas,857,druid,feral,30,9,21
Астраджет,gordunni,856,druid,feral,12,9,3
Aniprimal,auchindoun,854,druid,feral,18,9,9
Noyake,ragnaros,854,druid,feral,24,9,15
Wainl,hyjal,854,druid,feral,30,9,21
Bgam,ravencrest,853,druid,feral,12,9,3
Isaye,archimonde,850,druid,feral,88,31,57
Plingan,argent-dawn,847,druid,feral,17,9,8
Rellena,khaz-modan,847,druid,feral,27,12,15
Frökensuss,stormscale,844,druid,feral,27,12,15
Ziovris,silvermoon,839,druid,feral,33,9,24
Miukïna,archimonde,837,druid,feral,12,9,3
Kîñg,tarren-mill,836,druid,feral,76,33,43
Рефикс,gordunni,827,druid,feral,17,9,8
Théó,grim-batol,818,druid,feral,41,18,23
Snupy,outland,815,druid,feral,17,9,8
Зенза,howling-fjord,815,druid,feral,27,9,18
Saltow,archimonde,797,druid,feral,52,14,38
Domänia,onyxia,779,druid,feral,25,9,16
Snkxo,perenolde,768,druid,feral,12,8,4
Kgn,blackmoore,768,druid,feral,12,8,4
Mikor,aegwynn,768,druid,feral,12,8,4
Hakuchey,aegwynn,768,druid,feral,12,8,4
Kattenover,stormscale,768,druid,feral,12,8,4
Garoh,dalaran,768,druid,feral,18,8,10
Апвель,gordunni,768,druid,feral,18,8,10
Sølaria,kazzak,768,druid,feral,18,8,10
Älênkâ,drakthul,768,druid,feral,30,8,22
Svxstarz,archimonde,768,druid,feral,30,8,22
Kørnuto,nemesis,767,druid,feral,12,8,4
Firrothe,die-aldor,767,druid,feral,15,9,6
Jeezuschrist,archimonde,767,druid,feral,18,8,10
Стэлларпауэр,gordunni,767,druid,feral,18,8,10
Seysso,silvermoon,767,druid,feral,18,8,10
Mimir,la-croisade-écarlate,767,druid,feral,18,8,10
Pneuma,xavius,767,druid,feral,24,8,16
Laek,chogall,767,druid,feral,24,8,16
Acéré,archimonde,767,druid,feral,24,8,16
Psychodeliya,ragnaros,767,druid,feral,36,8,28
Kutjing,dun-modr,766,druid,feral,12,8,4
Hecky,xavius,766,druid,feral,12,8,4
Thielyy,blackmoore,766,druid,feral,18,8,10
Annksunamun,ysondre,766,druid,feral,24,8,16
Dracaan,boulderfist,765,druid,feral,12,8,4
Krvopito,tarren-mill,765,druid,feral,12,8,4
Koshde,blackrock,765,druid,feral,18,8,10
Chunkeykill,alonsus,765,druid,feral,18,8,10
Plankface,ravencrest,765,druid,feral,18,8,10
Шадараф,howling-fjord,765,druid,feral,21,9,12
Vorag,dalaran,765,druid,feral,24,8,16
Oblivark,draenor,764,druid,feral,18,8,10
Bâlou,nathrezim,764,druid,feral,18,8,10
Lukass,drakthul,764,druid,feral,18,8,10
Djsnigel,stormscale,764,druid,feral,24,8,16
Levila,defias-brotherhood,763,druid,feral,12,8,4
Shuffey,frostmane,763,druid,feral,12,8,4
Dash,the-maelstrom,763,druid,feral,18,8,10
Düldül,kargath,762,druid,feral,85,33,52
Holditorsken,grim-batol,761,druid,feral,18,8,10
Razorleaf,turalyon,761,druid,feral,24,8,16
Tombenuit,tarren-mill,757,druid,feral,18,8,10
Druidou,kaelthas,756,druid,feral,30,8,22
Jupter,burning-blade,755,druid,feral,18,8,10
Khai,argent-dawn,748,druid,feral,24,8,16
Neischa,das-konsortium,746,druid,feral,18,8,10
Âltashamane,elune,733,druid,feral,17,8,9
Ytzù,archimonde,719,druid,feral,11,8,3
Aègon,ravencrest,719,druid,feral,15,8,7
Cyriaan,eredar,719,druid,feral,17,8,9
Greenfingerz,azjolnerub,712,druid,feral,30,8,22
Zaibiendormi,kirin-tor,706,druid,feral,25,8,17
Euskal,chogall,703,druid,feral,14,8,6
Asarune,hyjal,703,druid,feral,20,9,11
Xarxius,sanguino,699,druid,feral,32,8,24
Necorine,silvermoon,672,druid,feral,12,7,5
Lolhaha,ravencrest,672,druid,feral,12,7,5
Симбиозный,howling-fjord,672,druid,feral,12,7,5
Диздру,howling-fjord,672,druid,feral,12,7,5
Cruelbunny,nemesis,672,druid,feral,12,7,5
Jincksdruid,anachronos,672,druid,feral,12,7,5
Snkyferalmov,aegwynn,672,druid,feral,12,7,5
Goretterog,archimonde,672,druid,feral,12,7,5
Fíja,blackmoore,672,druid,feral,12,7,5
Zoobidu,garona,672,druid,feral,12,7,5
Tanmax,blackmoore,672,druid,feral,12,7,5
Moderntalkin,aegwynn,672,druid,feral,23,10,13
Luveena,kazzak,672,druid,feral,18,7,11
Oni,kelthuzad,672,druid,feral,18,7,11
Flawkin,kazzak,672,druid,feral,18,7,11
Coldkíng,twisting-nether,672,druid,feral,18,7,11
Bearmeister,kazzak,672,druid,feral,18,7,11
Samian,turalyon,672,druid,feral,18,7,11
Saabeq,hyjal,672,druid,feral,18,7,11
Колайна,gordunni,672,druid,feral,18,7,11
Marshy,kazzak,672,druid,feral,20,7,13
Liptonbite,blackhand,672,druid,feral,24,7,17
Zulucat,aegwynn,672,druid,feral,24,7,17
Sôalôgel,blackrock,671,druid,feral,12,7,5
Druikraut,silvermoon,671,druid,feral,12,7,5
Déme,twisting-nether,671,druid,feral,12,7,5
Мехнакиске,howling-fjord,671,druid,feral,16,7,9
Sheradel,argent-dawn,671,druid,feral,18,7,11
Eltroncazo,sanguino,671,druid,feral,18,7,11
Miracoplixx,blackrock,671,druid,feral,18,7,11
Toron,dalaran,671,druid,feral,18,7,11
Speedlebee,malganis,671,druid,feral,18,7,11
Bærbell,blackrock,671,druid,feral,18,7,11
Lazerbinks,blackmoore,671,druid,feral,24,7,17
Axiu,kazzak,671,druid,feral,24,7,17
Noobbiiee,silvermoon,670,druid,feral,12,7,5
Biorythm,draenor,670,druid,feral,12,7,5
Toredorxy,blackrock,669,druid,feral,12,7,5
Radime,khaz-modan,669,druid,feral,12,7,5
Iloveadriana,kiljaeden,669,druid,feral,18,7,11
Терамин,howling-fjord,669,druid,feral,18,7,11
Stoormrage,deathwing,668,druid,feral,12,7,5
Itzferal,durotan,668,druid,feral,15,7,8
Грэкхэк,soulflayer,666,druid,feral,15,8,7
Tricklou,tarren-mill,666,druid,feral,18,7,11
Sherkàn,dalaran,661,druid,feral,18,7,11
Zulazain,bladefist,659,druid,feral,86,31,55
Blejkv,defias-brotherhood,658,druid,feral,18,7,11
Ôpium,eldrethalas,658,druid,feral,24,7,17
Kovlian,argent-dawn,655,druid,feral,17,7,10
Эвгедент,deathguard,646,druid,feral,30,7,23
Drujdjel,die-todeskrallen,641,druid,feral,17,7,10
Dooferdudu,azshara,640,druid,feral,21,7,14
Nspirit,ravencrest,639,druid,feral,17,7,10
Sìa,frostmane,639,druid,feral,23,7,16
Juraci,forscherliga,623,druid,feral,11,7,4
Лорирэнд,gordunni,623,druid,feral,23,7,16
Shalys,archimonde,622,druid,feral,11,7,4
Хённим,howling-fjord,607,druid,feral,11,7,4
Àyóorts,archimonde,607,druid,feral,14,7,7
Halabanaha,silvermoon,606,druid,feral,11,7,4
Hadoukan,ravencrest,576,druid,feral,6,6,0
Darkcon,silvermoon,576,druid,feral,6,6,0
Hàlunkè,eredar,576,druid,feral,12,6,6
Эриэс,gordunni,576,druid,feral,12,6,6
Kittý,terokkar,576,druid,feral,12,6,6
Biggestnick,ravencrest,576,druid,feral,12,6,6
Amandial,silvermoon,576,druid,feral,12,6,6
Druiderex,outland,576,druid,feral,12,6,6
Seekx,silvermoon,576,druid,feral,12,6,6
Madeath,stormscale,576,druid,feral,12,6,6
Forrest,bronze-dragonflight,576,druid,feral,12,6,6
Borja,malganis,576,druid,feral,12,6,6
Dragonferal,tarren-mill,576,druid,feral,12,6,6
Aslanah,hyjal,576,druid,feral,12,6,6
Rimpularaisa,grim-batol,576,druid,feral,12,6,6
Arlandia,drakthul,576,druid,feral,12,6,6
Сиэн,ashenvale,576,druid,feral,12,6,6
Snkyexpress,aegwynn,576,druid,feral,12,6,6
Migalo,outland,576,druid,feral,12,6,6
Ataxyhehe,sylvanas,576,druid,feral,12,6,6
Asoli,aegwynn,576,druid,feral,12,6,6
Мцк,deathguard,576,druid,feral,12,6,6
Imbadxx,kazzak,576,druid,feral,12,6,6
Mikecat,aegwynn,576,druid,feral,12,6,6
Шйшка,gordunni,576,druid,feral,12,6,6
Tonycatmeow,ravencrest,576,druid,feral,12,6,6
Baccthana,auchindoun,576,druid,feral,12,6,6
Sumecx,aegwynn,576,druid,feral,12,6,6
Imsothorny,genjuros,576,druid,feral,18,6,12
Bilis,nazjatar,576,druid,feral,18,6,12
Хокан,deepholm,576,druid,feral,18,6,12
Hasted,kazzak,576,druid,feral,18,6,12
Niknikola,silvermoon,576,druid,feral,18,6,12
Svass,ragnaros,576,druid,feral,18,6,12
Radauronny,malganis,576,druid,feral,18,6,12
Fur,antonidas,576,druid,feral,23,6,17
Трясишатай,gordunni,576,druid,feral,24,6,18
Teknó,ragnaros,575,druid,feral,6,6,0
Леромейкен,fordragon,575,druid,feral,12,6,6
Broccoliform,eredar,575,druid,feral,12,6,6
Leidbulle,blackrock,575,druid,feral,12,6,6
Psixx,blackhand,575,druid,feral,12,6,6
Xurta,kazzak,575,druid,feral,12,6,6
Lakaport,dun-modr,575,druid,feral,12,6,6
Chrîslol,twisting-nether,575,druid,feral,18,6,12
Скайтибрайдх,gordunni,575,druid,feral,24,6,18
Docdruid,outland,575,druid,feral,24,6,18
Мендея,gordunni,574,druid,feral,12,6,6
Kratzbeiß,blackmoore,574,druid,feral,24,6,18
Almightydudu,draenor,573,druid,feral,18,6,12
Alimona,the-venture-co,573,druid,feral,30,6,24
Taco,eredar,573,druid,feral,33,6,27
Harryharrt,veknilash,572,druid,feral,12,6,6
Avior,eonar,571,druid,feral,12,6,6
Грегориан,galakrond,571,druid,feral,12,6,6
Annajak,bloodfeather,570,druid,feral,12,6,6
Элинна,ashenvale,570,druid,feral,18,6,12
Горртек,howling-fjord,569,druid,feral,18,6,12
Sìíta,dun-modr,568,druid,feral,24,6,18
Glanis,malorne,558,druid,feral,17,6,11
Whiterun,pozzo-delleternità,555,druid,feral,19,7,12
Spangle,stormscale,554,druid,feral,21,7,14
Agè,stormscale,544,druid,feral,16,6,10
Shapeshifts,kul-tiras,543,druid,feral,11,6,5
Неваляка,gordunni,542,druid,feral,11,6,5
Диджейкошка,howling-fjord,527,druid,feral,11,6,5
Nuashoa,argent-dawn,521,druid,feral,16,7,9
Lionquokk,azjolnerub,512,druid,feral,10,6,4
Amuini,draenor,511,druid,feral,14,6,8
Ryselol,nemesis,480,druid,feral,6,5,1
Slaaya,ravencrest,480,druid,feral,6,5,1
Shanikya,argent-dawn,480,druid,feral,6,5,1
Drach,ravencrest,480,druid,feral,6,5,1
Vârima,ravencrest,480,druid,feral,6,5,1
Synzuu,turalyon,480,druid,feral,10,6,4
Xunjeral,blackhand,480,druid,feral,12,7,5
Einsfünfkcat,madmortem,480,druid,feral,12,5,7
Sketz,stormscale,480,druid,feral,12,5,7
Iproxy,dalaran,480,druid,feral,12,5,7
Rímeru,blackmoore,480,druid,feral,12,5,7
Deßradator,stormscale,480,druid,feral,12,5,7
Siire,ravencrest,480,druid,feral,12,5,7
Loryaayroll,stormscale,480,druid,feral,12,5,7
Hrabioid,burning-legion,480,druid,feral,12,5,7
Redlung,outland,480,druid,feral,12,5,7
Rapzr,argent-dawn,480,druid,feral,12,5,7
Жеводанский,gordunni,480,druid,feral,12,5,7
Bloomly,tarren-mill,480,druid,feral,12,5,7
Hipølita,zuljin,480,druid,feral,12,5,7
Flum,darksorrow,480,druid,feral,12,5,7
Guiltyas,turalyon,480,druid,feral,12,5,7
Оссава,blackscar,480,druid,feral,12,5,7
Hardbasior,burning-legion,480,druid,feral,12,5,7
Pronkson,tarren-mill,480,druid,feral,12,5,7
West,drakthul,480,druid,feral,12,5,7
Vãrima,ravencrest,480,druid,feral,12,5,7
Erenalby,draenor,480,druid,feral,12,5,7
Animålz,archimonde,480,druid,feral,12,5,7
Epidruid,stormrage,480,druid,feral,12,5,7
Falbâlas,hyjal,480,druid,feral,12,5,7
Mooqt,alexstrasza,480,druid,feral,12,5,7
Kardashìan,ravencrest,480,druid,feral,13,5,8
Nariah,silvermoon,480,druid,feral,15,5,10
Mérias,archimonde,480,druid,feral,18,5,13
Линнер,lich-king,480,druid,feral,18,5,13
Enylasi,hyjal,480,druid,feral,18,5,13
Outtanowhere,drakthul,480,druid,feral,18,5,13
Nefertiti,baelgun,480,druid,feral,18,5,13
Derrezzed,stormscale,480,druid,feral,18,5,13
Yamkar,blackrock,480,druid,feral,18,5,13
Tskilli,draenor,480,druid,feral,18,5,13
Yiradur,stormscale,480,druid,feral,18,5,13
Wølveríne,frostmane,480,druid,feral,18,5,13
Pethebär,tarren-mill,480,druid,feral,18,5,13
Cdsxr,outland,480,druid,feral,24,5,19
Morsee,hellfire,479,druid,feral,12,5,7
Poskehh,outland,479,druid,feral,12,5,7
Shifts,the-maelstrom,479,druid,feral,12,5,7
Astlanes,ysondre,479,druid,feral,12,5,7
Telpha,onyxia,479,druid,feral,12,5,7
Mambalol,sanguino,479,druid,feral,12,5,7
Dorcelvision,archimonde,479,druid,feral,12,5,7
Менстряк,howling-fjord,479,druid,feral,18,5,13
Фэк,eversong,479,druid,feral,18,5,13
Plandros,draenor,479,druid,feral,24,5,19
Yorashi,blackhand,478,druid,feral,6,5,1
Эндердру,gordunni,478,druid,feral,12,5,7
Jooriell,defias-brotherhood,477,druid,feral,6,5,1
Cattastrophe,bronzebeard,477,druid,feral,12,5,7
Mitomen,ragnaros,476,druid,feral,12,5,7
Skylarr,alexstrasza,475,druid,feral,12,5,7
Bumsbert,teldrassil,472,druid,feral,18,9,9
Cosiris,elune,469,druid,feral,18,5,13
Varø,aegwynn,463,druid,feral,11,5,6
Jamera,stormscale,463,druid,feral,17,5,12
Nuada,skullcrusher,462,druid,feral,11,5,6
Nefariz,dun-modr,448,druid,feral,10,5,5
Apetino,dun-modr,447,druid,feral,11,5,6
Infêrno,twisting-nether,446,druid,feral,22,5,17
Овналь,gordunni,431,druid,feral,11,5,6
Sároman,ravencrest,431,druid,feral,11,5,6
Гимодера,gordunni,431,druid,feral,11,5,6
Zynmeow,lordaeron,416,druid,feral,19,6,13
Бабакошка,gordunni,415,druid,feral,11,5,6
Nipply,ravencrest,415,druid,feral,15,6,9
Svarre,outland,413,druid,feral,10,5,5
Staness,khaz-modan,413,druid,feral,32,5,27
Furiol,darksorrow,384,druid,feral,6,4,2
Коксвейн,ashenvale,384,druid,feral,6,4,2
Gyome,sargeras,384,druid,feral,6,4,2
Крофтт,goldrinn,384,druid,feral,6,4,2
Шабашиоргия,soulflayer,384,druid,feral,6,4,2
Faveyo,die-nachtwache,384,druid,feral,6,4,2
Chpochm,stormscale,384,druid,feral,6,4,2
Nøwørnever,ulduar,384,druid,feral,6,4,2
Idraly,kirin-tor,384,druid,feral,6,4,2
Noxxzar,stormscale,384,druid,feral,6,4,2
Ryáanz,ravencrest,384,druid,feral,6,4,2
Takamizy,ysondre,384,druid,feral,6,4,2
Kkriss,stormscale,384,druid,feral,6,4,2
Ábomínatíon,draenor,384,druid,feral,6,4,2
Osaviciosa,shendralar,384,druid,feral,6,4,2
Tróllinger,blackrock,384,druid,feral,6,4,2
Improved,hyjal,384,druid,feral,6,4,2
Aliyxo,aegwynn,384,druid,feral,6,4,2
Knatch,outland,384,druid,feral,6,4,2
Dystaleon,blackrock,384,druid,feral,6,4,2
Currare,aegwynn,384,druid,feral,6,4,2
Pegert,aegwynn,384,druid,feral,6,4,2
Kowtuerz,silvermoon,384,druid,feral,6,4,2
Akifumi,archimonde,384,druid,feral,6,4,2
Righttwix,blackrock,384,druid,feral,6,4,2
Dèxò,blackmoore,384,druid,feral,17,7,10
Goatmeal,draenor,384,druid,feral,12,4,8
Helltoothz,ragnaros,384,druid,feral,12,4,8
Tropicqt,ravencrest,384,druid,feral,12,4,8
Giaya,turalyon,384,druid,feral,12,4,8
Ociroza,outland,384,druid,feral,12,4,8
Shiotake,hyjal,384,druid,feral,12,4,8
Deranion,drakthul,384,druid,feral,12,4,8
ßlackßåmßå,zuljin,384,druid,feral,12,4,8
Турбокалясик,gordunni,384,druid,feral,12,4,8
Tenader,draenor,384,druid,feral,12,4,8
Рэво,gordunni,384,druid,feral,12,4,8
Derni,burning-legion,384,druid,feral,12,4,8
Vitaex,blackrock,384,druid,feral,12,4,8
Milkniatrump,tarren-mill,384,druid,feral,12,4,8
Noxxll,gorgonnash,384,druid,feral,12,4,8
Valkeryu,hyjal,384,druid,feral,12,4,8
Skinnyleg,baelgun,384,druid,feral,12,4,8
Ялория,azuregos,384,druid,feral,12,4,8
Éxy,kazzak,384,druid,feral,12,4,8
Nibbl,doomhammer,384,druid,feral,12,4,8
Risibisi,blackmoore,384,druid,feral,12,4,8
Фдру,eversong,384,druid,feral,12,4,8
Алендор,deathguard,384,druid,feral,12,4,8
Gruffeline,marécage-de-zangar,384,druid,feral,12,4,8
Mbk,kazzak,384,druid,feral,12,4,8
Lupa,drakthul,384,druid,feral,18,4,14
Bullhoezerx,silvermoon,384,druid,feral,18,4,14
Nidaalee,thrall,383,druid,feral,6,4,2
Bearshift,aggra-português,383,druid,feral,6,4,2
Tsukuyómi,ragnaros,383,druid,feral,6,4,2
Afta,ysondre,383,druid,feral,6,4,2
Hartzig,blackmoore,383,druid,feral,6,4,2
Asterya,dun-modr,383,druid,feral,10,5,5
Murraywolf,dun-modr,383,druid,feral,12,4,8
Loafy,the-maelstrom,383,druid,feral,12,4,8
Whizkazz,ravencrest,383,druid,feral,12,4,8
Fòggie,silvermoon,383,druid,feral,12,4,8
Tettsu,silvermoon,383,druid,feral,12,4,8
Sheiheda,kazzak,383,druid,feral,18,4,14
Vanarea,argent-dawn,383,druid,feral,18,4,14
Altramuz,uldum,382,druid,feral,6,4,2
Fiagard,antonidas,382,druid,feral,6,4,2
Jamaicanherb,bronzebeard,382,druid,feral,12,4,8
Hasdruida,zuljin,382,druid,feral,14,4,10
Viølin,silvermoon,381,druid,feral,12,4,8
Yopi,stormscale,351,druid,feral,11,4,7
Nèxtløls,twisting-nether,336,druid,feral,9,5,4
Fyralion,silvermoon,335,druid,feral,9,4,5
Krekigaadzre,draenor,335,druid,feral,9,4,5
Dawodz,archimonde,330,druid,feral,8,5,3
Wintx,ragnaros,329,druid,feral,24,7,17
Rixdudu,silvermoon,319,druid,feral,5,4,1
Lybell,antonidas,319,druid,feral,8,4,4
Амахасла,deathweaver,288,druid,feral,6,3,3
Beckett,aszune,288,druid,feral,6,3,3
Fraptal,dalaran,288,druid,feral,6,3,3
Melondru,dun-modr,288,druid,feral,6,3,3
Ferpylul,ragnaros,288,druid,feral,6,3,3
Syniixmeow,ravencrest,288,druid,feral,6,3,3
Жексоул,gordunni,288,druid,feral,6,3,3
Millya,sargeras,288,druid,feral,6,3,3
Xercàs,outland,288,druid,feral,6,3,3
Kømo,draenor,288,druid,feral,6,3,3
Kúùsh,frostwolf,288,druid,feral,6,3,3
Wildthing,blackmoore,288,druid,feral,6,3,3
Quentalius,argent-dawn,288,druid,feral,6,3,3
Madgazfanboi,ravencrest,288,druid,feral,6,3,3
Ðeathwatch,ravencrest,288,druid,feral,6,3,3
Oddform,silvermoon,288,druid,feral,6,3,3
Gargnda,tarren-mill,288,druid,feral,6,3,3
Kørn,drakthul,288,druid,feral,6,3,3
Кошикк,azuregos,288,druid,feral,6,3,3
Павлорион,gordunni,288,druid,feral,6,3,3
Fearthecat,defias-brotherhood,288,druid,feral,6,3,3
Lyrasanna,argent-dawn,288,druid,feral,6,3,3
Мивинчик,ashenvale,288,druid,feral,6,3,3
Sylvy,dun-modr,288,druid,feral,6,3,3
Zusaria,azshara,288,druid,feral,6,3,3
Urgrull,baelgun,288,druid,feral,6,3,3
Lunanikuya,ravencrest,288,druid,feral,6,3,3
Hundavidsad,quelthalas,288,druid,feral,6,3,3
Mäffu,silvermoon,288,druid,feral,6,3,3
Ацкийдру,gordunni,288,druid,feral,6,3,3
Cacatus,tarren-mill,288,druid,feral,6,3,3
Reservebär,blackhand,288,druid,feral,6,3,3
Snky,perenolde,288,druid,feral,6,3,3
Payday,darksorrow,288,druid,feral,6,3,3
Alkurosa,sylvanas,288,druid,feral,6,3,3
Shirí,hyjal,288,druid,feral,6,3,3
Miruush,malganis,288,druid,feral,6,3,3
Liony,aegwynn,288,druid,feral,6,3,3
Yepnesse,khaz-modan,288,druid,feral,6,3,3
Theonlydruid,frostmane,288,druid,feral,6,3,3
Druidicchi,stormscale,288,druid,feral,6,3,3
Dianabigby,silvermoon,288,druid,feral,6,3,3
Feign,blackmoore,288,druid,feral,6,3,3
Muffler,ragnaros,288,druid,feral,6,3,3
Ysomnia,tirion,288,druid,feral,6,3,3
Zantill,chamber-of-aspects,288,druid,feral,7,3,4
Shingeki,alonsus,288,druid,feral,8,3,5
Bénjî,khazgoroth,288,druid,feral,12,3,9
Catbear,kazzak,288,druid,feral,12,3,9
Оленяпеченя,gordunni,288,druid,feral,12,3,9
Azyol,argent-dawn,288,druid,feral,12,3,9
Murzzilka,kazzak,288,druid,feral,12,3,9
Ripern,silvermoon,288,druid,feral,12,3,9
Ferdax,outland,288,druid,feral,12,3,9
Elocat,blackmoore,288,druid,feral,12,3,9
Myex,exodar,288,druid,feral,12,3,9
Phòènìx,twisting-nether,288,druid,feral,12,3,9
Ashamane,outland,288,druid,feral,12,3,9
Лорья,azuregos,288,druid,feral,12,3,9
Skywíng,stormscale,288,druid,feral,12,3,9
Шокшо,soulflayer,288,druid,feral,12,3,9
Kittyclâw,perenolde,288,druid,feral,12,3,9
Diow,elune,288,druid,feral,12,3,9
Drocos,genjuros,288,druid,feral,12,3,9
Zink,sanguino,288,druid,feral,12,3,9
Senoka,shattrath,288,druid,feral,12,3,9
Knææl,argent-dawn,288,druid,feral,18,3,15
Frincessa,burning-legion,288,druid,feral,18,3,15
Tallbutshort,stormscale,288,druid,feral,18,3,15
Cemendur,bronzebeard,287,druid,feral,6,3,3
Giosis,stormscale,287,druid,feral,6,3,3
Growshax,nerzhul,287,druid,feral,6,3,3
Huginmuninn,outland,287,druid,feral,6,3,3
Vicendius,drakthul,287,druid,feral,12,3,9
Kyth,forscherliga,287,druid,feral,12,3,9
Vólotyr,ravencrest,287,druid,feral,12,3,9
Poxu,eredar,287,druid,feral,18,3,15
Papírzsepi,ragnaros,287,druid,feral,18,3,15
Bakar,ghostlands,286,druid,feral,6,3,3
Puuhalí,stormreaver,286,druid,feral,6,3,3
Zottelmahne,blackrock,286,druid,feral,6,3,3
Dildor,ysondre,286,druid,feral,6,3,3
Mãui,blackhand,286,druid,feral,15,4,11
Bearmantlé,outland,256,druid,feral,10,3,7
Creadora,ravencrest,255,druid,feral,11,3,8
Muryo,der-rat-von-dalaran,255,druid,feral,11,3,8
Bartax,culte-de-la-rive-noire,240,druid,feral,9,3,6
Persefal,garona,239,druid,feral,5,3,2
Diktus,outland,234,druid,feral,8,4,4
Anyône,dun-morogh,229,druid,feral,16,4,12
Tommyferal,outland,192,druid,feral,4,3,1
Mapitom,stormscale,192,druid,feral,4,3,1
Bïscøte,archimonde,192,druid,feral,6,2,4
Rabatout,eitrigg,192,druid,feral,6,2,4
Seekíng,blackmoore,192,druid,feral,6,2,4
Zouzouille,ravencrest,192,druid,feral,6,2,4
Rabacki,blackmoore,192,druid,feral,6,2,4
Spale,twisting-nether,192,druid,feral,6,2,4
Likë,frostwolf,192,druid,feral,6,2,4
Catwild,blackmoore,192,druid,feral,6,2,4
Growlithe,hellfire,192,druid,feral,6,2,4
Leafceld,aggra-português,192,druid,feral,6,2,4
Tøpkittyg,twisting-nether,192,druid,feral,6,2,4
Jokiri,argent-dawn,192,druid,feral,6,2,4
Lyvaley,dun-modr,192,druid,feral,6,2,4
Getsomefunny,archimonde,192,druid,feral,6,2,4
Kig,ragnaros,192,druid,feral,6,2,4
Shyasiandru,area-52,192,druid,feral,6,2,4
Pitsas,silvermoon,192,druid,feral,6,2,4
Savagehèals,ravencrest,192,druid,feral,6,2,4
Bóssít,doomhammer,192,druid,feral,6,2,4
Shiningztar,twisting-nether,192,druid,feral,6,2,4
Citrus,sargeras,192,druid,feral,6,2,4
Sàngha,frostwolf,192,druid,feral,6,2,4
Атиса,gordunni,192,druid,feral,6,2,4
Snuggums,argent-dawn,192,druid,feral,6,2,4
Mcservietsky,chogall,192,druid,feral,6,2,4
Kisskossa,stormscale,192,druid,feral,6,2,4
Glyn,earthen-ring,192,druid,feral,6,2,4
Filiduttkatt,ravencrest,192,druid,feral,6,2,4
Nidra,silvermoon,192,druid,feral,6,2,4
Yeats,blackmoore,192,druid,feral,6,2,4
Nelfboyuk,tarren-mill,192,druid,feral,6,2,4
Womzas,blackhand,192,druid,feral,6,2,4
Glenn,alakir,192,druid,feral,6,2,4
Вендьета,blackscar,192,druid,feral,6,2,4
Erundrood,ysondre,192,druid,feral,6,2,4
Zyron,sanguino,192,druid,feral,6,2,4
Druipa,sylvanas,192,druid,feral,6,2,4
Mjáy,tarren-mill,192,druid,feral,6,2,4
Melcow,eredar,192,druid,feral,6,2,4
Papjin,blackhand,192,druid,feral,6,2,4
Вохако,howling-fjord,192,druid,feral,6,2,4
Treepoloski,stormscale,192,druid,feral,6,2,4
Leylajr,ravencrest,192,druid,feral,6,2,4
Kiizal,twisting-nether,192,druid,feral,6,2,4
Narawenn,ysondre,192,druid,feral,6,2,4
Túskér,stormscale,192,druid,feral,6,2,4
Агнотар,soulflayer,192,druid,feral,6,2,4
Lilkâzzam,blackrock,192,druid,feral,6,2,4
Bigbear,stormrage,192,druid,feral,6,2,4
Casiu,blackmoore,192,druid,feral,6,2,4
Voyerka,drakthul,192,druid,feral,6,2,4
Indräkah,dun-modr,192,druid,feral,6,2,4
Сверххищникк,soulflayer,192,druid,feral,6,2,4
Cemiink,drakthul,192,druid,feral,6,2,4
Friidaf,lightbringer,192,druid,feral,6,2,4
Aryitu,blackrock,192,druid,feral,6,2,4
Swagdemonxd,outland,192,druid,feral,6,2,4
Dwaokut,ravencrest,192,druid,feral,6,2,4
Szondykhan,ragnaros,192,druid,feral,6,2,4
Druiddamage,the-maelstrom,192,druid,feral,6,2,4
Chikiz,ghostlands,192,druid,feral,6,2,4
Redyogurt,outland,192,druid,feral,6,2,4
Smat,thunderhorn,192,druid,feral,6,2,4
Variolus,dun-modr,192,druid,feral,6,2,4
Feralsaber,ghostlands,192,druid,feral,6,2,4
Comodruid,nemesis,192,druid,feral,6,2,4
Кентухен,gordunni,192,druid,feral,6,2,4
Santamonica,blackrock,192,druid,feral,6,2,4
Snûx,antonidas,192,druid,feral,6,2,4
Nicodruid,ravencrest,192,druid,feral,6,2,4
Zibark,nemesis,192,druid,feral,6,2,4
Beginníng,outland,192,druid,feral,6,2,4
Pöttli,blackhand,192,druid,feral,6,2,4
Routasydän,shattered-hand,192,druid,feral,6,2,4
Sandirion,silvermoon,192,druid,feral,6,2,4
Ringthaw,silvermoon,192,druid,feral,6,2,4
Impertinent,outland,192,druid,feral,6,2,4
Jimmyxdd,kazzak,192,druid,feral,6,2,4
Lechaource,silvermoon,192,druid,feral,6,2,4
Píshi,silvermoon,192,druid,feral,6,2,4
Metamø,blackrock,192,druid,feral,6,2,4
Frunze,sylvanas,192,druid,feral,9,2,7
Spidete,sanguino,192,druid,feral,9,2,7
Aaune,argent-dawn,192,druid,feral,12,2,10
Nicotex,draenor,192,druid,feral,12,2,10
Adawehi,ravencrest,192,druid,feral,12,2,10
Naturexbot,silvermoon,192,druid,feral,12,2,10
Erelieva,silvermoon,192,druid,feral,12,2,10
Kuw,archimonde,192,druid,feral,12,2,10
Amoveo,argent-dawn,192,druid,feral,12,2,10
Yoshia,shadowsong,192,druid,feral,12,2,10
Твойбарсик,gordunni,192,druid,feral,12,2,10
Rasgath,kazzak,192,druid,feral,12,2,10
Ellaria,burning-legion,192,druid,feral,12,2,10
Astøriøn,elune,192,druid,feral,12,2,10
Steakotaur,chamber-of-aspects,192,druid,feral,12,2,10
Affines,the-maelstrom,192,druid,feral,12,2,10
Trànsformer,nemesis,192,druid,feral,12,2,10
Инфернох,gordunni,192,druid,feral,12,2,10
Speegle,kazzak,192,druid,feral,12,2,10
Feralzeus,sylvanas,192,druid,feral,12,2,10
Teám,tarren-mill,192,druid,feral,18,2,16
Tigerroll,kazzak,192,druid,feral,18,2,16
Gachal,kazzak,192,druid,feral,18,2,16
Sellsarya,blackmoore,191,druid,feral,6,2,4
Muju,stormscale,191,druid,feral,6,2,4
Jompemanfish,stormscale,191,druid,feral,6,2,4
Nayato,draenor,191,druid,feral,12,2,10
Loriann,twisting-nether,191,druid,feral,18,2,16
Meuhtéki,hyjal,190,druid,feral,13,3,10
Avisa,blackhand,190,druid,feral,12,2,10
Shadøwdruid,silvermoon,190,druid,feral,18,2,16
Wolfly,ravencrest,179,druid,feral,21,7,14
Ilyethea,earthen-ring,175,druid,feral,11,2,9
Hiloqtdruid,blackmoore,159,druid,feral,5,2,3
Korkskruven,draenor,159,druid,feral,5,2,3
Совулька,howling-fjord,159,druid,feral,5,2,3
Bearfôrceône,blackrock,159,druid,feral,11,2,9
Grawlex,silvermoon,159,druid,feral,11,2,9
Найадра,gordunni,144,druid,feral,9,2,7
Несессари,howling-fjord,144,druid,feral,15,2,13
Azaría,aegwynn,128,druid,feral,4,2,2
Baniaucygana,draenor,127,druid,feral,4,2,2
Wurnas,silvermoon,121,druid,feral,15,3,12
Epikeks,blackmoore,96,druid,feral,4,2,2
Skyreapa,burning-legion,96,druid,feral,9,2,7
Råbi,ravencrest,96,druid,feral,9,2,7
Xenrakh,blackhand,96,druid,feral,6,1,5
Hccl,blackhand,96,druid,feral,6,1,5
Hecone,los-errantes,96,druid,feral,6,1,5
Tartáros,blackrock,96,druid,feral,6,1,5
Абапер,galakrond,96,druid,feral,6,1,5
Markuslanz,blackrock,96,druid,feral,6,1,5
Yarrp,stormscale,96,druid,feral,6,1,5
Kattig,grim-batol,96,druid,feral,6,1,5
Herbstkind,frostmourne,96,druid,feral,6,1,5
Dawgydawg,emerald-dream,96,druid,feral,6,1,5
Ragnai,emerald-dream,96,druid,feral,6,1,5
Legyna,ravencrest,96,druid,feral,6,1,5
Snorlaxza,ravencrest,96,druid,feral,6,1,5
Saliencias,kazzak,96,druid,feral,6,1,5
Seraxi,der-mithrilorden,96,druid,feral,6,1,5
Солнцеедка,gordunni,96,druid,feral,6,1,5
Cegorach,xavius,96,druid,feral,6,1,5
Rszn,ravencrest,96,druid,feral,6,1,5
Бьеорн,gordunni,96,druid,feral,6,1,5
Папакамбэк,grom,96,druid,feral,6,1,5
Sodniss,aggra-português,96,druid,feral,6,1,5
Catgirlx,ravencrest,96,druid,feral,6,1,5
Hârâohshît,blackmoore,96,druid,feral,6,1,5
Спудич,eversong,96,druid,feral,6,1,5
Albinoape,doomhammer,96,druid,feral,6,1,5
Awán,aegwynn,96,druid,feral,6,1,5
Ayatola,conseil-des-ombres,96,druid,feral,6,1,5
Zðe,la-croisade-écarlate,96,druid,feral,6,1,5
Laaide,blackmoore,96,druid,feral,6,1,5
Venomjr,bloodhoof,96,druid,feral,6,1,5
Hyza,bronzebeard,96,druid,feral,6,1,5
Taurendruid,the-maelstrom,96,druid,feral,6,1,5
Horkz,frostmourne,96,druid,feral,6,1,5
Thaneo,blackmoore,96,druid,feral,6,1,5
Spoco,defias-brotherhood,96,druid,feral,6,1,5
Пивч,soulflayer,96,druid,feral,6,1,5
Vaalya,hyjal,96,druid,feral,6,1,5
Aahboom,draenor,96,druid,feral,6,1,5
Nytaleas,naxxramas,96,druid,feral,6,1,5
Hefdgaharald,antonidas,96,druid,feral,6,1,5
Benfufu,kazzak,96,druid,feral,6,1,5
Арбузир,howling-fjord,96,druid,feral,6,1,5
Fabulous,genjuros,96,druid,feral,6,1,5
Tshungubuäch,eredar,96,druid,feral,6,1,5
Feyzode,ysondre,96,druid,feral,6,1,5
Tael,argent-dawn,96,druid,feral,6,1,5
Majesty,nagrand,96,druid,feral,6,1,5
Zinister,hyjal,96,druid,feral,6,1,5
Haragmancs,arathor,96,druid,feral,6,1,5
Ãnimal,argent-dawn,96,druid,feral,6,1,5
Bolhás,defias-brotherhood,96,druid,feral,6,1,5
Jellybra,tarren-mill,96,druid,feral,6,1,5
Strand,ragnaros,96,druid,feral,6,1,5
Nidrien,doomhammer,96,druid,feral,6,1,5
Théodên,dalaran,96,druid,feral,6,1,5
Gurudru,tarren-mill,96,druid,feral,6,1,5
Plàntz,tarren-mill,96,druid,feral,6,1,5
Stjärna,kult-der-verdammten,96,druid,feral,6,1,5
Sabresheep,twisting-nether,96,druid,feral,6,1,5
Heav,kiljaeden,96,druid,feral,6,1,5
Мурталор,soulflayer,96,druid,feral,6,1,5
Cesty,silvermoon,96,druid,feral,6,1,5
Veyronn,burning-legion,96,druid,feral,12,1,11
Mássive,darkmoon-faire,96,druid,feral,12,1,11
Sempai,hyjal,96,druid,feral,12,1,11
Yabooni,ravencrest,96,druid,feral,12,1,11
Mäywen,ravencrest,96,druid,feral,12,1,11
Nakkikastike,magtheridon,96,druid,feral,12,1,11
Treébeárd,draenor,96,druid,feral,12,1,11
Raferalston,nathrezim,96,druid,feral,12,1,11
Farnae,kirin-tor,96,druid,feral,12,1,11
Bidodici,nemesis,95,druid,feral,6,1,5
Allîyâ,archimonde,79,druid,feral,5,1,4
Forigiver,draenor,64,druid,feral,4,1,3
Прокси,gordunni,64,druid,feral,4,1,3
Tamakie,blackmoore,64,druid,feral,4,1,3
Lycal,chogall,63,druid,feral,2,2,0
Cus,tarren-mill,48,druid,feral,3,1,2
Wadles,draenor,48,druid,feral,3,1,2
Maroxd,stormscale,2391,druid,balance,114,78,36
Kaabeedo,ravencrest,2389,druid,balance,114,70,44
Merceý,ravencrest,2323,druid,balance,97,65,32
Immuz,kazzak,2316,druid,balance,166,93,73
Skivesnulle,kazzak,2275,druid,balance,291,152,139
Fuséton,tarren-mill,2269,druid,balance,305,180,125
Wriong,ravencrest,2250,druid,balance,141,87,54
Ackiz,ravencrest,2225,druid,balance,87,53,34
Bd,stormscale,2225,druid,balance,83,49,34
Zødzin,kazzak,2217,druid,balance,126,70,56
Vabore,twisting-nether,2203,druid,balance,108,57,51
Batboomie,zuljin,2198,druid,balance,280,156,124
Thelire,silvermoon,2188,druid,balance,310,164,146
Isatá,ravencrest,2179,druid,balance,72,46,26
Norgand,die-aldor,2173,druid,balance,42,33,9
Flanagân,hyjal,2171,druid,balance,60,36,24
Ööh,outland,2158,druid,balance,138,77,61
Shayia,aegwynn,2156,druid,balance,143,78,65
Shåmss,kazzak,2151,druid,balance,54,35,19
Deép,nazjatar,2149,druid,balance,96,50,46
Dezarden,die-aldor,2147,druid,balance,99,61,38
Sleepyhallow,blackmoore,2143,druid,balance,106,61,45
Стомпбр,gordunni,2141,druid,balance,144,89,55
Eôxxd,blackrock,2135,druid,balance,95,63,32
Agagagagagag,ravencrest,2129,druid,balance,108,59,49
Wwboomy,kazzak,2129,druid,balance,132,65,67
Muhammadali,ravencrest,2126,druid,balance,72,42,30
Mopboomkin,twisting-nether,2122,druid,balance,78,45,33
Jwrld,stormscale,2121,druid,balance,66,35,31
Yore,tichondrius,2120,druid,balance,102,72,30
Rexonadudu,kazzak,2120,druid,balance,165,98,67
Bumkin,bloodhoof,2120,druid,balance,72,41,31
Kirexz,blackrock,2118,druid,balance,83,55,28
Newaccount,kazzak,2117,druid,balance,156,95,61
Feelstreeman,twisting-nether,2115,druid,balance,54,33,21
Rek,sanguino,2114,druid,balance,87,50,37
Эё,howling-fjord,2113,druid,balance,118,78,40
Ursulaboomer,blackrock,2113,druid,balance,96,55,41
Positivîty,stormscale,2111,druid,balance,168,99,69
Winkler,kazzak,2109,druid,balance,50,38,12
Broccoliboy,sylvanas,2107,druid,balance,144,76,68
Handsoff,stormscale,2104,druid,balance,210,112,98
Pikatwo,tyrande,2103,druid,balance,54,41,13
Бубаджек,howling-fjord,2102,druid,balance,48,31,17
Catchmê,archimonde,2099,druid,balance,86,50,36
Mephîs,ravencrest,2081,druid,balance,82,52,30
Tmeister,kazzak,2081,druid,balance,114,65,49
Eviscreator,stormscale,2076,druid,balance,120,76,44
Crippaa,tarren-mill,2071,druid,balance,121,74,47
Bambye,stormscale,2067,druid,balance,158,102,56
Limme,ravencrest,2066,druid,balance,122,81,41
Gonyogonyo,blackmoore,2061,druid,balance,66,38,28
Výragosa,der-rat-von-dalaran,2059,druid,balance,128,73,55
Antahka,archimonde,2057,druid,balance,60,34,26
Oskol,tarren-mill,2057,druid,balance,70,37,33
Shivany,twisting-nether,2052,druid,balance,130,66,64
Méáckós,aegwynn,2050,druid,balance,164,82,82
Celtimi,antonidas,2049,druid,balance,66,49,17
Владисзади,gordunni,2046,druid,balance,125,68,57
Bulla,culte-de-la-rive-noire,2045,druid,balance,213,122,91
Rootzxx,ravencrest,2043,druid,balance,126,72,54
Lifeseed,ravencrest,2040,druid,balance,89,51,38
Nutsnack,tarren-mill,2039,druid,balance,78,38,40
Gulmi,outland,2032,druid,balance,123,71,52
Starsy,frostmane,2032,druid,balance,89,42,47
Høtpøket,ravencrest,2028,druid,balance,54,36,18
Didiee,kazzak,2025,druid,balance,150,85,65
Sadgeconvoke,draenor,2021,druid,balance,316,183,133
Win,hellscream,2018,druid,balance,108,61,47
Рейзакх,howling-fjord,2017,druid,balance,150,80,70
Shakso,stormscale,2016,druid,balance,90,54,36
Saufeb,stormscale,2016,druid,balance,113,65,48
Flanagàn,hyjal,2016,druid,balance,82,41,41
Cmfg,blackrock,2015,druid,balance,104,65,39
Dincks,draenor,2015,druid,balance,89,54,35
Blanoz,ravencrest,2012,druid,balance,84,42,42
Iloveher,ravencrest,2011,druid,balance,48,34,14
Secrägodx,ragnaros,2011,druid,balance,90,54,36
Moodý,aegwynn,2009,druid,balance,76,51,25
Qtkitty,outland,2009,druid,balance,356,195,161
Ôwlnur,kult-der-verdammten,2008,druid,balance,91,50,41
Akinimod,ravencrest,2000,druid,balance,120,69,51
Ganqb,ravencrest,1995,druid,balance,483,264,219
Zaoow,stormscale,1994,druid,balance,114,71,43
Klimakleber,ravencrest,1991,druid,balance,158,78,80
Kruwkamilka,burning-legion,1988,druid,balance,182,100,82
Bittebads,stormscale,1987,druid,balance,54,35,19
Detü,blackrock,1979,druid,balance,89,56,33
Okøë,marécage-de-zangar,1978,druid,balance,54,34,20
Øsbura,silvermoon,1978,druid,balance,72,43,29
Lilpumpz,outland,1978,druid,balance,89,45,44
Disvikz,outland,1971,druid,balance,72,41,31
Rbgkári,draenor,1967,druid,balance,87,56,31
Slaugh,zuljin,1966,druid,balance,101,55,46
Turtleform,blackrock,1961,druid,balance,138,64,74
ßa,blackmoore,1960,druid,balance,59,38,21
Uglyrasputin,blackmoore,1960,druid,balance,156,94,62
Wizzlafa,ravencrest,1960,druid,balance,82,48,34
Wrathgodx,aegwynn,1958,druid,balance,54,33,21
Pvekek,stormscale,1953,druid,balance,74,48,26
Aggroasian,tarren-mill,1952,druid,balance,263,144,119
Даирлин,gordunni,1952,druid,balance,154,77,77
Transmangodx,tarren-mill,1950,druid,balance,78,48,30
Zuterlø,ragnaros,1950,druid,balance,72,38,34
Imperiusx,ravencrest,1944,druid,balance,251,139,112
Néllÿ,elune,1942,druid,balance,108,54,54
Kënzo,ravencrest,1941,druid,balance,121,79,42
Crnkie,sylvanas,1937,druid,balance,66,42,24
Cassiddyy,draenor,1937,druid,balance,78,45,33
Sentería,sylvanas,1937,druid,balance,90,42,48
Tuttu,kazzak,1936,druid,balance,90,50,40
Травкер,howling-fjord,1936,druid,balance,353,179,174
Anpassad,outland,1935,druid,balance,64,37,27
Ciucciotutto,nemesis,1934,druid,balance,66,46,20
Grässoppa,tarren-mill,1933,druid,balance,59,33,26
Muufasa,blackmoore,1931,druid,balance,260,134,126
Siuo,ravencrest,1930,druid,balance,77,43,34
Credenz,frostmane,1929,druid,balance,102,61,41
Laker,stormscale,1929,druid,balance,145,79,66
Maijs,ravencrest,1929,druid,balance,72,35,37
Gambós,kazzak,1927,druid,balance,59,30,29
Kayllie,silvermoon,1926,druid,balance,72,45,27
Veonski,argent-dawn,1925,druid,balance,105,57,48
Björnskift,tarren-mill,1924,druid,balance,66,40,26
Ezeke,eredar,1922,druid,balance,178,91,87
Mooskie,draenor,1921,druid,balance,54,37,17
Fredhqt,tarren-mill,1918,druid,balance,59,37,22
Ледруд,gordunni,1918,druid,balance,74,37,37
Dudukid,nemesis,1915,druid,balance,178,92,86
Hammd,kazzak,1914,druid,balance,161,89,72
Bompfer,blackmoore,1914,druid,balance,60,33,27
Narq,sylvanas,1911,druid,balance,84,51,33
Найттир,gordunni,1910,druid,balance,69,39,30
Flæppy,blackmoore,1910,druid,balance,208,105,103
Millions,tarren-mill,1909,druid,balance,129,82,47
Cioaralba,sylvanas,1909,druid,balance,81,50,31
Вбг,soulflayer,1908,druid,balance,166,90,76
Greenful,drakthul,1907,druid,balance,90,51,39
Trntydr,senjin,1906,druid,balance,41,30,11
Sleepystacy,argent-dawn,1904,druid,balance,60,40,20
Karvajyrä,stormreaver,1904,druid,balance,296,161,135
Afret,kazzak,1902,druid,balance,371,191,180
Kjøttberit,moonglade,1901,druid,balance,42,32,10
Hotflora,aegwynn,1898,druid,balance,36,22,14
Carnivals,twisting-nether,1897,druid,balance,138,74,64
Interaktio,ravencrest,1896,druid,balance,34,24,10
Captaïn,twisting-nether,1896,druid,balance,78,50,28
Æøøm,blackmoore,1896,druid,balance,200,112,88
Zendda,hyjal,1896,druid,balance,61,30,31
Malex,auchindoun,1895,druid,balance,54,32,22
Knùbz,ravencrest,1895,druid,balance,77,40,37
Calê,blackrock,1894,druid,balance,177,104,73
Рябчиик,blackscar,1894,druid,balance,215,119,96
Хальтенис,gordunni,1893,druid,balance,106,57,49
Votionex,tarren-mill,1891,druid,balance,64,38,26
Hunkex,frostmane,1891,druid,balance,93,51,42
Connorz,blackmoore,1890,druid,balance,81,50,31
Hppsr,eredar,1889,druid,balance,72,38,34
Melby,tarren-mill,1888,druid,balance,54,29,25
Punxybear,ravencrest,1887,druid,balance,289,149,140
Boomky,blackmoore,1887,druid,balance,57,29,28
Kenzia,stormrage,1886,druid,balance,72,43,29
Senfkai,kelthuzad,1885,druid,balance,42,35,7
Peaches,aerie-peak,1885,druid,balance,71,48,23
Kankstery,stormscale,1882,druid,balance,65,44,21
Shivany,outland,1880,druid,balance,106,63,43
Blopstar,stormscale,1879,druid,balance,54,34,20
Bmybmybmybmy,outland,1875,druid,balance,30,24,6
Ghostpaws,ravencrest,1874,druid,balance,130,67,63
Øncê,durotan,1871,druid,balance,54,29,25
Tobid,blackrock,1869,druid,balance,48,36,12
Restaidpvs,wildhammer,1868,druid,balance,66,34,32
Hyperbêast,blackrock,1866,druid,balance,41,31,10
Xerlog,thrall,1866,druid,balance,60,39,21
Boomjutzu,kazzak,1866,druid,balance,42,25,17
Rudabaebey,draenor,1863,druid,balance,42,28,14
Låsèrpêwpéw,tarren-mill,1861,druid,balance,96,60,36
Shàal,ysondre,1859,druid,balance,134,73,61
ßoomin,tarren-mill,1859,druid,balance,48,25,23
Trytargetme,outland,1858,druid,balance,72,43,29
Starbro,grim-batol,1856,druid,balance,48,27,21
Emmdru,silvermoon,1854,druid,balance,101,63,38
Starfallkey,dun-modr,1854,druid,balance,111,67,44
Howgh,destromath,1854,druid,balance,192,100,92
Bearpawzz,kazzak,1852,druid,balance,70,41,29
Juicypus,ragnaros,1851,druid,balance,54,32,22
Mdrgtwo,ravencrest,1850,druid,balance,53,36,17
Näela,archimonde,1850,druid,balance,54,27,27
Løsër,ravencrest,1849,druid,balance,44,26,18
Øhmygød,stormscale,1849,druid,balance,66,35,31
Миртлэкшн,gordunni,1848,druid,balance,83,45,38
Tzeeni,stormscale,1847,druid,balance,35,28,7
Mesmerizing,ravencrest,1847,druid,balance,78,43,35
Sænxx,blackrock,1846,druid,balance,42,30,12
Друлякич,gordunni,1846,druid,balance,49,30,19
Nuvemone,stormscale,1846,druid,balance,114,64,50
Snøø,frostwolf,1845,druid,balance,90,51,39
Xora,kazzak,1845,druid,balance,197,106,91
Арадия,gordunni,1843,druid,balance,66,35,31
Gipi,ravencrest,1843,druid,balance,60,31,29
Füllxtrap,hyjal,1841,druid,balance,24,20,4
Ovérheal,ravencrest,1840,druid,balance,51,37,14
Drooshy,ravencrest,1840,druid,balance,51,34,17
Fiskmåsn,twisting-nether,1840,druid,balance,185,103,82
Hrz,kazzak,1839,druid,balance,79,50,29
Memphiswhx,drakthul,1839,druid,balance,96,50,46
Rlwlwlwlwr,twisting-nether,1838,druid,balance,48,33,15
Pluginbaby,stormscale,1838,druid,balance,64,41,23
Ravneskrig,ravencrest,1838,druid,balance,62,38,24
Айрокси,blackscar,1838,druid,balance,48,28,20
Skirr,kelthuzad,1838,druid,balance,42,23,19
Anéry,ravencrest,1837,druid,balance,29,20,9
Tjillevippen,tarren-mill,1836,druid,balance,36,23,13
Nassii,antonidas,1836,druid,balance,162,99,63
Connydor,stormscale,1836,druid,balance,48,29,19
Metamoo,tarren-mill,1835,druid,balance,47,36,11
Atrosity,ravencrest,1835,druid,balance,66,40,26
Nyndrà,archimonde,1835,druid,balance,165,81,84
Vregord,twisting-nether,1834,druid,balance,48,32,16
Mochiløxz,tarren-mill,1834,druid,balance,149,89,60
Sylvy,dun-modr,1834,druid,balance,142,79,63
Tommyruin,the-venture-co,1834,druid,balance,105,57,48
Jøkèr,outland,1833,druid,balance,53,30,23
Кирукхэ,gordunni,1832,druid,balance,36,28,8
Brovis,sylvanas,1832,druid,balance,45,32,13
Bigpûmp,elune,1832,druid,balance,48,30,18
Kÿara,khaz-modan,1832,druid,balance,48,28,20
Tárzáñ,ravencrest,1831,druid,balance,60,37,23
Embrangle,silvermoon,1830,druid,balance,48,30,18
Kabôôm,stormscale,1830,druid,balance,48,28,20
Taurendruid,the-maelstrom,1830,druid,balance,150,84,66
Lóvebeam,ravencrest,1829,druid,balance,42,26,16
Tummus,blackrock,1829,druid,balance,60,32,28
Bastodonte,skullcrusher,1828,druid,balance,190,97,93
Rlwlwlwrtwo,twisting-nether,1828,druid,balance,54,27,27
Triskelion,burning-legion,1827,druid,balance,82,47,35
Eloahdruid,blackhand,1826,druid,balance,63,36,27
Rngmåchinéx,ravencrest,1825,druid,balance,127,83,44
Зетзул,grom,1825,druid,balance,290,155,135
Dizay,xavius,1823,druid,balance,60,40,20
Melyssea,argent-dawn,1823,druid,balance,59,35,24
Qtrly,ravencrest,1823,druid,balance,56,30,26
Faxotium,argent-dawn,1822,druid,balance,30,21,9
Djemdruid,argent-dawn,1822,druid,balance,42,27,15
Kaalil,argent-dawn,1822,druid,balance,72,40,32
Hyac,the-maelstrom,1819,druid,balance,42,29,13
Alxzdru,auchindoun,1819,druid,balance,135,83,52
Izhusky,ravencrest,1819,druid,balance,85,46,39
Sylindra,argent-dawn,1818,druid,balance,106,66,40
Zâe,archimonde,1818,druid,balance,36,21,15
Gurru,xavius,1818,druid,balance,155,78,77
Sunshinex,silvermoon,1818,druid,balance,96,47,49
Quadpulse,ravencrest,1817,druid,balance,42,23,19
Nerem,blackrock,1817,druid,balance,84,44,40
Bákhar,ravencrest,1817,druid,balance,148,71,77
Lunahu,argent-dawn,1816,druid,balance,72,42,30
Kokslina,sylvanas,1816,druid,balance,59,28,31
Astrobazooka,stormreaver,1815,druid,balance,77,48,29
Treesus,blackrock,1815,druid,balance,36,22,14
Neirdá,hyjal,1815,druid,balance,191,104,87
Brucebruce,stormscale,1814,druid,balance,36,21,15
Tallu,das-konsortium,1813,druid,balance,66,41,25
Flanders,blackrock,1811,druid,balance,36,25,11
Bashmac,mugthol,1811,druid,balance,72,49,23
Randomnup,sanguino,1811,druid,balance,48,28,20
Balanc,ragnaros,1811,druid,balance,164,92,72
Яммаккаасии,grom,1811,druid,balance,60,30,30
Owlbum,grim-batol,1810,druid,balance,48,31,17
Veganvapex,draenor,1810,druid,balance,79,48,31
Sartipus,draenor,1810,druid,balance,78,47,31
Artistdubose,kazzak,1809,druid,balance,42,27,15
Superchïcken,archimonde,1809,druid,balance,36,23,13
Núri,lordaeron,1809,druid,balance,80,46,34
Imaginarý,ravencrest,1809,druid,balance,47,26,21
Ccoco,aegwynn,1809,druid,balance,96,49,47
Ferawri,draenor,1808,druid,balance,42,24,18
Scaleo,stormreaver,1808,druid,balance,90,48,42
Citróne,blackrock,1807,druid,balance,24,19,5
Icek,outland,1806,druid,balance,54,33,21
Xalio,ravencrest,1806,druid,balance,65,39,26
Elunælle,les-sentinelles,1806,druid,balance,126,72,54
Gehrkehotter,silvermoon,1805,druid,balance,90,58,32
Otpboomie,dun-modr,1805,druid,balance,37,23,14
Shamerika,tarren-mill,1805,druid,balance,83,50,33
Meowcry,outland,1805,druid,balance,78,45,33
Solariah,garona,1804,druid,balance,143,84,59
Cøntrol,argent-dawn,1804,druid,balance,60,34,26
Starcowx,ragnaros,1804,druid,balance,69,38,31
Ruetinjeri,blackmoore,1804,druid,balance,73,38,35
Rnkx,sanguino,1803,druid,balance,57,33,24
Wrldx,twisting-nether,1802,druid,balance,106,61,45
Justyo,archimonde,1801,druid,balance,69,45,24
Jettad,ravencrest,1801,druid,balance,40,25,15
Geîl,blackrock,1801,druid,balance,42,24,18
Daÿdream,ravencrest,1800,druid,balance,60,39,21
Eselhirte,blackhand,1800,druid,balance,45,27,18
Совёнушек,howling-fjord,1799,druid,balance,59,34,25
Онличикен,gordunni,1797,druid,balance,150,78,72
Abyssaldepth,ravencrest,1796,druid,balance,96,65,31
Legitx,dentarg,1794,druid,balance,85,46,39
Crunchtime,ragnaros,1792,druid,balance,127,68,59
Klappskaft,outland,1791,druid,balance,35,20,15
Moonhusky,blackrock,1789,druid,balance,60,36,24
Ventrìx,alleria,1787,druid,balance,84,43,41
Laserchicken,malganis,1787,druid,balance,267,129,138
Kylaaz,die-ewige-wacht,1786,druid,balance,111,70,41
Krathar,kazzak,1786,druid,balance,47,22,25
Longhornjohn,ragnaros,1784,druid,balance,58,33,25
Trekkertt,zuljin,1784,druid,balance,53,28,25
Crywingz,antonidas,1783,druid,balance,136,68,68
Kivimon,dun-modr,1781,druid,balance,48,31,17
Morlán,blackmoore,1777,druid,balance,30,19,11
Darktigrou,archimonde,1775,druid,balance,30,21,9
Подпивасникх,gordunni,1775,druid,balance,42,28,14
Gigacooker,ravencrest,1774,druid,balance,42,30,12
Zkrd,kazzak,1774,druid,balance,61,33,28
Rivella,blackrock,1774,druid,balance,57,30,27
Dràkàn,dethecus,1772,druid,balance,48,26,22
Лёхалепеха,gordunni,1770,druid,balance,72,44,28
Zerozerosex,archimonde,1770,druid,balance,66,34,32
Stepgødx,twisting-nether,1769,druid,balance,69,30,39
Лсдспайсы,soulflayer,1767,druid,balance,69,44,25
Gallokiriko,zuljin,1767,druid,balance,78,39,39
Skarbowka,burning-legion,1766,druid,balance,24,20,4
Shiftowl,tarren-mill,1766,druid,balance,36,25,11
Mirynn,elune,1766,druid,balance,127,64,63
Mqs,stormscale,1765,druid,balance,122,72,50
Asinistar,ravencrest,1764,druid,balance,56,32,24
Bbl,rexxar,1763,druid,balance,30,20,10
Thcpositiv,aegwynn,1763,druid,balance,128,63,65
Мунстрайк,borean-tundra,1761,druid,balance,103,59,44
Сосисосочка,gordunni,1761,druid,balance,66,32,34
Durkdriven,kazzak,1759,druid,balance,63,37,26
Kotaryzi,kazzak,1758,druid,balance,24,19,5
Större,twisting-nether,1758,druid,balance,56,41,15
Yinx,darksorrow,1758,druid,balance,66,38,28
Escaa,stormscale,1757,druid,balance,36,21,15
Eddiethepunk,ravencrest,1757,druid,balance,237,134,103
Euphørie,twisting-nether,1757,druid,balance,211,117,94
Taylorshîft,burning-legion,1757,druid,balance,60,31,29
Jenovas,argent-dawn,1756,druid,balance,87,45,42
Shyngodx,archimonde,1755,druid,balance,96,58,38
Dyroxs,twisting-nether,1755,druid,balance,184,91,93
Amazed,wildhammer,1753,druid,balance,54,34,20
Broflovskii,tarren-mill,1752,druid,balance,60,27,33
Shroomdoom,ravencrest,1751,druid,balance,47,23,24
Gudñ,tarren-mill,1750,druid,balance,65,38,27
Stb,outland,1750,druid,balance,48,28,20
Hornykarenn,bladefist,1749,druid,balance,36,25,11
Pneuma,xavius,1749,druid,balance,117,67,50
Hilom,grim-batol,1748,druid,balance,47,29,18
Даена,razuvious,1747,druid,balance,48,34,14
Ånaðeårmas,outland,1746,druid,balance,77,47,30
Babynaty,ravencrest,1745,druid,balance,188,91,97
Págánxø,kazzak,1743,druid,balance,53,34,19
Угощаюх,howling-fjord,1743,druid,balance,47,30,17
Мариантус,greymane,1742,druid,balance,42,22,20
Frenkoz,outland,1741,druid,balance,90,53,37
Brîvaëlle,silvermoon,1740,druid,balance,30,24,6
Deepak,nemesis,1740,druid,balance,60,35,25
Ashleyx,antonidas,1738,druid,balance,36,30,6
Empi,sanguino,1738,druid,balance,54,34,20
Meowmf,silvermoon,1738,druid,balance,78,48,30
Kribie,aegwynn,1738,druid,balance,66,40,26
Jaiyen,ravencrest,1736,druid,balance,65,45,20
Fuzzylol,haomarush,1736,druid,balance,41,24,17
Leqt,ravencrest,1736,druid,balance,90,52,38
Frapucino,ravencrest,1735,druid,balance,39,28,11
Fantomasik,drakthul,1734,druid,balance,230,117,113
Bigbaddream,stormscale,1733,druid,balance,60,34,26
Isuckdruid,aegwynn,1733,druid,balance,100,56,44
Мягкийвисп,howling-fjord,1729,druid,balance,72,41,31
Трэйкотик,blackscar,1728,druid,balance,71,41,30
Ахисса,gordunni,1727,druid,balance,78,37,41
Tâliah,silvermoon,1726,druid,balance,54,35,19
Aleza,tarren-mill,1726,druid,balance,51,30,21
Rekked,alleria,1726,druid,balance,60,32,28
Pultsarí,tarren-mill,1725,druid,balance,39,24,15
Duckiethotx,twisting-nether,1725,druid,balance,36,21,15
Yarinai,blackmoore,1725,druid,balance,78,44,34
Pouletqt,archimonde,1723,druid,balance,42,21,21
Píøøx,tarren-mill,1722,druid,balance,84,53,31
Oommis,outland,1722,druid,balance,48,28,20
Blood,frostwolf,1722,druid,balance,66,36,30
Pwnylol,teldrassil,1721,druid,balance,70,46,24
Smøkewéed,ravencrest,1719,druid,balance,24,18,6
Xyzy,burning-legion,1719,druid,balance,96,48,48
Hugeragê,stormreaver,1719,druid,balance,71,33,38
Kalgarm,burning-legion,1719,druid,balance,66,29,37
Juicew,stormscale,1717,druid,balance,24,18,6
Adizero,blackrock,1716,druid,balance,37,24,13
Shakeme,zuljin,1716,druid,balance,48,25,23
Khålêd,kazzak,1714,druid,balance,52,38,14
Orangeterror,stormscale,1714,druid,balance,48,30,18
Хрофт,blackscar,1714,druid,balance,54,26,28
Yapyapyapyap,eredar,1713,druid,balance,42,25,17
Kabuul,dun-modr,1712,druid,balance,119,74,45
Sifferx,stormscale,1712,druid,balance,53,28,25
Batmòn,stormscale,1712,druid,balance,93,48,45
Владибой,gordunni,1712,druid,balance,36,18,18
Illmíndofboo,twisting-nether,1711,druid,balance,59,37,22
Madhatterr,kazzak,1710,druid,balance,96,63,33
Scars,outland,1710,druid,balance,30,18,12
Bîjaqt,blackmoore,1710,druid,balance,30,18,12
Mirâculixx,dethecus,1709,druid,balance,30,19,11
Kørra,dun-modr,1707,druid,balance,73,42,31
Moonfirecow,thrall,1706,druid,balance,54,32,22
Slahnesh,aegwynn,1706,druid,balance,48,26,22
Linkin,azshara,1704,druid,balance,102,53,49
Naturez,sylvanas,1704,druid,balance,74,37,37
Mikhaili,stormreaver,1703,druid,balance,30,18,12
Leywä,drekthar,1703,druid,balance,47,28,19
Каралесер,gordunni,1703,druid,balance,205,111,94
Nerfmemaybe,blackmoore,1702,druid,balance,29,20,9
Yuhor,outland,1702,druid,balance,202,107,95
Небесныйхант,soulflayer,1702,druid,balance,123,63,60
Elissian,silvermoon,1701,druid,balance,223,117,106
Neufcinqq,archimonde,1700,druid,balance,39,26,13
Symbiosa,silvermoon,1699,druid,balance,99,63,36
Thardruid,stormscale,1699,druid,balance,72,42,30
Колтрэйнх,fordragon,1699,druid,balance,54,29,25
Htxo,kazzak,1698,druid,balance,30,18,12
Shaakm,nerathor,1697,druid,balance,66,40,26
Cryspie,hyjal,1697,druid,balance,42,23,19
Raykk,culte-de-la-rive-noire,1696,druid,balance,30,18,12
Rexadria,blackrock,1695,druid,balance,24,18,6
Eñzo,stormscale,1695,druid,balance,30,21,9
Esrín,the-maelstrom,1695,druid,balance,104,56,48
Bubadruid,silvermoon,1694,druid,balance,65,47,18
Sinalûlz,outland,1694,druid,balance,30,18,12
Taveirasurge,kazzak,1693,druid,balance,42,28,14
Nastyclones,kazzak,1691,druid,balance,36,21,15
Chäz,sanguino,1690,druid,balance,56,42,14
Nzmdruid,burning-legion,1689,druid,balance,36,21,15
Hymìr,silvermoon,1689,druid,balance,71,37,34
Néxct,stormscale,1688,druid,balance,36,22,14
Bobobobobobo,blackrock,1687,druid,balance,101,60,41
Msb,the-maelstrom,1687,druid,balance,36,18,18
Gnoobr,ravencrest,1686,druid,balance,24,18,6
Ykg,twisting-nether,1686,druid,balance,51,32,19
Nergi,darksorrow,1686,druid,balance,53,31,22
Cyriaan,eredar,1686,druid,balance,101,55,46
Güccïmane,twisting-nether,1685,druid,balance,72,53,19
Teebeidl,tarren-mill,1685,druid,balance,78,46,32
Panpanqcul,archimonde,1685,druid,balance,99,57,42
Добродейтель,soulflayer,1683,druid,balance,132,82,50
Cowgurl,stormscale,1682,druid,balance,48,27,21
Haanook,ravencrest,1682,druid,balance,136,74,62
Mäismz,hyjal,1680,druid,balance,54,37,17
Sleepz,blackrock,1679,druid,balance,24,18,6
Npml,tarren-mill,1678,druid,balance,53,30,23
Kaïnak,dalaran,1677,druid,balance,54,29,25
Zeptune,tarren-mill,1677,druid,balance,126,59,67
Highonfire,grim-batol,1676,druid,balance,60,41,19
Ïndrä,arathi,1676,druid,balance,35,22,13
Dotclass,outland,1675,druid,balance,44,25,19
Iamobito,blackmoore,1674,druid,balance,36,22,14
Wildrice,blackhand,1674,druid,balance,65,37,28
Totemdrood,blackmoore,1673,druid,balance,30,20,10
Cptnclone,blackmoore,1669,druid,balance,72,38,34
Andreud,dunemaul,1669,druid,balance,77,37,40
Воому,soulflayer,1668,druid,balance,30,22,8
Drcaøs,sanguino,1668,druid,balance,84,47,37
Maladorf,draenor,1667,druid,balance,30,21,9
Pyaw,kazzak,1666,druid,balance,78,44,34
Мэдикейт,soulflayer,1665,druid,balance,84,48,36
Suomenlorgok,stormreaver,1664,druid,balance,36,23,13
Fapmasterx,eredar,1664,druid,balance,36,23,13
Settembre,ragnaros,1664,druid,balance,69,40,29
Dreathqt,twisting-nether,1664,druid,balance,84,37,47
Suprachybre,arathi,1662,druid,balance,48,31,17
Sanaponic,burning-legion,1660,druid,balance,40,26,14
Shapeshift,sanguino,1659,druid,balance,62,34,28
Suevlaki,ragnaros,1658,druid,balance,108,68,40
Møømøø,tarren-mill,1658,druid,balance,30,18,12
Nönö,tarren-mill,1657,druid,balance,36,21,15
Bàrathrum,blackrock,1657,druid,balance,48,27,21
Jamzydruid,kazzak,1657,druid,balance,72,37,35
Кектахан,soulflayer,1656,druid,balance,30,20,10
Bøllemís,silvermoon,1655,druid,balance,30,19,11
Hotsincee,stormscale,1654,druid,balance,157,85,72
Superdr,ragnaros,1653,druid,balance,28,21,7
Svend,kazzak,1653,druid,balance,59,36,23
Shreedex,blackmoore,1651,druid,balance,66,41,25
Chøpzjr,blackrock,1651,druid,balance,48,27,21
Сибирячечка,greymane,1651,druid,balance,116,61,55
Pewpewdruid,blackmoore,1650,druid,balance,144,79,65
Opathecool,bladefist,1649,druid,balance,35,25,10
Trinket,frostmane,1648,druid,balance,42,30,12
Troc,karazhan,1648,druid,balance,30,21,9
Beanery,aegwynn,1648,druid,balance,36,24,12
Macron,terokkar,1648,druid,balance,64,35,29
Kabòöóm,outland,1647,druid,balance,42,25,17
Cantdonothig,ravencrest,1646,druid,balance,245,130,115
Ampdru,ravencrest,1644,druid,balance,23,18,5
Hyunâ,dalaran,1644,druid,balance,48,30,18
Twitchmoney,archimonde,1643,druid,balance,32,24,8
Øffroadz,blackmoore,1643,druid,balance,30,20,10
Holziger,azshara,1643,druid,balance,51,32,19
Kittenmitten,ragnaros,1643,druid,balance,130,76,54
Spaceshift,magtheridon,1643,druid,balance,132,77,55
Мэдикейт,gordunni,1643,druid,balance,72,39,33
Ibuyicecream,outland,1642,druid,balance,89,55,34
Milantu,antonidas,1642,druid,balance,30,18,12
Pradasurge,ravencrest,1642,druid,balance,149,81,68
Ploho,blackmoore,1642,druid,balance,39,19,20
Laødinay,hyjal,1641,druid,balance,54,30,24
Фигарофигаро,gordunni,1641,druid,balance,66,35,31
Xoap,kazzak,1640,druid,balance,30,21,9
Loethen,argent-dawn,1640,druid,balance,76,51,25
Gstahr,taerar,1640,druid,balance,82,47,35
Cønvokê,tarren-mill,1640,druid,balance,64,34,30
Хотдиллер,howling-fjord,1639,druid,balance,30,20,10
Cupoftea,drakthul,1639,druid,balance,95,58,37
Zapx,hyjal,1639,druid,balance,90,50,40
Drutro,hellfire,1639,druid,balance,54,27,27
Meganfoxdq,sanguino,1638,druid,balance,82,53,29
ßoom,antonidas,1638,druid,balance,65,34,31
Ymagyne,frostmane,1638,druid,balance,44,23,21
Shiftcaster,ravencrest,1638,druid,balance,48,22,26
Obrys,tarren-mill,1637,druid,balance,42,21,21
Gotnaga,silvermoon,1636,druid,balance,30,20,10
Grafíx,blackrock,1636,druid,balance,30,18,12
Derfaï,kaelthas,1636,druid,balance,41,21,20
Balencìága,sanguino,1635,druid,balance,47,30,17
Gretathnberg,ravencrest,1635,druid,balance,38,20,18
Ðevilwhite,nemesis,1635,druid,balance,50,20,30
Deví,twilights-hammer,1634,druid,balance,48,30,18
Gentle,tarren-mill,1634,druid,balance,38,22,16
Bobcup,tarren-mill,1634,druid,balance,97,55,42
Naturalbeef,argent-dawn,1634,druid,balance,40,22,18
Naicy,khaz-modan,1633,druid,balance,42,24,18
Frodds,grim-batol,1632,druid,balance,75,53,22
Óffstér,kazzak,1632,druid,balance,72,22,50
Knuffle,eredar,1631,druid,balance,82,52,30
Rystafarian,kazzak,1631,druid,balance,38,22,16
Valgo,twisting-nether,1631,druid,balance,36,20,16
Bøøstèdtréè,ravencrest,1631,druid,balance,132,69,63
Moffwastaken,kazzak,1631,druid,balance,219,111,108
Masakrelol,sanguino,1631,druid,balance,36,18,18
Felysae,kazzak,1630,druid,balance,24,17,7
Klßa,grim-batol,1630,druid,balance,30,21,9
Myllymatti,frostwhisper,1630,druid,balance,36,21,15
Squirtdogx,drakthul,1630,druid,balance,30,17,13
Feralenjoyer,drakthul,1630,druid,balance,30,17,13
Жизэ,galakrond,1629,druid,balance,62,39,23
Боблерсс,gordunni,1629,druid,balance,36,21,15
Porzi,eredar,1628,druid,balance,84,51,33
Saqartvelo,tarren-mill,1628,druid,balance,60,34,26
Izzual,tarren-mill,1628,druid,balance,36,20,16
Èøèøèøèøè,stormscale,1627,druid,balance,18,17,1
Сансплэш,lich-king,1627,druid,balance,30,24,6
Ðréws,ravencrest,1627,druid,balance,30,19,11
Pikamoo,kazzak,1627,druid,balance,35,20,15
Зенза,howling-fjord,1627,druid,balance,60,33,27
Møønhorn,nemesis,1627,druid,balance,137,75,62
Vulkayn,ysondre,1627,druid,balance,42,22,20
Jaycutler,archimonde,1627,druid,balance,72,36,36
Séxycàt,ravencrest,1626,druid,balance,141,78,63
Иггдрасиль,gordunni,1625,druid,balance,103,61,42
Amøveo,draenor,1625,druid,balance,48,25,23
Dakotaboomer,ravencrest,1624,druid,balance,30,17,13
Kkona,silvermoon,1624,druid,balance,77,41,36
Ipsdray,ysondre,1623,druid,balance,48,31,17
Deßradator,stormscale,1623,druid,balance,42,25,17
Çhîñêséðrüîð,kazzak,1623,druid,balance,36,21,15
Hirmo,ragnaros,1623,druid,balance,52,30,22
Grisdrood,ragnaros,1623,druid,balance,54,31,23
Kittyexpress,arygos,1623,druid,balance,48,25,23
Elatadru,silvermoon,1623,druid,balance,42,21,21
Rassia,blackrock,1622,druid,balance,60,39,21
Храш,gordunni,1622,druid,balance,29,18,11
Yosimoo,draenor,1622,druid,balance,72,43,29
Baboss,chogall,1622,druid,balance,60,31,29
Слоич,howling-fjord,1622,druid,balance,158,76,82
Merfje,karazhan,1622,druid,balance,36,17,19
Valijan,blackrock,1622,druid,balance,40,18,22
Светдру,blackscar,1621,druid,balance,24,17,7
Nizkul,dun-modr,1621,druid,balance,67,36,31
Malvakten,kazzak,1621,druid,balance,194,94,100
Cyclønegodxd,dentarg,1620,druid,balance,57,40,17
Thundruid,archimonde,1620,druid,balance,30,18,12
Kåmen,ravenholdt,1620,druid,balance,91,53,38
Rasgath,kazzak,1620,druid,balance,285,157,128
Moonzysunzy,sylvanas,1620,druid,balance,36,17,19
Landesverrat,kazzak,1619,druid,balance,24,21,3
Rosskemp,tarren-mill,1619,druid,balance,24,17,7
Døttore,garona,1619,druid,balance,122,63,59
Whisker,outland,1618,druid,balance,24,17,7
Youngdinozzo,dalaran,1618,druid,balance,35,23,12
Xora,aegwynn,1618,druid,balance,38,23,15
Takemanstwix,ragnaros,1618,druid,balance,42,25,17
Damigjat,sylvanas,1618,druid,balance,215,123,92
Xenuss,kazzak,1618,druid,balance,42,23,19
Thielyy,blackmoore,1618,druid,balance,89,48,41
Pøpp,archimonde,1618,druid,balance,41,22,19
Mendorin,stormrage,1618,druid,balance,69,36,33
Аласторвов,deathweaver,1618,druid,balance,118,57,61
Ícekiss,hyjal,1617,druid,balance,30,24,6
Zì,stormscale,1617,druid,balance,54,31,23
Ryuzu,aegwynn,1616,druid,balance,79,45,34
Fabuboomy,blackrock,1616,druid,balance,30,17,13
Alessàsavage,nemesis,1616,druid,balance,36,18,18
Pumpingurass,twisting-nether,1615,druid,balance,24,17,7
Xirbtihs,stormscale,1615,druid,balance,50,32,18
Djsnigel,stormscale,1615,druid,balance,35,22,13
Âlhajillo,dun-modr,1615,druid,balance,30,17,13
Klørfem,draenor,1614,druid,balance,36,21,15
Happybear,outland,1613,druid,balance,63,46,17
Hollymedx,blackmoore,1613,druid,balance,98,57,41
Horadruid,silvermoon,1613,druid,balance,268,147,121
Gòrgoth,pozzo-delleternità,1613,druid,balance,42,23,19
Pawel,defias-brotherhood,1613,druid,balance,125,67,58
Exilara,twisting-nether,1612,druid,balance,61,38,23
Kubzii,archimonde,1612,druid,balance,90,48,42
Teaser,dun-modr,1612,druid,balance,66,35,31
Бонони,booty-bay,1612,druid,balance,102,51,51
Rá,outland,1611,druid,balance,32,22,10
Pëchy,aggra-português,1611,druid,balance,66,39,27
Mianmar,silvermoon,1610,druid,balance,149,92,57
Åkømo,aegwynn,1610,druid,balance,36,21,15
Deadmeøw,outland,1609,druid,balance,34,21,13
Vitaex,blackrock,1608,druid,balance,33,23,10
Boomykush,twisting-nether,1608,druid,balance,74,42,32
Kl,archimonde,1608,druid,balance,114,53,61
Doncy,ragnaros,1607,druid,balance,54,24,30
Sqoopy,tarren-mill,1606,druid,balance,36,27,9
Alethorn,twisting-nether,1606,druid,balance,43,30,13
Ryng,nagrand,1606,druid,balance,60,41,19
Ахаххаха,howling-fjord,1606,druid,balance,42,26,16
Lillevän,tarren-mill,1606,druid,balance,30,18,12
Noou,aegwynn,1606,druid,balance,46,25,21
Scamlafsen,ragnaros,1606,druid,balance,42,22,20
Dharli,stormscale,1606,druid,balance,60,27,33
Neverpanic,stormscale,1605,druid,balance,30,21,9
Hillarious,blackmoore,1605,druid,balance,111,65,46
Auches,argent-dawn,1605,druid,balance,42,22,20
Isylia,twisting-nether,1605,druid,balance,72,36,36
Owenwilson,twisting-nether,1604,druid,balance,36,22,14
Rode,magtheridon,1604,druid,balance,129,75,54
Grisdrood,draenor,1604,druid,balance,221,111,110
Duis,twilights-hammer,1603,druid,balance,80,44,36
Winarchikxxl,tarren-mill,1603,druid,balance,217,115,102
Alamâ,madmortem,1603,druid,balance,48,21,27
Pròtodrù,twisting-nether,1602,druid,balance,30,18,12
Dematos,forscherliga,1602,druid,balance,114,68,46
Cptsponksa,tarren-mill,1602,druid,balance,106,60,46
Arecsne,turalyon,1602,druid,balance,85,45,40
Nomilkforyou,steamwheedle-cartel,1601,druid,balance,63,39,24
Niul,aegwynn,1601,druid,balance,146,83,63
Aenrolz,hyjal,1600,druid,balance,30,21,9
Goom,rexxar,1600,druid,balance,214,124,90
Deepqt,kargath,1600,druid,balance,66,36,30
Mopferal,twisting-nether,1599,druid,balance,36,28,8
Стампид,blackscar,1599,druid,balance,127,76,51
Featherfeet,kazzak,1599,druid,balance,48,22,26
Bigtouch,draenor,1597,druid,balance,54,31,23
Siajin,frostwolf,1597,druid,balance,30,17,13
Saltymoo,tarren-mill,1597,druid,balance,53,30,23
Pitbull,archimonde,1597,druid,balance,72,38,34
Zonsy,twisting-nether,1597,druid,balance,60,28,32
Wísh,stormscale,1596,druid,balance,36,23,13
Phobidru,thrall,1595,druid,balance,30,19,11
Stinkyicky,sylvanas,1594,druid,balance,60,38,22
Malaprljavca,kazzak,1594,druid,balance,67,40,27
Hashishi,grim-batol,1594,druid,balance,72,40,32
Zømßie,outland,1594,druid,balance,102,56,46
Malfurien,magtheridon,1593,druid,balance,30,17,13
Àspro,hyjal,1591,druid,balance,42,21,21
Rwq,outland,1590,druid,balance,57,30,27
Муниня,gordunni,1589,druid,balance,78,45,33
Ôp,aegwynn,1589,druid,balance,65,31,34
Truffleßuttr,kazzak,1587,druid,balance,30,17,13
Xä,bloodscalp,1587,druid,balance,159,86,73
Veyronn,burning-legion,1586,druid,balance,48,25,23
Magnusson,shadowsong,1585,druid,balance,90,59,31
Convokeboost,archimonde,1581,druid,balance,235,136,99
Monkeynight,ambossar,1581,druid,balance,41,22,19
Vaacku,stormreaver,1581,druid,balance,64,34,30
Hotdóts,outland,1580,druid,balance,30,20,10
Zevis,outland,1580,druid,balance,126,65,61
Borderliner,blackrock,1576,druid,balance,48,29,19
Goüsta,archimonde,1576,druid,balance,60,35,25
Ittei,korgall,1575,druid,balance,36,22,14
Amoveo,argent-dawn,1574,druid,balance,56,31,25
Mjáy,tarren-mill,1574,druid,balance,36,19,17
Brainjuice,blackrock,1574,druid,balance,36,19,17
Redlung,outland,1573,druid,balance,30,18,12
Nevermeldx,blackrock,1573,druid,balance,29,17,12
Merawr,ravencrest,1573,druid,balance,129,66,63
Nctmé,tarren-mill,1573,druid,balance,35,17,18
Aègon,ravencrest,1572,druid,balance,89,53,36
Kolt,rajaxx,1571,druid,balance,86,47,39
Wildanomaly,argent-dawn,1571,druid,balance,94,51,43
Diggear,doomhammer,1570,druid,balance,30,21,9
Halouest,archimonde,1570,druid,balance,77,42,35
Bôoze,nathrezim,1569,druid,balance,36,19,17
Notmyfriend,sylvanas,1568,druid,balance,47,32,15
Azurai,blackmoore,1567,druid,balance,72,38,34
Kalthazar,twisting-nether,1567,druid,balance,36,19,17
Topfrag,outland,1566,druid,balance,42,22,20
Gibsx,blackmoore,1564,druid,balance,30,21,9
Elodìa,antonidas,1561,druid,balance,30,21,9
Synexi,sylvanas,1560,druid,balance,36,21,15
Maelkan,sanguino,1560,druid,balance,132,68,64
Hotlife,ravencrest,1559,druid,balance,55,29,26
Starcrash,amanthul,1559,druid,balance,60,28,32
Ðelix,ysera,1558,druid,balance,62,37,25
Insølitø,sanguino,1558,druid,balance,99,57,42
Newdudu,draenor,1557,druid,balance,53,30,23
Sequisha,tarren-mill,1555,druid,balance,30,17,13
Hackamore,archimonde,1555,druid,balance,115,61,54
Rédbull,outland,1554,druid,balance,148,81,67
Inkibek,burning-blade,1553,druid,balance,102,64,38
Урркке,soulflayer,1552,druid,balance,48,29,19
Legyna,ravencrest,1552,druid,balance,39,20,19
Rivenx,ravencrest,1551,druid,balance,53,32,21
Obsessíon,kazzak,1551,druid,balance,48,24,24
Баттнэйкед,gordunni,1551,druid,balance,83,41,42
Nixhot,blackmoore,1550,druid,balance,30,17,13
Wildmistake,argent-dawn,1550,druid,balance,35,17,18
Uptoyou,defias-brotherhood,1549,druid,balance,77,45,32
Potatodru,ragnaros,1549,druid,balance,30,17,13
Бамболони,gordunni,1548,druid,balance,92,56,36
Muhz,nathrezim,1548,druid,balance,70,39,31
Moonwatcher,blackrock,1548,druid,balance,188,103,85
Грибомания,soulflayer,1548,druid,balance,35,18,17
Majokz,ravencrest,1547,druid,balance,74,37,37
Threesixnìne,dun-morogh,1547,druid,balance,65,25,40
Brokul,kazzak,1546,druid,balance,54,29,25
Кыцко,soulflayer,1546,druid,balance,63,32,31
Wykked,outland,1545,druid,balance,42,18,24
Angelinax,silvermoon,1544,druid,balance,35,19,16
Frikolina,outland,1543,druid,balance,98,49,49
Krosanx,outland,1542,druid,balance,30,17,13
Moler,hyjal,1541,druid,balance,67,43,24
Maaw,tarren-mill,1541,druid,balance,48,27,21
Gretl,blackrock,1541,druid,balance,60,30,30
Zhof,ravencrest,1540,druid,balance,130,63,67
Algír,argent-dawn,1539,druid,balance,107,53,54
Chadru,magtheridon,1538,druid,balance,68,36,32
Lazerbinks,blackmoore,1536,druid,balance,29,18,11
Jazzme,aegwynn,1535,druid,balance,24,16,8
Elfsu,ravencrest,1534,druid,balance,54,36,18
Buurzalbai,drakthul,1534,druid,balance,66,34,32
Druidflight,ravencrest,1534,druid,balance,48,24,24
Gorthunx,kazzak,1533,druid,balance,40,26,14
Køßÿ,ysondre,1533,druid,balance,30,19,11
Хастла,galakrond,1532,druid,balance,30,18,12
Suitti,ravencrest,1532,druid,balance,29,17,12
Грандал,howling-fjord,1532,druid,balance,66,30,36
Thaeris,outland,1531,druid,balance,28,17,11
Mindruid,kazzak,1531,druid,balance,30,18,12
Chavinelf,twisting-nether,1530,druid,balance,30,16,14
Анестезий,soulflayer,1529,druid,balance,66,48,18
Catten,sylvanas,1529,druid,balance,30,17,13
Whiskers,emerald-dream,1529,druid,balance,84,44,40
Heiden,terokkar,1528,druid,balance,24,16,8
Ljóskan,kazzak,1528,druid,balance,36,16,20
Brandyballix,twisting-nether,1526,druid,balance,116,58,58
Migami,nemesis,1526,druid,balance,36,18,18
Crazzimus,tarren-mill,1525,druid,balance,36,21,15
Utiniutini,thrall,1525,druid,balance,33,19,14
Leathy,eredar,1524,druid,balance,60,35,25
Silvix,blackrock,1524,druid,balance,54,28,26
Lisbethqt,nemesis,1523,druid,balance,24,16,8
Chillerin,draenor,1523,druid,balance,54,31,23
Healol,sanguino,1523,druid,balance,75,42,33
Seboom,outland,1522,druid,balance,123,69,54
Crackfat,stormscale,1521,druid,balance,52,34,18
Bagginston,nazjatar,1521,druid,balance,38,20,18
Sofiadrood,stormreaver,1520,druid,balance,24,16,8
Chansnax,thrall,1519,druid,balance,58,32,26
Exca,stormscale,1519,druid,balance,54,28,26
Gløbal,antonidas,1518,druid,balance,33,19,14
Lyø,draenor,1518,druid,balance,112,64,48
Endoplazmik,silvermoon,1518,druid,balance,96,50,46
Milkywáys,draenor,1518,druid,balance,142,70,72
Nøny,gorgonnash,1517,druid,balance,69,40,29
Rilak,nordrassil,1517,druid,balance,112,61,51
Ylmh,archimonde,1516,druid,balance,24,16,8
Elrroir,dun-modr,1516,druid,balance,42,24,18
Feralspîrît,outland,1516,druid,balance,30,17,13
Telbo,ravencrest,1516,druid,balance,89,48,41
Likwidator,stormscale,1514,druid,balance,116,66,50
Schannine,archimonde,1513,druid,balance,41,20,21
Jerie,silvermoon,1512,druid,balance,24,16,8
Czarnykocur,burning-legion,1512,druid,balance,108,62,46
Lèafy,silvermoon,1511,druid,balance,43,26,17
Shedzokey,tarren-mill,1511,druid,balance,66,39,27
Opla,nethersturm,1510,druid,balance,40,27,13
Metzarqq,stormscale,1510,druid,balance,24,16,8
Saabeq,hyjal,1509,druid,balance,50,28,22
Ðrpressure,blackrock,1508,druid,balance,120,72,48
Abercrombx,thrall,1508,druid,balance,44,26,18
Calambius,blackhand,1508,druid,balance,66,31,35
Ashkaxx,ragnaros,1507,druid,balance,64,35,29
Rhaf,argent-dawn,1507,druid,balance,150,82,68
Pórts,kazzak,1507,druid,balance,42,20,22
Druidka,grim-batol,1507,druid,balance,42,20,22
Andjuga,doomhammer,1506,druid,balance,130,62,68
Fransman,sylvanas,1505,druid,balance,53,25,28
Gurudru,tarren-mill,1505,druid,balance,108,47,61
Ayamiss,outland,1504,druid,balance,30,16,14
Whythis,archimonde,1504,druid,balance,146,74,72
Lasertipu,tarren-mill,1503,druid,balance,53,28,25
Blackfür,sylvanas,1501,druid,balance,116,57,59
Sagezza,draenor,1500,druid,balance,180,91,89
Xqzmybleedz,onyxia,1499,druid,balance,38,24,14
Skadruid,blackmoore,1499,druid,balance,60,30,30
Trylune,blackmoore,1498,druid,balance,30,17,13
Ezkatka,ravencrest,1497,druid,balance,24,16,8
Nømat,defias-brotherhood,1497,druid,balance,149,86,63
Karodoom,twisting-nether,1497,druid,balance,125,68,57
Quorn,pozzo-delleternità,1497,druid,balance,70,34,36
Sweetner,outland,1495,druid,balance,58,35,23
Гнетея,howling-fjord,1494,druid,balance,59,33,26
Surps,ravencrest,1494,druid,balance,30,16,14
Carismatic,blackmoore,1494,druid,balance,224,116,108
Slaughtér,stormscale,1491,druid,balance,30,22,8
Dámøn,stormscale,1491,druid,balance,30,16,14
Syremark,silvermoon,1491,druid,balance,48,21,27
Woodzey,sylvanas,1489,druid,balance,36,18,18
Kittyperry,blackmoore,1489,druid,balance,41,20,21
Drutiful,outland,1486,druid,balance,54,24,30
Sodapop,aszune,1485,druid,balance,114,64,50
Smuktøs,twisting-nether,1484,druid,balance,63,43,20
Strinx,ragnaros,1484,druid,balance,96,60,36
Jejoueferal,chogall,1484,druid,balance,138,72,66
Arkatt,outland,1482,druid,balance,36,24,12
Seudoz,silvermoon,1482,druid,balance,48,29,19
Pyqmi,stormscale,1479,druid,balance,36,23,13
Yiradur,stormscale,1479,druid,balance,90,47,43
Rât,blackmoore,1478,druid,balance,54,36,18
Bëndover,uldaman,1478,druid,balance,36,23,13
Demonbalance,silvermoon,1478,druid,balance,64,39,25
Hållkäften,twisting-nether,1478,druid,balance,60,29,31
Dingeren,stormscale,1473,druid,balance,30,19,11
Epidemic,argent-dawn,1473,druid,balance,49,26,23
Báco,dun-modr,1473,druid,balance,36,17,19
Kbdd,outland,1472,druid,balance,36,16,20
Boomalot,auchindoun,1471,druid,balance,54,31,23
Prinzfarming,mugthol,1469,druid,balance,57,29,28
Aetheris,varimathras,1469,druid,balance,62,29,33
Mønrøe,ravencrest,1467,druid,balance,29,17,12
Ddggss,ragnaros,1466,druid,balance,37,21,16
Ziele,the-maelstrom,1465,druid,balance,40,23,17
Bashfui,draenor,1465,druid,balance,132,69,63
Pfandmalle,blackrock,1464,druid,balance,36,24,12
Lashketchum,aszune,1463,druid,balance,42,27,15
Sefinana,malganis,1463,druid,balance,132,60,72
Wallaar,ragnaros,1463,druid,balance,36,16,20
Vaizier,defias-brotherhood,1462,druid,balance,119,60,59
Restouz,twisting-nether,1462,druid,balance,129,65,64
Kroaxs,draenor,1461,druid,balance,157,87,70
Meatwallet,defias-brotherhood,1460,druid,balance,47,27,20
Skywíng,stormscale,1460,druid,balance,48,23,25
Magiskeforme,draenor,1459,druid,balance,32,22,10
Entas,kazzak,1459,druid,balance,36,24,12
Asterism,stormscale,1459,druid,balance,129,71,58
Kamzik,drakthul,1459,druid,balance,36,19,17
Primdâhl,ravencrest,1459,druid,balance,60,31,29
Fiomy,blackhand,1458,druid,balance,47,36,11
Beefsteaxs,thrall,1458,druid,balance,30,22,8
Teddyxbear,nefarian,1458,druid,balance,30,18,12
Tawaraki,outland,1458,druid,balance,215,114,101
Viverion,ravencrest,1458,druid,balance,92,47,45
Almrudi,blackrock,1456,druid,balance,42,20,22
Dabudi,kazzak,1455,druid,balance,57,32,25
Мантоя,gordunni,1455,druid,balance,174,93,81
Ånåphorå,archimonde,1454,druid,balance,33,16,17
Кулунхе,soulflayer,1453,druid,balance,78,50,28
Kuhgucci,blackmoore,1451,druid,balance,30,16,14
Gúccî,blackrock,1450,druid,balance,30,22,8
Fillet,aggra-português,1448,druid,balance,44,33,11
Aik,gorgonnash,1448,druid,balance,60,30,30
Mahist,archimonde,1447,druid,balance,54,31,23
Кортанус,gordunni,1447,druid,balance,39,21,18
Ciaolol,ragnaros,1443,druid,balance,30,19,11
Eärendir,ravencrest,1442,druid,balance,223,111,112
Dudana,argent-dawn,1441,druid,balance,48,29,19
Duridlol,nemesis,1439,druid,balance,18,15,3
Dudmæster,blackmoore,1439,druid,balance,33,18,15
Lappe,stormreaver,1439,druid,balance,30,15,15
Lacÿn,twisting-nether,1438,druid,balance,18,15,3
Jatto,magtheridon,1438,druid,balance,36,20,16
Vamix,aegwynn,1437,druid,balance,18,15,3
Ferraridudux,ravencrest,1437,druid,balance,18,15,3
Chángé,draenor,1437,druid,balance,36,23,13
Shuffey,frostmane,1437,druid,balance,45,24,21
Редмун,soulflayer,1436,druid,balance,104,55,49
Néøu,archimonde,1434,druid,balance,24,15,9
Duskdawn,xavius,1434,druid,balance,60,30,30
Kørn,drakthul,1433,druid,balance,61,28,33
Restromide,ravencrest,1432,druid,balance,30,15,15
Mogi,pozzo-delleternità,1432,druid,balance,75,35,40
Óðinn,stormscale,1431,druid,balance,18,15,3
Tøyz,stormscale,1431,druid,balance,18,15,3
Juvencus,twisting-nether,1431,druid,balance,24,15,9
Chouwa,korgall,1431,druid,balance,65,38,27
Drøøkîé,antonidas,1430,druid,balance,144,83,61
Tonutc,sanguino,1430,druid,balance,51,25,26
Elilith,auchindoun,1429,druid,balance,18,15,3
Ibnform,archimonde,1429,druid,balance,18,15,3
Jöggel,perenolde,1429,druid,balance,42,25,17
Lxz,blackhand,1429,druid,balance,52,23,29
Kazuid,argent-dawn,1428,druid,balance,38,24,14
Vëgâñgøðx,ragnaros,1428,druid,balance,24,15,9
Fouser,shattered-hand,1428,druid,balance,36,17,19
Крейзикет,eversong,1427,druid,balance,24,15,9
Keynn,kazzak,1427,druid,balance,72,33,39
Fluffeh,doomhammer,1426,druid,balance,36,22,14
Littleneo,ambossar,1426,druid,balance,53,25,28
Dypas,chogall,1425,druid,balance,36,20,16
Däkk,draenor,1425,druid,balance,72,32,40
Smashella,pozzo-delleternità,1423,druid,balance,36,25,11
Anabola,frostwhisper,1423,druid,balance,24,15,9
Inghlo,blackmoore,1423,druid,balance,53,29,24
Mørshac,blackrock,1422,druid,balance,24,15,9
Wize,pozzo-delleternità,1422,druid,balance,56,27,29
Bearcosby,burning-legion,1421,druid,balance,29,16,13
Dantet,the-maelstrom,1421,druid,balance,30,15,15
Petiteorange,archimonde,1420,druid,balance,24,16,8
Малисеннта,gordunni,1420,druid,balance,42,21,21
Reed,sylvanas,1420,druid,balance,30,15,15
Applestrudle,blackrock,1420,druid,balance,54,24,30
Екфта,gordunni,1419,druid,balance,36,18,18
Kanataka,stormscale,1418,druid,balance,54,32,22
Guthíx,silvermoon,1418,druid,balance,66,29,37
Wazam,kazzak,1417,druid,balance,50,34,16
Лардиан,gordunni,1417,druid,balance,30,15,15
Lyøñ,dun-modr,1417,druid,balance,35,16,19
Levéltetü,ragnaros,1416,druid,balance,24,15,9
Storpboom,drakthul,1416,druid,balance,108,62,46
Этъя,borean-tundra,1416,druid,balance,42,19,23
Carebearlol,frostmane,1416,druid,balance,42,17,25
Hauntie,kazzak,1413,druid,balance,42,24,18
Hypam,archimonde,1413,druid,balance,42,19,23
Chispiwini,cthun,1412,druid,balance,55,28,27
Flippy,blackmoore,1412,druid,balance,110,54,56
Traplordgen,outland,1411,druid,balance,24,15,9
Layle,argent-dawn,1411,druid,balance,36,15,21
Fruitdealer,antonidas,1410,druid,balance,42,23,19
Anahots,silvermoon,1410,druid,balance,141,69,72
Chúcky,twisting-nether,1409,druid,balance,91,50,41
Paulskinbak,tarren-mill,1409,druid,balance,36,18,18
Albás,kazzak,1407,druid,balance,18,15,3
Izzi,arathor,1405,druid,balance,56,31,25
Krtt,tarren-mill,1405,druid,balance,163,78,85
Rbgbear,blackhand,1403,druid,balance,59,32,27
Rrayed,kazzak,1402,druid,balance,64,42,22
Hisoca,tarren-mill,1402,druid,balance,108,60,48
Itadorikun,silvermoon,1401,druid,balance,71,41,30
Elonax,eredar,1400,druid,balance,44,28,16
Çãm,magtheridon,1399,druid,balance,24,16,8
Kielorn,stormscale,1399,druid,balance,30,16,14
Xyiz,ravencrest,1399,druid,balance,80,42,38
Матумбо,razuvious,1399,druid,balance,302,149,153
Fleq,antonidas,1397,druid,balance,65,34,31
Ilovedruid,forscherliga,1397,druid,balance,52,27,25
Ramgis,sanguino,1397,druid,balance,36,17,19
Weisslogia,aegwynn,1397,druid,balance,71,33,38
Druidboss,tarren-mill,1396,druid,balance,90,50,40
Nujus,kazzak,1394,druid,balance,30,15,15
Puppen,alakir,1392,druid,balance,24,15,9
Kénshin,blackhand,1392,druid,balance,30,15,15
Fluffykin,defias-brotherhood,1391,druid,balance,36,21,15
Кашаган,howling-fjord,1391,druid,balance,69,39,30
Anhoq,silvermoon,1391,druid,balance,64,33,31
Жибка,howling-fjord,1391,druid,balance,44,21,23
Шубаиздуба,howling-fjord,1390,druid,balance,72,38,34
Buhuu,blackmoore,1390,druid,balance,98,50,48
Natoro,outland,1389,druid,balance,36,19,17
Pantheraa,twisting-nether,1388,druid,balance,55,35,20
Cowárd,blackmoore,1388,druid,balance,38,18,20
Couleaf,stormscale,1387,druid,balance,31,22,9
Zhyra,arathor,1387,druid,balance,36,19,17
Icetep,sargeras,1386,druid,balance,60,30,30
Arrakiz,sanguino,1385,druid,balance,59,41,18
Джоннчек,gordunni,1385,druid,balance,46,29,17
Catsgomeow,outland,1382,druid,balance,54,27,27
Drazefin,twisting-nether,1382,druid,balance,42,15,27
Мурдермашин,deathguard,1381,druid,balance,36,15,21
Convoke,burning-legion,1380,druid,balance,42,18,24
Brujo,azjolnerub,1379,druid,balance,36,15,21
Salseo,uldum,1377,druid,balance,72,46,26
Boomzter,frostmane,1376,druid,balance,42,20,22
Rexiehunty,aszune,1376,druid,balance,59,28,31
Karolg,tyrande,1376,druid,balance,69,30,39
Данилсахарок,soulflayer,1376,druid,balance,47,20,27
Farmerone,tarren-mill,1373,druid,balance,96,54,42
Тёмныйзверь,borean-tundra,1373,druid,balance,84,43,41
Aliandrel,teldrassil,1372,druid,balance,42,27,15
Megaball,sylvanas,1372,druid,balance,72,44,28
Jarko,ysondre,1372,druid,balance,104,46,58
Оудин,blackscar,1371,druid,balance,36,21,15
Neova,dun-modr,1371,druid,balance,57,29,28
Pø,blackrock,1371,druid,balance,59,26,33
Owlcápown,ravencrest,1370,druid,balance,30,15,15
Mayhh,ragnaros,1369,druid,balance,143,79,64
Patchlølx,blackmoore,1367,druid,balance,51,31,20
Chrîslol,twisting-nether,1366,druid,balance,103,49,54
Arreton,silvermoon,1365,druid,balance,22,15,7
Shìrò,kelthuzad,1365,druid,balance,48,24,24
Альмазар,lich-king,1364,druid,balance,76,40,36
Jaile,burning-legion,1363,druid,balance,28,18,10
Heanra,frostmane,1363,druid,balance,35,22,13
Ðiàblos,nemesis,1363,druid,balance,72,41,31
Yungle,stormscale,1363,druid,balance,48,20,28
Druiddamage,the-maelstrom,1362,druid,balance,224,117,107
Ketama,sylvanas,1362,druid,balance,60,30,30
Irishdemón,ravencrest,1360,druid,balance,90,47,43
Vulyr,outland,1359,druid,balance,107,57,50
Aryitu,blackrock,1357,druid,balance,62,33,29
Catmøm,blackmoore,1357,druid,balance,94,47,47
Амахасла,deathweaver,1356,druid,balance,67,38,29
Kermit,die-aldor,1356,druid,balance,90,42,48
Nyetoo,dun-modr,1355,druid,balance,85,38,47
Ennelle,silvermoon,1353,druid,balance,38,23,15
Endoth,blackrock,1352,druid,balance,38,20,18
Mercmydude,ravencrest,1351,druid,balance,93,44,49
Zhroomx,blackmoore,1351,druid,balance,44,20,24
Xclonedotcom,aegwynn,1348,druid,balance,42,27,15
Druidere,outland,1348,druid,balance,66,32,34
Freakyo,blackrock,1347,druid,balance,29,15,14
Bum,ravencrest,1344,druid,balance,18,14,4
Divref,tarren-mill,1343,druid,balance,18,14,4
Corrupthz,outland,1343,druid,balance,27,16,11
Broxisqt,blackrock,1343,druid,balance,24,14,10
Wenciorek,kazzak,1343,druid,balance,36,17,19
Suppencaster,frostwolf,1342,druid,balance,18,14,4
Heav,kiljaeden,1342,druid,balance,29,19,10
Pôpcorn,ragnaros,1342,druid,balance,54,33,21
Kissachtak,blackrock,1341,druid,balance,18,14,4
Kuraina,the-maelstrom,1341,druid,balance,18,14,4
Ноунэймбич,blackscar,1341,druid,balance,24,14,10
Huxleyys,draenor,1339,druid,balance,24,14,10
Santoniq,dun-morogh,1339,druid,balance,162,79,83
Shiffe,argent-dawn,1338,druid,balance,24,14,10
Doublesunday,thrall,1338,druid,balance,27,15,12
Kittyboomy,burning-blade,1338,druid,balance,69,33,36
Rifthy,nemesis,1337,druid,balance,24,14,10
Insanexp,antonidas,1336,druid,balance,19,14,5
Nuqa,thrall,1336,druid,balance,21,15,6
Bazikk,kazzak,1336,druid,balance,58,41,17
Illebra,defias-brotherhood,1336,druid,balance,24,14,10
Chrevarraige,saurfang,1334,druid,balance,192,99,93
Tigerroll,kazzak,1334,druid,balance,30,14,16
Beamgødx,thrall,1333,druid,balance,22,15,7
Забурсчу,howling-fjord,1333,druid,balance,30,20,10
Wizår,outland,1332,druid,balance,18,14,4
When,kirin-tor,1332,druid,balance,55,27,28
Strix,dun-modr,1332,druid,balance,36,14,22
Soward,la-croisade-écarlate,1331,druid,balance,38,17,21
Deetaa,eredar,1330,druid,balance,24,14,10
Barbielolz,archimonde,1330,druid,balance,24,14,10
Stìck,archimonde,1330,druid,balance,65,34,31
Stêvé,silvermoon,1329,druid,balance,74,43,31
Kunya,tarren-mill,1329,druid,balance,116,55,61
Mirikastiko,korgall,1328,druid,balance,24,14,10
Ralffoosa,auchindoun,1328,druid,balance,24,14,10
Древогрут,howling-fjord,1325,druid,balance,18,14,4
Birb,archimonde,1325,druid,balance,29,17,12
Kâllîsto,eredar,1325,druid,balance,30,14,16
Cráck,nagrand,1324,druid,balance,28,15,13
Fruntimmern,sylvanas,1323,druid,balance,24,14,10
Экстазиус,borean-tundra,1321,druid,balance,42,14,28
Shag,archimonde,1319,druid,balance,36,17,19
Lucidx,blackrock,1319,druid,balance,54,20,34
Rinjindin,eredar,1318,druid,balance,48,25,23
Кекичшрекич,soulflayer,1318,druid,balance,54,25,29
Wildthing,blackmoore,1316,druid,balance,44,25,19
Srkameltouss,sanguino,1315,druid,balance,18,14,4
Pavesino,nemesis,1315,druid,balance,24,15,9
Kimba,onyxia,1315,druid,balance,66,36,30
Bløødax,hyjal,1315,druid,balance,136,64,72
Fejgi,stormreaver,1314,druid,balance,48,29,19
Fäcker,blackhand,1313,druid,balance,48,27,21
Hideinbushh,ravencrest,1309,druid,balance,20,15,5
Усыильвиры,soulflayer,1309,druid,balance,30,14,16
Zzblaah,archimonde,1309,druid,balance,42,15,27
Yomosh,eredar,1308,druid,balance,39,19,20
Губкобоб,galakrond,1307,druid,balance,34,16,18
Buffmeplz,medivh,1304,druid,balance,24,15,9
Solarian,ravencrest,1304,druid,balance,42,26,16
Toondog,doomhammer,1303,druid,balance,24,14,10
Cieniuu,burning-legion,1302,druid,balance,24,16,8
Шадарлогот,gordunni,1300,druid,balance,90,52,38
Æîîs,blackrock,1300,druid,balance,104,53,51
Sazo,elune,1300,druid,balance,28,14,14
Transformerr,silvermoon,1300,druid,balance,54,25,29
Fantaclause,tarren-mill,1298,druid,balance,194,95,99
Snedden,silvermoon,1298,druid,balance,31,14,17
Zeifana,khaz-modan,1297,druid,balance,30,18,12
Oiseth,tarren-mill,1297,druid,balance,78,36,42
Callmev,hyjal,1294,druid,balance,18,14,4
Tubi,darksorrow,1292,druid,balance,30,16,14
Aastal,uldaman,1292,druid,balance,37,15,22
Lindémann,blackhand,1291,druid,balance,44,30,14
Ðãddy,ravencrest,1291,druid,balance,38,24,14
Forestrun,sylvanas,1287,druid,balance,48,30,18
Nakkikastike,magtheridon,1287,druid,balance,36,19,17
Quiksx,blackrock,1286,druid,balance,43,20,23
Ralokian,drakthul,1285,druid,balance,53,34,19
Zindaya,blades-edge,1284,druid,balance,32,16,16
Shaize,dalaran,1283,druid,balance,26,17,9
Scottparker,sylvanas,1282,druid,balance,36,24,12
Fhi,antonidas,1281,druid,balance,42,23,19
Hadoukan,ravencrest,1281,druid,balance,41,22,19
Trydru,blackmoore,1281,druid,balance,90,46,44
Forigiver,draenor,1280,druid,balance,24,14,10
Myex,exodar,1280,druid,balance,30,14,16
Smøuler,sanguino,1279,druid,balance,27,15,12
Jeesman,sylvanas,1279,druid,balance,74,41,33
Ххансолл,gordunni,1279,druid,balance,131,69,62
Астраджет,gordunni,1279,druid,balance,30,15,15
Seysso,silvermoon,1279,druid,balance,90,39,51
Voorhess,blackmoore,1278,druid,balance,36,14,22
Àlec,silvermoon,1276,druid,balance,132,72,60
Droodfarm,hyjal,1275,druid,balance,70,37,33
Disclaimed,twisting-nether,1274,druid,balance,26,15,11
Meezy,ragnaros,1273,druid,balance,30,15,15
Antiseptik,ysondre,1273,druid,balance,36,17,19
Rektjin,stormscale,1273,druid,balance,42,17,25
Slaskêt,tarren-mill,1272,druid,balance,22,14,8
Revølter,kazzak,1272,druid,balance,32,15,17
Wtcseven,eredar,1272,druid,balance,36,16,20
Delmond,sylvanas,1272,druid,balance,50,21,29
Àsúnâ,eredar,1272,druid,balance,42,15,27
Chugs,draenor,1271,druid,balance,30,16,14
Doomkin,tichondrius,1271,druid,balance,36,17,19
Hardí,tarren-mill,1268,druid,balance,60,28,32
Atbõs,stormscale,1267,druid,balance,29,16,13
Duhdudu,thrall,1266,druid,balance,30,20,10
Melyo,blackmoore,1265,druid,balance,36,21,15
Caltvalai,ravencrest,1265,druid,balance,28,14,14
Ohndankalan,kazzak,1265,druid,balance,48,20,28
Tytankon,silvermoon,1264,druid,balance,73,32,41
Petju,darksorrow,1262,druid,balance,48,21,27
Toffyfee,anetheron,1260,druid,balance,38,25,13
Bambøué,khaz-modan,1260,druid,balance,24,14,10
Succee,stormscale,1259,druid,balance,90,47,43
Achre,thunderhorn,1259,druid,balance,30,14,16
Hushorde,twisting-nether,1259,druid,balance,48,17,31
Bearhúg,kazzak,1258,druid,balance,35,15,20
Braokhull,stormscale,1256,druid,balance,54,28,26
Ваандри,gordunni,1255,druid,balance,24,16,8
Rullader,draenor,1255,druid,balance,36,23,13
Нэйроуз,howling-fjord,1254,druid,balance,95,49,46
Medreas,argent-dawn,1253,druid,balance,71,46,25
Whísperclaw,ravencrest,1253,druid,balance,60,31,29
Demizeub,archimonde,1252,druid,balance,72,30,42
Mascraxx,earthen-ring,1249,druid,balance,73,38,35
Zuldram,uldaman,1249,druid,balance,29,14,15
Киллиманжаро,howling-fjord,1249,druid,balance,116,55,61
Tygra,blackrock,1248,druid,balance,18,13,5
Slurmms,sylvanas,1248,druid,balance,126,75,51
Iupa,silvermoon,1248,druid,balance,59,33,26
Luphrekmeow,ravencrest,1247,druid,balance,18,13,5
Lílpèëpgødx,archimonde,1247,druid,balance,18,13,5
Jeaylqt,archimonde,1247,druid,balance,21,14,7
Replicusowl,doomhammer,1247,druid,balance,24,13,11
Rozi,draenor,1247,druid,balance,24,13,11
Whêylon,ragnaros,1247,druid,balance,24,13,11
Mariss25076F,chogall,1246,druid,balance,30,18,12
Mazalot,kazzak,1246,druid,balance,25,14,11
Beutow,archimonde,1246,druid,balance,30,13,17
Xkirtach,dun-modr,1245,druid,balance,24,13,11
Djràkèâlòt,ravencrest,1244,druid,balance,18,13,5
Eranor,archimonde,1243,druid,balance,18,13,5
Ateli,kazzak,1243,druid,balance,21,14,7
Smittly,bloodhoof,1243,druid,balance,36,17,19
Velnens,shattered-halls,1243,druid,balance,66,30,36
Guccicken,garona,1242,druid,balance,18,13,5
Clonorrhea,tarren-mill,1242,druid,balance,24,13,11
Máedhros,ravencrest,1241,druid,balance,18,13,5
Mahwi,das-konsortium,1241,druid,balance,18,13,5
Vrill,kazzak,1241,druid,balance,99,51,48
Füsselviech,frostwolf,1239,druid,balance,18,13,5
Kikïnøu,garona,1239,druid,balance,24,13,11
Fangornn,outland,1239,druid,balance,30,13,17
Lunarveil,draenor,1236,druid,balance,24,13,11
Morphael,ravencrest,1233,druid,balance,24,13,11
Makelsi,tarren-mill,1233,druid,balance,29,14,15
Amici,eredar,1232,druid,balance,24,13,11
Мунмунмун,gordunni,1229,druid,balance,43,19,24
Psycloniac,ravencrest,1228,druid,balance,24,13,11
Oxox,defias-brotherhood,1227,druid,balance,24,14,10
Ðoxi,draenor,1226,druid,balance,120,58,62
Maurana,sylvanas,1225,druid,balance,30,13,17
Sheâ,nemesis,1221,druid,balance,126,63,63
Bulma,dun-modr,1220,druid,balance,36,15,21
Rayðii,archimonde,1219,druid,balance,44,24,20
Dancingrain,ravencrest,1219,druid,balance,30,13,17
Certton,arakarahm,1218,druid,balance,75,36,39
Artío,the-maelstrom,1215,druid,balance,69,32,37
Balzàc,ravencrest,1213,druid,balance,42,23,19
Weregoon,blackmoore,1213,druid,balance,57,21,36
Avior,eonar,1213,druid,balance,53,18,35
Vasilona,sanguino,1211,druid,balance,24,13,11
Мяурицао,howling-fjord,1210,druid,balance,98,54,44
Challi,nordrassil,1210,druid,balance,24,13,11
Cagaboliches,sanguino,1208,druid,balance,30,14,16
Zerofrenzy,hyjal,1207,druid,balance,142,60,82
Trollskee,draenor,1205,druid,balance,36,16,20
Астралъх,gordunni,1205,druid,balance,36,15,21
Eliaster,ysondre,1204,druid,balance,30,18,12
Coogee,malganis,1201,druid,balance,44,20,24
Gardenstate,silvermoon,1200,druid,balance,42,26,16
Altix,blackmoore,1200,druid,balance,48,26,22
Søfiaa,argent-dawn,1199,druid,balance,131,74,57
Wolfhealer,blackmoore,1198,druid,balance,42,24,18
Malammore,burning-legion,1195,druid,balance,77,49,28
Shåmssz,kazzak,1194,druid,balance,20,15,5
Sarkophag,blackrock,1193,druid,balance,36,13,23
Trollisha,mannoroth,1191,druid,balance,32,17,15
Suranaelle,argent-dawn,1190,druid,balance,38,19,19
Exactt,blackrock,1189,druid,balance,43,17,26
Dêesse,archimonde,1188,druid,balance,42,20,22
Uglydruid,drakthul,1187,druid,balance,110,57,53
Ærîs,garona,1185,druid,balance,58,24,34
Drrestospec,tarren-mill,1182,druid,balance,34,22,12
Laylie,aegwynn,1182,druid,balance,29,13,16
Blesya,ravencrest,1182,druid,balance,39,15,24
Ohpfo,outland,1181,druid,balance,17,13,4
Chulainn,sylvanas,1181,druid,balance,24,18,6
Deadmorph,ysondre,1178,druid,balance,27,14,13
Mööñ,hyjal,1177,druid,balance,22,14,8
Doggerz,aggra-português,1177,druid,balance,72,36,36
Farodiin,blackmoore,1177,druid,balance,48,18,30
Larbre,dalaran,1176,druid,balance,43,29,14
Fey,stormrage,1174,druid,balance,35,13,22
Попестовали,gordunni,1172,druid,balance,33,19,14
Trickpotato,terrordar,1172,druid,balance,42,24,18
Лякокля,soulflayer,1172,druid,balance,42,22,20
Mehgyver,ravencrest,1172,druid,balance,26,13,13
Maelinou,archimonde,1168,druid,balance,36,19,17
ßalmain,nethersturm,1163,druid,balance,36,20,16
Máilo,aegwynn,1158,druid,balance,60,23,37
Toxida,antonidas,1157,druid,balance,71,35,36
Haginator,twisting-nether,1157,druid,balance,102,48,54
Northstar,sylvanas,1156,druid,balance,18,13,5
Dremdra,draenor,1156,druid,balance,48,19,29
Gnotten,thunderhorn,1154,druid,balance,23,13,10
Conn,ravencrest,1153,druid,balance,27,16,11
Clonecity,ravencrest,1152,druid,balance,12,12,0
Afky,stormreaver,1152,druid,balance,18,12,6
Lêviàthäñ,blackhand,1152,druid,balance,24,12,12
Minado,outland,1151,druid,balance,12,12,0
Boomdruud,tarren-mill,1151,druid,balance,18,12,6
Renzay,ysondre,1151,druid,balance,18,12,6
Lodikum,defias-brotherhood,1151,druid,balance,18,12,6
Куколдос,eversong,1151,druid,balance,18,12,6
Vârima,ravencrest,1151,druid,balance,18,12,6
Bigfeeder,ravencrest,1151,druid,balance,20,12,8
Øwlkin,ravencrest,1151,druid,balance,24,12,12
Lazermonster,tarren-mill,1151,druid,balance,24,12,12
Fabutwo,blackrock,1151,druid,balance,24,12,12
Friidaf,lightbringer,1151,druid,balance,24,12,12
Bigbrrd,outland,1150,druid,balance,18,12,6
Deblin,ragnaros,1148,druid,balance,41,23,18
Drdudu,dun-morogh,1148,druid,balance,32,15,17
Putitimoriri,pozzo-delleternità,1147,druid,balance,30,21,9
Leafsandstuf,ragnaros,1147,druid,balance,18,12,6
Limmiited,ravencrest,1147,druid,balance,60,28,32
Iamramen,blackmoore,1147,druid,balance,82,35,47
Rabbalala,twisting-nether,1147,druid,balance,30,12,18
Cowxoxo,twisting-nether,1147,druid,balance,30,12,18
Nexirøs,hyjal,1146,druid,balance,12,12,0
Mnqn,ravencrest,1146,druid,balance,18,12,6
Merq,ravencrest,1146,druid,balance,18,12,6
Lunel,arathor,1146,druid,balance,24,12,12
Hïrøshïmå,malganis,1146,druid,balance,24,12,12
Ashär,kirin-tor,1146,druid,balance,75,33,42
Tjoepert,azjolnerub,1146,druid,balance,96,41,55
Meretrizx,kazzak,1145,druid,balance,24,12,12
Aestûs,outland,1145,druid,balance,24,12,12
Doruido,rashgarroth,1145,druid,balance,30,12,18
Sháko,dun-modr,1144,druid,balance,38,17,21
Mythiaran,argent-dawn,1144,druid,balance,30,12,18
Meuhtéki,hyjal,1143,druid,balance,18,12,6
Wartôn,blackhand,1143,druid,balance,46,24,22
Criaø,blackrock,1143,druid,balance,24,12,12
Hefdgaharald,antonidas,1141,druid,balance,24,12,12
Requinymph,ravencrest,1141,druid,balance,24,12,12
Loriann,twisting-nether,1141,druid,balance,75,36,39
Ibêx,blackmoore,1139,druid,balance,18,12,6
Blueedood,twisting-nether,1139,druid,balance,24,12,12
Shiotake,hyjal,1139,druid,balance,24,12,12
Schneéeule,blackrock,1138,druid,balance,30,12,18
Zoxen,nefarian,1138,druid,balance,30,12,18
Bztémor,archimonde,1137,druid,balance,24,12,12
Сейтил,deathguard,1137,druid,balance,73,31,42
Gluqt,outland,1135,druid,balance,54,21,33
Putzé,blackrock,1134,druid,balance,35,16,19
Kizilbuka,ragnaros,1133,druid,balance,30,21,9
Мутаборец,howling-fjord,1133,druid,balance,56,33,23
Blark,sylvanas,1133,druid,balance,30,12,18
Quoting,ravencrest,1132,druid,balance,29,12,17
Lonedrood,blackrock,1130,druid,balance,24,12,12
Bluebanana,bronzebeard,1128,druid,balance,48,20,28
Eyune,tarren-mill,1127,druid,balance,39,19,20
Youngjin,ravencrest,1126,druid,balance,18,12,6
Pretender,arathi,1123,druid,balance,40,13,27
Tankis,dalaran,1118,druid,balance,62,36,26
Fâucon,eitrigg,1115,druid,balance,22,13,9
Bénjî,khazgoroth,1114,druid,balance,60,26,34
Taskingoman,twisting-nether,1113,druid,balance,24,12,12
Happysw,thrall,1113,druid,balance,74,28,46
Дайтеполено,howling-fjord,1112,druid,balance,70,30,40
Jabah,silvermoon,1111,druid,balance,18,12,6
Morlas,kazzak,1111,druid,balance,50,22,28
Laiquaril,ravencrest,1111,druid,balance,31,12,19
Gallorath,draenor,1110,druid,balance,28,12,16
Two,silvermoon,1106,druid,balance,67,34,33
Hightotem,hakkar,1104,druid,balance,29,16,13
Ooxx,rashgarroth,1104,druid,balance,29,12,17
Roroa,ravencrest,1102,druid,balance,21,12,9
Aionx,ravencrest,1101,druid,balance,23,12,11
Phatbushy,silvermoon,1096,druid,balance,27,12,15
Krausz,burning-legion,1094,druid,balance,24,17,7
Ruberg,kazzak,1091,druid,balance,21,12,9
Животноеыы,howling-fjord,1089,druid,balance,29,12,17
Бруан,gordunni,1088,druid,balance,47,23,24
Исмалат,howling-fjord,1088,druid,balance,51,24,27
Orchard,silvermoon,1080,druid,balance,24,13,11
Kotomer,defias-brotherhood,1077,druid,balance,129,54,75
Darisom,alexstrasza,1076,druid,balance,219,117,102
Semiflora,silvermoon,1073,druid,balance,30,13,17
Dobradoonga,exodar,1072,druid,balance,21,13,8
Whøðìspélmé,twisting-nether,1071,druid,balance,13,12,1
Negríno,cthun,1067,druid,balance,27,18,9
Buckshee,doomhammer,1066,druid,balance,47,25,22
Cubir,turalyon,1065,druid,balance,23,12,11
Wherismygold,ravencrest,1064,druid,balance,22,12,10
Bjærky,silvermoon,1063,druid,balance,20,12,8
Exiztenz,deathwing,1062,druid,balance,36,18,18
Astralarius,argent-dawn,1061,druid,balance,38,12,26
Ellüna,ravencrest,1060,druid,balance,30,14,16
Потерявшийся,howling-fjord,1059,druid,balance,38,15,23
Amalou,ravencrest,1058,druid,balance,78,38,40
Colibrix,ravencrest,1057,druid,balance,56,20,36
Terrays,the-maelstrom,1056,druid,balance,18,15,3
Zyndril,silvermoon,1056,druid,balance,18,11,7
Cutiepain,kazzak,1055,druid,balance,12,11,1
Drmoe,blackmoore,1055,druid,balance,15,12,3
Maedic,outland,1055,druid,balance,18,11,7
Narkiza,blackhand,1055,druid,balance,18,11,7
Píps,ravencrest,1055,druid,balance,18,11,7
Crittler,forscherliga,1055,druid,balance,18,11,7
Buckmysallz,archimonde,1055,druid,balance,18,11,7
Fatfingerx,blackrock,1055,druid,balance,18,11,7
Speegle,kazzak,1054,druid,balance,18,11,7
Flukeyz,draenor,1054,druid,balance,18,11,7
Felicìty,draenor,1054,druid,balance,18,11,7
Curzex,blackmoore,1054,druid,balance,18,11,7
Oomhammer,darkspear,1054,druid,balance,18,11,7
Zwierzyniec,jaedenar,1053,druid,balance,18,11,7
Lechaource,silvermoon,1053,druid,balance,18,11,7
Нортикус,soulflayer,1053,druid,balance,24,11,13
Jamley,tarren-mill,1053,druid,balance,24,11,13
Varunys,blackrock,1052,druid,balance,18,11,7
Dèxò,blackmoore,1051,druid,balance,24,11,13
Rèchy,blackrock,1051,druid,balance,24,11,13
Gajani,stormscale,1050,druid,balance,18,11,7
Taylorshift,argent-dawn,1050,druid,balance,18,11,7
Bigpopp,kazzak,1050,druid,balance,18,11,7
Aimwaré,ravencrest,1050,druid,balance,24,11,13
Drugnag,blackmoore,1049,druid,balance,18,11,7
Wonderbear,blackrock,1049,druid,balance,18,11,7
Orazien,ravencrest,1049,druid,balance,18,11,7
Soguu,thrall,1049,druid,balance,18,11,7
Wrathofstar,azjolnerub,1048,druid,balance,18,11,7
Skyphi,silvermoon,1048,druid,balance,18,11,7
Tongá,draenor,1048,druid,balance,24,11,13
Tulleku,azjolnerub,1047,druid,balance,21,12,9
Nefariz,dun-modr,1047,druid,balance,24,11,13
Alterejuv,ravencrest,1047,druid,balance,30,11,19
Hengst,laughing-skull,1046,druid,balance,24,11,13
Tílac,eredar,1045,druid,balance,18,11,7
Feraligator,sanguino,1045,druid,balance,105,45,60
Покекек,lich-king,1045,druid,balance,33,14,19
Tchoubouléru,throkferoth,1045,druid,balance,36,13,23
Rorugo,sanguino,1044,druid,balance,18,11,7
Wainl,hyjal,1044,druid,balance,24,11,13
Naone,silvermoon,1044,druid,balance,36,14,22
Høtbøx,aegwynn,1044,druid,balance,33,11,22
Jirenthegrey,antonidas,1043,druid,balance,18,11,7
Bigdx,blackrock,1042,druid,balance,24,11,13
Adoodo,argent-dawn,1041,druid,balance,29,16,13
Ðelnôs,destromath,1041,druid,balance,24,11,13
Elmunia,ravencrest,1041,druid,balance,35,16,19
Kizerx,garona,1039,druid,balance,36,18,18
Månljuset,outland,1035,druid,balance,18,11,7
Hárty,tarren-mill,1035,druid,balance,24,11,13
Sabresheep,twisting-nether,1034,druid,balance,30,11,19
Athenã,blackmoore,1034,druid,balance,35,12,23
Xaeia,aegwynn,1033,druid,balance,18,11,7
Anerol,arthas,1031,druid,balance,36,19,17
Diepauline,aegwynn,1030,druid,balance,42,22,20
Nolak,frostwolf,1030,druid,balance,30,11,19
Dudukush,eredar,1029,druid,balance,43,19,24
Ronî,arthas,1028,druid,balance,30,11,19
Théodên,dalaran,1027,druid,balance,182,91,91
Вёкс,howling-fjord,1023,druid,balance,14,12,2
Hardruid,sanguino,1021,druid,balance,20,12,8
Fx,mazrigos,1018,druid,balance,17,11,6
Makoes,tarren-mill,1018,druid,balance,20,12,8
Nightingalee,stormscale,1018,druid,balance,30,12,18
Ambracer,silvermoon,1016,druid,balance,29,12,17
Bullmarkets,kazzak,1013,druid,balance,24,12,12
Yolobolo,ragnaros,1007,druid,balance,17,11,6
Frenkiej,pozzo-delleternità,1007,druid,balance,24,11,13
Yugene,dun-modr,991,druid,balance,20,11,9
Sløthy,uldum,990,druid,balance,16,11,5
Starcat,defias-brotherhood,988,druid,balance,20,11,9
Druice,tyrande,987,druid,balance,17,11,6
Skvll,silvermoon,987,druid,balance,26,11,15
Venh,forscherliga,982,druid,balance,14,11,3
Bulvai,medivh,979,druid,balance,14,11,3
Melábufes,dun-modr,976,druid,balance,19,11,8
Notsikaan,blackhand,975,druid,balance,25,11,14
Toxicclones,tarren-mill,960,druid,balance,12,10,2
Smokahontas,kilrogg,960,druid,balance,12,10,2
Boomco,stormscale,960,druid,balance,12,10,2
Nàaz,stormscale,960,druid,balance,12,10,2
Vizir,stormscale,960,druid,balance,12,10,2
Moonleaf,burning-steppes,960,druid,balance,12,10,2
Nätsügødxqt,archimonde,960,druid,balance,12,10,2
Rofyx,twisting-nether,960,druid,balance,18,10,8
Shayîa,nozdormu,960,druid,balance,18,10,8
Blackdrd,archimonde,960,druid,balance,18,10,8
Djfukface,ravencrest,960,druid,balance,18,10,8
Амераки,blackscar,960,druid,balance,18,10,8
Shapees,sylvanas,960,druid,balance,18,10,8
Eroxx,blackrock,960,druid,balance,24,10,14
Feralisser,ravencrest,959,druid,balance,12,10,2
Luphrekfurry,ysondre,959,druid,balance,18,10,8
Stalkdro,elune,959,druid,balance,18,10,8
Còwgummi,blackhand,959,druid,balance,18,10,8
Tiktokstar,blackrock,959,druid,balance,18,10,8
Sün,kazzak,959,druid,balance,18,10,8
Littlecok,blackmoore,959,druid,balance,18,10,8
Häggrä,dalaran,959,druid,balance,18,10,8
Ultrapoulet,archimonde,959,druid,balance,18,10,8
Slâkkxz,kazzak,959,druid,balance,18,10,8
Zarune,sanguino,959,druid,balance,18,10,8
Bignunu,silvermoon,959,druid,balance,18,10,8
Focusboomy,archimonde,959,druid,balance,18,10,8
Thepuma,dun-modr,958,druid,balance,12,10,2
Éatshiftndie,tarren-mill,958,druid,balance,18,10,8
Clone,aegwynn,958,druid,balance,18,10,8
Pèps,dalaran,958,druid,balance,18,10,8
Bears,outland,958,druid,balance,18,10,8
Nelíno,twisting-nether,958,druid,balance,18,10,8
Élán,sylvanas,958,druid,balance,24,10,14
Verenai,bloodfeather,957,druid,balance,12,10,2
Джасэл,howling-fjord,957,druid,balance,12,10,2
Coldleans,kazzak,957,druid,balance,12,10,2
Kahar,eredar,957,druid,balance,18,10,8
Gbq,ravencrest,957,druid,balance,18,10,8
Raízun,blackmoore,957,druid,balance,18,10,8
Jokodo,silvermoon,956,druid,balance,18,10,8
Ajgreed,grim-batol,956,druid,balance,18,10,8
Prytek,turalyon,955,druid,balance,18,10,8
Sajlol,doomhammer,955,druid,balance,18,10,8
Feral,mazrigos,955,druid,balance,18,10,8
Katharo,kult-der-verdammten,955,druid,balance,42,12,30
Медведяра,howling-fjord,954,druid,balance,84,38,46
Enolcyc,frostmane,954,druid,balance,24,10,14
Zac,quelthalas,953,druid,balance,18,10,8
Bolskigg,stormreaver,953,druid,balance,24,10,14
Degentiuso,alakir,952,druid,balance,18,10,8
Kaspurr,ravencrest,951,druid,balance,12,10,2
Mlyzioz,ahnqiraj,951,druid,balance,22,11,11
Hypnosoad,outland,951,druid,balance,24,10,14
Yeahbuddeh,draenor,951,druid,balance,28,11,17
Видди,soulflayer,947,druid,balance,24,10,14
Бсуза,soulflayer,947,druid,balance,30,10,20
Yepnesse,khaz-modan,946,druid,balance,18,10,8
Phanos,twisting-nether,945,druid,balance,24,10,14
Bearhugzz,outland,942,druid,balance,287,141,146
Metamorfurio,arthas,939,druid,balance,24,11,13
Nëko,chamber-of-aspects,936,druid,balance,35,10,25
Mâéviss,ysondre,936,druid,balance,36,10,26
Resthunor,draenor,935,druid,balance,18,10,8
Máximus,blades-edge,934,druid,balance,60,20,40
Shainá,dun-modr,930,druid,balance,24,10,14
Yaendra,dun-modr,926,druid,balance,33,14,19
Calistane,silvermoon,926,druid,balance,69,24,45
Numberonebs,silvermoon,925,druid,balance,17,10,7
Veijari,deathwing,925,druid,balance,22,11,11
Saxondale,aszune,918,druid,balance,30,14,16
Cöyote,hyjal,916,druid,balance,54,28,26
Суггуторр,howling-fjord,909,druid,balance,87,42,45
Mushröøms,nemesis,904,druid,balance,27,13,14
Darkillaa,anetheron,902,druid,balance,23,10,13
Древнина,gordunni,901,druid,balance,21,10,11
Flume,chromaggus,896,druid,balance,24,10,14
Durtidikdave,kazzak,895,druid,balance,23,10,13
Dao,aegwynn,893,druid,balance,20,10,10
Smexim,dalaran,876,druid,balance,49,26,23
Aggibääm,blackhand,868,druid,balance,24,12,12
Yshára,darkmoon-faire,864,druid,balance,12,9,3
Flopparider,ravencrest,864,druid,balance,12,9,3
Elandreth,twisting-nether,864,druid,balance,12,9,3
Ròb,magtheridon,864,druid,balance,12,9,3
Bakkú,ravencrest,864,druid,balance,12,9,3
Eftermalm,silvermoon,864,druid,balance,12,9,3
Betobalance,blackmoore,864,druid,balance,12,9,3
Shandala,ragnaros,864,druid,balance,12,9,3
Claynoe,blackmoore,864,druid,balance,15,10,5
Yseraheal,drakthul,864,druid,balance,18,9,9
Svp,ravencrest,864,druid,balance,18,9,9
Tronchetto,nemesis,864,druid,balance,24,9,15
Cioban,ravencrest,864,druid,balance,24,9,15
Jengá,nagrand,863,druid,balance,12,9,3
Lakersinfive,argent-dawn,863,druid,balance,12,9,3
Sakkrethd,hyjal,863,druid,balance,12,9,3
Aolynk,twisting-nether,863,druid,balance,12,9,3
Borticow,sanguino,863,druid,balance,12,9,3
Pezuñera,sanguino,863,druid,balance,12,9,3
Forthis,frostmane,863,druid,balance,18,9,9
Hunterkiller,azjolnerub,863,druid,balance,18,9,9
Lockied,eredar,863,druid,balance,18,9,9
Nymå,outland,863,druid,balance,18,9,9
Damagebot,tarren-mill,863,druid,balance,18,9,9
Кеорл,gordunni,863,druid,balance,18,9,9
Wîzzp,magtheridon,863,druid,balance,18,9,9
Croquetoro,sanguino,863,druid,balance,18,9,9
Moonpoxdru,nerathor,863,druid,balance,18,9,9
Malolepszy,burning-legion,863,druid,balance,24,9,15
Redyogurt,outland,863,druid,balance,24,9,15
Mokujiin,burning-blade,863,druid,balance,24,9,15
Bxxmkin,draenor,862,druid,balance,12,9,3
Hiquien,silvermoon,862,druid,balance,12,9,3
Téddý,tarren-mill,862,druid,balance,18,9,9
Karuck,ravencrest,862,druid,balance,18,9,9
Metaboss,ravencrest,862,druid,balance,18,9,9
Ábomínatíon,draenor,862,druid,balance,18,9,9
Angharradh,arthas,862,druid,balance,18,9,9
Jabbah,defias-brotherhood,862,druid,balance,18,9,9
Qocotte,archimonde,862,druid,balance,18,9,9
Oxe,malganis,861,druid,balance,12,9,3
Noctilus,steamwheedle-cartel,861,druid,balance,18,9,9
Quza,lightbringer,861,druid,balance,18,9,9
Schneelol,outland,861,druid,balance,18,9,9
Wombati,blackrock,861,druid,balance,24,9,15
Drocos,genjuros,860,druid,balance,18,9,9
Spoco,defias-brotherhood,860,druid,balance,18,9,9
Rumjin,burning-blade,859,druid,balance,18,9,9
Хоточник,gordunni,859,druid,balance,24,9,15
Corias,blackmoore,859,druid,balance,36,9,27
Pelagius,ravencrest,858,druid,balance,12,9,3
Дайдорогу,blackscar,857,druid,balance,18,9,9
Grizzlyhills,silvermoon,856,druid,balance,12,9,3
Lunably,silvermoon,855,druid,balance,18,9,9
Freshener,antonidas,854,druid,balance,20,10,10
Erbaiolo,pozzo-delleternità,852,druid,balance,12,9,3
Lootmann,die-silberne-hand,850,druid,balance,18,9,9
Shenzform,ysondre,848,druid,balance,19,11,8
Kucsmagoomba,ragnaros,846,druid,balance,117,52,65
Tombenuit,tarren-mill,843,druid,balance,18,9,9
Rockymarci,dalaran,840,druid,balance,12,9,3
Sethdr,hyjal,840,druid,balance,23,11,12
Tarâkings,outland,832,druid,balance,18,9,9
Сомеваск,deathweaver,830,druid,balance,23,9,14
Eikthyrson,alleria,829,druid,balance,16,10,6
Ribuu,dun-morogh,826,druid,balance,18,9,9
Пушистаялапа,blackscar,824,druid,balance,16,10,6
Split,rexxar,817,druid,balance,20,10,10
Yungtrappy,stormscale,815,druid,balance,15,10,5
Tôrmêñtêd,outland,815,druid,balance,17,9,8
Ishaqu,bladefist,815,druid,balance,23,9,14
Nuggetspøwa,dalaran,814,druid,balance,17,9,8
Burren,auchindoun,810,druid,balance,25,9,16
Ashirae,drakthul,798,druid,balance,14,9,5
Fréki,ravenholdt,791,druid,balance,20,9,11
Rungohar,stormscale,791,druid,balance,34,9,25
Kakaiy,shadowsong,784,druid,balance,96,43,53
Tritit,marécage-de-zangar,768,druid,balance,12,8,4
Treeswinger,twisting-nether,768,druid,balance,12,8,4
Positivity,stormscale,768,druid,balance,12,8,4
Khiree,archimonde,768,druid,balance,12,8,4
Jometatile,hyjal,768,druid,balance,12,8,4
Jónahfalcon,draenor,768,druid,balance,12,8,4
Soofiaa,ravencrest,768,druid,balance,12,8,4
Yiriy,baelgun,768,druid,balance,12,8,4
Ðíør,ravencrest,768,druid,balance,12,8,4
Ethiqd,aegwynn,768,druid,balance,12,8,4
Barneycatz,tarren-mill,768,druid,balance,12,8,4
Meillaeth,sylvanas,768,druid,balance,12,8,4
Cryspie,garona,768,druid,balance,12,8,4
Клыкояр,goldrinn,768,druid,balance,12,8,4
Mîrxy,outland,768,druid,balance,12,8,4
Moksy,outland,768,druid,balance,12,8,4
Kissaey,emeriss,768,druid,balance,12,8,4
Gsix,blackrock,768,druid,balance,12,8,4
Pjuske,silvermoon,768,druid,balance,12,8,4
Admeliora,ravencrest,768,druid,balance,12,8,4
Everdreamx,arathor,768,druid,balance,12,8,4
Emochicken,silvermoon,768,druid,balance,15,9,6
Epicplays,sylvanas,768,druid,balance,18,8,10
Superpoulet,archimonde,768,druid,balance,18,8,10
Réhagen,archimonde,768,druid,balance,18,8,10
Boompjeh,chamber-of-aspects,768,druid,balance,18,8,10
Commonsense,kazzak,768,druid,balance,18,8,10
Xtremeterror,blackmoore,767,druid,balance,12,8,4
Sebikboomie,ravencrest,767,druid,balance,12,8,4
Cîalîs,blackmoore,767,druid,balance,12,8,4
Salvagã,outland,767,druid,balance,12,8,4
Rengár,blackrock,767,druid,balance,12,8,4
Seasexsune,antonidas,767,druid,balance,12,8,4
Dëåd,zenedar,767,druid,balance,12,8,4
Kheleñ,blackrock,767,druid,balance,14,8,6
Bogahcan,twisting-nether,767,druid,balance,18,8,10
Snoxy,wrathbringer,767,druid,balance,18,8,10
Phanÿ,garona,767,druid,balance,18,8,10
Царапкатян,gordunni,767,druid,balance,18,8,10
Ilovehannah,laughing-skull,767,druid,balance,18,8,10
Bigsmoké,die-aldor,767,druid,balance,18,8,10
Asrais,dun-modr,767,druid,balance,18,8,10
Hugepepega,ravencrest,767,druid,balance,18,8,10
Eýesburn,silvermoon,767,druid,balance,18,8,10
Arydan,quelthalas,767,druid,balance,18,8,10
Isotopîa,antonidas,767,druid,balance,18,8,10
Loswochos,blackmoore,767,druid,balance,18,8,10
Schebäb,blackhand,767,druid,balance,24,8,16
Irithel,ravencrest,766,druid,balance,12,8,4
Stormspirit,hellscream,766,druid,balance,12,8,4
Humanoidpt,aggra-português,766,druid,balance,12,8,4
Doctóras,twisting-nether,766,druid,balance,12,8,4
Benzinoid,silvermoon,766,druid,balance,12,8,4
Vandalís,garrosh,766,druid,balance,12,8,4
Freefang,dun-modr,766,druid,balance,12,8,4
Коктявзер,deathweaver,766,druid,balance,18,8,10
Obois,archimonde,766,druid,balance,18,8,10
Kheluna,the-maelstrom,766,druid,balance,18,8,10
Lendron,malygos,766,druid,balance,23,8,15
Polimorphism,tarren-mill,766,druid,balance,24,8,16
Pansarbamse,outland,766,druid,balance,25,8,17
Darthiud,outland,765,druid,balance,12,8,4
Wiligun,archimonde,765,druid,balance,12,8,4
Machie,argent-dawn,765,druid,balance,18,8,10
Arenshimoon,kazzak,765,druid,balance,18,8,10
Zaratras,arathor,765,druid,balance,18,8,10
Raszcal,blackhand,765,druid,balance,18,8,10
Droodu,dun-modr,765,druid,balance,30,8,22
Cirwen,silvermoon,764,druid,balance,12,8,4
Mongobongo,onyxia,764,druid,balance,12,8,4
Fiberpäls,magtheridon,764,druid,balance,18,8,10
Teldrastion,silvermoon,764,druid,balance,30,8,22
Dwaokut,ravencrest,763,druid,balance,12,8,4
Cobradrood,culte-de-la-rive-noire,763,druid,balance,18,8,10
Карантини,howling-fjord,763,druid,balance,21,9,12
Anchoring,argent-dawn,763,druid,balance,22,9,13
Vigôuróuz,blackmoore,762,druid,balance,12,8,4
Moonsama,twisting-nether,762,druid,balance,24,8,16
Sároman,ravencrest,761,druid,balance,24,8,16
Lothadriel,sylvanas,760,druid,balance,18,8,10
Celebras,chogall,756,druid,balance,12,8,4
Drudd,hellscream,751,druid,balance,23,8,15
Swolecat,ravencrest,749,druid,balance,23,8,15
Fakers,the-maelstrom,747,druid,balance,12,8,4
Ратататата,blackscar,734,druid,balance,14,9,5
Litany,drakthul,731,druid,balance,17,8,9
Vaea,hyjal,731,druid,balance,26,9,17
Treepoloski,stormscale,719,druid,balance,15,9,6
Maw,hellfire,717,druid,balance,11,8,3
Cörelly,ravencrest,715,druid,balance,15,9,6
Humizon,silvermoon,714,druid,balance,21,9,12
Elpresidénté,blackmoore,713,druid,balance,12,9,3
Rain,kazzak,703,druid,balance,11,8,3
Rønièl,tarren-mill,702,druid,balance,11,8,3
Papalegba,kilrogg,700,druid,balance,14,8,6
Lörex,ravencrest,687,druid,balance,13,8,5
Хфикс,gordunni,683,druid,balance,13,8,5
Imcasting,doomhammer,672,druid,balance,12,7,5
Glúingél,tarren-mill,672,druid,balance,12,7,5
Mommymìlkers,archimonde,672,druid,balance,12,7,5
Qyoon,argent-dawn,672,druid,balance,12,7,5
Cotangens,tarren-mill,672,druid,balance,12,7,5
Noggelicious,ragnaros,672,druid,balance,12,7,5
Wafflecat,outland,672,druid,balance,12,7,5
Sitruu,zenedar,672,druid,balance,12,7,5
Ìluan,ravencrest,672,druid,balance,12,7,5
Трусырвущая,gordunni,672,druid,balance,12,7,5
Trønchetto,nemesis,672,druid,balance,12,7,5
Sweedrood,hyjal,672,druid,balance,12,7,5
Harrydòtter,eredar,672,druid,balance,12,7,5
Deeizm,ravencrest,672,druid,balance,12,7,5
Underrated,darksorrow,672,druid,balance,12,7,5
Därgon,archimonde,672,druid,balance,12,7,5
Аррерон,howling-fjord,672,druid,balance,12,7,5
Формен,howling-fjord,672,druid,balance,12,7,5
Sasosins,ravencrest,672,druid,balance,12,7,5
Kosadoodoo,sylvanas,672,druid,balance,12,7,5
Noobr,ravencrest,672,druid,balance,12,7,5
Emeskay,ravencrest,672,druid,balance,12,7,5
Surlax,defias-brotherhood,672,druid,balance,12,7,5
Twerkdabooty,azjolnerub,672,druid,balance,12,7,5
Delarion,nemesis,672,druid,balance,12,7,5
Thornat,chamber-of-aspects,672,druid,balance,12,7,5
Locite,blackrock,672,druid,balance,12,7,5
Hajlol,sylvanas,672,druid,balance,12,7,5
Tease,blackrock,672,druid,balance,12,7,5
Adelsten,tarren-mill,672,druid,balance,15,8,7
Pansaa,stormscale,672,druid,balance,15,8,7
Nyenna,twilights-hammer,672,druid,balance,16,8,8
Avimoo,tarren-mill,672,druid,balance,18,7,11
Ravenfang,dun-modr,672,druid,balance,18,7,11
Lilim,culte-de-la-rive-noire,672,druid,balance,18,7,11
Quellwell,outland,672,druid,balance,18,7,11
Lifty,dun-modr,672,druid,balance,18,7,11
Solgarna,saurfang,672,druid,balance,18,7,11
Murenito,nemesis,672,druid,balance,24,7,17
Shreddít,tarren-mill,672,druid,balance,24,7,17
Shehida,silvermoon,671,druid,balance,12,7,5
Лидир,blackscar,671,druid,balance,12,7,5
Maruuk,argent-dawn,671,druid,balance,12,7,5
Rikayn,tarren-mill,671,druid,balance,12,7,5
Halfback,blackhand,671,druid,balance,12,7,5
Найадра,gordunni,671,druid,balance,12,7,5
Yabooni,ravencrest,671,druid,balance,12,7,5
Asura,nozdormu,671,druid,balance,12,7,5
Alexuwu,draenor,671,druid,balance,12,7,5
Pogoth,turalyon,671,druid,balance,12,7,5
Vrillox,blackmoore,671,druid,balance,15,8,7
Fesenjon,blackhand,671,druid,balance,18,7,11
Thunderzeus,mazrigos,671,druid,balance,18,7,11
Kivu,blackrock,671,druid,balance,18,7,11
Picatso,blackrock,671,druid,balance,18,7,11
Yunød,silvermoon,671,druid,balance,18,7,11
Legevakten,grim-batol,671,druid,balance,18,7,11
Felfran,ravencrest,671,druid,balance,18,7,11
Phala,outland,671,druid,balance,18,7,11
Justycare,ragnaros,671,druid,balance,18,7,11
Knindza,tarren-mill,670,druid,balance,12,7,5
Släshes,stormreaver,670,druid,balance,12,7,5
Klatu,doomhammer,670,druid,balance,24,7,17
Jevcoh,area-52,668,druid,balance,12,7,5
Thyanya,blackmoore,668,druid,balance,18,7,11
Jokizy,burning-legion,667,druid,balance,18,7,11
Mondino,blackrock,667,druid,balance,24,7,17
Thrynitie,les-sentinelles,663,druid,balance,12,7,5
Bönüs,cthun,661,druid,balance,12,7,5
Nightshape,kragjin,661,druid,balance,18,7,11
Qra,area-52,660,druid,balance,12,7,5
Kawaíï,frostwolf,659,druid,balance,26,10,16
Ketash,ragnaros,657,druid,balance,12,7,5
Iskaarjx,archimonde,654,druid,balance,17,7,10
Yawawe,blackmoore,638,druid,balance,17,7,10
Abadar,tarren-mill,638,druid,balance,20,8,12
Nille,tarren-mill,617,druid,balance,14,8,6
Blazek,sylvanas,617,druid,balance,14,8,6
Kidawi,frostwolf,617,druid,balance,16,8,8
Kamatea,eredar,607,druid,balance,11,7,4
Bubidiblumdr,twisting-nether,605,druid,balance,16,7,9
Músclébéach,silvermoon,605,druid,balance,22,7,15
Rtfz,ravencrest,591,druid,balance,13,7,6
Ухухуня,gordunni,576,druid,balance,6,6,0
Dreamdoll,ravencrest,576,druid,balance,6,6,0
Zamans,silvermoon,576,druid,balance,6,6,0
Флаффер,soulflayer,576,druid,balance,6,6,0
Qpoof,sylvanas,576,druid,balance,6,6,0
Risuoksa,tarren-mill,576,druid,balance,6,6,0
Mentaldead,tarren-mill,576,druid,balance,12,6,6
Vedee,tarren-mill,576,druid,balance,12,6,6
Maníx,tarren-mill,576,druid,balance,12,6,6
Vongihkuhher,blackmoore,576,druid,balance,12,6,6
Dyuuna,hyjal,576,druid,balance,12,6,6
Ipossible,kazzak,576,druid,balance,12,6,6
Diolives,stormscale,576,druid,balance,12,6,6
Kamenká,aegwynn,576,druid,balance,12,6,6
Degnosaur,outland,576,druid,balance,12,6,6
Lèthal,arakarahm,576,druid,balance,12,6,6
Tonie,stormscale,576,druid,balance,12,6,6
Thefudge,silvermoon,576,druid,balance,12,6,6
Sajah,outland,576,druid,balance,12,6,6
Talressian,argent-dawn,576,druid,balance,12,6,6
Лунныйфилин,deathguard,576,druid,balance,12,6,6
Wrx,sylvanas,576,druid,balance,12,6,6
Ghostdoggie,stormscale,576,druid,balance,12,6,6
Knozylg,kazzak,576,druid,balance,12,6,6
Valoruk,ravencrest,576,druid,balance,12,6,6
Naturexbot,silvermoon,576,druid,balance,12,6,6
Pælter,draenor,576,druid,balance,12,6,6
Димитруа,howling-fjord,576,druid,balance,12,6,6
Nancey,auchindoun,576,druid,balance,12,6,6
Bildukas,ravencrest,576,druid,balance,12,6,6
Teryx,blackmoore,576,druid,balance,12,6,6
Quinten,ulduar,576,druid,balance,12,6,6
Pataleaqtp,sanguino,576,druid,balance,12,6,6
Póllen,magtheridon,576,druid,balance,12,6,6
Emidrem,ravencrest,576,druid,balance,12,6,6
Seraxi,der-mithrilorden,576,druid,balance,12,6,6
Fèéli,twisting-nether,576,druid,balance,12,6,6
Orious,dun-modr,576,druid,balance,12,6,6
Bane,dun-modr,576,druid,balance,12,6,6
Islandbôy,blackrock,576,druid,balance,12,6,6
Мунпраид,gordunni,576,druid,balance,12,6,6
Amrul,hyjal,576,druid,balance,12,6,6
Salvaga,outland,576,druid,balance,12,6,6
Lushe,kazzak,576,druid,balance,12,6,6
Fishanchips,archimonde,576,druid,balance,12,6,6
Зулкхаку,soulflayer,576,druid,balance,12,6,6
Yalojr,blackmoore,576,druid,balance,12,6,6
Inbml,silvermoon,576,druid,balance,12,6,6
Shoca,die-ewige-wacht,576,druid,balance,12,6,6
Axrae,ravencrest,576,druid,balance,18,6,12
Disney,ragnaros,576,druid,balance,18,6,12
Doncaino,amanthul,576,druid,balance,18,6,12
Aureliusx,drakthul,576,druid,balance,18,6,12
Smedoge,outland,576,druid,balance,18,6,12
Mugwa,blackmoore,575,druid,balance,6,6,0
Sojiz,outland,575,druid,balance,12,6,6
Òniz,hyjal,575,druid,balance,12,6,6
Graffyrre,eonar,575,druid,balance,12,6,6
Kleinii,blackrock,575,druid,balance,12,6,6
Helguard,silvermoon,575,druid,balance,12,6,6
Лицеторг,howling-fjord,575,druid,balance,12,6,6
Tekal,vashj,575,druid,balance,12,6,6
Grinnox,outland,575,druid,balance,12,6,6
Gruvkatt,stormscale,575,druid,balance,12,6,6
Praythysun,khaz-modan,575,druid,balance,12,6,6
Maniek,defias-brotherhood,575,druid,balance,12,6,6
Dinamitko,silvermoon,575,druid,balance,12,6,6
Raxona,blackmoore,575,druid,balance,12,6,6
Flagvan,ravencrest,575,druid,balance,13,6,7
Barkskin,grim-batol,575,druid,balance,15,6,9
Robinchwän,archimonde,575,druid,balance,18,6,12
Thruf,nemesis,575,druid,balance,18,6,12
Аматэррасу,blackscar,575,druid,balance,18,6,12
Дарзамат,blackscar,575,druid,balance,18,6,12
Aimïn,sanguino,575,druid,balance,18,6,12
Wardruíd,outland,575,druid,balance,24,6,18
Lucianis,drakthul,575,druid,balance,24,6,18
Lúthiëñ,silvermoon,575,druid,balance,24,6,18
Kimiza,hyjal,575,druid,balance,25,6,19
Тиликум,goldrinn,574,druid,balance,12,6,6
Raciness,grim-batol,574,druid,balance,12,6,6
Momaa,neptulon,574,druid,balance,12,6,6
Apodruid,tarren-mill,574,druid,balance,12,6,6
Derie,nazjatar,574,druid,balance,12,6,6
Tyreek,eredar,574,druid,balance,16,7,9
Жекакотик,eversong,574,druid,balance,24,6,18
Bareforms,medivh,573,druid,balance,12,6,6
Kittasek,drakthul,572,druid,balance,12,6,6
Tarantinonon,kazzak,572,druid,balance,18,6,12
Keltaris,dun-modr,565,druid,balance,12,6,6
Delfin,aerie-peak,563,druid,balance,21,7,14
Thaiboimbyy,veknilash,558,druid,balance,29,10,19
Duwaz,blackmoore,543,druid,balance,14,7,7
Ancientix,burning-legion,543,druid,balance,17,6,11
Blamer,thrall,527,druid,balance,17,6,11
Fotmrerollér,darksorrow,510,druid,balance,8,6,2
Фэк,eversong,509,druid,balance,10,6,4
Bigdambitex,draenor,480,druid,balance,6,5,1
Ferdiboo,draenor,480,druid,balance,6,5,1
Smøkyyd,eredar,480,druid,balance,6,5,1
Corkiri,tarren-mill,480,druid,balance,6,5,1
Éxy,kazzak,480,druid,balance,6,5,1
Murdok,suramar,480,druid,balance,6,5,1
Boomytunes,silvermoon,480,druid,balance,6,5,1
Tshungubuäch,eredar,480,druid,balance,6,5,1
Huayhey,the-maelstrom,480,druid,balance,6,5,1
Hashtagone,ysondre,480,druid,balance,6,5,1
Stkk,sanguino,480,druid,balance,6,5,1
Cowieowie,draenor,480,druid,balance,6,5,1
Bighike,drakthul,480,druid,balance,6,5,1
Ashidx,ragnaros,480,druid,balance,6,5,1
Catsareevil,silvermoon,480,druid,balance,6,5,1
Smølboi,ravencrest,480,druid,balance,6,5,1
Ñêkø,ravencrest,480,druid,balance,6,5,1
Svartvit,sylvanas,480,druid,balance,6,5,1
Brittmagi,sylvanas,480,druid,balance,6,5,1
Liften,blackhand,480,druid,balance,6,5,1
Хлайси,gordunni,480,druid,balance,6,5,1
Опущеныйкелх,gordunni,480,druid,balance,6,5,1
Clawlessqtx,outland,480,druid,balance,6,5,1
Corkiy,tarren-mill,480,druid,balance,6,5,1
Азраешль,gordunni,480,druid,balance,6,5,1
Papacarlo,ravencrest,480,druid,balance,6,5,1
Brbrøyk,tarren-mill,480,druid,balance,6,5,1
Myxo,aggra-português,480,druid,balance,6,5,1
Xhifty,ravencrest,480,druid,balance,6,5,1
Nyrrh,blackmoore,480,druid,balance,6,5,1
Sonjin,burning-legion,480,druid,balance,6,5,1
Pinkpanda,arthas,480,druid,balance,6,5,1
Ïmåkêïtråïñ,ravencrest,480,druid,balance,6,5,1
Whaazzform,tarren-mill,480,druid,balance,6,5,1
Tåylor,laughing-skull,480,druid,balance,6,5,1
Zulrája,outland,480,druid,balance,6,5,1
Súçúkbøømíe,aegwynn,480,druid,balance,6,5,1
Daisyx,eredar,480,druid,balance,9,6,3
Ischumekcid,anubarak,480,druid,balance,9,6,3
Dabär,mannoroth,480,druid,balance,10,6,4
Brunogösta,aerie-peak,480,druid,balance,12,5,7
Ассайоу,gordunni,480,druid,balance,12,5,7
Shawkz,kazzak,480,druid,balance,12,5,7
Yadon,the-maelstrom,480,druid,balance,12,5,7
Naturina,shattered-hand,480,druid,balance,12,5,7
Bafere,twisting-nether,480,druid,balance,12,5,7
Hairydøtter,aegwynn,480,druid,balance,12,5,7
Lifecycle,nemesis,480,druid,balance,12,5,7
Fofosdru,kazzak,480,druid,balance,12,5,7
Doup,alakir,480,druid,balance,12,5,7
Theridrax,twisting-nether,480,druid,balance,12,5,7
Tomixdd,stormrage,480,druid,balance,12,5,7
Yööi,nemesis,480,druid,balance,12,5,7
Лолэтохег,soulflayer,480,druid,balance,12,5,7
Balanced,blackhand,480,druid,balance,12,5,7
Shreddies,the-maelstrom,480,druid,balance,12,5,7
Liiandri,khaz-modan,480,druid,balance,12,5,7
Feraline,stormrage,480,druid,balance,12,5,7
Флексим,soulflayer,480,druid,balance,12,5,7
Variolus,dun-modr,480,druid,balance,12,5,7
Robsondruid,twisting-nether,480,druid,balance,12,5,7
Zomgcow,twisting-nether,480,druid,balance,12,5,7
Димадубощит,blackscar,480,druid,balance,12,5,7
Zebår,runetotem,480,druid,balance,12,5,7
Yabbah,blackrock,480,druid,balance,12,5,7
Goated,stormscale,480,druid,balance,12,5,7
Nyooxix,blackmoore,480,druid,balance,12,5,7
Angrykejton,silvermoon,480,druid,balance,12,5,7
Kovalawa,archimonde,480,druid,balance,12,5,7
Quisp,ravencrest,480,druid,balance,12,5,7
Caddan,argent-dawn,480,druid,balance,12,5,7
Quin,frostwolf,480,druid,balance,12,5,7
Acwi,dun-morogh,480,druid,balance,12,5,7
Xërxës,outland,480,druid,balance,12,5,7
Elayria,blackmoore,480,druid,balance,12,5,7
Grîsh,burning-legion,480,druid,balance,12,5,7
Polymorphler,theradras,480,druid,balance,12,5,7
Mîraculix,dun-morogh,480,druid,balance,12,5,7
Zephris,grim-batol,480,druid,balance,12,5,7
Elrandir,tarren-mill,480,druid,balance,12,5,7
Elekträ,ravencrest,480,druid,balance,15,6,9
Qïx,outland,480,druid,balance,15,6,9
Vodibull,aegwynn,480,druid,balance,15,6,9
Lemonjohn,outland,480,druid,balance,14,5,9
Miyá,sylvanas,480,druid,balance,18,5,13
Zeromario,draenor,480,druid,balance,18,5,13
Mazzawii,kazzak,480,druid,balance,18,5,13
Surgeshift,ravencrest,480,druid,balance,18,5,13
Teog,stormreaver,480,druid,balance,18,5,13
Aloraysoda,doomhammer,480,druid,balance,30,5,25
Faedria,outland,479,druid,balance,6,5,1
Zinnform,ragnaros,479,druid,balance,12,5,7
Biologie,onyxia,479,druid,balance,12,5,7
Larsia,nordrassil,479,druid,balance,12,5,7
Sinmanos,eredar,479,druid,balance,12,5,7
Betol,das-konsortium,479,druid,balance,12,5,7
Fallingmoon,ravencrest,479,druid,balance,18,5,13
Тахикамару,blackscar,479,druid,balance,18,5,13
Вилдвестганс,howling-fjord,478,druid,balance,12,5,7
Lysende,arathor,478,druid,balance,12,5,7
Чепенкос,gordunni,478,druid,balance,12,5,7
Druza,draenor,478,druid,balance,12,5,7
Барли,grom,478,druid,balance,16,6,10
Druvian,argent-dawn,478,druid,balance,24,5,19
Zenkay,naxxramas,476,druid,balance,16,6,10
Stanjr,archimonde,476,druid,balance,18,5,13
Закарпаття,galakrond,475,druid,balance,10,6,4
Krakus,twisting-nether,473,druid,balance,12,5,7
Spellmáster,ravencrest,473,druid,balance,12,5,7
Drix,frostwolf,463,druid,balance,17,5,12
Chouan,marécage-de-zangar,457,druid,balance,21,7,14
Karyaga,tarren-mill,431,druid,balance,14,6,8
Pine,aggramar,415,druid,balance,8,5,3
Foxîo,frostmane,415,druid,balance,8,5,3
Ragingmilker,tarren-mill,415,druid,balance,8,5,3
Tomyn,burning-legion,384,druid,balance,6,4,2
Womzas,blackhand,384,druid,balance,6,4,2
Fzx,aegwynn,384,druid,balance,6,4,2
Freedonnad,alleria,384,druid,balance,6,4,2
Daluria,malganis,384,druid,balance,6,4,2
Sunisan,stormscale,384,druid,balance,6,4,2
Hefnerd,grim-batol,384,druid,balance,6,4,2
Kkriss,stormscale,384,druid,balance,6,4,2
Cpt,xavius,384,druid,balance,6,4,2
Lucidz,kazzak,384,druid,balance,6,4,2
Mylanqx,ragnaros,384,druid,balance,6,4,2
Freshpussyz,ravencrest,384,druid,balance,6,4,2
Tharae,blackmoore,384,druid,balance,6,4,2
Kasugia,aegwynn,384,druid,balance,6,4,2
Sapheà,burning-legion,384,druid,balance,6,4,2
Geizagobble,twisting-nether,384,druid,balance,6,4,2
Bigbitez,kazzak,384,druid,balance,6,4,2
Dermegon,outland,384,druid,balance,6,4,2
Vertabrain,twilights-hammer,384,druid,balance,6,4,2
Petypeet,drakthul,384,druid,balance,6,4,2
Loasamdi,tarren-mill,384,druid,balance,6,4,2
Weremyst,outland,384,druid,balance,6,4,2
Dmgtràsh,dun-modr,384,druid,balance,6,4,2
Noodledru,tarren-mill,384,druid,balance,6,4,2
Djbéámgódx,ravencrest,384,druid,balance,6,4,2
Haarbál,tarren-mill,384,druid,balance,6,4,2
Aelins,twisting-nether,384,druid,balance,6,4,2
Hyoyoe,stormreaver,384,druid,balance,6,4,2
Xvmon,draenor,384,druid,balance,6,4,2
Feign,blackmoore,384,druid,balance,6,4,2
Mâlcøm,archimonde,384,druid,balance,6,4,2
Bearygrylls,sylvanas,384,druid,balance,6,4,2
Lolaven,turalyon,384,druid,balance,6,4,2
Nizrã,archimonde,384,druid,balance,6,4,2
Jwifgodx,archimonde,384,druid,balance,6,4,2
Ponardo,outland,384,druid,balance,6,4,2
Rugsul,kazzak,384,druid,balance,6,4,2
Shapeit,blackrock,384,druid,balance,6,4,2
Zootxd,ravencrest,384,druid,balance,6,4,2
Shiftmeow,tarren-mill,384,druid,balance,6,4,2
Jp,eredar,384,druid,balance,6,4,2
Fordragos,ravencrest,384,druid,balance,6,4,2
Cmzdruidxdd,ravencrest,384,druid,balance,6,4,2
Dikc,twisting-nether,384,druid,balance,6,4,2
Lunor,kazzak,384,druid,balance,6,4,2
Kattbjörnen,ragnaros,384,druid,balance,6,4,2
Ekologiskxx,outland,384,druid,balance,6,4,2
Wotahn,antonidas,384,druid,balance,6,4,2
Rawr,dun-morogh,384,druid,balance,6,4,2
Druikraut,silvermoon,384,druid,balance,6,4,2
Amellian,silvermoon,384,druid,balance,6,4,2
Stoptheclone,nordrassil,384,druid,balance,6,4,2
Buikstuk,kilrogg,384,druid,balance,6,4,2
Skavenlol,zuljin,384,druid,balance,6,4,2
Drufar,outland,384,druid,balance,6,4,2
Izzyb,draenor,384,druid,balance,6,4,2
Spatchy,silvermoon,384,druid,balance,6,4,2
Inspira,teldrassil,384,druid,balance,6,4,2
Treebearded,agamaggan,384,druid,balance,6,4,2
Euphoríax,ravencrest,384,druid,balance,10,5,5
Фамай,howling-fjord,384,druid,balance,8,4,4
Astralbody,auchindoun,384,druid,balance,12,4,8
Roxshifter,tarren-mill,384,druid,balance,12,4,8
Bellatrx,darksorrow,384,druid,balance,12,4,8
Ralenia,ravencrest,384,druid,balance,12,4,8
Феразинария,gordunni,384,druid,balance,12,4,8
Tmhaikyu,blackhand,384,druid,balance,12,4,8
Koffee,archimonde,384,druid,balance,12,4,8
Leyarin,argent-dawn,384,druid,balance,12,4,8
Lorucka,die-nachtwache,384,druid,balance,12,4,8
Piiti,burning-legion,384,druid,balance,12,4,8
Pathetik,archimonde,384,druid,balance,12,4,8
Sixtyinches,burning-blade,384,druid,balance,12,4,8
Màlàkaii,hyjal,384,druid,balance,12,4,8
Kiggstar,blackmoore,384,druid,balance,12,4,8
Elainx,thrall,384,druid,balance,12,4,8
Woopi,blackrock,384,druid,balance,12,4,8
Alanpapi,sanguino,384,druid,balance,12,4,8
Ibroninad,ragnaros,384,druid,balance,12,4,8
Ninoboyswag,stormscale,384,druid,balance,12,4,8
Gwendalyr,silvermoon,384,druid,balance,12,4,8
Druidytrudy,blackrock,384,druid,balance,12,4,8
Manimalia,kazzak,384,druid,balance,12,4,8
Yee,twisting-nether,384,druid,balance,12,4,8
Allîyâ,archimonde,384,druid,balance,12,4,8
Fortuma,eredar,384,druid,balance,12,4,8
Boomlex,defias-brotherhood,384,druid,balance,12,4,8
Rastamona,draenor,384,druid,balance,12,4,8
Mauzicek,drakthul,384,druid,balance,12,4,8
Telära,argent-dawn,384,druid,balance,12,4,8
Amhro,ragnaros,384,druid,balance,12,4,8
Tønychopper,sanguino,384,druid,balance,12,4,8
Мукару,howling-fjord,384,druid,balance,12,4,8
Astracat,korgall,384,druid,balance,12,4,8
Kasiopee,hyjal,384,druid,balance,12,4,8
Zeldaa,antonidas,384,druid,balance,14,4,10
Мехнакиске,howling-fjord,384,druid,balance,14,4,10
Ednaqt,grim-batol,384,druid,balance,18,4,14
Храмульчик,blackscar,383,druid,balance,6,4,2
Elm,trollbane,383,druid,balance,6,4,2
Котангис,eversong,383,druid,balance,6,4,2
Herten,tarren-mill,383,druid,balance,6,4,2
Mongwau,blackrock,383,druid,balance,6,4,2
Hecaloth,drakthul,383,druid,balance,6,4,2
Fluke,thrall,383,druid,balance,11,4,7
Summertearz,thrall,383,druid,balance,12,4,8
Ondope,blackmoore,383,druid,balance,12,4,8
Moonpouk,archimonde,383,druid,balance,12,4,8
Blablábla,silvermoon,383,druid,balance,12,4,8
Rústy,baelgun,383,druid,balance,12,4,8
Sodniss,aggra-português,383,druid,balance,14,4,10
Катафей,deathguard,382,druid,balance,6,4,2
Wuki,conseil-des-ombres,379,druid,balance,12,4,8
Billybobb,dentarg,377,druid,balance,19,8,11
Neincat,sylvanas,367,druid,balance,11,4,7
Ráw,dun-modr,367,druid,balance,11,4,7
Gôdzîllâ,silvermoon,352,druid,balance,10,4,6
Blakemonster,khaz-modan,351,druid,balance,8,5,3
Zybri,ragnaros,351,druid,balance,11,4,7
Nightshaðe,argent-dawn,351,druid,balance,11,4,7
Oaeb,stormscale,351,druid,balance,11,4,7
Soný,aegwynn,336,druid,balance,9,5,4
Blownaway,outland,336,druid,balance,9,4,5
Sketit,grim-batol,335,druid,balance,11,4,7
Hilliax,sanguino,330,druid,balance,13,5,8
Martinesämst,outland,320,druid,balance,10,4,6
Holyconvoke,stormscale,319,druid,balance,5,4,1
Eclipße,silvermoon,319,druid,balance,5,4,1
Olula,blackmoore,319,druid,balance,8,4,4
Ahylles,antonidas,288,druid,balance,6,3,3
Flower,aggramar,288,druid,balance,6,3,3
Catgirlx,ravencrest,288,druid,balance,6,3,3
Framoin,archimonde,288,druid,balance,6,3,3
Сэнтэс,soulflayer,288,druid,balance,6,3,3
Irfrayl,antonidas,288,druid,balance,6,3,3
Sucukk,antonidas,288,druid,balance,6,3,3
Jubbs,laughing-skull,288,druid,balance,6,3,3
Junglelist,antonidas,288,druid,balance,6,3,3
Zagrem,antonidas,288,druid,balance,6,3,3
Lærken,the-maelstrom,288,druid,balance,6,3,3
Блэкфорест,gordunni,288,druid,balance,6,3,3
Fayn,aggra-português,288,druid,balance,6,3,3
Garudas,eldrethalas,288,druid,balance,6,3,3
Erelieva,silvermoon,288,druid,balance,6,3,3
Yezzir,defias-brotherhood,288,druid,balance,6,3,3
Ciwone,blackrock,288,druid,balance,6,3,3
Блинчек,gordunni,288,druid,balance,6,3,3
Faqbàdi,twisting-nether,288,druid,balance,6,3,3
Baubles,ghostlands,288,druid,balance,6,3,3
Måckïngsx,the-maelstrom,288,druid,balance,6,3,3
Bäckey,silvermoon,288,druid,balance,6,3,3
Treksta,draenor,288,druid,balance,6,3,3
Tribemeister,twisting-nether,288,druid,balance,6,3,3
Уэсериктх,blackscar,288,druid,balance,6,3,3
Fishe,twisting-nether,288,druid,balance,6,3,3
Rêdx,archimonde,288,druid,balance,6,3,3
Heejåe,archimonde,288,druid,balance,6,3,3
Shermi,eredar,288,druid,balance,6,3,3
Sweqt,argent-dawn,288,druid,balance,6,3,3
Quinteness,silvermoon,288,druid,balance,6,3,3
Yeats,blackmoore,288,druid,balance,6,3,3
Heldil,chants-éternels,288,druid,balance,6,3,3
Hð,blackmoore,288,druid,balance,6,3,3
Gnarrdrood,eredar,288,druid,balance,6,3,3
Blietmachine,ravencrest,288,druid,balance,6,3,3
Hordepwnr,sylvanas,288,druid,balance,6,3,3
Sparkex,ravencrest,288,druid,balance,6,3,3
Seey,thrall,288,druid,balance,6,3,3
Testopöllö,ravencrest,288,druid,balance,6,3,3
Ullainho,stormscale,288,druid,balance,6,3,3
Barbulloup,hyjal,288,druid,balance,6,3,3
Cyclonejk,blackrock,288,druid,balance,6,3,3
Исканет,gordunni,288,druid,balance,6,3,3
Veilath,tarren-mill,288,druid,balance,6,3,3
Phike,blackrock,288,druid,balance,6,3,3
Garbagemonky,amanthul,288,druid,balance,6,3,3
Motry,tarren-mill,288,druid,balance,6,3,3
Jungleghost,sylvanas,288,druid,balance,6,3,3
Hippycraft,the-maelstrom,288,druid,balance,6,3,3
Вооми,gordunni,288,druid,balance,6,3,3
Worsteux,blackrock,288,druid,balance,6,3,3
Drester,blackrock,288,druid,balance,6,3,3
Bámbí,sylvanas,288,druid,balance,6,3,3
Nóque,ravencrest,288,druid,balance,6,3,3
Jazeera,ragnaros,288,druid,balance,6,3,3
Llcooljay,ravencrest,288,druid,balance,6,3,3
Urilmæ,blackmoore,288,druid,balance,6,3,3
Stiffýz,archimonde,288,druid,balance,6,3,3
Mogwaî,arygos,288,druid,balance,6,3,3
Катяблум,gordunni,288,druid,balance,6,3,3
Tsikarde,ravencrest,288,druid,balance,6,3,3
Maldrýn,stormscale,288,druid,balance,6,3,3
Jac,blackhand,288,druid,balance,6,3,3
Блиденг,gordunni,288,druid,balance,6,3,3
Durlehardu,archimonde,288,druid,balance,6,3,3
Vodkavodkaa,tarren-mill,288,druid,balance,6,3,3
Vyzir,stormscale,288,druid,balance,6,3,3
Mikeisbike,ragnaros,288,druid,balance,6,3,3
Зонкс,gordunni,288,druid,balance,6,3,3
Vícvega,ravencrest,288,druid,balance,6,3,3
Ilus,outland,288,druid,balance,6,3,3
Eysnd,blackrock,288,druid,balance,6,3,3
Àyóorts,archimonde,288,druid,balance,6,3,3
Auden,arathor,288,druid,balance,6,3,3
Amakary,blackrock,288,druid,balance,6,3,3
Alillaeth,ravencrest,288,druid,balance,6,3,3
Nareeik,tarren-mill,288,druid,balance,6,3,3
Løgbjørnen,tarren-mill,288,druid,balance,6,3,3
Cursedmee,blackrock,288,druid,balance,6,3,3
Svantte,stormreaver,288,druid,balance,6,3,3
Druidat,kazzak,288,druid,balance,6,3,3
Dabulla,kazzak,288,druid,balance,6,3,3
Wasïro,zuljin,288,druid,balance,6,3,3
Kooglaash,kazzak,288,druid,balance,6,3,3
Leslra,agamaggan,288,druid,balance,6,3,3
Byjiblznuk,kazzak,288,druid,balance,6,3,3
Rbg,dun-modr,288,druid,balance,6,3,3
Kvngthegoat,kazzak,288,druid,balance,6,3,3
Cáptnmorgan,blackmoore,288,druid,balance,6,3,3
Djclonebot,kazzak,288,druid,balance,6,3,3
Furíouz,darksorrow,288,druid,balance,9,4,5
Bootydrooty,thrall,288,druid,balance,9,3,6
Baracüda,draenor,288,druid,balance,12,3,9
Astarhot,cthun,288,druid,balance,12,3,9
Loverace,dun-modr,288,druid,balance,12,3,9
Akkamory,terokkar,288,druid,balance,12,3,9
Kidow,wrathbringer,288,druid,balance,12,3,9
Сэднхорни,howling-fjord,288,druid,balance,12,3,9
Tayswiftmend,defias-brotherhood,288,druid,balance,12,3,9
Groncowski,blackmoore,288,druid,balance,12,3,9
Zuwyldxd,blackrock,288,druid,balance,12,3,9
Astralcaller,kazzak,288,druid,balance,12,3,9
Thaneo,blackmoore,288,druid,balance,12,3,9
Segundø,archimonde,288,druid,balance,12,3,9
Сейдр,grom,288,druid,balance,18,3,15
Dasgrandeur,kazzak,287,druid,balance,6,3,3
Bigcappa,ahnqiraj,287,druid,balance,6,3,3
Walkao,tarren-mill,287,druid,balance,6,3,3
Millworgen,norgannon,286,druid,balance,12,3,9
Jhiun,ragnaros,256,druid,balance,4,4,0
Calligenia,antonidas,256,druid,balance,16,3,13
Bóssít,doomhammer,255,druid,balance,11,3,8
Drulius,tarren-mill,240,druid,balance,9,4,5
Sinyi,arathor,239,druid,balance,11,3,8
Qoatazinha,malganis,192,druid,balance,4,3,1
Baccon,ravencrest,192,druid,balance,6,2,4
Foxglove,ravencrest,192,druid,balance,6,2,4
Natzuri,lothar,192,druid,balance,6,2,4
Twodaysordie,ravencrest,192,druid,balance,6,2,4
Zolduran,archimonde,192,druid,balance,6,2,4
Halfaway,ravencrest,192,druid,balance,6,2,4
Trueforms,ravencrest,192,druid,balance,6,2,4
Rootbeamftw,ravencrest,192,druid,balance,6,2,4
Bidochonne,ravencrest,192,druid,balance,6,2,4
Ultimoos,aggra-português,192,druid,balance,6,2,4
Hotributionx,ravencrest,192,druid,balance,6,2,4
Dresten,burning-blade,192,druid,balance,6,2,4
Borne,aggra-português,192,druid,balance,6,2,4
Killxhard,ravencrest,192,druid,balance,6,2,4
Hâyâbusa,antonidas,192,druid,balance,6,2,4
Varìx,ysondre,192,druid,balance,6,2,4
Faetish,hyjal,192,druid,balance,6,2,4
Tallbutshort,stormscale,192,druid,balance,6,2,4
Chickenrice,blackhand,192,druid,balance,6,2,4
Chupapoya,pozzo-delleternità,192,druid,balance,6,2,4
Galgaan,burning-legion,192,druid,balance,6,2,4
Violess,burning-legion,192,druid,balance,6,2,4
Jaffacakeqt,draenor,192,druid,balance,6,2,4
Jimmyxdd,kazzak,192,druid,balance,6,2,4
Tranduiil,drakthul,192,druid,balance,6,2,4
Lïlara,elune,192,druid,balance,6,2,4
Jordnötssmör,draenor,192,druid,balance,6,2,4
Werevolf,drakthul,192,druid,balance,6,2,4
Harrasmoes,ravencrest,192,druid,balance,6,2,4
Jflow,draenor,192,druid,balance,6,2,4
Meatus,ragnaros,192,druid,balance,6,2,4
Lyj,dalaran,192,druid,balance,6,2,4
Chzycow,twisting-nether,192,druid,balance,6,2,4
Maxreflect,pozzo-delleternità,192,druid,balance,6,2,4
Erkerkerk,twisting-nether,192,druid,balance,6,2,4
Filderah,doomhammer,192,druid,balance,6,2,4
Roidcat,twisting-nether,192,druid,balance,6,2,4
Akiíra,twisting-nether,192,druid,balance,6,2,4
Уличныйиисус,azuregos,192,druid,balance,6,2,4
Chickenboss,sanguino,192,druid,balance,6,2,4
Снэйк,borean-tundra,192,druid,balance,6,2,4
Имбахилка,lich-king,192,druid,balance,6,2,4
Spidete,sanguino,192,druid,balance,6,2,4
Feraflux,dragonblight,192,druid,balance,6,2,4
Pawnamera,norgannon,192,druid,balance,6,2,4
Nilatsfloda,quelthalas,192,druid,balance,6,2,4
Versality,lightnings-blade,192,druid,balance,6,2,4
Mmhcharal,voljin,192,druid,balance,6,2,4
Blacksage,dragonmaw,192,druid,balance,6,2,4
Дробовик,soulflayer,192,druid,balance,6,2,4
Катали,soulflayer,192,druid,balance,6,2,4
Старселлер,gordunni,192,druid,balance,6,2,4
Kwenden,arygos,192,druid,balance,6,2,4
Друнуар,gordunni,192,druid,balance,6,2,4
Энокей,gordunni,192,druid,balance,6,2,4
Natuh,outland,192,druid,balance,6,2,4
Tamburoo,tarren-mill,192,druid,balance,6,2,4
Luveena,kazzak,192,druid,balance,6,2,4
Druidbox,ravencrest,192,druid,balance,6,2,4
Maxiturbogay,stormscale,192,druid,balance,6,2,4
Фераладзе,gordunni,192,druid,balance,6,2,4
Leliaen,sylvanas,192,druid,balance,6,2,4
Deezforms,kazzak,192,druid,balance,6,2,4
Луноэльф,gordunni,192,druid,balance,6,2,4
Маалир,gordunni,192,druid,balance,6,2,4
Biggestbirdx,stormscale,192,druid,balance,6,2,4
Héryse,hyjal,192,druid,balance,6,2,4
Wheyproteín,dun-modr,192,druid,balance,6,2,4
Kotkacy,silvermoon,192,druid,balance,6,2,4
Tadoson,blackmoore,192,druid,balance,6,2,4
Fromeden,silvermoon,192,druid,balance,6,2,4
Csmedruid,blackrock,192,druid,balance,6,2,4
Skrewu,silvermoon,192,druid,balance,6,2,4
Canezmvp,blackrock,192,druid,balance,6,2,4
Deadlydudu,magtheridon,192,druid,balance,6,2,4
Brømberry,blackrock,192,druid,balance,6,2,4
Auntypat,defias-brotherhood,192,druid,balance,6,2,4
Avanishri,defias-brotherhood,192,druid,balance,6,2,4
Epidruid,stormrage,192,druid,balance,6,2,4
Trowbsi,blackmoore,192,druid,balance,6,2,4
Sorkoxd,silvermoon,192,druid,balance,6,2,4
Kaamirach,blackmoore,192,druid,balance,6,2,4
Fanboij,kazzak,192,druid,balance,6,2,4
Saliencias,kazzak,192,druid,balance,6,2,4
Energäde,twisting-nether,192,druid,balance,7,2,5
Gurranq,argent-dawn,192,druid,balance,11,3,8
Aceeu,dalaran,192,druid,balance,9,2,7
Lelyssa,burning-legion,192,druid,balance,12,2,10
Onmyass,dragonblight,192,druid,balance,12,2,10
Shapeshiptur,argent-dawn,192,druid,balance,12,2,10
Darksthero,draenor,192,druid,balance,12,2,10
Hävefunny,archimonde,192,druid,balance,12,2,10
Leekroom,forscherliga,192,druid,balance,12,2,10
Trækvinden,ravencrest,192,druid,balance,12,2,10
Kramit,ravencrest,192,druid,balance,12,2,10
Querasidru,ravencrest,192,druid,balance,12,2,10
Broasted,stormscale,192,druid,balance,12,2,10
Plankface,ravencrest,192,druid,balance,19,3,16
Sumbahe,blackrock,191,druid,balance,6,2,4
Catbear,kazzak,191,druid,balance,6,2,4
Myrddil,kult-der-verdammten,191,druid,balance,12,2,10
Silvacustos,teldrassil,191,druid,balance,12,2,10
Arrock,malfurion,191,druid,balance,12,2,10
Vendeqt,aegwynn,159,druid,balance,5,2,3
Fabsl,archimonde,159,druid,balance,5,2,3
Иосси,soulflayer,138,druid,balance,9,5,4
Покусаютебя,gordunni,138,druid,balance,10,3,7
Tekilaz,sanguino,128,druid,balance,4,2,2
Xaahl,archimonde,128,druid,balance,4,2,2
Ligoz,silvermoon,96,druid,balance,3,2,1
Nayemi,blackmoore,96,druid,balance,6,1,5
Skinnyleg,baelgun,96,druid,balance,6,1,5
Lemónde,outland,96,druid,balance,6,1,5
Cattdamon,outland,96,druid,balance,6,1,5
Dreathie,kazzak,96,druid,balance,6,1,5
Wolfverine,dentarg,96,druid,balance,6,1,5
Môõn,tarren-mill,96,druid,balance,6,1,5
Ashiothie,argent-dawn,96,druid,balance,6,1,5
Leronox,blackmoore,96,druid,balance,6,1,5
Shalysae,silvermoon,96,druid,balance,6,1,5
Beginníng,outland,96,druid,balance,6,1,5
Anahita,emerald-dream,96,druid,balance,6,1,5
Ösdru,tarren-mill,96,druid,balance,6,1,5
Summër,los-errantes,96,druid,balance,6,1,5
Kaira,kazzak,96,druid,balance,6,1,5
Pudseytree,doomhammer,96,druid,balance,6,1,5
Ãnimal,argent-dawn,96,druid,balance,6,1,5
Scarykejton,draenor,96,druid,balance,6,1,5
Apojeanne,hyjal,96,druid,balance,6,1,5
Sorath,aggramar,96,druid,balance,6,1,5
Tigerbalm,ravenholdt,96,druid,balance,6,1,5
Blazor,eredar,96,druid,balance,6,1,5
Dramweida,eredar,96,druid,balance,6,1,5
Ayven,kazzak,96,druid,balance,6,1,5
Lilkâzzam,blackrock,96,druid,balance,6,1,5
Brownny,dun-modr,96,druid,balance,6,1,5
Panigale,dun-modr,96,druid,balance,6,1,5
Devióus,twilights-hammer,96,druid,balance,6,1,5
Tykè,outland,96,druid,balance,6,1,5
Druidlaba,drakthul,96,druid,balance,6,1,5
Whelpss,archimonde,96,druid,balance,6,1,5
Samuelito,ravencrest,96,druid,balance,6,1,5
Ayanakamurà,archimonde,96,druid,balance,6,1,5
Nermax,kazzak,96,druid,balance,6,1,5
Liegremmah,blackmoore,96,druid,balance,6,1,5
Druiduis,minahonda,96,druid,balance,6,1,5
Tortugo,dun-modr,96,druid,balance,6,1,5
Tàazz,sargeras,96,druid,balance,6,1,5
Droodzerqt,archimonde,96,druid,balance,6,1,5
Enia,azjolnerub,96,druid,balance,6,1,5
Fakeztwo,eredar,96,druid,balance,6,1,5
Арбузир,howling-fjord,96,druid,balance,6,1,5
Reyk,sunstrider,96,druid,balance,6,1,5
Druidja,sylvanas,96,druid,balance,6,1,5
Сверххищникк,soulflayer,96,druid,balance,6,1,5
Маминапуська,soulflayer,96,druid,balance,6,1,5
Hotseîdank,blackrock,96,druid,balance,6,1,5
Spielmann,ravencrest,96,druid,balance,6,1,5
Razah,ravencrest,96,druid,balance,6,1,5
Herekitykity,frostmane,96,druid,balance,6,1,5
Ghxsty,silvermoon,96,druid,balance,6,1,5
Garudax,blackrock,96,druid,balance,6,1,5
Beatball,aegwynn,96,druid,balance,6,1,5
Xwerzz,stormscale,96,druid,balance,6,1,5
Eredhion,stormscale,96,druid,balance,6,1,5
Blolzz,silvermoon,96,druid,balance,6,1,5
Хенет,blackscar,96,druid,balance,6,1,5
Arún,nazjatar,96,druid,balance,6,1,5
Fullcyclone,stormscale,96,druid,balance,6,1,5
Ra,stormscale,96,druid,balance,6,1,5
Nubsi,aegwynn,96,druid,balance,6,1,5
Frequentist,ragnaros,96,druid,balance,6,1,5
Котябра,gordunni,96,druid,balance,6,1,5
Siahra,khaz-modan,96,druid,balance,6,1,5
Jamaicanherb,bronzebeard,96,druid,balance,6,1,5
Zaerox,ambossar,96,druid,balance,6,1,5
Stjärna,kult-der-verdammten,96,druid,balance,6,1,5
Пасторизсша,soulflayer,96,druid,balance,6,1,5
Stuntgirlcat,pozzo-delleternità,96,druid,balance,6,1,5
Ewena,ragnaros,96,druid,balance,6,1,5
Tarendil,argent-dawn,96,druid,balance,12,1,11
Вэдэшечка,howling-fjord,96,druid,balance,12,1,11
Grynoth,silvermoon,96,druid,balance,12,1,11
Noiir,malfurion,96,druid,balance,12,1,11
Maßka,terokkar,96,druid,balance,12,1,11
Kocovali,frostmane,95,druid,balance,6,1,5
Gawsworth,aerie-peak,95,druid,balance,6,1,5
Mirelawe,stormscale,79,druid,balance,5,1,4
Mûcke,kazzak,79,druid,balance,5,1,4
Revoidý,blackmoore,79,druid,balance,5,1,4
Qb,blackrock,79,druid,balance,5,1,4
Kodobursto,stormscale,79,druid,balance,6,1,5
Ушастикэ,gordunni,64,druid,balance,4,1,3
Soofyan,kazzak,48,druid,balance,3,1,2
Exïlla,archimonde,48,druid,balance,3,1,2
Møønlight,scarshield-legion,48,druid,balance,3,1,2
Mortagua,kazzak,48,druid,balance,3,1,2
Madschinken,malganis,42,druid,balance,8,2,6
Melonjuicer,argent-dawn,42,druid,balance,9,2,7
Tiemyrôpe,outland,31,druid,balance,2,1,1
Shapeshifts,kul-tiras,31,druid,balance,2,1,1
Nalreaa,kazzak,31,druid,balance,8,1,7
Báttlx,blackrock,16,druid,balance,7,1,6
Kankethyr,korgall,2241,evoker,preservation,107,64,43
Гачитварь,galakrond,2194,evoker,preservation,251,130,121
Nesedon,stormscale,2170,evoker,preservation,239,127,112
Bodytypezero,terenas,2169,evoker,preservation,110,62,48
Бедныйгрузин,howling-fjord,2146,evoker,preservation,72,43,29
Zychodrac,draenor,2145,evoker,preservation,148,74,74
Néthy,argent-dawn,2131,evoker,preservation,108,60,48
Sukkmymadnes,draenor,2120,evoker,preservation,79,39,40
Сансетшторм,gordunni,2119,evoker,preservation,88,47,41
Kronata,sanguino,2112,evoker,preservation,102,45,57
Dn,shattered-hand,2111,evoker,preservation,89,46,43
Dragonsweat,hyjal,2088,evoker,preservation,120,66,54
Haxyia,outland,2083,evoker,preservation,120,63,57
Najikí,tarren-mill,2069,evoker,preservation,107,61,46
Ramfurry,kazzak,2045,evoker,preservation,201,107,94
Nerfevøker,ragnaros,2022,evoker,preservation,100,51,49
Humòngóus,kazzak,2008,evoker,preservation,54,29,25
Sinéstrà,antonidas,2005,evoker,preservation,216,111,105
Gardennewt,ravencrest,2001,evoker,preservation,78,39,39
Drogon,shendralar,1992,evoker,preservation,84,48,36
Xays,ravencrest,1987,evoker,preservation,100,50,50
Theories,blackhand,1977,evoker,preservation,110,54,56
Puzikloh,ravencrest,1973,evoker,preservation,42,23,19
Ноубадиаттак,soulflayer,1963,evoker,preservation,102,49,53
Smellybreath,ravencrest,1961,evoker,preservation,48,27,21
Шафлэнжоер,fordragon,1958,evoker,preservation,30,22,8
Rvrsl,outland,1954,evoker,preservation,108,55,53
Podonok,ravencrest,1932,evoker,preservation,84,45,39
Dizablise,burning-legion,1931,evoker,preservation,77,40,37
Seafolk,stormscale,1927,evoker,preservation,217,119,98
Onelastdance,ravencrest,1922,evoker,preservation,71,61,10
Jamesdéan,twisting-nether,1921,evoker,preservation,108,68,40
Dragondaddy,eredar,1917,evoker,preservation,114,63,51
Nahfr,terenas,1905,evoker,preservation,132,75,57
Drookun,outland,1905,evoker,preservation,75,39,36
Dracthal,blackmoore,1903,evoker,preservation,54,29,25
Waifuwu,blackhand,1900,evoker,preservation,175,85,90
Адоннис,gordunni,1891,evoker,preservation,72,43,29
Huxleysroar,draenor,1888,evoker,preservation,54,26,28
Ðåñîq,kazzak,1888,evoker,preservation,89,38,51
Phnx,blackrock,1886,evoker,preservation,246,125,121
Myxiwinxy,archimonde,1885,evoker,preservation,36,23,13
Theories,aegwynn,1880,evoker,preservation,53,29,24
Amadeusx,ravencrest,1879,evoker,preservation,96,47,49
Matrixslave,tarren-mill,1875,evoker,preservation,81,46,35
Vokedrak,eredar,1875,evoker,preservation,66,32,34
Plogi,twisting-nether,1869,evoker,preservation,54,32,22
Nakavoker,arygos,1859,evoker,preservation,115,56,59
Ipho,twisting-nether,1856,evoker,preservation,100,45,55
Titnoute,archimonde,1856,evoker,preservation,60,25,35
Bodytypefour,stormscale,1854,evoker,preservation,66,28,38
Béatér,aegwynn,1852,evoker,preservation,102,58,44
Ltmdrgn,ravencrest,1851,evoker,preservation,42,26,16
Ripgódx,bronzebeard,1851,evoker,preservation,354,182,172
Zimbello,nemesis,1849,evoker,preservation,54,34,20
Myshagini,ravencrest,1846,evoker,preservation,45,27,18
Æzorahai,area-52,1845,evoker,preservation,72,33,39
Bümber,stormscale,1835,evoker,preservation,129,64,65
Yulinex,argent-dawn,1833,evoker,preservation,160,92,68
Cellv,kazzak,1829,evoker,preservation,156,88,68
Jakelóng,ravencrest,1818,evoker,preservation,52,25,27
Justyowxs,archimonde,1817,evoker,preservation,85,49,36
Smâûg,silvermoon,1812,evoker,preservation,48,27,21
Mixn,argent-dawn,1812,evoker,preservation,93,41,52
Gneltharion,draenor,1811,evoker,preservation,68,31,37
Infidus,ravencrest,1810,evoker,preservation,145,82,63
Puffthemagic,archimonde,1810,evoker,preservation,60,28,32
Dragonmeta,kazzak,1808,evoker,preservation,36,19,17
Dreamwalk,archimonde,1806,evoker,preservation,24,19,5
Wakûwakû,kazzak,1805,evoker,preservation,135,72,63
Evokis,tarren-mill,1804,evoker,preservation,71,40,31
Трейш,soulflayer,1804,evoker,preservation,90,42,48
Hornyxj,draenor,1804,evoker,preservation,78,33,45
Keñwøød,ysondre,1803,evoker,preservation,60,33,27
Cptdrakon,twisting-nether,1802,evoker,preservation,77,43,34
Lerrastrasza,zirkel-des-cenarius,1802,evoker,preservation,48,24,24
Sính,ravencrest,1801,evoker,preservation,53,28,25
Alusiedrake,ravencrest,1800,evoker,preservation,295,163,132
Talim,terrordar,1800,evoker,preservation,78,37,41
Phyrrax,silvermoon,1798,evoker,preservation,54,33,21
Elcocodrilo,tarren-mill,1790,evoker,preservation,36,21,15
Лабирон,blackscar,1789,evoker,preservation,54,24,30
Swainsupp,archimonde,1776,evoker,preservation,42,19,23
Yayaxoxoxoxo,hyjal,1775,evoker,preservation,54,25,29
Lazey,stormscale,1769,evoker,preservation,94,50,44
Ezinice,hyjal,1767,evoker,preservation,88,45,43
Антошадф,gordunni,1760,evoker,preservation,54,29,25
Froststraza,chamber-of-aspects,1758,evoker,preservation,60,27,33
Kalevra,eredar,1757,evoker,preservation,123,66,57
Healevoker,aegwynn,1755,evoker,preservation,177,85,92
Хронолиса,blackscar,1752,evoker,preservation,258,133,125
Camdaddy,magtheridon,1749,evoker,preservation,171,88,83
Asyncgosa,ravencrest,1749,evoker,preservation,60,25,35
Elleavo,tarren-mill,1742,evoker,preservation,48,23,25
Baiyuekui,blackmoore,1740,evoker,preservation,375,183,192
Drakela,frostwhisper,1732,evoker,preservation,42,22,20
Themasktw,kazzak,1728,evoker,preservation,64,29,35
Evocy,ravencrest,1725,evoker,preservation,66,35,31
Däkuookami,twisting-nether,1716,evoker,preservation,24,18,6
Bugdul,twisting-nether,1713,evoker,preservation,74,46,28
Даэдра,gordunni,1712,evoker,preservation,186,94,92
Ранкондракон,lich-king,1712,evoker,preservation,95,42,53
Maxthecar,draenor,1710,evoker,preservation,136,87,49
Branados,argent-dawn,1707,evoker,preservation,36,22,14
Novvae,hyjal,1704,evoker,preservation,60,32,28
Carrotz,doomhammer,1703,evoker,preservation,60,28,32
Jaje,nerathor,1701,evoker,preservation,46,24,22
Pcerainer,stormscale,1699,evoker,preservation,53,26,27
Nyghtx,sanguino,1698,evoker,preservation,100,45,55
Kaipha,ravencrest,1697,evoker,preservation,71,38,33
Lurkî,blackhand,1690,evoker,preservation,179,82,97
Аскми,blackscar,1690,evoker,preservation,96,43,53
Tombeelee,kazzak,1687,evoker,preservation,36,21,15
Nivoker,kazzak,1687,evoker,preservation,51,24,27
Evoxter,twisting-nether,1686,evoker,preservation,36,26,10
Flouzzx,blackmoore,1685,evoker,preservation,48,24,24
Ms,ravencrest,1683,evoker,preservation,46,24,22
Reska,archimonde,1678,evoker,preservation,54,25,29
Mìnos,drakthul,1677,evoker,preservation,36,18,18
Brynesuge,ragnaros,1676,evoker,preservation,63,32,31
Setraxia,argent-dawn,1673,evoker,preservation,130,81,49
Jkdrage,stormscale,1670,evoker,preservation,36,19,17
Häröpallo,stormscale,1669,evoker,preservation,75,44,31
Malboroasted,archimonde,1665,evoker,preservation,48,25,23
Mixoö,throkferoth,1664,evoker,preservation,78,39,39
Эндемический,soulflayer,1664,evoker,preservation,79,39,40
Драконсила,gordunni,1663,evoker,preservation,41,21,20
Thèrèse,hyjal,1658,evoker,preservation,42,20,22
Ambuy,kazzak,1656,evoker,preservation,35,21,14
Sebek,archimonde,1653,evoker,preservation,33,19,14
Gardenewt,ravencrest,1647,evoker,preservation,42,21,21
Devidra,defias-brotherhood,1645,evoker,preservation,111,47,64
Wernøker,archimonde,1643,evoker,preservation,54,23,31
Roth,stormreaver,1641,evoker,preservation,220,110,110
Valtion,stormscale,1634,evoker,preservation,42,23,19
Evodorie,ravencrest,1634,evoker,preservation,44,21,23
Sanktcs,blackhand,1633,evoker,preservation,48,23,25
Rüllatorsven,stormscale,1631,evoker,preservation,36,21,15
Тирэсплюс,soulflayer,1630,evoker,preservation,30,17,13
Kackaloch,tarren-mill,1625,evoker,preservation,69,37,32
Dwagonzuv,the-maelstrom,1624,evoker,preservation,60,36,24
Aeste,dun-modr,1624,evoker,preservation,42,23,19
Detdragetid,zenedar,1622,evoker,preservation,102,40,62
Methamfetami,kazzak,1619,evoker,preservation,72,40,32
Âspên,archimonde,1618,evoker,preservation,105,50,55
Bòrís,kazzak,1617,evoker,preservation,18,17,1
Chasxstrasza,ravencrest,1616,evoker,preservation,54,20,34
Omac,sylvanas,1615,evoker,preservation,42,22,20
Akaos,silvermoon,1613,evoker,preservation,38,20,18
Blueaizu,draenor,1612,evoker,preservation,137,78,59
Bònéz,blackmoore,1612,evoker,preservation,107,50,57
Fartinhaler,ravencrest,1611,evoker,preservation,56,34,22
Dârys,kazzak,1611,evoker,preservation,46,20,26
Adriia,draenor,1610,evoker,preservation,24,17,7
Drakeadorie,twisting-nether,1610,evoker,preservation,30,20,10
Rgedrake,blackrock,1605,evoker,preservation,114,67,47
Hjucen,twisting-nether,1603,evoker,preservation,90,49,41
Ятромантис,gordunni,1603,evoker,preservation,625,318,307
Потныйдракон,soulflayer,1603,evoker,preservation,42,20,22
Пидрактир,soulflayer,1602,evoker,preservation,54,26,28
Castytopg,blackrock,1602,evoker,preservation,36,17,19
Akly,nemesis,1600,evoker,preservation,60,37,23
Bråckie,draenor,1600,evoker,preservation,84,49,35
Malowux,outland,1600,evoker,preservation,36,19,17
Dragonello,stormscale,1600,evoker,preservation,36,17,19
Draskathyr,sylvanas,1594,evoker,preservation,47,29,18
Crocodeal,ysondre,1593,evoker,preservation,48,26,22
Ксенондрейк,gordunni,1591,evoker,preservation,36,17,19
Dragnthsnuts,sylvanas,1590,evoker,preservation,50,26,24
Ystarblaze,tarren-mill,1590,evoker,preservation,57,26,31
Штеци,howling-fjord,1582,evoker,preservation,462,224,238
Odensbest,silvermoon,1580,evoker,preservation,79,48,31
Dragarius,tarren-mill,1580,evoker,preservation,48,19,29
Gracyn,ravencrest,1570,evoker,preservation,30,20,10
Nahkiainen,darksorrow,1569,evoker,preservation,42,19,23
Rawrus,blackrock,1567,evoker,preservation,53,24,29
Flowerscale,tarren-mill,1567,evoker,preservation,51,19,32
Scarydragôn,draenor,1565,evoker,preservation,140,79,61
Alamostrasza,doomhammer,1564,evoker,preservation,48,22,26
Kuramir,twisting-nether,1560,evoker,preservation,54,27,27
Websensation,twisting-nether,1559,evoker,preservation,90,35,55
Shroudflight,draenor,1558,evoker,preservation,125,52,73
Eidachsal,antonidas,1558,evoker,preservation,66,24,42
Lytër,sanguino,1555,evoker,preservation,141,75,66
Vydrag,der-rat-von-dalaran,1553,evoker,preservation,35,17,18
Fearawr,malganis,1552,evoker,preservation,63,22,41
Didii,frostwhisper,1548,evoker,preservation,183,88,95
Zenvoker,silvermoon,1543,evoker,preservation,119,60,59
Valkroth,argent-dawn,1541,evoker,preservation,149,67,82
Antiflexx,ragnaros,1537,evoker,preservation,66,30,36
Нежныйболт,howling-fjord,1536,evoker,preservation,134,68,66
Sürion,grim-batol,1535,evoker,preservation,72,39,33
Sedricae,twisting-nether,1534,evoker,preservation,137,70,67
Kirivoker,dun-modr,1526,evoker,preservation,65,31,34
Kharduk,outland,1525,evoker,preservation,40,19,21
Vimoker,trollbane,1523,evoker,preservation,102,49,53
Sinistrea,conseil-des-ombres,1512,evoker,preservation,117,65,52
Bubbleblower,stormscale,1510,evoker,preservation,30,21,9
Дарконикс,gordunni,1508,evoker,preservation,98,44,54
Torae,burning-legion,1502,evoker,preservation,66,31,35
Nexxà,archimonde,1501,evoker,preservation,63,45,18
Navilism,kazzak,1501,evoker,preservation,429,228,201
Jayrexx,doomhammer,1500,evoker,preservation,73,51,22
Skypov,sylvanas,1498,evoker,preservation,41,24,17
Pflanz,nozdormu,1494,evoker,preservation,36,24,12
Indragon,blackmoore,1492,evoker,preservation,78,37,41
Tenibris,die-nachtwache,1491,evoker,preservation,143,67,76
Tobbebakar,silvermoon,1490,evoker,preservation,48,22,26
Динамика,borean-tundra,1488,evoker,preservation,115,61,54
Fiiery,deathwing,1488,evoker,preservation,82,42,40
Lytër,dun-modr,1488,evoker,preservation,63,28,35
Polzeig,dentarg,1487,evoker,preservation,45,19,26
Superflyy,kazzak,1486,evoker,preservation,172,83,89
Obbwoke,ravencrest,1486,evoker,preservation,120,53,67
Ацидракон,blackscar,1481,evoker,preservation,83,35,48
Sakade,archimonde,1480,evoker,preservation,40,18,22
Sárkány,ravencrest,1478,evoker,preservation,36,17,19
Gg,wildhammer,1477,evoker,preservation,59,37,22
Srache,frostwolf,1477,evoker,preservation,36,16,20
Ámenó,stormscale,1476,evoker,preservation,48,25,23
Lazurius,ravencrest,1472,evoker,preservation,101,43,58
Eagleflow,aszune,1469,evoker,preservation,85,41,44
Nekrosdrake,tarren-mill,1469,evoker,preservation,83,39,44
Drageye,tarren-mill,1467,evoker,preservation,115,64,51
Luderx,outland,1467,evoker,preservation,90,49,41
Dragoncya,archimonde,1466,evoker,preservation,102,50,52
Oldwhiteman,guldan,1465,evoker,preservation,52,25,27
Viodragon,blackrock,1462,evoker,preservation,45,19,26
Samidr,ravencrest,1460,evoker,preservation,41,16,25
Бадикабаер,thermaplugg,1457,evoker,preservation,200,104,96
Beefwing,xavius,1454,evoker,preservation,48,21,27
Féféledragon,archimonde,1452,evoker,preservation,62,24,38
Fubukinoryuu,frostwolf,1451,evoker,preservation,112,61,51
Madelynxoxo,draenor,1450,evoker,preservation,30,25,5
Bigaluga,blackmoore,1446,evoker,preservation,54,22,32
Condrage,grim-batol,1445,evoker,preservation,42,22,20
Nanthira,darksorrow,1445,evoker,preservation,110,53,57
Etier,aegwynn,1444,evoker,preservation,48,25,23
Detixbae,blackrock,1443,evoker,preservation,41,16,25
Dazaar,kazzak,1442,evoker,preservation,54,34,20
Шкуроносец,gordunni,1442,evoker,preservation,36,20,16
Omnipøtens,silvermoon,1441,evoker,preservation,42,27,15
Evizard,nagrand,1438,evoker,preservation,89,49,40
Drachenlilie,aegwynn,1436,evoker,preservation,30,16,14
Nutson,blackrock,1436,evoker,preservation,30,15,15
Conwoker,ravencrest,1435,evoker,preservation,30,15,15
Wingard,twisting-nether,1431,evoker,preservation,29,17,12
Tarecgosa,sanguino,1431,evoker,preservation,245,118,127
Iblvicanfly,stormscale,1429,evoker,preservation,31,17,14
Dokkàmxk,archimonde,1429,evoker,preservation,36,15,21
Natashtrasza,tarren-mill,1427,evoker,preservation,72,26,46
Scalo,kazzak,1423,evoker,preservation,131,67,64
Dedx,sylvanas,1423,evoker,preservation,39,19,20
Cokayn,eonar,1422,evoker,preservation,51,23,28
Sârmikas,blackhand,1420,evoker,preservation,30,15,15
Cheryl,aggra-português,1420,evoker,preservation,31,15,16
Viseriøn,kazzak,1420,evoker,preservation,48,16,32
Орехдракона,gordunni,1418,evoker,preservation,30,16,14
Yeatsa,blackmoore,1417,evoker,preservation,24,15,9
Th,stormscale,1415,evoker,preservation,48,32,16
Djrabtah,sargeras,1414,evoker,preservation,82,43,39
Chronowalker,ragnaros,1413,evoker,preservation,30,15,15
Вексалис,gordunni,1411,evoker,preservation,30,15,15
Lichbõrne,outland,1411,evoker,preservation,42,18,24
Thyrke,aegwynn,1407,evoker,preservation,94,52,42
Spiragon,ysondre,1406,evoker,preservation,154,76,78
Kuubski,ravencrest,1405,evoker,preservation,26,17,9
Aêro,malganis,1403,evoker,preservation,50,22,28
Draelaynex,eredar,1403,evoker,preservation,36,15,21
Dragondznutz,defias-brotherhood,1401,evoker,preservation,65,31,34
Емари,howling-fjord,1397,evoker,preservation,43,30,13
Evoketing,tarren-mill,1396,evoker,preservation,24,15,9
Мефодийевок,howling-fjord,1394,evoker,preservation,60,23,37
Drackarys,tarren-mill,1393,evoker,preservation,60,31,29
Donns,frostmane,1391,evoker,preservation,58,36,22
Cragheart,ravencrest,1391,evoker,preservation,60,28,32
Nagimurr,kazzak,1390,evoker,preservation,99,57,42
Dracanus,bronze-dragonflight,1390,evoker,preservation,54,28,26
Nadoney,hyjal,1389,evoker,preservation,67,42,25
Dragio,blackrock,1387,evoker,preservation,48,25,23
Ammendorn,blackrock,1384,evoker,preservation,46,27,19
Azorgaron,outland,1383,evoker,preservation,60,26,34
Asraestrasz,silvermoon,1380,evoker,preservation,38,24,14
Jamiewing,ravencrest,1380,evoker,preservation,42,25,17
Krayvoker,tarren-mill,1372,evoker,preservation,35,15,20
Dothemath,blackmoore,1371,evoker,preservation,48,22,26
Badrig,silvermoon,1369,evoker,preservation,144,70,74
Filtendragon,stormscale,1362,evoker,preservation,43,21,22
Buqxrawrr,antonidas,1358,evoker,preservation,32,18,14
Matysniak,burning-legion,1355,evoker,preservation,51,24,27
Scalie,ravencrest,1353,evoker,preservation,54,31,23
Darigo,ravencrest,1353,evoker,preservation,30,16,14
Sarapakara,burning-blade,1351,evoker,preservation,36,18,18
Маркзук,gordunni,1350,evoker,preservation,112,53,59
Liliwood,ravencrest,1349,evoker,preservation,82,38,44
Evokazoran,dentarg,1349,evoker,preservation,78,27,51
Cinquanteuro,hyjal,1347,evoker,preservation,101,45,56
Choubalo,archimonde,1346,evoker,preservation,66,35,31
Rescuegirl,blackrock,1345,evoker,preservation,99,50,49
Varkoth,nemesis,1345,evoker,preservation,84,41,43
Sissilisko,sylvanas,1344,evoker,preservation,41,25,16
Kitoed,aegwynn,1344,evoker,preservation,78,35,43
Dragonsimp,archimonde,1340,evoker,preservation,28,17,11
Drarent,hyjal,1340,evoker,preservation,54,24,30
Profdrake,zuluhed,1337,evoker,preservation,24,14,10
Shosho,uldaman,1337,evoker,preservation,30,15,15
Rhaenîra,twisting-nether,1333,evoker,preservation,36,20,16
Ashmoo,archimonde,1333,evoker,preservation,30,14,16
Icemushu,twisting-nether,1331,evoker,preservation,24,14,10
Draevil,emerald-dream,1330,evoker,preservation,42,22,20
Loveheart,die-aldor,1330,evoker,preservation,94,41,53
Drakkujjer,twisting-nether,1329,evoker,preservation,24,15,9
Pelington,silvermoon,1329,evoker,preservation,59,27,32
Aphelïon,dun-modr,1327,evoker,preservation,173,84,89
Gissthebuzzy,dun-modr,1326,evoker,preservation,42,24,18
Saga,aegwynn,1325,evoker,preservation,154,77,77
Drdrag,blackmoore,1324,evoker,preservation,24,18,6
Fetzi,blackhand,1324,evoker,preservation,126,63,63
Smrdimipytel,drakthul,1323,evoker,preservation,40,15,25
Uroegevoker,twisting-nether,1316,evoker,preservation,68,36,32
Ladrieth,hyjal,1316,evoker,preservation,71,34,37
Desnø,frostwolf,1315,evoker,preservation,37,21,16
Голденджо,gordunni,1315,evoker,preservation,59,21,38
Dägon,drakthul,1312,evoker,preservation,72,36,36
Crunktusk,twisting-nether,1310,evoker,preservation,72,27,45
Thellon,frostwolf,1308,evoker,preservation,97,49,48
Бунтз,howling-fjord,1306,evoker,preservation,29,14,15
Xerragon,ravencrest,1306,evoker,preservation,60,20,40
Fredgobrr,tarren-mill,1305,evoker,preservation,102,62,40
Cenca,blackmoore,1304,evoker,preservation,210,101,109
Ludracy,antonidas,1301,evoker,preservation,102,54,48
Asinitaris,ravencrest,1300,evoker,preservation,77,42,35
Drashiku,zuljin,1299,evoker,preservation,84,30,54
Nonolildrake,ysondre,1297,evoker,preservation,82,46,36
Vahamut,argent-dawn,1297,evoker,preservation,42,22,20
Scarlexo,ravencrest,1297,evoker,preservation,47,22,25
Sorextrazy,twisting-nether,1296,evoker,preservation,70,29,41
Breall,tarren-mill,1292,evoker,preservation,388,185,203
Orocimaaru,pozzo-delleternità,1289,evoker,preservation,30,16,14
Flygfjås,stormscale,1288,evoker,preservation,57,28,29
Discodidling,silvermoon,1287,evoker,preservation,63,32,31
Pindaar,zenedar,1283,evoker,preservation,42,17,25
Malfø,exodar,1282,evoker,preservation,115,58,57
Cothikos,ysondre,1282,evoker,preservation,34,15,19
Xiomarita,frostmane,1280,evoker,preservation,60,29,31
Draxaer,outland,1278,evoker,preservation,116,60,56
Blamdrake,blackhand,1275,evoker,preservation,36,14,22
Lynastrasza,silvermoon,1274,evoker,preservation,147,78,69
Drogøn,khaz-modan,1274,evoker,preservation,42,21,21
Hyggëê,sanguino,1273,evoker,preservation,51,22,29
Stormwing,twilights-hammer,1272,evoker,preservation,29,19,10
Beharot,silvermoon,1272,evoker,preservation,96,33,63
Jimmytrivet,archimonde,1271,evoker,preservation,63,30,33
Vaermithor,tarren-mill,1270,evoker,preservation,59,33,26
Vyron,amanthul,1270,evoker,preservation,46,19,27
Iphonetwo,ravencrest,1267,evoker,preservation,29,20,9
Thundermifln,nemesis,1266,evoker,preservation,48,26,22
Dragonerr,kiljaeden,1264,evoker,preservation,47,25,22
Howtodragon,twisting-nether,1262,evoker,preservation,48,26,22
Mortlalune,conseil-des-ombres,1260,evoker,preservation,154,78,76
Folevo,stormreaver,1255,evoker,preservation,295,144,151
Mugeki,burning-legion,1255,evoker,preservation,59,28,31
Drgnokn,silvermoon,1252,evoker,preservation,80,48,32
Nagoli,silvermoon,1250,evoker,preservation,55,26,29
Dinotron,uldaman,1249,evoker,preservation,54,27,27
Lynt,burning-blade,1248,evoker,preservation,66,34,32
Sondosa,twisting-nether,1248,evoker,preservation,30,15,15
Aebivoker,dalaran,1245,evoker,preservation,30,18,12
Kda,die-nachtwache,1245,evoker,preservation,30,13,17
Nazalath,eonar,1245,evoker,preservation,42,18,24
Патриотика,howling-fjord,1244,evoker,preservation,95,45,50
Dargenpont,turalyon,1244,evoker,preservation,30,13,17
Schwañ,twisting-nether,1243,evoker,preservation,24,13,11
Crottedezen,archimonde,1243,evoker,preservation,30,13,17
Apaçi,ravencrest,1243,evoker,preservation,51,19,32
Ithijin,blackmoore,1241,evoker,preservation,59,27,32
Dragawn,grim-batol,1240,evoker,preservation,121,68,53
Kymura,archimonde,1239,evoker,preservation,30,13,17
Voraxos,silvermoon,1238,evoker,preservation,18,13,5
Vyore,silvermoon,1238,evoker,preservation,24,13,11
Тектрис,howling-fjord,1238,evoker,preservation,126,58,68
Kampe,nemesis,1237,evoker,preservation,36,17,19
Airwaves,hyjal,1233,evoker,preservation,24,14,10
Draagon,burning-legion,1232,evoker,preservation,36,15,21
Drackheal,kaelthas,1229,evoker,preservation,59,31,28
Elenaevoker,stormscale,1229,evoker,preservation,161,82,79
Beenus,doomhammer,1228,evoker,preservation,36,24,12
Lagadta,antonidas,1228,evoker,preservation,36,22,14
Драгоблуд,soulflayer,1227,evoker,preservation,54,25,29
Âbs,archimonde,1227,evoker,preservation,99,41,58
Smokitor,kazzak,1223,evoker,preservation,48,24,24
Pokemongame,draenor,1222,evoker,preservation,22,14,8
Douevnfly,ravencrest,1220,evoker,preservation,44,26,18
Stjáuni,ravencrest,1219,evoker,preservation,58,29,29
Мвпгуччи,blackscar,1219,evoker,preservation,36,13,23
Verithian,kazzak,1218,evoker,preservation,42,22,20
Drakdilla,tarren-mill,1216,evoker,preservation,24,13,11
Shnptyr,ragnaros,1215,evoker,preservation,42,22,20
Lojinevo,twisting-nether,1215,evoker,preservation,95,43,52
Kekvoker,antonidas,1213,evoker,preservation,72,35,37
Ruinastrasza,silvermoon,1212,evoker,preservation,24,13,11
Wrcdragon,drakthul,1212,evoker,preservation,136,60,76
Varaug,veklor,1211,evoker,preservation,40,25,15
Groovyy,hyjal,1211,evoker,preservation,60,36,24
Awaboo,draenor,1210,evoker,preservation,24,13,11
Slimygecko,ravencrest,1210,evoker,preservation,41,22,19
Flyingaway,tarren-mill,1209,evoker,preservation,42,19,23
Мэриджэин,soulflayer,1205,evoker,preservation,41,18,23
Geckonen,stormreaver,1204,evoker,preservation,179,90,89
Theocean,turalyon,1204,evoker,preservation,259,120,139
Whitelizzard,tarren-mill,1199,evoker,preservation,60,29,31
Dragonspaff,argent-dawn,1199,evoker,preservation,30,14,16
Erhvoker,veknilash,1199,evoker,preservation,111,47,64
Corneflex,chogall,1196,evoker,preservation,27,13,14
Yeetsera,thrall,1195,evoker,preservation,58,25,33
Zethreus,silvermoon,1192,evoker,preservation,64,34,30
Bestofriendo,eredar,1191,evoker,preservation,72,36,36
Dolphdrago,outland,1190,evoker,preservation,28,15,13
Sibvoker,kazzak,1188,evoker,preservation,108,52,56
Sitdownnow,blackrock,1188,evoker,preservation,56,19,37
Salamanderx,stormscale,1186,evoker,preservation,22,14,8
Uztfuzt,blackmoore,1185,evoker,preservation,44,29,15
Raøug,blackmoore,1182,evoker,preservation,54,18,36
Drakatha,kazzak,1181,evoker,preservation,57,33,24
Xdxd,burning-blade,1180,evoker,preservation,27,13,14
Muccavok,stormrage,1179,evoker,preservation,64,34,30
Belkavoker,zirkel-des-cenarius,1177,evoker,preservation,42,14,28
Kujira,draenor,1171,evoker,preservation,27,16,11
Dayandnight,quelthalas,1170,evoker,preservation,60,28,32
Aphi,frostwolf,1170,evoker,preservation,57,26,31
Glouglouti,drekthar,1168,evoker,preservation,60,27,33
Saucy,sanguino,1166,evoker,preservation,43,26,17
Anso,sanguino,1164,evoker,preservation,53,26,27
Уконэ,blackscar,1159,evoker,preservation,49,22,27
Dracobelli,drakthul,1157,evoker,preservation,30,14,16
Amaterãsu,kazzak,1154,evoker,preservation,77,37,40
Jmy,bloodhoof,1152,evoker,preservation,18,12,6
Dracum,kazzak,1152,evoker,preservation,24,12,12
Odiin,dun-modr,1151,evoker,preservation,21,13,8
Hehehihihaha,ravencrest,1151,evoker,preservation,24,12,12
Mistrßroducr,stormreaver,1151,evoker,preservation,24,12,12
Siìre,thrall,1150,evoker,preservation,12,12,0
Mysaldo,sylvanas,1150,evoker,preservation,18,12,6
Coarraze,eldrethalas,1148,evoker,preservation,18,12,6
Veryspikes,twisting-nether,1148,evoker,preservation,30,12,18
Reptak,stormscale,1146,evoker,preservation,24,12,12
Uwudyret,tarren-mill,1145,evoker,preservation,30,12,18
Панераи,gordunni,1145,evoker,preservation,39,12,27
Cryuu,burning-legion,1144,evoker,preservation,30,12,18
Sinusiitiis,destromath,1142,evoker,preservation,18,12,6
Tsukiko,archimonde,1140,evoker,preservation,43,16,27
Ryujíin,kazzak,1139,evoker,preservation,23,12,11
Nisiris,doomhammer,1139,evoker,preservation,58,29,29
Yorfyr,ravencrest,1139,evoker,preservation,37,16,21
Dragonbrx,antonidas,1138,evoker,preservation,18,12,6
Emberturd,blackmoore,1138,evoker,preservation,24,12,12
Nikoo,runetotem,1138,evoker,preservation,36,13,23
Jurrassic,defias-brotherhood,1133,evoker,preservation,69,38,31
Steeken,haomarush,1130,evoker,preservation,54,26,28
Xorago,guldan,1127,evoker,preservation,42,18,24
Adnoc,tarren-mill,1124,evoker,preservation,19,13,6
Djolero,silvermoon,1124,evoker,preservation,60,28,32
Siderion,drakthul,1122,evoker,preservation,24,14,10
Retyss,twisting-nether,1115,evoker,preservation,348,176,172
Nynnaydoth,drakthul,1112,evoker,preservation,80,39,41
Drachenglas,antonidas,1112,evoker,preservation,30,13,17
Sudrac,antonidas,1110,evoker,preservation,24,12,12
Tennin,thrall,1108,evoker,preservation,51,28,23
Huusdrache,outland,1107,evoker,preservation,34,14,20
Пероник,gordunni,1107,evoker,preservation,52,18,34
Dangai,draenor,1103,evoker,preservation,23,12,11
Hems,bronzebeard,1101,evoker,preservation,70,36,34
Tusibi,hyjal,1100,evoker,preservation,47,32,15
Алекстраса,blackscar,1097,evoker,preservation,30,16,14
Dmn,defias-brotherhood,1097,evoker,preservation,54,24,30
Saphirá,hyjal,1094,evoker,preservation,28,13,15
Xidalulz,sylvanas,1093,evoker,preservation,12,12,0
Deathwinng,twisting-nether,1090,evoker,preservation,66,26,40
Asgá,kazzak,1087,evoker,preservation,23,12,11
Dragonflye,kazzak,1084,evoker,preservation,29,12,17
Khaela,archimonde,1083,evoker,preservation,99,47,52
Калесгоз,howling-fjord,1083,evoker,preservation,42,19,23
Dractarys,arathi,1080,evoker,preservation,78,41,37
Gilgakek,darksorrow,1078,evoker,preservation,74,31,43
Drakeish,kazzak,1077,evoker,preservation,29,13,16
Bambusák,draenor,1077,evoker,preservation,94,38,56
Schenlong,kelthuzad,1074,evoker,preservation,54,26,28
Blackli,kazzak,1074,evoker,preservation,33,14,19
Dreiwyn,kazzak,1072,evoker,preservation,30,20,10
Pikiscalez,bronzebeard,1072,evoker,preservation,24,12,12
Kyrathir,hyjal,1069,evoker,preservation,30,12,18
Эбиб,gordunni,1066,evoker,preservation,66,34,32
Wingzy,chogall,1059,evoker,preservation,201,93,108
Lizardofoz,argent-dawn,1058,evoker,preservation,30,18,12
Haawwt,eredar,1058,evoker,preservation,24,12,12
Targzæ,hyjal,1057,evoker,preservation,24,12,12
Øoøoøoøo,outland,1056,evoker,preservation,12,11,1
Вискписк,soulflayer,1056,evoker,preservation,12,11,1
Berlyvoke,stormscale,1056,evoker,preservation,18,11,7
Kremost,sylvanas,1056,evoker,preservation,30,11,19
Шадофдрагон,deathweaver,1055,evoker,preservation,42,28,14
Lacer,minahonda,1055,evoker,preservation,30,11,19
Adrienne,steamwheedle-cartel,1054,evoker,preservation,30,13,17
Àtòmìc,malorne,1053,evoker,preservation,24,11,13
Bombrush,ragnaros,1052,evoker,preservation,27,15,12
Parodize,thrall,1051,evoker,preservation,24,11,13
Kurger,twisting-nether,1048,evoker,preservation,59,20,39
Дрэгтир,lich-king,1047,evoker,preservation,43,22,21
Horiz,kazzak,1047,evoker,preservation,30,11,19
Zeigrem,antonidas,1044,evoker,preservation,12,11,1
Elaijaz,turalyon,1040,evoker,preservation,18,14,4
Predatax,drakthul,1039,evoker,preservation,142,71,71
Morlie,argent-dawn,1036,evoker,preservation,76,36,40
Kharalambos,stormscale,1036,evoker,preservation,36,13,23
Thedrake,aegwynn,1034,evoker,preservation,47,28,19
Antistrasza,argent-dawn,1033,evoker,preservation,48,22,26
Spirow,archimonde,1032,evoker,preservation,30,17,13
Iceslinger,stormscale,1031,evoker,preservation,89,41,48
Leblon,stormreaver,1031,evoker,preservation,30,12,18
Chrisú,thrall,1029,evoker,preservation,30,12,18
Guntoker,tarren-mill,1029,evoker,preservation,60,21,39
Ohcaralho,outland,1028,evoker,preservation,50,19,31
Athyrstria,blackmoore,1028,evoker,preservation,65,18,47
Zathîel,argent-dawn,1026,evoker,preservation,149,64,85
Drazor,blackhand,1021,evoker,preservation,23,11,12
Snällaldo,bladefist,1020,evoker,preservation,16,12,4
Aezthaza,outland,1018,evoker,preservation,26,12,14
Offering,ravencrest,1015,evoker,preservation,30,11,19
Dragonna,argent-dawn,1013,evoker,preservation,99,43,56
Гопоп,gordunni,1011,evoker,preservation,31,14,17
Singe,nemesis,1010,evoker,preservation,120,42,78
Dreamiee,kazzak,1008,evoker,preservation,54,20,34
Quoz,ragnaros,1006,evoker,preservation,23,11,12
Nurant,blackmoore,1006,evoker,preservation,29,12,17
Dragonban,tarren-mill,1005,evoker,preservation,40,11,29
Chronicryder,draenor,1004,evoker,preservation,21,11,10
Pigioto,silvermoon,1002,evoker,preservation,210,104,106
Archont,eredar,999,evoker,preservation,42,12,30
Draknr,alakir,998,evoker,preservation,36,11,25
Kalerinozi,blackhand,997,evoker,preservation,44,11,33
Tf,doomhammer,988,evoker,preservation,40,15,25
Jhoanna,grim-batol,987,evoker,preservation,48,25,23
Palindre,argent-dawn,987,evoker,preservation,29,14,15
Viseron,zuljin,987,evoker,preservation,105,38,67
Deadfyre,dun-modr,986,evoker,preservation,30,15,15
Blackwing,twilights-hammer,986,evoker,preservation,28,11,17
Hios,twisting-nether,984,evoker,preservation,60,33,27
Kraaznus,ravencrest,984,evoker,preservation,20,11,9
Gantsu,blackhand,980,evoker,preservation,18,11,7
Zaverion,nathrezim,977,evoker,preservation,30,13,17
Абьюз,galakrond,970,evoker,preservation,271,140,131
Kàzuée,outland,969,evoker,preservation,42,14,28
Мйлкйвей,deathguard,968,evoker,preservation,40,25,15
Reddeaddrago,silvermoon,966,evoker,preservation,44,24,20
Алифсе,howling-fjord,965,evoker,preservation,84,23,61
Drazikz,archimonde,962,evoker,preservation,76,41,35
Drakares,la-croisade-écarlate,962,evoker,preservation,54,19,35
Silverwingg,tarren-mill,960,evoker,preservation,18,10,8
Konzaa,argent-dawn,960,evoker,preservation,18,10,8
Ecovoker,outland,960,evoker,preservation,18,10,8
Yavak,blackmoore,960,evoker,preservation,18,10,8
Mauül,ravencrest,959,evoker,preservation,12,10,2
Argnir,archimonde,959,evoker,preservation,24,10,14
Síire,ravencrest,958,evoker,preservation,12,10,2
Mithrandir,marécage-de-zangar,957,evoker,preservation,24,10,14
Druggz,burning-blade,955,evoker,preservation,12,10,2
Baszz,aegwynn,955,evoker,preservation,24,10,14
Kleftra,stormscale,954,evoker,preservation,18,10,8
Skrix,khadgar,953,evoker,preservation,18,10,8
Dontiá,draenor,953,evoker,preservation,81,37,44
Goalkeeper,ravencrest,952,evoker,preservation,18,10,8
Hool,silvermoon,951,evoker,preservation,149,71,78
Bobonakia,sylvanas,950,evoker,preservation,24,10,14
Slashlowe,archimonde,948,evoker,preservation,40,18,22
Jamesdouglas,eredar,946,evoker,preservation,30,19,11
Scaleyfurry,azshara,941,evoker,preservation,21,12,9
ßëkûsåùrús,ragnaros,941,evoker,preservation,23,10,13
Altairion,dalaran,939,evoker,preservation,30,18,12
Lînkôs,aegwynn,938,evoker,preservation,71,35,36
Dracwyn,shattrath,938,evoker,preservation,25,11,14
Ewings,archimonde,938,evoker,preservation,30,10,20
Винтер,azuregos,935,evoker,preservation,19,11,8
Vozzat,stormscale,934,evoker,preservation,24,11,13
Blazeros,sylvanas,933,evoker,preservation,42,21,21
Draklorn,moonglade,933,evoker,preservation,75,36,39
Dracnass,silvermoon,930,evoker,preservation,18,10,8
Тирдде,deathweaver,914,evoker,preservation,102,48,54
Zaraten,hyjal,909,evoker,preservation,27,14,13
Vores,norgannon,908,evoker,preservation,59,26,33
Kamings,outland,907,evoker,preservation,32,17,15
Domynevoc,hyjal,902,evoker,preservation,55,26,29
Cárried,twilights-hammer,902,evoker,preservation,33,11,22
Canitabravar,cthun,898,evoker,preservation,60,30,30
Drakutyr,defias-brotherhood,896,evoker,preservation,20,11,9
Morsan,tichondrius,896,evoker,preservation,48,23,25
Лесанор,gordunni,894,evoker,preservation,16,10,6
Marasz,silvermoon,893,evoker,preservation,42,22,20
Rafale,the-maelstrom,892,evoker,preservation,139,69,70
Eosin,blackrock,890,evoker,preservation,23,10,13
Drakars,kazzak,886,evoker,preservation,62,27,35
Doriangray,drakthul,884,evoker,preservation,20,11,9
Drachi,ambossar,880,evoker,preservation,78,35,43
Drâcarys,destromath,879,evoker,preservation,25,13,12
Mergwahlbark,hyjal,878,evoker,preservation,29,10,19
Dioni,sylvanas,873,evoker,preservation,39,15,24
Thymian,ambossar,871,evoker,preservation,149,68,81
Minikuja,culte-de-la-rive-noire,867,evoker,preservation,56,22,34
Escamosa,exodar,866,evoker,preservation,48,10,38
Antifightx,kazzak,864,evoker,preservation,12,9,3
Flystowardsu,argent-dawn,864,evoker,preservation,12,9,3
Dekaralol,ravencrest,864,evoker,preservation,12,9,3
Rullatorsvên,sylvanas,864,evoker,preservation,18,9,9
Moondraka,outland,864,evoker,preservation,18,9,9
Drgigapump,blackmoore,864,evoker,preservation,18,9,9
Laurenzos,tarren-mill,864,evoker,preservation,18,9,9
Мишанячешуя,gordunni,863,evoker,preservation,12,9,3
Wjörm,outland,863,evoker,preservation,18,9,9
Dracronix,the-maelstrom,863,evoker,preservation,18,9,9
Cupcâke,dalaran,863,evoker,preservation,18,9,9
Nassuada,dalaran,863,evoker,preservation,18,9,9
Anlong,alakir,863,evoker,preservation,23,10,13
Myntara,tarren-mill,863,evoker,preservation,24,9,15
Teneja,malganis,863,evoker,preservation,24,9,15
Exxa,tarren-mill,863,evoker,preservation,24,9,15
Zezus,outland,862,evoker,preservation,12,9,3
Zygumy,hyjal,862,evoker,preservation,18,9,9
Навидх,howling-fjord,862,evoker,preservation,24,9,15
Mistvoke,kazzak,860,evoker,preservation,18,9,9
Lithnxv,bladefist,859,evoker,preservation,18,9,9
Evok,deathwing,858,evoker,preservation,24,10,14
Drakmool,ysondre,858,evoker,preservation,30,12,18
Setoc,blackrock,857,evoker,preservation,19,9,10
Nedflanderss,silvermoon,856,evoker,preservation,18,9,9
Azurewings,argent-dawn,851,evoker,preservation,65,23,42
Zymotîx,stormscale,850,evoker,preservation,30,9,21
Javåscript,outland,849,evoker,preservation,18,9,9
Damssx,medivh,847,evoker,preservation,33,13,20
Drâkarys,khaz-modan,845,evoker,preservation,57,21,36
Yadormi,sylvanas,843,evoker,preservation,60,28,32
Sumo,burning-legion,841,evoker,preservation,36,16,20
Avizz,tarren-mill,837,evoker,preservation,23,12,11
Zerario,blackhand,827,evoker,preservation,23,9,14
Viseriðn,archimonde,827,evoker,preservation,24,9,15
Mendes,kazzak,827,evoker,preservation,84,26,58
Voryax,kirin-tor,825,evoker,preservation,30,9,21
Верметор,soulflayer,820,evoker,preservation,96,32,64
Miumyuki,drakthul,815,evoker,preservation,54,21,33
Aayala,dalaran,806,evoker,preservation,21,9,12
Xanthisa,malganis,800,evoker,preservation,34,13,21
Quetzalcoâtl,burning-blade,795,evoker,preservation,24,10,14
Nochance,dentarg,795,evoker,preservation,127,45,82
Dratheon,dun-modr,794,evoker,preservation,32,10,22
Cheapdragon,tarren-mill,791,evoker,preservation,45,18,27
Эфирид,blackscar,779,evoker,preservation,59,22,37
Kanketopg,kazzak,768,evoker,preservation,12,8,4
Nst,zuljin,768,evoker,preservation,12,8,4
Dragondn,alleria,768,evoker,preservation,12,8,4
Nhoru,stormscale,768,evoker,preservation,12,8,4
Swooshz,ragnaros,768,evoker,preservation,12,8,4
Zemar,dalaran,768,evoker,preservation,12,8,4
Naicover,kazzak,768,evoker,preservation,12,8,4
Myshavion,hyjal,768,evoker,preservation,12,8,4
Zendaë,archimonde,768,evoker,preservation,12,8,4
Dragonkim,draenor,768,evoker,preservation,18,8,10
Visage,kul-tiras,768,evoker,preservation,18,8,10
Ringil,tarren-mill,768,evoker,preservation,18,8,10
Korialstraz,aegwynn,767,evoker,preservation,12,8,4
Krazuntus,argent-dawn,767,evoker,preservation,12,8,4
Meteo,the-maelstrom,767,evoker,preservation,15,9,6
Sysstrasza,archimonde,767,evoker,preservation,18,8,10
Shenronblue,bloodscalp,767,evoker,preservation,24,8,16
Mirajhti,blackrock,767,evoker,preservation,30,8,22
Dragonsito,cthun,765,evoker,preservation,18,8,10
Nêóô,blackrock,765,evoker,preservation,18,8,10
Daracthyr,arathor,765,evoker,preservation,18,8,10
Mfdragon,grim-batol,765,evoker,preservation,24,8,16
Уполнамоченн,soulflayer,764,evoker,preservation,12,8,4
Mikevoker,aegwynn,763,evoker,preservation,12,8,4
Iscale,twisting-nether,763,evoker,preservation,24,8,16
Drakhtyr,draenor,762,evoker,preservation,12,8,4
Arecibo,tarren-mill,762,evoker,preservation,12,8,4
Dracanis,shendralar,761,evoker,preservation,27,12,15
Aevon,blackrock,758,evoker,preservation,48,11,37
Sarodari,blackhand,757,evoker,preservation,18,8,10
Dragonrocker,silvermoon,757,evoker,preservation,24,8,16
Cyclops,zuljin,756,evoker,preservation,24,8,16
Maverickx,nemesis,753,evoker,preservation,18,8,10
Lunariëlle,les-sentinelles,749,evoker,preservation,12,8,4
Inspecto,turalyon,737,evoker,preservation,18,8,10
Touge,varimathras,721,evoker,preservation,24,8,16
Ryujinx,blackhand,719,evoker,preservation,17,8,9
Ptipangoevok,dalaran,713,evoker,preservation,22,9,13
Kuzzan,blackhand,707,evoker,preservation,18,9,9
Baléryon,archimonde,705,evoker,preservation,11,8,3
Nicholbolas,nordrassil,690,evoker,preservation,11,8,3
Sunfyres,frostmane,679,evoker,preservation,28,8,20
Escaaboy,stormscale,672,evoker,preservation,12,7,5
Ricidevo,nerathor,672,evoker,preservation,12,7,5
Blazelt,blackrock,672,evoker,preservation,12,7,5
Fûrý,twisting-nether,672,evoker,preservation,12,7,5
Stormnn,kazzak,672,evoker,preservation,12,7,5
Zarikus,argent-dawn,672,evoker,preservation,12,7,5
Evyzz,blackmoore,672,evoker,preservation,12,7,5
Beetk,tarren-mill,672,evoker,preservation,12,7,5
Flyhacker,blackrock,672,evoker,preservation,12,7,5
Løcøtømmy,blackrock,672,evoker,preservation,12,7,5
Óceiros,silvermoon,672,evoker,preservation,18,7,11
Tojodormi,argent-dawn,672,evoker,preservation,18,7,11
Spacebreath,ravencrest,672,evoker,preservation,18,7,11
Iwaavoker,archimonde,672,evoker,preservation,18,7,11
Sulführer,sanguino,672,evoker,preservation,18,7,11
Deadwing,eonar,672,evoker,preservation,18,7,11
Dárnast,draenor,671,evoker,preservation,12,7,5
Draaxy,twisting-nether,671,evoker,preservation,15,8,7
Fusanabide,kazzak,671,evoker,preservation,14,7,7
Гневиан,eversong,671,evoker,preservation,18,7,11
Dagruel,exodar,671,evoker,preservation,18,7,11
Karristrasza,silvermoon,671,evoker,preservation,18,7,11
Evoris,frostmane,671,evoker,preservation,18,7,11
Dodgens,auchindoun,671,evoker,preservation,18,7,11
Therzer,drakthul,670,evoker,preservation,12,7,5
Coaxoch,thunderhorn,670,evoker,preservation,12,7,5
Spïzz,dun-modr,670,evoker,preservation,12,7,5
Esalisko,kazzak,670,evoker,preservation,12,7,5
Liroo,hyjal,670,evoker,preservation,12,7,5
Myszostrasza,burning-legion,670,evoker,preservation,12,7,5
Hakuzah,terokkar,670,evoker,preservation,18,7,11
Malfestio,zuljin,669,evoker,preservation,12,7,5
Ìzànamì,hyjal,669,evoker,preservation,12,7,5
Avemonetemus,silvermoon,669,evoker,preservation,18,7,11
Lapaneri,sylvanas,669,evoker,preservation,24,7,17
Vatiras,magtheridon,669,evoker,preservation,24,7,17
Wywill,eitrigg,668,evoker,preservation,12,7,5
Entombevoker,twisting-nether,668,evoker,preservation,12,7,5
Prikkedøden,grim-batol,668,evoker,preservation,18,7,11
Панкрок,thermaplugg,668,evoker,preservation,21,7,14
Hornbeam,tarren-mill,666,evoker,preservation,18,7,11
Acnologîa,ysondre,665,evoker,preservation,12,7,5
Gihzmo,tarren-mill,664,evoker,preservation,12,7,5
Büsselberg,blackmoore,658,evoker,preservation,18,7,11
Awfultrash,archimonde,655,evoker,preservation,23,7,16
Charezard,draenor,638,evoker,preservation,17,7,10
Myndragosa,varimathras,624,evoker,preservation,15,8,7
Judragon,kazzak,618,evoker,preservation,20,8,12
Blyatcuka,kazzak,617,evoker,preservation,17,8,9
Quewl,blackmoore,606,evoker,preservation,11,7,4
Voltyrh,antonidas,589,evoker,preservation,19,7,12
Iandret,destromath,576,evoker,preservation,12,6,6
Psheetae,kazzak,576,evoker,preservation,12,6,6
Oceirós,draenor,576,evoker,preservation,12,6,6
Lasissi,dragonblight,576,evoker,preservation,12,6,6
Snipy,burning-legion,576,evoker,preservation,12,6,6
Bluesaphir,ravencrest,576,evoker,preservation,12,6,6
Cutegirlx,blackrock,576,evoker,preservation,12,6,6
Louiekin,outland,576,evoker,preservation,12,6,6
Drakarroar,ragnaros,576,evoker,preservation,12,6,6
Rømmegrøt,tarren-mill,576,evoker,preservation,12,6,6
Dizatwo,silvermoon,576,evoker,preservation,12,6,6
Talynn,sylvanas,576,evoker,preservation,12,6,6
Jacko,nemesis,576,evoker,preservation,12,6,6
Rmplol,twisting-nether,576,evoker,preservation,12,6,6
Djsnake,twisting-nether,576,evoker,preservation,12,6,6
Darkevokoul,conseil-des-ombres,576,evoker,preservation,12,6,6
Kocaina,ravencrest,576,evoker,preservation,12,6,6
Kapevok,sanguino,576,evoker,preservation,12,6,6
Luu,the-maelstrom,576,evoker,preservation,12,6,6
Nèthy,argent-dawn,576,evoker,preservation,12,6,6
Kajer,nemesis,576,evoker,preservation,12,6,6
Yesdaddyowo,draenor,576,evoker,preservation,12,6,6
Ragnai,sunstrider,576,evoker,preservation,12,6,6
Holyvoker,aegwynn,576,evoker,preservation,12,6,6
Sindragonk,ravencrest,576,evoker,preservation,12,6,6
Mesarin,eredar,576,evoker,preservation,12,6,6
Trainsaw,kazzak,576,evoker,preservation,12,6,6
Alphabét,ravencrest,576,evoker,preservation,18,6,12
Enzetrius,argent-dawn,576,evoker,preservation,18,6,12
Lolprevoker,outland,576,evoker,preservation,18,6,12
Discodraken,stormscale,576,evoker,preservation,18,6,12
Дэзвинк,gordunni,576,evoker,preservation,24,6,18
Lìssàndra,argent-dawn,576,evoker,preservation,24,6,18
Pasqvoker,ravencrest,575,evoker,preservation,12,6,6
Nevara,ragnaros,575,evoker,preservation,12,6,6
Drakeó,kazzak,575,evoker,preservation,12,6,6
Raegos,ravencrest,575,evoker,preservation,12,6,6
Dragonlet,twisting-nether,575,evoker,preservation,12,6,6
Pe,dalaran,575,evoker,preservation,12,6,6
Drachenbeton,blackhand,575,evoker,preservation,12,6,6
Сулистраза,blackscar,575,evoker,preservation,12,6,6
Draccaris,silvermoon,575,evoker,preservation,12,6,6
Nexevo,blackmoore,575,evoker,preservation,18,6,12
Boonvoker,the-maelstrom,575,evoker,preservation,24,6,18
Kutdraak,laughing-skull,574,evoker,preservation,12,6,6
Tarystrasza,blackrock,574,evoker,preservation,12,6,6
Drakpojke,stormscale,574,evoker,preservation,12,6,6
Etherwood,bronze-dragonflight,573,evoker,preservation,12,6,6
Dracarysfire,kazzak,573,evoker,preservation,12,6,6
Skytrace,silvermoon,573,evoker,preservation,18,6,12
Kaiser,trollbane,573,evoker,preservation,18,6,12
Blainedragon,arathor,573,evoker,preservation,18,6,12
Synpho,ahnqiraj,571,evoker,preservation,12,6,6
Aevnon,sylvanas,569,evoker,preservation,12,6,6
Synhtol,ragnaros,564,evoker,preservation,18,6,12
Evÿ,turalyon,560,evoker,preservation,18,6,12
Балрогхаоса,gordunni,539,evoker,preservation,14,7,7
Ahyllesevok,antonidas,527,evoker,preservation,15,7,8
Rasalhague,uldum,522,evoker,preservation,15,6,9
Dracarysx,grim-batol,520,evoker,preservation,15,7,8
Drakthur,terenas,519,evoker,preservation,27,7,20
Drakinas,outland,511,evoker,preservation,11,6,5
Tyuz,antonidas,509,evoker,preservation,14,6,8
Draktoros,kazzak,504,evoker,preservation,30,11,19
Diggidydract,silvermoon,480,evoker,preservation,6,5,1
Baddragonn,nemesis,480,evoker,preservation,6,5,1
Stêwpit,blackhand,480,evoker,preservation,6,5,1
Pyrestra,argent-dawn,480,evoker,preservation,6,5,1
Ralfferion,auchindoun,480,evoker,preservation,6,5,1
Arfedar,kazzak,480,evoker,preservation,6,5,1
Jàcè,antonidas,480,evoker,preservation,6,5,1
Dåseskjuul,kazzak,480,evoker,preservation,6,5,1
Jmyzard,tarren-mill,480,evoker,preservation,10,6,4
Runewing,turalyon,480,evoker,preservation,12,5,7
Nemrák,blackmoore,480,evoker,preservation,12,5,7
Silversnakex,ravencrest,480,evoker,preservation,12,5,7
Candicewho,twisting-nether,480,evoker,preservation,12,5,7
Драгонкокс,gordunni,480,evoker,preservation,12,5,7
Mimic,scarshield-legion,480,evoker,preservation,12,5,7
Belzevoker,blackrock,480,evoker,preservation,12,5,7
Bigreddragon,outland,480,evoker,preservation,12,5,7
Rímmer,kazzak,480,evoker,preservation,12,5,7
Poporaight,archimonde,480,evoker,preservation,12,5,7
Dzin,burning-legion,480,evoker,preservation,12,5,7
Alanikus,silvermoon,480,evoker,preservation,12,5,7
Drdrayk,balnazzar,480,evoker,preservation,12,5,7
Fnom,hyjal,480,evoker,preservation,12,5,7
Evokoloko,outland,480,evoker,preservation,12,5,7
Vizdraken,tarren-mill,480,evoker,preservation,12,5,7
Twocats,twisting-nether,480,evoker,preservation,12,5,7
Lootharon,blackhand,480,evoker,preservation,12,5,7
Deathwingx,sylvanas,480,evoker,preservation,12,5,7
Flatterhipy,blackrock,480,evoker,preservation,12,5,7
Emeraldcomun,twisting-nether,480,evoker,preservation,12,5,7
Soupmah,silvermoon,480,evoker,preservation,12,5,7
Favera,taerar,480,evoker,preservation,12,5,7
Feddra,twisting-nether,480,evoker,preservation,12,5,7
Драмуся,gordunni,480,evoker,preservation,12,5,7
Катяламизил,howling-fjord,480,evoker,preservation,12,5,7
Toplevel,eredar,480,evoker,preservation,12,5,7
Xyphoo,kazzak,480,evoker,preservation,18,5,13
Invinite,blackrock,480,evoker,preservation,18,5,13
Draakoñ,outland,480,evoker,preservation,18,5,13
Theflight,ravencrest,480,evoker,preservation,18,5,13
Dragóndééz,draenor,480,evoker,preservation,18,5,13
Miraas,burning-blade,480,evoker,preservation,18,5,13
Rise,tarren-mill,480,evoker,preservation,24,5,19
Uxiono,dun-modr,480,evoker,preservation,24,5,19
Ophois,malygos,479,evoker,preservation,6,5,1
Dragondisnut,sylvanas,479,evoker,preservation,12,5,7
Scaleflux,argent-dawn,479,evoker,preservation,12,5,7
Dudebrö,arathor,479,evoker,preservation,12,5,7
Chunlooi,baelgun,479,evoker,preservation,12,5,7
Naloqa,frostwolf,479,evoker,preservation,12,5,7
Cinnamoon,defias-brotherhood,479,evoker,preservation,12,5,7
Darksaider,draenor,479,evoker,preservation,12,5,7
Shosk,chamber-of-aspects,479,evoker,preservation,12,5,7
Luftwaffel,blackmoore,479,evoker,preservation,12,5,7
Puffdaddyxd,twisting-nether,479,evoker,preservation,12,5,7
Chizy,aegwynn,479,evoker,preservation,18,5,13
Kärlethos,dun-modr,478,evoker,preservation,12,5,7
Widow,chromaggus,478,evoker,preservation,12,5,7
Bbuszek,outland,478,evoker,preservation,18,5,13
Fodom,medivh,477,evoker,preservation,12,5,7
Cazé,archimonde,477,evoker,preservation,12,5,7
Vereeza,draenor,477,evoker,preservation,15,6,9
Zahaak,doomhammer,477,evoker,preservation,18,5,13
Dragorasi,frostwolf,476,evoker,preservation,24,5,19
Гарил,grom,475,evoker,preservation,12,5,7
Gladdrake,doomhammer,474,evoker,preservation,18,5,13
Fricandela,sanguino,472,evoker,preservation,18,5,13
Valasthor,argent-dawn,469,evoker,preservation,18,5,13
Incarnevoke,ravencrest,463,evoker,preservation,11,5,6
Thyriån,kazzak,447,evoker,preservation,11,5,6
Missnorway,blackmoore,447,evoker,preservation,11,5,6
Яссон,howling-fjord,447,evoker,preservation,14,6,8
Kássadaín,the-maelstrom,447,evoker,preservation,16,5,11
Jcloud,shattered-hand,432,evoker,preservation,15,5,10
Grajade,dun-modr,422,evoker,preservation,15,6,9
Alrakis,kragjin,415,evoker,preservation,16,5,11
Дрейкорг,howling-fjord,384,evoker,preservation,6,4,2
Drakelussac,silvermoon,384,evoker,preservation,6,4,2
Variandre,ravencrest,384,evoker,preservation,6,4,2
Zaffira,kazzak,384,evoker,preservation,6,4,2
Momodragon,draenor,384,evoker,preservation,6,4,2
Killmeifucan,twisting-nether,384,evoker,preservation,6,4,2
Krakadayle,archimonde,384,evoker,preservation,6,4,2
Ahnë,archimonde,384,evoker,preservation,6,4,2
Roastedpig,kazzak,384,evoker,preservation,6,4,2
Snàx,aggra-português,384,evoker,preservation,6,4,2
Aymoreth,argent-dawn,384,evoker,preservation,6,4,2
Grumes,blackmoore,384,evoker,preservation,6,4,2
Bindrasz,ahnqiraj,384,evoker,preservation,6,4,2
Seboker,nemesis,384,evoker,preservation,6,4,2
Killafoolz,kazzak,384,evoker,preservation,12,4,8
Evokker,antonidas,384,evoker,preservation,12,4,8
Yaraxes,outland,384,evoker,preservation,12,4,8
Tokvoker,tarren-mill,384,evoker,preservation,12,4,8
Драксинед,howling-fjord,384,evoker,preservation,12,4,8
Azdaja,blackmoore,384,evoker,preservation,12,4,8
Галактиг,thermaplugg,384,evoker,preservation,12,4,8
Feradely,thrall,384,evoker,preservation,12,4,8
Toílet,blackmoore,384,evoker,preservation,12,4,8
Zelenobelata,neptulon,384,evoker,preservation,12,4,8
Ninhursag,hyjal,384,evoker,preservation,12,4,8
Feyrbrand,ysera,384,evoker,preservation,12,4,8
Arniye,ravencrest,384,evoker,preservation,12,4,8
Woke,the-venture-co,384,evoker,preservation,12,4,8
Multytür,antonidas,384,evoker,preservation,18,4,14
Lohis,grim-batol,384,evoker,preservation,18,4,14
Dractharion,blackrock,384,evoker,preservation,18,4,14
Fogwing,ravencrest,384,evoker,preservation,18,4,14
Belzilian,dalaran,384,evoker,preservation,18,4,14
Nicnacx,stormscale,383,evoker,preservation,6,4,2
Кефтыме,soulflayer,383,evoker,preservation,6,4,2
Timeshifter,stormscale,383,evoker,preservation,6,4,2
Thenotelmat,twisting-nether,383,evoker,preservation,6,4,2
Сантанико,grom,383,evoker,preservation,12,4,8
Cxsmetic,antonidas,383,evoker,preservation,12,4,8
Ignisaureus,silvermoon,383,evoker,preservation,12,4,8
Pureshot,archimonde,383,evoker,preservation,12,4,8
Flawxy,blackmoore,383,evoker,preservation,12,4,8
Renistra,argent-dawn,383,evoker,preservation,12,4,8
Yaldthion,dun-modr,383,evoker,preservation,18,4,14
Steadyop,doomhammer,382,evoker,preservation,6,4,2
Dolceprada,stormscale,381,evoker,preservation,12,4,8
Dragonboss,doomhammer,380,evoker,preservation,12,4,8
Мизурион,gordunni,379,evoker,preservation,12,4,8
Ekko,nethersturm,379,evoker,preservation,13,4,9
Sinastral,sanguino,350,evoker,preservation,11,4,7
Lycêrâ,antonidas,330,evoker,preservation,9,6,3
Zarog,frostwolf,303,evoker,preservation,7,4,3
Soø,kazzak,288,evoker,preservation,6,3,3
Zordrach,quelthalas,288,evoker,preservation,6,3,3
Flâneur,ysondre,288,evoker,preservation,6,3,3
Botomforgold,ravencrest,288,evoker,preservation,6,3,3
Colacorta,zuljin,288,evoker,preservation,6,3,3
Ramilbest,ravencrest,288,evoker,preservation,6,3,3
Noogon,outland,288,evoker,preservation,6,3,3
Jackarlys,outland,288,evoker,preservation,6,3,3
Alldru,outland,288,evoker,preservation,6,3,3
Моралдракон,soulflayer,288,evoker,preservation,6,3,3
Meezyevo,ragnaros,288,evoker,preservation,6,3,3
Konstraz,kazzak,288,evoker,preservation,6,3,3
Rippo,tarren-mill,288,evoker,preservation,6,3,3
Знамядрак,soulflayer,288,evoker,preservation,6,3,3
Nezruslfarm,cthun,288,evoker,preservation,6,3,3
Espâgnøl,hyjal,288,evoker,preservation,6,3,3
Alicendre,hyjal,288,evoker,preservation,6,3,3
Jpeo,blackhand,288,evoker,preservation,6,3,3
Eurydíke,blackhand,288,evoker,preservation,6,3,3
Shôrty,ravencrest,288,evoker,preservation,6,3,3
Saphiraa,lightnings-blade,288,evoker,preservation,6,3,3
Spudvoker,silvermoon,288,evoker,preservation,6,3,3
Dokkamok,hyjal,288,evoker,preservation,6,3,3
Психея,soulflayer,288,evoker,preservation,6,3,3
Zanarian,defias-brotherhood,288,evoker,preservation,6,3,3
Azwel,khaz-modan,288,evoker,preservation,6,3,3
Ivokerz,tarren-mill,288,evoker,preservation,6,3,3
Meyowuo,doomhammer,288,evoker,preservation,6,3,3
Niffdra,twisting-nether,288,evoker,preservation,6,3,3
Gloris,aegwynn,288,evoker,preservation,6,3,3
Keizal,twisting-nether,288,evoker,preservation,6,3,3
Jmý,tarren-mill,288,evoker,preservation,6,3,3
Släshés,ravencrest,288,evoker,preservation,6,3,3
Morkek,dun-modr,288,evoker,preservation,6,3,3
Kanketo,ravencrest,288,evoker,preservation,6,3,3
Ceroxs,aegwynn,288,evoker,preservation,6,3,3
Asrwea,draenor,288,evoker,preservation,6,3,3
Pruttburk,draenor,288,evoker,preservation,6,3,3
Distinkd,draenor,288,evoker,preservation,6,3,3
Evokimag,grim-batol,288,evoker,preservation,6,3,3
Notadvanced,draenor,288,evoker,preservation,6,3,3
Cauter,draenor,288,evoker,preservation,6,3,3
Scottpula,tarren-mill,288,evoker,preservation,6,3,3
Renalia,blackrock,288,evoker,preservation,6,3,3
Speckjarrow,blackrock,288,evoker,preservation,6,3,3
Tactician,stormreaver,288,evoker,preservation,6,3,3
Cadwalader,blades-edge,288,evoker,preservation,12,3,9
Elderruan,shattered-hand,288,evoker,preservation,12,3,9
Khaliy,blackrock,288,evoker,preservation,12,3,9
Edgybeb,archimonde,288,evoker,preservation,12,3,9
Siigge,draenor,288,evoker,preservation,12,3,9
Reelona,silvermoon,288,evoker,preservation,12,3,9
Effrt,ravencrest,288,evoker,preservation,12,3,9
Monftroglou,archimonde,288,evoker,preservation,12,3,9
Taktcik,archimonde,288,evoker,preservation,12,3,9
Dreamdoll,tarren-mill,288,evoker,preservation,12,3,9
Fumfum,twisting-nether,288,evoker,preservation,12,3,9
Боевойхомякд,howling-fjord,288,evoker,preservation,12,3,9
Chrisussy,argent-dawn,288,evoker,preservation,12,3,9
Bemil,twisting-nether,288,evoker,preservation,12,3,9
Terrorwings,twisting-nether,288,evoker,preservation,12,3,9
Moltenazo,dun-modr,288,evoker,preservation,13,3,10
Милеис,soulflayer,287,evoker,preservation,6,3,3
Elexatra,hyjal,287,evoker,preservation,12,3,9
Iashiak,silvermoon,286,evoker,preservation,6,3,3
Flymetothemo,twisting-nether,286,evoker,preservation,12,3,9
Лунет,lich-king,286,evoker,preservation,12,3,9
Valystrá,die-aldor,285,evoker,preservation,24,3,21
Quarsilly,frostwolf,271,evoker,preservation,11,3,8
Trellie,die-aldor,255,evoker,preservation,11,3,8
Smoochbumble,argent-dawn,240,evoker,preservation,9,3,6
Agnî,sanguino,240,evoker,preservation,9,3,6
Nêrifiel,hyjal,239,evoker,preservation,5,3,2
Provôker,tarren-mill,223,evoker,preservation,8,3,5
Baranzion,twisting-nether,207,evoker,preservation,8,3,5
Nordomu,silvermoon,192,evoker,preservation,6,2,4
Shëitan,sinstralis,192,evoker,preservation,6,2,4
Sénkú,silvermoon,192,evoker,preservation,6,2,4
Crazylucifer,kazzak,192,evoker,preservation,6,2,4
Burndaddy,dun-modr,192,evoker,preservation,6,2,4
Sloeez,kazzak,192,evoker,preservation,6,2,4
Asunarion,silvermoon,192,evoker,preservation,6,2,4
Змийх,gordunni,192,evoker,preservation,6,2,4
Alariath,mannoroth,192,evoker,preservation,6,2,4
Youzfull,blackrock,192,evoker,preservation,6,2,4
Sheràqt,blackrock,192,evoker,preservation,6,2,4
Shinad,ravencrest,192,evoker,preservation,6,2,4
Язычник,thermaplugg,192,evoker,preservation,6,2,4
Tamargon,frostwhisper,192,evoker,preservation,6,2,4
Campus,blackrock,192,evoker,preservation,6,2,4
Dno,archimonde,192,evoker,preservation,6,2,4
Eymo,archimonde,192,evoker,preservation,6,2,4
Flipflapflop,twisting-nether,192,evoker,preservation,6,2,4
Whatisthis,archimonde,192,evoker,preservation,6,2,4
Freesckretx,archimonde,192,evoker,preservation,6,2,4
Puzzles,ravencrest,192,evoker,preservation,6,2,4
Solutionevok,aegwynn,192,evoker,preservation,6,2,4
Glurakk,aegwynn,192,evoker,preservation,6,2,4
Hound,lordaeron,192,evoker,preservation,6,2,4
Høt,nemesis,192,evoker,preservation,6,2,4
Azurog,blackmoore,192,evoker,preservation,6,2,4
Zendervish,draenor,192,evoker,preservation,6,2,4
Drunkvoker,stormscale,192,evoker,preservation,6,2,4
Cousinbetty,defias-brotherhood,192,evoker,preservation,6,2,4
Garussy,draenor,192,evoker,preservation,6,2,4
Dragonlol,stormscale,192,evoker,preservation,6,2,4
Maudragosa,blackmoore,192,evoker,preservation,6,2,4
Glurak,stormscale,192,evoker,preservation,6,2,4
Voldermort,ravencrest,192,evoker,preservation,6,2,4
Rngmåchinè,ravencrest,192,evoker,preservation,6,2,4
Mistime,twisting-nether,192,evoker,preservation,6,2,4
Dragonzo,arathor,192,evoker,preservation,6,2,4
Vermithors,ravencrest,192,evoker,preservation,6,2,4
Adriia,ravencrest,192,evoker,preservation,6,2,4
Arbîter,eredar,192,evoker,preservation,6,2,4
Jaratitz,dun-modr,192,evoker,preservation,6,2,4
Иванза,howling-fjord,192,evoker,preservation,6,2,4
Soondeleted,eredar,192,evoker,preservation,6,2,4
Pico,madmortem,192,evoker,preservation,12,2,10
Rhäegal,kaelthas,192,evoker,preservation,12,2,10
Lazorkröte,blackrock,192,evoker,preservation,12,2,10
Teyvoker,blackmoore,192,evoker,preservation,12,2,10
Flametender,silvermoon,192,evoker,preservation,12,2,10
Dráthír,blackrock,192,evoker,preservation,12,2,10
Margouillax,archimonde,192,evoker,preservation,12,2,10
Lììn,hyjal,192,evoker,preservation,12,2,10
Dragonsphera,sylvanas,192,evoker,preservation,12,2,10
Suicidel,silvermoon,192,evoker,preservation,12,2,10
Macdrac,area-52,192,evoker,preservation,18,2,16
Dracipsouk,drakthul,192,evoker,preservation,18,2,16
Morpheuzx,tarren-mill,191,evoker,preservation,6,2,4
Drackial,zuljin,191,evoker,preservation,6,2,4
Ясосалочка,howling-fjord,191,evoker,preservation,6,2,4
Yuyux,sanguino,191,evoker,preservation,6,2,4
Адалдракулий,howling-fjord,191,evoker,preservation,6,2,4
Azza,uldum,191,evoker,preservation,12,2,10
Flameclaw,argent-dawn,191,evoker,preservation,12,2,10
Viorias,argent-dawn,191,evoker,preservation,27,2,25
Eldrax,emerald-dream,159,evoker,preservation,5,2,3
Cirøvoke,ravencrest,159,evoker,preservation,5,2,3
Kynirà,magtheridon,159,evoker,preservation,5,2,3
Taynia,stormscale,144,evoker,preservation,9,2,7
Stinka,blackmoore,138,evoker,preservation,9,5,4
Asharys,argent-dawn,138,evoker,preservation,17,4,13
Primepewpew,ragnaros,138,evoker,preservation,15,3,12
Zzaazaa,argent-dawn,137,evoker,preservation,10,3,7
Marcelproust,burning-legion,127,evoker,preservation,4,2,2
Dewi,anachronos,96,evoker,preservation,6,1,5
Rhaenaya,tarren-mill,96,evoker,preservation,6,1,5
Beec,tarren-mill,96,evoker,preservation,6,1,5
Rickastley,ragnaros,96,evoker,preservation,6,1,5
Kedel,tarren-mill,96,evoker,preservation,6,1,5
Drakenballen,ragnaros,96,evoker,preservation,6,1,5
Lumberdrake,stormscale,96,evoker,preservation,6,1,5
Tetrís,blackhand,96,evoker,preservation,6,1,5
Drgn,blackhand,96,evoker,preservation,6,1,5
Tokidormi,nemesis,96,evoker,preservation,6,1,5
Pavelito,ysondre,96,evoker,preservation,6,1,5
Mobidra,twisting-nether,96,evoker,preservation,6,1,5
Азивокер,howling-fjord,96,evoker,preservation,6,1,5
Mulqahdiiv,archimonde,96,evoker,preservation,6,1,5
Batmanjasii,eredar,96,evoker,preservation,6,1,5
Ch,ghostlands,96,evoker,preservation,6,1,5
Louzard,draenor,96,evoker,preservation,6,1,5
Hizzo,burning-legion,96,evoker,preservation,6,1,5
Huangzhang,burning-legion,96,evoker,preservation,6,1,5
Yaboismok,burning-legion,96,evoker,preservation,6,1,5
Drachenlord,alakir,96,evoker,preservation,6,1,5
Foldoudoune,archimonde,96,evoker,preservation,6,1,5
Larrykoopa,hyjal,96,evoker,preservation,6,1,5
Смехокрыл,deathguard,96,evoker,preservation,6,1,5
Xqa,hyjal,96,evoker,preservation,6,1,5
Oogabuga,outland,96,evoker,preservation,6,1,5
Brystrasza,quelthalas,96,evoker,preservation,6,1,5
Awienz,kazzak,96,evoker,preservation,6,1,5
Gwindora,azjolnerub,96,evoker,preservation,6,1,5
Dragonpro,kazzak,96,evoker,preservation,6,1,5
Madbreath,cthun,96,evoker,preservation,6,1,5
Tályn,twisting-nether,96,evoker,preservation,6,1,5
Charovoker,blackmoore,96,evoker,preservation,6,1,5
Kaezmasterx,blackrock,96,evoker,preservation,6,1,5
Chocodragon,blackmoore,96,evoker,preservation,6,1,5
Breathpitt,blackrock,96,evoker,preservation,6,1,5
Ceerdrogo,twisting-nether,96,evoker,preservation,9,1,8
Tatsuki,arthas,96,evoker,preservation,12,1,11
Frreeyya,silvermoon,96,evoker,preservation,12,1,11
Baddragonxxl,sylvanas,96,evoker,preservation,12,1,11
Vullgred,sylvanas,96,evoker,preservation,12,1,11
Sopollina,draenor,96,evoker,preservation,12,1,11
Vänesiä,sylvanas,96,evoker,preservation,12,1,11
Heidrun,ravenholdt,95,evoker,preservation,6,1,5
Kelisthrasa,antonidas,95,evoker,preservation,6,1,5
Fluffykoi,silvermoon,95,evoker,preservation,12,1,11
Imend,stormscale,79,evoker,preservation,5,1,4
Aarón,der-mithrilorden,79,evoker,preservation,5,1,4
Blokie,silvermoon,79,evoker,preservation,5,1,4
Sentos,blackmoore,64,evoker,preservation,10,1,9
Draginy,blackrock,63,evoker,preservation,2,2,0
Dopëshow,drakthul,48,evoker,preservation,3,1,2
Faijer,blackmoore,42,evoker,preservation,10,3,7
Nickydragonx,stormscale,42,evoker,preservation,10,3,7
Flyvern,kazzak,42,evoker,preservation,8,2,6
Ятутглавный,howling-fjord,16,evoker,preservation,1,1,0
Кеннокс,soulflayer,2177,evoker,devastation,86,49,37
Hehehihihaha,ravencrest,2176,evoker,devastation,84,44,40
Animenorgam,alakir,2126,evoker,devastation,254,151,103
Rexzstrasza,eredar,2114,evoker,devastation,78,49,29
Sârmikas,blackhand,2113,evoker,devastation,120,67,53
Kàido,ravencrest,2110,evoker,devastation,360,185,175
Ryujíin,kazzak,2045,evoker,devastation,89,59,30
Drakenyasha,tarren-mill,2045,evoker,devastation,207,103,104
Heõ,twisting-nether,2034,evoker,devastation,207,102,105
Babodrake,blackhand,2019,evoker,devastation,55,27,28
Нерфсрочно,gordunni,1990,evoker,devastation,228,114,114
Meust,blackrock,1960,evoker,devastation,48,33,15
Claxy,ragnaros,1952,evoker,devastation,72,38,34
Diznutz,kazzak,1949,evoker,devastation,90,45,45
Wexvoker,darksorrow,1936,evoker,devastation,109,59,50
Darkssoul,outland,1932,evoker,devastation,96,52,44
Twodeep,blackrock,1930,evoker,devastation,123,64,59
Myxker,burning-legion,1922,evoker,devastation,77,36,41
Dracohfeu,archimonde,1913,evoker,devastation,82,44,38
Evodraxx,hyjal,1911,evoker,devastation,72,32,40
Brokz,twisting-nether,1906,evoker,devastation,110,56,54
Ízma,ravencrest,1894,evoker,devastation,192,99,93
Oontäälihis,ravencrest,1889,evoker,devastation,157,84,73
Edvoker,twisting-nether,1875,evoker,devastation,120,62,58
Lesgrossman,ravencrest,1870,evoker,devastation,42,26,16
Ipanicsoar,tarren-mill,1869,evoker,devastation,128,64,64
Nigesaurus,burning-legion,1862,evoker,devastation,39,21,18
Enzetrius,argent-dawn,1861,evoker,devastation,36,22,14
Atoll,scarshield-legion,1858,evoker,devastation,55,29,26
Lizardbøi,blackhand,1855,evoker,devastation,72,37,35
Silvior,outland,1854,evoker,devastation,60,29,31
Frozendragon,twisting-nether,1849,evoker,devastation,45,32,13
Xzvoker,kazzak,1848,evoker,devastation,134,67,67
Balthinar,argent-dawn,1846,evoker,devastation,66,31,35
Calygosa,antonidas,1843,evoker,devastation,36,23,13
Advancedboy,archimonde,1839,evoker,devastation,69,32,37
Sagrax,silvermoon,1835,evoker,devastation,68,40,28
Mizamiza,blackrock,1832,evoker,devastation,142,75,67
Korvi,ravencrest,1830,evoker,devastation,44,25,19
Azorgaron,outland,1827,evoker,devastation,36,23,13
Ryuu,mazrigos,1823,evoker,devastation,41,22,19
Irvethius,argent-dawn,1822,evoker,devastation,203,103,100
Tremmérz,outland,1821,evoker,devastation,66,34,32
Bigmacfrite,ysondre,1821,evoker,devastation,88,45,43
Дракшотик,soulflayer,1817,evoker,devastation,30,19,11
Jamzyevoker,emerald-dream,1816,evoker,devastation,49,26,23
Ryuujin,outland,1815,evoker,devastation,66,30,36
Amadeusx,ravencrest,1810,evoker,devastation,55,30,25
Valdrakon,doomhammer,1807,evoker,devastation,66,39,27
Zmej,twisting-nether,1807,evoker,devastation,60,27,33
Дарратель,gordunni,1806,evoker,devastation,195,106,89
Wuiflyta,dun-modr,1805,evoker,devastation,65,29,36
Kamehaméha,outland,1803,evoker,devastation,48,26,22
Lidldragon,argent-dawn,1801,evoker,devastation,32,23,9
Hëroinhenry,tarren-mill,1794,evoker,devastation,48,33,15
Драгонтьма,gordunni,1793,evoker,devastation,77,38,39
Avë,kazzak,1790,evoker,devastation,77,39,38
Shaze,zuljin,1788,evoker,devastation,59,39,20
Rahzk,twisting-nether,1788,evoker,devastation,48,28,20
Eldunaries,argent-dawn,1788,evoker,devastation,105,53,52
Sloeez,kazzak,1782,evoker,devastation,48,24,24
Evøkergøðx,outland,1779,evoker,devastation,97,51,46
Apacstrasza,ragnaros,1776,evoker,devastation,116,57,59
Nazyr,blackhand,1765,evoker,devastation,60,32,28
Sawk,archimonde,1762,evoker,devastation,102,63,39
Obbwoke,ravencrest,1760,evoker,devastation,84,44,40
Дреадди,soulflayer,1756,evoker,devastation,76,40,36
Верестраз,howling-fjord,1746,evoker,devastation,72,34,38
Jeannedebruj,ravencrest,1725,evoker,devastation,165,81,84
Keñwøød,ysondre,1717,evoker,devastation,41,19,22
Kymaíra,hyjal,1716,evoker,devastation,48,22,26
Archdragon,argent-dawn,1715,evoker,devastation,103,59,44
Tetsú,tarren-mill,1714,evoker,devastation,90,53,37
Melodio,outland,1713,evoker,devastation,60,37,23
Kôlaghan,archimonde,1713,evoker,devastation,35,20,15
Zendaÿa,silvermoon,1713,evoker,devastation,60,29,31
Famouszorc,sanguino,1704,evoker,devastation,168,96,72
Rokki,blackrock,1701,evoker,devastation,82,45,37
Ларенил,gordunni,1701,evoker,devastation,66,28,38
Sintharion,ravencrest,1699,evoker,devastation,93,47,46
Mørningstãr,ragnaros,1698,evoker,devastation,36,22,14
Cybraxq,kazzak,1692,evoker,devastation,30,18,12
Хетсв,gordunni,1691,evoker,devastation,96,55,41
Hollowbreath,sanguino,1685,evoker,devastation,209,101,108
Duvahkahr,ragnaros,1683,evoker,devastation,57,28,29
Jamiewing,ravencrest,1679,evoker,devastation,159,81,78
Lurkî,blackhand,1678,evoker,devastation,48,21,27
Sadlylate,dentarg,1677,evoker,devastation,66,34,32
Скорукх,gordunni,1671,evoker,devastation,54,34,20
Amnevoker,dalaran,1671,evoker,devastation,30,18,12
Cinnannoe,tarren-mill,1670,evoker,devastation,151,85,66
Varagon,rexxar,1665,evoker,devastation,53,32,21
Гневиан,eversong,1660,evoker,devastation,160,81,79
Аксиомх,soulflayer,1658,evoker,devastation,42,20,22
Фиамниэль,gordunni,1655,evoker,devastation,48,22,26
Yuhabahha,kazzak,1653,evoker,devastation,166,87,79
Flâneur,ysondre,1652,evoker,devastation,53,25,28
Fyndassil,blackrock,1652,evoker,devastation,59,21,38
Dispelgodx,eredar,1647,evoker,devastation,42,20,22
Hanoostrasz,tarren-mill,1646,evoker,devastation,129,70,59
Dracoli,eredar,1646,evoker,devastation,91,48,43
Sürion,grim-batol,1642,evoker,devastation,72,39,33
Ясъелинеры,gordunni,1640,evoker,devastation,54,31,23
Tezkaz,blackmoore,1639,evoker,devastation,283,145,138
Draxxys,blackmoore,1637,evoker,devastation,66,33,33
Dragonide,draenor,1636,evoker,devastation,35,20,15
Serulyon,draenor,1636,evoker,devastation,84,43,41
Ruinastrasza,silvermoon,1636,evoker,devastation,187,93,94
Voklath,kazzak,1636,evoker,devastation,61,30,31
Hyperan,twisting-nether,1635,evoker,devastation,82,40,42
Rzektwo,eredar,1634,evoker,devastation,54,24,30
Aegón,uldum,1633,evoker,devastation,84,38,46
Niddhøgg,ragnaros,1632,evoker,devastation,36,21,15
Stefanosxios,bloodfeather,1631,evoker,devastation,125,69,56
Papayoyo,draenor,1630,evoker,devastation,156,75,81
Merkels,blackmoore,1629,evoker,devastation,323,162,161
Crueh,outland,1628,evoker,devastation,36,17,19
Saintly,kult-der-verdammten,1627,evoker,devastation,66,33,33
Meust,destromath,1627,evoker,devastation,42,20,22
Deathdream,stormscale,1627,evoker,devastation,36,17,19
Eskavoker,kazzak,1623,evoker,devastation,36,22,14
Грринч,deathweaver,1619,evoker,devastation,94,49,45
Саммеракс,gordunni,1619,evoker,devastation,60,25,35
Aesstrass,hyjal,1618,evoker,devastation,47,27,20
Mazaw,burning-legion,1613,evoker,devastation,72,41,31
Batsquatch,argent-dawn,1612,evoker,devastation,36,23,13
Drazam,blackrock,1612,evoker,devastation,94,55,39
Zapaflap,silvermoon,1612,evoker,devastation,119,65,54
Homeoffice,zenedar,1611,evoker,devastation,60,29,31
Släshés,ravencrest,1610,evoker,devastation,54,23,31
Леерустан,howling-fjord,1609,evoker,devastation,44,26,18
Denegos,sylvanas,1606,evoker,devastation,66,40,26
Drakshoff,khaz-modan,1606,evoker,devastation,265,142,123
Ludwoker,tarren-mill,1605,evoker,devastation,67,44,23
Lizarduck,tarren-mill,1605,evoker,devastation,52,26,26
Пивнаябошка,soulflayer,1603,evoker,devastation,36,19,17
Shumma,frostmane,1603,evoker,devastation,75,34,41
Voldermort,ravencrest,1602,evoker,devastation,77,46,31
Delorraine,burning-legion,1602,evoker,devastation,30,17,13
Мнякуня,howling-fjord,1600,evoker,devastation,46,24,22
Спайрок,gordunni,1600,evoker,devastation,158,78,80
Drakeflaps,lightnings-blade,1599,evoker,devastation,30,18,12
Soleric,drakthul,1599,evoker,devastation,121,57,64
Pêengei,blackrock,1596,evoker,devastation,66,36,30
Углекислот,howling-fjord,1595,evoker,devastation,78,35,43
Krothus,outland,1590,evoker,devastation,124,67,57
Ðø,antonidas,1589,evoker,devastation,35,18,17
Draguzee,draenor,1579,evoker,devastation,36,23,13
Lumberdrake,stormscale,1579,evoker,devastation,40,24,16
Ysterja,darkspear,1577,evoker,devastation,36,27,9
Øxyom,archimonde,1570,evoker,devastation,46,27,19
Ocanada,draenor,1563,evoker,devastation,84,45,39
Инсейнмэн,soulflayer,1562,evoker,devastation,133,69,64
Touchmywings,ravencrest,1560,evoker,devastation,24,17,7
Drôgon,archimonde,1560,evoker,devastation,60,28,32
Аймбадикабтв,howling-fjord,1555,evoker,devastation,72,33,39
Devoxz,tarren-mill,1554,evoker,devastation,54,30,24
Lagerstrasza,stormreaver,1553,evoker,devastation,42,21,21
Ch,ghostlands,1546,evoker,devastation,47,22,25
Dragonandyy,blackrock,1544,evoker,devastation,71,38,33
Kayly,twisting-nether,1540,evoker,devastation,42,29,13
Emmagosa,argent-dawn,1539,evoker,devastation,96,52,44
Øseria,khaz-modan,1538,evoker,devastation,124,73,51
Màlakir,chogall,1537,evoker,devastation,50,24,26
Tiganj,silvermoon,1536,evoker,devastation,48,31,17
Woasid,outland,1536,evoker,devastation,42,26,16
Shimmerscale,blackhand,1533,evoker,devastation,111,60,51
Hömeöffice,sylvanas,1532,evoker,devastation,50,26,24
Merqury,ravencrest,1529,evoker,devastation,24,16,8
Swapxyevo,ravencrest,1525,evoker,devastation,30,16,14
Филлид,gordunni,1525,evoker,devastation,43,19,24
Badrig,silvermoon,1523,evoker,devastation,210,112,98
Ольменго,fordragon,1523,evoker,devastation,44,18,26
Spýröo,kazzak,1522,evoker,devastation,108,67,41
Gämeovêrkïd,archimonde,1522,evoker,devastation,59,35,24
Hyperflexx,blackrock,1521,evoker,devastation,30,16,14
Cûddles,hyjal,1521,evoker,devastation,138,70,68
Bindrasz,ahnqiraj,1520,evoker,devastation,36,16,20
Savaithnir,draenor,1513,evoker,devastation,30,16,14
Gasparievok,sylvanas,1513,evoker,devastation,135,69,66
Lilpooper,bloodhoof,1508,evoker,devastation,61,32,29
Telepathy,ravencrest,1507,evoker,devastation,29,18,11
Lazurius,ravencrest,1507,evoker,devastation,54,26,28
Skywitch,ragnaros,1507,evoker,devastation,60,28,32
Draghad,blackmoore,1506,evoker,devastation,75,37,38
Phanex,bloodhoof,1506,evoker,devastation,66,28,38
Parisinka,silvermoon,1503,evoker,devastation,341,178,163
Ironwing,sanguino,1502,evoker,devastation,456,234,222
Лабриса,galakrond,1501,evoker,devastation,230,113,117
Bakspek,kilrogg,1498,evoker,devastation,24,16,8
Mommystrasza,dentarg,1493,evoker,devastation,92,46,46
Agnî,sanguino,1490,evoker,devastation,82,40,42
Kaynyxia,argent-dawn,1487,evoker,devastation,45,25,20
Deadlyvok,zenedar,1486,evoker,devastation,24,16,8
Bodytypechad,ravencrest,1482,evoker,devastation,60,32,28
Dracyan,taerar,1479,evoker,devastation,42,24,18
Fogwing,ravencrest,1478,evoker,devastation,71,38,33
Arbylegion,outland,1478,evoker,devastation,118,63,55
Piyuli,silvermoon,1475,evoker,devastation,49,27,22
Yol,bladefist,1474,evoker,devastation,66,30,36
Draakoñ,outland,1473,evoker,devastation,42,18,24
Dowaa,tarren-mill,1473,evoker,devastation,48,20,28
Dragorus,stormscale,1472,evoker,devastation,81,41,40
Rowzy,sylvanas,1468,evoker,devastation,148,77,71
Motloh,ravencrest,1468,evoker,devastation,42,20,22
Уфдрактир,howling-fjord,1466,evoker,devastation,48,23,25
Shenronblue,bloodscalp,1465,evoker,devastation,30,16,14
Nuvese,tarren-mill,1460,evoker,devastation,36,16,20
Mölnlycke,twisting-nether,1457,evoker,devastation,53,29,24
Baroqs,antonidas,1456,evoker,devastation,24,18,6
Простокоршун,howling-fjord,1456,evoker,devastation,30,20,10
Nagoli,silvermoon,1456,evoker,devastation,52,27,25
Grillkylling,outland,1454,evoker,devastation,69,38,31
Magmarôs,argent-dawn,1453,evoker,devastation,81,48,33
Кунидракон,gordunni,1453,evoker,devastation,86,40,46
Malfoyer,arathor,1452,evoker,devastation,54,30,24
Ghiscar,dentarg,1451,evoker,devastation,102,50,52
Chuckyy,archimonde,1446,evoker,devastation,48,26,22
Лечулечу,blackscar,1442,evoker,devastation,90,39,51
Judda,stormscale,1438,evoker,devastation,30,15,15
Nerfmeplze,outland,1438,evoker,devastation,30,15,15
Паунфаунд,eversong,1435,evoker,devastation,96,45,51
Норимида,soulflayer,1434,evoker,devastation,67,39,28
Feyrbrand,ysera,1434,evoker,devastation,92,48,44
Dikkondrus,twisting-nether,1434,evoker,devastation,101,50,51
Hellvarg,twisting-nether,1433,evoker,devastation,30,18,12
Ken,la-croisade-écarlate,1433,evoker,devastation,207,104,103
Drunkino,aegwynn,1432,evoker,devastation,60,31,29
Drakea,sanguino,1432,evoker,devastation,98,49,49
Juhadormu,stormreaver,1432,evoker,devastation,30,15,15
Pippomale,nemesis,1430,evoker,devastation,42,22,20
Йормунгандка,soulflayer,1429,evoker,devastation,39,20,19
Caliss,archimonde,1427,evoker,devastation,71,38,33
Evokimag,grim-batol,1425,evoker,devastation,30,15,15
Yoshinora,archimonde,1424,evoker,devastation,36,19,17
Dreek,emerald-dream,1423,evoker,devastation,30,20,10
Tibimbo,blackrock,1418,evoker,devastation,98,51,47
Drackial,zuljin,1418,evoker,devastation,72,32,40
Yála,anetheron,1416,evoker,devastation,232,116,116
Фаламэйн,soulflayer,1412,evoker,devastation,24,15,9
Solandor,kazzak,1411,evoker,devastation,24,15,9
Flügelnix,blackmoore,1401,evoker,devastation,59,28,31
Draconz,stormrage,1399,evoker,devastation,42,21,21
Avizz,tarren-mill,1396,evoker,devastation,39,21,18
Childofdawn,blackmoore,1392,evoker,devastation,60,36,24
Dreamfyrez,dun-modr,1391,evoker,devastation,60,29,31
Юнигоса,soulflayer,1388,evoker,devastation,36,20,16
Xtdrakaris,uldum,1388,evoker,devastation,478,237,241
Loveheart,die-aldor,1386,evoker,devastation,57,29,28
Ouaitamaman,draenor,1386,evoker,devastation,30,15,15
Kuve,stormscale,1386,evoker,devastation,81,39,42
Tályn,twisting-nether,1385,evoker,devastation,48,25,23
Голденджо,gordunni,1382,evoker,devastation,64,31,33
Honz,antonidas,1380,evoker,devastation,49,23,26
Keeqo,silvermoon,1378,evoker,devastation,54,33,21
Cuufizix,silvermoon,1377,evoker,devastation,70,38,32
Nathraakhza,argent-dawn,1375,evoker,devastation,48,26,22
Dratheon,dun-modr,1375,evoker,devastation,39,20,19
Xéíoín,kazzak,1374,evoker,devastation,78,41,37
Vagar,garona,1369,evoker,devastation,42,20,22
Kirinde,draenor,1368,evoker,devastation,30,19,11
Drákon,dalaran,1368,evoker,devastation,111,50,61
Kaìdo,tarren-mill,1365,evoker,devastation,48,21,27
Marvok,bloodfeather,1363,evoker,devastation,54,19,35
Sakade,archimonde,1359,evoker,devastation,66,22,44
Драгтир,blackscar,1355,evoker,devastation,76,45,31
Nazalath,eonar,1354,evoker,devastation,106,51,55
Nurilla,twisting-nether,1352,evoker,devastation,36,17,19
Saragoza,kirin-tor,1350,evoker,devastation,30,15,15
Smegma,norgannon,1348,evoker,devastation,30,15,15
Ferante,ragnaros,1346,evoker,devastation,131,60,71
Hazzèr,blackrock,1345,evoker,devastation,162,82,80
Thyriån,kazzak,1344,evoker,devastation,42,19,23
Juicyjeffe,blackrock,1341,evoker,devastation,18,14,4
Ксдз,soulflayer,1341,evoker,devastation,60,28,32
Thebigsmoke,lightbringer,1337,evoker,devastation,124,67,57
Yaboismok,burning-legion,1336,evoker,devastation,53,23,30
Potéto,rashgarroth,1334,evoker,devastation,72,31,41
Kuhi,twisting-nether,1328,evoker,devastation,42,18,24
Karnâks,silvermoon,1326,evoker,devastation,30,16,14
Hornytail,doomhammer,1323,evoker,devastation,29,15,14
Димадракон,gordunni,1321,evoker,devastation,58,37,21
Zsyntra,blackmoore,1321,evoker,devastation,30,14,16
Eldraegosa,argent-dawn,1320,evoker,devastation,30,14,16
Yantaî,hyjal,1315,evoker,devastation,48,30,18
Tenshà,nemesis,1314,evoker,devastation,71,35,36
Dakir,blackmoore,1312,evoker,devastation,38,26,12
Seryphys,blackhand,1312,evoker,devastation,48,24,24
Favill,blackhand,1312,evoker,devastation,69,30,39
Snoby,onyxia,1309,evoker,devastation,158,70,88
Nochance,dentarg,1305,evoker,devastation,102,51,51
Darktempest,onyxia,1300,evoker,devastation,66,32,34
Draxone,malfurion,1297,evoker,devastation,54,33,21
Yaldthion,dun-modr,1295,evoker,devastation,54,24,30
Thavion,forscherliga,1291,evoker,devastation,30,14,16
Душнот,fordragon,1283,evoker,devastation,65,35,30
Airbourne,sanguino,1280,evoker,devastation,38,18,20
Dragonaked,silvermoon,1279,evoker,devastation,78,38,40
Sharaxis,blackmoore,1276,evoker,devastation,42,23,19
Gharløk,outland,1276,evoker,devastation,80,43,37
Драганайт,gordunni,1274,evoker,devastation,94,58,36
Shmog,stormscale,1272,evoker,devastation,41,15,26
Ayders,khaz-modan,1270,evoker,devastation,156,76,80
Raagnar,kazzak,1266,evoker,devastation,60,29,31
Ppiaxx,dalaran,1263,evoker,devastation,30,15,15
Itisabuse,antonidas,1262,evoker,devastation,36,18,18
Echoker,stormscale,1261,evoker,devastation,31,16,15
Llael,blackhand,1259,evoker,devastation,86,36,50
Коляомон,gordunni,1256,evoker,devastation,71,38,33
Shoggoth,chogall,1256,evoker,devastation,187,89,98
Emayra,argent-dawn,1253,evoker,devastation,23,14,9
Rafale,the-maelstrom,1253,evoker,devastation,42,21,21
Orazur,hyjal,1247,evoker,devastation,18,13,5
Алексатэтсуя,ashenvale,1247,evoker,devastation,36,18,18
Evojøa,tarren-mill,1246,evoker,devastation,24,13,11
Steeken,haomarush,1246,evoker,devastation,129,59,70
Серцедраконн,gordunni,1246,evoker,devastation,81,36,45
Leyca,outland,1245,evoker,devastation,48,19,29
Veo,aggra-português,1244,evoker,devastation,42,20,22
Доракарис,deathweaver,1243,evoker,devastation,42,20,22
Nyedrak,kilrogg,1239,evoker,devastation,18,13,5
Rieper,twisting-nether,1239,evoker,devastation,207,101,106
Snitties,tarren-mill,1234,evoker,devastation,34,14,20
Rufistraz,burning-legion,1231,evoker,devastation,43,18,25
Haltorr,ravencrest,1230,evoker,devastation,36,13,23
Oudwood,onyxia,1229,evoker,devastation,36,13,23
Xendrag,silvermoon,1227,evoker,devastation,96,45,51
Дыханиеочка,howling-fjord,1227,evoker,devastation,30,13,17
Tokzestra,hyjal,1222,evoker,devastation,62,28,34
Minikuja,culte-de-la-rive-noire,1219,evoker,devastation,233,125,108
Шотнутый,soulflayer,1213,evoker,devastation,51,26,25
Dragoncloak,blackrock,1209,evoker,devastation,106,59,47
Evosker,zuljin,1207,evoker,devastation,48,17,31
Isizzu,draenor,1205,evoker,devastation,73,37,36
Zenda,turalyon,1202,evoker,devastation,67,30,37
Razthyr,twisting-nether,1201,evoker,devastation,70,33,37
Xfckd,ragnaros,1199,evoker,devastation,60,28,32
Wingit,frostmane,1187,evoker,devastation,36,21,15
Mesmerìze,khaz-modan,1185,evoker,devastation,30,14,16
Ryújín,blackhand,1183,evoker,devastation,29,13,16
Папиич,soulflayer,1176,evoker,devastation,59,21,38
Firaxis,kazzak,1173,evoker,devastation,60,32,28
Flaminghot,stormreaver,1173,evoker,devastation,257,137,120
Glennett,silvermoon,1172,evoker,devastation,28,13,15
Dopëshow,drakthul,1170,evoker,devastation,36,20,16
Rhel,the-maelstrom,1170,evoker,devastation,30,15,15
Lugarius,gilneas,1164,evoker,devastation,41,23,18
Camilis,archimonde,1159,evoker,devastation,33,14,19
Tazouu,marécage-de-zangar,1158,evoker,devastation,24,15,9
Рептилойдина,howling-fjord,1154,evoker,devastation,78,37,41
Kmzi,twisting-nether,1151,evoker,devastation,24,12,12
Deny,frostmane,1150,evoker,devastation,18,12,6
Darthagos,outland,1145,evoker,devastation,18,12,6
Zaralek,stormscale,1145,evoker,devastation,18,12,6
Imwhite,doomhammer,1144,evoker,devastation,48,22,26
Туймаада,soulflayer,1141,evoker,devastation,18,12,6
Dracsona,twisting-nether,1141,evoker,devastation,24,12,12
Ahiresegyfej,ragnaros,1139,evoker,devastation,72,39,33
Gissthebuzzy,dun-modr,1138,evoker,devastation,24,12,12
Ekko,nethersturm,1136,evoker,devastation,54,30,24
Scathethrel,draenor,1135,evoker,devastation,24,12,12
Wircea,kazzak,1133,evoker,devastation,18,12,6
Ignisaureus,silvermoon,1133,evoker,devastation,30,13,17
Алыйкиви,howling-fjord,1132,evoker,devastation,33,17,16
Lago,gorgonnash,1130,evoker,devastation,66,36,30
Antistrasza,argent-dawn,1125,evoker,devastation,33,15,18
Sleepnot,argent-dawn,1121,evoker,devastation,18,12,6
Dragomakry,blackmoore,1118,evoker,devastation,54,30,24
Lektar,eredar,1118,evoker,devastation,29,13,16
Deathdula,draenor,1117,evoker,devastation,30,14,16
Dranke,silvermoon,1115,evoker,devastation,85,45,40
Clueless,nemesis,1112,evoker,devastation,29,12,17
Jelboen,draenor,1111,evoker,devastation,34,19,15
Iolite,dun-modr,1111,evoker,devastation,78,39,39
Rytoshi,medivh,1111,evoker,devastation,78,28,50
Azzul,teldrassil,1110,evoker,devastation,31,16,15
Evokíng,argent-dawn,1109,evoker,devastation,97,42,55
Iordred,kazzak,1104,evoker,devastation,24,12,12
Theredpepper,outland,1104,evoker,devastation,30,12,18
Abcxqt,hyjal,1097,evoker,devastation,28,13,15
Dàenérys,hyjal,1089,evoker,devastation,48,31,17
Dragis,die-aldor,1088,evoker,devastation,36,17,19
Crygon,outland,1086,evoker,devastation,42,17,25
Fruhans,tarren-mill,1080,evoker,devastation,29,15,14
Padrepì,nemesis,1078,evoker,devastation,18,13,5
Syraxis,shadowsong,1074,evoker,devastation,22,12,10
Draganeel,frostwolf,1073,evoker,devastation,54,17,37
Raktoy,frostwolf,1071,evoker,devastation,70,28,42
Ferdibaba,aegwynn,1071,evoker,devastation,42,13,29
Мизурион,gordunni,1070,evoker,devastation,24,19,5
Akúda,blackhand,1069,evoker,devastation,42,20,22
Sethos,dalaran,1068,evoker,devastation,36,13,23
Дархо,goldrinn,1059,evoker,devastation,36,21,15
Canitabravar,cthun,1057,evoker,devastation,54,27,27
Fabrizios,blackrock,1055,evoker,devastation,24,11,13
Dragônslayer,amanthul,1054,evoker,devastation,24,14,10
Infopaki,stormscale,1054,evoker,devastation,19,11,8
Krazuntus,argent-dawn,1054,evoker,devastation,24,11,13
Beeragos,deathwing,1053,evoker,devastation,18,11,7
Калесгоз,howling-fjord,1053,evoker,devastation,24,11,13
Pêrcevâl,archimonde,1053,evoker,devastation,24,11,13
Dragonlia,blackrock,1052,evoker,devastation,18,11,7
Lecutos,sunstrider,1052,evoker,devastation,18,11,7
Lonte,hyjal,1052,evoker,devastation,18,11,7
Алрад,gordunni,1051,evoker,devastation,21,12,9
Daboc,tarren-mill,1051,evoker,devastation,74,30,44
Kirkgon,terokkar,1047,evoker,devastation,42,15,27
Dovakin,arathi,1043,evoker,devastation,20,12,8
Otr,draenor,1037,evoker,devastation,72,29,43
Гекаш,soulflayer,1034,evoker,devastation,36,11,25
Krithdow,terokkar,1031,evoker,devastation,23,13,10
Elorand,ulduar,1025,evoker,devastation,78,29,49
Bubbleblower,stormscale,1023,evoker,devastation,16,11,5
Rîncêwind,uldum,1018,evoker,devastation,42,25,17
Pedogos,outland,1016,evoker,devastation,75,31,44
Draqthyr,frostmane,1015,evoker,devastation,23,11,12
Arella,mannoroth,1006,evoker,devastation,149,76,73
Drakridarn,kazzak,999,evoker,devastation,29,11,18
Mallor,kirin-tor,990,evoker,devastation,36,14,22
Dragonhero,arygos,986,evoker,devastation,96,52,44
Julerion,draenor,984,evoker,devastation,42,26,16
Ashlàr,earthen-ring,979,evoker,devastation,51,21,30
Deskölorio,shendralar,978,evoker,devastation,22,13,9
Ewoky,ravencrest,976,evoker,devastation,30,12,18
Vucashi,blackhand,974,evoker,devastation,46,18,28
Bläckrow,tarren-mill,960,evoker,devastation,12,10,2
Rhegal,auchindoun,960,evoker,devastation,12,10,2
Billyhassan,stormscale,960,evoker,devastation,12,10,2
Spicylizard,stormscale,960,evoker,devastation,18,10,8
Soondeleted,eredar,960,evoker,devastation,18,10,8
Kiwí,antonidas,960,evoker,devastation,18,10,8
Azustraza,ysondre,960,evoker,devastation,24,10,14
Jinthyr,anachronos,959,evoker,devastation,12,10,2
Lùñe,hyjal,959,evoker,devastation,12,10,2
Terradòr,die-aldor,959,evoker,devastation,18,10,8
Dractaris,khaz-modan,959,evoker,devastation,18,10,8
Hästdrake,the-maelstrom,959,evoker,devastation,30,10,20
Drevo,nemesis,958,evoker,devastation,12,10,2
Волккейн,soulflayer,958,evoker,devastation,18,10,8
Maccen,twisting-nether,955,evoker,devastation,18,10,8
Danaval,blackhand,955,evoker,devastation,18,10,8
Enzospatalo,nemesis,955,evoker,devastation,18,10,8
Grajade,dun-modr,954,evoker,devastation,18,10,8
Batmanjasii,eredar,953,evoker,devastation,18,10,8
Boulior,defias-brotherhood,952,evoker,devastation,24,10,14
Akaitzu,blackmoore,950,evoker,devastation,18,10,8
Lizzardhero,kazzak,948,evoker,devastation,24,10,14
Быковскии,howling-fjord,939,evoker,devastation,60,34,26
Scalo,kazzak,935,evoker,devastation,17,10,7
Dragotar,malygos,932,evoker,devastation,97,50,47
Jkrowlingxox,ravencrest,928,evoker,devastation,36,17,19
Oeos,dragonblight,925,evoker,devastation,54,18,36
Leskano,aegwynn,923,evoker,devastation,30,14,16
Drakkisat,archimonde,918,evoker,devastation,34,17,17
Starblazed,defias-brotherhood,916,evoker,devastation,12,10,2
Dracofeuxd,archimonde,912,evoker,devastation,21,10,11
Azza,uldum,912,evoker,devastation,36,14,22
Stormydude,doomhammer,907,evoker,devastation,24,13,11
Tendoker,ragnaros,888,evoker,devastation,17,10,7
Sleipnyr,garrosh,888,evoker,devastation,60,27,33
Donairian,doomhammer,886,evoker,devastation,63,31,32
Blazinamazin,korgall,884,evoker,devastation,22,10,12
Tenkenfutsu,elune,879,evoker,devastation,100,41,59
Disizmaju,silvermoon,873,evoker,devastation,36,18,18
Lifestrasza,drakthul,868,evoker,devastation,13,10,3
Ralfferion,auchindoun,864,evoker,devastation,18,9,9
Yimvoker,blackrock,864,evoker,devastation,18,9,9
Pinacóladaqt,stormscale,864,evoker,devastation,18,9,9
Рогатыйдебик,gordunni,863,evoker,devastation,18,9,9
Luu,the-maelstrom,863,evoker,devastation,18,9,9
Féféledragon,archimonde,863,evoker,devastation,18,9,9
Setutekh,argent-dawn,863,evoker,devastation,24,9,15
Gle,ragnaros,863,evoker,devastation,30,9,21
Storhorn,silvermoon,863,evoker,devastation,30,9,21
Abehethan,archimonde,862,evoker,devastation,18,9,9
Runednmf,kazzak,862,evoker,devastation,18,9,9
Nanderoza,the-maelstrom,861,evoker,devastation,12,9,3
Bloodspiral,tarren-mill,861,evoker,devastation,18,9,9
Kroqmoo,drekthar,861,evoker,devastation,19,9,10
Shenrøn,garona,861,evoker,devastation,29,11,18
Skabaluga,blackrock,860,evoker,devastation,18,9,9
Copíum,silvermoon,859,evoker,devastation,30,9,21
Dschíses,malganis,858,evoker,devastation,18,9,9
Shyke,draenor,858,evoker,devastation,18,9,9
Karistrasza,sylvanas,854,evoker,devastation,24,9,15
Elitedraach,tarren-mill,847,evoker,devastation,17,9,8
Флардикас,gordunni,842,evoker,devastation,24,9,15
Scalash,drakthul,836,evoker,devastation,54,25,29
Xatures,twisting-nether,832,evoker,devastation,24,14,10
Sivaas,arathi,832,evoker,devastation,60,29,31
Acedragniir,khaz-modan,826,evoker,devastation,24,11,13
Thebabayag,kazzak,823,evoker,devastation,24,10,14
Crynerf,ravencrest,817,evoker,devastation,84,39,45
Tsunamì,ysondre,768,evoker,devastation,12,8,4
Gloombloom,emeriss,768,evoker,devastation,13,8,5
Súnny,archimonde,768,evoker,devastation,15,8,7
Mazakqt,draenor,768,evoker,devastation,18,8,10
Nekrosdrake,tarren-mill,768,evoker,devastation,18,8,10
Garussy,draenor,768,evoker,devastation,18,8,10
Lulvoker,blackrock,768,evoker,devastation,18,8,10
Zp,kazzak,768,evoker,devastation,18,8,10
Drãco,auchindoun,768,evoker,devastation,30,8,22
Fayral,blackmoore,767,evoker,devastation,12,8,4
Balerioon,draenor,767,evoker,devastation,12,8,4
Deathwingx,sylvanas,767,evoker,devastation,18,8,10
Tooltipshow,ragnaros,767,evoker,devastation,18,8,10
Shenlongoat,ravencrest,766,evoker,devastation,12,8,4
Aiakès,marécage-de-zangar,766,evoker,devastation,12,8,4
Flypzz,stormscale,766,evoker,devastation,18,8,10
Flawxy,blackmoore,766,evoker,devastation,18,8,10
Saratharion,argent-dawn,764,evoker,devastation,24,8,16
Firebutt,argent-dawn,763,evoker,devastation,12,8,4
Ogienoddech,silvermoon,762,evoker,devastation,18,8,10
Zerotales,turalyon,755,evoker,devastation,12,8,4
Drakenballen,ragnaros,755,evoker,devastation,15,8,7
Viorias,argent-dawn,751,evoker,devastation,24,8,16
Davioncz,thunderhorn,749,evoker,devastation,12,8,4
Vanima,forscherliga,746,evoker,devastation,12,8,4
Morsan,tichondrius,737,evoker,devastation,19,9,10
Zyevoker,silvermoon,687,evoker,devastation,13,8,5
Schmoker,stormscale,672,evoker,devastation,12,7,5
Arecibo,tarren-mill,672,evoker,devastation,12,7,5
Styxev,blackhand,672,evoker,devastation,12,7,5
Elbozo,kazzak,672,evoker,devastation,12,7,5
Knööz,antonidas,672,evoker,devastation,12,7,5
Zettaflare,nazjatar,672,evoker,devastation,12,7,5
Hodnsak,blackmoore,672,evoker,devastation,12,7,5
Paizz,tarren-mill,672,evoker,devastation,12,7,5
Flythe,silvermoon,672,evoker,devastation,12,7,5
Gonzalo,dun-modr,672,evoker,devastation,12,7,5
Sebek,archimonde,672,evoker,devastation,12,7,5
Jaykvoker,kazzak,672,evoker,devastation,12,7,5
Эбиб,gordunni,672,evoker,devastation,12,7,5
Cascadia,deathwing,672,evoker,devastation,15,8,7
Kda,die-nachtwache,672,evoker,devastation,18,7,11
Zaradreth,grim-batol,672,evoker,devastation,18,7,11
Glurakk,aegwynn,672,evoker,devastation,18,7,11
Ønce,durotan,672,evoker,devastation,18,7,11
Aeryz,burning-legion,672,evoker,devastation,24,7,17
Drexxe,boulderfist,672,evoker,devastation,24,7,17
Evoslaps,norgannon,671,evoker,devastation,12,7,5
Jarhys,draenor,671,evoker,devastation,12,7,5
Dracofion,ravencrest,671,evoker,devastation,12,7,5
Kábutø,antonidas,671,evoker,devastation,12,7,5
Chck,ragnaros,671,evoker,devastation,18,7,11
Stalkhyr,elune,671,evoker,devastation,18,7,11
Mijähh,taerar,671,evoker,devastation,18,7,11
Azzazed,dun-modr,670,evoker,devastation,12,7,5
Ryuniss,argent-dawn,670,evoker,devastation,12,7,5
Wôpz,archimonde,670,evoker,devastation,12,7,5
Bullseiye,silvermoon,670,evoker,devastation,18,7,11
Enemi,twisting-nether,669,evoker,devastation,14,9,5
Nebulai,silvermoon,669,evoker,devastation,19,7,12
Flapant,archimonde,668,evoker,devastation,18,7,11
Kvothe,malygos,668,evoker,devastation,18,7,11
Аверьятор,fordragon,663,evoker,devastation,18,7,11
Chrysaetor,argent-dawn,657,evoker,devastation,12,7,5
Flameclaw,argent-dawn,657,evoker,devastation,12,7,5
Kayizer,archimonde,657,evoker,devastation,12,7,5
Evokah,der-abyssische-rat,655,evoker,devastation,23,7,16
Draknil,ysondre,640,evoker,devastation,16,7,9
Auchedrax,argent-dawn,639,evoker,devastation,14,8,6
Zharas,nemesis,623,evoker,devastation,11,7,4
Zpartadraga,ragnaros,584,evoker,devastation,9,8,1
Dromar,malganis,576,evoker,devastation,6,6,0
Tholanía,baelgun,576,evoker,devastation,6,6,0
Kallistian,argent-dawn,576,evoker,devastation,6,6,0
Henmon,defias-brotherhood,576,evoker,devastation,6,6,0
Selectaa,grim-batol,576,evoker,devastation,12,6,6
Dracalos,silvermoon,576,evoker,devastation,12,6,6
Terrorclaw,ragnaros,576,evoker,devastation,12,6,6
Puffdaddyxd,twisting-nether,576,evoker,devastation,12,6,6
Gorgonn,cthun,576,evoker,devastation,12,6,6
Khimari,xavius,576,evoker,devastation,12,6,6
Xendragon,kazzak,576,evoker,devastation,12,6,6
Charezard,draenor,576,evoker,devastation,12,6,6
Scalewind,twisting-nether,576,evoker,devastation,12,6,6
Mattyastrasz,hyjal,576,evoker,devastation,12,6,6
Naömi,archimonde,576,evoker,devastation,12,6,6
Madeinhæven,ravencrest,576,evoker,devastation,18,6,12
Митокада,soulflayer,576,evoker,devastation,18,6,12
Burnrate,draenor,576,evoker,devastation,20,6,14
Barneyxx,tarren-mill,576,evoker,devastation,24,6,18
Ágarosz,sanguino,575,evoker,devastation,12,6,6
Chunlooi,baelgun,575,evoker,devastation,12,6,6
Hyunastraza,dalaran,575,evoker,devastation,12,6,6
Drdrake,aszune,575,evoker,devastation,12,6,6
Meyowuo,doomhammer,575,evoker,devastation,14,6,8
Uprover,kazzak,575,evoker,devastation,18,6,12
Малесиндра,gordunni,575,evoker,devastation,18,6,12
Temeraire,argent-dawn,575,evoker,devastation,18,6,12
Mazzg,blackmoore,574,evoker,devastation,21,7,14
Morph,talnivarr,574,evoker,devastation,18,6,12
Kharon,garrosh,574,evoker,devastation,24,6,18
Geckonen,stormreaver,573,evoker,devastation,18,6,12
Dragorona,kult-der-verdammten,572,evoker,devastation,12,6,6
Faijer,blackmoore,572,evoker,devastation,12,6,6
Voraxe,draenor,568,evoker,devastation,12,6,6
Эллъис,gordunni,544,evoker,devastation,34,7,27
Molem,defias-brotherhood,543,evoker,devastation,11,6,5
Lilvorki,silvermoon,543,evoker,devastation,17,6,11
Hekatonshire,hyjal,539,evoker,devastation,11,6,5
Rise,tarren-mill,522,evoker,devastation,12,7,5
Somntersu,argent-dawn,511,evoker,devastation,14,7,7
Streetspyro,ravencrest,480,evoker,devastation,6,5,1
Chronougi,ravencrest,480,evoker,devastation,6,5,1
Hösh,elune,480,evoker,devastation,6,5,1
Dragondeezs,silvermoon,480,evoker,devastation,6,5,1
Côlt,twisting-nether,480,evoker,devastation,6,5,1
Zendervish,draenor,480,evoker,devastation,6,5,1
Elvarg,ragnaros,480,evoker,devastation,6,5,1
Tovaro,xavius,480,evoker,devastation,6,5,1
Zinxo,ravencrest,480,evoker,devastation,12,5,7
Shazag,ragnaros,480,evoker,devastation,12,5,7
Ripgódx,bronzebeard,480,evoker,devastation,12,5,7
Dracnass,silvermoon,480,evoker,devastation,12,5,7
Icyevoker,ravencrest,480,evoker,devastation,12,5,7
Wuschwuscha,thrall,480,evoker,devastation,12,5,7
Skulblakas,blackmoore,480,evoker,devastation,12,5,7
Pavelito,ysondre,480,evoker,devastation,12,5,7
Pandagos,archimonde,480,evoker,devastation,12,5,7
Arbîter,eredar,480,evoker,devastation,12,5,7
Nerõ,thrall,480,evoker,devastation,12,5,7
Cooperevoker,blackrock,480,evoker,devastation,12,5,7
Сансетшторм,gordunni,480,evoker,devastation,12,5,7
Spyro,bloodfeather,480,evoker,devastation,12,5,7
Bal,arakarahm,480,evoker,devastation,12,5,7
Syraxxes,sanguino,480,evoker,devastation,12,5,7
Tilwahlzok,pozzo-delleternità,480,evoker,devastation,12,5,7
Gaargaveko,blackmoore,480,evoker,devastation,12,5,7
Niddhog,antonidas,480,evoker,devastation,12,5,7
Predictrash,archimonde,480,evoker,devastation,12,5,7
Rekinn,tarren-mill,480,evoker,devastation,12,5,7
Jetfqds,archimonde,480,evoker,devastation,18,5,13
Magicae,drakthul,479,evoker,devastation,12,5,7
Кайрэс,gordunni,479,evoker,devastation,12,5,7
Vermithors,ravencrest,479,evoker,devastation,12,5,7
Драккалис,eversong,479,evoker,devastation,12,5,7
Mirazare,khadgar,478,evoker,devastation,12,5,7
Штеци,howling-fjord,384,evoker,devastation,6,4,2
Iblvicanfly,stormscale,384,evoker,devastation,6,4,2
Hungryhank,ragnaros,384,evoker,devastation,6,4,2
Theralon,tarren-mill,384,evoker,devastation,6,4,2
Notadvanced,draenor,384,evoker,devastation,6,4,2
Dyrokan,blackhand,384,evoker,devastation,6,4,2
Gulimvoker,aegwynn,384,evoker,devastation,6,4,2
Wurm,shadowsong,384,evoker,devastation,6,4,2
Blamdrake,blackhand,384,evoker,devastation,6,4,2
Skiora,argent-dawn,384,evoker,devastation,6,4,2
Kárás,silvermoon,384,evoker,devastation,6,4,2
Aclysia,outland,384,evoker,devastation,6,4,2
Dèéz,ravencrest,384,evoker,devastation,8,5,3
Дракарус,soulflayer,384,evoker,devastation,12,4,8
Croker,ravencrest,384,evoker,devastation,12,4,8
Hijeon,ravencrest,384,evoker,devastation,12,4,8
Pentraktar,pozzo-delleternità,384,evoker,devastation,12,4,8
Nózdormuwu,argent-dawn,384,evoker,devastation,12,4,8
Draceon,argent-dawn,384,evoker,devastation,12,4,8
Ãbl,silvermoon,384,evoker,devastation,12,4,8
Huangzhang,burning-legion,384,evoker,devastation,12,4,8
Vrèsh,blackrock,384,evoker,devastation,12,4,8
Gazunkle,draenor,384,evoker,devastation,12,4,8
Tigurius,onyxia,384,evoker,devastation,12,4,8
Лавеон,gordunni,384,evoker,devastation,12,4,8
Fueu,draenor,384,evoker,devastation,12,4,8
Spyróò,ravencrest,384,evoker,devastation,12,4,8
Nynnaydoth,drakthul,384,evoker,devastation,12,4,8
Rikji,blackmoore,384,evoker,devastation,12,4,8
Bæxo,blackrock,384,evoker,devastation,18,4,14
Jamesdouglas,eredar,383,evoker,devastation,6,4,2
Bombrush,ragnaros,383,evoker,devastation,9,5,4
Ominobari,silvermoon,383,evoker,devastation,18,4,14
Calonddraig,turalyon,382,evoker,devastation,6,4,2
Sheego,anetheron,382,evoker,devastation,6,4,2
Deimong,khaz-modan,381,evoker,devastation,12,4,8
Quicksmoke,argent-dawn,379,evoker,devastation,21,6,15
Dracsamdi,tarren-mill,367,evoker,devastation,11,4,7
Crispywingz,draenor,366,evoker,devastation,11,4,7
Otøgí,antonidas,351,evoker,devastation,11,4,7
Renalia,blackrock,351,evoker,devastation,14,5,9
Tremola,twisting-nether,320,evoker,devastation,10,4,6
Belkavoker,zirkel-des-cenarius,319,evoker,devastation,5,4,1
Galanix,argent-dawn,288,evoker,devastation,6,3,3
Drachenwut,aegwynn,288,evoker,devastation,6,3,3
Flippmoker,argent-dawn,288,evoker,devastation,6,3,3
Kitoed,aegwynn,288,evoker,devastation,6,3,3
Chàrizàd,archimonde,288,evoker,devastation,6,3,3
Ðragøn,argent-dawn,288,evoker,devastation,6,3,3
Shåmsse,kazzak,288,evoker,devastation,6,3,3
Bestofriendo,eredar,288,evoker,devastation,6,3,3
Alusiedrake,ravencrest,288,evoker,devastation,6,3,3
Whaazzdragon,tarren-mill,288,evoker,devastation,6,3,3
Magalàs,pozzo-delleternità,288,evoker,devastation,6,3,3
Dantex,ravencrest,288,evoker,devastation,6,3,3
Feinerkerl,blackmoore,288,evoker,devastation,6,3,3
Тектрис,howling-fjord,288,evoker,devastation,6,3,3
Эндемический,soulflayer,288,evoker,devastation,6,3,3
Hateroll,ravencrest,288,evoker,devastation,6,3,3
Psheetae,kazzak,288,evoker,devastation,6,3,3
Merrius,der-rat-von-dalaran,288,evoker,devastation,6,3,3
Dalsath,silvermoon,288,evoker,devastation,6,3,3
Норус,howling-fjord,288,evoker,devastation,6,3,3
Darksmouke,forscherliga,288,evoker,devastation,6,3,3
Louzard,draenor,288,evoker,devastation,6,3,3
Гиперзверь,gordunni,288,evoker,devastation,6,3,3
Nørgan,die-aldor,288,evoker,devastation,6,3,3
Навидх,howling-fjord,288,evoker,devastation,6,3,3
Fivebeers,silvermoon,288,evoker,devastation,6,3,3
Dragenlul,tarren-mill,288,evoker,devastation,6,3,3
Ernesti,draenor,288,evoker,devastation,6,3,3
Lizzar,ravencrest,288,evoker,devastation,6,3,3
Kaskala,dun-morogh,288,evoker,devastation,6,3,3
Keltullis,archimonde,288,evoker,devastation,6,3,3
Mollÿ,sanguino,288,evoker,devastation,6,3,3
Azurog,blackmoore,288,evoker,devastation,6,3,3
Jrmdragik,kaelthas,288,evoker,devastation,6,3,3
Purplelizard,twisting-nether,288,evoker,devastation,6,3,3
Rosiash,auchindoun,288,evoker,devastation,6,3,3
Malowux,outland,288,evoker,devastation,6,3,3
Feldrac,ravencrest,288,evoker,devastation,6,3,3
Ughvoker,kazzak,288,evoker,devastation,6,3,3
Lajra,ragnaros,288,evoker,devastation,6,3,3
Drokki,burning-legion,288,evoker,devastation,6,3,3
Adônis,malorne,288,evoker,devastation,6,3,3
Lìshrá,baelgun,288,evoker,devastation,6,3,3
Skùzito,ysondre,288,evoker,devastation,6,3,3
Zephlas,sunstrider,288,evoker,devastation,6,3,3
Twinkillerx,dun-morogh,288,evoker,devastation,12,3,9
Tamargon,frostwhisper,288,evoker,devastation,12,3,9
Raøug,blackmoore,288,evoker,devastation,12,3,9
Valdrakken,anubarak,288,evoker,devastation,12,3,9
Gailliade,archimonde,288,evoker,devastation,12,3,9
Shindragøsa,ysondre,288,evoker,devastation,12,3,9
Dundrion,outland,288,evoker,devastation,12,3,9
Sáróman,ravencrest,288,evoker,devastation,13,3,10
Nybxx,frostmane,288,evoker,devastation,18,3,15
Sliimshady,dalaran,287,evoker,devastation,6,3,3
Дракариса,eversong,287,evoker,devastation,6,3,3
Belianf,silvermoon,287,evoker,devastation,6,3,3
Drakonovic,blackrock,287,evoker,devastation,6,3,3
Dahwi,blackmoore,287,evoker,devastation,6,3,3
Drks,draenor,287,evoker,devastation,12,4,8
Aegonis,archimonde,287,evoker,devastation,12,3,9
Syccs,blackrock,255,evoker,devastation,8,4,4
Argentrenard,twilights-hammer,239,evoker,devastation,5,3,2
Kirien,blackhand,234,evoker,devastation,22,4,18
Färsia,drakthul,223,evoker,devastation,8,3,5
Snàx,aggra-português,192,evoker,devastation,6,2,4
Bittewhyally,grim-batol,192,evoker,devastation,6,2,4
Adamâs,archimonde,192,evoker,devastation,6,2,4
Fullyndra,archimonde,192,evoker,devastation,6,2,4
Ninhursag,hyjal,192,evoker,devastation,6,2,4
Sindras,frostmane,192,evoker,devastation,6,2,4
Oogabuga,outland,192,evoker,devastation,6,2,4
Валказар,gordunni,192,evoker,devastation,6,2,4
Jibobo,the-maelstrom,192,evoker,devastation,6,2,4
Hahahahalolx,twisting-nether,192,evoker,devastation,6,2,4
Gelamk,twisting-nether,192,evoker,devastation,6,2,4
Draaxy,twisting-nether,192,evoker,devastation,6,2,4
Draknr,alakir,192,evoker,devastation,6,2,4
Exitelolx,blackrock,192,evoker,devastation,6,2,4
Drakary,chogall,192,evoker,devastation,6,2,4
Draagon,burning-legion,192,evoker,devastation,6,2,4
Lelemion,arathor,192,evoker,devastation,6,2,4
Ellphi,illidan,192,evoker,devastation,6,2,4
Evøcado,blackmoore,192,evoker,devastation,6,2,4
Chürbis,blackmoore,192,evoker,devastation,6,2,4
Frogzey,kazzak,192,evoker,devastation,6,2,4
Malydra,blackhand,192,evoker,devastation,6,2,4
Shenronn,zuljin,192,evoker,devastation,6,2,4
Twokgbananas,blackhand,192,evoker,devastation,6,2,4
Кмандр,gordunni,192,evoker,devastation,6,2,4
Авидогх,gordunni,192,evoker,devastation,6,2,4
Drevoker,daggerspine,192,evoker,devastation,6,2,4
Grogar,hellfire,192,evoker,devastation,6,2,4
Niluslangbal,stormscale,192,evoker,devastation,6,2,4
Norskairline,kazzak,192,evoker,devastation,6,2,4
Emiltate,ravencrest,192,evoker,devastation,6,2,4
Drgndeznuts,kazzak,192,evoker,devastation,6,2,4
Reddeaddrago,silvermoon,192,evoker,devastation,6,2,4
Vynestria,argent-dawn,192,evoker,devastation,6,2,4
Azzaanan,kirin-tor,192,evoker,devastation,6,2,4
Kandragor,antonidas,192,evoker,devastation,6,2,4
Airplanepeek,draenor,192,evoker,devastation,6,2,4
Майтимаус,goldrinn,192,evoker,devastation,6,2,4
Lubyan,pozzo-delleternità,192,evoker,devastation,18,3,15
Jpeo,blackhand,192,evoker,devastation,12,2,10
Shellfire,twisting-nether,192,evoker,devastation,12,2,10
Невердракон,howling-fjord,192,evoker,devastation,12,2,10
Jacra,twisting-nether,192,evoker,devastation,12,2,10
Дракомант,eversong,192,evoker,devastation,12,2,10
Erenhan,archimonde,192,evoker,devastation,12,2,10
Andragosa,confrérie-du-thorium,192,evoker,devastation,12,2,10
Oldlizard,blackrock,192,evoker,devastation,12,2,10
Czerwonooki,turalyon,192,evoker,devastation,12,2,10
Скозложёп,ashenvale,192,evoker,devastation,12,2,10
Aintnospyro,silvermoon,192,evoker,devastation,12,2,10
Tatsuki,arthas,192,evoker,devastation,18,2,16
Kraakraa,turalyon,191,evoker,devastation,6,2,4
Shenrøn,defias-brotherhood,160,evoker,devastation,10,2,8
Вжухкия,gordunni,159,evoker,devastation,5,2,3
Gypsydrake,tarren-mill,159,evoker,devastation,8,3,5
Kekeri,blackhand,112,evoker,devastation,7,2,5
Tneen,stormscale,96,evoker,devastation,3,2,1
Freaksy,blackmoore,96,evoker,devastation,3,2,1
Archidrake,ravencrest,96,evoker,devastation,6,1,5
Rawrdragon,twisting-nether,96,evoker,devastation,6,1,5
Zørix,hyjal,96,evoker,devastation,6,1,5
Dracarysfire,kazzak,96,evoker,devastation,6,1,5
Devanthar,argent-dawn,96,evoker,devastation,6,1,5
Asharys,argent-dawn,96,evoker,devastation,6,1,5
Craycry,argent-dawn,96,evoker,devastation,6,1,5
Monstrosity,proudmoore,96,evoker,devastation,6,1,5
Vahamut,argent-dawn,96,evoker,devastation,6,1,5
Suba,tarren-mill,96,evoker,devastation,6,1,5
Drakô,festung-der-stürme,96,evoker,devastation,6,1,5
Terrorwings,twisting-nether,96,evoker,devastation,6,1,5
Holdya,archimonde,96,evoker,devastation,6,1,5
Xahal,hyjal,96,evoker,devastation,6,1,5
Piecemaker,malganis,96,evoker,devastation,6,1,5
Erones,burning-blade,96,evoker,devastation,6,1,5
Ronmanarmy,blackrock,96,evoker,devastation,6,1,5
Retyss,twisting-nether,96,evoker,devastation,6,1,5
Skyfire,stormscale,96,evoker,devastation,6,1,5
Тренакса,soulflayer,96,evoker,devastation,6,1,5
Мельхиор,booty-bay,96,evoker,devastation,6,1,5
Zerario,blackhand,96,evoker,devastation,6,1,5
Eosin,blackrock,96,evoker,devastation,6,1,5
Effrt,ravencrest,96,evoker,devastation,12,1,11
Manadrake,silvermoon,96,evoker,devastation,12,1,11
Spioche,burning-legion,96,evoker,devastation,12,1,11
Setur,outland,96,evoker,devastation,12,1,11
Драгоблуд,soulflayer,79,evoker,devastation,5,1,4
Drakoonz,ravencrest,64,evoker,devastation,4,1,3
Xidalulz,sylvanas,63,evoker,devastation,2,2,0
Bulydracguir,kazzak,42,evoker,devastation,7,2,5
Âspên,archimonde,31,evoker,devastation,2,1,1
Abragan,aegwynn,31,evoker,devastation,2,1,1
Chronoalis,nemesis,31,evoker,devastation,2,1,1
Thundermifln,nemesis,16,evoker,devastation,7,1,6
Ceitronox,argent-dawn,2148,hunter,marksmanship,102,52,50
Matasso,burning-legion,1988,hunter,marksmanship,227,115,112
Olyleskotch,ravencrest,1983,hunter,marksmanship,60,31,29
Nennimi,ravencrest,1978,hunter,marksmanship,87,44,43
Yasuohasagi,archimonde,1967,hunter,marksmanship,60,30,30
Stylez,emeriss,1945,hunter,marksmanship,66,35,31
Pjållistani,ravencrest,1942,hunter,marksmanship,206,108,98
Drxta,blackrock,1937,hunter,marksmanship,72,36,36
Yezzu,sylvanas,1936,hunter,marksmanship,68,34,34
Gorethaur,twisting-nether,1935,hunter,marksmanship,57,47,10
Wruck,echsenkessel,1929,hunter,marksmanship,126,71,55
Harrianlar,ravenholdt,1905,hunter,marksmanship,132,59,73
Stavfel,kazzak,1903,hunter,marksmanship,101,50,51
Alêx,outland,1902,hunter,marksmanship,126,61,65
Huprah,ravencrest,1901,hunter,marksmanship,126,63,63
Мартидэн,howling-fjord,1894,hunter,marksmanship,173,83,90
Аккулэйд,blackscar,1859,hunter,marksmanship,72,35,37
Skilachi,stormscale,1848,hunter,marksmanship,84,39,45
Душнила,razuvious,1841,hunter,marksmanship,113,57,56
Aimywinehaus,drakthul,1840,hunter,marksmanship,60,31,29
Арамор,blackscar,1838,hunter,marksmanship,58,33,25
Onlystuns,sylvanas,1831,hunter,marksmanship,89,46,43
Trapsfordays,tarren-mill,1827,hunter,marksmanship,70,41,29
Evacuatur,argent-dawn,1826,hunter,marksmanship,66,33,33
Wildheárt,aegwynn,1824,hunter,marksmanship,66,35,31
Ancalarion,tarren-mill,1824,hunter,marksmanship,54,26,28
Hï,eitrigg,1819,hunter,marksmanship,72,35,37
Cenaa,ragnaros,1816,hunter,marksmanship,25,19,6
Rashoumon,zuljin,1816,hunter,marksmanship,52,35,17
Techpoint,silvermoon,1816,hunter,marksmanship,42,27,15
Crôwley,twisting-nether,1816,hunter,marksmanship,54,30,24
Suchskill,stormreaver,1813,hunter,marksmanship,77,37,40
Xoarqt,aegwynn,1812,hunter,marksmanship,72,32,40
Iceyx,stormscale,1810,hunter,marksmanship,48,21,27
Лесбиянюсь,gordunni,1809,hunter,marksmanship,30,19,11
Lenooby,blades-edge,1805,hunter,marksmanship,114,59,55
Áñmy,ravencrest,1804,hunter,marksmanship,53,28,25
Aimshotx,stormscale,1801,hunter,marksmanship,48,28,20
Mogwai,stormscale,1801,hunter,marksmanship,59,29,30
Spirys,drakthul,1797,hunter,marksmanship,54,25,29
Passalaqua,aegwynn,1795,hunter,marksmanship,78,47,31
Warbringerx,stormscale,1792,hunter,marksmanship,40,20,20
Chindala,zuljin,1780,hunter,marksmanship,49,24,25
Åíøñs,kazzak,1778,hunter,marksmanship,35,19,16
Samuru,auchindoun,1777,hunter,marksmanship,65,28,37
Myice,twisting-nether,1771,hunter,marksmanship,66,36,30
Misstrap,drakthul,1769,hunter,marksmanship,53,35,18
Spoonfingers,ravencrest,1744,hunter,marksmanship,41,21,20
Dis,twilights-hammer,1739,hunter,marksmanship,53,26,27
Murtagh,khaz-modan,1733,hunter,marksmanship,72,37,35
Amistat,kazzak,1732,hunter,marksmanship,115,57,58
Nutshotx,stormscale,1732,hunter,marksmanship,90,39,51
Huntrag,tarren-mill,1729,hunter,marksmanship,247,123,124
Лотариель,howling-fjord,1728,hunter,marksmanship,66,34,32
Cadvan,nagrand,1727,hunter,marksmanship,45,23,22
Trashcarlito,eredar,1725,hunter,marksmanship,36,23,13
Deuterium,stormscale,1723,hunter,marksmanship,42,29,13
Lègolas,sylvanas,1721,hunter,marksmanship,66,28,38
Setyouintrap,ravencrest,1717,hunter,marksmanship,54,31,23
Hallé,frostmane,1714,hunter,marksmanship,78,43,35
Bestregards,ravencrest,1714,hunter,marksmanship,124,56,68
Mógwaí,stormscale,1710,hunter,marksmanship,72,36,36
Strikke,archimonde,1709,hunter,marksmanship,42,18,24
Dragnial,kazzak,1703,hunter,marksmanship,53,26,27
Xanter,blackrock,1698,hunter,marksmanship,68,32,36
Ремонтлицаа,gordunni,1695,hunter,marksmanship,115,66,49
Dexter,ravencrest,1689,hunter,marksmanship,214,104,110
Адвентурер,howling-fjord,1685,hunter,marksmanship,108,60,48
Huntsmart,kazzak,1682,hunter,marksmanship,78,34,44
Lowcaskor,turalyon,1678,hunter,marksmanship,47,26,21
Sindorian,aggra-português,1675,hunter,marksmanship,60,31,29
Nêzz,tarren-mill,1675,hunter,marksmanship,68,31,37
Velrox,blackmoore,1674,hunter,marksmanship,60,30,30
Jabela,eredar,1668,hunter,marksmanship,78,35,43
Johnreapèr,sylvanas,1663,hunter,marksmanship,95,42,53
Maticshorter,blackmoore,1660,hunter,marksmanship,29,18,11
Pandanero,ravencrest,1660,hunter,marksmanship,36,20,16
Podroto,tyrande,1660,hunter,marksmanship,77,30,47
Eldrekou,kazzak,1657,hunter,marksmanship,48,22,26
Speedhack,argent-dawn,1650,hunter,marksmanship,63,35,28
Xqzmytrapz,blackrock,1650,hunter,marksmanship,36,18,18
Klarix,outland,1649,hunter,marksmanship,62,29,33
Pewpewstuff,draenor,1648,hunter,marksmanship,36,20,16
Buffrøgues,ravencrest,1648,hunter,marksmanship,204,100,104
Xzmiq,outland,1646,hunter,marksmanship,32,19,13
Hotshòt,silvermoon,1642,hunter,marksmanship,144,78,66
Rizlay,the-maelstrom,1640,hunter,marksmanship,108,50,58
Triggaz,stormscale,1637,hunter,marksmanship,83,39,44
Zeanoff,ravencrest,1636,hunter,marksmanship,54,35,19
Миссклик,soulflayer,1632,hunter,marksmanship,66,42,24
Srsbsnshunta,kazzak,1632,hunter,marksmanship,43,24,19
Naid,lordaeron,1632,hunter,marksmanship,36,20,16
Самокаратель,gordunni,1630,hunter,marksmanship,42,27,15
Khregan,aerie-peak,1630,hunter,marksmanship,42,18,24
Дарктеххно,howling-fjord,1629,hunter,marksmanship,36,18,18
Амореселф,gordunni,1629,hunter,marksmanship,59,25,34
Metak,auchindoun,1627,hunter,marksmanship,32,22,10
Куфачка,soulflayer,1627,hunter,marksmanship,36,17,19
Evengance,dragonblight,1624,hunter,marksmanship,66,43,23
Nidaliyae,archimonde,1624,hunter,marksmanship,42,20,22
Murkek,drakthul,1623,hunter,marksmanship,48,28,20
Natchell,ysondre,1623,hunter,marksmanship,48,22,26
Mfbloom,blackmoore,1621,hunter,marksmanship,48,23,25
Травок,gordunni,1620,hunter,marksmanship,64,34,30
Nätzz,dun-modr,1618,hunter,marksmanship,67,29,38
Ixxmhunt,blackrock,1616,hunter,marksmanship,54,24,30
Бипбип,galakrond,1615,hunter,marksmanship,35,20,15
Ледо,deathguard,1614,hunter,marksmanship,66,30,36
Jetay,silvermoon,1613,hunter,marksmanship,60,33,27
Играсломана,howling-fjord,1613,hunter,marksmanship,39,21,18
Arung,ravencrest,1610,hunter,marksmanship,48,22,26
Loretta,ragnaros,1609,hunter,marksmanship,47,27,20
Darts,outland,1608,hunter,marksmanship,82,41,41
Sizemattersx,kazzak,1608,hunter,marksmanship,124,59,65
Crétin,archimonde,1605,hunter,marksmanship,38,20,18
Legosoldaten,stormscale,1604,hunter,marksmanship,53,21,32
Streetxpres,nethersturm,1602,hunter,marksmanship,35,19,16
Çryneth,ravencrest,1602,hunter,marksmanship,92,49,43
Rêmøórsêlês,outland,1594,hunter,marksmanship,39,19,20
Gugenot,tarren-mill,1589,hunter,marksmanship,56,33,23
Vangeroth,kazzak,1589,hunter,marksmanship,324,169,155
Gunlaugr,defias-brotherhood,1588,hunter,marksmanship,33,18,15
Desudi,tarren-mill,1588,hunter,marksmanship,59,30,29
Крой,howling-fjord,1588,hunter,marksmanship,83,40,43
Bearmane,tarren-mill,1587,hunter,marksmanship,112,54,58
Recrent,kazzak,1582,hunter,marksmanship,96,53,43
Шотнес,gordunni,1579,hunter,marksmanship,72,33,39
Inayah,outland,1571,hunter,marksmanship,121,65,56
Scheixanter,drakthul,1570,hunter,marksmanship,146,72,74
Kayvaal,kaelthas,1568,hunter,marksmanship,48,26,22
Mönster,ravenholdt,1565,hunter,marksmanship,74,43,31
Lebalaffré,arathi,1562,hunter,marksmanship,77,41,36
Лисатия,gordunni,1562,hunter,marksmanship,48,22,26
Мизэрица,soulflayer,1556,hunter,marksmanship,66,32,34
Ekz,twisting-nether,1554,hunter,marksmanship,46,24,22
Mantinell,hellfire,1553,hunter,marksmanship,36,20,16
Trytoconnect,ravencrest,1546,hunter,marksmanship,60,33,27
Miladinorc,azjolnerub,1540,hunter,marksmanship,54,32,22
Chaussons,kazzak,1539,hunter,marksmanship,114,59,55
Lookmyezzy,ravencrest,1535,hunter,marksmanship,32,17,15
Jup,elune,1535,hunter,marksmanship,55,21,34
Brk,dun-modr,1534,hunter,marksmanship,30,16,14
Elja,laughing-skull,1531,hunter,marksmanship,73,40,33
Kyudo,ravencrest,1531,hunter,marksmanship,124,66,58
Mînérvá,blackhand,1530,hunter,marksmanship,60,38,22
Jamzyhunter,emerald-dream,1530,hunter,marksmanship,42,17,25
Хжв,ashenvale,1528,hunter,marksmanship,112,59,53
Daela,elune,1527,hunter,marksmanship,83,38,45
Hurion,sanguino,1526,hunter,marksmanship,36,17,19
Манаррия,soulflayer,1522,hunter,marksmanship,78,33,45
Kariss,khaz-modan,1521,hunter,marksmanship,143,71,72
Hardscoped,tarren-mill,1521,hunter,marksmanship,64,29,35
Килофвратх,gordunni,1520,hunter,marksmanship,170,81,89
Eenel,twisting-nether,1513,hunter,marksmanship,30,16,14
Eferos,quelthalas,1513,hunter,marksmanship,60,26,34
Minisay,magtheridon,1509,hunter,marksmanship,286,141,145
Crowsza,archimonde,1508,hunter,marksmanship,35,19,16
Cpflex,arthas,1508,hunter,marksmanship,76,32,44
Focushunter,outland,1506,hunter,marksmanship,64,30,34
Хальвеген,gordunni,1500,hunter,marksmanship,258,129,129
Rattentäter,alexstrasza,1498,hunter,marksmanship,54,28,26
Barnabaz,skullcrusher,1497,hunter,marksmanship,42,22,20
Ронингуд,gordunni,1496,hunter,marksmanship,60,32,28
Deatharow,ravencrest,1496,hunter,marksmanship,55,28,27
Xrey,ragnaros,1496,hunter,marksmanship,75,37,38
Длинноемоджо,soulflayer,1493,hunter,marksmanship,371,182,189
Tiidus,burning-legion,1492,hunter,marksmanship,24,16,8
Ravensoulz,stormscale,1492,hunter,marksmanship,30,18,12
Jimbow,blackrock,1486,hunter,marksmanship,34,19,15
Reyst,moonglade,1483,hunter,marksmanship,24,16,8
Vruh,antonidas,1483,hunter,marksmanship,60,31,29
Jeeves,outland,1481,hunter,marksmanship,36,17,19
Zirilan,nemesis,1480,hunter,marksmanship,112,57,55
Meinkoenig,frostwolf,1479,hunter,marksmanship,54,34,20
Swïtchz,hyjal,1479,hunter,marksmanship,117,59,58
Шимэйла,gordunni,1474,hunter,marksmanship,97,51,46
Souljâh,ravencrest,1473,hunter,marksmanship,59,30,29
Афигеннски,ashenvale,1473,hunter,marksmanship,66,31,35
Emnia,argent-dawn,1470,hunter,marksmanship,78,37,41
Yarnvid,twisting-nether,1467,hunter,marksmanship,153,81,72
Mervyl,burning-legion,1467,hunter,marksmanship,42,21,21
Epheso,daggerspine,1467,hunter,marksmanship,36,16,20
Дисконнэктор,soulflayer,1467,hunter,marksmanship,72,27,45
Rèyz,blackhand,1466,hunter,marksmanship,111,58,53
Boomkillshot,zuljin,1463,hunter,marksmanship,173,95,78
Короткиствол,gordunni,1463,hunter,marksmanship,48,21,27
Surtfire,alonsus,1462,hunter,marksmanship,108,54,54
Smekminbåge,tarren-mill,1462,hunter,marksmanship,36,16,20
Soupsoupsòup,blackmoore,1458,hunter,marksmanship,36,19,17
Вееном,gordunni,1458,hunter,marksmanship,111,51,60
Tntabsotrap,silvermoon,1455,hunter,marksmanship,82,44,38
Bøøgy,silvermoon,1455,hunter,marksmanship,176,93,83
Rex,chamber-of-aspects,1454,hunter,marksmanship,39,23,16
Summa,silvermoon,1452,hunter,marksmanship,72,34,38
Скартэкс,howling-fjord,1451,hunter,marksmanship,44,30,14
Dafhel,hyjal,1451,hunter,marksmanship,54,24,30
Sinplify,emeriss,1451,hunter,marksmanship,42,17,25
Bollo,malganis,1449,hunter,marksmanship,61,29,32
Mânhunt,blackhand,1447,hunter,marksmanship,59,33,26
Будкусломаю,grom,1447,hunter,marksmanship,77,35,42
Bapt,blackrock,1447,hunter,marksmanship,42,17,25
Hunsed,sanguino,1445,hunter,marksmanship,42,26,16
Balamut,aegwynn,1445,hunter,marksmanship,83,45,38
Pickaboo,defias-brotherhood,1445,hunter,marksmanship,215,106,109
Carpante,nemesis,1442,hunter,marksmanship,72,34,38
Asthorio,stormscale,1442,hunter,marksmanship,89,39,50
Jurá,perenolde,1441,hunter,marksmanship,83,37,46
Nanns,silvermoon,1439,hunter,marksmanship,59,29,30
Killitoss,blackmoore,1438,hunter,marksmanship,33,16,17
Джоуе,ashenvale,1437,hunter,marksmanship,30,15,15
Luuszapfae,aegwynn,1436,hunter,marksmanship,29,16,13
Keskolica,outland,1436,hunter,marksmanship,60,29,31
Àfpro,hyjal,1436,hunter,marksmanship,70,32,38
Babclaar,culte-de-la-rive-noire,1435,hunter,marksmanship,36,22,14
Nagu,antonidas,1435,hunter,marksmanship,30,15,15
Skillzone,silvermoon,1432,hunter,marksmanship,36,15,21
Jeston,amanthul,1430,hunter,marksmanship,49,23,26
Valkhen,boulderfist,1428,hunter,marksmanship,42,24,18
Роктджана,deathguard,1426,hunter,marksmanship,76,38,38
Mizumo,burning-legion,1425,hunter,marksmanship,133,74,59
Longblow,outland,1424,hunter,marksmanship,48,20,28
Begøne,draenor,1423,hunter,marksmanship,42,28,14
Ønske,azjolnerub,1423,hunter,marksmanship,48,25,23
Ashimaru,sylvanas,1423,hunter,marksmanship,63,31,32
Melriya,ravencrest,1421,hunter,marksmanship,24,15,9
Shootingbob,blackrock,1421,hunter,marksmanship,42,23,19
Shaib,kazzak,1420,hunter,marksmanship,24,15,9
Rikishot,ravencrest,1420,hunter,marksmanship,52,25,27
Everya,ravencrest,1418,hunter,marksmanship,24,15,9
Kravên,anubarak,1417,hunter,marksmanship,63,32,31
Kalima,malfurion,1416,hunter,marksmanship,72,28,44
Doubletap,ysondre,1415,hunter,marksmanship,18,15,3
Firescorpion,onyxia,1414,hunter,marksmanship,30,19,11
Littlerat,kult-der-verdammten,1414,hunter,marksmanship,30,15,15
Aimnfire,anachronos,1411,hunter,marksmanship,73,39,34
Аскентр,gordunni,1411,hunter,marksmanship,67,31,36
Elonyr,sanguino,1411,hunter,marksmanship,196,90,106
Piit,elune,1403,hunter,marksmanship,67,28,39
Abraxan,twisting-nether,1402,hunter,marksmanship,46,31,15
Scatshot,grim-batol,1401,hunter,marksmanship,24,16,8
Еввнух,gordunni,1401,hunter,marksmanship,72,31,41
Kértor,die-aldor,1401,hunter,marksmanship,46,19,27
Hiðe,archimonde,1399,hunter,marksmanship,56,28,28
Laskoo,tarren-mill,1398,hunter,marksmanship,84,45,39
Slmao,tarren-mill,1398,hunter,marksmanship,78,38,40
Darm,sunstrider,1398,hunter,marksmanship,36,15,21
Plzdontrun,sylvanas,1389,hunter,marksmanship,47,24,23
Duckling,argent-dawn,1387,hunter,marksmanship,54,25,29
Sharpeyezz,ravencrest,1387,hunter,marksmanship,71,28,43
Gwalëndil,hyjal,1384,hunter,marksmanship,66,33,33
Mindgap,pozzo-delleternità,1383,hunter,marksmanship,98,46,52
Ensomnia,silvermoon,1382,hunter,marksmanship,24,19,5
Bluelol,ravencrest,1382,hunter,marksmanship,46,16,30
Krypzit,garona,1378,hunter,marksmanship,42,15,27
Lincolne,ravencrest,1375,hunter,marksmanship,41,17,24
Wowkulaka,kazzak,1371,hunter,marksmanship,48,23,25
Lrr,grim-batol,1370,hunter,marksmanship,18,15,3
Zulthos,kazzak,1370,hunter,marksmanship,25,16,9
Samhunt,blackrock,1370,hunter,marksmanship,35,15,20
Doncar,stormscale,1367,hunter,marksmanship,99,44,55
Lobos,ravencrest,1367,hunter,marksmanship,60,25,35
Mmaaee,ravencrest,1365,hunter,marksmanship,58,33,25
Ofortuna,silvermoon,1365,hunter,marksmanship,42,23,19
Absolutnoob,blackrock,1362,hunter,marksmanship,38,21,17
Crar,frostwolf,1360,hunter,marksmanship,88,47,41
Chrishyh,blackrock,1357,hunter,marksmanship,42,20,22
Elyar,eredar,1355,hunter,marksmanship,40,23,17
Llaz,silvermoon,1355,hunter,marksmanship,28,15,13
Szybky,defias-brotherhood,1354,hunter,marksmanship,60,25,35
Curtiss,sanguino,1353,hunter,marksmanship,46,28,18
Wmaximoff,tarren-mill,1351,hunter,marksmanship,80,33,47
Adariana,archimonde,1349,hunter,marksmanship,60,27,33
Stingarrow,stormscale,1345,hunter,marksmanship,60,32,28
Vavabxl,ysondre,1345,hunter,marksmanship,114,52,62
Meskette,ravencrest,1344,hunter,marksmanship,36,18,18
Gromaya,elune,1342,hunter,marksmanship,47,23,24
Xalaar,frostwolf,1339,hunter,marksmanship,62,33,29
Antiork,doomhammer,1339,hunter,marksmanship,66,31,35
Røxxilia,blackmoore,1339,hunter,marksmanship,60,26,34
Enÿo,ysondre,1339,hunter,marksmanship,48,16,32
Snipèr,blackmoore,1336,hunter,marksmanship,26,16,10
Prodanhunts,frostmane,1336,hunter,marksmanship,66,32,34
Jamesie,ravencrest,1335,hunter,marksmanship,24,14,10
Nirn,ravencrest,1335,hunter,marksmanship,30,14,16
Encore,sylvanas,1334,hunter,marksmanship,48,23,25
Rzeezznik,burning-legion,1333,hunter,marksmanship,24,14,10
Moschtix,forscherliga,1333,hunter,marksmanship,48,20,28
Oatmeal,dun-morogh,1331,hunter,marksmanship,113,67,46
Эльк,gordunni,1331,hunter,marksmanship,57,29,28
Cryneth,twisting-nether,1329,hunter,marksmanship,24,14,10
Ëluna,burning-legion,1329,hunter,marksmanship,49,27,22
Noxxen,burning-legion,1328,hunter,marksmanship,31,18,13
Klinksz,ysondre,1328,hunter,marksmanship,31,16,15
Bæst,elune,1327,hunter,marksmanship,31,16,15
Deadfire,hyjal,1325,hunter,marksmanship,42,20,22
Diapositiv,draenor,1325,hunter,marksmanship,30,14,16
Maroxy,ragnaros,1325,hunter,marksmanship,35,14,21
Gilgharsh,rajaxx,1324,hunter,marksmanship,48,21,27
Оленнька,howling-fjord,1322,hunter,marksmanship,72,38,34
Selaesa,chamber-of-aspects,1321,hunter,marksmanship,45,22,23
Amphi,stormscale,1320,hunter,marksmanship,66,36,30
Glad,argent-dawn,1320,hunter,marksmanship,77,32,45
Tupalax,outland,1320,hunter,marksmanship,64,26,38
Donneraàn,blackrock,1319,hunter,marksmanship,60,33,27
Atiyêsh,arthas,1318,hunter,marksmanship,30,15,15
Kokowawaa,kazzak,1317,hunter,marksmanship,66,28,38
Arrown,outland,1316,hunter,marksmanship,35,17,18
Silvyn,pozzo-delleternità,1315,hunter,marksmanship,42,22,20
Setis,uldaman,1315,hunter,marksmanship,42,14,28
Smitheye,argent-dawn,1314,hunter,marksmanship,141,69,72
Zushji,ysondre,1314,hunter,marksmanship,152,69,83
Narawinger,silvermoon,1310,hunter,marksmanship,42,24,18
Arrowdoxx,silvermoon,1310,hunter,marksmanship,117,51,66
Xaotsu,ravencrest,1308,hunter,marksmanship,45,21,24
Lennylynx,garrosh,1308,hunter,marksmanship,30,14,16
Ксидре,eversong,1302,hunter,marksmanship,54,28,26
Silvyina,todeswache,1302,hunter,marksmanship,86,43,43
Огнеборик,howling-fjord,1302,hunter,marksmanship,36,14,22
Ixlxlxlxl,kazzak,1301,hunter,marksmanship,30,21,9
Høward,aegwynn,1300,hunter,marksmanship,36,20,16
Autoturret,eredar,1297,hunter,marksmanship,94,41,53
Deathshots,aggra-português,1297,hunter,marksmanship,66,26,40
Thysalee,hyjal,1296,hunter,marksmanship,38,15,23
Casey,zuluhed,1295,hunter,marksmanship,36,16,20
Pappous,kul-tiras,1294,hunter,marksmanship,65,32,33
Bobleearrow,darkspear,1294,hunter,marksmanship,53,25,28
Jeddaj,stormscale,1289,hunter,marksmanship,36,14,22
Yoúmad,draenor,1288,hunter,marksmanship,28,14,14
Heísenberg,ragnaros,1287,hunter,marksmanship,31,15,16
Pekkoe,khaz-modan,1286,hunter,marksmanship,60,33,27
Elywiél,frostwolf,1286,hunter,marksmanship,35,14,21
Rupeebtw,stormscale,1285,hunter,marksmanship,96,43,53
Rabiate,blackrock,1282,hunter,marksmanship,46,22,24
Fauda,hellscream,1277,hunter,marksmanship,30,15,15
Doomhorg,quelthalas,1276,hunter,marksmanship,60,30,30
Waltuhwhite,teldrassil,1275,hunter,marksmanship,20,14,6
Féliché,elune,1275,hunter,marksmanship,84,36,48
Iòvól,azuremyst,1274,hunter,marksmanship,82,41,41
Дайпострелят,gordunni,1273,hunter,marksmanship,36,15,21
Rmnsbm,blackmoore,1271,hunter,marksmanship,30,14,16
Argahnim,azjolnerub,1271,hunter,marksmanship,60,27,33
Tokkie,burning-blade,1268,hunter,marksmanship,24,14,10
Nightshäde,aggra-português,1264,hunter,marksmanship,40,16,24
Øßlíck,ysondre,1262,hunter,marksmanship,28,14,14
Zelira,boulderfist,1262,hunter,marksmanship,76,33,43
Yanger,burning-legion,1259,hunter,marksmanship,42,18,24
Шамагута,gordunni,1258,hunter,marksmanship,30,14,16
Sàclak,ysondre,1258,hunter,marksmanship,36,16,20
Хантвкроксах,gordunni,1257,hunter,marksmanship,22,14,8
Феорика,grom,1257,hunter,marksmanship,66,33,33
Имбакласс,howling-fjord,1257,hunter,marksmanship,80,37,43
Cutehuntér,ragnaros,1256,hunter,marksmanship,74,31,43
Booms,eonar,1254,hunter,marksmanship,65,31,34
Serihu,cthun,1251,hunter,marksmanship,48,19,29
Mspt,archimonde,1248,hunter,marksmanship,30,13,17
Zendar,blackmoore,1246,hunter,marksmanship,69,33,36
Darilli,wildhammer,1245,hunter,marksmanship,36,14,22
Lísy,hyjal,1244,hunter,marksmanship,24,13,11
Phillon,blackrock,1243,hunter,marksmanship,24,18,6
Iilac,argent-dawn,1242,hunter,marksmanship,184,104,80
Nharul,blackmoore,1242,hunter,marksmanship,30,13,17
Huntatard,silvermoon,1241,hunter,marksmanship,28,16,12
Рбг,blackscar,1241,hunter,marksmanship,30,13,17
Poatan,outland,1240,hunter,marksmanship,164,86,78
Арийская,gordunni,1239,hunter,marksmanship,65,29,36
Imfiné,outland,1239,hunter,marksmanship,30,13,17
Eskubar,burning-legion,1238,hunter,marksmanship,72,36,36
Хантнерюга,gordunni,1236,hunter,marksmanship,24,13,11
Jðsi,dalaran,1236,hunter,marksmanship,60,26,34
Shedzargo,twisting-nether,1234,hunter,marksmanship,24,13,11
Blowplac,moonglade,1234,hunter,marksmanship,64,29,35
Fränko,ravencrest,1234,hunter,marksmanship,36,13,23
Гусецап,gordunni,1233,hunter,marksmanship,30,13,17
Corrupth,outland,1233,hunter,marksmanship,33,14,19
Mainblu,nemesis,1231,hunter,marksmanship,30,14,16
Xesih,twisting-nether,1228,hunter,marksmanship,59,26,33
Sivoh,silvermoon,1227,hunter,marksmanship,50,23,27
Ililivillumi,tarren-mill,1227,hunter,marksmanship,36,16,20
Breier,argent-dawn,1225,hunter,marksmanship,95,49,46
Andtamed,thunderhorn,1225,hunter,marksmanship,54,25,29
Opsi,area-52,1223,hunter,marksmanship,78,35,43
Эннабонни,gordunni,1222,hunter,marksmanship,30,15,15
Travels,tarren-mill,1222,hunter,marksmanship,30,13,17
Одисенс,eversong,1220,hunter,marksmanship,109,55,54
Snaped,malganis,1219,hunter,marksmanship,37,14,23
Zajaczek,burning-legion,1218,hunter,marksmanship,30,13,17
Loca,twilights-hammer,1217,hunter,marksmanship,78,38,40
Курунирка,gordunni,1213,hunter,marksmanship,36,13,23
Elyxa,ysondre,1211,hunter,marksmanship,54,30,24
Coft,sargeras,1209,hunter,marksmanship,24,13,11
Sallina,blutkessel,1209,hunter,marksmanship,24,13,11
Buzzle,sylvanas,1209,hunter,marksmanship,30,16,14
Snipekill,bronze-dragonflight,1208,hunter,marksmanship,24,13,11
Эвилтар,soulflayer,1206,hunter,marksmanship,26,14,12
Vïcødïnë,sinstralis,1205,hunter,marksmanship,48,20,28
Хакаар,grom,1204,hunter,marksmanship,89,46,43
Hawkz,quelthalas,1204,hunter,marksmanship,67,32,35
Redneckjoe,draenor,1204,hunter,marksmanship,58,26,32
Deneja,kilrogg,1201,hunter,marksmanship,30,13,17
Skohal,draenor,1200,hunter,marksmanship,78,36,42
Sinsé,conseil-des-ombres,1198,hunter,marksmanship,28,17,11
Watty,chogall,1195,hunter,marksmanship,88,45,43
Серргио,soulflayer,1191,hunter,marksmanship,18,13,5
Barrex,guldan,1190,hunter,marksmanship,41,16,25
Fetts,silvermoon,1189,hunter,marksmanship,56,29,27
Bigfoot,argent-dawn,1189,hunter,marksmanship,129,56,73
Corrwus,argent-dawn,1181,hunter,marksmanship,42,18,24
Blackas,dun-modr,1179,hunter,marksmanship,78,36,42
Swáy,twisting-nether,1175,hunter,marksmanship,274,133,141
Каизик,soulflayer,1173,hunter,marksmanship,35,14,21
Tránsphobic,kilrogg,1171,hunter,marksmanship,60,29,31
Yunalèsca,eredar,1171,hunter,marksmanship,34,13,21
Анхантэй,lich-king,1170,hunter,marksmanship,166,87,79
Naven,minahonda,1170,hunter,marksmanship,36,15,21
Lillynahh,argent-dawn,1169,hunter,marksmanship,127,59,68
Viséeauto,confrérie-du-thorium,1168,hunter,marksmanship,24,13,11
Celtya,archimonde,1166,hunter,marksmanship,135,69,66
Linneâ,blackmoore,1166,hunter,marksmanship,32,15,17
Áragorn,frostmane,1165,hunter,marksmanship,36,20,16
Lightarròw,nordrassil,1162,hunter,marksmanship,36,13,23
Overhït,hyjal,1157,hunter,marksmanship,137,66,71
Sâetha,dun-modr,1157,hunter,marksmanship,36,14,22
Azaella,tarren-mill,1156,hunter,marksmanship,36,16,20
Металшот,blackscar,1155,hunter,marksmanship,23,13,10
Huntaloko,outland,1155,hunter,marksmanship,29,15,14
Taveon,turalyon,1154,hunter,marksmanship,36,13,23
Jodd,ragnaros,1152,hunter,marksmanship,24,12,12
Bøost,stormscale,1151,hunter,marksmanship,18,12,6
Krothga,blackrock,1151,hunter,marksmanship,48,23,25
Farmerjoee,alakir,1147,hunter,marksmanship,24,13,11
Migro,sylvanas,1145,hunter,marksmanship,24,12,12
Marcher,aggra-português,1145,hunter,marksmanship,30,12,18
Bgkrasavec,stormscale,1142,hunter,marksmanship,75,36,39
Narøs,blackhand,1142,hunter,marksmanship,82,33,49
Белыйатомщик,howling-fjord,1142,hunter,marksmanship,30,12,18
Pínnen,draenor,1140,hunter,marksmanship,24,12,12
Nezekielle,drekthar,1140,hunter,marksmanship,30,12,18
Survivr,frostmane,1139,hunter,marksmanship,24,14,10
Koratoz,blackmoore,1135,hunter,marksmanship,18,12,6
Хапмьюзик,howling-fjord,1133,hunter,marksmanship,96,39,57
Kakadoo,twisting-nether,1131,hunter,marksmanship,36,16,20
Aszasi,azjolnerub,1130,hunter,marksmanship,31,13,18
Touscahunter,kazzak,1129,hunter,marksmanship,270,134,136
Oneeyed,kazzak,1127,hunter,marksmanship,24,12,12
Jägarbröje,kazzak,1126,hunter,marksmanship,30,18,12
Anpaytoo,antonidas,1126,hunter,marksmanship,36,14,22
Sekeh,ragnaros,1126,hunter,marksmanship,42,15,27
Virdirthera,silvermoon,1124,hunter,marksmanship,24,12,12
Hoody,culte-de-la-rive-noire,1123,hunter,marksmanship,30,18,12
Docchr,doomhammer,1123,hunter,marksmanship,36,15,21
Лорбан,gordunni,1122,hunter,marksmanship,38,18,20
Kendow,blackrock,1122,hunter,marksmanship,66,29,37
Blacksyo,elune,1122,hunter,marksmanship,51,16,35
Jozsiur,ragnaros,1121,hunter,marksmanship,24,14,10
Bazrzokh,elune,1121,hunter,marksmanship,24,12,12
Rediction,ravencrest,1121,hunter,marksmanship,55,20,35
Jaggatee,senjin,1119,hunter,marksmanship,34,17,17
Cooroona,stormrage,1119,hunter,marksmanship,24,12,12
Gorá,dethecus,1118,hunter,marksmanship,18,12,6
Zirgoo,outland,1117,hunter,marksmanship,75,30,45
Meläna,ysondre,1117,hunter,marksmanship,36,14,22
Akyra,runetotem,1116,hunter,marksmanship,76,31,45
Réja,norgannon,1112,hunter,marksmanship,37,16,21
Bobihunt,argent-dawn,1108,hunter,marksmanship,30,14,16
Bélier,hyjal,1105,hunter,marksmanship,56,31,25
Hollabackgrl,outland,1105,hunter,marksmanship,42,18,24
Talcaliste,archimonde,1104,hunter,marksmanship,69,30,39
Barbrady,nethersturm,1103,hunter,marksmanship,36,16,20
Naghtel,die-silberne-hand,1101,hunter,marksmanship,54,29,25
Tinlop,ragnaros,1097,hunter,marksmanship,108,48,60
Mendinar,sylvanas,1096,hunter,marksmanship,53,14,39
Naizoo,doomhammer,1090,hunter,marksmanship,24,12,12
Voitelka,terokkar,1090,hunter,marksmanship,73,36,37
Травмаопасен,gordunni,1090,hunter,marksmanship,36,12,24
Vanstro,ragnaros,1086,hunter,marksmanship,26,12,14
Йошумитсу,howling-fjord,1084,hunter,marksmanship,56,29,27
Mántîs,argent-dawn,1084,hunter,marksmanship,73,32,41
Bendit,eredar,1083,hunter,marksmanship,62,31,31
Robìnhood,nemesis,1080,hunter,marksmanship,42,22,20
Shubichou,illidan,1080,hunter,marksmanship,36,16,20
Thelasiel,aerie-peak,1079,hunter,marksmanship,67,33,34
Dentaar,draenor,1078,hunter,marksmanship,125,62,63
Retroxia,stormreaver,1075,hunter,marksmanship,26,12,14
Sisilianno,khaz-modan,1073,hunter,marksmanship,124,55,69
Chassfurax,hyjal,1067,hunter,marksmanship,48,19,29
Thauana,los-errantes,1060,hunter,marksmanship,30,14,16
Aratoxx,blackmoore,1059,hunter,marksmanship,54,28,26
Neldrassil,blackmoore,1058,hunter,marksmanship,89,42,47
Miezuu,ravencrest,1056,hunter,marksmanship,33,14,19
Sùnzí,alakir,1055,hunter,marksmanship,18,11,7
Сандабар,borean-tundra,1055,hunter,marksmanship,41,20,21
Kittykite,thunderhorn,1055,hunter,marksmanship,36,11,25
Kirimbald,blackmoore,1054,hunter,marksmanship,24,11,13
Енвина,gordunni,1054,hunter,marksmanship,29,13,16
Uncø,kazzak,1053,hunter,marksmanship,18,11,7
Bladewing,archimonde,1053,hunter,marksmanship,30,11,19
Artémíss,kazzak,1050,hunter,marksmanship,24,11,13
Kbesagrillo,sanguino,1050,hunter,marksmanship,24,11,13
Nìsalle,argent-dawn,1050,hunter,marksmanship,32,13,19
Слезыотлука,howling-fjord,1048,hunter,marksmanship,18,11,7
Bgxd,tarren-mill,1048,hunter,marksmanship,30,11,19
Pøca,kaelthas,1045,hunter,marksmanship,18,11,7
Aerieshan,ravencrest,1045,hunter,marksmanship,24,11,13
Bulseye,kilrogg,1044,hunter,marksmanship,24,11,13
Omixloua,ragnaros,1044,hunter,marksmanship,53,23,30
Kliantra,wildhammer,1042,hunter,marksmanship,63,29,34
Винтаж,deepholm,1041,hunter,marksmanship,59,26,33
Cêdric,alleria,1041,hunter,marksmanship,28,12,16
Ямакасси,thermaplugg,1038,hunter,marksmanship,96,38,58
Hunterdream,aszune,1037,hunter,marksmanship,25,11,14
Honzu,silvermoon,1030,hunter,marksmanship,24,11,13
Gilgalat,drakthul,1029,hunter,marksmanship,47,20,27
Ispo,frostwolf,1028,hunter,marksmanship,94,45,49
Yrtja,minahonda,1027,hunter,marksmanship,32,18,14
Olnàk,ysondre,1023,hunter,marksmanship,60,32,28
Slicer,arthas,1023,hunter,marksmanship,73,31,42
Vèreesa,azjolnerub,1022,hunter,marksmanship,36,12,24
Triggery,ravencrest,1020,hunter,marksmanship,29,11,18
Fèhn,krasus,1019,hunter,marksmanship,24,14,10
Azsräel,dalaran,1019,hunter,marksmanship,80,33,47
Noobatala,tarren-mill,1018,hunter,marksmanship,36,17,19
Мальберна,eversong,1017,hunter,marksmanship,34,17,17
Hanzolo,uldum,1016,hunter,marksmanship,42,15,27
Crní,tarren-mill,1015,hunter,marksmanship,81,37,44
Isarnexx,dun-modr,1007,hunter,marksmanship,41,21,20
Tungusta,defias-brotherhood,1006,hunter,marksmanship,42,19,23
Nutzz,ragnaros,1006,hunter,marksmanship,41,15,26
Hkizzler,kazzak,1005,hunter,marksmanship,68,27,41
Neosmoke,shadowsong,1004,hunter,marksmanship,93,37,56
Брухлянка,gordunni,1003,hunter,marksmanship,24,12,12
Sazak,draenor,1000,hunter,marksmanship,30,17,13
Ashkabous,kazzak,1000,hunter,marksmanship,36,19,17
Heavenlyx,area-52,998,hunter,marksmanship,42,13,29
Honilsom,thunderhorn,997,hunter,marksmanship,49,14,35
Jaýlah,draenor,991,hunter,marksmanship,54,24,30
Bonquiesha,tarren-mill,991,hunter,marksmanship,25,11,14
Анреал,gordunni,988,hunter,marksmanship,38,16,22
Gorett,kazzak,987,hunter,marksmanship,30,11,19
Tomtus,aggramar,983,hunter,marksmanship,55,27,28
Laara,khaz-modan,983,hunter,marksmanship,131,63,68
Aidsmacka,shattered-hand,982,hunter,marksmanship,20,11,9
Honrø,hyjal,977,hunter,marksmanship,48,21,27
Ártemide,pozzo-delleternità,975,hunter,marksmanship,33,15,18
Väärä,stormscale,964,hunter,marksmanship,27,13,14
Hnut,kazzak,961,hunter,marksmanship,41,16,25
Nyxìa,shattered-halls,960,hunter,marksmanship,18,10,8
Imonér,frostmane,960,hunter,marksmanship,18,10,8
Lonewolfe,ravencrest,960,hunter,marksmanship,218,99,119
Xawai,ragnaros,960,hunter,marksmanship,24,10,14
Bekrepál,outland,960,hunter,marksmanship,24,10,14
Квит,blackscar,960,hunter,marksmanship,24,10,14
Amortên,silvermoon,959,hunter,marksmanship,18,10,8
Velites,aggra-português,959,hunter,marksmanship,18,10,8
Cill,ravencrest,959,hunter,marksmanship,18,10,8
Sazox,blackrock,959,hunter,marksmanship,24,10,14
Bãbas,sargeras,959,hunter,marksmanship,24,10,14
Meetyour,stormscale,959,hunter,marksmanship,24,10,14
Тамирка,deathguard,958,hunter,marksmanship,12,10,2
Metalbaci,sylvanas,958,hunter,marksmanship,18,10,8
Оверман,azuregos,958,hunter,marksmanship,18,10,8
Therakal,culte-de-la-rive-noire,958,hunter,marksmanship,18,10,8
Wìndrunner,malfurion,958,hunter,marksmanship,89,44,45
Snuupz,kazzak,958,hunter,marksmanship,24,10,14
Angelcr,uldum,958,hunter,marksmanship,24,10,14
Birgitta,jaedenar,958,hunter,marksmanship,24,10,14
Yelanna,argent-dawn,957,hunter,marksmanship,18,10,8
Zlejkadlec,burning-blade,957,hunter,marksmanship,24,10,14
Huntazt,draenor,956,hunter,marksmanship,18,10,8
Zrijad,draenor,955,hunter,marksmanship,18,10,8
Johnydep,silvermoon,955,hunter,marksmanship,30,10,20
Фузег,deathguard,953,hunter,marksmanship,18,10,8
Wlndrunner,ravencrest,953,hunter,marksmanship,18,10,8
Kaktus,shattered-hand,951,hunter,marksmanship,18,10,8
Aaryel,outland,948,hunter,marksmanship,18,10,8
Ромажиробас,gordunni,947,hunter,marksmanship,18,10,8
Argato,eredar,947,hunter,marksmanship,18,10,8
Jisila,ravencrest,947,hunter,marksmanship,63,27,36
Quinty,durotan,947,hunter,marksmanship,26,11,15
Freezyshinkn,blackrock,945,hunter,marksmanship,18,11,7
Milandria,antonidas,943,hunter,marksmanship,50,24,26
Djzntrap,outland,939,hunter,marksmanship,24,10,14
Ayshæ,tarren-mill,937,hunter,marksmanship,41,21,20
Agarez,blackrock,936,hunter,marksmanship,42,19,23
Жабра,gordunni,936,hunter,marksmanship,30,10,20
Armoredtiger,grim-batol,935,hunter,marksmanship,72,34,38
Nezuqo,archimonde,932,hunter,marksmanship,30,10,20
Mhood,dun-morogh,931,hunter,marksmanship,56,27,29
Ранбоу,howling-fjord,929,hunter,marksmanship,115,55,60
Sogoru,dun-modr,927,hunter,marksmanship,69,37,32
Euphellius,darkmoon-faire,923,hunter,marksmanship,42,18,24
Madida,ravencrest,916,hunter,marksmanship,29,15,14
Zicko,argent-dawn,909,hunter,marksmanship,53,22,31
Matarmeya,los-errantes,908,hunter,marksmanship,22,11,11
Mimiop,hyjal,907,hunter,marksmanship,60,30,30
Silverinn,turalyon,904,hunter,marksmanship,27,10,17
Амобарбиталх,gordunni,901,hunter,marksmanship,33,11,22
Enfinici,eitrigg,894,hunter,marksmanship,17,10,7
Jibolad,stormreaver,893,hunter,marksmanship,24,11,13
Burondeya,twisting-nether,886,hunter,marksmanship,30,13,17
Adventures,darkmoon-faire,881,hunter,marksmanship,18,10,8
Madtony,aegwynn,879,hunter,marksmanship,26,12,14
Лордорион,gordunni,878,hunter,marksmanship,23,12,11
Luckyshooter,nethersturm,877,hunter,marksmanship,71,32,39
Лордввт,howling-fjord,874,hunter,marksmanship,30,14,16
Aous,burning-legion,873,hunter,marksmanship,30,11,19
Aliyah,blackmoore,867,hunter,marksmanship,66,33,33
Feelmyfurý,tarren-mill,864,hunter,marksmanship,12,9,3
Nyjal,archimonde,864,hunter,marksmanship,12,9,3
Denkstah,tarren-mill,864,hunter,marksmanship,18,9,9
Liquidhunter,quelthalas,864,hunter,marksmanship,18,9,9
Mòzetonq,ravencrest,864,hunter,marksmanship,18,9,9
Krøsh,blackmoore,864,hunter,marksmanship,42,18,24
Medgical,outland,864,hunter,marksmanship,24,9,15
Watchouttah,the-maelstrom,864,hunter,marksmanship,24,9,15
Fìnwë,varimathras,863,hunter,marksmanship,12,9,3
Jayri,ravencrest,863,hunter,marksmanship,18,9,9
Vyana,sylvanas,863,hunter,marksmanship,18,9,9
Thugzilla,auchindoun,863,hunter,marksmanship,18,9,9
Какжеплевать,gordunni,862,hunter,marksmanship,12,9,3
Retropunk,ravencrest,862,hunter,marksmanship,18,9,9
Fantus,sylvanas,862,hunter,marksmanship,18,9,9
Grolmgar,malganis,862,hunter,marksmanship,18,9,9
Chloros,ysondre,862,hunter,marksmanship,18,9,9
Eilyn,quelthalas,862,hunter,marksmanship,18,9,9
Obii,stormscale,862,hunter,marksmanship,18,9,9
Vandathien,stormrage,861,hunter,marksmanship,24,9,15
Theuzikat,ragnaros,861,hunter,marksmanship,24,9,15
Jalcer,draenor,860,hunter,marksmanship,30,9,21
Джимуха,soulflayer,859,hunter,marksmanship,30,15,15
Warkum,zuljin,859,hunter,marksmanship,18,9,9
Enistee,silvermoon,859,hunter,marksmanship,19,9,10
Shieryu,archimonde,859,hunter,marksmanship,24,9,15
Krippie,dun-modr,857,hunter,marksmanship,42,19,23
Gintønic,blackmoore,857,hunter,marksmanship,36,9,27
Grafhunter,antonidas,855,hunter,marksmanship,99,49,50
Крипа,gordunni,855,hunter,marksmanship,22,10,12
Qmbonboni,ravencrest,855,hunter,marksmanship,24,9,15
Helioshin,pozzo-delleternità,855,hunter,marksmanship,30,9,21
Odyzeus,drakthul,854,hunter,marksmanship,24,9,15
Aliriana,doomhammer,853,hunter,marksmanship,18,9,9
Erdna,khaz-modan,853,hunter,marksmanship,42,20,22
Baldazr,shadowsong,853,hunter,marksmanship,24,9,15
Rivery,azjolnerub,852,hunter,marksmanship,18,10,8
Ruppig,nozdormu,851,hunter,marksmanship,24,9,15
Zerkarok,draenor,851,hunter,marksmanship,30,9,21
Talanar,tarren-mill,850,hunter,marksmanship,18,9,9
Фридор,deathguard,850,hunter,marksmanship,24,10,14
Falenwing,blackmoore,842,hunter,marksmanship,22,10,12
Calea,zirkel-des-cenarius,835,hunter,marksmanship,30,13,17
Куфа,blackscar,831,hunter,marksmanship,20,10,10
Faelhorn,archimonde,831,hunter,marksmanship,18,9,9
Кривоватый,galakrond,829,hunter,marksmanship,16,10,6
Digsholes,ravencrest,828,hunter,marksmanship,17,9,8
Hylzen,outland,828,hunter,marksmanship,17,9,8
Annihllation,twilights-hammer,826,hunter,marksmanship,18,9,9
Eldrilaon,arthas,823,hunter,marksmanship,45,20,25
Gyldain,argent-dawn,823,hunter,marksmanship,65,16,49
Rollei,uldum,816,hunter,marksmanship,18,9,9
Kartouche,culte-de-la-rive-noire,816,hunter,marksmanship,56,26,30
Пуллятель,borean-tundra,810,hunter,marksmanship,17,9,8
Hollybuster,perenolde,809,hunter,marksmanship,17,9,8
Zion,kul-tiras,800,hunter,marksmanship,22,9,13
Ímpulsion,stormscale,799,hunter,marksmanship,20,9,11
Tenkai,cthun,791,hunter,marksmanship,65,29,36
Эксп,ashenvale,784,hunter,marksmanship,25,9,16
Neiloh,defias-brotherhood,782,hunter,marksmanship,13,9,4
Hellriderr,silvermoon,779,hunter,marksmanship,42,16,26
Moonzsu,ravencrest,768,hunter,marksmanship,12,8,4
Küredent,archimonde,768,hunter,marksmanship,12,8,4
Luzivar,malganis,768,hunter,marksmanship,12,8,4
Fitzgerald,ragnaros,768,hunter,marksmanship,12,8,4
Смотрюанимэ,gordunni,768,hunter,marksmanship,18,8,10
Carre,twilights-hammer,768,hunter,marksmanship,18,8,10
Wolfud,pozzo-delleternità,768,hunter,marksmanship,18,8,10
Celesticx,chamber-of-aspects,768,hunter,marksmanship,18,8,10
Луврен,deepholm,768,hunter,marksmanship,30,8,22
Sylverain,silvermoon,767,hunter,marksmanship,12,8,4
Elmadre,arthas,767,hunter,marksmanship,12,8,4
Mareyn,argent-dawn,767,hunter,marksmanship,12,8,4
Raegal,sanguino,767,hunter,marksmanship,18,8,10
Рэкрэйван,gordunni,767,hunter,marksmanship,18,8,10
Treyzzor,blackmoore,767,hunter,marksmanship,18,8,10
Donfabio,norgannon,767,hunter,marksmanship,18,8,10
Bicepflex,ragnaros,767,hunter,marksmanship,18,8,10
Иттириса,gordunni,767,hunter,marksmanship,18,8,10
Dasimir,blackrock,767,hunter,marksmanship,18,8,10
Lourse,ysondre,767,hunter,marksmanship,18,8,10
Thallia,todeswache,767,hunter,marksmanship,18,8,10
Jettraichu,aggra-português,767,hunter,marksmanship,18,8,10
Krooghan,outland,767,hunter,marksmanship,18,8,10
Skitari,draenor,767,hunter,marksmanship,18,8,10
Screewu,twisting-nether,767,hunter,marksmanship,21,8,13
Обнимуха,soulflayer,767,hunter,marksmanship,24,8,16
Иоссифсталин,soulflayer,767,hunter,marksmanship,24,8,16
Nelftard,agamaggan,766,hunter,marksmanship,12,8,4
Lani,talnivarr,766,hunter,marksmanship,12,8,4
Shoót,blackmoore,766,hunter,marksmanship,18,8,10
Leílah,kazzak,766,hunter,marksmanship,24,8,16
Makaxx,stormscale,766,hunter,marksmanship,24,8,16
Sylphie,dalaran,766,hunter,marksmanship,24,8,16
Galadris,kirin-tor,765,hunter,marksmanship,18,8,10
Æthelflæd,nathrezim,765,hunter,marksmanship,18,8,10
Ixôn,tarren-mill,765,hunter,marksmanship,24,8,16
Guerrilla,stormscale,765,hunter,marksmanship,24,8,16
Zajebantip,sylvanas,765,hunter,marksmanship,25,8,17
Oneeyedjoe,the-maelstrom,764,hunter,marksmanship,18,8,10
Aourön,archimonde,764,hunter,marksmanship,18,8,10
Muckel,area-52,764,hunter,marksmanship,24,8,16
Juliã,dalaran,763,hunter,marksmanship,12,8,4
Høøli,nethersturm,763,hunter,marksmanship,12,8,4
Rosiee,dun-modr,762,hunter,marksmanship,12,8,4
Shibai,outland,762,hunter,marksmanship,18,8,10
Galintzor,area-52,761,hunter,marksmanship,18,8,10
Hunterhouse,draenor,761,hunter,marksmanship,23,8,15
Wetto,ravencrest,759,hunter,marksmanship,18,8,10
Diosteayuda,dun-modr,755,hunter,marksmanship,12,8,4
Skynner,blackrock,755,hunter,marksmanship,18,8,10
Greel,saurfang,753,hunter,marksmanship,68,27,41
Thrund,burning-legion,751,hunter,marksmanship,12,8,4
Sasi,burning-legion,750,hunter,marksmanship,12,8,4
Спелла,goldrinn,748,hunter,marksmanship,29,8,21
Erestor,hellfire,747,hunter,marksmanship,12,8,4
Ønur,twisting-nether,747,hunter,marksmanship,18,8,10
Thedoors,twisting-nether,746,hunter,marksmanship,30,9,21
Aadarshh,turalyon,741,hunter,marksmanship,24,9,15
Filizvogel,aegwynn,735,hunter,marksmanship,17,8,9
Foxhunt,turalyon,731,hunter,marksmanship,22,8,14
Deathøfrats,ravencrest,719,hunter,marksmanship,11,8,3
Gen,twisting-nether,719,hunter,marksmanship,17,8,9
Эолиана,borean-tundra,715,hunter,marksmanship,15,8,7
Ryhope,silvermoon,714,hunter,marksmanship,11,8,3
Saccä,ysondre,711,hunter,marksmanship,36,9,27
Загзигзаг,soulflayer,710,hunter,marksmanship,21,9,12
Sauer,stormreaver,704,hunter,marksmanship,24,8,16
Grinfall,archimonde,704,hunter,marksmanship,32,9,23
Thieuu,twisting-nether,703,hunter,marksmanship,11,8,3
Фломидзе,gordunni,688,hunter,marksmanship,13,8,5
Dtq,silvermoon,672,hunter,marksmanship,12,7,5
Weilerz,drakthul,672,hunter,marksmanship,12,7,5
Barrybigtoe,tarren-mill,672,hunter,marksmanship,12,7,5
Killershadow,twisting-nether,672,hunter,marksmanship,12,7,5
Vracarx,silvermoon,672,hunter,marksmanship,12,7,5
Merquryh,ravencrest,672,hunter,marksmanship,12,7,5
Hesuss,kazzak,672,hunter,marksmanship,12,7,5
Агелетка,gordunni,672,hunter,marksmanship,12,7,5
Fluttershy,terokkar,672,hunter,marksmanship,12,7,5
Lilsnuss,outland,672,hunter,marksmanship,12,7,5
Costner,darksorrow,672,hunter,marksmanship,12,7,5
Blackbane,ravencrest,672,hunter,marksmanship,12,7,5
Bonjwa,aegwynn,672,hunter,marksmanship,12,7,5
Аабстрактная,gordunni,672,hunter,marksmanship,12,7,5
Monnee,outland,672,hunter,marksmanship,12,7,5
Bigbowyahurd,draenor,672,hunter,marksmanship,12,7,5
Veñom,stormscale,672,hunter,marksmanship,12,7,5
Найтхантишка,gordunni,672,hunter,marksmanship,12,7,5
Riflur,stormscale,672,hunter,marksmanship,12,7,5
Хвоостт,gordunni,672,hunter,marksmanship,12,7,5
Avaren,archimonde,672,hunter,marksmanship,12,7,5
Bawzé,archimonde,672,hunter,marksmanship,12,7,5
Bnji,hyjal,672,hunter,marksmanship,18,7,11
Påtrîckbátém,ravencrest,672,hunter,marksmanship,18,7,11
Mclooving,runetotem,672,hunter,marksmanship,18,7,11
Scartet,blackmoore,672,hunter,marksmanship,18,7,11
Землепух,howling-fjord,672,hunter,marksmanship,18,7,11
Джарвиз,soulflayer,672,hunter,marksmanship,18,7,11
Ahrtemís,destromath,672,hunter,marksmanship,18,7,11
Трольболь,eversong,672,hunter,marksmanship,18,7,11
Онкьяр,gordunni,672,hunter,marksmanship,24,7,17
Griffithstew,blackmoore,672,hunter,marksmanship,24,7,17
Piksî,kazzak,672,hunter,marksmanship,24,7,17
Халикер,soulflayer,671,hunter,marksmanship,12,7,5
Недоношенная,howling-fjord,671,hunter,marksmanship,12,7,5
Ôrïøn,archimonde,671,hunter,marksmanship,12,7,5
Poppson,magtheridon,671,hunter,marksmanship,12,7,5
Partouche,sargeras,671,hunter,marksmanship,12,7,5
Qiruun,draenor,671,hunter,marksmanship,12,7,5
Pargz,auchindoun,671,hunter,marksmanship,12,7,5
Maknamara,tarren-mill,671,hunter,marksmanship,12,7,5
Rísu,argent-dawn,671,hunter,marksmanship,12,7,5
Fixel,pozzo-delleternità,671,hunter,marksmanship,12,7,5
Rydén,pozzo-delleternità,671,hunter,marksmanship,18,7,11
Fanstwo,tarren-mill,671,hunter,marksmanship,18,7,11
Jomerin,thrall,671,hunter,marksmanship,18,7,11
Thengill,draenor,671,hunter,marksmanship,18,7,11
Snaptrap,eredar,671,hunter,marksmanship,18,7,11
Ashrak,frostmourne,671,hunter,marksmanship,18,7,11
Ihateyoumore,ravencrest,671,hunter,marksmanship,18,7,11
Aureboby,hyjal,671,hunter,marksmanship,24,7,17
Faenor,arygos,671,hunter,marksmanship,24,7,17
Sjufemman,ravencrest,671,hunter,marksmanship,24,7,17
Pôts,blackrock,671,hunter,marksmanship,24,7,17
Deathtrapper,bronzebeard,670,hunter,marksmanship,12,7,5
Pewpewshotz,stormscale,670,hunter,marksmanship,12,7,5
Spêctrâ,sylvanas,670,hunter,marksmanship,18,7,11
Yip,twisting-nether,670,hunter,marksmanship,18,7,11
Jiton,grim-batol,670,hunter,marksmanship,18,7,11
Ричардн,howling-fjord,670,hunter,marksmanship,18,7,11
Elektrô,blackmoore,670,hunter,marksmanship,27,7,20
Dahunter,blackmoore,669,hunter,marksmanship,12,7,5
Qqc,burning-legion,669,hunter,marksmanship,12,7,5
Aggyaceshot,silvermoon,669,hunter,marksmanship,18,7,11
Flintenwilly,die-aldor,669,hunter,marksmanship,18,7,11
Kaudza,archimonde,669,hunter,marksmanship,18,7,11
Ядрис,gordunni,668,hunter,marksmanship,12,7,5
Wishmeweed,kazzak,668,hunter,marksmanship,18,7,11
Rayzør,eitrigg,668,hunter,marksmanship,18,7,11
Panfilmaaj,burning-legion,667,hunter,marksmanship,18,7,11
Enerhunt,ysondre,667,hunter,marksmanship,18,7,11
Мокку,howling-fjord,665,hunter,marksmanship,12,7,5
Eilaa,ravencrest,662,hunter,marksmanship,18,7,11
Fernetcola,los-errantes,661,hunter,marksmanship,12,7,5
Banshees,sylvanas,661,hunter,marksmanship,12,7,5
Arkman,malganis,660,hunter,marksmanship,30,7,23
Shokre,silvermoon,657,hunter,marksmanship,12,7,5
Breezhunt,twisting-nether,655,hunter,marksmanship,17,7,10
Есселин,thermaplugg,650,hunter,marksmanship,18,7,11
Lofiv,turalyon,639,hunter,marksmanship,16,7,9
Jocitwitch,ragnaros,624,hunter,marksmanship,15,8,7
Элфй,gordunni,623,hunter,marksmanship,21,7,14
Scark,tarren-mill,621,hunter,marksmanship,11,7,4
Kyliun,frostmane,620,hunter,marksmanship,17,7,10
Zaragattas,aggra-português,618,hunter,marksmanship,23,9,14
Фаффурион,gordunni,617,hunter,marksmanship,19,9,10
Iniduhr,dalaran,617,hunter,marksmanship,21,8,13
Sylasteria,twisting-nether,617,hunter,marksmanship,22,8,14
Weridia,der-rat-von-dalaran,607,hunter,marksmanship,11,7,4
Trachunt,twisting-nether,607,hunter,marksmanship,11,7,4
Chizuna,dun-morogh,606,hunter,marksmanship,14,7,7
Tingly,grim-batol,605,hunter,marksmanship,20,7,13
Саэсантессис,howling-fjord,601,hunter,marksmanship,16,7,9
Biggusdickuz,tarren-mill,590,hunter,marksmanship,11,7,4
Крошкамэг,eversong,582,hunter,marksmanship,13,7,6
Connyrövöga,draenor,576,hunter,marksmanship,6,6,0
Djidawn,ysondre,576,hunter,marksmanship,12,6,6
Hunlin,kazzak,576,hunter,marksmanship,12,6,6
Shína,argent-dawn,576,hunter,marksmanship,12,6,6
Aenina,kazzak,576,hunter,marksmanship,12,6,6
Dugini,ravencrest,576,hunter,marksmanship,12,6,6
Axran,ravencrest,576,hunter,marksmanship,12,6,6
Nelf,shattered-hand,576,hunter,marksmanship,12,6,6
Pantero,kazzak,576,hunter,marksmanship,12,6,6
Инкризшот,gordunni,576,hunter,marksmanship,12,6,6
Bøgs,the-maelstrom,576,hunter,marksmanship,12,6,6
Sketana,silvermoon,576,hunter,marksmanship,12,6,6
Madjia,ravencrest,576,hunter,marksmanship,12,6,6
Vorsia,tarren-mill,576,hunter,marksmanship,12,6,6
Destynarîa,illidan,576,hunter,marksmanship,12,6,6
Stamzer,drakthul,576,hunter,marksmanship,12,6,6
Grandiosity,tarren-mill,576,hunter,marksmanship,12,6,6
Gramyr,ysondre,576,hunter,marksmanship,12,6,6
Greg,defias-brotherhood,576,hunter,marksmanship,12,6,6
Джинксан,blackscar,576,hunter,marksmanship,12,6,6
Crudeconzept,talnivarr,576,hunter,marksmanship,12,6,6
Dolwen,argent-dawn,576,hunter,marksmanship,12,6,6
Freexkite,aegwynn,576,hunter,marksmanship,14,6,8
Antisniper,kazzak,576,hunter,marksmanship,17,6,11
Tomli,nemesis,576,hunter,marksmanship,18,6,12
Oobe,hyjal,576,hunter,marksmanship,18,6,12
Такувами,gordunni,576,hunter,marksmanship,18,6,12
Avaîo,ysondre,576,hunter,marksmanship,18,6,12
Тохадиско,gordunni,575,hunter,marksmanship,6,6,0
Xeragon,frostwolf,575,hunter,marksmanship,12,6,6
Чизано,deathguard,575,hunter,marksmanship,12,6,6
Fugass,ragnaros,575,hunter,marksmanship,12,6,6
Jägarenen,kazzak,575,hunter,marksmanship,12,6,6
Ina,tarren-mill,575,hunter,marksmanship,12,6,6
Eledryn,bronze-dragonflight,575,hunter,marksmanship,12,6,6
Dirtydolores,thrall,575,hunter,marksmanship,12,6,6
Kilölek,ragnaros,575,hunter,marksmanship,12,6,6
Ruger,hyjal,575,hunter,marksmanship,12,6,6
Neuwi,stormreaver,575,hunter,marksmanship,12,6,6
Slayné,silvermoon,575,hunter,marksmanship,12,6,6
Elladiel,blackmoore,575,hunter,marksmanship,12,6,6
Itenik,frostwolf,575,hunter,marksmanship,12,6,6
Domsín,ravencrest,575,hunter,marksmanship,12,6,6
Earlyspring,ragnaros,575,hunter,marksmanship,12,6,6
Muddí,ravencrest,575,hunter,marksmanship,12,6,6
Squidy,archimonde,575,hunter,marksmanship,12,6,6
Tolkienn,archimonde,575,hunter,marksmanship,12,6,6
Evelhunter,kargath,575,hunter,marksmanship,12,6,6
Переферия,galakrond,575,hunter,marksmanship,18,6,12
Bawwykwipkee,ragnaros,575,hunter,marksmanship,18,6,12
Dritzdòurden,dun-modr,575,hunter,marksmanship,18,6,12
Narziel,die-todeskrallen,575,hunter,marksmanship,18,6,12
Elvenian,twisting-nether,575,hunter,marksmanship,18,6,12
Bourrinax,kazzak,575,hunter,marksmanship,18,6,12
Gxx,burning-blade,575,hunter,marksmanship,18,6,12
Longshot,burning-legion,574,hunter,marksmanship,12,6,6
Egy,the-maelstrom,574,hunter,marksmanship,12,6,6
Hunterixx,outland,574,hunter,marksmanship,12,6,6
Løløsifredo,ysondre,574,hunter,marksmanship,12,6,6
Seariko,draenor,574,hunter,marksmanship,18,6,12
Kveyther,silvermoon,572,hunter,marksmanship,12,6,6
Hitscan,ravencrest,572,hunter,marksmanship,12,6,6
Анариэлль,gordunni,572,hunter,marksmanship,12,6,6
Orcgun,mugthol,572,hunter,marksmanship,18,6,12
Cilia,suramar,571,hunter,marksmanship,18,6,12
Selini,bloodfeather,570,hunter,marksmanship,12,6,6
Dødshøt,twisting-nether,569,hunter,marksmanship,18,6,12
Jilkhar,twisting-nether,565,hunter,marksmanship,12,6,6
Mooj,malganis,559,hunter,marksmanship,11,6,5
Rockymarciaa,dalaran,527,hunter,marksmanship,21,6,15
Hantdown,defias-brotherhood,526,hunter,marksmanship,11,6,5
Кисяныч,gordunni,522,hunter,marksmanship,15,7,8
Huntseeker,draenor,511,hunter,marksmanship,14,6,8
Emriye,antonidas,510,hunter,marksmanship,14,6,8
Фэйсконтроль,azuregos,506,hunter,marksmanship,20,6,14
Пушкабомби,soulflayer,497,hunter,marksmanship,20,6,14
Сальверди,gordunni,480,hunter,marksmanship,6,5,1
Deepcleaning,kazzak,480,hunter,marksmanship,6,5,1
Hvaskøduenme,stormscale,480,hunter,marksmanship,6,5,1
Srédder,defias-brotherhood,480,hunter,marksmanship,6,5,1
Hollyz,auchindoun,480,hunter,marksmanship,6,5,1
Eveo,antonidas,480,hunter,marksmanship,6,5,1
Ðarrk,tarren-mill,480,hunter,marksmanship,6,5,1
Hawkinstinct,tarren-mill,480,hunter,marksmanship,6,5,1
Soloist,sylvanas,480,hunter,marksmanship,6,5,1
Akkixz,antonidas,480,hunter,marksmanship,6,5,1
Îløvémêld,kazzak,480,hunter,marksmanship,6,5,1
Toptìérgoðx,drakthul,480,hunter,marksmanship,6,5,1
Ormsliskaren,shattered-hand,480,hunter,marksmanship,6,5,1
Полития,azuregos,480,hunter,marksmanship,9,6,3
Agbaba,twisting-nether,480,hunter,marksmanship,12,5,7
Headshott,agamaggan,480,hunter,marksmanship,12,5,7
Famex,blackmoore,480,hunter,marksmanship,12,5,7
Denaik,ravencrest,480,hunter,marksmanship,12,5,7
Galou,ghostlands,480,hunter,marksmanship,12,5,7
Adhdbad,tarren-mill,480,hunter,marksmanship,12,5,7
Psychlolzxr,burning-legion,480,hunter,marksmanship,12,5,7
Sissnik,thrall,480,hunter,marksmanship,12,5,7
Ghøst,madmortem,480,hunter,marksmanship,12,5,7
Lambtron,tarren-mill,480,hunter,marksmanship,12,5,7
Bloodymarìe,kelthuzad,480,hunter,marksmanship,12,5,7
Уайлен,gordunni,480,hunter,marksmanship,12,5,7
Mazhug,stormreaver,480,hunter,marksmanship,12,5,7
Msir,kazzak,480,hunter,marksmanship,12,5,7
Huntardös,outland,480,hunter,marksmanship,12,5,7
Nawwaf,tarren-mill,480,hunter,marksmanship,12,5,7
Кукито,goldrinn,480,hunter,marksmanship,12,5,7
Кайсго,gordunni,480,hunter,marksmanship,12,5,7
Мафчик,razuvious,480,hunter,marksmanship,12,5,7
Zulthat,thrall,480,hunter,marksmanship,12,5,7
Majuli,stormrage,480,hunter,marksmanship,12,5,7
Deathmarks,blackrock,480,hunter,marksmanship,12,5,7
Sloee,sylvanas,480,hunter,marksmanship,12,5,7
Thúnar,aegwynn,480,hunter,marksmanship,12,5,7
Geete,kazzak,480,hunter,marksmanship,12,5,7
Nothrokh,auchindoun,480,hunter,marksmanship,12,5,7
Trapmanager,kazzak,480,hunter,marksmanship,12,5,7
Tackleberry,ysondre,480,hunter,marksmanship,12,5,7
Ðõt,ravencrest,480,hunter,marksmanship,12,5,7
Kundra,ravencrest,480,hunter,marksmanship,12,5,7
Tavira,zuljin,480,hunter,marksmanship,12,5,7
Куников,booty-bay,480,hunter,marksmanship,12,5,7
Frágile,drakthul,480,hunter,marksmanship,12,5,7
Carrilynn,blackrock,480,hunter,marksmanship,12,5,7
Fylealaes,ravencrest,480,hunter,marksmanship,12,5,7
Ashide,dun-modr,480,hunter,marksmanship,12,5,7
Sodavand,silvermoon,480,hunter,marksmanship,12,5,7
Spitchy,kazzak,480,hunter,marksmanship,12,5,7
Serpos,cthun,480,hunter,marksmanship,12,5,7
Sashobg,aerie-peak,480,hunter,marksmanship,12,5,7
Meghanmarkle,tarren-mill,480,hunter,marksmanship,13,5,8
Draknik,nemesis,480,hunter,marksmanship,16,6,10
Deathchoice,azshara,480,hunter,marksmanship,18,5,13
Elcouche,draenor,480,hunter,marksmanship,18,5,13
Ceres,kaelthas,480,hunter,marksmanship,18,5,13
Тэуреэль,gordunni,480,hunter,marksmanship,18,5,13
Athel,moonglade,480,hunter,marksmanship,18,5,13
Deathwallker,silvermoon,480,hunter,marksmanship,18,5,13
Dramin,defias-brotherhood,480,hunter,marksmanship,18,5,13
Hÿyrøk,ysondre,480,hunter,marksmanship,18,5,13
Outkást,sylvanas,480,hunter,marksmanship,18,5,13
Gukéx,stormscale,480,hunter,marksmanship,18,5,13
Ggproiettili,pozzo-delleternità,480,hunter,marksmanship,18,5,13
Carnificis,sanguino,480,hunter,marksmanship,18,5,13
Noobhuntress,norgannon,480,hunter,marksmanship,18,5,13
Glockzs,auchindoun,480,hunter,marksmanship,18,5,13
Tetiscaza,sanguino,480,hunter,marksmanship,24,5,19
Asâya,blackmoore,479,hunter,marksmanship,6,5,1
Nathah,burning-legion,479,hunter,marksmanship,6,5,1
Xeqter,ravencrest,479,hunter,marksmanship,12,5,7
Typex,defias-brotherhood,479,hunter,marksmanship,12,5,7
Whereismypet,azjolnerub,479,hunter,marksmanship,12,5,7
Ninjaskillss,ravencrest,479,hunter,marksmanship,12,5,7
Zäyk,zuljin,479,hunter,marksmanship,12,5,7
Lunalai,antonidas,479,hunter,marksmanship,12,5,7
Aspéct,ravencrest,479,hunter,marksmanship,12,5,7
Razzét,stormscale,479,hunter,marksmanship,12,5,7
Grimazg,chogall,479,hunter,marksmanship,12,5,7
Bicepz,azjolnerub,479,hunter,marksmanship,12,5,7
Secrety,doomhammer,479,hunter,marksmanship,17,5,12
Зиргус,gordunni,479,hunter,marksmanship,18,5,13
Nígruløl,arthas,479,hunter,marksmanship,18,5,13
Leafstorm,vashj,479,hunter,marksmanship,18,5,13
Hentt,burning-legion,479,hunter,marksmanship,18,5,13
Naregar,draenor,479,hunter,marksmanship,18,5,13
Ðepleter,outland,479,hunter,marksmanship,18,5,13
Fugerlynipps,stormrage,479,hunter,marksmanship,24,5,19
Bæbåk,frostmane,478,hunter,marksmanship,6,5,1
Nightarrows,ravencrest,478,hunter,marksmanship,6,5,1
Thebalrog,korgall,478,hunter,marksmanship,12,5,7
Tiph,argent-dawn,478,hunter,marksmanship,12,5,7
Лукорды,gordunni,478,hunter,marksmanship,12,5,7
Miisakaa,antonidas,477,hunter,marksmanship,12,5,7
Bloodshot,nethersturm,477,hunter,marksmanship,12,5,7
Titanx,sylvanas,477,hunter,marksmanship,12,5,7
Legath,emerald-dream,477,hunter,marksmanship,12,5,7
Pylos,azshara,477,hunter,marksmanship,12,5,7
Ашмадей,eversong,476,hunter,marksmanship,12,5,7
Robros,dentarg,475,hunter,marksmanship,12,5,7
Klittcrit,bloodhoof,475,hunter,marksmanship,12,5,7
Sixty,rajaxx,474,hunter,marksmanship,18,5,13
Karmios,drakthul,473,hunter,marksmanship,12,5,7
Juki,pozzo-delleternità,472,hunter,marksmanship,12,5,7
Banninymph,culte-de-la-rive-noire,467,hunter,marksmanship,18,5,13
Brønkø,azshara,463,hunter,marksmanship,17,5,12
Rdevill,outland,448,hunter,marksmanship,16,5,11
Шэнчи,greymane,447,hunter,marksmanship,11,6,5
Littlenugget,ravencrest,447,hunter,marksmanship,11,5,6
Urith,les-clairvoyants,447,hunter,marksmanship,14,6,8
Snípér,blackhand,447,hunter,marksmanship,20,6,14
Haleth,uldum,447,hunter,marksmanship,17,5,12
Thedanchodak,stormrage,440,hunter,marksmanship,11,5,6
Darkstripe,turalyon,431,hunter,marksmanship,11,5,6
Cais,drakthul,426,hunter,marksmanship,18,6,12
Сашатетива,gordunni,426,hunter,marksmanship,20,6,14
Deadyeyez,doomhammer,423,hunter,marksmanship,15,7,8
Sleepyarrow,chogall,420,hunter,marksmanship,12,6,6
Artaeos,lordaeron,416,hunter,marksmanship,16,5,11
Azmena,silvermoon,415,hunter,marksmanship,11,5,6
Гилара,soulflayer,415,hunter,marksmanship,22,5,17
Gotha,festung-der-stürme,414,hunter,marksmanship,14,5,9
Anjeschka,nemesis,400,hunter,marksmanship,7,5,2
Thain,stormscale,384,hunter,marksmanship,6,4,2
Unßørn,archimonde,384,hunter,marksmanship,6,4,2
Snipinx,draenor,384,hunter,marksmanship,6,4,2
Тумбаюмб,howling-fjord,384,hunter,marksmanship,6,4,2
Comegetme,auchindoun,384,hunter,marksmanship,6,4,2
Burninghunt,ravencrest,384,hunter,marksmanship,6,4,2
Chase,wildhammer,384,hunter,marksmanship,6,4,2
Hntudwn,azshara,384,hunter,marksmanship,6,4,2
Kikilirilivi,ysondre,384,hunter,marksmanship,6,4,2
Nßatrapper,outland,384,hunter,marksmanship,6,4,2
Haranti,dun-modr,384,hunter,marksmanship,6,4,2
Kragán,silvermoon,384,hunter,marksmanship,6,4,2
Smígol,stormreaver,384,hunter,marksmanship,6,4,2
Ðøper,hyjal,384,hunter,marksmanship,6,4,2
Øtemløol,sanguino,384,hunter,marksmanship,6,4,2
Roke,malganis,384,hunter,marksmanship,6,4,2
Huntbegin,burning-legion,384,hunter,marksmanship,6,4,2
Rymous,nemesis,384,hunter,marksmanship,6,4,2
Хантероо,gordunni,384,hunter,marksmanship,6,4,2
Velen,pozzo-delleternità,384,hunter,marksmanship,6,4,2
Skytraped,hyjal,384,hunter,marksmanship,6,4,2
Томбомбадил,howling-fjord,384,hunter,marksmanship,6,4,2
Sovanz,aggra-português,384,hunter,marksmanship,6,4,2
Yoey,tarren-mill,384,hunter,marksmanship,6,4,2
Likandria,blackmoore,384,hunter,marksmanship,6,4,2
Spyte,twisting-nether,384,hunter,marksmanship,6,4,2
Dariusmm,silvermoon,384,hunter,marksmanship,6,4,2
Niffe,stormscale,384,hunter,marksmanship,6,4,2
Zoêva,blackhand,384,hunter,marksmanship,6,4,2
Lennyx,quelthalas,384,hunter,marksmanship,6,4,2
Myoui,silvermoon,384,hunter,marksmanship,6,4,2
Ðæom,outland,384,hunter,marksmanship,6,4,2
Sandchaton,ragnaros,384,hunter,marksmanship,6,4,2
Luzivarus,malganis,384,hunter,marksmanship,6,4,2
Slo,sylvanas,384,hunter,marksmanship,6,4,2
Benbutton,antonidas,384,hunter,marksmanship,6,4,2
Hävenofün,archimonde,384,hunter,marksmanship,6,4,2
Ditbjrapex,chants-éternels,384,hunter,marksmanship,6,4,2
Yuichiro,senjin,384,hunter,marksmanship,6,4,2
Сынсема,blackscar,384,hunter,marksmanship,6,4,2
Джеймсфранко,blackscar,384,hunter,marksmanship,6,4,2
Doloresman,tarren-mill,384,hunter,marksmanship,6,4,2
Intoxd,sylvanas,384,hunter,marksmanship,6,4,2
Gaudio,outland,384,hunter,marksmanship,6,4,2
Idtrapthat,nagrand,384,hunter,marksmanship,6,4,2
Сацыви,gordunni,384,hunter,marksmanship,6,4,2
Bosseleon,blackrock,384,hunter,marksmanship,6,4,2
Vantagepoint,arathor,384,hunter,marksmanship,6,4,2
Yuptae,alonsus,384,hunter,marksmanship,6,4,2
Darllene,kazzak,384,hunter,marksmanship,6,4,2
Nöbody,khaz-modan,384,hunter,marksmanship,6,4,2
Donpromìlló,blackhand,384,hunter,marksmanship,9,5,4
Wîldhunt,burning-legion,384,hunter,marksmanship,11,4,7
Fennecshand,colinas-pardas,384,hunter,marksmanship,12,4,8
Йинги,gordunni,384,hunter,marksmanship,12,4,8
Darkshe,dun-modr,384,hunter,marksmanship,12,4,8
Ozaï,eredar,384,hunter,marksmanship,12,4,8
Querro,azshara,384,hunter,marksmanship,12,4,8
Harmonía,outland,384,hunter,marksmanship,12,4,8
Peonfarmer,argent-dawn,384,hunter,marksmanship,12,4,8
Slinkywinky,eonar,384,hunter,marksmanship,12,4,8
Sjins,draenor,384,hunter,marksmanship,12,4,8
Tartaupommes,hyjal,384,hunter,marksmanship,12,4,8
Dangerousfoe,argent-dawn,384,hunter,marksmanship,12,4,8
Shadowxx,silvermoon,384,hunter,marksmanship,12,4,8
Tonttulul,draenor,384,hunter,marksmanship,12,4,8
Nyri,drakthul,384,hunter,marksmanship,12,4,8
Jondone,silvermoon,384,hunter,marksmanship,12,4,8
Kanlina,ravencrest,384,hunter,marksmanship,12,4,8
Графруру,soulflayer,384,hunter,marksmanship,12,4,8
Becoming,burning-legion,384,hunter,marksmanship,12,4,8
Døømslayer,nemesis,384,hunter,marksmanship,12,4,8
Rapid,sylvanas,384,hunter,marksmanship,12,4,8
Rndhunt,shattrath,384,hunter,marksmanship,12,4,8
Chaoticshot,ravencrest,384,hunter,marksmanship,12,4,8
Mexine,dun-morogh,384,hunter,marksmanship,12,4,8
Jinxpeasant,twisting-nether,384,hunter,marksmanship,12,4,8
Diqtore,aszune,384,hunter,marksmanship,12,4,8
Oròg,hyjal,384,hunter,marksmanship,12,4,8
Mousysnok,ravencrest,384,hunter,marksmanship,12,4,8
Jskey,aggramar,384,hunter,marksmanship,12,4,8
Bugspitz,outland,384,hunter,marksmanship,12,4,8
Marodan,ambossar,384,hunter,marksmanship,12,4,8
Абунай,soulflayer,384,hunter,marksmanship,12,4,8
Sharún,sylvanas,384,hunter,marksmanship,12,4,8
Deeparrow,stormscale,384,hunter,marksmanship,12,4,8
Skyttelaj,stormscale,384,hunter,marksmanship,12,4,8
Aamön,tarren-mill,384,hunter,marksmanship,12,4,8
Vallêria,malganis,384,hunter,marksmanship,12,4,8
Zurzok,blackrock,384,hunter,marksmanship,12,4,8
Tytoyz,khaz-modan,384,hunter,marksmanship,12,4,8
Hashaya,hyjal,384,hunter,marksmanship,12,4,8
Naestra,tarren-mill,384,hunter,marksmanship,12,4,8
Vohnívak,turalyon,384,hunter,marksmanship,12,4,8
Egodennis,frostwolf,384,hunter,marksmanship,12,4,8
Aimedbot,azjolnerub,384,hunter,marksmanship,12,4,8
Свадебная,gordunni,384,hunter,marksmanship,12,4,8
Gødzftw,kazzak,384,hunter,marksmanship,14,4,10
Soppatorsk,shadowsong,384,hunter,marksmanship,18,4,14
Шумогон,gordunni,384,hunter,marksmanship,18,4,14
Kêêpsmile,blackmoore,384,hunter,marksmanship,18,4,14
Ruhen,aegwynn,384,hunter,marksmanship,18,4,14
Маори,deepholm,384,hunter,marksmanship,18,4,14
Haraigoshí,grim-batol,384,hunter,marksmanship,18,4,14
Enablee,lightbringer,384,hunter,marksmanship,24,4,20
Конар,soulflayer,383,hunter,marksmanship,6,4,2
Вевери,blackscar,383,hunter,marksmanship,6,4,2
Køûrø,hyjal,383,hunter,marksmanship,6,4,2
Amiosi,sanguino,383,hunter,marksmanship,10,5,5
Penelopé,darkmoon-faire,383,hunter,marksmanship,12,4,8
Zirriath,mazrigos,383,hunter,marksmanship,12,4,8
Anguerande,khaz-modan,383,hunter,marksmanship,12,4,8
Meletis,stormreaver,383,hunter,marksmanship,12,4,8
Tervel,dun-morogh,383,hunter,marksmanship,12,4,8
Kyéra,kirin-tor,383,hunter,marksmanship,12,4,8
Amsterdamer,sylvanas,383,hunter,marksmanship,12,4,8
Beaupapa,archimonde,383,hunter,marksmanship,14,4,10
Hunntte,ravencrest,383,hunter,marksmanship,14,4,10
Koreic,silvermoon,383,hunter,marksmanship,18,4,14
Musux,uldum,383,hunter,marksmanship,18,4,14
Agnõr,chants-éternels,382,hunter,marksmanship,6,4,2
Bulhumt,draenor,382,hunter,marksmanship,6,4,2
Deadshout,kazzak,382,hunter,marksmanship,6,4,2
Petardas,outland,382,hunter,marksmanship,6,4,2
Nonamenoskil,sylvanas,382,hunter,marksmanship,12,4,8
Costae,aerie-peak,382,hunter,marksmanship,12,4,8
Бурбоньчик,soulflayer,382,hunter,marksmanship,12,4,8
Metapouk,archimonde,382,hunter,marksmanship,12,4,8
Skapig,frostwolf,381,hunter,marksmanship,12,4,8
Pâthfînder,destromath,379,hunter,marksmanship,12,4,8
Lumidii,burning-legion,379,hunter,marksmanship,12,4,8
Ketsh,antonidas,367,hunter,marksmanship,11,4,7
Dhmuntar,ravencrest,367,hunter,marksmanship,11,4,7
Éddiémórphín,kazzak,367,hunter,marksmanship,11,4,7
Jablaka,blackhand,366,hunter,marksmanship,23,4,19
Boehelientje,defias-brotherhood,351,hunter,marksmanship,11,4,7
Naepy,thrall,351,hunter,marksmanship,16,4,12
Rea,archimonde,350,hunter,marksmanship,16,4,12
Shadoox,argent-dawn,335,hunter,marksmanship,11,4,7
Arwenna,argent-dawn,328,hunter,marksmanship,11,6,5
Rakmo,blackmoore,320,hunter,marksmanship,10,4,6
Bloópy,silvermoon,320,hunter,marksmanship,10,4,6
Выпейдождь,gordunni,319,hunter,marksmanship,8,4,4
Трапавграунд,howling-fjord,288,hunter,marksmanship,6,3,3
Magmageul,archimonde,288,hunter,marksmanship,6,3,3
Kaznek,hyjal,288,hunter,marksmanship,6,3,3
Антисерт,ashenvale,288,hunter,marksmanship,6,3,3
Djøgi,archimonde,288,hunter,marksmanship,6,3,3
Mhb,quelthalas,288,hunter,marksmanship,6,3,3
Nerdhark,hyjal,288,hunter,marksmanship,6,3,3
Dreemshoot,stormscale,288,hunter,marksmanship,6,3,3
Eéilin,the-maelstrom,288,hunter,marksmanship,6,3,3
Fize,blackmoore,288,hunter,marksmanship,6,3,3
Andrøk,archimonde,288,hunter,marksmanship,6,3,3
Tardoboy,blackrock,288,hunter,marksmanship,6,3,3
Люблюлюбовь,gordunni,288,hunter,marksmanship,6,3,3
Комомура,soulflayer,288,hunter,marksmanship,6,3,3
ßæro,hyjal,288,hunter,marksmanship,6,3,3
Brûmovitch,archimonde,288,hunter,marksmanship,6,3,3
Phinecone,stormscale,288,hunter,marksmanship,6,3,3
Zøk,stormscale,288,hunter,marksmanship,6,3,3
Lioness,ahnqiraj,288,hunter,marksmanship,6,3,3
Loydzz,hyjal,288,hunter,marksmanship,6,3,3
Mariabanks,aegwynn,288,hunter,marksmanship,6,3,3
Padancete,sanguino,288,hunter,marksmanship,6,3,3
Spítz,outland,288,hunter,marksmanship,6,3,3
Ев,lich-king,288,hunter,marksmanship,6,3,3
Celebor,sanguino,288,hunter,marksmanship,6,3,3
Feyoonxx,blackrock,288,hunter,marksmanship,6,3,3
Spunkybum,nagrand,288,hunter,marksmanship,6,3,3
Atranex,ravencrest,288,hunter,marksmanship,6,3,3
Колякилшот,gordunni,288,hunter,marksmanship,6,3,3
Abaforth,bronze-dragonflight,288,hunter,marksmanship,6,3,3
Яроняютрапу,gordunni,288,hunter,marksmanship,6,3,3
Aimshot,ravencrest,288,hunter,marksmanship,6,3,3
Kahbe,ravencrest,288,hunter,marksmanship,6,3,3
Neescafe,sylvanas,288,hunter,marksmanship,6,3,3
Rakshor,thrall,288,hunter,marksmanship,6,3,3
Velne,ravencrest,288,hunter,marksmanship,6,3,3
Sylariel,die-aldor,288,hunter,marksmanship,6,3,3
Samasukë,grim-batol,288,hunter,marksmanship,6,3,3
Techpøint,silvermoon,288,hunter,marksmanship,6,3,3
Hiddenstalk,outland,288,hunter,marksmanship,6,3,3
Attileus,ragnaros,288,hunter,marksmanship,6,3,3
Хихихихх,gordunni,288,hunter,marksmanship,6,3,3
Kaminôr,antonidas,288,hunter,marksmanship,6,3,3
Каэсс,gordunni,288,hunter,marksmanship,6,3,3
Threeguns,blackrock,288,hunter,marksmanship,6,3,3
Jarhead,arthas,288,hunter,marksmanship,6,3,3
Anthélià,antonidas,288,hunter,marksmanship,6,3,3
Pläpp,stormscale,288,hunter,marksmanship,6,3,3
Ätea,hyjal,288,hunter,marksmanship,6,3,3
Экономист,fordragon,288,hunter,marksmanship,6,3,3
Kfcmanagerx,silvermoon,288,hunter,marksmanship,6,3,3
Dedral,aegwynn,288,hunter,marksmanship,6,3,3
Hreo,twisting-nether,288,hunter,marksmanship,6,3,3
Bocek,silvermoon,288,hunter,marksmanship,6,3,3
Semda,blackmoore,288,hunter,marksmanship,6,3,3
Aliltoxic,silvermoon,288,hunter,marksmanship,6,3,3
Zwockeline,blutkessel,288,hunter,marksmanship,6,3,3
Гунныч,grom,288,hunter,marksmanship,6,3,3
Osie,kazzak,288,hunter,marksmanship,6,3,3
Rykini,twisting-nether,288,hunter,marksmanship,6,3,3
Ozzaty,drekthar,288,hunter,marksmanship,6,3,3
Milhambré,ysondre,288,hunter,marksmanship,6,3,3
Eliune,silvermoon,288,hunter,marksmanship,6,3,3
Storphunt,drakthul,288,hunter,marksmanship,6,3,3
Stripedcani,kelthuzad,288,hunter,marksmanship,6,3,3
Hidalgô,kult-der-verdammten,288,hunter,marksmanship,6,3,3
Zugzlug,tarren-mill,288,hunter,marksmanship,6,3,3
Lithell,kazzak,288,hunter,marksmanship,6,3,3
Burbutsuluki,silvermoon,288,hunter,marksmanship,6,3,3
Ayiu,argent-dawn,288,hunter,marksmanship,6,3,3
Deadluck,kazzak,288,hunter,marksmanship,6,3,3
Elonmask,argent-dawn,288,hunter,marksmanship,6,3,3
Graavi,silvermoon,288,hunter,marksmanship,6,3,3
Ökisek,drakthul,288,hunter,marksmanship,6,3,3
Nightarrowq,tarren-mill,288,hunter,marksmanship,9,4,5
Amdéa,boulderfist,288,hunter,marksmanship,10,4,6
Boen,nordrassil,288,hunter,marksmanship,8,3,5
Нойран,eversong,288,hunter,marksmanship,9,3,6
Астериел,blackscar,288,hunter,marksmanship,12,3,9
Saîtek,chogall,288,hunter,marksmanship,12,3,9
Richidex,zuljin,288,hunter,marksmanship,12,3,9
Jensa,darksorrow,288,hunter,marksmanship,12,3,9
Ghenter,sargeras,288,hunter,marksmanship,12,3,9
Dafragger,blackmoore,288,hunter,marksmanship,12,3,9
Akù,magtheridon,288,hunter,marksmanship,12,3,9
Flucxx,stormscale,288,hunter,marksmanship,12,3,9
Mewithoutyou,ragnaros,288,hunter,marksmanship,12,3,9
Хедшоттер,blackscar,288,hunter,marksmanship,12,3,9
Chassuu,khaz-modan,288,hunter,marksmanship,12,3,9
Sphinx,neptulon,288,hunter,marksmanship,12,3,9
Deahtviper,blackmoore,288,hunter,marksmanship,12,3,9
Naaztko,stormscale,288,hunter,marksmanship,12,3,9
Funkemarie,blackmoore,288,hunter,marksmanship,12,3,9
Скадхи,blackscar,288,hunter,marksmanship,12,3,9
Missdarkness,shattered-hand,288,hunter,marksmanship,12,3,9
Нэвлоск,gordunni,288,hunter,marksmanship,12,3,9
Snipar,chogall,288,hunter,marksmanship,12,3,9
Bâng,zuljin,288,hunter,marksmanship,12,3,9
Bowgamerx,ravencrest,288,hunter,marksmanship,12,3,9
Fatfrumos,twisting-nether,288,hunter,marksmanship,12,3,9
Incompetence,argent-dawn,288,hunter,marksmanship,12,3,9
Бубунн,howling-fjord,288,hunter,marksmanship,12,3,9
Oduross,minahonda,288,hunter,marksmanship,12,3,9
Flyingnipp,arthas,288,hunter,marksmanship,12,3,9
Spakster,blackrock,288,hunter,marksmanship,12,3,9
Thalanel,arthas,288,hunter,marksmanship,12,3,9
Jakis,silvermoon,288,hunter,marksmanship,12,3,9
Rløad,hyjal,288,hunter,marksmanship,12,3,9
Aurah,les-clairvoyants,288,hunter,marksmanship,12,3,9
Soviectk,aggra-português,288,hunter,marksmanship,12,3,9
Zubro,kazzak,288,hunter,marksmanship,12,3,9
Augie,kazzak,288,hunter,marksmanship,12,3,9
Nímren,ambossar,288,hunter,marksmanship,12,3,9
Deify,grim-batol,288,hunter,marksmanship,12,3,9
Lùchiean,kazzak,288,hunter,marksmanship,12,3,9
Foxmis,kazzak,288,hunter,marksmanship,12,3,9
Tsía,ysondre,288,hunter,marksmanship,17,3,14
Shademd,ahnqiraj,288,hunter,marksmanship,18,3,15
Apolix,ragnaros,288,hunter,marksmanship,18,3,15
Lamenob,neptulon,288,hunter,marksmanship,18,3,15
Showdope,drakthul,288,hunter,marksmanship,18,3,15
Sidera,der-rat-von-dalaran,288,hunter,marksmanship,18,3,15
Turkos,krasus,287,hunter,marksmanship,6,3,3
Nycto,norgannon,287,hunter,marksmanship,6,3,3
Оркос,deathweaver,287,hunter,marksmanship,6,3,3
Cronox,sporeggar,287,hunter,marksmanship,6,3,3
Pulica,the-maelstrom,287,hunter,marksmanship,6,3,3
Kolskoot,kilrogg,287,hunter,marksmanship,6,3,3
Kilshot,burning-legion,287,hunter,marksmanship,6,3,3
Btk,sanguino,287,hunter,marksmanship,6,3,3
Cøbrâ,hyjal,287,hunter,marksmanship,10,3,7
Onexshot,draenor,287,hunter,marksmanship,12,3,9
Dwoas,darkspear,287,hunter,marksmanship,12,3,9
Constantín,aegwynn,287,hunter,marksmanship,12,3,9
Zwerglogan,amanthul,287,hunter,marksmanship,18,3,15
Jomoguin,stormscale,286,hunter,marksmanship,6,3,3
Millhunter,norgannon,284,hunter,marksmanship,12,3,9
Najetazruda,drakthul,255,hunter,marksmanship,10,3,7
Jaguarundy,dun-modr,239,hunter,marksmanship,5,3,2
Eazzyy,auchindoun,239,hunter,marksmanship,5,3,2
Олдорк,howling-fjord,239,hunter,marksmanship,12,3,9
Incrediown,tarren-mill,234,hunter,marksmanship,7,4,3
Шикаа,gordunni,223,hunter,marksmanship,8,3,5
Dampfwâlzê,nozdormu,223,hunter,marksmanship,14,3,11
Skarra,zuljin,208,hunter,marksmanship,7,3,4
Zinà,naxxramas,192,hunter,marksmanship,6,2,4
Entaiy,blackmoore,192,hunter,marksmanship,6,2,4
Bobshmurda,defias-brotherhood,192,hunter,marksmanship,6,2,4
Notikâ,aegwynn,192,hunter,marksmanship,6,2,4
Горгудц,gordunni,192,hunter,marksmanship,6,2,4
Хароко,gordunni,192,hunter,marksmanship,6,2,4
Ecthelione,the-venture-co,192,hunter,marksmanship,6,2,4
Гернриета,gordunni,192,hunter,marksmanship,6,2,4
Nnoyk,defias-brotherhood,192,hunter,marksmanship,6,2,4
Bowner,frostmane,192,hunter,marksmanship,6,2,4
Bignug,conseil-des-ombres,192,hunter,marksmanship,6,2,4
Lagich,sylvanas,192,hunter,marksmanship,6,2,4
Sloe,sylvanas,192,hunter,marksmanship,6,2,4
Bärberøusse,illidan,192,hunter,marksmanship,6,2,4
Bellecoq,arathi,192,hunter,marksmanship,6,2,4
Flick,auchindoun,192,hunter,marksmanship,6,2,4
Avp,sylvanas,192,hunter,marksmanship,6,2,4
Bréanni,auchindoun,192,hunter,marksmanship,6,2,4
Traplørdx,sylvanas,192,hunter,marksmanship,6,2,4
Mìrilass,nemesis,192,hunter,marksmanship,6,2,4
Sarblade,bronze-dragonflight,192,hunter,marksmanship,6,2,4
Sebrienne,defias-brotherhood,192,hunter,marksmanship,6,2,4
Anklar,blackrock,192,hunter,marksmanship,6,2,4
Трисциллочка,howling-fjord,192,hunter,marksmanship,6,2,4
Sankari,blackmoore,192,hunter,marksmanship,6,2,4
Darkshàdow,archimonde,192,hunter,marksmanship,6,2,4
Rixxâr,blackrock,192,hunter,marksmanship,6,2,4
Sayn,la-croisade-écarlate,192,hunter,marksmanship,6,2,4
Hapocalypt,pozzo-delleternità,192,hunter,marksmanship,6,2,4
Velvett,blackmoore,192,hunter,marksmanship,6,2,4
Silenta,outland,192,hunter,marksmanship,6,2,4
Keinzira,hyjal,192,hunter,marksmanship,6,2,4
Melloy,drakthul,192,hunter,marksmanship,6,2,4
Rickgrimés,silvermoon,192,hunter,marksmanship,6,2,4
Elvyns,silvermoon,192,hunter,marksmanship,6,2,4
Themehdi,silvermoon,192,hunter,marksmanship,6,2,4
Fenomhunt,silvermoon,192,hunter,marksmanship,6,2,4
Ävírøñskÿ,ravencrest,192,hunter,marksmanship,6,2,4
Ðkð,archimonde,192,hunter,marksmanship,6,2,4
Brizza,talnivarr,192,hunter,marksmanship,6,2,4
Greenstar,twisting-nether,192,hunter,marksmanship,6,2,4
Охотуначал,soulflayer,192,hunter,marksmanship,6,2,4
Фетсол,soulflayer,192,hunter,marksmanship,6,2,4
Зихантер,soulflayer,192,hunter,marksmanship,6,2,4
Mobshot,twisting-nether,192,hunter,marksmanship,6,2,4
Tòràk,twisting-nether,192,hunter,marksmanship,6,2,4
Сактарион,soulflayer,192,hunter,marksmanship,6,2,4
Kodakcrack,draenor,192,hunter,marksmanship,6,2,4
Plilolz,archimonde,192,hunter,marksmanship,6,2,4
Шергала,soulflayer,192,hunter,marksmanship,6,2,4
Othellö,kazzak,192,hunter,marksmanship,6,2,4
Legöläs,tarren-mill,192,hunter,marksmanship,6,2,4
Doknak,gilneas,192,hunter,marksmanship,6,2,4
Vâleriaa,blackrock,192,hunter,marksmanship,6,2,4
Realme,blackrock,192,hunter,marksmanship,6,2,4
Olsenas,silvermoon,192,hunter,marksmanship,6,2,4
Slayman,kazzak,192,hunter,marksmanship,6,2,4
Sinadoreck,sargeras,192,hunter,marksmanship,6,2,4
Olrik,dentarg,192,hunter,marksmanship,6,2,4
Goldnug,karazhan,192,hunter,marksmanship,6,2,4
Dola,archimonde,192,hunter,marksmanship,6,2,4
Miracleh,tarren-mill,192,hunter,marksmanship,6,2,4
Hadto,der-rat-von-dalaran,192,hunter,marksmanship,6,2,4
Arrowlight,archimonde,192,hunter,marksmanship,6,2,4
Sinequanon,mannoroth,192,hunter,marksmanship,6,2,4
Хисдед,howling-fjord,192,hunter,marksmanship,6,2,4
Ricoshet,silvermoon,192,hunter,marksmanship,6,2,4
Nashanael,argent-dawn,192,hunter,marksmanship,6,2,4
Powerofanime,drakthul,192,hunter,marksmanship,6,2,4
Bóssit,skullcrusher,192,hunter,marksmanship,6,2,4
Isokrates,das-syndikat,192,hunter,marksmanship,6,2,4
Tórbjorn,argent-dawn,192,hunter,marksmanship,6,2,4
Beletor,medivh,192,hunter,marksmanship,6,2,4
Phanos,draenor,192,hunter,marksmanship,6,2,4
Nimri,kazzak,192,hunter,marksmanship,6,2,4
Carioca,blackhand,192,hunter,marksmanship,6,2,4
Дианнесса,howling-fjord,192,hunter,marksmanship,6,2,4
Rhyle,hyjal,192,hunter,marksmanship,6,2,4
Garrash,teldrassil,192,hunter,marksmanship,6,2,4
Lilsnipè,outland,192,hunter,marksmanship,6,2,4
Jachtorc,kazzak,192,hunter,marksmanship,6,2,4
Aspergun,ragnaros,192,hunter,marksmanship,6,2,4
Hvnn,stormscale,192,hunter,marksmanship,6,2,4
Zulldek,sanguino,192,hunter,marksmanship,6,2,4
Sylverein,silvermoon,192,hunter,marksmanship,6,2,4
Hexorn,ysondre,192,hunter,marksmanship,6,2,4
Hntard,stormscale,192,hunter,marksmanship,6,2,4
Chenony,ravencrest,192,hunter,marksmanship,6,2,4
Maeba,shendralar,192,hunter,marksmanship,6,2,4
Bláckheart,doomhammer,192,hunter,marksmanship,6,2,4
Kerrveros,ravencrest,192,hunter,marksmanship,6,2,4
Viktorijå,draenor,192,hunter,marksmanship,6,2,4
Boarthrills,ravencrest,192,hunter,marksmanship,6,2,4
Nyght,ravencrest,192,hunter,marksmanship,6,2,4
Meztarinnan,twisting-nether,192,hunter,marksmanship,6,2,4
Denixilith,eredar,192,hunter,marksmanship,6,2,4
Jamais02AEE6,stormscale,192,hunter,marksmanship,6,2,4
Huntbeard,ragnaros,192,hunter,marksmanship,6,2,4
Dãhrn,sanguino,192,hunter,marksmanship,6,2,4
Elfyhunter,outland,192,hunter,marksmanship,6,2,4
Brubeck,terokkar,192,hunter,marksmanship,6,2,4
Eilosh,outland,192,hunter,marksmanship,6,2,4
Arunaky,uldum,192,hunter,marksmanship,6,2,4
Anoroxx,arthas,192,hunter,marksmanship,6,2,4
Grytax,outland,192,hunter,marksmanship,6,2,4
Youardead,arthas,192,hunter,marksmanship,6,2,4
Rafaela,genjuros,192,hunter,marksmanship,6,2,4
Traenuss,azuremyst,192,hunter,marksmanship,6,2,4
Enfaktüs,silvermoon,192,hunter,marksmanship,6,2,4
Mcperra,zuljin,192,hunter,marksmanship,6,2,4
Coxxie,ragnaros,192,hunter,marksmanship,6,2,4
Arnakua,outland,192,hunter,marksmanship,6,2,4
Machini,terokkar,192,hunter,marksmanship,6,2,4
Corrector,outland,192,hunter,marksmanship,6,2,4
Яриона,galakrond,192,hunter,marksmanship,6,2,4
Sïrrys,nemesis,192,hunter,marksmanship,7,2,5
Андреймвп,galakrond,192,hunter,marksmanship,9,2,7
Ghostriders,archimonde,192,hunter,marksmanship,11,2,9
Explicits,stormscale,192,hunter,marksmanship,12,2,10
Spacenøub,archimonde,192,hunter,marksmanship,12,2,10
Застрельщикц,soulflayer,192,hunter,marksmanship,12,2,10
Cazaó,sanguino,192,hunter,marksmanship,12,2,10
Headshota,stormscale,192,hunter,marksmanship,12,2,10
Weedonyhunt,hyjal,192,hunter,marksmanship,12,2,10
Whitehor,ragnaros,192,hunter,marksmanship,12,2,10
Лиасон,howling-fjord,192,hunter,marksmanship,12,2,10
Kenpach,frostmane,192,hunter,marksmanship,12,2,10
Hyod,khaz-modan,192,hunter,marksmanship,12,2,10
Suchykeb,silvermoon,192,hunter,marksmanship,12,2,10
Dmanite,ravencrest,192,hunter,marksmanship,12,2,10
Katharyne,argent-dawn,192,hunter,marksmanship,12,2,10
Коватори,borean-tundra,192,hunter,marksmanship,12,2,10
Elitepeon,blackmoore,192,hunter,marksmanship,12,2,10
Rêxxer,blackmoore,192,hunter,marksmanship,12,2,10
Friskì,draenor,192,hunter,marksmanship,12,2,10
Gingiismydad,outland,192,hunter,marksmanship,12,2,10
Banglor,shattered-hand,192,hunter,marksmanship,12,2,10
Fedya,kazzak,192,hunter,marksmanship,12,2,10
Chaydee,stormscale,192,hunter,marksmanship,18,2,16
Kronzucker,eredar,192,hunter,marksmanship,18,2,16
Гекагека,gordunni,191,hunter,marksmanship,6,2,4
Enanorabioso,minahonda,191,hunter,marksmanship,6,2,4
Downpipe,shattered-hand,191,hunter,marksmanship,6,2,4
Sushimän,kaelthas,191,hunter,marksmanship,6,2,4
Кикто,gordunni,191,hunter,marksmanship,6,2,4
Fakepvper,darksorrow,191,hunter,marksmanship,6,2,4
Rockét,malorne,191,hunter,marksmanship,6,2,4
Stormhoofd,bloodhoof,191,hunter,marksmanship,6,2,4
Fingon,alleria,191,hunter,marksmanship,12,2,10
Chalyto,dun-morogh,191,hunter,marksmanship,12,2,10
Kure,blackrock,191,hunter,marksmanship,12,2,10
Buttsnipe,sylvanas,159,hunter,marksmanship,5,2,3
Doojas,archimonde,159,hunter,marksmanship,5,2,3
Jaguàr,kazzak,159,hunter,marksmanship,5,2,3
Spagooters,argent-dawn,138,hunter,marksmanship,11,3,8
Robingood,alexstrasza,138,hunter,marksmanship,22,5,17
Neremyn,sylvanas,138,hunter,marksmanship,15,3,12
Primator,argent-dawn,128,hunter,marksmanship,4,2,2
Akahr,thrall,96,hunter,marksmanship,3,2,1
Ríffraff,silvermoon,96,hunter,marksmanship,3,2,1
Janoh,dalaran,96,hunter,marksmanship,3,2,1
Tryx,darksorrow,96,hunter,marksmanship,3,2,1
Tyrone,saurfang,96,hunter,marksmanship,9,2,7
Åbomìnatïon,ravencrest,96,hunter,marksmanship,18,3,15
Sângha,frostwolf,96,hunter,marksmanship,6,1,5
Nortroll,draenor,96,hunter,marksmanship,6,1,5
Kongweaver,ragnaros,96,hunter,marksmanship,6,1,5
Gabbriel,ravencrest,96,hunter,marksmanship,6,1,5
Eowale,outland,96,hunter,marksmanship,6,1,5
Drolarin,zuljin,96,hunter,marksmanship,6,1,5
Pestilencio,shendralar,96,hunter,marksmanship,6,1,5
Cowmelk,stormscale,96,hunter,marksmanship,6,1,5
Negz,eredar,96,hunter,marksmanship,6,1,5
Tesourinho,aggra-português,96,hunter,marksmanship,6,1,5
Jagarbladet,ravencrest,96,hunter,marksmanship,6,1,5
Камсшотт,gordunni,96,hunter,marksmanship,6,1,5
Pennymarks,blackhand,96,hunter,marksmanship,6,1,5
Raverave,burning-legion,96,hunter,marksmanship,6,1,5
Mehtäsika,xavius,96,hunter,marksmanship,6,1,5
Akaname,ravencrest,96,hunter,marksmanship,6,1,5
Almêryck,ysondre,96,hunter,marksmanship,6,1,5
Chantalia,ravencrest,96,hunter,marksmanship,6,1,5
Roupinol,aggra-português,96,hunter,marksmanship,6,1,5
Орталиус,deathguard,96,hunter,marksmanship,6,1,5
Левери,gordunni,96,hunter,marksmanship,6,1,5
Wèdra,hyjal,96,hunter,marksmanship,6,1,5
Mästerkill,dun-modr,96,hunter,marksmanship,6,1,5
Elaresas,argent-dawn,96,hunter,marksmanship,6,1,5
Velcy,ravencrest,96,hunter,marksmanship,6,1,5
Fayenia,ravencrest,96,hunter,marksmanship,6,1,5
Frilance,dun-modr,96,hunter,marksmanship,6,1,5
Cendrac,ravencrest,96,hunter,marksmanship,6,1,5
Nethria,antonidas,96,hunter,marksmanship,6,1,5
Cléò,kazzak,96,hunter,marksmanship,6,1,5
Høøl,hyjal,96,hunter,marksmanship,6,1,5
Hanzú,argent-dawn,96,hunter,marksmanship,6,1,5
Tillhunt,kargath,96,hunter,marksmanship,6,1,5
Xaraimz,ravencrest,96,hunter,marksmanship,6,1,5
Galedjïn,conseil-des-ombres,96,hunter,marksmanship,6,1,5
Drágø,blackmoore,96,hunter,marksmanship,6,1,5
Badkirves,kazzak,96,hunter,marksmanship,6,1,5
Crowcifer,argent-dawn,96,hunter,marksmanship,6,1,5
Cxc,dun-modr,96,hunter,marksmanship,6,1,5
Гижуна,howling-fjord,96,hunter,marksmanship,6,1,5
Nalys,argent-dawn,96,hunter,marksmanship,6,1,5
Killzo,sylvanas,96,hunter,marksmanship,6,1,5
Навальница,gordunni,96,hunter,marksmanship,6,1,5
Deadlymayhem,dragonblight,96,hunter,marksmanship,6,1,5
Salie,argent-dawn,96,hunter,marksmanship,6,1,5
Avâlos,dentarg,96,hunter,marksmanship,6,1,5
Statik,deathwing,96,hunter,marksmanship,6,1,5
Hallem,karazhan,96,hunter,marksmanship,6,1,5
Chassour,archimonde,96,hunter,marksmanship,6,1,5
Xurrl,kazzak,96,hunter,marksmanship,6,1,5
Iddqd,outland,96,hunter,marksmanship,6,1,5
Обспн,borean-tundra,96,hunter,marksmanship,6,1,5
Wàterloo,marécage-de-zangar,96,hunter,marksmanship,6,1,5
Санзи,howling-fjord,96,hunter,marksmanship,6,1,5
Ренектон,soulflayer,96,hunter,marksmanship,6,1,5
Teedfredd,tarren-mill,96,hunter,marksmanship,6,1,5
Хантунец,soulflayer,96,hunter,marksmanship,6,1,5
Darthbow,outland,96,hunter,marksmanship,6,1,5
Flechaoscurä,exodar,96,hunter,marksmanship,6,1,5
Mavis,bloodfeather,96,hunter,marksmanship,6,1,5
Feedbackloop,silvermoon,96,hunter,marksmanship,6,1,5
Desow,blackrock,96,hunter,marksmanship,6,1,5
Лсныйпамп,howling-fjord,96,hunter,marksmanship,6,1,5
Frapt,dalaran,96,hunter,marksmanship,6,1,5
Tuljan,ravencrest,96,hunter,marksmanship,6,1,5
Delanoche,exodar,96,hunter,marksmanship,6,1,5
Syx,amanthul,96,hunter,marksmanship,6,1,5
Arkancia,throkferoth,96,hunter,marksmanship,6,1,5
Applix,tarren-mill,96,hunter,marksmanship,6,1,5
Наладдчик,howling-fjord,96,hunter,marksmanship,6,1,5
Wolfmcquade,draenor,96,hunter,marksmanship,6,1,5
Instinctx,agamaggan,96,hunter,marksmanship,6,1,5
Farkrin,silvermoon,96,hunter,marksmanship,6,1,5
Quasar,arakarahm,96,hunter,marksmanship,6,1,5
Leaxs,onyxia,96,hunter,marksmanship,6,1,5
Superfacial,twisting-nether,96,hunter,marksmanship,6,1,5
Kolgrim,temple-noir,96,hunter,marksmanship,6,1,5
Chillø,elune,96,hunter,marksmanship,6,1,5
Pinocion,drakthul,96,hunter,marksmanship,6,1,5
Faccacamoale,twisting-nether,96,hunter,marksmanship,6,1,5
Wantsumsnipe,twisting-nether,96,hunter,marksmanship,6,1,5
Castbuny,drakthul,96,hunter,marksmanship,6,1,5
Avizi,anachronos,96,hunter,marksmanship,6,1,5
Cítyzens,drakthul,96,hunter,marksmanship,6,1,5
Горгонт,blackscar,96,hunter,marksmanship,6,1,5
Chapovito,twisting-nether,96,hunter,marksmanship,6,1,5
Dewshot,silvermoon,96,hunter,marksmanship,6,1,5
Wonderbrax,nemesis,96,hunter,marksmanship,6,1,5
Oneofus,malygos,96,hunter,marksmanship,6,1,5
Toulouki,silvermoon,96,hunter,marksmanship,6,1,5
Kichassequi,khaz-modan,96,hunter,marksmanship,14,2,12
Gorgorotha,ragnaros,96,hunter,marksmanship,12,1,11
Noskillbot,twisting-nether,96,hunter,marksmanship,12,1,11
Artexxia,kazzak,96,hunter,marksmanship,12,1,11
Moskalhunter,terokkar,96,hunter,marksmanship,12,1,11
Götthunter,antonidas,96,hunter,marksmanship,12,1,11
Tiguy,archimonde,96,hunter,marksmanship,12,1,11
Donáldtrúmp,tarren-mill,96,hunter,marksmanship,12,1,11
Râpton,blackmoore,96,hunter,marksmanship,12,1,11
Kratozs,outland,96,hunter,marksmanship,13,1,12
Kælan,grim-batol,96,hunter,marksmanship,18,1,17
Denixxia,bronzebeard,95,hunter,marksmanship,3,2,1
Magahra,thrall,95,hunter,marksmanship,6,1,5
Gohsthunter,dun-morogh,95,hunter,marksmanship,6,1,5
Nogneteen,chamber-of-aspects,95,hunter,marksmanship,12,1,11
Twinshot,anetheron,84,hunter,marksmanship,15,5,10
Gettóbuxa,arathor,79,hunter,marksmanship,5,1,4
Dréws,kazzak,64,hunter,marksmanship,4,1,3
Draugrinnh,tarren-mill,48,hunter,marksmanship,3,1,2
Nimrod,norgannon,48,hunter,marksmanship,3,1,2
Howlinjoe,darkspear,48,hunter,marksmanship,9,1,8
Merveilleux,hyjal,42,hunter,marksmanship,11,3,8
Svinrbglol,arygos,31,hunter,marksmanship,2,1,1
Geruga,thrall,31,hunter,marksmanship,2,1,1
Elgango,blackrock,16,hunter,marksmanship,1,1,0
Дунморг,grom,16,hunter,marksmanship,1,1,0
Tudjuk,arathor,16,hunter,marksmanship,1,1,0
Imortaltroll,kazzak,16,hunter,marksmanship,1,1,0
Skaedi,silvermoon,16,hunter,marksmanship,1,1,0
Bicmex,ravencrest,2304,hunter,survival,86,51,35
Bonquiesha,tarren-mill,2163,hunter,survival,120,69,51
Corossity,blackmoore,2155,hunter,survival,107,71,36
Gíggí,malganis,2155,hunter,survival,72,40,32
Rynex,festung-der-stürme,2134,hunter,survival,78,45,33
Harrianlar,ravenholdt,2128,hunter,survival,166,84,82
Pridz,archimonde,2121,hunter,survival,186,94,92
Nikzeubii,archimonde,2113,hunter,survival,66,39,27
Razoorine,blackrock,2102,hunter,survival,156,87,69
Djheartstrng,argent-dawn,2100,hunter,survival,138,82,56
Götdelen,kult-der-verdammten,2084,hunter,survival,182,97,85
Fíng,tarren-mill,2079,hunter,survival,216,109,107
Uglybaboon,draenor,2064,hunter,survival,305,150,155
Earfalass,twisting-nether,2040,hunter,survival,238,133,105
Macrolaim,outland,2016,hunter,survival,251,122,129
Epicsurvive,ravencrest,2013,hunter,survival,102,52,50
Yeezu,sylvanas,2009,hunter,survival,66,36,30
Marvelmary,ravencrest,2004,hunter,survival,83,38,45
Krakenaspect,kazzak,2002,hunter,survival,50,32,18
Josethepimpo,stormscale,2002,hunter,survival,161,81,80
Jànet,ravencrest,2002,hunter,survival,66,33,33
Mestar,outland,2001,hunter,survival,199,100,99
Belaux,archimonde,1997,hunter,survival,221,108,113
Huntity,kazzak,1995,hunter,survival,101,54,47
Crucfixion,kazzak,1993,hunter,survival,60,35,25
Exquisitor,draenor,1990,hunter,survival,295,156,139
Лесбиянюсь,gordunni,1983,hunter,survival,137,77,60
Booxun,sylvanas,1982,hunter,survival,133,68,65
Dackeldustin,norgannon,1970,hunter,survival,59,50,9
Stormblãze,ravencrest,1969,hunter,survival,155,73,82
Mspt,archimonde,1967,hunter,survival,130,63,67
Gukexa,outland,1965,hunter,survival,66,39,27
Gukéx,stormscale,1965,hunter,survival,72,39,33
Hyderr,aegwynn,1964,hunter,survival,54,34,20
Rayadz,nethersturm,1961,hunter,survival,210,104,106
Dyndns,blackmoore,1959,hunter,survival,90,46,44
Pokefangirlx,grim-batol,1952,hunter,survival,259,140,119
Akronis,outland,1951,hunter,survival,119,58,61
Jackjager,ravencrest,1950,hunter,survival,63,40,23
Yemistar,archimonde,1949,hunter,survival,90,48,42
Jamboss,twisting-nether,1945,hunter,survival,60,29,31
Aboleon,ragnaros,1934,hunter,survival,74,38,36
Cjezka,blackmoore,1931,hunter,survival,123,64,59
Zhulk,los-errantes,1926,hunter,survival,137,68,69
Kfcmanagerx,silvermoon,1923,hunter,survival,58,38,20
Rewgodxq,ravencrest,1903,hunter,survival,161,81,80
Mmkekw,guldan,1902,hunter,survival,48,33,15
Горгонт,blackscar,1897,hunter,survival,132,72,60
Sneakyshøt,nemesis,1894,hunter,survival,263,137,126
Yake,kazzak,1881,hunter,survival,52,23,29
Momohenní,archimonde,1871,hunter,survival,156,86,70
Raelaf,zuljin,1866,hunter,survival,42,23,19
Scypher,ragnaros,1864,hunter,survival,50,33,17
Lágåta,outland,1864,hunter,survival,53,27,26
Ryomen,garona,1862,hunter,survival,189,99,90
Øvade,argent-dawn,1861,hunter,survival,67,41,26
Brkh,ravencrest,1857,hunter,survival,54,30,24
Calesthas,tarren-mill,1856,hunter,survival,96,51,45
Nwnw,tarren-mill,1855,hunter,survival,36,22,14
Svinrbglol,arygos,1854,hunter,survival,54,26,28
Kagrot,silvermoon,1847,hunter,survival,102,49,53
Kyosoku,silvermoon,1845,hunter,survival,57,28,29
Madzynette,archimonde,1842,hunter,survival,67,40,27
Feignfisto,draenor,1840,hunter,survival,33,20,13
Zanpa,archimonde,1840,hunter,survival,82,49,33
Lugnåls,hyjal,1838,hunter,survival,89,46,43
Moustø,archimonde,1836,hunter,survival,47,29,18
Zerberas,blackrock,1835,hunter,survival,60,32,28
Åíøñs,kazzak,1834,hunter,survival,42,26,16
Djshibalxd,argent-dawn,1834,hunter,survival,90,44,46
Квит,blackscar,1832,hunter,survival,30,20,10
Fwaffidack,tarren-mill,1829,hunter,survival,63,36,27
Vunter,malganis,1828,hunter,survival,48,26,22
Dabeszt,draenor,1827,hunter,survival,60,38,22
Avaren,archimonde,1826,hunter,survival,118,61,57
Майен,thermaplugg,1823,hunter,survival,72,32,40
Vènuhá,ravencrest,1822,hunter,survival,66,41,25
Sarrow,ravencrest,1822,hunter,survival,115,64,51
Qwèrts,stormscale,1822,hunter,survival,60,33,27
Skârlock,blackmoore,1819,hunter,survival,89,50,39
Зеленыйиисус,gordunni,1818,hunter,survival,153,84,69
Stuckstepbro,silvermoon,1818,hunter,survival,47,22,25
Mogumogu,blackhand,1817,hunter,survival,66,34,32
Marchik,outland,1813,hunter,survival,52,34,18
Frog,crushridge,1810,hunter,survival,78,46,32
Thugzilla,auchindoun,1810,hunter,survival,71,40,31
Polaqu,burning-legion,1809,hunter,survival,60,37,23
Betarayjinx,kazzak,1806,hunter,survival,63,37,26
Соняпиво,gordunni,1804,hunter,survival,72,41,31
Glosendra,ravencrest,1803,hunter,survival,90,52,38
Ksreport,stormscale,1802,hunter,survival,58,27,31
Zpf,silvermoon,1801,hunter,survival,56,30,26
Minibicmex,aegwynn,1801,hunter,survival,82,43,39
Lagich,stormscale,1799,hunter,survival,34,24,10
Killerkatze,outland,1794,hunter,survival,36,19,17
Clydefrog,outland,1794,hunter,survival,52,24,28
Alexdi,kazzak,1792,hunter,survival,66,30,36
Laayopeh,argent-dawn,1788,hunter,survival,48,29,19
Fatbushpig,stormscale,1786,hunter,survival,30,19,11
Saliressa,ravencrest,1775,hunter,survival,102,50,52
Onlylfg,drakthul,1772,hunter,survival,68,35,33
Dreämhäck,ravencrest,1768,hunter,survival,78,47,31
Sneakyshoot,nemesis,1767,hunter,survival,59,31,28
Ravebae,silvermoon,1766,hunter,survival,150,73,77
Скадхи,blackscar,1761,hunter,survival,156,79,77
Летмимейт,howling-fjord,1759,hunter,survival,96,53,43
Easyclass,hyjal,1756,hunter,survival,78,40,38
Burbutsuluki,silvermoon,1755,hunter,survival,48,24,24
Boops,ragnaros,1754,hunter,survival,96,45,51
Chopitoo,blackmoore,1749,hunter,survival,72,40,32
Obbnfriends,ravencrest,1749,hunter,survival,66,30,36
Clifton,archimonde,1748,hunter,survival,42,27,15
Grulog,kazzak,1747,hunter,survival,66,31,35
Svetlanatrap,stormscale,1746,hunter,survival,48,24,24
Draxil,archimonde,1739,hunter,survival,112,60,52
Pwon,ravencrest,1739,hunter,survival,242,125,117
Hunjo,quelthalas,1739,hunter,survival,90,40,50
Døvah,argent-dawn,1737,hunter,survival,54,30,24
Fablet,draenor,1736,hunter,survival,54,31,23
Monkeytrapz,norgannon,1733,hunter,survival,54,29,25
Subha,quelthalas,1731,hunter,survival,48,31,17
Kalthrog,ragnaros,1731,hunter,survival,66,37,29
Глефард,fordragon,1727,hunter,survival,42,29,13
Ехесу,soulflayer,1720,hunter,survival,36,19,17
Иснсейшн,soulflayer,1718,hunter,survival,53,31,22
Curbý,blackhand,1718,hunter,survival,36,20,16
Тэмплест,howling-fjord,1714,hunter,survival,48,32,16
Yosia,draenor,1714,hunter,survival,126,64,62
Wicmex,archimonde,1713,hunter,survival,33,21,12
Skewdar,hyjal,1712,hunter,survival,60,27,33
Sipsomewater,ravencrest,1707,hunter,survival,36,21,15
Hühneknubbel,blackmoore,1707,hunter,survival,42,24,18
Løvebombing,ravencrest,1706,hunter,survival,30,18,12
Robzyhunter,kazzak,1705,hunter,survival,77,46,31
Леоа,howling-fjord,1703,hunter,survival,54,24,30
Snippy,sanguino,1702,hunter,survival,132,63,69
Bnak,die-ewige-wacht,1700,hunter,survival,24,18,6
Razôr,blackhand,1700,hunter,survival,30,18,12
Киссмайпет,howling-fjord,1700,hunter,survival,60,34,26
Sorozo,aegwynn,1699,hunter,survival,120,62,58
Разплюханка,howling-fjord,1698,hunter,survival,120,62,58
Микихаса,galakrond,1697,hunter,survival,105,56,49
Rubydacherrý,argent-dawn,1696,hunter,survival,30,21,9
Yazqua,deathwing,1696,hunter,survival,70,42,28
Fusko,ysondre,1695,hunter,survival,54,29,25
Búddhìst,ravencrest,1694,hunter,survival,48,22,26
Zøk,stormscale,1689,hunter,survival,125,71,54
Плутяра,blackscar,1684,hunter,survival,66,31,35
Nurki,the-maelstrom,1680,hunter,survival,53,26,27
Eunte,archimonde,1680,hunter,survival,78,38,40
Danissia,argent-dawn,1675,hunter,survival,57,32,25
Slizzle,sporeggar,1675,hunter,survival,78,42,36
Субоота,gordunni,1672,hunter,survival,137,70,67
Arrcher,thrall,1670,hunter,survival,36,26,10
Аркеро,soulflayer,1670,hunter,survival,61,31,30
Knokkelmann,outland,1668,hunter,survival,36,24,12
Kukenisluken,stormscale,1667,hunter,survival,29,18,11
Avizi,anachronos,1667,hunter,survival,84,42,42
Оскорбление,howling-fjord,1667,hunter,survival,84,42,42
Véncsótány,ragnaros,1666,hunter,survival,54,29,25
Axehead,outland,1664,hunter,survival,42,22,20
Liikes,arygos,1664,hunter,survival,48,25,23
Kurkelx,ravencrest,1661,hunter,survival,48,30,18
Sunyjuyono,ravencrest,1659,hunter,survival,54,25,29
Lukez,ravencrest,1656,hunter,survival,48,28,20
Lìmpy,stormreaver,1656,hunter,survival,36,21,15
Zäroury,ravencrest,1653,hunter,survival,64,32,32
Хансбург,howling-fjord,1653,hunter,survival,92,42,50
Бомбетта,grom,1649,hunter,survival,90,43,47
Xiumiune,antonidas,1648,hunter,survival,69,40,29
Urtanis,stormscale,1647,hunter,survival,107,58,49
Бубунн,howling-fjord,1646,hunter,survival,87,50,37
Amilienne,nozdormu,1646,hunter,survival,45,22,23
Чууч,blackscar,1645,hunter,survival,153,72,81
Xamisch,eredar,1644,hunter,survival,34,22,12
Yemmeth,argent-dawn,1644,hunter,survival,216,110,106
Brattamer,twisting-nether,1642,hunter,survival,28,19,9
Wonkeedx,ravencrest,1641,hunter,survival,42,21,21
Halfogre,draenor,1640,hunter,survival,30,20,10
Zulldek,sanguino,1638,hunter,survival,78,42,36
Mewithoutyou,ragnaros,1637,hunter,survival,214,99,115
Xexhel,twisting-nether,1634,hunter,survival,45,26,19
Gedept,blackrock,1633,hunter,survival,80,41,39
Closeenought,ravencrest,1633,hunter,survival,102,51,51
Unsáinted,ravencrest,1632,hunter,survival,227,119,108
Maiverx,ravencrest,1631,hunter,survival,24,17,7
Lxoh,turalyon,1629,hunter,survival,251,125,126
Nienel,archimonde,1629,hunter,survival,125,57,68
Renathir,argent-dawn,1628,hunter,survival,56,31,25
Skyh,outland,1628,hunter,survival,101,48,53
Кулерквест,soulflayer,1627,hunter,survival,85,46,39
Albumx,hyjal,1627,hunter,survival,271,139,132
Marryme,blackhand,1625,hunter,survival,50,32,18
Iceyx,stormscale,1624,hunter,survival,49,22,27
Babûsch,blackmoore,1623,hunter,survival,54,25,29
Shiceloch,blackmoore,1621,hunter,survival,42,20,22
Kajtarn,outland,1621,hunter,survival,60,27,33
Katzila,outland,1620,hunter,survival,41,22,19
Жуткойкрот,lich-king,1620,hunter,survival,78,32,46
Копия,azuregos,1619,hunter,survival,72,30,42
Leviáckerman,ravencrest,1617,hunter,survival,36,17,19
Skytraped,hyjal,1616,hunter,survival,41,25,16
Saejku,archimonde,1616,hunter,survival,75,40,35
Ntwoõ,ravencrest,1615,hunter,survival,65,37,28
Pizzafanatic,blackrock,1614,hunter,survival,49,25,24
Losiané,thrall,1613,hunter,survival,94,48,46
Фломидзе,gordunni,1611,hunter,survival,76,47,29
Defjacks,argent-dawn,1609,hunter,survival,80,40,40
Savageone,frostwhisper,1609,hunter,survival,48,23,25
Ластшот,blackscar,1608,hunter,survival,30,17,13
Ruxhunter,sanguino,1607,hunter,survival,90,50,40
Skydraz,ysondre,1606,hunter,survival,60,33,27
Cira,archimonde,1606,hunter,survival,48,24,24
Gradevine,twisting-nether,1605,hunter,survival,86,52,34
Гудхантер,blackscar,1605,hunter,survival,66,38,28
Rasmi,kazzak,1605,hunter,survival,65,31,34
Mclooving,runetotem,1604,hunter,survival,49,29,20
Turdy,executus,1603,hunter,survival,82,45,37
Жэш,howling-fjord,1602,hunter,survival,42,21,21
Tiffanydoll,hyjal,1601,hunter,survival,54,30,24
Сабакаа,borean-tundra,1600,hunter,survival,78,44,34
Darllene,kazzak,1599,hunter,survival,101,46,55
Dariusmm,silvermoon,1598,hunter,survival,58,32,26
Твояпомощь,gordunni,1596,hunter,survival,24,17,7
Noop,sylvanas,1596,hunter,survival,96,48,48
Regale,archimonde,1595,hunter,survival,66,25,41
Смолильщик,gordunni,1594,hunter,survival,69,36,33
Hûntyhunt,silvermoon,1594,hunter,survival,42,21,21
Calyssae,shattered-halls,1591,hunter,survival,99,58,41
Ódelagga,sylvanas,1591,hunter,survival,123,66,57
Løwg,drekthar,1590,hunter,survival,54,28,26
Aspergun,ragnaros,1590,hunter,survival,46,22,24
Оути,azuregos,1588,hunter,survival,138,76,62
Стингергодх,gordunni,1587,hunter,survival,81,40,41
Sznxøxo,ravencrest,1585,hunter,survival,42,24,18
Xallis,outland,1582,hunter,survival,36,19,17
Xelsera,antonidas,1580,hunter,survival,30,17,13
Kydérr,aegwynn,1580,hunter,survival,42,20,22
Tillhunt,kargath,1573,hunter,survival,87,50,37
Свадебная,gordunni,1572,hunter,survival,148,78,70
Zapzy,ravencrest,1570,hunter,survival,95,49,46
Ilovejwrld,dun-modr,1569,hunter,survival,40,18,22
Nemámponetí,drakthul,1568,hunter,survival,78,42,36
Juniorm,kazzak,1568,hunter,survival,42,22,20
Хантзер,howling-fjord,1568,hunter,survival,86,42,44
Миаур,gordunni,1567,hunter,survival,60,27,33
Suzumebachi,twisting-nether,1562,hunter,survival,54,34,20
Zeer,sylvanas,1562,hunter,survival,159,73,86
Cenesthesia,draenor,1560,hunter,survival,70,39,31
Виралатта,gordunni,1558,hunter,survival,42,23,19
Ázurâ,blackhand,1557,hunter,survival,151,73,78
Doraxa,sanguino,1557,hunter,survival,39,17,22
Bren,shattrath,1554,hunter,survival,73,36,37
Zacxx,ravencrest,1551,hunter,survival,53,37,16
Ðarrk,tarren-mill,1551,hunter,survival,66,35,31
Rettoo,aszune,1550,hunter,survival,42,25,17
Westcøãst,archimonde,1550,hunter,survival,54,32,22
Ðrãke,blackmoore,1550,hunter,survival,54,30,24
Âmalphy,ravencrest,1549,hunter,survival,42,17,25
Танчибосс,soulflayer,1547,hunter,survival,121,60,61
Rizlay,the-maelstrom,1546,hunter,survival,78,37,41
Пистоглазка,howling-fjord,1544,hunter,survival,29,18,11
Neyv,blackmoore,1542,hunter,survival,33,18,15
Shotazz,frostmane,1541,hunter,survival,30,17,13
Ищименявтени,gordunni,1540,hunter,survival,77,40,37
Wikariusz,kazzak,1540,hunter,survival,66,27,39
Capd,kazzak,1538,hunter,survival,71,39,32
Knoxblå,stormscale,1533,hunter,survival,24,16,8
Horxxa,kul-tiras,1531,hunter,survival,84,51,33
Bnak,thrall,1530,hunter,survival,24,16,8
Skzu,archimonde,1529,hunter,survival,30,20,10
Lottemor,tarren-mill,1528,hunter,survival,47,32,15
Garxzhunter,tarren-mill,1528,hunter,survival,30,16,14
Sphexya,ravencrest,1528,hunter,survival,30,16,14
Horku,kazzak,1528,hunter,survival,36,16,20
Errowini,blackmoore,1525,hunter,survival,24,16,8
Глаззалмаз,howling-fjord,1519,hunter,survival,34,21,13
Bittercoast,stormscale,1518,hunter,survival,29,16,13
Outofcontrol,karazhan,1515,hunter,survival,30,17,13
Raztreadör,dun-modr,1514,hunter,survival,299,153,146
Capullospawn,dun-morogh,1513,hunter,survival,36,21,15
Jakis,silvermoon,1513,hunter,survival,35,17,18
Dedral,aegwynn,1509,hunter,survival,30,16,14
Robinbuds,stormscale,1508,hunter,survival,46,25,21
Iòvól,azuremyst,1507,hunter,survival,84,44,40
Jailevaccin,khaz-modan,1505,hunter,survival,121,58,63
Китас,soulflayer,1504,hunter,survival,153,90,63
Næ,kazzak,1504,hunter,survival,103,55,48
Fmatzen,the-maelstrom,1503,hunter,survival,30,16,14
Молеандрис,gordunni,1503,hunter,survival,81,41,40
Clicktrap,runetotem,1503,hunter,survival,38,17,21
Blvckjvckz,ravencrest,1500,hunter,survival,30,16,14
Badboyxoxo,stormscale,1497,hunter,survival,48,35,13
Галятрицепс,eversong,1494,hunter,survival,38,19,19
Clicker,runetotem,1494,hunter,survival,60,28,32
Вандамос,soulflayer,1492,hunter,survival,103,57,46
Sayn,la-croisade-écarlate,1488,hunter,survival,56,30,26
Hakkoti,argent-dawn,1486,hunter,survival,66,33,33
Jeddaj,stormscale,1485,hunter,survival,66,32,34
Huntiika,silvermoon,1484,hunter,survival,76,37,39
Riema,ragnaros,1483,hunter,survival,76,34,42
Andjelaa,kazzak,1482,hunter,survival,36,18,18
Чужойй,howling-fjord,1478,hunter,survival,54,28,26
Deathwallker,silvermoon,1473,hunter,survival,63,42,21
Штынь,gordunni,1471,hunter,survival,36,17,19
Hreo,twisting-nether,1470,hunter,survival,60,30,30
Комомура,soulflayer,1467,hunter,survival,65,34,31
Killitoss,blackmoore,1466,hunter,survival,54,26,28
Óneshóter,madmortem,1465,hunter,survival,36,21,15
Melissax,silvermoon,1464,hunter,survival,40,17,23
Яшатаю,soulflayer,1463,hunter,survival,39,26,13
Jäegr,hyjal,1462,hunter,survival,42,22,20
Vâleriaa,blackrock,1460,hunter,survival,90,43,47
Xhn,stormscale,1460,hunter,survival,48,18,30
Frapt,dalaran,1459,hunter,survival,28,16,12
Boggy,outland,1453,hunter,survival,47,26,21
Psychotik,stormreaver,1451,hunter,survival,166,83,83
Atalnta,ravencrest,1451,hunter,survival,69,28,41
Pentaboule,archimonde,1448,hunter,survival,120,64,56
Nalys,argent-dawn,1447,hunter,survival,70,39,31
Варкраб,blackscar,1446,hunter,survival,36,16,20
Makeawish,antonidas,1444,hunter,survival,64,37,27
Olk,stormscale,1439,hunter,survival,24,15,9
Islide,ravencrest,1438,hunter,survival,36,15,21
Хитвейн,gordunni,1438,hunter,survival,54,22,32
Blackwarz,la-croisade-écarlate,1437,hunter,survival,30,21,9
Блатнайт,blackscar,1436,hunter,survival,25,15,10
Huntsmart,kazzak,1432,hunter,survival,30,15,15
Zinà,naxxramas,1429,hunter,survival,34,19,15
Каморан,grom,1427,hunter,survival,30,16,14
Dorota,auchindoun,1426,hunter,survival,36,19,17
Гаррельд,blackscar,1426,hunter,survival,36,18,18
Kalani,la-croisade-écarlate,1426,hunter,survival,137,65,72
Тэуреэль,gordunni,1426,hunter,survival,66,26,40
Flappypig,stormscale,1424,hunter,survival,24,15,9
Headhunterrz,burning-legion,1424,hunter,survival,48,24,24
Vengefull,draenor,1421,hunter,survival,162,84,78
Shibai,outland,1420,hunter,survival,65,31,34
Crème,blackrock,1419,hunter,survival,83,36,47
Coromant,blackrock,1417,hunter,survival,32,15,17
Torelk,dalaran,1416,hunter,survival,36,17,19
Hoffen,dentarg,1414,hunter,survival,24,18,6
Notikâ,aegwynn,1414,hunter,survival,102,50,52
Artemisïa,archimonde,1414,hunter,survival,42,17,25
Tyrone,saurfang,1410,hunter,survival,42,17,25
Kürze,silvermoon,1409,hunter,survival,58,27,31
Arykes,drakthul,1409,hunter,survival,59,27,32
Шадак,soulflayer,1405,hunter,survival,47,24,23
Taurïel,stormscale,1404,hunter,survival,85,46,39
Крэин,howling-fjord,1403,hunter,survival,54,27,27
Oggi,draenor,1402,hunter,survival,60,29,31
Shoty,zuluhed,1402,hunter,survival,106,50,56
Survsen,kazzak,1399,hunter,survival,78,38,40
Рэдхаант,soulflayer,1397,hunter,survival,56,23,33
Feignindeath,twisting-nether,1396,hunter,survival,38,23,15
Живучийорех,gordunni,1394,hunter,survival,24,15,9
Ballistix,elune,1394,hunter,survival,30,15,15
Sívér,antonidas,1393,hunter,survival,42,16,26
Кфоззи,soulflayer,1391,hunter,survival,30,15,15
Moralisa,eredar,1390,hunter,survival,35,17,18
Itchy,das-syndikat,1387,hunter,survival,57,28,29
Bigbababotan,blackrock,1384,hunter,survival,44,27,17
Eufumo,sanguino,1384,hunter,survival,29,16,13
Wastage,draenor,1383,hunter,survival,54,26,28
Кир,blackscar,1378,hunter,survival,54,31,23
Ajko,blackmoore,1378,hunter,survival,60,33,27
Milééna,ravencrest,1375,hunter,survival,65,27,38
Сильвиина,eversong,1372,hunter,survival,36,17,19
Йинги,gordunni,1371,hunter,survival,77,40,37
Heliandra,dun-modr,1370,hunter,survival,30,17,13
Jónes,dunemaul,1370,hunter,survival,36,16,20
Hunttes,nagrand,1365,hunter,survival,29,15,14
Twitche,ravencrest,1365,hunter,survival,36,15,21
Shootingu,aegwynn,1364,hunter,survival,96,49,47
Ðoñko,hyjal,1363,hunter,survival,156,74,82
Rolky,silvermoon,1360,hunter,survival,30,16,14
Suxino,doomhammer,1360,hunter,survival,94,43,51
Zwerghauer,arthas,1358,hunter,survival,30,17,13
Dîdierraoult,archimonde,1358,hunter,survival,29,15,14
Стивстифлер,razuvious,1357,hunter,survival,60,33,27
Мандалорецц,soulflayer,1356,hunter,survival,92,44,48
Röwene,argent-dawn,1355,hunter,survival,44,24,20
Torrë,sanguino,1355,hunter,survival,55,26,29
Santiägø,archimonde,1353,hunter,survival,54,30,24
Abovival,ragnaros,1349,hunter,survival,30,20,10
Skyyw,tarren-mill,1348,hunter,survival,62,34,28
Zaphody,doomhammer,1346,hunter,survival,63,32,31
Icetrapped,eredar,1341,hunter,survival,30,14,16
Ðévi,ravencrest,1340,hunter,survival,18,14,4
Xaone,blackrock,1340,hunter,survival,18,14,4
Айхана,gordunni,1337,hunter,survival,53,30,23
Snôptas,blackmoore,1337,hunter,survival,32,15,17
Satantrapbot,outland,1337,hunter,survival,30,14,16
Подлыйстарик,gordunni,1336,hunter,survival,49,34,15
Jalcer,draenor,1334,hunter,survival,56,25,31
Janoh,dalaran,1332,hunter,survival,24,14,10
Анариэльсин,soulflayer,1332,hunter,survival,60,27,33
Sasquaczek,burning-legion,1328,hunter,survival,42,24,18
Jamalinho,silvermoon,1322,hunter,survival,60,38,22
Карвинн,soulflayer,1321,hunter,survival,30,14,16
Spitchy,kazzak,1320,hunter,survival,42,23,19
Zehned,ysondre,1316,hunter,survival,57,25,32
Ниалла,thermaplugg,1316,hunter,survival,48,19,29
Slagatronic,ragnaros,1314,hunter,survival,108,57,51
Malgorn,burning-legion,1313,hunter,survival,46,29,17
Занзуолли,howling-fjord,1309,hunter,survival,66,32,34
Gakco,twisting-nether,1308,hunter,survival,36,20,16
Littlhuntard,tarren-mill,1306,hunter,survival,24,14,10
Пятницкий,soulflayer,1304,hunter,survival,33,17,16
Dhmain,frostmane,1304,hunter,survival,45,18,27
Ilørell,archimonde,1303,hunter,survival,36,15,21
Karabeg,twisting-nether,1301,hunter,survival,53,22,31
Kobayashi,arathor,1300,hunter,survival,101,45,56
Thëoden,cthun,1298,hunter,survival,30,16,14
Steezowl,kazzak,1297,hunter,survival,47,20,27
Prodanhunts,frostmane,1296,hunter,survival,30,14,16
Wôôdsy,blackrock,1291,hunter,survival,30,14,16
Sarttrap,aerie-peak,1289,hunter,survival,24,14,10
Cásper,tarren-mill,1288,hunter,survival,54,27,27
Bigmøist,ravencrest,1287,hunter,survival,80,38,42
Kasperle,frostwolf,1281,hunter,survival,24,14,10
Фурболгов,gordunni,1278,hunter,survival,66,30,36
Барабаша,deathguard,1278,hunter,survival,40,15,25
Daweí,draenor,1275,hunter,survival,40,15,25
Trapfish,dalaran,1265,hunter,survival,84,42,42
Nith,ungoro,1263,hunter,survival,42,22,20
Nvukaze,argent-dawn,1262,hunter,survival,33,22,11
Ägris,die-todeskrallen,1255,hunter,survival,90,47,43
Jomoguin,stormscale,1255,hunter,survival,54,27,27
Куджикс,soulflayer,1248,hunter,survival,18,13,5
Zudith,sanguino,1248,hunter,survival,24,14,10
Xxø,ravencrest,1248,hunter,survival,24,13,11
Tortillia,madmortem,1248,hunter,survival,87,38,49
Petshøp,outland,1247,hunter,survival,18,13,5
Kurdo,outland,1247,hunter,survival,24,13,11
Getsniffarn,sylvanas,1247,hunter,survival,42,20,22
Jumong,ragnaros,1246,hunter,survival,24,13,11
Khodii,aegwynn,1245,hunter,survival,18,13,5
Caelas,outland,1245,hunter,survival,36,17,19
Foxyfoxo,guldan,1245,hunter,survival,41,19,22
Vargar,arygos,1245,hunter,survival,30,13,17
Guanchin,silvermoon,1245,hunter,survival,42,16,26
Thalanos,antonidas,1243,hunter,survival,30,13,17
Paxiwtf,eredar,1242,hunter,survival,22,14,8
Oczkuhne,burning-legion,1241,hunter,survival,24,13,11
Morkahs,dalaran,1240,hunter,survival,24,13,11
Bicepspump,dun-morogh,1240,hunter,survival,30,13,17
Lilsnuss,outland,1239,hunter,survival,18,13,5
Wuad,silvermoon,1239,hunter,survival,24,13,11
ßlackjack,thrall,1237,hunter,survival,18,13,5
Junglez,nagrand,1232,hunter,survival,30,16,14
Критпояйцам,howling-fjord,1230,hunter,survival,23,15,8
Huntanova,antonidas,1226,hunter,survival,30,13,17
Mcgloebels,archimonde,1225,hunter,survival,27,14,13
Bowmasterjay,kazzak,1221,hunter,survival,24,13,11
Herubin,doomhammer,1220,hunter,survival,63,29,34
Тике,soulflayer,1215,hunter,survival,38,19,19
Vorsord,zuljin,1209,hunter,survival,30,13,17
Waziralwazar,auchindoun,1207,hunter,survival,28,13,15
Bloodxx,ragnaros,1201,hunter,survival,72,33,39
Sainttcc,thrall,1195,hunter,survival,60,28,32
Согекхей,gordunni,1192,hunter,survival,48,13,35
Kazzaak,kazzak,1188,hunter,survival,72,26,46
Illnysa,silvermoon,1187,hunter,survival,23,13,10
Binhoker,argent-dawn,1173,hunter,survival,18,13,5
Doru,silvermoon,1162,hunter,survival,60,29,31
Ketaminösa,zuljin,1151,hunter,survival,18,12,6
Jäinenool,outland,1151,hunter,survival,24,12,12
Ähäkutti,kazzak,1151,hunter,survival,30,12,18
Erhu,drakthul,1150,hunter,survival,18,12,6
Nkl,archimonde,1150,hunter,survival,24,12,12
Alwaysthug,ravencrest,1150,hunter,survival,30,12,18
Natchell,ysondre,1148,hunter,survival,24,12,12
Nevêrse,archimonde,1147,hunter,survival,24,12,12
Terrorduni,tarren-mill,1147,hunter,survival,30,12,18
Звериныйпапа,gordunni,1146,hunter,survival,24,12,12
Äzul,ysondre,1142,hunter,survival,27,13,14
Мертвыйпсарь,soulflayer,1142,hunter,survival,40,17,23
Såvëâmäzøñíà,stormscale,1142,hunter,survival,30,12,18
Akasa,twilights-hammer,1142,hunter,survival,30,12,18
Kaynor,dalaran,1141,hunter,survival,24,12,12
Gilzog,exodar,1138,hunter,survival,30,12,18
Cabaim,eredar,1137,hunter,survival,18,12,6
Autoturret,eredar,1130,hunter,survival,30,12,18
Floris,outland,1126,hunter,survival,24,12,12
Cämper,aegwynn,1124,hunter,survival,24,12,12
Leemool,ysondre,1123,hunter,survival,30,18,12
Fãdê,ravencrest,1118,hunter,survival,20,13,7
Ashablack,argent-dawn,1118,hunter,survival,119,55,64
Bâng,zuljin,1117,hunter,survival,24,12,12
Inter,hellscream,1117,hunter,survival,32,13,19
Бандерака,goldrinn,1115,hunter,survival,24,12,12
Hännibal,nazjatar,1114,hunter,survival,23,12,11
Absolutnoob,blackrock,1103,hunter,survival,56,28,28
Milandra,the-maelstrom,1101,hunter,survival,42,20,22
Apachy,amanthul,1100,hunter,survival,29,12,17
Sláyer,the-shatar,1099,hunter,survival,58,28,30
Harrak,ysondre,1098,hunter,survival,18,12,6
Aszasi,azjolnerub,1096,hunter,survival,23,12,11
Bairex,magtheridon,1090,hunter,survival,42,23,19
Himba,dentarg,1088,hunter,survival,36,18,18
Spliinter,twisting-nether,1086,hunter,survival,28,17,11
Dragonflayer,sylvanas,1083,hunter,survival,24,13,11
Yinn,kilrogg,1074,hunter,survival,42,15,27
Pôîson,kazzak,1070,hunter,survival,94,39,55
Speedymarieh,argent-dawn,1056,hunter,survival,18,11,7
Djsecousse,hyjal,1056,hunter,survival,18,11,7
Guccyfied,blackrock,1056,hunter,survival,18,11,7
Lutza,sanguino,1056,hunter,survival,24,11,13
Chrønôs,archimonde,1055,hunter,survival,18,11,7
Djtrápálót,dragonmaw,1055,hunter,survival,18,11,7
Ранкон,lich-king,1055,hunter,survival,24,11,13
Síraw,tarren-mill,1055,hunter,survival,30,11,19
Éddiémórphín,kazzak,1053,hunter,survival,24,11,13
Ayshæ,tarren-mill,1053,hunter,survival,66,23,43
Cataleýà,outland,1052,hunter,survival,18,11,7
Kabedon,drakthul,1049,hunter,survival,24,11,13
Pyrep,draenor,1048,hunter,survival,18,11,7
Didzon,ravencrest,1045,hunter,survival,18,11,7
Querro,azshara,1036,hunter,survival,42,11,31
Agarez,blackrock,1026,hunter,survival,36,16,20
Szybky,defias-brotherhood,1017,hunter,survival,18,11,7
Voltár,antonidas,1017,hunter,survival,30,11,19
Roacher,hyjal,1011,hunter,survival,29,11,18
Giobi,draenor,996,hunter,survival,24,13,11
Hotgrillexde,sylvanas,990,hunter,survival,23,11,12
Animàl,argent-dawn,988,hunter,survival,22,11,11
Huntoruu,outland,983,hunter,survival,113,48,65
Änubïs,culte-de-la-rive-noire,973,hunter,survival,28,12,16
Крысюкпифпаф,blackscar,971,hunter,survival,19,11,8
Tayu,throkferoth,960,hunter,survival,12,10,2
Reviam,ravencrest,960,hunter,survival,12,10,2
Аминотоксид,blackscar,960,hunter,survival,12,10,2
Vincex,ravencrest,960,hunter,survival,18,10,8
Мигнитюша,blackscar,960,hunter,survival,18,10,8
Hiddenstalke,argent-dawn,960,hunter,survival,18,10,8
Neddly,draenor,960,hunter,survival,24,10,14
Nayeem,silvermoon,959,hunter,survival,12,10,2
Смертонносна,lich-king,959,hunter,survival,12,10,2
Tomasínos,drakthul,959,hunter,survival,18,10,8
Nttcoopzz,silvermoon,959,hunter,survival,18,10,8
Cadier,argent-dawn,959,hunter,survival,24,10,14
Fiskerr,darksorrow,959,hunter,survival,24,10,14
Mógwaí,stormscale,958,hunter,survival,18,10,8
Менстряк,deathguard,958,hunter,survival,18,10,8
Элфй,gordunni,956,hunter,survival,18,10,8
Starkt,ragnaros,956,hunter,survival,24,10,14
Whyareurunin,silvermoon,953,hunter,survival,30,10,20
Memli,uldaman,950,hunter,survival,18,10,8
Marluxiâ,archimonde,947,hunter,survival,30,11,19
Kinaou,sargeras,944,hunter,survival,18,10,8
Zipzâp,blackrock,936,hunter,survival,18,10,8
Neilime,marécage-de-zangar,936,hunter,survival,74,33,41
Akibane,blackmoore,925,hunter,survival,20,11,9
Pechvogel,blackmoore,910,hunter,survival,17,10,7
Otekkâ,hyjal,894,hunter,survival,23,10,13
Bláckheart,doomhammer,888,hunter,survival,22,10,12
Ирртой,grom,885,hunter,survival,24,10,14
Urrane,archimonde,864,hunter,survival,12,9,3
Crøxx,archimonde,864,hunter,survival,12,9,3
Mahikotwo,arathor,864,hunter,survival,12,9,3
Dribla,blackhand,864,hunter,survival,12,9,3
Mortybeans,ravencrest,864,hunter,survival,18,9,9
Agnêas,silvermoon,864,hunter,survival,18,9,9
Bùddhíst,ravencrest,864,hunter,survival,18,9,9
Xlít,outland,864,hunter,survival,18,9,9
Nooksem,blackrock,864,hunter,survival,18,9,9
Vexxed,thrall,863,hunter,survival,12,9,3
Shøt,stormreaver,863,hunter,survival,12,9,3
Murkek,drakthul,863,hunter,survival,12,9,3
Mileysaures,stormscale,863,hunter,survival,12,9,3
Kayhh,stormscale,863,hunter,survival,12,9,3
Kapitannapas,deathwing,863,hunter,survival,18,9,9
Zion,kul-tiras,863,hunter,survival,18,9,9
Kirax,ravencrest,863,hunter,survival,21,10,11
Ashendan,silvermoon,863,hunter,survival,24,9,15
Тиометра,gordunni,862,hunter,survival,12,9,3
Skumrask,outland,862,hunter,survival,24,9,15
Rollin,khaz-modan,861,hunter,survival,12,9,3
Вилдфлекс,gordunni,861,hunter,survival,12,9,3
Fluffiis,twisting-nether,861,hunter,survival,12,9,3
Tôm,ravencrest,860,hunter,survival,12,9,3
Пивпавнах,gordunni,859,hunter,survival,12,9,3
Raenard,ragnaros,858,hunter,survival,21,10,11
Orcpie,defias-brotherhood,856,hunter,survival,18,9,9
Cliff,kiljaeden,852,hunter,survival,24,9,15
Beaupapa,archimonde,846,hunter,survival,18,9,9
Killdembro,sunstrider,835,hunter,survival,102,31,71
Abeji,malygos,830,hunter,survival,23,9,14
Chillibetv,blackrock,829,hunter,survival,22,10,12
Reenacer,dun-modr,826,hunter,survival,30,10,20
Powerhord,burning-legion,794,hunter,survival,23,9,14
Drolig,blackmoore,793,hunter,survival,17,9,8
Velen,pozzo-delleternità,768,hunter,survival,12,8,4
Techpoint,silvermoon,768,hunter,survival,12,8,4
Jaggy,hyjal,768,hunter,survival,12,8,4
Poggersdaddy,kazzak,768,hunter,survival,12,8,4
Bawzé,archimonde,768,hunter,survival,12,8,4
Djfortnite,ravencrest,768,hunter,survival,12,8,4
Gurrmex,stormscale,768,hunter,survival,12,8,4
Патчхороший,howling-fjord,768,hunter,survival,12,8,4
Maiver,ravencrest,768,hunter,survival,12,8,4
Фираналь,blackscar,768,hunter,survival,18,8,10
Трапавграунд,howling-fjord,768,hunter,survival,18,8,10
Bø,burning-blade,768,hunter,survival,18,8,10
Пьёт,gordunni,768,hunter,survival,18,8,10
Epicsurvive,kazzak,768,hunter,survival,24,8,16
Тиандриса,soulflayer,767,hunter,survival,12,8,4
Øpedro,kirin-tor,767,hunter,survival,12,8,4
Luftikuss,arthas,767,hunter,survival,12,8,4
Nokti,die-ewige-wacht,767,hunter,survival,12,8,4
Double,sylvanas,767,hunter,survival,18,8,10
Zuggander,ravencrest,767,hunter,survival,18,8,10
Arnakua,outland,767,hunter,survival,18,8,10
Abeba,grim-batol,767,hunter,survival,18,8,10
Борькабритва,soulflayer,767,hunter,survival,18,8,10
Вуйчеч,howling-fjord,766,hunter,survival,24,8,16
Harmonía,outland,764,hunter,survival,24,8,16
Eledanu,blackmoore,762,hunter,survival,12,8,4
Риппер,gordunni,762,hunter,survival,24,8,16
Хантероо,gordunni,756,hunter,survival,18,8,10
Thëhunter,tyrande,749,hunter,survival,17,8,9
Hanibale,burning-blade,740,hunter,survival,31,8,23
Оверман,azuregos,735,hunter,survival,26,9,17
Hyparion,kazzak,719,hunter,survival,17,8,9
Ватмано,gordunni,718,hunter,survival,11,8,3
Focüs,les-sentinelles,703,hunter,survival,20,8,12
Reefa,the-maelstrom,702,hunter,survival,11,8,3
Dexx,kazzak,698,hunter,survival,17,9,8
Алекскиллшот,blackscar,672,hunter,survival,12,7,5
Dauria,blackhand,672,hunter,survival,12,7,5
Laptopplayër,ravencrest,672,hunter,survival,12,7,5
Tomorrow,ravencrest,672,hunter,survival,12,7,5
Trappewpew,blackmoore,672,hunter,survival,12,7,5
Amadia,defias-brotherhood,672,hunter,survival,12,7,5
Nulles,ravencrest,672,hunter,survival,12,7,5
Merquryh,ravencrest,672,hunter,survival,12,7,5
Motri,tarren-mill,672,hunter,survival,12,7,5
Buoma,kazzak,672,hunter,survival,12,7,5
Burninghunt,ravencrest,672,hunter,survival,12,7,5
Davidghettô,dalaran,672,hunter,survival,12,7,5
Волкорн,gordunni,672,hunter,survival,12,7,5
Трапгодикс,eversong,672,hunter,survival,12,7,5
Ilovemax,archimonde,672,hunter,survival,12,7,5
Норапина,eversong,672,hunter,survival,33,15,18
Avashah,ravencrest,672,hunter,survival,16,7,9
Niro,argent-dawn,672,hunter,survival,18,7,11
Wórldz,dun-modr,672,hunter,survival,18,7,11
Aspects,blackrock,672,hunter,survival,18,7,11
Mahikosan,outland,672,hunter,survival,18,7,11
Oldlynx,ravencrest,671,hunter,survival,12,7,5
Fyoni,silvermoon,671,hunter,survival,12,7,5
Kissnodig,outland,671,hunter,survival,12,7,5
Flamehand,kazzak,671,hunter,survival,12,7,5
Алестея,gordunni,671,hunter,survival,18,7,11
Shanndu,ravencrest,671,hunter,survival,18,7,11
Madtony,aegwynn,671,hunter,survival,18,7,11
Koblih,draenor,671,hunter,survival,30,7,23
Blackox,zirkel-des-cenarius,670,hunter,survival,12,7,5
Renegansnipe,silvermoon,670,hunter,survival,18,7,11
Panfilmaaj,burning-legion,670,hunter,survival,19,7,12
Karasana,earthen-ring,669,hunter,survival,24,7,17
Санясурв,gordunni,665,hunter,survival,25,12,13
Mahemi,mazrigos,664,hunter,survival,30,7,23
Skyythe,dun-morogh,649,hunter,survival,18,7,11
Bowkeeper,kazzak,642,hunter,survival,24,7,17
Daiking,pozzo-delleternità,639,hunter,survival,22,7,15
Iendx,silvermoon,623,hunter,survival,11,7,4
Beersalma,arathor,623,hunter,survival,11,7,4
Bugspitz,outland,622,hunter,survival,11,7,4
Хищник,gordunni,622,hunter,survival,14,8,6
Onefatalshot,the-maelstrom,617,hunter,survival,14,8,6
Shanè,blackrock,603,hunter,survival,20,7,13
Iloveluna,silvermoon,576,hunter,survival,6,6,0
Gitanìlla,dun-modr,576,hunter,survival,6,6,0
Adefthunt,kazzak,576,hunter,survival,6,6,0
Haileyjones,darkmoon-faire,576,hunter,survival,6,6,0
Ernorx,stormscale,576,hunter,survival,6,6,0
Alissón,aegwynn,576,hunter,survival,6,6,0
Ревирин,gordunni,576,hunter,survival,6,6,0
Uranîa,blackmoore,576,hunter,survival,12,6,6
Alibigjungle,ravencrest,576,hunter,survival,12,6,6
Snoude,silvermoon,576,hunter,survival,12,6,6
Nobuno,dun-modr,576,hunter,survival,12,6,6
Schwabbels,silvermoon,576,hunter,survival,12,6,6
Zøøkëëper,silvermoon,576,hunter,survival,12,6,6
Anupephu,stormscale,576,hunter,survival,12,6,6
Kuzes,ravencrest,576,hunter,survival,12,6,6
Lightxyz,ravencrest,576,hunter,survival,12,6,6
Maddoqx,frostwolf,576,hunter,survival,12,6,6
Nunziatellà,nemesis,576,hunter,survival,12,6,6
Bicmeks,ravencrest,576,hunter,survival,12,6,6
Huntaro,blackmoore,576,hunter,survival,12,6,6
Weraxo,ravencrest,576,hunter,survival,12,6,6
Yezzu,sylvanas,576,hunter,survival,12,6,6
Mouganstine,archimonde,576,hunter,survival,12,6,6
Scarletgirl,draenor,576,hunter,survival,12,6,6
Seandeluxe,defias-brotherhood,576,hunter,survival,12,6,6
Milkyway,jaedenar,576,hunter,survival,12,6,6
Дарктеххно,howling-fjord,576,hunter,survival,12,6,6
Sneakyshot,nemesis,576,hunter,survival,12,6,6
Ямилигодц,soulflayer,576,hunter,survival,12,6,6
Reelgigachad,archimonde,576,hunter,survival,12,6,6
Isøbu,hyjal,576,hunter,survival,12,6,6
Psghunt,argent-dawn,576,hunter,survival,12,6,6
Jamoneame,sanguino,576,hunter,survival,12,6,6
Уроборос,gordunni,576,hunter,survival,12,6,6
Nirn,ravencrest,576,hunter,survival,12,6,6
Crapulegangz,archimonde,576,hunter,survival,12,6,6
Куджикс,gordunni,576,hunter,survival,20,7,13
Lucrecius,magtheridon,575,hunter,survival,12,6,6
Hevl,silvermoon,575,hunter,survival,12,6,6
Pãstèque,ravencrest,575,hunter,survival,12,6,6
Grimazg,chogall,575,hunter,survival,12,6,6
Broomyuk,kilrogg,575,hunter,survival,12,6,6
Йеттеринг,deathweaver,575,hunter,survival,15,7,8
Дондонандон,gordunni,575,hunter,survival,18,6,12
Enistee,silvermoon,575,hunter,survival,18,6,12
Girlfwiend,argent-dawn,575,hunter,survival,18,6,12
Sekkeh,ragnaros,575,hunter,survival,18,6,12
Amjamh,hyjal,575,hunter,survival,18,6,12
Bôbby,kelthuzad,575,hunter,survival,18,6,12
Jwishrankone,outland,574,hunter,survival,12,6,6
Mufassa,sinstralis,574,hunter,survival,12,6,6
Васябицепс,howling-fjord,574,hunter,survival,18,6,12
Vuloshi,twisting-nether,573,hunter,survival,18,6,12
Mâjôô,blackhand,544,hunter,survival,10,6,4
Sumecxh,aegwynn,543,hunter,survival,11,6,5
Боцекабузер,galakrond,543,hunter,survival,11,6,5
Reðrighthånð,throkferoth,528,hunter,survival,9,6,3
Yvenne,uldaman,525,hunter,survival,11,6,5
Aequitaz,blackhand,511,hunter,survival,20,6,14
Хантвкроксах,gordunni,496,hunter,survival,13,6,7
Dheredre,silvermoon,480,hunter,survival,6,5,1
Smellygroin,darksorrow,480,hunter,survival,6,5,1
Deek,ysera,480,hunter,survival,6,5,1
Lísy,hyjal,480,hunter,survival,6,5,1
Musen,draenor,480,hunter,survival,6,5,1
Silverlaine,quelthalas,480,hunter,survival,6,5,1
Alohunt,archimonde,480,hunter,survival,6,5,1
Spirys,drakthul,480,hunter,survival,6,5,1
Glama,archimonde,480,hunter,survival,6,5,1
Zybxd,drakthul,480,hunter,survival,6,5,1
Забзаб,soulflayer,480,hunter,survival,6,5,1
Jelibon,ragnaros,480,hunter,survival,6,5,1
Sebikh,ravencrest,480,hunter,survival,6,5,1
Intensivigel,blackmoore,480,hunter,survival,6,5,1
Vilopez,arthas,480,hunter,survival,6,5,1
Mòzetónq,ravencrest,480,hunter,survival,6,5,1
Oof,lightnings-blade,480,hunter,survival,12,5,7
Мэйвиан,gordunni,480,hunter,survival,12,5,7
Эвилтар,soulflayer,480,hunter,survival,12,5,7
Akyra,runetotem,480,hunter,survival,12,5,7
Acefyre,sylvanas,480,hunter,survival,12,5,7
Аскентр,gordunni,480,hunter,survival,12,5,7
Vypaz,twisting-nether,480,hunter,survival,12,5,7
Baconflips,ravencrest,480,hunter,survival,12,5,7
Solotrap,kazzak,480,hunter,survival,12,5,7
Discoråttan,stormscale,480,hunter,survival,12,5,7
Hunterado,burning-legion,480,hunter,survival,12,5,7
Grusijohn,executus,480,hunter,survival,12,5,7
Gogolehunt,archimonde,480,hunter,survival,12,5,7
Repap,defias-brotherhood,480,hunter,survival,12,5,7
Unferth,the-venture-co,480,hunter,survival,12,5,7
Doloresman,tarren-mill,480,hunter,survival,12,5,7
Cyhi,ravencrest,480,hunter,survival,12,5,7
Moscowmule,tarren-mill,480,hunter,survival,12,5,7
Вкинулматрас,gordunni,480,hunter,survival,12,5,7
Ðîe,ysondre,480,hunter,survival,12,5,7
Mercpet,tarren-mill,480,hunter,survival,12,5,7
Yakayoshi,kazzak,480,hunter,survival,12,5,7
Coopatron,silvermoon,480,hunter,survival,12,5,7
Snarer,argent-dawn,480,hunter,survival,12,5,7
Djzntrap,outland,480,hunter,survival,12,5,7
Ormassey,drakthul,480,hunter,survival,12,5,7
Noneedtotrap,darksorrow,480,hunter,survival,12,5,7
Caìuz,pozzo-delleternità,480,hunter,survival,12,5,7
Beletor,medivh,480,hunter,survival,18,5,13
Ector,silvermoon,480,hunter,survival,18,5,13
Sharpeyezz,ravencrest,480,hunter,survival,18,5,13
Дэнитрехо,soulflayer,480,hunter,survival,24,5,19
Zireal,pozzo-delleternità,479,hunter,survival,6,5,1
Yakx,dun-modr,479,hunter,survival,12,5,7
Daltyr,ravencrest,479,hunter,survival,12,5,7
Cazados,shendralar,479,hunter,survival,16,6,10
Сногивкабину,soulflayer,479,hunter,survival,18,5,13
Marvii,drakthul,479,hunter,survival,18,5,13
Grufflin,bronzebeard,479,hunter,survival,18,5,13
Jabela,eredar,447,hunter,survival,11,5,6
Axiøs,thrall,431,hunter,survival,11,5,6
Jeanpisse,hyjal,431,hunter,survival,11,5,6
Azuren,twisting-nether,430,hunter,survival,11,5,6
Nektard,ravencrest,425,hunter,survival,14,6,8
Speartusk,blackhand,384,hunter,survival,6,4,2
Antisober,ravencrest,384,hunter,survival,6,4,2
Vazaî,ravencrest,384,hunter,survival,6,4,2
Henario,ravencrest,384,hunter,survival,6,4,2
Bubboo,dun-modr,384,hunter,survival,6,4,2
Fyrya,ravencrest,384,hunter,survival,6,4,2
Djurmästaren,ravencrest,384,hunter,survival,6,4,2
Куфа,blackscar,384,hunter,survival,6,4,2
Murotar,dalaran,384,hunter,survival,6,4,2
Nazona,blackmoore,384,hunter,survival,6,4,2
Rokmahr,stormscale,384,hunter,survival,6,4,2
Ледо,deathguard,384,hunter,survival,6,4,2
Giggiwho,malganis,384,hunter,survival,6,4,2
Mooj,malganis,384,hunter,survival,6,4,2
Eyvin,defias-brotherhood,384,hunter,survival,6,4,2
Rynextwo,khaz-modan,384,hunter,survival,6,4,2
Bièretrand,les-clairvoyants,384,hunter,survival,6,4,2
Thresha,ravenholdt,384,hunter,survival,6,4,2
Rheyl,dun-morogh,384,hunter,survival,6,4,2
Tyràél,mugthol,384,hunter,survival,6,4,2
Kàisèr,shendralar,384,hunter,survival,6,4,2
Vádîazmeý,twisting-nether,384,hunter,survival,6,4,2
Shenra,argent-dawn,384,hunter,survival,6,4,2
Blhunt,magtheridon,384,hunter,survival,6,4,2
Cinnè,frostwolf,384,hunter,survival,6,4,2
Dumbfoundead,argent-dawn,384,hunter,survival,6,4,2
Morgard,uldum,384,hunter,survival,6,4,2
Jske,silvermoon,384,hunter,survival,6,4,2
Nyxìa,shattered-halls,384,hunter,survival,6,4,2
Youngbepse,blackrock,384,hunter,survival,6,4,2
Virzion,silvermoon,384,hunter,survival,6,4,2
Djøgi,archimonde,384,hunter,survival,6,4,2
Nomorex,frostwhisper,384,hunter,survival,6,4,2
Trapandstun,aszune,384,hunter,survival,6,4,2
Tibaq,burning-legion,384,hunter,survival,6,4,2
Shubou,silvermoon,384,hunter,survival,6,4,2
Kleiar,dun-modr,384,hunter,survival,9,5,4
Eâgleêyê,frostwolf,384,hunter,survival,12,4,8
Fíwhale,tarren-mill,384,hunter,survival,12,4,8
Хикази,soulflayer,384,hunter,survival,12,4,8
Abgeherjoe,antonidas,384,hunter,survival,12,4,8
Beaststeaks,thrall,384,hunter,survival,12,4,8
Nillaxy,blackmoore,384,hunter,survival,12,4,8
Nåzumaks,stormscale,384,hunter,survival,12,4,8
Illuminate,laughing-skull,384,hunter,survival,12,4,8
Magicnanø,nemesis,384,hunter,survival,12,4,8
Florya,blackhand,384,hunter,survival,12,4,8
Dzago,burning-legion,384,hunter,survival,12,4,8
Helvetiya,sylvanas,384,hunter,survival,12,4,8
Salie,argent-dawn,384,hunter,survival,12,4,8
Headshotxd,ragnaros,384,hunter,survival,12,4,8
Esperion,ragnaros,384,hunter,survival,12,4,8
Wärft,arathi,384,hunter,survival,12,4,8
Voldagor,hyjal,384,hunter,survival,12,4,8
Dettas,silvermoon,384,hunter,survival,12,4,8
Geevhunt,hyjal,384,hunter,survival,12,4,8
Keinzira,hyjal,384,hunter,survival,18,4,14
Døømslayer,nemesis,383,hunter,survival,6,4,2
Platza,ragnaros,383,hunter,survival,12,4,8
Vhaagarr,blackmoore,351,hunter,survival,11,4,7
Ghob,kazzak,330,hunter,survival,8,5,3
Эквинтия,soulflayer,319,hunter,survival,5,4,1
Sùnzí,alakir,319,hunter,survival,6,4,2
Джулибуба,howling-fjord,304,hunter,survival,7,4,3
Velrhegal,tarren-mill,304,hunter,survival,13,4,9
Naramir,ysondre,288,hunter,survival,6,3,3
Psychadelic,chamber-of-aspects,288,hunter,survival,6,3,3
Loading,garrosh,288,hunter,survival,6,3,3
Himatoumi,elune,288,hunter,survival,6,3,3
Fjarla,aegwynn,288,hunter,survival,6,3,3
Neepal,archimonde,288,hunter,survival,6,3,3
Unöhänä,archimonde,288,hunter,survival,6,3,3
Марчик,blackscar,288,hunter,survival,6,3,3
Hépheistos,kelthuzad,288,hunter,survival,6,3,3
Natheldir,silvermoon,288,hunter,survival,6,3,3
Kq,argent-dawn,288,hunter,survival,6,3,3
Assaultrifle,frostmane,288,hunter,survival,6,3,3
Monnezzus,nemesis,288,hunter,survival,6,3,3
Hræsvëlg,archimonde,288,hunter,survival,6,3,3
Zwergjäger,aegwynn,288,hunter,survival,6,3,3
Gormlokar,kazzak,288,hunter,survival,6,3,3
Рэкрэйван,gordunni,288,hunter,survival,6,3,3
Daddytrap,burning-legion,288,hunter,survival,6,3,3
Ремонтлицаа,gordunni,288,hunter,survival,6,3,3
Whis,blackrock,288,hunter,survival,6,3,3
Spakster,blackrock,288,hunter,survival,6,3,3
Likandria,blackmoore,288,hunter,survival,6,3,3
Goblinstyle,kazzak,288,hunter,survival,6,3,3
Veganmuscles,madmortem,288,hunter,survival,6,3,3
Rákthar,blackmoore,288,hunter,survival,6,3,3
Simppeli,sylvanas,288,hunter,survival,6,3,3
Prinzz,blackmoore,288,hunter,survival,6,3,3
Deskö,shendralar,288,hunter,survival,6,3,3
Jayquillen,sylvanas,288,hunter,survival,6,3,3
Arrowknee,outland,288,hunter,survival,6,3,3
Eazzyy,auchindoun,288,hunter,survival,6,3,3
Bubonciêl,archimonde,288,hunter,survival,6,3,3
Åzey,hyjal,288,hunter,survival,6,3,3
Benbutton,antonidas,288,hunter,survival,6,3,3
Jäegarn,ravencrest,288,hunter,survival,6,3,3
Bubby,burning-legion,288,hunter,survival,6,3,3
Aidsmacka,shattered-hand,288,hunter,survival,6,3,3
Crispystix,draenor,288,hunter,survival,6,3,3
Engetsu,drakthul,288,hunter,survival,6,3,3
Bkrbot,dun-modr,288,hunter,survival,6,3,3
Паркх,soulflayer,288,hunter,survival,6,3,3
Oneeyedjoe,the-maelstrom,288,hunter,survival,6,3,3
Faccacamoale,twisting-nether,288,hunter,survival,6,3,3
Friendlyone,quelthalas,288,hunter,survival,6,3,3
Kapowz,kazzak,288,hunter,survival,6,3,3
Grippage,draenor,288,hunter,survival,6,3,3
Нойран,eversong,288,hunter,survival,6,3,3
Sworra,silvermoon,288,hunter,survival,6,3,3
Buekåre,outland,288,hunter,survival,6,3,3
Igyunk,ragnaros,288,hunter,survival,6,3,3
Properchub,ravencrest,288,hunter,survival,6,3,3
Thekev,ravencrest,288,hunter,survival,6,3,3
Suetøløgx,shadowsong,288,hunter,survival,6,3,3
Badwar,twisting-nether,288,hunter,survival,6,3,3
Tràpz,archimonde,288,hunter,survival,6,3,3
Nyyrikkí,ravencrest,288,hunter,survival,6,3,3
Jorhan,ravencrest,288,hunter,survival,6,3,3
Myoui,silvermoon,288,hunter,survival,6,3,3
Bláckthorn,ravencrest,288,hunter,survival,12,3,9
Aleenya,dalaran,288,hunter,survival,12,3,9
Aella,thrall,288,hunter,survival,12,3,9
Caedus,argent-dawn,288,hunter,survival,12,3,9
Астериел,blackscar,288,hunter,survival,12,3,9
Swïtchz,hyjal,288,hunter,survival,12,3,9
Cryts,dun-modr,288,hunter,survival,12,3,9
Wolfína,drakthul,288,hunter,survival,12,3,9
Шмалетар,gordunni,288,hunter,survival,12,3,9
Àfpro,hyjal,288,hunter,survival,12,3,9
Nestór,todeswache,288,hunter,survival,12,3,9
Bigfoot,argent-dawn,288,hunter,survival,12,3,9
Amyst,senjin,288,hunter,survival,12,3,9
Zäphiiro,archimonde,288,hunter,survival,12,3,9
Lezigoulleur,marécage-de-zangar,287,hunter,survival,6,3,3
Charlet,archimonde,287,hunter,survival,6,3,3
Trabucones,sanguino,287,hunter,survival,12,3,9
Arkeye,draenor,271,hunter,survival,11,3,8
Twinkhunter,pozzo-delleternità,256,hunter,survival,10,3,7
Jacobszy,outland,255,hunter,survival,8,4,4
Bowtreat,aggramar,239,hunter,survival,5,3,2
Arrowboss,kazzak,239,hunter,survival,5,3,2
Дочьпескова,gordunni,239,hunter,survival,5,3,2
Sizemattersx,kazzak,239,hunter,survival,11,3,8
Gharzok,blackrock,234,hunter,survival,8,4,4
Himpy,twisting-nether,234,hunter,survival,14,4,10
Одисенс,eversong,233,hunter,survival,13,4,9
Shall,outland,223,hunter,survival,8,3,5
Malover,ravencrest,192,hunter,survival,6,2,4
Hasselunden,ravencrest,192,hunter,survival,6,2,4
Vasco,chogall,192,hunter,survival,6,2,4
Наладдчик,howling-fjord,192,hunter,survival,6,2,4
Abomìnatìon,blackhand,192,hunter,survival,6,2,4
Eromoar,outland,192,hunter,survival,6,2,4
Steffxd,twisting-nether,192,hunter,survival,6,2,4
Bèâr,stormscale,192,hunter,survival,6,2,4
Akhtabot,twisting-nether,192,hunter,survival,6,2,4
Elyar,eredar,192,hunter,survival,6,2,4
Robosexual,ravencrest,192,hunter,survival,6,2,4
Drvix,outland,192,hunter,survival,6,2,4
Rølyn,hyjal,192,hunter,survival,6,2,4
Мусафа,eversong,192,hunter,survival,6,2,4
Нью,soulflayer,192,hunter,survival,6,2,4
Афганыч,soulflayer,192,hunter,survival,6,2,4
Gynax,hyjal,192,hunter,survival,6,2,4
Daarkkhunter,twisting-nether,192,hunter,survival,6,2,4
Yopps,draenor,192,hunter,survival,6,2,4
Jarekk,auchindoun,192,hunter,survival,6,2,4
Evazeonhunt,antonidas,192,hunter,survival,6,2,4
Brindefolìe,archimonde,192,hunter,survival,6,2,4
Орталиус,deathguard,192,hunter,survival,6,2,4
Тандеркейдж,gordunni,192,hunter,survival,6,2,4
Неужто,deathguard,192,hunter,survival,6,2,4
Grundibg,chamber-of-aspects,192,hunter,survival,6,2,4
Xaotsu,ravencrest,192,hunter,survival,6,2,4
Ammò,kazzak,192,hunter,survival,6,2,4
Nýka,sanguino,192,hunter,survival,6,2,4
Valtondre,argent-dawn,192,hunter,survival,6,2,4
Roscke,drakthul,192,hunter,survival,6,2,4
Honeytrap,blackmoore,192,hunter,survival,6,2,4
Twobuttngodx,blackrock,192,hunter,survival,6,2,4
Ilòóll,veknilash,192,hunter,survival,6,2,4
Lithell,kazzak,192,hunter,survival,6,2,4
Gransu,argent-dawn,192,hunter,survival,6,2,4
Draugrinnh,tarren-mill,192,hunter,survival,6,2,4
Aggrobatics,blackmoore,192,hunter,survival,6,2,4
Flexifys,tarren-mill,192,hunter,survival,6,2,4
Adram,burning-legion,192,hunter,survival,6,2,4
Fajitax,lightbringer,192,hunter,survival,6,2,4
Gerzyy,drakthul,192,hunter,survival,6,2,4
Bloodyshot,dun-modr,192,hunter,survival,6,2,4
Sakaryali,silvermoon,192,hunter,survival,6,2,4
Tdapills,sanguino,192,hunter,survival,6,2,4
Nimoria,zuluhed,192,hunter,survival,6,2,4
Réja,norgannon,192,hunter,survival,12,2,10
Zéros,argent-dawn,192,hunter,survival,12,2,10
Haskeer,shattrath,192,hunter,survival,12,2,10
Блоуйоэсс,howling-fjord,192,hunter,survival,12,2,10
Louårn,hyjal,192,hunter,survival,12,2,10
Ecthelione,the-venture-co,192,hunter,survival,12,2,10
Sixty,rajaxx,192,hunter,survival,18,2,16
Bélier,hyjal,191,hunter,survival,6,2,4
Bosnimph,bloodfeather,191,hunter,survival,12,2,10
Thalanos,blackmoore,185,hunter,survival,14,4,10
Bnji,hyjal,159,hunter,survival,11,2,9
Rdwlf,draenor,138,hunter,survival,8,3,5
Donaldtrap,archimonde,128,hunter,survival,4,2,2
Archfiend,stormscale,96,hunter,survival,6,1,5
Draksha,stormscale,96,hunter,survival,6,1,5
Hekyna,ravencrest,96,hunter,survival,6,1,5
Nixerious,alakir,96,hunter,survival,6,1,5
Supcuz,stormscale,96,hunter,survival,6,1,5
Lowfet,neptulon,96,hunter,survival,6,1,5
Oobe,hyjal,96,hunter,survival,6,1,5
Katzchen,burning-legion,96,hunter,survival,6,1,5
Барановируса,soulflayer,96,hunter,survival,6,1,5
Aimywinehaus,drakthul,96,hunter,survival,6,1,5
Multigodx,draenor,96,hunter,survival,6,1,5
Ryztik,garona,96,hunter,survival,6,1,5
Gyurkicz,hyjal,96,hunter,survival,6,1,5
Panzershot,hyjal,96,hunter,survival,6,1,5
Durion,tichondrius,96,hunter,survival,6,1,5
Diabloiv,doomhammer,96,hunter,survival,6,1,5
Leaxs,onyxia,96,hunter,survival,6,1,5
Zynga,sylvanas,96,hunter,survival,6,1,5
Ansâvage,ravencrest,96,hunter,survival,6,1,5
Zárnah,defias-brotherhood,96,hunter,survival,6,1,5
Stirea,alakir,96,hunter,survival,6,1,5
Zuggi,defias-brotherhood,96,hunter,survival,6,1,5
Grollar,ragnaros,96,hunter,survival,6,1,5
Fantus,sylvanas,96,hunter,survival,6,1,5
Куоль,gordunni,96,hunter,survival,6,1,5
Saksa,blackrock,96,hunter,survival,6,1,5
Раелиин,gordunni,96,hunter,survival,6,1,5
Хипстеркотик,gordunni,96,hunter,survival,6,1,5
Серомиг,eversong,96,hunter,survival,6,1,5
Liljan,kult-der-verdammten,96,hunter,survival,6,1,5
Claimi,silvermoon,96,hunter,survival,6,1,5
Escaflôwn,aegwynn,96,hunter,survival,6,1,5
Эннабонни,gordunni,79,hunter,survival,5,1,4
Рангмар,howling-fjord,79,hunter,survival,5,1,4
Kamayail,skullcrusher,64,hunter,survival,4,1,3
Хароко,gordunni,42,hunter,survival,9,3,6
Скримзх,gordunni,41,hunter,survival,6,3,3
Mizumo,burning-legion,16,hunter,survival,1,1,0
Mariabanks,aegwynn,2271,hunter,beastmastery,234,124,110
Куфа,blackscar,2222,hunter,beastmastery,78,43,35
Hypse,kazzak,2172,hunter,beastmastery,292,145,147
Brokeasalwys,ravencrest,2164,hunter,beastmastery,84,46,38
Cbã,ravencrest,2156,hunter,beastmastery,60,32,28
Nelida,ragnaros,2105,hunter,beastmastery,60,32,28
Noorky,kazzak,2093,hunter,beastmastery,78,43,35
Mekerosh,burning-legion,2069,hunter,beastmastery,88,43,45
Fãdê,ravencrest,2053,hunter,beastmastery,114,72,42
Eldrekou,kazzak,2045,hunter,beastmastery,96,53,43
Plugonbaby,hyjal,2035,hunter,beastmastery,77,37,40
Kfcmanagerx,silvermoon,2024,hunter,beastmastery,90,42,48
Truejkee,silvermoon,2014,hunter,beastmastery,137,72,65
Jambomambo,twisting-nether,2008,hunter,beastmastery,90,46,44
Baltímore,stormscale,2006,hunter,beastmastery,77,35,42
Тружка,soulflayer,2000,hunter,beastmastery,96,44,52
Kachaxa,kazzak,1999,hunter,beastmastery,99,46,53
Luzivarus,malganis,1993,hunter,beastmastery,83,40,43
Doghxnter,ravencrest,1989,hunter,beastmastery,60,29,31
Берх,gordunni,1984,hunter,beastmastery,148,72,76
Esperion,ragnaros,1976,hunter,beastmastery,144,68,76
Gernoqz,frostwolf,1973,hunter,beastmastery,107,51,56
Ynv,argent-dawn,1956,hunter,beastmastery,134,69,65
Teals,blackrock,1954,hunter,beastmastery,141,73,68
Expiraa,twisting-nether,1954,hunter,beastmastery,72,35,37
Nivshot,kazzak,1950,hunter,beastmastery,54,31,23
Raawy,blackmoore,1948,hunter,beastmastery,42,31,11
Sipsomewater,ravencrest,1943,hunter,beastmastery,69,36,33
Zyphx,der-rat-von-dalaran,1935,hunter,beastmastery,146,68,78
Баянист,soulflayer,1934,hunter,beastmastery,120,59,61
Luzivar,malganis,1934,hunter,beastmastery,83,38,45
Odeôn,twisting-nether,1921,hunter,beastmastery,65,27,38
Мираклдримз,gordunni,1919,hunter,beastmastery,72,38,34
Babýrage,twisting-nether,1919,hunter,beastmastery,60,31,29
Feevah,frostmane,1916,hunter,beastmastery,278,139,139
Roarmantic,blackrock,1915,hunter,beastmastery,66,31,35
Safnirx,tarren-mill,1908,hunter,beastmastery,72,32,40
Trend,silvermoon,1907,hunter,beastmastery,213,105,108
Aimshots,twisting-nether,1906,hunter,beastmastery,66,36,30
Ataxyz,draenor,1906,hunter,beastmastery,60,30,30
Экономист,fordragon,1905,hunter,beastmastery,60,37,23
Libanais,archimonde,1905,hunter,beastmastery,251,119,132
Онкьяр,gordunni,1901,hunter,beastmastery,98,53,45
Беби,gordunni,1901,hunter,beastmastery,66,31,35
Thing,kazzak,1900,hunter,beastmastery,36,21,15
Izmad,archimonde,1899,hunter,beastmastery,317,178,139
Trapgoddxx,archimonde,1894,hunter,beastmastery,65,44,21
Гринмех,gordunni,1893,hunter,beastmastery,66,35,31
Tagz,ravencrest,1887,hunter,beastmastery,60,29,31
Rndhunt,shattrath,1881,hunter,beastmastery,90,43,47
Snarthelg,tarren-mill,1874,hunter,beastmastery,60,32,28
Priceqtxd,ravencrest,1870,hunter,beastmastery,145,88,57
Евилик,gordunni,1870,hunter,beastmastery,66,31,35
Pussirotta,stormreaver,1869,hunter,beastmastery,60,30,30
Jàsøn,ravencrest,1867,hunter,beastmastery,72,33,39
Sukzess,antonidas,1866,hunter,beastmastery,84,38,46
Phesx,sylvanas,1865,hunter,beastmastery,54,27,27
Биско,gordunni,1865,hunter,beastmastery,144,71,73
Ígrågøßñø,silvermoon,1864,hunter,beastmastery,44,30,14
Breezme,twisting-nether,1864,hunter,beastmastery,72,33,39
Hanuong,ragnaros,1862,hunter,beastmastery,36,20,16
Moscowmule,tarren-mill,1859,hunter,beastmastery,59,29,30
Krampack,dun-modr,1858,hunter,beastmastery,54,31,23
Draxil,archimonde,1855,hunter,beastmastery,60,27,33
Найстити,deathguard,1854,hunter,beastmastery,66,31,35
Raggeh,frostwhisper,1853,hunter,beastmastery,66,35,31
Rákthar,blackmoore,1852,hunter,beastmastery,128,63,65
Nexztwo,blackrock,1852,hunter,beastmastery,69,33,36
Samanou,kazzak,1851,hunter,beastmastery,94,45,49
Chillbroo,twisting-nether,1851,hunter,beastmastery,71,33,38
Âmalphy,ravencrest,1846,hunter,beastmastery,47,23,24
Ryxzn,eredar,1846,hunter,beastmastery,78,36,42
Дианнесса,howling-fjord,1845,hunter,beastmastery,83,40,43
Колякилшот,gordunni,1844,hunter,beastmastery,60,29,31
Kondy,twisting-nether,1843,hunter,beastmastery,43,29,14
Nyzuri,die-aldor,1843,hunter,beastmastery,54,26,28
Мерзкийбот,gordunni,1843,hunter,beastmastery,74,33,41
Miraculous,dalaran,1841,hunter,beastmastery,51,25,26
Scrubbi,destromath,1840,hunter,beastmastery,59,30,29
Wilfyre,twisting-nether,1840,hunter,beastmastery,75,36,39
Каосси,gordunni,1839,hunter,beastmastery,61,31,30
Лесбиянюсь,gordunni,1838,hunter,beastmastery,60,43,17
Imcuteandfun,ravencrest,1838,hunter,beastmastery,135,69,66
Thogel,hyjal,1838,hunter,beastmastery,72,33,39
Irefutabil,stormscale,1838,hunter,beastmastery,72,32,40
Tyranski,ravencrest,1837,hunter,beastmastery,87,49,38
Winiswin,stormscale,1837,hunter,beastmastery,178,84,94
Dheredre,silvermoon,1835,hunter,beastmastery,48,27,21
Miløø,silvermoon,1835,hunter,beastmastery,48,26,22
Manj,blackhand,1835,hunter,beastmastery,65,32,33
Hugø,twisting-nether,1835,hunter,beastmastery,102,43,59
Hlogic,tarren-mill,1834,hunter,beastmastery,108,51,57
Pfizershotx,khaz-modan,1832,hunter,beastmastery,60,29,31
Næmes,hyjal,1830,hunter,beastmastery,66,32,34
Kabaro,rajaxx,1830,hunter,beastmastery,60,27,33
Рагнарианх,gordunni,1829,hunter,beastmastery,105,48,57
Кразайс,ashenvale,1829,hunter,beastmastery,91,39,52
Крайдершот,howling-fjord,1828,hunter,beastmastery,59,30,29
Diktatos,kazzak,1828,hunter,beastmastery,64,31,33
Bilbohunter,draenor,1825,hunter,beastmastery,48,27,21
Горгонт,blackscar,1825,hunter,beastmastery,47,25,22
Saggymilkies,outland,1825,hunter,beastmastery,72,33,39
Mottorhead,kazzak,1823,hunter,beastmastery,45,30,15
Burninghunt,ravencrest,1822,hunter,beastmastery,60,32,28
Wêskêr,tarren-mill,1821,hunter,beastmastery,66,31,35
Куроните,howling-fjord,1820,hunter,beastmastery,48,27,21
Bynen,tarren-mill,1819,hunter,beastmastery,77,33,44
Pryse,hyjal,1818,hunter,beastmastery,48,24,24
Шергала,soulflayer,1818,hunter,beastmastery,298,147,151
Omegakek,madmortem,1817,hunter,beastmastery,85,45,40
Jawox,antonidas,1817,hunter,beastmastery,60,27,33
Wiffed,tarren-mill,1816,hunter,beastmastery,36,24,12
Brokenpetman,defias-brotherhood,1816,hunter,beastmastery,36,22,14
Haltrâdar,archimonde,1816,hunter,beastmastery,69,35,34
Blackszpak,jaedenar,1816,hunter,beastmastery,48,24,24
Играсломана,howling-fjord,1815,hunter,beastmastery,60,39,21
Bíllybobbs,argent-dawn,1815,hunter,beastmastery,36,19,17
Badboybørge,draenor,1815,hunter,beastmastery,42,22,20
Пожилойпупь,soulflayer,1815,hunter,beastmastery,66,32,34
Ooh,doomhammer,1815,hunter,beastmastery,120,56,64
Jabela,eredar,1814,hunter,beastmastery,59,42,17
Dangen,stormreaver,1814,hunter,beastmastery,36,19,17
Cor,ravencrest,1814,hunter,beastmastery,113,54,59
Лордсахарок,gordunni,1814,hunter,beastmastery,90,40,50
Alpharaven,ravencrest,1812,hunter,beastmastery,60,31,29
Twineyes,ravencrest,1812,hunter,beastmastery,154,75,79
Dréws,kazzak,1811,hunter,beastmastery,58,26,32
Shroomynuts,kazzak,1810,hunter,beastmastery,114,68,46
Марчик,blackscar,1810,hunter,beastmastery,42,19,23
Masthuhn,blackmoore,1809,hunter,beastmastery,36,27,9
Jungletime,outland,1809,hunter,beastmastery,48,26,22
Mòzetonq,ravencrest,1809,hunter,beastmastery,42,22,20
Corossity,blackmoore,1808,hunter,beastmastery,30,19,11
Hiddenx,blackmoore,1808,hunter,beastmastery,42,21,21
Sparcùs,stormreaver,1807,hunter,beastmastery,140,79,61
Bøgs,the-maelstrom,1807,hunter,beastmastery,42,22,20
Поппишот,blackscar,1806,hunter,beastmastery,36,19,17
Цитрукс,gordunni,1806,hunter,beastmastery,90,47,43
Huntchonk,kazzak,1806,hunter,beastmastery,53,27,26
Spirys,drakthul,1806,hunter,beastmastery,47,20,27
Dogetrainer,silvermoon,1805,hunter,beastmastery,199,101,98
Hacz,bronzebeard,1804,hunter,beastmastery,138,70,68
Lysanhunt,zuljin,1804,hunter,beastmastery,54,27,27
Jägarnmt,twisting-nether,1804,hunter,beastmastery,89,37,52
Crippa,tarren-mill,1803,hunter,beastmastery,54,28,26
Tillhunt,kargath,1803,hunter,beastmastery,54,26,28
Ayiu,argent-dawn,1802,hunter,beastmastery,53,24,29
Трапгодикс,eversong,1800,hunter,beastmastery,176,95,81
Qtìp,aegwynn,1798,hunter,beastmastery,89,42,47
Sekzpitch,blackmoore,1790,hunter,beastmastery,48,24,24
Пивопьюня,ashenvale,1790,hunter,beastmastery,71,34,37
Smhx,stormscale,1788,hunter,beastmastery,30,21,9
Wodhunterxdd,outland,1788,hunter,beastmastery,53,25,28
Pkz,dun-modr,1787,hunter,beastmastery,99,46,53
Appirc,tarren-mill,1785,hunter,beastmastery,48,24,24
Deathcode,stormscale,1784,hunter,beastmastery,66,27,39
Wîldhunt,burning-legion,1781,hunter,beastmastery,161,76,85
Jamesyy,ravencrest,1776,hunter,beastmastery,60,28,32
Gucçi,kazzak,1773,hunter,beastmastery,73,42,31
Orcji,blackhand,1772,hunter,beastmastery,101,49,52
Chúx,twisting-nether,1771,hunter,beastmastery,96,53,43
Каоссхант,howling-fjord,1770,hunter,beastmastery,53,32,21
Silverwolfa,dun-modr,1770,hunter,beastmastery,81,43,38
Erethrus,ravencrest,1769,hunter,beastmastery,48,19,29
Вождь,howling-fjord,1768,hunter,beastmastery,59,29,30
Fanjah,sylvanas,1767,hunter,beastmastery,63,36,27
Amyndôr,ravencrest,1767,hunter,beastmastery,48,27,21
Guccihuntlol,ravencrest,1766,hunter,beastmastery,68,33,35
Altimor,blackmoore,1765,hunter,beastmastery,35,19,16
Donixx,blackrock,1765,hunter,beastmastery,60,29,31
Dìgítal,twisting-nether,1763,hunter,beastmastery,95,47,48
Fullxtrap,hyjal,1763,hunter,beastmastery,41,19,22
Jamzyhunter,emerald-dream,1762,hunter,beastmastery,48,24,24
Скадхи,blackscar,1762,hunter,beastmastery,88,42,46
Dafhel,hyjal,1762,hunter,beastmastery,95,44,51
Grynu,kazzak,1761,hunter,beastmastery,72,31,41
Nimhunt,dentarg,1759,hunter,beastmastery,65,29,36
Futureman,blackrock,1758,hunter,beastmastery,54,31,23
Ruffixvs,blackrock,1756,hunter,beastmastery,35,19,16
Riflur,stormscale,1756,hunter,beastmastery,84,42,42
Djfury,archimonde,1756,hunter,beastmastery,46,21,25
Порошокк,gordunni,1756,hunter,beastmastery,69,29,40
Vrikenh,tarren-mill,1755,hunter,beastmastery,127,75,52
Nollieflip,stormscale,1754,hunter,beastmastery,114,67,47
Мэлвиса,borean-tundra,1754,hunter,beastmastery,90,50,40
Антошадпс,gordunni,1752,hunter,beastmastery,66,38,28
Kachaxaa,ravencrest,1752,hunter,beastmastery,64,27,37
Father,auchindoun,1750,hunter,beastmastery,107,57,50
Pewpewshotz,stormscale,1750,hunter,beastmastery,229,117,112
Nystaleoss,grim-batol,1750,hunter,beastmastery,267,131,136
Pawzz,kazzak,1750,hunter,beastmastery,60,29,31
Ilovemax,archimonde,1750,hunter,beastmastery,46,20,26
Такувами,gordunni,1747,hunter,beastmastery,108,44,64
Мориартис,ashenvale,1744,hunter,beastmastery,83,43,40
Åsynåmvp,twisting-nether,1742,hunter,beastmastery,65,29,36
Блэкстейдж,howling-fjord,1741,hunter,beastmastery,135,74,61
Carioca,blackhand,1741,hunter,beastmastery,66,30,36
Treaz,sanguino,1739,hunter,beastmastery,66,33,33
Fatmum,magtheridon,1738,hunter,beastmastery,81,43,38
Dhadhar,kazzak,1737,hunter,beastmastery,161,79,82
Hawkeyé,forscherliga,1735,hunter,beastmastery,147,66,81
Fluphy,thrall,1734,hunter,beastmastery,94,51,43
Stingsz,chogall,1733,hunter,beastmastery,64,25,39
Darksmoke,forscherliga,1732,hunter,beastmastery,42,24,18
Lofiel,blackrock,1732,hunter,beastmastery,92,50,42
Nèxz,blackrock,1732,hunter,beastmastery,77,33,44
Parhainkoira,argent-dawn,1728,hunter,beastmastery,78,45,33
Valkrys,die-aldor,1726,hunter,beastmastery,70,35,35
Duppdupp,eredar,1726,hunter,beastmastery,84,38,46
Oldbear,frostmane,1725,hunter,beastmastery,70,38,32
Dohter,kazzak,1725,hunter,beastmastery,43,23,20
Ashily,blackhand,1725,hunter,beastmastery,56,27,29
Sankari,blackmoore,1724,hunter,beastmastery,48,26,22
Idtrapthat,nagrand,1723,hunter,beastmastery,84,41,43
Lsa,kazzak,1722,hunter,beastmastery,59,28,31
Misstrap,nemesis,1722,hunter,beastmastery,60,28,32
Mtrider,twisting-nether,1721,hunter,beastmastery,105,50,55
Easyclass,hyjal,1718,hunter,beastmastery,159,92,67
Дэнвин,deathweaver,1718,hunter,beastmastery,219,110,109
Ericspet,stormscale,1717,hunter,beastmastery,48,32,16
Painaldeepz,stormscale,1717,hunter,beastmastery,48,26,22
Piranhaa,archimonde,1717,hunter,beastmastery,39,18,21
Laserkamel,aegwynn,1716,hunter,beastmastery,24,18,6
Vajraw,blackrock,1716,hunter,beastmastery,190,95,95
Peazý,ravencrest,1715,hunter,beastmastery,48,27,21
Дашатрирубля,soulflayer,1715,hunter,beastmastery,42,21,21
Фираналь,blackscar,1715,hunter,beastmastery,93,46,47
Spider,zuljin,1710,hunter,beastmastery,42,25,17
Noversia,aegwynn,1710,hunter,beastmastery,123,59,64
Jägarntwo,stormscale,1710,hunter,beastmastery,51,20,31
Petshopgirl,ravencrest,1709,hunter,beastmastery,30,18,12
Mogwai,stormscale,1709,hunter,beastmastery,42,18,24
Jêsslíne,ravencrest,1706,hunter,beastmastery,48,24,24
Bicmax,archimonde,1705,hunter,beastmastery,45,20,25
Ansâvage,ravencrest,1705,hunter,beastmastery,84,37,47
Impxgodx,outland,1704,hunter,beastmastery,51,24,27
Lobo,kazzak,1704,hunter,beastmastery,66,28,38
Dmanite,ravencrest,1703,hunter,beastmastery,96,53,43
Saiko,kazzak,1703,hunter,beastmastery,42,18,24
Unßørn,archimonde,1702,hunter,beastmastery,96,38,58
Vilopez,arthas,1701,hunter,beastmastery,24,20,4
Kafkules,outland,1700,hunter,beastmastery,137,78,59
Shinkichi,archimonde,1699,hunter,beastmastery,30,18,12
Elamondria,outland,1699,hunter,beastmastery,72,42,30
Sznxøxo,ravencrest,1699,hunter,beastmastery,54,29,25
Hacx,ravencrest,1697,hunter,beastmastery,57,25,32
Rakeesh,hyjal,1696,hunter,beastmastery,36,18,18
Гигапупсх,howling-fjord,1695,hunter,beastmastery,149,85,64
Merquryh,ravencrest,1693,hunter,beastmastery,48,27,21
Kamar,archimonde,1692,hunter,beastmastery,66,43,23
Naraxis,blackrock,1692,hunter,beastmastery,54,27,27
Fize,blackmoore,1692,hunter,beastmastery,77,36,41
Séyena,outland,1692,hunter,beastmastery,54,22,32
Krix,ragnaros,1691,hunter,beastmastery,54,34,20
Пихпахах,gordunni,1691,hunter,beastmastery,82,43,39
Pëâcêßß,outland,1688,hunter,beastmastery,36,21,15
Адыгах,blackscar,1688,hunter,beastmastery,61,35,26
Balthazzarxx,ravencrest,1686,hunter,beastmastery,68,36,32
Вееном,gordunni,1685,hunter,beastmastery,48,24,24
Thogelle,hyjal,1684,hunter,beastmastery,84,41,43
Ðxlz,archimonde,1683,hunter,beastmastery,71,35,36
Letsrock,outland,1682,hunter,beastmastery,33,20,13
Deathvain,tarren-mill,1682,hunter,beastmastery,42,18,24
Liquidhunter,quelthalas,1681,hunter,beastmastery,42,25,17
Poupoune,uldum,1680,hunter,beastmastery,48,24,24
Забзаб,soulflayer,1680,hunter,beastmastery,63,31,32
Nestór,todeswache,1678,hunter,beastmastery,47,28,19
Sïmc,archimonde,1678,hunter,beastmastery,108,58,50
Erilis,twisting-nether,1676,hunter,beastmastery,37,22,15
Kestlér,twisting-nether,1675,hunter,beastmastery,84,35,49
Galileo,sanguino,1674,hunter,beastmastery,62,29,33
Murtagh,khaz-modan,1673,hunter,beastmastery,48,26,22
Raindra,twisting-nether,1672,hunter,beastmastery,42,20,22
Irefutabilâ,outland,1670,hunter,beastmastery,138,63,75
Techpøint,silvermoon,1669,hunter,beastmastery,35,18,17
Zubro,kazzak,1666,hunter,beastmastery,60,31,29
Triggaz,stormscale,1665,hunter,beastmastery,216,109,107
Yarrgi,kazzak,1663,hunter,beastmastery,84,46,38
Zanpa,archimonde,1663,hunter,beastmastery,122,56,66
Chrysantes,forscherliga,1660,hunter,beastmastery,38,19,19
Ysina,arathi,1660,hunter,beastmastery,42,20,22
Trenesta,tarren-mill,1659,hunter,beastmastery,34,18,16
Eazzyy,auchindoun,1659,hunter,beastmastery,115,56,59
Tháyn,tarren-mill,1658,hunter,beastmastery,41,25,16
Dogwatcher,outland,1658,hunter,beastmastery,48,23,25
Pérnix,tarren-mill,1657,hunter,beastmastery,30,18,12
Anklar,blackrock,1657,hunter,beastmastery,53,24,29
Dragosvis,arathor,1656,hunter,beastmastery,36,23,13
Хантунец,soulflayer,1654,hunter,beastmastery,48,27,21
Cnby,stormscale,1652,hunter,beastmastery,43,26,17
Meghanmarkle,tarren-mill,1650,hunter,beastmastery,52,26,26
Ðéadsøulz,stormscale,1648,hunter,beastmastery,135,71,64
Стэпси,gordunni,1648,hunter,beastmastery,36,18,18
Røzy,twisting-nether,1647,hunter,beastmastery,48,35,13
Каэлланис,soulflayer,1647,hunter,beastmastery,53,24,29
Oldcocknbals,silvermoon,1645,hunter,beastmastery,100,54,46
Nîøssx,blackrock,1644,hunter,beastmastery,53,28,25
Nkdchef,outland,1642,hunter,beastmastery,54,29,25
Astari,outland,1641,hunter,beastmastery,48,21,27
Смертонносна,lich-king,1641,hunter,beastmastery,71,30,41
Rynx,hellfire,1640,hunter,beastmastery,60,28,32
Askaway,sylvanas,1639,hunter,beastmastery,42,31,11
Povish,twisting-nether,1639,hunter,beastmastery,49,25,24
Gaeln,outland,1639,hunter,beastmastery,204,93,111
Kerólus,blackhand,1639,hunter,beastmastery,48,18,30
Teestylee,stormscale,1638,hunter,beastmastery,42,21,21
Traplørdx,sylvanas,1638,hunter,beastmastery,48,21,27
Drøøðqt,blackrock,1637,hunter,beastmastery,60,31,29
Ætå,blackmoore,1637,hunter,beastmastery,47,22,25
Coltan,nemesis,1636,hunter,beastmastery,60,22,38
Akaris,archimonde,1635,hunter,beastmastery,78,35,43
Yolofant,blackhand,1634,hunter,beastmastery,36,22,14
Wlâd,archimonde,1634,hunter,beastmastery,35,21,14
Hultasy,outland,1634,hunter,beastmastery,134,67,67
Жажждущий,gordunni,1633,hunter,beastmastery,79,43,36
Paimen,darksorrow,1633,hunter,beastmastery,102,55,47
Bebiyo,sanguino,1631,hunter,beastmastery,94,45,49
Horhyndan,ragnaros,1631,hunter,beastmastery,51,24,27
Bluefluclue,draenor,1630,hunter,beastmastery,110,46,64
Nickyhunt,stormscale,1629,hunter,beastmastery,71,37,34
Ðesøtø,frostwolf,1628,hunter,beastmastery,66,33,33
Drewsx,ravencrest,1627,hunter,beastmastery,36,22,14
Xenvantoss,silvermoon,1627,hunter,beastmastery,30,17,13
Ðrtrapx,blackmoore,1627,hunter,beastmastery,50,27,23
Hypsenn,kazzak,1627,hunter,beastmastery,36,17,19
Trapzila,aggra-português,1626,hunter,beastmastery,90,50,40
Eggcowmeow,azjolnerub,1626,hunter,beastmastery,42,22,20
Xenvantos,stormscale,1626,hunter,beastmastery,42,21,21
Klausmanne,blackrock,1626,hunter,beastmastery,218,101,117
Порошокк,howling-fjord,1625,hunter,beastmastery,30,17,13
Fåded,ravencrest,1625,hunter,beastmastery,65,31,34
Gibiswag,outland,1625,hunter,beastmastery,36,17,19
Uglybaboon,draenor,1625,hunter,beastmastery,42,17,25
Mirmona,stormscale,1624,hunter,beastmastery,40,19,21
Lambo,laughing-skull,1624,hunter,beastmastery,36,17,19
Sayn,la-croisade-écarlate,1624,hunter,beastmastery,59,24,35
Sicktrapbtw,hyjal,1624,hunter,beastmastery,42,17,25
Solò,eredar,1623,hunter,beastmastery,30,17,13
Fiftyóne,festung-der-stürme,1622,hunter,beastmastery,96,53,43
Bebar,kazzak,1622,hunter,beastmastery,120,62,58
Infléx,silvermoon,1622,hunter,beastmastery,77,39,38
Podroto,tyrande,1622,hunter,beastmastery,47,22,25
Gigamesh,sporeggar,1621,hunter,beastmastery,90,52,38
Piky,nemesis,1620,hunter,beastmastery,36,20,16
Índigo,kazzak,1620,hunter,beastmastery,56,30,26
Flappypig,stormscale,1620,hunter,beastmastery,50,22,28
Jèrsèy,draenor,1619,hunter,beastmastery,42,22,20
Vezeka,ravencrest,1618,hunter,beastmastery,42,26,16
Zuxz,blackmoore,1618,hunter,beastmastery,79,38,41
Vinsanity,dunemaul,1618,hunter,beastmastery,42,17,25
Neïç,antonidas,1618,hunter,beastmastery,65,25,40
Djøgi,archimonde,1617,hunter,beastmastery,42,22,20
Bobon,stormscale,1617,hunter,beastmastery,54,26,28
Notdilly,varimathras,1617,hunter,beastmastery,48,20,28
Quasar,ravencrest,1616,hunter,beastmastery,42,17,25
Ганидони,soulflayer,1616,hunter,beastmastery,59,23,36
Ефрейя,gordunni,1615,hunter,beastmastery,30,17,13
Sentriks,tarren-mill,1615,hunter,beastmastery,36,17,19
Tobbè,silvermoon,1615,hunter,beastmastery,36,17,19
Lufreak,ravencrest,1614,hunter,beastmastery,30,23,7
Eltrapo,ravencrest,1613,hunter,beastmastery,24,17,7
Missmytraps,ravencrest,1613,hunter,beastmastery,39,20,19
Wrongtarget,auchindoun,1613,hunter,beastmastery,54,24,30
Aroeris,ravencrest,1611,hunter,beastmastery,57,32,25
Lowfet,neptulon,1611,hunter,beastmastery,156,85,71
Spinella,antonidas,1611,hunter,beastmastery,102,50,52
Ixix,blackhand,1611,hunter,beastmastery,54,26,28
Pekaxôxô,sanguino,1609,hunter,beastmastery,48,34,14
Denkstah,tarren-mill,1609,hunter,beastmastery,51,21,30
Nordafrøst,antonidas,1609,hunter,beastmastery,66,27,39
Feralhound,exodar,1608,hunter,beastmastery,252,129,123
Eaglexx,twisting-nether,1608,hunter,beastmastery,78,39,39
Hîldegard,todeswache,1608,hunter,beastmastery,59,27,32
Downey,azshara,1608,hunter,beastmastery,54,19,35
Símpíng,tarren-mill,1607,hunter,beastmastery,24,17,7
Jinxpeasant,twisting-nether,1607,hunter,beastmastery,30,20,10
Nukenfoobs,draenor,1607,hunter,beastmastery,36,23,13
Axran,ravencrest,1607,hunter,beastmastery,52,23,29
Ingvi,antonidas,1606,hunter,beastmastery,131,60,71
Jomerin,thrall,1606,hunter,beastmastery,48,20,28
Зуланария,howling-fjord,1605,hunter,beastmastery,41,26,15
Homesz,blackmoore,1605,hunter,beastmastery,36,22,14
Smegmagol,baelgun,1605,hunter,beastmastery,41,20,21
Lolez,dun-modr,1605,hunter,beastmastery,42,17,25
Taoshii,die-aldor,1604,hunter,beastmastery,66,36,30
Céah,blackrock,1604,hunter,beastmastery,54,28,26
Эвилтар,soulflayer,1604,hunter,beastmastery,78,40,38
Wèndy,blackrock,1604,hunter,beastmastery,82,41,41
Ariabeast,archimonde,1604,hunter,beastmastery,42,20,22
Xiioo,ravencrest,1604,hunter,beastmastery,83,37,46
Chasseurcool,argent-dawn,1603,hunter,beastmastery,50,28,22
Bànsundara,hyjal,1603,hunter,beastmastery,97,53,44
Cubro,sanguino,1603,hunter,beastmastery,77,42,35
Asery,blackmoore,1603,hunter,beastmastery,42,20,22
Pluttbug,xavius,1602,hunter,beastmastery,32,19,13
Bigdog,eredar,1602,hunter,beastmastery,77,33,44
Sjins,draenor,1601,hunter,beastmastery,35,20,15
Hunterlolz,tarren-mill,1601,hunter,beastmastery,54,29,25
Nottberozz,silvermoon,1601,hunter,beastmastery,146,72,74
Douglas,die-silberne-hand,1601,hunter,beastmastery,36,17,19
Stickey,antonidas,1600,hunter,beastmastery,66,34,32
Trapyx,malganis,1600,hunter,beastmastery,327,165,162
Chasxc,kazzak,1599,hunter,beastmastery,60,31,29
Spidak,stormscale,1597,hunter,beastmastery,42,23,19
Snaipergirl,twisting-nether,1597,hunter,beastmastery,66,30,36
Оути,azuregos,1595,hunter,beastmastery,69,37,32
Morìtz,ravencrest,1592,hunter,beastmastery,36,20,16
Mânhunt,blackhand,1592,hunter,beastmastery,373,181,192
Memehunter,aegwynn,1591,hunter,beastmastery,66,41,25
Eagletalon,twisting-nether,1590,hunter,beastmastery,57,27,30
Bøøya,aegwynn,1590,hunter,beastmastery,85,39,46
Зоотян,gordunni,1589,hunter,beastmastery,111,55,56
Earlygrey,ravencrest,1588,hunter,beastmastery,105,50,55
Keinzira,hyjal,1588,hunter,beastmastery,48,22,26
Xxiioo,ravencrest,1583,hunter,beastmastery,85,49,36
Иоссифсталин,soulflayer,1583,hunter,beastmastery,36,17,19
Survabuse,silvermoon,1581,hunter,beastmastery,33,20,13
Búddhá,stormscale,1581,hunter,beastmastery,186,88,98
Diapositiv,draenor,1580,hunter,beastmastery,60,33,27
Тиблэк,soulflayer,1579,hunter,beastmastery,101,51,50
Knocked,quelthalas,1579,hunter,beastmastery,54,20,34
Idetylem,burning-legion,1574,hunter,beastmastery,48,29,19
Reptile,outland,1574,hunter,beastmastery,88,49,39
Lëgølåslõrdx,blackrock,1574,hunter,beastmastery,68,32,36
Jeeso,baelgun,1574,hunter,beastmastery,130,61,69
Отерон,gordunni,1573,hunter,beastmastery,158,85,73
Йокуя,blackscar,1572,hunter,beastmastery,24,18,6
Akïratqz,sanguino,1572,hunter,beastmastery,30,18,12
Janko,ravencrest,1572,hunter,beastmastery,284,142,142
Леао,howling-fjord,1571,hunter,beastmastery,45,30,15
Мунлэс,lich-king,1569,hunter,beastmastery,69,30,39
Pandanero,ravencrest,1568,hunter,beastmastery,36,18,18
Dragomirka,kazzak,1568,hunter,beastmastery,62,29,33
Комомура,soulflayer,1568,hunter,beastmastery,53,24,29
Sallya,kazzak,1567,hunter,beastmastery,42,22,20
Сотк,howling-fjord,1567,hunter,beastmastery,42,19,23
Dispairge,antonidas,1566,hunter,beastmastery,42,18,24
Sagethunt,blackrock,1565,hunter,beastmastery,41,17,24
Arcaniz,ravencrest,1564,hunter,beastmastery,42,22,20
Tigerups,burning-legion,1563,hunter,beastmastery,58,29,29
Келен,blackscar,1560,hunter,beastmastery,30,19,11
Saymqt,blackrock,1560,hunter,beastmastery,63,29,34
Charleramsey,outland,1558,hunter,beastmastery,60,30,30
Brisbya,khaz-modan,1557,hunter,beastmastery,47,28,19
Nolove,burning-legion,1557,hunter,beastmastery,137,67,70
Жокра,greymane,1557,hunter,beastmastery,42,19,23
Zendra,sylvanas,1555,hunter,beastmastery,59,36,23
Shkorvi,drakthul,1555,hunter,beastmastery,36,17,19
Søuïlløn,archimonde,1553,hunter,beastmastery,48,30,18
Альриен,gordunni,1553,hunter,beastmastery,30,17,13
Medûse,stormscale,1551,hunter,beastmastery,42,26,16
Gunde,kazzak,1551,hunter,beastmastery,102,52,50
Nallepuuoh,outland,1549,hunter,beastmastery,123,62,61
Sharún,sylvanas,1548,hunter,beastmastery,56,27,29
Gedzer,silvermoon,1547,hunter,beastmastery,40,19,21
Æblesaft,stormscale,1547,hunter,beastmastery,76,34,42
Calutis,blackmoore,1546,hunter,beastmastery,48,28,20
Пулявзубах,gordunni,1544,hunter,beastmastery,110,58,52
Grusijohn,executus,1543,hunter,beastmastery,72,35,37
Tiendat,kazzak,1540,hunter,beastmastery,30,17,13
Антисерт,ashenvale,1538,hunter,beastmastery,70,33,37
Солевойй,gordunni,1537,hunter,beastmastery,42,20,22
Bortian,argent-dawn,1536,hunter,beastmastery,73,41,32
Snipertjuh,silvermoon,1536,hunter,beastmastery,103,51,52
Arcø,dun-modr,1535,hunter,beastmastery,30,16,14
Wolfster,kazzak,1534,hunter,beastmastery,42,19,23
Corrupth,outland,1533,hunter,beastmastery,36,18,18
Encore,sylvanas,1532,hunter,beastmastery,140,75,65
Sonìc,kazzak,1531,hunter,beastmastery,44,25,19
Ledrox,ravencrest,1531,hunter,beastmastery,78,38,40
Djbombastic,archimonde,1528,hunter,beastmastery,48,31,17
Tayaa,draenor,1528,hunter,beastmastery,91,47,44
Аллони,booty-bay,1528,hunter,beastmastery,165,80,85
Xraay,stormscale,1527,hunter,beastmastery,42,22,20
Córelly,outland,1527,hunter,beastmastery,119,57,62
Lascazador,dun-modr,1526,hunter,beastmastery,74,32,42
Orcoro,ysondre,1525,hunter,beastmastery,268,131,137
Vaelyste,doomhammer,1524,hunter,beastmastery,59,31,28
Zugmypole,stormscale,1524,hunter,beastmastery,48,25,23
Blupo,stormscale,1524,hunter,beastmastery,127,62,65
Инкризшот,gordunni,1524,hunter,beastmastery,36,17,19
Sarrow,ravencrest,1523,hunter,beastmastery,77,41,36
Chenony,ravencrest,1523,hunter,beastmastery,78,36,42
Atrisi,tarren-mill,1522,hunter,beastmastery,24,16,8
Оуаоа,blackscar,1522,hunter,beastmastery,24,16,8
Камшотовна,blackscar,1521,hunter,beastmastery,139,79,60
Pewmasters,stormscale,1519,hunter,beastmastery,31,18,13
Dregor,nemesis,1519,hunter,beastmastery,30,16,14
Palaur,kazzak,1519,hunter,beastmastery,94,50,44
Valldes,argent-dawn,1518,hunter,beastmastery,69,31,38
Wøden,ysondre,1517,hunter,beastmastery,78,34,44
Moistmán,kazzak,1514,hunter,beastmastery,176,85,91
Draugrinnh,tarren-mill,1511,hunter,beastmastery,66,29,37
Маунтдроп,gordunni,1509,hunter,beastmastery,130,70,60
Кежма,howling-fjord,1507,hunter,beastmastery,42,26,16
Gnouminøu,archimonde,1507,hunter,beastmastery,145,76,69
Avatarofwoe,blackmoore,1507,hunter,beastmastery,48,20,28
Жмыххунтер,howling-fjord,1504,hunter,beastmastery,60,26,34
Icetrapped,eredar,1502,hunter,beastmastery,41,25,16
Leriath,shadowsong,1502,hunter,beastmastery,89,52,37
Palav,outland,1502,hunter,beastmastery,30,16,14
Badkirves,kazzak,1502,hunter,beastmastery,84,41,43
Druckwelle,frostwolf,1502,hunter,beastmastery,62,25,37
Kravchenko,draenor,1501,hunter,beastmastery,41,23,18
Gumm,gorgonnash,1496,hunter,beastmastery,30,17,13
Funkalation,ravencrest,1495,hunter,beastmastery,36,20,16
Ryuwen,dun-modr,1495,hunter,beastmastery,83,39,44
Rdom,stormreaver,1493,hunter,beastmastery,96,49,47
Øô,dun-morogh,1492,hunter,beastmastery,83,41,42
Фдкд,howling-fjord,1492,hunter,beastmastery,72,33,39
Amigoss,argent-dawn,1490,hunter,beastmastery,36,20,16
Thinkerer,silvermoon,1490,hunter,beastmastery,38,17,21
Solot,silvermoon,1490,hunter,beastmastery,54,24,30
Laoriane,hyjal,1489,hunter,beastmastery,51,28,23
Трэйсх,howling-fjord,1487,hunter,beastmastery,36,17,19
Жэш,howling-fjord,1486,hunter,beastmastery,63,43,20
Ahlgood,stormscale,1484,hunter,beastmastery,30,16,14
Dramin,defias-brotherhood,1482,hunter,beastmastery,209,114,95
Domnite,ravencrest,1482,hunter,beastmastery,139,74,65
Anjeschka,nemesis,1481,hunter,beastmastery,58,35,23
Raxedo,blackrock,1481,hunter,beastmastery,30,16,14
Rhee,the-maelstrom,1481,hunter,beastmastery,96,44,52
Лёт,azuregos,1478,hunter,beastmastery,50,31,19
Almogrote,sanguino,1478,hunter,beastmastery,54,25,29
Engetsu,drakthul,1476,hunter,beastmastery,90,43,47
Lobos,ravencrest,1475,hunter,beastmastery,104,53,51
Tràxes,quelthalas,1473,hunter,beastmastery,50,21,29
Johnblønn,stormscale,1472,hunter,beastmastery,33,16,17
Wingclip,ravencrest,1472,hunter,beastmastery,40,17,23
Bastianapa,twisting-nether,1471,hunter,beastmastery,66,31,35
Aenina,kazzak,1466,hunter,beastmastery,30,19,11
Coldmonster,tarren-mill,1466,hunter,beastmastery,163,88,75
Råhl,zuljin,1466,hunter,beastmastery,41,17,24
Jas,kargath,1465,hunter,beastmastery,90,48,42
Baileé,onyxia,1464,hunter,beastmastery,50,30,20
Куоль,gordunni,1463,hunter,beastmastery,47,21,26
Budhunter,alakir,1462,hunter,beastmastery,72,39,33
Mytown,hyjal,1462,hunter,beastmastery,126,64,62
Huntma,kazzak,1462,hunter,beastmastery,73,36,37
Anca,aegwynn,1462,hunter,beastmastery,107,52,55
Делар,howling-fjord,1461,hunter,beastmastery,42,17,25
Ххун,gordunni,1460,hunter,beastmastery,46,24,22
Ayyubi,blackrock,1460,hunter,beastmastery,71,36,35
Чапуршилов,lich-king,1460,hunter,beastmastery,148,75,73
Zäyk,zuljin,1459,hunter,beastmastery,37,21,16
Ázurâ,blackhand,1458,hunter,beastmastery,75,39,36
Johnwick,aerie-peak,1457,hunter,beastmastery,42,24,18
Mufdii,sylvanas,1457,hunter,beastmastery,34,16,18
Dzikabestia,burning-legion,1455,hunter,beastmastery,30,18,12
Sylariel,die-aldor,1455,hunter,beastmastery,40,20,20
Снюсинка,gordunni,1455,hunter,beastmastery,47,23,24
Ivanthebeast,twisting-nether,1454,hunter,beastmastery,51,30,21
Metalmaison,archimonde,1452,hunter,beastmastery,88,40,48
Acmé,kazzak,1451,hunter,beastmastery,54,22,32
Shawnrai,drakthul,1449,hunter,beastmastery,44,24,20
Dirtydolores,thrall,1448,hunter,beastmastery,35,20,15
Толяарканшот,razuvious,1448,hunter,beastmastery,36,20,16
Сенджогахара,greymane,1447,hunter,beastmastery,37,17,20
Slmao,tarren-mill,1447,hunter,beastmastery,91,39,52
Raymear,kazzak,1446,hunter,beastmastery,48,27,21
Metrolog,twisting-nether,1446,hunter,beastmastery,99,48,51
Assbúrgers,silvermoon,1446,hunter,beastmastery,70,33,37
Shieryu,archimonde,1446,hunter,beastmastery,48,19,29
Yoggys,outland,1445,hunter,beastmastery,54,27,27
Toxical,ragnaros,1444,hunter,beastmastery,24,17,7
Gramzy,blackmoore,1443,hunter,beastmastery,41,18,23
Watchouttah,the-maelstrom,1439,hunter,beastmastery,24,15,9
Kásúxôxô,ravencrest,1439,hunter,beastmastery,30,15,15
Ghost,tarren-mill,1439,hunter,beastmastery,30,15,15
Earnzie,outland,1438,hunter,beastmastery,60,25,35
Ilovekatsu,archimonde,1437,hunter,beastmastery,24,15,9
Waalth,ragnaros,1437,hunter,beastmastery,76,37,39
Yryyh,silvermoon,1436,hunter,beastmastery,54,20,34
Clockwerk,durotan,1435,hunter,beastmastery,28,16,12
Mágaz,draenor,1435,hunter,beastmastery,48,26,22
Drigs,blackrock,1434,hunter,beastmastery,62,31,31
Pancakesgo,twilights-hammer,1434,hunter,beastmastery,71,33,38
Kissnodig,outland,1433,hunter,beastmastery,39,26,13
Spizglub,defias-brotherhood,1433,hunter,beastmastery,59,28,31
Crynomore,tarren-mill,1432,hunter,beastmastery,53,34,19
Джаствэл,howling-fjord,1432,hunter,beastmastery,30,15,15
Duïvell,grim-batol,1432,hunter,beastmastery,36,15,21
Tukene,kazzak,1432,hunter,beastmastery,45,17,28
Noréaga,suramar,1431,hunter,beastmastery,36,20,16
Shoranon,stormscale,1431,hunter,beastmastery,30,15,15
Jaxteller,archimonde,1431,hunter,beastmastery,30,15,15
Strélka,blackrock,1431,hunter,beastmastery,36,16,20
Fotmrerollér,aegwynn,1430,hunter,beastmastery,30,15,15
Акройя,gordunni,1430,hunter,beastmastery,72,33,39
Khatia,blackrock,1429,hunter,beastmastery,36,18,18
Dzikapumpa,burning-legion,1429,hunter,beastmastery,39,18,21
Наспидахх,blackscar,1427,hunter,beastmastery,24,15,9
Eufumo,sanguino,1427,hunter,beastmastery,88,48,40
Gondoo,tarren-mill,1427,hunter,beastmastery,30,15,15
Grabbin,silvermoon,1425,hunter,beastmastery,34,16,18
Гульнарамвд,gordunni,1422,hunter,beastmastery,36,15,21
Ubietza,aegwynn,1421,hunter,beastmastery,54,23,31
Трапча,soulflayer,1420,hunter,beastmastery,24,15,9
Kethos,draenor,1420,hunter,beastmastery,54,28,26
Mariehunt,blackmoore,1420,hunter,beastmastery,108,52,56
Siegbald,ragnaros,1419,hunter,beastmastery,30,15,15
Land,darkspear,1419,hunter,beastmastery,30,15,15
Vypaz,twisting-nether,1419,hunter,beastmastery,54,26,28
Sníper,aggra-português,1419,hunter,beastmastery,109,51,58
Drivenscope,twisting-nether,1418,hunter,beastmastery,34,16,18
Andjelaa,kazzak,1417,hunter,beastmastery,38,19,19
Oife,auchindoun,1416,hunter,beastmastery,47,27,20
Neíth,the-maelstrom,1415,hunter,beastmastery,69,31,38
Jarekk,auchindoun,1414,hunter,beastmastery,53,28,25
Xeld,outland,1414,hunter,beastmastery,30,15,15
Эмомото,howling-fjord,1414,hunter,beastmastery,30,15,15
Edùens,ysondre,1413,hunter,beastmastery,45,25,20
Kalt,twisting-nether,1412,hunter,beastmastery,54,30,24
Velocity,nagrand,1411,hunter,beastmastery,41,19,22
Cosmol,kazzak,1409,hunter,beastmastery,47,24,23
Стреладемона,gordunni,1407,hunter,beastmastery,69,40,29
Hruon,sporeggar,1407,hunter,beastmastery,36,17,19
Hammertime,sanguino,1406,hunter,beastmastery,71,36,35
Flunkytim,blackmoore,1405,hunter,beastmastery,102,56,46
Фетсол,soulflayer,1405,hunter,beastmastery,48,26,22
Juha,the-maelstrom,1405,hunter,beastmastery,40,18,22
Elsasehunter,zuljin,1402,hunter,beastmastery,132,60,72
Váal,dun-modr,1401,hunter,beastmastery,63,36,27
Neescafe,sylvanas,1401,hunter,beastmastery,45,25,20
Xüscha,ysera,1401,hunter,beastmastery,78,33,45
Geete,kazzak,1400,hunter,beastmastery,30,17,13
Phinecone,stormscale,1399,hunter,beastmastery,42,18,24
Thyala,twisting-nether,1398,hunter,beastmastery,33,16,17
Дипшот,deathguard,1397,hunter,beastmastery,44,23,21
Дафирия,deathguard,1395,hunter,beastmastery,58,31,27
Luluxfire,burning-legion,1394,hunter,beastmastery,30,15,15
Mââl,archimonde,1394,hunter,beastmastery,36,16,20
Бубунн,howling-fjord,1394,hunter,beastmastery,96,42,54
Metsänmies,defias-brotherhood,1393,hunter,beastmastery,46,27,19
Xystîco,thrall,1393,hunter,beastmastery,54,26,28
Шионо,howling-fjord,1391,hunter,beastmastery,56,29,27
Беспокойный,soulflayer,1390,hunter,beastmastery,36,15,21
Афигеннски,ashenvale,1387,hunter,beastmastery,54,25,29
Adram,burning-legion,1386,hunter,beastmastery,29,16,13
Berkobaggins,twisting-nether,1386,hunter,beastmastery,58,26,32
Vimd,archimonde,1384,hunter,beastmastery,42,18,24
Grrizzly,kazzak,1382,hunter,beastmastery,43,23,20
Chagaure,hyjal,1382,hunter,beastmastery,36,17,19
Viktorijå,draenor,1380,hunter,beastmastery,36,20,16
Туруханец,gordunni,1380,hunter,beastmastery,108,59,49
Beardmastery,auchindoun,1380,hunter,beastmastery,36,16,20
Bambamgalke,antonidas,1378,hunter,beastmastery,72,34,38
Amitar,tarren-mill,1377,hunter,beastmastery,48,28,20
Талигар,razuvious,1377,hunter,beastmastery,78,33,45
Хлопс,howling-fjord,1376,hunter,beastmastery,36,16,20
Loógosh,blackmoore,1375,hunter,beastmastery,66,32,34
Esgar,blackrock,1374,hunter,beastmastery,74,34,40
Texaco,dun-modr,1374,hunter,beastmastery,55,25,30
Nyght,ravencrest,1373,hunter,beastmastery,86,41,45
Boulaax,ysondre,1372,hunter,beastmastery,118,66,52
Lokiis,hyjal,1372,hunter,beastmastery,84,44,40
Гиладар,borean-tundra,1372,hunter,beastmastery,41,18,23
Фузег,deathguard,1370,hunter,beastmastery,128,65,63
Glorfindhel,archimonde,1370,hunter,beastmastery,36,18,18
Pumbuboo,deathwing,1370,hunter,beastmastery,42,18,24
Wondersnipes,stormrage,1369,hunter,beastmastery,33,15,18
Jaky,illidan,1368,hunter,beastmastery,179,104,75
Анариэльсин,soulflayer,1368,hunter,beastmastery,36,15,21
Честнный,howling-fjord,1366,hunter,beastmastery,141,64,77
Beletor,medivh,1365,hunter,beastmastery,30,15,15
Focuslhunt,archimonde,1363,hunter,beastmastery,30,18,12
Zantorious,ravencrest,1363,hunter,beastmastery,63,37,26
Saromán,ravencrest,1362,hunter,beastmastery,42,23,19
Dêstiny,dun-modr,1360,hunter,beastmastery,30,17,13
Traktorr,stormscale,1360,hunter,beastmastery,90,43,47
Desow,blackrock,1359,hunter,beastmastery,48,27,21
Dotkor,laughing-skull,1359,hunter,beastmastery,72,38,34
Zúzú,hyjal,1358,hunter,beastmastery,54,32,22
Pixxeel,khaz-modan,1356,hunter,beastmastery,30,15,15
Nycrom,ravencrest,1354,hunter,beastmastery,32,15,17
Киборка,howling-fjord,1352,hunter,beastmastery,30,15,15
Asâya,blackmoore,1348,hunter,beastmastery,60,31,29
Sebastien,frostmane,1347,hunter,beastmastery,33,17,16
Artemisas,draenor,1346,hunter,beastmastery,48,16,32
Zelarun,ragnaros,1345,hunter,beastmastery,42,24,18
Felorya,kazzak,1345,hunter,beastmastery,46,25,21
Glizzygobblr,kazzak,1345,hunter,beastmastery,28,15,13
Porch,dragonmaw,1345,hunter,beastmastery,31,16,15
Tåxi,silvermoon,1345,hunter,beastmastery,160,78,82
Шэйдуокер,gordunni,1344,hunter,beastmastery,277,134,143
Nerdhark,hyjal,1343,hunter,beastmastery,45,22,23
Straybullet,kazzak,1343,hunter,beastmastery,119,56,63
Yezzu,sylvanas,1343,hunter,beastmastery,30,14,16
Ðoxz,blackrock,1342,hunter,beastmastery,24,14,10
Чизано,deathguard,1342,hunter,beastmastery,53,25,28
Hogar,frostwolf,1341,hunter,beastmastery,26,16,10
Сатарр,gordunni,1341,hunter,beastmastery,154,74,80
Äyumi,chogall,1341,hunter,beastmastery,42,18,24
Karuso,ravencrest,1340,hunter,beastmastery,30,14,16
Meskette,ravencrest,1340,hunter,beastmastery,70,30,40
Gostry,archimonde,1339,hunter,beastmastery,24,14,10
Joshalama,quelthalas,1339,hunter,beastmastery,35,19,16
Unrealy,grim-batol,1339,hunter,beastmastery,182,95,87
Clickbile,twisting-nether,1338,hunter,beastmastery,24,14,10
Poatan,outland,1338,hunter,beastmastery,96,54,42
Zisqa,alleria,1337,hunter,beastmastery,28,15,13
Notikâ,aegwynn,1336,hunter,beastmastery,48,20,28
Pammycakes,bronze-dragonflight,1335,hunter,beastmastery,194,96,98
Raythe,argent-dawn,1335,hunter,beastmastery,30,14,16
Simpyani,silvermoon,1333,hunter,beastmastery,24,14,10
Заксель,soulflayer,1333,hunter,beastmastery,30,14,16
Heoden,nemesis,1332,hunter,beastmastery,24,14,10
Santiino,silvermoon,1332,hunter,beastmastery,30,14,16
Lustor,ravencrest,1332,hunter,beastmastery,83,34,49
Lòò,aegwynn,1330,hunter,beastmastery,24,14,10
Trapwann,argent-dawn,1329,hunter,beastmastery,24,14,10
Watntietjes,burning-blade,1329,hunter,beastmastery,48,22,26
Афонадзе,gordunni,1329,hunter,beastmastery,90,41,49
Feignindeath,twisting-nether,1328,hunter,beastmastery,60,35,25
Mînérvá,blackhand,1327,hunter,beastmastery,36,20,16
Settisetä,defias-brotherhood,1323,hunter,beastmastery,24,14,10
Sélenaé,hyjal,1323,hunter,beastmastery,52,21,31
Kiingsane,archimonde,1323,hunter,beastmastery,43,17,26
Lis,gorgonnash,1323,hunter,beastmastery,36,14,22
Drestan,drakthul,1322,hunter,beastmastery,60,26,34
Luniel,gilneas,1321,hunter,beastmastery,24,14,10
Travels,tarren-mill,1320,hunter,beastmastery,165,82,83
Ríckybobby,kazzak,1319,hunter,beastmastery,43,22,21
Zinco,ravencrest,1318,hunter,beastmastery,36,14,22
Ловихимеру,soulflayer,1316,hunter,beastmastery,24,14,10
Джантига,howling-fjord,1315,hunter,beastmastery,30,16,14
Øßlíck,ysondre,1314,hunter,beastmastery,30,14,16
Meredo,burning-legion,1313,hunter,beastmastery,64,33,31
Dùmbo,khaz-modan,1313,hunter,beastmastery,96,46,50
Bogüen,sanguino,1313,hunter,beastmastery,30,14,16
Muspigen,tarren-mill,1313,hunter,beastmastery,83,38,45
Ханзолес,gordunni,1312,hunter,beastmastery,24,14,10
Люблюлюбовь,gordunni,1310,hunter,beastmastery,42,27,15
Platzpatron,eredar,1310,hunter,beastmastery,69,30,39
Nårgai,kargath,1305,hunter,beastmastery,30,18,12
Showerhead,silvermoon,1305,hunter,beastmastery,32,14,18
Proccter,silvermoon,1303,hunter,beastmastery,26,14,12
Michaelvm,ravencrest,1302,hunter,beastmastery,36,20,16
Devøurer,blackmoore,1301,hunter,beastmastery,24,14,10
Penthesîlea,aegwynn,1301,hunter,beastmastery,50,24,26
Halessia,ravencrest,1300,hunter,beastmastery,117,57,60
Koopo,stormreaver,1299,hunter,beastmastery,51,28,23
Whatifany,tarren-mill,1299,hunter,beastmastery,90,36,54
Magarosh,eredar,1298,hunter,beastmastery,30,14,16
Footsy,twisting-nether,1298,hunter,beastmastery,30,14,16
Blastarrow,the-maelstrom,1293,hunter,beastmastery,72,30,42
Hantro,argent-dawn,1292,hunter,beastmastery,36,20,16
Bøwjøb,arthas,1292,hunter,beastmastery,42,23,19
Sixty,rajaxx,1291,hunter,beastmastery,42,22,20
Bågeniburen,draenor,1290,hunter,beastmastery,32,16,16
Belorgrim,kirin-tor,1289,hunter,beastmastery,36,18,18
Crippler,arthas,1288,hunter,beastmastery,22,15,7
Zerisi,silvermoon,1288,hunter,beastmastery,35,21,14
Salvia,chromaggus,1288,hunter,beastmastery,96,51,45
Дзэнмашина,booty-bay,1285,hunter,beastmastery,80,40,40
Yoüllsuffer,twisting-nether,1285,hunter,beastmastery,36,15,21
Maknamara,tarren-mill,1284,hunter,beastmastery,60,31,29
Fahin,draenor,1284,hunter,beastmastery,68,32,36
Ynfik,sinstralis,1283,hunter,beastmastery,81,40,41
Кулинарк,howling-fjord,1282,hunter,beastmastery,60,29,31
Cobra,magtheridon,1282,hunter,beastmastery,71,30,41
Bravestarr,blades-edge,1280,hunter,beastmastery,66,32,34
Fenstad,dalaran,1279,hunter,beastmastery,52,25,27
Rushgarroth,ravencrest,1271,hunter,beastmastery,96,44,52
Безос,soulflayer,1270,hunter,beastmastery,44,23,21
Asousa,stormscale,1269,hunter,beastmastery,66,32,34
Яроняютрапу,gordunni,1268,hunter,beastmastery,34,21,13
Rxr,kazzak,1264,hunter,beastmastery,54,17,37
Бирмингем,ashenvale,1262,hunter,beastmastery,36,17,19
Pennymarks,blackhand,1261,hunter,beastmastery,32,14,18
Necromercy,burning-legion,1260,hunter,beastmastery,32,16,16
Cêleste,kaelthas,1257,hunter,beastmastery,70,33,37
Waidø,blackhand,1256,hunter,beastmastery,24,14,10
Linchpin,dentarg,1255,hunter,beastmastery,62,28,34
Aneji,hyjal,1254,hunter,beastmastery,38,19,19
Swâân,sanguino,1254,hunter,beastmastery,33,16,17
Mehtäsika,xavius,1254,hunter,beastmastery,45,21,24
Pareia,blackrock,1248,hunter,beastmastery,18,13,5
Oliene,twisting-nether,1248,hunter,beastmastery,58,27,31
Ðowz,ysondre,1248,hunter,beastmastery,30,13,17
Rïm,haomarush,1247,hunter,beastmastery,24,13,11
Elmez,outland,1247,hunter,beastmastery,24,13,11
Pagman,thrall,1247,hunter,beastmastery,30,13,17
Космодиск,gordunni,1246,hunter,beastmastery,18,13,5
Ivanoé,archimonde,1246,hunter,beastmastery,30,13,17
Shenely,kazzak,1245,hunter,beastmastery,24,13,11
Lothram,les-sentinelles,1245,hunter,beastmastery,24,13,11
Лвндскейп,gordunni,1245,hunter,beastmastery,30,13,17
Ommadawn,dun-modr,1244,hunter,beastmastery,72,33,39
Brawnshunt,stormscale,1244,hunter,beastmastery,30,13,17
Дуссита,gordunni,1244,hunter,beastmastery,36,13,23
Dogthebounty,tarren-mill,1243,hunter,beastmastery,26,15,11
Zäroury,ravencrest,1242,hunter,beastmastery,24,13,11
Skytraped,hyjal,1242,hunter,beastmastery,24,13,11
Ägris,die-todeskrallen,1242,hunter,beastmastery,150,72,78
Bêastî,blackrock,1242,hunter,beastmastery,30,13,17
Хастла,greymane,1240,hunter,beastmastery,30,13,17
Blazeityolo,outland,1240,hunter,beastmastery,36,13,23
Zusale,azshara,1238,hunter,beastmastery,24,13,11
Verathelon,drakthul,1238,hunter,beastmastery,57,27,30
Halgen,medivh,1237,hunter,beastmastery,88,37,51
Freebïrd,shattered-hand,1236,hunter,beastmastery,24,13,11
Benbutton,antonidas,1234,hunter,beastmastery,58,27,31
Jyenety,stormscale,1233,hunter,beastmastery,36,18,18
Bufosh,twisting-nether,1232,hunter,beastmastery,86,43,43
Heiltfürzwei,ungoro,1232,hunter,beastmastery,35,15,20
Брзенк,gordunni,1232,hunter,beastmastery,64,23,41
Shaznak,argent-dawn,1231,hunter,beastmastery,36,17,19
Skidzo,alakir,1231,hunter,beastmastery,32,15,17
Оксанчек,howling-fjord,1229,hunter,beastmastery,29,13,16
Latschodives,malorne,1229,hunter,beastmastery,33,13,20
Bibsy,tarren-mill,1228,hunter,beastmastery,24,13,11
Lusifa,antonidas,1228,hunter,beastmastery,87,46,41
Qmbonboni,ravencrest,1226,hunter,beastmastery,55,32,23
Toralfmoralf,aegwynn,1225,hunter,beastmastery,24,13,11
Davíncí,tarren-mill,1224,hunter,beastmastery,77,41,36
Neeske,sylvanas,1224,hunter,beastmastery,30,13,17
Annisaqt,kazzak,1222,hunter,beastmastery,47,25,22
Vexhh,outland,1221,hunter,beastmastery,24,13,11
Ridlas,silvermoon,1221,hunter,beastmastery,60,28,32
Ililivillumi,tarren-mill,1219,hunter,beastmastery,43,24,19
Pewpewcus,ravencrest,1219,hunter,beastmastery,43,24,19
Балласкиндер,gordunni,1219,hunter,beastmastery,66,36,30
Kyliun,frostmane,1219,hunter,beastmastery,53,24,29
Robal,burning-legion,1219,hunter,beastmastery,42,19,23
Stogie,auchindoun,1217,hunter,beastmastery,24,13,11
Spineshot,thrall,1217,hunter,beastmastery,60,24,36
Bigfoot,argent-dawn,1215,hunter,beastmastery,98,44,54
Гримкааг,eversong,1214,hunter,beastmastery,55,27,28
Тофуитер,howling-fjord,1214,hunter,beastmastery,57,25,32
Kiwala,burning-legion,1212,hunter,beastmastery,48,22,26
Câonimâ,twisting-nether,1212,hunter,beastmastery,30,13,17
Snipingdog,stormscale,1209,hunter,beastmastery,36,18,18
Heylie,senjin,1206,hunter,beastmastery,47,16,31
Papithagore,hyjal,1203,hunter,beastmastery,29,13,16
Ниамх,blackscar,1203,hunter,beastmastery,47,21,26
Diac,dalaran,1201,hunter,beastmastery,18,13,5
Sithrom,blackmoore,1201,hunter,beastmastery,28,13,15
Анютикус,gordunni,1199,hunter,beastmastery,60,34,26
Фитьфитий,howling-fjord,1197,hunter,beastmastery,47,22,25
Slojork,thrall,1190,hunter,beastmastery,92,40,52
Johntoffee,eredar,1190,hunter,beastmastery,35,14,21
Ashjen,aszune,1188,hunter,beastmastery,29,18,11
Kaletorw,ragnaros,1187,hunter,beastmastery,36,20,16
Eddy,the-maelstrom,1187,hunter,beastmastery,36,20,16
Быщь,gordunni,1186,hunter,beastmastery,29,14,15
Loyalman,blackmoore,1180,hunter,beastmastery,24,15,9
Винченцо,blackscar,1180,hunter,beastmastery,27,13,14
Cicatrice,kazzak,1180,hunter,beastmastery,28,13,15
Harpin,azuremyst,1179,hunter,beastmastery,65,32,33
Haleth,uldum,1177,hunter,beastmastery,29,13,16
Fizè,blackmoore,1175,hunter,beastmastery,23,13,10
Амобарбиталх,gordunni,1173,hunter,beastmastery,39,20,19
Gbureczka,burning-legion,1171,hunter,beastmastery,32,13,19
Skullstah,ravencrest,1169,hunter,beastmastery,24,13,11
Straikkeri,draenor,1169,hunter,beastmastery,41,18,23
Sàclak,ysondre,1166,hunter,beastmastery,31,17,14
Spycke,dalaran,1163,hunter,beastmastery,33,22,11
Cabuløsø,aggra-português,1162,hunter,beastmastery,24,13,11
Cinan,twisting-nether,1161,hunter,beastmastery,119,60,59
Ønur,twisting-nether,1159,hunter,beastmastery,72,37,35
Cityhunter,archimonde,1156,hunter,beastmastery,64,30,34
Eluun,saurfang,1156,hunter,beastmastery,30,13,17
Velites,aggra-português,1155,hunter,beastmastery,27,15,12
Rafizox,kazzak,1152,hunter,beastmastery,18,12,6
Lajnus,frostmane,1152,hunter,beastmastery,24,12,12
Basìcs,nemesis,1152,hunter,beastmastery,60,27,33
Hizzenstein,blackhand,1151,hunter,beastmastery,24,12,12
Jeskö,tarren-mill,1151,hunter,beastmastery,24,12,12
Mercoßenz,kazzak,1151,hunter,beastmastery,24,12,12
Blazinghunt,kazzak,1150,hunter,beastmastery,18,12,6
Fendros,kazzak,1150,hunter,beastmastery,18,12,6
Kayluh,sylvanas,1150,hunter,beastmastery,18,12,6
Digimørtal,kazzak,1150,hunter,beastmastery,18,12,6
Wicmex,archimonde,1150,hunter,beastmastery,18,12,6
Leza,kult-der-verdammten,1150,hunter,beastmastery,24,12,12
Bujie,ragnaros,1150,hunter,beastmastery,30,12,18
Амореселф,gordunni,1150,hunter,beastmastery,30,12,18
Outkást,sylvanas,1150,hunter,beastmastery,30,12,18
Næ,kazzak,1150,hunter,beastmastery,30,12,18
Crowsza,archimonde,1150,hunter,beastmastery,34,13,21
Mâjôô,blackhand,1149,hunter,beastmastery,22,13,9
Noxin,blackrock,1149,hunter,beastmastery,24,12,12
Hõth,kazzak,1149,hunter,beastmastery,30,12,18
Мэдраэль,deathguard,1148,hunter,beastmastery,39,18,21
Garfie,tarren-mill,1147,hunter,beastmastery,22,13,9
Amdonesia,ravencrest,1147,hunter,beastmastery,54,18,36
Yoorizz,outland,1147,hunter,beastmastery,36,12,24
Подлыйстарик,gordunni,1146,hunter,beastmastery,24,12,12
Gorgorm,ravencrest,1146,hunter,beastmastery,36,12,24
Eöe,ragnaros,1145,hunter,beastmastery,24,12,12
Лсныйпамп,howling-fjord,1145,hunter,beastmastery,24,12,12
Weiaw,blackmoore,1144,hunter,beastmastery,24,12,12
Yeign,eredar,1144,hunter,beastmastery,24,12,12
Hunterbeck,ravencrest,1144,hunter,beastmastery,78,32,46
Lunaunii,argent-dawn,1142,hunter,beastmastery,18,12,6
Nissa,blackrock,1142,hunter,beastmastery,24,12,12
Синглшот,blackscar,1141,hunter,beastmastery,24,12,12
Xéraphine,mannoroth,1141,hunter,beastmastery,30,12,18
Hlynsson,tarren-mill,1140,hunter,beastmastery,18,12,6
Retroxia,stormreaver,1139,hunter,beastmastery,24,12,12
Mordhunterx,draenor,1138,hunter,beastmastery,24,12,12
Tedohunter,ragnaros,1138,hunter,beastmastery,42,19,23
Zpy,blackmoore,1137,hunter,beastmastery,18,12,6
Crossjob,kazzak,1136,hunter,beastmastery,24,12,12
Бвонсамдик,howling-fjord,1135,hunter,beastmastery,24,12,12
Abovival,ragnaros,1134,hunter,beastmastery,24,12,12
Tempestes,tarren-mill,1133,hunter,beastmastery,83,41,42
Tomli,nemesis,1133,hunter,beastmastery,27,13,14
Armanny,sylvanas,1132,hunter,beastmastery,36,12,24
Olamay,blackmoore,1131,hunter,beastmastery,62,31,31
Ázèrøñå,ravencrest,1129,hunter,beastmastery,27,16,11
Oròme,pozzo-delleternità,1129,hunter,beastmastery,72,36,36
Pigoen,sporeggar,1128,hunter,beastmastery,89,40,49
Tremby,kazzak,1124,hunter,beastmastery,27,13,14
Deunan,shattered-hand,1122,hunter,beastmastery,24,12,12
Paînfull,kazzak,1115,hunter,beastmastery,29,12,17
Huntiio,khaz-modan,1113,hunter,beastmastery,60,25,35
Cäri,colinas-pardas,1109,hunter,beastmastery,36,16,20
Jollis,argent-dawn,1108,hunter,beastmastery,33,13,20
Øutkast,silvermoon,1105,hunter,beastmastery,29,18,11
Ládysháyà,blackrock,1104,hunter,beastmastery,84,42,42
Куфачка,soulflayer,1103,hunter,beastmastery,17,12,5
Nerfjuice,silvermoon,1102,hunter,beastmastery,39,21,18
Sâranjágo,argent-dawn,1102,hunter,beastmastery,61,29,32
Savori,kazzak,1100,hunter,beastmastery,37,21,16
Cyclontrapgg,antonidas,1100,hunter,beastmastery,23,13,10
Paraskámu,twisting-nether,1099,hunter,beastmastery,23,12,11
Atraxi,aegwynn,1096,hunter,beastmastery,64,28,36
Tsoutsoukoss,silvermoon,1095,hunter,beastmastery,109,52,57
Goonii,bronzebeard,1094,hunter,beastmastery,24,12,12
Janjal,silvermoon,1094,hunter,beastmastery,129,57,72
Karstarkk,sanguino,1092,hunter,beastmastery,65,28,37
Ertestuing,tarren-mill,1090,hunter,beastmastery,30,14,16
Ezelina,lightnings-blade,1086,hunter,beastmastery,54,27,27
Brometheus,sylvanas,1083,hunter,beastmastery,41,15,26
Soulshoot,khaz-modan,1078,hunter,beastmastery,88,44,44
Pawder,silvermoon,1077,hunter,beastmastery,42,15,27
Musraah,zuljin,1076,hunter,beastmastery,21,13,8
Nieki,eitrigg,1070,hunter,beastmastery,80,30,50
Spiritshot,baelgun,1066,hunter,beastmastery,34,14,20
Venkox,archimonde,1062,hunter,beastmastery,79,42,37
Cruelsummer,kul-tiras,1061,hunter,beastmastery,60,22,38
Deblaze,aegwynn,1056,hunter,beastmastery,18,11,7
Irükandji,chants-éternels,1056,hunter,beastmastery,18,11,7
Trapgodxx,archimonde,1056,hunter,beastmastery,24,11,13
Vargar,arygos,1056,hunter,beastmastery,24,11,13
Jaxxoo,outland,1055,hunter,beastmastery,18,11,7
Pjållistani,ravencrest,1055,hunter,beastmastery,30,11,19
Reyko,stormscale,1055,hunter,beastmastery,30,11,19
Bazouf,outland,1054,hunter,beastmastery,18,11,7
Дэскрайт,soulflayer,1054,hunter,beastmastery,18,11,7
Notx,ravencrest,1054,hunter,beastmastery,18,11,7
Daveq,drakthul,1054,hunter,beastmastery,24,11,13
Зимняясказка,soulflayer,1053,hunter,beastmastery,29,11,18
Jakis,silvermoon,1052,hunter,beastmastery,18,11,7
Gobliniehoóo,azuremyst,1051,hunter,beastmastery,16,12,4
Arrechus,khaz-modan,1051,hunter,beastmastery,116,54,62
Greg,defias-brotherhood,1051,hunter,beastmastery,24,11,13
Darllene,kazzak,1051,hunter,beastmastery,30,11,19
Pilogbueferd,silvermoon,1050,hunter,beastmastery,18,11,7
Румлис,gordunni,1048,hunter,beastmastery,33,16,17
Коблазнх,howling-fjord,1048,hunter,beastmastery,24,11,13
Sourxete,silvermoon,1048,hunter,beastmastery,24,11,13
Githo,argent-dawn,1047,hunter,beastmastery,21,12,9
Sillychilly,frostwolf,1045,hunter,beastmastery,30,11,19
Shinibon,blackmoore,1044,hunter,beastmastery,36,11,25
Бедствиие,galakrond,1044,hunter,beastmastery,36,11,25
Nidromel,stormscale,1043,hunter,beastmastery,113,52,61
Ayaille,marécage-de-zangar,1043,hunter,beastmastery,40,14,26
Yukina,frostmourne,1038,hunter,beastmastery,28,13,15
Arnatti,tyrande,1036,hunter,beastmastery,28,16,12
Pumukle,madmortem,1035,hunter,beastmastery,34,15,19
Luckyhunty,dalaran,1034,hunter,beastmastery,53,21,32
Айлиси,soulflayer,1031,hunter,beastmastery,43,11,32
Nesthor,sinstralis,1026,hunter,beastmastery,30,11,19
Ремонтлицаа,gordunni,1022,hunter,beastmastery,23,11,12
Ветиринарша,gordunni,1020,hunter,beastmastery,30,11,19
Leemool,ysondre,1017,hunter,beastmastery,24,12,12
Grollar,ragnaros,1014,hunter,beastmastery,80,42,38
Faze,hellfire,1013,hunter,beastmastery,60,30,30
Schnezzler,nerathor,1011,hunter,beastmastery,100,48,52
Bouboule,elune,1010,hunter,beastmastery,48,29,19
Arakton,drakthul,1008,hunter,beastmastery,46,23,23
Weisswinter,drakthul,1004,hunter,beastmastery,24,12,12
Jimmý,sylvanas,1004,hunter,beastmastery,26,11,15
Magrha,khaz-modan,1003,hunter,beastmastery,23,11,12
Фэннон,gordunni,1002,hunter,beastmastery,27,13,14
Lissudarlin,stormreaver,1000,hunter,beastmastery,211,110,101
Shpider,burning-blade,1000,hunter,beastmastery,52,22,30
Feigur,sanguino,999,hunter,beastmastery,47,24,23
Kagan,nemesis,998,hunter,beastmastery,29,17,12
Bigbababotan,blackrock,996,hunter,beastmastery,27,12,15
Sinux,lordaeron,995,hunter,beastmastery,17,11,6
Kure,blackrock,993,hunter,beastmastery,91,43,48
Grandiosity,tarren-mill,992,hunter,beastmastery,17,11,6
Хантвкроксах,gordunni,991,hunter,beastmastery,26,12,14
Enanorabioso,minahonda,991,hunter,beastmastery,30,12,18
Frencharena,the-venture-co,990,hunter,beastmastery,29,11,18
Ulyash,ysondre,990,hunter,beastmastery,42,14,28
Neuromancien,archimonde,990,hunter,beastmastery,35,11,24
Rubyblack,archimonde,984,hunter,beastmastery,48,24,24
Floppybobby,burning-blade,980,hunter,beastmastery,29,12,17
Вагар,blackscar,974,hunter,beastmastery,18,12,6
Kikijojo,ravencrest,971,hunter,beastmastery,30,16,14
Traenuss,azuremyst,968,hunter,beastmastery,48,19,29
Llamp,draenor,964,hunter,beastmastery,60,29,31
Dariatate,eredar,963,hunter,beastmastery,40,17,23
Торая,gordunni,960,hunter,beastmastery,12,10,2
Missmytrap,archimonde,960,hunter,beastmastery,12,10,2
Dathrixjr,ravencrest,960,hunter,beastmastery,12,10,2
Narolaf,doomhammer,960,hunter,beastmastery,15,11,4
Kásúxøxø,ravencrest,960,hunter,beastmastery,16,11,5
Akhtabot,twisting-nether,960,hunter,beastmastery,18,10,8
Hasáblover,ragnaros,960,hunter,beastmastery,18,10,8
Spergmeister,argent-dawn,960,hunter,beastmastery,18,10,8
Dealtqt,ysondre,960,hunter,beastmastery,18,10,8
Хантнерюга,gordunni,960,hunter,beastmastery,18,10,8
Filaliel,outland,960,hunter,beastmastery,18,10,8
Hahahxd,ragnaros,960,hunter,beastmastery,18,10,8
Vhalín,magtheridon,960,hunter,beastmastery,24,10,14
Jägarn,stormscale,960,hunter,beastmastery,24,10,14
Zeanort,nordrassil,960,hunter,beastmastery,24,10,14
Jackjager,ravencrest,960,hunter,beastmastery,24,10,14
Hollyz,auchindoun,960,hunter,beastmastery,24,10,14
Gitanìlla,dun-modr,960,hunter,beastmastery,30,10,20
Bubby,burning-legion,960,hunter,beastmastery,34,11,23
Mckanê,ysondre,959,hunter,beastmastery,18,10,8
Rashoumon,zuljin,959,hunter,beastmastery,18,10,8
Dragh,blackrock,959,hunter,beastmastery,18,10,8
Bempl,onyxia,959,hunter,beastmastery,24,10,14
Appollo,magtheridon,959,hunter,beastmastery,24,10,14
Ausgefuchst,forscherliga,959,hunter,beastmastery,24,10,14
Brmwall,twisting-nether,959,hunter,beastmastery,24,10,14
Svolatch,blackrock,959,hunter,beastmastery,30,10,20
Alée,twisting-nether,959,hunter,beastmastery,30,10,20
Rikitikii,burning-legion,958,hunter,beastmastery,15,11,4
Wüst,tarren-mill,958,hunter,beastmastery,18,10,8
Soblazed,twisting-nether,958,hunter,beastmastery,18,10,8
Shikar,sanguino,958,hunter,beastmastery,18,10,8
Blainehunts,arathor,958,hunter,beastmastery,36,11,25
Vescar,argent-dawn,958,hunter,beastmastery,36,10,26
Choukzt,archimonde,957,hunter,beastmastery,18,10,8
Therasin,ravenholdt,957,hunter,beastmastery,18,10,8
Nandrohunt,dalaran,957,hunter,beastmastery,24,10,14
Skipee,ravencrest,956,hunter,beastmastery,18,10,8
Vassiliadis,bronze-dragonflight,956,hunter,beastmastery,30,10,20
Blutack,stormscale,956,hunter,beastmastery,30,10,20
Pufyrella,kilrogg,955,hunter,beastmastery,18,10,8
Ahsóka,frostwhisper,955,hunter,beastmastery,18,10,8
Hílfíger,kazzak,955,hunter,beastmastery,30,10,20
Badhunt,stormscale,954,hunter,beastmastery,30,10,20
Herpray,blackmoore,953,hunter,beastmastery,18,10,8
Shantala,frostwolf,953,hunter,beastmastery,24,10,14
Soen,zuljin,953,hunter,beastmastery,24,10,14
Karên,blackmoore,952,hunter,beastmastery,24,10,14
Ecalter,dun-modr,951,hunter,beastmastery,18,10,8
Darkdexou,defias-brotherhood,951,hunter,beastmastery,18,10,8
Marleyson,uldum,951,hunter,beastmastery,24,10,14
Lioness,ahnqiraj,951,hunter,beastmastery,24,10,14
Misfîre,tarren-mill,950,hunter,beastmastery,18,10,8
Zappikhunter,silvermoon,950,hunter,beastmastery,24,10,14
Woöky,dalaran,948,hunter,beastmastery,26,16,10
Crittix,kiljaeden,948,hunter,beastmastery,24,10,14
Zarlena,tarren-mill,947,hunter,beastmastery,43,19,24
Bakatumbah,draenor,946,hunter,beastmastery,18,10,8
Cernunnos,auchindoun,944,hunter,beastmastery,19,10,9
Lemeric,blackmoore,942,hunter,beastmastery,19,10,9
Deadlysnîpe,antonidas,941,hunter,beastmastery,16,11,5
Грознострел,gordunni,939,hunter,beastmastery,32,17,15
Jaguarundy,dun-modr,939,hunter,beastmastery,24,10,14
Guanchin,silvermoon,938,hunter,beastmastery,30,10,20
Dioxis,silvermoon,932,hunter,beastmastery,118,57,61
Lore,hyjal,922,hunter,beastmastery,17,10,7
Nixxay,antonidas,920,hunter,beastmastery,42,22,20
Xyrone,bladefist,920,hunter,beastmastery,36,15,21
Goliathoz,blackmoore,917,hunter,beastmastery,35,19,16
Stjordal,chamber-of-aspects,917,hunter,beastmastery,63,30,33
Баззи,grom,916,hunter,beastmastery,30,16,14
Kronzucker,eredar,914,hunter,beastmastery,36,16,20
Graltar,tarren-mill,911,hunter,beastmastery,23,10,13
Allcollapse,outland,910,hunter,beastmastery,21,11,10
Rachelgg,ravencrest,910,hunter,beastmastery,22,10,12
Zorana,twisting-nether,910,hunter,beastmastery,23,10,13
Mankkis,stormscale,909,hunter,beastmastery,48,14,34
Vystrelil,drakthul,906,hunter,beastmastery,109,56,53
Happyrme,thrall,906,hunter,beastmastery,30,14,16
Bjarnhild,die-aldor,906,hunter,beastmastery,24,11,13
Delazi,proudmoore,905,hunter,beastmastery,30,11,19
Beeng,ravencrest,896,hunter,beastmastery,22,10,12
Zoomiesuwu,antonidas,895,hunter,beastmastery,17,10,7
Draknik,nemesis,895,hunter,beastmastery,39,10,29
Jagarbladet,ravencrest,894,hunter,beastmastery,16,10,6
Teacee,twisting-nether,894,hunter,beastmastery,29,13,16
Kënshiro,kazzak,893,hunter,beastmastery,20,10,10
Bornum,khaz-modan,892,hunter,beastmastery,31,10,21
Utopia,korgall,890,hunter,beastmastery,36,12,24
Catmother,grim-batol,886,hunter,beastmastery,20,12,8
Зоопсихолог,gordunni,886,hunter,beastmastery,36,18,18
Lakys,cthun,886,hunter,beastmastery,28,10,18
Akrepkral,kargath,881,hunter,beastmastery,55,26,29
Wodlenprince,draenor,874,hunter,beastmastery,66,14,52
Onlyforfun,ravencrest,864,hunter,beastmastery,12,9,3
Lilpancake,kazzak,864,hunter,beastmastery,12,9,3
Grapemint,blackrock,864,hunter,beastmastery,12,9,3
Тирин,ashenvale,864,hunter,beastmastery,12,9,3
Kapowz,kazzak,864,hunter,beastmastery,12,9,3
Hispanøxd,sanguino,864,hunter,beastmastery,12,9,3
Eenel,twisting-nether,864,hunter,beastmastery,12,9,3
Dwgkia,ravencrest,864,hunter,beastmastery,18,9,9
Tauriêl,blutkessel,864,hunter,beastmastery,18,9,9
Cryptomars,twisting-nether,864,hunter,beastmastery,18,9,9
Negz,eredar,864,hunter,beastmastery,18,9,9
Timec,outland,864,hunter,beastmastery,18,9,9
Lísy,hyjal,864,hunter,beastmastery,18,9,9
Weoneshot,ravencrest,864,hunter,beastmastery,18,9,9
Petitsui,zuljin,864,hunter,beastmastery,18,9,9
Dawil,ragnaros,864,hunter,beastmastery,18,9,9
Chipok,outland,864,hunter,beastmastery,29,11,18
Valhnir,sanguino,864,hunter,beastmastery,24,9,15
Zyrøra,ravencrest,864,hunter,beastmastery,24,9,15
Coôkie,ysondre,864,hunter,beastmastery,24,9,15
Леоа,howling-fjord,864,hunter,beastmastery,27,10,17
Elfyhunter,outland,864,hunter,beastmastery,30,9,21
Skeng,xavius,863,hunter,beastmastery,12,9,3
Srvol,dun-modr,863,hunter,beastmastery,12,9,3
Jahunter,aggra-português,863,hunter,beastmastery,18,9,9
Reshka,dunemaul,863,hunter,beastmastery,18,9,9
Лиор,howling-fjord,863,hunter,beastmastery,18,9,9
Aliltoxic,silvermoon,863,hunter,beastmastery,18,9,9
Fléxyz,sylvanas,863,hunter,beastmastery,18,9,9
Holdmypurse,kazzak,863,hunter,beastmastery,18,9,9
Кишмякхант,howling-fjord,863,hunter,beastmastery,18,9,9
Pavxar,draenor,863,hunter,beastmastery,18,9,9
Nillaxy,blackmoore,863,hunter,beastmastery,18,9,9
Lightcheese,twisting-nether,863,hunter,beastmastery,18,9,9
Wolfyx,cthun,863,hunter,beastmastery,18,9,9
Lännennopein,outland,863,hunter,beastmastery,23,11,12
Nettie,arathor,863,hunter,beastmastery,24,9,15
Krâven,ysondre,863,hunter,beastmastery,36,9,27
Massimox,draenor,862,hunter,beastmastery,12,9,3
Ecthelione,the-venture-co,862,hunter,beastmastery,18,9,9
Vyrê,ghostlands,862,hunter,beastmastery,18,9,9
Leáa,eredar,862,hunter,beastmastery,18,9,9
Arrowman,burning-legion,862,hunter,beastmastery,18,9,9
Aamön,tarren-mill,862,hunter,beastmastery,24,9,15
Buc,burning-legion,862,hunter,beastmastery,28,9,19
Hävenofün,archimonde,862,hunter,beastmastery,30,9,21
Tsivoula,twisting-nether,861,hunter,beastmastery,12,9,3
Xalh,hyjal,861,hunter,beastmastery,18,9,9
Measpy,blackrock,860,hunter,beastmastery,18,9,9
Скелус,soulflayer,859,hunter,beastmastery,18,9,9
Zalacko,ragnaros,859,hunter,beastmastery,18,9,9
Герциг,gordunni,859,hunter,beastmastery,18,9,9
Sylverein,silvermoon,859,hunter,beastmastery,25,9,16
Sokyokuh,burning-legion,858,hunter,beastmastery,18,9,9
Darilli,wildhammer,858,hunter,beastmastery,19,9,10
Tunhaa,arthas,858,hunter,beastmastery,28,11,17
Mindgap,pozzo-delleternità,858,hunter,beastmastery,24,9,15
Тысячиимен,gordunni,857,hunter,beastmastery,18,9,9
Бруксиан,fordragon,857,hunter,beastmastery,19,9,10
Sika,nozdormu,857,hunter,beastmastery,24,9,15
Сяову,gordunni,852,hunter,beastmastery,97,37,60
Towu,archimonde,849,hunter,beastmastery,24,9,15
Zinnady,outland,846,hunter,beastmastery,12,9,3
Greenstar,twisting-nether,846,hunter,beastmastery,27,10,17
Гоу,fordragon,843,hunter,beastmastery,30,9,21
Olddèath,archimonde,837,hunter,beastmastery,24,9,15
Zimmoo,tarren-mill,833,hunter,beastmastery,18,9,9
Venõm,pozzo-delleternità,832,hunter,beastmastery,21,11,10
Гримнар,borean-tundra,831,hunter,beastmastery,17,9,8
Jexxa,draenor,831,hunter,beastmastery,31,9,22
Enty,blackrock,830,hunter,beastmastery,14,10,4
Deathmarks,blackrock,830,hunter,beastmastery,29,9,20
Marlaska,exodar,829,hunter,beastmastery,57,27,30
Аквилеон,gordunni,829,hunter,beastmastery,23,9,14
Võnbødefeld,frostmourne,827,hunter,beastmastery,17,9,8
Poine,sylvanas,826,hunter,beastmastery,24,11,13
Oramar,archimonde,824,hunter,beastmastery,24,9,15
Angeedau,kazzak,815,hunter,beastmastery,17,9,8
Anoroxx,arthas,815,hunter,beastmastery,17,9,8
Шаурмэ,gordunni,815,hunter,beastmastery,21,9,12
Belgorin,alexstrasza,813,hunter,beastmastery,66,30,36
Insanepvper,argent-dawn,812,hunter,beastmastery,21,9,12
Kreiden,twisting-nether,810,hunter,beastmastery,34,11,23
Legosoldaten,stormscale,800,hunter,beastmastery,16,9,7
Colth,hyjal,799,hunter,beastmastery,29,9,20
Slaghunter,argent-dawn,798,hunter,beastmastery,17,9,8
Bnji,hyjal,797,hunter,beastmastery,22,9,13
Maglór,senjin,796,hunter,beastmastery,25,10,15
Melèxè,ysondre,795,hunter,beastmastery,29,9,20
Grokis,blackhand,782,hunter,beastmastery,67,28,39
Hecken,nemesis,768,hunter,beastmastery,12,8,4
Ebobuss,tarren-mill,768,hunter,beastmastery,12,8,4
Thebigboom,outland,768,hunter,beastmastery,12,8,4
Poggelicious,terenas,768,hunter,beastmastery,12,8,4
Mettämies,twisting-nether,768,hunter,beastmastery,12,8,4
Sejkxi,malganis,768,hunter,beastmastery,12,8,4
Suffrebobbs,ravencrest,768,hunter,beastmastery,12,8,4
Deadshøt,thrall,768,hunter,beastmastery,12,8,4
Híldir,draenor,768,hunter,beastmastery,12,8,4
Bonobo,dentarg,768,hunter,beastmastery,18,8,10
Baïonnettex,archimonde,768,hunter,beastmastery,18,8,10
Krâýnn,aegwynn,768,hunter,beastmastery,18,8,10
Páiz,tarren-mill,768,hunter,beastmastery,18,8,10
Ishotharambe,doomhammer,768,hunter,beastmastery,18,8,10
Utoast,ravencrest,768,hunter,beastmastery,18,8,10
Vasco,chogall,768,hunter,beastmastery,18,8,10
Leonidazar,draenor,768,hunter,beastmastery,18,8,10
Psymòn,ravencrest,768,hunter,beastmastery,18,8,10
Рафлекс,eversong,768,hunter,beastmastery,18,8,10
Freakyhoe,twisting-nether,768,hunter,beastmastery,18,8,10
Krakenaspect,kazzak,768,hunter,beastmastery,18,8,10
Кертион,howling-fjord,768,hunter,beastmastery,18,8,10
Pewpewstuff,draenor,768,hunter,beastmastery,18,8,10
Stuckstepbro,silvermoon,768,hunter,beastmastery,24,8,16
Джулибуба,howling-fjord,768,hunter,beastmastery,24,8,16
Craná,blackrock,768,hunter,beastmastery,24,8,16
Mogumogu,blackhand,768,hunter,beastmastery,24,8,16
Wayland,dalaran,768,hunter,beastmastery,24,8,16
Fridion,argent-dawn,768,hunter,beastmastery,24,8,16
Deepcleaning,kazzak,768,hunter,beastmastery,30,8,22
Hyunkies,ysondre,768,hunter,beastmastery,30,8,22
Huntyadaun,blackrock,767,hunter,beastmastery,12,8,4
Callmepapi,kazzak,767,hunter,beastmastery,12,8,4
Kuljaa,ravencrest,767,hunter,beastmastery,12,8,4
Awoe,blackrock,767,hunter,beastmastery,12,8,4
Loydzz,hyjal,767,hunter,beastmastery,12,8,4
Macabremoon,silvermoon,767,hunter,beastmastery,12,8,4
Арнесс,deepholm,767,hunter,beastmastery,15,9,6
Jónes,dunemaul,767,hunter,beastmastery,18,8,10
Blàdê,blackrock,767,hunter,beastmastery,18,8,10
Môrkh,sanguino,767,hunter,beastmastery,18,8,10
Deathwallker,silvermoon,767,hunter,beastmastery,18,8,10
Yayoo,cthun,767,hunter,beastmastery,24,8,16
Гунныч,grom,767,hunter,beastmastery,24,8,16
Шурикцаревич,galakrond,767,hunter,beastmastery,24,8,16
Loridana,tichondrius,767,hunter,beastmastery,24,8,16
Prodanhunts,frostmane,767,hunter,beastmastery,24,8,16
Имбакласс,howling-fjord,766,hunter,beastmastery,12,8,4
Sørha,chogall,766,hunter,beastmastery,12,8,4
Druvnik,zenedar,766,hunter,beastmastery,18,8,10
Miracleh,tarren-mill,766,hunter,beastmastery,18,8,10
Rdwlf,draenor,766,hunter,beastmastery,18,8,10
Birdseye,thrall,766,hunter,beastmastery,18,8,10
Msâka,blackrock,766,hunter,beastmastery,24,8,16
Aluara,burning-legion,766,hunter,beastmastery,24,8,16
Rickh,ravencrest,765,hunter,beastmastery,12,8,4
Fivebabe,tarren-mill,765,hunter,beastmastery,12,8,4
Лузановка,gordunni,765,hunter,beastmastery,18,8,10
Cxc,dun-modr,765,hunter,beastmastery,18,8,10
Marsian,lordaeron,765,hunter,beastmastery,19,8,11
Mykris,aegwynn,765,hunter,beastmastery,86,34,52
Джэромо,gordunni,765,hunter,beastmastery,24,8,16
Attiladagun,hellfire,765,hunter,beastmastery,24,8,16
Castbuny,drakthul,765,hunter,beastmastery,24,8,16
Tracrium,hyjal,764,hunter,beastmastery,30,8,22
Фаталлити,grom,763,hunter,beastmastery,12,8,4
Killzo,sylvanas,763,hunter,beastmastery,18,8,10
Laerya,les-clairvoyants,763,hunter,beastmastery,18,8,10
Eilnu,zuljin,763,hunter,beastmastery,35,8,27
Plong,argent-dawn,761,hunter,beastmastery,12,8,4
Boompuf,draenor,761,hunter,beastmastery,24,8,16
Orgasmatronn,stormscale,760,hunter,beastmastery,24,8,16
Vachekiki,archimonde,759,hunter,beastmastery,12,8,4
Auau,the-maelstrom,759,hunter,beastmastery,18,8,10
Bliss,senjin,756,hunter,beastmastery,12,8,4
Dravara,blackmoore,755,hunter,beastmastery,24,8,16
Sushimän,kaelthas,751,hunter,beastmastery,12,8,4
Lynx,garona,750,hunter,beastmastery,50,12,38
Begehunter,sylvanas,740,hunter,beastmastery,18,8,10
Remiss,sanguino,738,hunter,beastmastery,22,10,12
Kakopaikths,sylvanas,733,hunter,beastmastery,23,8,15
Адула,eversong,729,hunter,beastmastery,35,12,23
Пушкабомби,soulflayer,719,hunter,beastmastery,88,34,54
Oogyboogy,draenor,718,hunter,beastmastery,23,8,15
Drogostorm,steamwheedle-cartel,717,hunter,beastmastery,17,8,9
Kürze,silvermoon,712,hunter,beastmastery,22,10,12
Бей,gordunni,703,hunter,beastmastery,14,8,6
Zevlove,kazzak,703,hunter,beastmastery,20,8,12
Feyoonx,blackrock,703,hunter,beastmastery,23,9,14
Bláckheart,doomhammer,702,hunter,beastmastery,26,8,18
Kruk,blackhand,698,hunter,beastmastery,16,8,8
Huntbeard,aegwynn,695,hunter,beastmastery,22,8,14
Attileus,ragnaros,687,hunter,beastmastery,17,8,9
Elledrin,argent-dawn,680,hunter,beastmastery,21,11,10
Marcsman,blackrock,672,hunter,beastmastery,12,7,5
Lultrap,nemesis,672,hunter,beastmastery,12,7,5
Razuye,nerathor,672,hunter,beastmastery,12,7,5
Unreachable,dethecus,672,hunter,beastmastery,12,7,5
Bulletride,stormscale,672,hunter,beastmastery,12,7,5
Connyrøvøga,stormscale,672,hunter,beastmastery,12,7,5
Белатраиса,gordunni,672,hunter,beastmastery,12,7,5
Найтсол,greymane,672,hunter,beastmastery,12,7,5
Forthehordee,chamber-of-aspects,672,hunter,beastmastery,12,7,5
Lambikas,argent-dawn,672,hunter,beastmastery,12,7,5
Dåo,doomhammer,672,hunter,beastmastery,12,7,5
Potatobeast,twisting-nether,672,hunter,beastmastery,12,7,5
Knokkelmann,outland,672,hunter,beastmastery,12,7,5
Виралатта,gordunni,672,hunter,beastmastery,12,7,5
Ravis,aegwynn,672,hunter,beastmastery,12,7,5
Kioception,blackrock,672,hunter,beastmastery,12,7,5
Midist,stormscale,672,hunter,beastmastery,12,7,5
Onof,archimonde,672,hunter,beastmastery,12,7,5
Belaux,archimonde,672,hunter,beastmastery,12,7,5
Hunttes,nagrand,672,hunter,beastmastery,12,7,5
Сашказнаток,azuregos,672,hunter,beastmastery,12,7,5
Berenger,twisting-nether,672,hunter,beastmastery,12,7,5
Mspt,archimonde,672,hunter,beastmastery,12,7,5
Ufecläimbe,eredar,672,hunter,beastmastery,12,7,5
Загзигзаг,soulflayer,672,hunter,beastmastery,12,7,5
Whiskeylover,outland,672,hunter,beastmastery,12,7,5
Sazox,blackrock,672,hunter,beastmastery,12,7,5
Stamzer,drakthul,672,hunter,beastmastery,12,7,5
Nightvarn,burning-blade,672,hunter,beastmastery,12,7,5
Slougshot,archimonde,672,hunter,beastmastery,12,7,5
Zamx,outland,672,hunter,beastmastery,12,7,5
Exzö,outland,672,hunter,beastmastery,12,7,5
Slejpy,drakthul,672,hunter,beastmastery,12,7,5
Cajakekw,madmortem,672,hunter,beastmastery,12,7,5
Haxaids,sylvanas,672,hunter,beastmastery,12,7,5
Ahotnik,aegwynn,672,hunter,beastmastery,12,7,5
Flugsmälla,kazzak,672,hunter,beastmastery,12,7,5
Kissay,blackmoore,672,hunter,beastmastery,12,7,5
Hølinkasbabe,blackmoore,672,hunter,beastmastery,12,7,5
Beorind,frostwolf,672,hunter,beastmastery,12,7,5
Gødcømplêx,ravencrest,672,hunter,beastmastery,12,7,5
Isaîas,uldum,672,hunter,beastmastery,12,7,5
Hiddenxsabo,blackmoore,672,hunter,beastmastery,12,7,5
Alexdi,kazzak,672,hunter,beastmastery,12,7,5
Fôx,frostmane,672,hunter,beastmastery,12,7,5
Ulfrîc,exodar,672,hunter,beastmastery,12,7,5
Eisenhørn,archimonde,672,hunter,beastmastery,12,7,5
Expoh,blackmoore,672,hunter,beastmastery,13,7,6
Blmlooter,stormreaver,672,hunter,beastmastery,15,8,7
Frods,dun-modr,672,hunter,beastmastery,16,8,8
Fyô,outland,672,hunter,beastmastery,15,7,8
Hask,pozzo-delleternità,672,hunter,beastmastery,15,7,8
Bigramy,sanguino,672,hunter,beastmastery,18,7,11
Mårcxb,antonidas,672,hunter,beastmastery,18,7,11
Hunterstein,archimonde,672,hunter,beastmastery,18,7,11
Chïefhunt,twisting-nether,672,hunter,beastmastery,18,7,11
Graavi,silvermoon,672,hunter,beastmastery,18,7,11
Бранцо,howling-fjord,672,hunter,beastmastery,18,7,11
Boybiron,silvermoon,672,hunter,beastmastery,18,7,11
Дьярэ,gordunni,672,hunter,beastmastery,18,7,11
Düivell,grim-batol,672,hunter,beastmastery,18,7,11
Дэментед,soulflayer,672,hunter,beastmastery,18,7,11
Pilpetra,tarren-mill,672,hunter,beastmastery,18,7,11
Lurigalinda,twisting-nether,672,hunter,beastmastery,18,7,11
Géeked,ravencrest,672,hunter,beastmastery,18,7,11
Sauce,alonsus,672,hunter,beastmastery,18,7,11
Ромкола,gordunni,672,hunter,beastmastery,18,7,11
Тандеркейдж,gordunni,672,hunter,beastmastery,18,7,11
Zublime,dragonblight,672,hunter,beastmastery,18,7,11
Rachelzane,blackrock,672,hunter,beastmastery,18,7,11
Uselessx,kazzak,672,hunter,beastmastery,24,7,17
Setyouintrap,ravencrest,672,hunter,beastmastery,24,7,17
Ridbàck,archimonde,672,hunter,beastmastery,24,7,17
Летмимейт,howling-fjord,672,hunter,beastmastery,26,7,19
Akkonas,antonidas,671,hunter,beastmastery,12,7,5
Døømslayer,nemesis,671,hunter,beastmastery,12,7,5
Jaydogg,lightbringer,671,hunter,beastmastery,12,7,5
Aýsun,kazzak,671,hunter,beastmastery,12,7,5
Nakepw,stormscale,671,hunter,beastmastery,12,7,5
Nith,ungoro,671,hunter,beastmastery,12,7,5
Ashryqt,ravencrest,671,hunter,beastmastery,12,7,5
Mazekhin,khaz-modan,671,hunter,beastmastery,12,7,5
Бэталол,gordunni,671,hunter,beastmastery,12,7,5
Beaststeaks,thrall,671,hunter,beastmastery,12,7,5
Doubleoseven,frostmane,671,hunter,beastmastery,12,7,5
Strade,argent-dawn,671,hunter,beastmastery,12,7,5
Noaim,blackrock,671,hunter,beastmastery,12,7,5
Orian,argent-dawn,671,hunter,beastmastery,18,7,11
Блудитролль,soulflayer,671,hunter,beastmastery,18,7,11
Nîco,nathrezim,671,hunter,beastmastery,18,7,11
Rifle,dun-morogh,671,hunter,beastmastery,18,7,11
Aguerex,alleria,671,hunter,beastmastery,18,7,11
Dràcula,tarren-mill,671,hunter,beastmastery,18,7,11
Løløsifredo,ysondre,671,hunter,beastmastery,24,7,17
Tstigaard,argent-dawn,671,hunter,beastmastery,24,7,17
Hugart,sylvanas,670,hunter,beastmastery,12,7,5
Hoppelchen,blackmoore,670,hunter,beastmastery,12,7,5
Epheso,daggerspine,670,hunter,beastmastery,12,7,5
Хантмантхант,howling-fjord,670,hunter,beastmastery,12,7,5
Oneshotkill,laughing-skull,670,hunter,beastmastery,12,7,5
Kirky,terokkar,670,hunter,beastmastery,12,7,5
Paradisiaco,sanguino,670,hunter,beastmastery,24,7,17
Bobmàrley,frostwolf,670,hunter,beastmastery,24,7,17
Gladiátor,kult-der-verdammten,669,hunter,beastmastery,12,7,5
Sackboy,thrall,669,hunter,beastmastery,18,7,11
Qled,sylvanas,669,hunter,beastmastery,18,7,11
Darkhunt,ysondre,669,hunter,beastmastery,18,7,11
Casey,zuluhed,669,hunter,beastmastery,18,7,11
Nelerias,defias-brotherhood,669,hunter,beastmastery,24,7,17
Trollhunt,bloodscalp,668,hunter,beastmastery,18,7,11
Asharial,twisting-nether,668,hunter,beastmastery,21,8,13
Okumo,the-maelstrom,667,hunter,beastmastery,18,7,11
Bourrinax,kazzak,667,hunter,beastmastery,24,7,17
Rollei,uldum,666,hunter,beastmastery,12,7,5
Doômzi,ysondre,666,hunter,beastmastery,12,7,5
Chillarn,tarren-mill,666,hunter,beastmastery,23,7,16
Aroldo,kazzak,665,hunter,beastmastery,12,7,5
Саэсантессис,howling-fjord,665,hunter,beastmastery,18,7,11
Electrastar,illidan,664,hunter,beastmastery,12,7,5
Winfar,draenor,664,hunter,beastmastery,24,7,17
Барбарисовна,ashenvale,655,hunter,beastmastery,17,7,10
Akù,magtheridon,653,hunter,beastmastery,23,7,16
Toosmall,stormscale,638,hunter,beastmastery,16,7,9
Pennyflame,blackmoore,623,hunter,beastmastery,17,7,10
Grufflin,bronzebeard,620,hunter,beastmastery,17,7,10
Stukrotka,hellfire,617,hunter,beastmastery,15,7,8
Zwergnàse,thrall,616,hunter,beastmastery,23,7,16
Rezgor,stormscale,606,hunter,beastmastery,11,7,4
Хантетский,howling-fjord,604,hunter,beastmastery,14,7,7
Ôrly,outland,587,hunter,beastmastery,20,7,13
Luke,chromaggus,576,hunter,beastmastery,6,6,0
Келентори,gordunni,576,hunter,beastmastery,12,6,6
Мишечкатоп,gordunni,576,hunter,beastmastery,12,6,6
Ráptør,silvermoon,576,hunter,beastmastery,12,6,6
Zajebantip,sylvanas,576,hunter,beastmastery,12,6,6
Iuyiuy,dalaran,576,hunter,beastmastery,12,6,6
Стёпкахант,gordunni,576,hunter,beastmastery,12,6,6
Syveera,twisting-nether,576,hunter,beastmastery,12,6,6
Komesz,ragnaros,576,hunter,beastmastery,12,6,6
Niedzwiedzor,silvermoon,576,hunter,beastmastery,12,6,6
Xðxðxðxðxðxð,sylvanas,576,hunter,beastmastery,12,6,6
Burbutsuluki,silvermoon,576,hunter,beastmastery,12,6,6
Dunkelmut,arthas,576,hunter,beastmastery,12,6,6
Nomadest,silvermoon,576,hunter,beastmastery,12,6,6
Double,sylvanas,576,hunter,beastmastery,12,6,6
Kurtanâ,blackmoore,576,hunter,beastmastery,12,6,6
Boen,nordrassil,576,hunter,beastmastery,12,6,6
Gréènthumbs,ragnaros,576,hunter,beastmastery,12,6,6
Венкара,gordunni,576,hunter,beastmastery,12,6,6
Dtq,silvermoon,576,hunter,beastmastery,12,6,6
Razoorine,blackrock,576,hunter,beastmastery,12,6,6
Массовик,blackscar,576,hunter,beastmastery,12,6,6
Efficíent,auchindoun,576,hunter,beastmastery,12,6,6
Dorkos,sanguino,576,hunter,beastmastery,12,6,6
Magicnanø,nemesis,576,hunter,beastmastery,12,6,6
Logales,dragonblight,576,hunter,beastmastery,12,6,6
Skarra,zuljin,576,hunter,beastmastery,12,6,6
Raegal,sanguino,576,hunter,beastmastery,12,6,6
Cítyzens,drakthul,576,hunter,beastmastery,12,6,6
Metalbaci,sylvanas,576,hunter,beastmastery,12,6,6
Wödën,argent-dawn,576,hunter,beastmastery,12,6,6
Vu,shattered-hand,576,hunter,beastmastery,12,6,6
Gîsh,burning-legion,576,hunter,beastmastery,12,6,6
Arkelion,argent-dawn,576,hunter,beastmastery,12,6,6
Хаурос,soulflayer,576,hunter,beastmastery,12,6,6
Zæuz,outland,576,hunter,beastmastery,12,6,6
Fogknows,ravencrest,576,hunter,beastmastery,12,6,6
Kartantrax,culte-de-la-rive-noire,576,hunter,beastmastery,12,6,6
Flecheoeil,hyjal,576,hunter,beastmastery,12,6,6
Showdope,drakthul,576,hunter,beastmastery,12,6,6
Autopilot,aegwynn,576,hunter,beastmastery,12,6,6
Toptìérgoðx,drakthul,576,hunter,beastmastery,12,6,6
Guidomista,drakthul,576,hunter,beastmastery,12,6,6
Максиммужик,soulflayer,576,hunter,beastmastery,12,6,6
Lökout,twilights-hammer,576,hunter,beastmastery,12,6,6
Vepzen,haomarush,576,hunter,beastmastery,12,6,6
Therakal,culte-de-la-rive-noire,576,hunter,beastmastery,12,6,6
Darkstripe,turalyon,576,hunter,beastmastery,12,6,6
Batcool,tarren-mill,576,hunter,beastmastery,12,6,6
Bråndy,draenor,576,hunter,beastmastery,12,6,6
Poke,aggra-português,576,hunter,beastmastery,12,6,6
Haraigoshí,grim-batol,576,hunter,beastmastery,12,6,6
Flytomars,ravencrest,576,hunter,beastmastery,12,6,6
Nagu,antonidas,576,hunter,beastmastery,12,6,6
Zêrøtwø,draenor,576,hunter,beastmastery,12,6,6
Шмыгахант,gordunni,576,hunter,beastmastery,12,6,6
Зихантер,soulflayer,576,hunter,beastmastery,12,6,6
Ptithoms,hyjal,576,hunter,beastmastery,12,6,6
Зеленыйиисус,gordunni,576,hunter,beastmastery,12,6,6
Джарвиз,soulflayer,576,hunter,beastmastery,12,6,6
Steìn,ysondre,576,hunter,beastmastery,12,6,6
Дайсё,soulflayer,576,hunter,beastmastery,12,6,6
Astair,hyjal,576,hunter,beastmastery,12,6,6
Kaballa,ahnqiraj,576,hunter,beastmastery,12,6,6
Healscare,dalaran,576,hunter,beastmastery,16,7,9
Huntarbeît,eredar,576,hunter,beastmastery,18,6,12
Suisiide,antonidas,576,hunter,beastmastery,18,6,12
Xiaoly,kaelthas,576,hunter,beastmastery,18,6,12
Disyö,kazzak,576,hunter,beastmastery,18,6,12
Свадебная,gordunni,576,hunter,beastmastery,18,6,12
Кронн,howling-fjord,576,hunter,beastmastery,18,6,12
Azrhu,ravencrest,576,hunter,beastmastery,18,6,12
Матанал,gordunni,576,hunter,beastmastery,18,6,12
Realme,blackrock,576,hunter,beastmastery,18,6,12
Wetto,ravencrest,576,hunter,beastmastery,18,6,12
Exwifey,ravencrest,576,hunter,beastmastery,18,6,12
Ângell,kirin-tor,576,hunter,beastmastery,18,6,12
Jwah,tarren-mill,576,hunter,beastmastery,18,6,12
Сексишмекс,soulflayer,576,hunter,beastmastery,24,6,18
Mævis,ravencrest,576,hunter,beastmastery,24,6,18
Rheyl,dun-morogh,576,hunter,beastmastery,30,6,24
Труласек,blackscar,575,hunter,beastmastery,12,6,6
Deôrro,twisting-nether,575,hunter,beastmastery,12,6,6
Petfeelya,antonidas,575,hunter,beastmastery,12,6,6
Kairrux,twisting-nether,575,hunter,beastmastery,12,6,6
Robingood,alexstrasza,575,hunter,beastmastery,12,6,6
Абунай,soulflayer,575,hunter,beastmastery,12,6,6
Nosfuratu,stormscale,575,hunter,beastmastery,12,6,6
Blacksyo,elune,575,hunter,beastmastery,12,6,6
Ghanik,draenor,575,hunter,beastmastery,12,6,6
Truedetectiv,aggramar,575,hunter,beastmastery,12,6,6
Gløbi,malfurion,575,hunter,beastmastery,12,6,6
Splodge,kazzak,575,hunter,beastmastery,12,6,6
Haggy,die-nachtwache,575,hunter,beastmastery,12,6,6
Eyetto,dun-modr,575,hunter,beastmastery,12,6,6
Furian,der-rat-von-dalaran,575,hunter,beastmastery,12,6,6
Hunterizi,silvermoon,575,hunter,beastmastery,12,6,6
Bolgroth,balnazzar,575,hunter,beastmastery,12,6,6
Puska,gilneas,575,hunter,beastmastery,12,6,6
Krasavcik,shattrath,575,hunter,beastmastery,12,6,6
Iddqd,outland,575,hunter,beastmastery,12,6,6
Hitray,stormscale,575,hunter,beastmastery,18,6,12
Täpy,arathor,575,hunter,beastmastery,18,6,12
Ápêx,ravencrest,575,hunter,beastmastery,18,6,12
Quasar,arakarahm,575,hunter,beastmastery,24,6,18
Ketator,archimonde,574,hunter,beastmastery,12,6,6
Erenjaeger,onyxia,574,hunter,beastmastery,12,6,6
Kannon,twisting-nether,574,hunter,beastmastery,18,6,12
Mizumi,frostmane,574,hunter,beastmastery,18,6,12
Örrn,ragnaros,574,hunter,beastmastery,18,6,12
Penelopé,darkmoon-faire,573,hunter,beastmastery,12,6,6
Ranrôk,rexxar,573,hunter,beastmastery,12,6,6
Cliff,kiljaeden,572,hunter,beastmastery,30,6,24
Шейхант,gordunni,571,hunter,beastmastery,12,6,6
Glarco,eldrethalas,571,hunter,beastmastery,12,6,6
Jsâ,blackmoore,571,hunter,beastmastery,12,6,6
Ñava,dalaran,570,hunter,beastmastery,12,6,6
Corrwus,argent-dawn,570,hunter,beastmastery,18,6,12
Олькахант,galakrond,568,hunter,beastmastery,12,6,6
Zahgrug,aerie-peak,568,hunter,beastmastery,12,6,6
Bloodxx,ragnaros,568,hunter,beastmastery,18,6,12
Barzti,thrall,566,hunter,beastmastery,18,8,10
Marudô,aegwynn,559,hunter,beastmastery,17,6,11
Бэрими,gordunni,543,hunter,beastmastery,11,6,5
Dreemshoot,stormscale,542,hunter,beastmastery,11,6,5
Åånei,twisting-nether,528,hunter,beastmastery,15,6,9
Kukenisluken,stormscale,527,hunter,beastmastery,11,6,5
Dybhalsma,outland,527,hunter,beastmastery,11,6,5
Archfiend,stormscale,527,hunter,beastmastery,11,6,5
Braatski,stormscale,526,hunter,beastmastery,18,7,11
Kareltje,stormscale,521,hunter,beastmastery,13,7,6
Raxxic,eredar,512,hunter,beastmastery,10,6,4
Buzzle,sylvanas,512,hunter,beastmastery,22,6,16
Sacroz,frostwhisper,510,hunter,beastmastery,20,6,14
Nefroo,defias-brotherhood,505,hunter,beastmastery,11,6,5
Dogliz,stormscale,480,hunter,beastmastery,6,5,1
Gabbriel,ravencrest,480,hunter,beastmastery,6,5,1
Smokerofweed,kazzak,480,hunter,beastmastery,6,5,1
Sunyjuyono,ravencrest,480,hunter,beastmastery,6,5,1
Hidethegun,draenor,480,hunter,beastmastery,6,5,1
Connyrövöga,draenor,480,hunter,beastmastery,6,5,1
Huntourd,eredar,480,hunter,beastmastery,6,5,1
Jinxbomber,draenor,480,hunter,beastmastery,6,5,1
Wellocérapt,confrérie-du-thorium,480,hunter,beastmastery,6,5,1
Ветрослав,thermaplugg,480,hunter,beastmastery,6,5,1
Мунмейстер,blackscar,480,hunter,beastmastery,6,5,1
Tøkÿöghøül,ravencrest,480,hunter,beastmastery,7,5,2
Круперок,howling-fjord,480,hunter,beastmastery,12,5,7
Jins,illidan,480,hunter,beastmastery,12,5,7
Келкузд,howling-fjord,480,hunter,beastmastery,12,5,7
Вуйчеч,howling-fjord,480,hunter,beastmastery,12,5,7
Speartusk,blackhand,480,hunter,beastmastery,12,5,7
Eredark,zuljin,480,hunter,beastmastery,12,5,7
Bubbahubba,ragnaros,480,hunter,beastmastery,12,5,7
Makaxx,stormscale,480,hunter,beastmastery,12,5,7
Hiff,burning-legion,480,hunter,beastmastery,12,5,7
Bloodpanter,ragnaros,480,hunter,beastmastery,12,5,7
Waneìs,stormscale,480,hunter,beastmastery,12,5,7
Naposin,ragnaros,480,hunter,beastmastery,12,5,7
Crasharrow,stormscale,480,hunter,beastmastery,12,5,7
Stónéyyx,azjolnerub,480,hunter,beastmastery,12,5,7
Tizzlbang,ragnaros,480,hunter,beastmastery,12,5,7
Smecher,ravencrest,480,hunter,beastmastery,12,5,7
Trapyoubro,blackrock,480,hunter,beastmastery,12,5,7
Yamadorî,blackrock,480,hunter,beastmastery,12,5,7
Notley,thrall,480,hunter,beastmastery,12,5,7
Китас,soulflayer,480,hunter,beastmastery,12,5,7
Feelmyfurý,tarren-mill,480,hunter,beastmastery,12,5,7
Elvenian,twisting-nether,480,hunter,beastmastery,12,5,7
Dyve,antonidas,480,hunter,beastmastery,12,5,7
Palomo,argent-dawn,480,hunter,beastmastery,12,5,7
Bloodymarìe,kelthuzad,480,hunter,beastmastery,12,5,7
Sxmphxny,argent-dawn,480,hunter,beastmastery,12,5,7
Khort,twisting-nether,480,hunter,beastmastery,12,5,7
Jimbowjones,antonidas,480,hunter,beastmastery,12,5,7
Kanzlerkohl,frostwolf,480,hunter,beastmastery,12,5,7
Seviaz,draenor,480,hunter,beastmastery,12,5,7
Yésdave,stormscale,480,hunter,beastmastery,12,5,7
Mdmalol,malganis,480,hunter,beastmastery,12,5,7
Квит,blackscar,480,hunter,beastmastery,12,5,7
Quoicoubèh,hyjal,480,hunter,beastmastery,12,5,7
Orosko,archimonde,480,hunter,beastmastery,12,5,7
Джеймсфранко,blackscar,480,hunter,beastmastery,12,5,7
Trendsetterx,pozzo-delleternità,480,hunter,beastmastery,12,5,7
Juniorm,kazzak,480,hunter,beastmastery,12,5,7
Kaaj,nemesis,480,hunter,beastmastery,12,5,7
Sbegodx,hyjal,480,hunter,beastmastery,12,5,7
Темпеест,gordunni,480,hunter,beastmastery,12,5,7
Kongharald,ravencrest,480,hunter,beastmastery,12,5,7
Bojestemrudy,outland,480,hunter,beastmastery,12,5,7
Maxtozer,silvermoon,480,hunter,beastmastery,12,5,7
Стрелывалеры,gordunni,480,hunter,beastmastery,12,5,7
Elðer,dentarg,480,hunter,beastmastery,16,6,10
Lepap,arygos,480,hunter,beastmastery,17,5,12
Hêndricks,eredar,480,hunter,beastmastery,18,5,13
Chrishyh,blackrock,480,hunter,beastmastery,18,5,13
Begøne,draenor,480,hunter,beastmastery,18,5,13
Artexxia,kazzak,479,hunter,beastmastery,6,5,1
Jana,ragnaros,479,hunter,beastmastery,12,5,7
Swïtchz,hyjal,479,hunter,beastmastery,12,5,7
Djzntrap,outland,479,hunter,beastmastery,12,5,7
Droubidi,garona,479,hunter,beastmastery,12,5,7
Arhyah,medivh,479,hunter,beastmastery,12,5,7
Ninjaskillss,ravencrest,479,hunter,beastmastery,12,5,7
Latira,eonar,479,hunter,beastmastery,12,5,7
Ivanrockstar,draenor,479,hunter,beastmastery,12,5,7
Zercore,echsenkessel,479,hunter,beastmastery,12,5,7
Енвина,gordunni,479,hunter,beastmastery,12,5,7
Goethe,ravencrest,479,hunter,beastmastery,15,6,9
Nelthara,burning-blade,479,hunter,beastmastery,18,5,13
Arielowy,doomhammer,479,hunter,beastmastery,18,5,13
Talmïr,archimonde,479,hunter,beastmastery,18,5,13
Добрыйклыкач,gordunni,478,hunter,beastmastery,12,5,7
Kepâssa,ysondre,478,hunter,beastmastery,12,5,7
Oldrocker,sylvanas,478,hunter,beastmastery,18,5,13
Бодрыйсэм,soulflayer,477,hunter,beastmastery,12,5,7
Ghostaim,kazzak,475,hunter,beastmastery,10,6,4
Ahilleaa,aegwynn,472,hunter,beastmastery,12,5,7
Ferax,alleria,472,hunter,beastmastery,12,5,7
Aryaae,les-clairvoyants,472,hunter,beastmastery,13,5,8
Ruhen,aegwynn,463,hunter,beastmastery,11,5,6
Tiguy,archimonde,462,hunter,beastmastery,23,5,18
Momohenní,archimonde,448,hunter,beastmastery,10,5,5
Kabedon,drakthul,448,hunter,beastmastery,16,5,11
Bellecoq,arathi,447,hunter,beastmastery,11,5,6
Artemmis,tarren-mill,447,hunter,beastmastery,11,5,6
Anesa,lightbringer,446,hunter,beastmastery,15,6,9
Lovecjelenu,drakthul,431,hunter,beastmastery,11,5,6
Såvëâmäzøñíà,stormscale,431,hunter,beastmastery,11,5,6
Axg,burning-legion,429,hunter,beastmastery,15,6,9
Truxp,tarren-mill,416,hunter,beastmastery,10,5,5
Valamié,stormscale,415,hunter,beastmastery,8,5,3
Topbow,talnivarr,415,hunter,beastmastery,10,5,5
Darkshe,dun-modr,415,hunter,beastmastery,14,5,9
Elíonora,kazzak,400,hunter,beastmastery,7,5,2
Mórz,magtheridon,384,hunter,beastmastery,6,4,2
Xiviora,archimonde,384,hunter,beastmastery,6,4,2
Khregan,aerie-peak,384,hunter,beastmastery,6,4,2
Mestar,outland,384,hunter,beastmastery,6,4,2
Mothmanx,kazzak,384,hunter,beastmastery,6,4,2
Патапум,deathguard,384,hunter,beastmastery,6,4,2
Napa,kazzak,384,hunter,beastmastery,6,4,2
Garratha,burning-legion,384,hunter,beastmastery,6,4,2
Áñmy,ravencrest,384,hunter,beastmastery,6,4,2
Psychotik,dalaran,384,hunter,beastmastery,6,4,2
Bãldur,ravencrest,384,hunter,beastmastery,6,4,2
Разплюханка,howling-fjord,384,hunter,beastmastery,6,4,2
Arellia,blackmoore,384,hunter,beastmastery,6,4,2
Schwabbels,silvermoon,384,hunter,beastmastery,6,4,2
Wristflex,kazzak,384,hunter,beastmastery,6,4,2
Ксила,blackscar,384,hunter,beastmastery,6,4,2
Tidydarts,balnazzar,384,hunter,beastmastery,6,4,2
Zanéy,ravencrest,384,hunter,beastmastery,6,4,2
Galduhr,silvermoon,384,hunter,beastmastery,6,4,2
Cfueb,doomhammer,384,hunter,beastmastery,6,4,2
Zigi,grim-batol,384,hunter,beastmastery,6,4,2
Wolder,burning-legion,384,hunter,beastmastery,6,4,2
Вихтриэль,gordunni,384,hunter,beastmastery,6,4,2
Nomorepain,outland,384,hunter,beastmastery,6,4,2
Sindaro,kazzak,384,hunter,beastmastery,6,4,2
Missmytraps,stormscale,384,hunter,beastmastery,6,4,2
Hetzenauer,nathrezim,384,hunter,beastmastery,6,4,2
Vïcødïnë,sinstralis,384,hunter,beastmastery,6,4,2
Marksmaniak,ysondre,384,hunter,beastmastery,6,4,2
Djurmästaren,ravencrest,384,hunter,beastmastery,6,4,2
Stingarrow,stormscale,384,hunter,beastmastery,6,4,2
Nulldmgmaker,malganis,384,hunter,beastmastery,6,4,2
Béarrockx,alleria,384,hunter,beastmastery,6,4,2
Xndr,sanguino,384,hunter,beastmastery,6,4,2
Апельсинчес,howling-fjord,384,hunter,beastmastery,6,4,2
Fajitax,lightbringer,384,hunter,beastmastery,6,4,2
Oobe,hyjal,384,hunter,beastmastery,6,4,2
Thursty,twisting-nether,384,hunter,beastmastery,6,4,2
Dafragger,blackmoore,384,hunter,beastmastery,6,4,2
Tiratats,sylvanas,384,hunter,beastmastery,6,4,2
Ghõst,frostmane,384,hunter,beastmastery,6,4,2
Нью,soulflayer,384,hunter,beastmastery,6,4,2
Robbingyou,tarren-mill,384,hunter,beastmastery,6,4,2
Azzazeal,drakthul,384,hunter,beastmastery,6,4,2
Kurobi,kazzak,384,hunter,beastmastery,6,4,2
Zbyrkana,neptulon,384,hunter,beastmastery,6,4,2
Sín,kirin-tor,384,hunter,beastmastery,6,4,2
Chindaliña,zuljin,384,hunter,beastmastery,6,4,2
Dorkis,sanguino,384,hunter,beastmastery,6,4,2
Трисциллочка,howling-fjord,384,hunter,beastmastery,6,4,2
Riema,ragnaros,384,hunter,beastmastery,6,4,2
Kàisèr,shendralar,384,hunter,beastmastery,6,4,2
Кейдлер,gordunni,384,hunter,beastmastery,6,4,2
Varkiza,sylvanas,384,hunter,beastmastery,6,4,2
Матопопа,gordunni,384,hunter,beastmastery,6,4,2
Няшуличка,gordunni,384,hunter,beastmastery,6,4,2
Кайсго,gordunni,384,hunter,beastmastery,6,4,2
Machinedream,sylvanas,384,hunter,beastmastery,6,4,2
Jablaka,blackhand,384,hunter,beastmastery,6,4,2
Illaice,antonidas,384,hunter,beastmastery,6,4,2
Zyprix,blackrock,384,hunter,beastmastery,6,4,2
Thromkhar,sanguino,384,hunter,beastmastery,6,4,2
Silenthunter,blackrock,384,hunter,beastmastery,6,4,2
Ntguilty,blackrock,384,hunter,beastmastery,6,4,2
Celebor,sanguino,384,hunter,beastmastery,6,4,2
Nocturr,ragnaros,384,hunter,beastmastery,6,4,2
Murkek,drakthul,384,hunter,beastmastery,6,4,2
Quasarx,draenor,384,hunter,beastmastery,9,5,4
Valomeere,tarren-mill,384,hunter,beastmastery,12,4,8
Xavers,outland,384,hunter,beastmastery,12,4,8
Nßatrapper,outland,384,hunter,beastmastery,12,4,8
Elionora,kazzak,384,hunter,beastmastery,12,4,8
Brønkø,azshara,384,hunter,beastmastery,12,4,8
Zakert,zuljin,384,hunter,beastmastery,12,4,8
Catman,stormreaver,384,hunter,beastmastery,12,4,8
Вейзу,ashenvale,384,hunter,beastmastery,12,4,8
Sylphie,dalaran,384,hunter,beastmastery,12,4,8
Дэлмор,greymane,384,hunter,beastmastery,12,4,8
Кустурица,azuregos,384,hunter,beastmastery,12,4,8
Lexayah,twisting-nether,384,hunter,beastmastery,12,4,8
Sharpeneye,ragnaros,384,hunter,beastmastery,12,4,8
Marzenielas,silvermoon,384,hunter,beastmastery,12,4,8
Серцебиение,soulflayer,384,hunter,beastmastery,12,4,8
Sîriell,arthas,384,hunter,beastmastery,12,4,8
Mobshot,twisting-nether,384,hunter,beastmastery,12,4,8
Гернриета,gordunni,384,hunter,beastmastery,12,4,8
Pergola,spinebreaker,384,hunter,beastmastery,12,4,8
Zippyzen,twisting-nether,384,hunter,beastmastery,12,4,8
Monnee,outland,384,hunter,beastmastery,12,4,8
Malromero,outland,384,hunter,beastmastery,12,4,8
Tusibi,dalaran,384,hunter,beastmastery,12,4,8
Øï,outland,384,hunter,beastmastery,12,4,8
Horxxa,kul-tiras,384,hunter,beastmastery,12,4,8
Thérón,ravencrest,384,hunter,beastmastery,12,4,8
Aléxy,sanguino,384,hunter,beastmastery,12,4,8
Neocb,ravencrest,384,hunter,beastmastery,12,4,8
Tøixøna,tyrande,384,hunter,beastmastery,12,4,8
Killstreak,magtheridon,384,hunter,beastmastery,12,4,8
Sjufemman,ravencrest,384,hunter,beastmastery,12,4,8
Zynga,sylvanas,384,hunter,beastmastery,12,4,8
Thekev,ravencrest,384,hunter,beastmastery,12,4,8
Teddybeardo,stormscale,384,hunter,beastmastery,12,4,8
Penehuntos,eredar,384,hunter,beastmastery,12,4,8
Khyleanqt,dun-modr,384,hunter,beastmastery,12,4,8
Focùs,eredar,384,hunter,beastmastery,12,4,8
Staynador,turalyon,384,hunter,beastmastery,12,4,8
Navarro,nemesis,384,hunter,beastmastery,12,4,8
Rockshredder,ravencrest,384,hunter,beastmastery,12,4,8
Охотницагодх,borean-tundra,384,hunter,beastmastery,12,4,8
Dissectiøn,hyjal,384,hunter,beastmastery,12,4,8
Donbonz,blackmoore,384,hunter,beastmastery,12,4,8
Mógwaí,stormscale,384,hunter,beastmastery,12,4,8
Дланьгоспода,soulflayer,384,hunter,beastmastery,13,4,9
Mélovéa,sinstralis,384,hunter,beastmastery,18,4,14
Swargano,archimonde,384,hunter,beastmastery,18,4,14
Хедшоттер,blackscar,384,hunter,beastmastery,18,4,14
Tervueren,burning-blade,384,hunter,beastmastery,18,4,14
Bemtistaru,draenor,384,hunter,beastmastery,18,4,14
Kayvaal,kaelthas,384,hunter,beastmastery,18,4,14
Resonate,stormreaver,383,hunter,beastmastery,6,4,2
Whyareurunin,silvermoon,383,hunter,beastmastery,6,4,2
Xscaper,twilights-hammer,383,hunter,beastmastery,6,4,2
Jelezenchuk,outland,383,hunter,beastmastery,6,4,2
Bessa,skullcrusher,383,hunter,beastmastery,12,4,8
Doguago,draenor,383,hunter,beastmastery,12,4,8
Huntseeker,draenor,383,hunter,beastmastery,12,4,8
Lalluna,malganis,383,hunter,beastmastery,12,4,8
Machini,terokkar,383,hunter,beastmastery,17,4,13
Mugiwaras,eldrethalas,383,hunter,beastmastery,18,4,14
Hentt,burning-legion,382,hunter,beastmastery,12,4,8
Neuwi,stormreaver,382,hunter,beastmastery,12,4,8
Beerox,ysondre,382,hunter,beastmastery,12,4,8
Яугеныч,blackscar,381,hunter,beastmastery,12,4,8
Sanite,dun-morogh,381,hunter,beastmastery,12,4,8
Jolox,blackrock,379,hunter,beastmastery,12,4,8
Thelasiel,aerie-peak,379,hunter,beastmastery,14,4,10
Pîpî,blackrock,368,hunter,beastmastery,11,6,5
Zakos,kirin-tor,351,hunter,beastmastery,17,4,13
Jaszczomp,magtheridon,350,hunter,beastmastery,16,4,12
Harpers,kazzak,336,hunter,beastmastery,15,4,11
Dorollo,khaz-modan,332,hunter,beastmastery,11,4,7
Itzcritch,tarren-mill,330,hunter,beastmastery,14,5,9
Skyh,outland,330,hunter,beastmastery,16,5,11
Ozunâ,blackmoore,318,hunter,beastmastery,24,8,16
Greinktar,archimonde,317,hunter,beastmastery,10,4,6
Nastynutshot,stormscale,288,hunter,beastmastery,6,3,3
Taurïel,stormscale,288,hunter,beastmastery,6,3,3
Ileira,blackmoore,288,hunter,beastmastery,6,3,3
Renamexyz,blackmoore,288,hunter,beastmastery,6,3,3
Kondirox,twisting-nether,288,hunter,beastmastery,6,3,3
Shimzz,twisting-nether,288,hunter,beastmastery,6,3,3
Lofiel,aegwynn,288,hunter,beastmastery,6,3,3
Козладой,gordunni,288,hunter,beastmastery,6,3,3
Saîtek,chogall,288,hunter,beastmastery,6,3,3
Fangzahn,aegwynn,288,hunter,beastmastery,6,3,3
Sarnak,thrall,288,hunter,beastmastery,6,3,3
Akahr,thrall,288,hunter,beastmastery,6,3,3
Papisbae,stormscale,288,hunter,beastmastery,6,3,3
Arsola,sylvanas,288,hunter,beastmastery,6,3,3
Prurt,pozzo-delleternità,288,hunter,beastmastery,6,3,3
Shedzargo,twisting-nether,288,hunter,beastmastery,6,3,3
Боураш,gordunni,288,hunter,beastmastery,6,3,3
Varøsch,thrall,288,hunter,beastmastery,6,3,3
Стингергодх,gordunni,288,hunter,beastmastery,6,3,3
Kanwfulldmg,stormscale,288,hunter,beastmastery,6,3,3
Djtrapyasis,blackmoore,288,hunter,beastmastery,6,3,3
Kronkh,nemesis,288,hunter,beastmastery,6,3,3
Lioneli,sylvanas,288,hunter,beastmastery,6,3,3
Sebikh,ravencrest,288,hunter,beastmastery,6,3,3
Bârli,amanthul,288,hunter,beastmastery,6,3,3
Ekz,twisting-nether,288,hunter,beastmastery,6,3,3
Zoophobiaqt,silvermoon,288,hunter,beastmastery,6,3,3
Nizzoz,blackmoore,288,hunter,beastmastery,6,3,3
Kyudoka,sylvanas,288,hunter,beastmastery,6,3,3
Микихаса,galakrond,288,hunter,beastmastery,6,3,3
Кискавтесте,gordunni,288,hunter,beastmastery,6,3,3
Ванхогер,gordunni,288,hunter,beastmastery,6,3,3
Живучийорех,gordunni,288,hunter,beastmastery,6,3,3
Daela,elune,288,hunter,beastmastery,6,3,3
Salemenos,silvermoon,288,hunter,beastmastery,6,3,3
Люциферо,goldrinn,288,hunter,beastmastery,6,3,3
Whitehor,ragnaros,288,hunter,beastmastery,6,3,3
Anhur,blackmoore,288,hunter,beastmastery,6,3,3
Styxht,blackhand,288,hunter,beastmastery,6,3,3
Keyshu,die-aldor,288,hunter,beastmastery,6,3,3
Enthur,sylvanas,288,hunter,beastmastery,6,3,3
Hattorisama,ghostlands,288,hunter,beastmastery,6,3,3
Колтрэйнборз,blackscar,288,hunter,beastmastery,6,3,3
Hallem,karazhan,288,hunter,beastmastery,6,3,3
Nervetøxin,ravencrest,288,hunter,beastmastery,6,3,3
Humanoidorc,the-maelstrom,288,hunter,beastmastery,6,3,3
Mooj,malganis,288,hunter,beastmastery,6,3,3
Hinorist,ravencrest,288,hunter,beastmastery,6,3,3
Анастазис,soulflayer,288,hunter,beastmastery,6,3,3
Kragán,silvermoon,288,hunter,beastmastery,6,3,3
Артекриогг,soulflayer,288,hunter,beastmastery,6,3,3
Aimshot,ravencrest,288,hunter,beastmastery,6,3,3
Abonah,khaz-modan,288,hunter,beastmastery,6,3,3
Imonér,frostmane,288,hunter,beastmastery,6,3,3
Yümekø,khaz-modan,288,hunter,beastmastery,6,3,3
Crmov,silvermoon,288,hunter,beastmastery,6,3,3
Szrek,frostmane,288,hunter,beastmastery,6,3,3
Slett,twisting-nether,288,hunter,beastmastery,6,3,3
Пиворк,soulflayer,288,hunter,beastmastery,6,3,3
Elbatale,sylvanas,288,hunter,beastmastery,6,3,3
Трапавграунд,howling-fjord,288,hunter,beastmastery,6,3,3
Скукота,grom,288,hunter,beastmastery,6,3,3
Sakaryali,silvermoon,288,hunter,beastmastery,6,3,3
Доррети,howling-fjord,288,hunter,beastmastery,6,3,3
Katana,stormreaver,288,hunter,beastmastery,6,3,3
Наладдчик,howling-fjord,288,hunter,beastmastery,6,3,3
Шеннокс,howling-fjord,288,hunter,beastmastery,6,3,3
Scräppÿ,kazzak,288,hunter,beastmastery,6,3,3
Aldra,kelthuzad,288,hunter,beastmastery,6,3,3
Рофшор,gordunni,288,hunter,beastmastery,6,3,3
Lookmyezzy,ravencrest,288,hunter,beastmastery,6,3,3
Nihau,ravencrest,288,hunter,beastmastery,6,3,3
Демела,gordunni,288,hunter,beastmastery,6,3,3
Будкусломаю,grom,288,hunter,beastmastery,6,3,3
Оркос,deathweaver,288,hunter,beastmastery,6,3,3
Yssup,frostmane,288,hunter,beastmastery,6,3,3
Natchell,ysondre,288,hunter,beastmastery,6,3,3
Haeero,archimonde,288,hunter,beastmastery,6,3,3
Japuog,kazzak,288,hunter,beastmastery,6,3,3
Darkdrais,archimonde,288,hunter,beastmastery,6,3,3
Nathah,burning-legion,288,hunter,beastmastery,6,3,3
Eveo,antonidas,288,hunter,beastmastery,6,3,3
Shtooko,conseil-des-ombres,288,hunter,beastmastery,6,3,3
Kxx,kazzak,288,hunter,beastmastery,6,3,3
Katzchen,burning-legion,288,hunter,beastmastery,6,3,3
Megagloc,shadowsong,288,hunter,beastmastery,6,3,3
Bòw,antonidas,288,hunter,beastmastery,6,3,3
Zdravkomamic,kazzak,288,hunter,beastmastery,6,3,3
Weedonyhunt,hyjal,288,hunter,beastmastery,6,3,3
Bâng,zuljin,288,hunter,beastmastery,6,3,3
Bugspitz,outland,288,hunter,beastmastery,6,3,3
Taemper,azshara,288,hunter,beastmastery,6,3,3
Popofles,outland,288,hunter,beastmastery,6,3,3
Chasseeur,archimonde,288,hunter,beastmastery,6,3,3
Sugutor,malfurion,288,hunter,beastmastery,6,3,3
Hugechode,kazzak,288,hunter,beastmastery,6,3,3
Jimpage,eredar,288,hunter,beastmastery,6,3,3
Tukezz,outland,288,hunter,beastmastery,6,3,3
Visas,burning-legion,288,hunter,beastmastery,6,3,3
Ipad,cthun,288,hunter,beastmastery,6,3,3
Lowpital,hyjal,288,hunter,beastmastery,6,3,3
Ritmkesh,draenor,288,hunter,beastmastery,6,3,3
Birdwatcher,kazzak,288,hunter,beastmastery,6,3,3
Zamale,arakarahm,288,hunter,beastmastery,6,3,3
Skrag,outland,288,hunter,beastmastery,6,3,3
Yoey,tarren-mill,288,hunter,beastmastery,6,3,3
Chrønôs,archimonde,288,hunter,beastmastery,6,3,3
Anthorio,cthun,288,hunter,beastmastery,6,3,3
Barrybigtoe,tarren-mill,288,hunter,beastmastery,6,3,3
Heedbónger,tarren-mill,288,hunter,beastmastery,6,3,3
Stillflowi,draenor,288,hunter,beastmastery,6,3,3
Ragingdragon,turalyon,288,hunter,beastmastery,6,3,3
Natashä,area-52,288,hunter,beastmastery,6,3,3
Iliíilíiílíl,outland,288,hunter,beastmastery,6,3,3
Innaria,argent-dawn,288,hunter,beastmastery,6,3,3
Nestereo,zirkel-des-cenarius,288,hunter,beastmastery,6,3,3
Hexorn,ysondre,288,hunter,beastmastery,6,3,3
Artze,outland,288,hunter,beastmastery,6,3,3
Klèo,frostwhisper,288,hunter,beastmastery,6,3,3
Blazeblue,hyjal,288,hunter,beastmastery,6,3,3
Svinrbglol,arygos,288,hunter,beastmastery,6,3,3
Lûnelle,argent-dawn,288,hunter,beastmastery,6,3,3
Darthbow,outland,288,hunter,beastmastery,6,3,3
Beefchops,draenor,288,hunter,beastmastery,6,3,3
Huntness,kazzak,288,hunter,beastmastery,6,3,3
Ðøømsðay,sanguino,288,hunter,beastmastery,6,3,3
Anayhh,dun-modr,288,hunter,beastmastery,6,3,3
Valtondre,argent-dawn,288,hunter,beastmastery,6,3,3
Fedya,kazzak,288,hunter,beastmastery,6,3,3
Heavenknøws,dun-modr,288,hunter,beastmastery,9,4,5
Antisniper,kazzak,288,hunter,beastmastery,9,4,5
Хантероо,gordunni,288,hunter,beastmastery,8,3,5
Gzà,kazzak,288,hunter,beastmastery,12,3,9
Demónhunter,frostmane,288,hunter,beastmastery,12,3,9
Perkxd,stormscale,288,hunter,beastmastery,12,3,9
Headhunterzz,dun-modr,288,hunter,beastmastery,12,3,9
Ayaz,ravencrest,288,hunter,beastmastery,12,3,9
Ímpulsion,stormscale,288,hunter,beastmastery,12,3,9
Squidy,archimonde,288,hunter,beastmastery,12,3,9
Goosebite,ravencrest,288,hunter,beastmastery,12,3,9
Jamesbownd,ravencrest,288,hunter,beastmastery,12,3,9
Hante,ravencrest,288,hunter,beastmastery,12,3,9
Xoarqt,aegwynn,288,hunter,beastmastery,12,3,9
Krëmpai,frostmane,288,hunter,beastmastery,12,3,9
Götthunter,antonidas,288,hunter,beastmastery,12,3,9
Nerøz,ravencrest,288,hunter,beastmastery,12,3,9
Spakster,blackrock,288,hunter,beastmastery,12,3,9
Zárnah,defias-brotherhood,288,hunter,beastmastery,12,3,9
Sabnak,burning-blade,288,hunter,beastmastery,12,3,9
Liikes,arygos,288,hunter,beastmastery,12,3,9
Drherbs,bloodhoof,288,hunter,beastmastery,12,3,9
Rrushi,argent-dawn,288,hunter,beastmastery,12,3,9
Lagich,sylvanas,288,hunter,beastmastery,12,3,9
Shalinda,azshara,288,hunter,beastmastery,12,3,9
Andraz,burning-legion,288,hunter,beastmastery,12,3,9
Mark,runetotem,288,hunter,beastmastery,12,3,9
Riik,ragnaros,288,hunter,beastmastery,12,3,9
Drakess,daggerspine,288,hunter,beastmastery,12,3,9
Kalá,defias-brotherhood,288,hunter,beastmastery,12,3,9
Phillon,blackrock,288,hunter,beastmastery,12,3,9
Frikandelli,outland,288,hunter,beastmastery,12,3,9
Jellyfat,silvermoon,288,hunter,beastmastery,12,3,9
Marusmaskin,kazzak,288,hunter,beastmastery,12,3,9
Хансбург,howling-fjord,288,hunter,beastmastery,12,3,9
Huntardxx,outland,288,hunter,beastmastery,12,3,9
Narziel,die-todeskrallen,288,hunter,beastmastery,12,3,9
Drennak,kult-der-verdammten,288,hunter,beastmastery,12,3,9
Mârked,argent-dawn,288,hunter,beastmastery,12,3,9
Дварфмэн,gordunni,288,hunter,beastmastery,13,3,10
Tràpz,archimonde,288,hunter,beastmastery,14,3,11
Ohwagga,pozzo-delleternità,287,hunter,beastmastery,6,3,3
Zhazha,chamber-of-aspects,287,hunter,beastmastery,6,3,3
Топотелло,ashenvale,287,hunter,beastmastery,6,3,3
Voraxh,draenor,287,hunter,beastmastery,12,3,9
Asca,eldrethalas,287,hunter,beastmastery,12,3,9
Jazminluv,blackrock,287,hunter,beastmastery,12,3,9
Anghron,minahonda,287,hunter,beastmastery,12,3,9
Oatmeal,dun-morogh,287,hunter,beastmastery,12,3,9
Промахнулся,gordunni,287,hunter,beastmastery,12,3,9
Snehvit,bloodhoof,285,hunter,beastmastery,18,3,15
Trapgodz,ragnaros,271,hunter,beastmastery,11,3,8
Lightrandom,kazzak,269,hunter,beastmastery,11,3,8
Ватмано,gordunni,255,hunter,beastmastery,8,4,4
Huntercheese,ravencrest,255,hunter,beastmastery,11,3,8
Sarblade,bronze-dragonflight,255,hunter,beastmastery,11,3,8
Shoothim,destromath,254,hunter,beastmastery,8,4,4
Кулерквест,soulflayer,240,hunter,beastmastery,9,3,6
Huntinger,twisting-nether,234,hunter,beastmastery,10,5,5
Слышумертвых,gordunni,234,hunter,beastmastery,15,5,10
Snakepit,archimonde,234,hunter,beastmastery,17,4,13
Shagora,dalaran,223,hunter,beastmastery,8,3,5
Sarbacanes,hyjal,192,hunter,beastmastery,6,2,4
Waveshoot,hyjal,192,hunter,beastmastery,6,2,4
Zetaph,argent-dawn,192,hunter,beastmastery,6,2,4
Bodytypedog,ragnaros,192,hunter,beastmastery,6,2,4
Privelle,argent-dawn,192,hunter,beastmastery,6,2,4
Nerfit,argent-dawn,192,hunter,beastmastery,6,2,4
Kirinó,ragnaros,192,hunter,beastmastery,6,2,4
Jezaja,draenor,192,hunter,beastmastery,6,2,4
Holytrapqt,aegwynn,192,hunter,beastmastery,6,2,4
Pets,aegwynn,192,hunter,beastmastery,6,2,4
Phantoprowl,stormscale,192,hunter,beastmastery,6,2,4
Wülfhart,argent-dawn,192,hunter,beastmastery,6,2,4
Korrekt,stormscale,192,hunter,beastmastery,6,2,4
Hvaskøduenme,stormscale,192,hunter,beastmastery,6,2,4
Mufassa,sinstralis,192,hunter,beastmastery,6,2,4
Хароко,gordunni,192,hunter,beastmastery,6,2,4
Фломидзе,gordunni,192,hunter,beastmastery,6,2,4
Шимэйла,gordunni,192,hunter,beastmastery,6,2,4
Twirlylock,emerald-dream,192,hunter,beastmastery,6,2,4
Wolfmarko,ragnaros,192,hunter,beastmastery,6,2,4
Talanar,tarren-mill,192,hunter,beastmastery,6,2,4
Patrouifort,ysondre,192,hunter,beastmastery,6,2,4
Dentaar,draenor,192,hunter,beastmastery,6,2,4
Retropunk,ravencrest,192,hunter,beastmastery,6,2,4
Álfié,ravencrest,192,hunter,beastmastery,6,2,4
Avâlos,dentarg,192,hunter,beastmastery,6,2,4
Progh,ragnaros,192,hunter,beastmastery,6,2,4
Риперквин,gordunni,192,hunter,beastmastery,6,2,4
Sylasteria,twisting-nether,192,hunter,beastmastery,6,2,4
Willzz,ravencrest,192,hunter,beastmastery,6,2,4
Não,onyxia,192,hunter,beastmastery,6,2,4
Abraxan,twisting-nether,192,hunter,beastmastery,6,2,4
Gheezana,blackhand,192,hunter,beastmastery,6,2,4
Axams,archimonde,192,hunter,beastmastery,6,2,4
Starkt,ragnaros,192,hunter,beastmastery,6,2,4
Atylla,ravencrest,192,hunter,beastmastery,6,2,4
Luuszapfae,aegwynn,192,hunter,beastmastery,6,2,4
Wodhunterjr,ravencrest,192,hunter,beastmastery,6,2,4
Хихихихх,gordunni,192,hunter,beastmastery,6,2,4
Silencxz,aegwynn,192,hunter,beastmastery,6,2,4
Aliyaan,twisting-nether,192,hunter,beastmastery,6,2,4
Samodiva,twisting-nether,192,hunter,beastmastery,6,2,4
Ataxyjr,ravencrest,192,hunter,beastmastery,6,2,4
Díkembe,aegwynn,192,hunter,beastmastery,6,2,4
Вентрана,gordunni,192,hunter,beastmastery,6,2,4
Ядрис,gordunni,192,hunter,beastmastery,6,2,4
Bernhardoder,blackhand,192,hunter,beastmastery,6,2,4
Wolfariana,chamber-of-aspects,192,hunter,beastmastery,6,2,4
Sotu,stormscale,192,hunter,beastmastery,6,2,4
Фэйсконтроль,azuregos,192,hunter,beastmastery,6,2,4
Dis,twilights-hammer,192,hunter,beastmastery,6,2,4
Кукито,goldrinn,192,hunter,beastmastery,6,2,4
Спелла,goldrinn,192,hunter,beastmastery,6,2,4
Jarran,karazhan,192,hunter,beastmastery,6,2,4
Marryme,blackhand,192,hunter,beastmastery,6,2,4
Longblow,outland,192,hunter,beastmastery,6,2,4
Samasukë,grim-batol,192,hunter,beastmastery,6,2,4
Kabá,eredar,192,hunter,beastmastery,6,2,4
Генрах,soulflayer,192,hunter,beastmastery,6,2,4
Dogstrust,stormscale,192,hunter,beastmastery,6,2,4
Legolex,burning-blade,192,hunter,beastmastery,6,2,4
Ancalarion,tarren-mill,192,hunter,beastmastery,6,2,4
Vör,drakthul,192,hunter,beastmastery,6,2,4
Ренектон,soulflayer,192,hunter,beastmastery,6,2,4
Bethenny,draenor,192,hunter,beastmastery,6,2,4
Arykes,drakthul,192,hunter,beastmastery,6,2,4
Lágåta,outland,192,hunter,beastmastery,6,2,4
Варсор,soulflayer,192,hunter,beastmastery,6,2,4
Vorthrax,drakthul,192,hunter,beastmastery,6,2,4
Lifeiscool,drakthul,192,hunter,beastmastery,6,2,4
Bówyóurfácé,outland,192,hunter,beastmastery,6,2,4
Shademd,ahnqiraj,192,hunter,beastmastery,6,2,4
Jayyke,frostmane,192,hunter,beastmastery,6,2,4
Nómarak,drakthul,192,hunter,beastmastery,6,2,4
Elionora,grim-batol,192,hunter,beastmastery,6,2,4
Foleck,aegwynn,192,hunter,beastmastery,6,2,4
Xeragon,frostwolf,192,hunter,beastmastery,6,2,4
Brummel,frostwolf,192,hunter,beastmastery,6,2,4
Mecamoot,drekthar,192,hunter,beastmastery,6,2,4
Gukéx,stormscale,192,hunter,beastmastery,6,2,4
Snakepit,stormscale,192,hunter,beastmastery,6,2,4
Avp,sylvanas,192,hunter,beastmastery,6,2,4
Diabloiv,doomhammer,192,hunter,beastmastery,6,2,4
Scatterinc,antonidas,192,hunter,beastmastery,6,2,4
Nikzeubii,archimonde,192,hunter,beastmastery,6,2,4
Травок,gordunni,192,hunter,beastmastery,6,2,4
Níne,sylvanas,192,hunter,beastmastery,6,2,4
Bradunov,sylvanas,192,hunter,beastmastery,6,2,4
Aughtism,turalyon,192,hunter,beastmastery,6,2,4
Azahunt,kazzak,192,hunter,beastmastery,6,2,4
Elastaplast,thunderhorn,192,hunter,beastmastery,6,2,4
Sarganno,archimonde,192,hunter,beastmastery,6,2,4
Yakayoshi,kazzak,192,hunter,beastmastery,6,2,4
Bæbåk,frostmane,192,hunter,beastmastery,6,2,4
Comegetme,auchindoun,192,hunter,beastmastery,6,2,4
Sloter,stormscale,192,hunter,beastmastery,6,2,4
Dola,archimonde,192,hunter,beastmastery,6,2,4
Stronkbeast,kazzak,192,hunter,beastmastery,6,2,4
Thecorruptor,skullcrusher,192,hunter,beastmastery,6,2,4
Reiign,burning-legion,192,hunter,beastmastery,6,2,4
Dragoki,blackmoore,192,hunter,beastmastery,6,2,4
Scycs,nazjatar,192,hunter,beastmastery,6,2,4
Deskö,shendralar,192,hunter,beastmastery,6,2,4
Wildwingsebb,nazjatar,192,hunter,beastmastery,6,2,4
As,kazzak,192,hunter,beastmastery,6,2,4
Phyllobates,blackrock,192,hunter,beastmastery,6,2,4
Nythilia,blackrock,192,hunter,beastmastery,6,2,4
Fofoulinaki,silvermoon,192,hunter,beastmastery,6,2,4
Gandro,blackmoore,192,hunter,beastmastery,6,2,4
Gunmeister,bronzebeard,192,hunter,beastmastery,6,2,4
Crostaws,terokkar,192,hunter,beastmastery,6,2,4
Màdnéss,blackmoore,192,hunter,beastmastery,6,2,4
Dahunter,blackmoore,192,hunter,beastmastery,6,2,4
Droz,blackmoore,192,hunter,beastmastery,6,2,4
Myoui,silvermoon,192,hunter,beastmastery,6,2,4
Feedbackloop,silvermoon,192,hunter,beastmastery,6,2,4
Igotwatuneed,kazzak,192,hunter,beastmastery,6,2,4
Skalgor,thrall,192,hunter,beastmastery,6,2,4
Mâgnesium,blackmoore,192,hunter,beastmastery,6,2,4
Cøkø,sanguino,192,hunter,beastmastery,6,2,4
Doraxa,sanguino,192,hunter,beastmastery,6,2,4
Lersey,blackmoore,192,hunter,beastmastery,6,2,4
Maeba,shendralar,192,hunter,beastmastery,6,2,4
Miesmuschel,guldan,192,hunter,beastmastery,6,2,4
Naid,lordaeron,192,hunter,beastmastery,6,2,4
Annababygirl,silvermoon,192,hunter,beastmastery,6,2,4
Curtiss,sanguino,192,hunter,beastmastery,6,2,4
Raztreadör,dun-modr,192,hunter,beastmastery,6,2,4
Zulldek,sanguino,192,hunter,beastmastery,6,2,4
Жабра,gordunni,192,hunter,beastmastery,11,3,8
Куджикс,soulflayer,192,hunter,beastmastery,19,4,15
Elja,laughing-skull,192,hunter,beastmastery,12,2,10
Calesthas,tarren-mill,192,hunter,beastmastery,12,2,10
Rabyan,zuljin,192,hunter,beastmastery,12,2,10
Korneatza,twisting-nether,192,hunter,beastmastery,12,2,10
Ziday,sargeras,192,hunter,beastmastery,12,2,10
Swallowbaby,lothar,192,hunter,beastmastery,12,2,10
Tyronjr,tarren-mill,192,hunter,beastmastery,12,2,10
Willýs,ysondre,192,hunter,beastmastery,12,2,10
Jeddaj,stormscale,192,hunter,beastmastery,12,2,10
Pôîson,kazzak,192,hunter,beastmastery,12,2,10
Bloodking,madmortem,192,hunter,beastmastery,12,2,10
Biorson,silvermoon,192,hunter,beastmastery,12,2,10
Dorakor,ysondre,192,hunter,beastmastery,12,2,10
Schräubchen,antonidas,192,hunter,beastmastery,12,2,10
Waraëlle,dalaran,192,hunter,beastmastery,12,2,10
Фомкалол,howling-fjord,192,hunter,beastmastery,12,2,10
Psailaa,azjolnerub,192,hunter,beastmastery,12,2,10
Slayman,kazzak,192,hunter,beastmastery,18,2,16
Charlet,archimonde,191,hunter,beastmastery,6,2,4
Сливочкии,goldrinn,191,hunter,beastmastery,6,2,4
Traknard,confrérie-du-thorium,191,hunter,beastmastery,6,2,4
Uab,dun-morogh,191,hunter,beastmastery,12,2,10
Kizscamander,magtheridon,191,hunter,beastmastery,12,2,10
Masarusan,eredar,175,hunter,beastmastery,11,2,9
Eilosh,outland,160,hunter,beastmastery,10,2,8
Ripulianneli,stormscale,159,hunter,beastmastery,6,3,3
Rakmo,blackmoore,159,hunter,beastmastery,5,2,3
Guna,aggra-português,159,hunter,beastmastery,5,2,3
Dolwen,argent-dawn,159,hunter,beastmastery,5,2,3
Phinox,sanguino,159,hunter,beastmastery,11,2,9
Cadier,argent-dawn,144,hunter,beastmastery,3,3,0
Hakaîí,aegwynn,138,hunter,beastmastery,10,4,6
Tanteaab,blackmoore,138,hunter,beastmastery,11,4,7
Enîgmatîke,archimonde,138,hunter,beastmastery,9,3,6
Deathøfrats,ravencrest,128,hunter,beastmastery,4,2,2
Elnazar,archimonde,128,hunter,beastmastery,4,2,2
Иттириса,gordunni,128,hunter,beastmastery,4,2,2
Тауриэлль,soulflayer,126,hunter,beastmastery,21,7,14
Liscie,silvermoon,105,hunter,beastmastery,16,4,12
Anun,magtheridon,96,hunter,beastmastery,6,1,5
Furiouslao,eredar,96,hunter,beastmastery,6,1,5
Gurkans,aggramar,96,hunter,beastmastery,6,1,5
Jakuken,dun-modr,96,hunter,beastmastery,6,1,5
Hÿyrøk,ysondre,96,hunter,beastmastery,6,1,5
Rem,zuljin,96,hunter,beastmastery,6,1,5
Táráh,proudmoore,96,hunter,beastmastery,6,1,5
Дочьпескова,gordunni,96,hunter,beastmastery,6,1,5
Золларис,deathguard,96,hunter,beastmastery,6,1,5
Rîsas,draenor,96,hunter,beastmastery,6,1,5
Буреклык,gordunni,96,hunter,beastmastery,6,1,5
Nätzz,dun-modr,96,hunter,beastmastery,6,1,5
Opasan,nordrassil,96,hunter,beastmastery,6,1,5
Akkixz,antonidas,96,hunter,beastmastery,6,1,5
Zogzøg,draenor,96,hunter,beastmastery,6,1,5
Platano,hyjal,96,hunter,beastmastery,6,1,5
Buoma,kazzak,96,hunter,beastmastery,6,1,5
Zulô,rexxar,96,hunter,beastmastery,6,1,5
Baldazr,shadowsong,96,hunter,beastmastery,6,1,5
Steez,hyjal,96,hunter,beastmastery,6,1,5
Derhùnethàl,hyjal,96,hunter,beastmastery,6,1,5
Furheious,archimonde,96,hunter,beastmastery,6,1,5
Billythree,argent-dawn,96,hunter,beastmastery,6,1,5
Bobletty,tarren-mill,96,hunter,beastmastery,6,1,5
Hairyplottér,kazzak,96,hunter,beastmastery,6,1,5
Wórldz,dun-modr,96,hunter,beastmastery,6,1,5
Imahuntard,frostmane,96,hunter,beastmastery,6,1,5
Zergst,nathrezim,96,hunter,beastmastery,6,1,5
Fakepvper,darksorrow,96,hunter,beastmastery,6,1,5
Odenssbest,silvermoon,96,hunter,beastmastery,6,1,5
Teedfredd,tarren-mill,96,hunter,beastmastery,6,1,5
Valiriz,blackmoore,96,hunter,beastmastery,6,1,5
Jâyranger,ravencrest,96,hunter,beastmastery,6,1,5
Bensoussan,archimonde,96,hunter,beastmastery,6,1,5
Nomorex,frostwhisper,96,hunter,beastmastery,6,1,5
Fizí,stormscale,96,hunter,beastmastery,6,1,5
Syjinny,kazzak,96,hunter,beastmastery,6,1,5
Zugzlug,tarren-mill,96,hunter,beastmastery,6,1,5
Sokrám,sanguino,96,hunter,beastmastery,6,1,5
Foxhunt,turalyon,96,hunter,beastmastery,6,1,5
Weafster,outland,96,hunter,beastmastery,6,1,5
Nicoh,elune,96,hunter,beastmastery,6,1,5
Chambiann,tarren-mill,96,hunter,beastmastery,6,1,5
Betarayjinx,kazzak,96,hunter,beastmastery,6,1,5
Hashaya,hyjal,96,hunter,beastmastery,6,1,5
Rayana,garrosh,96,hunter,beastmastery,6,1,5
Ventaric,pozzo-delleternità,96,hunter,beastmastery,6,1,5
Shadowmiz,shattered-hand,96,hunter,beastmastery,6,1,5
Bloodfallen,onyxia,96,hunter,beastmastery,6,1,5
Oou,auchindoun,96,hunter,beastmastery,6,1,5
Øô,blackrock,96,hunter,beastmastery,6,1,5
Clownchef,blackhand,96,hunter,beastmastery,6,1,5
Anhyzer,nemesis,96,hunter,beastmastery,6,1,5
Justchill,ravencrest,96,hunter,beastmastery,6,1,5
Drolarin,zuljin,96,hunter,beastmastery,6,1,5
Сочнаятурель,howling-fjord,96,hunter,beastmastery,6,1,5
Hechozar,kazzak,96,hunter,beastmastery,6,1,5
Ichbringbier,blackrock,96,hunter,beastmastery,6,1,5
Zurzok,blackrock,96,hunter,beastmastery,6,1,5
Женистайл,howling-fjord,96,hunter,beastmastery,6,1,5
Exorbitant,blackrock,96,hunter,beastmastery,6,1,5
Пиппиракон,soulflayer,96,hunter,beastmastery,6,1,5
Beastmaster,ragnaros,96,hunter,beastmastery,6,1,5
Jozsiur,ragnaros,96,hunter,beastmastery,6,1,5
Traptard,blackrock,96,hunter,beastmastery,6,1,5
Jägerjokke,blackrock,96,hunter,beastmastery,6,1,5
Grigur,dalaran,96,hunter,beastmastery,6,1,5
Hntudwn,azshara,96,hunter,beastmastery,6,1,5
Травмаопасен,gordunni,96,hunter,beastmastery,6,1,5
Dasmusdrückn,antonidas,96,hunter,beastmastery,6,1,5
Darkray,dalaran,96,hunter,beastmastery,6,1,5
Runescimmy,twisting-nether,96,hunter,beastmastery,6,1,5
Trollohunt,twisting-nether,96,hunter,beastmastery,6,1,5
Noxll,gorgonnash,96,hunter,beastmastery,6,1,5
Achiles,die-todeskrallen,96,hunter,beastmastery,6,1,5
Левери,gordunni,96,hunter,beastmastery,6,1,5
Bobtroll,twisting-nether,96,hunter,beastmastery,6,1,5
Эннабонни,gordunni,96,hunter,beastmastery,6,1,5
Arthass,die-aldor,96,hunter,beastmastery,12,1,11
Jamaro,dun-modr,96,hunter,beastmastery,12,1,11
Schmaikell,blackmoore,96,hunter,beastmastery,12,1,11
Tsyapka,tarren-mill,96,hunter,beastmastery,12,1,11
Thóorin,ravencrest,96,hunter,beastmastery,12,1,11
Лиасон,howling-fjord,96,hunter,beastmastery,12,1,11
Johnnygnus,drakthul,96,hunter,beastmastery,12,1,11
Сыньйорита,howling-fjord,96,hunter,beastmastery,12,1,11
Døgtamer,twisting-nether,96,hunter,beastmastery,12,1,11
Críted,blackmoore,96,hunter,beastmastery,12,1,11
Vandathien,stormrage,96,hunter,beastmastery,12,1,11
Milandria,antonidas,96,hunter,beastmastery,18,1,17
Халфен,eversong,79,hunter,beastmastery,5,1,4
Franzfuchs,blackmoore,79,hunter,beastmastery,5,1,4
Quiarà,elune,64,hunter,beastmastery,4,1,3
Bmilfhunter,blackhand,64,hunter,beastmastery,4,1,3
Yahamenistos,ysondre,64,hunter,beastmastery,4,1,3
Youngjinh,ravencrest,64,hunter,beastmastery,4,1,3
Acuatropatas,sanguino,64,hunter,beastmastery,4,1,3
Illnysa,silvermoon,48,hunter,beastmastery,3,1,2
Графруру,soulflayer,48,hunter,beastmastery,3,1,2
Voldtzeig,dentarg,42,hunter,beastmastery,13,4,9
Рэттс,soulflayer,31,hunter,beastmastery,2,1,1
Martuk,aegwynn,31,hunter,beastmastery,2,1,1
Котюнечка,gordunni,31,hunter,beastmastery,2,1,1
Melloy,drakthul,31,hunter,beastmastery,2,1,1
Soulflyer,draenor,16,hunter,beastmastery,1,1,0
Random,sylvanas,16,hunter,beastmastery,1,1,0
Gwaan,outland,9,hunter,beastmastery,6,2,4
Aleç,ravencrest,1971,mage,arcane,66,33,33
Cubis,archimonde,1952,mage,arcane,66,34,32
Boogeymanx,ravencrest,1940,mage,arcane,71,42,29
Aleteia,stormscale,1917,mage,arcane,76,38,38
Magegôd,outland,1910,mage,arcane,75,39,36
Макотшельник,gordunni,1881,mage,arcane,30,23,7
Choll,stormscale,1866,mage,arcane,30,20,10
Wàneís,ravencrest,1843,mage,arcane,78,38,40
Castorcato,kazzak,1841,mage,arcane,60,34,26
Фоулли,howling-fjord,1829,mage,arcane,66,31,35
Obbcontrol,ravencrest,1820,mage,arcane,84,45,39
Tokerlol,stormscale,1811,mage,arcane,221,122,99
Belthesad,twisting-nether,1806,mage,arcane,62,42,20
Lemaroxd,draenor,1801,mage,arcane,59,33,26
Ephreaym,stormscale,1787,mage,arcane,83,39,44
Bebenm,archimonde,1762,mage,arcane,105,47,58
Wracrz,argent-dawn,1761,mage,arcane,96,55,41
Папущенный,soulflayer,1749,mage,arcane,91,48,43
Нефростмаг,gordunni,1743,mage,arcane,192,96,96
Ecovation,tarren-mill,1731,mage,arcane,121,68,53
Frostseeker,tarren-mill,1731,mage,arcane,54,30,24
Derett,stormscale,1725,mage,arcane,48,22,26
Raíku,ravencrest,1723,mage,arcane,30,18,12
Непутевыймаг,gordunni,1715,mage,arcane,24,23,1
Waterhagx,tarren-mill,1712,mage,arcane,29,20,9
Mercem,stormscale,1711,mage,arcane,30,21,9
Persi,dentarg,1702,mage,arcane,192,97,95
Sallesauruus,outland,1700,mage,arcane,107,54,53
Shirrunn,the-maelstrom,1687,mage,arcane,38,19,19
Burstology,kazzak,1683,mage,arcane,167,87,80
Dardíe,ravencrest,1681,mage,arcane,54,31,23
Shiranize,aegwynn,1676,mage,arcane,70,35,35
Fearbeäch,ravencrest,1666,mage,arcane,52,25,27
Dárdie,ravencrest,1662,mage,arcane,40,21,19
Radagulf,outland,1659,mage,arcane,127,63,64
Astrryy,burning-legion,1650,mage,arcane,41,19,22
Covran,stormscale,1650,mage,arcane,65,29,36
Uknowhowwedu,blackrock,1649,mage,arcane,36,22,14
Magijoana,silvermoon,1629,mage,arcane,32,18,14
Nvpk,blackrock,1628,mage,arcane,48,24,24
Alustrasz,skullcrusher,1627,mage,arcane,111,60,51
Проблембойх,gordunni,1627,mage,arcane,36,17,19
Sérc,ravencrest,1626,mage,arcane,30,17,13
Barbeuqx,garona,1623,mage,arcane,108,59,49
Медивера,gordunni,1622,mage,arcane,24,17,7
Orkamor,sylvanas,1622,mage,arcane,42,17,25
Сизаам,howling-fjord,1608,mage,arcane,41,21,20
Absie,tarren-mill,1603,mage,arcane,72,47,25
Бигдикмаг,soulflayer,1590,mage,arcane,35,17,18
Antaos,drakthul,1553,mage,arcane,66,41,25
Димаскунфу,howling-fjord,1534,mage,arcane,52,21,31
Манкай,fordragon,1520,mage,arcane,248,131,117
Poochmage,archimonde,1516,mage,arcane,66,31,35
Nelg,silvermoon,1506,mage,arcane,60,35,25
Ekron,sanguino,1496,mage,arcane,385,195,190
Råståfåri,uldum,1490,mage,arcane,107,60,47
Nakamura,outland,1486,mage,arcane,344,171,173
Samirra,stormscale,1485,mage,arcane,60,32,28
Vxvfrowstxvx,jaedenar,1471,mage,arcane,30,17,13
Magikere,tarren-mill,1456,mage,arcane,125,76,49
Akâri,silvermoon,1450,mage,arcane,71,44,27
Portal,scarshield-legion,1446,mage,arcane,48,27,21
Шттрвблнкт,soulflayer,1443,mage,arcane,103,48,55
Ímnotback,outland,1440,mage,arcane,52,24,28
Tiqma,sylvanas,1434,mage,arcane,36,15,21
Ogarcanefist,outland,1424,mage,arcane,69,35,34
Leanboy,dun-modr,1418,mage,arcane,30,16,14
Раканчик,gordunni,1406,mage,arcane,86,42,44
Sukalamink,alonsus,1405,mage,arcane,48,22,26
Lusionator,defias-brotherhood,1394,mage,arcane,54,31,23
Másterdukè,silvermoon,1387,mage,arcane,48,19,29
Sapien,sanguino,1373,mage,arcane,64,27,37
Barspin,lightnings-blade,1368,mage,arcane,102,54,48
Elor,eredar,1361,mage,arcane,39,20,19
Azuredragon,tarren-mill,1361,mage,arcane,61,30,31
Ðøæø,twisting-nether,1346,mage,arcane,93,46,47
Tnhigh,blackrock,1343,mage,arcane,57,31,26
Рбгпотаскуха,gordunni,1337,mage,arcane,18,14,4
Trucy,eredar,1332,mage,arcane,162,76,86
Diper,burning-legion,1328,mage,arcane,36,15,21
Fadi,anachronos,1325,mage,arcane,30,14,16
Aloxigozal,shendralar,1320,mage,arcane,18,14,4
Jhawkwizard,draenor,1314,mage,arcane,274,138,136
Krykz,sanguino,1308,mage,arcane,54,22,32
Hâplo,burning-legion,1307,mage,arcane,30,18,12
Arkeus,turalyon,1305,mage,arcane,41,26,15
Paradigma,sylvanas,1305,mage,arcane,30,14,16
Faxchungus,argent-dawn,1304,mage,arcane,24,16,8
Весиал,deathguard,1304,mage,arcane,77,42,35
Даанрен,galakrond,1301,mage,arcane,36,14,22
Манаманна,gordunni,1300,mage,arcane,382,192,190
Валбериса,deepholm,1298,mage,arcane,60,39,21
Wolftemper,ravencrest,1296,mage,arcane,42,19,23
Nefrendel,kazzak,1292,mage,arcane,86,42,44
Mäalaka,archimonde,1289,mage,arcane,42,16,26
Pradapimp,ravencrest,1286,mage,arcane,32,15,17
Nimdáá,stormscale,1286,mage,arcane,54,24,30
Venchimage,silvermoon,1284,mage,arcane,62,26,36
Nïo,ravencrest,1283,mage,arcane,104,44,60
Estelliên,burning-legion,1273,mage,arcane,27,14,13
Sadrã,kazzak,1247,mage,arcane,69,30,39
Яшабурстх,blackscar,1246,mage,arcane,30,13,17
Нормалмап,soulflayer,1243,mage,arcane,54,21,33
Meolchum,outland,1237,mage,arcane,45,22,23
Nécrømage,confrérie-du-thorium,1235,mage,arcane,18,13,5
Léa,rashgarroth,1235,mage,arcane,48,21,27
Scaleeth,kazzak,1233,mage,arcane,30,13,17
Moxine,la-croisade-écarlate,1230,mage,arcane,59,26,33
Rezre,stormscale,1212,mage,arcane,60,31,29
Kazeen,silvermoon,1211,mage,arcane,82,45,37
Noarcane,twisting-nether,1209,mage,arcane,93,54,39
Tokyodes,twisting-nether,1206,mage,arcane,85,37,48
Канеллис,howling-fjord,1197,mage,arcane,37,14,23
Hruon,ravenholdt,1195,mage,arcane,30,14,16
Bananflickan,kazzak,1189,mage,arcane,96,53,43
Ozdewish,hyjal,1183,mage,arcane,118,55,63
Xiaomofashi,quelthalas,1166,mage,arcane,120,58,62
Scaless,stormscale,1157,mage,arcane,52,19,33
Demizboub,archimonde,1154,mage,arcane,168,85,83
Knúbbz,ravencrest,1147,mage,arcane,36,12,24
Sszz,ravencrest,1145,mage,arcane,145,76,69
Vaelwin,argent-dawn,1145,mage,arcane,42,21,21
Minglul,archimonde,1142,mage,arcane,18,12,6
Айсъмэджик,azuregos,1128,mage,arcane,36,14,22
Gorn,ravencrest,1123,mage,arcane,36,21,15
Kobrass,spinebreaker,1111,mage,arcane,36,12,24
Hardways,archimonde,1109,mage,arcane,153,67,86
Burnqq,twisting-nether,1101,mage,arcane,77,37,40
Säga,the-venture-co,1101,mage,arcane,70,29,41
Romethito,dun-modr,1089,mage,arcane,41,15,26
Sulteaxion,garrosh,1085,mage,arcane,24,12,12
Nelfchewer,ravencrest,1068,mage,arcane,23,12,11
Fôôxy,aegwynn,1059,mage,arcane,36,16,20
Angryalways,stormscale,1054,mage,arcane,18,11,7
Bullegong,archimonde,1052,mage,arcane,24,11,13
Soulraider,tarren-mill,1050,mage,arcane,24,11,13
Roulettefar,kazzak,1038,mage,arcane,24,11,13
Plor,exodar,1019,mage,arcane,26,13,13
Iwannakissu,gorgonnash,1009,mage,arcane,41,21,20
Roughfked,silvermoon,1002,mage,arcane,53,31,22
Mylord,bronze-dragonflight,993,mage,arcane,53,21,32
Дантрий,gordunni,985,mage,arcane,30,16,14
Кронни,razuvious,979,mage,arcane,23,11,12
Banjó,twilights-hammer,959,mage,arcane,12,10,2
Arcticfury,ravencrest,959,mage,arcane,18,10,8
Magiwan,silvermoon,959,mage,arcane,30,10,20
Иссэя,borean-tundra,954,mage,arcane,37,21,16
Чобон,soulflayer,952,mage,arcane,30,10,20
Дырявка,galakrond,949,mage,arcane,30,10,20
Zezt,tarren-mill,939,mage,arcane,30,10,20
Malshash,outland,937,mage,arcane,18,10,8
Syltris,drakthul,930,mage,arcane,48,19,29
Frostdeath,medivh,906,mage,arcane,24,10,14
Mannenye,stormscale,899,mage,arcane,30,11,19
Исусина,borean-tundra,877,mage,arcane,23,11,12
Вадимодесса,soulflayer,877,mage,arcane,61,28,33
Puni,emerald-dream,864,mage,arcane,12,9,3
Fuhry,tarren-mill,864,mage,arcane,12,9,3
Uknowhowwedu,aegwynn,864,mage,arcane,12,9,3
Techies,archimonde,863,mage,arcane,12,9,3
Letsa,stormscale,863,mage,arcane,12,9,3
Gnarrly,tarren-mill,863,mage,arcane,15,9,6
Arcann,ravencrest,863,mage,arcane,18,9,9
Superduck,ragnaros,863,mage,arcane,24,9,15
Сморгонец,gordunni,856,mage,arcane,26,11,15
Kaevelin,argent-dawn,852,mage,arcane,24,9,15
Beardmorph,auchindoun,842,mage,arcane,23,9,14
Merlïne,les-clairvoyants,838,mage,arcane,72,31,41
Modjahead,tarren-mill,822,mage,arcane,29,9,20
Mageé,argent-dawn,807,mage,arcane,23,9,14
Neséri,blackmoore,800,mage,arcane,22,9,13
Zimbabweborc,burning-legion,768,mage,arcane,12,8,4
Sÿmera,dun-modr,768,mage,arcane,18,8,10
Jayhó,outland,767,mage,arcane,12,8,4
Aristarco,outland,767,mage,arcane,18,8,10
Zehnvonzehn,antonidas,767,mage,arcane,18,8,10
Aeghis,darkspear,765,mage,arcane,18,8,10
Angélique,ragnaros,763,mage,arcane,24,8,16
Diaflash,silvermoon,752,mage,arcane,41,15,26
Sticlachivas,stormscale,730,mage,arcane,23,8,15
Freshforces,ragnaros,703,mage,arcane,22,8,14
Nelluc,turalyon,702,mage,arcane,14,8,6
Pyroden,stormscale,700,mage,arcane,20,8,12
Doryy,silvermoon,672,mage,arcane,12,7,5
Jengele,argent-dawn,672,mage,arcane,12,7,5
Wanrltw,ragnaros,672,mage,arcane,12,7,5
Млдбоярин,gordunni,672,mage,arcane,12,7,5
Pizwiz,kazzak,672,mage,arcane,16,8,8
Adetin,tarren-mill,671,mage,arcane,12,7,5
Nötmârtònxø,ragnaros,671,mage,arcane,12,7,5
Thorstäin,ragnaros,670,mage,arcane,18,7,11
Itzlucky,twisting-nether,670,mage,arcane,18,7,11
Зухвала,howling-fjord,655,mage,arcane,29,8,21
Brugg,antonidas,651,mage,arcane,18,7,11
Nergl,darksorrow,623,mage,arcane,27,7,20
Pyllymake,kazzak,576,mage,arcane,12,6,6
Æones,kult-der-verdammten,576,mage,arcane,18,6,12
Shõrty,thrall,575,mage,arcane,12,6,6
Apc,sylvanas,575,mage,arcane,12,6,6
Tarovan,defias-brotherhood,575,mage,arcane,12,6,6
Aod,chogall,575,mage,arcane,12,6,6
Spicymash,chogall,575,mage,arcane,12,6,6
Карраско,soulflayer,575,mage,arcane,12,6,6
ßjwercke,stormscale,575,mage,arcane,18,6,12
Окости,howling-fjord,574,mage,arcane,12,6,6
Sarjeta,grim-batol,572,mage,arcane,18,6,12
Corlys,defias-brotherhood,569,mage,arcane,12,6,6
Leil,die-todeskrallen,569,mage,arcane,24,6,18
Sparrowixx,turalyon,537,mage,arcane,14,7,7
Seraf,argent-dawn,496,mage,arcane,13,6,7
Vaerén,malganis,495,mage,arcane,13,6,7
Tamtheone,frostwhisper,480,mage,arcane,6,5,1
Rmnzr,blackrock,480,mage,arcane,6,5,1
Rayniß,blackmoore,480,mage,arcane,6,5,1
Aletheía,stormscale,480,mage,arcane,6,5,1
Auchenax,argent-dawn,480,mage,arcane,12,5,7
Alarak,drakthul,480,mage,arcane,12,5,7
Jînexo,shattrath,480,mage,arcane,12,5,7
Magevnr,hyjal,480,mage,arcane,12,5,7
Pwntt,terenas,480,mage,arcane,12,5,7
Médivh,archimonde,480,mage,arcane,12,5,7
Barryscótt,stormscale,480,mage,arcane,12,5,7
Ледянойкекс,gordunni,480,mage,arcane,18,5,13
Mðj,kazzak,480,mage,arcane,18,5,13
Ewina,twisting-nether,479,mage,arcane,6,5,1
Skankengine,twisting-nether,479,mage,arcane,6,5,1
Insømnium,stormscale,479,mage,arcane,12,5,7
Mortlol,chamber-of-aspects,479,mage,arcane,12,5,7
Winterblues,frostmourne,479,mage,arcane,12,5,7
Gripe,defias-brotherhood,478,mage,arcane,6,5,1
Odor,haomarush,475,mage,arcane,12,5,7
Bogher,pozzo-delleternità,472,mage,arcane,12,5,7
Mysticbeard,argent-dawn,384,mage,arcane,6,4,2
Yunox,stormscale,384,mage,arcane,6,4,2
Apollohouse,ravencrest,384,mage,arcane,6,4,2
Rizzlybear,outland,384,mage,arcane,6,4,2
Мглавечная,azuregos,384,mage,arcane,6,4,2
Hexmath,tarren-mill,384,mage,arcane,6,4,2
Cysbb,arathi,384,mage,arcane,12,4,8
Boogeyone,drakthul,384,mage,arcane,12,4,8
Uní,emerald-dream,384,mage,arcane,12,4,8
Isralysa,ravencrest,384,mage,arcane,12,4,8
Zoot,ravencrest,384,mage,arcane,12,4,8
Mupana,nagrand,384,mage,arcane,12,4,8
Uskomaaginen,ravencrest,384,mage,arcane,12,4,8
Mikaelà,blackmoore,383,mage,arcane,6,4,2
Reiggo,silvermoon,383,mage,arcane,6,4,2
Némmesis,zuljin,378,mage,arcane,12,4,8
Bigshape,frostwolf,351,mage,arcane,11,4,7
Roxolani,defias-brotherhood,303,mage,arcane,14,4,10
Æskalatîøn,blackmoore,288,mage,arcane,6,3,3
Dcolon,tarren-mill,288,mage,arcane,6,3,3
Bmbiscuit,ravencrest,288,mage,arcane,6,3,3
Khadgia,argent-dawn,288,mage,arcane,6,3,3
Колдрагос,gordunni,288,mage,arcane,6,3,3
Mylanq,ragnaros,288,mage,arcane,6,3,3
Onlymage,outland,288,mage,arcane,6,3,3
Inaruy,hyjal,288,mage,arcane,6,3,3
Purrpl,twisting-nether,288,mage,arcane,6,3,3
Choise,stormscale,288,mage,arcane,6,3,3
Hachiro,onyxia,288,mage,arcane,6,3,3
Radiantfury,outland,288,mage,arcane,6,3,3
Euklid,ravencrest,288,mage,arcane,6,3,3
Kyrn,zuljin,288,mage,arcane,6,3,3
Euphorie,twisting-nether,288,mage,arcane,6,3,3
Seyece,silvermoon,288,mage,arcane,6,3,3
Ignyx,ragnaros,288,mage,arcane,6,3,3
Astroknight,silvermoon,288,mage,arcane,6,3,3
Khoshgele,draenor,288,mage,arcane,6,3,3
Deadtedd,twisting-nether,288,mage,arcane,6,3,3
Ovrpwrdxd,kazzak,288,mage,arcane,6,3,3
Gagaj,ravencrest,288,mage,arcane,6,3,3
Brokenlegman,defias-brotherhood,288,mage,arcane,6,3,3
Мактай,gordunni,288,mage,arcane,6,3,3
Serctheone,ravencrest,288,mage,arcane,9,4,5
Dareah,blackmoore,288,mage,arcane,12,3,9
Kudakto,ravencrest,288,mage,arcane,12,3,9
Magitis,blackhand,288,mage,arcane,12,3,9
Хблэйз,howling-fjord,288,mage,arcane,12,3,9
Chimará,eredar,288,mage,arcane,18,3,15
Магборода,soulflayer,287,mage,arcane,6,3,3
Frökenfrost,stormscale,287,mage,arcane,6,3,3
Burnem,kult-der-verdammten,287,mage,arcane,6,3,3
Arcadua,sanguino,287,mage,arcane,6,3,3
Kasus,sporeggar,286,mage,arcane,6,3,3
Ivoc,drakthul,254,mage,arcane,11,3,8
Naween,hyjal,239,mage,arcane,5,3,2
Kairøs,dragonblight,223,mage,arcane,16,3,13
Teeclis,twisting-nether,192,mage,arcane,6,2,4
Kold,stormscale,192,mage,arcane,6,2,4
Schøkø,eredar,192,mage,arcane,6,2,4
Линклер,fordragon,192,mage,arcane,6,2,4
Baravar,blackrock,192,mage,arcane,6,2,4
Génociidz,archimonde,192,mage,arcane,6,2,4
Sheeptowin,thrall,192,mage,arcane,6,2,4
Versachi,neptulon,192,mage,arcane,6,2,4
Quaile,malygos,192,mage,arcane,6,2,4
Magepress,silvermoon,192,mage,arcane,6,2,4
Phyzed,archimonde,192,mage,arcane,6,2,4
Mejtschazor,twisting-nether,192,mage,arcane,6,2,4
Леракобольд,gordunni,192,mage,arcane,6,2,4
Kuhwar,echsenkessel,192,mage,arcane,6,2,4
Ryûblast,archimonde,192,mage,arcane,6,2,4
Rommelo,ravencrest,192,mage,arcane,6,2,4
Миднаит,gordunni,192,mage,arcane,6,2,4
Галадриелька,gordunni,192,mage,arcane,6,2,4
Nerzzhul,burning-legion,192,mage,arcane,6,2,4
Arimila,sylvanas,192,mage,arcane,6,2,4
Kjh,twisting-nether,192,mage,arcane,6,2,4
Drinte,blackmoore,192,mage,arcane,6,2,4
Imbatto,quelthalas,192,mage,arcane,6,2,4
Зерагуд,eversong,192,mage,arcane,6,2,4
Noxkin,stormscale,192,mage,arcane,6,2,4
Ãshs,archimonde,192,mage,arcane,6,2,4
Shockólot,outland,192,mage,arcane,6,2,4
Azoru,twisting-nether,192,mage,arcane,6,2,4
Naomypayton,tarren-mill,192,mage,arcane,6,2,4
Kbd,outland,192,mage,arcane,6,2,4
Smlx,outland,192,mage,arcane,12,2,10
Magse,kirin-tor,191,mage,arcane,6,2,4
Roslinda,outland,191,mage,arcane,6,2,4
Icx,tarren-mill,191,mage,arcane,6,2,4
Veveroiu,defias-brotherhood,191,mage,arcane,6,2,4
Anderl,kirin-tor,191,mage,arcane,12,2,10
Jamzymage,emerald-dream,96,mage,arcane,3,2,1
Sidildur,ravencrest,96,mage,arcane,6,1,5
Саназэр,soulflayer,96,mage,arcane,6,1,5
Autramage,emerald-dream,96,mage,arcane,6,1,5
Kalokoh,tarren-mill,96,mage,arcane,6,1,5
Криаркана,howling-fjord,96,mage,arcane,6,1,5
Sorrow,outland,96,mage,arcane,6,1,5
Souldemon,burning-legion,96,mage,arcane,6,1,5
Thelastmage,outland,96,mage,arcane,6,1,5
Døomey,ravencrest,96,mage,arcane,6,1,5
Animaze,argent-dawn,96,mage,arcane,6,1,5
Мерац,howling-fjord,96,mage,arcane,6,1,5
Старкскрим,gordunni,96,mage,arcane,6,1,5
Lumberth,sanguino,96,mage,arcane,6,1,5
Moosemæn,stormscale,96,mage,arcane,6,1,5
Azakadabra,ysondre,96,mage,arcane,6,1,5
Wushii,aggra-português,96,mage,arcane,6,1,5
Firehasse,draenor,96,mage,arcane,6,1,5
Yungbambix,twisting-nether,96,mage,arcane,6,1,5
Zerøsílgødx,antonidas,96,mage,arcane,6,1,5
Nohbrain,blackmoore,96,mage,arcane,6,1,5
Шпексх,soulflayer,96,mage,arcane,6,1,5
Hólmess,silvermoon,96,mage,arcane,6,1,5
Buttet,blackmoore,96,mage,arcane,12,1,11
Patricstewrd,draenor,96,mage,arcane,12,1,11
Varini,twisting-nether,96,mage,arcane,12,1,11
Magicpowers,silvermoon,96,mage,arcane,12,1,11
Манднесс,azuregos,79,mage,arcane,11,1,10
Vinlimar,drakthul,64,mage,arcane,4,1,3
Stümpy,ravencrest,64,mage,arcane,5,1,4
Thegoodoctor,kazzak,2186,mage,fire,268,142,126
Hatsu,kazzak,2138,mage,fire,90,47,43
Файрус,soulflayer,2133,mage,fire,104,58,46
Håtsu,ravencrest,2123,mage,fire,143,73,70
Slôw,kazzak,2119,mage,fire,65,42,23
Jíncks,draenor,2104,mage,fire,71,41,30
Диссоциация,greymane,2093,mage,fire,83,49,34
Gelußaßa,ravencrest,2076,mage,fire,77,42,35
Шипми,gordunni,2041,mage,fire,132,72,60
Dazz,ravencrest,2033,mage,fire,210,109,101
Ráìkù,ravencrest,2021,mage,fire,60,32,28
Яшабурстх,blackscar,1986,mage,fire,119,63,56
Urkela,sylvanas,1980,mage,fire,138,79,59
Реордиан,gordunni,1975,mage,fire,86,38,48
Twizzkek,silvermoon,1945,mage,fire,142,67,75
Tommy,laughing-skull,1928,mage,fire,60,34,26
Rizzlybear,outland,1918,mage,fire,75,35,40
Laynerz,kazzak,1917,mage,fire,27,21,6
Ygø,hyjal,1911,mage,fire,228,115,113
Рофкастер,gordunni,1910,mage,fire,154,73,81
Milkenjoyer,ravencrest,1906,mage,fire,47,30,17
Síckmode,khadgar,1903,mage,fire,96,57,39
Mssilvy,sylvanas,1901,mage,fire,216,118,98
Барсуктри,deathguard,1899,mage,fire,60,35,25
Прауз,soulflayer,1899,mage,fire,79,42,37
Isenhour,frostmane,1885,mage,fire,222,115,107
Uknowhowwedu,aegwynn,1879,mage,fire,36,20,16
Altraftw,archimonde,1871,mage,fire,77,52,25
Smlx,outland,1868,mage,fire,78,42,36
Cornfloax,ravencrest,1866,mage,fire,54,33,21
Nilitar,kazzak,1865,mage,fire,54,31,23
Uniquenoodle,alakir,1857,mage,fire,72,34,38
Excuséme,ravencrest,1851,mage,fire,51,27,24
Frøstqt,ravencrest,1851,mage,fire,65,30,35
Dardie,ravencrest,1849,mage,fire,48,30,18
Hazewrld,ravencrest,1848,mage,fire,132,62,70
Lotharie,aegwynn,1847,mage,fire,36,23,13
Tiáno,drakthul,1845,mage,fire,72,36,36
Spelltastíc,blackmoore,1844,mage,fire,54,34,20
Belled,silvermoon,1836,mage,fire,95,64,31
Wàneís,ravencrest,1831,mage,fire,40,25,15
Archíques,kazzak,1831,mage,fire,46,24,22
Zzpf,silvermoon,1831,mage,fire,72,37,35
Wizzárd,ravencrest,1830,mage,fire,48,23,25
Cörnflekz,stormscale,1829,mage,fire,50,30,20
Твейзи,blackscar,1823,mage,fire,40,24,16
Evohz,stormscale,1822,mage,fire,66,33,33
Nøw,kazzak,1816,mage,fire,48,29,19
Hiryú,kazzak,1815,mage,fire,30,20,10
Elmaestró,aegwynn,1815,mage,fire,48,30,18
Bigkent,stormscale,1814,mage,fire,62,27,35
Djflashz,archimonde,1813,mage,fire,52,27,25
Fuego,sylvanas,1811,mage,fire,163,89,74
Jirt,stormscale,1809,mage,fire,59,35,24
Cienaños,outland,1807,mage,fire,102,59,43
Divey,draenor,1805,mage,fire,304,166,138
Spelltastìc,blackmoore,1795,mage,fire,48,27,21
Medivqt,ragnaros,1792,mage,fire,42,33,9
Акиххабара,gordunni,1786,mage,fire,42,31,11
Goomba,tarren-mill,1786,mage,fire,71,29,42
Dxdxdxdxdx,drakthul,1783,mage,fire,60,35,25
Hey,khazgoroth,1783,mage,fire,77,44,33
Ввнд,galakrond,1782,mage,fire,36,21,15
Nøw,ravencrest,1779,mage,fire,69,35,34
Reyown,archimonde,1777,mage,fire,54,40,14
Ширм,blackscar,1774,mage,fire,42,22,20
Ðevlqt,blackmoore,1771,mage,fire,48,30,18
Nihilvm,dalaran,1767,mage,fire,58,28,30
Wenant,ravencrest,1765,mage,fire,66,32,34
Sanjoop,tarren-mill,1756,mage,fire,48,25,23
Choll,stormscale,1754,mage,fire,90,47,43
Arcticfury,ravencrest,1753,mage,fire,36,22,14
Hooksclay,archimonde,1753,mage,fire,60,33,27
Ókamí,ravencrest,1752,mage,fire,133,67,66
Magnobi,sanguino,1750,mage,fire,36,23,13
Frozentwink,kul-tiras,1749,mage,fire,58,29,29
Saiyangodx,twisting-nether,1744,mage,fire,72,37,35
Dizzy,ahnqiraj,1743,mage,fire,131,61,70
Titarie,ravencrest,1742,mage,fire,42,22,20
Magão,frostmane,1738,mage,fire,72,41,31
Гекомория,fordragon,1736,mage,fire,65,26,39
Авгурей,howling-fjord,1735,mage,fire,130,65,65
Nocturnes,sylvanas,1734,mage,fire,67,28,39
Достижений,soulflayer,1733,mage,fire,66,30,36
Asterixus,sylvanas,1728,mage,fire,72,44,28
Cesi,silvermoon,1728,mage,fire,60,26,34
Libre,stormscale,1723,mage,fire,225,119,106
Obbcontrol,ravencrest,1723,mage,fire,162,85,77
Siérra,outland,1708,mage,fire,119,70,49
Rekzaop,ravencrest,1700,mage,fire,28,19,9
Magethings,kazzak,1700,mage,fire,120,66,54
Underscore,outland,1698,mage,fire,73,38,35
Skrex,blackrock,1694,mage,fire,323,171,152
Isildurone,ragnaros,1693,mage,fire,50,28,22
Auchenax,argent-dawn,1686,mage,fire,40,25,15
Jumpfanqt,stormscale,1685,mage,fire,30,23,7
Naps,argent-dawn,1685,mage,fire,104,61,43
Nùts,archimonde,1681,mage,fire,66,30,36
Вовзон,howling-fjord,1677,mage,fire,71,39,32
Aryasa,silvermoon,1676,mage,fire,30,18,12
Фоулли,howling-fjord,1675,mage,fire,48,24,24
Macheat,kazzak,1668,mage,fire,78,42,36
Sheepmeepbip,ravencrest,1664,mage,fire,112,52,60
Аквамэрис,gordunni,1658,mage,fire,36,21,15
Pisini,tarren-mill,1656,mage,fire,48,22,26
Gaárá,stormscale,1655,mage,fire,300,153,147
Møøk,magtheridon,1654,mage,fire,30,19,11
Skylezy,blackrock,1654,mage,fire,35,18,17
Defrozen,twisting-nether,1653,mage,fire,54,31,23
Гнилоглазка,howling-fjord,1651,mage,fire,119,68,51
Consquens,aszune,1648,mage,fire,42,25,17
Symera,dun-modr,1646,mage,fire,48,28,20
Quentin,grim-batol,1646,mage,fire,80,42,38
Elldiamage,draenor,1639,mage,fire,41,23,18
Magenerfed,archimonde,1637,mage,fire,42,21,21
Lemaroxd,draenor,1633,mage,fire,39,22,17
Fuhrem,blackrock,1630,mage,fire,36,23,13
Ayken,burning-legion,1628,mage,fire,42,26,16
Råståfåri,uldum,1627,mage,fire,87,47,40
Ênizt,archimonde,1626,mage,fire,58,34,24
Roxxis,kazzak,1625,mage,fire,30,17,13
Radiantfury,outland,1623,mage,fire,88,41,47
Âcryz,blackrock,1622,mage,fire,59,27,32
Игрдлпдров,gordunni,1621,mage,fire,163,91,72
Oseri,defias-brotherhood,1621,mage,fire,42,20,22
Evovar,silvermoon,1621,mage,fire,40,18,22
Witak,ysondre,1620,mage,fire,130,65,65
Aimaniac,stormscale,1618,mage,fire,199,112,87
Lilblinks,silvermoon,1616,mage,fire,126,67,59
Itrius,tarren-mill,1616,mage,fire,71,33,38
Hólmess,silvermoon,1609,mage,fire,97,46,51
Enandia,darksorrow,1608,mage,fire,92,48,44
Pyrobomb,sylvanas,1608,mage,fire,66,33,33
Insaneex,aegwynn,1607,mage,fire,36,20,16
Whats,korgall,1602,mage,fire,112,61,51
Triplesevenx,silvermoon,1602,mage,fire,180,96,84
Dantiqa,ravencrest,1602,mage,fire,370,188,182
Айслэнц,howling-fjord,1602,mage,fire,42,21,21
Wheí,ravencrest,1601,mage,fire,30,17,13
Twoeightybpm,draenor,1601,mage,fire,40,22,18
Htwhy,kazzak,1601,mage,fire,165,85,80
Zimbabweborc,burning-legion,1600,mage,fire,36,25,11
Doonii,ragnaros,1596,mage,fire,47,20,27
Миднаит,gordunni,1588,mage,fire,54,33,21
Säroumäne,archimonde,1584,mage,fire,49,25,24
Texmexguden,tarren-mill,1583,mage,fire,60,31,29
Shahnoza,thrall,1580,mage,fire,30,17,13
Czd,outland,1580,mage,fire,83,31,52
Мосгормаг,gordunni,1579,mage,fire,35,21,14
Wenndrid,draenor,1579,mage,fire,206,115,91
Firedeáth,kazzak,1577,mage,fire,76,42,34
Tomia,burning-legion,1576,mage,fire,66,36,30
Zíru,outland,1572,mage,fire,63,32,31
Stoychav,outland,1572,mage,fire,96,48,48
Vulcanô,sanguino,1561,mage,fire,72,33,39
Двинск,soulflayer,1558,mage,fire,66,28,38
Калихор,gordunni,1557,mage,fire,36,21,15
Hardtimes,blackhand,1556,mage,fire,74,38,36
Колдрагос,gordunni,1553,mage,fire,80,41,39
Пыроженное,deathguard,1553,mage,fire,36,17,19
Whócárés,dragonmaw,1546,mage,fire,30,17,13
Terlon,ragnaros,1544,mage,fire,90,50,40
Babidi,nemesis,1544,mage,fire,42,23,19
Kjh,twisting-nether,1540,mage,fire,26,17,9
Utarii,deathwing,1538,mage,fire,66,35,31
Gagaj,ravencrest,1534,mage,fire,42,20,22
Твейдей,blackscar,1533,mage,fire,30,16,14
Calientay,ragnaros,1533,mage,fire,54,27,27
Бингчилинг,howling-fjord,1532,mage,fire,42,21,21
Camiina,shattered-hand,1526,mage,fire,143,76,67
Prácticemàge,archimonde,1524,mage,fire,24,16,8
Cheerió,aggramar,1523,mage,fire,209,108,101
Аквамелис,gordunni,1522,mage,fire,84,36,48
Mëgu,silvermoon,1520,mage,fire,373,197,176
Тачитачи,gordunni,1518,mage,fire,47,28,19
Hexmath,tarren-mill,1518,mage,fire,53,30,23
Aronnax,ravencrest,1518,mage,fire,46,21,25
Flypz,stormscale,1516,mage,fire,54,35,19
Hil,blackrock,1516,mage,fire,30,19,11
Экзорсус,goldrinn,1513,mage,fire,154,77,77
Эстерленс,gordunni,1507,mage,fire,70,44,26
Emoden,silvermoon,1506,mage,fire,36,17,19
Petar,tarren-mill,1490,mage,fire,127,62,65
Аластормаг,deathweaver,1488,mage,fire,123,64,59
Aikamie,draenor,1480,mage,fire,93,49,44
Insanewizard,kazzak,1480,mage,fire,59,30,29
Thughunterqt,silvermoon,1474,mage,fire,177,89,88
Ghalanz,ravencrest,1474,mage,fire,141,70,71
Мозифорест,gordunni,1474,mage,fire,78,37,41
Mikefires,blackrock,1473,mage,fire,34,21,13
Robowhoore,silvermoon,1469,mage,fire,42,24,18
Soxlol,sylvanas,1463,mage,fire,29,16,13
Einsmagus,blackrock,1460,mage,fire,30,16,14
Kickyaa,twisting-nether,1460,mage,fire,43,22,21
Caesarclown,silvermoon,1457,mage,fire,216,121,95
Anthrex,drakthul,1456,mage,fire,66,27,39
Imtrynasheep,kazzak,1455,mage,fire,30,18,12
Razrkh,ragnaros,1448,mage,fire,72,39,33
Eddiee,outland,1444,mage,fire,30,17,13
Carinuz,blackmoore,1444,mage,fire,67,29,38
Дрраго,greymane,1443,mage,fire,125,64,61
Tûttifrutti,ravencrest,1442,mage,fire,84,41,43
Secretagent,aegwynn,1439,mage,fire,66,37,29
Mäalaka,archimonde,1439,mage,fire,54,29,25
Intz,twisting-nether,1438,mage,fire,57,24,33
Zazatorica,tarren-mill,1433,mage,fire,120,64,56
Barbeuqx,garona,1432,mage,fire,47,24,23
Mieria,argent-dawn,1432,mage,fire,48,24,24
Kappotjeplif,ravencrest,1431,mage,fire,120,64,56
Yshax,malganis,1430,mage,fire,85,35,50
Gnomag,argent-dawn,1429,mage,fire,113,56,57
Lokilus,dalaran,1428,mage,fire,72,40,32
Neird,sinstralis,1428,mage,fire,72,38,34
Plætinum,ravencrest,1427,mage,fire,110,55,55
Fireblood,runetotem,1426,mage,fire,36,15,21
Baxeraa,draenor,1425,mage,fire,73,41,32
Shizzy,onyxia,1423,mage,fire,57,30,27
Bònk,sylvanas,1423,mage,fire,36,17,19
Chucknoir,draenor,1420,mage,fire,30,16,14
Rayniß,blackmoore,1419,mage,fire,72,34,38
Yatsune,defias-brotherhood,1418,mage,fire,48,33,15
Смилер,gordunni,1416,mage,fire,36,18,18
Morphis,talnivarr,1414,mage,fire,30,16,14
Pluggis,the-maelstrom,1409,mage,fire,30,15,15
Rockyballboa,silvermoon,1403,mage,fire,44,24,20
Kyrn,zuljin,1403,mage,fire,63,32,31
Mejtschazor,twisting-nether,1400,mage,fire,29,16,13
Zéngã,kazzak,1399,mage,fire,61,31,30
Abêj,malygos,1393,mage,fire,32,16,16
Apócalyptic,tarren-mill,1393,mage,fire,147,73,74
Liendri,aegwynn,1392,mage,fire,36,17,19
Ледянойкекс,gordunni,1390,mage,fire,52,26,26
Fortian,boulderfist,1384,mage,fire,24,15,9
Akâri,silvermoon,1380,mage,fire,30,15,15
Calegos,twisting-nether,1378,mage,fire,48,25,23
Линклер,fordragon,1374,mage,fire,24,15,9
Noviina,argent-dawn,1372,mage,fire,56,30,26
Frøzzen,blackrock,1370,mage,fire,29,15,14
Mons,the-venture-co,1369,mage,fire,136,66,70
Atixx,aegwynn,1369,mage,fire,48,20,28
Glïder,archimonde,1366,mage,fire,47,22,25
Spellsteal,antonidas,1366,mage,fire,126,54,72
Elesios,blackmoore,1365,mage,fire,78,34,44
Zensheep,silvermoon,1364,mage,fire,30,15,15
Rilac,nordrassil,1364,mage,fire,48,22,26
Töframaður,draenor,1362,mage,fire,78,43,35
Sadrã,kazzak,1362,mage,fire,48,20,28
Maguscarlsen,ravencrest,1355,mage,fire,30,16,14
Frostytutes,ragnaros,1351,mage,fire,120,62,58
Tiltedpapi,ravencrest,1348,mage,fire,47,20,27
Immortanjoe,thrall,1345,mage,fire,84,44,40
Bobbasor,defias-brotherhood,1345,mage,fire,68,33,35
Шуткам,gordunni,1343,mage,fire,18,14,4
Freeyourmind,kazzak,1341,mage,fire,50,23,27
Zestrax,kazzak,1339,mage,fire,42,29,13
Feuererdnuss,blackhand,1338,mage,fire,42,24,18
Нереварин,soulflayer,1338,mage,fire,27,15,12
Estelliên,burning-legion,1338,mage,fire,36,15,21
Stylaaz,twisting-nether,1337,mage,fire,59,31,28
Reqwyz,ragnaros,1337,mage,fire,32,16,16
Fenrirson,drakthul,1336,mage,fire,144,77,67
Rictue,silvermoon,1335,mage,fire,43,24,19
Sylvîe,tarren-mill,1335,mage,fire,65,31,34
Magmarro,burning-legion,1334,mage,fire,107,54,53
Steveishigh,tarren-mill,1332,mage,fire,25,14,11
Jessaniel,chogall,1330,mage,fire,24,14,10
Climatrix,twisting-nether,1328,mage,fire,18,14,4
Sukalamink,alonsus,1328,mage,fire,42,22,20
Wwjd,darksorrow,1326,mage,fire,25,15,10
Rewq,twisting-nether,1326,mage,fire,24,14,10
Jaídy,aegwynn,1326,mage,fire,52,25,27
Wankel,blackmoore,1325,mage,fire,60,28,32
Magicalmig,draenor,1323,mage,fire,126,75,51
Manvo,bloodscalp,1323,mage,fire,126,65,61
Darríck,argent-dawn,1323,mage,fire,41,16,25
Рифтиг,howling-fjord,1322,mage,fire,95,43,52
Momomagic,silvermoon,1318,mage,fire,64,31,33
Wizmec,silvermoon,1317,mage,fire,171,83,88
Cinoox,blackrock,1316,mage,fire,84,46,38
Versachi,neptulon,1315,mage,fire,30,15,15
Sonofdragon,frostwolf,1314,mage,fire,36,19,17
Quiwi,dun-modr,1313,mage,fire,45,30,15
Darkice,sanguino,1308,mage,fire,48,22,26
Skarxaa,sanguino,1307,mage,fire,80,36,44
Exitelol,blackrock,1305,mage,fire,24,14,10
Aulny,kaelthas,1304,mage,fire,70,30,40
Fiveboyjr,tarren-mill,1302,mage,fire,54,29,25
Быкуня,gordunni,1298,mage,fire,60,33,27
Pumped,haomarush,1298,mage,fire,29,14,15
Bloodycast,archimonde,1298,mage,fire,52,19,33
Nohbrain,blackmoore,1297,mage,fire,75,36,39
Ziscine,tarren-mill,1297,mage,fire,51,23,28
Greey,blackhand,1293,mage,fire,38,21,17
Fingolfin,amanthul,1293,mage,fire,316,152,164
Аваон,deathguard,1289,mage,fire,136,67,69
Дэлос,gordunni,1288,mage,fire,23,14,9
Hahahehe,aegwynn,1288,mage,fire,45,24,21
Magicuze,argent-dawn,1287,mage,fire,60,25,35
Bclaudiu,terokkar,1285,mage,fire,50,22,28
Maggresive,sylvanas,1284,mage,fire,36,16,20
Деозар,eversong,1272,mage,fire,216,103,113
Нетлель,soulflayer,1270,mage,fire,36,16,20
Ihatemages,stormreaver,1270,mage,fire,66,27,39
Mauvé,blades-edge,1266,mage,fire,65,33,32
Cyrîll,malygos,1263,mage,fire,133,75,58
Kuríbo,gorgonnash,1262,mage,fire,33,19,14
Varenca,blackrock,1256,mage,fire,75,35,40
Фрозитв,blackscar,1247,mage,fire,18,13,5
Yanir,die-arguswacht,1245,mage,fire,24,13,11
Larmp,outland,1245,mage,fire,24,13,11
Haxyo,twisting-nether,1244,mage,fire,18,13,5
Johnnydeepp,archimonde,1244,mage,fire,18,13,5
Kurtcobain,draenor,1242,mage,fire,18,13,5
Romethito,dun-modr,1240,mage,fire,42,27,15
Zivac,kazzak,1240,mage,fire,24,13,11
Sekulicgoga,draenor,1235,mage,fire,24,17,7
Grandbasile,hyjal,1235,mage,fire,42,13,29
Pandathis,frostwolf,1233,mage,fire,18,13,5
Elcølgaø,sanguino,1233,mage,fire,30,13,17
Вселениум,razuvious,1232,mage,fire,63,32,31
Tokerlol,stormscale,1231,mage,fire,27,13,14
Faunas,kazzak,1230,mage,fire,46,27,19
Warwizz,sanguino,1226,mage,fire,24,13,11
Silatara,twisting-nether,1223,mage,fire,24,13,11
Ryzea,ravencrest,1223,mage,fire,53,23,30
Pewwpewwpeww,doomhammer,1221,mage,fire,83,37,46
Ràyden,khaz-modan,1219,mage,fire,36,18,18
Durdi,silvermoon,1217,mage,fire,30,17,13
Røvso,ragnaros,1216,mage,fire,36,13,23
Searchy,blackhand,1213,mage,fire,152,79,73
Critzeklein,antonidas,1213,mage,fire,60,24,36
Nuvx,ravencrest,1212,mage,fire,72,39,33
Dobbite,archimonde,1207,mage,fire,48,31,17
Джеззабэль,ashenvale,1204,mage,fire,24,15,9
Айсбоунт,eversong,1203,mage,fire,51,20,31
Wîtchcurse,dentarg,1197,mage,fire,36,15,21
Anshara,stormscale,1193,mage,fire,66,39,27
Bonto,tarren-mill,1182,mage,fire,52,23,29
Athenå,dalaran,1176,mage,fire,48,21,27
Blitzo,madmortem,1174,mage,fire,53,29,24
Critr,sylvanas,1167,mage,fire,134,68,66
Darkoftw,ysondre,1166,mage,fire,25,13,12
Dóncójones,blackrock,1166,mage,fire,95,42,53
Gerdâ,chants-éternels,1154,mage,fire,72,38,34
Drunkpunk,kazzak,1152,mage,fire,60,35,25
Moojob,kazzak,1151,mage,fire,24,12,12
Kaki,stormscale,1150,mage,fire,36,19,17
Córgi,ravencrest,1149,mage,fire,24,12,12
Azulêera,archimonde,1149,mage,fire,24,12,12
Wizarð,archimonde,1149,mage,fire,29,13,16
Самза,howling-fjord,1145,mage,fire,48,27,21
Slashkiiss,archimonde,1145,mage,fire,77,39,38
Demensida,ravencrest,1145,mage,fire,28,13,15
Büyübaba,twisting-nether,1145,mage,fire,30,12,18
Avakadaver,draenor,1143,mage,fire,24,12,12
Revanov,outland,1142,mage,fire,18,12,6
Themagicguy,silvermoon,1140,mage,fire,24,12,12
Skitsó,shadowsong,1139,mage,fire,48,29,19
Fäust,drakthul,1136,mage,fire,52,16,36
Isiah,kaelthas,1132,mage,fire,62,27,35
Мерджреквест,howling-fjord,1128,mage,fire,24,12,12
Асидочка,soulflayer,1118,mage,fire,86,41,45
Lybazinga,frostmane,1118,mage,fire,37,16,21
Дмблдр,soulflayer,1116,mage,fire,33,14,19
Blasic,stormscale,1105,mage,fire,30,12,18
Rapidfrost,drakthul,1104,mage,fire,34,21,13
Worstlove,blackrock,1099,mage,fire,44,23,21
Nezousta,sinstralis,1094,mage,fire,24,12,12
Скиллао,gordunni,1086,mage,fire,29,13,16
Fritmckhaine,archimonde,1084,mage,fire,66,35,31
Leontus,outland,1072,mage,fire,18,12,6
Gorleg,draenor,1072,mage,fire,47,17,30
Бабайбайкала,gordunni,1071,mage,fire,29,12,17
Newtwo,ravencrest,1070,mage,fire,25,12,13
Wushii,aggra-português,1060,mage,fire,25,12,13
Shadowmag,burning-legion,1058,mage,fire,48,19,29
Ilikesheep,blackmoore,1056,mage,fire,18,11,7
Uknowhowwedu,blackrock,1056,mage,fire,24,11,13
Mowns,ravencrest,1056,mage,fire,24,11,13
Sleepingfate,stormscale,1055,mage,fire,18,11,7
Mohammedjiba,ragnaros,1055,mage,fire,18,11,7
Sérum,drakthul,1055,mage,fire,18,11,7
Covran,stormscale,1055,mage,fire,24,11,13
Anisovsky,archimonde,1055,mage,fire,24,11,13
Мизерун,deathguard,1053,mage,fire,79,33,46
Laetitiah,archimonde,1042,mage,fire,26,11,15
Mikaelà,blackmoore,1040,mage,fire,18,11,7
Larah,les-clairvoyants,1038,mage,fire,18,11,7
Rèsí,dun-morogh,1037,mage,fire,30,12,18
Dyx,nemesis,1036,mage,fire,89,42,47
Vantimere,twisting-nether,1036,mage,fire,30,11,19
Rmforever,archimonde,1029,mage,fire,42,21,21
Pablø,blackrock,1024,mage,fire,34,17,17
Icx,tarren-mill,1021,mage,fire,108,56,52
Freezeballs,blackmoore,1017,mage,fire,37,12,25
Хээйлии,goldrinn,1001,mage,fire,30,15,15
Devilpain,zuluhed,1001,mage,fire,24,11,13
Комонщик,howling-fjord,993,mage,fire,30,11,19
Netrinkuet,outland,991,mage,fire,17,11,6
Зубарол,gordunni,984,mage,fire,49,24,25
Plazem,argent-dawn,971,mage,fire,54,20,34
Sukmikok,twisting-nether,960,mage,fire,12,10,2
Фюртэ,howling-fjord,960,mage,fire,12,10,2
Plexyoo,thrall,960,mage,fire,24,10,14
Drè,daggerspine,959,mage,fire,18,10,8
Витуз,gordunni,959,mage,fire,18,10,8
Gandelfmaly,burning-legion,959,mage,fire,18,10,8
Pepsimaxlord,silvermoon,959,mage,fire,18,10,8
Magijoana,silvermoon,959,mage,fire,36,10,26
Ахиригиз,gordunni,958,mage,fire,18,10,8
Rambau,archimonde,958,mage,fire,18,10,8
Charizard,emerald-dream,956,mage,fire,15,11,4
Arcann,ravencrest,956,mage,fire,18,10,8
Shìnra,ravencrest,955,mage,fire,24,10,14
Gàtsby,outland,955,mage,fire,24,10,14
Arandartis,kazzak,954,mage,fire,18,10,8
Tóadette,die-aldor,953,mage,fire,28,11,17
Firen,thrall,952,mage,fire,24,13,11
Çana,thrall,952,mage,fire,30,10,20
Shealá,blackhand,951,mage,fire,24,10,14
Mohrgan,malorne,950,mage,fire,24,10,14
Firewitch,blackhand,950,mage,fire,24,10,14
Cräzÿfrøst,archimonde,949,mage,fire,24,10,14
Khalkazzar,darkspear,943,mage,fire,30,10,20
Santoz,blackrock,938,mage,fire,100,52,48
Кельтаз,soulflayer,932,mage,fire,30,15,15
Häddës,archimonde,925,mage,fire,24,14,10
Pyro,daggerspine,924,mage,fire,60,32,28
Freezandrun,tarren-mill,918,mage,fire,47,21,26
Netherstorm,chogall,896,mage,fire,66,30,36
Nåzmyz,outland,891,mage,fire,23,10,13
Plessx,sylvanas,888,mage,fire,21,11,10
Texhex,ahnqiraj,877,mage,fire,36,10,26
Warpx,aegwynn,872,mage,fire,24,10,14
Sagregas,silvermoon,866,mage,fire,83,36,47
Dyen,hyjal,864,mage,fire,12,9,3
Magerocks,ragnaros,864,mage,fire,12,9,3
Grumpié,ravencrest,864,mage,fire,12,9,3
Turbomedusa,draenor,864,mage,fire,12,9,3
Lisanalgaib,kilrogg,864,mage,fire,18,9,9
Spacehoe,stormscale,864,mage,fire,18,9,9
Magiwan,silvermoon,864,mage,fire,24,9,15
Tagrine,kaelthas,863,mage,fire,12,9,3
Smíte,kazzak,863,mage,fire,12,9,3
Diffa,tarren-mill,863,mage,fire,18,9,9
Sakuranosuke,twisting-nether,863,mage,fire,18,9,9
Vixis,dalaran,863,mage,fire,18,9,9
Satyrnaar,tarren-mill,863,mage,fire,18,9,9
Rhodghar,ravencrest,862,mage,fire,18,9,9
Weedup,zuljin,862,mage,fire,18,9,9
Poporciné,archimonde,862,mage,fire,18,9,9
Интровертка,blackscar,862,mage,fire,22,10,12
Феновар,goldrinn,862,mage,fire,24,9,15
Hokuspokicus,ravencrest,862,mage,fire,24,9,15
Abocajarro,dun-modr,861,mage,fire,18,9,9
Backped,kazzak,860,mage,fire,34,10,24
Чоуза,gordunni,858,mage,fire,24,9,15
Pwntt,terenas,858,mage,fire,24,9,15
Mirobol,hyjal,856,mage,fire,24,9,15
Spader,argent-dawn,851,mage,fire,18,9,9
Bigbazzabean,silvermoon,849,mage,fire,42,17,25
Sippebób,laughing-skull,830,mage,fire,16,10,6
Nagano,deathwing,827,mage,fire,23,9,14
Abruaa,tarren-mill,799,mage,fire,11,9,2
Wëylin,chogall,797,mage,fire,16,9,7
Løxyy,ysondre,793,mage,fire,36,12,24
Aurelius,kargath,783,mage,fire,13,9,4
Takayaki,terokkar,783,mage,fire,19,9,10
Занерзулаа,soulflayer,782,mage,fire,23,9,14
Sèrum,drakthul,777,mage,fire,23,10,13
Matsuratkø,nemesis,768,mage,fire,12,8,4
Apollohouse,ravencrest,768,mage,fire,12,8,4
Nilitarrgh,outland,768,mage,fire,12,8,4
Mlodysimba,burning-legion,768,mage,fire,12,8,4
Funkyfriday,twisting-nether,768,mage,fire,12,8,4
Yésdávé,stormscale,768,mage,fire,12,8,4
Stockfísh,ravencrest,768,mage,fire,12,8,4
Spellonfire,ravencrest,768,mage,fire,12,8,4
Marøjuniõr,draenor,768,mage,fire,12,8,4
Lestrangé,azjolnerub,768,mage,fire,12,8,4
Sölø,stormscale,768,mage,fire,12,8,4
Dcolon,tarren-mill,768,mage,fire,12,8,4
Nuj,blackrock,768,mage,fire,12,8,4
Harrisøn,dun-modr,768,mage,fire,12,8,4
Stümpy,ravencrest,768,mage,fire,12,8,4
Seshlad,stormscale,768,mage,fire,12,8,4
Fakeklepter,sylvanas,768,mage,fire,12,8,4
Zelimeth,outland,768,mage,fire,18,8,10
Octtmiss,twisting-nether,768,mage,fire,18,8,10
Незерёб,soulflayer,768,mage,fire,18,8,10
Zoot,ravencrest,768,mage,fire,24,8,16
Airo,drakthul,768,mage,fire,24,8,16
Mðj,kazzak,768,mage,fire,24,8,16
Azakadabra,ysondre,767,mage,fire,12,8,4
Benjibop,ravencrest,767,mage,fire,12,8,4
Neférú,thrall,767,mage,fire,12,8,4
Kbd,outland,767,mage,fire,18,8,10
Testzerodeux,archimonde,767,mage,fire,18,8,10
Alyraza,chamber-of-aspects,767,mage,fire,18,8,10
Эммилиарда,gordunni,767,mage,fire,18,8,10
Алаурс,howling-fjord,767,mage,fire,18,8,10
Dynamica,ravencrest,767,mage,fire,18,8,10
Elreas,blackmoore,767,mage,fire,18,8,10
Dauwen,silvermoon,767,mage,fire,18,8,10
Codeincassie,blackhand,767,mage,fire,18,8,10
Магмагистр,blackscar,767,mage,fire,24,8,16
Takiix,antonidas,766,mage,fire,12,8,4
Solarian,nemesis,764,mage,fire,18,8,10
Estwald,arathor,763,mage,fire,18,8,10
Iamslow,sylvanas,762,mage,fire,12,8,4
Linyah,arathor,762,mage,fire,18,8,10
Вельдрик,soulflayer,762,mage,fire,24,8,16
Majinbo,doomhammer,760,mage,fire,18,8,10
Arcadua,sanguino,758,mage,fire,12,8,4
Veveroiu,defias-brotherhood,752,mage,fire,24,9,15
Mimicassa,defias-brotherhood,751,mage,fire,26,14,12
Фиеран,grom,747,mage,fire,26,10,16
Rasputina,blackrock,744,mage,fire,35,12,23
Kalyypso,arygos,735,mage,fire,16,9,7
Magicspark,madmortem,735,mage,fire,77,35,42
Mitchmage,ravencrest,732,mage,fire,17,8,9
Tragíc,blackmoore,719,mage,fire,17,8,9
Lanadorei,stormscale,711,mage,fire,21,8,13
Тудысюдым,eversong,684,mage,fire,19,8,11
Pàntera,blackmoore,683,mage,fire,31,8,23
Gnðmeonfire,sylvanas,672,mage,fire,12,7,5
Исендэя,gordunni,672,mage,fire,12,7,5
Draquengar,tyrande,672,mage,fire,12,7,5
Randommagexd,ravencrest,672,mage,fire,12,7,5
Кодимагх,gordunni,672,mage,fire,12,7,5
Equálity,blackrock,672,mage,fire,12,7,5
Iconic,eredar,672,mage,fire,12,7,5
Greaterkick,blackrock,672,mage,fire,12,7,5
Melíssa,silvermoon,672,mage,fire,12,7,5
Pïeck,archimonde,672,mage,fire,12,7,5
Consulalgeri,archimonde,672,mage,fire,18,7,11
Анзот,howling-fjord,672,mage,fire,18,7,11
Mangiafuoco,nemesis,672,mage,fire,18,7,11
Anaxtra,guldan,672,mage,fire,18,7,11
Akrapovic,drakthul,672,mage,fire,18,7,11
Azîlko,frostwolf,671,mage,fire,12,7,5
Uwutehe,ravencrest,671,mage,fire,12,7,5
Wizkidcutt,tarren-mill,671,mage,fire,12,7,5
Spellfaker,drakthul,671,mage,fire,12,7,5
Barspin,lightnings-blade,671,mage,fire,12,7,5
Zaci,argent-dawn,671,mage,fire,12,7,5
Sokardes,the-maelstrom,671,mage,fire,16,8,8
Karima,drekthar,671,mage,fire,16,8,8
Anagramix,silvermoon,671,mage,fire,15,7,8
Camelshaver,tarren-mill,671,mage,fire,18,7,11
Mìsaki,hellscream,671,mage,fire,18,7,11
Ustafrr,argent-dawn,670,mage,fire,13,7,6
Spispi,burning-legion,670,mage,fire,21,8,13
Awart,burning-legion,670,mage,fire,24,7,17
Жгумпель,howling-fjord,670,mage,fire,24,7,17
Vanah,the-maelstrom,669,mage,fire,12,7,5
Mogettemagic,ysondre,669,mage,fire,27,8,19
Kyani,mannoroth,667,mage,fire,24,7,17
Kaktuzze,antonidas,664,mage,fire,18,7,11
Smî,aegwynn,659,mage,fire,12,7,5
Elypøde,ysondre,657,mage,fire,12,7,5
Magikere,tarren-mill,639,mage,fire,17,7,10
Vulcanx,stormscale,638,mage,fire,17,7,10
Cleophe,burning-legion,637,mage,fire,16,8,8
Luxxurious,xavius,623,mage,fire,9,7,2
Bezelgeuse,pozzo-delleternità,623,mage,fire,17,7,10
Qusx,malganis,607,mage,fire,11,7,4
Serctheone,ravencrest,607,mage,fire,14,7,7
Chrismage,argent-dawn,606,mage,fire,20,7,13
Apcg,sylvanas,576,mage,fire,6,6,0
Lyrath,ghostlands,576,mage,fire,6,6,0
Canceled,kazzak,576,mage,fire,12,6,6
Derchong,kazzak,576,mage,fire,12,6,6
Macey,ravencrest,576,mage,fire,12,6,6
Olzaa,outland,576,mage,fire,12,6,6
Pradapimp,ravencrest,576,mage,fire,12,6,6
Icepiece,tarren-mill,576,mage,fire,12,6,6
Nihilum,dalaran,576,mage,fire,12,6,6
Feath,ravencrest,576,mage,fire,12,6,6
Skylez,blackrock,576,mage,fire,12,6,6
Qwibbly,kazzak,576,mage,fire,18,6,12
Nötmârtònxø,ragnaros,576,mage,fire,18,6,12
Relik,sylvanas,576,mage,fire,18,6,12
Ofeu,archimonde,576,mage,fire,18,6,12
Wormhole,kazzak,576,mage,fire,18,6,12
Zymage,silvermoon,575,mage,fire,12,6,6
Arckaen,elune,575,mage,fire,12,6,6
Arhi,silvermoon,575,mage,fire,12,6,6
Akhali,chamber-of-aspects,575,mage,fire,12,6,6
Vurtnez,kazzak,575,mage,fire,12,6,6
Gavra,ravencrest,575,mage,fire,12,6,6
Kitchimage,ravencrest,575,mage,fire,12,6,6
Saturator,burning-legion,575,mage,fire,18,6,12
Zuckerzimt,ravencrest,575,mage,fire,18,6,12
Lupuus,anubarak,575,mage,fire,24,6,18
Explosìve,arthas,574,mage,fire,12,6,6
Zeddic,burning-legion,574,mage,fire,12,6,6
Shâykó,sylvanas,573,mage,fire,12,6,6
Поймайбелку,booty-bay,572,mage,fire,12,6,6
Melimar,khaz-modan,572,mage,fire,12,6,6
Труупоед,borean-tundra,571,mage,fire,12,6,6
Laviathan,die-aldor,568,mage,fire,12,6,6
Hidrax,outland,543,mage,fire,16,6,10
Nâmiz,blackrock,528,mage,fire,9,6,3
Мэдраша,gordunni,527,mage,fire,23,6,17
Zeklo,frostmane,521,mage,fire,20,7,13
Dárdie,ravencrest,512,mage,fire,10,6,4
Yoku,nethersturm,480,mage,fire,6,5,1
Helloimgone,blackmoore,480,mage,fire,6,5,1
Jél,stormscale,480,mage,fire,6,5,1
Palpfiction,silvermoon,480,mage,fire,6,5,1
Magicflame,draenor,480,mage,fire,6,5,1
Bzzr,tarren-mill,480,mage,fire,6,5,1
Mmrlancer,blackmoore,480,mage,fire,6,5,1
Рамблз,gordunni,480,mage,fire,6,5,1
Ицка,fordragon,480,mage,fire,6,5,1
Проблембойх,gordunni,480,mage,fire,12,5,7
Røysi,ravencrest,480,mage,fire,12,5,7
Schøkø,eredar,480,mage,fire,12,5,7
Teeclis,twisting-nether,480,mage,fire,12,5,7
Moleester,twisting-nether,480,mage,fire,12,5,7
Máximus,ravencrest,480,mage,fire,12,5,7
Gadeplan,sylvanas,480,mage,fire,12,5,7
Firever,sanguino,480,mage,fire,12,5,7
Brokenlegman,defias-brotherhood,480,mage,fire,12,5,7
Sheepwithmeh,blackrock,480,mage,fire,12,5,7
Gêrky,drakthul,480,mage,fire,12,5,7
Arcandor,tarren-mill,480,mage,fire,12,5,7
Cleancc,blackhand,480,mage,fire,12,5,7
Magechonk,kazzak,480,mage,fire,12,5,7
Runbabyrun,hyjal,480,mage,fire,12,5,7
Shifteurprõ,hyjal,480,mage,fire,12,5,7
Shíróyama,ravencrest,480,mage,fire,12,5,7
Tessai,sargeras,480,mage,fire,12,5,7
Dmme,dun-morogh,480,mage,fire,18,5,13
Валбериса,deepholm,479,mage,fire,6,5,1
Neoreactor,ravencrest,479,mage,fire,12,5,7
Megancox,blackmoore,479,mage,fire,12,5,7
Tratuf,hyjal,479,mage,fire,12,5,7
Beardmorph,auchindoun,479,mage,fire,18,5,13
Iceorb,azshara,479,mage,fire,24,5,19
Oneal,the-maelstrom,478,mage,fire,12,5,7
Illiaria,antonidas,478,mage,fire,18,5,13
Exorifrigo,dun-modr,477,mage,fire,22,5,17
Eldiablo,dun-modr,476,mage,fire,12,5,7
Draenaya,forscherliga,473,mage,fire,21,6,15
Nabucor,culte-de-la-rive-noire,468,mage,fire,25,6,19
Mínêrvâ,blackrock,431,mage,fire,11,5,6
Buuszek,outland,430,mage,fire,11,5,6
Сморгонец,gordunni,412,mage,fire,14,5,9
Shyasianmage,area-52,384,mage,fire,6,4,2
Naween,hyjal,384,mage,fire,6,4,2
Botbotamba,hyjal,384,mage,fire,6,4,2
Drewna,silvermoon,384,mage,fire,6,4,2
Cardioexpert,ravencrest,384,mage,fire,6,4,2
Khronic,darksorrow,384,mage,fire,6,4,2
Bergillos,sanguino,384,mage,fire,6,4,2
Rotøk,burning-legion,384,mage,fire,6,4,2
Келлазар,gordunni,384,mage,fire,6,4,2
Taylorswîft,ragnaros,384,mage,fire,6,4,2
Файрусх,deathguard,384,mage,fire,6,4,2
Gidsor,silvermoon,384,mage,fire,6,4,2
Saryotheone,silvermoon,384,mage,fire,6,4,2
Kkohp,ravencrest,384,mage,fire,6,4,2
Farmassist,stormscale,384,mage,fire,6,4,2
Xsro,blackrock,384,mage,fire,6,4,2
Fkndog,ravencrest,384,mage,fire,6,4,2
Curran,ravencrest,384,mage,fire,6,4,2
Pavlé,draenor,384,mage,fire,6,4,2
Dubbleblast,draenor,384,mage,fire,6,4,2
Blinker,frostwhisper,384,mage,fire,6,4,2
Нефростмаг,gordunni,384,mage,fire,6,4,2
Praison,defias-brotherhood,384,mage,fire,6,4,2
Monfisback,archimonde,384,mage,fire,6,4,2
Zyreanx,blackrock,384,mage,fire,6,4,2
Wopi,sylvanas,384,mage,fire,6,4,2
Gennésïs,darksorrow,384,mage,fire,6,4,2
Katzron,twisting-nether,384,mage,fire,6,4,2
Dibzz,sanguino,384,mage,fire,6,4,2
Kold,stormscale,384,mage,fire,6,4,2
Whìtewalker,pozzo-delleternità,384,mage,fire,6,4,2
Doryy,silvermoon,384,mage,fire,6,4,2
Мактай,gordunni,384,mage,fire,6,4,2
Mnday,ravencrest,384,mage,fire,6,4,2
Нехай,ashenvale,384,mage,fire,6,4,2
Halfanapple,the-maelstrom,384,mage,fire,6,4,2
Ovrpwrdxd,kazzak,384,mage,fire,6,4,2
Yenneferr,magtheridon,384,mage,fire,6,4,2
Гандолъер,soulflayer,384,mage,fire,6,4,2
Dwang,nemesis,384,mage,fire,6,4,2
Cyser,kazzak,384,mage,fire,6,4,2
Waterhagx,tarren-mill,384,mage,fire,6,4,2
Partypower,twisting-nether,384,mage,fire,12,4,8
Rooven,aegwynn,384,mage,fire,12,4,8
Feuern,antonidas,384,mage,fire,12,4,8
Genviedgiclé,arathi,384,mage,fire,12,4,8
Popbg,outland,384,mage,fire,12,4,8
Sam,outland,384,mage,fire,12,4,8
Diji,the-maelstrom,384,mage,fire,12,4,8
Аркагос,gordunni,384,mage,fire,12,4,8
Дантрий,gordunni,384,mage,fire,12,4,8
Раканчик,gordunni,384,mage,fire,12,4,8
Викликс,borean-tundra,384,mage,fire,12,4,8
Kazeen,silvermoon,384,mage,fire,12,4,8
Гелиадо,soulflayer,384,mage,fire,12,4,8
Aarcheon,kazzak,384,mage,fire,12,4,8
Деорро,gordunni,384,mage,fire,12,4,8
Michellee,ravencrest,384,mage,fire,12,4,8
Bhalïn,dun-modr,384,mage,fire,18,4,14
Lusionator,defias-brotherhood,384,mage,fire,18,4,14
Anghim,tarren-mill,383,mage,fire,6,4,2
Birdlort,draenor,383,mage,fire,6,4,2
Ildrøv,stormscale,383,mage,fire,12,4,8
Unhedged,eredar,383,mage,fire,12,4,8
Мэджиксул,grom,383,mage,fire,12,4,8
Chimará,eredar,367,mage,fire,17,4,13
Lusifera,outland,336,mage,fire,9,4,5
Niivel,ysondre,336,mage,fire,15,4,11
Blazenaa,drakthul,333,mage,fire,15,4,11
Tigerblod,tarren-mill,330,mage,fire,10,5,5
Мегумин,galakrond,318,mage,fire,15,4,11
Kinetiq,kazzak,288,mage,fire,6,3,3
Xlarb,kazzak,288,mage,fire,6,3,3
Procahontas,ravencrest,288,mage,fire,6,3,3
Salvadordalí,ravencrest,288,mage,fire,6,3,3
Abovè,outland,288,mage,fire,6,3,3
Driana,dragonmaw,288,mage,fire,6,3,3
Shermî,blackrock,288,mage,fire,6,3,3
Kàtsu,tarren-mill,288,mage,fire,6,3,3
Sonybonanza,kazzak,288,mage,fire,6,3,3
Adetin,tarren-mill,288,mage,fire,6,3,3
Волшпробуда,gordunni,288,mage,fire,6,3,3
Shinigamí,blackrock,288,mage,fire,6,3,3
Balderk,sanguino,288,mage,fire,6,3,3
Fuchso,area-52,288,mage,fire,6,3,3
Zerøsílgødx,antonidas,288,mage,fire,6,3,3
Pævl,drakthul,288,mage,fire,6,3,3
Maveya,blackmoore,288,mage,fire,6,3,3
Bamz,malganis,288,mage,fire,6,3,3
Tildetbfa,antonidas,288,mage,fire,6,3,3
Cryptik,blackmoore,288,mage,fire,6,3,3
Dampgame,twisting-nether,288,mage,fire,6,3,3
Êgôn,perenolde,288,mage,fire,6,3,3
Макотшельник,gordunni,288,mage,fire,6,3,3
Nïo,ravencrest,288,mage,fire,6,3,3
Namemage,stormscale,288,mage,fire,6,3,3
Onlymage,ravencrest,288,mage,fire,6,3,3
Sendro,twisting-nether,288,mage,fire,6,3,3
Blästz,hyjal,288,mage,fire,6,3,3
Alearis,die-aldor,288,mage,fire,6,3,3
Bebenm,archimonde,288,mage,fire,6,3,3
Mylanq,ragnaros,288,mage,fire,6,3,3
Modrone,ragnaros,288,mage,fire,6,3,3
Quincy,frostwolf,288,mage,fire,6,3,3
Noxkin,stormscale,288,mage,fire,6,3,3
Capphaow,ravencrest,288,mage,fire,6,3,3
Trowbe,blackmoore,288,mage,fire,6,3,3
Fleurdelacur,ravencrest,288,mage,fire,6,3,3
Nàtcho,tichondrius,288,mage,fire,6,3,3
Narexa,silvermoon,288,mage,fire,6,3,3
Meign,eredar,288,mage,fire,6,3,3
Мэджу,gordunni,288,mage,fire,6,3,3
Ãzi,ravencrest,288,mage,fire,6,3,3
Coachrmp,ravencrest,288,mage,fire,6,3,3
Elor,eredar,288,mage,fire,6,3,3
Couñterspell,eredar,288,mage,fire,6,3,3
Kryptass,aegwynn,288,mage,fire,6,3,3
Trxkxx,ragnaros,288,mage,fire,6,3,3
Dardíe,ravencrest,288,mage,fire,6,3,3
Даатхедра,booty-bay,288,mage,fire,6,3,3
Frøstdream,dun-modr,288,mage,fire,6,3,3
Ørka,stormscale,288,mage,fire,6,3,3
Botstyle,ravencrest,288,mage,fire,6,3,3
Zøe,aggra-português,288,mage,fire,6,3,3
Mága,grim-batol,288,mage,fire,6,3,3
Lëyra,ysondre,288,mage,fire,6,3,3
Сизаам,howling-fjord,288,mage,fire,6,3,3
Alterwhite,archimonde,288,mage,fire,6,3,3
Росвенд,gordunni,288,mage,fire,6,3,3
Néiloth,frostmane,288,mage,fire,6,3,3
Matroze,sylvanas,288,mage,fire,6,3,3
Ice,sargeras,288,mage,fire,9,4,5
Хблэйз,howling-fjord,288,mage,fire,9,4,5
Lovësosa,hyjal,288,mage,fire,10,4,6
Колтрэйн,blackscar,288,mage,fire,9,3,6
Aylan,kazzak,288,mage,fire,12,3,9
Frökenfrost,stormscale,288,mage,fire,12,3,9
Rasaku,argent-dawn,288,mage,fire,12,3,9
Waan,sylvanas,288,mage,fire,12,3,9
Tombkiller,kult-der-verdammten,288,mage,fire,12,3,9
Oblív,ravencrest,288,mage,fire,12,3,9
Tsubas,blackmoore,288,mage,fire,12,3,9
Saivedija,blackmoore,288,mage,fire,12,3,9
Овеча,gordunni,288,mage,fire,12,3,9
Milton,dunemaul,288,mage,fire,12,3,9
Trenpapi,twisting-nether,288,mage,fire,12,3,9
Hargun,the-maelstrom,288,mage,fire,12,3,9
Roey,defias-brotherhood,288,mage,fire,12,3,9
Räikü,ravencrest,287,mage,fire,12,4,8
Ceanna,argent-dawn,287,mage,fire,12,3,9
Kyrox,ysondre,287,mage,fire,12,3,9
Regenn,kazzak,286,mage,fire,6,3,3
Венлич,gordunni,271,mage,fire,9,4,5
Incenia,ravencrest,271,mage,fire,17,3,14
Khalix,blackmoore,239,mage,fire,5,3,2
Goukakyu,ravencrest,239,mage,fire,5,3,2
Mercem,stormscale,239,mage,fire,5,3,2
Worstwòrld,draenor,208,mage,fire,7,3,4
Jokiss,draenor,192,mage,fire,6,2,4
Decedé,dun-modr,192,mage,fire,6,2,4
Mohovik,wildhammer,192,mage,fire,6,2,4
Zisseron,frostmane,192,mage,fire,6,2,4
Бигдикмаг,soulflayer,192,mage,fire,6,2,4
Solitaria,tarren-mill,192,mage,fire,6,2,4
Sickßlink,outland,192,mage,fire,6,2,4
Gregoss,elune,192,mage,fire,6,2,4
Cortis,outland,192,mage,fire,6,2,4
Dnt,twilights-hammer,192,mage,fire,6,2,4
Antaos,drakthul,192,mage,fire,6,2,4
Kairøs,dragonblight,192,mage,fire,6,2,4
Frígíd,outland,192,mage,fire,6,2,4
Ikefire,draenor,192,mage,fire,6,2,4
Xatures,tarren-mill,192,mage,fire,6,2,4
Roberx,sanguino,192,mage,fire,6,2,4
Skankengine,twisting-nether,192,mage,fire,6,2,4
Rõdokunohi,darksorrow,192,mage,fire,6,2,4
Frostvirgin,twisting-nether,192,mage,fire,6,2,4
Zerobelow,silvermoon,192,mage,fire,6,2,4
Eksl,draenor,192,mage,fire,6,2,4
Alberdoor,blackmoore,192,mage,fire,6,2,4
Xkod,draenor,192,mage,fire,6,2,4
Alarak,drakthul,192,mage,fire,6,2,4
Atzin,sanguino,192,mage,fire,6,2,4
Ôbsury,hyjal,192,mage,fire,6,2,4
Shinegami,hyjal,192,mage,fire,6,2,4
Milminmage,ravencrest,192,mage,fire,6,2,4
Oizar,hyjal,192,mage,fire,6,2,4
Пиньон,borean-tundra,192,mage,fire,6,2,4
Malshash,outland,192,mage,fire,6,2,4
Hopewell,aszune,192,mage,fire,6,2,4
ßigzok,kazzak,192,mage,fire,6,2,4
Apc,sylvanas,192,mage,fire,6,2,4
Stepdaddyy,kazzak,192,mage,fire,6,2,4
Дэката,grom,192,mage,fire,6,2,4
Grìmmjow,tarren-mill,192,mage,fire,6,2,4
Elynaé,draenor,192,mage,fire,6,2,4
Watchmeclic,archimonde,192,mage,fire,6,2,4
Fleqs,antonidas,192,mage,fire,6,2,4
Transformo,draenor,192,mage,fire,6,2,4
Alorin,dun-modr,192,mage,fire,6,2,4
Kilféfroid,ysondre,192,mage,fire,6,2,4
Димаскунфу,howling-fjord,192,mage,fire,6,2,4
Juicedup,blackrock,192,mage,fire,6,2,4
Letitsnow,ravencrest,192,mage,fire,6,2,4
Гнег,gordunni,192,mage,fire,6,2,4
Mirajânê,blackmoore,192,mage,fire,6,2,4
Quínt,blackhand,192,mage,fire,6,2,4
Zeusmon,ragnaros,192,mage,fire,6,2,4
Szarbán,ragnaros,192,mage,fire,6,2,4
Lìx,ravencrest,192,mage,fire,6,2,4
Magenox,blackrock,192,mage,fire,6,2,4
Puracz,defias-brotherhood,192,mage,fire,6,2,4
Компромис,howling-fjord,192,mage,fire,6,2,4
Кеото,gordunni,192,mage,fire,6,2,4
Symbiano,twisting-nether,192,mage,fire,12,2,10
Явернулси,soulflayer,192,mage,fire,12,2,10
Firelight,argent-dawn,192,mage,fire,12,2,10
Mesvef,archimonde,192,mage,fire,12,2,10
Buzzgnom,malfurion,192,mage,fire,12,2,10
Çatàclysmík,kazzak,192,mage,fire,12,2,10
Kirripirri,doomhammer,191,mage,fire,12,2,10
Shockólot,outland,159,mage,fire,5,2,3
Tahiti,twisting-nether,159,mage,fire,5,2,3
Xhal,hyjal,138,mage,fire,9,3,6
Rukiax,blackrock,128,mage,fire,4,2,2
Ayoubz,outland,128,mage,fire,4,2,2
Burstology,kazzak,128,mage,fire,4,2,2
Akadran,blackmoore,96,mage,fire,6,1,5
Wumz,blackrock,96,mage,fire,6,1,5
Alaster,culte-de-la-rive-noire,96,mage,fire,6,1,5
Фантомланс,howling-fjord,96,mage,fire,6,1,5
Камаёри,howling-fjord,96,mage,fire,6,1,5
Ckrax,sanguino,96,mage,fire,6,1,5
Infamage,draenor,96,mage,fire,6,1,5
Варриморыч,soulflayer,96,mage,fire,6,1,5
Phenoxi,sylvanas,96,mage,fire,6,1,5
Warfio,garona,96,mage,fire,6,1,5
Arcanik,archimonde,96,mage,fire,6,1,5
Мелми,howling-fjord,96,mage,fire,6,1,5
Muzbi,turalyon,96,mage,fire,6,1,5
Jipa,tarren-mill,96,mage,fire,6,1,5
Halbattar,garona,96,mage,fire,6,1,5
Dingin,bronze-dragonflight,96,mage,fire,6,1,5
Nodnarb,dragonblight,96,mage,fire,6,1,5
Cavadrex,arathor,96,mage,fire,6,1,5
Nerzzhul,burning-legion,96,mage,fire,6,1,5
Satheril,argent-dawn,96,mage,fire,6,1,5
Prinskoekie,twisting-nether,96,mage,fire,6,1,5
Leonora,blackhand,96,mage,fire,6,1,5
Zalfax,sinstralis,96,mage,fire,6,1,5
Símple,sylvanas,96,mage,fire,6,1,5
Bekkmzi,drakthul,96,mage,fire,6,1,5
Tsungy,twisting-nether,96,mage,fire,6,1,5
Пламяорды,soulflayer,96,mage,fire,6,1,5
Westx,blackmoore,96,mage,fire,6,1,5
Slïnks,stormscale,96,mage,fire,6,1,5
Caststuffatu,sylvanas,96,mage,fire,6,1,5
Polÿmorph,stormscale,96,mage,fire,6,1,5
Zakardo,kazzak,96,mage,fire,6,1,5
Amalou,stormscale,96,mage,fire,6,1,5
Goodopeners,outland,96,mage,fire,6,1,5
Martixx,stormscale,96,mage,fire,6,1,5
Pyroden,stormscale,96,mage,fire,6,1,5
Zagori,sylvanas,96,mage,fire,6,1,5
Zïa,kazzak,96,mage,fire,6,1,5
Megart,stormscale,96,mage,fire,6,1,5
Maybeblood,kazzak,96,mage,fire,6,1,5
Mexxî,thrall,96,mage,fire,6,1,5
Дизордерх,gordunni,96,mage,fire,6,1,5
Radagulf,outland,96,mage,fire,6,1,5
Одз,grom,96,mage,fire,6,1,5
Slashlife,wrathbringer,96,mage,fire,6,1,5
Lovesosa,malorne,96,mage,fire,9,1,8
Tarryxa,kazzak,96,mage,fire,12,1,11
Kenny,nerzhul,96,mage,fire,12,1,11
Mallphass,dalaran,96,mage,fire,12,1,11
Syltris,drakthul,96,mage,fire,18,1,17
Pyrias,sylvanas,95,mage,fire,6,1,5
Shâdozy,blackmoore,89,mage,fire,6,3,3
Alkhazzar,defias-brotherhood,64,mage,fire,4,1,3
Hecht,burning-legion,64,mage,fire,4,1,3
Preí,archimonde,42,mage,fire,12,3,9
Озобочений,greymane,31,mage,fire,2,1,1
Ðøæø,twisting-nether,16,mage,fire,1,1,0
Partypower,twisting-nether,2294,mage,frost,201,105,96
Chikounet,archimonde,2188,mage,frost,150,78,72
Tommy,laughing-skull,2144,mage,frost,88,45,43
Ðeejkñ,archimonde,2139,mage,frost,72,45,27
Avizura,kazzak,2134,mage,frost,60,35,25
Laynerz,kazzak,2132,mage,frost,67,38,29
Kilstine,outland,2126,mage,frost,78,39,39
Dastion,ravencrest,2105,mage,frost,91,45,46
Макотшельник,gordunni,2091,mage,frost,85,54,31
Медивера,gordunni,2076,mage,frost,95,50,45
Søz,agamaggan,2059,mage,frost,161,79,82
Fakér,ravencrest,2058,mage,frost,184,88,96
Watchmeclic,archimonde,2053,mage,frost,96,46,50
Serctheone,ravencrest,2043,mage,frost,190,94,96
Sóz,ravencrest,2033,mage,frost,109,51,58
Philoû,archimonde,2019,mage,frost,77,36,41
Ticklefinger,agamaggan,2004,mage,frost,59,40,19
Arnoldkelly,tarren-mill,1998,mage,frost,55,32,23
Барсуктри,deathguard,1984,mage,frost,60,30,30
Ràiku,ravencrest,1983,mage,frost,60,30,30
Evovar,silvermoon,1981,mage,frost,119,59,60
Kalamaras,quelthalas,1972,mage,frost,62,30,32
Яшабурстх,blackscar,1971,mage,frost,83,45,38
Oscarwizyo,ravencrest,1968,mage,frost,77,36,41
Voerk,twisting-nether,1955,mage,frost,88,46,42
Gavno,ravencrest,1955,mage,frost,54,26,28
Naynn,archimonde,1948,mage,frost,86,44,42
Øscarwizyo,ravencrest,1940,mage,frost,78,38,40
Efes,dun-modr,1934,mage,frost,58,32,26
Akyrâz,blackrock,1930,mage,frost,130,58,72
Sìckofme,aegwynn,1929,mage,frost,42,29,13
Setyouoncs,ravencrest,1927,mage,frost,84,42,42
Abovè,outland,1918,mage,frost,54,23,31
Sukmikok,twisting-nether,1911,mage,frost,190,94,96
Nilitar,kazzak,1910,mage,frost,60,24,36
Watchmeclick,archimonde,1909,mage,frost,36,20,16
Oseri,defias-brotherhood,1897,mage,frost,155,73,82
Santriss,defias-brotherhood,1883,mage,frost,72,36,36
Zimbabweborc,burning-legion,1875,mage,frost,100,62,38
Kurtkiels,draenor,1872,mage,frost,60,29,31
Ввнд,galakrond,1869,mage,frost,60,27,33
Praison,defias-brotherhood,1863,mage,frost,54,32,22
Zhodusqt,ragnaros,1859,mage,frost,54,27,27
Bebenm,archimonde,1857,mage,frost,42,28,14
Henqo,burning-legion,1856,mage,frost,64,30,34
Cleophe,burning-legion,1853,mage,frost,81,44,37
Emoden,silvermoon,1850,mage,frost,302,158,144
Môv,tarren-mill,1849,mage,frost,54,26,28
Arkhaen,archimonde,1848,mage,frost,71,36,35
Незерёб,soulflayer,1844,mage,frost,114,56,58
Mlodysimba,burning-legion,1843,mage,frost,64,34,30
Drfeeldgoodd,mazrigos,1843,mage,frost,84,38,46
Auchenax,argent-dawn,1839,mage,frost,167,84,83
Aìnz,hyjal,1837,mage,frost,60,27,33
Silverlining,ravencrest,1830,mage,frost,169,88,81
Missl,draenor,1830,mage,frost,62,29,33
Exone,sylvanas,1828,mage,frost,66,32,34
Lyndsey,dalaran,1826,mage,frost,65,31,34
Laurents,silvermoon,1825,mage,frost,128,86,42
Rosady,ragnaros,1824,mage,frost,113,57,56
Soz,agamaggan,1823,mage,frost,42,23,19
Èverix,ravencrest,1823,mage,frost,106,47,59
Goneforever,draenor,1820,mage,frost,42,27,15
Мэдвэйз,gordunni,1819,mage,frost,48,31,17
Søbert,hyjal,1818,mage,frost,36,22,14
Алаурс,howling-fjord,1814,mage,frost,60,31,29
Stîckî,malganis,1814,mage,frost,69,31,38
Pryt,ragnaros,1813,mage,frost,137,78,59
Crylz,kazzak,1813,mage,frost,59,28,31
Djdankzter,outland,1812,mage,frost,42,19,23
Máximus,ravencrest,1809,mage,frost,53,27,26
Ëloenn,dalaran,1807,mage,frost,47,21,26
Reflexz,thrall,1805,mage,frost,42,25,17
Xmoo,blackrock,1805,mage,frost,48,24,24
Novaco,ravencrest,1805,mage,frost,59,29,30
Mßs,outland,1804,mage,frost,48,24,24
Baconlance,stormscale,1803,mage,frost,42,23,19
Tellysia,blackmoore,1802,mage,frost,47,26,21
Símple,sylvanas,1802,mage,frost,60,27,33
Kiirin,drakthul,1801,mage,frost,57,34,23
Lidely,kazzak,1800,mage,frost,30,19,11
Zøe,aggra-português,1800,mage,frost,54,34,20
Kyomachix,ahnqiraj,1799,mage,frost,54,31,23
Whócárés,dragonmaw,1798,mage,frost,45,32,13
Stickiburn,malganis,1797,mage,frost,87,42,45
Knometsj,ravencrest,1796,mage,frost,48,26,22
Løwskìll,outland,1795,mage,frost,95,53,42
Einsmagus,blackrock,1793,mage,frost,60,31,29
Shíróyama,ravencrest,1785,mage,frost,210,114,96
Mgtowforlife,ravencrest,1785,mage,frost,194,97,97
Onnÿy,dun-modr,1781,mage,frost,80,37,43
Dodgezdream,kazzak,1779,mage,frost,40,32,8
Chazs,kazzak,1778,mage,frost,72,36,36
Rekzaop,ravencrest,1778,mage,frost,108,48,60
Polÿmorph,stormscale,1774,mage,frost,65,33,32
Medara,darkspear,1768,mage,frost,72,38,34
Ovrpwrdxd,kazzak,1763,mage,frost,24,20,4
Wmp,ravencrest,1763,mage,frost,42,23,19
Wracrz,argent-dawn,1762,mage,frost,72,38,34
Sorrow,outland,1762,mage,frost,84,39,45
Shakéx,outland,1758,mage,frost,51,26,25
Zoot,ravencrest,1758,mage,frost,84,37,47
Sâkuya,blackrock,1756,mage,frost,122,60,62
Äntigood,outland,1755,mage,frost,161,85,76
Gossipgirlz,outland,1754,mage,frost,262,130,132
Sunehx,blackrock,1753,mage,frost,54,30,24
Колинас,soulflayer,1748,mage,frost,101,50,51
Nightfee,eredar,1745,mage,frost,42,21,21
Esscheppert,blackrock,1743,mage,frost,96,46,50
Jirø,cthun,1738,mage,frost,130,65,65
Mumage,blackrock,1735,mage,frost,60,32,28
Jocelynn,aggramar,1735,mage,frost,65,27,38
Rambau,archimonde,1731,mage,frost,227,112,115
Soloqtarget,archimonde,1730,mage,frost,110,55,55
Darkoftw,ysondre,1729,mage,frost,125,58,67
Neymar,aszune,1725,mage,frost,35,24,11
Blackfirez,ravencrest,1725,mage,frost,30,18,12
Гелиадо,soulflayer,1724,mage,frost,42,19,23
Sylbris,outland,1722,mage,frost,131,62,69
Калихор,gordunni,1719,mage,frost,42,28,14
Mexxî,thrall,1719,mage,frost,72,37,35
Nozarashí,hyjal,1719,mage,frost,103,51,52
Sìsia,ragnaros,1717,mage,frost,30,18,12
Tánu,quelthalas,1717,mage,frost,66,32,34
Fireblood,runetotem,1716,mage,frost,60,28,32
Whïm,ysondre,1714,mage,frost,89,35,54
Аресуперпрес,gordunni,1712,mage,frost,46,21,25
Lorothar,blackhand,1712,mage,frost,60,24,36
Raíner,eredar,1708,mage,frost,78,44,34
Lo,kilrogg,1707,mage,frost,102,50,52
Shalien,tarren-mill,1704,mage,frost,65,35,30
Marybaguette,archimonde,1702,mage,frost,54,25,29
Axhole,darksorrow,1700,mage,frost,48,23,25
Tfmchamp,ravencrest,1698,mage,frost,33,22,11
Ishimura,eredar,1697,mage,frost,54,31,23
Ãshs,archimonde,1696,mage,frost,50,21,29
Леракобольд,gordunni,1695,mage,frost,41,20,21
Slobbery,aggramar,1694,mage,frost,54,29,25
Bombswag,bloodhoof,1693,mage,frost,137,66,71
Melíssa,silvermoon,1692,mage,frost,36,25,11
Chíefsheep,thrall,1692,mage,frost,48,26,22
Dènzx,ravencrest,1690,mage,frost,24,18,6
Alearis,die-aldor,1690,mage,frost,72,38,34
Jaimey,blackhand,1690,mage,frost,161,75,86
Frostgodxqt,ravencrest,1689,mage,frost,105,58,47
Ironhood,nemesis,1685,mage,frost,42,24,18
Swizzy,arathor,1685,mage,frost,64,35,29
Jenggot,ravencrest,1681,mage,frost,35,18,17
Vilain,tarren-mill,1678,mage,frost,35,18,17
Xirrasho,argent-dawn,1677,mage,frost,42,22,20
Tiqma,sylvanas,1673,mage,frost,42,23,19
Саваннхмаег,blackscar,1665,mage,frost,57,34,23
Tdv,draenor,1664,mage,frost,45,23,22
Buffenhance,ravencrest,1664,mage,frost,59,23,36
Ephixis,ravencrest,1664,mage,frost,60,23,37
Lïppoutou,archimonde,1663,mage,frost,35,18,17
Мэтаскрим,soulflayer,1662,mage,frost,84,34,50
Bigacombusta,tarren-mill,1661,mage,frost,72,33,39
Quinella,ravencrest,1660,mage,frost,137,73,64
Reðemption,dun-modr,1659,mage,frost,35,23,12
Rankonedeep,kazzak,1659,mage,frost,57,34,23
Vilenciaga,kazzak,1659,mage,frost,66,35,31
Dsmoke,ravencrest,1657,mage,frost,57,27,30
Snowsánji,blackmoore,1656,mage,frost,41,21,20
Gensorèd,darksorrow,1655,mage,frost,74,36,38
Trowbe,blackmoore,1654,mage,frost,48,26,22
Гекомория,fordragon,1654,mage,frost,74,39,35
Манакса,gordunni,1654,mage,frost,54,24,30
Bigkent,stormscale,1653,mage,frost,48,22,26
Nebbur,dun-modr,1650,mage,frost,54,25,29
Thinamerican,defias-brotherhood,1649,mage,frost,30,20,10
Tagrine,kaelthas,1648,mage,frost,102,49,53
Hógwarts,aegwynn,1646,mage,frost,78,42,36
Johnnydeepp,archimonde,1646,mage,frost,36,18,18
Pharohe,stormscale,1646,mage,frost,57,26,31
Келлазар,gordunni,1645,mage,frost,72,34,38
Bestial,alexstrasza,1645,mage,frost,106,50,56
Rukiax,blackrock,1645,mage,frost,54,18,36
Djflashz,archimonde,1644,mage,frost,42,18,24
Firebaw,tarren-mill,1643,mage,frost,36,25,11
Dostoïevskix,hyjal,1640,mage,frost,30,19,11
Emesarry,scarshield-legion,1636,mage,frost,29,18,11
Highrollerqt,tarren-mill,1636,mage,frost,48,28,20
Ahdetärjag,silvermoon,1636,mage,frost,47,26,21
Nickg,ravencrest,1636,mage,frost,42,21,21
Magerocks,ragnaros,1635,mage,frost,36,20,16
Sondremage,outland,1635,mage,frost,134,60,74
Pezi,outland,1634,mage,frost,50,31,19
Demensida,ravencrest,1634,mage,frost,190,100,90
Xall,silvermoon,1632,mage,frost,48,29,19
Scorchira,outland,1631,mage,frost,30,18,12
Манахк,gordunni,1631,mage,frost,42,19,23
Asiman,eredar,1631,mage,frost,51,22,29
Райоми,fordragon,1630,mage,frost,172,88,84
Thesiôu,ravencrest,1629,mage,frost,36,20,16
Buddi,burning-blade,1629,mage,frost,287,148,139
Xep,ragnaros,1629,mage,frost,48,23,25
Bumbumdead,sylvanas,1628,mage,frost,36,20,16
Girldalf,silvermoon,1627,mage,frost,219,110,109
Unsaìntly,kult-der-verdammten,1625,mage,frost,37,17,20
Glowie,stormreaver,1623,mage,frost,36,20,16
Xenant,ravencrest,1623,mage,frost,42,18,24
Kaeser,ravencrest,1622,mage,frost,101,52,49
Jonku,tarren-mill,1619,mage,frost,47,24,23
Layzzy,kazzak,1619,mage,frost,162,76,86
Emerlyn,ragnaros,1618,mage,frost,30,17,13
Sykz,hyjal,1617,mage,frost,65,35,30
Digi,ravencrest,1617,mage,frost,57,22,35
Anaxtra,guldan,1616,mage,frost,147,70,77
Mlogic,tarren-mill,1615,mage,frost,30,17,13
Covran,stormscale,1614,mage,frost,30,17,13
Samath,conseil-des-ombres,1614,mage,frost,42,19,23
Apeex,chamber-of-aspects,1612,mage,frost,96,48,48
Манаксаа,gordunni,1612,mage,frost,45,21,24
Xæll,silvermoon,1611,mage,frost,114,61,53
Sheepthrillz,blackmoore,1609,mage,frost,41,24,17
Mupana,nagrand,1607,mage,frost,150,76,74
Espressno,ravencrest,1606,mage,frost,30,19,11
Tills,kargath,1606,mage,frost,42,20,22
Ðazzftw,archimonde,1605,mage,frost,24,17,7
Dubstep,blackrock,1605,mage,frost,48,23,25
Манахк,blackscar,1605,mage,frost,53,21,32
Jamzymage,emerald-dream,1604,mage,frost,30,17,13
Copyright,deathwing,1604,mage,frost,36,17,19
Helminsterr,archimonde,1603,mage,frost,48,25,23
Noxkin,stormscale,1603,mage,frost,36,17,19
Magethings,kazzak,1603,mage,frost,54,25,29
Фирдаркнесс,howling-fjord,1602,mage,frost,36,19,17
Bzzr,tarren-mill,1601,mage,frost,54,35,19
Réd,earthen-ring,1601,mage,frost,77,36,41
Icefix,dun-modr,1599,mage,frost,119,67,52
Absoluteswag,tarren-mill,1598,mage,frost,39,22,17
Takayaki,terokkar,1598,mage,frost,72,38,34
Mecharience,rexxar,1597,mage,frost,33,18,15
Iroya,festung-der-stürme,1597,mage,frost,179,90,89
Вольняша,azuregos,1591,mage,frost,112,49,63
Sersei,garona,1590,mage,frost,36,17,19
Knúbbz,ravencrest,1588,mage,frost,36,18,18
Okayhehexd,dun-morogh,1586,mage,frost,90,51,39
Leafløver,ravencrest,1586,mage,frost,59,30,29
Blasty,guldan,1585,mage,frost,75,32,43
Joulz,ravencrest,1583,mage,frost,200,94,106
Ёкай,soulflayer,1582,mage,frost,199,111,88
Ôbsury,hyjal,1581,mage,frost,106,56,50
Гамаюнх,deathguard,1581,mage,frost,48,23,25
Boomboomciao,nemesis,1578,mage,frost,102,49,53
Óuíja,outland,1576,mage,frost,45,28,17
Nimdáá,stormscale,1575,mage,frost,204,113,91
Мибринк,soulflayer,1575,mage,frost,72,32,40
Аквамелис,gordunni,1573,mage,frost,42,19,23
Iverson,kazzak,1571,mage,frost,69,29,40
Dubbleblast,draenor,1570,mage,frost,48,25,23
Petepan,argent-dawn,1570,mage,frost,109,53,56
Ингилейф,howling-fjord,1570,mage,frost,46,18,28
Datpolytho,twisting-nether,1567,mage,frost,54,36,18
Левелнес,howling-fjord,1567,mage,frost,74,32,42
Ceillech,blackrock,1564,mage,frost,76,38,38
Sheepmaster,aegwynn,1563,mage,frost,36,19,17
Smashdown,blackrock,1562,mage,frost,36,19,17
Hbarftw,ravencrest,1562,mage,frost,59,30,29
Itzlucky,twisting-nether,1561,mage,frost,166,82,84
Vyuca,argent-dawn,1559,mage,frost,52,28,24
Karstnstenzl,blackrock,1559,mage,frost,42,22,20
Chareyla,argent-dawn,1558,mage,frost,83,42,41
Afterimage,zuljin,1556,mage,frost,122,57,65
Gaduz,kazzak,1556,mage,frost,72,31,41
Rihnou,blackmoore,1551,mage,frost,89,40,49
Mxrrz,kazzak,1547,mage,frost,211,111,100
Icydeadsheep,draenor,1547,mage,frost,72,28,44
Ghalanz,ravencrest,1545,mage,frost,60,29,31
Homellander,silvermoon,1543,mage,frost,323,168,155
Бингчилинг,howling-fjord,1543,mage,frost,64,30,34
Старкскрим,gordunni,1542,mage,frost,100,48,52
Озобочений,greymane,1541,mage,frost,73,34,39
Koreanbbq,outland,1541,mage,frost,42,18,24
Necizbored,tarren-mill,1539,mage,frost,48,30,18
Sakuranosuke,twisting-nether,1534,mage,frost,36,20,16
Newintown,blackmoore,1533,mage,frost,56,30,26
Elcritadoré,ragnaros,1533,mage,frost,45,22,23
Walian,burning-blade,1532,mage,frost,42,24,18
Arimila,sylvanas,1532,mage,frost,156,75,81
Alluryeine,draenor,1531,mage,frost,59,34,25
Миднаит,gordunni,1531,mage,frost,105,47,58
Фоулли,howling-fjord,1528,mage,frost,34,17,17
Kèj,kazzak,1528,mage,frost,39,19,20
Widmage,silvermoon,1526,mage,frost,134,62,72
Fullpolly,twisting-nether,1525,mage,frost,36,23,13
Lilblinks,silvermoon,1525,mage,frost,30,18,12
Excuses,chamber-of-aspects,1525,mage,frost,290,143,147
Evilmagíc,tarren-mill,1523,mage,frost,30,16,14
Вендайса,soulflayer,1522,mage,frost,256,146,110
Tjq,ravencrest,1522,mage,frost,111,55,56
Beaun,tarren-mill,1521,mage,frost,87,46,41
Manafuzz,outland,1521,mage,frost,36,17,19
Qùb,eldrethalas,1519,mage,frost,42,23,19
Лакифриз,gordunni,1518,mage,frost,36,22,14
Únna,sanguino,1517,mage,frost,81,45,36
Larmp,outland,1517,mage,frost,42,16,26
Ney,drakthul,1516,mage,frost,24,16,8
Фемна,soulflayer,1515,mage,frost,119,65,54
Sekulicgoga,draenor,1515,mage,frost,309,168,141
Mystikj,arathor,1514,mage,frost,36,16,20
Ckrax,sanguino,1512,mage,frost,24,16,8
Rexør,frostwolf,1505,mage,frost,54,31,23
Denaleidi,stormscale,1505,mage,frost,54,30,24
Snakebit,kazzak,1505,mage,frost,73,37,36
Wýr,archimonde,1504,mage,frost,60,26,34
Isralysa,ravencrest,1502,mage,frost,251,131,120
Dzikk,silvermoon,1502,mage,frost,66,34,32
Kaì,twisting-nether,1499,mage,frost,90,51,39
Skretx,archimonde,1497,mage,frost,24,17,7
Shainax,dun-modr,1497,mage,frost,94,49,45
Spellcast,ravencrest,1496,mage,frost,33,18,15
Aeternitaz,outland,1492,mage,frost,53,28,25
Senedai,stormscale,1491,mage,frost,30,16,14
Averus,outland,1490,mage,frost,36,21,15
Мозифрост,gordunni,1490,mage,frost,62,23,39
Сосулькина,gordunni,1488,mage,frost,95,50,45
Phélenia,sargeras,1488,mage,frost,90,44,46
Surlancealot,outland,1488,mage,frost,53,23,30
Borko,rashgarroth,1486,mage,frost,36,19,17
Icekíss,hyjal,1486,mage,frost,70,33,37
Plætinum,ravencrest,1485,mage,frost,192,97,95
Свдпро,deathguard,1485,mage,frost,58,28,30
Корадо,gordunni,1483,mage,frost,120,54,66
Datakrigern,tarren-mill,1480,mage,frost,41,22,19
Saucise,hyjal,1480,mage,frost,54,28,26
Tromie,archimonde,1479,mage,frost,191,96,95
Scaleeth,kazzak,1479,mage,frost,40,18,22
Тачмахал,soulflayer,1478,mage,frost,60,31,29
Qqpwn,ragnaros,1477,mage,frost,65,32,33
Realone,ragnaros,1477,mage,frost,59,25,34
Zaruna,arathor,1476,mage,frost,63,33,30
Octtmiss,twisting-nether,1476,mage,frost,33,17,16
Spamblink,archimonde,1474,mage,frost,63,18,45
Rodatudo,ravencrest,1472,mage,frost,82,37,45
Sciren,nagrand,1471,mage,frost,31,16,15
Джейнанис,gordunni,1471,mage,frost,64,33,31
Vannq,silvermoon,1468,mage,frost,66,26,40
Tôke,kaelthas,1467,mage,frost,66,38,28
Ðíø,twisting-nether,1467,mage,frost,34,18,16
Kelthuzed,twisting-nether,1466,mage,frost,33,18,15
Fïttan,stormscale,1464,mage,frost,44,20,24
Néiloth,frostmane,1463,mage,frost,35,16,19
Nàtcho,tichondrius,1462,mage,frost,36,20,16
Hernêise,silvermoon,1462,mage,frost,167,87,80
Frostique,kazzak,1460,mage,frost,97,54,43
Trais,blackrock,1458,mage,frost,33,22,11
Tainted,eredar,1458,mage,frost,36,18,18
Lolmageop,aegwynn,1457,mage,frost,35,16,19
Hambones,outland,1456,mage,frost,38,16,22
Оай,gordunni,1456,mage,frost,54,22,32
Bebarz,darksorrow,1455,mage,frost,106,57,49
Råståfåri,uldum,1455,mage,frost,60,25,35
Метох,soulflayer,1454,mage,frost,168,78,90
Lesoleil,archimonde,1453,mage,frost,30,19,11
Ia,kirin-tor,1452,mage,frost,46,25,21
Дарнивил,gordunni,1452,mage,frost,167,85,82
Airo,drakthul,1451,mage,frost,36,22,14
Sangumage,silvermoon,1451,mage,frost,54,25,29
Azkarr,stormscale,1450,mage,frost,59,33,26
Dllarky,drakthul,1448,mage,frost,48,24,24
Khivax,twisting-nether,1448,mage,frost,66,27,39
Woorm,sylvanas,1446,mage,frost,76,44,32
Afklow,pozzo-delleternità,1442,mage,frost,39,21,18
Maquiwizz,aggra-português,1442,mage,frost,48,24,24
Eldariel,ravencrest,1442,mage,frost,83,39,44
Comodus,ragnaros,1437,mage,frost,112,52,60
Shnitz,stormscale,1436,mage,frost,24,15,9
Novalia,wrathbringer,1435,mage,frost,84,46,38
Astaden,die-aldor,1435,mage,frost,39,21,18
Hayaka,sanguino,1435,mage,frost,59,30,29
Charliezard,argent-dawn,1435,mage,frost,36,15,21
Нереварин,soulflayer,1435,mage,frost,42,15,27
Hazzá,ravencrest,1433,mage,frost,24,15,9
Maege,ragnaros,1432,mage,frost,32,17,15
Quadekun,tarren-mill,1432,mage,frost,30,15,15
Stillfrostin,blackrock,1430,mage,frost,60,38,22
Аваон,deathguard,1429,mage,frost,81,39,42
Фростидзе,gordunni,1427,mage,frost,60,27,33
Пиньон,borean-tundra,1425,mage,frost,36,21,15
Azakadabra,ysondre,1425,mage,frost,55,31,24
Jezí,ghostlands,1425,mage,frost,36,15,21
Моритакаа,gordunni,1424,mage,frost,60,33,27
Гатмир,gordunni,1423,mage,frost,231,115,116
Gêrky,drakthul,1422,mage,frost,108,53,55
Koreanbbq,kazzak,1422,mage,frost,65,31,34
Borêta,blackrock,1421,mage,frost,120,55,65
Jedite,die-todeskrallen,1420,mage,frost,218,114,104
Tærrëñshíll,tarren-mill,1420,mage,frost,36,15,21
Naylz,archimonde,1419,mage,frost,30,15,15
Iceiceice,stormscale,1418,mage,frost,54,30,24
Hellionblast,ragnaros,1416,mage,frost,30,15,15
Учительйода,ashenvale,1413,mage,frost,36,23,13
Hexmath,tarren-mill,1413,mage,frost,30,15,15
Nutsa,silvermoon,1412,mage,frost,24,15,9
Messatsux,tarren-mill,1411,mage,frost,30,15,15
Нонекс,soulflayer,1411,mage,frost,71,33,38
Zionw,frostwolf,1410,mage,frost,121,60,61
Xyfys,azshara,1409,mage,frost,24,15,9
Pipihu,silvermoon,1409,mage,frost,54,27,27
Elcølgaø,sanguino,1406,mage,frost,90,39,51
Firehasse,draenor,1400,mage,frost,104,57,47
Sixx,aegwynn,1400,mage,frost,41,19,22
Shagee,stormscale,1399,mage,frost,30,16,14
Kippercarry,outland,1398,mage,frost,30,15,15
Wormhole,kazzak,1398,mage,frost,30,15,15
Pluribusunum,outland,1398,mage,frost,38,17,21
Frèézê,frostwolf,1398,mage,frost,36,16,20
Tàylerdarden,nemesis,1396,mage,frost,65,29,36
Elynaé,draenor,1395,mage,frost,70,33,37
Apócalyptic,tarren-mill,1392,mage,frost,76,44,32
Nightplays,sylvanas,1391,mage,frost,36,22,14
Shüri,kazzak,1391,mage,frost,72,41,31
Ymirë,khaz-modan,1391,mage,frost,45,20,25
Shunii,ravencrest,1390,mage,frost,29,15,14
Гунмаказ,soulflayer,1384,mage,frost,28,20,8
Velâska,malganis,1383,mage,frost,81,47,34
Синийлед,galakrond,1382,mage,frost,144,69,75
Derbomber,guldan,1382,mage,frost,41,16,25
Lukewizard,twisting-nether,1381,mage,frost,56,32,24
Iulie,kazzak,1381,mage,frost,174,87,87
Zice,antonidas,1380,mage,frost,34,18,16
Psika,kazzak,1377,mage,frost,79,37,42
Bolesnimage,draenor,1376,mage,frost,47,28,19
Texita,sylvanas,1376,mage,frost,29,17,12
Eclyftw,blackmoore,1374,mage,frost,36,16,20
Find,archimonde,1373,mage,frost,86,36,50
Lsdt,stormscale,1372,mage,frost,42,16,26
Oizar,hyjal,1371,mage,frost,48,25,23
Цепнойпёс,goldrinn,1371,mage,frost,34,17,17
Daneliam,outland,1369,mage,frost,55,28,27
Mohovik,wildhammer,1368,mage,frost,30,15,15
Heathrow,ravencrest,1367,mage,frost,48,28,20
Анзот,howling-fjord,1366,mage,frost,40,23,17
Орижн,howling-fjord,1366,mage,frost,53,29,24
Smöked,tarren-mill,1366,mage,frost,294,150,144
Alicánte,silvermoon,1365,mage,frost,66,29,37
Iceorb,azshara,1364,mage,frost,114,52,62
Arlunea,blackmoore,1364,mage,frost,50,20,30
Cheerió,aggramar,1360,mage,frost,254,118,136
Dabka,argent-dawn,1359,mage,frost,193,95,98
Däpper,ragnaros,1357,mage,frost,42,16,26
Енотмаг,gordunni,1356,mage,frost,42,20,22
Фиджарь,soulflayer,1352,mage,frost,129,66,63
Fistersfrizz,aegwynn,1348,mage,frost,36,20,16
Sylênna,kazzak,1347,mage,frost,60,30,30
Corpusqq,eredar,1347,mage,frost,54,26,28
Morphees,twisting-nether,1345,mage,frost,36,22,14
Confine,twisting-nether,1345,mage,frost,70,34,36
Manvo,bloodscalp,1345,mage,frost,60,23,37
Jíncks,anachronos,1344,mage,frost,24,14,10
Preí,archimonde,1344,mage,frost,37,15,22
Seikatsu,sylvanas,1343,mage,frost,30,14,16
Dastion,sylvanas,1343,mage,frost,30,14,16
Abolf,twisting-nether,1342,mage,frost,36,20,16
Obbcontrol,ravencrest,1342,mage,frost,30,14,16
Lzd,ravencrest,1340,mage,frost,24,14,10
Dmmeforcam,archimonde,1340,mage,frost,26,15,11
Lovësosa,hyjal,1340,mage,frost,47,25,22
Jokiss,draenor,1339,mage,frost,114,57,57
Immobilizer,eredar,1339,mage,frost,78,39,39
Caesarclown,silvermoon,1339,mage,frost,131,65,66
Деорро,gordunni,1338,mage,frost,30,14,16
Grandbasile,hyjal,1338,mage,frost,30,14,16
Mollymorph,ragnaros,1338,mage,frost,42,14,28
Cinoox,blackrock,1337,mage,frost,34,15,19
Pruneau,hyjal,1336,mage,frost,53,28,25
Animaze,argent-dawn,1335,mage,frost,155,88,67
Tirenia,bloodfeather,1335,mage,frost,41,15,26
Fractox,ysondre,1334,mage,frost,118,61,57
Illius,kelthuzad,1334,mage,frost,37,18,19
Spelltastíc,blackmoore,1333,mage,frost,24,14,10
Imbatto,quelthalas,1332,mage,frost,42,20,22
Destruct,doomhammer,1331,mage,frost,66,38,28
Shinzel,hyjal,1331,mage,frost,64,26,38
Кройзис,howling-fjord,1328,mage,frost,80,46,34
Игрдлпдров,gordunni,1327,mage,frost,72,34,38
Pronyma,outland,1327,mage,frost,30,14,16
Dïabolike,archimonde,1326,mage,frost,36,22,14
Phenoxi,sylvanas,1325,mage,frost,24,14,10
Laenadria,argent-dawn,1325,mage,frost,71,28,43
Tìnder,tarren-mill,1324,mage,frost,78,40,38
Discomorph,the-maelstrom,1322,mage,frost,24,14,10
Tarkún,dun-modr,1321,mage,frost,66,39,27
Sused,outland,1321,mage,frost,30,16,14
Маушко,soulflayer,1321,mage,frost,77,40,37
Katarapower,silvermoon,1321,mage,frost,243,117,126
Nïo,ravencrest,1318,mage,frost,36,19,17
Mdog,stormreaver,1317,mage,frost,68,35,33
Zagori,sylvanas,1316,mage,frost,61,30,31
Кварийм,howling-fjord,1316,mage,frost,80,36,44
Лутиум,howling-fjord,1313,mage,frost,181,100,81
Левченкопро,soulflayer,1313,mage,frost,151,78,73
Hetaxata,kazzak,1313,mage,frost,32,16,16
Iceym,ravencrest,1313,mage,frost,41,17,24
Bænoß,ravencrest,1312,mage,frost,30,16,14
Crackheads,hyjal,1312,mage,frost,66,30,36
Seyece,silvermoon,1311,mage,frost,41,22,19
Umaguma,elune,1310,mage,frost,47,20,27
Iggilaus,blackhand,1308,mage,frost,333,166,167
Sandalf,lightnings-blade,1307,mage,frost,30,14,16
Ímnotback,outland,1306,mage,frost,277,139,138
Quilava,ghostlands,1305,mage,frost,37,19,18
Vrajitöru,doomhammer,1304,mage,frost,26,16,10
Mogettemagic,ysondre,1304,mage,frost,30,15,15
Alktraz,outland,1302,mage,frost,78,34,44
Викликс,borean-tundra,1301,mage,frost,40,22,18
Ryydee,silvermoon,1301,mage,frost,146,76,70
Magitron,wildhammer,1301,mage,frost,35,18,17
Iceterror,ravencrest,1300,mage,frost,24,15,9
Quail,anubarak,1300,mage,frost,136,64,72
Oiklo,eitrigg,1300,mage,frost,55,24,31
Nups,ravencrest,1300,mage,frost,84,35,49
Máurus,antonidas,1299,mage,frost,54,21,33
Psychosiss,kazzak,1298,mage,frost,49,27,22
Kaaguraa,ravencrest,1298,mage,frost,181,94,87
Lìx,ravencrest,1295,mage,frost,23,14,9
Магсимум,ashenvale,1292,mage,frost,35,18,17
Winterblues,frostmourne,1291,mage,frost,36,20,16
Seelengott,onyxia,1290,mage,frost,209,106,103
Kundry,tarren-mill,1289,mage,frost,42,16,26
Frostjävel,grim-batol,1288,mage,frost,46,24,22
Zoubaz,archimonde,1286,mage,frost,31,16,15
Voldemort,bronzebeard,1284,mage,frost,51,24,27
Funakin,blackrock,1284,mage,frost,48,18,30
Akúmã,stormscale,1278,mage,frost,203,100,103
Xhal,hyjal,1277,mage,frost,36,18,18
Jackin,burning-legion,1277,mage,frost,66,31,35
Гаразлик,howling-fjord,1277,mage,frost,168,77,91
Justleblanc,dalaran,1277,mage,frost,46,18,28
Flakeh,outland,1276,mage,frost,83,40,43
Mfnz,stormreaver,1275,mage,frost,35,15,20
Asteria,twisting-nether,1274,mage,frost,142,67,75
Kleini,die-aldor,1273,mage,frost,23,15,8
Nevaehine,ravencrest,1272,mage,frost,156,79,77
Silvariy,stormscale,1272,mage,frost,142,71,71
Teuboku,ysondre,1271,mage,frost,43,27,16
Tradez,norgannon,1271,mage,frost,42,17,25
Jaghahah,tarren-mill,1266,mage,frost,90,52,38
Lenycz,burning-blade,1266,mage,frost,36,19,17
Alkhazzar,defias-brotherhood,1265,mage,frost,214,97,117
Nightnovae,ravencrest,1265,mage,frost,42,17,25
Tacto,ravencrest,1264,mage,frost,160,84,76
Nandie,stormreaver,1263,mage,frost,32,18,14
Zwölfte,outland,1262,mage,frost,100,57,43
Braxxorz,chamber-of-aspects,1261,mage,frost,36,24,12
Sikaia,twisting-nether,1261,mage,frost,45,21,24
Дырявка,galakrond,1261,mage,frost,72,32,40
Qtiepatootie,silvermoon,1260,mage,frost,157,84,73
Zeusmon,ragnaros,1260,mage,frost,41,17,24
Shroomie,eredar,1258,mage,frost,78,35,43
Nuryielle,blackmoore,1256,mage,frost,30,15,15
Проблембойх,gordunni,1248,mage,frost,24,13,11
Ghettomagé,aegwynn,1247,mage,frost,30,13,17
Abruaa,tarren-mill,1246,mage,frost,18,13,5
Crzyubrdrver,blackrock,1246,mage,frost,24,13,11
Bengé,ragnaros,1245,mage,frost,22,14,8
Bceps,stormscale,1245,mage,frost,66,35,31
Xânârchy,minahonda,1242,mage,frost,72,33,39
Rinuria,blackrock,1241,mage,frost,18,13,5
Dabina,sanguino,1240,mage,frost,54,25,29
Donishakur,ragnaros,1240,mage,frost,37,13,24
Track,blackhand,1238,mage,frost,30,13,17
Titanshao,silvermoon,1237,mage,frost,24,16,8
Криолетта,gordunni,1237,mage,frost,78,35,43
Séptímus,kazzak,1237,mage,frost,34,15,19
Вайконд,howling-fjord,1236,mage,frost,50,23,27
Prinskoekie,twisting-nether,1235,mage,frost,100,39,61
Wslyx,dun-morogh,1233,mage,frost,42,13,29
Stace,area-52,1231,mage,frost,42,13,29
Glöden,ravencrest,1228,mage,frost,24,13,11
Luxxurious,xavius,1225,mage,frost,34,14,20
Pyroden,stormscale,1224,mage,frost,42,18,24
Boredpeon,burning-legion,1223,mage,frost,60,31,29
Gliffy,terokkar,1222,mage,frost,49,29,20
Dyx,nemesis,1222,mage,frost,78,33,45
Хблэйз,howling-fjord,1222,mage,frost,36,14,22
Eléaena,argent-dawn,1221,mage,frost,30,13,17
Pwntt,terenas,1219,mage,frost,51,20,31
Suidas,auchindoun,1217,mage,frost,66,28,38
Apic,blackrock,1215,mage,frost,23,15,8
Lupuus,anubarak,1215,mage,frost,24,13,11
Faycia,blackhand,1212,mage,frost,72,30,42
Meydoum,archimonde,1209,mage,frost,24,13,11
Esculapìo,nemesis,1207,mage,frost,124,64,60
Olivaresa,ravencrest,1205,mage,frost,50,17,33
Хоф,deathguard,1204,mage,frost,30,13,17
Zevúlòs,ravencrest,1202,mage,frost,42,28,14
Rektd,blackhand,1193,mage,frost,133,61,72
Vathalis,zuluhed,1193,mage,frost,77,29,48
Phaege,defias-brotherhood,1192,mage,frost,32,15,17
Søphiâ,thrall,1191,mage,frost,72,38,34
Вельдрик,soulflayer,1191,mage,frost,142,71,71
Orelox,kazzak,1191,mage,frost,29,13,16
Вескнам,lich-king,1188,mage,frost,72,30,42
Сибиди,gordunni,1185,mage,frost,24,13,11
Fleurdelacur,ravencrest,1182,mage,frost,57,29,28
Хируэль,gordunni,1180,mage,frost,98,47,51
Scaless,stormscale,1176,mage,frost,77,37,40
Инкрионити,gordunni,1175,mage,frost,23,13,10
Yenkonidas,blackmoore,1175,mage,frost,54,23,31
Quincy,frostwolf,1173,mage,frost,54,24,30
Kótaranka,kazzak,1168,mage,frost,47,21,26
Zvuta,sanguino,1166,mage,frost,18,14,4
Zzombi,sylvanas,1166,mage,frost,81,39,42
Айсвеном,gordunni,1166,mage,frost,36,16,20
Akâri,silvermoon,1166,mage,frost,31,13,18
Морозящий,howling-fjord,1162,mage,frost,165,84,81
Bossgb,twisting-nether,1160,mage,frost,27,15,12
Flamya,stormscale,1160,mage,frost,47,20,27
Nazø,archimonde,1158,mage,frost,80,36,44
Hagiko,archimonde,1156,mage,frost,21,14,7
Baravar,blackrock,1155,mage,frost,35,14,21
Айсбоунт,eversong,1151,mage,frost,49,27,22
Valyndra,twisting-nether,1150,mage,frost,18,12,6
Amicuta,ravencrest,1150,mage,frost,48,24,24
Arcticfury,ravencrest,1149,mage,frost,24,12,12
Anamalhoa,aggra-português,1147,mage,frost,36,18,18
Sukky,todeswache,1146,mage,frost,24,12,12
Gameboycolor,ravencrest,1146,mage,frost,30,12,18
Чистокрут,gordunni,1146,mage,frost,36,12,24
Блья,howling-fjord,1145,mage,frost,54,31,23
Ayoubz,outland,1145,mage,frost,24,12,12
Scoodles,kazzak,1145,mage,frost,30,12,18
Goukí,drakthul,1144,mage,frost,18,12,6
Tiltedpapi,ravencrest,1142,mage,frost,46,24,22
Qulinx,kazzak,1142,mage,frost,29,13,16
Magjaw,twisting-nether,1141,mage,frost,30,18,12
Maggresive,sylvanas,1140,mage,frost,30,15,15
Iceicebáby,draenor,1139,mage,frost,36,17,19
Frostvirgin,twisting-nether,1138,mage,frost,30,12,18
Frostyfart,tarren-mill,1136,mage,frost,24,12,12
Aern,sinstralis,1136,mage,frost,30,12,18
Дивеансерт,blackscar,1136,mage,frost,36,13,23
Rafaeala,argent-dawn,1135,mage,frost,121,64,57
Oathkeepper,silvermoon,1135,mage,frost,124,60,64
Райдзен,greymane,1135,mage,frost,75,30,45
Momotemp,emerald-dream,1133,mage,frost,102,50,52
Roughfked,silvermoon,1132,mage,frost,68,39,29
Iamslow,sylvanas,1130,mage,frost,18,12,6
Stryee,ragnaros,1128,mage,frost,24,12,12
Ewina,twisting-nether,1128,mage,frost,24,12,12
Tomuru,draenor,1127,mage,frost,74,44,30
Gacosane,chamber-of-aspects,1126,mage,frost,75,30,45
Vignoni,the-maelstrom,1125,mage,frost,24,12,12
Lêgólás,blackmoore,1119,mage,frost,24,12,12
Lifemagic,chamber-of-aspects,1118,mage,frost,81,43,38
Pinkis,darkmoon-faire,1116,mage,frost,79,40,39
Kapueca,jaedenar,1110,mage,frost,39,25,14
Roey,defias-brotherhood,1110,mage,frost,30,14,16
Suikune,twisting-nether,1104,mage,frost,18,12,6
Луциаз,gordunni,1104,mage,frost,41,24,17
Popixx,magtheridon,1102,mage,frost,42,13,29
Kalyipso,blackrock,1097,mage,frost,48,14,34
Tygaone,tirion,1096,mage,frost,36,17,19
Саназэр,soulflayer,1095,mage,frost,66,30,36
Latiny,destromath,1091,mage,frost,65,28,37
Kadsy,tarren-mill,1090,mage,frost,41,18,23
Aileean,burning-legion,1087,mage,frost,47,20,27
Saphiregos,dalaran,1085,mage,frost,112,54,58
Goeb,kazzak,1083,mage,frost,35,14,21
Niivel,ysondre,1082,mage,frost,120,68,52
Warwizz,sanguino,1081,mage,frost,22,12,10
Килавый,eversong,1080,mage,frost,24,16,8
Broduy,draenor,1079,mage,frost,90,40,50
Çxçx,dun-modr,1077,mage,frost,30,12,18
Aelire,die-aldor,1077,mage,frost,33,12,21
Isolia,silvermoon,1075,mage,frost,29,12,17
Metaboi,ragnaros,1072,mage,frost,47,14,33
Cardioexpert,ravencrest,1071,mage,frost,19,12,7
Arcanik,archimonde,1065,mage,frost,49,14,35
Miidi,doomhammer,1064,mage,frost,42,23,19
Дедамаг,eversong,1064,mage,frost,36,18,18
Shivah,onyxia,1064,mage,frost,118,46,72
Jodiefroster,bronzebeard,1063,mage,frost,50,29,21
Xèrec,ysondre,1058,mage,frost,36,12,24
Лемозяра,gordunni,1056,mage,frost,12,11,1
Elldiamage,draenor,1056,mage,frost,24,11,13
Унитазныймаг,howling-fjord,1056,mage,frost,24,11,13
Unsaîntly,kult-der-verdammten,1056,mage,frost,28,11,17
Decedé,dun-modr,1055,mage,frost,18,11,7
Xläderz,ravencrest,1055,mage,frost,18,11,7
Tenetic,thrall,1055,mage,frost,20,11,9
Stümpy,ravencrest,1055,mage,frost,24,11,13
Yshax,malganis,1055,mage,frost,36,11,25
Síckmode,khadgar,1055,mage,frost,36,11,25
Rere,zenedar,1054,mage,frost,26,13,13
Kõl,ravencrest,1054,mage,frost,24,11,13
Grömit,drakthul,1053,mage,frost,18,11,7
Ilovedana,dun-modr,1053,mage,frost,38,11,27
Xzp,der-rat-von-dalaran,1052,mage,frost,24,11,13
Pixlet,kazzak,1052,mage,frost,30,11,19
Винилочка,deathguard,1051,mage,frost,24,11,13
Бальзамон,eversong,1051,mage,frost,37,15,22
Ízumi,stormscale,1051,mage,frost,30,11,19
Lyramage,draenor,1051,mage,frost,36,11,25
Destrech,aggra-português,1050,mage,frost,18,11,7
Morozuvko,tarren-mill,1050,mage,frost,18,11,7
Файрусх,blackscar,1049,mage,frost,18,11,7
Жемчужина,eversong,1049,mage,frost,18,11,7
Shakamage,grim-batol,1049,mage,frost,28,14,14
Shøcked,blackrock,1049,mage,frost,36,11,25
Spellsteal,antonidas,1048,mage,frost,24,11,13
Chililol,dun-modr,1048,mage,frost,24,11,13
Ryzea,ravencrest,1047,mage,frost,23,15,8
Риктусемпра,ashenvale,1047,mage,frost,18,11,7
Atixx,aegwynn,1047,mage,frost,36,11,25
Qwixxis,sylvanas,1045,mage,frost,96,44,52
Férécide,ysondre,1045,mage,frost,30,11,19
Умелецмаг,gordunni,1044,mage,frost,54,27,27
Bobbasor,defias-brotherhood,1044,mage,frost,37,14,23
Ãzi,ravencrest,1042,mage,frost,18,11,7
Ørcan,azshara,1042,mage,frost,78,29,49
Thry,bronzebeard,1042,mage,frost,30,11,19
Blinklet,twisting-nether,1040,mage,frost,26,17,9
Юлианх,gordunni,1039,mage,frost,256,124,132
Khoshgele,draenor,1039,mage,frost,24,11,13
Irreversal,ravencrest,1037,mage,frost,59,27,32
Nåzmyz,outland,1035,mage,frost,66,28,38
Clonefcf,sylvanas,1032,mage,frost,55,31,24
Forestie,silvermoon,1032,mage,frost,50,23,27
Mystto,silvermoon,1030,mage,frost,48,29,19
Snowrain,chogall,1030,mage,frost,47,23,24
Ramcoz,twisting-nether,1029,mage,frost,42,21,21
Ananaskana,ragnaros,1025,mage,frost,18,11,7
Lunnysvet,blackrock,1024,mage,frost,47,24,23
Коласольдом,gordunni,1024,mage,frost,24,11,13
Neverblockx,blackrock,1023,mage,frost,16,11,5
Skyra,les-sentinelles,1023,mage,frost,36,21,15
Yasheaa,ysondre,1020,mage,frost,23,11,12
Tiefkühler,norgannon,1019,mage,frost,36,19,17
Icyshot,blackhand,1019,mage,frost,24,11,13
Gønzô,blackmoore,1018,mage,frost,49,21,28
Dumbledores,aegwynn,1018,mage,frost,59,25,34
Sântillius,twisting-nether,1016,mage,frost,18,11,7
Pinguíni,aegwynn,1015,mage,frost,54,25,29
Shíntaro,stormscale,1013,mage,frost,41,12,29
Fôôxy,aegwynn,1009,mage,frost,29,11,18
Илайла,booty-bay,1007,mage,frost,15,12,3
Fashes,sunstrider,1006,mage,frost,81,40,41
Smõóve,hyjal,1005,mage,frost,84,32,52
Thalaja,kazzak,1005,mage,frost,29,11,18
Rusdor,frostwhisper,1000,mage,frost,42,13,29
Этридемус,howling-fjord,1000,mage,frost,42,11,31
Фрайбл,gordunni,997,mage,frost,25,12,13
Erzà,todeswache,991,mage,frost,35,18,17
Labyssra,argent-dawn,990,mage,frost,20,11,9
Kumakara,archimonde,981,mage,frost,24,12,12
Дроййд,gordunni,981,mage,frost,52,14,38
Didub,outland,977,mage,frost,36,13,23
Dnt,twilights-hammer,974,mage,frost,24,11,13
Schtenen,silvermoon,971,mage,frost,192,88,104
Zedsdeadbaby,argent-dawn,968,mage,frost,67,31,36
Acx,drakthul,960,mage,frost,18,10,8
Cosmostms,ravencrest,960,mage,frost,18,10,8
Oblív,ravencrest,960,mage,frost,24,10,14
Reákan,ragnaros,959,mage,frost,18,10,8
Brolyzerr,archimonde,959,mage,frost,19,10,9
Тортикток,soulflayer,959,mage,frost,24,10,14
Spacehoe,stormscale,959,mage,frost,24,10,14
Kyrox,ysondre,959,mage,frost,42,12,30
Spellfaker,drakthul,958,mage,frost,12,10,2
Джинетикс,deathguard,958,mage,frost,18,10,8
Pølåris,outland,958,mage,frost,18,10,8
Javelintouch,eldrethalas,957,mage,frost,18,10,8
Doidadetanga,aggra-português,957,mage,frost,24,10,14
Widurr,burning-legion,956,mage,frost,24,10,14
Соорка,gordunni,956,mage,frost,24,10,14
Zenó,blackrock,956,mage,frost,30,10,20
Gyanni,blackmoore,955,mage,frost,18,10,8
Anthrex,drakthul,955,mage,frost,24,10,14
Grismage,twisting-nether,955,mage,frost,36,10,26
Bambaga,kazzak,954,mage,frost,24,10,14
Vamelia,blackmoore,953,mage,frost,54,22,32
Dollzer,khaz-modan,952,mage,frost,18,10,8
Adagar,chamber-of-aspects,952,mage,frost,24,10,14
Xaerow,archimonde,951,mage,frost,18,10,8
Jobarttrach,les-clairvoyants,951,mage,frost,138,70,68
Ezzekkiel,elune,951,mage,frost,24,12,12
Бабайбайкала,gordunni,951,mage,frost,36,10,26
Haljina,kazzak,949,mage,frost,255,117,138
Celdra,blackrock,949,mage,frost,24,10,14
Shanny,argent-dawn,948,mage,frost,18,10,8
Maybeblood,kazzak,946,mage,frost,28,11,17
Frisstana,outland,946,mage,frost,30,10,20
Evuryl,nemesis,944,mage,frost,24,10,14
Helloimgone,blackmoore,943,mage,frost,23,10,13
Neboonu,sylvanas,942,mage,frost,42,19,23
Chogger,blackmoore,938,mage,frost,30,17,13
Fujitoras,khaz-modan,938,mage,frost,54,25,29
Xæl,ravencrest,929,mage,frost,87,44,43
Speedshatter,aegwynn,928,mage,frost,22,10,12
Мосгормаг,gordunni,924,mage,frost,23,10,13
Qwibbly,kazzak,921,mage,frost,17,10,7
Pyro,eldrethalas,918,mage,frost,32,11,21
Teals,turalyon,915,mage,frost,48,16,32
Piego,turalyon,913,mage,frost,70,37,33
Døliprane,garona,911,mage,frost,54,28,26
Toxttr,drakthul,908,mage,frost,18,11,7
Magicoliwia,ysera,905,mage,frost,30,16,14
Tvångstralla,tarren-mill,905,mage,frost,21,11,10
Mutly,kazzak,900,mage,frost,20,11,9
Ттэль,gordunni,899,mage,frost,46,23,23
Misscandy,doomhammer,898,mage,frost,79,35,44
Мрперут,eversong,895,mage,frost,125,64,61
Funnyzowie,minahonda,895,mage,frost,20,10,10
Pickaachu,doomhammer,893,mage,frost,30,15,15
Çana,thrall,893,mage,frost,22,10,12
Frostspree,wildhammer,892,mage,frost,20,10,10
Wopi,sylvanas,890,mage,frost,36,13,23
Êmmá,blackmoore,885,mage,frost,54,22,32
Heavyfire,kazzak,884,mage,frost,23,12,11
Sammelbot,kargath,872,mage,frost,48,24,24
Lexalia,blackmoore,869,mage,frost,32,14,18
Venu,dun-modr,866,mage,frost,36,17,19
Zauberdose,blackhand,864,mage,frost,12,9,3
Fakeklepter,sylvanas,864,mage,frost,12,9,3
Andors,conseil-des-ombres,864,mage,frost,18,9,9
Mizt,ragnaros,864,mage,frost,24,9,15
Qtpoof,sylvanas,863,mage,frost,18,9,9
Qqcult,ravencrest,863,mage,frost,18,9,9
Мирикон,gordunni,863,mage,frost,18,9,9
Næj,hyjal,863,mage,frost,18,9,9
Авгурей,howling-fjord,863,mage,frost,18,9,9
Musé,kazzak,863,mage,frost,18,9,9
Rodeyy,nathrezim,863,mage,frost,18,9,9
Слизерин,gordunni,863,mage,frost,24,9,15
Muchmage,silvermoon,863,mage,frost,24,9,15
Darkseidez,alonsus,862,mage,frost,18,9,9
Манднесс,azuregos,861,mage,frost,18,9,9
Souleh,ravencrest,861,mage,frost,18,9,9
Strychne,ragnaros,860,mage,frost,12,9,3
Raikøn,blackmoore,860,mage,frost,18,9,9
Noviina,argent-dawn,860,mage,frost,18,9,9
Cybercommand,blackmoore,860,mage,frost,31,15,16
Zanazanelor,twisting-nether,859,mage,frost,18,9,9
Ilikepoly,blackmoore,859,mage,frost,18,9,9
Amazona,veklor,859,mage,frost,38,18,20
Lylla,cthun,859,mage,frost,24,9,15
Klésh,nemesis,858,mage,frost,18,9,9
Naote,blackhand,858,mage,frost,18,9,9
Aûrûm,silvermoon,858,mage,frost,24,9,15
Vexperious,tarren-mill,857,mage,frost,12,9,3
Markasaura,kazzak,856,mage,frost,38,11,27
Voralastor,doomhammer,855,mage,frost,12,9,3
Nargaroc,blackhand,855,mage,frost,24,9,15
Farrä,dun-modr,854,mage,frost,53,26,27
Narzoul,ysondre,849,mage,frost,18,9,9
Банана,lich-king,847,mage,frost,18,9,9
Madzía,ravencrest,842,mage,frost,33,16,17
Ghostgivree,archimonde,839,mage,frost,54,24,30
Лордбелиал,soulflayer,834,mage,frost,24,9,15
Rintoh,pozzo-delleternità,828,mage,frost,30,9,21
Eìnì,kazzak,815,mage,frost,17,9,8
Zenoss,khaz-modan,815,mage,frost,42,18,24
Aerius,lightnings-blade,813,mage,frost,21,9,12
Lemonshelo,archimonde,806,mage,frost,27,9,18
Frigus,khaz-modan,804,mage,frost,27,9,18
Hooffer,stormscale,797,mage,frost,28,9,19
Rusdorcito,frostwhisper,793,mage,frost,25,10,15
Margistikus,die-aldor,776,mage,frost,111,57,54
Rillia,argent-dawn,768,mage,frost,12,8,4
Утрус,soulflayer,768,mage,frost,12,8,4
Arunx,magtheridon,768,mage,frost,12,8,4
Botanicula,the-maelstrom,768,mage,frost,12,8,4
Procahontas,ravencrest,768,mage,frost,12,8,4
Drmng,stormscale,768,mage,frost,12,8,4
Séxmachiné,draenor,768,mage,frost,12,8,4
Ascik,dalaran,768,mage,frost,12,8,4
Ambulancex,kazzak,768,mage,frost,12,8,4
Subzeraxo,archimonde,768,mage,frost,12,8,4
Serclulz,ravencrest,768,mage,frost,12,8,4
Trashmage,blackrock,768,mage,frost,12,8,4
Väänik,draenor,768,mage,frost,18,8,10
Transformo,draenor,768,mage,frost,18,8,10
Terash,ravencrest,768,mage,frost,18,8,10
Nelfchewer,ravencrest,768,mage,frost,18,8,10
Mðj,kazzak,768,mage,frost,18,8,10
Styxmg,blackhand,768,mage,frost,18,8,10
Гдедипфриз,soulflayer,768,mage,frost,18,8,10
Frígíd,outland,768,mage,frost,18,8,10
Bumboozling,kazzak,768,mage,frost,18,8,10
Venque,blackrock,768,mage,frost,24,8,16
Zelimeth,outland,768,mage,frost,24,8,16
Blinkfloyd,blackmoore,768,mage,frost,24,8,16
Wambamm,ravencrest,768,mage,frost,24,8,16
Gagaj,ravencrest,767,mage,frost,12,8,4
Chicke,outland,767,mage,frost,12,8,4
Zili,draenor,767,mage,frost,12,8,4
Tajos,drakthul,767,mage,frost,12,8,4
Нуклер,howling-fjord,767,mage,frost,12,8,4
Экструдия,gordunni,767,mage,frost,12,8,4
Lumberth,sanguino,767,mage,frost,12,8,4
Opíum,tarren-mill,767,mage,frost,12,8,4
Bamz,malganis,767,mage,frost,18,8,10
Goodheadcake,ragnaros,767,mage,frost,18,8,10
Autramage,emerald-dream,767,mage,frost,18,8,10
Archyl,kazzak,767,mage,frost,18,8,10
Khorosho,draenor,767,mage,frost,24,8,16
Vinlimar,drakthul,767,mage,frost,24,8,16
Maximilian,pozzo-delleternità,767,mage,frost,24,8,16
Insanewizard,kazzak,766,mage,frost,12,8,4
Thorstäin,ragnaros,766,mage,frost,12,8,4
Anoez,kargath,766,mage,frost,18,8,10
Illiaria,antonidas,765,mage,frost,12,8,4
Ærrflôw,frostwolf,765,mage,frost,18,8,10
Partagedeco,dalaran,765,mage,frost,18,8,10
Xakiha,kazzak,764,mage,frost,18,8,10
Шанлис,gordunni,763,mage,frost,18,8,10
Skarxaa,sanguino,763,mage,frost,18,8,10
Кельтузат,azuregos,762,mage,frost,12,8,4
Dominos,medivh,762,mage,frost,18,8,10
Archilól,drakthul,762,mage,frost,18,8,10
Полеморв,soulflayer,761,mage,frost,18,8,10
Edwiin,dun-morogh,761,mage,frost,33,9,24
Gedzi,silvermoon,758,mage,frost,12,8,4
Tomjedusor,hyjal,757,mage,frost,12,8,4
Gnoumen,shadowsong,755,mage,frost,18,8,10
Мерджреквест,howling-fjord,745,mage,frost,17,8,9
Qqlool,draenor,735,mage,frost,23,8,15
Amalou,stormscale,729,mage,frost,32,9,23
Mumpii,blackrock,719,mage,frost,17,8,9
Clitch,blutkessel,715,mage,frost,20,9,11
Чогоце,eversong,715,mage,frost,66,19,47
Coldnight,uldum,712,mage,frost,25,9,16
Kaeki,khaz-modan,708,mage,frost,20,10,10
Scoxywoxy,ragnaros,708,mage,frost,22,10,12
Thamagus,burning-legion,702,mage,frost,17,9,8
Tjayy,kazzak,702,mage,frost,26,8,18
Rayniß,blackmoore,702,mage,frost,26,8,18
Щавзорву,gordunni,686,mage,frost,16,8,8
Lanere,argent-dawn,684,mage,frost,19,8,11
Atreu,mazrigos,684,mage,frost,26,10,16
Icéy,kazzak,672,mage,frost,12,7,5
Fîsheye,blackrock,672,mage,frost,12,7,5
Wortyvery,outland,672,mage,frost,12,7,5
Gizzoo,draenor,672,mage,frost,12,7,5
Lyès,uldaman,672,mage,frost,12,7,5
Альмодера,gordunni,672,mage,frost,12,7,5
Monkeydmafia,blackrock,672,mage,frost,12,7,5
Glindalefay,silvermoon,672,mage,frost,12,7,5
Agus,ravencrest,672,mage,frost,12,7,5
Hérä,archimonde,672,mage,frost,12,7,5
Birckin,sanguino,672,mage,frost,12,7,5
Gøsu,rexxar,672,mage,frost,12,7,5
Yobys,burning-legion,672,mage,frost,12,7,5
Hendersson,blackrock,672,mage,frost,12,7,5
Schmutzki,eredar,672,mage,frost,12,7,5
Skyblink,hyjal,672,mage,frost,12,7,5
Candydead,alakir,672,mage,frost,12,7,5
Njl,blackmoore,672,mage,frost,12,7,5
Viro,defias-brotherhood,672,mage,frost,15,8,7
Drwrey,tarren-mill,672,mage,frost,18,7,11
Dalaras,archimonde,672,mage,frost,18,7,11
Mezaiyh,blackmoore,672,mage,frost,18,7,11
Lillelord,defias-brotherhood,672,mage,frost,18,7,11
Drandis,blackmoore,672,mage,frost,18,7,11
Løgi,drakthul,672,mage,frost,18,7,11
Mageyreid,quelthalas,672,mage,frost,18,7,11
Azegodxlul,kazzak,672,mage,frost,18,7,11
Aterso,azshara,672,mage,frost,21,8,13
Krookéd,tarren-mill,672,mage,frost,24,7,17
Wàneís,ravencrest,672,mage,frost,24,7,17
Tabueno,kazzak,672,mage,frost,24,7,17
Митгори,gordunni,671,mage,frost,12,7,5
Ellyson,silvermoon,671,mage,frost,12,7,5
Broccosoup,kazzak,671,mage,frost,12,7,5
Badphaz,frostmane,671,mage,frost,12,7,5
Møstwãntêd,aegwynn,671,mage,frost,12,7,5
Microsmag,thrall,671,mage,frost,12,7,5
Kokenn,hyjal,671,mage,frost,12,7,5
Geepie,twisting-nether,671,mage,frost,12,7,5
Мэлфариус,soulflayer,671,mage,frost,18,7,11
Hardways,archimonde,671,mage,frost,18,7,11
Crayz,magtheridon,671,mage,frost,18,7,11
Primodious,kazzak,671,mage,frost,18,7,11
Finkle,spinebreaker,671,mage,frost,18,7,11
Ice,sargeras,671,mage,frost,18,7,11
Kyrn,zuljin,671,mage,frost,18,7,11
Chread,bronze-dragonflight,671,mage,frost,18,7,11
Fyriel,burning-legion,671,mage,frost,18,7,11
Antaos,drakthul,671,mage,frost,18,7,11
Edelvise,azjolnerub,671,mage,frost,30,7,23
Cns,tarren-mill,670,mage,frost,12,7,5
Suitx,draenor,670,mage,frost,12,7,5
Hotpotatox,ravencrest,670,mage,frost,13,7,6
Комонщик,howling-fjord,670,mage,frost,18,7,11
Ronnyraggare,silvermoon,670,mage,frost,18,7,11
Misskity,blackrock,670,mage,frost,18,7,11
Unreadyx,archimonde,670,mage,frost,18,7,11
Placidius,twisting-nether,670,mage,frost,18,7,11
Nery,ravencrest,670,mage,frost,18,7,11
Quaile,malygos,670,mage,frost,24,7,17
Crematorium,argent-dawn,669,mage,frost,19,7,12
Allotropia,ravencrest,668,mage,frost,18,7,11
Aériza,silvermoon,667,mage,frost,12,7,5
Bolthen,uldum,667,mage,frost,24,7,17
Yojimbot,archimonde,667,mage,frost,36,7,29
Vurtnez,kazzak,665,mage,frost,15,7,8
Listro,argent-dawn,664,mage,frost,12,7,5
Madbad,auchindoun,662,mage,frost,18,7,11
Sinanogan,draenor,658,mage,frost,24,7,17
Xatures,tarren-mill,653,mage,frost,23,7,16
Expulse,blackmoore,639,mage,frost,11,7,4
Escobar,frostmane,622,mage,frost,26,8,18
Skæde,ravencrest,618,mage,frost,17,11,6
Svanteg,kazzak,618,mage,frost,14,8,6
Hidrax,outland,617,mage,frost,15,9,6
Jockin,stormrage,616,mage,frost,19,8,11
Ioriyagami,dragonmaw,608,mage,frost,22,7,15
Sleîhg,sanguino,607,mage,frost,16,7,9
Tharillion,drakthul,606,mage,frost,14,7,7
Estonka,ravencrest,576,mage,frost,6,6,0
Escapematrix,ravencrest,576,mage,frost,6,6,0
Necro,zuljin,576,mage,frost,6,6,0
Sölø,stormscale,576,mage,frost,6,6,0
Kurtcobain,draenor,576,mage,frost,12,6,6
Ouija,kazzak,576,mage,frost,12,6,6
Sainth,sanguino,576,mage,frost,12,6,6
Сизаам,howling-fjord,576,mage,frost,12,6,6
Søo,kazzak,576,mage,frost,12,6,6
Skdroople,ravencrest,576,mage,frost,12,6,6
Shifteurprõ,hyjal,576,mage,frost,12,6,6
Magicdingo,lightnings-blade,576,mage,frost,12,6,6
Azrx,blackmoore,576,mage,frost,12,6,6
Caststuffatu,sylvanas,576,mage,frost,12,6,6
Alirya,stormscale,576,mage,frost,12,6,6
Alcatrax,bronze-dragonflight,576,mage,frost,12,6,6
Dumblemore,ragnaros,576,mage,frost,12,6,6
Sickofme,blackmoore,576,mage,frost,12,6,6
Titarie,ravencrest,576,mage,frost,12,6,6
Watchmylance,blackrock,576,mage,frost,12,6,6
Froststarr,burning-legion,576,mage,frost,12,6,6
Диппро,soulflayer,576,mage,frost,12,6,6
Elgriefo,sylvanas,576,mage,frost,12,6,6
Ecnaclappy,blackrock,576,mage,frost,12,6,6
Invinsible,xavius,576,mage,frost,12,6,6
Рамблз,gordunni,576,mage,frost,12,6,6
Kanjani,antonidas,576,mage,frost,12,6,6
Halfanapple,the-maelstrom,576,mage,frost,12,6,6
Nécrømage,confrérie-du-thorium,576,mage,frost,12,6,6
Creden,frostmane,576,mage,frost,12,6,6
Миллерфест,howling-fjord,576,mage,frost,12,6,6
Jakora,bronze-dragonflight,576,mage,frost,12,6,6
Wheí,ravencrest,576,mage,frost,12,6,6
Insømnium,stormscale,576,mage,frost,12,6,6
Lepronsito,kazzak,576,mage,frost,12,6,6
Wickedblink,ravencrest,576,mage,frost,12,6,6
Zikyo,silvermoon,576,mage,frost,18,6,12
Articunoh,ravencrest,576,mage,frost,18,6,12
Reeroll,arthas,576,mage,frost,18,6,12
Деметрадон,gordunni,576,mage,frost,18,6,12
Ury,hyjal,576,mage,frost,18,6,12
Shakeándbake,ravencrest,576,mage,frost,18,6,12
Wenndrid,draenor,576,mage,frost,24,6,18
Poter,silvermoon,575,mage,frost,12,6,6
Depai,blackrock,575,mage,frost,12,6,6
Zulko,krasus,575,mage,frost,12,6,6
Pitbones,archimonde,575,mage,frost,12,6,6
Tyronesbone,stormscale,575,mage,frost,12,6,6
Jokèr,silvermoon,575,mage,frost,12,6,6
Yvonnita,chamber-of-aspects,575,mage,frost,12,6,6
Cafcaf,archimonde,575,mage,frost,12,6,6
Razzìatore,pozzo-delleternità,575,mage,frost,13,6,7
Длинныеухи,blackscar,575,mage,frost,18,6,12
Saturator,burning-legion,575,mage,frost,18,6,12
Bloodymage,zenedar,575,mage,frost,18,6,12
Kaptenski,stormscale,575,mage,frost,24,6,18
Crashleaf,argent-dawn,575,mage,frost,24,6,18
Zyxiie,sylvanas,575,mage,frost,24,6,18
Panlong,twisting-nether,574,mage,frost,12,6,6
Вхламинка,howling-fjord,574,mage,frost,12,6,6
Larsimore,drakthul,574,mage,frost,12,6,6
Bhaâl,hyjal,574,mage,frost,12,6,6
Galdrari,sylvanas,574,mage,frost,12,6,6
Pumpzy,tarren-mill,574,mage,frost,18,6,12
Stilnox,nemesis,574,mage,frost,18,6,12
Piscialetto,nemesis,572,mage,frost,18,6,12
Oryom,blackhand,566,mage,frost,12,6,6
Hadziaj,doomhammer,565,mage,frost,30,6,24
Soulcatcheus,archimonde,560,mage,frost,24,6,18
Maran,outland,555,mage,frost,24,6,18
Løxyy,ysondre,543,mage,frost,14,7,7
Meign,eredar,537,mage,frost,22,8,14
Mínêrvâ,blackrock,528,mage,frost,15,7,8
Lidin,draenor,527,mage,frost,11,6,5
Arcanom,azjolnerub,527,mage,frost,11,6,5
Avb,twisting-nether,527,mage,frost,17,6,11
Nøxas,archimonde,527,mage,frost,17,6,11
Xyhno,eredar,519,mage,frost,13,7,6
Tschelo,eredar,512,mage,frost,16,6,10
Kukerr,burning-legion,511,mage,frost,16,6,10
Miihawkk,khaz-modan,510,mage,frost,20,6,14
Magicstorm,anubarak,504,mage,frost,16,6,10
Magipus,anetheron,496,mage,frost,20,6,14
Шеллестун,soulflayer,495,mage,frost,13,6,7
Trøll,nemesis,480,mage,frost,6,5,1
Frostmyst,outland,480,mage,frost,6,5,1
Мэдраша,gordunni,480,mage,frost,6,5,1
Cumburlok,silvermoon,480,mage,frost,6,5,1
Chucknoir,draenor,480,mage,frost,6,5,1
Zehnvonzehn,antonidas,480,mage,frost,6,5,1
Barryscótt,stormscale,480,mage,frost,6,5,1
Driana,dragonmaw,480,mage,frost,6,5,1
Veemi,blackmoore,480,mage,frost,6,5,1
Magnopvp,sanguino,480,mage,frost,10,6,4
Moleester,twisting-nether,480,mage,frost,12,5,7
Zaurok,sanguino,480,mage,frost,12,5,7
Vapurx,blackmoore,480,mage,frost,12,5,7
Funkyfriday,twisting-nether,480,mage,frost,12,5,7
Okey,frostwhisper,480,mage,frost,12,5,7
Betomage,blackmoore,480,mage,frost,12,5,7
Reznøør,confrérie-du-thorium,480,mage,frost,12,5,7
Manôu,kirin-tor,480,mage,frost,12,5,7
Лрее,gordunni,480,mage,frost,12,5,7
Kleptomania,archimonde,480,mage,frost,12,5,7
Alytà,ravencrest,480,mage,frost,12,5,7
Barzle,blackmoore,480,mage,frost,12,5,7
Beardyman,haomarush,480,mage,frost,12,5,7
Médivh,archimonde,480,mage,frost,12,5,7
Spell,blackmoore,480,mage,frost,12,5,7
Burnit,dalaran,480,mage,frost,12,5,7
Marikisanx,blackmoore,480,mage,frost,12,5,7
Milkenjoyer,ravencrest,480,mage,frost,12,5,7
Homper,argent-dawn,480,mage,frost,12,5,7
Javellja,ravencrest,480,mage,frost,12,5,7
Chrømy,twisting-nether,480,mage,frost,12,5,7
Moffmage,sylvanas,480,mage,frost,12,5,7
Trevise,ravencrest,480,mage,frost,12,5,7
Leontus,outland,480,mage,frost,12,5,7
Gàtsby,outland,480,mage,frost,12,5,7
Maestrá,outland,480,mage,frost,12,5,7
Deathcast,ravencrest,480,mage,frost,12,5,7
Shirrunn,the-maelstrom,480,mage,frost,12,5,7
Magenox,blackrock,480,mage,frost,12,5,7
Thelastmage,outland,480,mage,frost,12,5,7
Ikefire,draenor,480,mage,frost,12,5,7
Snaapz,kazzak,480,mage,frost,18,5,13
Xoouuboo,eredar,480,mage,frost,18,5,13
Wukidiwn,draenor,480,mage,frost,18,5,13
Vioulette,elune,480,mage,frost,18,5,13
Шипкастермвп,howling-fjord,480,mage,frost,18,5,13
Арара,gordunni,480,mage,frost,18,5,13
Roberx,sanguino,480,mage,frost,18,5,13
Reblink,draenor,480,mage,frost,18,5,13
Kyraja,arthas,480,mage,frost,24,5,19
Intêrnet,archimonde,480,mage,frost,26,5,21
Restinnpiss,twisting-nether,479,mage,frost,6,5,1
Шиллаа,blackscar,479,mage,frost,12,5,7
Kalterfurz,thrall,479,mage,frost,12,5,7
Xýton,azjolnerub,479,mage,frost,12,5,7
Coldstormz,terenas,479,mage,frost,12,5,7
Промагер,gordunni,479,mage,frost,12,5,7
Zionara,stormscale,479,mage,frost,12,5,7
Brutal,thrall,479,mage,frost,12,5,7
Whitestiev,antonidas,479,mage,frost,12,5,7
Deletron,ragnaros,479,mage,frost,18,5,13
Líquiçìty,ragnaros,479,mage,frost,18,5,13
Feuerflamme,theradras,478,mage,frost,12,5,7
Потныйдпс,eversong,478,mage,frost,16,6,10
Furoranight,malfurion,477,mage,frost,12,5,7
Polflop,sylvanas,476,mage,frost,12,5,7
Rifinouu,archimonde,476,mage,frost,12,5,7
Phibonaci,sylvanas,475,mage,frost,12,5,7
Blinkinggoat,ragnaros,448,mage,frost,16,5,11
Azadan,pozzo-delleternità,447,mage,frost,11,5,6
Saytmage,ragnaros,447,mage,frost,17,5,12
Swemagus,outland,432,mage,frost,9,5,4
Dozono,silvermoon,428,mage,frost,15,5,10
Euklid,ravencrest,416,mage,frost,10,5,5
Substitutes,draenor,415,mage,frost,14,5,9
Торар,deathguard,415,mage,frost,16,5,11
Xerathon,ravencrest,414,mage,frost,16,5,11
Leylus,blackmoore,399,mage,frost,5,5,0
Màgí,stormscale,384,mage,frost,6,4,2
Pinkusbruh,aggra-português,384,mage,frost,6,4,2
Вулльф,gordunni,384,mage,frost,6,4,2
Friedkek,ravencrest,384,mage,frost,6,4,2
Doryy,silvermoon,384,mage,frost,6,4,2
Sylvîe,tarren-mill,384,mage,frost,6,4,2
Shatterdude,kazzak,384,mage,frost,6,4,2
Anev,sylvanas,384,mage,frost,6,4,2
Fuhry,tarren-mill,384,mage,frost,6,4,2
Nightcàller,pozzo-delleternità,384,mage,frost,6,4,2
Willmajacki,blackmoore,384,mage,frost,6,4,2
Fontaíne,doomhammer,384,mage,frost,6,4,2
Proudmøøre,argent-dawn,384,mage,frost,6,4,2
Gravelegacy,quelthalas,384,mage,frost,6,4,2
Ón,burning-steppes,384,mage,frost,6,4,2
Jodíefroster,doomhammer,384,mage,frost,6,4,2
Ahøllic,frostwolf,384,mage,frost,6,4,2
Leonora,blackhand,384,mage,frost,6,4,2
Arcitech,tarren-mill,384,mage,frost,6,4,2
Sneakii,the-maelstrom,384,mage,frost,6,4,2
Nötmârtònxø,ragnaros,384,mage,frost,6,4,2
Cesi,silvermoon,384,mage,frost,6,4,2
Поэтик,soulflayer,384,mage,frost,6,4,2
Zerobelow,silvermoon,384,mage,frost,6,4,2
Elor,eredar,384,mage,frost,12,4,8
Newtwo,ravencrest,384,mage,frost,12,4,8
Fikkamika,ragnaros,384,mage,frost,12,4,8
Luckydo,turalyon,384,mage,frost,12,4,8
Proffset,outland,384,mage,frost,12,4,8
Johnnyblazin,outland,384,mage,frost,12,4,8
Querasimar,blackrock,384,mage,frost,12,4,8
Jazzi,blackrock,384,mage,frost,12,4,8
Mobjar,twisting-nether,384,mage,frost,12,4,8
Tarovan,defias-brotherhood,384,mage,frost,12,4,8
Facerollyo,tarren-mill,384,mage,frost,12,4,8
Managurke,blackrock,384,mage,frost,12,4,8
Kaschnatze,blackmoore,384,mage,frost,12,4,8
Wwjd,darksorrow,384,mage,frost,12,4,8
Yajimage,archimonde,384,mage,frost,12,4,8
Stærq,blackrock,384,mage,frost,12,4,8
Kuhwar,echsenkessel,384,mage,frost,12,4,8
Bloodycast,archimonde,384,mage,frost,12,4,8
Babyboyj,blackmoore,384,mage,frost,12,4,8
Mopus,ravencrest,384,mage,frost,12,4,8
Ðarkreaver,kaelthas,384,mage,frost,12,4,8
Muntiks,ravencrest,384,mage,frost,12,4,8
Acclay,malganis,384,mage,frost,12,4,8
Зефенжо,howling-fjord,384,mage,frost,12,4,8
Stellarie,sylvanas,384,mage,frost,12,4,8
Юджегс,soulflayer,384,mage,frost,12,4,8
Lambaa,thrall,384,mage,frost,12,4,8
Gnðmeonfire,sylvanas,384,mage,frost,12,4,8
Пламяорды,soulflayer,384,mage,frost,12,4,8
Faunas,kazzak,384,mage,frost,12,4,8
Ruténa,aegwynn,384,mage,frost,18,4,14
Бигдикмаг,soulflayer,384,mage,frost,18,4,14
Blinkmehome,silvermoon,384,mage,frost,18,4,14
Ripdeepfreez,culte-de-la-rive-noire,384,mage,frost,18,4,14
Cavadrex,arathor,384,mage,frost,18,4,14
Gylith,kirin-tor,384,mage,frost,18,4,14
Waîdø,blackhand,383,mage,frost,6,4,2
Capyla,blackmoore,383,mage,frost,6,4,2
Xblaze,balnazzar,383,mage,frost,6,4,2
Wuffwuffspik,grim-batol,383,mage,frost,6,4,2
Juntara,stormscale,383,mage,frost,12,4,8
Труупоед,borean-tundra,383,mage,frost,12,4,8
Скватро,gordunni,383,mage,frost,12,4,8
Brandonjames,ragnaros,383,mage,frost,12,4,8
Xenodike,blackrock,383,mage,frost,12,4,8
Ashkalor,frostwolf,383,mage,frost,17,4,13
Asnesh,silvermoon,383,mage,frost,18,4,14
Malicä,ravencrest,383,mage,frost,30,4,26
Bibidibabidi,nefarian,382,mage,frost,6,4,2
Skankengine,twisting-nether,382,mage,frost,12,4,8
Bisuke,stormscale,367,mage,frost,11,4,7
Whosthemage,kazzak,351,mage,frost,8,5,3
Nebby,argent-dawn,351,mage,frost,11,4,7
Møøk,magtheridon,336,mage,frost,15,4,11
Tsubas,blackmoore,330,mage,frost,15,5,10
Consquens,aszune,330,mage,frost,18,5,13
Regenn,kazzak,318,mage,frost,5,4,1
Aestus,outland,288,mage,frost,6,3,3
Овеча,gordunni,288,mage,frost,6,3,3
Equálity,blackrock,288,mage,frost,6,3,3
Rèkt,lightbringer,288,mage,frost,6,3,3
Snowberry,blackrock,288,mage,frost,6,3,3
Нефростмаг,gordunni,288,mage,frost,6,3,3
Xlarb,kazzak,288,mage,frost,6,3,3
Ballesteinen,outland,288,mage,frost,6,3,3
Тейемор,gordunni,288,mage,frost,6,3,3
Bóósh,alakir,288,mage,frost,6,3,3
Halø,bloodhoof,288,mage,frost,6,3,3
Siérra,outland,288,mage,frost,6,3,3
Eliosia,drakthul,288,mage,frost,6,3,3
Arandartis,kazzak,288,mage,frost,6,3,3
Olzaa,outland,288,mage,frost,6,3,3
Gladxp,outland,288,mage,frost,6,3,3
Swayyx,sylvanas,288,mage,frost,6,3,3
Fboltprocd,ragnaros,288,mage,frost,6,3,3
Tommyboy,dragonblight,288,mage,frost,6,3,3
Kimfjongmajs,silvermoon,288,mage,frost,6,3,3
Gotone,tarren-mill,288,mage,frost,6,3,3
Blitzo,madmortem,288,mage,frost,6,3,3
Amaterâsu,antonidas,288,mage,frost,6,3,3
Brunettdelux,archimonde,288,mage,frost,6,3,3
Sozie,tarren-mill,288,mage,frost,6,3,3
Blåskjell,kazzak,288,mage,frost,6,3,3
Narcîsa,sanguino,288,mage,frost,6,3,3
Hotpockets,die-aldor,288,mage,frost,6,3,3
Айсъмэджик,azuregos,288,mage,frost,6,3,3
Bigburns,draenor,288,mage,frost,6,3,3
Сайджена,howling-fjord,288,mage,frost,6,3,3
Meras,die-ewige-wacht,288,mage,frost,6,3,3
Muuckie,blackrock,288,mage,frost,6,3,3
Ковенн,howling-fjord,288,mage,frost,6,3,3
Justvik,eredar,288,mage,frost,6,3,3
Askannor,norgannon,288,mage,frost,6,3,3
Волшебну,soulflayer,288,mage,frost,6,3,3
Frökenfrost,stormscale,288,mage,frost,6,3,3
Nevertøxic,ravencrest,288,mage,frost,6,3,3
Verygoodgame,blackrock,288,mage,frost,6,3,3
Frostandrew,twisting-nether,288,mage,frost,6,3,3
Kebkhadar,ravencrest,288,mage,frost,6,3,3
Ørixx,blackhand,288,mage,frost,6,3,3
Periphery,zenedar,288,mage,frost,6,3,3
Vodjka,nemesis,288,mage,frost,6,3,3
Magekaoz,sylvanas,288,mage,frost,6,3,3
ßjwercke,stormscale,288,mage,frost,6,3,3
Zlacked,tarren-mill,288,mage,frost,6,3,3
Illîllîllî,blackrock,288,mage,frost,6,3,3
Zyllu,argent-dawn,288,mage,frost,6,3,3
Каперниан,fordragon,288,mage,frost,6,3,3
Dragotus,dragonblight,288,mage,frost,6,3,3
Ghayaa,defias-brotherhood,288,mage,frost,6,3,3
Bigraphael,ravencrest,288,mage,frost,6,3,3
Onegaisenpai,ragnaros,288,mage,frost,6,3,3
Milminmage,ravencrest,288,mage,frost,6,3,3
Haginatorr,twisting-nether,288,mage,frost,6,3,3
Nynduriella,teldrassil,288,mage,frost,6,3,3
Merlín,malganis,288,mage,frost,6,3,3
Сэрруденкент,soulflayer,288,mage,frost,6,3,3
Дмблдр,soulflayer,288,mage,frost,6,3,3
Sérum,drakthul,288,mage,frost,12,3,9
Synblink,eredar,288,mage,frost,12,3,9
Illastrov,silvermoon,288,mage,frost,12,3,9
Devon,haomarush,288,mage,frost,12,3,9
Imasheeper,silvermoon,288,mage,frost,12,3,9
Naween,hyjal,288,mage,frost,12,3,9
Xeldary,blackmoore,288,mage,frost,12,3,9
Paradigma,sylvanas,288,mage,frost,12,3,9
Kryptass,aegwynn,288,mage,frost,12,3,9
Чоуза,gordunni,288,mage,frost,12,3,9
Эммилиарда,gordunni,288,mage,frost,12,3,9
Micklolz,blackmoore,288,mage,frost,12,3,9
Gogara,kazzak,288,mage,frost,12,3,9
Subtempo,silvermoon,288,mage,frost,12,3,9
Fernandéz,ravencrest,288,mage,frost,12,3,9
Waterhagx,tarren-mill,288,mage,frost,12,3,9
Tadaa,blackmoore,288,mage,frost,12,3,9
Скайлуйт,gordunni,288,mage,frost,12,3,9
Faitha,ravencrest,288,mage,frost,12,3,9
Ахиригиз,gordunni,288,mage,frost,12,3,9
Elreas,blackmoore,288,mage,frost,12,3,9
Kaiyn,argent-dawn,288,mage,frost,12,3,9
Hacimari,hyjal,288,mage,frost,12,3,9
Котофайв,howling-fjord,288,mage,frost,12,3,9
Äßäm,outland,288,mage,frost,12,3,9
Ypy,dragonmaw,288,mage,frost,12,3,9
Heatwavesa,ravencrest,288,mage,frost,12,3,9
Phonkim,stormscale,288,mage,frost,12,3,9
Voraxma,draenor,288,mage,frost,12,3,9
Sérc,ravencrest,288,mage,frost,12,3,9
Тудысюдым,eversong,288,mage,frost,12,3,9
Cortis,outland,288,mage,frost,18,3,15
Reeyymmoo,draenor,287,mage,frost,6,3,3
Tsr,burning-legion,287,mage,frost,6,3,3
Fumachustas,kazzak,287,mage,frost,6,3,3
Magó,eredar,287,mage,frost,6,3,3
Valtarisoo,amanthul,287,mage,frost,6,3,3
Djblink,twisting-nether,287,mage,frost,12,3,9
Kasus,sporeggar,287,mage,frost,12,3,9
Mexxlaz,eredar,287,mage,frost,12,3,9
Nekroulis,agamaggan,287,mage,frost,12,3,9
Familyfrost,thunderhorn,287,mage,frost,12,3,9
Freeto,blackmoore,286,mage,frost,6,3,3
Serlath,defias-brotherhood,286,mage,frost,6,3,3
Rosenkrauz,kul-tiras,280,mage,frost,26,3,23
Torryel,silvermoon,256,mage,frost,10,3,7
Кагумми,gordunni,256,mage,frost,16,3,13
Колдунская,gordunni,255,mage,frost,11,3,8
Delvir,stormreaver,240,mage,frost,9,3,6
Iif,zirkel-des-cenarius,239,mage,frost,5,3,2
Setyon,burning-legion,223,mage,frost,8,3,5
Kairøs,dragonblight,192,mage,frost,9,3,6
Blastus,ragnaros,192,mage,frost,6,2,4
Wumz,blackrock,192,mage,frost,6,2,4
Fearbeäch,ravencrest,192,mage,frost,6,2,4
Smokedaddy,stormscale,192,mage,frost,6,2,4
Brísingamen,outland,192,mage,frost,6,2,4
Dueudafrøven,stormscale,192,mage,frost,6,2,4
Proxanlulz,ravencrest,192,mage,frost,6,2,4
Shealá,blackhand,192,mage,frost,6,2,4
Бд,blackscar,192,mage,frost,6,2,4
Rizzlybear,outland,192,mage,frost,6,2,4
Goodopeners,outland,192,mage,frost,6,2,4
Sany,anubarak,192,mage,frost,6,2,4
Creak,blackhand,192,mage,frost,6,2,4
Zheakz,kazzak,192,mage,frost,6,2,4
Labius,dun-modr,192,mage,frost,6,2,4
Халадель,howling-fjord,192,mage,frost,6,2,4
Димаскунфу,howling-fjord,192,mage,frost,6,2,4
Onlymage,outland,192,mage,frost,6,2,4
Ceinxjk,ravencrest,192,mage,frost,6,2,4
Budgetziqo,ravencrest,192,mage,frost,6,2,4
Feath,ravencrest,192,mage,frost,6,2,4
Thegoodoctor,kazzak,192,mage,frost,6,2,4
Robsn,blackrock,192,mage,frost,6,2,4
Exael,ravencrest,192,mage,frost,6,2,4
Laciee,silvermoon,192,mage,frost,6,2,4
Skylezy,blackrock,192,mage,frost,6,2,4
Sperow,marécage-de-zangar,192,mage,frost,6,2,4
Momolamoto,hyjal,192,mage,frost,6,2,4
Alleii,kazzak,192,mage,frost,6,2,4
Ðøæø,twisting-nether,192,mage,frost,6,2,4
Perfection,cthun,192,mage,frost,6,2,4
Whìtewalker,pozzo-delleternità,192,mage,frost,6,2,4
Etherìon,los-errantes,192,mage,frost,6,2,4
Maeflix,aegwynn,192,mage,frost,6,2,4
Sweetcandy,outland,192,mage,frost,6,2,4
Swørd,aggra-português,192,mage,frost,6,2,4
Sebers,kazzak,192,mage,frost,6,2,4
Zerøsílgødx,antonidas,192,mage,frost,6,2,4
Magovix,archimonde,192,mage,frost,6,2,4
Rachouu,archimonde,192,mage,frost,6,2,4
Мистркорбэн,soulflayer,192,mage,frost,6,2,4
Frostbringer,archimonde,192,mage,frost,6,2,4
Gameart,alexstrasza,192,mage,frost,6,2,4
Barspin,lightnings-blade,192,mage,frost,6,2,4
Ingibjorg,auchindoun,192,mage,frost,6,2,4
Ohateyz,burning-legion,192,mage,frost,6,2,4
Burnem,kult-der-verdammten,192,mage,frost,6,2,4
Zeramage,eredar,192,mage,frost,6,2,4
Maveya,blackmoore,192,mage,frost,6,2,4
Queuefiend,eredar,192,mage,frost,6,2,4
Ipen,bloodfeather,192,mage,frost,6,2,4
Mooryel,burning-legion,192,mage,frost,6,2,4
Arcaneiun,nagrand,192,mage,frost,6,2,4
Галадриелька,gordunni,192,mage,frost,6,2,4
Bodyrocker,sylvanas,192,mage,frost,6,2,4
Estupen,sanguino,192,mage,frost,6,2,4
Tobie,bladefist,192,mage,frost,6,2,4
Yunion,burning-legion,192,mage,frost,6,2,4
Frazztato,tarren-mill,192,mage,frost,6,2,4
Infamage,draenor,192,mage,frost,6,2,4
Tomia,burning-legion,192,mage,frost,6,2,4
Levioosah,draenor,192,mage,frost,6,2,4
Ellianor,drakthul,192,mage,frost,6,2,4
Adetin,tarren-mill,192,mage,frost,6,2,4
Kobrass,spinebreaker,192,mage,frost,6,2,4
Xblaz,draenor,192,mage,frost,6,2,4
Treyz,tichondrius,192,mage,frost,6,2,4
Флоой,gordunni,192,mage,frost,6,2,4
Meteofrost,draenor,192,mage,frost,6,2,4
Medium,der-rat-von-dalaran,192,mage,frost,6,2,4
Welt,drakthul,192,mage,frost,6,2,4
Berylton,argent-dawn,192,mage,frost,6,2,4
Zulkas,stormreaver,192,mage,frost,6,2,4
Banausisch,blackmoore,192,mage,frost,6,2,4
Kàtsu,tarren-mill,192,mage,frost,6,2,4
Ehbehad,doomhammer,192,mage,frost,6,2,4
Harpelmage,auchindoun,192,mage,frost,6,2,4
Alieni,stormreaver,192,mage,frost,6,2,4
Naldora,turalyon,192,mage,frost,6,2,4
Dxdxdxdxdx,drakthul,192,mage,frost,6,2,4
Balmak,doomhammer,192,mage,frost,6,2,4
Rapidfrost,drakthul,192,mage,frost,12,2,10
Boned,ravencrest,192,mage,frost,12,2,10
Myriel,thrall,192,mage,frost,12,2,10
Магниффика,blackscar,192,mage,frost,12,2,10
Mariujana,ravencrest,192,mage,frost,12,2,10
Xawokem,outland,192,mage,frost,12,2,10
Sephis,anubarak,192,mage,frost,12,2,10
Kbd,outland,192,mage,frost,12,2,10
Braínfreeze,kazzak,192,mage,frost,12,2,10
Pogmage,blackrock,192,mage,frost,12,2,10
Bêta,dun-modr,192,mage,frost,12,2,10
Arinel,stormreaver,192,mage,frost,12,2,10
Freezeballs,blackmoore,192,mage,frost,12,2,10
Portnography,draenor,192,mage,frost,12,2,10
Shizzy,onyxia,192,mage,frost,12,2,10
Atírpá,doomhammer,192,mage,frost,12,2,10
Ezìl,nemesis,192,mage,frost,12,2,10
Kaevelin,argent-dawn,192,mage,frost,12,2,10
Illiot,twisting-nether,192,mage,frost,12,2,10
Flamê,ragnaros,192,mage,frost,12,2,10
Shallari,argent-dawn,192,mage,frost,12,2,10
Shiftea,argent-dawn,192,mage,frost,12,2,10
Hruon,ravenholdt,192,mage,frost,15,2,13
Aaropalli,kazzak,191,mage,frost,6,2,4
Illusionx,grim-batol,191,mage,frost,6,2,4
Faithseed,dun-modr,191,mage,frost,6,2,4
Makkertje,silvermoon,191,mage,frost,6,2,4
Duncanidaho,throkferoth,191,mage,frost,6,2,4
Mátraxx,silvermoon,191,mage,frost,12,2,10
Proxj,stormscale,175,mage,frost,11,2,9
Иксайс,soulflayer,168,mage,frost,29,9,20
Ivailo,ravencrest,159,mage,frost,5,2,3
Aerathâ,blackrock,159,mage,frost,5,2,3
Kyan,burning-legion,159,mage,frost,5,2,3
Dødo,archimonde,159,mage,frost,5,2,3
Codeincassie,blackhand,138,mage,frost,10,4,6
Zôot,ravencrest,138,mage,frost,11,4,7
Drinte,blackmoore,138,mage,frost,10,3,7
Distrophy,vashj,138,mage,frost,12,3,9
Lovesosa,malorne,138,mage,frost,13,3,10
Klivapå,aggramar,128,mage,frost,4,2,2
Швайго,gordunni,128,mage,frost,4,2,2
Skitsó,shadowsong,127,mage,frost,4,2,2
Arghen,nemesis,105,mage,frost,13,3,10
Firestárter,ravencrest,96,mage,frost,3,2,1
Ntintsec,tarren-mill,96,mage,frost,3,2,1
Tylic,doomhammer,96,mage,frost,9,2,7
Sheeptonreup,archimonde,96,mage,frost,6,1,5
Alphaburstqx,ragnaros,96,mage,frost,6,1,5
Pflanzenn,nozdormu,96,mage,frost,6,1,5
Pringlesrör,ragnaros,96,mage,frost,6,1,5
Rouxbignol,archimonde,96,mage,frost,6,1,5
Homeessa,stormreaver,96,mage,frost,6,1,5
Loskapaska,stormreaver,96,mage,frost,6,1,5
Ekyoo,blackrock,96,mage,frost,6,1,5
Arogance,archimonde,96,mage,frost,6,1,5
Consulalgeri,archimonde,96,mage,frost,6,1,5
Keïji,khaz-modan,96,mage,frost,6,1,5
Vildfogel,tarren-mill,96,mage,frost,6,1,5
Dóncójones,blackrock,96,mage,frost,6,1,5
Mëgu,silvermoon,96,mage,frost,6,1,5
Magiocre,silvermoon,96,mage,frost,6,1,5
Fîrestorm,doomhammer,96,mage,frost,6,1,5
Dphz,tarren-mill,96,mage,frost,6,1,5
Dwarfyy,frostmane,96,mage,frost,6,1,5
Graell,archimonde,96,mage,frost,6,1,5
Coombuster,kazzak,96,mage,frost,6,1,5
Vali,drakthul,96,mage,frost,6,1,5
Pungvre,kazzak,96,mage,frost,6,1,5
Rezre,stormscale,96,mage,frost,6,1,5
Froostii,aegwynn,96,mage,frost,6,1,5
Холдми,gordunni,96,mage,frost,6,1,5
Aarcheon,kazzak,96,mage,frost,6,1,5
Осуждаюпве,gordunni,96,mage,frost,6,1,5
Niladyel,hyjal,96,mage,frost,6,1,5
Teeclis,twisting-nether,96,mage,frost,6,1,5
Jesjess,ravencrest,96,mage,frost,6,1,5
Dyen,hyjal,96,mage,frost,6,1,5
Petri,laughing-skull,96,mage,frost,6,1,5
Sílvér,draenor,96,mage,frost,6,1,5
Magîny,antonidas,96,mage,frost,6,1,5
Devòna,silvermoon,96,mage,frost,6,1,5
Capz,outland,96,mage,frost,6,1,5
Rmforever,archimonde,96,mage,frost,6,1,5
Babynilli,ravencrest,96,mage,frost,6,1,5
Deathbrínger,alakir,96,mage,frost,6,1,5
Kosso,twisting-nether,96,mage,frost,6,1,5
Chimará,eredar,96,mage,frost,6,1,5
Kpacey,guldan,96,mage,frost,6,1,5
Dzomage,kazzak,96,mage,frost,6,1,5
Bananabread,the-maelstrom,96,mage,frost,6,1,5
Dphalos,ravencrest,96,mage,frost,6,1,5
Ghelder,drakthul,96,mage,frost,6,1,5
Sesseel,veklor,96,mage,frost,6,1,5
Meisterg,frostwolf,96,mage,frost,6,1,5
Testoletku,twisting-nether,96,mage,frost,6,1,5
Luckymango,alakir,96,mage,frost,6,1,5
Crooja,antonidas,96,mage,frost,6,1,5
Nergl,darksorrow,96,mage,frost,6,1,5
Одз,grom,96,mage,frost,6,1,5
Ледянойкекс,gordunni,96,mage,frost,6,1,5
Skinirp,dun-modr,96,mage,frost,6,1,5
Vaessi,doomhammer,96,mage,frost,6,1,5
Squìshy,magtheridon,96,mage,frost,6,1,5
Romaga,quelthalas,96,mage,frost,6,1,5
Nullso,zuljin,96,mage,frost,6,1,5
Сморгонец,gordunni,96,mage,frost,6,1,5
Fumandalonso,sanguino,96,mage,frost,6,1,5
Rilac,nordrassil,96,mage,frost,6,1,5
Колтрэйн,blackscar,96,mage,frost,6,1,5
Мэджиксул,grom,96,mage,frost,6,1,5
Vïto,zuljin,96,mage,frost,12,1,11
Snowy,sargeras,96,mage,frost,12,1,11
Krykz,sanguino,96,mage,frost,12,1,11
Ploufatak,hyjal,96,mage,frost,18,1,17
Floé,twisting-nether,95,mage,frost,6,1,5
Aurayaa,teldrassil,95,mage,frost,11,1,10
Nalord,saurfang,95,mage,frost,12,1,11
Bagss,ysondre,95,mage,frost,12,1,11
Elkayizer,archimonde,95,mage,frost,12,1,11
Milhoux,ysondre,79,mage,frost,5,1,4
Levora,ragnaros,79,mage,frost,5,1,4
Mimicassa,defias-brotherhood,71,mage,frost,24,9,15
Каппашилка,gordunni,64,mage,frost,4,1,3
Деозар,eversong,63,mage,frost,2,2,0
Magebraín,ravencrest,63,mage,frost,2,2,0
Gocu,tarren-mill,63,mage,frost,2,2,0
Ямурайхо,howling-fjord,48,mage,frost,3,1,2
Aeghis,darkspear,42,mage,frost,10,3,7
Grönmonster,shattered-hand,42,mage,frost,7,2,5
Mayreel,antonidas,42,mage,frost,11,3,8
Modjahead,tarren-mill,42,mage,frost,15,3,12
Yoxt,blackhand,31,mage,frost,2,1,1
Интровертка,blackscar,31,mage,frost,2,1,1
Jambonpistol,archimonde,31,mage,frost,8,1,7
Flizwiz,ragnaros,16,mage,frost,7,1,6
Xaramael,colinas-pardas,8,mage,frost,9,3,6
Fisterino,zuljin,2304,monk,mistweaver,54,42,12
Fister,zuljin,2295,monk,mistweaver,77,54,23
Commadore,draenor,2288,monk,mistweaver,137,76,61
Cocojones,tarren-mill,2286,monk,mistweaver,114,79,35
Nnsstt,zuljin,2277,monk,mistweaver,104,64,40
Bankmw,tarren-mill,2265,monk,mistweaver,77,52,25
Brickedup,twisting-nether,2246,monk,mistweaver,139,81,58
Kurbanov,stormscale,2239,monk,mistweaver,117,63,54
Brickeduptwo,twisting-nether,2238,monk,mistweaver,174,127,47
Sâu,twisting-nether,2236,monk,mistweaver,122,76,46
Chsx,ravencrest,2234,monk,mistweaver,138,97,41
Iminar,blackrock,2233,monk,mistweaver,84,54,30
Donitrivegas,blackrock,2225,monk,mistweaver,207,132,75
Montex,stormscale,2210,monk,mistweaver,96,53,43
Lp,mugthol,2206,monk,mistweaver,78,52,26
Kjñ,ravencrest,2204,monk,mistweaver,147,90,57
Ballademager,magtheridon,2191,monk,mistweaver,108,65,43
Kåtsumi,sanguino,2175,monk,mistweaver,131,88,43
Онимэшнеца,gordunni,2170,monk,mistweaver,77,48,29
Øllen,stormscale,2161,monk,mistweaver,107,59,48
Botweaver,tarren-mill,2157,monk,mistweaver,54,36,18
Sofunny,blackrock,2157,monk,mistweaver,141,86,55
Zaerin,eredar,2155,monk,mistweaver,67,39,28
Quendiz,frostwolf,2152,monk,mistweaver,90,49,41
Chichigneux,hyjal,2148,monk,mistweaver,99,67,32
Вульфхильда,soulflayer,2146,monk,mistweaver,246,144,102
Lyashi,dalaran,2144,monk,mistweaver,90,50,40
Nawak,archimonde,2144,monk,mistweaver,201,108,93
Meliowo,ravencrest,2141,monk,mistweaver,102,58,44
Çoomðragon,stormscale,2139,monk,mistweaver,48,33,15
Akanetsu,kazzak,2139,monk,mistweaver,138,80,58
Turricane,blackmoore,2133,monk,mistweaver,114,60,54
Kêkburagol,kazzak,2131,monk,mistweaver,174,109,65
Mønkeÿ,ravencrest,2130,monk,mistweaver,70,42,28
Ltmxy,ravencrest,2127,monk,mistweaver,66,40,26
Vivie,destromath,2126,monk,mistweaver,78,48,30
Umadbrohuh,outland,2126,monk,mistweaver,66,39,27
Willxmonk,silvermoon,2126,monk,mistweaver,101,56,45
Shorus,blackmoore,2125,monk,mistweaver,132,84,48
Фунтос,soulflayer,2124,monk,mistweaver,66,41,25
Mibe,alonsus,2121,monk,mistweaver,126,63,63
Trashcarlita,eredar,2120,monk,mistweaver,90,51,39
Beetlejuicé,stormscale,2118,monk,mistweaver,42,28,14
Loofey,ragnaros,2117,monk,mistweaver,218,128,90
Mharlie,stormscale,2117,monk,mistweaver,291,158,133
Дамбмонк,blackscar,2116,monk,mistweaver,76,46,30
Tryhârdx,stormscale,2115,monk,mistweaver,96,51,45
Bmane,archimonde,2114,monk,mistweaver,71,40,31
Vanost,kazzak,2114,monk,mistweaver,90,45,45
Bighealz,aggra-português,2113,monk,mistweaver,77,43,34
Loiyah,dun-modr,2113,monk,mistweaver,78,40,38
Dekaramw,ravencrest,2112,monk,mistweaver,42,33,9
Bigbøøty,silvermoon,2112,monk,mistweaver,90,46,44
Cranex,terenas,2109,monk,mistweaver,118,72,46
Glooni,blackrock,2108,monk,mistweaver,75,46,29
Кимлейн,blackscar,2108,monk,mistweaver,48,29,19
Shonbadatret,argent-dawn,2108,monk,mistweaver,90,54,36
Mememaster,blackhand,2106,monk,mistweaver,172,105,67
Bobthewild,draenor,2104,monk,mistweaver,449,233,216
Sinted,blackmoore,2103,monk,mistweaver,83,52,31
Lifelessons,blackrock,2103,monk,mistweaver,57,34,23
Fisterbean,outland,2103,monk,mistweaver,72,40,32
Swoshz,ragnaros,2103,monk,mistweaver,66,33,33
Blubberwurst,gorgonnash,2102,monk,mistweaver,130,74,56
Webhottie,twisting-nether,2102,monk,mistweaver,155,88,67
Karsat,hyjal,2102,monk,mistweaver,639,339,300
Wajoba,blackhand,2102,monk,mistweaver,114,58,56
Monkield,kazzak,2101,monk,mistweaver,236,147,89
Diorc,outland,2101,monk,mistweaver,116,67,49
Flowy,uldum,2101,monk,mistweaver,60,31,29
Глитч,deepholm,2100,monk,mistweaver,66,43,23
Hiryu,argent-dawn,2100,monk,mistweaver,125,75,50
Yellowtape,kiljaeden,2100,monk,mistweaver,215,127,88
Dollyqt,ravencrest,2100,monk,mistweaver,90,46,44
Ruurruuru,archimonde,2095,monk,mistweaver,185,110,75
Ðurîmar,ravencrest,2090,monk,mistweaver,75,43,32
Lylleri,darksorrow,2089,monk,mistweaver,68,40,28
Tímmz,blackrock,2088,monk,mistweaver,96,56,40
Kêkbûrâgól,kazzak,2079,monk,mistweaver,157,89,68
Loiyh,dun-modr,2079,monk,mistweaver,90,45,45
Леолайт,borean-tundra,2075,monk,mistweaver,118,68,50
Йорита,soulflayer,2072,monk,mistweaver,72,44,28
Хапаюивтыкаю,gordunni,2069,monk,mistweaver,66,43,23
Pizzabud,ravencrest,2068,monk,mistweaver,64,43,21
Ltmdwarf,ravencrest,2067,monk,mistweaver,84,45,39
Joke,ragnaros,2059,monk,mistweaver,102,51,51
Seeyoulater,nemesis,2047,monk,mistweaver,342,176,166
Bigbummer,blackmoore,2044,monk,mistweaver,144,83,61
Couchfrmikea,twisting-nether,2043,monk,mistweaver,84,46,38
Ashm,shattered-halls,2043,monk,mistweaver,78,42,36
Monkeystar,archimonde,2036,monk,mistweaver,114,63,51
Stringg,zuljin,2036,monk,mistweaver,336,185,151
Zevenblad,stormscale,2036,monk,mistweaver,82,43,39
Monkeyi,silvermoon,2028,monk,mistweaver,119,60,59
Mergina,silvermoon,2026,monk,mistweaver,66,37,29
Pennyflame,stormscale,2026,monk,mistweaver,125,67,58
Quendi,frostwolf,2023,monk,mistweaver,190,92,98
Adgoh,tarren-mill,2018,monk,mistweaver,58,43,15
Qwertyxo,draenor,2017,monk,mistweaver,123,77,46
Mistyhoe,twisting-nether,2017,monk,mistweaver,172,92,80
Tigermw,twisting-nether,2016,monk,mistweaver,100,62,38
Monkeymain,tarren-mill,2013,monk,mistweaver,65,34,31
Кулакх,blackscar,2012,monk,mistweaver,106,59,47
Ðalvan,blackrock,2011,monk,mistweaver,78,39,39
Fåtjøë,ravencrest,2010,monk,mistweaver,48,31,17
Flandersmonk,ravencrest,2008,monk,mistweaver,90,57,33
Шортмневноги,howling-fjord,2008,monk,mistweaver,137,74,63
Speedahx,dun-modr,2006,monk,mistweaver,104,64,40
Neszesmonk,ragnaros,2003,monk,mistweaver,242,133,109
Суммрачная,gordunni,2002,monk,mistweaver,144,89,55
Gronkr,draenor,1999,monk,mistweaver,106,59,47
Timmzý,blackmoore,1998,monk,mistweaver,95,64,31
Ганссмонк,blackscar,1997,monk,mistweaver,120,62,58
Кулачонка,blackscar,1992,monk,mistweaver,59,33,26
Mösêê,eredar,1992,monk,mistweaver,88,39,49
Shadezz,blackmoore,1991,monk,mistweaver,82,54,28
Brxndimonk,antonidas,1990,monk,mistweaver,63,35,28
Teampro,ragnaros,1990,monk,mistweaver,258,138,120
Øméga,ravencrest,1989,monk,mistweaver,194,128,66
Srdarr,kazzak,1987,monk,mistweaver,90,52,38
Marqinio,archimonde,1984,monk,mistweaver,84,47,37
Kanketoe,korgall,1984,monk,mistweaver,54,30,24
Swagmonk,silvermoon,1984,monk,mistweaver,122,65,57
Holyrop,aegwynn,1982,monk,mistweaver,36,25,11
Môûsè,ravencrest,1981,monk,mistweaver,102,62,40
Zeoverx,ragnaros,1977,monk,mistweaver,78,36,42
Yoghurtz,frostmourne,1976,monk,mistweaver,192,110,82
Uao,tarren-mill,1971,monk,mistweaver,66,31,35
Боецкфц,soulflayer,1969,monk,mistweaver,64,37,27
Коконгкд,blackscar,1969,monk,mistweaver,358,192,166
Monkrah,blackmoore,1969,monk,mistweaver,72,37,35
Halùnkè,eredar,1968,monk,mistweaver,177,101,76
Veganweaver,ravencrest,1966,monk,mistweaver,60,37,23
Zonsym,twisting-nether,1966,monk,mistweaver,96,51,45
Magixc,drakthul,1965,monk,mistweaver,104,62,42
Bigmilkies,ysondre,1965,monk,mistweaver,96,52,44
Ouhmaikgød,dun-modr,1964,monk,mistweaver,171,83,88
Manatoiled,draenor,1961,monk,mistweaver,54,34,20
Vienuolè,silvermoon,1961,monk,mistweaver,54,30,24
Rocknreroll,executus,1960,monk,mistweaver,138,82,56
Howtoown,burning-legion,1960,monk,mistweaver,60,34,26
Pyrìt,blackhand,1959,monk,mistweaver,60,41,19
Kapud,twisting-nether,1958,monk,mistweaver,84,47,37
Haìryplotter,kazzak,1957,monk,mistweaver,280,155,125
Notzaele,zuljin,1956,monk,mistweaver,66,35,31
Pwner,daggerspine,1956,monk,mistweaver,287,151,136
Гроксси,howling-fjord,1955,monk,mistweaver,146,89,57
Residùe,kazzak,1954,monk,mistweaver,90,53,37
Prototyp,burning-legion,1953,monk,mistweaver,88,49,39
Roadrunnér,ravencrest,1952,monk,mistweaver,66,35,31
Лабирончик,blackscar,1949,monk,mistweaver,71,50,21
Lanvia,argent-dawn,1946,monk,mistweaver,198,114,84
Beili,ravencrest,1946,monk,mistweaver,79,42,37
Wwvwwvwwvwwv,ragnaros,1946,monk,mistweaver,102,49,53
Skailzkrtwo,hyjal,1943,monk,mistweaver,72,41,31
Chanzey,silvermoon,1943,monk,mistweaver,288,161,127
Manjini,blackhand,1940,monk,mistweaver,92,49,43
Inlakech,auchindoun,1938,monk,mistweaver,141,77,64
Problematic,blackmoore,1932,monk,mistweaver,52,33,19
Пиписечка,gordunni,1932,monk,mistweaver,47,28,19
Stemanit,draenor,1929,monk,mistweaver,77,47,30
Lildaddymunk,ravencrest,1928,monk,mistweaver,54,31,23
Arenatwo,outland,1925,monk,mistweaver,93,56,37
Voltzeig,dentarg,1925,monk,mistweaver,312,163,149
Pudgefeed,silvermoon,1924,monk,mistweaver,108,65,43
Dicedkiwi,quelthalas,1924,monk,mistweaver,334,194,140
Machó,kazzak,1922,monk,mistweaver,71,36,35
Toram,burning-legion,1920,monk,mistweaver,72,37,35
Zöumi,ravencrest,1917,monk,mistweaver,178,97,81
Djsqx,outland,1915,monk,mistweaver,30,20,10
Tinydolls,archimonde,1915,monk,mistweaver,42,24,18
Yexìu,kult-der-verdammten,1914,monk,mistweaver,54,30,24
Cítysushi,draenor,1913,monk,mistweaver,110,63,47
Siphem,ravencrest,1911,monk,mistweaver,287,154,133
Ûnknöw,archimonde,1910,monk,mistweaver,66,39,27
Lxstcxntury,stormscale,1908,monk,mistweaver,47,32,15
Фуфинус,gordunni,1907,monk,mistweaver,59,33,26
Monkwithlove,blackhand,1906,monk,mistweaver,120,72,48
Meemyo,blackmoore,1904,monk,mistweaver,83,34,49
Muchobijca,defias-brotherhood,1900,monk,mistweaver,78,44,34
Limbaskalol,dun-modr,1900,monk,mistweaver,253,133,120
Shirkán,ragnaros,1899,monk,mistweaver,162,90,72
Subàru,draenor,1898,monk,mistweaver,93,60,33
Yuukiiqt,kult-der-verdammten,1897,monk,mistweaver,113,61,52
Sookrates,ragnaros,1896,monk,mistweaver,60,38,22
Seventhirty,ravencrest,1896,monk,mistweaver,36,20,16
Лемонк,gordunni,1895,monk,mistweaver,40,21,19
Æøwyn,ragnaros,1892,monk,mistweaver,88,61,27
Jemp,ravencrest,1892,monk,mistweaver,592,328,264
Uwû,ravencrest,1890,monk,mistweaver,107,73,34
Jam,aerie-peak,1889,monk,mistweaver,24,20,4
Mafiazøo,hyjal,1888,monk,mistweaver,130,81,49
Egg,frostmane,1887,monk,mistweaver,48,30,18
Ínsanez,dun-modr,1886,monk,mistweaver,54,29,25
Killibrew,ravencrest,1885,monk,mistweaver,48,34,14
Melysà,antonidas,1885,monk,mistweaver,45,27,18
Rolxx,twisting-nether,1883,monk,mistweaver,116,59,57
Dmonk,aegwynn,1882,monk,mistweaver,146,69,77
Zanzetsu,twisting-nether,1881,monk,mistweaver,173,93,80
Tierrax,cthun,1880,monk,mistweaver,71,36,35
Deepl,dun-modr,1880,monk,mistweaver,54,27,27
Lmnsx,ravencrest,1875,monk,mistweaver,36,23,13
Nåwãk,archimonde,1875,monk,mistweaver,145,71,74
Siignmonk,ravencrest,1874,monk,mistweaver,194,101,93
Blantai,tarren-mill,1874,monk,mistweaver,78,38,40
Meldi,ravencrest,1873,monk,mistweaver,54,32,22
Texiq,drakthul,1872,monk,mistweaver,213,126,87
Monkeycoke,ragnaros,1870,monk,mistweaver,35,21,14
Brxmonki,antonidas,1870,monk,mistweaver,83,45,38
Kratzl,blackrock,1867,monk,mistweaver,54,34,20
Luru,outland,1867,monk,mistweaver,83,47,36
Ræïzò,dun-morogh,1865,monk,mistweaver,58,34,24
Wrv,kazzak,1864,monk,mistweaver,277,147,130
Perceptîon,thrall,1863,monk,mistweaver,114,61,53
Тащунаскилле,thermaplugg,1862,monk,mistweaver,62,39,23
Jiafei,tarren-mill,1862,monk,mistweaver,42,25,17
Effeots,blackrock,1862,monk,mistweaver,222,116,106
Cptsensey,draenor,1861,monk,mistweaver,42,29,13
Chazu,outland,1861,monk,mistweaver,66,36,30
Hélpx,stormscale,1860,monk,mistweaver,42,23,19
Youkâi,blackrock,1859,monk,mistweaver,48,31,17
Минимонахх,blackscar,1859,monk,mistweaver,84,54,30
Savagex,sanguino,1859,monk,mistweaver,66,35,31
Dragzol,tarren-mill,1858,monk,mistweaver,144,72,72
Rullsimpa,ravencrest,1858,monk,mistweaver,77,34,43
Aromipesäx,outland,1857,monk,mistweaver,71,35,36
Digzzy,draenor,1856,monk,mistweaver,63,35,28
Waramow,eredar,1855,monk,mistweaver,36,25,11
Butterbean,conseil-des-ombres,1855,monk,mistweaver,69,41,28
Shâng,blackhand,1855,monk,mistweaver,54,32,22
Neyoklol,blackrock,1855,monk,mistweaver,117,68,49
Crôcøpx,blackhand,1855,monk,mistweaver,78,39,39
Фунтос,gordunni,1854,monk,mistweaver,48,34,14
Cdriscas,aggra-português,1854,monk,mistweaver,143,80,63
Фейкнаут,soulflayer,1854,monk,mistweaver,132,69,63
Døk,twisting-nether,1852,monk,mistweaver,36,24,12
Vingurd,terokkar,1852,monk,mistweaver,45,28,17
Sugra,frostwolf,1852,monk,mistweaver,63,39,24
Bicmex,archimonde,1852,monk,mistweaver,96,46,50
Muerb,die-arguswacht,1851,monk,mistweaver,45,28,17
Fùckaround,emeriss,1851,monk,mistweaver,95,55,40
Perelman,burning-legion,1851,monk,mistweaver,84,48,36
Buddiline,baelgun,1851,monk,mistweaver,48,24,24
Мичан,howling-fjord,1849,monk,mistweaver,146,88,58
Taeyhung,thrall,1848,monk,mistweaver,99,59,40
Çheeks,kazzak,1848,monk,mistweaver,48,26,22
Wrynja,blackmoore,1847,monk,mistweaver,54,32,22
Керизз,gordunni,1846,monk,mistweaver,42,27,15
Strillen,twisting-nether,1846,monk,mistweaver,138,69,69
Кодизи,gordunni,1845,monk,mistweaver,41,28,13
Yamqt,thrall,1845,monk,mistweaver,42,27,15
Kóan,stormscale,1845,monk,mistweaver,105,56,49
Inuria,ravencrest,1844,monk,mistweaver,129,79,50
Neisha,drakthul,1843,monk,mistweaver,102,63,39
Enveløp,stormscale,1842,monk,mistweaver,42,29,13
Pizelx,alakir,1842,monk,mistweaver,54,28,26
Musclemage,turalyon,1841,monk,mistweaver,60,31,29
Hidekami,archimonde,1840,monk,mistweaver,90,46,44
Péppy,aegwynn,1839,monk,mistweaver,46,28,18
Lîlilîlîlîlí,stormscale,1839,monk,mistweaver,48,24,24
Swaghäuser,blackmoore,1838,monk,mistweaver,174,98,76
Pøhx,ragnaros,1837,monk,mistweaver,87,51,36
Mwmonk,blackrock,1836,monk,mistweaver,65,42,23
Флориус,soulflayer,1836,monk,mistweaver,53,31,22
Rokux,kazzak,1836,monk,mistweaver,43,25,18
Homes,blackmoore,1836,monk,mistweaver,114,61,53
Monkdrak,eredar,1835,monk,mistweaver,39,24,15
Jades,emeriss,1835,monk,mistweaver,198,99,99
Moariann,drakthul,1834,monk,mistweaver,132,67,65
Hajlong,outland,1834,monk,mistweaver,66,32,34
Myeers,dun-modr,1833,monk,mistweaver,180,97,83
Jabington,aegwynn,1832,monk,mistweaver,121,73,48
Рендикаое,soulflayer,1832,monk,mistweaver,199,110,89
Monkbtw,kazzak,1831,monk,mistweaver,36,27,9
Ønlyfäns,kazzak,1831,monk,mistweaver,112,67,45
Jamiedhism,ravencrest,1831,monk,mistweaver,54,28,26
Donkeymønk,hyjal,1830,monk,mistweaver,355,193,162
Santoron,baelgun,1829,monk,mistweaver,75,36,39
Нубстриимс,gordunni,1828,monk,mistweaver,62,33,29
Mistyfox,aszune,1828,monk,mistweaver,95,45,50
Koguosa,outland,1827,monk,mistweaver,42,32,10
Véxyra,draenor,1827,monk,mistweaver,48,32,16
Lanory,blackmoore,1827,monk,mistweaver,42,26,16
Ilovesanrio,kazzak,1827,monk,mistweaver,86,53,33
Trifogeorge,archimonde,1827,monk,mistweaver,48,28,20
Chitea,argent-dawn,1827,monk,mistweaver,53,30,23
Tráïner,madmortem,1827,monk,mistweaver,161,85,76
Мефодийкун,howling-fjord,1826,monk,mistweaver,108,63,45
Playbîrd,archimonde,1826,monk,mistweaver,100,54,46
Cåpybårå,outland,1826,monk,mistweaver,261,137,124
Bmwmthree,draenor,1826,monk,mistweaver,60,31,29
Notachi,doomhammer,1825,monk,mistweaver,243,135,108
Porcman,archimonde,1825,monk,mistweaver,141,71,70
Scribzw,twisting-nether,1824,monk,mistweaver,77,43,34
Элонхаск,gordunni,1824,monk,mistweaver,54,29,25
Maesha,ahnqiraj,1823,monk,mistweaver,90,57,33
Dmonkz,magtheridon,1823,monk,mistweaver,54,30,24
Vizfist,tarren-mill,1823,monk,mistweaver,54,26,28
Grauwe,stormscale,1822,monk,mistweaver,57,35,22
Sadmw,archimonde,1822,monk,mistweaver,48,28,20
Patiencebro,archimonde,1822,monk,mistweaver,78,43,35
Lildaddymonk,ravencrest,1822,monk,mistweaver,54,24,30
Táy,ravencrest,1821,monk,mistweaver,84,52,32
Astromune,draenor,1821,monk,mistweaver,53,32,21
Sikaan,blackhand,1820,monk,mistweaver,42,27,15
Амаранточка,howling-fjord,1820,monk,mistweaver,60,38,22
Trollroll,defias-brotherhood,1820,monk,mistweaver,132,74,58
Mobrac,twisting-nether,1820,monk,mistweaver,50,26,24
Анстапоблх,grom,1820,monk,mistweaver,54,24,30
Hurri,krasus,1819,monk,mistweaver,36,25,11
Kungfublyat,twisting-nether,1818,monk,mistweaver,59,43,16
Шэганэ,deathguard,1818,monk,mistweaver,74,45,29
Fistíe,sylvanas,1817,monk,mistweaver,33,22,11
Nesedondondn,stormscale,1816,monk,mistweaver,30,23,7
Motang,blackmoore,1816,monk,mistweaver,62,34,28
Precocconx,stormreaver,1816,monk,mistweaver,36,19,17
Mugenzen,sanguino,1816,monk,mistweaver,36,19,17
Polch,archimonde,1816,monk,mistweaver,78,38,40
Твикса,soulflayer,1816,monk,mistweaver,114,54,60
Loiythree,dun-modr,1815,monk,mistweaver,60,29,31
Wrox,sylvanas,1814,monk,mistweaver,60,43,17
Zulein,defias-brotherhood,1814,monk,mistweaver,36,21,15
Тамаз,gordunni,1814,monk,mistweaver,59,24,35
Crñ,blackmoore,1813,monk,mistweaver,44,26,18
Basilbrushxd,stormscale,1813,monk,mistweaver,48,27,21
Людзяо,galakrond,1813,monk,mistweaver,107,59,48
Karmasnitch,antonidas,1812,monk,mistweaver,72,41,31
Onlyfist,stormscale,1811,monk,mistweaver,42,28,14
Vxs,blackhand,1811,monk,mistweaver,72,45,27
Sugermum,outland,1811,monk,mistweaver,54,31,23
Insanepace,blackmoore,1811,monk,mistweaver,61,31,30
Xoconut,kazzak,1810,monk,mistweaver,292,160,132
Shyheimyo,outland,1810,monk,mistweaver,54,27,27
Crymonkya,aegwynn,1809,monk,mistweaver,138,88,50
Evad,kazzak,1809,monk,mistweaver,113,69,44
Schizacademy,draenor,1809,monk,mistweaver,44,26,18
Yäffa,archimonde,1809,monk,mistweaver,126,71,55
Schøcker,blackmoore,1809,monk,mistweaver,59,32,27
Wernos,archimonde,1809,monk,mistweaver,60,32,28
Fìstpwnjk,forscherliga,1808,monk,mistweaver,145,93,52
Errowin,blackmoore,1807,monk,mistweaver,108,68,40
Kilograme,tarren-mill,1806,monk,mistweaver,66,36,30
Kîrânâ,eredar,1806,monk,mistweaver,54,29,25
Ранки,lich-king,1806,monk,mistweaver,60,27,33
Fullzi,dalaran,1805,monk,mistweaver,30,19,11
Maybeexm,ravencrest,1805,monk,mistweaver,48,26,22
Yulonian,argent-dawn,1804,monk,mistweaver,166,103,63
Panson,twisting-nether,1804,monk,mistweaver,54,28,26
Dewamønk,blackmoore,1803,monk,mistweaver,70,41,29
Oikodomos,twisting-nether,1803,monk,mistweaver,77,45,32
Wiwâ,outland,1803,monk,mistweaver,85,46,39
Yum,anetheron,1803,monk,mistweaver,90,46,44
Vanicweaver,aegwynn,1802,monk,mistweaver,36,26,10
Cæsifer,ungoro,1802,monk,mistweaver,53,28,25
Alprox,moonglade,1802,monk,mistweaver,170,87,83
Djpunchable,blackrock,1801,monk,mistweaver,50,38,12
Bossmanfred,outland,1801,monk,mistweaver,84,56,28
Сазуко,gordunni,1801,monk,mistweaver,48,27,21
Monkgolitaxd,dun-modr,1801,monk,mistweaver,240,131,109
Heramonk,dun-modr,1801,monk,mistweaver,58,30,28
Jinxini,twisting-nether,1800,monk,mistweaver,24,19,5
Callysra,archimonde,1800,monk,mistweaver,42,30,12
Monknice,sylvanas,1800,monk,mistweaver,77,40,37
Xarêlla,aegwynn,1800,monk,mistweaver,114,58,56
Hurricaine,hyjal,1799,monk,mistweaver,30,19,11
Саас,gordunni,1799,monk,mistweaver,35,21,14
Vienuole,silvermoon,1798,monk,mistweaver,53,27,26
Brewnox,ragnaros,1797,monk,mistweaver,59,30,29
Нимбмонк,soulflayer,1796,monk,mistweaver,53,25,28
Shurdax,silvermoon,1793,monk,mistweaver,90,49,41
Snówtea,silvermoon,1792,monk,mistweaver,45,28,17
Doffm,auchindoun,1791,monk,mistweaver,84,51,33
Claudiå,kazzak,1791,monk,mistweaver,63,31,32
Skïrmíshgødx,ravencrest,1790,monk,mistweaver,54,25,29
Lünara,ambossar,1787,monk,mistweaver,90,52,38
Лиянь,soulflayer,1787,monk,mistweaver,108,61,47
Luvmollý,silvermoon,1787,monk,mistweaver,114,57,57
Jorahmarmond,tarren-mill,1786,monk,mistweaver,48,35,13
Piedliés,ravencrest,1784,monk,mistweaver,84,39,45
Bluran,dalaran,1783,monk,mistweaver,76,42,34
Sushiroller,blackrock,1783,monk,mistweaver,48,26,22
Threesíxníne,dun-morogh,1783,monk,mistweaver,42,22,20
Loobee,ravencrest,1782,monk,mistweaver,48,24,24
Shehulkk,ravencrest,1779,monk,mistweaver,48,26,22
Zoida,azuremyst,1779,monk,mistweaver,144,70,74
Birgitbuddha,gorgonnash,1776,monk,mistweaver,84,48,36
Shortinlegs,silvermoon,1776,monk,mistweaver,60,32,28
Brysiqtx,aegwynn,1775,monk,mistweaver,75,38,37
Yukimøn,hyjal,1774,monk,mistweaver,103,73,30
Papimonkx,garona,1773,monk,mistweaver,48,22,26
Taylorghost,ravencrest,1769,monk,mistweaver,68,44,24
Pamtu,dun-modr,1769,monk,mistweaver,96,61,35
Monkler,blackhand,1769,monk,mistweaver,102,48,54
Baatu,frostmane,1768,monk,mistweaver,108,53,55
Legsweep,blackhand,1767,monk,mistweaver,133,84,49
Soulring,kazzak,1767,monk,mistweaver,63,31,32
Esriin,shattered-hand,1765,monk,mistweaver,36,24,12
Cøcøøn,blackrock,1765,monk,mistweaver,146,79,67
Фунтих,soulflayer,1764,monk,mistweaver,40,21,19
Yungsooth,stormscale,1763,monk,mistweaver,65,40,25
Ultdave,eredar,1760,monk,mistweaver,183,104,79
Bammemw,archimonde,1760,monk,mistweaver,54,25,29
Sícknéss,aegwynn,1759,monk,mistweaver,42,26,16
Riendy,silvermoon,1759,monk,mistweaver,302,167,135
Räpeltäjä,stormreaver,1757,monk,mistweaver,30,24,6
Mêshuggâh,malganis,1757,monk,mistweaver,48,28,20
Gréèñðrägôñ,stormscale,1756,monk,mistweaver,36,26,10
Sîono,antonidas,1755,monk,mistweaver,48,34,14
Key,stormreaver,1755,monk,mistweaver,82,50,32
Holyropx,aegwynn,1755,monk,mistweaver,42,25,17
Inear,chogall,1755,monk,mistweaver,244,132,112
Sniffn,ravencrest,1754,monk,mistweaver,54,35,19
Natsuø,nemesis,1754,monk,mistweaver,36,22,14
Blamethegame,hyjal,1753,monk,mistweaver,35,24,11
Demmonkz,stormreaver,1753,monk,mistweaver,36,24,12
Actionsusi,area-52,1753,monk,mistweaver,48,27,21
Эрмонд,soulflayer,1753,monk,mistweaver,68,37,31
Januslapuce,culte-de-la-rive-noire,1752,monk,mistweaver,35,19,16
Päws,kazzak,1751,monk,mistweaver,42,25,17
Stifmeister,tarren-mill,1750,monk,mistweaver,94,50,44
Jayber,laughing-skull,1749,monk,mistweaver,72,46,26
Эрмилинда,gordunni,1749,monk,mistweaver,54,26,28
Callim,blackrock,1748,monk,mistweaver,30,19,11
Бадика,howling-fjord,1748,monk,mistweaver,221,123,98
Carlteaz,drakthul,1747,monk,mistweaver,85,52,33
Taekwonroll,stormscale,1747,monk,mistweaver,42,23,19
Hôn,sanguino,1746,monk,mistweaver,53,36,17
Kaezm,blackrock,1746,monk,mistweaver,42,26,16
Xámell,ravencrest,1746,monk,mistweaver,36,19,17
Dog,garona,1745,monk,mistweaver,84,36,48
Seandyche,ravencrest,1744,monk,mistweaver,34,23,11
Neash,silvermoon,1744,monk,mistweaver,90,51,39
Teahihi,ravencrest,1742,monk,mistweaver,36,27,9
Mcscrub,ragnaros,1742,monk,mistweaver,35,24,11
Binkote,zuljin,1737,monk,mistweaver,119,72,47
Calmed,tarren-mill,1737,monk,mistweaver,259,148,111
Konnîchîwa,kazzak,1737,monk,mistweaver,167,91,76
Mommymonk,outland,1737,monk,mistweaver,51,27,24
Ipmanlol,archimonde,1736,monk,mistweaver,114,69,45
Fatdad,magtheridon,1735,monk,mistweaver,83,41,42
Zýru,ragnaros,1734,monk,mistweaver,124,75,49
Shishasho,stormreaver,1734,monk,mistweaver,52,28,24
Táuriéll,eredar,1734,monk,mistweaver,42,21,21
Kapitan,sanguino,1732,monk,mistweaver,105,67,38
Mugotea,twisting-nether,1732,monk,mistweaver,90,48,42
Аскмилол,deathweaver,1731,monk,mistweaver,76,44,32
Nsq,ravencrest,1731,monk,mistweaver,48,26,22
Onaiâ,ravencrest,1730,monk,mistweaver,43,29,14
Greentape,kiljaeden,1730,monk,mistweaver,42,27,15
Wørsthealxd,alakir,1728,monk,mistweaver,88,59,29
Súzy,stormscale,1727,monk,mistweaver,124,67,57
Brewstea,kazzak,1727,monk,mistweaver,84,40,44
Ziibaa,outland,1726,monk,mistweaver,81,48,33
Эифорйя,howling-fjord,1726,monk,mistweaver,58,25,33
Фдма,soulflayer,1724,monk,mistweaver,41,26,15
Pikemi,dun-modr,1724,monk,mistweaver,90,56,34
Théverre,uldaman,1724,monk,mistweaver,195,121,74
Yadokaí,darkmoon-faire,1724,monk,mistweaver,48,23,25
Kickin,burning-legion,1723,monk,mistweaver,64,37,27
Chünlii,dun-modr,1723,monk,mistweaver,60,29,31
Nrafflig,draenor,1722,monk,mistweaver,48,32,16
Fulgrem,stormscale,1722,monk,mistweaver,87,53,34
Wajøba,blackhand,1722,monk,mistweaver,36,18,18
Capkum,dun-modr,1721,monk,mistweaver,161,83,78
Jacksa,bronze-dragonflight,1721,monk,mistweaver,164,83,81
Séi,kazzak,1721,monk,mistweaver,36,18,18
Mwrbg,shadowsong,1720,monk,mistweaver,113,63,50
Poohya,silvermoon,1720,monk,mistweaver,36,18,18
Risesx,blackmoore,1719,monk,mistweaver,103,53,50
Chimara,kazzak,1718,monk,mistweaver,79,45,34
Типмах,howling-fjord,1718,monk,mistweaver,56,31,25
Wisear,silvermoon,1718,monk,mistweaver,53,25,28
Déffly,ravencrest,1717,monk,mistweaver,24,18,6
Акли,gordunni,1717,monk,mistweaver,48,31,17
Jackål,silvermoon,1716,monk,mistweaver,27,19,8
Pabloboy,kazzak,1715,monk,mistweaver,42,24,18
Jerymonk,tarren-mill,1715,monk,mistweaver,168,93,75
Pogimonkey,ragnaros,1715,monk,mistweaver,54,28,26
Alë,argent-dawn,1714,monk,mistweaver,105,65,40
Blacktee,eredar,1714,monk,mistweaver,36,21,15
Merína,ragnaros,1714,monk,mistweaver,207,109,98
Onlyfunds,blackrock,1713,monk,mistweaver,24,18,6
Olympiiee,archimonde,1713,monk,mistweaver,293,157,136
Барлиос,soulflayer,1713,monk,mistweaver,331,172,159
Ashjaxa,silvermoon,1710,monk,mistweaver,42,18,24
Ultrasense,outland,1709,monk,mistweaver,30,18,12
Oukaläv,archimonde,1709,monk,mistweaver,40,20,20
Rogvi,argent-dawn,1709,monk,mistweaver,192,94,98
Ivanzamonka,stormscale,1708,monk,mistweaver,71,47,24
Lukeybabyy,defias-brotherhood,1708,monk,mistweaver,111,69,42
Behrens,defias-brotherhood,1708,monk,mistweaver,39,23,16
Babbub,tarren-mill,1707,monk,mistweaver,60,36,24
Bigdaddypump,blackmoore,1707,monk,mistweaver,42,25,17
Tjann,stormscale,1706,monk,mistweaver,48,33,15
Бладмонки,soulflayer,1706,monk,mistweaver,60,38,22
Zlodey,laughing-skull,1706,monk,mistweaver,43,25,18
Jolude,nemesis,1706,monk,mistweaver,133,73,60
Shyheim,outland,1705,monk,mistweaver,48,36,12
ßsøßxx,hyjal,1704,monk,mistweaver,24,18,6
Öhlinmonk,outland,1704,monk,mistweaver,42,24,18
Kebabrolle,blackrock,1704,monk,mistweaver,42,21,21
Adis,nerathor,1703,monk,mistweaver,48,28,20
Moontríx,kazzak,1703,monk,mistweaver,48,21,27
Lurklee,blackhand,1701,monk,mistweaver,48,27,21
Nuke,steamwheedle-cartel,1701,monk,mistweaver,36,18,18
Shigong,hellscream,1700,monk,mistweaver,66,36,30
Fisterinos,blackrock,1699,monk,mistweaver,120,78,42
Orfantal,ravencrest,1698,monk,mistweaver,120,71,49
Erapanzon,nemesis,1698,monk,mistweaver,48,28,20
Callmeks,stormscale,1698,monk,mistweaver,48,28,20
Rullefald,stormscale,1697,monk,mistweaver,102,57,45
Handarbetare,ravencrest,1696,monk,mistweaver,94,46,48
Onlyfunn,sanguino,1695,monk,mistweaver,86,48,38
Вакидзави,gordunni,1694,monk,mistweaver,48,31,17
Mmrkick,kazzak,1694,monk,mistweaver,60,33,27
Кикподхвост,blackscar,1694,monk,mistweaver,66,29,37
Фучой,howling-fjord,1692,monk,mistweaver,57,34,23
Pitrols,twisting-nether,1692,monk,mistweaver,237,134,103
Ryx,twisting-nether,1691,monk,mistweaver,55,26,29
Кербю,gordunni,1690,monk,mistweaver,42,23,19
Doll,stormscale,1689,monk,mistweaver,36,18,18
Zorkev,dun-modr,1688,monk,mistweaver,119,67,52
Irêfutabil,sylvanas,1688,monk,mistweaver,63,34,29
Olgachocolat,blackmoore,1687,monk,mistweaver,108,81,27
Kungfupanda,stormscale,1687,monk,mistweaver,62,33,29
Kukn,twisting-nether,1686,monk,mistweaver,87,44,43
Нийтринно,howling-fjord,1685,monk,mistweaver,102,55,47
Эрумонк,gordunni,1685,monk,mistweaver,36,18,18
Shiftkin,stormscale,1685,monk,mistweaver,54,25,29
Rhatid,twisting-nether,1683,monk,mistweaver,210,113,97
Bullergøjen,ravencrest,1682,monk,mistweaver,90,59,31
Saáru,argent-dawn,1682,monk,mistweaver,66,41,25
Ninetz,tarren-mill,1681,monk,mistweaver,30,18,12
Suliya,zuluhed,1681,monk,mistweaver,48,28,20
Vregorx,twisting-nether,1680,monk,mistweaver,42,25,17
Mîstxd,kazzak,1679,monk,mistweaver,53,30,23
Simonex,ravencrest,1678,monk,mistweaver,24,18,6
Papours,ysondre,1676,monk,mistweaver,30,22,8
Milksbtw,kazzak,1676,monk,mistweaver,113,79,34
Quickmist,draenor,1675,monk,mistweaver,107,65,42
Монккд,gordunni,1675,monk,mistweaver,183,105,78
Whoszeus,archimonde,1673,monk,mistweaver,202,113,89
Финуправ,soulflayer,1672,monk,mistweaver,24,18,6
Aseidith,tarren-mill,1672,monk,mistweaver,48,26,22
Аци,blackscar,1671,monk,mistweaver,47,31,16
Dokternelg,silvermoon,1671,monk,mistweaver,36,23,13
Hokespokus,silvermoon,1671,monk,mistweaver,59,37,22
Jingfeng,arthas,1670,monk,mistweaver,167,79,88
Артэкрио,soulflayer,1669,monk,mistweaver,54,37,17
Coularx,stormscale,1669,monk,mistweaver,48,25,23
Milkhy,minahonda,1669,monk,mistweaver,148,73,75
Elmezz,burning-legion,1668,monk,mistweaver,39,19,20
Macpunchy,defias-brotherhood,1667,monk,mistweaver,48,28,20
Yto,gorgonnash,1667,monk,mistweaver,36,19,17
Notdearmw,shattered-hand,1666,monk,mistweaver,36,24,12
Dearmw,silvermoon,1666,monk,mistweaver,90,50,40
Diffenbachia,outland,1665,monk,mistweaver,87,58,29
Steveé,kazzak,1664,monk,mistweaver,36,25,11
Féfè,archimonde,1663,monk,mistweaver,42,22,20
Calli,auchindoun,1662,monk,mistweaver,82,42,40
Xineeaa,outland,1661,monk,mistweaver,106,58,48
Insømnia,ragnaros,1660,monk,mistweaver,34,21,13
Mistïnguette,dalaran,1660,monk,mistweaver,216,124,92
Linshai,eredar,1659,monk,mistweaver,36,23,13
ßojo,kazzak,1658,monk,mistweaver,101,62,39
Jûzô,illidan,1658,monk,mistweaver,36,21,15
Hamsster,ravencrest,1658,monk,mistweaver,146,74,72
Репаблликуес,gordunni,1656,monk,mistweaver,34,20,14
Varyat,uldum,1656,monk,mistweaver,41,24,17
Chichi,ravencrest,1656,monk,mistweaver,100,52,48
Trollandroll,stormscale,1655,monk,mistweaver,131,71,60
Эддрос,gordunni,1655,monk,mistweaver,66,35,31
Mangi,rexxar,1655,monk,mistweaver,72,37,35
Incmines,ravencrest,1655,monk,mistweaver,62,30,32
Botspec,twisting-nether,1654,monk,mistweaver,69,46,23
Kaàli,pozzo-delleternità,1654,monk,mistweaver,36,21,15
Elhäbedehä,eredar,1654,monk,mistweaver,218,109,109
Meltfistqt,ravencrest,1654,monk,mistweaver,112,52,60
Maikez,stormreaver,1654,monk,mistweaver,46,19,27
Akkadianx,ravencrest,1653,monk,mistweaver,65,38,27
Cochonhalall,archimonde,1653,monk,mistweaver,42,20,22
Джулибубба,borean-tundra,1650,monk,mistweaver,48,30,18
Skailzkrt,hyjal,1649,monk,mistweaver,43,19,24
Tøwtc,outland,1648,monk,mistweaver,63,37,26
Varea,blackrock,1648,monk,mistweaver,95,47,48
Leiwill,stormreaver,1647,monk,mistweaver,42,23,19
Needthát,twisting-nether,1646,monk,mistweaver,48,31,17
Etzu,shattrath,1646,monk,mistweaver,72,43,29
Otemøøn,sanguino,1646,monk,mistweaver,45,25,20
Mankee,kazzak,1646,monk,mistweaver,109,57,52
Xameht,the-maelstrom,1645,monk,mistweaver,134,67,67
Drugashe,archimonde,1645,monk,mistweaver,360,177,183
Darlaa,ravencrest,1644,monk,mistweaver,29,18,11
Imeon,dun-modr,1644,monk,mistweaver,30,18,12
Freyas,outland,1644,monk,mistweaver,89,51,38
Unsanegodx,ravencrest,1643,monk,mistweaver,54,38,16
Eugenn,alonsus,1643,monk,mistweaver,52,29,23
Invadem,shattered-hand,1642,monk,mistweaver,33,22,11
Eedaza,blackrock,1642,monk,mistweaver,93,61,32
Tanata,blackmoore,1642,monk,mistweaver,63,39,24
Nepho,twisting-nether,1642,monk,mistweaver,38,23,15
Belärus,outland,1641,monk,mistweaver,42,23,19
Campix,blackmoore,1640,monk,mistweaver,111,62,49
Mer,outland,1640,monk,mistweaver,44,24,20
Fistify,destromath,1639,monk,mistweaver,24,20,4
Saneshayne,ravencrest,1639,monk,mistweaver,29,18,11
Amatör,frostwolf,1638,monk,mistweaver,30,20,10
Timboqt,blackmoore,1638,monk,mistweaver,70,43,27
Uftis,thrall,1637,monk,mistweaver,77,56,21
Dharmå,norgannon,1637,monk,mistweaver,32,21,11
Uckkm,ragnaros,1637,monk,mistweaver,42,24,18
Phyxone,twisting-nether,1637,monk,mistweaver,42,21,21
Apolskis,ravencrest,1636,monk,mistweaver,42,30,12
Gronoz,drakthul,1636,monk,mistweaver,108,67,41
Frednmonk,twisting-nether,1635,monk,mistweaver,48,26,22
Karoou,kelthuzad,1635,monk,mistweaver,89,48,41
Cykatea,dun-modr,1634,monk,mistweaver,615,320,295
Pe,blackhand,1633,monk,mistweaver,106,58,48
Raveleth,silvermoon,1632,monk,mistweaver,36,21,15
Youssee,silvermoon,1632,monk,mistweaver,192,105,87
Bonk,defias-brotherhood,1631,monk,mistweaver,47,22,25
Schane,zuluhed,1630,monk,mistweaver,24,18,6
Orcimon,draenor,1630,monk,mistweaver,30,17,13
Shyreen,zirkel-des-cenarius,1630,monk,mistweaver,47,25,22
Soulxq,blackrock,1629,monk,mistweaver,141,77,64
Quotes,darksorrow,1629,monk,mistweaver,78,38,40
Brüderlichke,elune,1629,monk,mistweaver,48,21,27
Авентусс,howling-fjord,1628,monk,mistweaver,42,31,11
Xurf,draenor,1628,monk,mistweaver,36,26,10
Rashakura,blackrock,1628,monk,mistweaver,36,23,13
Saduh,thrall,1628,monk,mistweaver,42,24,18
Løta,blackmoore,1627,monk,mistweaver,30,20,10
Papermakerx,blackrock,1627,monk,mistweaver,46,28,18
Çz,tarren-mill,1627,monk,mistweaver,36,20,16
Teamviewer,blackmoore,1627,monk,mistweaver,42,23,19
Egï,azshara,1626,monk,mistweaver,47,26,21
Ðéliora,la-croisade-écarlate,1626,monk,mistweaver,60,30,30
Zaiyox,thrall,1626,monk,mistweaver,42,20,22
Twistie,aegwynn,1626,monk,mistweaver,36,17,19
Фапдао,howling-fjord,1625,monk,mistweaver,236,126,110
Старыйхиро,gordunni,1624,monk,mistweaver,24,17,7
Correforrest,dun-modr,1624,monk,mistweaver,105,66,39
Yotke,ravencrest,1624,monk,mistweaver,48,30,18
Enoffovicz,archimonde,1624,monk,mistweaver,72,43,29
Rulletunna,grim-batol,1623,monk,mistweaver,42,25,17
Шенген,soulflayer,1623,monk,mistweaver,36,19,17
Issho,der-rat-von-dalaran,1620,monk,mistweaver,36,19,17
Glaphan,the-maelstrom,1619,monk,mistweaver,29,20,9
Deadlywuu,antonidas,1619,monk,mistweaver,71,44,27
Endir,mazrigos,1619,monk,mistweaver,119,71,48
Almonkdiga,sanguino,1619,monk,mistweaver,60,26,34
Xadu,frostwolf,1618,monk,mistweaver,65,41,24
Mimimatrick,hyjal,1618,monk,mistweaver,48,28,20
Quezatrix,ravencrest,1617,monk,mistweaver,184,100,84
Jpstwo,gorgonnash,1617,monk,mistweaver,54,28,26
Jetleê,eredar,1617,monk,mistweaver,138,71,67
Kwa,grim-batol,1616,monk,mistweaver,69,37,32
Sonydl,archimonde,1616,monk,mistweaver,34,18,16
Jiuhjitsu,blackmoore,1616,monk,mistweaver,42,21,21
Fansolini,burning-legion,1616,monk,mistweaver,46,22,24
Vasknem,hyjal,1615,monk,mistweaver,66,45,21
Ceeja,blackmoore,1615,monk,mistweaver,137,76,61
Biftas,nagrand,1614,monk,mistweaver,51,30,21
Wwception,blackrock,1614,monk,mistweaver,38,22,16
Harislkwamk,aegwynn,1614,monk,mistweaver,101,58,43
Sensorium,ravencrest,1614,monk,mistweaver,108,59,49
Watchmedamp,draenor,1613,monk,mistweaver,176,104,72
Simòna,dun-modr,1613,monk,mistweaver,287,150,137
Encanthar,blackhand,1613,monk,mistweaver,237,123,114
Junâ,les-sentinelles,1613,monk,mistweaver,37,19,18
Dr,sylvanas,1612,monk,mistweaver,36,20,16
Zanizu,blackhand,1612,monk,mistweaver,60,33,27
Sart,aerie-peak,1612,monk,mistweaver,42,22,20
Zuvzuv,the-maelstrom,1612,monk,mistweaver,72,37,35
Zodyiac,blackrock,1611,monk,mistweaver,41,29,12
Andoran,hyjal,1611,monk,mistweaver,36,22,14
Hydrôlîcz,blackrock,1611,monk,mistweaver,42,23,19
Koraxx,blackmoore,1611,monk,mistweaver,90,46,44
Stanimirov,outland,1611,monk,mistweaver,42,19,23
Zxcursèd,tarren-mill,1610,monk,mistweaver,24,17,7
Сэм,gordunni,1610,monk,mistweaver,30,21,9
Arimira,outland,1610,monk,mistweaver,80,46,34
Биак,howling-fjord,1609,monk,mistweaver,38,23,15
Slizzlie,outland,1609,monk,mistweaver,45,26,19
Kitingbuddha,aegwynn,1609,monk,mistweaver,114,62,52
Plebmonkx,frostmane,1609,monk,mistweaver,185,98,87
Nirexi,blackrock,1609,monk,mistweaver,63,32,31
Лолидевочка,soulflayer,1609,monk,mistweaver,61,24,37
Mikeson,sylvanas,1608,monk,mistweaver,56,35,21
Даопецдын,howling-fjord,1608,monk,mistweaver,32,19,13
Ignygodx,ragnaros,1608,monk,mistweaver,35,19,16
Cerrya,silvermoon,1608,monk,mistweaver,48,21,27
Molgar,tarren-mill,1607,monk,mistweaver,56,36,20
Ulns,blackrock,1607,monk,mistweaver,60,25,35
Áyell,archimonde,1606,monk,mistweaver,171,95,76
Явтильте,blackscar,1606,monk,mistweaver,35,19,16
Òó,vashj,1606,monk,mistweaver,66,33,33
Makïi,archimonde,1605,monk,mistweaver,185,111,74
Elvand,twisting-nether,1605,monk,mistweaver,89,48,41
Happymonktwo,ravencrest,1605,monk,mistweaver,124,64,60
Melamonk,ravencrest,1605,monk,mistweaver,335,172,163
Igozoom,draenor,1604,monk,mistweaver,36,29,7
Crazydingo,lightnings-blade,1604,monk,mistweaver,72,51,21
Sinnermonkk,outland,1604,monk,mistweaver,30,19,11
Çhên,draenor,1604,monk,mistweaver,81,48,33
Якунка,soulflayer,1604,monk,mistweaver,42,20,22
Chinmachine,kazzak,1603,monk,mistweaver,66,39,27
Waitaminute,outland,1603,monk,mistweaver,166,97,69
Bamiegoreng,aegwynn,1603,monk,mistweaver,30,17,13
Амаззонния,soulflayer,1603,monk,mistweaver,168,86,82
Chundan,twisting-nether,1602,monk,mistweaver,93,62,31
Lizardspock,hyjal,1602,monk,mistweaver,30,17,13
Räyh,outland,1602,monk,mistweaver,57,31,26
Yörg,eredar,1600,monk,mistweaver,51,30,21
Snookzlol,aegwynn,1600,monk,mistweaver,65,38,27
Devivify,twilights-hammer,1600,monk,mistweaver,108,61,47
Setup,thrall,1600,monk,mistweaver,197,111,86
Ness,hyjal,1598,monk,mistweaver,30,17,13
Frónzy,kazzak,1598,monk,mistweaver,206,114,92
Jcchi,xavius,1597,monk,mistweaver,72,37,35
Hardi,chamber-of-aspects,1597,monk,mistweaver,90,44,46
Hollymêdx,blackmoore,1596,monk,mistweaver,66,39,27
Nêøø,blackrock,1596,monk,mistweaver,221,130,91
Vooxis,drakthul,1596,monk,mistweaver,60,35,25
Монккд,soulflayer,1595,monk,mistweaver,36,25,11
Demakis,stormscale,1594,monk,mistweaver,83,54,29
Monkiful,haomarush,1594,monk,mistweaver,42,17,25
Zenfir,sylvanas,1593,monk,mistweaver,74,46,28
Rngmåchínè,ravencrest,1593,monk,mistweaver,86,44,42
Saibell,scarshield-legion,1592,monk,mistweaver,42,28,14
Psychoo,ragnaros,1591,monk,mistweaver,42,27,15
Bonnybravo,wildhammer,1590,monk,mistweaver,30,20,10
Elmonkodonko,draenor,1590,monk,mistweaver,30,17,13
Shokko,uldaman,1589,monk,mistweaver,36,21,15
Lacasyto,sanguino,1586,monk,mistweaver,48,34,14
Pitit,outland,1584,monk,mistweaver,78,31,47
Tû,nerathor,1583,monk,mistweaver,72,41,31
Srav,archimonde,1583,monk,mistweaver,36,19,17
Cubw,archimonde,1583,monk,mistweaver,42,20,22
Spicyrice,twisting-nether,1582,monk,mistweaver,100,49,51
Leblatt,blackhand,1581,monk,mistweaver,82,52,30
Факенщет,soulflayer,1581,monk,mistweaver,97,56,41
Слишкомхорош,thermaplugg,1580,monk,mistweaver,23,17,6
Jeydi,ravencrest,1580,monk,mistweaver,86,49,37
Psychocop,drakthul,1580,monk,mistweaver,227,119,108
Lillklappz,outland,1579,monk,mistweaver,24,20,4
Monkim,chogall,1579,monk,mistweaver,42,24,18
Chiuna,sylvanas,1577,monk,mistweaver,48,25,23
Syyn,twisting-nether,1576,monk,mistweaver,150,89,61
Bitbird,zirkel-des-cenarius,1573,monk,mistweaver,48,29,19
Monarko,twisting-nether,1573,monk,mistweaver,61,36,25
Stdzym,tarren-mill,1573,monk,mistweaver,62,26,36
Slugerpigen,stormscale,1572,monk,mistweaver,327,180,147
Vanoarabidze,ravencrest,1572,monk,mistweaver,78,36,42
Sanktxy,blackhand,1572,monk,mistweaver,81,34,47
Kaizetsu,drakthul,1570,monk,mistweaver,42,28,14
Warsox,aegwynn,1570,monk,mistweaver,48,26,22
Orgasmix,tarren-mill,1569,monk,mistweaver,42,21,21
Basthek,blackhand,1568,monk,mistweaver,48,23,25
Hugemuffin,the-maelstrom,1567,monk,mistweaver,60,41,19
Dosakua,silvermoon,1563,monk,mistweaver,66,38,28
Jinhee,nemesis,1562,monk,mistweaver,66,44,22
Jum,blackhand,1561,monk,mistweaver,42,27,15
Chàrràth,blackmoore,1561,monk,mistweaver,128,64,64
Madafis,twisting-nether,1560,monk,mistweaver,42,28,14
Nerdmonkx,tarren-mill,1560,monk,mistweaver,36,21,15
Fungku,azjolnerub,1560,monk,mistweaver,279,143,136
Endorrphine,ravencrest,1560,monk,mistweaver,110,48,62
Mòñkêÿgøðx,outland,1558,monk,mistweaver,36,23,13
Namelessmist,drakthul,1558,monk,mistweaver,60,35,25
Jasonbbmist,stormscale,1558,monk,mistweaver,36,21,15
Musslee,elune,1556,monk,mistweaver,105,54,51
Isadri,madmortem,1555,monk,mistweaver,36,21,15
Mushush,draenor,1554,monk,mistweaver,62,34,28
Thiiogg,archimonde,1553,monk,mistweaver,44,18,26
Ouaipäül,archimonde,1552,monk,mistweaver,36,19,17
Dromarch,dun-modr,1552,monk,mistweaver,51,26,25
Monkymonka,antonidas,1551,monk,mistweaver,127,64,63
Blondefurry,twisting-nether,1550,monk,mistweaver,42,28,14
Garcon,tarren-mill,1550,monk,mistweaver,42,24,18
Klotsobunidi,kazzak,1550,monk,mistweaver,102,52,50
Idrdob,kazzak,1548,monk,mistweaver,140,78,62
Rzi,amanthul,1548,monk,mistweaver,155,86,69
Taìka,archimonde,1546,monk,mistweaver,27,17,10
Prettysus,silvermoon,1546,monk,mistweaver,66,41,25
Visk,blackmoore,1545,monk,mistweaver,131,73,58
Njursten,twilights-hammer,1545,monk,mistweaver,260,132,128
Kirkeý,ravencrest,1544,monk,mistweaver,55,31,24
Barracüs,dun-modr,1544,monk,mistweaver,78,43,35
Кулаквнос,gordunni,1544,monk,mistweaver,78,39,39
Inthepoopa,outland,1543,monk,mistweaver,102,56,46
Eckø,rashgarroth,1542,monk,mistweaver,88,52,36
Milkabtw,kazzak,1542,monk,mistweaver,43,25,18
Вдыхайтуман,gordunni,1542,monk,mistweaver,96,52,44
Тевикс,gordunni,1542,monk,mistweaver,60,30,30
Индоран,howling-fjord,1541,monk,mistweaver,66,47,19
Bîgmø,blades-edge,1540,monk,mistweaver,30,20,10
Kåýðø,archimonde,1540,monk,mistweaver,90,48,42
Zikzer,darksorrow,1536,monk,mistweaver,51,29,22
Smâsh,blackhand,1535,monk,mistweaver,70,44,26
Jusn,tarren-mill,1535,monk,mistweaver,113,64,49
Zenmastêr,twisting-nether,1535,monk,mistweaver,190,107,83
Тучковский,lich-king,1535,monk,mistweaver,102,57,45
Absolutezen,tarren-mill,1535,monk,mistweaver,66,34,32
Desmî,ravencrest,1534,monk,mistweaver,26,20,6
Incapme,outland,1534,monk,mistweaver,121,71,50
Pembi,blades-edge,1534,monk,mistweaver,80,39,41
Vitnam,auchindoun,1533,monk,mistweaver,84,51,33
Ashenore,outland,1533,monk,mistweaver,42,17,25
Loddarita,ravencrest,1532,monk,mistweaver,54,38,16
Progresse,tarren-mill,1532,monk,mistweaver,54,28,26
Chikokon,silvermoon,1531,monk,mistweaver,63,42,21
Windspiritt,ragnaros,1531,monk,mistweaver,60,31,29
Djsnake,blackrock,1528,monk,mistweaver,24,16,8
Woushou,outland,1528,monk,mistweaver,138,81,57
Karatekickyo,ravencrest,1528,monk,mistweaver,40,22,18
Mistbringer,kazzak,1528,monk,mistweaver,244,130,114
Saitamä,archimonde,1528,monk,mistweaver,98,45,53
Urbàs,blackmoore,1526,monk,mistweaver,42,29,13
Àjay,outland,1526,monk,mistweaver,24,16,8
Doingmaster,blackrock,1526,monk,mistweaver,42,22,20
Shkorwi,drakthul,1525,monk,mistweaver,30,17,13
Musashiden,twisting-nether,1525,monk,mistweaver,42,23,19
Xfu,auchindoun,1525,monk,mistweaver,48,24,24
Gravityfist,aegwynn,1525,monk,mistweaver,60,28,32
Clemoine,archimonde,1524,monk,mistweaver,24,16,8
Xoleck,aegwynn,1522,monk,mistweaver,36,16,20
Дилейнх,gordunni,1521,monk,mistweaver,24,16,8
Uncleheal,tarren-mill,1521,monk,mistweaver,37,21,16
Yumhai,dun-modr,1520,monk,mistweaver,48,26,22
Plaguer,nordrassil,1519,monk,mistweaver,30,18,12
Kæmará,blackrock,1519,monk,mistweaver,30,16,14
Bláckøutx,quelthalas,1518,monk,mistweaver,49,30,19
Mightnorn,tarren-mill,1517,monk,mistweaver,36,20,16
Erannas,turalyon,1517,monk,mistweaver,29,16,13
Dmonk,alakir,1517,monk,mistweaver,72,34,38
Misthera,burning-legion,1517,monk,mistweaver,90,41,49
Eynodiggity,blackmoore,1516,monk,mistweaver,72,38,34
Kobudo,burning-legion,1516,monk,mistweaver,110,51,59
Ticktak,archimonde,1515,monk,mistweaver,86,52,34
Timmyßênz,kaelthas,1515,monk,mistweaver,77,46,31
Pundok,blackrock,1515,monk,mistweaver,110,65,45
Sobadzlolz,alexstrasza,1515,monk,mistweaver,60,28,32
Aryaz,ravencrest,1515,monk,mistweaver,69,32,37
Shàká,stormscale,1514,monk,mistweaver,30,22,8
Piednuques,archimonde,1514,monk,mistweaver,46,20,26
Notfist,kazzak,1513,monk,mistweaver,54,35,19
Børis,draenor,1513,monk,mistweaver,92,54,38
Xiaokingqvq,silvermoon,1512,monk,mistweaver,78,41,37
Xado,aegwynn,1511,monk,mistweaver,24,16,8
Aryphus,blackmoore,1511,monk,mistweaver,36,18,18
Elity,archimonde,1510,monk,mistweaver,82,54,28
Medovic,blackmoore,1510,monk,mistweaver,156,89,67
Лалафест,soulflayer,1510,monk,mistweaver,46,25,21
Oneshotmacro,spinebreaker,1509,monk,mistweaver,24,16,8
Orkiya,archimonde,1507,monk,mistweaver,324,170,154
Cbmonk,sylvanas,1506,monk,mistweaver,50,34,16
Spoompls,argent-dawn,1505,monk,mistweaver,54,24,30
Gernokz,antonidas,1504,monk,mistweaver,156,84,72
Darkkmonk,dun-modr,1504,monk,mistweaver,101,51,50
Aeolôs,hyjal,1503,monk,mistweaver,48,27,21
Ричфлекс,howling-fjord,1503,monk,mistweaver,218,122,96
Caniluvz,eredar,1501,monk,mistweaver,24,16,8
Самадайка,howling-fjord,1501,monk,mistweaver,154,80,74
Гачитварина,galakrond,1499,monk,mistweaver,24,16,8
Lefferubie,hyjal,1499,monk,mistweaver,36,20,16
Calmpalms,tarren-mill,1499,monk,mistweaver,87,45,42
Benenutz,archimonde,1498,monk,mistweaver,36,27,9
Trnd,draenor,1497,monk,mistweaver,47,19,28
Shiesel,draenor,1496,monk,mistweaver,42,24,18
Miînd,tarren-mill,1494,monk,mistweaver,60,35,25
Monkzdino,destromath,1494,monk,mistweaver,47,24,23
Civix,sanguino,1492,monk,mistweaver,116,69,47
Stramonk,nemesis,1492,monk,mistweaver,199,96,103
Zukatan,tarren-mill,1491,monk,mistweaver,81,45,36
Chakuro,ravencrest,1488,monk,mistweaver,30,20,10
Gråce,nemesis,1488,monk,mistweaver,140,82,58
Thuz,kazzak,1488,monk,mistweaver,63,34,29
Quicc,ravencrest,1488,monk,mistweaver,72,36,36
Skusle,defias-brotherhood,1487,monk,mistweaver,30,19,11
Oregan,conseil-des-ombres,1487,monk,mistweaver,36,19,17
Kegrøll,doomhammer,1486,monk,mistweaver,54,29,25
Moveietss,stormscale,1485,monk,mistweaver,18,16,2
Nihao,tarren-mill,1485,monk,mistweaver,56,30,26
Bóber,kazzak,1485,monk,mistweaver,42,22,20
Sneezao,ravencrest,1484,monk,mistweaver,150,82,68
Инженерия,howling-fjord,1483,monk,mistweaver,54,32,22
Sindresa,outland,1483,monk,mistweaver,108,51,57
Ohmegah,frostmane,1481,monk,mistweaver,24,18,6
Fluki,twisting-nether,1480,monk,mistweaver,48,24,24
Kano,burning-legion,1479,monk,mistweaver,38,23,15
Kreynich,blackhand,1477,monk,mistweaver,36,25,11
Dìó,tarren-mill,1477,monk,mistweaver,210,117,93
Leôlulu,blackmoore,1476,monk,mistweaver,36,27,9
Влажныйтач,soulflayer,1475,monk,mistweaver,30,19,11
Teninchwilly,outland,1475,monk,mistweaver,31,18,13
Jihaaz,nemesis,1475,monk,mistweaver,106,56,50
Fatskeleton,stormreaver,1475,monk,mistweaver,427,198,229
Kungfubatti,stormscale,1474,monk,mistweaver,173,96,77
Okdontnerf,kazzak,1473,monk,mistweaver,82,39,43
Фешнмонк,soulflayer,1471,monk,mistweaver,30,17,13
Монкиннияя,gordunni,1471,monk,mistweaver,45,21,24
Bullbøx,chamber-of-aspects,1471,monk,mistweaver,93,38,55
Wushin,antonidas,1470,monk,mistweaver,27,17,10
Farmander,silvermoon,1470,monk,mistweaver,149,88,61
Moistweaver,hellfire,1468,monk,mistweaver,84,44,40
Zenified,ragnaros,1468,monk,mistweaver,82,40,42
Zinnout,twisting-nether,1467,monk,mistweaver,54,35,19
Teacup,aegwynn,1467,monk,mistweaver,131,79,52
Venac,burning-legion,1466,monk,mistweaver,185,110,75
Meuhporgg,hyjal,1463,monk,mistweaver,36,25,11
Zeldrís,ragnaros,1463,monk,mistweaver,96,46,50
Пивкотянка,gordunni,1462,monk,mistweaver,30,22,8
Sshbrew,kazzak,1462,monk,mistweaver,48,26,22
Watchôut,blackmoore,1462,monk,mistweaver,74,40,34
Caskgut,ravencrest,1461,monk,mistweaver,95,58,37
Hymonk,draenor,1459,monk,mistweaver,42,25,17
Guthäxlul,khazgoroth,1459,monk,mistweaver,281,152,129
Pøwcow,blackrock,1459,monk,mistweaver,113,61,52
Noni,gorgonnash,1459,monk,mistweaver,65,31,34
Gucciweaver,tarren-mill,1458,monk,mistweaver,30,19,11
Тадоичи,soulflayer,1458,monk,mistweaver,78,47,31
Rheinair,antonidas,1457,monk,mistweaver,78,37,41
Sinthorasas,blackrock,1453,monk,mistweaver,54,28,26
Bambøuéqtz,khaz-modan,1452,monk,mistweaver,42,27,15
Drâcømørt,dalaran,1452,monk,mistweaver,33,21,12
Kroyus,antonidas,1450,monk,mistweaver,120,63,57
Неэверида,deepholm,1449,monk,mistweaver,180,94,86
Rebekko,pozzo-delleternità,1449,monk,mistweaver,126,62,64
Cybert,blackmoore,1449,monk,mistweaver,59,25,34
Jyll,malganis,1449,monk,mistweaver,131,52,79
Aebì,dalaran,1448,monk,mistweaver,36,23,13
Suggy,kilrogg,1447,monk,mistweaver,40,22,18
Lökmedsmör,draenor,1446,monk,mistweaver,30,23,7
Coopers,hyjal,1444,monk,mistweaver,77,42,35
Larå,ravencrest,1444,monk,mistweaver,223,119,104
Daitaro,ravencrest,1443,monk,mistweaver,80,43,37
Bleja,blackhand,1442,monk,mistweaver,160,85,75
Guanglee,silvermoon,1441,monk,mistweaver,56,37,19
Monkadorie,twisting-nether,1441,monk,mistweaver,62,39,23
Mëñghûøx,sylvanas,1439,monk,mistweaver,24,15,9
Mugenzenx,sanguino,1439,monk,mistweaver,24,15,9
Achtal,blackmoore,1439,monk,mistweaver,41,23,18
Chisurgeon,outland,1438,monk,mistweaver,24,15,9
Benzzy,ragnaros,1435,monk,mistweaver,43,26,17
Vivir,stormreaver,1435,monk,mistweaver,133,75,58
Poyi,ravencrest,1434,monk,mistweaver,24,15,9
Ähronius,stormscale,1434,monk,mistweaver,24,15,9
Kungfox,frostwolf,1434,monk,mistweaver,36,17,19
Musaya,chamber-of-aspects,1434,monk,mistweaver,48,21,27
Freebírd,shattered-hand,1431,monk,mistweaver,45,31,14
Heartless,sporeggar,1430,monk,mistweaver,42,30,12
Tokz,ravencrest,1430,monk,mistweaver,30,19,11
Nievah,argent-dawn,1430,monk,mistweaver,39,24,15
Malkaviano,kazzak,1430,monk,mistweaver,80,46,34
Xadoqt,aegwynn,1429,monk,mistweaver,24,15,9
Monkgd,sylvanas,1428,monk,mistweaver,152,85,67
Saliya,draenor,1428,monk,mistweaver,34,16,18
Puddinpop,auchindoun,1427,monk,mistweaver,61,29,32
Slâpzz,ravencrest,1426,monk,mistweaver,18,15,3
Mentonk,frostwolf,1426,monk,mistweaver,24,15,9
Скорпин,ashenvale,1426,monk,mistweaver,68,35,33
Nèver,dalaran,1426,monk,mistweaver,30,15,15
Applestrûdel,blackrock,1425,monk,mistweaver,45,27,18
Brewzleè,ravencrest,1425,monk,mistweaver,52,27,25
Oddessa,ravenholdt,1424,monk,mistweaver,143,79,64
Zavarius,silvermoon,1424,monk,mistweaver,36,17,19
Capwouk,tarren-mill,1423,monk,mistweaver,24,15,9
Yarie,blackmoore,1423,monk,mistweaver,78,39,39
Тсайм,howling-fjord,1423,monk,mistweaver,36,15,21
Pikajeww,kazzak,1422,monk,mistweaver,50,37,13
Zenzu,blackmoore,1422,monk,mistweaver,36,24,12
Dumplings,earthen-ring,1422,monk,mistweaver,48,29,19
Bigchaz,outland,1421,monk,mistweaver,24,15,9
Conguitø,colinas-pardas,1421,monk,mistweaver,30,17,13
Ikuyaa,ravencrest,1421,monk,mistweaver,29,15,14
Xianxiaa,ravencrest,1420,monk,mistweaver,88,51,37
Dudulinda,silvermoon,1419,monk,mistweaver,108,56,52
Imamonk,tarren-mill,1419,monk,mistweaver,30,15,15
Saolin,emeriss,1417,monk,mistweaver,54,31,23
ßountÿ,kazzak,1416,monk,mistweaver,66,46,20
Dachilla,gilneas,1416,monk,mistweaver,28,16,12
Xplosiv,twisting-nether,1416,monk,mistweaver,244,128,116
Affrro,drakthul,1415,monk,mistweaver,42,25,17
Aironqqt,blackhand,1415,monk,mistweaver,29,17,12
Greenshortea,aegwynn,1415,monk,mistweaver,52,30,22
Масакрейн,howling-fjord,1415,monk,mistweaver,182,87,95
Mistsen,kazzak,1414,monk,mistweaver,81,47,34
Hulkules,blackhand,1413,monk,mistweaver,24,19,5
Bendís,twisting-nether,1413,monk,mistweaver,36,18,18
Deusfist,ravencrest,1413,monk,mistweaver,36,15,21
Qlmo,ravencrest,1412,monk,mistweaver,30,21,9
Dipdop,blackhand,1412,monk,mistweaver,171,101,70
Shailene,kazzak,1411,monk,mistweaver,69,50,19
Kyukoku,blackmoore,1411,monk,mistweaver,28,16,12
Shiguru,dun-morogh,1411,monk,mistweaver,149,80,69
Shenson,mazrigos,1409,monk,mistweaver,30,20,10
Snack,mannoroth,1408,monk,mistweaver,24,16,8
Kéza,culte-de-la-rive-noire,1407,monk,mistweaver,28,16,12
Soyuz,die-aldor,1406,monk,mistweaver,36,23,13
Orenjis,kazzak,1405,monk,mistweaver,40,19,21
Мирюзаки,gordunni,1404,monk,mistweaver,58,34,24
Edll,silvermoon,1403,monk,mistweaver,24,15,9
Kify,dun-modr,1402,monk,mistweaver,33,19,14
Gigilonis,korgall,1397,monk,mistweaver,170,89,81
Wryktas,aegwynn,1396,monk,mistweaver,18,15,3
Notadrâgon,sylvanas,1396,monk,mistweaver,28,15,13
Keksmash,ravencrest,1396,monk,mistweaver,68,33,35
Nela,sanguino,1395,monk,mistweaver,36,20,16
Kushvendorx,silvermoon,1394,monk,mistweaver,66,34,32
Pantyypolice,blackrock,1393,monk,mistweaver,22,16,6
Folfimo,silvermoon,1393,monk,mistweaver,29,17,12
Picayune,mazrigos,1391,monk,mistweaver,48,29,19
Panicfist,stormscale,1391,monk,mistweaver,45,21,24
Baddany,sanguino,1390,monk,mistweaver,102,57,45
Popcornn,archimonde,1389,monk,mistweaver,54,29,25
Kungfupandy,blackmoore,1388,monk,mistweaver,180,99,81
Mythadeya,stormscale,1388,monk,mistweaver,54,21,33
Haxxo,die-nachtwache,1387,monk,mistweaver,32,22,10
Romk,darkspear,1387,monk,mistweaver,48,32,16
Badcøwboy,archimonde,1387,monk,mistweaver,122,54,68
Mistfistmw,outland,1387,monk,mistweaver,66,29,37
Rymz,sanguino,1385,monk,mistweaver,85,50,35
Moohamood,argent-dawn,1384,monk,mistweaver,72,29,43
Monkehst,dun-modr,1383,monk,mistweaver,96,50,46
Umagon,chogall,1383,monk,mistweaver,60,29,31
Roidcarry,blackrock,1383,monk,mistweaver,41,16,25
Striptina,blackmoore,1382,monk,mistweaver,90,49,41
Bigballs,ysera,1382,monk,mistweaver,36,15,21
Pandimaci,ragnaros,1381,monk,mistweaver,101,56,45
Pandacus,silvermoon,1381,monk,mistweaver,90,40,50
Tyzin,blackrock,1380,monk,mistweaver,66,37,29
Smmithyy,draenor,1379,monk,mistweaver,34,19,15
Garmuth,tarren-mill,1378,monk,mistweaver,40,25,15
Kruemelkeks,frostwolf,1378,monk,mistweaver,57,33,24
Barks,archimonde,1378,monk,mistweaver,70,40,30
Amélith,kirin-tor,1378,monk,mistweaver,42,23,19
Awesomebrah,the-maelstrom,1377,monk,mistweaver,24,15,9
Onlyvegan,ravencrest,1375,monk,mistweaver,28,16,12
Bukkits,argent-dawn,1375,monk,mistweaver,48,22,26
Xladerzz,kazzak,1374,monk,mistweaver,23,15,8
Jarô,silvermoon,1374,monk,mistweaver,130,58,72
Brofist,emeriss,1374,monk,mistweaver,79,35,44
Германика,soulflayer,1372,monk,mistweaver,225,108,117
Akùmawíns,archimonde,1368,monk,mistweaver,48,21,27
Faa,archimonde,1367,monk,mistweaver,23,17,6
Fuzzypunch,draenor,1366,monk,mistweaver,106,58,48
Torqualis,kazzak,1366,monk,mistweaver,155,81,74
Beaglemo,blackrock,1366,monk,mistweaver,35,15,20
Myfresh,ysondre,1366,monk,mistweaver,38,16,22
Boozmoo,stormscale,1365,monk,mistweaver,40,32,8
Profylaxist,arathor,1365,monk,mistweaver,95,49,46
Konexzx,blackmoore,1364,monk,mistweaver,36,22,14
Coollann,drakthul,1364,monk,mistweaver,58,26,32
Sanhollo,stormscale,1361,monk,mistweaver,23,15,8
Heyami,ravencrest,1360,monk,mistweaver,48,16,32
Mareki,nethersturm,1359,monk,mistweaver,50,28,22
Brêwjob,archimonde,1356,monk,mistweaver,34,20,14
Nevelbeast,rexxar,1356,monk,mistweaver,69,38,31
Дольчипауэр,soulflayer,1355,monk,mistweaver,59,37,22
Dánný,antonidas,1354,monk,mistweaver,43,26,17
Thayne,blades-edge,1354,monk,mistweaver,30,15,15
Патаомальчик,blackscar,1352,monk,mistweaver,35,15,20
Løsang,blackrock,1350,monk,mistweaver,143,86,57
Mécagnóme,dalaran,1350,monk,mistweaver,96,51,45
Touchofmonk,draenor,1348,monk,mistweaver,48,26,22
Discoelysia,outland,1348,monk,mistweaver,96,47,49
Yahní,eredar,1347,monk,mistweaver,65,37,28
Nîcko,ravencrest,1347,monk,mistweaver,30,17,13
Kwacisawhe,die-aldor,1347,monk,mistweaver,56,25,31
Smitheal,outland,1346,monk,mistweaver,18,15,3
Сильфиета,gordunni,1345,monk,mistweaver,65,37,28
Хэйхати,gordunni,1345,monk,mistweaver,158,82,76
Marvboy,aegwynn,1343,monk,mistweaver,18,14,4
Rokobasilisk,outland,1343,monk,mistweaver,24,14,10
Dodomino,archimonde,1343,monk,mistweaver,24,14,10
Æctò,blackmoore,1343,monk,mistweaver,59,27,32
Кувырбек,howling-fjord,1342,monk,mistweaver,18,14,4
Akuuji,silvermoon,1342,monk,mistweaver,24,14,10
Zagar,emeriss,1342,monk,mistweaver,24,14,10
Izuwumi,ragnaros,1342,monk,mistweaver,24,14,10
Scare,stormreaver,1342,monk,mistweaver,49,24,25
Ipmonk,outland,1341,monk,mistweaver,18,14,4
Carloz,drakthul,1340,monk,mistweaver,60,38,22
Brucechi,kargath,1338,monk,mistweaver,36,31,5
Førzãlêvskî,ravencrest,1338,monk,mistweaver,18,14,4
Mônkykong,ravencrest,1338,monk,mistweaver,24,14,10
Kandislee,ravencrest,1338,monk,mistweaver,36,15,21
Jeññie,stormscale,1337,monk,mistweaver,18,14,4
Atenazadonte,sanguino,1337,monk,mistweaver,27,16,11
Lazyslooth,ravencrest,1337,monk,mistweaver,30,14,16
Фериго,gordunni,1336,monk,mistweaver,36,19,17
Tidemist,argent-dawn,1335,monk,mistweaver,24,14,10
Sînê,archimonde,1334,monk,mistweaver,33,19,14
Ilovesnoopy,blackmoore,1333,monk,mistweaver,24,14,10
Evilrui,ravencrest,1333,monk,mistweaver,30,15,15
Boomboôom,outland,1332,monk,mistweaver,24,14,10
Marielo,blackmoore,1331,monk,mistweaver,39,27,12
Maqs,argent-dawn,1331,monk,mistweaver,42,27,15
Spiritualia,kazzak,1331,monk,mistweaver,68,39,29
Acidflexx,kazzak,1331,monk,mistweaver,41,20,21
Mistur,blackrock,1331,monk,mistweaver,30,14,16
Миамита,eversong,1330,monk,mistweaver,57,30,27
Гиббискус,gordunni,1330,monk,mistweaver,42,18,24
Уиннии,soulflayer,1329,monk,mistweaver,24,14,10
Sajin,la-croisade-écarlate,1329,monk,mistweaver,36,15,21
Sÿldae,dun-modr,1328,monk,mistweaver,30,21,9
Wannabejoker,stormscale,1328,monk,mistweaver,24,14,10
Córporation,outland,1327,monk,mistweaver,30,14,16
Ariluna,tarren-mill,1326,monk,mistweaver,24,14,10
Salix,quelthalas,1325,monk,mistweaver,32,20,12
Krylin,antonidas,1322,monk,mistweaver,93,45,48
Lovange,silvermoon,1320,monk,mistweaver,24,14,10
Vladikus,tarren-mill,1320,monk,mistweaver,105,50,55
Monkypunch,tarren-mill,1319,monk,mistweaver,46,23,23
Адскиймех,deathweaver,1317,monk,mistweaver,69,36,33
Scpdevil,outland,1316,monk,mistweaver,22,15,7
Akalaja,alakir,1316,monk,mistweaver,34,19,15
Erenaar,nemesis,1315,monk,mistweaver,42,24,18
Genjosanso,kazzak,1315,monk,mistweaver,177,97,80
Bruceliam,emerald-dream,1315,monk,mistweaver,30,14,16
Thegrudge,dragonblight,1315,monk,mistweaver,42,16,26
Йомо,borean-tundra,1315,monk,mistweaver,54,20,34
Shreckmonk,burning-blade,1313,monk,mistweaver,30,14,16
Brewswíllis,tarren-mill,1312,monk,mistweaver,18,14,4
Lfmasctop,ravencrest,1312,monk,mistweaver,22,16,6
Pinkstar,kazzak,1312,monk,mistweaver,24,15,9
Blinkër,sanguino,1311,monk,mistweaver,36,19,17
Рекилоллз,gordunni,1311,monk,mistweaver,59,31,28
Leefang,neptulon,1311,monk,mistweaver,49,24,25
Extrimist,sylvanas,1310,monk,mistweaver,150,76,74
Rèddit,kazzak,1310,monk,mistweaver,78,37,41
Facetimee,ahnqiraj,1309,monk,mistweaver,34,19,15
Loreo,burning-legion,1305,monk,mistweaver,99,57,42
Трикленд,azuregos,1305,monk,mistweaver,42,21,21
Theichi,draenor,1304,monk,mistweaver,42,23,19
Onlyfísts,stormscale,1304,monk,mistweaver,48,16,32
Bizzet,jaedenar,1303,monk,mistweaver,27,17,10
Applemonk,tarren-mill,1302,monk,mistweaver,58,28,30
Fistingfury,burning-blade,1302,monk,mistweaver,103,46,57
Murdalum,ravencrest,1301,monk,mistweaver,30,17,13
Tetetete,silvermoon,1301,monk,mistweaver,85,38,47
Ðëvx,argent-dawn,1300,monk,mistweaver,96,52,44
Quendi,arthas,1300,monk,mistweaver,191,97,94
Звиздаатый,blackscar,1299,monk,mistweaver,18,14,4
Moinalisaa,outland,1299,monk,mistweaver,30,18,12
Джоский,borean-tundra,1299,monk,mistweaver,72,29,43
Камикадзэн,gordunni,1296,monk,mistweaver,24,15,9
Lanuia,aegwynn,1295,monk,mistweaver,21,14,7
Zenmist,kazzak,1294,monk,mistweaver,23,14,9
Stolas,spinebreaker,1293,monk,mistweaver,36,24,12
Moonica,zenedar,1291,monk,mistweaver,26,17,9
Tintatama,aszune,1291,monk,mistweaver,124,61,63
Boomshaq,defias-brotherhood,1288,monk,mistweaver,119,60,59
Galaxyfist,ragnaros,1287,monk,mistweaver,177,92,85
Proxxyqt,blackrock,1285,monk,mistweaver,20,15,5
Carnat,blackrock,1284,monk,mistweaver,30,17,13
Trivi,blackrock,1284,monk,mistweaver,45,24,21
Siamesedream,outland,1283,monk,mistweaver,60,37,23
Rsk,antonidas,1283,monk,mistweaver,28,16,12
Drboombay,kazzak,1283,monk,mistweaver,38,21,17
Saeedki,wildhammer,1283,monk,mistweaver,27,14,13
Shakal,outland,1280,monk,mistweaver,36,23,13
Jetchi,twisting-nether,1279,monk,mistweaver,101,59,42
Янезнаюкенни,soulflayer,1279,monk,mistweaver,48,26,22
Mischenka,thrall,1279,monk,mistweaver,54,27,27
Marrave,chogall,1279,monk,mistweaver,90,37,53
Amemiya,sanguino,1278,monk,mistweaver,24,14,10
Toshi,argent-dawn,1277,monk,mistweaver,54,32,22
Lízãriñ,ravencrest,1277,monk,mistweaver,52,28,24
Numpys,sanguino,1277,monk,mistweaver,29,14,15
Gottegrisen,sylvanas,1277,monk,mistweaver,51,21,30
Ráây,blackrock,1276,monk,mistweaver,36,22,14
Bruceflea,blackrock,1275,monk,mistweaver,156,83,73
Tsifsakari,silvermoon,1274,monk,mistweaver,102,41,61
Ugras,auchindoun,1273,monk,mistweaver,36,14,22
Cranecannon,aegwynn,1272,monk,mistweaver,24,14,10
Mickjabber,aegwynn,1272,monk,mistweaver,36,19,17
Bloodpanci,ragnaros,1270,monk,mistweaver,57,32,25
Vetocorleone,kazzak,1268,monk,mistweaver,141,71,70
Mishax,draenor,1268,monk,mistweaver,78,38,40
Juicyloux,aegwynn,1266,monk,mistweaver,51,35,16
Bulletproof,bloodscalp,1266,monk,mistweaver,42,24,18
Rotkäppchen,blackmoore,1265,monk,mistweaver,23,14,9
Szilvia,sylvanas,1263,monk,mistweaver,48,25,23
Bluum,ravencrest,1263,monk,mistweaver,54,23,31
Evelios,blackmoore,1262,monk,mistweaver,41,23,18
Boredom,wildhammer,1261,monk,mistweaver,75,42,33
Алли,lich-king,1260,monk,mistweaver,72,31,41
Kîârâ,frostwolf,1259,monk,mistweaver,28,17,11
Macgyverr,outland,1258,monk,mistweaver,24,14,10
Schaulong,blackmoore,1258,monk,mistweaver,72,34,38
Sandrafarm,ragnaros,1257,monk,mistweaver,102,65,37
Юансноу,blackscar,1257,monk,mistweaver,36,19,17
Chígoku,grim-batol,1257,monk,mistweaver,52,23,29
Daltailr,silvermoon,1257,monk,mistweaver,54,22,32
Zaïn,hyjal,1256,monk,mistweaver,43,22,21
Mestro,argent-dawn,1255,monk,mistweaver,172,94,78
Putrezitu,ragnaros,1252,monk,mistweaver,27,17,10
Oogwai,twisting-nether,1249,monk,mistweaver,24,14,10
Sheishot,kazzak,1249,monk,mistweaver,31,15,16
Angeryw,kazzak,1248,monk,mistweaver,18,13,5
Supaverli,archimonde,1248,monk,mistweaver,18,13,5
Katmunk,kazzak,1248,monk,mistweaver,18,13,5
Hialdó,sylvanas,1248,monk,mistweaver,24,14,10
Worf,haomarush,1247,monk,mistweaver,54,30,24
Catmønk,drakthul,1247,monk,mistweaver,24,13,11
Batmanwife,stormscale,1247,monk,mistweaver,24,13,11
Ajay,outland,1247,monk,mistweaver,30,13,17
Xdhehehexd,twisting-nether,1246,monk,mistweaver,18,13,5
Deliveroo,twisting-nether,1246,monk,mistweaver,24,13,11
Йуппи,galakrond,1246,monk,mistweaver,24,13,11
Salsina,nemesis,1246,monk,mistweaver,138,74,64
Nesthorian,draenor,1246,monk,mistweaver,123,61,62
Репабликус,gordunni,1246,monk,mistweaver,30,13,17
Eclipsè,dragonmaw,1245,monk,mistweaver,23,14,9
Deore,kazzak,1245,monk,mistweaver,24,13,11
Mcloving,turalyon,1245,monk,mistweaver,29,14,15
Ana,eredar,1244,monk,mistweaver,24,13,11
Kunolis,kazzak,1244,monk,mistweaver,42,22,20
Spinonyou,silvermoon,1243,monk,mistweaver,18,13,5
Кубермонкер,gordunni,1243,monk,mistweaver,24,13,11
Nìkâ,blackmoore,1243,monk,mistweaver,57,29,28
Yeetkunmeep,outland,1243,monk,mistweaver,54,25,29
Bigmckoy,kazzak,1242,monk,mistweaver,21,14,7
Kuug,ravencrest,1241,monk,mistweaver,24,13,11
Kammia,drekthar,1241,monk,mistweaver,24,13,11
Chibuku,burning-legion,1240,monk,mistweaver,24,13,11
Hoppinxd,burning-blade,1240,monk,mistweaver,24,13,11
Luciellie,archimonde,1240,monk,mistweaver,24,13,11
Freemann,archimonde,1240,monk,mistweaver,295,149,146
Bréwmáster,silvermoon,1238,monk,mistweaver,18,13,5
Kayen,frostwhisper,1238,monk,mistweaver,46,23,23
Ninjasven,bladefist,1238,monk,mistweaver,30,13,17
Wteg,emerald-dream,1237,monk,mistweaver,54,24,30
Loma,drakthul,1234,monk,mistweaver,42,26,16
Drpajhiwo,burning-legion,1234,monk,mistweaver,52,30,22
Astolfochan,silvermoon,1232,monk,mistweaver,24,13,11
Jozo,hyjal,1231,monk,mistweaver,36,18,18
Maiver,stormscale,1230,monk,mistweaver,24,14,10
Chainster,defias-brotherhood,1229,monk,mistweaver,70,35,35
Ytonie,gorgonnash,1228,monk,mistweaver,18,13,5
Rgkekw,dun-modr,1222,monk,mistweaver,66,39,27
Arathos,tichondrius,1220,monk,mistweaver,111,62,49
Namitsa,trollbane,1220,monk,mistweaver,42,21,21
Tripitakâ,dun-modr,1220,monk,mistweaver,65,30,35
Egwane,argent-dawn,1220,monk,mistweaver,55,24,31
Mugn,sanguino,1215,monk,mistweaver,20,14,6
Fistus,dentarg,1214,monk,mistweaver,29,13,16
Bhasundara,turalyon,1212,monk,mistweaver,88,51,37
Pandasia,kargath,1212,monk,mistweaver,62,25,37
Nylzz,archimonde,1210,monk,mistweaver,26,14,12
Badonkamonk,twilights-hammer,1209,monk,mistweaver,42,26,16
Xwtdreamz,hyjal,1209,monk,mistweaver,42,18,24
Mofisto,bladefist,1208,monk,mistweaver,60,29,31
Nainketx,ravencrest,1208,monk,mistweaver,29,13,16
Bensó,stormscale,1207,monk,mistweaver,57,38,19
Ðømínus,blackmoore,1206,monk,mistweaver,86,39,47
Toon,eredar,1203,monk,mistweaver,118,56,62
Ivi,neptulon,1197,monk,mistweaver,58,29,29
Vattghern,blackhand,1196,monk,mistweaver,88,43,45
Eltonj,sylvanas,1193,monk,mistweaver,23,15,8
Heretogo,draenor,1189,monk,mistweaver,72,39,33
Ksll,silvermoon,1189,monk,mistweaver,36,17,19
Légit,argent-dawn,1188,monk,mistweaver,42,25,17
Мистерхюй,gordunni,1186,monk,mistweaver,101,45,56
Slayâtwo,blackrock,1185,monk,mistweaver,21,13,8
Vørdèthxd,outland,1184,monk,mistweaver,24,18,6
Nyrkkiseski,outland,1183,monk,mistweaver,17,13,4
Lcflay,archimonde,1183,monk,mistweaver,75,37,38
Houzagackel,blackrock,1183,monk,mistweaver,48,17,31
Phrynè,silvermoon,1182,monk,mistweaver,31,16,15
Sosyc,malganis,1181,monk,mistweaver,23,13,10
Highmonktain,alakir,1177,monk,mistweaver,41,25,16
Creatinin,ragnaros,1177,monk,mistweaver,36,18,18
Skaadoosh,aggra-português,1176,monk,mistweaver,27,13,14
Elainmonk,thrall,1175,monk,mistweaver,17,13,4
Kelechi,stormreaver,1172,monk,mistweaver,32,13,19
Fistweavr,antonidas,1171,monk,mistweaver,36,14,22
Rag,burning-legion,1161,monk,mistweaver,60,22,38
Hvnm,ravencrest,1158,monk,mistweaver,170,86,84
Dèathpunch,doomhammer,1155,monk,mistweaver,110,58,52
Yayaxoxoxo,archimonde,1152,monk,mistweaver,18,12,6
Yuuhai,ravencrest,1152,monk,mistweaver,18,12,6
Chijis,blackmoore,1152,monk,mistweaver,24,12,12
Bekachu,ragnaros,1151,monk,mistweaver,18,12,6
Statícx,twisting-nether,1151,monk,mistweaver,18,12,6
Pikachi,ysondre,1151,monk,mistweaver,18,12,6
Shixen,ragnaros,1151,monk,mistweaver,24,12,12
Kôtsvlêkjê,outland,1151,monk,mistweaver,24,12,12
Ofwgkta,moonglade,1151,monk,mistweaver,24,12,12
Zesha,zuljin,1151,monk,mistweaver,30,12,18
Дилдобойс,gordunni,1150,monk,mistweaver,18,12,6
Loorda,neptulon,1150,monk,mistweaver,24,13,11
Нунтяк,gordunni,1150,monk,mistweaver,24,12,12
Yshaolin,tarren-mill,1150,monk,mistweaver,24,12,12
Ciridely,thrall,1149,monk,mistweaver,18,12,6
Kackwalker,blackmoore,1149,monk,mistweaver,18,12,6
Chiá,tarren-mill,1149,monk,mistweaver,47,26,21
Fungxi,archimonde,1146,monk,mistweaver,30,12,18
Telder,sylvanas,1145,monk,mistweaver,24,12,12
Антошамв,gordunni,1145,monk,mistweaver,36,12,24
Nimander,burning-legion,1144,monk,mistweaver,24,12,12
Alphafist,argent-dawn,1144,monk,mistweaver,30,14,16
Tokkz,eredar,1143,monk,mistweaver,16,13,3
Октай,gordunni,1143,monk,mistweaver,34,23,11
Pô,sanguino,1143,monk,mistweaver,18,12,6
Shiftchenko,stormscale,1142,monk,mistweaver,42,24,18
Ajita,blackmoore,1141,monk,mistweaver,24,12,12
Hitsumia,archimonde,1141,monk,mistweaver,36,12,24
Icantstopme,argent-dawn,1139,monk,mistweaver,18,12,6
Cicera,kazzak,1138,monk,mistweaver,30,12,18
Syyrø,silvermoon,1137,monk,mistweaver,36,12,24
Валялекарь,gordunni,1135,monk,mistweaver,24,12,12
Fellatia,garrosh,1134,monk,mistweaver,36,24,12
Kapauww,twisting-nether,1134,monk,mistweaver,18,12,6
Gantz,blackhand,1134,monk,mistweaver,72,28,44
Kyuumaa,ravencrest,1132,monk,mistweaver,26,13,13
Lubeï,kirin-tor,1131,monk,mistweaver,34,21,13
Aznreznzfdqs,grim-batol,1129,monk,mistweaver,18,12,6
Hornissy,antonidas,1129,monk,mistweaver,35,22,13
Claudet,das-konsortium,1127,monk,mistweaver,70,32,38
Friartucker,bloodhoof,1126,monk,mistweaver,51,32,19
Vvårdenfell,hyjal,1126,monk,mistweaver,33,13,20
Mondrim,burning-legion,1123,monk,mistweaver,145,63,82
Mislaw,silvermoon,1121,monk,mistweaver,27,16,11
Snitzla,drakthul,1119,monk,mistweaver,21,16,5
Nasaislying,grim-batol,1119,monk,mistweaver,34,14,20
Jumper,xavius,1118,monk,mistweaver,24,12,12
Yèna,pozzo-delleternità,1118,monk,mistweaver,161,70,91
Akiiro,aegwynn,1118,monk,mistweaver,36,15,21
Tsouli,twilights-hammer,1116,monk,mistweaver,24,12,12
Coliusz,bloodhoof,1116,monk,mistweaver,35,12,23
Dankiron,darksorrow,1114,monk,mistweaver,42,13,29
Zøubida,draenor,1111,monk,mistweaver,24,12,12
Katse,eredar,1106,monk,mistweaver,62,29,33
Serilyah,aegwynn,1102,monk,mistweaver,25,14,11
Pussochkram,ravencrest,1101,monk,mistweaver,18,12,6
Kungfuppl,kazzak,1099,monk,mistweaver,23,12,11
Ляосинь,deepholm,1099,monk,mistweaver,24,12,12
Ryanshazier,eredar,1097,monk,mistweaver,30,18,12
Carcasce,la-croisade-écarlate,1096,monk,mistweaver,38,22,16
Thrallergik,ysondre,1093,monk,mistweaver,24,15,9
Bigdickmonk,blackmoore,1092,monk,mistweaver,21,13,8
Kalet,ragnaros,1092,monk,mistweaver,77,36,41
Brünó,kazzak,1089,monk,mistweaver,60,38,22
Апесиинка,gordunni,1084,monk,mistweaver,36,18,18
Cudworth,silvermoon,1082,monk,mistweaver,24,17,7
Gârdt,blackmoore,1081,monk,mistweaver,42,26,16
Chun,arathor,1076,monk,mistweaver,50,24,26
Loctak,nathrezim,1075,monk,mistweaver,54,38,16
Enceladion,burning-legion,1073,monk,mistweaver,54,25,29
Vanquishlølz,archimonde,1070,monk,mistweaver,50,22,28
Bobbyknuckls,ravencrest,1064,monk,mistweaver,54,17,37
Äcé,sylvanas,1063,monk,mistweaver,31,12,19
Ninpou,blackrock,1060,monk,mistweaver,17,12,5
Yoogychi,ravencrest,1056,monk,mistweaver,18,11,7
Totemlygodx,alakir,1056,monk,mistweaver,18,11,7
Traickomonk,eredar,1056,monk,mistweaver,18,11,7
Flãô,draenor,1056,monk,mistweaver,18,11,7
Bjj,blackrock,1056,monk,mistweaver,18,11,7
Vöyage,kazzak,1056,monk,mistweaver,18,11,7
Exbuddhist,outland,1056,monk,mistweaver,18,11,7
Judochops,sylvanas,1056,monk,mistweaver,18,11,7
Coalsack,outland,1056,monk,mistweaver,22,12,10
Darkmonkky,tarren-mill,1056,monk,mistweaver,24,11,13
Ffxivrefugee,argent-dawn,1056,monk,mistweaver,24,11,13
Deii,frostwolf,1056,monk,mistweaver,42,15,27
Kakor,gorgonnash,1055,monk,mistweaver,18,11,7
Busfâhrer,antonidas,1055,monk,mistweaver,18,11,7
Srchi,aggra-português,1055,monk,mistweaver,19,11,8
Jakethestake,twilights-hammer,1054,monk,mistweaver,12,11,1
Hærleyquin,ravencrest,1054,monk,mistweaver,18,11,7
Emblax,blackhand,1054,monk,mistweaver,18,11,7
Kragor,eredar,1054,monk,mistweaver,18,11,7
Neehl,aegwynn,1054,monk,mistweaver,18,11,7
Kispiszock,bloodscalp,1054,monk,mistweaver,18,11,7
Zødiac,quelthalas,1054,monk,mistweaver,18,11,7
Barbielølz,archimonde,1053,monk,mistweaver,18,11,7
Psychømonk,antonidas,1053,monk,mistweaver,18,11,7
Pepesmacks,kazzak,1052,monk,mistweaver,18,11,7
Найтчерри,deathguard,1052,monk,mistweaver,18,11,7
Rebeka,dun-modr,1052,monk,mistweaver,24,11,13
Diabolùs,blackmoore,1052,monk,mistweaver,30,11,19
Lambofmonkz,stormscale,1052,monk,mistweaver,36,11,25
Fithz,kaelthas,1051,monk,mistweaver,12,11,1
Asho,outland,1051,monk,mistweaver,24,11,13
Анамо,blackscar,1050,monk,mistweaver,18,11,7
Brewmâster,kazzak,1050,monk,mistweaver,24,11,13
Irìss,nerzhul,1048,monk,mistweaver,39,19,20
Sydras,silvermoon,1048,monk,mistweaver,301,146,155
Fisticuffs,tarren-mill,1048,monk,mistweaver,24,11,13
Ashulera,archimonde,1048,monk,mistweaver,30,11,19
Mjaweaver,stormscale,1046,monk,mistweaver,62,23,39
Hithxbye,stormscale,1044,monk,mistweaver,66,24,42
Birdymonk,boulderfist,1043,monk,mistweaver,61,36,25
Irphan,ravencrest,1042,monk,mistweaver,18,11,7
Хромдар,gordunni,1040,monk,mistweaver,21,12,9
Graffy,eonar,1040,monk,mistweaver,54,29,25
Gozgajr,twisting-nether,1039,monk,mistweaver,24,11,13
Ívó,ragnaros,1039,monk,mistweaver,24,11,13
ßam,ravencrest,1039,monk,mistweaver,35,14,21
Assfist,drakthul,1038,monk,mistweaver,93,51,42
Badonna,burning-legion,1033,monk,mistweaver,24,11,13
Rumiñawi,ravencrest,1033,monk,mistweaver,30,11,19
Brizs,outland,1032,monk,mistweaver,36,22,14
Mcronald,blackhand,1031,monk,mistweaver,46,23,23
Chimonk,ravencrest,1030,monk,mistweaver,18,11,7
Eldunári,sanguino,1026,monk,mistweaver,24,11,13
Allosthenos,ravencrest,1019,monk,mistweaver,56,29,27
Ugotcraned,tarren-mill,1019,monk,mistweaver,72,27,45
Zedruu,tarren-mill,1015,monk,mistweaver,24,12,12
Madmonki,ragnaros,1011,monk,mistweaver,24,15,9
Shoshin,stormscale,1009,monk,mistweaver,66,37,29
Bèfmoka,sargeras,1008,monk,mistweaver,194,95,99
Mwmkgodxz,archimonde,1007,monk,mistweaver,15,12,3
Nathaanel,argent-dawn,1007,monk,mistweaver,42,20,22
Gøøgodx,tarren-mill,1006,monk,mistweaver,17,11,6
Ivnatorx,outland,1006,monk,mistweaver,17,11,6
Candypoppe,argent-dawn,1004,monk,mistweaver,52,27,25
Kameltreiba,antonidas,1004,monk,mistweaver,23,11,12
Zenchî,ysondre,1001,monk,mistweaver,22,13,9
Lucebree,nozdormu,999,monk,mistweaver,48,18,30
Celestine,mugthol,994,monk,mistweaver,132,64,68
Kégman,silvermoon,992,monk,mistweaver,33,18,15
Pawfong,draenor,987,monk,mistweaver,24,12,12
Andim,frostwolf,986,monk,mistweaver,42,24,18
Wangho,magtheridon,986,monk,mistweaver,96,40,56
Shmidi,antonidas,981,monk,mistweaver,30,15,15
Heäléna,ragnaros,979,monk,mistweaver,21,15,6
Tootenchamun,veklor,971,monk,mistweaver,96,38,58
Samh,twisting-nether,969,monk,mistweaver,29,17,12
Chukwandi,ravencrest,966,monk,mistweaver,64,33,31
Blackmonk,chromaggus,964,monk,mistweaver,21,12,9
Suchergebnis,tarren-mill,964,monk,mistweaver,66,23,43
Brofistmw,outland,960,monk,mistweaver,12,10,2
Vadrigar,drakthul,960,monk,mistweaver,12,10,2
Habmit,ravencrest,960,monk,mistweaver,12,10,2
Kz,culte-de-la-rive-noire,960,monk,mistweaver,12,10,2
Dihsa,ragnaros,960,monk,mistweaver,12,10,2
Sqxgodx,ragnaros,960,monk,mistweaver,12,10,2
Wåñmëíßãøx,sylvanas,960,monk,mistweaver,18,10,8
Zorxen,argent-dawn,960,monk,mistweaver,18,10,8
Cannonk,blackhand,960,monk,mistweaver,18,10,8
Pizelx,ravencrest,960,monk,mistweaver,24,10,14
Garuda,darkspear,959,monk,mistweaver,12,10,2
Citamonk,blackmoore,959,monk,mistweaver,12,10,2
Sioumoo,malganis,959,monk,mistweaver,16,11,5
Ricidora,nerathor,959,monk,mistweaver,18,10,8
Såvonnette,ysondre,959,monk,mistweaver,18,10,8
Energyqt,twisting-nether,959,monk,mistweaver,18,10,8
Mahøni,malganis,959,monk,mistweaver,18,10,8
Chexmonk,silvermoon,959,monk,mistweaver,18,10,8
Mâjô,blackhand,959,monk,mistweaver,18,10,8
Valdaras,runetotem,959,monk,mistweaver,18,10,8
Toaborsten,tarren-mill,958,monk,mistweaver,14,12,2
Zappikmonk,silvermoon,958,monk,mistweaver,12,10,2
Mynokxu,blackmoore,958,monk,mistweaver,12,10,2
Fettakules,eredar,958,monk,mistweaver,18,10,8
Búns,draenor,958,monk,mistweaver,18,10,8
Kbwser,silvermoon,958,monk,mistweaver,18,10,8
Caipha,ravencrest,958,monk,mistweaver,18,10,8
Yuyuni,laughing-skull,958,monk,mistweaver,18,10,8
Паклюха,howling-fjord,958,monk,mistweaver,18,10,8
Sèrafin,burning-legion,958,monk,mistweaver,18,10,8
Kanajambe,twisting-nether,957,monk,mistweaver,12,10,2
Rollsamdi,tarren-mill,957,monk,mistweaver,18,10,8
Teoroll,stormscale,956,monk,mistweaver,18,10,8
Gumar,antonidas,956,monk,mistweaver,18,10,8
Spánkproóf,kazzak,956,monk,mistweaver,18,10,8
Lithenyx,bladefist,956,monk,mistweaver,24,10,14
Lobnx,kazzak,955,monk,mistweaver,18,10,8
Fizted,tarren-mill,955,monk,mistweaver,18,10,8
Ossifist,blackhand,955,monk,mistweaver,24,10,14
Latsu,silvermoon,955,monk,mistweaver,24,10,14
Bottomoré,silvermoon,955,monk,mistweaver,71,24,47
Bråin,ravenholdt,953,monk,mistweaver,24,10,14
Jimbearend,argent-dawn,952,monk,mistweaver,18,10,8
Siouxxsie,thunderhorn,952,monk,mistweaver,84,25,59
Pämella,alleria,951,monk,mistweaver,12,10,2
Tojokirumi,dalaran,951,monk,mistweaver,12,10,2
Dennó,mannoroth,951,monk,mistweaver,18,10,8
Monkyd,stormscale,950,monk,mistweaver,18,10,8
Kakos,eldrethalas,943,monk,mistweaver,12,10,2
Gammelbruno,azshara,942,monk,mistweaver,18,10,8
Serylliah,aegwynn,942,monk,mistweaver,24,10,14
Røär,khaz-modan,934,monk,mistweaver,12,10,2
Puñetaso,los-errantes,934,monk,mistweaver,30,10,20
Ariä,marécage-de-zangar,930,monk,mistweaver,24,13,11
Liathina,sylvanas,928,monk,mistweaver,25,10,15
Keeba,kirin-tor,926,monk,mistweaver,206,98,108
Шадялинь,howling-fjord,920,monk,mistweaver,23,10,13
Ronanze,silvermoon,918,monk,mistweaver,60,30,30
Blackeyé,malganis,914,monk,mistweaver,47,25,22
Millhouse,die-aldor,911,monk,mistweaver,17,10,7
Dícxi,ravencrest,910,monk,mistweaver,17,10,7
Yøøps,dalaran,908,monk,mistweaver,27,13,14
Leafsoup,argent-dawn,906,monk,mistweaver,84,41,43
Indris,dun-modr,895,monk,mistweaver,17,10,7
Мишапяточка,howling-fjord,890,monk,mistweaver,12,11,1
Тиктокмонк,gordunni,877,monk,mistweaver,20,11,9
Greez,tarren-mill,869,monk,mistweaver,22,10,12
Kookmin,doomhammer,864,monk,mistweaver,12,9,3
Sanchios,twisting-nether,864,monk,mistweaver,12,9,3
Iixil,sylvanas,864,monk,mistweaver,12,9,3
Fistpunk,kazzak,864,monk,mistweaver,12,9,3
Turbobär,blackrock,864,monk,mistweaver,12,9,3
Remyhadley,dun-modr,864,monk,mistweaver,12,9,3
Jiest,outland,864,monk,mistweaver,18,9,9
Monkasape,nemesis,864,monk,mistweaver,18,9,9
Kaguræ,hyjal,864,monk,mistweaver,18,9,9
Nule,outland,864,monk,mistweaver,18,9,9
Kareek,sylvanas,864,monk,mistweaver,18,9,9
Miists,kazzak,864,monk,mistweaver,18,9,9
Ультрадевка,blackscar,864,monk,mistweaver,22,9,13
Nillebpgodx,kazzak,864,monk,mistweaver,24,9,15
Fredmonk,stormscale,864,monk,mistweaver,24,9,15
Flowey,uldum,864,monk,mistweaver,24,9,15
Balia,blackrock,864,monk,mistweaver,24,9,15
Malfius,shadowsong,863,monk,mistweaver,12,9,3
Spinalot,eredar,863,monk,mistweaver,12,9,3
Mistwave,eredar,863,monk,mistweaver,12,9,3
Shabaz,draenor,863,monk,mistweaver,12,9,3
Arlot,blackmoore,863,monk,mistweaver,12,9,3
Backseatgmr,ravencrest,863,monk,mistweaver,12,9,3
Bearmw,draenor,863,monk,mistweaver,18,9,9
Kattlåda,darkspear,863,monk,mistweaver,18,9,9
Kyleestrutt,stormscale,863,monk,mistweaver,18,9,9
Torinia,madmortem,863,monk,mistweaver,18,9,9
Phébz,archimonde,863,monk,mistweaver,18,9,9
Monkéy,blackhand,863,monk,mistweaver,18,9,9
Fiddle,archimonde,863,monk,mistweaver,18,9,9
Saadlol,sanguino,863,monk,mistweaver,18,9,9
Nowhaazzer,dun-modr,863,monk,mistweaver,18,9,9
Вондерофъю,gordunni,863,monk,mistweaver,18,9,9
Rminto,twisting-nether,863,monk,mistweaver,24,9,15
Beerbringer,kazzak,862,monk,mistweaver,12,9,3
Missfist,stormscale,862,monk,mistweaver,12,9,3
Niborc,doomhammer,862,monk,mistweaver,12,9,3
Monkjakt,draenor,862,monk,mistweaver,18,9,9
Mwsama,stormscale,861,monk,mistweaver,12,9,3
Puñolou,sanguino,861,monk,mistweaver,12,9,3
Tílidin,malganis,861,monk,mistweaver,12,9,3
Koldar,grim-batol,861,monk,mistweaver,17,12,5
Mistréss,silvermoon,858,monk,mistweaver,18,9,9
Herdom,blackmoore,856,monk,mistweaver,12,9,3
Thymesurge,ravencrest,856,monk,mistweaver,18,9,9
Pafia,sargeras,852,monk,mistweaver,25,12,13
Liwong,antonidas,850,monk,mistweaver,12,9,3
Geckazz,kazzak,847,monk,mistweaver,12,9,3
Wûcm,silvermoon,846,monk,mistweaver,17,9,8
Geeberz,twisting-nether,838,monk,mistweaver,18,9,9
Changzu,sanguino,837,monk,mistweaver,42,17,25
ßæutiful,silvermoon,835,monk,mistweaver,30,13,17
Drakzyr,argent-dawn,831,monk,mistweaver,16,9,7
Fistarfrans,sylvanas,828,monk,mistweaver,14,10,4
Fréýáá,blackrock,827,monk,mistweaver,18,9,9
Tèam,defias-brotherhood,810,monk,mistweaver,15,9,6
Nouraxo,kazzak,809,monk,mistweaver,22,10,12
Xalyà,archimonde,803,monk,mistweaver,18,12,6
Extaszeh,turalyon,802,monk,mistweaver,17,11,6
Mellu,kazzak,798,monk,mistweaver,14,9,5
Zerochi,kazzak,796,monk,mistweaver,19,10,9
Jînex,shattrath,784,monk,mistweaver,13,9,4
Gatubarnet,stormscale,783,monk,mistweaver,13,9,4
Гуппер,howling-fjord,768,monk,mistweaver,12,8,4
Jlo,stormscale,768,monk,mistweaver,12,8,4
Mástermônkèy,tarren-mill,768,monk,mistweaver,12,8,4
Shushux,ysondre,768,monk,mistweaver,12,8,4
Mialena,eredar,768,monk,mistweaver,12,8,4
Guarnounet,hyjal,768,monk,mistweaver,12,8,4
Dexcore,draenor,768,monk,mistweaver,12,8,4
Анимешнеца,gordunni,768,monk,mistweaver,12,8,4
Fckisrael,archimonde,768,monk,mistweaver,12,8,4
Wisebeb,les-clairvoyants,768,monk,mistweaver,12,8,4
Brutamonk,blackmoore,768,monk,mistweaver,12,8,4
Miamalkøva,nemesis,768,monk,mistweaver,12,8,4
Hurjat,stormreaver,768,monk,mistweaver,12,8,4
Bidzi,kazzak,768,monk,mistweaver,12,8,4
Cattleyah,ysondre,768,monk,mistweaver,12,8,4
Xoonaki,turalyon,768,monk,mistweaver,12,8,4
Plancton,kazzak,768,monk,mistweaver,12,8,4
Savvuzzino,nemesis,768,monk,mistweaver,12,8,4
Adrianchase,ravencrest,768,monk,mistweaver,12,8,4
Бэккс,howling-fjord,768,monk,mistweaver,12,8,4
Kradder,nordrassil,768,monk,mistweaver,12,8,4
Shyrea,nazjatar,768,monk,mistweaver,12,8,4
Ånåsenpåi,archimonde,768,monk,mistweaver,12,8,4
Infamøus,uldum,768,monk,mistweaver,12,8,4
Mvm,outland,768,monk,mistweaver,12,8,4
Reivil,kazzak,768,monk,mistweaver,12,8,4
Orki,ragnaros,768,monk,mistweaver,18,8,10
Goamix,ravencrest,768,monk,mistweaver,18,8,10
Adamlól,tarren-mill,768,monk,mistweaver,18,8,10
Träskolasse,tarren-mill,768,monk,mistweaver,18,8,10
Tøxicweaver,kazzak,768,monk,mistweaver,18,8,10
Eldaras,tarren-mill,768,monk,mistweaver,18,8,10
Ronkingkong,ravencrest,768,monk,mistweaver,18,8,10
Loth,archimonde,767,monk,mistweaver,12,8,4
Россиянин,thermaplugg,767,monk,mistweaver,12,8,4
Adzk,tarren-mill,767,monk,mistweaver,12,8,4
Lin,nathrezim,767,monk,mistweaver,12,8,4
Truelo,eredar,767,monk,mistweaver,12,8,4
Souhei,drakthul,767,monk,mistweaver,12,8,4
Draxed,kazzak,767,monk,mistweaver,12,8,4
Xerzulo,silvermoon,767,monk,mistweaver,12,8,4
Hvdo,silvermoon,767,monk,mistweaver,12,8,4
Pvppenergy,silvermoon,767,monk,mistweaver,12,8,4
Мистхоррор,gordunni,767,monk,mistweaver,12,8,4
Maigraith,malganis,767,monk,mistweaver,12,8,4
Æbscourgê,azjolnerub,767,monk,mistweaver,18,8,10
Lerouxx,archimonde,767,monk,mistweaver,18,8,10
Aliyo,aegwynn,767,monk,mistweaver,18,8,10
Gízmö,tarren-mill,767,monk,mistweaver,18,8,10
Nexyyfist,kazzak,767,monk,mistweaver,18,8,10
Shàllýn,antonidas,767,monk,mistweaver,18,8,10
Qî,ravencrest,767,monk,mistweaver,30,8,22
Cocoonkappa,dun-modr,766,monk,mistweaver,12,8,4
Papasan,aggramar,766,monk,mistweaver,12,8,4
Lilithrevan,frostmourne,766,monk,mistweaver,12,8,4
Sinzy,dentarg,766,monk,mistweaver,12,8,4
Nulojeu,archimonde,766,monk,mistweaver,12,8,4
Weavi,kazzak,766,monk,mistweaver,12,8,4
Riip,ysondre,766,monk,mistweaver,12,8,4
Galaxumi,ragnaros,766,monk,mistweaver,18,8,10
Gakunie,blackhand,766,monk,mistweaver,18,8,10
Hersmonk,drakthul,765,monk,mistweaver,12,8,4
Kegbrew,kazzak,765,monk,mistweaver,12,8,4
Lorkas,darkmoon-faire,765,monk,mistweaver,12,8,4
Каземат,booty-bay,765,monk,mistweaver,18,8,10
Lûxz,ragnaros,765,monk,mistweaver,18,8,10
Tolomèo,nemesis,765,monk,mistweaver,18,8,10
Trxy,argent-dawn,765,monk,mistweaver,36,8,28
Lilniccí,blackrock,764,monk,mistweaver,12,8,4
Lumpiiná,antonidas,764,monk,mistweaver,18,8,10
Idkfa,sylvanas,764,monk,mistweaver,18,8,10
Порвуседло,soulflayer,764,monk,mistweaver,18,8,10
Saintmoon,drakthul,762,monk,mistweaver,18,8,10
Pekinn,sanguino,761,monk,mistweaver,18,8,10
Karmasfist,ravencrest,760,monk,mistweaver,12,8,4
Kieteltje,sylvanas,760,monk,mistweaver,12,8,4
Skrøn,kult-der-verdammten,760,monk,mistweaver,12,8,4
Сукавкимоно,soulflayer,758,monk,mistweaver,18,8,10
Slý,archimonde,757,monk,mistweaver,12,8,4
Nezukoko,archimonde,735,monk,mistweaver,16,8,8
Fetchd,blackmoore,733,monk,mistweaver,16,8,8
Ndaula,drakthul,733,monk,mistweaver,25,9,16
Dinxfar,draenor,732,monk,mistweaver,14,9,5
Zóma,ragnaros,714,monk,mistweaver,22,9,13
Moreløs,stormscale,710,monk,mistweaver,24,10,14
Jsuispasheal,dalaran,705,monk,mistweaver,28,12,16
Elasha,archimonde,703,monk,mistweaver,11,8,3
Шаолий,gordunni,683,monk,mistweaver,30,8,22
Simbabsu,thrall,672,monk,mistweaver,10,8,2
Biggesttaf,stormscale,672,monk,mistweaver,10,8,2
Alutzharn,argent-dawn,672,monk,mistweaver,12,7,5
Lamasauce,ravencrest,672,monk,mistweaver,12,7,5
Yàfa,archimonde,672,monk,mistweaver,12,7,5
Longpeng,ysera,672,monk,mistweaver,12,7,5
Aessella,antonidas,672,monk,mistweaver,12,7,5
Franziskanus,das-syndikat,672,monk,mistweaver,12,7,5
Fugmonk,ravencrest,672,monk,mistweaver,12,7,5
Hessuzen,stormreaver,672,monk,mistweaver,12,7,5
Mélêxe,ysondre,672,monk,mistweaver,12,7,5
Cmonbruh,ravencrest,672,monk,mistweaver,12,7,5
Monkamonk,blutkessel,672,monk,mistweaver,12,7,5
Klappzz,outland,672,monk,mistweaver,12,7,5
Starside,tarren-mill,672,monk,mistweaver,12,7,5
Flexify,outland,672,monk,mistweaver,12,7,5
ßreacher,argent-dawn,672,monk,mistweaver,12,7,5
Podrugabomja,outland,672,monk,mistweaver,12,7,5
Yepp,blackmoore,672,monk,mistweaver,12,7,5
Soulcháos,ravencrest,672,monk,mistweaver,12,7,5
Merçury,dun-morogh,672,monk,mistweaver,12,7,5
Mw,magtheridon,672,monk,mistweaver,12,7,5
Tedels,kazzak,672,monk,mistweaver,12,7,5
Medinâ,kult-der-verdammten,672,monk,mistweaver,12,7,5
Mjoo,blackrock,672,monk,mistweaver,12,7,5
Irønmaxx,die-aldor,672,monk,mistweaver,12,7,5
Mistkueefer,tarren-mill,672,monk,mistweaver,12,7,5
Nastyføxÿ,ysondre,672,monk,mistweaver,12,7,5
Prismaticx,ravencrest,672,monk,mistweaver,12,7,5
Yulon,blackrock,672,monk,mistweaver,12,7,5
Фистингкоуч,gordunni,672,monk,mistweaver,12,7,5
Frajer,auchindoun,672,monk,mistweaver,12,7,5
Fshn,sylvanas,672,monk,mistweaver,12,7,5
Astarrserran,drakthul,672,monk,mistweaver,12,7,5
Monkel,frostwolf,672,monk,mistweaver,12,7,5
Вхукьютиикс,howling-fjord,672,monk,mistweaver,13,7,6
Leykom,ravencrest,672,monk,mistweaver,15,8,7
Amzu,kazzak,672,monk,mistweaver,18,7,11
Dråf,ysondre,672,monk,mistweaver,18,7,11
Bâsarä,archimonde,672,monk,mistweaver,18,7,11
Exru,draenor,672,monk,mistweaver,18,7,11
Scz,draenor,672,monk,mistweaver,18,7,11
Atómic,eredar,672,monk,mistweaver,18,7,11
Boîndíl,malfurion,672,monk,mistweaver,18,7,11
Abdulhealer,stormscale,672,monk,mistweaver,18,7,11
Mâki,ravencrest,672,monk,mistweaver,18,7,11
Fistweavingg,tarren-mill,672,monk,mistweaver,18,7,11
Bigkim,khadgar,672,monk,mistweaver,18,7,11
Madraven,ravencrest,672,monk,mistweaver,24,7,17
Mitchell,sylvanas,671,monk,mistweaver,12,7,5
Jagermonk,doomhammer,671,monk,mistweaver,12,7,5
Fonk,blades-edge,671,monk,mistweaver,12,7,5
Agodx,sanguino,671,monk,mistweaver,12,7,5
Shoryugrops,chants-éternels,671,monk,mistweaver,12,7,5
Изимонк,gordunni,671,monk,mistweaver,12,7,5
Wudao,anubarak,671,monk,mistweaver,12,7,5
Åshêrs,stormscale,671,monk,mistweaver,12,7,5
Chigee,kazzak,671,monk,mistweaver,12,7,5
Xanadoll,outland,671,monk,mistweaver,12,7,5
Anadia,blackrock,671,monk,mistweaver,12,7,5
Кисеч,soulflayer,671,monk,mistweaver,12,7,5
Ogpandapo,stormscale,671,monk,mistweaver,12,7,5
Sensëi,bronze-dragonflight,671,monk,mistweaver,13,7,6
Gilario,silvermoon,671,monk,mistweaver,18,7,11
Алунам,soulflayer,671,monk,mistweaver,18,7,11
Hittokick,draenor,671,monk,mistweaver,18,7,11
Lazuros,auchindoun,671,monk,mistweaver,18,7,11
Spinniboi,blackhand,671,monk,mistweaver,18,7,11
Sideswipes,the-maelstrom,671,monk,mistweaver,18,7,11
Аверлорд,fordragon,670,monk,mistweaver,12,7,5
Monkinamight,turalyon,670,monk,mistweaver,12,7,5
Brewm,silvermoon,670,monk,mistweaver,12,7,5
Bréwsléé,ragnaros,670,monk,mistweaver,12,7,5
Healmeup,anetheron,670,monk,mistweaver,12,7,5
Zendyy,argent-dawn,670,monk,mistweaver,12,7,5
Joübar,archimonde,670,monk,mistweaver,12,7,5
Rhuru,argent-dawn,670,monk,mistweaver,14,7,7
Furynextdoor,hyjal,669,monk,mistweaver,12,7,5
Zywoo,emerald-dream,668,monk,mistweaver,18,7,11
Chenpô,gorgonnash,667,monk,mistweaver,12,7,5
Dotheas,argent-dawn,667,monk,mistweaver,18,7,11
Senseithai,trollbane,665,monk,mistweaver,18,7,11
Cheriedevile,drakthul,665,monk,mistweaver,24,7,17
Wuchanglan,blackmoore,665,monk,mistweaver,30,7,23
Pandadoum,ysondre,663,monk,mistweaver,12,7,5
Ràsetsu,nagrand,663,monk,mistweaver,12,7,5
Brewteaful,outland,655,monk,mistweaver,11,7,4
Mistyheals,nagrand,647,monk,mistweaver,18,7,11
Qdwdwqerdads,ravencrest,640,monk,mistweaver,16,8,8
Lylaei,argent-dawn,639,monk,mistweaver,17,7,10
Klischi,taerar,639,monk,mistweaver,17,7,10
Shapumvilla,alonsus,637,monk,mistweaver,8,8,0
Randomxbrew,draenor,624,monk,mistweaver,9,8,1
Vatsmijter,silvermoon,623,monk,mistweaver,11,7,4
Yøda,malganis,621,monk,mistweaver,15,7,8
Nxmonk,sylvanas,618,monk,mistweaver,16,8,8
Tanyà,hyjal,617,monk,mistweaver,12,8,4
Varolul,aegwynn,606,monk,mistweaver,11,7,4
Ronocs,turalyon,606,monk,mistweaver,14,7,7
Chìless,shadowsong,576,monk,mistweaver,6,6,0
Mowì,stormscale,576,monk,mistweaver,6,6,0
Dupengchi,blackrock,576,monk,mistweaver,6,6,0
Althéia,dalaran,576,monk,mistweaver,6,6,0
Redundänt,kazzak,576,monk,mistweaver,6,6,0
Флориусс,soulflayer,576,monk,mistweaver,6,6,0
Djalexmw,kazzak,576,monk,mistweaver,6,6,0
Pivomamrad,drakthul,576,monk,mistweaver,12,6,6
Mozzi,frostmane,576,monk,mistweaver,12,6,6
Iliketofist,ravencrest,576,monk,mistweaver,12,6,6
Bluebery,burning-legion,576,monk,mistweaver,12,6,6
Tiddor,burning-legion,576,monk,mistweaver,12,6,6
Req,darksorrow,576,monk,mistweaver,12,6,6
Garfunkel,emeriss,576,monk,mistweaver,12,6,6
Åmba,blackrock,576,monk,mistweaver,12,6,6
Fistandfury,outland,576,monk,mistweaver,12,6,6
Deepênd,antonidas,576,monk,mistweaver,12,6,6
Aritisi,tarren-mill,576,monk,mistweaver,12,6,6
Leashed,blackmoore,576,monk,mistweaver,12,6,6
Gruslinovica,archimonde,576,monk,mistweaver,12,6,6
Rudiculous,malganis,576,monk,mistweaver,12,6,6
Annoyingtwo,archimonde,576,monk,mistweaver,12,6,6
Yez,azjolnerub,576,monk,mistweaver,12,6,6
Ryac,defias-brotherhood,576,monk,mistweaver,12,6,6
Rashtamonk,blackmoore,576,monk,mistweaver,12,6,6
Oiorie,twisting-nether,576,monk,mistweaver,12,6,6
Garweaver,frostwolf,576,monk,mistweaver,12,6,6
Gosphhell,archimonde,576,monk,mistweaver,12,6,6
Sinensi,conseil-des-ombres,576,monk,mistweaver,12,6,6
Revii,anubarak,576,monk,mistweaver,12,6,6
Mickeyworms,archimonde,576,monk,mistweaver,12,6,6
Vàlky,outland,576,monk,mistweaver,12,6,6
Кончеглаз,soulflayer,576,monk,mistweaver,12,6,6
Icecoldbrew,outland,576,monk,mistweaver,12,6,6
Vedak,stormreaver,576,monk,mistweaver,12,6,6
Дезмимонк,ashenvale,576,monk,mistweaver,12,6,6
Atralês,azshara,576,monk,mistweaver,12,6,6
Миражмонк,howling-fjord,576,monk,mistweaver,12,6,6
Potkuri,stormreaver,576,monk,mistweaver,12,6,6
Kurzgesagt,destromath,576,monk,mistweaver,12,6,6
Ankelstrumpa,tarren-mill,576,monk,mistweaver,12,6,6
Zabjudah,stormscale,576,monk,mistweaver,12,6,6
Mørbradgryde,silvermoon,576,monk,mistweaver,12,6,6
Monjonagger,tyrande,576,monk,mistweaver,12,6,6
Faki,eredar,576,monk,mistweaver,12,6,6
Huricän,drakthul,576,monk,mistweaver,15,7,8
Коумана,gordunni,576,monk,mistweaver,15,7,8
Renegatt,twisting-nether,576,monk,mistweaver,18,6,12
Ayanaami,pozzo-delleternità,576,monk,mistweaver,18,6,12
Дядямаготика,deathguard,576,monk,mistweaver,18,6,12
Торен,soulflayer,576,monk,mistweaver,18,6,12
Modequillo,blackmoore,576,monk,mistweaver,18,6,12
Монкмяу,howling-fjord,576,monk,mistweaver,18,6,12
Vrexza,kazzak,576,monk,mistweaver,18,6,12
Itsthemonkky,tarren-mill,576,monk,mistweaver,24,6,18
Fraideberoa,ravencrest,575,monk,mistweaver,6,6,0
Тэсси,blackscar,575,monk,mistweaver,12,6,6
Drlyn,blackmoore,575,monk,mistweaver,12,6,6
Vexzen,tarren-mill,575,monk,mistweaver,12,6,6
Shenyen,silvermoon,575,monk,mistweaver,12,6,6
Tily,stormreaver,575,monk,mistweaver,12,6,6
Kushinaa,teldrassil,575,monk,mistweaver,12,6,6
Ðoom,sylvanas,575,monk,mistweaver,12,6,6
Skonk,frostmane,575,monk,mistweaver,12,6,6
Khakk,elune,575,monk,mistweaver,12,6,6
Charlett,the-venture-co,575,monk,mistweaver,12,6,6
Rakowo,arthas,575,monk,mistweaver,12,6,6
Drír,archimonde,575,monk,mistweaver,12,6,6
Bbigttgothgf,doomhammer,575,monk,mistweaver,12,6,6
Druni,archimonde,575,monk,mistweaver,12,6,6
Samie,ravencrest,575,monk,mistweaver,12,6,6
Toweliè,thrall,575,monk,mistweaver,12,6,6
Painswîft,blackhand,575,monk,mistweaver,18,6,12
Latify,todeswache,575,monk,mistweaver,18,6,12
Mulana,sanguino,575,monk,mistweaver,18,6,12
Kswis,outland,575,monk,mistweaver,18,6,12
Othalain,silvermoon,574,monk,mistweaver,12,6,6
Kungfusler,twisting-nether,574,monk,mistweaver,12,6,6
Irishdëmon,ravencrest,574,monk,mistweaver,16,6,10
Jackamonk,kazzak,574,monk,mistweaver,18,6,12
Xentimus,kazzak,573,monk,mistweaver,18,6,12
Ghninscare,blackmoore,560,monk,mistweaver,13,8,5
Christien,ungoro,558,monk,mistweaver,23,6,17
Psychö,zuljin,538,monk,mistweaver,17,6,11
Gingerbrew,hyjal,528,monk,mistweaver,9,7,2
Lidalol,silvermoon,527,monk,mistweaver,9,7,2
Trymax,blackmoore,522,monk,mistweaver,17,7,10
Leïsha,ysondre,522,monk,mistweaver,18,7,11
Tondi,malygos,511,monk,mistweaver,10,6,4
Годъяр,gordunni,510,monk,mistweaver,14,6,8
Tarzaki,hyjal,494,monk,mistweaver,13,6,7
Watschensepp,arthas,480,monk,mistweaver,6,5,1
Muix,draenor,480,monk,mistweaver,6,5,1
Sloopkogel,tarren-mill,480,monk,mistweaver,6,5,1
Ribbeh,draenor,480,monk,mistweaver,6,5,1
Saenxz,blackrock,480,monk,mistweaver,6,5,1
Gaalon,ravencrest,480,monk,mistweaver,6,5,1
Павнмонкх,gordunni,480,monk,mistweaver,6,5,1
Notgherit,nemesis,480,monk,mistweaver,6,5,1
Подорожнник,gordunni,480,monk,mistweaver,6,5,1
Monkatapiti,malganis,480,monk,mistweaver,6,5,1
Drylezm,twisting-nether,480,monk,mistweaver,6,5,1
Ørcqt,tarren-mill,480,monk,mistweaver,6,5,1
Nobrainfist,stormscale,480,monk,mistweaver,6,5,1
Veladana,chamber-of-aspects,480,monk,mistweaver,6,5,1
Sio,dentarg,480,monk,mistweaver,6,5,1
Zoruun,quelthalas,480,monk,mistweaver,6,5,1
Kiziibrla,archimonde,480,monk,mistweaver,6,5,1
Chingbag,dalaran,480,monk,mistweaver,6,5,1
Sozzemonk,kazzak,480,monk,mistweaver,6,5,1
Dukhi,kazzak,480,monk,mistweaver,6,5,1
Такиера,gordunni,480,monk,mistweaver,6,5,1
Kaowar,nerzhul,480,monk,mistweaver,6,5,1
Garfeels,sylvanas,480,monk,mistweaver,6,5,1
Stromon,silvermoon,480,monk,mistweaver,6,5,1
Clydemonk,outland,480,monk,mistweaver,6,5,1
Akwaman,stormscale,480,monk,mistweaver,6,5,1
Xkäz,archimonde,480,monk,mistweaver,6,5,1
Zarona,outland,480,monk,mistweaver,6,5,1
Jeanmartin,hyjal,480,monk,mistweaver,12,5,7
Lunì,nathrezim,480,monk,mistweaver,12,5,7
Jodeen,shadowsong,480,monk,mistweaver,12,5,7
Hon,sanguino,480,monk,mistweaver,12,5,7
Ðrçleañ,stormreaver,480,monk,mistweaver,12,5,7
Erandja,silvermoon,480,monk,mistweaver,12,5,7
Otuschxin,blackmoore,480,monk,mistweaver,12,5,7
Andelicek,burning-blade,480,monk,mistweaver,12,5,7
Chimý,tarren-mill,480,monk,mistweaver,12,5,7
Minervaez,grim-batol,480,monk,mistweaver,12,5,7
Jacm,blackhand,480,monk,mistweaver,12,5,7
Siezlebabo,blackrock,480,monk,mistweaver,12,5,7
Hoibglotzn,antonidas,480,monk,mistweaver,12,5,7
Bountyño,dun-modr,480,monk,mistweaver,12,5,7
Gecli,stormscale,480,monk,mistweaver,12,5,7
Виброолег,gordunni,480,monk,mistweaver,12,5,7
Tîptap,blackrock,480,monk,mistweaver,12,5,7
Gemil,argent-dawn,480,monk,mistweaver,12,5,7
Тайви,deepholm,480,monk,mistweaver,12,5,7
Miquella,scarshield-legion,480,monk,mistweaver,12,5,7
Místborn,ravencrest,480,monk,mistweaver,12,5,7
Skiqzy,ravencrest,480,monk,mistweaver,12,5,7
Tino,sylvanas,480,monk,mistweaver,12,5,7
Axelight,chants-éternels,480,monk,mistweaver,12,5,7
Whytoosxy,silvermoon,480,monk,mistweaver,18,5,13
Drumonk,kelthuzad,480,monk,mistweaver,18,5,13
Копытька,gordunni,480,monk,mistweaver,18,5,13
Wkiller,outland,480,monk,mistweaver,18,5,13
Risomonk,blackrock,480,monk,mistweaver,24,5,19
Pandalezanda,silvermoon,479,monk,mistweaver,6,5,1
Proxxona,eredar,479,monk,mistweaver,6,5,1
Bovinebuddha,stormscale,479,monk,mistweaver,12,5,7
Luigimonk,dun-modr,479,monk,mistweaver,12,5,7
Яутжа,soulflayer,479,monk,mistweaver,12,5,7
Stenhård,azjolnerub,479,monk,mistweaver,12,5,7
Lascala,eredar,479,monk,mistweaver,12,5,7
Durand,blackhand,479,monk,mistweaver,12,5,7
Kryopumper,blackmoore,479,monk,mistweaver,12,5,7
Wotaner,eredar,479,monk,mistweaver,12,5,7
Дарума,grom,479,monk,mistweaver,12,5,7
Sotqyy,stormscale,479,monk,mistweaver,12,5,7
Добраядушка,gordunni,479,monk,mistweaver,18,5,13
Knotze,eredar,479,monk,mistweaver,18,5,13
Løkî,culte-de-la-rive-noire,479,monk,mistweaver,24,5,19
Xèrá,antonidas,479,monk,mistweaver,24,5,19
Shontal,ravencrest,478,monk,mistweaver,12,5,7
Zoolloonn,norgannon,478,monk,mistweaver,12,5,7
Wînk,amanthul,478,monk,mistweaver,12,5,7
Backbone,auchindoun,478,monk,mistweaver,12,5,7
Fardareismai,kazzak,478,monk,mistweaver,18,5,13
Брэйки,lich-king,478,monk,mistweaver,18,5,13
Leffe,thunderhorn,476,monk,mistweaver,12,5,7
Drugarix,uldaman,475,monk,mistweaver,12,5,7
Chucknorrís,kilrogg,474,monk,mistweaver,18,7,11
Filomenata,rexxar,469,monk,mistweaver,19,5,14
Zinzyo,aegwynn,447,monk,mistweaver,11,5,6
Pìmpìnelle,garona,432,monk,mistweaver,9,6,3
Mku,kazzak,432,monk,mistweaver,9,6,3
Ygêrne,archimonde,426,monk,mistweaver,15,6,9
Dræk,twisting-nether,426,monk,mistweaver,19,6,13
Chakarma,twisting-nether,416,monk,mistweaver,22,5,17
Lévanà,antonidas,415,monk,mistweaver,8,5,3
Sudoku,thrall,415,monk,mistweaver,14,5,9
Fistyboyuk,tarren-mill,384,monk,mistweaver,6,4,2
Xloxloxloxy,outland,384,monk,mistweaver,6,4,2
Meineaugen,blackhand,384,monk,mistweaver,6,4,2
Roudious,arathi,384,monk,mistweaver,6,4,2
Peaceweaver,ravencrest,384,monk,mistweaver,6,4,2
Ibsmonk,outland,384,monk,mistweaver,6,4,2
Bratana,dun-morogh,384,monk,mistweaver,6,4,2
Highline,draenor,384,monk,mistweaver,6,4,2
Харуказэ,howling-fjord,384,monk,mistweaver,6,4,2
Fakestrxx,aegwynn,384,monk,mistweaver,6,4,2
Bigflex,conseil-des-ombres,384,monk,mistweaver,6,4,2
Tmnmnk,alakir,384,monk,mistweaver,6,4,2
Slokwerk,dentarg,384,monk,mistweaver,6,4,2
Zbamonk,burning-legion,384,monk,mistweaver,6,4,2
Trácybéákérx,kazzak,384,monk,mistweaver,6,4,2
Deniise,kult-der-verdammten,384,monk,mistweaver,6,4,2
Kazéshini,doomhammer,384,monk,mistweaver,6,4,2
Xevol,burning-legion,384,monk,mistweaver,6,4,2
Spîndêmôrt,stormscale,384,monk,mistweaver,6,4,2
Олежатоксик,gordunni,384,monk,mistweaver,6,4,2
Mistfeeder,burning-blade,384,monk,mistweaver,6,4,2
Zugzuwg,ahnqiraj,384,monk,mistweaver,6,4,2
Nêrfmeta,kazzak,384,monk,mistweaver,6,4,2
Lennifer,ragnaros,384,monk,mistweaver,6,4,2
Shenexo,kazzak,384,monk,mistweaver,6,4,2
Dath,outland,384,monk,mistweaver,6,4,2
Podekouil,ysondre,384,monk,mistweaver,6,4,2
Punkfukanda,drakthul,384,monk,mistweaver,6,4,2
Missislee,aegwynn,384,monk,mistweaver,6,4,2
Муррчалкин,howling-fjord,384,monk,mistweaver,6,4,2
Camlen,draenor,384,monk,mistweaver,6,4,2
Леобтв,soulflayer,384,monk,mistweaver,6,4,2
Alomonk,archimonde,384,monk,mistweaver,6,4,2
Naìsh,arygos,384,monk,mistweaver,6,4,2
Monkersquad,doomhammer,384,monk,mistweaver,6,4,2
Jifun,kazzak,384,monk,mistweaver,6,4,2
Trancendent,silvermoon,384,monk,mistweaver,6,4,2
Spittq,ysondre,384,monk,mistweaver,6,4,2
Foaqer,aegwynn,384,monk,mistweaver,6,4,2
Plånck,archimonde,384,monk,mistweaver,6,4,2
Bhrag,die-aldor,384,monk,mistweaver,6,4,2
Cocacolazeró,draenor,384,monk,mistweaver,6,4,2
Claww,blackrock,384,monk,mistweaver,6,4,2
Jemijedno,drakthul,384,monk,mistweaver,6,4,2
Escopetin,los-errantes,384,monk,mistweaver,6,4,2
Ennamoly,blackmoore,384,monk,mistweaver,6,4,2
Gangichi,blackhand,384,monk,mistweaver,9,5,4
Dúlgor,blackmoore,384,monk,mistweaver,11,6,5
Scarymønk,kazzak,384,monk,mistweaver,8,4,4
Päätöksiä,defias-brotherhood,384,monk,mistweaver,12,4,8
Chimail,blackrock,384,monk,mistweaver,12,4,8
Woofi,tarren-mill,384,monk,mistweaver,12,4,8
Bûl,blackmoore,384,monk,mistweaver,12,4,8
Invsionrush,crushridge,384,monk,mistweaver,12,4,8
Suhnukka,stormscale,384,monk,mistweaver,12,4,8
Pikkupotkuri,stormreaver,384,monk,mistweaver,12,4,8
Konïï,dalaran,384,monk,mistweaver,12,4,8
Skelmir,dragonblight,384,monk,mistweaver,12,4,8
Monkmonkesen,stormscale,384,monk,mistweaver,12,4,8
Слишкомхорош,howling-fjord,384,monk,mistweaver,12,4,8
Eth,nagrand,384,monk,mistweaver,12,4,8
Lysanmonk,zuljin,384,monk,mistweaver,12,4,8
Craneovic,kult-der-verdammten,384,monk,mistweaver,12,4,8
Bakersdozen,tarren-mill,384,monk,mistweaver,12,4,8
Карманедаун,howling-fjord,384,monk,mistweaver,12,4,8
Bruceli,darkmoon-faire,384,monk,mistweaver,12,4,8
Audaz,dun-modr,384,monk,mistweaver,12,4,8
Nebelwandler,blackhand,384,monk,mistweaver,12,4,8
Subzxftw,archimonde,384,monk,mistweaver,12,4,8
Betelgeuse,jaedenar,384,monk,mistweaver,18,4,14
Níki,earthen-ring,383,monk,mistweaver,6,4,2
Goldenquinn,sylvanas,383,monk,mistweaver,6,4,2
Vzan,kazzak,383,monk,mistweaver,6,4,2
Wrathing,tarren-mill,383,monk,mistweaver,6,4,2
Supwithat,kazzak,383,monk,mistweaver,6,4,2
Shuzao,steamwheedle-cartel,383,monk,mistweaver,12,4,8
Velicko,ravencrest,383,monk,mistweaver,12,4,8
Korrok,sanguino,383,monk,mistweaver,12,4,8
Gnomebrew,ravencrest,383,monk,mistweaver,12,4,8
Ornithorynke,hyjal,383,monk,mistweaver,12,4,8
Eucalyptuz,draenor,383,monk,mistweaver,12,4,8
Doneithné,stormscale,383,monk,mistweaver,12,4,8
Fkflying,defias-brotherhood,381,monk,mistweaver,12,4,8
Plií,frostwolf,362,monk,mistweaver,19,6,13
Hullumunkki,blackmoore,352,monk,mistweaver,10,4,6
Автотюн,gordunni,352,monk,mistweaver,16,4,12
Matrim,arathor,351,monk,mistweaver,8,5,3
Киото,ashenvale,350,monk,mistweaver,11,4,7
Masimonk,blackrock,350,monk,mistweaver,11,4,7
Frodrin,kazzak,347,monk,mistweaver,11,4,7
Thiccbaby,kazzak,336,monk,mistweaver,9,4,5
Insomniyah,tarren-mill,335,monk,mistweaver,11,4,7
Buckersxo,kazzak,330,monk,mistweaver,11,6,5
Midgetyoda,outland,330,monk,mistweaver,22,5,17
Ilikeducks,ravencrest,319,monk,mistweaver,5,4,1
Zaalleh,draenor,319,monk,mistweaver,5,4,1
Nabenja,madmortem,319,monk,mistweaver,14,4,10
Schellentano,defias-brotherhood,301,monk,mistweaver,13,4,9
Moistweaver,drakthul,288,monk,mistweaver,6,3,3
Loempia,outland,288,monk,mistweaver,6,3,3
Fistwave,malganis,288,monk,mistweaver,6,3,3
Atommyran,frostmane,288,monk,mistweaver,6,3,3
Relentlessly,blackrock,288,monk,mistweaver,6,3,3
Incapp,ysondre,288,monk,mistweaver,6,3,3
Shoskio,chamber-of-aspects,288,monk,mistweaver,6,3,3
Tastyfists,blackmoore,288,monk,mistweaver,6,3,3
Киликххл,deathguard,288,monk,mistweaver,6,3,3
Friidam,lightbringer,288,monk,mistweaver,6,3,3
Shnohh,blackmoore,288,monk,mistweaver,6,3,3
Nexìan,kazzak,288,monk,mistweaver,6,3,3
Louiemon,outland,288,monk,mistweaver,6,3,3
Mistless,ragnaros,288,monk,mistweaver,6,3,3
Кроанла,howling-fjord,288,monk,mistweaver,6,3,3
Norbii,twisting-nether,288,monk,mistweaver,6,3,3
Shiìnx,hyjal,288,monk,mistweaver,6,3,3
Kätelyys,dun-modr,288,monk,mistweaver,6,3,3
Zyrosmonk,blackmoore,288,monk,mistweaver,6,3,3
Menecares,blackhand,288,monk,mistweaver,6,3,3
Monkiz,veknilash,288,monk,mistweaver,6,3,3
Cmgxbrew,blackrock,288,monk,mistweaver,6,3,3
Helacoon,archimonde,288,monk,mistweaver,6,3,3
Xanderpowa,sanguino,288,monk,mistweaver,6,3,3
Uggs,hyjal,288,monk,mistweaver,6,3,3
Leifjuster,stormscale,288,monk,mistweaver,6,3,3
Napqi,malganis,288,monk,mistweaver,6,3,3
Ilsalumiere,nemesis,288,monk,mistweaver,6,3,3
Kaskinhas,archimonde,288,monk,mistweaver,6,3,3
Màlydôr,outland,288,monk,mistweaver,6,3,3
Похмелись,blackscar,288,monk,mistweaver,6,3,3
Leikô,grim-batol,288,monk,mistweaver,6,3,3
Badwithnames,stormscale,288,monk,mistweaver,6,3,3
Rípple,alakir,288,monk,mistweaver,6,3,3
Fairhand,emerald-dream,288,monk,mistweaver,6,3,3
Viggex,outland,288,monk,mistweaver,6,3,3
Shàolïn,dalaran,288,monk,mistweaver,6,3,3
Domedagsdamp,draenor,288,monk,mistweaver,6,3,3
Ipès,archimonde,288,monk,mistweaver,6,3,3
Culiacàn,blackmoore,288,monk,mistweaver,6,3,3
Píco,gorgonnash,288,monk,mistweaver,6,3,3
Mecin,ragnaros,288,monk,mistweaver,6,3,3
Crommul,burning-legion,288,monk,mistweaver,6,3,3
Mønkek,kazzak,288,monk,mistweaver,6,3,3
Wando,defias-brotherhood,288,monk,mistweaver,6,3,3
Grenreaper,twisting-nether,288,monk,mistweaver,6,3,3
Baisi,blackhand,288,monk,mistweaver,6,3,3
Neptulion,ravencrest,288,monk,mistweaver,6,3,3
Yutahon,azjolnerub,288,monk,mistweaver,6,3,3
Коррелир,howling-fjord,288,monk,mistweaver,6,3,3
Kaizenthor,runetotem,288,monk,mistweaver,6,3,3
Kylâas,die-ewige-wacht,288,monk,mistweaver,6,3,3
Fluxqt,ravencrest,288,monk,mistweaver,6,3,3
Koba,frostwolf,288,monk,mistweaver,6,3,3
Perikencito,dun-modr,288,monk,mistweaver,6,3,3
Родо,blackscar,288,monk,mistweaver,6,3,3
Wèéman,grim-batol,288,monk,mistweaver,6,3,3
Trubushatal,ravencrest,288,monk,mistweaver,6,3,3
Lassador,onyxia,288,monk,mistweaver,6,3,3
Yogi,defias-brotherhood,288,monk,mistweaver,6,3,3
Askmeout,ravencrest,288,monk,mistweaver,7,3,4
Karatemonk,stormscale,288,monk,mistweaver,12,3,9
Drunklee,aegwynn,288,monk,mistweaver,12,3,9
Alilith,drakthul,288,monk,mistweaver,12,3,9
Jinora,theradras,288,monk,mistweaver,12,3,9
Xvll,kaelthas,288,monk,mistweaver,12,3,9
Fistmeg,grim-batol,288,monk,mistweaver,12,3,9
Monkiky,hyjal,288,monk,mistweaver,12,3,9
Brewdooms,laughing-skull,288,monk,mistweaver,12,3,9
Aguerxf,alleria,288,monk,mistweaver,12,3,9
Olîvê,ravencrest,288,monk,mistweaver,12,3,9
Albertã,doomhammer,288,monk,mistweaver,12,3,9
Justfistyoux,archimonde,288,monk,mistweaver,12,3,9
Tossen,ragnaros,288,monk,mistweaver,12,3,9
Lonechi,sylvanas,288,monk,mistweaver,12,3,9
Monkenya,kazzak,288,monk,mistweaver,12,3,9
Mîyüki,dalaran,288,monk,mistweaver,12,3,9
Koreanbullet,archimonde,288,monk,mistweaver,12,3,9
Leøni,malfurion,288,monk,mistweaver,12,3,9
Whinestein,the-venture-co,288,monk,mistweaver,12,3,9
Velita,dun-modr,288,monk,mistweaver,18,3,15
Phínez,thunderhorn,288,monk,mistweaver,18,3,15
Munkeguden,ravencrest,288,monk,mistweaver,22,3,19
Nosrewolwer,burning-legion,287,monk,mistweaver,6,3,3
Athëlyn,hyjal,287,monk,mistweaver,6,3,3
Bo,malorne,287,monk,mistweaver,6,3,3
Мастерхилфу,ashenvale,287,monk,mistweaver,6,3,3
Playboicarti,frostwolf,287,monk,mistweaver,6,3,3
Hanumahn,kilrogg,287,monk,mistweaver,12,3,9
Edenbllow,twisting-nether,287,monk,mistweaver,12,3,9
Pepefocho,sanguino,286,monk,mistweaver,6,3,3
Shorebreak,argent-dawn,286,monk,mistweaver,6,3,3
Ragenn,zuljin,256,monk,mistweaver,4,4,0
Mossadjr,blackmoore,256,monk,mistweaver,4,4,0
Maharaj,terenas,255,monk,mistweaver,11,3,8
Trlmøna,gorgonnash,240,monk,mistweaver,9,4,5
Nypö,hyjal,234,monk,mistweaver,10,4,6
Mouhous,hellscream,234,monk,mistweaver,13,4,9
Jackíechen,draenor,234,monk,mistweaver,15,4,11
Арнольдовна,blackscar,234,monk,mistweaver,17,4,13
Colita,kazzak,233,monk,mistweaver,16,5,11
Mynaira,tarren-mill,208,monk,mistweaver,25,3,22
Злюкшо,howling-fjord,192,monk,mistweaver,10,4,6
Fisterxd,blackrock,192,monk,mistweaver,6,2,4
Obeliskbrew,kazzak,192,monk,mistweaver,6,2,4
Nephi,kirin-tor,192,monk,mistweaver,6,2,4
Âsmoran,blackmoore,192,monk,mistweaver,6,2,4
Luffix,outland,192,monk,mistweaver,6,2,4
Scorpìon,blackrock,192,monk,mistweaver,6,2,4
Yinsho,stormscale,192,monk,mistweaver,6,2,4
Loveít,blackrock,192,monk,mistweaver,6,2,4
Skâte,dun-modr,192,monk,mistweaver,6,2,4
Auaaua,ravencrest,192,monk,mistweaver,6,2,4
Dalaipyjama,quelthalas,192,monk,mistweaver,6,2,4
Merlyñ,blackmoore,192,monk,mistweaver,6,2,4
Domingovivas,dun-modr,192,monk,mistweaver,6,2,4
Menazera,antonidas,192,monk,mistweaver,6,2,4
Chegweaver,ravencrest,192,monk,mistweaver,6,2,4
Mystize,shattered-hand,192,monk,mistweaver,6,2,4
Jetsweep,kazzak,192,monk,mistweaver,6,2,4
Wilymonka,dalaran,192,monk,mistweaver,6,2,4
Хере,soulflayer,192,monk,mistweaver,6,2,4
Espectrå,dun-modr,192,monk,mistweaver,6,2,4
Kmorhin,antonidas,192,monk,mistweaver,6,2,4
Люсилью,howling-fjord,192,monk,mistweaver,6,2,4
Dennismansix,sylvanas,192,monk,mistweaver,6,2,4
Âechlz,malfurion,192,monk,mistweaver,6,2,4
Acbcz,draenor,192,monk,mistweaver,6,2,4
Watermelon,laughing-skull,192,monk,mistweaver,6,2,4
Brewsmaster,archimonde,192,monk,mistweaver,6,2,4
Venemy,sanguino,192,monk,mistweaver,6,2,4
Fènja,kult-der-verdammten,192,monk,mistweaver,6,2,4
Karatemooves,kazzak,192,monk,mistweaver,6,2,4
Starwalkin,silvermoon,192,monk,mistweaver,6,2,4
Pleasure,laughing-skull,192,monk,mistweaver,6,2,4
Jolifine,alleria,192,monk,mistweaver,6,2,4
Shinyin,outland,192,monk,mistweaver,6,2,4
Liluzi,aszune,192,monk,mistweaver,6,2,4
Dunkfjås,stormscale,192,monk,mistweaver,6,2,4
Ebonymilfy,archimonde,192,monk,mistweaver,6,2,4
Ïnaho,hyjal,192,monk,mistweaver,6,2,4
Wifeeagro,doomhammer,192,monk,mistweaver,6,2,4
Karmaclit,malganis,192,monk,mistweaver,6,2,4
Yokuboo,ysondre,192,monk,mistweaver,6,2,4
Shaosshoshin,exodar,192,monk,mistweaver,6,2,4
Sînge,archimonde,192,monk,mistweaver,6,2,4
Rbgmachine,burning-legion,192,monk,mistweaver,6,2,4
Mutai,tarren-mill,192,monk,mistweaver,6,2,4
Sashun,blackmoore,192,monk,mistweaver,6,2,4
Зараз,gordunni,192,monk,mistweaver,6,2,4
Kûngfu,tarren-mill,192,monk,mistweaver,6,2,4
Monkfriend,quelthalas,192,monk,mistweaver,6,2,4
Zaheer,xavius,192,monk,mistweaver,6,2,4
Justacomma,outland,192,monk,mistweaver,6,2,4
Altairan,ragnaros,192,monk,mistweaver,6,2,4
Ahaa,kazzak,192,monk,mistweaver,6,2,4
Flyingraven,magtheridon,192,monk,mistweaver,6,2,4
Shynlee,frostwhisper,192,monk,mistweaver,6,2,4
Syy,medivh,192,monk,mistweaver,6,2,4
Ronnchi,twisting-nether,192,monk,mistweaver,6,2,4
Ønøf,rashgarroth,192,monk,mistweaver,6,2,4
Faustíne,blackmoore,192,monk,mistweaver,6,2,4
Tøngpø,argent-dawn,192,monk,mistweaver,6,2,4
Jadefain,argent-dawn,192,monk,mistweaver,6,2,4
Кулаквтебе,borean-tundra,192,monk,mistweaver,6,2,4
Mistya,ragnaros,192,monk,mistweaver,6,2,4
Леронтас,gordunni,192,monk,mistweaver,6,2,4
Xùen,blackrock,192,monk,mistweaver,6,2,4
Монкпех,gordunni,192,monk,mistweaver,6,2,4
Toxicvxpe,archimonde,192,monk,mistweaver,6,2,4
Trippyv,ragnaros,192,monk,mistweaver,6,2,4
Axan,drekthar,192,monk,mistweaver,6,2,4
Beriberi,tichondrius,192,monk,mistweaver,7,2,5
Alexandrovic,hyjal,192,monk,mistweaver,12,2,10
Johnsôn,blackmoore,192,monk,mistweaver,12,2,10
Ascrem,ragnaros,192,monk,mistweaver,12,2,10
Headakzar,kazzak,192,monk,mistweaver,12,2,10
Chîca,ysondre,192,monk,mistweaver,12,2,10
Brixelol,kazzak,192,monk,mistweaver,12,2,10
Clonaz,silvermoon,192,monk,mistweaver,12,2,10
Jacksbäro,zirkel-des-cenarius,192,monk,mistweaver,12,2,10
Anifurry,tarren-mill,192,monk,mistweaver,12,2,10
Sargnorak,dalaran,191,monk,mistweaver,6,2,4
Чвка,booty-bay,191,monk,mistweaver,6,2,4
Hisagi,khaz-modan,191,monk,mistweaver,6,2,4
Arukoru,kazzak,191,monk,mistweaver,18,2,16
Andrah,blackmoore,185,monk,mistweaver,14,4,10
Swiftmonky,azuremyst,159,monk,mistweaver,5,2,3
Мирксимонк,soulflayer,144,monk,mistweaver,3,3,0
Зрти,gordunni,138,monk,mistweaver,12,4,8
Saïtama,krasus,138,monk,mistweaver,10,3,7
Ostarikyttä,stormscale,138,monk,mistweaver,10,3,7
Ghettomonk,blackmoore,138,monk,mistweaver,11,3,8
Shenlong,burning-blade,138,monk,mistweaver,14,3,11
Спартаннка,gordunni,137,monk,mistweaver,8,3,5
Wraq,tarren-mill,128,monk,mistweaver,4,2,2
Cheechong,grim-batol,127,monk,mistweaver,8,2,6
Aequïtas,nemesis,96,monk,mistweaver,6,1,5
Lìlíy,taerar,96,monk,mistweaver,6,1,5
Shîïna,ysondre,96,monk,mistweaver,6,1,5
Ytjin,draenor,96,monk,mistweaver,6,1,5
Brewbunnyqt,thrall,96,monk,mistweaver,6,1,5
Itxelita,zuljin,96,monk,mistweaver,6,1,5
Ätishâ,archimonde,96,monk,mistweaver,6,1,5
Rostick,drakthul,96,monk,mistweaver,6,1,5
Gôeller,stormscale,96,monk,mistweaver,6,1,5
Mailyne,blackmoore,96,monk,mistweaver,6,1,5
Brandy,kazzak,96,monk,mistweaver,6,1,5
Legpunch,the-maelstrom,96,monk,mistweaver,6,1,5
Toté,kazzak,96,monk,mistweaver,6,1,5
Botsmw,kazzak,96,monk,mistweaver,6,1,5
Кукуныч,deathguard,96,monk,mistweaver,6,1,5
Jusex,stormreaver,96,monk,mistweaver,6,1,5
Butrinto,hellfire,96,monk,mistweaver,6,1,5
Jessiemonk,blackhand,96,monk,mistweaver,6,1,5
Moorf,ravencrest,96,monk,mistweaver,6,1,5
Skadchi,blackhand,96,monk,mistweaver,6,1,5
Fapmaster,aegwynn,96,monk,mistweaver,6,1,5
Bruslie,cthun,96,monk,mistweaver,6,1,5
Mongretod,ravencrest,96,monk,mistweaver,6,1,5
Glivilalis,drekthar,96,monk,mistweaver,6,1,5
Bænkai,naxxramas,96,monk,mistweaver,6,1,5
Smlpp,kazzak,96,monk,mistweaver,6,1,5
Pream,blackrock,96,monk,mistweaver,6,1,5
Monkinator,stormreaver,96,monk,mistweaver,6,1,5
Monkolben,blackmoore,96,monk,mistweaver,6,1,5
Cbamonk,tarren-mill,96,monk,mistweaver,6,1,5
Xuaolang,sanguino,96,monk,mistweaver,6,1,5
Àómìñêdâìkí,lightnings-blade,96,monk,mistweaver,6,1,5
Havefunguys,alakir,96,monk,mistweaver,6,1,5
Assaalaria,argent-dawn,96,monk,mistweaver,6,1,5
Sooyung,kazzak,96,monk,mistweaver,6,1,5
Missblack,zuljin,96,monk,mistweaver,6,1,5
Capos,wrathbringer,96,monk,mistweaver,11,1,10
Rhodin,krasus,96,monk,mistweaver,12,1,11
Sigournémist,silvermoon,96,monk,mistweaver,12,1,11
Upbringer,ragnaros,96,monk,mistweaver,12,1,11
Xiâomèi,dun-modr,96,monk,mistweaver,12,1,11
Marrów,chamber-of-aspects,96,monk,mistweaver,14,1,13
Nïkaa,dun-modr,84,monk,mistweaver,9,5,4
Woguo,drakthul,84,monk,mistweaver,10,4,6
Griffens,argent-dawn,79,monk,mistweaver,5,1,4
Barendhoff,sylvanas,64,monk,mistweaver,4,1,3
Бязь,gordunni,63,monk,mistweaver,2,2,0
Fae,kirin-tor,63,monk,mistweaver,14,2,12
Johnnybgood,tarren-mill,42,monk,mistweaver,10,3,7
Axilane,outland,42,monk,mistweaver,7,2,5
Флокэ,soulflayer,42,monk,mistweaver,9,2,7
Monkeykung,defias-brotherhood,40,monk,mistweaver,16,3,13
Sinpho,ahnqiraj,1190,monk,brewmaster,42,16,26
Winchun,ravencrest,820,monk,brewmaster,32,14,18
Padawang,twisting-nether,767,monk,brewmaster,24,8,16
Комбатпро,borean-tundra,764,monk,brewmaster,70,30,40
Jademyst,outland,671,monk,brewmaster,18,7,11
Shirôhige,zirkel-des-cenarius,288,monk,brewmaster,6,3,3
Tauroné,draenor,288,monk,brewmaster,12,3,9
Fullzi,dalaran,192,monk,brewmaster,6,2,4
Zerendir,magtheridon,192,monk,brewmaster,6,2,4
Tayoo,aegwynn,192,monk,brewmaster,6,2,4
Youkaii,alexstrasza,192,monk,brewmaster,12,2,10
Tylee,tarren-mill,96,monk,brewmaster,6,1,5
Mezz,ahnqiraj,96,monk,brewmaster,6,1,5
Badcøwboy,archimonde,96,monk,brewmaster,6,1,5
Lubeï,kirin-tor,96,monk,brewmaster,6,1,5
Lòthbar,confrérie-du-thorium,63,monk,brewmaster,2,2,0
Queteapie,stormscale,2331,monk,windwalker,100,60,40
Sîxmonths,stormscale,2325,monk,windwalker,84,56,28
Fistyw,stormscale,2313,monk,windwalker,104,60,44
Faxax,draenor,2243,monk,windwalker,120,63,57
Ilovehim,antonidas,2237,monk,windwalker,102,58,44
Ewynamonk,silvermoon,2236,monk,windwalker,114,61,53
Rmtexter,ravencrest,2204,monk,windwalker,137,72,65
Senretsu,shattered-halls,2177,monk,windwalker,102,54,48
Plaww,dalaran,2172,monk,windwalker,120,75,45
Monkmeta,frostwolf,2171,monk,windwalker,114,70,44
Щищ,gordunni,2170,monk,windwalker,198,114,84
Wonkeed,hyjal,2144,monk,windwalker,113,68,45
Daosh,nemesis,2137,monk,windwalker,91,48,43
Deretrox,twisting-nether,2127,monk,windwalker,84,47,37
Tabetai,tarren-mill,2125,monk,windwalker,90,46,44
Elinalia,burning-legion,2124,monk,windwalker,120,62,58
Keeferslover,dun-morogh,2123,monk,windwalker,60,35,25
Lilcatlife,tyrande,2123,monk,windwalker,66,36,30
Redundänt,kazzak,2122,monk,windwalker,78,43,35
Brñ,twisting-nether,2121,monk,windwalker,72,39,33
Edenwalker,dun-morogh,2121,monk,windwalker,96,46,50
Unpruneable,stormscale,2116,monk,windwalker,161,81,80
Váinz,ravencrest,2112,monk,windwalker,78,41,37
Rivazsunkick,archimonde,2104,monk,windwalker,208,103,105
Leppix,outland,2103,monk,windwalker,66,35,31
Pichouhuahua,elune,2096,monk,windwalker,120,63,57
Theoww,dragonblight,2094,monk,windwalker,96,48,48
Snusochnocco,the-maelstrom,2088,monk,windwalker,84,41,43
Ladderfiend,stormscale,2072,monk,windwalker,137,66,71
Fistinguhuhu,outland,2067,monk,windwalker,84,45,39
Hitsuwalker,archimonde,2049,monk,windwalker,204,115,89
Fabrina,blackrock,2038,monk,windwalker,96,52,44
Hefners,grim-batol,2028,monk,windwalker,71,36,35
Stepsyzz,stormscale,2021,monk,windwalker,137,65,72
Edenmonk,dun-morogh,2020,monk,windwalker,60,35,25
Fistenjoyer,outland,2020,monk,windwalker,101,52,49
Нелегитимный,howling-fjord,2006,monk,windwalker,379,193,186
Ilovealicia,ragnaros,2005,monk,windwalker,89,47,42
Melyda,ravencrest,2003,monk,windwalker,168,92,76
Zukatan,tarren-mill,2001,monk,windwalker,111,59,52
Gyto,archimonde,1998,monk,windwalker,71,39,32
Balia,blackrock,1997,monk,windwalker,78,39,39
Ninadobrév,stormscale,1993,monk,windwalker,150,90,60
Enerchi,ravencrest,1988,monk,windwalker,72,42,30
Stillwater,thrall,1986,monk,windwalker,172,92,80
Nicesky,ravencrest,1985,monk,windwalker,114,59,55
Минимонахх,blackscar,1985,monk,windwalker,99,46,53
Мистмастер,soulflayer,1984,monk,windwalker,48,30,18
Rismonk,frostmane,1982,monk,windwalker,54,29,25
Niamix,archimonde,1978,monk,windwalker,194,96,98
Orkamonka,burning-legion,1977,monk,windwalker,54,31,23
Erazhen,blackrock,1977,monk,windwalker,60,31,29
Eth,nagrand,1975,monk,windwalker,84,42,42
Инрэйджинкап,soulflayer,1972,monk,windwalker,168,85,83
Yassøux,archimonde,1971,monk,windwalker,270,142,128
Bulluh,blackmoore,1964,monk,windwalker,59,31,28
Juujika,ravencrest,1961,monk,windwalker,53,31,22
Vixia,outland,1956,monk,windwalker,35,21,14
Sayozz,hyjal,1953,monk,windwalker,204,106,98
Sørann,drekthar,1943,monk,windwalker,100,55,45
Имортарион,howling-fjord,1935,monk,windwalker,48,29,19
Ztl,twisting-nether,1931,monk,windwalker,185,103,82
Dänÿww,elune,1926,monk,windwalker,62,32,30
Oberháupt,blackrock,1922,monk,windwalker,72,41,31
Jájsemshadow,drakthul,1922,monk,windwalker,72,37,35
Shînøbi,dalaran,1918,monk,windwalker,84,42,42
Dêsmî,ravencrest,1913,monk,windwalker,34,25,9
Sobadzlolz,alexstrasza,1911,monk,windwalker,184,104,80
Trendyroxy,blackrock,1908,monk,windwalker,103,51,52
Tianzu,twisting-nether,1908,monk,windwalker,96,47,49
Muix,draenor,1906,monk,windwalker,30,20,10
Vexíllum,sylvanas,1906,monk,windwalker,84,46,38
Riskcapcap,dentarg,1905,monk,windwalker,72,37,35
Pitball,ravencrest,1898,monk,windwalker,72,36,36
Милыйколян,soulflayer,1898,monk,windwalker,66,33,33
Ksâin,ravencrest,1896,monk,windwalker,66,34,32
Pandamoniun,aggra-português,1890,monk,windwalker,176,87,89
Копытька,gordunni,1889,monk,windwalker,63,35,28
Rismonk,twisting-nether,1887,monk,windwalker,96,47,49
Санварион,eversong,1884,monk,windwalker,96,48,48
Муррчалкин,howling-fjord,1880,monk,windwalker,48,28,20
Ellipirelli,doomhammer,1880,monk,windwalker,70,30,40
Аррани,thermaplugg,1874,monk,windwalker,58,33,25
Doktormonk,blackrock,1873,monk,windwalker,184,105,79
Domww,outland,1871,monk,windwalker,108,59,49
Shpunk,ravencrest,1870,monk,windwalker,132,64,68
Troopmonk,ravencrest,1867,monk,windwalker,157,76,81
Shrimpcawk,alonsus,1866,monk,windwalker,77,47,30
Rivaz,archimonde,1865,monk,windwalker,54,31,23
Эльморо,goldrinn,1865,monk,windwalker,54,30,24
Ãmaterasû,kazzak,1864,monk,windwalker,61,30,31
Hurricrane,kazzak,1861,monk,windwalker,232,115,117
Эльторо,goldrinn,1860,monk,windwalker,60,29,31
Beernie,tarren-mill,1855,monk,windwalker,66,41,25
Маруты,soulflayer,1855,monk,windwalker,88,35,53
Wolmachégodx,archimonde,1854,monk,windwalker,42,25,17
Shaolinthug,stormscale,1854,monk,windwalker,72,32,40
Mosch,blackrock,1853,monk,windwalker,54,33,21
Carbozø,archimonde,1850,monk,windwalker,101,61,40
Kokushibo,cthun,1850,monk,windwalker,54,28,26
Яагрессивный,howling-fjord,1850,monk,windwalker,74,36,38
Gararasu,eredar,1846,monk,windwalker,42,22,20
Rorkito,sanguino,1846,monk,windwalker,86,45,41
Devilmønk,thrall,1845,monk,windwalker,96,49,47
Boostarevine,stormscale,1842,monk,windwalker,59,38,21
Rêshi,draenor,1841,monk,windwalker,96,62,34
Тихийпук,deathguard,1839,monk,windwalker,164,92,72
Soulja,bloodfeather,1839,monk,windwalker,326,165,161
Teressah,argent-dawn,1838,monk,windwalker,48,24,24
Джэкичача,soulflayer,1837,monk,windwalker,56,29,27
Santanax,ravencrest,1834,monk,windwalker,42,27,15
Zéroneufsix,silvermoon,1834,monk,windwalker,68,31,37
Kitcheneer,twisting-nether,1832,monk,windwalker,65,37,28
Peaceweaver,ravencrest,1832,monk,windwalker,94,53,41
Linuxx,ravencrest,1832,monk,windwalker,90,45,45
Chucknorrîs,doomhammer,1831,monk,windwalker,79,47,32
Toyless,ravencrest,1831,monk,windwalker,54,27,27
Freehelper,stormscale,1831,monk,windwalker,66,28,38
Ванфист,gordunni,1830,monk,windwalker,113,66,47
Iløvealicia,ravencrest,1830,monk,windwalker,58,28,30
Venuki,blackrock,1829,monk,windwalker,60,35,25
Xinxanxonxin,zuljin,1829,monk,windwalker,54,25,29
Диванн,howling-fjord,1827,monk,windwalker,53,27,26
Sàitama,hyjal,1827,monk,windwalker,58,29,29
Jinpachi,ravencrest,1826,monk,windwalker,48,23,25
Reõ,argent-dawn,1825,monk,windwalker,107,64,43
Iceym,stormscale,1825,monk,windwalker,81,41,40
Monkini,kazzak,1823,monk,windwalker,54,27,27
Sororicide,stormscale,1822,monk,windwalker,161,81,80
Klumpenx,draenor,1821,monk,windwalker,80,43,37
Iminzww,ravencrest,1819,monk,windwalker,90,45,45
Denjasftw,culte-de-la-rive-noire,1818,monk,windwalker,42,27,15
Дезмимонк,ashenvale,1816,monk,windwalker,43,21,22
Monkees,twisting-nether,1815,monk,windwalker,65,33,32
Калестонз,howling-fjord,1811,monk,windwalker,54,31,23
Fotmwalker,ragnaros,1811,monk,windwalker,257,129,128
Lullerull,silvermoon,1810,monk,windwalker,51,31,20
Mónkâs,tarren-mill,1810,monk,windwalker,72,32,40
Рэйвх,howling-fjord,1808,monk,windwalker,36,19,17
Sushiroll,stormrage,1808,monk,windwalker,111,55,56
Эвэйжион,gordunni,1807,monk,windwalker,84,54,30
Venrea,archimonde,1807,monk,windwalker,54,31,23
Baltimore,stormscale,1806,monk,windwalker,36,25,11
Arachmk,drakthul,1806,monk,windwalker,72,33,39
Mynokxu,blackmoore,1805,monk,windwalker,92,54,38
Mebrin,ragnaros,1805,monk,windwalker,71,37,34
Åbyssgòd,kazzak,1805,monk,windwalker,60,24,36
Niyka,silvermoon,1804,monk,windwalker,72,40,32
Möîne,arathi,1804,monk,windwalker,84,44,40
Unangebracht,silvermoon,1803,monk,windwalker,227,121,106
Pandafuki,ravencrest,1803,monk,windwalker,62,33,29
Saltotriks,tarren-mill,1802,monk,windwalker,62,28,34
Notmelo,dun-modr,1801,monk,windwalker,48,25,23
Krothus,tarren-mill,1800,monk,windwalker,48,32,16
Windwanker,eredar,1800,monk,windwalker,36,22,14
Fln,blackrock,1800,monk,windwalker,58,33,25
Ревенджж,howling-fjord,1798,monk,windwalker,34,20,14
Yacum,blackrock,1795,monk,windwalker,71,32,39
Twinny,drakthul,1793,monk,windwalker,90,52,38
Akuuji,silvermoon,1793,monk,windwalker,60,32,28
Karmaisabich,ragnaros,1792,monk,windwalker,30,19,11
Yukfou,tarren-mill,1792,monk,windwalker,59,28,31
Kaijam,argent-dawn,1792,monk,windwalker,78,33,45
Цеска,howling-fjord,1790,monk,windwalker,54,29,25
Pàrádìsé,ravencrest,1787,monk,windwalker,119,60,59
Salvaje,stormscale,1786,monk,windwalker,90,56,34
Projectasura,draenor,1786,monk,windwalker,191,97,94
Madelnheaven,burning-legion,1784,monk,windwalker,59,31,28
Megatazz,hyjal,1783,monk,windwalker,82,47,35
Tommypistol,runetotem,1782,monk,windwalker,214,106,108
Healbotzweik,frostwolf,1782,monk,windwalker,54,24,30
Skailzkrt,hyjal,1779,monk,windwalker,48,22,26
Дуэльныйчел,howling-fjord,1774,monk,windwalker,122,64,58
Tinjihn,magtheridon,1774,monk,windwalker,86,39,47
Blïss,kazzak,1773,monk,windwalker,77,42,35
Sponkas,tarren-mill,1768,monk,windwalker,42,20,22
Ароба,blackscar,1766,monk,windwalker,90,42,48
Pwaff,kazzak,1765,monk,windwalker,84,44,40
Korié,ravencrest,1761,monk,windwalker,53,30,23
Heran,ravencrest,1761,monk,windwalker,111,50,61
Moultsou,hyjal,1758,monk,windwalker,66,33,33
Тэсти,blackscar,1758,monk,windwalker,64,32,32
Flunkefar,defias-brotherhood,1758,monk,windwalker,102,45,57
Ackken,twisting-nether,1748,monk,windwalker,51,26,25
Ellevance,draenor,1747,monk,windwalker,36,19,17
Hôllowx,archimonde,1743,monk,windwalker,39,24,15
Pelou,culte-de-la-rive-noire,1743,monk,windwalker,100,56,44
Shoura,blackmoore,1741,monk,windwalker,48,24,24
Фодз,soulflayer,1740,monk,windwalker,76,30,46
Dwdw,aerie-peak,1737,monk,windwalker,54,28,26
Shoenk,blackhand,1734,monk,windwalker,36,21,15
Янакаблуках,howling-fjord,1734,monk,windwalker,245,139,106
Lonechi,sylvanas,1733,monk,windwalker,36,21,15
Лазанья,grom,1731,monk,windwalker,66,30,36
Inkegomonk,draenor,1729,monk,windwalker,66,31,35
Bugrika,tarren-mill,1728,monk,windwalker,42,22,20
Виндволкерша,gordunni,1725,monk,windwalker,54,31,23
Däemon,twisting-nether,1725,monk,windwalker,45,20,25
Zandoy,draenor,1724,monk,windwalker,76,42,34
Locotommy,blackrock,1721,monk,windwalker,42,21,21
Roidcarry,blackrock,1720,monk,windwalker,83,45,38
Omnibar,kazzak,1719,monk,windwalker,36,21,15
Varis,stormreaver,1718,monk,windwalker,39,19,20
Трэйци,blackscar,1716,monk,windwalker,39,23,16
Yiannischan,draenor,1715,monk,windwalker,92,49,43
Narstie,kazzak,1714,monk,windwalker,71,36,35
Виноипиво,soulflayer,1713,monk,windwalker,60,30,30
Ютуми,soulflayer,1712,monk,windwalker,48,24,24
Димакарма,howling-fjord,1712,monk,windwalker,101,45,56
Aslêyia,antonidas,1709,monk,windwalker,49,26,23
Cranekickbot,ravencrest,1709,monk,windwalker,53,23,30
Dansaam,tarren-mill,1706,monk,windwalker,24,18,6
Cheethfu,ragnaros,1705,monk,windwalker,42,29,13
Mikedcrybaby,tarren-mill,1705,monk,windwalker,143,72,71
Yungdrippy,eredar,1705,monk,windwalker,52,26,26
Лагвай,gordunni,1705,monk,windwalker,42,21,21
Moistpocket,stormscale,1705,monk,windwalker,54,22,32
Broner,dunemaul,1703,monk,windwalker,34,19,15
Pili,aegwynn,1702,monk,windwalker,42,25,17
Gorguts,stormscale,1700,monk,windwalker,54,25,29
Xiâomèi,dun-modr,1700,monk,windwalker,78,35,43
Helloimfrank,tarren-mill,1698,monk,windwalker,36,18,18
Меняубило,howling-fjord,1696,monk,windwalker,78,37,41
Osalot,ravencrest,1695,monk,windwalker,60,30,30
Chaospilot,sylvanas,1694,monk,windwalker,122,57,65
Testmonial,hyjal,1694,monk,windwalker,48,21,27
Jeydi,ravencrest,1692,monk,windwalker,72,50,22
Idiot,outland,1691,monk,windwalker,54,28,26
Ashânti,eredar,1691,monk,windwalker,62,30,32
Гладастар,soulflayer,1690,monk,windwalker,96,49,47
Форгетх,soulflayer,1690,monk,windwalker,42,21,21
Ugabugash,silvermoon,1689,monk,windwalker,36,25,11
Bnî,blackmoore,1687,monk,windwalker,75,47,28
Ravelbaby,blackrock,1687,monk,windwalker,51,25,26
Tea,arathor,1686,monk,windwalker,92,52,40
Lørðbrøñkø,blackrock,1686,monk,windwalker,102,56,46
Greenshortea,aegwynn,1684,monk,windwalker,36,18,18
Сугробикк,soulflayer,1683,monk,windwalker,66,24,42
Sesi,drakthul,1682,monk,windwalker,66,28,38
Khrylx,twisting-nether,1681,monk,windwalker,40,25,15
Кианасоломид,gordunni,1681,monk,windwalker,182,91,91
Tenshinhann,outland,1681,monk,windwalker,78,37,41
Tisaki,blackhand,1680,monk,windwalker,41,25,16
Hilzaxsub,archimonde,1679,monk,windwalker,47,29,18
Pazü,ysondre,1679,monk,windwalker,119,57,62
Senguro,frostwolf,1677,monk,windwalker,30,18,12
Holmwalker,twisting-nether,1677,monk,windwalker,70,31,39
Donvishas,aegwynn,1676,monk,windwalker,71,36,35
Fistofrage,ravencrest,1675,monk,windwalker,54,31,23
Шотгар,howling-fjord,1675,monk,windwalker,48,21,27
Mädic,outland,1673,monk,windwalker,42,22,20
Ratslayerz,dun-modr,1669,monk,windwalker,42,24,18
Mionoor,aegwynn,1667,monk,windwalker,237,115,122
Vtx,blackrock,1662,monk,windwalker,30,18,12
Shagzy,ravencrest,1660,monk,windwalker,35,22,13
Mollytov,tarren-mill,1659,monk,windwalker,53,22,31
Geeér,outland,1658,monk,windwalker,42,24,18
Kåýðø,archimonde,1658,monk,windwalker,50,25,25
Leadgen,tarren-mill,1657,monk,windwalker,36,20,16
Shardonay,ravencrest,1655,monk,windwalker,42,26,16
Wuux,tarren-mill,1655,monk,windwalker,66,37,29
Jjslag,stormscale,1655,monk,windwalker,72,31,41
Nightingalê,silvermoon,1653,monk,windwalker,36,20,16
Saduh,thrall,1653,monk,windwalker,44,20,24
Минагороси,galakrond,1652,monk,windwalker,48,28,20
Bîmbâmboom,blackmoore,1650,monk,windwalker,48,25,23
Mîsts,aszune,1650,monk,windwalker,45,23,22
Shirkán,ragnaros,1649,monk,windwalker,36,21,15
Thérez,les-sentinelles,1648,monk,windwalker,42,22,20
Hunkfur,ravencrest,1647,monk,windwalker,44,25,19
Бадхидхаарма,booty-bay,1647,monk,windwalker,78,32,46
Bonepalm,kazzak,1646,monk,windwalker,23,18,5
Кишмякмонк,howling-fjord,1646,monk,windwalker,60,31,29
Гуппер,howling-fjord,1646,monk,windwalker,54,23,31
Capedbaldy,blackhand,1645,monk,windwalker,29,18,11
Faustux,blackmoore,1644,monk,windwalker,60,28,32
Gresmar,defias-brotherhood,1642,monk,windwalker,36,18,18
Alkanphel,kazzak,1641,monk,windwalker,30,20,10
Miløøx,silvermoon,1641,monk,windwalker,76,40,36
Kármo,thrall,1638,monk,windwalker,41,20,21
Мионелолл,goldrinn,1637,monk,windwalker,48,28,20
Schøcker,blackmoore,1637,monk,windwalker,72,33,39
Bastos,blackrock,1636,monk,windwalker,322,167,155
Zenothar,ravencrest,1635,monk,windwalker,36,24,12
Mefîsto,blackrock,1634,monk,windwalker,69,38,31
Yeratel,argent-dawn,1633,monk,windwalker,90,39,51
Gonkun,outland,1631,monk,windwalker,73,36,37
Атакцуки,gordunni,1630,monk,windwalker,42,25,17
Jafandmeja,tarren-mill,1629,monk,windwalker,100,60,40
Hosh,ysondre,1629,monk,windwalker,66,33,33
Sylicia,alleria,1628,monk,windwalker,102,49,53
Пекинес,gordunni,1626,monk,windwalker,42,22,20
Yobo,archimonde,1626,monk,windwalker,47,23,24
Akhlÿs,ysondre,1624,monk,windwalker,30,17,13
Thyf,drakthul,1624,monk,windwalker,54,22,32
Anteric,sylvanas,1623,monk,windwalker,30,20,10
Bossdog,mugthol,1623,monk,windwalker,33,21,12
Gaehitmonlee,ravencrest,1623,monk,windwalker,223,120,103
Монкигодхх,howling-fjord,1621,monk,windwalker,31,21,10
Wwisalright,burning-legion,1621,monk,windwalker,50,28,22
Hybridtheory,doomhammer,1620,monk,windwalker,159,81,78
Iastyn,kazzak,1620,monk,windwalker,99,50,49
Sérrè,tarren-mill,1618,monk,windwalker,48,25,23
Монголгодх,howling-fjord,1617,monk,windwalker,192,110,82
Catchmee,agamaggan,1616,monk,windwalker,30,17,13
Erenaar,nemesis,1614,monk,windwalker,60,43,17
Fijiwater,draenor,1613,monk,windwalker,24,17,7
Тринх,ashenvale,1613,monk,windwalker,54,31,23
Saisha,defias-brotherhood,1613,monk,windwalker,36,20,16
Notsmol,quelthalas,1613,monk,windwalker,54,26,28
Ampm,ravencrest,1613,monk,windwalker,36,17,19
Heyami,ravencrest,1613,monk,windwalker,36,17,19
Morslee,burning-legion,1612,monk,windwalker,97,44,53
Tauti,dun-morogh,1610,monk,windwalker,36,21,15
Steros,die-aldor,1608,monk,windwalker,42,21,21
Nigu,dun-modr,1606,monk,windwalker,67,38,29
Тайммуайтай,howling-fjord,1606,monk,windwalker,90,50,40
Chigre,hyjal,1606,monk,windwalker,60,30,30
Такюн,howling-fjord,1606,monk,windwalker,227,111,116
Vayarah,antonidas,1605,monk,windwalker,54,28,26
Акумах,blackscar,1605,monk,windwalker,99,48,51
Elpuncho,dentarg,1604,monk,windwalker,48,30,18
Thungara,emerald-dream,1604,monk,windwalker,42,22,20
Valduri,stormscale,1604,monk,windwalker,60,27,33
Shypanda,thrall,1602,monk,windwalker,84,52,32
Fistu,silvermoon,1602,monk,windwalker,31,18,13
Faustix,blackmoore,1602,monk,windwalker,78,42,36
Blizò,tarren-mill,1601,monk,windwalker,36,19,17
Lycké,silvermoon,1599,monk,windwalker,72,43,29
Hazzat,nordrassil,1599,monk,windwalker,42,24,18
Mcflaïe,ysondre,1599,monk,windwalker,36,17,19
Lemmeportbk,ravencrest,1599,monk,windwalker,56,24,32
Stormymonk,blackrock,1599,monk,windwalker,53,21,32
Waaks,archimonde,1592,monk,windwalker,36,20,16
Belobe,stormscale,1590,monk,windwalker,36,20,16
Шейдла,soulflayer,1590,monk,windwalker,47,23,24
Ròux,blackmoore,1589,monk,windwalker,53,27,26
Pêterpump,blackrock,1589,monk,windwalker,54,24,30
Saadx,ravencrest,1583,monk,windwalker,31,18,13
Bluumorc,ravencrest,1580,monk,windwalker,30,20,10
Skiplegsweeb,stormscale,1579,monk,windwalker,30,21,9
Samantonah,nemesis,1572,monk,windwalker,51,32,19
Vandamme,archimonde,1570,monk,windwalker,38,18,20
Сандерстрайк,howling-fjord,1567,monk,windwalker,51,28,23
Djshady,sylvanas,1566,monk,windwalker,60,30,30
Uwuhehe,ravencrest,1565,monk,windwalker,30,18,12
Монашкасюэ,howling-fjord,1564,monk,windwalker,30,21,9
Chulli,stormscale,1558,monk,windwalker,39,21,18
Трайтубайтми,gordunni,1556,monk,windwalker,39,18,21
Permagone,argent-dawn,1555,monk,windwalker,54,30,24
Ocëane,sanguino,1554,monk,windwalker,124,59,65
Løllapalooza,ragnaros,1553,monk,windwalker,39,20,19
Sòftx,stormscale,1549,monk,windwalker,34,22,12
Mikz,ravencrest,1548,monk,windwalker,36,22,14
Soxx,arthas,1548,monk,windwalker,85,46,39
Rayokhen,kazzak,1546,monk,windwalker,30,17,13
Рокебайбейби,howling-fjord,1546,monk,windwalker,143,71,72
Zenified,ragnaros,1545,monk,windwalker,36,18,18
Gdkz,tarren-mill,1543,monk,windwalker,48,18,30
Xullon,dragonblight,1542,monk,windwalker,60,27,33
Dankiron,darksorrow,1537,monk,windwalker,38,17,21
Fistedx,twisting-nether,1537,monk,windwalker,87,36,51
Анпапаяя,galakrond,1535,monk,windwalker,53,30,23
Хекмуги,borean-tundra,1535,monk,windwalker,91,44,47
Ryle,forscherliga,1534,monk,windwalker,42,21,21
Thighdiver,emeriss,1532,monk,windwalker,60,40,20
Chireapz,blackrock,1532,monk,windwalker,48,25,23
Муайтайец,howling-fjord,1532,monk,windwalker,47,20,27
Bwayn,blackhand,1531,monk,windwalker,30,16,14
Луэнн,gordunni,1531,monk,windwalker,144,75,69
Jeppehmonk,stormscale,1530,monk,windwalker,30,16,14
Adrianchase,ravencrest,1526,monk,windwalker,30,16,14
Тшейши,howling-fjord,1526,monk,windwalker,54,28,26
Scribzw,twisting-nether,1524,monk,windwalker,24,16,8
Такиера,gordunni,1523,monk,windwalker,30,16,14
Mezz,ahnqiraj,1522,monk,windwalker,36,16,20
Naschitüte,blackrock,1521,monk,windwalker,323,160,163
Jolbucheron,hyjal,1517,monk,windwalker,99,52,47
Qwizqwak,twisting-nether,1516,monk,windwalker,30,16,14
Jackywayne,blackmoore,1513,monk,windwalker,53,29,24
Feyzmonk,ysondre,1513,monk,windwalker,30,16,14
Bloodfist,zuljin,1509,monk,windwalker,28,17,11
Дивипи,blackscar,1506,monk,windwalker,54,24,30
Ànklar,blackrock,1504,monk,windwalker,57,26,31
Artharox,anachronos,1501,monk,windwalker,36,22,14
Wakmo,bladefist,1497,monk,windwalker,61,35,26
Fablemayfly,tarren-mill,1497,monk,windwalker,54,25,29
Nggz,archimonde,1495,monk,windwalker,121,73,48
Eonyzi,kazzak,1491,monk,windwalker,42,20,22
Gotmonkon,tarren-mill,1490,monk,windwalker,36,18,18
Annamonk,tarren-mill,1489,monk,windwalker,48,16,32
Soleriasbrew,blackhand,1482,monk,windwalker,36,18,18
Plsnerfmemor,hyjal,1480,monk,windwalker,64,32,32
Хзт,howling-fjord,1480,monk,windwalker,45,17,28
Awesomebrah,the-maelstrom,1478,monk,windwalker,36,19,17
ßibip,hyjal,1474,monk,windwalker,32,22,10
Vuzashiji,argent-dawn,1473,monk,windwalker,36,17,19
Xuuan,argent-dawn,1472,monk,windwalker,101,57,44
Mynaira,tarren-mill,1471,monk,windwalker,43,18,25
Senshí,stormscale,1468,monk,windwalker,42,20,22
Galaxyfists,blackhand,1467,monk,windwalker,132,68,64
Ролитта,gordunni,1466,monk,windwalker,30,19,11
Agitoyamissj,burning-legion,1466,monk,windwalker,139,66,73
Реброперо,gordunni,1466,monk,windwalker,51,20,31
Embodimonk,twisting-nether,1463,monk,windwalker,132,66,66
Крутотимс,howling-fjord,1463,monk,windwalker,47,18,29
Ìnconnu,dalaran,1460,monk,windwalker,100,51,49
Fungamelol,blackhand,1459,monk,windwalker,30,19,11
Fantazero,burning-legion,1459,monk,windwalker,35,16,19
Dòrâ,archimonde,1459,monk,windwalker,51,22,29
Sagewhisper,ravencrest,1458,monk,windwalker,57,27,30
Kukazamura,silvermoon,1458,monk,windwalker,47,21,26
Antomamonk,ravencrest,1455,monk,windwalker,33,16,17
Andyww,doomhammer,1454,monk,windwalker,54,17,37
Boxpunchkick,kazzak,1452,monk,windwalker,56,27,29
Doobly,kazzak,1451,monk,windwalker,143,74,69
Gatyz,archimonde,1450,monk,windwalker,69,31,38
Bèrïth,kazzak,1447,monk,windwalker,78,35,43
Nikchi,destromath,1444,monk,windwalker,66,30,36
Spinntowin,blackmoore,1442,monk,windwalker,114,57,57
Yesman,quelthalas,1439,monk,windwalker,152,82,70
Пампич,borean-tundra,1438,monk,windwalker,36,17,19
Артемиоксх,blackscar,1437,monk,windwalker,37,15,22
Ðâvàizskÿ,ysondre,1436,monk,windwalker,30,15,15
Saodiseng,outland,1435,monk,windwalker,42,17,25
Флурсон,gordunni,1434,monk,windwalker,24,15,9
Niyatî,draenor,1433,monk,windwalker,34,16,18
Flowér,auchindoun,1433,monk,windwalker,36,15,21
Denji,kargath,1432,monk,windwalker,24,15,9
Домудароги,gordunni,1431,monk,windwalker,60,29,31
Ijji,argent-dawn,1427,monk,windwalker,36,15,21
Anhox,ragnaros,1425,monk,windwalker,30,15,15
Jukei,blackmoore,1425,monk,windwalker,30,15,15
Azato,hyjal,1423,monk,windwalker,54,27,27
Chígoku,grim-batol,1421,monk,windwalker,128,62,66
Løwping,blackmoore,1421,monk,windwalker,95,41,54
Exikûsh,frostwolf,1417,monk,windwalker,45,25,20
Kirkeý,ravencrest,1417,monk,windwalker,61,26,35
Misutò,tarren-mill,1414,monk,windwalker,42,25,17
Циорех,gordunni,1414,monk,windwalker,27,16,11
Анике,howling-fjord,1413,monk,windwalker,33,16,17
Mirôku,onyxia,1412,monk,windwalker,48,27,21
Mink,uldum,1412,monk,windwalker,30,15,15
Votbo,kazzak,1412,monk,windwalker,60,25,35
Pandarok,argent-dawn,1412,monk,windwalker,48,20,28
Enjàz,sylvanas,1410,monk,windwalker,29,17,12
Dræk,twisting-nether,1410,monk,windwalker,116,60,56
Vibé,blackmoore,1407,monk,windwalker,30,17,13
Rãkan,kazzak,1405,monk,windwalker,36,21,15
Euronymesis,silvermoon,1403,monk,windwalker,55,27,28
Kneecapper,ravencrest,1403,monk,windwalker,80,39,41
Белено,deathguard,1402,monk,windwalker,30,15,15
Добраядушка,gordunni,1400,monk,windwalker,36,19,17
Ívó,ragnaros,1400,monk,windwalker,48,20,28
Cac,argent-dawn,1399,monk,windwalker,105,46,59
Akÿo,archimonde,1399,monk,windwalker,35,15,20
Pipatvs,drakthul,1398,monk,windwalker,31,21,10
Бладмонки,soulflayer,1395,monk,windwalker,42,18,24
Fífrelin,archimonde,1394,monk,windwalker,48,24,24
Bakash,ysondre,1394,monk,windwalker,235,112,123
Kyraxs,silvermoon,1392,monk,windwalker,53,26,27
Fratznkicker,blackhand,1391,monk,windwalker,107,56,51
Wazari,nemesis,1389,monk,windwalker,79,39,40
Монахнехилит,howling-fjord,1389,monk,windwalker,66,27,39
Brüshïë,kazzak,1387,monk,windwalker,29,15,14
Mycki,dalaran,1386,monk,windwalker,47,24,23
Kîngjungeîle,dalaran,1384,monk,windwalker,30,17,13
Räudiger,nazjatar,1381,monk,windwalker,186,92,94
Кюзичка,gordunni,1379,monk,windwalker,83,38,45
Nolo,outland,1379,monk,windwalker,99,43,56
Swiftmonky,azuremyst,1376,monk,windwalker,48,27,21
Kyujushigu,silvermoon,1375,monk,windwalker,72,39,33
Recklusa,stormscale,1374,monk,windwalker,69,39,30
Nodzomi,shadowsong,1374,monk,windwalker,58,31,27
Darré,sylvanas,1373,monk,windwalker,199,93,106
Odelagga,draenor,1371,monk,windwalker,36,19,17
Lucaspires,sylvanas,1370,monk,windwalker,72,25,47
Îrønfist,blackmoore,1368,monk,windwalker,41,23,18
Bænkai,naxxramas,1368,monk,windwalker,41,21,20
Йетисан,gordunni,1359,monk,windwalker,137,63,74
Bandiya,archimonde,1358,monk,windwalker,61,28,33
Монкфейс,howling-fjord,1357,monk,windwalker,36,16,20
Greytail,argent-dawn,1350,monk,windwalker,42,16,26
Orkuuddiu,pozzo-delleternità,1350,monk,windwalker,48,18,30
Fantasiløs,twisting-nether,1349,monk,windwalker,30,16,14
Boutarzi,hyjal,1347,monk,windwalker,54,25,29
Risomonk,blackrock,1346,monk,windwalker,33,16,17
Intensivee,silvermoon,1345,monk,windwalker,77,36,41
Icecoldish,tarren-mill,1344,monk,windwalker,78,41,37
Traxxus,sanguino,1344,monk,windwalker,42,20,22
Bubjuu,ravencrest,1343,monk,windwalker,24,14,10
Hôllowx,throkferoth,1342,monk,windwalker,36,14,22
Тхэгык,soulflayer,1342,monk,windwalker,36,14,22
Schmidti,kazzak,1340,monk,windwalker,30,14,16
Arsonists,argent-dawn,1339,monk,windwalker,24,14,10
Domiqx,blackhand,1339,monk,windwalker,30,14,16
Томтью,gordunni,1338,monk,windwalker,119,57,62
Czvibuh,drakthul,1337,monk,windwalker,42,21,21
Bobbyknuckls,ravencrest,1336,monk,windwalker,185,87,98
Piedliés,ravencrest,1336,monk,windwalker,30,14,16
Tubørg,ravencrest,1336,monk,windwalker,30,14,16
Rerowine,magtheridon,1336,monk,windwalker,36,14,22
Undefinedid,ravencrest,1335,monk,windwalker,110,57,53
Matlahon,kazzak,1333,monk,windwalker,113,54,59
Lesauceboss,kazzak,1332,monk,windwalker,30,14,16
Thekaj,kazzak,1324,monk,windwalker,30,18,12
Øbamakush,archimonde,1323,monk,windwalker,36,17,19
Коркирас,howling-fjord,1322,monk,windwalker,90,50,40
Tempestu,twisting-nether,1319,monk,windwalker,30,14,16
Fûràxx,hyjal,1314,monk,windwalker,60,31,29
Огненныйкит,blackscar,1311,monk,windwalker,33,18,15
Vivvy,argent-dawn,1311,monk,windwalker,35,17,18
Óó,los-errantes,1309,monk,windwalker,39,20,19
Sarmal,nemesis,1305,monk,windwalker,62,29,33
Kungfumite,twisting-nether,1296,monk,windwalker,95,49,46
Miyaghï,dun-modr,1296,monk,windwalker,91,46,45
Djînns,blackmoore,1296,monk,windwalker,30,15,15
Xialongbao,khaz-modan,1291,monk,windwalker,47,19,28
Hampocket,ravencrest,1290,monk,windwalker,38,15,23
Cptfist,argent-dawn,1289,monk,windwalker,29,14,15
Phyllochinon,blackrock,1288,monk,windwalker,52,32,20
Яшкациган,howling-fjord,1288,monk,windwalker,70,31,39
Karmachi,ravencrest,1283,monk,windwalker,41,14,27
Gúerrilla,tarren-mill,1280,monk,windwalker,96,55,41
Sajin,la-croisade-écarlate,1279,monk,windwalker,29,14,15
Fatlazypanda,argent-dawn,1273,monk,windwalker,56,33,23
Пивондэполо,gordunni,1271,monk,windwalker,46,22,24
Mønkeydluffy,blackmoore,1269,monk,windwalker,66,33,33
Des,bronzebeard,1265,monk,windwalker,20,14,6
Maino,dalaran,1262,monk,windwalker,30,19,11
Вагонюлеера,howling-fjord,1260,monk,windwalker,28,14,14
Ketakarlsson,tarren-mill,1253,monk,windwalker,128,68,60
Lòthbar,confrérie-du-thorium,1252,monk,windwalker,47,27,20
Malutkie,defias-brotherhood,1252,monk,windwalker,144,68,76
Kylerøne,hyjal,1249,monk,windwalker,42,19,23
Thänkky,kazzak,1247,monk,windwalker,18,13,5
Vajawalkerx,twisting-nether,1247,monk,windwalker,18,13,5
Атммо,soulflayer,1247,monk,windwalker,24,13,11
Djpunchable,blackrock,1247,monk,windwalker,24,13,11
Meineaugen,blackhand,1246,monk,windwalker,18,13,5
Moonkeeye,stormscale,1246,monk,windwalker,114,59,55
Owalker,ravencrest,1245,monk,windwalker,18,13,5
Фортрен,deepholm,1244,monk,windwalker,30,13,17
Blyatfist,draenor,1243,monk,windwalker,24,13,11
Pawsgodx,ragnaros,1242,monk,windwalker,24,13,11
Pacimaru,silvermoon,1242,monk,windwalker,30,13,17
Brandy,kazzak,1242,monk,windwalker,30,13,17
Fullzi,dalaran,1241,monk,windwalker,24,13,11
Sweeneyboo,outland,1241,monk,windwalker,24,13,11
Monkeystar,archimonde,1240,monk,windwalker,18,13,5
Shapzxd,archimonde,1240,monk,windwalker,24,13,11
Брэгандерт,gordunni,1238,monk,windwalker,24,13,11
Pandermann,antonidas,1238,monk,windwalker,30,16,14
Fisty,lightbringer,1238,monk,windwalker,30,13,17
Miyagisensei,ravencrest,1237,monk,windwalker,24,13,11
Кирокко,gordunni,1235,monk,windwalker,30,20,10
Чвка,booty-bay,1235,monk,windwalker,73,36,37
Kouradoskylo,twisting-nether,1234,monk,windwalker,29,16,13
Panzeerotto,nemesis,1234,monk,windwalker,60,26,34
Meltfistqt,ravencrest,1234,monk,windwalker,30,13,17
Blyatfast,draenor,1233,monk,windwalker,24,13,11
Blumonk,argent-dawn,1233,monk,windwalker,140,69,71
Lumpero,stormreaver,1232,monk,windwalker,24,16,8
Bal,tyrande,1232,monk,windwalker,33,20,13
Янасру,gordunni,1232,monk,windwalker,273,136,137
Kegrøll,doomhammer,1231,monk,windwalker,42,21,21
Gorskie,silvermoon,1230,monk,windwalker,27,13,14
Merilwyn,argent-dawn,1229,monk,windwalker,22,14,8
Phesxm,sylvanas,1229,monk,windwalker,23,13,10
Hazmad,archimonde,1229,monk,windwalker,60,28,32
Jesmander,kazzak,1224,monk,windwalker,30,16,14
Лаодзы,deathguard,1220,monk,windwalker,36,13,23
Bruzuh,outland,1215,monk,windwalker,31,15,16
Vushao,blackmoore,1215,monk,windwalker,174,81,93
Néroburnsred,eredar,1215,monk,windwalker,39,16,23
Клепер,soulflayer,1213,monk,windwalker,24,14,10
Kanõ,outland,1210,monk,windwalker,81,40,41
Likethat,hyjal,1210,monk,windwalker,77,34,43
Keskonriz,ysondre,1209,monk,windwalker,108,46,62
Imvengeance,stormscale,1205,monk,windwalker,40,19,21
Joaquuin,sylvanas,1204,monk,windwalker,54,27,27
Билльбо,fordragon,1203,monk,windwalker,132,65,67
Yøøps,dalaran,1191,monk,windwalker,71,33,38
Smørc,the-maelstrom,1186,monk,windwalker,32,14,18
Bogey,ragnaros,1182,monk,windwalker,26,13,13
Vercya,dun-morogh,1173,monk,windwalker,43,22,21
Trunks,turalyon,1164,monk,windwalker,42,20,22
Брысьли,howling-fjord,1162,monk,windwalker,32,14,18
Djstepmom,ravencrest,1152,monk,windwalker,12,12,0
Bellarika,nemesis,1152,monk,windwalker,12,12,0
Wajoba,blackhand,1152,monk,windwalker,18,12,6
Monk,shattered-hand,1152,monk,windwalker,30,12,18
Stronkman,frostwhisper,1151,monk,windwalker,30,20,10
Kungfuhkyou,tarren-mill,1151,monk,windwalker,18,12,6
Tðptier,drakthul,1151,monk,windwalker,18,12,6
Çhina,twisting-nether,1151,monk,windwalker,24,12,12
Bigfistah,tarren-mill,1150,monk,windwalker,24,12,12
Coollann,drakthul,1150,monk,windwalker,30,12,18
Elfisto,baelgun,1149,monk,windwalker,26,13,13
Monk,dun-modr,1148,monk,windwalker,24,12,12
Brorsantuck,frostmane,1147,monk,windwalker,18,12,6
Траблы,howling-fjord,1147,monk,windwalker,24,12,12
Sugura,dethecus,1146,monk,windwalker,24,12,12
Yipmaan,kazzak,1146,monk,windwalker,24,12,12
Гномкия,gordunni,1146,monk,windwalker,24,12,12
Kagëra,ysondre,1145,monk,windwalker,24,12,12
Silvrt,tarren-mill,1145,monk,windwalker,24,12,12
Omoi,twisting-nether,1142,monk,windwalker,24,12,12
Blickx,draenor,1141,monk,windwalker,28,13,15
Mistbeever,ragnaros,1136,monk,windwalker,24,12,12
Thichquang,sylvanas,1134,monk,windwalker,18,12,6
Monkgol,stormscale,1129,monk,windwalker,24,12,12
Халиосфа,gordunni,1129,monk,windwalker,30,12,18
Azangar,kazzak,1114,monk,windwalker,22,12,10
Djbuttholex,tarren-mill,1114,monk,windwalker,23,12,11
Noodlesauce,silvermoon,1100,monk,windwalker,15,12,3
Malarie,magtheridon,1096,monk,windwalker,110,58,52
Chæli,tarren-mill,1094,monk,windwalker,23,12,11
Непорядочная,gordunni,1094,monk,windwalker,42,17,25
Ехерех,blackscar,1084,monk,windwalker,36,21,15
Martial,arthas,1081,monk,windwalker,59,26,33
Jayline,kazzak,1069,monk,windwalker,54,21,33
Kusid,ragnaros,1066,monk,windwalker,21,12,9
Daybaobao,the-maelstrom,1062,monk,windwalker,22,12,10
Одиниз,gordunni,1059,monk,windwalker,54,34,20
Monkiatsu,turalyon,1059,monk,windwalker,38,22,16
Ørlandéa,archimonde,1057,monk,windwalker,35,20,15
Hàtéppl,ravencrest,1056,monk,windwalker,18,11,7
Astriz,outland,1056,monk,windwalker,18,11,7
Зестус,galakrond,1056,monk,windwalker,24,11,13
Dévíllíá,ragnaros,1056,monk,windwalker,24,11,13
Monksea,ravencrest,1056,monk,windwalker,24,11,13
Padawang,twisting-nether,1056,monk,windwalker,24,11,13
Гкдшка,blackscar,1056,monk,windwalker,24,11,13
Weezé,outland,1055,monk,windwalker,18,11,7
Cirixx,outland,1055,monk,windwalker,18,11,7
Tecisharmony,ravencrest,1055,monk,windwalker,18,11,7
Runefists,twisting-nether,1055,monk,windwalker,18,11,7
Mabkww,ravencrest,1055,monk,windwalker,18,11,7
Turbofistsqt,kazzak,1054,monk,windwalker,18,11,7
Melaz,ravencrest,1054,monk,windwalker,18,11,7
Garlä,archimonde,1054,monk,windwalker,18,11,7
Leolilu,ravencrest,1054,monk,windwalker,18,11,7
Goldengem,silvermoon,1054,monk,windwalker,24,11,13
Вэилэй,gordunni,1054,monk,windwalker,24,11,13
Ñinjakick,outland,1054,monk,windwalker,30,11,19
Futtefut,ravencrest,1054,monk,windwalker,30,11,19
Tiaqa,aegwynn,1053,monk,windwalker,12,11,1
Ноупэйн,soulflayer,1053,monk,windwalker,30,11,19
Cleør,blackmoore,1052,monk,windwalker,18,11,7
Degentz,alakir,1051,monk,windwalker,21,12,9
Realiaze,tichondrius,1051,monk,windwalker,30,11,19
Вамптолкер,howling-fjord,1049,monk,windwalker,18,11,7
Dokuziq,twisting-nether,1046,monk,windwalker,28,12,16
Нежненький,gordunni,1045,monk,windwalker,24,11,13
Klapptoast,blackmoore,1036,monk,windwalker,24,11,13
Napqi,malganis,1023,monk,windwalker,17,11,6
Chlamydious,silvermoon,1019,monk,windwalker,60,24,36
Roptoglad,hyjal,1017,monk,windwalker,29,11,18
Secretmonk,ravencrest,1007,monk,windwalker,23,11,12
Laggedfist,kazzak,1007,monk,windwalker,27,11,16
Kebabvevaren,twisting-nether,1005,monk,windwalker,21,12,9
Buggaa,dalaran,996,monk,windwalker,23,11,12
Dionee,twisting-nether,992,monk,windwalker,27,14,13
Marcianorock,archimonde,987,monk,windwalker,30,13,17
Agress,sanguino,984,monk,windwalker,72,33,39
Ekincheng,twisting-nether,964,monk,windwalker,30,15,15
Pïpöu,archimonde,960,monk,windwalker,12,10,2
Elfisto,eredar,960,monk,windwalker,12,10,2
Wreckpuss,tarren-mill,960,monk,windwalker,18,10,8
Senniñ,ravencrest,960,monk,windwalker,18,10,8
Rìnox,blackmoore,960,monk,windwalker,18,10,8
Martur,bronzebeard,960,monk,windwalker,18,10,8
Ðävàizskó,ysondre,960,monk,windwalker,18,10,8
Mcscrub,ragnaros,960,monk,windwalker,18,10,8
Ilovefreddy,stormscale,960,monk,windwalker,18,10,8
Plånck,archimonde,960,monk,windwalker,18,10,8
Sqoobie,tarren-mill,960,monk,windwalker,18,10,8
Волкейн,soulflayer,960,monk,windwalker,24,10,14
Kåtsumi,sanguino,960,monk,windwalker,24,10,14
Eggroll,archimonde,959,monk,windwalker,18,10,8
Nycea,blackrock,959,monk,windwalker,18,10,8
Såsha,sanguino,959,monk,windwalker,18,10,8
Miridius,silvermoon,959,monk,windwalker,24,10,14
Драконзмей,soulflayer,959,monk,windwalker,30,10,20
Crewladal,arakarahm,959,monk,windwalker,30,10,20
Lottelita,tarren-mill,958,monk,windwalker,18,10,8
Купейчик,gordunni,958,monk,windwalker,24,10,14
Symaro,aegwynn,958,monk,windwalker,24,10,14
Sigath,emeriss,958,monk,windwalker,36,10,26
Heffertonne,eredar,957,monk,windwalker,18,10,8
Doreese,moonglade,955,monk,windwalker,18,10,8
Duches,tarren-mill,955,monk,windwalker,24,10,14
Runny,sanguino,930,monk,windwalker,36,10,26
Sebbii,twisting-nether,927,monk,windwalker,23,10,13
Chilleê,blackmoore,909,monk,windwalker,17,10,7
Scedadle,outland,909,monk,windwalker,21,10,11
Концептуалик,gordunni,896,monk,windwalker,21,11,10
Gidmonk,darkspear,894,monk,windwalker,24,12,12
Апесиинка,gordunni,874,monk,windwalker,23,11,12
Broussly,voljin,871,monk,windwalker,36,15,21
Pattafixcrin,blackrock,864,monk,windwalker,12,9,3
Weaverman,ragnaros,864,monk,windwalker,18,9,9
Brols,dalaran,864,monk,windwalker,18,9,9
Zmile,ragnaros,864,monk,windwalker,18,9,9
Øåæøæøåæ,ravencrest,864,monk,windwalker,18,9,9
Gankplank,nemesis,864,monk,windwalker,18,9,9
Notadrâgon,sylvanas,864,monk,windwalker,18,9,9
Skriptzy,blackmoore,864,monk,windwalker,18,9,9
Джобишоп,howling-fjord,864,monk,windwalker,18,9,9
Snookzlol,aegwynn,864,monk,windwalker,18,9,9
Lrizz,argent-dawn,864,monk,windwalker,18,9,9
Alandriai,blackmoore,863,monk,windwalker,12,9,3
Barneyzan,tarren-mill,863,monk,windwalker,18,9,9
Otp,hyjal,863,monk,windwalker,18,9,9
Wâgwân,hyjal,863,monk,windwalker,18,9,9
Thawy,sargeras,863,monk,windwalker,24,9,15
Gálaxyfist,blackhand,863,monk,windwalker,24,9,15
Nouraxo,kazzak,862,monk,windwalker,18,9,9
Sûûn,hyjal,862,monk,windwalker,18,9,9
Mcsmack,argent-dawn,861,monk,windwalker,12,9,3
Lin,nathrezim,861,monk,windwalker,18,9,9
Teztouza,kazzak,861,monk,windwalker,18,9,9
Linocence,draenor,860,monk,windwalker,95,47,48
Franziskanus,das-syndikat,860,monk,windwalker,24,9,15
Iluvatareru,twisting-nether,859,monk,windwalker,18,9,9
Кримсон,blackscar,858,monk,windwalker,12,9,3
Sinziana,silvermoon,858,monk,windwalker,12,9,3
Tetetete,silvermoon,858,monk,windwalker,18,9,9
Somonks,twisting-nether,857,monk,windwalker,18,9,9
Zoyrac,malygos,856,monk,windwalker,18,9,9
Meff,hyjal,855,monk,windwalker,16,10,6
Patadademijo,tarren-mill,855,monk,windwalker,24,9,15
Mozzaks,doomhammer,852,monk,windwalker,12,9,3
Jgma,auchindoun,852,monk,windwalker,30,9,21
Goltigald,archimonde,838,monk,windwalker,23,9,14
Apprentice,ravencrest,815,monk,windwalker,17,9,8
Yamo,blackrock,814,monk,windwalker,17,9,8
Okilexsan,sanguino,797,monk,windwalker,11,9,2
Karatiy,doomhammer,795,monk,windwalker,99,33,66
Monkiki,hyjal,784,monk,windwalker,25,9,16
Sultanofrizz,draenor,768,monk,windwalker,12,8,4
Gøøgodx,tarren-mill,768,monk,windwalker,12,8,4
Wladqz,stormscale,768,monk,windwalker,12,8,4
Ðìør,kazzak,768,monk,windwalker,12,8,4
Fistyfast,hyjal,768,monk,windwalker,12,8,4
Gojò,outland,768,monk,windwalker,12,8,4
Karels,archimonde,768,monk,windwalker,12,8,4
Slayh,archimonde,768,monk,windwalker,12,8,4
Cuteshygirl,shattrath,768,monk,windwalker,18,8,10
Jamiedhism,ravencrest,768,monk,windwalker,18,8,10
Stÿvww,archimonde,768,monk,windwalker,24,8,16
Дыня,gordunni,767,monk,windwalker,12,8,4
Sêssai,outland,767,monk,windwalker,12,8,4
Daizz,magtheridon,767,monk,windwalker,12,8,4
Nízra,archimonde,767,monk,windwalker,12,8,4
Yungbaren,frostwolf,767,monk,windwalker,12,8,4
Pimahz,aggra-português,767,monk,windwalker,12,8,4
Earendil,culte-de-la-rive-noire,767,monk,windwalker,12,8,4
Kaztruman,draenor,767,monk,windwalker,15,9,6
Vyneth,draenor,767,monk,windwalker,20,10,10
Johnsôn,blackmoore,767,monk,windwalker,18,8,10
Lellaccio,pozzo-delleternità,767,monk,windwalker,18,8,10
Kryzu,ragnaros,767,monk,windwalker,18,8,10
Alurymnk,blackrock,767,monk,windwalker,18,8,10
Bansheerrz,hyjal,767,monk,windwalker,18,8,10
Plsnerfrogue,tarren-mill,766,monk,windwalker,12,8,4
Wilywolxx,silvermoon,766,monk,windwalker,12,8,4
Pocaa,arakarahm,766,monk,windwalker,18,8,10
Verfa,twisting-nether,765,monk,windwalker,18,8,10
Rollah,ravencrest,765,monk,windwalker,18,8,10
Kaipo,ragnaros,765,monk,windwalker,24,8,16
Chiroidz,kazzak,764,monk,windwalker,18,8,10
Krâr,onyxia,763,monk,windwalker,18,8,10
Rangomind,silvermoon,761,monk,windwalker,12,8,4
Elayja,twisting-nether,717,monk,windwalker,17,8,9
Zledriasa,ravencrest,703,monk,windwalker,20,8,12
Fredder,blackrock,701,monk,windwalker,23,8,15
Dmeenmonk,kazzak,672,monk,windwalker,12,7,5
Vixiatwo,outland,672,monk,windwalker,12,7,5
Dopi,frostmane,672,monk,windwalker,12,7,5
Dennismansix,sylvanas,672,monk,windwalker,12,7,5
Мандаирины,gordunni,672,monk,windwalker,12,7,5
Chryan,marécage-de-zangar,672,monk,windwalker,12,7,5
Bryggarn,draenor,672,monk,windwalker,12,7,5
Sàlêxz,ysondre,672,monk,windwalker,12,7,5
Chiscake,blackrock,672,monk,windwalker,12,7,5
Despéradø,archimonde,672,monk,windwalker,12,7,5
Arthanaar,drakthul,672,monk,windwalker,12,7,5
Njursten,twilights-hammer,672,monk,windwalker,12,7,5
Shoelaren,ragnaros,672,monk,windwalker,12,7,5
Wrizz,area-52,672,monk,windwalker,12,7,5
Balanceqt,ravencrest,672,monk,windwalker,12,7,5
Cander,stormscale,672,monk,windwalker,12,7,5
Potsymist,twisting-nether,672,monk,windwalker,12,7,5
Kàrmà,aegwynn,672,monk,windwalker,12,7,5
Tortasauro,sanguino,672,monk,windwalker,12,7,5
Breezzmonka,twisting-nether,672,monk,windwalker,12,7,5
Daltailr,silvermoon,672,monk,windwalker,12,7,5
Chanzey,silvermoon,672,monk,windwalker,12,7,5
Âdonis,twisting-nether,672,monk,windwalker,12,7,5
Pawsy,twisting-nether,672,monk,windwalker,12,7,5
Jiya,blackmoore,672,monk,windwalker,18,7,11
Elababe,ravencrest,672,monk,windwalker,18,7,11
Risingspud,frostmane,672,monk,windwalker,18,7,11
Quï,hyjal,672,monk,windwalker,18,7,11
Ráây,blackrock,672,monk,windwalker,18,7,11
Keberathom,stormscale,672,monk,windwalker,18,7,11
Джийви,goldrinn,672,monk,windwalker,18,7,11
Winifspin,twisting-nether,672,monk,windwalker,18,7,11
Bonkboi,tarren-mill,672,monk,windwalker,18,7,11
Mayliene,stormscale,672,monk,windwalker,18,7,11
Zymonks,silvermoon,672,monk,windwalker,18,7,11
Jkmonkyo,blackrock,672,monk,windwalker,18,7,11
Galexuz,blackrock,672,monk,windwalker,18,7,11
Qtv,arthas,672,monk,windwalker,18,7,11
Sungødx,blackrock,672,monk,windwalker,18,7,11
Sonofelrond,twisting-nether,671,monk,windwalker,12,7,5
Mystikmonk,blackrock,671,monk,windwalker,12,7,5
Bierdame,blackhand,671,monk,windwalker,12,7,5
Эзархадон,lich-king,671,monk,windwalker,12,7,5
Dubhira,blackmoore,671,monk,windwalker,12,7,5
Discosean,frostmane,671,monk,windwalker,18,7,11
Arshy,silvermoon,671,monk,windwalker,18,7,11
Velita,dun-modr,671,monk,windwalker,18,7,11
Авентусс,howling-fjord,671,monk,windwalker,18,7,11
Tysonwonka,thrall,670,monk,windwalker,12,7,5
Zhiothe,argent-dawn,670,monk,windwalker,12,7,5
Dummars,ragnaros,670,monk,windwalker,18,7,11
Mwoinesamdi,hyjal,670,monk,windwalker,18,7,11
Xamaan,sanguino,670,monk,windwalker,18,7,11
Digô,malganis,669,monk,windwalker,12,7,5
Kirara,talnivarr,668,monk,windwalker,12,7,5
Рочч,gordunni,668,monk,windwalker,12,7,5
Monktoon,doomhammer,668,monk,windwalker,18,7,11
Bâmbêlvî,tyrande,667,monk,windwalker,15,7,8
Brucilli,dalaran,666,monk,windwalker,12,7,5
Undgrund,burning-legion,661,monk,windwalker,18,7,11
Humpenpower,blackhand,655,monk,windwalker,17,7,10
Fusetonww,tarren-mill,623,monk,windwalker,11,7,4
Ahlu,argent-dawn,623,monk,windwalker,21,7,14
Ktrina,ravencrest,618,monk,windwalker,21,9,12
Pïpöu,kirin-tor,607,monk,windwalker,11,7,4
Sori,mazrigos,592,monk,windwalker,19,7,12
Koreangirlx,archimonde,576,monk,windwalker,6,6,0
Rezuz,draenor,576,monk,windwalker,6,6,0
Rigbone,kazzak,576,monk,windwalker,12,6,6
Balance,laughing-skull,576,monk,windwalker,12,6,6
Fistweavs,ravencrest,576,monk,windwalker,12,6,6
Pabu,emeriss,576,monk,windwalker,12,6,6
Shaokïng,exodar,576,monk,windwalker,12,6,6
Luckyjones,tarren-mill,576,monk,windwalker,12,6,6
Geezer,the-maelstrom,576,monk,windwalker,12,6,6
Worasemonk,hyjal,576,monk,windwalker,12,6,6
Gîø,blackmoore,576,monk,windwalker,12,6,6
Whoszeus,archimonde,576,monk,windwalker,12,6,6
Мэрджик,soulflayer,576,monk,windwalker,12,6,6
Doyoubleed,twisting-nether,576,monk,windwalker,12,6,6
Ogelele,twisting-nether,576,monk,windwalker,12,6,6
Rainymonday,ravencrest,576,monk,windwalker,12,6,6
Tenszangetsu,ragnaros,576,monk,windwalker,12,6,6
Níko,korgall,576,monk,windwalker,12,6,6
Jollyzug,blackrock,576,monk,windwalker,12,6,6
Xàrslòulolz,kazzak,576,monk,windwalker,12,6,6
Ferree,tarren-mill,576,monk,windwalker,12,6,6
Nyrkkikylpy,ravencrest,576,monk,windwalker,12,6,6
Yeol,ravencrest,576,monk,windwalker,12,6,6
Муаннуар,soulflayer,576,monk,windwalker,12,6,6
Rhâzalgûl,khaz-modan,576,monk,windwalker,12,6,6
Ilovecravmag,draenor,576,monk,windwalker,12,6,6
Jam,aerie-peak,576,monk,windwalker,12,6,6
Naynayrb,draenor,576,monk,windwalker,12,6,6
Lîlilîlîlîlí,stormscale,576,monk,windwalker,12,6,6
Gramkin,ravencrest,576,monk,windwalker,12,6,6
Fiddyy,outland,576,monk,windwalker,12,6,6
Мишадуротар,borean-tundra,576,monk,windwalker,16,7,9
Bbcmonkinc,aegwynn,576,monk,windwalker,16,7,9
Fiststowin,blackrock,576,monk,windwalker,18,6,12
Xoconut,ravencrest,576,monk,windwalker,18,6,12
Desmî,ravencrest,576,monk,windwalker,18,6,12
Norgamx,alakir,576,monk,windwalker,18,6,12
Шоты,soulflayer,575,monk,windwalker,6,6,0
Woknroll,draenor,575,monk,windwalker,12,6,6
Raychi,draenor,575,monk,windwalker,12,6,6
Teetoor,argent-dawn,575,monk,windwalker,12,6,6
Woalter,silvermoon,575,monk,windwalker,12,6,6
Okpm,marécage-de-zangar,575,monk,windwalker,12,6,6
Mongole,hellscream,575,monk,windwalker,18,6,12
Крэйзимедвед,howling-fjord,575,monk,windwalker,18,6,12
Sixqtn,blackrock,575,monk,windwalker,18,6,12
Jaylée,thrall,574,monk,windwalker,12,6,6
Mönchdog,blackmoore,573,monk,windwalker,12,6,6
Veila,the-maelstrom,573,monk,windwalker,12,6,6
Izabell,bronzebeard,573,monk,windwalker,18,6,12
Mullan,eonar,573,monk,windwalker,24,6,18
Монкуем,gordunni,567,monk,windwalker,12,6,6
Жарптыца,gordunni,559,monk,windwalker,17,6,11
Dianly,ravencrest,543,monk,windwalker,23,6,17
Merjis,stormscale,527,monk,windwalker,11,6,5
Armutschkerl,blackhand,522,monk,windwalker,23,8,15
Everydayrain,ravencrest,511,monk,windwalker,14,6,8
Eaghor,draenor,510,monk,windwalker,10,6,4
Жекадобряк,howling-fjord,503,monk,windwalker,15,7,8
Boxarnsgrabb,shattered-hand,480,monk,windwalker,6,5,1
Монкигодх,howling-fjord,480,monk,windwalker,6,5,1
Энвишь,soulflayer,480,monk,windwalker,6,5,1
Ameri,burning-steppes,480,monk,windwalker,6,5,1
Killabees,stormscale,480,monk,windwalker,6,5,1
Kapud,twisting-nether,480,monk,windwalker,6,5,1
Wheelchairqt,stormscale,480,monk,windwalker,6,5,1
Prototypx,blackmoore,480,monk,windwalker,6,5,1
Nastyvibes,dun-modr,480,monk,windwalker,6,5,1
Larsowns,ragnaros,480,monk,windwalker,6,5,1
Emptyeyés,kazzak,480,monk,windwalker,6,5,1
Loordcraft,silvermoon,480,monk,windwalker,6,5,1
Threevthree,kazzak,480,monk,windwalker,6,5,1
Расселкроу,galakrond,480,monk,windwalker,12,5,7
Aljabbar,ravencrest,480,monk,windwalker,12,5,7
Kenjibsen,blackhand,480,monk,windwalker,12,5,7
Áutumnfalls,stormscale,480,monk,windwalker,12,5,7
Badcøwboy,archimonde,480,monk,windwalker,12,5,7
Archnun,stormscale,480,monk,windwalker,12,5,7
Enrookiejr,aegwynn,480,monk,windwalker,12,5,7
Qdwdwqerdads,ravencrest,480,monk,windwalker,12,5,7
Dertekk,archimonde,480,monk,windwalker,12,5,7
Mickjabber,aegwynn,480,monk,windwalker,12,5,7
Çùçé,dalaran,480,monk,windwalker,12,5,7
Udon,argent-dawn,480,monk,windwalker,12,5,7
Nevertouch,blackrock,480,monk,windwalker,12,5,7
Babyfax,draenor,480,monk,windwalker,12,5,7
Investing,silvermoon,480,monk,windwalker,12,5,7
Bimberta,argent-dawn,480,monk,windwalker,12,5,7
Pîna,onyxia,480,monk,windwalker,12,5,7
Onlypressw,tarren-mill,480,monk,windwalker,12,5,7
Øåæøæøåæ,kazzak,480,monk,windwalker,12,5,7
Kaelwind,burning-legion,480,monk,windwalker,12,5,7
Käsefäuste,azshara,480,monk,windwalker,12,5,7
Fistus,dentarg,480,monk,windwalker,12,5,7
Màrlux,kazzak,480,monk,windwalker,12,5,7
Nerd,argent-dawn,480,monk,windwalker,12,5,7
Grintilif,malygos,480,monk,windwalker,12,5,7
Yaxleyx,dragonblight,480,monk,windwalker,12,5,7
Béarly,outland,480,monk,windwalker,12,5,7
Npkwalker,outland,480,monk,windwalker,12,5,7
Diagmonk,kazzak,480,monk,windwalker,12,5,7
Tonikor,kazzak,480,monk,windwalker,12,5,7
Кунфумастер,gordunni,480,monk,windwalker,12,5,7
Krazylegs,sanguino,480,monk,windwalker,12,5,7
Joshxao,blackmoore,480,monk,windwalker,12,5,7
Charlett,the-venture-co,480,monk,windwalker,12,5,7
Betelgeuse,jaedenar,480,monk,windwalker,12,5,7
Мяуки,soulflayer,480,monk,windwalker,12,5,7
Plingpong,sylvanas,480,monk,windwalker,12,5,7
Drfistalot,blackrock,480,monk,windwalker,12,5,7
Nicetrybuddy,draenor,480,monk,windwalker,18,5,13
Draxaxa,hyjal,480,monk,windwalker,18,5,13
Немонахх,howling-fjord,480,monk,windwalker,18,5,13
Диксэш,ashenvale,479,monk,windwalker,12,5,7
Askarg,khaz-modan,479,monk,windwalker,12,5,7
Alopécida,voljin,479,monk,windwalker,15,6,9
Øñ,cthun,479,monk,windwalker,18,5,13
Effeots,blackrock,479,monk,windwalker,18,5,13
Tjukkas,bloodhoof,479,monk,windwalker,24,5,19
Nichonne,khaz-modan,478,monk,windwalker,12,5,7
Blackdu,drakthul,477,monk,windwalker,16,6,10
Sadwhi,turalyon,472,monk,windwalker,12,5,7
Lqp,outland,447,monk,windwalker,11,5,6
Wodniuch,defias-brotherhood,447,monk,windwalker,11,5,6
Iamzra,kazzak,431,monk,windwalker,17,5,12
Dushimonk,runetotem,416,monk,windwalker,10,5,5
Twdabuser,tarren-mill,415,monk,windwalker,8,5,3
Камагами,howling-fjord,400,monk,windwalker,7,5,2
Theoalt,dragonblight,399,monk,windwalker,5,5,0
Larrý,sylvanas,384,monk,windwalker,6,4,2
Toúch,blackmoore,384,monk,windwalker,6,4,2
Møønkëy,archimonde,384,monk,windwalker,6,4,2
Vjelan,forscherliga,384,monk,windwalker,6,4,2
Windstormcro,ragnaros,384,monk,windwalker,6,4,2
Baisi,blackhand,384,monk,windwalker,6,4,2
Rugys,ravenholdt,384,monk,windwalker,6,4,2
Willempie,stormreaver,384,monk,windwalker,6,4,2
Màlydôr,outland,384,monk,windwalker,6,4,2
Soulspar,ragnaros,384,monk,windwalker,6,4,2
Venersere,eitrigg,384,monk,windwalker,6,4,2
Пашаскороход,gordunni,384,monk,windwalker,6,4,2
Styxmk,blackhand,384,monk,windwalker,6,4,2
Емопацан,gordunni,384,monk,windwalker,6,4,2
Zéroneufsizz,silvermoon,384,monk,windwalker,6,4,2
Wushin,antonidas,384,monk,windwalker,6,4,2
Orênda,silvermoon,384,monk,windwalker,6,4,2
Ilcooljay,ravencrest,384,monk,windwalker,6,4,2
Sprizzfuaz,blackmoore,384,monk,windwalker,6,4,2
Silcet,stormscale,384,monk,windwalker,6,4,2
Blazeuu,drakthul,384,monk,windwalker,6,4,2
Diagmonk,arathi,384,monk,windwalker,6,4,2
Stormsong,arthas,384,monk,windwalker,6,4,2
Orenichi,antonidas,384,monk,windwalker,6,4,2
Alâkhai,nerzhul,384,monk,windwalker,6,4,2
Pandaria,bronze-dragonflight,384,monk,windwalker,6,4,2
Sepi,hellfire,384,monk,windwalker,6,4,2
Palarîns,dalaran,384,monk,windwalker,6,4,2
Piednuques,archimonde,384,monk,windwalker,6,4,2
Jériícho,khaz-modan,384,monk,windwalker,6,4,2
Ubap,emeriss,384,monk,windwalker,6,4,2
Hertel,boulderfist,384,monk,windwalker,6,4,2
Karatemonk,stormscale,384,monk,windwalker,6,4,2
Monkflexi,draenor,384,monk,windwalker,6,4,2
Nicomonk,ravencrest,384,monk,windwalker,6,4,2
Àyoörts,archimonde,384,monk,windwalker,6,4,2
Милосердие,eversong,384,monk,windwalker,6,4,2
Jakkeez,twisting-nether,384,monk,windwalker,6,4,2
Elahn,outland,384,monk,windwalker,6,4,2
Disciprín,tarren-mill,384,monk,windwalker,6,4,2
Onn,outland,384,monk,windwalker,6,4,2
Windvibes,antonidas,384,monk,windwalker,6,4,2
Tàlo,anachronos,384,monk,windwalker,6,4,2
Dadrael,argent-dawn,384,monk,windwalker,6,4,2
Twinkletoe,twisting-nether,384,monk,windwalker,6,4,2
Jetcee,kazzak,384,monk,windwalker,6,4,2
Seyley,tarren-mill,384,monk,windwalker,6,4,2
Vetocorleone,kazzak,384,monk,windwalker,6,4,2
Rulliya,kazzak,384,monk,windwalker,6,4,2
Karrin,ghostlands,384,monk,windwalker,6,4,2
Clìtfister,silvermoon,384,monk,windwalker,6,4,2
Wingwalker,twisting-nether,384,monk,windwalker,6,4,2
Andrah,blackmoore,384,monk,windwalker,12,4,8
Räyh,outland,384,monk,windwalker,12,4,8
Fueradeserie,dun-modr,384,monk,windwalker,12,4,8
Blutáar,khazgoroth,384,monk,windwalker,12,4,8
Ketrie,argent-dawn,384,monk,windwalker,12,4,8
Showmeskillz,blackmoore,384,monk,windwalker,12,4,8
Hoøo,hyjal,384,monk,windwalker,12,4,8
Ожиганов,soulflayer,384,monk,windwalker,12,4,8
Rhift,draenor,384,monk,windwalker,12,4,8
Ragobd,argent-dawn,384,monk,windwalker,12,4,8
Deathmøøn,tyrande,384,monk,windwalker,12,4,8
Fishweaver,ravencrest,384,monk,windwalker,12,4,8
Kunjo,earthen-ring,384,monk,windwalker,12,4,8
Kushvendorx,silvermoon,384,monk,windwalker,12,4,8
Scribzz,twisting-nether,384,monk,windwalker,12,4,8
Løkî,culte-de-la-rive-noire,384,monk,windwalker,12,4,8
Jessie,bloodscalp,384,monk,windwalker,12,4,8
Ledoz,ravencrest,384,monk,windwalker,12,4,8
Аоепуп,soulflayer,384,monk,windwalker,12,4,8
Axan,drekthar,384,monk,windwalker,12,4,8
Bluum,ravencrest,384,monk,windwalker,12,4,8
Dëvilliä,ragnaros,384,monk,windwalker,12,4,8
Гарчи,azuregos,384,monk,windwalker,12,4,8
Байтли,gordunni,384,monk,windwalker,12,4,8
Bigkim,khadgar,384,monk,windwalker,12,4,8
Кириешек,deathguard,384,monk,windwalker,12,4,8
Aesthetìc,draenor,384,monk,windwalker,12,4,8
Goremancey,draenor,384,monk,windwalker,12,4,8
Azia,bronzebeard,384,monk,windwalker,12,4,8
Bbinzu,lothar,383,monk,windwalker,6,4,2
Yuchiiro,hyjal,383,monk,windwalker,6,4,2
Югэн,azuregos,383,monk,windwalker,12,4,8
Youngmonk,tarren-mill,351,monk,windwalker,23,4,19
Benkkei,ysondre,336,monk,windwalker,15,4,11
Shamarinator,kazzak,330,monk,windwalker,15,5,10
Jujujitsu,archimonde,330,monk,windwalker,17,4,13
Choje,blackmoore,319,monk,windwalker,5,4,1
Alë,argent-dawn,319,monk,windwalker,8,4,4
Shàllýn,antonidas,304,monk,windwalker,13,4,9
Marcjess,kazzak,288,monk,windwalker,6,3,3
Klotsobunidi,kazzak,288,monk,windwalker,6,3,3
Homelanderxx,tarren-mill,288,monk,windwalker,6,3,3
Bobblasfists,tarren-mill,288,monk,windwalker,6,3,3
Aaronm,tarren-mill,288,monk,windwalker,6,3,3
Exòar,ravencrest,288,monk,windwalker,6,3,3
Jweise,tarren-mill,288,monk,windwalker,6,3,3
Wowweaver,outland,288,monk,windwalker,6,3,3
Jogiemonk,ravencrest,288,monk,windwalker,6,3,3
Billyebbasta,nemesis,288,monk,windwalker,6,3,3
Ratfacè,outland,288,monk,windwalker,6,3,3
Fapmaster,aegwynn,288,monk,windwalker,6,3,3
Møngøwéávé,argent-dawn,288,monk,windwalker,6,3,3
Testibuul,archimonde,288,monk,windwalker,6,3,3
Zunixxww,terrordar,288,monk,windwalker,6,3,3
Ybnobama,outland,288,monk,windwalker,6,3,3
Zìnko,eredar,288,monk,windwalker,6,3,3
Räpeltäjä,stormreaver,288,monk,windwalker,6,3,3
Tshajek,hyjal,288,monk,windwalker,6,3,3
Shaol,stormreaver,288,monk,windwalker,6,3,3
Serizawã,hyjal,288,monk,windwalker,6,3,3
Mushush,draenor,288,monk,windwalker,6,3,3
Vultzm,draenor,288,monk,windwalker,6,3,3
Droozy,silvermoon,288,monk,windwalker,6,3,3
Jakfuki,ragnaros,288,monk,windwalker,6,3,3
Пингкин,deathweaver,288,monk,windwalker,6,3,3
Realfighter,arathor,288,monk,windwalker,6,3,3
Månkey,ahnqiraj,288,monk,windwalker,6,3,3
Iluvfistinjk,sylvanas,288,monk,windwalker,6,3,3
Ðoom,sylvanas,288,monk,windwalker,6,3,3
Adewelee,dalaran,288,monk,windwalker,6,3,3
Zéná,gilneas,288,monk,windwalker,6,3,3
Monkacek,drakthul,288,monk,windwalker,6,3,3
Бреэйн,howling-fjord,288,monk,windwalker,6,3,3
Дзинкс,howling-fjord,288,monk,windwalker,6,3,3
Válkyrìe,ravencrest,288,monk,windwalker,6,3,3
Zelraqt,burning-steppes,288,monk,windwalker,6,3,3
Blyadislav,ravencrest,288,monk,windwalker,6,3,3
Koot,ragnaros,288,monk,windwalker,6,3,3
Рендикаое,soulflayer,288,monk,windwalker,6,3,3
Sizok,blackmoore,288,monk,windwalker,6,3,3
Астрал,soulflayer,288,monk,windwalker,6,3,3
Rma,twisting-nether,288,monk,windwalker,6,3,3
Lokregar,blackmoore,288,monk,windwalker,6,3,3
Tjmnk,ravencrest,288,monk,windwalker,6,3,3
Velduin,dun-modr,288,monk,windwalker,6,3,3
Xpobak,ravencrest,288,monk,windwalker,6,3,3
Междунамиад,gordunni,288,monk,windwalker,6,3,3
Dasjinso,blackhand,288,monk,windwalker,6,3,3
Migg,burning-legion,288,monk,windwalker,6,3,3
Stonkss,ragnaros,288,monk,windwalker,6,3,3
Kungf,twisting-nether,288,monk,windwalker,6,3,3
Monkelibonk,ravencrest,288,monk,windwalker,6,3,3
Atrøciøus,ravencrest,288,monk,windwalker,6,3,3
Xen,uldum,288,monk,windwalker,6,3,3
Nüffelbüffel,blackrock,288,monk,windwalker,6,3,3
Tossen,ragnaros,288,monk,windwalker,6,3,3
Arisua,blackhand,288,monk,windwalker,6,3,3
Hästgodx,the-maelstrom,288,monk,windwalker,6,3,3
Chakkal,twisting-nether,288,monk,windwalker,6,3,3
Bg,blackhand,288,monk,windwalker,6,3,3
Бичмэн,deathguard,288,monk,windwalker,6,3,3
Street,nethersturm,288,monk,windwalker,7,3,4
Balkanbeastt,draenor,288,monk,windwalker,10,4,6
Clamps,darkspear,288,monk,windwalker,12,3,9
Ikasama,culte-de-la-rive-noire,288,monk,windwalker,12,3,9
Mönchfatih,blackhand,288,monk,windwalker,12,3,9
Geliôs,kazzak,288,monk,windwalker,12,3,9
Barylen,outland,288,monk,windwalker,12,3,9
Roxmonk,ravencrest,288,monk,windwalker,12,3,9
Howkong,archimonde,288,monk,windwalker,12,3,9
Cøbrakaï,archimonde,288,monk,windwalker,12,3,9
Ayyee,blackmoore,288,monk,windwalker,18,3,15
Мистерхюй,gordunni,288,monk,windwalker,18,3,15
Lewimoäne,khaz-modan,287,monk,windwalker,6,3,3
Baazoka,blackmoore,287,monk,windwalker,6,3,3
Михот,eversong,287,monk,windwalker,6,3,3
Wallky,burning-blade,287,monk,windwalker,18,3,15
Соловьюх,gordunni,286,monk,windwalker,12,3,9
Syaóran,exodar,286,monk,windwalker,12,3,9
Touchgodx,blackrock,256,monk,windwalker,8,4,4
Пкмлкм,gordunni,255,monk,windwalker,11,3,8
Dolkenm,tarren-mill,240,monk,windwalker,9,4,5
Yamqt,thrall,240,monk,windwalker,9,3,6
Zerno,archimonde,239,monk,windwalker,5,3,2
Kungfupandy,blackmoore,224,monk,windwalker,10,3,7
Trolleurz,archimonde,224,monk,windwalker,16,3,13
Idointcare,ravencrest,192,monk,windwalker,4,3,1
Bignessb,draenor,192,monk,windwalker,4,3,1
Wickly,stormscale,192,monk,windwalker,10,4,6
Kano,burning-legion,192,monk,windwalker,9,3,6
Geochi,tarren-mill,192,monk,windwalker,6,2,4
Lildaddymonk,ravencrest,192,monk,windwalker,6,2,4
Loorda,neptulon,192,monk,windwalker,6,2,4
Keisy,kazzak,192,monk,windwalker,6,2,4
Tayoo,aegwynn,192,monk,windwalker,6,2,4
Loriodas,tarren-mill,192,monk,windwalker,6,2,4
Bensil,ravencrest,192,monk,windwalker,6,2,4
Márliene,twisting-nether,192,monk,windwalker,6,2,4
Youruba,dun-modr,192,monk,windwalker,6,2,4
Fístfillet,twisting-nether,192,monk,windwalker,6,2,4
Emå,nemesis,192,monk,windwalker,6,2,4
Karateboy,dun-modr,192,monk,windwalker,6,2,4
Melombus,dun-modr,192,monk,windwalker,6,2,4
Bamboosnack,kazzak,192,monk,windwalker,6,2,4
Stenhård,azjolnerub,192,monk,windwalker,6,2,4
Psyhooz,burning-legion,192,monk,windwalker,6,2,4
Bloodychi,ravencrest,192,monk,windwalker,6,2,4
Дедизшишки,soulflayer,192,monk,windwalker,6,2,4
Lollonko,kazzak,192,monk,windwalker,6,2,4
Mtmonk,tarren-mill,192,monk,windwalker,6,2,4
Monkkr,argent-dawn,192,monk,windwalker,6,2,4
Såliten,tarren-mill,192,monk,windwalker,6,2,4
Panicfist,stormscale,192,monk,windwalker,6,2,4
Icaena,ravencrest,192,monk,windwalker,6,2,4
Tyrastel,dalaran,192,monk,windwalker,6,2,4
Nebelpanda,ravencrest,192,monk,windwalker,6,2,4
Mychigun,ravencrest,192,monk,windwalker,6,2,4
Yaevinn,burning-legion,192,monk,windwalker,6,2,4
Shyriu,kazzak,192,monk,windwalker,6,2,4
Fistingfury,burning-blade,192,monk,windwalker,6,2,4
Brewroll,ravencrest,192,monk,windwalker,6,2,4
Îreful,tarren-mill,192,monk,windwalker,6,2,4
Akkadianx,ravencrest,192,monk,windwalker,6,2,4
Friidam,lightbringer,192,monk,windwalker,6,2,4
Deathpùlse,ravencrest,192,monk,windwalker,6,2,4
Popox,stormreaver,192,monk,windwalker,6,2,4
Påiñ,silvermoon,192,monk,windwalker,6,2,4
Bludclart,outland,192,monk,windwalker,6,2,4
Pawpipe,ravencrest,192,monk,windwalker,6,2,4
Shïma,sargeras,192,monk,windwalker,6,2,4
Panzerfall,hyjal,192,monk,windwalker,6,2,4
Walterwayne,blackrock,192,monk,windwalker,6,2,4
Joachi,outland,192,monk,windwalker,6,2,4
Khirazim,ysondre,192,monk,windwalker,6,2,4
Karradine,khaz-modan,192,monk,windwalker,6,2,4
Bobthewild,draenor,192,monk,windwalker,6,2,4
Glorïagaynor,archimonde,192,monk,windwalker,6,2,4
Musclorww,ysondre,192,monk,windwalker,6,2,4
Mezeko,stormscale,192,monk,windwalker,6,2,4
Rationis,blackmoore,192,monk,windwalker,6,2,4
Madinsane,thrall,192,monk,windwalker,6,2,4
Frajer,auchindoun,192,monk,windwalker,6,2,4
Adis,nerathor,192,monk,windwalker,6,2,4
Псилоцибин,gordunni,192,monk,windwalker,6,2,4
Wahrye,hyjal,192,monk,windwalker,6,2,4
Пекник,gordunni,192,monk,windwalker,6,2,4
Lxq,blackhand,192,monk,windwalker,6,2,4
Eynodiggity,blackmoore,192,monk,windwalker,6,2,4
Qtk,arthas,192,monk,windwalker,6,2,4
Miamausebär,blackmoore,192,monk,windwalker,6,2,4
Беглыйлаваш,gordunni,192,monk,windwalker,6,2,4
Latify,todeswache,192,monk,windwalker,6,2,4
Lilßaby,archimonde,192,monk,windwalker,6,2,4
Нагиботар,thermaplugg,192,monk,windwalker,6,2,4
Akazuki,frostwolf,192,monk,windwalker,6,2,4
Brevduwan,ragnaros,192,monk,windwalker,6,2,4
Priosia,ragnaros,192,monk,windwalker,6,2,4
Gabbah,blackrock,192,monk,windwalker,6,2,4
Niborc,doomhammer,192,monk,windwalker,6,2,4
Jackonk,eredar,192,monk,windwalker,6,2,4
Zýru,ragnaros,192,monk,windwalker,6,2,4
Dodoglad,hyjal,192,monk,windwalker,6,2,4
Манамба,blackscar,192,monk,windwalker,6,2,4
Schneewase,blackrock,192,monk,windwalker,6,2,4
Drýton,blackrock,192,monk,windwalker,6,2,4
Orcword,ragnaros,192,monk,windwalker,6,2,4
Майамибитч,howling-fjord,192,monk,windwalker,6,2,4
Savecdfornxt,blackmoore,192,monk,windwalker,6,2,4
Píkachuu,ragnaros,192,monk,windwalker,9,2,7
Tongat,ravencrest,192,monk,windwalker,12,2,10
Гнидожор,booty-bay,192,monk,windwalker,12,2,10
Shaow,hyjal,192,monk,windwalker,12,2,10
Lilotus,ragnaros,192,monk,windwalker,12,2,10
Yianjih,blackmoore,191,monk,windwalker,6,2,4
Mashalar,ravencrest,191,monk,windwalker,6,2,4
Crokmoche,archimonde,143,monk,windwalker,3,3,0
Marqinio,archimonde,138,monk,windwalker,9,4,5
Yanmonk,silvermoon,138,monk,windwalker,8,3,5
Astmönk,archimonde,127,monk,windwalker,8,2,6
Uftis,thrall,127,monk,windwalker,8,2,6
Butrinto,hellfire,96,monk,windwalker,6,1,5
Jongoatjones,outland,96,monk,windwalker,6,1,5
Gøsù,antonidas,96,monk,windwalker,6,1,5
Umbrâsyl,ravencrest,96,monk,windwalker,6,1,5
Dìó,tarren-mill,96,monk,windwalker,6,1,5
Mjaweaver,stormscale,96,monk,windwalker,6,1,5
Kazéshini,doomhammer,96,monk,windwalker,6,1,5
Smâsh,blackhand,96,monk,windwalker,6,1,5
Родиер,gordunni,96,monk,windwalker,6,1,5
Kickboxer,burning-legion,96,monk,windwalker,6,1,5
Мяяумяу,gordunni,96,monk,windwalker,6,1,5
Kinføu,hyjal,96,monk,windwalker,6,1,5
Cumspiller,ravencrest,96,monk,windwalker,6,1,5
Sînge,archimonde,96,monk,windwalker,6,1,5
Fistyouslow,kazzak,96,monk,windwalker,6,1,5
Dudulinda,silvermoon,96,monk,windwalker,6,1,5
Harislkwamk,aegwynn,96,monk,windwalker,6,1,5
Musaya,chamber-of-aspects,96,monk,windwalker,6,1,5
Jakaron,kazzak,96,monk,windwalker,6,1,5
Синнэрли,soulflayer,96,monk,windwalker,6,1,5
Chucknøørys,archimonde,96,monk,windwalker,6,1,5
Konnîchîwa,kazzak,96,monk,windwalker,6,1,5
Doneithné,stormscale,96,monk,windwalker,6,1,5
Тиронфлакс,soulflayer,96,monk,windwalker,6,1,5
Gilario,silvermoon,96,monk,windwalker,6,1,5
Olgachocolat,blackmoore,96,monk,windwalker,6,1,5
Zugzuwg,ahnqiraj,96,monk,windwalker,6,1,5
Lîlpumpx,outland,96,monk,windwalker,6,1,5
Salderlol,stormscale,96,monk,windwalker,6,1,5
Mìcrøb,blackmoore,96,monk,windwalker,6,1,5
Dadeldo,blackrock,96,monk,windwalker,6,1,5
Olympeá,silvermoon,96,monk,windwalker,6,1,5
Yvètte,ravencrest,96,monk,windwalker,6,1,5
Tooweezé,outland,96,monk,windwalker,6,1,5
Kaizenthor,runetotem,96,monk,windwalker,6,1,5
Masbrew,ravencrest,96,monk,windwalker,6,1,5
Monkenya,kazzak,96,monk,windwalker,6,1,5
Бумчака,blackscar,96,monk,windwalker,6,1,5
Drlightorc,tarren-mill,96,monk,windwalker,6,1,5
Draina,archimonde,96,monk,windwalker,6,1,5
Nightninja,drakthul,96,monk,windwalker,6,1,5
Yunxi,stormreaver,96,monk,windwalker,6,1,5
Bâsarä,archimonde,96,monk,windwalker,6,1,5
Onisakebi,nemesis,96,monk,windwalker,10,1,9
Chifù,silvermoon,96,monk,windwalker,10,1,9
Deuxmonk,outland,96,monk,windwalker,12,1,11
Araey,argent-dawn,89,monk,windwalker,9,3,6
Xtcc,kazzak,79,monk,windwalker,5,1,4
Odanobunaga,ravencrest,79,monk,windwalker,5,1,4
Tenzen,dun-modr,79,monk,windwalker,11,1,10
Kûma,echsenkessel,64,monk,windwalker,4,1,3
Xámell,ravencrest,48,monk,windwalker,3,1,2
Monkinko,tarren-mill,42,monk,windwalker,10,2,8
Pjetro,draenor,31,monk,windwalker,2,1,1
Makïi,archimonde,31,monk,windwalker,2,1,1
Åbx,argent-dawn,2191,paladin,holy,113,59,54
Wiriday,draenor,2139,paladin,holy,353,183,170
Crewxdlolz,frostmane,2123,paladin,holy,211,118,93
Likkik,ravencrest,2121,paladin,holy,86,42,44
Royki,the-maelstrom,2111,paladin,holy,70,38,32
Алексендлер,howling-fjord,2061,paladin,holy,356,194,162
Ranchiek,ravencrest,2019,paladin,holy,60,31,29
Lickssi,outland,2001,paladin,holy,94,56,38
Nemesisbot,dun-modr,1965,paladin,holy,102,59,43
Zabrok,outland,1964,paladin,holy,70,42,28
Måvé,tarren-mill,1945,paladin,holy,108,63,45
Goyimslayer,ravencrest,1939,paladin,holy,120,64,56
Rekieuna,archimonde,1937,paladin,holy,402,213,189
Jìmjim,ysondre,1916,paladin,holy,114,53,61
Peacerainer,stormscale,1915,paladin,holy,72,32,40
Rïzé,ravencrest,1911,paladin,holy,54,26,28
Odrareg,kazzak,1899,paladin,holy,83,37,46
Seabrook,stormscale,1895,paladin,holy,111,49,62
Galaxys,blackhand,1887,paladin,holy,145,74,71
Aww,anachronos,1874,paladin,holy,150,77,73
Kyoma,burning-legion,1869,paladin,holy,149,70,79
Pointguard,blackrock,1862,paladin,holy,54,28,26
Tipmax,ravencrest,1856,paladin,holy,61,37,24
Goodpeace,kazzak,1855,paladin,holy,73,35,38
Niwariel,silvermoon,1852,paladin,holy,60,37,23
Типмакс,howling-fjord,1851,paladin,holy,42,25,17
Áftershøck,ravencrest,1850,paladin,holy,60,32,28
Powertilt,ravencrest,1848,paladin,holy,159,77,82
Гигашмяк,howling-fjord,1845,paladin,holy,251,135,116
Wheelybin,argent-dawn,1843,paladin,holy,53,23,30
Optîmuslîme,veklor,1835,paladin,holy,42,27,15
Insanez,stormscale,1834,paladin,holy,48,25,23
Shufflenjoyr,argent-dawn,1824,paladin,holy,125,64,61
Phalphlingo,stormscale,1824,paladin,holy,84,40,44
Wokyo,tarren-mill,1823,paladin,holy,231,134,97
Jeø,stormscale,1823,paladin,holy,54,28,26
Eldorín,blackmoore,1823,paladin,holy,54,20,34
Welivewewin,defias-brotherhood,1820,paladin,holy,175,90,85
Kianpal,silvermoon,1818,paladin,holy,158,89,69
Danipaladin,tarren-mill,1817,paladin,holy,88,51,37
Neverlostx,ravencrest,1816,paladin,holy,48,31,17
Popecrusade,archimonde,1813,paladin,holy,107,66,41
Ránchìek,ravencrest,1812,paladin,holy,54,26,28
Majör,ysondre,1809,paladin,holy,66,34,32
Vaîjin,aegwynn,1807,paladin,holy,194,95,99
Jûliâ,archimonde,1802,paladin,holy,94,53,41
Svyata,twisting-nether,1783,paladin,holy,119,56,63
Edelarøs,ysondre,1771,paladin,holy,54,27,27
Гола,gordunni,1771,paladin,holy,97,44,53
Reckx,argent-dawn,1766,paladin,holy,53,26,27
Runtheshôw,tarren-mill,1766,paladin,holy,166,79,87
Holylightxz,runetotem,1765,paladin,holy,93,46,47
Pêacerainer,stormscale,1765,paladin,holy,186,78,108
Pignonn,dalaran,1763,paladin,holy,149,77,72
Макстипчик,howling-fjord,1758,paladin,holy,63,29,34
Ajani,la-croisade-écarlate,1750,paladin,holy,54,23,31
Holysacx,aegwynn,1745,paladin,holy,42,25,17
Rettyfield,blackrock,1744,paladin,holy,42,23,19
Wollymolly,ravencrest,1741,paladin,holy,60,30,30
Everflame,blackmoore,1739,paladin,holy,84,50,34
Dbblou,draenor,1739,paladin,holy,42,20,22
Jüther,pozzo-delleternità,1736,paladin,holy,35,19,16
Vindîcator,defias-brotherhood,1736,paladin,holy,191,91,100
Skyf,outland,1717,paladin,holy,239,116,123
Valia,argent-dawn,1715,paladin,holy,75,40,35
Tyrsa,defias-brotherhood,1715,paladin,holy,53,23,30
Haylø,archimonde,1714,paladin,holy,45,24,21
Stratarxis,kazzak,1714,paladin,holy,82,43,39
Kwinn,aggra-português,1713,paladin,holy,36,18,18
Pigpiss,ravencrest,1707,paladin,holy,46,19,27
Акунделар,gordunni,1706,paladin,holy,125,63,62
Думгохан,howling-fjord,1706,paladin,holy,48,21,27
Аришалисичка,blackscar,1704,paladin,holy,76,38,38
Beefcrusher,outland,1704,paladin,holy,42,18,24
Faíren,mugthol,1697,paladin,holy,66,36,30
Emlight,kazzak,1693,paladin,holy,53,32,21
Фьюжндрайв,gordunni,1693,paladin,holy,36,18,18
Drohim,aegwynn,1688,paladin,holy,46,23,23
Tibælius,ravencrest,1683,paladin,holy,65,33,32
Xaérulus,draenor,1682,paladin,holy,47,26,21
Thaderyl,auchindoun,1678,paladin,holy,168,82,86
Lycerax,antonidas,1677,paladin,holy,42,24,18
Voklane,tarren-mill,1676,paladin,holy,48,23,25
Мылонеуроних,deathguard,1675,paladin,holy,54,26,28
Narkal,archimonde,1672,paladin,holy,99,51,48
Callístó,amanthul,1670,paladin,holy,316,159,157
Holysac,aegwynn,1669,paladin,holy,48,26,22
Isøri,antonidas,1667,paladin,holy,114,58,56
Andûrîl,tarren-mill,1665,paladin,holy,107,54,53
Mðnsterz,archimonde,1661,paladin,holy,54,25,29
Shabbyy,bronzebeard,1659,paladin,holy,102,58,44
Emloses,outland,1653,paladin,holy,330,168,162
Kakii,gorgonnash,1645,paladin,holy,59,24,35
Spinne,tarren-mill,1642,paladin,holy,142,71,71
Itsjulie,sylvanas,1642,paladin,holy,94,46,48
Chosenlight,darkspear,1641,paladin,holy,169,81,88
Powarpufgirl,blackrock,1638,paladin,holy,42,22,20
Faíren,blackrock,1634,paladin,holy,48,22,26
Хегия,gordunni,1633,paladin,holy,48,28,20
Wíw,kazzak,1633,paladin,holy,142,73,69
Мускатер,gordunni,1633,paladin,holy,58,26,32
Baazil,ragnaros,1631,paladin,holy,84,38,46
Chowo,argent-dawn,1631,paladin,holy,63,26,37
Insanevegan,ravencrest,1628,paladin,holy,66,33,33
Marcope,kazzak,1628,paladin,holy,36,17,19
Fleshgraft,silvermoon,1627,paladin,holy,60,31,29
Holeck,aegwynn,1627,paladin,holy,66,26,40
Máttés,antonidas,1626,paladin,holy,59,21,38
Chryme,thrall,1625,paladin,holy,66,36,30
Jeromesavile,tarren-mill,1625,paladin,holy,143,68,75
Lofé,drakthul,1623,paladin,holy,44,22,22
Crucifiction,balnazzar,1623,paladin,holy,60,29,31
Jambbo,twisting-nether,1622,paladin,holy,148,81,67
Dewastor,veklor,1619,paladin,holy,48,25,23
Jcbubs,xavius,1619,paladin,holy,180,91,89
Nezâ,blackhand,1619,paladin,holy,58,26,32
Blazerlolz,kazzak,1616,paladin,holy,60,33,27
Athenewins,tarren-mill,1616,paladin,holy,400,210,190
Crankaess,tarren-mill,1616,paladin,holy,73,37,36
Lexolex,ravencrest,1616,paladin,holy,36,17,19
Papasito,tarren-mill,1616,paladin,holy,48,17,31
Vxqt,blackrock,1614,paladin,holy,53,25,28
Percocetx,tarren-mill,1613,paladin,holy,54,24,30
Buntqt,kazzak,1612,paladin,holy,100,54,46
Jinyssa,silvermoon,1610,paladin,holy,42,25,17
ßestsacjk,kazzak,1610,paladin,holy,54,22,32
Rickstone,kazzak,1609,paladin,holy,42,17,25
Zondãn,blackrock,1608,paladin,holy,95,51,44
Pisr,draenor,1607,paladin,holy,48,21,27
Kaputs,twisting-nether,1606,paladin,holy,31,18,13
Острит,gordunni,1605,paladin,holy,78,45,33
Dömötörp,ragnaros,1604,paladin,holy,135,71,64
Джонниджага,blackscar,1604,paladin,holy,58,28,30
Lexó,ravencrest,1604,paladin,holy,42,20,22
Enemylosers,stormscale,1603,paladin,holy,180,99,81
Kristelle,argent-dawn,1602,paladin,holy,102,55,47
Stepsislana,tarren-mill,1601,paladin,holy,30,17,13
Judgejuryexe,kazzak,1600,paladin,holy,92,44,48
Xray,ahnqiraj,1598,paladin,holy,53,27,26
Лайтпалочка,soulflayer,1596,paladin,holy,334,163,171
Easypala,blackrock,1595,paladin,holy,114,50,64
Дарксайгн,gordunni,1593,paladin,holy,48,17,31
Ìschtarsdad,blackrock,1591,paladin,holy,192,96,96
Сэлфхил,gordunni,1591,paladin,holy,107,47,60
Erathoor,grim-batol,1589,paladin,holy,66,32,34
Astollfo,hyjal,1588,paladin,holy,42,26,16
Gloonî,blackmoore,1588,paladin,holy,47,19,28
Holychît,sanguino,1586,paladin,holy,117,54,63
Smightypal,silvermoon,1582,paladin,holy,123,62,61
Xenyaa,arygos,1581,paladin,holy,103,53,50
Пчелодин,howling-fjord,1581,paladin,holy,36,17,19
Louiepal,outland,1580,paladin,holy,41,25,16
Fourshaw,ravencrest,1578,paladin,holy,167,87,80
Myssa,uldum,1577,paladin,holy,42,21,21
Fannypoo,sylvanas,1574,paladin,holy,215,105,110
Аронасхе,blackscar,1573,paladin,holy,89,39,50
Umirinbruv,zenedar,1573,paladin,holy,50,20,30
Arysur,defias-brotherhood,1566,paladin,holy,332,161,171
Потокденег,howling-fjord,1563,paladin,holy,152,71,81
Nîkå,ravencrest,1561,paladin,holy,109,62,47
Femaleelf,eredar,1561,paladin,holy,48,20,28
Ретриксвета,eversong,1559,paladin,holy,48,31,17
Deodas,kazzak,1555,paladin,holy,293,145,148
Erao,the-maelstrom,1554,paladin,holy,48,24,24
Skurly,ragnaros,1551,paladin,holy,42,19,23
Tibelious,ravencrest,1548,paladin,holy,114,47,67
Pablok,minahonda,1548,paladin,holy,48,17,31
Fløcki,blackhand,1547,paladin,holy,100,54,46
Drdeus,kazzak,1547,paladin,holy,166,85,81
Алукартик,deathguard,1546,paladin,holy,89,44,45
Mistsx,kazzak,1546,paladin,holy,60,27,33
Strûgglebûs,outland,1543,paladin,holy,47,25,22
Срувтапкизз,blackscar,1543,paladin,holy,89,32,57
Cozm,silvermoon,1540,paladin,holy,60,31,29
Asenae,draenor,1540,paladin,holy,72,29,43
Тошанич,soulflayer,1539,paladin,holy,54,24,30
Gasilol,frostwolf,1537,paladin,holy,81,41,40
Andronar,blackmoore,1536,paladin,holy,66,29,37
Nstea,zuljin,1534,paladin,holy,30,16,14
Lóde,silvermoon,1530,paladin,holy,148,77,71
Pooncy,ragnaros,1530,paladin,holy,60,27,33
Sncx,ravencrest,1528,paladin,holy,42,22,20
Бадбх,howling-fjord,1527,paladin,holy,90,39,51
Búbblicioús,ravencrest,1524,paladin,holy,84,49,35
Леонящер,gordunni,1524,paladin,holy,288,157,131
Всехилящий,gordunni,1522,paladin,holy,48,21,27
Devinèqt,tarren-mill,1521,paladin,holy,67,38,29
Aiyäna,argent-dawn,1521,paladin,holy,83,40,43
Marygueguete,archimonde,1518,paladin,holy,108,53,55
Lrnz,tarren-mill,1518,paladin,holy,42,16,26
Dathróhán,silvermoon,1512,paladin,holy,267,135,132
Sorfalinka,silvermoon,1511,paladin,holy,24,17,7
Rotana,eredar,1511,paladin,holy,36,24,12
Selphii,twisting-nether,1511,paladin,holy,40,22,18
Powerpufgirl,blackrock,1511,paladin,holy,36,19,17
Снупарь,blackscar,1509,paladin,holy,138,72,66
Sofishoida,blackmoore,1508,paladin,holy,78,47,31
Sonil,les-sentinelles,1507,paladin,holy,57,24,33
Jaesa,lordaeron,1506,paladin,holy,71,32,39
Ironmikë,outland,1505,paladin,holy,42,24,18
Fatmidget,kazzak,1503,paladin,holy,66,43,23
Aíe,draenor,1503,paladin,holy,81,44,37
Sorfalik,silvermoon,1502,paladin,holy,30,18,12
Astarox,kazzak,1501,paladin,holy,173,74,99
Hawki,blackmoore,1500,paladin,holy,42,23,19
Aese,dun-modr,1499,paladin,holy,102,51,51
Эндемичный,soulflayer,1498,paladin,holy,48,28,20
Rùfus,tarren-mill,1497,paladin,holy,162,84,78
Sübôvîñ,ravencrest,1497,paladin,holy,135,69,66
Foxywild,aszune,1497,paladin,holy,54,24,30
Сатангодх,gordunni,1497,paladin,holy,78,30,48
Delmothounet,ysondre,1496,paladin,holy,46,28,18
Chocòbon,archimonde,1496,paladin,holy,56,32,24
Delicztwo,der-rat-von-dalaran,1490,paladin,holy,30,16,14
Xsÿde,archimonde,1489,paladin,holy,48,17,31
Emistesía,stormscale,1488,paladin,holy,54,24,30
Hirolde,zenedar,1487,paladin,holy,128,61,67
Shaevira,ravencrest,1487,paladin,holy,66,30,36
Elsewhere,archimonde,1487,paladin,holy,47,18,29
Rookbeef,eredar,1486,paladin,holy,42,22,20
Мифариан,blackscar,1486,paladin,holy,135,67,68
Флэшкапро,soulflayer,1485,paladin,holy,208,102,106
Ирестли,azuregos,1480,paladin,holy,78,39,39
Волнысвета,howling-fjord,1479,paladin,holy,82,46,36
Эллиарэй,gordunni,1478,paladin,holy,95,46,49
Tuoppi,steamwheedle-cartel,1478,paladin,holy,90,42,48
Drzärc,sanguino,1478,paladin,holy,60,28,32
Nano,veknilash,1478,paladin,holy,60,27,33
Kfcmanager,archimonde,1478,paladin,holy,36,16,20
Nåmï,culte-de-la-rive-noire,1475,paladin,holy,48,26,22
Stidi,frostmane,1475,paladin,holy,60,24,36
Skinstructor,silvermoon,1473,paladin,holy,72,37,35
Veléxis,outland,1464,paladin,holy,87,45,42
Arenalena,sylvanas,1464,paladin,holy,181,88,93
Брилз,soulflayer,1462,paladin,holy,71,33,38
Curufin,grim-batol,1460,paladin,holy,149,80,69
Jajmentx,kazzak,1459,paladin,holy,78,40,38
Hairybabe,outland,1456,paladin,holy,48,29,19
Nemesi,archimonde,1455,paladin,holy,42,20,22
Konane,drekthar,1454,paladin,holy,37,17,20
Divinetollen,ravencrest,1454,paladin,holy,62,26,36
Realpalla,ravenholdt,1452,paladin,holy,126,62,64
Archaegis,silvermoon,1452,paladin,holy,48,19,29
Luxxorr,outland,1451,paladin,holy,21,17,4
Крусейдор,soulflayer,1450,paladin,holy,91,40,51
Emistesia,stormscale,1448,paladin,holy,47,22,25
Scrimple,stormscale,1447,paladin,holy,73,35,38
Norandel,turalyon,1447,paladin,holy,42,16,26
Mercedes,arthas,1443,paladin,holy,35,20,15
Alessaqas,ravencrest,1443,paladin,holy,63,28,35
Présidential,grim-batol,1441,paladin,holy,59,28,31
Коварное,borean-tundra,1440,paladin,holy,52,25,27
Паладинас,lich-king,1440,paladin,holy,64,21,43
Thaifo,silvermoon,1439,paladin,holy,33,20,13
Глиндес,gordunni,1439,paladin,holy,168,80,88
Уретроград,soulflayer,1436,paladin,holy,72,36,36
Hpal,aegwynn,1435,paladin,holy,123,55,68
Flouzz,blackmoore,1434,paladin,holy,30,15,15
Holydawnx,kazzak,1432,paladin,holy,62,30,32
Tiffanyqt,frostwolf,1428,paladin,holy,24,16,8
Injection,khaz-modan,1428,paladin,holy,87,40,47
Toohotty,archimonde,1428,paladin,holy,53,22,31
Sacbøt,stormscale,1427,paladin,holy,259,132,127
Ekzykes,ravencrest,1427,paladin,holy,48,21,27
Séphiran,hyjal,1426,paladin,holy,53,28,25
Slezz,tarren-mill,1426,paladin,holy,356,184,172
Taiso,alonsus,1422,paladin,holy,132,64,68
Xenaké,kazzak,1421,paladin,holy,155,68,87
Jackieb,dun-modr,1421,paladin,holy,39,16,23
Phalex,outland,1416,paladin,holy,36,23,13
Swâpxy,proudmoore,1414,paladin,holy,24,15,9
Preyy,eredar,1414,paladin,holy,54,30,24
Bécasszelium,varimathras,1414,paladin,holy,165,82,83
Mamporro,dun-modr,1413,paladin,holy,36,19,17
Zilu,kazzak,1413,paladin,holy,47,24,23
Maitrelampe,argent-dawn,1413,paladin,holy,84,42,42
Wepalapvpbop,ravencrest,1413,paladin,holy,30,15,15
Böllerbarbie,silvermoon,1411,paladin,holy,36,21,15
Blazeberg,tirion,1411,paladin,holy,36,20,16
Сашафистинг,gordunni,1411,paladin,holy,159,77,82
Nimeron,ravencrest,1411,paladin,holy,72,30,42
Curtfizzle,kazzak,1411,paladin,holy,65,26,39
Vadomar,emerald-dream,1409,paladin,holy,78,33,45
Ðenlox,destromath,1408,paladin,holy,104,53,51
Дифицит,blackscar,1407,paladin,holy,87,50,37
Rekolon,antonidas,1407,paladin,holy,273,145,128
Aachenbrand,blackhand,1407,paladin,holy,131,55,76
Gzerloth,ragnaros,1407,paladin,holy,36,15,21
Кельдерик,howling-fjord,1406,paladin,holy,45,24,21
Blessedpapi,draenor,1406,paladin,holy,72,32,40
Diamir,rajaxx,1404,paladin,holy,75,55,20
Dimetrix,stormscale,1403,paladin,holy,30,15,15
Beecq,tarren-mill,1402,paladin,holy,54,30,24
Alciera,silvermoon,1402,paladin,holy,54,24,30
Аяпал,blackscar,1401,paladin,holy,72,39,33
Deathsfate,defias-brotherhood,1397,paladin,holy,39,18,21
Грор,galakrond,1395,paladin,holy,79,35,44
Витёнокь,howling-fjord,1394,paladin,holy,44,29,15
Hazø,silvermoon,1394,paladin,holy,48,26,22
Stinkepieet,blackmoore,1390,paladin,holy,48,20,28
Реколори,gordunni,1389,paladin,holy,167,91,76
Эверейс,howling-fjord,1389,paladin,holy,47,22,25
Mestgone,dalaran,1388,paladin,holy,65,30,35
Kantfyrste,ravencrest,1388,paladin,holy,139,59,80
Бэнкли,soulflayer,1387,paladin,holy,78,45,33
Expot,blackmoore,1387,paladin,holy,60,34,26
Moeixu,kazzak,1387,paladin,holy,33,15,18
Fenye,twisting-nether,1386,paladin,holy,68,32,36
Эскейпми,howling-fjord,1385,paladin,holy,35,18,17
Locofatguy,drakthul,1385,paladin,holy,149,70,79
Салфеточник,thermaplugg,1384,paladin,holy,72,28,44
Noliferx,ravencrest,1383,paladin,holy,82,49,33
Cerinae,tarren-mill,1383,paladin,holy,57,26,31
Rullstolen,the-maelstrom,1382,paladin,holy,48,28,20
Artherius,silvermoon,1381,paladin,holy,60,34,26
Cykadin,dun-modr,1380,paladin,holy,72,30,42
Danepala,defias-brotherhood,1378,paladin,holy,59,29,30
Rëtnuhka,drakthul,1378,paladin,holy,50,24,26
Zycqo,silvermoon,1377,paladin,holy,174,84,90
Wingcomandêr,aegwynn,1377,paladin,holy,36,15,21
Бирко,blackscar,1377,paladin,holy,45,17,28
Elvandara,blackmoore,1377,paladin,holy,65,23,42
Gabriev,twisting-nether,1376,paladin,holy,49,25,24
Gimch,magtheridon,1375,paladin,holy,24,15,9
Døgstømper,outland,1370,paladin,holy,29,15,14
Louiepalmoo,outland,1370,paladin,holy,34,17,17
Badckes,sylvanas,1367,paladin,holy,116,54,62
Vivalabeef,stormscale,1367,paladin,holy,60,26,34
Unpal,ravencrest,1366,paladin,holy,42,18,24
Mecah,hyjal,1365,paladin,holy,42,21,21
Pullheavy,silvermoon,1363,paladin,holy,89,38,51
Xelqt,draenor,1361,paladin,holy,36,15,21
Goodbit,dentarg,1360,paladin,holy,59,36,23
Ramos,aggra-português,1360,paladin,holy,60,22,38
Ассантийка,deathguard,1358,paladin,holy,45,21,24
Ostardo,blackhand,1357,paladin,holy,24,15,9
Flowerbud,tarren-mill,1357,paladin,holy,48,23,25
Dlfî,hyjal,1356,paladin,holy,50,30,20
Aebî,dalaran,1355,paladin,holy,42,24,18
Shakalol,dun-modr,1355,paladin,holy,60,23,37
Heilgaharald,blackrock,1351,paladin,holy,110,51,59
Honeygodx,antonidas,1350,paladin,holy,45,24,21
Sixtynien,outland,1350,paladin,holy,54,28,26
Mikemyers,blackhand,1350,paladin,holy,42,20,22
Talimañ,kazzak,1349,paladin,holy,42,23,19
Demonskiller,alakir,1346,paladin,holy,89,47,42
Кольт,borean-tundra,1346,paladin,holy,79,40,39
Nerdpallyx,tarren-mill,1346,paladin,holy,69,28,41
Европпа,soulflayer,1346,paladin,holy,93,30,63
Pussdocta,ravencrest,1345,paladin,holy,89,48,41
Arlette,moonglade,1345,paladin,holy,72,32,40
Nudzolini,tarren-mill,1344,paladin,holy,36,22,14
Derpe,hellscream,1344,paladin,holy,24,14,10
Эсерпи,gordunni,1343,paladin,holy,299,148,151
Jerryhârvey,kazzak,1342,paladin,holy,24,14,10
Ballantine,thunderhorn,1341,paladin,holy,30,18,12
Keele,stormscale,1341,paladin,holy,69,32,37
Expander,draenor,1341,paladin,holy,36,14,22
Vonat,outland,1340,paladin,holy,42,16,26
Shamoo,archimonde,1338,paladin,holy,24,14,10
Рэймондх,gordunni,1338,paladin,holy,24,14,10
Itsgossiplol,twisting-nether,1338,paladin,holy,205,104,101
Freaak,dethecus,1337,paladin,holy,60,24,36
Alphaøne,stormscale,1336,paladin,holy,30,14,16
Lugnals,hyjal,1336,paladin,holy,114,52,62
Holypapa,argent-dawn,1336,paladin,holy,60,27,33
Elians,outland,1336,paladin,holy,54,22,32
Sangriul,outland,1336,paladin,holy,93,37,56
Лимфома,goldrinn,1334,paladin,holy,65,25,40
Anythíng,kazzak,1333,paladin,holy,115,58,57
Alldo,drakthul,1333,paladin,holy,124,58,66
Ztiina,tarren-mill,1332,paladin,holy,60,27,33
Ugolf,kazzak,1331,paladin,holy,78,43,35
Mitsaklas,grim-batol,1331,paladin,holy,150,65,85
Steggeh,argent-dawn,1331,paladin,holy,120,48,72
Lightbrîng,hyjal,1327,paladin,holy,53,26,27
Бэдмэн,deathguard,1327,paladin,holy,53,16,37
Dàrckness,ravencrest,1326,paladin,holy,269,142,127
Lastaid,azshara,1326,paladin,holy,156,73,83
Wrathlol,ravencrest,1325,paladin,holy,195,97,98
Watras,drakthul,1324,paladin,holy,72,26,46
Aytu,blackmoore,1321,paladin,holy,39,19,20
Nde,silvermoon,1320,paladin,holy,47,20,27
Holynstuff,auchindoun,1319,paladin,holy,37,26,11
Даниэль,howling-fjord,1319,paladin,holy,66,36,30
Alard,sanguino,1319,paladin,holy,96,42,54
Maxôr,norgannon,1317,paladin,holy,48,27,21
Öbedö,malganis,1316,paladin,holy,69,34,35
Dogmatic,blackmoore,1316,paladin,holy,30,14,16
Lazyknight,silvermoon,1316,paladin,holy,60,25,35
Crusherpala,laughing-skull,1316,paladin,holy,83,33,50
Neyd,hyjal,1314,paladin,holy,60,21,39
Necrozi,stormscale,1311,paladin,holy,60,35,25
Agadin,ysondre,1310,paladin,holy,35,19,16
Bigfailure,blackmoore,1309,paladin,holy,65,21,44
Bagull,zuljin,1308,paladin,holy,94,45,49
Rookx,stormscale,1308,paladin,holy,66,23,43
Mythsion,blackmoore,1307,paladin,holy,36,16,20
Daizen,blackrock,1306,paladin,holy,67,45,22
Skengdaddy,ragnaros,1306,paladin,holy,84,39,45
Рэймета,soulflayer,1306,paladin,holy,42,16,26
Подлыйдим,fordragon,1303,paladin,holy,84,34,50
Pokébowl,outland,1302,paladin,holy,48,27,21
Evo,drakthul,1301,paladin,holy,55,25,30
Wyllian,grim-batol,1300,paladin,holy,83,44,39
Malodos,archimonde,1299,paladin,holy,62,33,29
Bladê,kazzak,1299,paladin,holy,66,26,40
Keltinne,ysondre,1298,paladin,holy,39,23,16
Noskillze,ravencrest,1298,paladin,holy,24,14,10
Bovinequeef,twisting-nether,1298,paladin,holy,42,21,21
Æmiø,blackmoore,1298,paladin,holy,59,27,32
Lapew,eredar,1297,paladin,holy,27,16,11
Vuup,silvermoon,1295,paladin,holy,44,25,19
Hîfi,blackmoore,1295,paladin,holy,147,80,67
Wernøw,archimonde,1294,paladin,holy,27,14,13
Matagladis,dun-modr,1294,paladin,holy,84,42,42
Îiî,archimonde,1294,paladin,holy,30,14,16
Kerven,doomhammer,1293,paladin,holy,54,22,32
Scholzpala,twisting-nether,1292,paladin,holy,30,18,12
Kapikøoqt,suramar,1291,paladin,holy,151,80,71
Kocovic,tarren-mill,1289,paladin,holy,48,24,24
Alphä,auchindoun,1287,paladin,holy,30,14,16
Dedy,frostwhisper,1286,paladin,holy,47,24,23
Zeratris,defias-brotherhood,1286,paladin,holy,43,20,23
Gegge,kazzak,1285,paladin,holy,50,19,31
Алекхей,gordunni,1282,paladin,holy,66,28,38
Åsaruki,emerald-dream,1281,paladin,holy,42,17,25
Paellysuir,blackmoore,1280,paladin,holy,38,19,19
Ggiwastheret,kazzak,1277,paladin,holy,23,14,9
Arand,blackrock,1275,paladin,holy,63,37,26
Tyktyk,draenor,1275,paladin,holy,42,24,18
Holyfrick,kazzak,1275,paladin,holy,42,17,25
Holyppower,frostmane,1275,paladin,holy,35,14,21
Ärinváyá,defias-brotherhood,1274,paladin,holy,57,33,24
Taligon,arathor,1272,paladin,holy,42,21,21
Albertina,silvermoon,1271,paladin,holy,38,19,19
Mifuttoasort,draenor,1270,paladin,holy,54,26,28
Gucix,sylvanas,1269,paladin,holy,89,37,52
Toradin,thunderhorn,1268,paladin,holy,49,22,27
Делатор,gordunni,1267,paladin,holy,48,22,26
Polydeukis,stormscale,1267,paladin,holy,90,34,56
Trisunonvaki,khazgoroth,1266,paladin,holy,144,78,66
Кузнейц,borean-tundra,1264,paladin,holy,52,18,34
Tíep,blackmoore,1262,paladin,holy,71,36,35
Pajtash,doomhammer,1261,paladin,holy,59,29,30
Bloodsoldier,twisting-nether,1258,paladin,holy,88,45,43
Hotub,twisting-nether,1258,paladin,holy,123,57,66
Bulten,twilights-hammer,1257,paladin,holy,58,18,40
Strudell,terrordar,1254,paladin,holy,60,31,29
Kaitlyne,tarren-mill,1254,paladin,holy,97,49,48
Анбели,gordunni,1252,paladin,holy,60,24,36
Reeley,drakthul,1251,paladin,holy,107,53,54
Ginbeam,aegwynn,1251,paladin,holy,100,48,52
Hogma,hyjal,1250,paladin,holy,36,14,22
Luraa,drakthul,1249,paladin,holy,42,21,21
Alastrr,hyjal,1248,paladin,holy,73,44,29
Opopoï,dalaran,1247,paladin,holy,24,15,9
Рустиктоп,gordunni,1247,paladin,holy,30,13,17
Sheroo,rexxar,1244,paladin,holy,18,13,5
Pupsihasi,kelthuzad,1244,paladin,holy,35,19,16
Valkhana,draenor,1244,paladin,holy,58,29,29
Hÿrrøkk,ysondre,1243,paladin,holy,60,40,20
Paiadinho,malganis,1243,paladin,holy,83,27,56
Tommoffwarrs,archimonde,1241,paladin,holy,73,35,38
Вертуосгодх,soulflayer,1240,paladin,holy,49,24,25
Haros,xavius,1239,paladin,holy,31,16,15
Зондарк,booty-bay,1239,paladin,holy,65,23,42
Neithi,twisting-nether,1238,paladin,holy,42,20,22
Askmy,stormscale,1237,paladin,holy,24,13,11
Aelly,hyjal,1237,paladin,holy,112,56,56
Rookzter,sylvanas,1237,paladin,holy,78,39,39
Skailzpal,hyjal,1236,paladin,holy,36,21,15
Alesiah,blackhand,1235,paladin,holy,61,26,35
Judgealdo,sylvanas,1234,paladin,holy,25,14,11
Nitrous,zuljin,1232,paladin,holy,36,22,14
Jaezlin,tarren-mill,1232,paladin,holy,130,70,60
Neverbuble,archimonde,1231,paladin,holy,76,33,43
Reudi,argent-dawn,1230,paladin,holy,54,28,26
Farata,ravencrest,1230,paladin,holy,160,78,82
Ashbrìnger,aegwynn,1227,paladin,holy,24,13,11
Skolisse,kazzak,1225,paladin,holy,131,69,62
Kherathan,argent-dawn,1225,paladin,holy,42,21,21
Cowvid,grim-batol,1225,paladin,holy,30,13,17
Naenel,dun-modr,1225,paladin,holy,37,16,21
Ninko,sylvanas,1224,paladin,holy,54,29,25
Emilíá,kazzak,1223,paladin,holy,24,13,11
Regis,dragonblight,1223,paladin,holy,74,40,34
Schrikii,archimonde,1221,paladin,holy,66,27,39
Ðeswynd,hyjal,1220,paladin,holy,83,35,48
Lightmachine,kirin-tor,1218,paladin,holy,54,36,18
Baubble,silvermoon,1218,paladin,holy,48,28,20
Pegason,twisting-nether,1218,paladin,holy,49,26,23
Ritiv,stormreaver,1218,paladin,holy,102,46,56
Lianndrin,blackhand,1218,paladin,holy,58,25,33
Aranael,nemesis,1218,paladin,holy,52,21,31
Trastos,wildhammer,1217,paladin,holy,54,28,26
Fleny,thrall,1215,paladin,holy,24,13,11
Paladins,archimonde,1214,paladin,holy,38,20,18
Weserwehr,laughing-skull,1214,paladin,holy,54,27,27
Lightmamba,draenor,1214,paladin,holy,48,16,32
Eline,zenedar,1213,paladin,holy,36,13,23
Cmelacek,wildhammer,1212,paladin,holy,30,18,12
Babybeater,outland,1212,paladin,holy,77,36,41
Lucá,silvermoon,1211,paladin,holy,23,13,10
Ромерл,gordunni,1210,paladin,holy,223,103,120
Святстраж,gordunni,1210,paladin,holy,32,14,18
Johnnydeeps,blackrock,1210,paladin,holy,35,13,22
Johnaggro,outland,1209,paladin,holy,46,23,23
Johnnÿsins,hyjal,1209,paladin,holy,63,28,35
Stuzzyy,ravencrest,1209,paladin,holy,36,16,20
Uzuriel,chogall,1206,paladin,holy,353,159,194
Rébél,argent-dawn,1206,paladin,holy,42,17,25
Нинтендо,grom,1205,paladin,holy,126,53,73
Skarn,pozzo-delleternità,1205,paladin,holy,37,15,22
Satipal,sargeras,1205,paladin,holy,116,45,71
Warkyria,sanguino,1204,paladin,holy,31,15,16
Faildin,arathor,1204,paladin,holy,96,46,50
Xastur,rexxar,1201,paladin,holy,33,17,16
Майдмен,gordunni,1200,paladin,holy,66,37,29
Demecir,twisting-nether,1198,paladin,holy,204,96,108
Tucibi,hyjal,1196,paladin,holy,42,24,18
Trístesse,tarren-mill,1193,paladin,holy,167,86,81
Lightaldo,bladefist,1188,paladin,holy,24,14,10
Holymax,gorgonnash,1188,paladin,holy,45,25,20
Линвэль,gordunni,1188,paladin,holy,27,13,14
Сашокс,gordunni,1188,paladin,holy,54,23,31
Кейлол,soulflayer,1186,paladin,holy,71,31,40
Boric,bloodhoof,1184,paladin,holy,29,16,13
Keryann,argent-dawn,1183,paladin,holy,108,53,55
Pisdez,malganis,1183,paladin,holy,54,24,30
Skwáru,burning-legion,1179,paladin,holy,77,30,47
Фэрплэйн,gordunni,1178,paladin,holy,48,22,26
Kayndornek,ravencrest,1178,paladin,holy,78,35,43
Shiidori,aegwynn,1175,paladin,holy,57,23,34
Kiyam,kelthuzad,1174,paladin,holy,18,13,5
Rhulana,blackrock,1171,paladin,holy,67,41,26
Affiicous,silvermoon,1171,paladin,holy,60,19,41
Dawnforged,stormscale,1170,paladin,holy,78,34,44
Claudîax,kazzak,1170,paladin,holy,81,31,50
Manole,ravencrest,1168,paladin,holy,35,17,18
Цитология,borean-tundra,1166,paladin,holy,39,15,24
Seinz,talnivarr,1165,paladin,holy,66,29,37
Puiçanpal,archimonde,1163,paladin,holy,30,15,15
Elohim,echsenkessel,1163,paladin,holy,154,71,83
Mjabubble,stormscale,1158,paladin,holy,78,44,34
Rivanii,kazzak,1155,paladin,holy,129,60,69
Taraniah,argent-dawn,1154,paladin,holy,71,36,35
Kaki,gorgonnash,1151,paladin,holy,18,12,6
Wedervärdig,twilights-hammer,1151,paladin,holy,54,23,31
Djspresty,ravencrest,1150,paladin,holy,18,12,6
Алексендлерх,soulflayer,1149,paladin,holy,18,12,6
Strykar,aggra-português,1147,paladin,holy,54,27,27
Irefutabila,stormscale,1146,paladin,holy,30,12,18
Crispydixx,draenor,1143,paladin,holy,77,37,40
Eskorbuto,dun-modr,1143,paladin,holy,51,24,27
Trolladincho,twisting-nether,1141,paladin,holy,54,25,29
Gromezrael,elune,1141,paladin,holy,42,19,23
Thickets,argent-dawn,1140,paladin,holy,38,18,20
Naylaeh,draenor,1138,paladin,holy,24,12,12
Kambood,twisting-nether,1138,paladin,holy,165,72,93
Мэйр,howling-fjord,1137,paladin,holy,42,17,25
Yonì,thrall,1136,paladin,holy,18,12,6
Minouminou,archimonde,1136,paladin,holy,24,13,11
Lezoom,draenor,1136,paladin,holy,79,40,39
Slistrash,outland,1135,paladin,holy,71,36,35
Milesteris,medivh,1134,paladin,holy,24,14,10
Cadila,silvermoon,1134,paladin,holy,54,25,29
Mirabol,hyjal,1133,paladin,holy,42,16,26
Jasiv,draenor,1132,paladin,holy,36,14,22
Palix,dalaran,1132,paladin,holy,36,12,24
Ниссида,blackscar,1131,paladin,holy,65,32,33
Dunka,twisting-nether,1130,paladin,holy,130,67,63
Spankmeproof,kazzak,1128,paladin,holy,30,12,18
Yaj,magtheridon,1122,paladin,holy,59,27,32
Zebramann,silvermoon,1121,paladin,holy,48,20,28
Psycholas,ysondre,1118,paladin,holy,29,15,14
Zerfleddern,aegwynn,1118,paladin,holy,149,73,76
Truthbearer,darksorrow,1118,paladin,holy,116,53,63
Striike,drakthul,1117,paladin,holy,29,12,17
Luzcian,zuljin,1117,paladin,holy,46,17,29
Guidone,sylvanas,1116,paladin,holy,30,13,17
Echooes,ravencrest,1116,paladin,holy,237,101,136
Mozzie,archimonde,1116,paladin,holy,158,67,91
Sepha,eonar,1115,paladin,holy,39,21,18
Kanina,outland,1114,paladin,holy,58,23,35
Ithealy,twisting-nether,1113,paladin,holy,60,29,31
Tscheba,kazzak,1109,paladin,holy,82,42,40
Unithral,durotan,1107,paladin,holy,24,12,12
Новирка,deathguard,1107,paladin,holy,48,20,28
Ðelusion,sanguino,1103,paladin,holy,17,12,5
Kaleto,ragnaros,1102,paladin,holy,65,38,27
Paidi,die-todeskrallen,1101,paladin,holy,74,34,40
Джонигодх,gordunni,1100,paladin,holy,21,12,9
Minui,onyxia,1100,paladin,holy,30,12,18
Shoby,silvermoon,1100,paladin,holy,30,12,18
Eastranspal,ravencrest,1096,paladin,holy,36,13,23
Dryntee,blackmoore,1095,paladin,holy,21,13,8
Darkironpala,argent-dawn,1095,paladin,holy,59,28,31
Кукусяшка,gordunni,1094,paladin,holy,32,12,20
Yokurolel,sanguino,1092,paladin,holy,48,29,19
Debts,aggramar,1092,paladin,holy,40,13,27
Stonebeard,ahnqiraj,1088,paladin,holy,81,48,33
Ampoula,ravencrest,1088,paladin,holy,28,12,16
Nosn,ravencrest,1087,paladin,holy,66,34,32
Verianer,shadowsong,1086,paladin,holy,46,27,19
Dabstar,antonidas,1086,paladin,holy,88,41,47
Макспал,lich-king,1085,paladin,holy,22,14,8
Rejst,drakthul,1085,paladin,holy,35,12,23
Ларенси,gordunni,1084,paladin,holy,41,18,23
Ragua,tarren-mill,1082,paladin,holy,66,23,43
Paladzor,twisting-nether,1082,paladin,holy,38,13,25
Poundcake,stormscale,1080,paladin,holy,86,43,43
Darvius,auchindoun,1080,paladin,holy,93,44,49
Ashmaden,tarren-mill,1077,paladin,holy,87,49,38
Mscrabtree,aggramar,1076,paladin,holy,30,13,17
Ðuïvel,grim-batol,1076,paladin,holy,28,12,16
Naliax,ravencrest,1072,paladin,holy,29,12,17
Zeret,twisting-nether,1068,paladin,holy,35,15,20
Bàldur,dalaran,1067,paladin,holy,42,22,20
Paliat,silvermoon,1066,paladin,holy,31,12,19
Vintar,quelthalas,1058,paladin,holy,57,31,26
Feldrøider,nemesis,1057,paladin,holy,60,32,28
Djaléxx,kazzak,1056,paladin,holy,36,11,25
Flashyplays,silvermoon,1055,paladin,holy,36,26,10
Casmira,blackrock,1055,paladin,holy,18,11,7
Palanolmal,dun-modr,1055,paladin,holy,45,22,23
Necrocursed,blackrock,1055,paladin,holy,24,11,13
Zendæ,archimonde,1054,paladin,holy,18,11,7
Palaadschin,festung-der-stürme,1054,paladin,holy,54,25,29
Misarosh,drakthul,1054,paladin,holy,24,11,13
Superalt,archimonde,1052,paladin,holy,18,11,7
Kaktuszfüge,ragnaros,1052,paladin,holy,58,35,23
Nicewar,silvermoon,1052,paladin,holy,58,29,29
Penth,doomhammer,1052,paladin,holy,24,11,13
Thaliasword,sylvanas,1052,paladin,holy,30,11,19
Дезоиль,gordunni,1052,paladin,holy,30,11,19
Billkop,silvermoon,1051,paladin,holy,49,24,25
Borndark,stormscale,1051,paladin,holy,24,11,13
Impro,archimonde,1051,paladin,holy,30,11,19
Whatisapalla,ragnaros,1051,paladin,holy,30,11,19
Скайлайтх,soulflayer,1050,paladin,holy,24,11,13
Pâmê,kazzak,1049,paladin,holy,30,12,18
Mvppaladin,thrall,1048,paladin,holy,12,11,1
Serim,dun-modr,1048,paladin,holy,149,67,82
Rdypaladin,ravencrest,1047,paladin,holy,24,11,13
Høpé,malganis,1046,paladin,holy,86,42,44
Shaggybeard,frostmane,1045,paladin,holy,24,11,13
Cmen,silvermoon,1043,paladin,holy,109,54,55
Grimbold,hellfire,1042,paladin,holy,18,11,7
Паландис,howling-fjord,1042,paladin,holy,54,23,31
Niechepala,grim-batol,1042,paladin,holy,30,11,19
Fearleß,malganis,1041,paladin,holy,18,11,7
Fract,aggramar,1041,paladin,holy,63,32,31
Lènnja,baelgun,1041,paladin,holy,24,11,13
Kuhs,eredar,1038,paladin,holy,59,23,36
Satip,archimonde,1036,paladin,holy,48,31,17
Sheldon,sylvanas,1034,paladin,holy,35,14,21
Çrúsader,frostmane,1032,paladin,holy,36,18,18
Фломастер,gordunni,1031,paladin,holy,66,28,38
Iovä,twisting-nether,1031,paladin,holy,142,54,88
Mowik,archimonde,1030,paladin,holy,72,32,40
Crusadelight,alakir,1026,paladin,holy,134,65,69
Mjølnîr,eredar,1025,paladin,holy,36,12,24
Purificatoru,draenor,1024,paladin,holy,54,26,28
Jessìca,ravenholdt,1020,paladin,holy,54,26,28
Ugurpala,sylvanas,1016,paladin,holy,24,11,13
Darhuun,antonidas,1012,paladin,holy,60,23,37
Mccrit,ravencrest,1011,paladin,holy,37,21,16
Palir,ysondre,1010,paladin,holy,24,11,13
Golldy,burning-legion,1008,paladin,holy,21,12,9
Paliester,stormscale,1007,paladin,holy,18,12,6
Ланиакеа,deathguard,1007,paladin,holy,24,12,12
Zetla,khaz-modan,1001,paladin,holy,40,18,22
Флаила,ashenvale,999,paladin,holy,36,18,18
Hëüss,suramar,998,paladin,holy,23,11,12
Пегая,soulflayer,994,paladin,holy,24,13,11
Buddy,conseil-des-ombres,988,paladin,holy,50,24,26
Marik,argent-dawn,987,paladin,holy,17,11,6
Arkkipiispa,outland,987,paladin,holy,66,32,34
Ryuzu,khazgoroth,985,paladin,holy,41,20,21
Áfx,blackmoore,985,paladin,holy,44,17,27
Первыйпал,blackscar,982,paladin,holy,91,48,43
Cerseï,frostmane,979,paladin,holy,41,13,28
Kpunkpam,dun-modr,976,paladin,holy,44,24,20
Skydor,silvermoon,974,paladin,holy,57,21,36
Fleshoflight,arathor,972,paladin,holy,74,26,48
Leon,veknilash,971,paladin,holy,102,41,61
Pappipala,tarren-mill,967,paladin,holy,25,11,14
Øsirix,archimonde,966,paladin,holy,66,26,40
Rapidforce,kazzak,965,paladin,holy,102,51,51
Ударник,soulflayer,964,paladin,holy,54,30,24
Rafox,malygos,964,paladin,holy,42,17,25
Byoß,ravencrest,960,paladin,holy,18,10,8
Юмэйнару,deepholm,959,paladin,holy,18,10,8
Ozzuum,twisting-nether,959,paladin,holy,18,10,8
Lofotof,silvermoon,958,paladin,holy,12,10,2
Herayo,aegwynn,958,paladin,holy,24,10,14
Whórainzóne,eredar,958,paladin,holy,36,10,26
Kapsloch,twisting-nether,958,paladin,holy,36,10,26
Padraic,scarshield-legion,957,paladin,holy,18,10,8
Demytxx,silvermoon,957,paladin,holy,30,10,20
Rubadubskrub,silvermoon,957,paladin,holy,54,17,37
Crashband,bronzebeard,956,paladin,holy,18,10,8
Shockhoe,tarren-mill,955,paladin,holy,24,10,14
Zymotíx,stormscale,954,paladin,holy,30,10,20
Pb,twilights-hammer,953,paladin,holy,18,10,8
Brøadway,eredar,953,paladin,holy,19,10,9
Roshï,tarren-mill,953,paladin,holy,30,10,20
Iauna,tarren-mill,952,paladin,holy,30,10,20
Runeington,silvermoon,951,paladin,holy,18,10,8
Swungling,outland,951,paladin,holy,18,10,8
Dánn,outland,950,paladin,holy,18,10,8
Dunutunicorn,argent-dawn,950,paladin,holy,18,10,8
Tömmÿ,draenor,950,paladin,holy,52,24,28
Bcrp,ragnaros,950,paladin,holy,30,10,20
Випанк,howling-fjord,949,paladin,holy,155,60,95
Arcanïk,archimonde,949,paladin,holy,30,10,20
Churrucuca,minahonda,948,paladin,holy,33,13,20
Алекссис,blackscar,948,paladin,holy,78,30,48
Tepowze,twisting-nether,947,paladin,holy,18,10,8
Legenda,grim-batol,946,paladin,holy,48,20,28
Tmàc,twisting-nether,946,paladin,holy,36,10,26
Datz,nerathor,943,paladin,holy,24,10,14
Groove,colinas-pardas,941,paladin,holy,34,11,23
Selenaluna,turalyon,941,paladin,holy,42,13,29
Messîah,outland,939,paladin,holy,43,19,24
Colpadeltank,kazzak,939,paladin,holy,54,15,39
Clerik,eredar,936,paladin,holy,88,42,46
Tärkan,chogall,935,paladin,holy,24,10,14
Синрайчик,gordunni,934,paladin,holy,36,16,20
Paladons,darksorrow,933,paladin,holy,41,22,19
Menagron,tarren-mill,932,paladin,holy,31,14,17
Catali,sanguino,931,paladin,holy,115,54,61
Yasmira,frostmourne,930,paladin,holy,30,16,14
Ázot,burning-legion,929,paladin,holy,48,19,29
Djalexx,kazzak,927,paladin,holy,23,10,13
Perpon,exodar,925,paladin,holy,42,16,26
Ridethelight,nemesis,922,paladin,holy,30,15,15
Santtox,dun-modr,919,paladin,holy,34,11,23
Imaturtle,darksorrow,915,paladin,holy,41,10,31
Divinelightz,kazzak,914,paladin,holy,25,14,11
Fifisztos,burning-legion,911,paladin,holy,27,13,14
Scumbakitty,ysondre,911,paladin,holy,29,10,19
Equablex,argent-dawn,910,paladin,holy,20,11,9
Reeceboss,ravencrest,906,paladin,holy,29,12,17
Cøllinz,ragnaros,904,paladin,holy,21,10,11
Heyley,twisting-nether,903,paladin,holy,21,11,10
Khaerhadur,argent-dawn,901,paladin,holy,83,24,59
Míxu,stormreaver,896,paladin,holy,29,12,17
Sweestance,minahonda,895,paladin,holy,230,100,130
Holycoomer,silvermoon,894,paladin,holy,20,10,10
Shakziva,draenor,892,paladin,holy,35,14,21
Amolan,drakthul,888,paladin,holy,115,63,52
Яполковник,gordunni,887,paladin,holy,53,30,23
Aéther,quelthalas,883,paladin,holy,20,11,9
Theisixtus,drakthul,883,paladin,holy,23,12,11
Àkí,blackmoore,883,paladin,holy,35,14,21
Даурия,soulflayer,883,paladin,holy,28,10,18
Nykothpn,ghostlands,881,paladin,holy,59,19,40
Silvers,steamwheedle-cartel,880,paladin,holy,76,22,54
Karnwield,kirin-tor,875,paladin,holy,38,16,22
Likkik,tarren-mill,864,paladin,holy,12,9,3
Profundus,zuluhed,864,paladin,holy,12,9,3
Криптонитх,blackscar,864,paladin,holy,18,9,9
Лайхтни,gordunni,864,paladin,holy,18,9,9
Rezvaya,tarren-mill,864,paladin,holy,24,9,15
Holylightxz,archimonde,864,paladin,holy,24,9,15
Cunix,draenor,863,paladin,holy,12,9,3
Дэнриэль,howling-fjord,863,paladin,holy,24,9,15
Язвавгорле,soulflayer,863,paladin,holy,24,9,15
Évo,drakthul,863,paladin,holy,24,9,15
Этосальвабро,lich-king,863,paladin,holy,32,9,23
Висперок,soulflayer,862,paladin,holy,12,9,3
Yoanie,draenor,862,paladin,holy,12,9,3
Niou,alleria,861,paladin,holy,24,9,15
Mohamedx,tarren-mill,861,paladin,holy,24,9,15
Ванябублгам,soulflayer,861,paladin,holy,24,9,15
Firetorch,twisting-nether,861,paladin,holy,30,9,21
Инблумхх,blackscar,860,paladin,holy,18,9,9
Calipse,outland,860,paladin,holy,24,9,15
Elfaza,uldum,860,paladin,holy,36,9,27
Savitri,drakthul,859,paladin,holy,18,9,9
Bjammin,burning-legion,859,paladin,holy,42,15,27
Toxicmo,kazzak,858,paladin,holy,12,9,3
Palolog,burning-legion,858,paladin,holy,49,10,39
Smirk,aggra-português,857,paladin,holy,12,9,3
Ырбис,soulflayer,857,paladin,holy,22,9,13
Truko,frostwolf,857,paladin,holy,24,9,15
Elganor,hyjal,856,paladin,holy,18,9,9
Lurdz,sylvanas,855,paladin,holy,20,11,9
Ауё,blackscar,855,paladin,holy,24,9,15
Elisiell,turalyon,854,paladin,holy,18,9,9
Degods,ravencrest,854,paladin,holy,18,9,9
Burkaal,antonidas,852,paladin,holy,24,9,15
Qyrija,malganis,845,paladin,holy,18,9,9
Vanghelie,doomhammer,843,paladin,holy,24,11,13
Tarhal,guldan,841,paladin,holy,18,9,9
Veelris,kazzak,825,paladin,holy,72,33,39
Миллагрессия,soulflayer,824,paladin,holy,143,59,84
Odensson,sylvanas,823,paladin,holy,30,9,21
Chantal,gilneas,822,paladin,holy,42,18,24
Mustangs,archimonde,821,paladin,holy,45,15,30
Arabicbomb,archimonde,819,paladin,holy,23,9,14
Salubrifie,archimonde,817,paladin,holy,18,9,9
Syrenia,die-silberne-hand,814,paladin,holy,40,9,31
Pepegasensei,ravencrest,805,paladin,holy,19,10,9
Marcosaurio,stormscale,800,paladin,holy,28,9,19
Bbcanalyzed,blackmoore,798,paladin,holy,32,10,22
Autyzmterror,silvermoon,795,paladin,holy,38,9,29
Lèonarth,pozzo-delleternità,794,paladin,holy,22,10,12
Pölark,archimonde,790,paladin,holy,41,14,27
Palafrugell,sanguino,789,paladin,holy,32,13,19
Oscardrei,norgannon,786,paladin,holy,30,10,20
Халлейя,gordunni,768,paladin,holy,12,8,4
Meldi,dalaran,768,paladin,holy,12,8,4
Gayestpala,ravencrest,768,paladin,holy,18,8,10
Imapala,tarren-mill,767,paladin,holy,12,8,4
Ivailo,outland,767,paladin,holy,12,8,4
Darkoulipal,ravencrest,767,paladin,holy,12,8,4
Demytx,burning-legion,767,paladin,holy,16,9,7
Micrøsi,thrall,767,paladin,holy,18,8,10
Shiøn,zuljin,767,paladin,holy,18,8,10
Defnotsikaan,blackhand,767,paladin,holy,18,8,10
Qpax,twisting-nether,767,paladin,holy,18,8,10
Spårvagn,draenor,767,paladin,holy,24,8,16
Bezvakost,thunderhorn,766,paladin,holy,18,8,10
Tytharion,silvermoon,766,paladin,holy,18,8,10
Бебралом,howling-fjord,766,paladin,holy,18,8,10
Thudor,ravencrest,766,paladin,holy,27,9,18
Môdhân,archimonde,765,paladin,holy,12,8,4
Coopz,defias-brotherhood,765,paladin,holy,18,8,10
Bighammerx,ravencrest,765,paladin,holy,18,8,10
Анофарин,gordunni,765,paladin,holy,18,8,10
Спэнсэр,gordunni,764,paladin,holy,12,8,4
Даняхгод,gordunni,763,paladin,holy,18,8,10
Syfaria,eldrethalas,761,paladin,holy,18,8,10
Ikbenmani,tarren-mill,760,paladin,holy,18,8,10
Galadørn,elune,760,paladin,holy,24,8,16
Wrede,the-maelstrom,760,paladin,holy,24,8,16
Эвердрим,soulflayer,756,paladin,holy,30,12,18
Kubrat,eredar,740,paladin,holy,84,28,56
Оберинмартел,blackscar,731,paladin,holy,18,8,10
Amnésía,twisting-nether,728,paladin,holy,23,8,15
Anemonaa,argent-dawn,722,paladin,holy,18,8,10
Pallnatoke,silvermoon,711,paladin,holy,29,9,20
Ubiquitous,kazzak,700,paladin,holy,23,8,15
Kárlsberg,aegwynn,683,paladin,holy,32,13,19
Аидахо,gordunni,679,paladin,holy,31,12,19
Yimnotprot,ravencrest,672,paladin,holy,12,7,5
Gigajudge,blackrock,672,paladin,holy,12,7,5
Электрокинг,lich-king,672,paladin,holy,12,7,5
Babaluga,blackrock,672,paladin,holy,12,7,5
Gtgpiscine,kirin-tor,672,paladin,holy,12,7,5
Sínístèr,kazzak,672,paladin,holy,12,7,5
Minpaladin,aegwynn,672,paladin,holy,16,8,8
Léinãd,kazzak,672,paladin,holy,18,7,11
Djalex,kazzak,672,paladin,holy,18,7,11
Нетораре,howling-fjord,672,paladin,holy,18,7,11
Вивай,howling-fjord,672,paladin,holy,18,7,11
Achtfufzig,eredar,672,paladin,holy,18,7,11
Istani,twisting-nether,672,paladin,holy,18,7,11
Wizqy,ravencrest,672,paladin,holy,18,7,11
Cahirs,ravencrest,672,paladin,holy,24,7,17
Obviously,echsenkessel,672,paladin,holy,24,7,17
Rápunzél,blackmoore,671,paladin,holy,12,7,5
Daddysiliam,ravencrest,671,paladin,holy,12,7,5
Хоулик,howling-fjord,671,paladin,holy,18,7,11
Ämkaz,archimonde,671,paladin,holy,18,7,11
Skatiaringos,silvermoon,671,paladin,holy,18,7,11
Hampoof,blackrock,671,paladin,holy,18,7,11
Ownkas,kazzak,670,paladin,holy,12,7,5
Hølymaid,blackmoore,670,paladin,holy,12,7,5
Pârabellum,the-maelstrom,670,paladin,holy,18,7,11
Tyrallan,ragnaros,670,paladin,holy,24,7,17
Videogame,twilights-hammer,669,paladin,holy,12,7,5
Avengers,sylvanas,669,paladin,holy,12,7,5
Med,malganis,669,paladin,holy,18,7,11
Luckies,drakthul,668,paladin,holy,12,7,5
Holyhooves,thrall,667,paladin,holy,12,7,5
Eledhwen,mannoroth,667,paladin,holy,12,7,5
Edwín,tichondrius,667,paladin,holy,12,7,5
Luminix,ragnaros,667,paladin,holy,12,7,5
Koreanpistol,aegwynn,667,paladin,holy,19,7,12
Рамго,grom,665,paladin,holy,12,7,5
Leadfoot,argent-dawn,665,paladin,holy,24,7,17
Juicemachine,silvermoon,663,paladin,holy,12,7,5
Oswoldio,ravencrest,659,paladin,holy,24,7,17
Langibo,malfurion,658,paladin,holy,12,7,5
Strugglebusx,outland,650,paladin,holy,19,9,10
Finpála,kul-tiras,648,paladin,holy,13,9,4
Jargot,antonidas,645,paladin,holy,18,7,11
Rezilience,archimonde,639,paladin,holy,10,7,3
Kansenbass,outland,637,paladin,holy,17,7,10
Кизарыч,galakrond,624,paladin,holy,33,7,26
Торсгард,howling-fjord,622,paladin,holy,15,8,7
Meive,sanguino,622,paladin,holy,17,7,10
Yezel,dalaran,621,paladin,holy,17,7,10
Bonsamedi,garona,620,paladin,holy,27,8,19
Djozeeph,burning-legion,618,paladin,holy,11,7,4
Fluentx,ravencrest,618,paladin,holy,22,8,14
Gunshøtx,archimonde,616,paladin,holy,28,10,18
Пауэрлайт,blackscar,610,paladin,holy,34,9,25
Catsnek,darksorrow,590,paladin,holy,19,7,12
Дантепаладос,soulflayer,583,paladin,holy,49,7,42
Holyfuchsia,ravencrest,576,paladin,holy,12,6,6
Жухолова,howling-fjord,576,paladin,holy,12,6,6
Держинский,gordunni,576,paladin,holy,12,6,6
Nefarius,malganis,576,paladin,holy,12,6,6
Roqu,nathrezim,576,paladin,holy,12,6,6
Ajany,blackmoore,576,paladin,holy,12,6,6
Bubblig,silvermoon,576,paladin,holy,12,6,6
Kiingen,ragnaros,576,paladin,holy,12,6,6
Iîvîl,ravencrest,576,paladin,holy,12,6,6
Bapêe,thrall,576,paladin,holy,12,6,6
Verlinya,archimonde,576,paladin,holy,12,6,6
Хохахо,howling-fjord,576,paladin,holy,12,6,6
Nádrüstál,kazzak,576,paladin,holy,12,6,6
Ben,ghostlands,576,paladin,holy,12,6,6
Fahqmeh,thrall,576,paladin,holy,12,6,6
Linnea,kazzak,576,paladin,holy,18,6,12
Westranspal,ravencrest,576,paladin,holy,18,6,12
Демига,ashenvale,576,paladin,holy,18,6,12
Amôn,outland,576,paladin,holy,28,6,22
Heldarim,ysondre,576,paladin,holy,36,6,30
Rohanan,blackrock,575,paladin,holy,12,6,6
Dragonwingz,kazzak,575,paladin,holy,12,6,6
Omgsoholy,stormscale,575,paladin,holy,12,6,6
Friendadin,chamber-of-aspects,575,paladin,holy,12,6,6
Cóól,cthun,575,paladin,holy,12,6,6
Kraajp,stormscale,575,paladin,holy,12,6,6
Lichbörnè,outland,575,paladin,holy,18,6,12
Pussas,burning-legion,575,paladin,holy,18,6,12
Холиэвил,gordunni,575,paladin,holy,18,6,12
Zodshock,stormscale,575,paladin,holy,18,6,12
Jeyløl,antonidas,574,paladin,holy,12,6,6
Masuroc,antonidas,574,paladin,holy,12,6,6
Talies,ravencrest,574,paladin,holy,12,6,6
Holyherb,the-maelstrom,574,paladin,holy,12,6,6
Elsirosel,dun-modr,574,paladin,holy,12,6,6
Nezrus,dun-modr,574,paladin,holy,18,6,12
Darthdin,stormscale,572,paladin,holy,12,6,6
Rosemary,mugthol,570,paladin,holy,12,6,6
Mýv,archimonde,568,paladin,holy,24,6,18
Gaskohle,blackmoore,543,paladin,holy,17,6,11
Nam,culte-de-la-rive-noire,527,paladin,holy,11,6,5
Heavel,thrall,527,paladin,holy,17,6,11
Elp,ysondre,526,paladin,holy,15,6,9
Dragg,kirin-tor,522,paladin,holy,17,8,9
Hearten,outland,512,paladin,holy,10,6,4
Holÿbeard,ravencrest,495,paladin,holy,19,6,13
Teksor,frostmourne,480,paladin,holy,6,5,1
Tejbzx,blackmoore,480,paladin,holy,6,5,1
Abroxis,alleria,480,paladin,holy,6,5,1
Athàs,ysondre,480,paladin,holy,6,5,1
Deliveröö,silvermoon,480,paladin,holy,6,5,1
Shinesalot,kazzak,480,paladin,holy,6,5,1
Æffy,nemesis,480,paladin,holy,6,5,1
Bossedin,aszune,480,paladin,holy,12,5,7
Sweetjane,deathwing,480,paladin,holy,12,5,7
Kîsyhrâ,aegwynn,480,paladin,holy,12,5,7
Ethurospal,tarren-mill,480,paladin,holy,12,5,7
Holdmybible,the-maelstrom,480,paladin,holy,12,5,7
Sumecbtw,aegwynn,480,paladin,holy,12,5,7
Plaeschrmaex,aegwynn,480,paladin,holy,12,5,7
Docoùla,twisting-nether,480,paladin,holy,12,5,7
Stierchen,aegwynn,480,paladin,holy,12,5,7
Înphy,cthun,480,paladin,holy,12,5,7
Dimdon,silvermoon,480,paladin,holy,12,5,7
Ÿani,argent-dawn,480,paladin,holy,12,5,7
Astridx,kazzak,480,paladin,holy,12,5,7
Ornosh,draenor,480,paladin,holy,12,5,7
Listina,twisting-nether,480,paladin,holy,12,5,7
Diffay,tarren-mill,480,paladin,holy,12,5,7
Chodegobbler,draenor,480,paladin,holy,12,5,7
Alennya,dalaran,480,paladin,holy,12,5,7
Аффикстинка,soulflayer,480,paladin,holy,12,5,7
Drdeus,silvermoon,480,paladin,holy,12,5,7
Justix,arathor,480,paladin,holy,12,5,7
Morthiel,burning-blade,480,paladin,holy,12,5,7
Fluv,ravencrest,480,paladin,holy,12,5,7
Lezin,thrall,480,paladin,holy,12,5,7
Holydeals,silvermoon,480,paladin,holy,12,5,7
Padrak,eredar,480,paladin,holy,12,5,7
Санэрдин,soulflayer,480,paladin,holy,12,5,7
Zunis,jaedenar,480,paladin,holy,12,5,7
Glassbaren,draenor,480,paladin,holy,12,5,7
Zaphiri,pozzo-delleternità,480,paladin,holy,12,5,7
Fotmfactory,burning-blade,480,paladin,holy,12,5,7
Snoogléface,grim-batol,480,paladin,holy,14,5,9
Katsümï,archimonde,480,paladin,holy,18,5,13
Холидугги,howling-fjord,480,paladin,holy,18,5,13
Holydhanas,outland,480,paladin,holy,18,5,13
Conker,malganis,480,paladin,holy,18,5,13
Screws,dun-modr,480,paladin,holy,18,5,13
Ãgra,hyjal,480,paladin,holy,18,5,13
Palagrom,kazzak,480,paladin,holy,18,5,13
Дюве,blackscar,480,paladin,holy,18,5,13
Omgimapala,kazzak,480,paladin,holy,20,5,15
Polixeni,draenor,480,paladin,holy,24,5,19
Vilcochon,kaelthas,479,paladin,holy,6,5,1
Руслаанеш,soulflayer,479,paladin,holy,12,5,7
Малимон,soulflayer,479,paladin,holy,12,5,7
Dreamwatcher,outland,479,paladin,holy,12,5,7
Paluladin,turalyon,479,paladin,holy,12,5,7
Лазуриса,deathguard,479,paladin,holy,12,5,7
Spacepal,archimonde,479,paladin,holy,12,5,7
Stinkytoes,draenor,479,paladin,holy,12,5,7
Gavril,bloodfeather,479,paladin,holy,12,5,7
Axpala,ragnaros,479,paladin,holy,12,5,7
Erthelios,silvermoon,479,paladin,holy,17,5,12
Vulgati,kazzak,479,paladin,holy,18,5,13
Sultaani,ravencrest,479,paladin,holy,18,5,13
Hùrikan,hyjal,479,paladin,holy,18,5,13
Bellamy,vashj,479,paladin,holy,18,5,13
Brölin,sanguino,479,paladin,holy,18,5,13
Khalicies,archimonde,479,paladin,holy,30,5,25
Omnimus,draenor,478,paladin,holy,6,5,1
Radhya,sargeras,478,paladin,holy,12,5,7
Bubblegum,dentarg,478,paladin,holy,18,5,13
Kaedena,kaelthas,476,paladin,holy,12,5,7
Styflor,dalaran,476,paladin,holy,18,5,13
Grayscale,dun-morogh,476,paladin,holy,18,5,13
Cenox,antonidas,475,paladin,holy,12,5,7
Palabel,blackrock,475,paladin,holy,24,5,19
Alone,sporeggar,473,paladin,holy,12,5,7
Лералучшая,gordunni,464,paladin,holy,19,7,12
Árcangel,minahonda,447,paladin,holy,17,5,12
Himmelsfuror,proudmoore,445,paladin,holy,17,5,12
Bämbunga,madmortem,426,paladin,holy,16,6,10
Memewings,tarren-mill,426,paladin,holy,23,7,16
Тейдехан,gordunni,426,paladin,holy,21,6,15
Battalgazi,azjolnerub,423,paladin,holy,23,7,16
Ralo,shattrath,415,paladin,holy,16,5,11
Exødus,defias-brotherhood,414,paladin,holy,14,5,9
Superpopa,twisting-nether,400,paladin,holy,13,5,8
Idontknow,nemesis,384,paladin,holy,6,4,2
Bloednicht,dentarg,384,paladin,holy,6,4,2
Ринрэи,howling-fjord,384,paladin,holy,6,4,2
Ellisdee,kazzak,384,paladin,holy,6,4,2
Wiffy,ravencrest,384,paladin,holy,6,4,2
Pastabianco,ravencrest,384,paladin,holy,6,4,2
Rikiji,ravencrest,384,paladin,holy,6,4,2
Wontbubblejk,tarren-mill,384,paladin,holy,6,4,2
Kesq,ravencrest,384,paladin,holy,6,4,2
Chewwaka,bloodhoof,384,paladin,holy,6,4,2
Bjôrnstad,ravencrest,384,paladin,holy,6,4,2
Shaleq,cthun,384,paladin,holy,12,4,8
Waldpaladin,malganis,384,paladin,holy,12,4,8
Superkudden,kazzak,384,paladin,holy,12,4,8
Freý,ravencrest,384,paladin,holy,12,4,8
Psikatchuu,hyjal,384,paladin,holy,12,4,8
Akazâ,ysondre,384,paladin,holy,12,4,8
Fedaikin,stormscale,384,paladin,holy,12,4,8
Mooderna,ravencrest,384,paladin,holy,12,4,8
Hammarfall,ravencrest,384,paladin,holy,12,4,8
Visersion,tarren-mill,384,paladin,holy,12,4,8
Bimylover,archimonde,384,paladin,holy,12,4,8
Brüllt,dun-modr,384,paladin,holy,12,4,8
Victwo,burning-legion,384,paladin,holy,12,4,8
Nobodycanxit,twisting-nether,384,paladin,holy,12,4,8
Vânwêêd,thrall,384,paladin,holy,12,4,8
Sebatrøz,ravencrest,384,paladin,holy,12,4,8
Бладиполи,soulflayer,384,paladin,holy,12,4,8
Tyrø,ravencrest,384,paladin,holy,12,4,8
Êggsy,grim-batol,384,paladin,holy,12,4,8
Madlightsxd,dun-modr,384,paladin,holy,12,4,8
Tharelion,twisting-nether,384,paladin,holy,12,4,8
Chopocrisp,dun-modr,384,paladin,holy,12,4,8
Pristín,blackhand,384,paladin,holy,12,4,8
Shívah,auchindoun,384,paladin,holy,12,4,8
Небулариум,howling-fjord,384,paladin,holy,12,4,8
Imitrex,hyjal,384,paladin,holy,12,4,8
Jokkepaappa,darksorrow,384,paladin,holy,12,4,8
Padisonmeth,blackmoore,384,paladin,holy,12,4,8
Divinemove,stormscale,384,paladin,holy,12,4,8
Сакон,borean-tundra,384,paladin,holy,18,4,14
Талрэн,howling-fjord,384,paladin,holy,18,4,14
Лортремар,howling-fjord,384,paladin,holy,18,4,14
Elfaza,dun-modr,384,paladin,holy,18,4,14
Gardaken,draenor,384,paladin,holy,18,4,14
Taxpayer,aegwynn,384,paladin,holy,24,4,20
Гниленький,razuvious,384,paladin,holy,24,4,20
Tôra,hyjal,383,paladin,holy,6,4,2
Uoloop,kazzak,383,paladin,holy,12,4,8
Anfe,silvermoon,383,paladin,holy,12,4,8
Thorhum,moonglade,383,paladin,holy,12,4,8
Rôlfzukowzky,guldan,383,paladin,holy,12,4,8
Ênmâ,archimonde,383,paladin,holy,12,4,8
Aggressìon,twisting-nether,383,paladin,holy,12,4,8
Кэлви,blackscar,383,paladin,holy,12,4,8
Caumon,los-errantes,383,paladin,holy,12,4,8
Duine,the-venture-co,383,paladin,holy,12,4,8
Grafes,sanguino,383,paladin,holy,12,4,8
Allesandra,antonidas,383,paladin,holy,12,4,8
Nyryon,ysondre,383,paladin,holy,18,4,14
Superpaladin,draenor,383,paladin,holy,18,4,14
Scissors,dun-morogh,383,paladin,holy,18,4,14
Mortalitis,tarren-mill,383,paladin,holy,30,4,26
Avengilo,silvermoon,382,paladin,holy,12,4,8
Овахус,soulflayer,382,paladin,holy,12,4,8
Thranduïl,tarren-mill,382,paladin,holy,18,4,14
Nêkro,dun-modr,382,paladin,holy,18,4,14
Preamx,blackrock,367,paladin,holy,11,4,7
Konpala,blackmoore,367,paladin,holy,11,4,7
Justyowx,archimonde,352,paladin,holy,16,5,11
Xe,kaelthas,352,paladin,holy,16,4,12
Browario,burning-legion,351,paladin,holy,11,4,7
Soulskin,sylvanas,350,paladin,holy,11,4,7
Liadry,sylvanas,329,paladin,holy,16,5,11
Ysnee,sanguino,320,paladin,holy,16,4,12
Tyralia,archimonde,288,paladin,holy,6,3,3
Wäsabi,khaz-modan,288,paladin,holy,6,3,3
Nikcsy,ragnaros,288,paladin,holy,6,3,3
Tacodin,blackrock,288,paladin,holy,6,3,3
Bandrogina,shattered-hand,288,paladin,holy,6,3,3
Jogging,thrall,288,paladin,holy,6,3,3
Mearsheimer,ysondre,288,paladin,holy,6,3,3
Tadjmahal,ravencrest,288,paladin,holy,6,3,3
Zunis,ravencrest,288,paladin,holy,6,3,3
Trudi,arthas,288,paladin,holy,6,3,3
Tyn,dragonmaw,288,paladin,holy,6,3,3
Íva,twisting-nether,288,paladin,holy,6,3,3
Kiwia,burning-legion,288,paladin,holy,6,3,3
Naiconpala,kazzak,288,paladin,holy,6,3,3
Гиркин,ashenvale,288,paladin,holy,6,3,3
Solumon,gorgonnash,288,paladin,holy,6,3,3
Unhittable,draenor,288,paladin,holy,6,3,3
Yungboii,kazzak,288,paladin,holy,6,3,3
Nidaime,zuljin,288,paladin,holy,6,3,3
Lunalovesyou,blackmoore,288,paladin,holy,6,3,3
Belzepal,blackrock,288,paladin,holy,6,3,3
Holynoby,kazzak,288,paladin,holy,6,3,3
Penthxoxo,outland,288,paladin,holy,6,3,3
Vôltuxx,outland,288,paladin,holy,6,3,3
Ramels,hyjal,288,paladin,holy,6,3,3
Gulyas,tarren-mill,288,paladin,holy,6,3,3
Runtheshow,deathwing,288,paladin,holy,10,4,6
Lògàn,pozzo-delleternità,288,paladin,holy,9,3,6
Tyraïa,archimonde,288,paladin,holy,12,3,9
Влажныйбоб,soulflayer,288,paladin,holy,12,3,9
Azthin,outland,288,paladin,holy,12,3,9
Monaatamis,kazzak,288,paladin,holy,12,3,9
Kelmarr,blackmoore,288,paladin,holy,12,3,9
Arbuzno,draenor,288,paladin,holy,12,3,9
Daneyholy,ravencrest,288,paladin,holy,12,3,9
Telarii,die-nachtwache,288,paladin,holy,12,3,9
Jctp,ravencrest,288,paladin,holy,12,3,9
Chusterb,draenor,288,paladin,holy,12,3,9
Vissticks,nagrand,288,paladin,holy,12,3,9
Гуэргос,gordunni,288,paladin,holy,12,3,9
Krayzier,nordrassil,288,paladin,holy,12,3,9
Lifthorn,twisting-nether,288,paladin,holy,12,3,9
Баблейми,gordunni,288,paladin,holy,12,3,9
Bigdamjudge,argent-dawn,288,paladin,holy,12,3,9
Breez,die-aldor,288,paladin,holy,12,3,9
Hotchíck,outland,288,paladin,holy,12,3,9
Zerohour,kilrogg,288,paladin,holy,12,3,9
Linxo,argent-dawn,288,paladin,holy,12,3,9
Nÿwa,temple-noir,288,paladin,holy,12,3,9
Kaelorian,silvermoon,288,paladin,holy,18,3,15
Averyholycow,the-maelstrom,287,paladin,holy,6,3,3
Toxií,argent-dawn,287,paladin,holy,12,3,9
Auliæ,chogall,287,paladin,holy,12,3,9
Kcore,blackrock,287,paladin,holy,12,3,9
Jellish,argent-dawn,287,paladin,holy,12,3,9
Faustan,rexxar,287,paladin,holy,12,3,9
Järnkroken,tarren-mill,287,paladin,holy,13,3,10
Biót,tarren-mill,287,paladin,holy,18,3,15
Мерасфард,howling-fjord,287,paladin,holy,18,3,15
Zàrílâ,dun-morogh,286,paladin,holy,6,3,3
Belgblue,ravenholdt,286,paladin,holy,6,3,3
Lorithias,sargeras,286,paladin,holy,12,3,9
Flamxd,blackmoore,234,paladin,holy,10,5,5
Тамерланх,gordunni,234,paladin,holy,9,4,5
Xila,blackrock,234,paladin,holy,9,4,5
Mustardio,tarren-mill,234,paladin,holy,14,4,10
Dewastør,blackmoore,234,paladin,holy,15,4,11
Zeiserig,antonidas,234,paladin,holy,17,4,13
Faranume,sylvanas,233,paladin,holy,16,4,12
Elrack,blackhand,192,paladin,holy,6,2,4
Heilbuch,durotan,192,paladin,holy,6,2,4
Rane,arthas,192,paladin,holy,6,2,4
Durnell,sylvanas,192,paladin,holy,6,2,4
Eim,moonglade,192,paladin,holy,6,2,4
Fruitschaal,moonglade,192,paladin,holy,6,2,4
Tsomoo,antonidas,192,paladin,holy,6,2,4
Keyla,los-errantes,192,paladin,holy,6,2,4
Defianze,tarren-mill,192,paladin,holy,6,2,4
Wvwwvwvwvwwv,ravencrest,192,paladin,holy,6,2,4
Realdeal,argent-dawn,192,paladin,holy,6,2,4
Palidi,tarren-mill,192,paladin,holy,6,2,4
Pagadi,blackhand,192,paladin,holy,6,2,4
Прожектор,gordunni,192,paladin,holy,6,2,4
Palaneuía,antonidas,192,paladin,holy,6,2,4
Böbble,twisting-nether,192,paladin,holy,6,2,4
Yuz,archimonde,192,paladin,holy,6,2,4
Poonky,dun-modr,192,paladin,holy,6,2,4
Benedikt,stormscale,192,paladin,holy,6,2,4
Lacertosus,nemesis,192,paladin,holy,6,2,4
Bàrlo,kazzak,192,paladin,holy,6,2,4
Edyk,silvermoon,192,paladin,holy,6,2,4
Pátish,terenas,192,paladin,holy,6,2,4
Skølir,rashgarroth,192,paladin,holy,6,2,4
Холлихэйт,howling-fjord,192,paladin,holy,6,2,4
Superpiniouf,archimonde,192,paladin,holy,6,2,4
Galadrion,dun-modr,192,paladin,holy,6,2,4
Unstobubblex,burning-blade,192,paladin,holy,6,2,4
Teflonmagìc,ravencrest,192,paladin,holy,6,2,4
Solazola,blackmoore,192,paladin,holy,6,2,4
Rulîx,blackmoore,192,paladin,holy,6,2,4
Alisonquínn,defias-brotherhood,192,paladin,holy,6,2,4
Lompe,karazhan,192,paladin,holy,6,2,4
Lafrogge,culte-de-la-rive-noire,192,paladin,holy,6,2,4
Envli,ragnaros,192,paladin,holy,6,2,4
Dafukx,ragnaros,192,paladin,holy,6,2,4
Ришардебюр,soulflayer,192,paladin,holy,6,2,4
Schukka,azshara,192,paladin,holy,6,2,4
Xirôs,zirkel-des-cenarius,192,paladin,holy,6,2,4
Botaref,kazzak,192,paladin,holy,6,2,4
Lxvideoscom,blackrock,192,paladin,holy,6,2,4
Holysac,kazzak,192,paladin,holy,6,2,4
Kapigentil,suramar,192,paladin,holy,6,2,4
Nirvanä,drakthul,192,paladin,holy,6,2,4
Edgï,confrérie-du-thorium,192,paladin,holy,6,2,4
Bígmachine,draenor,192,paladin,holy,6,2,4
Andokaî,blackrock,192,paladin,holy,6,2,4
Archîmondê,marécage-de-zangar,192,paladin,holy,6,2,4
Паблойд,deathguard,192,paladin,holy,6,2,4
Вишенций,howling-fjord,192,paladin,holy,12,2,10
Bala,ravenholdt,192,paladin,holy,12,2,10
Bígpumprz,archimonde,192,paladin,holy,12,2,10
Essina,argent-dawn,192,paladin,holy,12,2,10
Pichuflor,sanguino,192,paladin,holy,12,2,10
Tsukaima,uldaman,192,paladin,holy,12,2,10
Týr,forscherliga,192,paladin,holy,12,2,10
Zeleron,darksorrow,192,paladin,holy,12,2,10
Uldurin,ravencrest,192,paladin,holy,12,2,10
Aienest,ragnaros,192,paladin,holy,12,2,10
Keft,twisting-nether,192,paladin,holy,12,2,10
Krièr,aggra-português,192,paladin,holy,12,2,10
Ucu,terokkar,192,paladin,holy,12,2,10
Kÿsse,hyjal,192,paladin,holy,12,2,10
Theodun,xavius,192,paladin,holy,12,2,10
Croptol,dun-modr,192,paladin,holy,12,2,10
Кирюшафридом,gordunni,192,paladin,holy,13,2,11
Bjutiful,silvermoon,192,paladin,holy,15,2,13
Eky,stormreaver,192,paladin,holy,18,2,16
Blancucky,kazzak,192,paladin,holy,18,2,16
Getblessed,rexxar,192,paladin,holy,18,2,16
Harycon,thrall,192,paladin,holy,24,2,22
Jeunepadawan,dalaran,191,paladin,holy,6,2,4
Aodren,varimathras,191,paladin,holy,6,2,4
Tiboeufpéi,archimonde,191,paladin,holy,6,2,4
Zuplex,deathwing,191,paladin,holy,6,2,4
Chasie,antonidas,191,paladin,holy,12,2,10
Droseros,sylvanas,175,paladin,holy,23,2,21
Arshlicht,frostwolf,159,paladin,holy,5,2,3
Orogerrabbit,archimonde,144,paladin,holy,3,3,0
Drylink,kazzak,138,paladin,holy,11,3,8
Pïñkñætðøðÿ,tarren-mill,138,paladin,holy,14,3,11
Switchflip,frostmane,96,paladin,holy,6,1,5
Xephiroxus,the-venture-co,96,paladin,holy,6,1,5
Dedicatèd,draenor,96,paladin,holy,6,1,5
Shanik,zuljin,96,paladin,holy,6,1,5
Whiskeypal,draenor,96,paladin,holy,6,1,5
Kyarï,culte-de-la-rive-noire,96,paladin,holy,6,1,5
Visaria,twisting-nether,96,paladin,holy,6,1,5
Lyciha,blackrock,96,paladin,holy,6,1,5
Eàrànël,les-clairvoyants,96,paladin,holy,6,1,5
Buladin,darkspear,96,paladin,holy,6,1,5
Flashhèart,draenor,96,paladin,holy,6,1,5
Tønyx,les-clairvoyants,96,paladin,holy,6,1,5
Playprist,aegwynn,96,paladin,holy,6,1,5
Tacita,nazjatar,96,paladin,holy,6,1,5
Bubblebun,kazzak,96,paladin,holy,6,1,5
Palariaan,defias-brotherhood,96,paladin,holy,6,1,5
Wingcomander,aegwynn,96,paladin,holy,6,1,5
Therador,dun-morogh,96,paladin,holy,6,1,5
Xzarat,kazzak,96,paladin,holy,6,1,5
Dobbygotsock,kazzak,96,paladin,holy,6,1,5
Holyfalls,blackmoore,96,paladin,holy,6,1,5
Bubbleheart,ahnqiraj,96,paladin,holy,6,1,5
Пепсекольный,soulflayer,96,paladin,holy,6,1,5
Хочусметанки,howling-fjord,96,paladin,holy,6,1,5
Whatapity,silvermoon,96,paladin,holy,6,1,5
Noanoshy,eredar,96,paladin,holy,6,1,5
Enriel,temple-noir,96,paladin,holy,6,1,5
Mínara,drakthul,96,paladin,holy,6,1,5
Fükdîscláss,ravencrest,96,paladin,holy,6,1,5
Nôxi,garona,96,paladin,holy,6,1,5
Синерина,blackscar,96,paladin,holy,6,1,5
Iamyellow,silvermoon,96,paladin,holy,6,1,5
Agorasieya,frostwolf,96,paladin,holy,6,1,5
Minirempart,khaz-modan,96,paladin,holy,6,1,5
Andrøiz,dun-modr,96,paladin,holy,6,1,5
Moobykin,stormscale,96,paladin,holy,6,1,5
Nhum,destromath,96,paladin,holy,6,1,5
Awer,magtheridon,96,paladin,holy,6,1,5
Holysheto,sanguino,96,paladin,holy,6,1,5
Rehtu,malganis,96,paladin,holy,6,1,5
Eoox,outland,96,paladin,holy,6,1,5
Belgradee,silvermoon,96,paladin,holy,6,1,5
Razztafari,tarren-mill,96,paladin,holy,6,1,5
Mybadvibes,tarren-mill,96,paladin,holy,6,1,5
Bittersweex,stormscale,96,paladin,holy,6,1,5
Lunaary,antonidas,96,paladin,holy,12,1,11
Лейфи,howling-fjord,96,paladin,holy,12,1,11
Veest,doomhammer,96,paladin,holy,12,1,11
Pigma,outland,96,paladin,holy,12,1,11
Zerafic,sylvanas,96,paladin,holy,12,1,11
Mathelac,argent-dawn,96,paladin,holy,12,1,11
Fúrion,burning-blade,96,paladin,holy,12,1,11
Ganadorie,twisting-nether,96,paladin,holy,12,1,11
Goldenstern,blackhand,96,paladin,holy,12,1,11
Ahronius,stormscale,96,paladin,holy,12,1,11
Encod,magtheridon,96,paladin,holy,12,1,11
Hasler,drakthul,96,paladin,holy,12,1,11
Callon,das-syndikat,95,paladin,holy,6,1,5
Hancipapa,ragnaros,95,paladin,holy,6,1,5
Laidevon,twisting-nether,84,paladin,holy,21,6,15
Защешот,gordunni,79,paladin,holy,5,1,4
Shaxxzii,kazzak,79,paladin,holy,5,1,4
Firfiris,twisting-nether,64,paladin,holy,4,1,3
Hitaki,tarren-mill,64,paladin,holy,4,1,3
Barundarr,arthas,48,paladin,holy,9,1,8
Jâybee,ravencrest,42,paladin,holy,8,2,6
Holymerda,grim-batol,42,paladin,holy,8,2,6
Xonika,outland,42,paladin,holy,9,2,7
Waltgyubeef,argent-dawn,42,paladin,holy,9,2,7
Xpurcica,twisting-nether,42,paladin,holy,10,2,8
Acongojante,zuljin,42,paladin,holy,15,2,13
Syruplol,blackrock,2387,paladin,retribution,117,69,48
Pïkachû,ravencrest,2213,paladin,retribution,84,45,39
Ctierpala,ravencrest,2161,paladin,retribution,90,47,43
Ðâny,elune,2128,paladin,retribution,135,68,67
Royki,the-maelstrom,2127,paladin,retribution,186,95,91
Drkp,blackrock,2126,paladin,retribution,61,42,19
Отловщик,gordunni,2123,paladin,retribution,82,43,39
Âlßêdø,ravencrest,2118,paladin,retribution,201,102,99
Mcweedy,aegwynn,2108,paladin,retribution,84,42,42
Аеррис,gordunni,2106,paladin,retribution,113,57,56
Bakawolf,burning-legion,2103,paladin,retribution,89,46,43
Cosmicstâr,kazzak,2100,paladin,retribution,167,84,83
Stracciatell,archimonde,2097,paladin,retribution,103,74,29
Miilicium,archimonde,2091,paladin,retribution,83,41,42
Sacredwrath,burning-legion,2089,paladin,retribution,65,35,30
Ufø,magtheridon,2082,paladin,retribution,102,53,49
Herrius,ravencrest,2076,paladin,retribution,84,41,43
Ricexoxo,blackhand,2066,paladin,retribution,98,48,50
Sonne,tarren-mill,2058,paladin,retribution,102,52,50
Elypsia,tarren-mill,2058,paladin,retribution,104,53,51
Mýstíc,ravencrest,2049,paladin,retribution,118,56,62
Steelsuit,argent-dawn,2044,paladin,retribution,254,134,120
Стимулин,howling-fjord,2034,paladin,retribution,126,67,59
Davewins,dragonblight,2033,paladin,retribution,42,34,8
Bigspin,ravencrest,2030,paladin,retribution,202,103,99
Fkadin,kazzak,2028,paladin,retribution,137,77,60
Miriokekw,archimonde,2027,paladin,retribution,102,48,54
Nedith,pozzo-delleternità,2026,paladin,retribution,168,89,79
Мевар,gordunni,2024,paladin,retribution,96,45,51
Альмор,blackscar,2023,paladin,retribution,54,28,26
Franclovis,hyjal,2019,paladin,retribution,63,28,35
Qshadow,frostwhisper,2018,paladin,retribution,112,54,58
Jowanno,stormscale,2013,paladin,retribution,107,57,50
Bernhoftxd,ravencrest,2010,paladin,retribution,260,126,134
Tròth,twisting-nether,2004,paladin,retribution,66,33,33
Nîhil,silvermoon,2004,paladin,retribution,88,43,45
Shinøaa,wrathbringer,2003,paladin,retribution,167,89,78
Xourens,twisting-nether,2003,paladin,retribution,73,33,40
Rankoneretri,arathor,2002,paladin,retribution,54,30,24
Kazuroo,blackmoore,2002,paladin,retribution,102,56,46
Retwar,ravencrest,1986,paladin,retribution,77,49,28
Peiker,blackrock,1984,paladin,retribution,172,81,91
Fullsendbro,ravencrest,1982,paladin,retribution,113,66,47
Msharix,kazzak,1982,paladin,retribution,114,58,56
Марчи,howling-fjord,1982,paladin,retribution,107,52,55
Агинон,gordunni,1981,paladin,retribution,60,30,30
Tj,dun-modr,1981,paladin,retribution,114,53,61
Нейтхигерс,howling-fjord,1974,paladin,retribution,83,43,40
Синодх,eversong,1974,paladin,retribution,101,46,55
Аполодориан,gordunni,1972,paladin,retribution,120,64,56
Vabz,blackrock,1968,paladin,retribution,65,30,35
Sitekx,burning-legion,1968,paladin,retribution,99,45,54
Mcret,ravencrest,1965,paladin,retribution,82,38,44
Galaadh,archimonde,1960,paladin,retribution,78,35,43
Xillindion,blackhand,1955,paladin,retribution,314,158,156
Gluttön,tarren-mill,1954,paladin,retribution,83,42,41
Legodudex,ravencrest,1954,paladin,retribution,72,36,36
Greywords,silvermoon,1952,paladin,retribution,53,30,23
Wingsteak,draenor,1952,paladin,retribution,81,44,37
Beautýbeast,ravencrest,1950,paladin,retribution,125,65,60
Martoretard,archimonde,1949,paladin,retribution,358,181,177
Prex,dun-modr,1948,paladin,retribution,72,39,33
Мрч,howling-fjord,1947,paladin,retribution,60,31,29
Günykoloke,blackrock,1939,paladin,retribution,60,33,27
Kriszi,burning-legion,1938,paladin,retribution,90,39,51
Timmes,blackhand,1936,paladin,retribution,60,28,32
Bigdblaster,twisting-nether,1935,paladin,retribution,102,49,53
Запалтосик,blackscar,1934,paladin,retribution,36,23,13
Doomsoom,kazzak,1931,paladin,retribution,46,34,12
Spacknas,blackmoore,1931,paladin,retribution,110,62,48
Pallyprinces,dentarg,1927,paladin,retribution,72,30,42
Yungboii,kazzak,1925,paladin,retribution,95,61,34
Monkeytm,archimonde,1923,paladin,retribution,64,28,36
Kírin,drakthul,1921,paladin,retribution,66,32,34
Nabbi,ravencrest,1921,paladin,retribution,72,30,42
Retbùll,stormscale,1919,paladin,retribution,37,29,8
Milkyavenger,sylvanas,1915,paladin,retribution,107,71,36
Réfractio,die-aldor,1915,paladin,retribution,90,46,44
Exolix,archimonde,1914,paladin,retribution,48,27,21
Smilé,sylvanas,1911,paladin,retribution,84,44,40
Реальныйпал,gordunni,1911,paladin,retribution,90,46,44
Daybreak,kazzak,1911,paladin,retribution,69,34,35
Vatix,trollbane,1911,paladin,retribution,66,31,35
Mezor,dun-modr,1910,paladin,retribution,202,100,102
Mélli,eredar,1907,paladin,retribution,99,55,44
Tazken,tarren-mill,1906,paladin,retribution,96,48,48
Littlelíght,silvermoon,1905,paladin,retribution,83,41,42
Courage,stormscale,1902,paladin,retribution,71,37,34
Yungboihoj,twisting-nether,1901,paladin,retribution,221,111,110
Tadashì,aegwynn,1901,paladin,retribution,78,35,43
Jualom,colinas-pardas,1900,paladin,retribution,68,35,33
Rígel,silvermoon,1899,paladin,retribution,58,35,23
Ðeathron,blackmoore,1898,paladin,retribution,128,62,66
Byths,blackmoore,1896,paladin,retribution,127,56,71
Harridin,ravencrest,1895,paladin,retribution,178,84,94
Холирайз,gordunni,1894,paladin,retribution,42,21,21
Лиспорий,gordunni,1894,paladin,retribution,60,29,31
Zscrew,nemesis,1892,paladin,retribution,42,24,18
Nastalia,elune,1892,paladin,retribution,101,54,47
Brassaren,stormscale,1890,paladin,retribution,67,36,31
Carlá,silvermoon,1890,paladin,retribution,73,37,36
Eysn,blackrock,1890,paladin,retribution,60,30,30
Pancakee,the-maelstrom,1889,paladin,retribution,66,32,34
Rùuru,archimonde,1889,paladin,retribution,168,77,91
Sloug,archimonde,1888,paladin,retribution,60,29,31
Hojinson,blackrock,1883,paladin,retribution,60,39,21
Kamata,kazzak,1883,paladin,retribution,57,28,29
Biggerspin,ravencrest,1882,paladin,retribution,24,20,4
Модрит,soulflayer,1882,paladin,retribution,70,47,23
Bersercute,sylvanas,1882,paladin,retribution,124,60,64
Толвард,gordunni,1881,paladin,retribution,25,21,4
Jedzy,ragnaros,1881,paladin,retribution,42,24,18
Tj,sanguino,1881,paladin,retribution,42,20,22
Хохахо,howling-fjord,1880,paladin,retribution,54,32,22
Меварх,howling-fjord,1878,paladin,retribution,42,22,20
Melantus,eredar,1878,paladin,retribution,83,41,42
Saygexx,draenor,1875,paladin,retribution,57,34,23
Apolloos,grim-batol,1873,paladin,retribution,89,40,49
Crysania,twisting-nether,1872,paladin,retribution,60,27,33
Pâsla,hyjal,1871,paladin,retribution,158,81,77
Hódle,silvermoon,1870,paladin,retribution,78,46,32
Kjn,tarren-mill,1870,paladin,retribution,54,31,23
Kiriel,dun-modr,1869,paladin,retribution,90,40,50
Анофарин,gordunni,1868,paladin,retribution,153,77,76
Zerørespect,ravencrest,1868,paladin,retribution,113,51,62
Дэнискарз,gordunni,1866,paladin,retribution,48,26,22
Thyrec,blackmoore,1865,paladin,retribution,54,32,22
Sumecbtw,aegwynn,1865,paladin,retribution,49,24,25
Hammarfall,ravencrest,1863,paladin,retribution,156,88,68
Nellyrld,stormscale,1863,paladin,retribution,77,32,45
Swahadon,stormscale,1862,paladin,retribution,60,29,31
Davoss,outland,1862,paladin,retribution,63,29,34
Holysiah,kazzak,1861,paladin,retribution,96,46,50
Freshreroll,tarren-mill,1860,paladin,retribution,48,30,18
Smirk,aggra-português,1860,paladin,retribution,102,46,56
Mhehø,hyjal,1855,paladin,retribution,273,137,136
Chyve,tarren-mill,1855,paladin,retribution,66,28,38
Ollebala,ravencrest,1854,paladin,retribution,103,64,39
Ðeusvult,draenor,1854,paladin,retribution,48,26,22
Vanthael,chamber-of-aspects,1853,paladin,retribution,201,115,86
Phix,outland,1853,paladin,retribution,165,81,84
Alphaladin,stormscale,1852,paladin,retribution,54,31,23
Hammerzemall,tarren-mill,1852,paladin,retribution,65,34,31
Galenhad,kazzak,1852,paladin,retribution,84,41,43
Jicob,ravencrest,1851,paladin,retribution,48,30,18
Zion,runetotem,1851,paladin,retribution,42,25,17
Dasar,twisting-nether,1851,paladin,retribution,72,31,41
Súnshìne,blackhand,1850,paladin,retribution,42,29,13
Clessington,die-aldor,1850,paladin,retribution,63,33,30
Pog,azshara,1850,paladin,retribution,63,30,33
Elganor,hyjal,1849,paladin,retribution,113,72,41
Агинон,howling-fjord,1849,paladin,retribution,60,34,26
Pætter,aggra-português,1849,paladin,retribution,60,34,26
Jessrabit,tarren-mill,1848,paladin,retribution,54,25,29
Nein,blackhand,1848,paladin,retribution,102,47,55
Valkûn,rexxar,1846,paladin,retribution,66,32,34
Exolia,archimonde,1845,paladin,retribution,54,30,24
Dibzi,argent-dawn,1845,paladin,retribution,54,27,27
Djstompyamom,stormscale,1845,paladin,retribution,99,47,52
Risingfi,kult-der-verdammten,1844,paladin,retribution,78,47,31
Nam,culte-de-la-rive-noire,1844,paladin,retribution,48,26,22
Palior,sylvanas,1841,paladin,retribution,54,31,23
Allenn,tarren-mill,1841,paladin,retribution,41,21,20
Vadya,ravencrest,1840,paladin,retribution,187,95,92
Retforlife,sylvanas,1839,paladin,retribution,42,26,16
Hornyret,kazzak,1839,paladin,retribution,96,46,50
Wingsmode,kazzak,1839,paladin,retribution,90,36,54
Crîîngêr,blackhand,1838,paladin,retribution,44,24,20
Holyhäätz,aegwynn,1838,paladin,retribution,63,33,30
Zóran,kazzak,1838,paladin,retribution,78,38,40
Surian,kazzak,1835,paladin,retribution,72,45,27
Antimov,twisting-nether,1835,paladin,retribution,156,77,79
Ophillan,draenor,1835,paladin,retribution,72,34,38
Murkyxd,sanguino,1835,paladin,retribution,66,30,36
Стьюпидбой,howling-fjord,1834,paladin,retribution,179,90,89
Yuber,ravencrest,1833,paladin,retribution,78,34,44
Сотранокинг,soulflayer,1832,paladin,retribution,36,20,16
Riyo,twisting-nether,1832,paladin,retribution,48,21,27
Skyf,outland,1832,paladin,retribution,80,33,47
Miju,blackmoore,1831,paladin,retribution,51,28,23
Ilòvekris,draenor,1831,paladin,retribution,195,99,96
Neiiz,ragnaros,1831,paladin,retribution,76,34,42
Baxuz,draenor,1830,paladin,retribution,64,33,31
Декионзхц,howling-fjord,1830,paladin,retribution,78,29,49
Ðaegos,blackmoore,1829,paladin,retribution,107,49,58
Opettaja,ravencrest,1828,paladin,retribution,60,30,30
Exolis,archimonde,1827,paladin,retribution,54,26,28
Nizzlee,eredar,1827,paladin,retribution,90,43,47
Denastys,nemesis,1827,paladin,retribution,72,31,41
Dréamypie,silvermoon,1827,paladin,retribution,65,26,39
Holzer,azshara,1826,paladin,retribution,65,35,30
Maxes,twisting-nether,1826,paladin,retribution,60,29,31
Lättäkamerus,ravencrest,1826,paladin,retribution,80,32,48
Ablaa,blackhand,1825,paladin,retribution,36,21,15
Tremelay,silvermoon,1825,paladin,retribution,240,122,118
Eimaqt,stormscale,1825,paladin,retribution,70,33,37
Zagwan,ravencrest,1824,paladin,retribution,90,51,39
Игры,gordunni,1823,paladin,retribution,76,39,37
Cqt,ravencrest,1823,paladin,retribution,66,30,36
Keinah,silvermoon,1822,paladin,retribution,54,36,18
Iagö,argent-dawn,1822,paladin,retribution,71,32,39
Lorex,grim-batol,1821,paladin,retribution,54,26,28
Ërzã,outland,1821,paladin,retribution,72,31,41
Muhnnin,archimonde,1820,paladin,retribution,72,37,35
Foreskinx,draenor,1819,paladin,retribution,42,25,17
Номос,soulflayer,1819,paladin,retribution,72,41,31
Arígato,argent-dawn,1819,paladin,retribution,173,95,78
Дюрьвючыф,razuvious,1819,paladin,retribution,143,74,69
Âtlas,ragnaros,1819,paladin,retribution,48,24,24
Nìcky,stormscale,1819,paladin,retribution,83,37,46
Bulkpwders,burning-legion,1818,paladin,retribution,42,20,22
Wingsgodx,archimonde,1818,paladin,retribution,60,28,32
Xsÿde,archimonde,1818,paladin,retribution,108,50,58
Кошкотяночка,ashenvale,1818,paladin,retribution,54,23,31
Nikkibenzqt,blackmoore,1818,paladin,retribution,84,35,49
Taurski,sylvanas,1817,paladin,retribution,48,35,13
Quelän,draenor,1817,paladin,retribution,47,29,18
Hirako,nemesis,1817,paladin,retribution,72,39,33
Thedarksteel,ravencrest,1817,paladin,retribution,70,34,36
Calaestra,twisting-nether,1817,paladin,retribution,63,30,33
Astragore,archimonde,1817,paladin,retribution,71,30,41
Кхабелех,howling-fjord,1817,paladin,retribution,78,32,46
Фэйсрол,gordunni,1817,paladin,retribution,93,37,56
Jacadin,sunstrider,1816,paladin,retribution,54,34,20
Шакиори,gordunni,1816,paladin,retribution,64,35,29
Katanaclówn,eredar,1816,paladin,retribution,215,116,99
Angryturk,ravencrest,1816,paladin,retribution,36,19,17
Батллграунд,soulflayer,1815,paladin,retribution,90,50,40
Соулерт,ashenvale,1815,paladin,retribution,54,28,26
Madmartigane,ysondre,1815,paladin,retribution,114,48,66
Wellick,ravencrest,1814,paladin,retribution,35,20,15
Фемдом,blackscar,1814,paladin,retribution,48,27,21
Wickedwings,silvermoon,1814,paladin,retribution,47,23,24
Morri,ravencrest,1814,paladin,retribution,171,83,88
Ганка,blackscar,1814,paladin,retribution,83,31,52
Umîrînbrah,twisting-nether,1813,paladin,retribution,76,45,31
Déna,draenor,1813,paladin,retribution,52,29,23
Ktk,ravencrest,1813,paladin,retribution,121,67,54
Rekktadin,grim-batol,1813,paladin,retribution,155,79,76
Granfort,argent-dawn,1813,paladin,retribution,114,55,59
Хадакур,howling-fjord,1813,paladin,retribution,60,27,33
Торсгард,howling-fjord,1813,paladin,retribution,108,46,62
Малиновыйбох,gordunni,1812,paladin,retribution,123,70,53
Bangßros,archimonde,1812,paladin,retribution,54,30,24
Durenai,aegwynn,1812,paladin,retribution,170,79,91
Losër,ravencrest,1812,paladin,retribution,66,27,39
Ykzy,hyjal,1811,paladin,retribution,36,24,12
Elbígotes,dun-modr,1811,paladin,retribution,72,40,32
Деленка,gordunni,1810,paladin,retribution,118,68,50
Коварное,borean-tundra,1810,paladin,retribution,66,36,30
Alloüt,outland,1809,paladin,retribution,37,20,17
Ironquist,doomhammer,1809,paladin,retribution,42,22,20
Bätïk,blackmoore,1809,paladin,retribution,60,30,30
Purgebop,ravencrest,1808,paladin,retribution,45,30,15
Mâttyy,stormscale,1808,paladin,retribution,66,29,37
Ças,quelthalas,1808,paladin,retribution,72,30,42
Kêkbûrâgol,kazzak,1807,paladin,retribution,42,26,16
Wannabis,twisting-nether,1807,paladin,retribution,113,66,47
Exolie,archimonde,1807,paladin,retribution,48,25,23
Васапрагиб,howling-fjord,1806,paladin,retribution,60,35,25
Bregowine,doomhammer,1806,paladin,retribution,243,137,106
Malthred,ravenholdt,1806,paladin,retribution,171,91,80
Weekly,outland,1806,paladin,retribution,36,19,17
Аниф,ashenvale,1806,paladin,retribution,210,110,100
Lightlogic,ravencrest,1806,paladin,retribution,71,35,36
Réaxon,archimonde,1806,paladin,retribution,69,30,39
Matriarchxd,kazzak,1805,paladin,retribution,48,24,24
Vhardan,archimonde,1805,paladin,retribution,143,71,72
Geneundreitt,dethecus,1805,paladin,retribution,54,26,28
Îiî,archimonde,1805,paladin,retribution,45,21,24
Магрейм,gordunni,1805,paladin,retribution,77,35,42
Gimly,anachronos,1805,paladin,retribution,72,31,41
Taneren,argent-dawn,1804,paladin,retribution,48,29,19
Heiimdal,dun-morogh,1804,paladin,retribution,46,26,20
Tsorig,tarren-mill,1804,paladin,retribution,177,98,79
Zarrex,blackrock,1804,paladin,retribution,54,28,26
Делимнаноль,blackscar,1804,paladin,retribution,183,92,91
Netharia,antonidas,1804,paladin,retribution,120,59,61
Блэканус,blackscar,1804,paladin,retribution,60,28,32
Aqualisse,hyjal,1804,paladin,retribution,66,30,36
Qpala,quelthalas,1803,paladin,retribution,36,19,17
Flaapz,hyjal,1802,paladin,retribution,112,69,43
Selina,burning-legion,1802,paladin,retribution,111,59,52
Атмх,soulflayer,1802,paladin,retribution,54,28,26
Antou,twisting-nether,1802,paladin,retribution,211,108,103
Meruem,blackrock,1802,paladin,retribution,53,26,27
Karadøc,archimonde,1802,paladin,retribution,90,41,49
Ibnkrook,archimonde,1801,paladin,retribution,54,28,26
Brõw,hyjal,1801,paladin,retribution,42,21,21
Lesterqt,thrall,1801,paladin,retribution,114,54,60
Delgato,kazzak,1800,paladin,retribution,152,80,72
Zachäus,kirin-tor,1800,paladin,retribution,114,57,57
Tauskiz,sylvanas,1800,paladin,retribution,48,19,29
Мидэас,gordunni,1798,paladin,retribution,96,44,52
Gladiator,die-aldor,1796,paladin,retribution,54,30,24
Icekissz,hyjal,1795,paladin,retribution,24,19,5
Телканапалке,blackscar,1795,paladin,retribution,48,35,13
Pepehands,nazjatar,1795,paladin,retribution,54,27,27
Papichuló,aegwynn,1794,paladin,retribution,96,45,51
Zialo,ravencrest,1792,paladin,retribution,99,44,55
Møøgødx,bronzebeard,1792,paladin,retribution,120,49,71
Arayël,archimonde,1790,paladin,retribution,96,54,42
Xairo,twisting-nether,1790,paladin,retribution,54,27,27
Pestomp,tarren-mill,1789,paladin,retribution,65,28,37
Pridehammer,stormscale,1788,paladin,retribution,48,31,17
Ниашес,howling-fjord,1788,paladin,retribution,65,29,36
Киото,gordunni,1788,paladin,retribution,48,19,29
Simjon,defias-brotherhood,1787,paladin,retribution,181,102,79
Elitest,hyjal,1787,paladin,retribution,73,34,39
Guilt,aegwynn,1787,paladin,retribution,69,30,39
ßlacklight,archimonde,1787,paladin,retribution,66,26,40
Astilia,sylvanas,1785,paladin,retribution,90,44,46
Kayllan,ravencrest,1784,paladin,retribution,113,65,48
Кухонныйвор,howling-fjord,1784,paladin,retribution,54,29,25
Mayhemx,ravencrest,1779,paladin,retribution,277,133,144
Ромерл,gordunni,1778,paladin,retribution,107,58,49
Posttal,aggra-português,1775,paladin,retribution,42,19,23
Deriøt,dun-modr,1773,paladin,retribution,96,52,44
Dacilez,ravencrest,1773,paladin,retribution,117,58,59
Goofymits,twisting-nether,1772,paladin,retribution,60,32,28
Skyrose,ravencrest,1772,paladin,retribution,162,86,76
Vankwok,stormscale,1771,paladin,retribution,33,20,13
Cheradin,ragnaros,1771,paladin,retribution,49,22,27
Répo,twisting-nether,1770,paladin,retribution,42,22,20
Riares,darkspear,1768,paladin,retribution,103,53,50
Dalemiar,ravencrest,1767,paladin,retribution,117,55,62
ßancu,ragnaros,1767,paladin,retribution,54,22,32
Алепос,soulflayer,1766,paladin,retribution,54,21,33
Valterus,burning-legion,1765,paladin,retribution,84,40,44
Refuse,blackrock,1761,paladin,retribution,89,43,46
Ослепителен,eversong,1761,paladin,retribution,60,26,34
Tsunà,antonidas,1760,paladin,retribution,48,21,27
Sofhiya,silvermoon,1759,paladin,retribution,42,24,18
Опгоп,gordunni,1758,paladin,retribution,89,45,44
Tanny,kazzak,1758,paladin,retribution,66,29,37
Extremnäsa,outland,1758,paladin,retribution,102,43,59
Tcret,sanguino,1757,paladin,retribution,47,25,22
Saabnaab,outland,1754,paladin,retribution,216,126,90
Naneno,silvermoon,1754,paladin,retribution,63,30,33
Zubxp,ravencrest,1753,paladin,retribution,76,37,39
Данхайк,gordunni,1750,paladin,retribution,114,68,46
Loratheon,stormscale,1745,paladin,retribution,36,22,14
Hýox,malganis,1745,paladin,retribution,55,27,28
Darkkissret,lightbringer,1745,paladin,retribution,66,28,38
Akoumb,twisting-nether,1743,paladin,retribution,108,58,50
Molgran,defias-brotherhood,1743,paladin,retribution,102,45,57
Justyowx,archimonde,1740,paladin,retribution,42,20,22
Мува,soulflayer,1739,paladin,retribution,62,29,33
Мегопалл,blackscar,1738,paladin,retribution,90,38,52
Jíyü,blackmoore,1737,paladin,retribution,42,23,19
Холиврас,gordunni,1737,paladin,retribution,36,19,17
Plarbo,blackmoore,1737,paladin,retribution,66,32,34
Halevia,kazzak,1737,paladin,retribution,71,32,39
Tekåpal,tarren-mill,1736,paladin,retribution,72,34,38
Охоху,gordunni,1735,paladin,retribution,113,61,52
Caladys,silvermoon,1735,paladin,retribution,91,49,42
Valnyr,the-maelstrom,1735,paladin,retribution,66,35,31
Liendry,antonidas,1735,paladin,retribution,53,28,25
Солошафл,howling-fjord,1735,paladin,retribution,48,24,24
Shakkur,varimathras,1734,paladin,retribution,36,23,13
Bajheeroth,kazzak,1734,paladin,retribution,78,49,29
Ruath,xavius,1734,paladin,retribution,112,58,54
Yana,blackrock,1733,paladin,retribution,49,26,23
Kanyewesh,dalaran,1733,paladin,retribution,42,21,21
Johannx,tarren-mill,1733,paladin,retribution,198,96,102
Vanques,burning-legion,1732,paladin,retribution,41,20,21
Лакостик,howling-fjord,1732,paladin,retribution,66,31,35
Zazalamel,hyjal,1731,paladin,retribution,48,28,20
Ÿani,argent-dawn,1730,paladin,retribution,42,25,17
Justivo,tarren-mill,1730,paladin,retribution,67,39,28
Claymore,ravenholdt,1730,paladin,retribution,59,24,35
Runhexi,silvermoon,1728,paladin,retribution,169,91,78
Чупаа,howling-fjord,1728,paladin,retribution,88,47,41
Пинкпуссибой,howling-fjord,1727,paladin,retribution,58,32,26
Inkzen,silvermoon,1727,paladin,retribution,42,22,20
Sántouryu,ravencrest,1725,paladin,retribution,269,135,134
Elisight,ravencrest,1724,paladin,retribution,48,25,23
Mouku,stormreaver,1724,paladin,retribution,66,29,37
Mimð,kazzak,1723,paladin,retribution,42,24,18
Trølled,aegwynn,1722,paladin,retribution,168,81,87
Лайтфури,gordunni,1722,paladin,retribution,42,19,23
Sübôvîñ,ravencrest,1721,paladin,retribution,71,40,31
Djrayk,archimonde,1721,paladin,retribution,36,18,18
Miru,defias-brotherhood,1719,paladin,retribution,30,18,12
Dankin,pozzo-delleternità,1719,paladin,retribution,58,31,27
Milipal,hyjal,1719,paladin,retribution,36,18,18
Bigbuffdaddy,draenor,1718,paladin,retribution,328,165,163
Ezetrol,xavius,1718,paladin,retribution,42,20,22
Xeaa,tarren-mill,1718,paladin,retribution,42,18,24
Highfivè,ravencrest,1717,paladin,retribution,48,28,20
Xinze,ravencrest,1716,paladin,retribution,42,24,18
Xyzl,argent-dawn,1715,paladin,retribution,108,66,42
Larnbert,argent-dawn,1715,paladin,retribution,54,27,27
Ryxxii,ravencrest,1715,paladin,retribution,54,26,28
Beigerbala,blackrock,1715,paladin,retribution,42,18,24
Testør,ragnaros,1714,paladin,retribution,123,55,68
Honorkill,silvermoon,1713,paladin,retribution,211,118,93
Русэльф,howling-fjord,1713,paladin,retribution,105,56,49
Fullflavor,bladefist,1713,paladin,retribution,90,39,51
Wingsuit,eredar,1713,paladin,retribution,62,25,37
Dannyvye,outland,1712,paladin,retribution,48,21,27
Guskey,draenor,1711,paladin,retribution,72,39,33
Odin,silvermoon,1711,paladin,retribution,77,41,36
Lazaraat,antonidas,1711,paladin,retribution,65,25,40
Kinvqt,tarren-mill,1710,paladin,retribution,76,36,40
Matinacc,tarren-mill,1709,paladin,retribution,30,18,12
Slapmedaddy,die-ewige-wacht,1709,paladin,retribution,54,29,25
Ayylmeow,tarren-mill,1709,paladin,retribution,56,28,28
Ilikejudge,blackmoore,1709,paladin,retribution,96,43,53
Deidâra,blackhand,1709,paladin,retribution,42,18,24
Shockashy,stormscale,1708,paladin,retribution,56,31,25
Drownlord,eredar,1707,paladin,retribution,30,18,12
Wickedret,kazzak,1707,paladin,retribution,30,18,12
Zarispal,tarren-mill,1707,paladin,retribution,39,23,16
Релаин,gordunni,1707,paladin,retribution,60,27,33
Starcker,sanguino,1707,paladin,retribution,72,24,48
Sigmud,turalyon,1706,paladin,retribution,42,23,19
Babaluga,blackrock,1706,paladin,retribution,42,21,21
Gùtz,xavius,1704,paladin,retribution,57,27,30
Draìgo,nemesis,1703,paladin,retribution,35,21,14
Alatie,dentarg,1703,paladin,retribution,84,45,39
Яидваклоуна,soulflayer,1703,paladin,retribution,36,18,18
Dominikcro,sylvanas,1702,paladin,retribution,30,18,12
Nutqtgodx,archimonde,1702,paladin,retribution,36,21,15
Gwynel,argent-dawn,1702,paladin,retribution,60,28,32
Pârabellum,the-maelstrom,1702,paladin,retribution,93,40,53
Витурус,howling-fjord,1702,paladin,retribution,72,28,44
Winkz,rajaxx,1701,paladin,retribution,36,18,18
Cowwithspell,stormscale,1701,paladin,retribution,122,60,62
Dainan,blackmoore,1701,paladin,retribution,134,65,69
Mirøku,silvermoon,1701,paladin,retribution,79,37,42
Baraya,archimonde,1701,paladin,retribution,41,19,22
Thórvaldr,argent-dawn,1700,paladin,retribution,54,30,24
Mordar,ravencrest,1700,paladin,retribution,67,33,34
Staticdeath,ravencrest,1699,paladin,retribution,240,123,117
Ðenlox,destromath,1699,paladin,retribution,72,29,43
Холихит,gordunni,1698,paladin,retribution,100,50,50
Smirky,silvermoon,1697,paladin,retribution,42,20,22
Rullatôrsven,stormscale,1697,paladin,retribution,48,18,30
Mefrandie,frostwolf,1696,paladin,retribution,42,24,18
Glàdiator,outland,1696,paladin,retribution,81,38,43
Qarak,argent-dawn,1695,paladin,retribution,71,32,39
Алекхей,gordunni,1695,paladin,retribution,80,29,51
Zayaka,ragnaros,1695,paladin,retribution,90,32,58
Яправ,borean-tundra,1694,paladin,retribution,66,38,28
Lecutus,sunstrider,1694,paladin,retribution,99,42,57
Dragonwingz,kazzak,1693,paladin,retribution,40,24,16
Salti,magtheridon,1693,paladin,retribution,142,77,65
Starworkal,ragnaros,1693,paladin,retribution,70,36,34
Сводимиаое,soulflayer,1692,paladin,retribution,52,24,28
Rli,twisting-nether,1691,paladin,retribution,80,41,39
Инфернох,howling-fjord,1691,paladin,retribution,155,78,77
Эвангер,gordunni,1691,paladin,retribution,48,22,26
Almighty,ravencrest,1690,paladin,retribution,66,28,38
Jout,tarren-mill,1689,paladin,retribution,144,73,71
Bubbleteâ,blackhand,1688,paladin,retribution,78,35,43
Lightsaint,kazzak,1687,paladin,retribution,66,37,29
Утипутя,goldrinn,1687,paladin,retribution,48,21,27
Зондарк,booty-bay,1687,paladin,retribution,77,33,44
Holyshet,blackrock,1686,paladin,retribution,79,44,35
Ertheus,argent-dawn,1686,paladin,retribution,54,25,29
Yo,azshara,1684,paladin,retribution,66,34,32
Mistérion,archimonde,1683,paladin,retribution,66,27,39
Thàø,chants-éternels,1682,paladin,retribution,58,30,28
Yséria,kirin-tor,1682,paladin,retribution,72,35,37
Вайлдбебриз,eversong,1680,paladin,retribution,48,32,16
Бэйгреон,gordunni,1680,paladin,retribution,142,81,61
Данбро,borean-tundra,1680,paladin,retribution,60,29,31
Instaquez,stormscale,1679,paladin,retribution,97,50,47
Varunyyo,blackrock,1679,paladin,retribution,82,40,42
Møg,blackrock,1679,paladin,retribution,59,24,35
Dudjaw,stormscale,1679,paladin,retribution,96,38,58
Obackbarama,outland,1678,paladin,retribution,42,23,19
Ratklng,ravencrest,1677,paladin,retribution,72,47,25
Blakethorn,silvermoon,1676,paladin,retribution,36,18,18
Cursedd,sanguino,1675,paladin,retribution,30,18,12
Scorebit,draenor,1675,paladin,retribution,41,19,22
Socx,outland,1675,paladin,retribution,60,21,39
Mcfëë,ysondre,1673,paladin,retribution,95,50,45
Lílou,blackmoore,1673,paladin,retribution,57,30,27
Bjornulfr,ravencrest,1673,paladin,retribution,107,46,61
Justyferr,nemesis,1673,paladin,retribution,93,38,55
Wootschi,arthas,1672,paladin,retribution,59,30,29
Eldrial,argent-dawn,1672,paladin,retribution,65,32,33
Shanice,twilights-hammer,1671,paladin,retribution,42,23,19
Tyri,silvermoon,1671,paladin,retribution,96,50,46
Дракула,howling-fjord,1671,paladin,retribution,102,53,49
Грайндсет,galakrond,1671,paladin,retribution,41,18,23
Shmndr,kazzak,1670,paladin,retribution,42,24,18
Mainôs,ravencrest,1670,paladin,retribution,42,22,20
Kaileena,archimonde,1669,paladin,retribution,42,25,17
Puers,burning-blade,1669,paladin,retribution,35,20,15
Bullsy,kazzak,1669,paladin,retribution,62,32,30
Merkury,sanguino,1669,paladin,retribution,48,21,27
Xciepo,rexxar,1669,paladin,retribution,66,28,38
Дохлаяженах,gordunni,1668,paladin,retribution,36,20,16
Bigducc,draenor,1668,paladin,retribution,47,22,25
Saintseiya,pozzo-delleternità,1667,paladin,retribution,36,23,13
Xtekz,tarren-mill,1667,paladin,retribution,62,33,29
Youmistpew,antonidas,1667,paladin,retribution,48,19,29
Pingla,argent-dawn,1666,paladin,retribution,37,23,14
Holymerda,grim-batol,1666,paladin,retribution,47,23,24
Hèllkeepêr,archimonde,1666,paladin,retribution,41,20,21
Hojacat,ravencrest,1665,paladin,retribution,36,20,16
Оззмо,howling-fjord,1665,paladin,retribution,165,85,80
Korendil,frostmane,1665,paladin,retribution,60,25,35
Keft,twisting-nether,1664,paladin,retribution,47,25,22
Zeggayodax,nemesis,1663,paladin,retribution,42,22,20
Ivarladin,draenor,1663,paladin,retribution,66,30,36
Vickdicator,stormscale,1663,paladin,retribution,68,30,38
Deadholland,ravencrest,1662,paladin,retribution,140,73,67
Pruntadin,silvermoon,1661,paladin,retribution,78,36,42
Denounce,defias-brotherhood,1661,paladin,retribution,57,22,35
Sünlight,nemesis,1660,paladin,retribution,116,54,62
Bumaye,tarren-mill,1659,paladin,retribution,42,24,18
Focuspally,outland,1659,paladin,retribution,54,29,25
Âyasê,blackhand,1659,paladin,retribution,100,49,51
Meìster,blackmoore,1658,paladin,retribution,63,30,33
Limitles,nemesis,1658,paladin,retribution,51,19,32
Misako,sanguino,1657,paladin,retribution,124,62,62
Trendragon,argent-dawn,1657,paladin,retribution,41,19,22
Drakingsang,blackhand,1657,paladin,retribution,84,35,49
Auriuss,defias-brotherhood,1656,paladin,retribution,177,95,82
Kouyhalaide,hyjal,1656,paladin,retribution,48,24,24
Warmâchiine,burning-legion,1655,paladin,retribution,143,75,68
Telionrootan,die-aldor,1655,paladin,retribution,58,29,29
Novania,perenolde,1655,paladin,retribution,69,32,37
Ёйхйё,blackscar,1654,paladin,retribution,109,62,47
Niou,alleria,1654,paladin,retribution,53,27,26
Vuup,silvermoon,1654,paladin,retribution,72,35,37
Сёмаигрок,soulflayer,1654,paladin,retribution,54,26,28
Aylion,blackrock,1653,paladin,retribution,42,28,14
Earendìl,blackmoore,1653,paladin,retribution,54,31,23
Zynuwu,blackmoore,1653,paladin,retribution,42,22,20
Ruotollo,ravencrest,1653,paladin,retribution,51,23,28
Valin,frostmane,1653,paladin,retribution,66,29,37
Irondawg,rajaxx,1653,paladin,retribution,56,21,35
Rugila,ragnaros,1652,paladin,retribution,164,93,71
Íbossít,doomhammer,1652,paladin,retribution,66,36,30
Райтивуд,howling-fjord,1652,paladin,retribution,110,58,52
Modeladin,ragnaros,1652,paladin,retribution,70,32,38
Xila,blackrock,1652,paladin,retribution,60,24,36
Gaalarr,burning-legion,1650,paladin,retribution,36,20,16
Palwig,tarren-mill,1650,paladin,retribution,148,78,70
Harlequina,argent-dawn,1650,paladin,retribution,40,20,20
Zuveron,the-maelstrom,1650,paladin,retribution,54,23,31
Screws,dun-modr,1650,paladin,retribution,54,22,32
Unschúld,blackrock,1649,paladin,retribution,127,71,56
Aederec,argent-dawn,1649,paladin,retribution,78,42,36
Shenwarr,twisting-nether,1649,paladin,retribution,36,19,17
Хаспадин,gordunni,1649,paladin,retribution,42,21,21
Elisabeth,kazzak,1648,paladin,retribution,72,31,41
Spegepølse,silvermoon,1647,paladin,retribution,74,42,32
Namapala,silvermoon,1647,paladin,retribution,95,46,49
Reito,eredar,1647,paladin,retribution,60,28,32
Wakke,outland,1646,paladin,retribution,32,23,9
Exoblade,twisting-nether,1646,paladin,retribution,72,40,32
Saintys,sylvanas,1646,paladin,retribution,68,36,32
Сандалар,gordunni,1646,paladin,retribution,54,24,30
Batteldin,blackmoore,1644,paladin,retribution,152,89,63
Cîzzar,burning-legion,1644,paladin,retribution,153,85,68
Аилерия,howling-fjord,1644,paladin,retribution,248,134,114
Bubbledøtcøm,blackmoore,1644,paladin,retribution,60,29,31
Xòtrios,argent-dawn,1643,paladin,retribution,48,24,24
Milkadìn,twisting-nether,1642,paladin,retribution,66,35,31
Ysell,sargeras,1642,paladin,retribution,62,31,31
Nøvå,ravencrest,1642,paladin,retribution,78,36,42
Panicmaker,ravencrest,1641,paladin,retribution,42,28,14
Bikkuz,kazzak,1641,paladin,retribution,42,28,14
Gigasack,ravencrest,1641,paladin,retribution,36,23,13
Саймум,blackscar,1641,paladin,retribution,57,29,28
Powerpuffret,antonidas,1640,paladin,retribution,72,40,32
Иев,howling-fjord,1640,paladin,retribution,53,23,30
Димасгачи,gordunni,1638,paladin,retribution,42,32,10
Аскеттх,gordunni,1638,paladin,retribution,66,33,33
Zeroeffect,blackhand,1638,paladin,retribution,48,24,24
Zaaen,burning-legion,1637,paladin,retribution,84,45,39
Brabop,zirkel-des-cenarius,1637,paladin,retribution,42,22,20
Tîrana,ysondre,1637,paladin,retribution,69,31,38
Dízeltekurva,ragnaros,1636,paladin,retribution,42,21,21
Bancu,outland,1636,paladin,retribution,36,18,18
Badbuññy,sylvanas,1636,paladin,retribution,54,24,30
Skoopey,twisting-nether,1636,paladin,retribution,54,23,31
Trenvendor,ravencrest,1635,paladin,retribution,33,22,11
Mácá,outland,1635,paladin,retribution,30,20,10
Naexea,archimonde,1635,paladin,retribution,60,28,32
Kýríl,antonidas,1635,paladin,retribution,44,18,26
Arturius,ravencrest,1634,paladin,retribution,60,30,30
Djandja,blackrock,1634,paladin,retribution,59,29,30
Breakdøwñ,blackrock,1634,paladin,retribution,148,63,85
Palagray,blackmoore,1633,paladin,retribution,173,100,73
Retaxx,outland,1633,paladin,retribution,36,19,17
Прожектор,gordunni,1633,paladin,retribution,48,25,23
Theladrie,blackhand,1632,paladin,retribution,48,24,24
Itsgossiplol,twisting-nether,1632,paladin,retribution,74,30,44
Flipzz,blackrock,1631,paladin,retribution,26,18,8
Needel,argent-dawn,1631,paladin,retribution,47,26,21
Кавайнекс,azuregos,1631,paladin,retribution,134,67,67
Draizor,twisting-nether,1631,paladin,retribution,89,42,47
Батллграунт,soulflayer,1630,paladin,retribution,101,64,37
Ibuc,blackrock,1630,paladin,retribution,36,21,15
Djcurry,archimonde,1630,paladin,retribution,30,17,13
Кельритос,soulflayer,1630,paladin,retribution,64,28,36
Antsh,nemesis,1629,paladin,retribution,36,22,14
Bobiwan,ravencrest,1629,paladin,retribution,30,17,13
Krîstal,aegwynn,1629,paladin,retribution,41,20,21
Ønlyfâns,dragonblight,1629,paladin,retribution,78,34,44
Akrobatka,sanguino,1629,paladin,retribution,76,33,43
Gilet,argent-dawn,1628,paladin,retribution,30,18,12
Tyrael,darksorrow,1628,paladin,retribution,200,100,100
Wyllian,grim-batol,1628,paladin,retribution,48,23,25
Suprisexd,ravencrest,1628,paladin,retribution,42,20,22
Коссандра,greymane,1628,paladin,retribution,47,21,26
Таптыгин,gordunni,1628,paladin,retribution,54,23,31
Lifepower,nemesis,1627,paladin,retribution,34,21,13
Эйзенхорн,grom,1626,paladin,retribution,42,23,19
Торсгад,gordunni,1626,paladin,retribution,42,23,19
Crusshqt,silvermoon,1626,paladin,retribution,126,63,63
Zeusp,archimonde,1626,paladin,retribution,42,21,21
Zarron,blackrock,1626,paladin,retribution,42,20,22
Serratus,thunderhorn,1626,paladin,retribution,50,22,28
Ragen,kazzak,1626,paladin,retribution,48,21,27
Kasualwrath,stormscale,1625,paladin,retribution,30,17,13
Strykar,aggra-português,1625,paladin,retribution,42,19,23
Bluehustler,tarren-mill,1625,paladin,retribution,117,48,69
Wyzpal,archimonde,1624,paladin,retribution,42,24,18
Akaasix,stormscale,1624,paladin,retribution,57,31,26
Babyboo,aggra-português,1624,paladin,retribution,36,17,19
Misú,ravencrest,1623,paladin,retribution,30,17,13
Lisma,bloodfeather,1623,paladin,retribution,47,26,21
Blazeer,pozzo-delleternità,1623,paladin,retribution,42,23,19
Leoxander,outland,1623,paladin,retribution,60,30,30
Notpitball,kazzak,1623,paladin,retribution,48,23,25
Brecs,frostmourne,1623,paladin,retribution,84,36,48
Diccari,stormreaver,1623,paladin,retribution,42,18,24
Ghosti,festung-der-stürme,1622,paladin,retribution,30,17,13
Ливх,blackscar,1622,paladin,retribution,79,42,37
Relius,outland,1622,paladin,retribution,67,25,42
Gøretterøg,archimonde,1621,paladin,retribution,30,18,12
Threathor,outland,1621,paladin,retribution,135,72,63
Kraakz,sanguino,1621,paladin,retribution,35,18,17
Анастэриан,thermaplugg,1621,paladin,retribution,78,39,39
Dreamwatcher,outland,1621,paladin,retribution,48,21,27
Elendor,shadowsong,1620,paladin,retribution,36,20,16
Ajkulaa,kazzak,1620,paladin,retribution,74,35,39
Tpainjr,kazzak,1620,paladin,retribution,36,17,19
Valhella,stormscale,1619,paladin,retribution,137,70,67
Combinecka,chamber-of-aspects,1619,paladin,retribution,118,60,58
Kaleyra,argent-dawn,1619,paladin,retribution,48,20,28
Rullatorsvèn,stormscale,1619,paladin,retribution,42,17,25
Charmxx,stormscale,1618,paladin,retribution,30,18,12
Lonesolo,sylvanas,1618,paladin,retribution,36,20,16
Menephannt,outland,1618,paladin,retribution,39,18,21
Sletlana,burning-blade,1618,paladin,retribution,48,21,27
Bloodsworn,stormrage,1617,paladin,retribution,90,58,32
Фатумм,howling-fjord,1617,paladin,retribution,36,18,18
Okcså,ragnaros,1617,paladin,retribution,64,25,39
Typhadin,sylvanas,1616,paladin,retribution,42,20,22
Harbiter,ravencrest,1616,paladin,retribution,36,17,19
Ассайоу,soulflayer,1616,paladin,retribution,60,21,39
Mommyret,draenor,1615,paladin,retribution,84,45,39
Mâterîa,antonidas,1615,paladin,retribution,102,54,48
Holyblast,archimonde,1615,paladin,retribution,42,22,20
Bloodaxjr,archimonde,1614,paladin,retribution,178,95,83
Lightbrîng,hyjal,1614,paladin,retribution,114,57,57
Хексали,soulflayer,1614,paladin,retribution,51,25,26
Cloudlight,argent-dawn,1613,paladin,retribution,30,18,12
Budgetcara,stormscale,1613,paladin,retribution,35,19,16
Kayøz,aegwynn,1613,paladin,retribution,72,36,36
Nanisunda,thrall,1613,paladin,retribution,132,63,69
Koly,dun-modr,1613,paladin,retribution,38,18,20
Oliverrar,blackrock,1613,paladin,retribution,48,21,27
Vanithar,thrall,1613,paladin,retribution,60,25,35
Аностазия,ashenvale,1613,paladin,retribution,78,30,48
Holyzero,ravencrest,1612,paladin,retribution,24,17,7
Mangz,ysondre,1612,paladin,retribution,36,25,11
Briman,neptulon,1612,paladin,retribution,60,37,23
Девствениица,gordunni,1612,paladin,retribution,54,32,22
Johnßlake,dun-modr,1612,paladin,retribution,95,51,44
Nergigante,drekthar,1612,paladin,retribution,48,23,25
Paradoxiâ,thrall,1612,paladin,retribution,60,28,32
Lyraestra,hyjal,1612,paladin,retribution,66,28,38
Wellmetqt,aegwynn,1611,paladin,retribution,95,40,55
Karyouka,archimonde,1610,paladin,retribution,54,33,21
Мяумяухх,soulflayer,1610,paladin,retribution,196,104,92
Discølove,blackmoore,1610,paladin,retribution,43,21,22
Testament,antonidas,1610,paladin,retribution,54,25,29
Vylnoa,twisting-nether,1610,paladin,retribution,139,62,77
Grimstark,argent-dawn,1609,paladin,retribution,36,23,13
Promise,dun-modr,1609,paladin,retribution,60,32,28
Bíceron,sanguino,1609,paladin,retribution,64,32,32
Lazone,ysondre,1609,paladin,retribution,46,22,24
Кхарнх,soulflayer,1609,paladin,retribution,36,17,19
Racduck,dunemaul,1609,paladin,retribution,64,30,34
Snødunkern,outland,1609,paladin,retribution,96,41,55
Rettalius,ravencrest,1609,paladin,retribution,99,41,58
Mystixd,talnivarr,1608,paladin,retribution,42,31,11
Hølypowah,tarren-mill,1608,paladin,retribution,24,17,7
Alammar,burning-legion,1608,paladin,retribution,30,18,12
Ämÿcüs,zuljin,1608,paladin,retribution,72,41,31
Uliko,twisting-nether,1608,paladin,retribution,60,33,27
Vodax,argent-dawn,1608,paladin,retribution,72,37,35
Elohim,echsenkessel,1608,paladin,retribution,75,36,39
Рикшак,howling-fjord,1608,paladin,retribution,42,17,25
Biggboii,twisting-nether,1608,paladin,retribution,48,19,29
Кинбул,ashenvale,1607,paladin,retribution,30,17,13
Ревирант,gordunni,1607,paladin,retribution,39,21,18
Thmas,tarren-mill,1607,paladin,retribution,90,48,42
Vitacé,burning-legion,1607,paladin,retribution,66,33,33
Ттиаматт,howling-fjord,1607,paladin,retribution,36,17,19
Эллесар,blackscar,1607,paladin,retribution,132,62,70
Fisslol,kazzak,1606,paladin,retribution,66,31,35
Arosyr,alleria,1605,paladin,retribution,60,36,24
Asærý,blackmoore,1605,paladin,retribution,51,26,25
Torvik,eredar,1605,paladin,retribution,96,46,50
Frankostyle,sanguino,1605,paladin,retribution,59,28,31
Elesmerias,dalaran,1604,paladin,retribution,65,36,29
Tìtan,ravencrest,1604,paladin,retribution,48,25,23
Кронкс,howling-fjord,1604,paladin,retribution,141,73,68
Emìnem,kazzak,1604,paladin,retribution,122,63,59
Tinyandy,blackrock,1604,paladin,retribution,48,21,27
Майлайт,gordunni,1603,paladin,retribution,100,59,41
Hargreeve,ravencrest,1602,paladin,retribution,48,24,24
Синодушка,blackscar,1602,paladin,retribution,40,19,21
Fordragon,twisting-nether,1602,paladin,retribution,54,21,33
Quasimod,ravencrest,1601,paladin,retribution,30,17,13
Pappnas,aegwynn,1601,paladin,retribution,30,17,13
Flashyo,archimonde,1601,paladin,retribution,36,20,16
Nashret,kazzak,1601,paladin,retribution,54,28,26
Thun,azjolnerub,1601,paladin,retribution,36,17,19
Zwergicus,alexstrasza,1601,paladin,retribution,71,33,38
Lübu,archimonde,1601,paladin,retribution,42,19,23
Guccishock,twisting-nether,1600,paladin,retribution,85,48,37
Skippadin,ravencrest,1600,paladin,retribution,59,30,29
Carlash,draenor,1599,paladin,retribution,96,53,43
Djcrusade,twisting-nether,1599,paladin,retribution,140,77,63
Daoht,ysondre,1599,paladin,retribution,54,28,26
Рамзеса,soulflayer,1599,paladin,retribution,48,22,26
Azlaya,sargeras,1598,paladin,retribution,135,65,70
Wuzzle,azshara,1597,paladin,retribution,36,22,14
Салутан,thermaplugg,1597,paladin,retribution,92,43,49
Братстепина,gordunni,1596,paladin,retribution,48,21,27
Nlyrld,magtheridon,1595,paladin,retribution,36,19,17
Spéos,archimonde,1595,paladin,retribution,52,26,26
Grìmmjøw,silvermoon,1595,paladin,retribution,39,19,20
Ïdø,hyjal,1594,paladin,retribution,108,46,62
Joniopala,stormreaver,1594,paladin,retribution,47,19,28
Crohnox,nemesis,1593,paladin,retribution,62,30,32
Topzin,argent-dawn,1592,paladin,retribution,45,27,18
Neverknõw,draenor,1592,paladin,retribution,36,21,15
Siorraidh,archimonde,1592,paladin,retribution,42,23,19
Salelol,ravencrest,1591,paladin,retribution,60,22,38
Dabeefchief,outland,1590,paladin,retribution,28,21,7
Kedaris,antonidas,1590,paladin,retribution,54,30,24
Redex,tarren-mill,1590,paladin,retribution,48,26,22
Атикинс,gordunni,1590,paladin,retribution,114,54,60
Pallidino,antonidas,1590,paladin,retribution,47,20,27
Draeymora,thrall,1589,paladin,retribution,61,33,28
Фэрплэйн,gordunni,1589,paladin,retribution,36,19,17
Sstalowy,silvermoon,1589,paladin,retribution,151,74,77
Ahpoual,archimonde,1588,paladin,retribution,64,39,25
Владыкасвета,borean-tundra,1588,paladin,retribution,120,64,56
Gigajudge,ravencrest,1588,paladin,retribution,48,25,23
Raoun,archimonde,1588,paladin,retribution,48,23,25
Serjudge,kazzak,1588,paladin,retribution,42,19,23
Shaylaru,tarren-mill,1587,paladin,retribution,41,22,19
Altundrdel,ravencrest,1587,paladin,retribution,60,31,29
Yaldly,dun-modr,1586,paladin,retribution,36,18,18
Асканиэль,howling-fjord,1586,paladin,retribution,84,37,47
Grobididi,malygos,1585,paladin,retribution,155,85,70
Eniste,silvermoon,1585,paladin,retribution,80,36,44
Emostylex,draenor,1585,paladin,retribution,101,40,61
Джамбит,howling-fjord,1584,paladin,retribution,42,22,20
Cilise,bronzebeard,1583,paladin,retribution,54,24,30
Шэйкер,blackscar,1583,paladin,retribution,79,35,44
Slump,ravencrest,1582,paladin,retribution,73,38,35
Aerieon,draenor,1582,paladin,retribution,42,21,21
Талрэн,howling-fjord,1582,paladin,retribution,66,32,34
Дезоиль,gordunni,1582,paladin,retribution,42,19,23
Irenita,kazzak,1582,paladin,retribution,54,23,31
Retstarr,draenor,1580,paladin,retribution,114,57,57
Диманватикан,howling-fjord,1580,paladin,retribution,66,27,39
Bagok,drakthul,1576,paladin,retribution,42,26,16
Elektek,archimonde,1576,paladin,retribution,30,18,12
Твойвайб,gordunni,1576,paladin,retribution,108,58,50
Lawtõn,argent-dawn,1575,paladin,retribution,132,70,62
Azûl,archimonde,1575,paladin,retribution,138,70,68
Наспидах,grom,1575,paladin,retribution,55,20,35
Báldür,silvermoon,1574,paladin,retribution,60,30,30
Thazyru,frostmane,1573,paladin,retribution,42,30,12
Opsyoudie,kazzak,1573,paladin,retribution,111,51,60
Gulinborsti,aegwynn,1572,paladin,retribution,54,36,18
Seductîve,kazzak,1572,paladin,retribution,108,63,45
Heallgodxx,ragnaros,1572,paladin,retribution,30,17,13
Zaatar,stormscale,1572,paladin,retribution,53,30,23
Nukss,silvermoon,1572,paladin,retribution,54,21,33
Jaro,alleria,1571,paladin,retribution,51,26,25
Nexzz,outland,1570,paladin,retribution,35,26,9
Ксенджин,gordunni,1570,paladin,retribution,34,19,15
Mearsheimer,ysondre,1570,paladin,retribution,42,18,24
Mazekiel,archimonde,1569,paladin,retribution,36,22,14
Йосяфлексер,howling-fjord,1569,paladin,retribution,102,56,46
Luhae,archimonde,1568,paladin,retribution,72,44,28
Биоразлагаем,gordunni,1568,paladin,retribution,78,41,37
Paellysuir,blackmoore,1567,paladin,retribution,108,54,54
Afhvahj,tichondrius,1566,paladin,retribution,143,71,72
Orti,sanguino,1565,paladin,retribution,65,37,28
Bsepal,silvermoon,1565,paladin,retribution,188,99,89
Aethelwold,ragnaros,1565,paladin,retribution,132,56,76
Kathí,kazzak,1563,paladin,retribution,24,18,6
Trixzie,blackhand,1563,paladin,retribution,36,18,18
Сэдвиг,gordunni,1563,paladin,retribution,35,17,18
Jiraaqi,silvermoon,1562,paladin,retribution,53,27,26
Dalbo,aegwynn,1561,paladin,retribution,30,23,7
Kuhfleisch,eredar,1561,paladin,retribution,79,48,31
Qïkarï,antonidas,1561,paladin,retribution,61,35,26
Imaturtle,darksorrow,1561,paladin,retribution,54,19,35
Eiennoai,argent-dawn,1560,paladin,retribution,32,19,13
Lysander,antonidas,1560,paladin,retribution,36,17,19
Thesavage,magtheridon,1558,paladin,retribution,42,20,22
Blówout,tarren-mill,1557,paladin,retribution,42,23,19
Búbbles,nerathor,1556,paladin,retribution,30,18,12
Seraphyonhd,blackmoore,1556,paladin,retribution,82,44,38
Argentø,ravencrest,1556,paladin,retribution,168,87,81
Røck,aggra-português,1555,paladin,retribution,131,72,59
Giroud,dalaran,1555,paladin,retribution,36,17,19
Спидфрик,blackscar,1554,paladin,retribution,62,35,27
Ùthér,sylvanas,1554,paladin,retribution,43,22,21
Belnadris,eredar,1552,paladin,retribution,76,41,35
Taiso,alonsus,1552,paladin,retribution,59,30,29
Ketherian,blutkessel,1552,paladin,retribution,52,20,32
Cauze,ravencrest,1551,paladin,retribution,144,75,69
Drylands,ravencrest,1551,paladin,retribution,54,28,26
Elyox,ravencrest,1551,paladin,retribution,36,18,18
Naree,stormreaver,1549,paladin,retribution,42,21,21
Sunhalo,twisting-nether,1548,paladin,retribution,41,18,23
Lightwitcher,silvermoon,1548,paladin,retribution,96,42,54
Дорогаснега,gordunni,1547,paladin,retribution,42,23,19
Addwyr,blackrock,1547,paladin,retribution,60,30,30
Цитрон,blackscar,1546,paladin,retribution,24,17,7
Лаитнем,gordunni,1546,paladin,retribution,66,40,26
Zneeks,shattered-hand,1545,paladin,retribution,30,19,11
Letharen,argent-dawn,1545,paladin,retribution,32,17,15
Paakz,stormscale,1545,paladin,retribution,172,84,88
Мизуриэль,howling-fjord,1543,paladin,retribution,42,24,18
Maybach,onyxia,1543,paladin,retribution,66,31,35
Темплеар,gordunni,1543,paladin,retribution,66,23,43
Xëlâ,archimonde,1542,paladin,retribution,57,29,28
Раффаэло,borean-tundra,1542,paladin,retribution,96,46,50
Kènpachî,blackrock,1542,paladin,retribution,48,22,26
Isora,twisting-nether,1542,paladin,retribution,93,39,54
Baxxster,blackhand,1542,paladin,retribution,60,23,37
Interop,tarren-mill,1541,paladin,retribution,54,30,24
Эеомли,blackscar,1541,paladin,retribution,51,25,26
Nîcolascage,stormscale,1541,paladin,retribution,42,19,23
Obsidyen,outland,1541,paladin,retribution,38,17,21
Гневнебес,howling-fjord,1541,paladin,retribution,84,36,48
Zeldalòl,outland,1541,paladin,retribution,59,25,34
Ceccil,dun-modr,1540,paladin,retribution,78,46,32
Rimlod,saurfang,1540,paladin,retribution,84,46,38
Zehnya,grim-batol,1540,paladin,retribution,162,88,74
Arrious,frostmane,1540,paladin,retribution,47,25,22
Волатбай,gordunni,1539,paladin,retribution,60,36,24
Deloréane,archimonde,1539,paladin,retribution,62,30,32
Холишокович,deathweaver,1539,paladin,retribution,54,26,28
Лакоста,ashenvale,1538,paladin,retribution,57,26,31
Lycasia,hyjal,1538,paladin,retribution,66,27,39
Forja,silvermoon,1537,paladin,retribution,63,31,32
Runcarsnwpen,kazzak,1536,paladin,retribution,41,27,14
Cos,stormscale,1536,paladin,retribution,34,20,14
Darkdeal,tarren-mill,1536,paladin,retribution,32,17,15
Lavawraith,argent-dawn,1536,paladin,retribution,34,17,17
Krivonis,tarren-mill,1536,paladin,retribution,41,18,23
Catar,arathor,1535,paladin,retribution,169,95,74
Drdo,blackrock,1534,paladin,retribution,18,16,2
Vleisboom,ravencrest,1534,paladin,retribution,42,23,19
Byakkospal,tarren-mill,1534,paladin,retribution,114,58,56
Руказакона,deathguard,1533,paladin,retribution,67,32,35
Zerad,quelthalas,1533,paladin,retribution,80,32,48
Sikthorlan,ravencrest,1532,paladin,retribution,42,22,20
Rqd,blackrock,1532,paladin,retribution,36,16,20
Mofawilli,blackrock,1531,paladin,retribution,60,35,25
Fítzgerald,antonidas,1531,paladin,retribution,46,26,20
Hanksolos,drakthul,1531,paladin,retribution,40,22,18
Jorhall,antonidas,1531,paladin,retribution,103,54,49
Myrieni,silvermoon,1530,paladin,retribution,36,19,17
Bullstorm,burning-legion,1530,paladin,retribution,36,19,17
Tharizod,nagrand,1530,paladin,retribution,68,34,34
Riskha,archimonde,1529,paladin,retribution,45,31,14
Kawabanga,the-maelstrom,1529,paladin,retribution,46,25,21
Mimsy,dalaran,1529,paladin,retribution,107,54,53
Igrael,argent-dawn,1529,paladin,retribution,42,21,21
Júdger,twisting-nether,1528,paladin,retribution,77,38,39
Борссалино,gordunni,1528,paladin,retribution,99,48,51
Ришардебюр,soulflayer,1528,paladin,retribution,71,34,37
Valkyrjai,silvermoon,1528,paladin,retribution,65,30,35
Tyristrum,kilrogg,1528,paladin,retribution,42,17,25
Myridan,bloodhoof,1527,paladin,retribution,48,23,25
Apokalipsnik,drakthul,1527,paladin,retribution,48,22,26
Мётод,howling-fjord,1526,paladin,retribution,42,22,20
Galevar,argent-dawn,1526,paladin,retribution,132,68,64
Lamohru,argent-dawn,1526,paladin,retribution,66,29,37
Pný,silvermoon,1525,paladin,retribution,42,20,22
Saedrick,nemesis,1525,paladin,retribution,45,17,28
Xawier,ghostlands,1524,paladin,retribution,60,31,29
Wingzy,hyjal,1523,paladin,retribution,36,16,20
Mograine,die-aldor,1522,paladin,retribution,106,55,51
Shroomez,frostmane,1522,paladin,retribution,46,23,23
Retdead,nordrassil,1522,paladin,retribution,36,16,20
Stazo,drakthul,1522,paladin,retribution,36,16,20
Auryel,nemesis,1521,paladin,retribution,44,22,22
Snackzy,twisting-nether,1521,paladin,retribution,54,25,29
Dantrag,eredar,1521,paladin,retribution,60,24,36
Imreallybadx,blackrock,1520,paladin,retribution,55,31,24
Créo,draenor,1520,paladin,retribution,36,17,19
Supergallows,shattered-hand,1520,paladin,retribution,54,22,32
Buyamazon,kazzak,1519,paladin,retribution,36,17,19
Копаю,gordunni,1518,paladin,retribution,90,54,36
Adiútrix,silvermoon,1517,paladin,retribution,48,30,18
Codindio,silvermoon,1516,paladin,retribution,76,39,37
Timal,eitrigg,1516,paladin,retribution,109,55,54
Swàyz,archimonde,1516,paladin,retribution,126,55,71
Llaynn,argent-dawn,1516,paladin,retribution,54,20,34
Gashqx,hyjal,1515,paladin,retribution,45,32,13
Stelanâal,archimonde,1515,paladin,retribution,86,44,42
Rapwnzel,sylvanas,1515,paladin,retribution,60,30,30
Zoltes,twisting-nether,1515,paladin,retribution,63,31,32
Hys,stormscale,1514,paladin,retribution,42,23,19
Yømø,antonidas,1514,paladin,retribution,48,26,22
Сангвиний,howling-fjord,1514,paladin,retribution,162,74,88
Ojn,tarren-mill,1513,paladin,retribution,36,27,9
Io,frostwolf,1512,paladin,retribution,161,75,86
Theodór,antonidas,1512,paladin,retribution,83,35,48
Akâshi,dalaran,1511,paladin,retribution,48,28,20
Nataii,argent-dawn,1511,paladin,retribution,30,16,14
Lawlight,frostmane,1511,paladin,retribution,81,42,39
Вэис,borean-tundra,1510,paladin,retribution,53,29,24
Impaross,shattrath,1509,paladin,retribution,159,87,72
Mooses,stormscale,1509,paladin,retribution,66,34,32
Lestaf,the-maelstrom,1509,paladin,retribution,80,40,40
Clamjam,sylvanas,1509,paladin,retribution,72,28,44
Вэндрик,azuregos,1509,paladin,retribution,42,16,26
Vedaar,dun-modr,1508,paladin,retribution,30,24,6
Günselsen,antonidas,1507,paladin,retribution,228,119,109
Ínvi,aegwynn,1507,paladin,retribution,57,29,28
Истенен,blackscar,1507,paladin,retribution,90,39,51
Nfxx,argent-dawn,1506,paladin,retribution,58,35,23
Farata,ravencrest,1506,paladin,retribution,66,37,29
Росиель,soulflayer,1506,paladin,retribution,80,40,40
Hülä,antonidas,1506,paladin,retribution,36,16,20
Ulrhik,nemesis,1506,paladin,retribution,75,30,45
Enlightendz,ravencrest,1506,paladin,retribution,42,16,26
Koami,blackmoore,1505,paladin,retribution,56,30,26
Paradoax,quelthalas,1505,paladin,retribution,30,16,14
Tazkaz,archimonde,1505,paladin,retribution,56,27,29
Лусейд,howling-fjord,1503,paladin,retribution,47,32,15
Шоринг,gordunni,1503,paladin,retribution,48,25,23
Séanors,archimonde,1502,paladin,retribution,22,17,5
Notdeadfred,silvermoon,1502,paladin,retribution,48,28,20
Zélix,bronzebeard,1502,paladin,retribution,95,51,44
Elrandil,kazzak,1501,paladin,retribution,78,35,43
Enveador,garrosh,1500,paladin,retribution,60,35,25
Jathx,silvermoon,1498,paladin,retribution,62,36,26
Ralphias,tarren-mill,1498,paladin,retribution,72,32,40
Rafflesia,sanguino,1498,paladin,retribution,47,16,31
Válé,silvermoon,1497,paladin,retribution,92,42,50
Apolytos,laughing-skull,1497,paladin,retribution,85,35,50
Mattiesko,kazzak,1496,paladin,retribution,139,72,67
Колсет,soulflayer,1496,paladin,retribution,43,20,23
Eärendil,drakthul,1496,paladin,retribution,72,32,40
Dananas,draenor,1496,paladin,retribution,72,27,45
Варблэйз,gordunni,1495,paladin,retribution,30,16,14
Morninnstaar,kazzak,1495,paladin,retribution,30,16,14
Azhrei,archimonde,1495,paladin,retribution,36,16,20
Knigh,draenor,1494,paladin,retribution,96,47,49
Hornybìlly,stormscale,1494,paladin,retribution,42,16,26
Santaclaus,zuljin,1493,paladin,retribution,42,26,16
Маркант,gordunni,1493,paladin,retribution,72,42,30
Trisunonvaki,khazgoroth,1493,paladin,retribution,119,65,54
Тьёрн,gordunni,1493,paladin,retribution,48,26,22
Петуретрик,gordunni,1493,paladin,retribution,106,55,51
Majk,hellscream,1493,paladin,retribution,79,34,45
Ben,ghostlands,1492,paladin,retribution,24,16,8
Enolaer,ragnaros,1492,paladin,retribution,39,19,20
Галиор,soulflayer,1491,paladin,retribution,40,24,16
Násty,twisting-nether,1491,paladin,retribution,137,68,69
Havefunzqt,archimonde,1491,paladin,retribution,96,46,50
Jimrogier,argent-dawn,1491,paladin,retribution,60,28,32
Blader,darksorrow,1491,paladin,retribution,81,37,44
Angelcore,tarren-mill,1490,paladin,retribution,176,91,85
Малоко,thermaplugg,1490,paladin,retribution,36,18,18
Tuppo,argent-dawn,1490,paladin,retribution,109,51,58
Slayfer,dun-modr,1490,paladin,retribution,72,31,41
Eleuterus,bloodfeather,1490,paladin,retribution,48,19,29
Cassandrina,kazzak,1489,paladin,retribution,59,32,27
Selaphíel,kazzak,1489,paladin,retribution,150,78,72
Riukÿ,nemesis,1489,paladin,retribution,47,24,23
Sonarix,blackrock,1488,paladin,retribution,51,26,25
Менетиил,galakrond,1488,paladin,retribution,52,17,35
Azryn,kazzak,1487,paladin,retribution,32,18,14
Qpalax,outland,1487,paladin,retribution,38,17,21
Bloodyret,outland,1486,paladin,retribution,72,32,40
Astolfia,silvermoon,1485,paladin,retribution,37,21,16
Humphry,vashj,1485,paladin,retribution,54,27,27
Baldivar,silvermoon,1484,paladin,retribution,66,38,28
Nînaninja,silvermoon,1484,paladin,retribution,69,34,35
Pav,eredar,1484,paladin,retribution,53,24,29
Мистеравадон,gordunni,1484,paladin,retribution,158,71,87
Poohsie,ravencrest,1481,paladin,retribution,30,19,11
Osïrïs,kazzak,1481,paladin,retribution,81,35,46
Uxxer,sanguino,1479,paladin,retribution,41,23,18
Wrathlight,nemesis,1479,paladin,retribution,42,23,19
Portgas,hyjal,1479,paladin,retribution,48,24,24
Beefdaddyy,kazzak,1478,paladin,retribution,41,20,21
Rimva,alleria,1477,paladin,retribution,24,16,8
Романтик,deathweaver,1477,paladin,retribution,42,18,24
Râoh,arathi,1476,paladin,retribution,78,38,40
Neltix,blackrock,1476,paladin,retribution,77,37,40
Krakr,ravencrest,1476,paladin,retribution,36,17,19
Bloodpaly,silvermoon,1476,paladin,retribution,64,27,37
Boomboomciao,draenor,1473,paladin,retribution,30,21,9
Snibsxpala,silvermoon,1473,paladin,retribution,41,20,21
Rulîx,blackmoore,1473,paladin,retribution,80,30,50
Aurroraa,doomhammer,1471,paladin,retribution,45,22,23
Puré,festung-der-stürme,1470,paladin,retribution,41,18,23
Arfeniel,stormscale,1470,paladin,retribution,66,27,39
Graeme,ysondre,1469,paladin,retribution,36,16,20
Angelisho,zuljin,1469,paladin,retribution,101,39,62
Ðivine,stormscale,1468,paladin,retribution,76,42,34
Craaw,archimonde,1468,paladin,retribution,71,28,43
Ippî,blackmoore,1467,paladin,retribution,37,23,14
Schôck,eredar,1467,paladin,retribution,33,16,17
Ярослэйв,howling-fjord,1467,paladin,retribution,92,39,53
Annyaiva,outland,1467,paladin,retribution,66,27,39
Scarabeus,ravencrest,1466,paladin,retribution,52,30,22
Sieghard,aegwynn,1466,paladin,retribution,138,68,70
Leeroyjinks,twisting-nether,1464,paladin,retribution,36,21,15
Noxxiê,blackmoore,1464,paladin,retribution,36,20,16
Gazïel,kaelthas,1464,paladin,retribution,60,32,28
Avalindro,wrathbringer,1463,paladin,retribution,54,22,32
Gymly,kazzak,1462,paladin,retribution,156,87,69
Albz,laughing-skull,1461,paladin,retribution,36,17,19
Wälläce,sanguino,1461,paladin,retribution,41,16,25
Khouvec,tarren-mill,1460,paladin,retribution,30,19,11
Malemanlad,silvermoon,1460,paladin,retribution,132,67,65
Teryanna,ragnaros,1460,paladin,retribution,74,29,45
Цитология,borean-tundra,1459,paladin,retribution,108,63,45
Zanreti,outland,1458,paladin,retribution,110,57,53
Sangiorgio,nemesis,1458,paladin,retribution,36,18,18
Альфазеро,howling-fjord,1458,paladin,retribution,46,19,27
Leroya,blackrock,1457,paladin,retribution,35,18,17
Ветрум,gordunni,1456,paladin,retribution,36,18,18
Moodý,ragnaros,1455,paladin,retribution,88,43,45
Хамили,gordunni,1455,paladin,retribution,48,20,28
Elinmogz,kazzak,1454,paladin,retribution,26,16,10
Грузор,gordunni,1454,paladin,retribution,48,28,20
Holyhi,silvermoon,1454,paladin,retribution,58,32,26
Atemes,malorne,1453,paladin,retribution,27,17,10
Dvouklik,burning-blade,1453,paladin,retribution,47,28,19
Whitebreeze,sanguino,1453,paladin,retribution,70,37,33
Iljanaqt,blackrock,1452,paladin,retribution,64,26,38
Ficsuur,ragnaros,1451,paladin,retribution,187,94,93
Термотравка,grom,1451,paladin,retribution,186,86,100
Essenz,eredar,1451,paladin,retribution,64,23,41
Джагадаптер,gordunni,1450,paladin,retribution,88,49,39
Айэмбомб,howling-fjord,1450,paladin,retribution,40,20,20
Тюрр,lich-king,1450,paladin,retribution,49,23,26
Жанож,gordunni,1449,paladin,retribution,42,23,19
Wadey,tarren-mill,1449,paladin,retribution,54,25,29
Bubblebuttx,ghostlands,1448,paladin,retribution,59,29,30
Oldsqlmofu,blackrock,1448,paladin,retribution,36,17,19
Splasher,grim-batol,1448,paladin,retribution,84,39,45
Àræs,archimonde,1448,paladin,retribution,66,27,39
Logikoma,tarren-mill,1447,paladin,retribution,54,30,24
Асшура,howling-fjord,1447,paladin,retribution,40,20,20
Архэла,gordunni,1447,paladin,retribution,42,20,22
Dimes,argent-dawn,1446,paladin,retribution,25,18,7
Teìltaus,eredar,1446,paladin,retribution,60,28,32
Сакермвп,howling-fjord,1445,paladin,retribution,36,23,13
Рипкарт,gordunni,1445,paladin,retribution,30,18,12
Finñ,sylvanas,1445,paladin,retribution,65,32,33
Lerie,ravencrest,1444,paladin,retribution,39,19,20
Feelmylight,tarren-mill,1444,paladin,retribution,35,16,19
Frutte,malganis,1443,paladin,retribution,48,27,21
Valarians,nemesis,1443,paladin,retribution,30,16,14
Protos,ambossar,1443,paladin,retribution,42,21,21
Pliscken,kazzak,1443,paladin,retribution,47,20,27
Хиккудоджер,eversong,1442,paladin,retribution,196,104,92
Evililz,kazzak,1442,paladin,retribution,85,43,42
Torpala,burning-legion,1441,paladin,retribution,36,18,18
Neêsoldr,blackmoore,1441,paladin,retribution,54,25,29
Nothonnest,archimonde,1440,paladin,retribution,34,23,11
Legendaryxw,drakthul,1440,paladin,retribution,57,29,28
Hugins,chamber-of-aspects,1440,paladin,retribution,36,17,19
Pak,amanthul,1440,paladin,retribution,45,18,27
Soossi,silvermoon,1439,paladin,retribution,24,15,9
Naethan,malganis,1439,paladin,retribution,48,24,24
Андерлайт,azuregos,1439,paladin,retribution,41,19,22
Jcpd,drakthul,1439,paladin,retribution,40,16,24
Æthëlflæd,ravencrest,1438,paladin,retribution,83,53,30
Zebramann,silvermoon,1438,paladin,retribution,81,45,36
Hogan,blackmoore,1438,paladin,retribution,36,20,16
Dinønuggets,ravencrest,1438,paladin,retribution,30,15,15
Veckra,kazzak,1438,paladin,retribution,47,23,24
Dijkie,boulderfist,1438,paladin,retribution,36,16,20
Amburet,kazzak,1438,paladin,retribution,36,15,21
Chíllpills,silvermoon,1437,paladin,retribution,60,25,35
Mezzí,aegwynn,1436,paladin,retribution,48,27,21
Exceed,blackmoore,1436,paladin,retribution,30,15,15
Джибути,soulflayer,1436,paladin,retribution,105,51,54
Sebatrøz,ravencrest,1435,paladin,retribution,30,17,13
Alvagur,zirkel-des-cenarius,1435,paladin,retribution,46,26,20
Shröömïë,silvermoon,1435,paladin,retribution,140,69,71
Aumium,sunstrider,1435,paladin,retribution,112,51,61
Крода,deepholm,1434,paladin,retribution,36,18,18
Whitebronco,tarren-mill,1434,paladin,retribution,36,15,21
Holÿbeard,ravencrest,1433,paladin,retribution,42,26,16
Lipsvirgin,kazzak,1433,paladin,retribution,30,15,15
Lezira,ravencrest,1433,paladin,retribution,36,15,21
Drhammerdin,antonidas,1433,paladin,retribution,36,15,21
Campo,tarren-mill,1433,paladin,retribution,60,23,37
Vanyon,malganis,1432,paladin,retribution,26,16,10
Артреал,blackscar,1432,paladin,retribution,96,56,40
Lightstrike,stormrage,1432,paladin,retribution,30,17,13
Kyrokonserve,blackmoore,1431,paladin,retribution,73,38,35
Alithyra,earthen-ring,1431,paladin,retribution,85,42,43
Hammertime,guldan,1431,paladin,retribution,54,25,29
Logossh,dun-modr,1430,paladin,retribution,26,16,10
Sickbolt,eredar,1429,paladin,retribution,96,52,44
Jøøs,sargeras,1429,paladin,retribution,105,56,49
Holyshied,silvermoon,1429,paladin,retribution,36,16,20
Laptop,aegwynn,1427,paladin,retribution,24,15,9
Хоулик,howling-fjord,1427,paladin,retribution,69,37,32
Милостьрока,gordunni,1427,paladin,retribution,48,24,24
Refléx,zirkel-des-cenarius,1427,paladin,retribution,36,15,21
Сазар,gordunni,1426,paladin,retribution,51,21,30
Komen,dalaran,1424,paladin,retribution,24,15,9
Кериас,gordunni,1424,paladin,retribution,24,15,9
Rhyvar,outland,1424,paladin,retribution,30,15,15
Uraraka,burning-blade,1423,paladin,retribution,36,24,12
Cracish,ragnaros,1422,paladin,retribution,30,15,15
Каштоуны,soulflayer,1422,paladin,retribution,50,19,31
Nillenkäse,antonidas,1421,paladin,retribution,24,15,9
Slipmax,eredar,1421,paladin,retribution,42,17,25
Flaweldin,ravencrest,1420,paladin,retribution,18,15,3
Jâybee,ravencrest,1420,paladin,retribution,48,25,23
Shtaladin,sylvanas,1420,paladin,retribution,118,55,63
Fredas,hyjal,1419,paladin,retribution,78,42,36
Somixd,ragnaros,1418,paladin,retribution,176,83,93
Olivaresx,ravencrest,1418,paladin,retribution,54,19,35
Hydrath,ysondre,1417,paladin,retribution,90,41,49
Diamir,rajaxx,1417,paladin,retribution,51,20,31
Fryl,quelthalas,1416,paladin,retribution,66,37,29
Offa,draenor,1416,paladin,retribution,48,23,25
Jac,nemesis,1416,paladin,retribution,122,58,64
Ljumá,kazzak,1416,paladin,retribution,114,54,60
Madman,drakthul,1416,paladin,retribution,36,15,21
Fumaça,dun-modr,1415,paladin,retribution,107,61,46
Пивняк,eversong,1414,paladin,retribution,48,29,19
Воркаллес,gordunni,1414,paladin,retribution,66,39,27
Primle,thrall,1413,paladin,retribution,82,46,36
Valerionn,blackmoore,1413,paladin,retribution,37,19,18
Vaako,blackrock,1412,paladin,retribution,36,19,17
Синфуледи,gordunni,1412,paladin,retribution,66,23,43
Диваин,gordunni,1411,paladin,retribution,78,42,36
Lukeus,the-maelstrom,1411,paladin,retribution,84,45,39
Kaitlyne,tarren-mill,1411,paladin,retribution,271,129,142
Pállis,ravencrest,1410,paladin,retribution,24,16,8
Iklohz,sanguino,1410,paladin,retribution,76,43,33
Horgar,nagrand,1410,paladin,retribution,100,51,49
Izolated,aegwynn,1410,paladin,retribution,78,34,44
Kaelthir,bladefist,1409,paladin,retribution,47,30,17
Квемсис,ashenvale,1409,paladin,retribution,99,62,37
Йзериль,howling-fjord,1408,paladin,retribution,18,15,3
Наолина,gordunni,1408,paladin,retribution,59,28,31
Holyblast,shattered-hand,1407,paladin,retribution,30,23,7
Tóxicpaladín,kazzak,1407,paladin,retribution,103,46,57
Taiiki,archimonde,1406,paladin,retribution,72,42,30
Argonak,sanguino,1406,paladin,retribution,42,22,20
Grapaladin,sanguino,1406,paladin,retribution,44,23,21
Melior,skullcrusher,1406,paladin,retribution,94,47,47
Maltazar,arygos,1404,paladin,retribution,24,15,9
Fleshoflight,arathor,1404,paladin,retribution,45,27,18
Hagën,minahonda,1404,paladin,retribution,47,26,21
Keladen,burning-legion,1404,paladin,retribution,36,19,17
Ashent,stormscale,1404,paladin,retribution,76,38,38
Spartain,draenor,1404,paladin,retribution,42,19,23
Doomgape,alakir,1404,paladin,retribution,88,35,53
Crazzylight,kazzak,1403,paladin,retribution,74,35,39
Блуудс,howling-fjord,1403,paladin,retribution,55,25,30
Хилерскийхил,soulflayer,1403,paladin,retribution,38,15,23
Loscar,silvermoon,1402,paladin,retribution,30,15,15
Swan,chogall,1402,paladin,retribution,48,23,25
Nomurabeta,naxxramas,1401,paladin,retribution,50,24,26
Кветирон,soulflayer,1400,paladin,retribution,102,46,56
Boabux,draenor,1399,paladin,retribution,92,48,44
Баблспула,soulflayer,1399,paladin,retribution,109,51,58
Benno,dun-modr,1398,paladin,retribution,106,47,59
Ekzykes,ravencrest,1397,paladin,retribution,24,15,9
Samueel,blackmoore,1397,paladin,retribution,42,23,19
Пурджпал,soulflayer,1397,paladin,retribution,36,19,17
Panthalassá,argent-dawn,1396,paladin,retribution,48,26,22
Jeriiret,khaz-modan,1396,paladin,retribution,60,28,32
Vendikor,nemesis,1396,paladin,retribution,156,69,87
Gojesi,silvermoon,1395,paladin,retribution,48,21,27
Eulion,burning-legion,1394,paladin,retribution,18,15,3
Lééroÿ,sylvanas,1394,paladin,retribution,84,41,43
Sîlversun,grim-batol,1394,paladin,retribution,36,15,21
Vorber,darksorrow,1393,paladin,retribution,35,15,20
Gigap,ragnaros,1391,paladin,retribution,30,15,15
Buddabob,antonidas,1391,paladin,retribution,96,33,63
Jackub,draenor,1390,paladin,retribution,44,24,20
Thrinea,blackrock,1390,paladin,retribution,36,18,18
Ðøñe,draenor,1390,paladin,retribution,36,17,19
Софилион,gordunni,1389,paladin,retribution,57,30,27
Windsor,argent-dawn,1389,paladin,retribution,66,31,35
Syracx,blackhand,1389,paladin,retribution,59,27,32
Wisupl,silvermoon,1387,paladin,retribution,42,29,13
Booyaahh,ravencrest,1387,paladin,retribution,48,26,22
Блейзерфайт,eversong,1387,paladin,retribution,42,19,23
Блатш,greymane,1387,paladin,retribution,55,16,39
Shrøømz,antonidas,1386,paladin,retribution,48,25,23
Blekadin,ragnaros,1386,paladin,retribution,74,34,40
Zandorath,argent-dawn,1386,paladin,retribution,54,24,30
Rudî,sanguino,1384,paladin,retribution,34,25,9
Càrláßrùní,hyjal,1384,paladin,retribution,30,20,10
Unkillablee,stormscale,1384,paladin,retribution,64,34,30
Støøk,shendralar,1383,paladin,retribution,95,50,45
Parlma,naxxramas,1383,paladin,retribution,49,24,25
Ëlësilf,sanguino,1381,paladin,retribution,42,23,19
Ayàhuazka,ysondre,1381,paladin,retribution,96,43,53
Dmytropal,draenor,1380,paladin,retribution,36,17,19
Террорх,blackscar,1380,paladin,retribution,48,18,30
Palyx,cthun,1379,paladin,retribution,24,15,9
Илюшагодх,gordunni,1379,paladin,retribution,54,30,24
Vangottwald,drakthul,1379,paladin,retribution,54,25,29
Perrinaybull,magtheridon,1379,paladin,retribution,50,21,29
Vlodthar,uldum,1378,paladin,retribution,30,18,12
Далходж,soulflayer,1378,paladin,retribution,47,15,32
Мизиола,galakrond,1377,paladin,retribution,108,57,51
Кузькинамать,greymane,1377,paladin,retribution,102,42,60
Хеллкик,howling-fjord,1377,paladin,retribution,43,15,28
Tríbunus,blackmoore,1376,paladin,retribution,31,17,14
Retgaffeooku,conseil-des-ombres,1376,paladin,retribution,66,35,31
Tobzin,argent-dawn,1376,paladin,retribution,42,19,23
Algoric,suramar,1376,paladin,retribution,42,16,26
Sagittaxx,kazzak,1375,paladin,retribution,80,42,38
Walladin,stormscale,1375,paladin,retribution,93,45,48
Xavios,eredar,1375,paladin,retribution,42,18,24
Morniarn,argent-dawn,1374,paladin,retribution,54,29,25
Мэднессх,howling-fjord,1374,paladin,retribution,32,15,17
Dd,blackmoore,1374,paladin,retribution,76,35,41
Darnero,blackrock,1373,paladin,retribution,24,16,8
Бэдбой,howling-fjord,1373,paladin,retribution,48,23,25
Esdras,sanguino,1373,paladin,retribution,36,17,19
Gìne,archimonde,1373,paladin,retribution,32,15,17
Soulglo,ragnaros,1373,paladin,retribution,36,16,20
Duckiboy,ragnaros,1372,paladin,retribution,102,56,46
Bezúziusz,ragnaros,1372,paladin,retribution,56,30,26
Aleixodolphi,argent-dawn,1372,paladin,retribution,197,86,111
Дджаб,booty-bay,1372,paladin,retribution,46,20,26
Telredor,rexxar,1372,paladin,retribution,42,15,27
Palladain,draenor,1370,paladin,retribution,46,28,18
Hazorarh,argent-dawn,1370,paladin,retribution,31,17,14
Mexou,la-croisade-écarlate,1370,paladin,retribution,42,20,22
Hella,dunemaul,1368,paladin,retribution,47,26,21
Beyma,twisting-nether,1368,paladin,retribution,29,15,14
Goldhand,vashj,1368,paladin,retribution,72,34,38
Uwelist,arathor,1368,paladin,retribution,73,34,39
Ùthër,silvermoon,1367,paladin,retribution,36,20,16
Aeyalana,ragnaros,1367,paladin,retribution,35,17,18
Svetijuju,kazzak,1367,paladin,retribution,60,29,31
Töphuria,silvermoon,1366,paladin,retribution,53,27,26
Andocay,das-syndikat,1366,paladin,retribution,66,32,34
Серёжблондин,gordunni,1366,paladin,retribution,54,26,28
Rodakinos,outland,1365,paladin,retribution,52,30,22
Bladê,kazzak,1365,paladin,retribution,33,19,14
Memororo,stormscale,1365,paladin,retribution,38,15,23
Lovetospoonn,ravencrest,1364,paladin,retribution,30,18,12
Burstyléz,silvermoon,1364,paladin,retribution,30,18,12
Yaoiri,argent-dawn,1364,paladin,retribution,41,21,20
Синдикатх,soulflayer,1363,paladin,retribution,125,66,59
Ямыч,ashenvale,1362,paladin,retribution,34,17,17
Викиллер,grom,1361,paladin,retribution,42,22,20
Aasimar,twilights-hammer,1361,paladin,retribution,167,85,82
Pascual,magtheridon,1360,paladin,retribution,50,24,26
Vorsip,tarren-mill,1360,paladin,retribution,42,19,23
Эзарх,gordunni,1359,paladin,retribution,58,29,29
Ханпаладин,howling-fjord,1358,paladin,retribution,24,17,7
Azaël,illidan,1358,paladin,retribution,34,17,17
Sødaz,hyjal,1358,paladin,retribution,89,44,45
Тромбб,soulflayer,1358,paladin,retribution,36,15,21
Denlow,silvermoon,1357,paladin,retribution,66,32,34
Juliea,aegwynn,1357,paladin,retribution,84,39,45
Brigholm,argent-dawn,1357,paladin,retribution,74,30,44
Archibäld,silvermoon,1356,paladin,retribution,25,15,10
Гучив,howling-fjord,1354,paladin,retribution,48,27,21
Apolomaeuz,blackhand,1354,paladin,retribution,36,20,16
Âlßêdø,silvermoon,1354,paladin,retribution,84,43,41
Chimurei,silvermoon,1354,paladin,retribution,42,20,22
Bloodlord,twisting-nether,1354,paladin,retribution,55,24,31
Curtwizz,silvermoon,1353,paladin,retribution,39,19,20
Flawx,blackmoore,1352,paladin,retribution,47,23,24
Рэгнволд,deathguard,1352,paladin,retribution,52,25,27
Тэлматос,soulflayer,1351,paladin,retribution,36,15,21
Iamnami,earthen-ring,1351,paladin,retribution,58,23,35
Straxotia,twisting-nether,1350,paladin,retribution,36,19,17
Aisnil,twilights-hammer,1350,paladin,retribution,95,46,49
Troublebuble,silvermoon,1350,paladin,retribution,68,30,38
Sacredlol,blackmoore,1350,paladin,retribution,48,15,33
Yunax,silvermoon,1349,paladin,retribution,36,23,13
Raerion,ragnaros,1348,paladin,retribution,42,31,11
Sanduciorba,chamber-of-aspects,1348,paladin,retribution,32,19,13
Tønyx,les-clairvoyants,1346,paladin,retribution,38,16,22
Vâskt,dun-modr,1345,paladin,retribution,96,49,47
Forneus,nemesis,1344,paladin,retribution,84,47,37
Таурусс,booty-bay,1344,paladin,retribution,54,24,30
Budweison,silvermoon,1344,paladin,retribution,54,22,32
Esito,draenor,1343,paladin,retribution,28,15,13
Mashijudge,blackhand,1343,paladin,retribution,60,31,29
Джедай,blackscar,1343,paladin,retribution,30,14,16
Prosteprazak,ragnaros,1343,paladin,retribution,45,20,25
Защешот,gordunni,1343,paladin,retribution,36,14,22
Якунии,blackscar,1342,paladin,retribution,24,14,10
Маразоточка,howling-fjord,1342,paladin,retribution,35,17,18
Hislifelmao,kazzak,1342,paladin,retribution,36,14,22
Блэкхарм,gordunni,1342,paladin,retribution,42,14,28
Balthassar,kirin-tor,1341,paladin,retribution,60,28,32
Тайронх,soulflayer,1341,paladin,retribution,30,14,16
Chocbear,tarren-mill,1341,paladin,retribution,30,14,16
Аргонис,gordunni,1341,paladin,retribution,30,14,16
Wordup,senjin,1341,paladin,retribution,36,14,22
Тэмплари,galakrond,1340,paladin,retribution,93,48,45
Teho,dragonblight,1340,paladin,retribution,143,72,71
Zeyz,defias-brotherhood,1340,paladin,retribution,42,21,21
Brölin,sanguino,1340,paladin,retribution,48,22,26
Гуэргос,gordunni,1338,paladin,retribution,30,14,16
Screâm,eredar,1338,paladin,retribution,42,14,28
Aisolôn,thrall,1337,paladin,retribution,36,18,18
Ahzut,rashgarroth,1337,paladin,retribution,30,15,15
Mustach,aggra-português,1337,paladin,retribution,41,20,21
Razrpal,tarren-mill,1337,paladin,retribution,30,14,16
Stavrosy,outland,1337,paladin,retribution,36,14,22
Proximo,burning-legion,1336,paladin,retribution,24,14,10
Orzix,sylvanas,1336,paladin,retribution,47,26,21
Proletardk,draenor,1336,paladin,retribution,102,51,51
Dodgerwilly,outland,1336,paladin,retribution,30,14,16
Неиспоримый,soulflayer,1335,paladin,retribution,18,14,4
Yull,twisting-nether,1335,paladin,retribution,41,20,21
Мэибибэиби,howling-fjord,1335,paladin,retribution,36,14,22
Blaîzer,archimonde,1335,paladin,retribution,42,14,28
Zipoohun,arathor,1334,paladin,retribution,97,52,45
Radamanthes,ysondre,1334,paladin,retribution,66,32,34
Кранштейн,gordunni,1334,paladin,retribution,36,17,19
Neithi,twisting-nether,1334,paladin,retribution,30,14,16
Medieh,ravencrest,1334,paladin,retribution,33,15,18
Hisblade,emerald-dream,1333,paladin,retribution,30,17,13
Vaníos,nazjatar,1333,paladin,retribution,34,19,15
Блэквилл,howling-fjord,1333,paladin,retribution,114,55,59
Fløcki,blackhand,1333,paladin,retribution,30,14,16
Garthoronir,antonidas,1333,paladin,retribution,39,15,24
Deadlydawn,kazzak,1333,paladin,retribution,48,14,34
Disadin,sylvanas,1332,paladin,retribution,24,14,10
Eruth,ravencrest,1331,paladin,retribution,24,14,10
Romfis,arathor,1331,paladin,retribution,42,22,20
Белкоксю,booty-bay,1331,paladin,retribution,84,39,45
Dàrkùsh,archimonde,1330,paladin,retribution,35,21,14
Blakkjack,xavius,1330,paladin,retribution,24,14,10
Sharkayne,anubarak,1330,paladin,retribution,42,14,28
Imoss,hyjal,1329,paladin,retribution,36,22,14
Obé,argent-dawn,1329,paladin,retribution,184,102,82
Baé,drakthul,1329,paladin,retribution,37,15,22
Unohana,shattered-halls,1329,paladin,retribution,100,40,60
Ædrenn,archimonde,1329,paladin,retribution,42,14,28
Беспощадие,gordunni,1328,paladin,retribution,30,14,16
Egx,draenor,1328,paladin,retribution,36,15,21
Endar,drakthul,1327,paladin,retribution,48,21,27
Drivenlight,twisting-nether,1326,paladin,retribution,24,14,10
Doubtfire,tarren-mill,1325,paladin,retribution,30,14,16
Кливерти,gordunni,1325,paladin,retribution,36,14,22
Enriel,temple-noir,1324,paladin,retribution,30,16,14
Chelan,thrall,1324,paladin,retribution,36,14,22
Divinenoob,ravencrest,1321,paladin,retribution,24,14,10
Steakenstein,nathrezim,1320,paladin,retribution,48,26,22
Hydarr,twisting-nether,1320,paladin,retribution,62,33,29
Vvaarok,blackmoore,1320,paladin,retribution,77,33,44
Rothmans,aggra-português,1319,paladin,retribution,36,20,16
Ahnaa,argent-dawn,1319,paladin,retribution,100,50,50
Klittsurf,bloodhoof,1317,paladin,retribution,66,39,27
Barakisback,silvermoon,1317,paladin,retribution,40,22,18
Karthvitall,kaelthas,1316,paladin,retribution,24,14,10
Rosallyn,argent-dawn,1316,paladin,retribution,77,26,51
Hàsbulla,khaz-modan,1315,paladin,retribution,124,61,63
Sparrda,dun-modr,1314,paladin,retribution,48,24,24
Синерина,blackscar,1314,paladin,retribution,47,20,27
Valaeryanae,nemesis,1313,paladin,retribution,42,18,24
Howard,dalaran,1313,paladin,retribution,36,14,22
Foxare,burning-legion,1312,paladin,retribution,53,29,24
Пепсекольный,soulflayer,1312,paladin,retribution,48,25,23
Angarx,draenor,1311,paladin,retribution,28,16,12
Viiri,burning-legion,1311,paladin,retribution,71,40,31
Mendril,malorne,1309,paladin,retribution,36,23,13
Nardindindou,ysondre,1309,paladin,retribution,164,83,81
Zethadin,kazzak,1306,paladin,retribution,27,15,12
Kaizêr,silvermoon,1306,paladin,retribution,97,46,51
Slageth,argent-dawn,1306,paladin,retribution,42,17,25
Mataleo,archimonde,1305,paladin,retribution,66,41,25
Флаила,ashenvale,1304,paladin,retribution,66,37,29
Беймикс,gordunni,1303,paladin,retribution,72,36,36
Светонносец,gordunni,1303,paladin,retribution,72,28,44
Bonzai,blackrock,1302,paladin,retribution,109,54,55
Gavril,bloodfeather,1302,paladin,retribution,126,61,65
Darhuun,antonidas,1299,paladin,retribution,99,47,52
Nevermoore,doomhammer,1299,paladin,retribution,42,19,23
Serkunkoira,emeriss,1298,paladin,retribution,24,14,10
Jackypala,ravencrest,1298,paladin,retribution,48,25,23
Truezero,draenor,1297,paladin,retribution,42,23,19
Palangel,eldrethalas,1296,paladin,retribution,114,51,63
Elení,thrall,1296,paladin,retribution,37,15,22
Ретриванлав,gordunni,1296,paladin,retribution,72,24,48
Raweo,kilrogg,1294,paladin,retribution,78,47,31
Olaghkan,dun-modr,1294,paladin,retribution,26,14,12
Ultrabenzo,ravencrest,1294,paladin,retribution,35,14,21
Erin,wildhammer,1293,paladin,retribution,51,25,26
Варасса,grom,1293,paladin,retribution,30,14,16
Хен,blackscar,1292,paladin,retribution,50,26,24
Хоулишит,blackscar,1291,paladin,retribution,42,26,16
Orseis,anubarak,1291,paladin,retribution,29,15,14
Købìtø,archimonde,1291,paladin,retribution,48,21,27
Mantinel,hellfire,1290,paladin,retribution,32,20,12
Ahramanyu,blackrock,1289,paladin,retribution,42,20,22
Kreyvin,argent-dawn,1289,paladin,retribution,77,33,44
Uragan,blackmoore,1287,paladin,retribution,62,31,31
Raerk,dalaran,1286,paladin,retribution,73,41,32
Tomiris,twisting-nether,1286,paladin,retribution,36,16,20
Epoke,archimonde,1285,paladin,retribution,36,21,15
Angrykorean,blackmoore,1284,paladin,retribution,59,28,31
Holylimx,draenor,1283,paladin,retribution,114,56,58
Корсаро,deepholm,1283,paladin,retribution,109,53,56
Miqee,burning-legion,1283,paladin,retribution,47,20,27
Trollarage,confrérie-du-thorium,1281,paladin,retribution,54,28,26
Mughena,kazzak,1281,paladin,retribution,36,16,20
Ludø,ysondre,1280,paladin,retribution,26,15,11
Dieversity,stormscale,1280,paladin,retribution,41,16,25
Nazdarvole,drakthul,1279,paladin,retribution,54,29,25
Aikm,tarren-mill,1279,paladin,retribution,74,36,38
Zulem,grim-batol,1276,paladin,retribution,36,17,19
Aegend,antonidas,1275,paladin,retribution,169,79,90
Doxynator,silvermoon,1275,paladin,retribution,35,14,21
Кетран,howling-fjord,1273,paladin,retribution,48,20,28
Gonhilda,kazzak,1272,paladin,retribution,48,25,23
Lightmonger,drakthul,1271,paladin,retribution,30,17,13
Лейфи,howling-fjord,1271,paladin,retribution,48,23,25
Hammexõr,sylvanas,1271,paladin,retribution,87,39,48
Lightheartx,argent-dawn,1271,paladin,retribution,52,18,34
Hornox,ragnaros,1270,paladin,retribution,54,27,27
Молотоборец,gordunni,1269,paladin,retribution,74,40,34
Cästiël,arathor,1269,paladin,retribution,41,21,20
Plésmo,blackmoore,1269,paladin,retribution,41,20,21
Malagat,die-todeskrallen,1269,paladin,retribution,50,19,31
Кенториус,soulflayer,1268,paladin,retribution,30,21,9
Боевикс,ashenvale,1268,paladin,retribution,42,21,21
Эльбабло,lich-king,1268,paladin,retribution,45,21,24
Monkeylight,ambossar,1268,paladin,retribution,46,20,26
Перизкопец,gordunni,1267,paladin,retribution,32,17,15
Jagen,tyrande,1267,paladin,retribution,63,30,33
Auditõr,argent-dawn,1267,paladin,retribution,85,32,53
Dehanath,draenor,1266,paladin,retribution,41,18,23
Conserva,jaedenar,1265,paladin,retribution,52,32,20
Масачусетсс,gordunni,1263,paladin,retribution,54,28,26
Палочка,howling-fjord,1263,paladin,retribution,102,50,52
Dragonous,darkmoon-faire,1263,paladin,retribution,120,54,66
Irinor,rashgarroth,1262,paladin,retribution,36,18,18
Belldog,tarren-mill,1262,paladin,retribution,42,17,25
Splendida,festung-der-stürme,1260,paladin,retribution,17,14,3
Owiganowi,ulduar,1260,paladin,retribution,36,22,14
Shuler,silvermoon,1260,paladin,retribution,64,37,27
Teogrim,blackmoore,1259,paladin,retribution,54,32,22
Hemdâl,kirin-tor,1259,paladin,retribution,60,31,29
Icearth,pozzo-delleternità,1259,paladin,retribution,140,66,74
Takaret,hyjal,1259,paladin,retribution,145,68,77
Émøùki,dalaran,1258,paladin,retribution,41,19,22
Bärghest,sanguino,1256,paladin,retribution,48,29,19
Carpetcummer,ravencrest,1255,paladin,retribution,36,15,21
Lightppl,outland,1254,paladin,retribution,54,28,26
Миоцуки,gordunni,1254,paladin,retribution,82,37,45
Faithsmemory,silvermoon,1254,paladin,retribution,74,31,43
Derian,antonidas,1253,paladin,retribution,48,18,30
Hollylady,outland,1251,paladin,retribution,42,25,17
Gxdéon,hyjal,1249,paladin,retribution,69,39,30
Snottybrat,draenor,1249,paladin,retribution,86,45,41
Galadrion,dun-modr,1248,paladin,retribution,30,13,17
Asorte,chants-éternels,1248,paladin,retribution,96,40,56
Maloumnik,stormscale,1247,paladin,retribution,18,13,5
Retdream,nemesis,1247,paladin,retribution,18,13,5
Revinox,silvermoon,1247,paladin,retribution,24,15,9
Xanrian,kazzak,1247,paladin,retribution,24,13,11
Liadrineá,burning-blade,1247,paladin,retribution,24,13,11
Moløk,ysondre,1247,paladin,retribution,56,28,28
Leyawin,sanguino,1247,paladin,retribution,48,24,24
Zâre,sanguino,1247,paladin,retribution,71,34,37
Тардариус,gordunni,1247,paladin,retribution,30,13,17
Paladiodinos,hyjal,1247,paladin,retribution,42,16,26
Ilealstras,twisting-nether,1247,paladin,retribution,36,13,23
Khoping,silvermoon,1246,paladin,retribution,18,13,5
Нурти,gordunni,1246,paladin,retribution,18,13,5
Luckyman,aszune,1246,paladin,retribution,24,13,11
Kriszaa,burning-legion,1246,paladin,retribution,36,13,23
Тутн,gordunni,1245,paladin,retribution,24,13,11
Leith,neptulon,1245,paladin,retribution,46,24,22
Eagleone,shattrath,1245,paladin,retribution,30,15,15
Heavensfang,outland,1245,paladin,retribution,30,13,17
Hito,sylvanas,1245,paladin,retribution,30,13,17
Gromzed,ravencrest,1245,paladin,retribution,30,13,17
Sukinsin,aegwynn,1244,paladin,retribution,30,13,17
Marthawise,eredar,1244,paladin,retribution,30,13,17
Proxidus,blackmoore,1244,paladin,retribution,41,16,25
Fufth,pozzo-delleternità,1243,paladin,retribution,30,13,17
Mattüsälëmm,sanguino,1242,paladin,retribution,33,22,11
Jannene,draenor,1242,paladin,retribution,36,13,23
Arkura,nozdormu,1241,paladin,retribution,24,14,10
Joelosteen,neptulon,1241,paladin,retribution,54,29,25
Ague,spinebreaker,1241,paladin,retribution,36,13,23
Ïnata,khaz-modan,1240,paladin,retribution,36,15,21
Níthag,ragnaros,1239,paladin,retribution,24,13,11
Jdizzy,tarren-mill,1239,paladin,retribution,24,13,11
Aguerx,alleria,1239,paladin,retribution,30,13,17
Deldrina,nozdormu,1239,paladin,retribution,42,17,25
Geilershrimp,blackrock,1239,paladin,retribution,42,13,29
Nowitzki,sanguino,1238,paladin,retribution,18,13,5
Moraru,neptulon,1238,paladin,retribution,75,28,47
Cianna,shattered-hand,1237,paladin,retribution,40,13,27
Æe,blackmoore,1236,paladin,retribution,37,22,15
Ventsi,kazzak,1236,paladin,retribution,149,75,74
Singedth,defias-brotherhood,1236,paladin,retribution,57,28,29
Teliriyon,blackrock,1236,paladin,retribution,32,14,18
Khaelor,frostwolf,1235,paladin,retribution,24,13,11
Yrgin,ravencrest,1235,paladin,retribution,120,59,61
Нормвал,gordunni,1235,paladin,retribution,37,13,24
Lewp,tarren-mill,1234,paladin,retribution,18,13,5
Anatorka,drakthul,1234,paladin,retribution,78,39,39
Skénder,kazzak,1234,paladin,retribution,78,29,49
Akelad,arathor,1234,paladin,retribution,48,13,35
Гермесиус,deepholm,1233,paladin,retribution,41,21,20
Valpen,veknilash,1233,paladin,retribution,30,15,15
Хентайбогиня,ashenvale,1233,paladin,retribution,30,13,17
Irhoy,dalaran,1232,paladin,retribution,22,14,8
Zhaz,blackmoore,1232,paladin,retribution,84,38,46
Émilia,frostwolf,1232,paladin,retribution,40,14,26
Цвандр,gordunni,1231,paladin,retribution,64,30,34
Ликанн,soulflayer,1231,paladin,retribution,54,20,34
Bornir,khaz-modan,1230,paladin,retribution,71,33,38
Gerin,ulduar,1230,paladin,retribution,36,15,21
Wumbo,sinstralis,1229,paladin,retribution,36,19,17
Наваляка,deathguard,1228,paladin,retribution,24,13,11
Uthelf,ragnaros,1228,paladin,retribution,36,16,20
Nessùm,hyjal,1228,paladin,retribution,72,28,44
Painshield,outland,1228,paladin,retribution,41,13,28
Walorez,ragnaros,1227,paladin,retribution,23,13,10
Tillak,draenor,1227,paladin,retribution,24,13,11
Llya,blackrock,1227,paladin,retribution,26,14,12
Fintros,silvermoon,1227,paladin,retribution,30,14,16
Roxter,burning-legion,1227,paladin,retribution,30,13,17
Вандиир,soulflayer,1226,paladin,retribution,24,13,11
Barqin,ragnaros,1225,paladin,retribution,31,15,16
Atomicbubble,balnazzar,1225,paladin,retribution,54,26,28
Palantex,drakthul,1225,paladin,retribution,30,13,17
Juozas,argent-dawn,1225,paladin,retribution,30,13,17
Pytha,nozdormu,1224,paladin,retribution,79,43,36
Nollieflip,tarren-mill,1224,paladin,retribution,30,15,15
Ðarkjøjø,hyjal,1224,paladin,retribution,36,17,19
Bootybanger,thrall,1223,paladin,retribution,24,13,11
Patsani,twilights-hammer,1222,paladin,retribution,54,31,23
Cinderlight,aszune,1221,paladin,retribution,24,15,9
Velkar,frostmane,1221,paladin,retribution,56,29,27
Энилейт,lich-king,1220,paladin,retribution,70,44,26
Öwai,dun-modr,1220,paladin,retribution,47,28,19
Valerner,argent-dawn,1220,paladin,retribution,24,13,11
Swagged,kazzak,1220,paladin,retribution,46,21,25
Юлец,galakrond,1220,paladin,retribution,30,13,17
Lagaminë,dalaran,1219,paladin,retribution,111,53,58
Línke,sanguino,1218,paladin,retribution,55,32,23
Ragnarük,khaz-modan,1217,paladin,retribution,42,20,22
Helmed,tarren-mill,1215,paladin,retribution,57,31,26
Kyríé,tarren-mill,1215,paladin,retribution,24,13,11
Гарраж,howling-fjord,1215,paladin,retribution,36,14,22
Джекадамс,gordunni,1215,paladin,retribution,195,74,121
Бьюттасттл,howling-fjord,1215,paladin,retribution,35,13,22
Rilledread,stormscale,1214,paladin,retribution,114,57,57
Джагашарага,soulflayer,1214,paladin,retribution,29,13,16
Jynxedxoxo,blackrock,1214,paladin,retribution,36,16,20
Snowydin,tarren-mill,1213,paladin,retribution,30,17,13
Petitê,blackmoore,1210,paladin,retribution,29,17,12
Platanid,doomhammer,1210,paladin,retribution,62,35,27
Эезекииль,howling-fjord,1210,paladin,retribution,68,34,34
Aistor,burning-legion,1209,paladin,retribution,42,17,25
Lynaé,blackhand,1208,paladin,retribution,25,13,12
Hehtmonghour,sanguino,1208,paladin,retribution,36,17,19
Kýrp,stormreaver,1207,paladin,retribution,43,16,27
Diøstemplar,dun-modr,1206,paladin,retribution,70,36,34
Hypothalamus,silvermoon,1206,paladin,retribution,36,17,19
Storpixpala,drakthul,1205,paladin,retribution,24,13,11
Светлыйкит,blackscar,1204,paladin,retribution,48,25,23
Thorold,earthen-ring,1202,paladin,retribution,63,36,27
Dwangl,silvermoon,1201,paladin,retribution,30,13,17
Pitusá,dun-modr,1201,paladin,retribution,54,20,34
Edyk,silvermoon,1200,paladin,retribution,95,51,44
Лютыйчпок,fordragon,1200,paladin,retribution,76,34,42
Ramsay,arthas,1199,paladin,retribution,25,15,10
Flashyplays,silvermoon,1197,paladin,retribution,24,16,8
Tivv,blackhand,1197,paladin,retribution,29,13,16
Ironstealman,shattered-hand,1196,paladin,retribution,42,13,29
Ustex,argent-dawn,1195,paladin,retribution,29,13,16
Siuras,blackmoore,1194,paladin,retribution,23,13,10
Самерваль,borean-tundra,1194,paladin,retribution,91,47,44
Sertoli,frostwhisper,1194,paladin,retribution,30,15,15
Malianterø,ravencrest,1193,paladin,retribution,132,59,73
Dinøx,archimonde,1192,paladin,retribution,140,67,73
Mma,sylvanas,1192,paladin,retribution,65,31,34
Yanisx,burning-legion,1191,paladin,retribution,43,21,22
Thyalon,ragnaros,1191,paladin,retribution,30,14,16
Hïto,dun-modr,1189,paladin,retribution,24,14,10
Flòope,destromath,1188,paladin,retribution,60,33,27
Ocgynle,alonsus,1188,paladin,retribution,167,88,79
Мистерху,gordunni,1188,paladin,retribution,145,73,72
Freyjä,turalyon,1188,paladin,retribution,120,55,65
Keith,dragonmaw,1188,paladin,retribution,42,17,25
Toshvarak,turalyon,1187,paladin,retribution,60,29,31
Syng,garona,1186,paladin,retribution,36,14,22
Акерсарин,gordunni,1185,paladin,retribution,31,17,14
Shorella,malganis,1183,paladin,retribution,41,22,19
Tracsiee,twisting-nether,1183,paladin,retribution,32,14,18
Perfectum,burning-legion,1182,paladin,retribution,28,13,15
Remthas,argent-dawn,1181,paladin,retribution,57,24,33
Neijih,blackrock,1181,paladin,retribution,32,13,19
Bázer,antonidas,1181,paladin,retribution,34,13,21
Trainingdumy,aszune,1179,paladin,retribution,30,16,14
Raê,hyjal,1179,paladin,retribution,66,26,40
Ylvannka,blackmoore,1177,paladin,retribution,48,23,25
Ункаль,ashenvale,1177,paladin,retribution,156,74,82
Palitard,turalyon,1176,paladin,retribution,48,27,21
Ashernos,tarren-mill,1176,paladin,retribution,29,13,16
Tomkü,burning-legion,1174,paladin,retribution,34,15,19
Æternäl,arathor,1174,paladin,retribution,48,21,27
Exiztant,ravencrest,1173,paladin,retribution,60,32,28
Seigi,tarren-mill,1173,paladin,retribution,42,20,22
Atanasum,dun-modr,1172,paladin,retribution,20,13,7
Spanzer,dun-modr,1172,paladin,retribution,30,16,14
Антисеептик,gordunni,1172,paladin,retribution,69,35,34
Mirauda,nemesis,1171,paladin,retribution,66,23,43
Paladie,dalaran,1168,paladin,retribution,239,126,113
Paillasson,nerzhul,1167,paladin,retribution,52,31,21
Khrotos,draenor,1166,paladin,retribution,72,33,39
Lumino,twilights-hammer,1166,paladin,retribution,47,20,27
Whiffy,silvermoon,1165,paladin,retribution,60,24,36
Zemoss,kazzak,1164,paladin,retribution,24,14,10
Djpalacinka,drakthul,1164,paladin,retribution,36,16,20
Мильфорд,eversong,1162,paladin,retribution,84,37,47
Пропала,greymane,1161,paladin,retribution,60,28,32
Vallorum,ravencrest,1161,paladin,retribution,35,13,22
Holybubo,tarren-mill,1160,paladin,retribution,66,34,32
Beastyblodne,sylvanas,1160,paladin,retribution,36,18,18
Judgemented,turalyon,1160,paladin,retribution,60,27,33
Sufrion,outland,1159,paladin,retribution,42,18,24
Judgement,quelthalas,1158,paladin,retribution,30,20,10
Mosih,bloodfeather,1158,paladin,retribution,56,33,23
Vrgingamer,kazzak,1158,paladin,retribution,48,16,32
Pery,malganis,1157,paladin,retribution,48,28,20
Messîah,outland,1156,paladin,retribution,218,112,106
Vörtëx,tarren-mill,1155,paladin,retribution,29,15,14
Artplex,ravencrest,1154,paladin,retribution,27,15,12
Donwone,aegwynn,1152,paladin,retribution,18,12,6
Ixøne,kazzak,1152,paladin,retribution,18,12,6
Kilô,sylvanas,1152,paladin,retribution,24,12,12
Bighugg,draenor,1152,paladin,retribution,30,12,18
Aflogistina,sylvanas,1151,paladin,retribution,18,12,6
Vorthir,khaz-modan,1151,paladin,retribution,32,16,16
Валандор,gordunni,1151,paladin,retribution,24,12,12
Ретриксвета,eversong,1151,paladin,retribution,24,12,12
Рашенс,gordunni,1151,paladin,retribution,62,26,36
Arkk,blackrock,1151,paladin,retribution,30,12,18
Rizzdaddy,outland,1151,paladin,retribution,30,12,18
Memeadinxx,ravencrest,1151,paladin,retribution,30,12,18
Строу,blackscar,1150,paladin,retribution,18,12,6
Swânn,sanguino,1150,paladin,retribution,18,12,6
Гацкан,gordunni,1150,paladin,retribution,23,13,10
Cigyal,hyjal,1150,paladin,retribution,54,28,26
Stepamusicz,stormreaver,1150,paladin,retribution,42,21,21
Shatar,culte-de-la-rive-noire,1150,paladin,retribution,24,12,12
Käyle,alakir,1150,paladin,retribution,24,12,12
Knusern,dunemaul,1150,paladin,retribution,30,12,18
Konardos,burning-legion,1150,paladin,retribution,30,12,18
Missoii,khaz-modan,1149,paladin,retribution,18,12,6
Jkøø,sanguino,1149,paladin,retribution,24,12,12
Verbrännter,grim-batol,1149,paladin,retribution,30,12,18
Badjake,stormscale,1148,paladin,retribution,18,12,6
Spooder,xavius,1148,paladin,retribution,29,12,17
Deathlaf,argent-dawn,1147,paladin,retribution,18,12,6
Hippiehuman,darkspear,1147,paladin,retribution,18,12,6
Vakaza,cthun,1147,paladin,retribution,24,12,12
Unzufrieden,silvermoon,1147,paladin,retribution,24,12,12
Kirkmeister,terokkar,1147,paladin,retribution,43,19,24
Думклиф,gordunni,1147,paladin,retribution,36,12,24
Nebrii,doomhammer,1146,paladin,retribution,36,19,17
Ruftadin,ragnaros,1146,paladin,retribution,24,12,12
Хельдотер,howling-fjord,1146,paladin,retribution,25,12,13
Retenki,silvermoon,1146,paladin,retribution,30,12,18
Kreselia,ravencrest,1146,paladin,retribution,30,12,18
Иродиада,gordunni,1146,paladin,retribution,30,12,18
Aderos,sylvanas,1145,paladin,retribution,18,12,6
Analnydarek,silvermoon,1145,paladin,retribution,27,12,15
Trefino,blackrock,1144,paladin,retribution,18,12,6
Ultret,silvermoon,1144,paladin,retribution,24,12,12
Paulìe,draenor,1144,paladin,retribution,24,12,12
Медверус,gordunni,1144,paladin,retribution,37,15,22
Whatapity,silvermoon,1144,paladin,retribution,30,12,18
Glarcouf,eldrethalas,1143,paladin,retribution,29,16,13
Rînedaman,ysondre,1143,paladin,retribution,24,12,12
Eleiktra,suramar,1143,paladin,retribution,36,15,21
Bigdamjudge,argent-dawn,1142,paladin,retribution,18,12,6
Gucix,sylvanas,1142,paladin,retribution,24,12,12
Rayshield,tarren-mill,1142,paladin,retribution,47,23,24
Hèmera,archimonde,1141,paladin,retribution,24,12,12
Lerîan,dun-modr,1141,paladin,retribution,24,12,12
Eywinn,silvermoon,1141,paladin,retribution,30,12,18
Unogym,dragonblight,1140,paladin,retribution,24,12,12
Aipal,silvermoon,1138,paladin,retribution,30,12,18
Velikor,dun-modr,1137,paladin,retribution,24,12,12
Névér,steamwheedle-cartel,1134,paladin,retribution,24,12,12
Хампал,howling-fjord,1134,paladin,retribution,29,12,17
Animouse,drakthul,1133,paladin,retribution,18,12,6
Cpsuper,azuremyst,1133,paladin,retribution,24,14,10
Krïstâlùlz,archimonde,1132,paladin,retribution,58,30,28
Palaur,silvermoon,1131,paladin,retribution,30,12,18
Mimkoo,wildhammer,1130,paladin,retribution,27,16,11
Questos,burning-legion,1130,paladin,retribution,45,25,20
Thoorval,silvermoon,1130,paladin,retribution,34,14,20
Quoque,turalyon,1129,paladin,retribution,63,35,28
Pyronort,eredar,1128,paladin,retribution,24,12,12
Nelasson,eredar,1126,paladin,retribution,26,13,13
Deathzinger,aszune,1126,paladin,retribution,24,12,12
Sunsaiy,doomhammer,1125,paladin,retribution,119,63,56
Troj,ahnqiraj,1125,paladin,retribution,51,24,27
Sessian,bronze-dragonflight,1123,paladin,retribution,72,39,33
Адептустер,gordunni,1123,paladin,retribution,38,17,21
Bucaxin,cthun,1121,paladin,retribution,18,12,6
Buckfizz,ysondre,1121,paladin,retribution,36,22,14
Bulle,the-venture-co,1121,paladin,retribution,24,12,12
Ghallandre,khaz-modan,1120,paladin,retribution,24,13,11
Mystíque,die-todeskrallen,1119,paladin,retribution,66,34,32
Duralyon,marécage-de-zangar,1119,paladin,retribution,42,20,22
Joti,proudmoore,1119,paladin,retribution,30,12,18
Bàroo,twisting-nether,1117,paladin,retribution,29,12,17
Enîgmä,ravencrest,1117,paladin,retribution,40,12,28
Themlstake,kazzak,1115,paladin,retribution,18,12,6
Makiwara,emeriss,1113,paladin,retribution,91,44,47
Dafe,zuluhed,1113,paladin,retribution,50,21,29
Dewios,silvermoon,1112,paladin,retribution,30,14,16
Mindoxlawlz,sanguino,1111,paladin,retribution,36,12,24
Ghostfacê,khaz-modan,1105,paladin,retribution,42,20,22
Shädyss,hyjal,1105,paladin,retribution,76,34,42
Prínce,blackmoore,1105,paladin,retribution,32,12,20
Sylazz,blackrock,1104,paladin,retribution,130,60,70
Palabido,nemesis,1101,paladin,retribution,191,85,106
Fëanôr,tarren-mill,1100,paladin,retribution,200,102,98
Ayba,defias-brotherhood,1100,paladin,retribution,30,14,16
Javalie,sanguino,1099,paladin,retribution,21,12,9
Akeemys,ragnaros,1099,paladin,retribution,23,12,11
Baldarlyset,tarren-mill,1099,paladin,retribution,39,13,26
Kaljir,archimonde,1098,paladin,retribution,21,13,8
Ranitwo,tarren-mill,1098,paladin,retribution,28,14,14
Миссйеллоу,gordunni,1097,paladin,retribution,23,12,11
Xflye,khaz-modan,1096,paladin,retribution,41,22,19
Runkpaladin,kazzak,1096,paladin,retribution,60,32,28
Veshnu,blackrock,1095,paladin,retribution,50,20,30
Gropleindsup,ysondre,1095,paladin,retribution,36,14,22
Gnarlds,doomhammer,1094,paladin,retribution,42,24,18
Retrystyle,ragnaros,1093,paladin,retribution,53,24,29
Jebenatreba,sporeggar,1091,paladin,retribution,29,12,17
Irini,sylvanas,1089,paladin,retribution,25,14,11
Milojcica,kazzak,1087,paladin,retribution,17,12,5
Rileys,turalyon,1086,paladin,retribution,114,52,62
Opgezwolle,draenor,1085,paladin,retribution,56,35,21
Phaenre,pozzo-delleternità,1085,paladin,retribution,52,26,26
Azzael,thrall,1085,paladin,retribution,95,35,60
Mírato,blackhand,1083,paladin,retribution,42,19,23
Gllorya,ragnaros,1083,paladin,retribution,40,13,27
Valgar,ragnaros,1081,paladin,retribution,17,12,5
Nenenita,cthun,1081,paladin,retribution,115,58,57
Kollak,dun-modr,1081,paladin,retribution,51,20,31
Sandorr,area-52,1079,paladin,retribution,30,17,13
Aerathil,nethersturm,1079,paladin,retribution,41,22,19
Böb,garona,1078,paladin,retribution,36,14,22
Goungokuhrbo,doomhammer,1077,paladin,retribution,40,24,16
Samail,malganis,1076,paladin,retribution,30,13,17
Thardran,ravencrest,1075,paladin,retribution,30,14,16
Coelslaw,azjolnerub,1074,paladin,retribution,35,12,23
Zelphyr,pozzo-delleternità,1073,paladin,retribution,50,28,22
Starstríder,aszune,1073,paladin,retribution,24,12,12
Êxood,archimonde,1071,paladin,retribution,47,18,29
Gaizilla,burning-blade,1068,paladin,retribution,27,13,14
Wexo,frostwolf,1065,paladin,retribution,40,12,28
Apoffis,burning-legion,1064,paladin,retribution,36,19,17
Durwin,mazrigos,1063,paladin,retribution,55,23,32
Lliissaa,kazzak,1059,paladin,retribution,54,31,23
Хеллпанч,howling-fjord,1059,paladin,retribution,54,29,25
Lytza,frostwolf,1059,paladin,retribution,30,15,15
Doban,shattered-hand,1057,paladin,retribution,27,14,13
Йёкипавер,gordunni,1056,paladin,retribution,16,12,4
Nissesolsken,outland,1056,paladin,retribution,18,11,7
Sølitude,kazzak,1056,paladin,retribution,18,11,7
Сакон,borean-tundra,1056,paladin,retribution,24,11,13
Pia,twisting-nether,1056,paladin,retribution,24,11,13
Franzîskûs,blackmoore,1056,paladin,retribution,24,11,13
Phaewingsftw,kazzak,1056,paladin,retribution,24,11,13
Таурмакус,howling-fjord,1056,paladin,retribution,30,12,18
Nyxbane,kazzak,1056,paladin,retribution,30,11,19
Djmontana,archimonde,1056,paladin,retribution,30,11,19
Evölution,frostmane,1056,paladin,retribution,30,11,19
Turskah,shattered-hand,1055,paladin,retribution,18,11,7
Terrozina,stormscale,1055,paladin,retribution,18,11,7
Holydhanas,outland,1055,paladin,retribution,18,11,7
Erasdin,silvermoon,1055,paladin,retribution,18,11,7
Eléndrên,blackrock,1055,paladin,retribution,18,11,7
Tavil,sylvanas,1055,paladin,retribution,18,11,7
Kalimgor,theradras,1055,paladin,retribution,24,11,13
Шульц,borean-tundra,1055,paladin,retribution,24,11,13
Blademasteer,jaedenar,1055,paladin,retribution,24,11,13
Ijudgeppl,stormscale,1055,paladin,retribution,24,11,13
Mîakhalîfa,tarren-mill,1055,paladin,retribution,24,11,13
Stukker,silvermoon,1055,paladin,retribution,24,11,13
Mythsion,blackmoore,1055,paladin,retribution,24,11,13
Neverdeath,stormscale,1055,paladin,retribution,24,11,13
Vvsdiamonds,archimonde,1055,paladin,retribution,24,11,13
Roostersucka,stormreaver,1055,paladin,retribution,24,11,13
Palandiade,draenor,1055,paladin,retribution,24,11,13
Takezop,dun-modr,1055,paladin,retribution,24,11,13
Spiritbreak,archimonde,1055,paladin,retribution,24,11,13
Kaní,eredar,1055,paladin,retribution,30,11,19
Nukkss,silvermoon,1055,paladin,retribution,30,11,19
Hetrox,silvermoon,1054,paladin,retribution,18,11,7
Aludra,twisting-nether,1054,paladin,retribution,59,33,26
Sinthoràs,shattered-hand,1054,paladin,retribution,36,20,16
Blademàster,twisting-nether,1054,paladin,retribution,22,12,10
Palidos,blackrock,1054,paladin,retribution,24,11,13
Fleckige,nethersturm,1054,paladin,retribution,30,11,19
Phalex,outland,1054,paladin,retribution,30,11,19
Bailleya,drakthul,1054,paladin,retribution,30,11,19
Этокомедия,howling-fjord,1054,paladin,retribution,30,11,19
Redeem,nemesis,1054,paladin,retribution,30,11,19
Хилоретка,blackscar,1053,paladin,retribution,18,11,7
Vendil,tarren-mill,1053,paladin,retribution,18,11,7
Ridethelight,nemesis,1053,paladin,retribution,21,12,9
Snaty,khaz-modan,1053,paladin,retribution,83,44,39
Bartelemeus,draenor,1053,paladin,retribution,24,11,13
Mufuqa,ragnaros,1053,paladin,retribution,24,11,13
Moarcry,outland,1053,paladin,retribution,24,11,13
Trollilolz,eredar,1053,paladin,retribution,24,11,13
Deceneü,kazzak,1053,paladin,retribution,24,11,13
Némesis,frostmane,1053,paladin,retribution,24,11,13
Palaradis,doomhammer,1052,paladin,retribution,18,11,7
Ryaz,blackrock,1052,paladin,retribution,18,11,7
Hideinlight,hellscream,1052,paladin,retribution,24,11,13
Shufflee,drakthul,1052,paladin,retribution,24,11,13
Alard,sanguino,1052,paladin,retribution,30,11,19
Phorios,agamaggan,1052,paladin,retribution,36,11,25
Widj,silvermoon,1051,paladin,retribution,24,11,13
Rinocerb,ravencrest,1051,paladin,retribution,30,11,19
Омникнайтх,howling-fjord,1051,paladin,retribution,36,11,25
Ratedge,hyjal,1050,paladin,retribution,18,11,7
Traýan,blackmoore,1050,paladin,retribution,18,11,7
Dufftroll,kazzak,1050,paladin,retribution,24,11,13
Anamary,ravencrest,1050,paladin,retribution,45,18,27
Antidrasi,turalyon,1050,paladin,retribution,37,12,25
Lóyal,kazzak,1049,paladin,retribution,18,11,7
Plato,arthas,1049,paladin,retribution,30,16,14
Inkuboss,nemesis,1049,paladin,retribution,24,11,13
Freetimer,norgannon,1049,paladin,retribution,30,11,19
Justïce,twisting-nether,1049,paladin,retribution,30,11,19
Malleius,ravencrest,1049,paladin,retribution,30,11,19
Cornfalke,silvermoon,1048,paladin,retribution,18,11,7
Âchîle,garona,1048,paladin,retribution,55,31,24
Gerannan,kirin-tor,1048,paladin,retribution,48,24,24
Huhuu,outland,1048,paladin,retribution,24,11,13
Raptasenda,archimonde,1048,paladin,retribution,68,27,41
Crazybones,marécage-de-zangar,1047,paladin,retribution,36,16,20
Aury,mannoroth,1046,paladin,retribution,18,11,7
Arhu,stormscale,1046,paladin,retribution,24,14,10
Spizz,dun-modr,1046,paladin,retribution,30,11,19
Krustenkaese,kelthuzad,1045,paladin,retribution,18,11,7
Leilak,draenor,1045,paladin,retribution,44,26,18
Daicic,kazzak,1045,paladin,retribution,19,11,8
Palakag,blackhand,1045,paladin,retribution,42,12,30
Jooki,drakthul,1044,paladin,retribution,18,11,7
Kaelron,sanguino,1044,paladin,retribution,18,11,7
Traqnbilkarq,stormscale,1044,paladin,retribution,24,12,12
Shadderkpal,draenor,1042,paladin,retribution,30,11,19
Harycon,thrall,1041,paladin,retribution,30,11,19
Xinti,silvermoon,1039,paladin,retribution,17,11,6
Dildotbagins,argent-dawn,1039,paladin,retribution,58,34,24
Bigdamjudgee,outland,1039,paladin,retribution,23,11,12
Sinalia,shattrath,1039,paladin,retribution,24,11,13
Killa,stormrage,1038,paladin,retribution,24,11,13
Janky,draenor,1038,paladin,retribution,30,11,19
Rêmo,blackrock,1037,paladin,retribution,28,17,11
Поласс,gordunni,1037,paladin,retribution,23,11,12
Bitether,burning-legion,1037,paladin,retribution,24,11,13
Lowen,deathwing,1037,paladin,retribution,41,11,30
Эллессар,howling-fjord,1036,paladin,retribution,30,12,18
Kaedena,kaelthas,1035,paladin,retribution,18,11,7
Saró,ravencrest,1035,paladin,retribution,22,12,10
Celdrin,silvermoon,1035,paladin,retribution,23,12,11
Лефша,soulflayer,1034,paladin,retribution,18,11,7
Фокспро,lich-king,1032,paladin,retribution,24,11,13
Gôdfâthér,kazzak,1031,paladin,retribution,23,11,12
Nykothpn,ghostlands,1028,paladin,retribution,12,11,1
Aégon,archimonde,1026,paladin,retribution,54,23,31
Khveasir,argent-dawn,1026,paladin,retribution,36,11,25
Арморих,gordunni,1024,paladin,retribution,22,11,11
Hateless,tarren-mill,1024,paladin,retribution,28,11,17
Zanathos,onyxia,1023,paladin,retribution,30,20,10
Justrhino,kazzak,1023,paladin,retribution,29,11,18
Crazypits,silvermoon,1022,paladin,retribution,42,18,24
Nomeel,twisting-nether,1019,paladin,retribution,157,81,76
Devilsangel,antonidas,1019,paladin,retribution,29,11,18
Arathorin,ravencrest,1016,paladin,retribution,30,15,15
Matikosik,steamwheedle-cartel,1014,paladin,retribution,30,12,18
Quasimotto,turalyon,1014,paladin,retribution,36,13,23
Vonryan,defias-brotherhood,1011,paladin,retribution,51,20,31
Crynó,blackmoore,1010,paladin,retribution,30,13,17
Mickeyvorace,archimonde,1009,paladin,retribution,24,11,13
Danneris,sanguino,1008,paladin,retribution,31,15,16
Morhgain,kazzak,1007,paladin,retribution,42,21,21
Renaseh,twisting-nether,1007,paladin,retribution,23,11,12
Kipperb,kazzak,1007,paladin,retribution,23,11,12
ßrav,hyjal,1007,paladin,retribution,27,12,15
Bomsamdi,draenor,1007,paladin,retribution,85,37,48
Rdmhrvojehr,tarren-mill,1005,paladin,retribution,31,15,16
Dadpally,shattered-hand,1005,paladin,retribution,60,27,33
Ilovemylay,area-52,1004,paladin,retribution,21,11,10
Akakaboto,draenor,1003,paladin,retribution,30,11,19
Монбиин,soulflayer,1001,paladin,retribution,24,12,12
Sheïkka,hyjal,1001,paladin,retribution,68,30,38
Нэксти,howling-fjord,1001,paladin,retribution,29,11,18
Loire,blackmoore,1000,paladin,retribution,17,11,6
Сверхпаладин,howling-fjord,999,paladin,retribution,18,11,7
Tomales,aggramar,998,paladin,retribution,36,18,18
Killtauren,kazzak,998,paladin,retribution,78,36,42
Эксвайп,howling-fjord,997,paladin,retribution,23,11,12
Kealen,nemesis,997,paladin,retribution,85,34,51
Bryllks,die-todeskrallen,996,paladin,retribution,42,25,17
Pratt,deathwing,989,paladin,retribution,20,11,9
Zerohour,kilrogg,987,paladin,retribution,34,11,23
Jenyu,sanguino,986,paladin,retribution,29,13,16
Assyr,blackmoore,984,paladin,retribution,17,11,6
Cydor,khaz-modan,983,paladin,retribution,36,13,23
Ukey,sanguino,978,paladin,retribution,48,27,21
Haquiles,shendralar,974,paladin,retribution,22,12,10
Summuno,eredar,973,paladin,retribution,150,59,91
Supou,twisting-nether,972,paladin,retribution,24,14,10
Almohalhil,tarren-mill,972,paladin,retribution,24,13,11
Бунча,gordunni,971,paladin,retribution,66,23,43
Thebestpala,tarren-mill,969,paladin,retribution,25,11,14
Ârthâstrâs,terrordar,968,paladin,retribution,30,17,13
Fannii,ravencrest,968,paladin,retribution,24,11,13
Eltruite,archimonde,962,paladin,retribution,60,25,35
Joekickass,madmortem,960,paladin,retribution,12,10,2
Fîzè,blackmoore,960,paladin,retribution,16,11,5
Vhalkur,dun-modr,960,paladin,retribution,18,10,8
Nzmamba,burning-legion,960,paladin,retribution,18,10,8
Blazerlolz,kazzak,960,paladin,retribution,18,10,8
Navayo,frostmourne,960,paladin,retribution,18,10,8
Roklim,blackhand,960,paladin,retribution,18,10,8
Rubína,aegwynn,960,paladin,retribution,20,10,10
Daveboss,dragonblight,960,paladin,retribution,24,10,14
Sulask,argent-dawn,960,paladin,retribution,24,10,14
Darkkissx,lightbringer,960,paladin,retribution,24,10,14
Байстр,soulflayer,960,paladin,retribution,24,10,14
Dioxius,stormscale,960,paladin,retribution,24,10,14
Валькирия,grom,960,paladin,retribution,24,10,14
Styxpl,blackhand,960,paladin,retribution,30,10,20
Садистка,soulflayer,960,paladin,retribution,30,10,20
Атласс,gordunni,960,paladin,retribution,30,10,20
Saulencio,zuljin,960,paladin,retribution,36,10,26
Dìe,silvermoon,959,paladin,retribution,18,10,8
Malapal,hyjal,959,paladin,retribution,18,10,8
Lonesoul,tarren-mill,959,paladin,retribution,18,10,8
Gangb,ravencrest,959,paladin,retribution,18,10,8
Bunurata,silvermoon,959,paladin,retribution,18,10,8
Адвакаад,soulflayer,959,paladin,retribution,18,10,8
Aroyul,silvermoon,959,paladin,retribution,18,10,8
Omaw,ragnaros,959,paladin,retribution,18,10,8
Makakí,twisting-nether,959,paladin,retribution,18,10,8
Vindicatê,stormscale,959,paladin,retribution,18,10,8
Naenel,dun-modr,959,paladin,retribution,24,10,14
Croptol,dun-modr,959,paladin,retribution,24,10,14
Thaddios,burning-blade,959,paladin,retribution,24,10,14
Нижмубабл,soulflayer,959,paladin,retribution,27,11,16
Armas,stormscale,959,paladin,retribution,28,11,17
Annurra,quelthalas,959,paladin,retribution,30,10,20
Teshkipowa,kazzak,959,paladin,retribution,30,10,20
Mögräine,grim-batol,959,paladin,retribution,30,10,20
Coralinê,sanguino,958,paladin,retribution,12,10,2
Eosan,argent-dawn,958,paladin,retribution,12,10,2
Nyren,guldan,958,paladin,retribution,12,10,2
Милликсайс,howling-fjord,958,paladin,retribution,18,10,8
Sorciex,blackmoore,958,paladin,retribution,18,10,8
Arcardi,dun-morogh,958,paladin,retribution,18,10,8
Антрасс,soulflayer,958,paladin,retribution,18,10,8
Balderstomp,jaedenar,958,paladin,retribution,18,10,8
Valanysa,blackmoore,958,paladin,retribution,18,10,8
Béhèlit,sargeras,958,paladin,retribution,18,10,8
Леаркус,blackscar,958,paladin,retribution,24,10,14
Évert,twisting-nether,957,paladin,retribution,12,10,2
Keógh,kazzak,957,paladin,retribution,12,10,2
Rèmi,pozzo-delleternità,957,paladin,retribution,16,11,5
Xalthan,defias-brotherhood,957,paladin,retribution,18,10,8
Кадаврициан,howling-fjord,957,paladin,retribution,24,10,14
Winterwall,sylvanas,957,paladin,retribution,24,10,14
Dimdon,silvermoon,957,paladin,retribution,24,10,14
Feenux,drakthul,956,paladin,retribution,16,11,5
Malodos,archimonde,956,paladin,retribution,18,10,8
Ayoub,argent-dawn,956,paladin,retribution,18,10,8
Mílkme,antonidas,956,paladin,retribution,18,10,8
Injustice,chamber-of-aspects,956,paladin,retribution,25,11,14
Szaporító,ragnaros,956,paladin,retribution,24,10,14
Diaéna,kirin-tor,956,paladin,retribution,30,10,20
Didtaras,terokkar,956,paladin,retribution,30,10,20
Løøktår,ysondre,955,paladin,retribution,18,10,8
Mííss,silvermoon,955,paladin,retribution,24,10,14
Crawladin,eonar,955,paladin,retribution,24,10,14
Holypurger,shattered-hand,955,paladin,retribution,25,10,15
Calluk,turalyon,955,paladin,retribution,29,11,18
Рапсодихх,gordunni,955,paladin,retribution,32,10,22
Palahôlika,antonidas,953,paladin,retribution,18,10,8
Iqso,argent-dawn,953,paladin,retribution,18,10,8
Palädörette,dalaran,951,paladin,retribution,17,11,6
Ressurection,outland,951,paladin,retribution,58,25,33
Nözderg,archimonde,951,paladin,retribution,30,10,20
Gottfrid,sunstrider,949,paladin,retribution,18,10,8
Groelin,frostmane,949,paladin,retribution,18,10,8
Cáli,forscherliga,949,paladin,retribution,18,10,8
Cyclope,frostmane,948,paladin,retribution,26,10,16
Xemoth,kazzak,947,paladin,retribution,18,10,8
Olwie,argent-dawn,947,paladin,retribution,18,10,8
Bierkapítän,blackrock,946,paladin,retribution,12,10,2
Ziggyz,kul-tiras,945,paladin,retribution,19,10,9
Thëone,exodar,945,paladin,retribution,22,11,11
Donttaskwhy,sylvanas,942,paladin,retribution,30,10,20
Patzi,die-todeskrallen,941,paladin,retribution,67,33,34
Kawakii,outland,940,paladin,retribution,18,10,8
Glotzkowski,kelthuzad,938,paladin,retribution,18,10,8
Meneth,elune,930,paladin,retribution,55,15,40
Josuaa,ragnaros,929,paladin,retribution,80,36,44
Wolya,blackrock,927,paladin,retribution,21,11,10
Ghéttørèt,das-konsortium,927,paladin,retribution,26,11,15
Куоширо,goldrinn,925,paladin,retribution,36,16,20
Lightblaze,doomhammer,924,paladin,retribution,54,18,36
Eatfasteatas,doomhammer,923,paladin,retribution,12,10,2
Zayonix,amanthul,923,paladin,retribution,17,10,7
Stfortt,ragnaros,920,paladin,retribution,18,11,7
Zingler,norgannon,920,paladin,retribution,30,16,14
Atacan,twisting-nether,920,paladin,retribution,48,23,25
Luxor,sporeggar,919,paladin,retribution,24,14,10
Ressler,tichondrius,919,paladin,retribution,27,12,15
Klikas,twisting-nether,918,paladin,retribution,36,18,18
Схемас,gordunni,910,paladin,retribution,36,14,22
Helvirya,defias-brotherhood,909,paladin,retribution,198,87,111
Rustig,talnivarr,906,paladin,retribution,17,10,7
Ranish,aegwynn,906,paladin,retribution,33,11,22
Апония,gordunni,906,paladin,retribution,34,11,23
Vibeer,ravencrest,901,paladin,retribution,122,59,63
Érléuchtas,kazzak,899,paladin,retribution,22,11,11
Танси,fordragon,898,paladin,retribution,18,11,7
Gurutze,ragnaros,896,paladin,retribution,16,10,6
Nordiusek,drakthul,896,paladin,retribution,28,10,18
Tigerherz,antonidas,895,paladin,retribution,28,10,18
Lògàn,pozzo-delleternità,894,paladin,retribution,20,10,10
Lolladin,blackmoore,894,paladin,retribution,26,10,16
Reiwyn,archimonde,893,paladin,retribution,28,10,18
Vexxus,blackrock,892,paladin,retribution,48,22,26
Milicos,sylvanas,891,paladin,retribution,48,24,24
Tánk,twilights-hammer,888,paladin,retribution,48,22,26
Purjolöken,tarren-mill,887,paladin,retribution,26,10,16
Romkaq,silvermoon,884,paladin,retribution,18,11,7
Pepsimaxpvp,blackmoore,880,paladin,retribution,25,10,15
Celébriel,twisting-nether,877,paladin,retribution,19,10,9
Fardahr,ravencrest,877,paladin,retribution,24,10,14
Evilerpaly,stormscale,873,paladin,retribution,17,11,6
Фэнон,gordunni,864,paladin,retribution,12,9,3
Stitchup,argent-dawn,864,paladin,retribution,12,9,3
Unleashed,antonidas,864,paladin,retribution,12,9,3
Eazybubble,blackhand,864,paladin,retribution,12,9,3
Сынбогов,gordunni,864,paladin,retribution,12,9,3
Subzie,archimonde,864,paladin,retribution,12,9,3
Duno,archimonde,864,paladin,retribution,12,9,3
Holmat,twisting-nether,864,paladin,retribution,12,9,3
Ðox,frostmane,864,paladin,retribution,12,9,3
Holysnickers,tarren-mill,864,paladin,retribution,12,9,3
Camusa,kazzak,864,paladin,retribution,12,9,3
Camusax,kazzak,864,paladin,retribution,12,9,3
Loani,dalaran,864,paladin,retribution,18,9,9
Hølypwnjk,forscherliga,864,paladin,retribution,18,9,9
Retgodx,eredar,864,paladin,retribution,18,9,9
Püshup,archimonde,864,paladin,retribution,18,9,9
Pesterci,draenor,864,paladin,retribution,18,9,9
Zey,auchindoun,864,paladin,retribution,18,9,9
Gulyas,tarren-mill,864,paladin,retribution,18,9,9
Kaarsius,defias-brotherhood,864,paladin,retribution,18,9,9
Noxy,thrall,864,paladin,retribution,18,9,9
Cùpìdstunt,draenor,864,paladin,retribution,18,9,9
Limitlez,blackhand,864,paladin,retribution,18,9,9
Paterymon,ravencrest,864,paladin,retribution,18,9,9
Mitsoû,archimonde,864,paladin,retribution,18,9,9
Jicekaa,archimonde,864,paladin,retribution,18,9,9
Xinxin,azshara,864,paladin,retribution,18,9,9
Scillá,aegwynn,864,paladin,retribution,18,9,9
Reckonin,nagrand,864,paladin,retribution,18,9,9
Lagrops,chants-éternels,864,paladin,retribution,24,9,15
Krýptø,ravencrest,864,paladin,retribution,24,9,15
Thoriz,elune,864,paladin,retribution,24,9,15
Shuukz,blackmoore,864,paladin,retribution,24,9,15
Veldora,zuljin,864,paladin,retribution,24,9,15
Kæycc,blackmoore,864,paladin,retribution,24,9,15
Saiyaan,silvermoon,864,paladin,retribution,24,9,15
Lindrone,aggra-português,864,paladin,retribution,24,9,15
Святстраж,gordunni,864,paladin,retribution,27,10,17
Umirinbruv,zenedar,864,paladin,retribution,30,9,21
Døgpaladin,outland,864,paladin,retribution,30,9,21
Âtom,outland,864,paladin,retribution,30,9,21
Aksios,kazzak,863,paladin,retribution,12,9,3
Vootele,draenor,863,paladin,retribution,12,9,3
Nakedholy,draenor,863,paladin,retribution,12,9,3
Váliant,tarren-mill,863,paladin,retribution,12,9,3
Koltop,ravencrest,863,paladin,retribution,12,9,3
Тарйья,gordunni,863,paladin,retribution,13,9,4
Paidien,twisting-nether,863,paladin,retribution,17,9,8
Dälaghetto,kilrogg,863,paladin,retribution,18,9,9
Nordkreuz,aegwynn,863,paladin,retribution,18,9,9
Fujszi,arathor,863,paladin,retribution,18,9,9
Durnell,sylvanas,863,paladin,retribution,18,9,9
Veejxo,silvermoon,863,paladin,retribution,18,9,9
Yngild,antonidas,863,paladin,retribution,18,9,9
Thaldrael,colinas-pardas,863,paladin,retribution,18,9,9
Lightsbreath,ragnaros,863,paladin,retribution,18,9,9
Sildrit,draenor,863,paladin,retribution,18,9,9
Зольвинталь,deathguard,863,paladin,retribution,18,9,9
Frequencer,ragnaros,863,paladin,retribution,18,9,9
Добегуубью,thermaplugg,863,paladin,retribution,21,10,11
Galerian,twilights-hammer,863,paladin,retribution,24,9,15
Celerius,trollbane,863,paladin,retribution,24,9,15
Palarezz,ysondre,863,paladin,retribution,24,9,15
Axone,ravencrest,863,paladin,retribution,24,9,15
Дэвсон,greymane,863,paladin,retribution,24,9,15
Asgardietis,kazzak,863,paladin,retribution,27,10,17
Anesthesiax,ravencrest,863,paladin,retribution,33,10,23
Tapsgg,silvermoon,863,paladin,retribution,30,9,21
Саламанлдрыч,soulflayer,863,paladin,retribution,42,9,33
Blatrix,kazzak,862,paladin,retribution,12,9,3
Wtyou,blackhand,862,paladin,retribution,12,9,3
Kabóm,kazzak,862,paladin,retribution,12,9,3
Ephialtis,hyjal,862,paladin,retribution,12,9,3
Paduj,kazzak,862,paladin,retribution,12,9,3
Stinkytoes,draenor,862,paladin,retribution,18,9,9
Slipoj,blackhand,862,paladin,retribution,18,9,9
Alâkir,kazzak,862,paladin,retribution,18,9,9
Lìmier,ysondre,862,paladin,retribution,18,9,9
Darkenorr,silvermoon,862,paladin,retribution,18,9,9
Yæø,archimonde,862,paladin,retribution,18,9,9
Mugraine,ravencrest,862,paladin,retribution,18,9,9
Роллита,gordunni,862,paladin,retribution,24,9,15
Ллосла,howling-fjord,862,paladin,retribution,36,9,27
Viffi,darkspear,861,paladin,retribution,12,9,3
Skittlespala,twisting-nether,861,paladin,retribution,12,9,3
Retributon,madmortem,861,paladin,retribution,18,9,9
Bubblefett,ysera,861,paladin,retribution,18,9,9
Paajaxd,drakthul,861,paladin,retribution,18,9,9
Jpally,ravencrest,861,paladin,retribution,18,9,9
Wøømy,hyjal,861,paladin,retribution,24,9,15
Sölaria,silvermoon,860,paladin,retribution,18,9,9
Catsnek,darksorrow,860,paladin,retribution,18,9,9
Banister,eredar,860,paladin,retribution,24,9,15
Artorya,outland,859,paladin,retribution,18,9,9
Jêzus,blackrock,858,paladin,retribution,12,9,3
Кс,greymane,858,paladin,retribution,18,9,9
Rètbull,blackhand,858,paladin,retribution,18,9,9
Ènyalius,silvermoon,858,paladin,retribution,24,9,15
Immortalkrux,archimonde,858,paladin,retribution,71,23,48
Gljeto,tarren-mill,856,paladin,retribution,12,9,3
Mootaindew,tarren-mill,855,paladin,retribution,12,9,3
Holytrol,kazzak,855,paladin,retribution,18,9,9
Сапфирия,galakrond,855,paladin,retribution,30,9,21
Legiønr,ravencrest,854,paladin,retribution,12,9,3
Greyeyed,kazzak,854,paladin,retribution,32,10,22
Bubblemama,aegwynn,853,paladin,retribution,18,9,9
Fortination,dalaran,853,paladin,retribution,18,9,9
Fløki,blackrock,848,paladin,retribution,20,10,10
Fortplus,pozzo-delleternità,846,paladin,retribution,28,13,15
Bellùm,archimonde,846,paladin,retribution,20,9,11
Atírpákja,doomhammer,846,paladin,retribution,21,9,12
Ericafontës,kazzak,846,paladin,retribution,23,9,14
Knygnesys,silvermoon,844,paladin,retribution,15,11,4
Orelius,guldan,838,paladin,retribution,42,16,26
Тельбрук,gordunni,832,paladin,retribution,22,9,13
Humangüy,kazzak,831,paladin,retribution,23,9,14
Драгун,gordunni,830,paladin,retribution,61,27,34
Dôrä,ysondre,830,paladin,retribution,23,9,14
Pàlàthor,khaz-modan,826,paladin,retribution,18,9,9
Kolam,khaz-modan,825,paladin,retribution,24,10,14
Spánkit,stormscale,825,paladin,retribution,26,10,16
Pyrogon,malorne,823,paladin,retribution,164,76,88
Vuzetevacabo,doomhammer,823,paladin,retribution,114,51,63
Scralet,tarren-mill,815,paladin,retribution,17,9,8
Mckellen,antonidas,810,paladin,retribution,15,10,5
Valaudu,stormscale,810,paladin,retribution,17,9,8
Ararion,tarren-mill,809,paladin,retribution,18,10,8
Khadet,draenor,809,paladin,retribution,22,10,12
Fumatelo,tyrande,808,paladin,retribution,18,9,9
Fufenzee,stormscale,808,paladin,retribution,101,41,60
Choyoki,blackmoore,802,paladin,retribution,26,9,17
Melnes,draenor,801,paladin,retribution,23,12,11
Ксамо,howling-fjord,798,paladin,retribution,11,9,2
Юримия,blackscar,798,paladin,retribution,17,9,8
Penknife,ravencrest,797,paladin,retribution,20,9,11
Altrazel,archimonde,795,paladin,retribution,20,10,10
Guckzu,malganis,794,paladin,retribution,25,10,15
Сенторин,borean-tundra,791,paladin,retribution,28,9,19
Kubrat,eredar,788,paladin,retribution,42,16,26
Legitpower,silvermoon,783,paladin,retribution,46,19,27
Сильвернайт,soulflayer,779,paladin,retribution,29,10,19
Баблыч,borean-tundra,771,paladin,retribution,42,17,25
Sunfather,twilights-hammer,769,paladin,retribution,71,32,39
Xoriun,norgannon,768,paladin,retribution,12,8,4
Biqmac,mugthol,768,paladin,retribution,12,8,4
Pakór,blackrock,768,paladin,retribution,12,8,4
Enanon,zuljin,768,paladin,retribution,12,8,4
Touch,vashj,768,paladin,retribution,12,8,4
Jïncks,anachronos,768,paladin,retribution,12,8,4
Sweyz,archimonde,768,paladin,retribution,12,8,4
Odisea,burning-blade,768,paladin,retribution,12,8,4
Øttøø,outland,768,paladin,retribution,12,8,4
Фантаззер,soulflayer,768,paladin,retribution,12,8,4
Herô,drakthul,768,paladin,retribution,12,8,4
Superhick,veknilash,768,paladin,retribution,12,8,4
Khyleancbum,sanguino,768,paladin,retribution,12,8,4
Insanepvplol,archimonde,768,paladin,retribution,12,8,4
Mooriel,burning-legion,768,paladin,retribution,15,9,6
Ласковыйкуфа,howling-fjord,768,paladin,retribution,15,9,6
Легейнда,soulflayer,768,paladin,retribution,18,8,10
Rùfus,tarren-mill,768,paladin,retribution,18,8,10
Endavour,ravencrest,768,paladin,retribution,18,8,10
Пчелодин,howling-fjord,768,paladin,retribution,18,8,10
Mudan,stormscale,768,paladin,retribution,18,8,10
ßßæßßæßß,stormscale,768,paladin,retribution,18,8,10
Хитвэйв,soulflayer,768,paladin,retribution,18,8,10
Dadyolimp,kazzak,768,paladin,retribution,18,8,10
Sekztokio,blackmoore,768,paladin,retribution,18,8,10
Retrigodx,ragnaros,768,paladin,retribution,18,8,10
Iiwar,silvermoon,768,paladin,retribution,18,8,10
Círuq,eredar,768,paladin,retribution,18,8,10
Valiscar,antonidas,768,paladin,retribution,18,8,10
Кисаммэ,howling-fjord,768,paladin,retribution,18,8,10
Laaserjörö,outland,768,paladin,retribution,18,8,10
Bubblor,ravencrest,768,paladin,retribution,18,8,10
Чемеряк,gordunni,768,paladin,retribution,18,8,10
Holyinstinct,bronze-dragonflight,768,paladin,retribution,18,8,10
Enmà,archimonde,768,paladin,retribution,18,8,10
Deresos,anetheron,768,paladin,retribution,18,8,10
Chuy,burning-legion,768,paladin,retribution,18,8,10
Ngel,marécage-de-zangar,768,paladin,retribution,18,8,10
Bloodbeard,twisting-nether,768,paladin,retribution,18,8,10
Getpawned,rexxar,768,paladin,retribution,18,8,10
Hydrolic,blackrock,768,paladin,retribution,18,8,10
Bâbass,sargeras,768,paladin,retribution,18,8,10
Postî,eredar,768,paladin,retribution,18,8,10
Зена,gordunni,768,paladin,retribution,18,8,10
Abbendis,twisting-nether,768,paladin,retribution,18,8,10
Ббпп,howling-fjord,768,paladin,retribution,18,8,10
Retlikeme,ravencrest,768,paladin,retribution,18,8,10
Летвамар,gordunni,768,paladin,retribution,18,8,10
Palamag,grim-batol,768,paladin,retribution,18,8,10
Goüstà,ysondre,768,paladin,retribution,18,8,10
Piratalpha,thrall,768,paladin,retribution,18,8,10
Sinclo,hyjal,768,paladin,retribution,20,8,12
Vilayesyo,ravencrest,768,paladin,retribution,24,8,16
Piti,burning-legion,768,paladin,retribution,24,8,16
Ashmaker,khaz-modan,768,paladin,retribution,24,8,16
Benzimus,ragnaros,768,paladin,retribution,24,8,16
Powerphally,outland,768,paladin,retribution,24,8,16
Tjabo,burning-blade,768,paladin,retribution,24,8,16
Wankerjim,ghostlands,768,paladin,retribution,24,8,16
Mythorpala,dun-modr,768,paladin,retribution,24,8,16
Найдэкер,gordunni,768,paladin,retribution,24,8,16
Toxií,argent-dawn,768,paladin,retribution,30,8,22
Ландри,greymane,767,paladin,retribution,12,8,4
Dawnnslayer,kazzak,767,paladin,retribution,12,8,4
Spinzr,draenor,767,paladin,retribution,12,8,4
Crossfaded,azjolnerub,767,paladin,retribution,12,8,4
Unforsakenx,silvermoon,767,paladin,retribution,12,8,4
Serenityxo,twisting-nether,767,paladin,retribution,12,8,4
Acp,twisting-nether,767,paladin,retribution,12,8,4
Hutimeni,turalyon,767,paladin,retribution,12,8,4
Lightblaster,argent-dawn,767,paladin,retribution,12,8,4
Blagori,blackhand,767,paladin,retribution,12,8,4
Londonn,silvermoon,767,paladin,retribution,12,8,4
Pitux,dun-modr,767,paladin,retribution,16,9,7
Samuel,ahnqiraj,767,paladin,retribution,18,8,10
Mïnnîe,ysondre,767,paladin,retribution,18,8,10
Манддалорец,howling-fjord,767,paladin,retribution,18,8,10
Belight,burning-legion,767,paladin,retribution,18,8,10
Retenki,draenor,767,paladin,retribution,18,8,10
Aston,sylvanas,767,paladin,retribution,18,8,10
Athain,sanguino,767,paladin,retribution,18,8,10
Baxteria,dun-modr,767,paladin,retribution,18,8,10
Hôrrible,ravencrest,767,paladin,retribution,18,8,10
Palachdinka,drakthul,767,paladin,retribution,18,8,10
Бальтазёрыч,soulflayer,767,paladin,retribution,18,8,10
Retgrets,kazzak,767,paladin,retribution,18,8,10
Xersys,draenor,767,paladin,retribution,18,8,10
Phlakorn,blackhand,767,paladin,retribution,18,8,10
Uweósas,aegwynn,767,paladin,retribution,18,8,10
Dideta,colinas-pardas,767,paladin,retribution,18,8,10
Gaveren,ravencrest,767,paladin,retribution,18,8,10
Nicolae,colinas-pardas,767,paladin,retribution,18,8,10
Thoreas,perenolde,767,paladin,retribution,24,8,16
Brightgrove,silvermoon,767,paladin,retribution,24,8,16
Freeloliipop,darksorrow,767,paladin,retribution,24,8,16
Saath,malfurion,767,paladin,retribution,24,8,16
Lusugo,alakir,767,paladin,retribution,24,8,16
Konithis,doomhammer,766,paladin,retribution,12,8,4
Fremuduin,argent-dawn,766,paladin,retribution,12,8,4
Laugan,ysondre,766,paladin,retribution,12,8,4
Ryozupala,frostwolf,766,paladin,retribution,12,8,4
Méény,archimonde,766,paladin,retribution,18,8,10
Beefbombs,blackmoore,766,paladin,retribution,18,8,10
Quordthor,sanguino,766,paladin,retribution,24,8,16
Quaterbâck,antonidas,766,paladin,retribution,24,8,16
Mareshki,outland,766,paladin,retribution,24,8,16
Notsomuch,alakir,765,paladin,retribution,15,9,6
Liardin,draenor,765,paladin,retribution,18,8,10
Wtfudo,sylvanas,765,paladin,retribution,18,8,10
Mikipaki,tarren-mill,765,paladin,retribution,18,8,10
Trøllørd,shattrath,764,paladin,retribution,18,8,10
Retroon,doomhammer,764,paladin,retribution,18,8,10
Luridity,argent-dawn,764,paladin,retribution,24,8,16
Wingedguard,ragnaros,763,paladin,retribution,12,8,4
Ahritea,blackrock,763,paladin,retribution,12,8,4
Lewanor,tarren-mill,763,paladin,retribution,12,8,4
Ночнаябуря,gordunni,763,paladin,retribution,12,8,4
Yúlía,ravencrest,763,paladin,retribution,18,8,10
Nauriell,blackmoore,762,paladin,retribution,12,8,4
Tank,uldum,762,paladin,retribution,12,8,4
Цабля,gordunni,762,paladin,retribution,18,8,10
Vondarkmoor,magtheridon,761,paladin,retribution,18,8,10
Torczy,frostwhisper,760,paladin,retribution,12,8,4
Tripani,twisting-nether,760,paladin,retribution,18,8,10
Rivela,bloodhoof,758,paladin,retribution,18,8,10
Grundgron,burning-legion,753,paladin,retribution,27,8,19
Nazaninez,tarren-mill,749,paladin,retribution,18,8,10
Lawrence,deathwing,748,paladin,retribution,24,8,16
Ryüü,uldaman,748,paladin,retribution,42,13,29
Grayparser,silvermoon,735,paladin,retribution,14,9,5
Nollieflipx,tarren-mill,735,paladin,retribution,17,8,9
Ragnarauc,elune,720,paladin,retribution,15,8,7
Caleel,nemesis,719,paladin,retribution,15,9,6
Ritoru,drekthar,719,paladin,retribution,17,8,9
Serawyn,twisting-nether,718,paladin,retribution,15,8,7
Депреседмодх,soulflayer,717,paladin,retribution,15,9,6
Unbreakable,eredar,717,paladin,retribution,15,8,7
Darkironpala,argent-dawn,717,paladin,retribution,21,8,13
Áramor,blackmoore,716,paladin,retribution,17,8,9
Äthénâ,archimonde,713,paladin,retribution,23,9,14
ßean,dun-modr,704,paladin,retribution,16,8,8
Aelthir,kazzak,703,paladin,retribution,11,8,3
Myxas,tarren-mill,702,paladin,retribution,14,8,6
Demsi,ravencrest,702,paladin,retribution,14,8,6
Ericpala,turalyon,702,paladin,retribution,17,8,9
Angelepetit,hyjal,701,paladin,retribution,16,8,8
Veliios,silvermoon,701,paladin,retribution,25,9,16
Milisha,the-maelstrom,696,paladin,retribution,26,8,18
Derbrècher,azshara,688,paladin,retribution,16,8,8
Luveria,der-rat-von-dalaran,687,paladin,retribution,13,8,5
Gradepal,drakthul,687,paladin,retribution,19,8,11
Neicha,trollbane,672,paladin,retribution,12,7,5
Windwings,drakthul,672,paladin,retribution,12,7,5
Mullinsilmä,stormreaver,672,paladin,retribution,12,7,5
Ginka,blackrock,672,paladin,retribution,12,7,5
Anatollia,silvermoon,672,paladin,retribution,12,7,5
Veganbeefman,draenor,672,paladin,retribution,12,7,5
Punlac,draenor,672,paladin,retribution,12,7,5
Sunwalker,bronzebeard,672,paladin,retribution,12,7,5
Eldrack,defias-brotherhood,672,paladin,retribution,12,7,5
Gîn,aszune,672,paladin,retribution,12,7,5
Arkhàn,ravencrest,672,paladin,retribution,12,7,5
Curt,sanguino,672,paladin,retribution,12,7,5
Shjami,rexxar,672,paladin,retribution,12,7,5
Проверялка,thermaplugg,672,paladin,retribution,12,7,5
Шефлион,soulflayer,672,paladin,retribution,12,7,5
Израф,borean-tundra,672,paladin,retribution,12,7,5
Uriens,zuljin,672,paladin,retribution,12,7,5
Миллиционер,razuvious,672,paladin,retribution,12,7,5
Ceca,lightnings-blade,672,paladin,retribution,12,7,5
Fatherabdul,ravencrest,672,paladin,retribution,12,7,5
Нефростинг,gordunni,672,paladin,retribution,12,7,5
Dragon,zenedar,672,paladin,retribution,12,7,5
Падаетслезаа,howling-fjord,672,paladin,retribution,12,7,5
Miriem,twisting-nether,672,paladin,retribution,12,7,5
Mâlâk,dun-modr,672,paladin,retribution,12,7,5
Davè,blackmoore,672,paladin,retribution,12,7,5
Noiwings,sanguino,672,paladin,retribution,12,7,5
Estellar,bronze-dragonflight,672,paladin,retribution,12,7,5
Wohx,archimonde,672,paladin,retribution,12,7,5
Vircy,outland,672,paladin,retribution,12,7,5
Petsadin,ravencrest,672,paladin,retribution,12,7,5
Negash,archimonde,672,paladin,retribution,12,7,5
Purrifire,sylvanas,672,paladin,retribution,12,7,5
Ellünca,ravencrest,672,paladin,retribution,12,7,5
Shénggi,kazzak,672,paladin,retribution,12,7,5
Pallygân,thrall,672,paladin,retribution,12,7,5
Fabsy,frostwolf,672,paladin,retribution,12,7,5
Xônia,sylvanas,672,paladin,retribution,12,7,5
Silverglaze,defias-brotherhood,672,paladin,retribution,12,7,5
Pratiarch,kazzak,672,paladin,retribution,12,7,5
Ilpreside,nemesis,672,paladin,retribution,12,7,5
Lighteousnes,blackmoore,672,paladin,retribution,12,7,5
Даракар,deathguard,672,paladin,retribution,12,7,5
Okroschka,blackrock,672,paladin,retribution,12,7,5
Лиривель,howling-fjord,672,paladin,retribution,12,7,5
Skycraft,kazzak,672,paladin,retribution,12,7,5
Блудиз,howling-fjord,672,paladin,retribution,12,7,5
Holymolee,blackmoore,672,paladin,retribution,15,7,8
Destaen,kazzak,672,paladin,retribution,18,7,11
Trýhærd,ragnaros,672,paladin,retribution,18,7,11
Ritaora,aggramar,672,paladin,retribution,18,7,11
Elyrax,nemesis,672,paladin,retribution,18,7,11
Tezmodian,antonidas,672,paladin,retribution,18,7,11
Apocalypsé,twisting-nether,672,paladin,retribution,18,7,11
Mawrâ,twisting-nether,672,paladin,retribution,18,7,11
Melyntholdra,argent-dawn,672,paladin,retribution,18,7,11
Alersia,twisting-nether,672,paladin,retribution,18,7,11
Arethos,twisting-nether,672,paladin,retribution,18,7,11
Shownómercy,stormscale,672,paladin,retribution,18,7,11
Trixbunny,arathor,672,paladin,retribution,18,7,11
Sucsii,outland,672,paladin,retribution,18,7,11
Calliopes,tarren-mill,672,paladin,retribution,18,7,11
Norganpala,die-aldor,672,paladin,retribution,18,7,11
Мериатас,soulflayer,672,paladin,retribution,18,7,11
Pìnkyy,draenor,672,paladin,retribution,18,7,11
Scairtin,ravencrest,672,paladin,retribution,18,7,11
Deltapower,archimonde,672,paladin,retribution,18,7,11
Nicklovsofia,silvermoon,672,paladin,retribution,18,7,11
Seekêr,tarren-mill,672,paladin,retribution,18,7,11
Arbuzno,draenor,672,paladin,retribution,18,7,11
Kjobergen,tarren-mill,672,paladin,retribution,18,7,11
Milkzaddy,kazzak,672,paladin,retribution,18,7,11
Бэкворд,soulflayer,672,paladin,retribution,18,7,11
Frazyl,kilrogg,672,paladin,retribution,18,7,11
Алепос,gordunni,672,paladin,retribution,18,7,11
Blickyman,arathor,672,paladin,retribution,18,7,11
Атмта,razuvious,672,paladin,retribution,18,7,11
Drident,die-nachtwache,672,paladin,retribution,18,7,11
Littlenight,emerald-dream,672,paladin,retribution,18,7,11
Lightstorm,voljin,672,paladin,retribution,18,7,11
Emíly,dun-morogh,672,paladin,retribution,18,7,11
Holybubble,stormscale,672,paladin,retribution,18,7,11
Snowlyi,stormscale,672,paladin,retribution,18,7,11
Arshiaa,ravencrest,672,paladin,retribution,21,8,13
Stellartois,thunderhorn,672,paladin,retribution,19,7,12
Глаймис,gordunni,672,paladin,retribution,22,8,14
Chiriner,drakthul,672,paladin,retribution,21,7,14
Boscho,argent-dawn,672,paladin,retribution,24,7,17
Pikoman,hellfire,672,paladin,retribution,24,7,17
Ваэлин,deathweaver,672,paladin,retribution,24,7,17
Zerlat,twisting-nether,672,paladin,retribution,24,7,17
Aliceredlips,dun-modr,672,paladin,retribution,24,7,17
Jaegeer,draenor,672,paladin,retribution,24,7,17
Vivike,silvermoon,672,paladin,retribution,24,7,17
Nurix,dun-modr,672,paladin,retribution,24,7,17
Ящеры,gordunni,672,paladin,retribution,24,7,17
Cáranthír,draenor,672,paladin,retribution,24,7,17
Manole,ravencrest,672,paladin,retribution,24,7,17
Cheesus,argent-dawn,672,paladin,retribution,24,7,17
ßlitzkrieg,blackmoore,672,paladin,retribution,24,7,17
Aranael,nemesis,672,paladin,retribution,30,7,23
Zycqo,silvermoon,672,paladin,retribution,31,7,24
Mýv,archimonde,671,paladin,retribution,12,7,5
Retzzo,ravencrest,671,paladin,retribution,12,7,5
Gavain,blackhand,671,paladin,retribution,12,7,5
Liamisi,blackhand,671,paladin,retribution,12,7,5
Sixqti,blackrock,671,paladin,retribution,12,7,5
Kolts,ragnaros,671,paladin,retribution,12,7,5
Merkurial,sylvanas,671,paladin,retribution,12,7,5
Bronan,draenor,671,paladin,retribution,12,7,5
Liliána,ragnaros,671,paladin,retribution,12,7,5
Odregon,draenor,671,paladin,retribution,12,7,5
Sakred,hellscream,671,paladin,retribution,12,7,5
Архемор,ashenvale,671,paladin,retribution,12,7,5
Saviourself,silvermoon,671,paladin,retribution,12,7,5
Granadir,doomhammer,671,paladin,retribution,12,7,5
Wolfpala,drakthul,671,paladin,retribution,12,7,5
Amatar,ravencrest,671,paladin,retribution,12,7,5
Dramaking,the-maelstrom,671,paladin,retribution,12,7,5
Gbejr,xavius,671,paladin,retribution,12,7,5
Ralfx,ragnaros,671,paladin,retribution,12,7,5
Titoturixd,dun-modr,671,paladin,retribution,12,7,5
Gindolon,blackhand,671,paladin,retribution,12,7,5
Zpock,archimonde,671,paladin,retribution,12,7,5
Baltyros,thrall,671,paladin,retribution,12,7,5
Indye,hyjal,671,paladin,retribution,12,7,5
Ljusbågen,silvermoon,671,paladin,retribution,13,7,6
Ôrâ,archimonde,671,paladin,retribution,15,8,7
Тешеус,gordunni,671,paladin,retribution,17,7,10
Testovasara,ravencrest,671,paladin,retribution,18,7,11
Laenira,nemesis,671,paladin,retribution,18,7,11
Альбусор,galakrond,671,paladin,retribution,18,7,11
Sytrexxer,frostwolf,671,paladin,retribution,18,7,11
Erethes,magtheridon,671,paladin,retribution,18,7,11
Чотут,howling-fjord,671,paladin,retribution,18,7,11
Giglix,twisting-nether,671,paladin,retribution,18,7,11
Кесару,goldrinn,671,paladin,retribution,18,7,11
Konori,mannoroth,671,paladin,retribution,18,7,11
Sheaps,les-sentinelles,671,paladin,retribution,18,7,11
Рогафайти,goldrinn,671,paladin,retribution,18,7,11
Ardalìon,archimonde,671,paladin,retribution,18,7,11
Alvíss,sanguino,671,paladin,retribution,18,7,11
Labier,tarren-mill,671,paladin,retribution,18,7,11
Fishnchips,twisting-nether,671,paladin,retribution,18,7,11
Disconnector,aegwynn,671,paladin,retribution,18,7,11
Eken,hyjal,671,paladin,retribution,18,7,11
Öbedö,malganis,671,paladin,retribution,24,7,17
Paladson,burning-blade,671,paladin,retribution,24,7,17
Eldrielle,culte-de-la-rive-noire,671,paladin,retribution,24,7,17
Zyklôn,antonidas,671,paladin,retribution,30,7,23
Onestone,wrathbringer,671,paladin,retribution,30,7,23
Edb,silvermoon,670,paladin,retribution,12,7,5
Keol,sanguino,670,paladin,retribution,12,7,5
Patriok,moonglade,670,paladin,retribution,12,7,5
Atrexie,lightbringer,670,paladin,retribution,12,7,5
Prótpál,the-maelstrom,670,paladin,retribution,18,7,11
Blessmedaddy,tarren-mill,670,paladin,retribution,18,7,11
Thandoro,amanthul,670,paladin,retribution,18,7,11
Amoxapine,hyjal,670,paladin,retribution,18,7,11
Tidus,conseil-des-ombres,670,paladin,retribution,18,7,11
Lighttitan,ravencrest,670,paladin,retribution,18,7,11
Babajõ,twisting-nether,669,paladin,retribution,12,7,5
Solarouz,draenor,669,paladin,retribution,12,7,5
Zvirblis,chamber-of-aspects,669,paladin,retribution,15,8,7
Baymanda,tarren-mill,669,paladin,retribution,18,7,11
Rangorian,defias-brotherhood,669,paladin,retribution,24,7,17
Bandaga,sanguino,668,paladin,retribution,12,7,5
Эррор,azuregos,668,paladin,retribution,18,7,11
Ратомир,howling-fjord,668,paladin,retribution,20,7,13
Shennzo,wildhammer,667,paladin,retribution,12,7,5
Stêx,anubarak,667,paladin,retribution,12,7,5
Oheiligster,kult-der-verdammten,667,paladin,retribution,12,7,5
Megara,bronze-dragonflight,667,paladin,retribution,12,7,5
Tobebryant,eonar,667,paladin,retribution,12,7,5
Willmasmashn,blackmoore,667,paladin,retribution,18,7,11
Bedrock,kirin-tor,666,paladin,retribution,12,7,5
Rocaviva,sanguino,666,paladin,retribution,12,7,5
Ксинем,howling-fjord,666,paladin,retribution,16,8,8
Шелволк,eversong,665,paladin,retribution,18,7,11
Zealotic,doomhammer,664,paladin,retribution,12,7,5
Pallido,exodar,664,paladin,retribution,12,7,5
Chikaz,archimonde,664,paladin,retribution,20,10,10
Azlan,nagrand,664,paladin,retribution,16,8,8
Halimox,terokkar,664,paladin,retribution,18,7,11
Blinklys,ragnaros,664,paladin,retribution,18,7,11
Purpledurple,twisting-nether,663,paladin,retribution,18,7,11
Ruffus,magtheridon,662,paladin,retribution,12,7,5
Sarinise,draenor,662,paladin,retribution,12,7,5
Thebøss,blackmoore,662,paladin,retribution,18,7,11
Mechoka,auchindoun,661,paladin,retribution,13,7,6
Belzed,draenor,660,paladin,retribution,15,8,7
Сашок,gordunni,657,paladin,retribution,12,7,5
Bebcho,turalyon,646,paladin,retribution,27,9,18
Ordain,senjin,643,paladin,retribution,18,7,11
Benkenoah,ragnaros,641,paladin,retribution,30,7,23
Alë,sanguino,639,paladin,retribution,11,7,4
Keele,stormscale,639,paladin,retribution,17,7,10
Breezpal,twisting-nether,639,paladin,retribution,17,7,10
Rîex,alleria,639,paladin,retribution,26,8,18
Arear,kazzak,624,paladin,retribution,15,8,7
Badpal,blackhand,624,paladin,retribution,15,7,8
Samànta,nemesis,623,paladin,retribution,11,7,4
Маефис,gordunni,622,paladin,retribution,24,8,16
Nybrash,sanguino,620,paladin,retribution,15,7,8
Séphiran,hyjal,618,paladin,retribution,15,9,6
Goofyaf,ravencrest,618,paladin,retribution,16,9,7
Скадих,soulflayer,618,paladin,retribution,22,8,14
Sunrazor,kazzak,617,paladin,retribution,20,9,11
Pelbo,ravencrest,617,paladin,retribution,21,8,13
Mariaremarc,silvermoon,617,paladin,retribution,25,8,17
Авереон,gordunni,617,paladin,retribution,29,8,21
Ренегадер,thermaplugg,615,paladin,retribution,12,8,4
Leouric,argent-dawn,607,paladin,retribution,20,7,13
Palladxx,twilights-hammer,596,paladin,retribution,16,7,9
Алланор,fordragon,584,paladin,retribution,13,8,5
Deathlyblaze,draenor,576,paladin,retribution,6,6,0
Necorínex,silvermoon,576,paladin,retribution,6,6,0
Twomog,ravencrest,576,paladin,retribution,6,6,0
Zatoxi,frostmane,576,paladin,retribution,6,6,0
Classicheroo,stormscale,576,paladin,retribution,6,6,0
Blacked,baelgun,576,paladin,retribution,10,7,3
Blindhoj,ravencrest,576,paladin,retribution,12,6,6
Lévrone,alexstrasza,576,paladin,retribution,12,6,6
Госпелька,blackscar,576,paladin,retribution,12,6,6
Plainrage,blackrock,576,paladin,retribution,12,6,6
Rothus,bronze-dragonflight,576,paladin,retribution,12,6,6
Qotro,ravencrest,576,paladin,retribution,12,6,6
Waaynejudgeu,blackhand,576,paladin,retribution,12,6,6
Luciter,silvermoon,576,paladin,retribution,12,6,6
Abukasol,kazzak,576,paladin,retribution,12,6,6
Cycodin,garrosh,576,paladin,retribution,12,6,6
Rétalin,blackhand,576,paladin,retribution,12,6,6
Drekio,blackrock,576,paladin,retribution,12,6,6
Crusxder,kazzak,576,paladin,retribution,12,6,6
Stève,ravencrest,576,paladin,retribution,12,6,6
Ruggero,stormscale,576,paladin,retribution,12,6,6
Elendíl,azjolnerub,576,paladin,retribution,12,6,6
Askmy,stormscale,576,paladin,retribution,12,6,6
Noforgivenes,kazzak,576,paladin,retribution,12,6,6
Erthelios,silvermoon,576,paladin,retribution,12,6,6
Бэнсон,ashenvale,576,paladin,retribution,12,6,6
Стальгор,ashenvale,576,paladin,retribution,12,6,6
Lbj,eredar,576,paladin,retribution,12,6,6
Søulréaper,stormscale,576,paladin,retribution,12,6,6
Téralus,ravencrest,576,paladin,retribution,12,6,6
Palamauka,kazzak,576,paladin,retribution,12,6,6
Armion,stormscale,576,paladin,retribution,12,6,6
Sämaelia,ysondre,576,paladin,retribution,12,6,6
Sorkohoho,silvermoon,576,paladin,retribution,12,6,6
Divineovic,ravencrest,576,paladin,retribution,12,6,6
Jaing,magtheridon,576,paladin,retribution,12,6,6
Shailwo,ysondre,576,paladin,retribution,12,6,6
Éllé,der-rat-von-dalaran,576,paladin,retribution,12,6,6
Gabrîel,sanguino,576,paladin,retribution,12,6,6
Ultimatix,stormscale,576,paladin,retribution,12,6,6
Bigdaddypump,ravencrest,576,paladin,retribution,12,6,6
Nanduil,stormscale,576,paladin,retribution,12,6,6
Palamanyaka,kazzak,576,paladin,retribution,12,6,6
Pallachyrk,kazzak,576,paladin,retribution,12,6,6
Seothor,argent-dawn,576,paladin,retribution,12,6,6
Ríppex,kazzak,576,paladin,retribution,12,6,6
Zondãn,blackrock,576,paladin,retribution,12,6,6
Kptayn,archimonde,576,paladin,retribution,12,6,6
Sienna,kazzak,576,paladin,retribution,12,6,6
Raceper,the-maelstrom,576,paladin,retribution,12,6,6
Анфлераж,gordunni,576,paladin,retribution,12,6,6
Yurinovsky,aggra-português,576,paladin,retribution,12,6,6
Vysavo,draenor,576,paladin,retribution,12,6,6
Tarenath,aegwynn,576,paladin,retribution,12,6,6
Vuutnëx,twisting-nether,576,paladin,retribution,12,6,6
Керантий,gordunni,576,paladin,retribution,12,6,6
Melverti,kazzak,576,paladin,retribution,12,6,6
Lostfire,sinstralis,576,paladin,retribution,12,6,6
Yourredead,shadowsong,576,paladin,retribution,12,6,6
Ibanez,lightnings-blade,576,paladin,retribution,12,6,6
Бляля,gordunni,576,paladin,retribution,12,6,6
Mouncake,archimonde,576,paladin,retribution,12,6,6
Mekluba,twisting-nether,576,paladin,retribution,12,6,6
Aldio,pozzo-delleternità,576,paladin,retribution,12,6,6
Азов,thermaplugg,576,paladin,retribution,12,6,6
Drdax,wildhammer,576,paladin,retribution,12,6,6
Blubbajoe,blackmoore,576,paladin,retribution,12,6,6
Paliax,outland,576,paladin,retribution,12,6,6
Lommeuld,auchindoun,576,paladin,retribution,12,6,6
Reth,tarren-mill,576,paladin,retribution,12,6,6
Cildan,talnivarr,576,paladin,retribution,12,6,6
Nesquikudder,kazzak,576,paladin,retribution,12,6,6
Moossolin,tarren-mill,576,paladin,retribution,12,6,6
Wingdude,ysera,576,paladin,retribution,12,6,6
Greko,ysera,576,paladin,retribution,12,6,6
Таймкил,gordunni,576,paladin,retribution,12,6,6
Упругийтуз,gordunni,576,paladin,retribution,12,6,6
Tharduk,outland,576,paladin,retribution,12,6,6
Néero,defias-brotherhood,576,paladin,retribution,12,6,6
Илонка,gordunni,576,paladin,retribution,12,6,6
Teahero,doomhammer,576,paladin,retribution,12,6,6
Karnator,eldrethalas,576,paladin,retribution,12,6,6
Stankow,kazzak,576,paladin,retribution,12,6,6
Моррзито,soulflayer,576,paladin,retribution,12,6,6
Argeltal,auchindoun,576,paladin,retribution,12,6,6
Emlo,thrall,576,paladin,retribution,12,6,6
Стифаний,booty-bay,576,paladin,retribution,12,6,6
Pabló,azshara,576,paladin,retribution,12,6,6
Lightmyst,outland,576,paladin,retribution,12,6,6
Ashery,elune,576,paladin,retribution,12,6,6
Aalbringer,blackmoore,576,paladin,retribution,12,6,6
Kjellus,tarren-mill,576,paladin,retribution,12,6,6
Диджейнобабл,howling-fjord,576,paladin,retribution,12,6,6
Mingyao,sanguino,576,paladin,retribution,12,6,6
Ærîo,dalaran,576,paladin,retribution,12,6,6
Скварлетх,howling-fjord,576,paladin,retribution,12,6,6
Milner,stormreaver,576,paladin,retribution,12,6,6
Notnerb,outland,576,paladin,retribution,12,6,6
Бордюрчег,howling-fjord,576,paladin,retribution,12,6,6
Snowife,drakthul,576,paladin,retribution,12,6,6
Fatâl,antonidas,576,paladin,retribution,15,7,8
Aimee,draenor,576,paladin,retribution,16,7,9
Кольт,borean-tundra,576,paladin,retribution,16,6,10
Mipendz,draenor,576,paladin,retribution,18,6,12
Myrmidan,magtheridon,576,paladin,retribution,18,6,12
Kelduril,draenor,576,paladin,retribution,18,6,12
Bothways,stormscale,576,paladin,retribution,18,6,12
Dunklerzwerg,the-maelstrom,576,paladin,retribution,18,6,12
Gunpowderx,silvermoon,576,paladin,retribution,18,6,12
Vazayo,ravencrest,576,paladin,retribution,18,6,12
Thickets,argent-dawn,576,paladin,retribution,18,6,12
Hermmes,alakir,576,paladin,retribution,18,6,12
Ironkra,stormscale,576,paladin,retribution,18,6,12
Exfire,daggerspine,576,paladin,retribution,18,6,12
Генатрамбон,howling-fjord,576,paladin,retribution,18,6,12
Îshybî,archimonde,576,paladin,retribution,18,6,12
Retrehsacul,blackrock,576,paladin,retribution,18,6,12
Hegazy,darkmoon-faire,576,paladin,retribution,18,6,12
Bigfatpig,ravencrest,576,paladin,retribution,18,6,12
Tosá,antonidas,576,paladin,retribution,18,6,12
Yaloh,sylvanas,576,paladin,retribution,18,6,12
Mâêdhrøsx,ravencrest,576,paladin,retribution,18,6,12
Czachadymii,defias-brotherhood,576,paladin,retribution,18,6,12
Mooderna,ravencrest,576,paladin,retribution,18,6,12
Saht,silvermoon,576,paladin,retribution,18,6,12
Pinx,kazzak,576,paladin,retribution,18,6,12
Byczorek,turalyon,576,paladin,retribution,18,6,12
Meldø,drakthul,576,paladin,retribution,18,6,12
Sházen,silvermoon,576,paladin,retribution,18,6,12
Реализатор,howling-fjord,576,paladin,retribution,23,6,17
Эйтэр,howling-fjord,576,paladin,retribution,24,6,18
Vokesh,silvermoon,576,paladin,retribution,24,6,18
Actionjack,area-52,576,paladin,retribution,24,6,18
Ethurospal,tarren-mill,576,paladin,retribution,24,6,18
Badtrip,bloodscalp,576,paladin,retribution,24,6,18
Nikibrahboi,outland,576,paladin,retribution,24,6,18
Huevo,frostmane,576,paladin,retribution,24,6,18
Berethas,darksorrow,575,paladin,retribution,6,6,0
Zenfret,kazzak,575,paladin,retribution,10,7,3
Eyebluee,tarren-mill,575,paladin,retribution,12,6,6
Ustnivkusni,kazzak,575,paladin,retribution,12,6,6
Bcrp,ragnaros,575,paladin,retribution,12,6,6
Tehdark,outland,575,paladin,retribution,12,6,6
Hylion,kirin-tor,575,paladin,retribution,12,6,6
Тамплиир,gordunni,575,paladin,retribution,12,6,6
Myradur,burning-legion,575,paladin,retribution,12,6,6
Skieras,draenor,575,paladin,retribution,12,6,6
Blazix,kazzak,575,paladin,retribution,12,6,6
Greatme,frostmane,575,paladin,retribution,12,6,6
Faventu,ragnaros,575,paladin,retribution,12,6,6
Vandorin,dun-morogh,575,paladin,retribution,12,6,6
Proteiin,drakthul,575,paladin,retribution,12,6,6
Holycide,twisting-nether,575,paladin,retribution,12,6,6
Nishe,earthen-ring,575,paladin,retribution,12,6,6
Rohb,blackmoore,575,paladin,retribution,12,6,6
Ньюзеропал,howling-fjord,575,paladin,retribution,12,6,6
Humungus,sylvanas,575,paladin,retribution,12,6,6
Antón,dun-modr,575,paladin,retribution,12,6,6
Mbp,blackmoore,575,paladin,retribution,12,6,6
Phillipe,illidan,575,paladin,retribution,12,6,6
Kimberveils,blackrock,575,paladin,retribution,12,6,6
Helson,draenor,575,paladin,retribution,12,6,6
Sæsh,die-aldor,575,paladin,retribution,12,6,6
Eldivin,hyjal,575,paladin,retribution,12,6,6
Oûtplâyêd,blackmoore,575,paladin,retribution,12,6,6
Ysunna,magtheridon,575,paladin,retribution,12,6,6
Poutoux,archimonde,575,paladin,retribution,12,6,6
Labadin,darkspear,575,paladin,retribution,12,6,6
Celsia,blackrock,575,paladin,retribution,12,6,6
Kendomendo,ravencrest,575,paladin,retribution,12,6,6
Pewpews,twisting-nether,575,paladin,retribution,12,6,6
Йенфира,gordunni,575,paladin,retribution,12,6,6
Andrõs,argent-dawn,575,paladin,retribution,15,7,8
Gotra,stormscale,575,paladin,retribution,21,7,14
Edathar,argent-dawn,575,paladin,retribution,24,6,18
Легионор,galakrond,574,paladin,retribution,12,6,6
Duris,drakthul,574,paladin,retribution,12,6,6
Mormazor,outland,574,paladin,retribution,12,6,6
Askimo,twisting-nether,574,paladin,retribution,12,6,6
Goouse,marécage-de-zangar,574,paladin,retribution,12,6,6
Roxian,burning-blade,574,paladin,retribution,12,6,6
Dönki,hyjal,574,paladin,retribution,12,6,6
Gatsßy,archimonde,574,paladin,retribution,18,6,12
Babarush,nozdormu,574,paladin,retribution,18,6,12
Humaladi,draenor,574,paladin,retribution,18,6,12
Jelcz,burning-legion,574,paladin,retribution,24,6,18
Draarks,archimonde,573,paladin,retribution,12,6,6
Paxillustral,twisting-nether,573,paladin,retribution,12,6,6
Windîr,draenor,573,paladin,retribution,18,6,12
Moriex,drakthul,573,paladin,retribution,24,6,18
Renalex,ravencrest,572,paladin,retribution,12,6,6
Fatique,twisting-nether,572,paladin,retribution,12,6,6
Nhum,destromath,572,paladin,retribution,12,6,6
Beefix,blackmoore,572,paladin,retribution,12,6,6
Jesophar,archimonde,572,paladin,retribution,18,6,12
Virusee,doomhammer,571,paladin,retribution,12,6,6
Taomeba,runetotem,571,paladin,retribution,12,6,6
Boaka,outland,571,paladin,retribution,18,6,12
Elannor,sylvanas,569,paladin,retribution,12,6,6
Mhorcain,silvermoon,569,paladin,retribution,18,6,12
Nicgr,nemesis,566,paladin,retribution,12,6,6
Vengryn,turalyon,566,paladin,retribution,37,8,29
Shendis,uldaman,565,paladin,retribution,12,6,6
Årés,sanguino,565,paladin,retribution,12,6,6
Севенола,galakrond,565,paladin,retribution,18,6,12
Нероблр,gordunni,560,paladin,retribution,19,7,12
Toruk,burning-legion,559,paladin,retribution,15,7,8
Bugo,drakthul,559,paladin,retribution,17,6,11
Иусто,howling-fjord,559,paladin,retribution,17,6,11
Ràwx,twisting-nether,559,paladin,retribution,23,6,17
Uriziel,the-shatar,558,paladin,retribution,18,6,12
Tavyy,sylvanas,551,paladin,retribution,15,9,6
Ретроградий,howling-fjord,543,paladin,retribution,16,6,10
Wlåð,archimonde,543,paladin,retribution,17,6,11
Gundahar,das-syndikat,531,paladin,retribution,16,6,10
Kelianna,drakthul,528,paladin,retribution,12,7,5
Optì,eredar,527,paladin,retribution,11,6,5
Ichimaru,burning-legion,527,paladin,retribution,11,6,5
Сенлеида,gordunni,527,paladin,retribution,15,7,8
Mozg,silvermoon,527,paladin,retribution,17,6,11
Sàbèr,blackmoore,527,paladin,retribution,17,6,11
Zoomzoom,sylvanas,527,paladin,retribution,22,7,15
Plsdøntusemd,ravencrest,522,paladin,retribution,17,8,9
Митахо,gordunni,522,paladin,retribution,21,7,14
Окилан,gordunni,522,paladin,retribution,21,7,14
Тошши,soulflayer,522,paladin,retribution,28,8,20
Uriel,scarshield-legion,520,paladin,retribution,16,8,8
Thormentâ,sanguino,512,paladin,retribution,10,6,4
Råckamoo,emerald-dream,512,paladin,retribution,22,6,16
Вессори,blackscar,511,paladin,retribution,8,6,2
Vell,bronze-dragonflight,511,paladin,retribution,11,6,5
Babypic,ambossar,511,paladin,retribution,14,6,8
Hanterus,antonidas,507,paladin,retribution,14,6,8
Rockymarcian,hyjal,506,paladin,retribution,16,6,10
Briggybomb,outland,506,paladin,retribution,19,7,12
Рэдиенс,howling-fjord,496,paladin,retribution,7,6,1
Prínce,earthen-ring,495,paladin,retribution,13,6,7
Bramonier,blackmoore,480,paladin,retribution,6,5,1
Vardin,sanguino,480,paladin,retribution,6,5,1
Voycetwo,frostwolf,480,paladin,retribution,6,5,1
Salladín,stormscale,480,paladin,retribution,6,5,1
Neldöwn,dalaran,480,paladin,retribution,6,5,1
Тенькопыт,howling-fjord,480,paladin,retribution,6,5,1
Luzmortal,zuljin,480,paladin,retribution,6,5,1
Henklord,jaedenar,480,paladin,retribution,6,5,1
Римидал,howling-fjord,480,paladin,retribution,6,5,1
Röland,sanguino,480,paladin,retribution,6,5,1
Holyfatherr,draenor,480,paladin,retribution,6,5,1
Percocetx,tarren-mill,480,paladin,retribution,6,5,1
Yezitzme,blackrock,480,paladin,retribution,6,5,1
Tryggt,the-shatar,480,paladin,retribution,6,5,1
Zïons,hyjal,480,paladin,retribution,6,5,1
Nocleanse,argent-dawn,480,paladin,retribution,6,5,1
Daj,draenor,480,paladin,retribution,6,5,1
Feaná,silvermoon,480,paladin,retribution,6,5,1
Sabríel,ragnaros,480,paladin,retribution,6,5,1
Taurantes,garona,480,paladin,retribution,6,5,1
Libertum,silvermoon,480,paladin,retribution,6,5,1
Escanør,anetheron,480,paladin,retribution,6,5,1
Demecir,twisting-nether,480,paladin,retribution,6,5,1
Yasuomid,sanguino,480,paladin,retribution,6,5,1
Daminika,das-syndikat,480,paladin,retribution,6,5,1
Violetex,blackmoore,480,paladin,retribution,6,5,1
Paradok,thrall,480,paladin,retribution,6,5,1
Esköll,hyjal,480,paladin,retribution,6,5,1
Chocodin,drakthul,480,paladin,retribution,6,5,1
Melvòó,blackrock,480,paladin,retribution,9,6,3
Lightswrath,thunderhorn,480,paladin,retribution,8,5,3
Pigma,outland,480,paladin,retribution,13,7,6
Sawier,ragnaros,480,paladin,retribution,12,5,7
Swapxyr,aegwynn,480,paladin,retribution,12,5,7
Necadin,ravencrest,480,paladin,retribution,12,5,7
Mozaiczny,burning-legion,480,paladin,retribution,12,5,7
Onishu,blackhand,480,paladin,retribution,12,5,7
Morggann,drakthul,480,paladin,retribution,12,5,7
Bacilla,archimonde,480,paladin,retribution,12,5,7
Kewell,dun-modr,480,paladin,retribution,12,5,7
Эрогот,gordunni,480,paladin,retribution,12,5,7
Evohammer,silvermoon,480,paladin,retribution,12,5,7
Arakir,ragnaros,480,paladin,retribution,12,5,7
Kylaz,die-ewige-wacht,480,paladin,retribution,12,5,7
Froxies,drakthul,480,paladin,retribution,12,5,7
Títanîa,blackmoore,480,paladin,retribution,12,5,7
Llighthand,ravencrest,480,paladin,retribution,12,5,7
Cameron,taerar,480,paladin,retribution,12,5,7
Quelly,das-syndikat,480,paladin,retribution,12,5,7
Lïnea,aegwynn,480,paladin,retribution,12,5,7
Dêstî,silvermoon,480,paladin,retribution,12,5,7
Рукибудды,soulflayer,480,paladin,retribution,12,5,7
Destroyer,archimonde,480,paladin,retribution,12,5,7
Vaalé,aegwynn,480,paladin,retribution,12,5,7
Måxrajoy,dun-modr,480,paladin,retribution,12,5,7
Bopstar,tarren-mill,480,paladin,retribution,12,5,7
Тевеон,gordunni,480,paladin,retribution,12,5,7
Пашштет,gordunni,480,paladin,retribution,12,5,7
Darnito,blackmoore,480,paladin,retribution,12,5,7
Illythia,anachronos,480,paladin,retribution,12,5,7
Poporfour,archimonde,480,paladin,retribution,12,5,7
Palladia,rexxar,480,paladin,retribution,12,5,7
Skinriper,stormscale,480,paladin,retribution,12,5,7
Pappnas,blackmoore,480,paladin,retribution,12,5,7
Emloses,outland,480,paladin,retribution,12,5,7
Karatus,ravencrest,480,paladin,retribution,12,5,7
Pompée,dalaran,480,paladin,retribution,12,5,7
Зеппели,gordunni,480,paladin,retribution,12,5,7
Mikalia,aegwynn,480,paladin,retribution,12,5,7
Fotoniy,kazzak,480,paladin,retribution,12,5,7
Brinkz,argent-dawn,480,paladin,retribution,12,5,7
Hännó,malganis,480,paladin,retribution,12,5,7
Enviniv,tarren-mill,480,paladin,retribution,12,5,7
Harakiri,kargath,480,paladin,retribution,12,5,7
Célésté,ravencrest,480,paladin,retribution,12,5,7
Hifyve,kazzak,480,paladin,retribution,12,5,7
Гниленький,razuvious,480,paladin,retribution,12,5,7
Pianiste,sinstralis,480,paladin,retribution,12,5,7
Palacetámol,gorgonnash,480,paladin,retribution,12,5,7
Сладупся,gordunni,480,paladin,retribution,12,5,7
Meriween,ravencrest,480,paladin,retribution,12,5,7
Lôrelei,blackrock,480,paladin,retribution,12,5,7
Roflemente,bladefist,480,paladin,retribution,12,5,7
Palá,dun-modr,480,paladin,retribution,12,5,7
Hipo,zuljin,480,paladin,retribution,12,5,7
Zethhx,stormscale,480,paladin,retribution,12,5,7
Scoobywooby,sanguino,480,paladin,retribution,12,5,7
Dobbygotsock,kazzak,480,paladin,retribution,12,5,7
Takálus,eredar,480,paladin,retribution,12,5,7
Alus,blackmoore,480,paladin,retribution,12,5,7
Héphäistos,silvermoon,480,paladin,retribution,12,5,7
Krisbull,kazzak,480,paladin,retribution,12,5,7
Solcustos,tarren-mill,480,paladin,retribution,12,5,7
Glückskreuza,die-aldor,480,paladin,retribution,12,5,7
Serethor,blackrock,480,paladin,retribution,12,5,7
Роллерблэйд,gordunni,480,paladin,retribution,12,5,7
Hazura,blackmoore,480,paladin,retribution,12,5,7
Lyan,archimonde,480,paladin,retribution,12,5,7
Ênma,archimonde,480,paladin,retribution,12,5,7
Docoùla,twisting-nether,480,paladin,retribution,12,5,7
Cêa,blackrock,480,paladin,retribution,12,5,7
Ðesolace,twisting-nether,480,paladin,retribution,12,5,7
Morsadin,burning-legion,480,paladin,retribution,12,5,7
Fannypoo,sylvanas,480,paladin,retribution,12,5,7
Palafrugell,sanguino,480,paladin,retribution,12,5,7
Blazkowicz,twisting-nether,480,paladin,retribution,12,5,7
Valonforth,magtheridon,480,paladin,retribution,12,5,7
Holysznajt,burning-legion,480,paladin,retribution,12,5,7
Retzrik,kazzak,480,paladin,retribution,12,5,7
Chillmachine,stormscale,480,paladin,retribution,12,5,7
Himèji,pozzo-delleternità,480,paladin,retribution,12,5,7
Pallajalla,the-maelstrom,480,paladin,retribution,12,5,7
Aïzo,archimonde,480,paladin,retribution,12,5,7
Bascelik,outland,480,paladin,retribution,12,5,7
Blokeedaro,sanguino,480,paladin,retribution,12,5,7
Oldsurehand,blackmoore,480,paladin,retribution,12,5,7
Equityy,burning-legion,480,paladin,retribution,12,5,7
Gambá,stormscale,480,paladin,retribution,12,5,7
Yuvile,destromath,480,paladin,retribution,12,5,7
Shanderhilo,pozzo-delleternità,480,paladin,retribution,12,5,7
Crupth,outland,480,paladin,retribution,12,5,7
Ноулайфир,eversong,480,paladin,retribution,12,5,7
Bobilous,twisting-nether,480,paladin,retribution,12,5,7
Ksama,ysondre,480,paladin,retribution,12,5,7
Milenia,nemesis,480,paladin,retribution,12,5,7
Angelynor,ysondre,480,paladin,retribution,12,5,7
Goodfail,sanguino,480,paladin,retribution,12,5,7
Freedomwinds,kazzak,480,paladin,retribution,12,5,7
Нойззмс,gordunni,480,paladin,retribution,12,5,7
Bobjohnny,bloodfeather,480,paladin,retribution,12,5,7
Zaopink,blackhand,480,paladin,retribution,12,5,7
Холивеник,gordunni,480,paladin,retribution,12,5,7
Instaraid,blackmoore,480,paladin,retribution,12,5,7
Skølir,rashgarroth,480,paladin,retribution,12,5,7
Valunajhnwar,azuremyst,480,paladin,retribution,12,5,7
Arator,terenas,480,paladin,retribution,12,5,7
Боремир,borean-tundra,480,paladin,retribution,12,5,7
Mecah,hyjal,480,paladin,retribution,12,5,7
Ëhra,hyjal,480,paladin,retribution,12,5,7
Faldrinx,hyjal,480,paladin,retribution,12,5,7
Syjinora,teldrassil,480,paladin,retribution,12,5,7
Víii,outland,480,paladin,retribution,15,6,9
Aresian,burning-legion,480,paladin,retribution,13,5,8
Dhb,darksorrow,480,paladin,retribution,14,5,9
Destroyér,blackmoore,480,paladin,retribution,18,5,13
Lancelotas,defias-brotherhood,480,paladin,retribution,18,5,13
Мэркес,fordragon,480,paladin,retribution,18,5,13
Cøygonne,archimonde,480,paladin,retribution,18,5,13
Cøctab,kirin-tor,480,paladin,retribution,18,5,13
Arthuriân,outland,480,paladin,retribution,18,5,13
Legâin,twisting-nether,480,paladin,retribution,18,5,13
Ywrow,burning-blade,480,paladin,retribution,18,5,13
Juicycheeks,frostwolf,480,paladin,retribution,18,5,13
Ramhal,stormscale,480,paladin,retribution,18,5,13
Ashbi,dun-modr,480,paladin,retribution,18,5,13
Nëphilim,arakarahm,480,paladin,retribution,18,5,13
Xiuya,dun-modr,480,paladin,retribution,18,5,13
Øsgar,dun-modr,480,paladin,retribution,18,5,13
Nalaea,arathor,480,paladin,retribution,18,5,13
Авараан,galakrond,480,paladin,retribution,18,5,13
Retisfine,silvermoon,480,paladin,retribution,18,5,13
Strätholme,drakthul,480,paladin,retribution,18,5,13
Boyard,silvermoon,480,paladin,retribution,18,5,13
Копранесса,soulflayer,480,paladin,retribution,18,5,13
Bumboombeem,stormscale,480,paladin,retribution,18,5,13
Powericius,drakthul,480,paladin,retribution,18,5,13
Kreozz,destromath,480,paladin,retribution,21,5,16
Exobyte,stormscale,480,paladin,retribution,24,5,19
Cadearas,antonidas,480,paladin,retribution,24,5,19
Korgant,burning-legion,480,paladin,retribution,30,5,25
Phlek,drakthul,479,paladin,retribution,6,5,1
Grynd,blackmoore,479,paladin,retribution,6,5,1
Deyvan,dalaran,479,paladin,retribution,12,5,7
Майнстер,gordunni,479,paladin,retribution,12,5,7
Edwards,sanguino,479,paladin,retribution,12,5,7
Dayr,sylvanas,479,paladin,retribution,12,5,7
Rettarded,draenor,479,paladin,retribution,12,5,7
Drizuc,bloodhoof,479,paladin,retribution,12,5,7
Subzerox,ravenholdt,479,paladin,retribution,12,5,7
Grannybash,silvermoon,479,paladin,retribution,12,5,7
Bakasnoop,hyjal,479,paladin,retribution,12,5,7
Lightsblood,outland,479,paladin,retribution,12,5,7
Missti,azjolnerub,479,paladin,retribution,12,5,7
Сасмен,blackscar,479,paladin,retribution,12,5,7
Vcd,kazzak,479,paladin,retribution,12,5,7
Notholy,defias-brotherhood,479,paladin,retribution,12,5,7
Dykopala,doomhammer,479,paladin,retribution,12,5,7
Taffz,burning-legion,479,paladin,retribution,12,5,7
Gaab,aggra-português,479,paladin,retribution,12,5,7
Angelwings,nefarian,479,paladin,retribution,12,5,7
Brammers,doomhammer,479,paladin,retribution,12,5,7
Solyra,blackhand,479,paladin,retribution,12,5,7
Benø,malganis,479,paladin,retribution,12,5,7
Sorâ,archimonde,479,paladin,retribution,12,5,7
Aion,chamber-of-aspects,479,paladin,retribution,18,5,13
Aelaris,dunemaul,479,paladin,retribution,18,5,13
Drestaen,drakthul,479,paladin,retribution,18,5,13
Eriesh,cthun,479,paladin,retribution,18,5,13
Hazeman,colinas-pardas,478,paladin,retribution,6,5,1
Mysticlight,sylvanas,478,paladin,retribution,18,8,10
Nerdcore,blackrock,478,paladin,retribution,12,5,7
Mirelaw,drakthul,478,paladin,retribution,12,5,7
Atreyu,stormscale,478,paladin,retribution,12,5,7
Kanot,outland,478,paladin,retribution,12,5,7
Shrékhead,hellfire,478,paladin,retribution,12,5,7
Четкийчервь,soulflayer,478,paladin,retribution,18,5,13
Ragnàr,aggra-português,477,paladin,retribution,12,5,7
Chofre,thunderhorn,477,paladin,retribution,18,5,13
Zantria,alleria,476,paladin,retribution,12,5,7
Luciiano,malygos,476,paladin,retribution,12,5,7
Lysân,eredar,475,paladin,retribution,12,5,7
Izri,hellscream,475,paladin,retribution,12,5,7
Sindur,perenolde,474,paladin,retribution,12,5,7
Thiccfreak,tarren-mill,474,paladin,retribution,14,5,9
Parkla,twisting-nether,473,paladin,retribution,12,5,7
Yeohinyiu,khaz-modan,472,paladin,retribution,12,5,7
Hateze,kazzak,472,paladin,retribution,12,5,7
Yeretria,krasus,472,paladin,retribution,12,5,7
Лонса,soulflayer,463,paladin,retribution,11,5,6
Kurøneko,hyjal,463,paladin,retribution,11,5,6
Demool,the-maelstrom,463,paladin,retribution,11,5,6
Slayton,twisting-nether,447,paladin,retribution,11,5,6
Гкм,howling-fjord,447,paladin,retribution,11,5,6
Эсканор,galakrond,447,paladin,retribution,14,6,8
Davairabotai,kazzak,447,paladin,retribution,20,6,14
Kevlar,frostmane,446,paladin,retribution,12,6,6
Аркрум,gordunni,446,paladin,retribution,11,5,6
Æïs,blackrock,432,paladin,retribution,9,5,4
Åvra,ysondre,432,paladin,retribution,15,5,10
Sunnyboy,tarren-mill,431,paladin,retribution,11,5,6
Theodun,xavius,430,paladin,retribution,11,5,6
Caps,the-venture-co,416,paladin,retribution,16,5,11
Willmot,stormscale,415,paladin,retribution,8,5,3
Jobsu,defias-brotherhood,415,paladin,retribution,9,5,4
Zell,silvermoon,414,paladin,retribution,16,5,11
Zouppis,ravencrest,400,paladin,retribution,7,5,2
Veléxis,outland,384,paladin,retribution,6,4,2
Giggs,turalyon,384,paladin,retribution,6,4,2
Jøløz,hyjal,384,paladin,retribution,6,4,2
Missybugla,turalyon,384,paladin,retribution,6,4,2
Firfiris,twisting-nether,384,paladin,retribution,6,4,2
Léona,hyjal,384,paladin,retribution,6,4,2
Nezgrôs,hyjal,384,paladin,retribution,6,4,2
Uhtrèd,turalyon,384,paladin,retribution,6,4,2
Aprânax,twisting-nether,384,paladin,retribution,6,4,2
Cattelsaan,hyjal,384,paladin,retribution,6,4,2
Раикерс,gordunni,384,paladin,retribution,6,4,2
Michelineous,auchindoun,384,paladin,retribution,6,4,2
Kralenko,archimonde,384,paladin,retribution,6,4,2
Вэйсспал,howling-fjord,384,paladin,retribution,6,4,2
Hiloqtpala,blackmoore,384,paladin,retribution,6,4,2
Oriath,draenor,384,paladin,retribution,6,4,2
Idin,nemesis,384,paladin,retribution,6,4,2
Драгмитухел,gordunni,384,paladin,retribution,6,4,2
Boaz,norgannon,384,paladin,retribution,6,4,2
Daddyolimpp,kazzak,384,paladin,retribution,6,4,2
Zhàø,ysondre,384,paladin,retribution,6,4,2
Udrik,proudmoore,384,paladin,retribution,6,4,2
Jaime,magtheridon,384,paladin,retribution,6,4,2
Kaähz,archimonde,384,paladin,retribution,6,4,2
Jiricech,tarren-mill,384,paladin,retribution,6,4,2
Cerfica,drakthul,384,paladin,retribution,6,4,2
Wiither,argent-dawn,384,paladin,retribution,6,4,2
Peacekeep,stormscale,384,paladin,retribution,6,4,2
Hurrier,outland,384,paladin,retribution,6,4,2
Missmyhoj,archimonde,384,paladin,retribution,6,4,2
Hanknpank,quelthalas,384,paladin,retribution,6,4,2
Tigurius,zuljin,384,paladin,retribution,6,4,2
Kayback,archimonde,384,paladin,retribution,6,4,2
Miskok,twisting-nether,384,paladin,retribution,6,4,2
Morgoth,daggerspine,384,paladin,retribution,6,4,2
Neverdiex,blackrock,384,paladin,retribution,6,4,2
Haudrupp,blackmoore,384,paladin,retribution,6,4,2
Kazui,lordaeron,384,paladin,retribution,6,4,2
Адирон,booty-bay,384,paladin,retribution,6,4,2
Arcillus,stormscale,384,paladin,retribution,6,4,2
Raek,stormscale,384,paladin,retribution,6,4,2
Zùlka,krasus,384,paladin,retribution,6,4,2
Dornu,tarren-mill,384,paladin,retribution,6,4,2
Spartacøn,kazzak,384,paladin,retribution,6,4,2
Paladoom,magtheridon,384,paladin,retribution,6,4,2
Petrzajonc,outland,384,paladin,retribution,6,4,2
Òlymp,blackhand,384,paladin,retribution,6,4,2
Любитель,azuregos,384,paladin,retribution,6,4,2
Angeal,ysondre,384,paladin,retribution,6,4,2
Skrýmir,marécage-de-zangar,384,paladin,retribution,6,4,2
Aresdin,blackmoore,384,paladin,retribution,6,4,2
Baldrheim,culte-de-la-rive-noire,384,paladin,retribution,6,4,2
Скидульф,blackscar,384,paladin,retribution,6,4,2
Хашон,gordunni,384,paladin,retribution,6,4,2
Holaa,blackrock,384,paladin,retribution,6,4,2
Pawelinus,blackrock,384,paladin,retribution,6,4,2
Sunstrider,quelthalas,384,paladin,retribution,6,4,2
Zeportpala,archimonde,384,paladin,retribution,6,4,2
Соргосош,gordunni,384,paladin,retribution,6,4,2
Zeggayoda,nemesis,384,paladin,retribution,6,4,2
Fluppy,the-maelstrom,384,paladin,retribution,6,4,2
Lothacia,blackmoore,384,paladin,retribution,6,4,2
Cake,alakir,384,paladin,retribution,6,4,2
Teebxu,outland,384,paladin,retribution,6,4,2
Sabriaña,silvermoon,384,paladin,retribution,6,4,2
Dragongîrl,lothar,384,paladin,retribution,6,4,2
Blessedpapi,draenor,384,paladin,retribution,6,4,2
Sneptica,draenor,384,paladin,retribution,6,4,2
Kirlight,blackrock,384,paladin,retribution,6,4,2
Sheldon,sylvanas,384,paladin,retribution,6,4,2
Madarä,arathi,384,paladin,retribution,6,4,2
Elenia,baelgun,384,paladin,retribution,6,4,2
Zeackzs,rajaxx,384,paladin,retribution,6,4,2
Imtheßoss,pozzo-delleternità,384,paladin,retribution,6,4,2
Deworld,tarren-mill,384,paladin,retribution,6,4,2
Keem,aszune,384,paladin,retribution,6,4,2
Marmotaxx,dun-modr,384,paladin,retribution,6,4,2
Retqt,eredar,384,paladin,retribution,6,4,2
Rölfchen,frostwolf,384,paladin,retribution,6,4,2
Shevøçk,ravencrest,384,paladin,retribution,6,4,2
Minpala,kazzak,384,paladin,retribution,6,4,2
Позабытый,deathweaver,384,paladin,retribution,6,4,2
Лиадринель,howling-fjord,384,paladin,retribution,6,4,2
Фоггихохо,gordunni,384,paladin,retribution,6,4,2
Chobb,thunderhorn,384,paladin,retribution,6,4,2
Clementine,spinebreaker,384,paladin,retribution,6,4,2
Кукусяшка,gordunni,384,paladin,retribution,6,4,2
Timoxas,kazzak,384,paladin,retribution,6,4,2
Судья,greymane,384,paladin,retribution,6,4,2
Alciera,silvermoon,384,paladin,retribution,6,4,2
Röcc,draenor,384,paladin,retribution,6,4,2
Volkai,zuljin,384,paladin,retribution,6,4,2
Boëndil,ravencrest,384,paladin,retribution,6,4,2
Raratina,draenor,384,paladin,retribution,6,4,2
Джиблэйд,gordunni,384,paladin,retribution,6,4,2
Бабичпал,soulflayer,384,paladin,retribution,6,4,2
Tuxa,blackrock,384,paladin,retribution,6,4,2
Phiana,blackmoore,384,paladin,retribution,6,4,2
Maýlin,das-konsortium,384,paladin,retribution,6,4,2
Mariahuana,sanguino,384,paladin,retribution,6,4,2
Naizem,dun-modr,384,paladin,retribution,6,4,2
Néméssisx,ravencrest,384,paladin,retribution,6,4,2
Unhittable,draenor,384,paladin,retribution,6,4,2
Mcnnuggets,ravencrest,384,paladin,retribution,6,4,2
Colpadeltank,kazzak,384,paladin,retribution,6,4,2
Tdchopa,ravencrest,384,paladin,retribution,6,4,2
Exley,blackmoore,384,paladin,retribution,6,4,2
Æmiø,blackmoore,384,paladin,retribution,6,4,2
Кэшбэкер,fordragon,384,paladin,retribution,6,4,2
Pâlâpâm,blackmoore,384,paladin,retribution,6,4,2
Crussaden,stormscale,384,paladin,retribution,7,4,3
Ковбаскаа,gordunni,384,paladin,retribution,9,5,4
Lotarios,tarren-mill,384,paladin,retribution,9,5,4
Ashengelm,silvermoon,384,paladin,retribution,9,5,4
Crêuyf,elune,384,paladin,retribution,10,5,5
Shoogle,alonsus,384,paladin,retribution,9,4,5
Хилвкд,blackscar,384,paladin,retribution,11,4,7
Athênâ,azjolnerub,384,paladin,retribution,15,5,10
Ревирант,howling-fjord,384,paladin,retribution,12,4,8
Suavé,ravencrest,384,paladin,retribution,12,4,8
Sorkara,argent-dawn,384,paladin,retribution,12,4,8
Æternal,arathor,384,paladin,retribution,12,4,8
Холигор,deathguard,384,paladin,retribution,12,4,8
Lûvmølly,silvermoon,384,paladin,retribution,12,4,8
Бладриус,howling-fjord,384,paladin,retribution,12,4,8
Beefcake,bladefist,384,paladin,retribution,12,4,8
Халва,deathguard,384,paladin,retribution,12,4,8
Hasart,tarren-mill,384,paladin,retribution,12,4,8
Aleya,arathor,384,paladin,retribution,12,4,8
Thiccdeeps,aegwynn,384,paladin,retribution,12,4,8
Liléa,hyjal,384,paladin,retribution,12,4,8
Decain,twisting-nether,384,paladin,retribution,12,4,8
Sgiach,draenor,384,paladin,retribution,12,4,8
One,grim-batol,384,paladin,retribution,12,4,8
Хэймердингер,howling-fjord,384,paladin,retribution,12,4,8
Cheerrios,arathor,384,paladin,retribution,12,4,8
Kimozabie,ravencrest,384,paladin,retribution,12,4,8
Trefata,kazzak,384,paladin,retribution,12,4,8
Дрейв,soulflayer,384,paladin,retribution,12,4,8
Beefdaddykuu,ravencrest,384,paladin,retribution,12,4,8
Waks,dalaran,384,paladin,retribution,12,4,8
Lucretius,kilrogg,384,paladin,retribution,12,4,8
Eîon,argent-dawn,384,paladin,retribution,12,4,8
Redmoo,tarren-mill,384,paladin,retribution,12,4,8
Trainors,chamber-of-aspects,384,paladin,retribution,12,4,8
Karsini,arathor,384,paladin,retribution,12,4,8
Bugohoss,nathrezim,384,paladin,retribution,12,4,8
Myû,die-aldor,384,paladin,retribution,12,4,8
Âgreë,frostwhisper,384,paladin,retribution,12,4,8
Лаунесса,gordunni,384,paladin,retribution,12,4,8
Valoren,todeswache,384,paladin,retribution,12,4,8
Ekber,ravencrest,384,paladin,retribution,12,4,8
Azrpal,kazzak,384,paladin,retribution,12,4,8
Ambîorix,dun-modr,384,paladin,retribution,12,4,8
Stjusmussel,ragnaros,384,paladin,retribution,12,4,8
Alawdi,ysondre,384,paladin,retribution,12,4,8
Blockitp,stormscale,384,paladin,retribution,12,4,8
Турбобит,gordunni,384,paladin,retribution,12,4,8
Etzann,draenor,384,paladin,retribution,12,4,8
Artoriaz,ravencrest,384,paladin,retribution,12,4,8
Krullfar,ravencrest,384,paladin,retribution,12,4,8
Popelarr,burning-blade,384,paladin,retribution,12,4,8
Serim,dun-modr,384,paladin,retribution,12,4,8
Dennyboy,sylvanas,384,paladin,retribution,12,4,8
Pålegg,emerald-dream,384,paladin,retribution,12,4,8
Adevald,silvermoon,384,paladin,retribution,12,4,8
Mystràs,khaz-modan,384,paladin,retribution,12,4,8
Xerya,dun-modr,384,paladin,retribution,12,4,8
Arkkipiispa,outland,384,paladin,retribution,12,4,8
Jericcho,dun-modr,384,paladin,retribution,12,4,8
Minfa,argent-dawn,384,paladin,retribution,12,4,8
Øazimutø,archimonde,384,paladin,retribution,12,4,8
Киилаа,gordunni,384,paladin,retribution,12,4,8
Nexo,bloodscalp,384,paladin,retribution,12,4,8
Ragonas,mannoroth,384,paladin,retribution,12,4,8
Cyban,twisting-nether,384,paladin,retribution,12,4,8
Эсмория,gordunni,384,paladin,retribution,12,4,8
Chïefen,twisting-nether,384,paladin,retribution,12,4,8
Yeetholy,ragnaros,384,paladin,retribution,12,4,8
Dêadgame,aegwynn,384,paladin,retribution,12,4,8
Vhestas,dun-modr,384,paladin,retribution,12,4,8
Avengence,dragonblight,384,paladin,retribution,12,4,8
Phazio,twisting-nether,384,paladin,retribution,12,4,8
Lullabye,runetotem,384,paladin,retribution,12,4,8
Æfhm,blackrock,384,paladin,retribution,12,4,8
Quarrel,kul-tiras,384,paladin,retribution,12,4,8
Kyrín,onyxia,384,paladin,retribution,12,4,8
Strongman,twilights-hammer,384,paladin,retribution,12,4,8
Cafa,turalyon,384,paladin,retribution,12,4,8
Palapaye,archimonde,384,paladin,retribution,12,4,8
Retfull,sylvanas,384,paladin,retribution,12,4,8
Nobo,hellfire,384,paladin,retribution,12,4,8
Zarifence,ragnaros,384,paladin,retribution,12,4,8
Kielonpala,kazzak,384,paladin,retribution,12,4,8
Somaxpala,burning-legion,384,paladin,retribution,12,4,8
Zhroomxx,blackmoore,384,paladin,retribution,12,4,8
Highcrown,argent-dawn,384,paladin,retribution,12,4,8
Valzyffs,twisting-nether,384,paladin,retribution,12,4,8
Bundagains,silvermoon,384,paladin,retribution,12,4,8
Yakuron,blackhand,384,paladin,retribution,12,4,8
Катсес,eversong,384,paladin,retribution,12,4,8
Lopal,silvermoon,384,paladin,retribution,12,4,8
Madeofsteel,silvermoon,384,paladin,retribution,12,4,8
Kÿsse,hyjal,384,paladin,retribution,12,4,8
Ippex,silvermoon,384,paladin,retribution,12,4,8
Pecar,stormscale,384,paladin,retribution,12,4,8
Розовыйбабл,gordunni,384,paladin,retribution,12,4,8
Зираэлис,gordunni,384,paladin,retribution,12,4,8
Phannelle,ysondre,384,paladin,retribution,12,4,8
Поддыхдам,gordunni,384,paladin,retribution,12,4,8
Denathar,draenor,384,paladin,retribution,12,4,8
Yasfy,stormscale,384,paladin,retribution,12,4,8
Cyborg,ysondre,384,paladin,retribution,12,4,8
Heidfield,draenor,384,paladin,retribution,12,4,8
Ríék,lightbringer,384,paladin,retribution,12,4,8
Бойкийкот,eversong,384,paladin,retribution,12,4,8
Astamye,ysondre,384,paladin,retribution,12,4,8
Grymbol,boulderfist,384,paladin,retribution,12,4,8
Perxx,stormscale,384,paladin,retribution,12,4,8
Cartell,dun-morogh,384,paladin,retribution,12,4,8
Gellmar,the-maelstrom,384,paladin,retribution,12,4,8
Monaatamis,kazzak,384,paladin,retribution,12,4,8
Ruttodidio,outland,384,paladin,retribution,12,4,8
Stoneð,antonidas,384,paladin,retribution,12,4,8
Crowdev,zuljin,384,paladin,retribution,12,4,8
Millianoxys,norgannon,384,paladin,retribution,12,4,8
Douglazz,tarren-mill,384,paladin,retribution,13,4,9
Artonus,sylvanas,384,paladin,retribution,14,4,10
Nitay,blades-edge,384,paladin,retribution,16,4,12
Nôva,stormscale,384,paladin,retribution,17,4,13
Forthy,drakthul,384,paladin,retribution,18,4,14
Orbia,draenor,384,paladin,retribution,18,4,14
Masuroc,antonidas,384,paladin,retribution,18,4,14
Caribbean,outland,384,paladin,retribution,18,4,14
Wftw,draenor,384,paladin,retribution,18,4,14
Trismegistos,bloodhoof,384,paladin,retribution,18,4,14
Астарин,gordunni,384,paladin,retribution,18,4,14
Pepegasensei,ravencrest,384,paladin,retribution,18,4,14
Загошслакер,howling-fjord,384,paladin,retribution,18,4,14
Halldòr,ravencrest,384,paladin,retribution,18,4,14
Kaatha,archimonde,384,paladin,retribution,18,4,14
Galaerøn,elune,384,paladin,retribution,18,4,14
Neyd,hyjal,384,paladin,retribution,18,4,14
Sorannian,hyjal,384,paladin,retribution,24,4,20
Gélan,stormscale,384,paladin,retribution,24,4,20
Цитри,borean-tundra,383,paladin,retribution,6,4,2
Supersnubben,grim-batol,383,paladin,retribution,6,4,2
Krögerelf,garrosh,383,paladin,retribution,6,4,2
Рукаф,soulflayer,383,paladin,retribution,6,4,2
Lancelhot,archimonde,383,paladin,retribution,6,4,2
Buddy,conseil-des-ombres,383,paladin,retribution,9,5,4
Donfilippo,burning-legion,383,paladin,retribution,12,4,8
Omixlis,ragnaros,383,paladin,retribution,12,4,8
Chunpala,silvermoon,383,paladin,retribution,12,4,8
Elvyri,silvermoon,383,paladin,retribution,12,4,8
Giuliagirod,kazzak,383,paladin,retribution,12,4,8
Ashreaver,burning-legion,383,paladin,retribution,12,4,8
Käylä,silvermoon,383,paladin,retribution,12,4,8
Timesover,doomhammer,383,paladin,retribution,12,4,8
Paladoon,ravencrest,383,paladin,retribution,12,4,8
Hilkisen,ragnaros,383,paladin,retribution,12,4,8
Syrenia,die-silberne-hand,383,paladin,retribution,12,4,8
Ságé,thrall,383,paladin,retribution,16,4,12
Lavacalistar,turalyon,383,paladin,retribution,21,5,16
Shurikèn,khaz-modan,382,paladin,retribution,6,4,2
Larth,the-maelstrom,382,paladin,retribution,6,4,2
Pelaghia,tarren-mill,382,paladin,retribution,6,4,2
Kaezerg,khaz-modan,382,paladin,retribution,12,4,8
Kulgan,aerie-peak,380,paladin,retribution,12,4,8
Palastratos,turalyon,379,paladin,retribution,12,4,8
Bellight,sinstralis,376,paladin,retribution,19,4,15
Errn,ragnaros,367,paladin,retribution,11,4,7
Emakk,darksorrow,351,paladin,retribution,8,5,3
Spóntaneous,ravencrest,351,paladin,retribution,8,5,3
Madzy,archimonde,351,paladin,retribution,11,4,7
Hàppy,malfurion,351,paladin,retribution,11,4,7
Joeintkaa,ragnaros,351,paladin,retribution,11,4,7
Kantfyrste,ravencrest,351,paladin,retribution,11,4,7
Олегсудья,howling-fjord,351,paladin,retribution,11,4,7
Taigetos,draenor,351,paladin,retribution,11,4,7
Freemain,doomhammer,336,paladin,retribution,9,4,5
Strcker,sylvanas,336,paladin,retribution,9,4,5
Нимбоо,soulflayer,335,paladin,retribution,11,4,7
Sunsera,blackrock,330,paladin,retribution,8,5,3
Alanore,tarren-mill,330,paladin,retribution,13,6,7
Хочучерешни,lich-king,330,paladin,retribution,14,5,9
Enary,zuljin,330,paladin,retribution,15,5,10
Каплясвета,gordunni,330,paladin,retribution,15,5,10
Rafistor,khaz-modan,330,paladin,retribution,24,7,17
Matharr,kazzak,330,paladin,retribution,19,5,14
Respen,trollbane,330,paladin,retribution,22,5,17
Stonebeard,ahnqiraj,329,paladin,retribution,25,5,20
Bafbaf,arathi,329,paladin,retribution,30,5,25
Glâdiatør,blackrock,320,paladin,retribution,10,4,6
Lgbtqlover,kazzak,319,paladin,retribution,5,4,1
Kyazar,sylvanas,319,paladin,retribution,5,4,1
Strìke,ragnaros,319,paladin,retribution,8,4,4
Vermilia,blackmoore,319,paladin,retribution,8,4,4
Артуроэльф,eversong,318,paladin,retribution,11,4,7
Ønyxqt,archimonde,304,paladin,retribution,7,4,3
Stárchy,terenas,288,paladin,retribution,6,3,3
Môôses,kazzak,288,paladin,retribution,6,3,3
Lightfôrce,blackmoore,288,paladin,retribution,6,3,3
Partur,stormreaver,288,paladin,retribution,6,3,3
Hione,burning-legion,288,paladin,retribution,6,3,3
Sparckqt,nemesis,288,paladin,retribution,6,3,3
Mayhem,area-52,288,paladin,retribution,6,3,3
Isgarot,pozzo-delleternità,288,paladin,retribution,6,3,3
Novà,ravencrest,288,paladin,retribution,6,3,3
Staturos,burning-legion,288,paladin,retribution,6,3,3
Kelsumi,draenor,288,paladin,retribution,6,3,3
Ráydrax,dun-modr,288,paladin,retribution,6,3,3
Tìberias,blackmoore,288,paladin,retribution,6,3,3
Septèmber,draenor,288,paladin,retribution,6,3,3
Vaciusta,silvermoon,288,paladin,retribution,6,3,3
Senteha,stormscale,288,paladin,retribution,6,3,3
Taukkï,kazzak,288,paladin,retribution,6,3,3
Dominoeffect,sylvanas,288,paladin,retribution,6,3,3
Akcope,thunderhorn,288,paladin,retribution,6,3,3
Fogell,ravencrest,288,paladin,retribution,6,3,3
Tyn,dragonmaw,288,paladin,retribution,6,3,3
Holythore,shadowsong,288,paladin,retribution,6,3,3
Thalyia,neptulon,288,paladin,retribution,6,3,3
Swäagg,hyjal,288,paladin,retribution,6,3,3
Bootysmasher,silvermoon,288,paladin,retribution,6,3,3
Lolsurprise,twisting-nether,288,paladin,retribution,6,3,3
Редрот,gordunni,288,paladin,retribution,6,3,3
Alekks,silvermoon,288,paladin,retribution,6,3,3
Isotun,kazzak,288,paladin,retribution,6,3,3
Crazydiamond,garona,288,paladin,retribution,6,3,3
Muradun,aegwynn,288,paladin,retribution,6,3,3
Valeantz,draenor,288,paladin,retribution,6,3,3
Strangerx,blackrock,288,paladin,retribution,6,3,3
Illmindofyou,twisting-nether,288,paladin,retribution,6,3,3
Krístjan,silvermoon,288,paladin,retribution,6,3,3
Andriâ,blackhand,288,paladin,retribution,6,3,3
Belåkor,silvermoon,288,paladin,retribution,6,3,3
Wonkans,draenor,288,paladin,retribution,6,3,3
Bashx,outland,288,paladin,retribution,6,3,3
Ñusret,aegwynn,288,paladin,retribution,6,3,3
Paladiaz,blackhand,288,paladin,retribution,6,3,3
Bogrács,silvermoon,288,paladin,retribution,6,3,3
Mansoureagle,kazzak,288,paladin,retribution,6,3,3
Shaká,ravencrest,288,paladin,retribution,6,3,3
Feliora,magtheridon,288,paladin,retribution,6,3,3
Synthesis,uldum,288,paladin,retribution,6,3,3
Astralz,aegwynn,288,paladin,retribution,6,3,3
Sekoran,sunstrider,288,paladin,retribution,6,3,3
Deckardpain,shattered-hand,288,paladin,retribution,6,3,3
Azzaelea,tarren-mill,288,paladin,retribution,6,3,3
Watchmestomp,draenor,288,paladin,retribution,6,3,3
Animegifx,ragnaros,288,paladin,retribution,6,3,3
Holydeath,aegwynn,288,paladin,retribution,6,3,3
Лайсен,gordunni,288,paladin,retribution,6,3,3
Thomususholy,silvermoon,288,paladin,retribution,6,3,3
Rômtone,dalaran,288,paladin,retribution,6,3,3
Véngeance,twilights-hammer,288,paladin,retribution,6,3,3
Heyley,twisting-nether,288,paladin,retribution,6,3,3
Goofyret,ravencrest,288,paladin,retribution,6,3,3
Hatoms,hyjal,288,paladin,retribution,6,3,3
Exero,frostmane,288,paladin,retribution,6,3,3
Хэппипала,soulflayer,288,paladin,retribution,6,3,3
Sérath,twisting-nether,288,paladin,retribution,6,3,3
Divinemove,stormscale,288,paladin,retribution,6,3,3
Amq,blackhand,288,paladin,retribution,6,3,3
Ráikou,sylvanas,288,paladin,retribution,6,3,3
Uoloop,kazzak,288,paladin,retribution,6,3,3
Synexy,kazzak,288,paladin,retribution,6,3,3
Stocks,burning-blade,288,paladin,retribution,6,3,3
Drwings,drakthul,288,paladin,retribution,6,3,3
Meezu,ravencrest,288,paladin,retribution,6,3,3
Prâtox,blackmoore,288,paladin,retribution,6,3,3
Partysyster,defias-brotherhood,288,paladin,retribution,6,3,3
Împala,twisting-nether,288,paladin,retribution,6,3,3
Xirôs,zirkel-des-cenarius,288,paladin,retribution,6,3,3
Neoz,ravencrest,288,paladin,retribution,6,3,3
Epipheny,frostmane,288,paladin,retribution,6,3,3
Dezaster,dentarg,288,paladin,retribution,6,3,3
Tyranius,bronzebeard,288,paladin,retribution,6,3,3
Ruben,kirin-tor,288,paladin,retribution,6,3,3
Tørque,archimonde,288,paladin,retribution,6,3,3
Zetnic,kazzak,288,paladin,retribution,6,3,3
Muieiulica,twisting-nether,288,paladin,retribution,6,3,3
Steínsgate,ravencrest,288,paladin,retribution,6,3,3
Paladikt,teldrassil,288,paladin,retribution,6,3,3
Ðåøóýöøðí,ravencrest,288,paladin,retribution,6,3,3
Judgedude,stormscale,288,paladin,retribution,6,3,3
Dédoniste,archimonde,288,paladin,retribution,6,3,3
Yoggsaron,dun-modr,288,paladin,retribution,6,3,3
Ollepala,draenor,288,paladin,retribution,6,3,3
Phystos,culte-de-la-rive-noire,288,paladin,retribution,6,3,3
Reptoglad,archimonde,288,paladin,retribution,6,3,3
Nympa,sylvanas,288,paladin,retribution,6,3,3
Astralenigma,hyjal,288,paladin,retribution,6,3,3
Palapouffe,khaz-modan,288,paladin,retribution,6,3,3
Pappipala,tarren-mill,288,paladin,retribution,6,3,3
Moolurk,stormscale,288,paladin,retribution,6,3,3
Bahamamama,ambossar,288,paladin,retribution,6,3,3
Киръпич,grom,288,paladin,retribution,6,3,3
Failhammer,tarren-mill,288,paladin,retribution,6,3,3
Кузнейц,borean-tundra,288,paladin,retribution,6,3,3
Bämschi,blackrock,288,paladin,retribution,6,3,3
Freakks,twisting-nether,288,paladin,retribution,6,3,3
Lóde,silvermoon,288,paladin,retribution,6,3,3
Minirempart,khaz-modan,288,paladin,retribution,6,3,3
Hyroshima,archimonde,288,paladin,retribution,6,3,3
Tonynox,hyjal,288,paladin,retribution,6,3,3
Thunderwoman,ragnaros,288,paladin,retribution,6,3,3
Aklime,blackmoore,288,paladin,retribution,6,3,3
Hondur,blackmoore,288,paladin,retribution,6,3,3
Holyshêêt,draenor,288,paladin,retribution,6,3,3
Xirac,antonidas,288,paladin,retribution,6,3,3
Hotchíck,outland,288,paladin,retribution,6,3,3
Svipdag,quelthalas,288,paladin,retribution,6,3,3
Glorfindel,tarren-mill,288,paladin,retribution,6,3,3
Myrtîllê,archimonde,288,paladin,retribution,6,3,3
Daemøs,antonidas,288,paladin,retribution,6,3,3
Retroxy,stormreaver,288,paladin,retribution,6,3,3
Pastabianco,ravencrest,288,paladin,retribution,6,3,3
Lixîa,hyjal,288,paladin,retribution,6,3,3
Aoldur,ragnaros,288,paladin,retribution,6,3,3
Ozen,blackrock,288,paladin,retribution,6,3,3
Cilodin,blackrock,288,paladin,retribution,6,3,3
Dyonisøs,archimonde,288,paladin,retribution,6,3,3
Lotheirid,antonidas,288,paladin,retribution,6,3,3
Vîdelle,eldrethalas,288,paladin,retribution,6,3,3
Razztafari,tarren-mill,288,paladin,retribution,6,3,3
Kirikoro,blackmoore,288,paladin,retribution,6,3,3
Elyeasia,silvermoon,288,paladin,retribution,6,3,3
Sixtynien,outland,288,paladin,retribution,6,3,3
Gipas,quelthalas,288,paladin,retribution,6,3,3
Khrogan,bronzebeard,288,paladin,retribution,6,3,3
Мортлайт,soulflayer,288,paladin,retribution,6,3,3
Kishijoten,archimonde,288,paladin,retribution,6,3,3
Raketenreiko,blackrock,288,paladin,retribution,6,3,3
Vérdugo,quelthalas,288,paladin,retribution,6,3,3
Иретис,gordunni,288,paladin,retribution,6,3,3
Бигтедо,gordunni,288,paladin,retribution,6,3,3
Sarunan,ravencrest,288,paladin,retribution,6,3,3
Londrette,kazzak,288,paladin,retribution,6,3,3
Nicolae,saurfang,288,paladin,retribution,6,3,3
Shealby,thrall,288,paladin,retribution,6,3,3
Bonkkar,antonidas,288,paladin,retribution,6,3,3
Golgel,turalyon,288,paladin,retribution,6,3,3
Emet,twisting-nether,288,paladin,retribution,6,3,3
Veo,sylvanas,288,paladin,retribution,6,3,3
Ênmâ,archimonde,288,paladin,retribution,6,3,3
Môdhân,archimonde,288,paladin,retribution,6,3,3
Sakulchan,antonidas,288,paladin,retribution,6,3,3
Faté,madmortem,288,paladin,retribution,6,3,3
Fahrèl,hyjal,288,paladin,retribution,6,3,3
Sileria,kazzak,288,paladin,retribution,6,3,3
Даркхолмь,howling-fjord,288,paladin,retribution,6,3,3
Брюхатая,howling-fjord,288,paladin,retribution,6,3,3
Белоус,howling-fjord,288,paladin,retribution,6,3,3
Hium,zuljin,288,paladin,retribution,6,3,3
Nøradin,argent-dawn,288,paladin,retribution,6,3,3
Paidi,die-todeskrallen,288,paladin,retribution,6,3,3
Lyrïcs,ysondre,288,paladin,retribution,6,3,3
Ïrönhämmër,argent-dawn,288,paladin,retribution,6,3,3
Blookedaro,sanguino,288,paladin,retribution,6,3,3
Guko,frostwolf,288,paladin,retribution,6,3,3
Khredo,eredar,288,paladin,retribution,6,3,3
Лантана,howling-fjord,288,paladin,retribution,6,3,3
Vultrix,tarren-mill,288,paladin,retribution,6,3,3
Dathrohan,sanguino,288,paladin,retribution,6,3,3
Milkâ,burning-legion,288,paladin,retribution,6,3,3
Zeltose,uldaman,288,paladin,retribution,6,3,3
Киэрсис,howling-fjord,288,paladin,retribution,6,3,3
Noanoshy,eredar,288,paladin,retribution,6,3,3
Tjú,mannoroth,288,paladin,retribution,6,3,3
Ryuzu,khazgoroth,288,paladin,retribution,6,3,3
Синтел,eversong,288,paladin,retribution,6,3,3
Бинур,eversong,288,paladin,retribution,6,3,3
Fumbz,alakir,288,paladin,retribution,6,3,3
Рамстафарай,gordunni,288,paladin,retribution,6,3,3
Rhadamentes,ysondre,288,paladin,retribution,6,3,3
Grial,eredar,288,paladin,retribution,6,3,3
Blessbabe,tarren-mill,288,paladin,retribution,6,3,3
Alexii,azjolnerub,288,paladin,retribution,10,4,6
Dorlen,argent-dawn,288,paladin,retribution,10,4,6
Songg,zuljin,288,paladin,retribution,8,3,5
Hýpærpøp,ravencrest,288,paladin,retribution,8,3,5
Aenhel,zuljin,288,paladin,retribution,11,4,7
Tastán,aegwynn,288,paladin,retribution,9,3,6
Dragg,kirin-tor,288,paladin,retribution,10,3,7
Gabe,aggra-português,288,paladin,retribution,15,4,11
Taptreus,antonidas,288,paladin,retribution,12,3,9
Kiytrew,ravencrest,288,paladin,retribution,12,3,9
Mathrixo,silvermoon,288,paladin,retribution,12,3,9
Schoolbus,blackrock,288,paladin,retribution,12,3,9
Liquesco,draenor,288,paladin,retribution,12,3,9
Бетте,gordunni,288,paladin,retribution,12,3,9
Ауё,blackscar,288,paladin,retribution,12,3,9
Shassera,ravencrest,288,paladin,retribution,12,3,9
Ahreesh,blackrock,288,paladin,retribution,12,3,9
Whórainzóne,eredar,288,paladin,retribution,12,3,9
Xzpal,silvermoon,288,paladin,retribution,12,3,9
Çolette,silvermoon,288,paladin,retribution,12,3,9
Strikè,stormscale,288,paladin,retribution,12,3,9
Lucyd,stormscale,288,paladin,retribution,12,3,9
Dmascus,blackrock,288,paladin,retribution,12,3,9
Râkim,malganis,288,paladin,retribution,12,3,9
Notnding,draenor,288,paladin,retribution,12,3,9
Azmocore,blackhand,288,paladin,retribution,12,3,9
Trollpaladin,blackmoore,288,paladin,retribution,12,3,9
Souror,blackmoore,288,paladin,retribution,12,3,9
Каадзуто,eversong,288,paladin,retribution,12,3,9
Popolelo,dun-modr,288,paladin,retribution,12,3,9
Darkham,nemesis,288,paladin,retribution,12,3,9
Dalaly,kazzak,288,paladin,retribution,12,3,9
Галлионн,gordunni,288,paladin,retribution,12,3,9
Эледвен,howling-fjord,288,paladin,retribution,12,3,9
Fuyúrí,burning-legion,288,paladin,retribution,12,3,9
Dathea,aegwynn,288,paladin,retribution,12,3,9
Blecheîmer,aegwynn,288,paladin,retribution,12,3,9
Daddysiliam,ravencrest,288,paladin,retribution,12,3,9
Synáx,blackhand,288,paladin,retribution,12,3,9
Астта,fordragon,288,paladin,retribution,12,3,9
Flogiston,burning-legion,288,paladin,retribution,12,3,9
Wolluna,frostwolf,288,paladin,retribution,12,3,9
Slaaneesh,zuljin,288,paladin,retribution,12,3,9
Shneéz,blackmoore,288,paladin,retribution,12,3,9
Tehacê,blackrock,288,paladin,retribution,12,3,9
Arthàs,blackmoore,288,paladin,retribution,12,3,9
Inmortality,sanguino,288,paladin,retribution,12,3,9
Ахелеззик,gordunni,288,paladin,retribution,12,3,9
Lacrossé,kazzak,288,paladin,retribution,12,3,9
Lylennâ,argent-dawn,288,paladin,retribution,12,3,9
Trwwsano,stormscale,288,paladin,retribution,12,3,9
Mandingbull,stormscale,288,paladin,retribution,12,3,9
Radeto,outland,288,paladin,retribution,12,3,9
Skuzee,archimonde,288,paladin,retribution,12,3,9
Jojomann,stormscale,288,paladin,retribution,12,3,9
Aurasis,archimonde,288,paladin,retribution,12,3,9
Harvel,outland,288,paladin,retribution,12,3,9
Notingvar,doomhammer,288,paladin,retribution,12,3,9
Nasrudan,ravenholdt,288,paladin,retribution,12,3,9
Valarïs,outland,288,paladin,retribution,12,3,9
Simsaii,stormscale,288,paladin,retribution,12,3,9
Leoniidas,cthun,288,paladin,retribution,12,3,9
Câlon,twisting-nether,288,paladin,retribution,12,3,9
Murodin,twisting-nether,288,paladin,retribution,12,3,9
Harnêlia,marécage-de-zangar,288,paladin,retribution,12,3,9
Djuwuu,twisting-nether,288,paladin,retribution,12,3,9
Artemes,malorne,288,paladin,retribution,12,3,9
Kypamop,argent-dawn,288,paladin,retribution,12,3,9
Iñgkara,tarren-mill,288,paladin,retribution,12,3,9
Izelv,dalaran,288,paladin,retribution,12,3,9
Coldcuts,sylvanas,288,paladin,retribution,12,3,9
Cigoveth,sylvanas,288,paladin,retribution,12,3,9
Аладушок,gordunni,288,paladin,retribution,12,3,9
Steelrose,auchindoun,288,paladin,retribution,12,3,9
Sangaro,ragnaros,288,paladin,retribution,12,3,9
Dasvidania,uldum,288,paladin,retribution,12,3,9
Deholyloa,frostwhisper,288,paladin,retribution,12,3,9
Ашилолпро,soulflayer,288,paladin,retribution,12,3,9
Cilla,kult-der-verdammten,288,paladin,retribution,12,3,9
Amadeo,genjuros,288,paladin,retribution,12,3,9
Thærõck,thrall,288,paladin,retribution,12,3,9
Turbopal,burning-blade,288,paladin,retribution,12,3,9
Korneta,sanguino,288,paladin,retribution,12,3,9
Japsee,runetotem,288,paladin,retribution,12,3,9
Pokexx,ragnaros,288,paladin,retribution,12,3,9
Крутикрит,goldrinn,288,paladin,retribution,13,3,10
Agrkan,defias-brotherhood,288,paladin,retribution,17,3,14
Fenik,dun-modr,288,paladin,retribution,18,3,15
Razzim,eredar,288,paladin,retribution,18,3,15
Paladinslaye,dun-modr,288,paladin,retribution,18,3,15
Skemfar,sanguino,288,paladin,retribution,18,3,15
Shârâs,kazzak,288,paladin,retribution,18,3,15
Ulderoth,dun-modr,288,paladin,retribution,18,3,15
Paintdafence,kazzak,288,paladin,retribution,18,3,15
Símp,grim-batol,288,paladin,retribution,18,3,15
Sztat,burning-legion,288,paladin,retribution,18,3,15
Mêyra,blackhand,288,paladin,retribution,20,3,17
Айронс,ashenvale,287,paladin,retribution,6,3,3
Стекловатный,gordunni,287,paladin,retribution,6,3,3
Malzj,garrosh,287,paladin,retribution,6,3,3
Ïwâ,hyjal,287,paladin,retribution,6,3,3
Arthane,frostmane,287,paladin,retribution,6,3,3
Moodypala,doomhammer,287,paladin,retribution,6,3,3
Sìegfrìed,sargeras,287,paladin,retribution,6,3,3
Hrubo,drakthul,287,paladin,retribution,6,3,3
Magott,doomhammer,287,paladin,retribution,6,3,3
Psihar,kazzak,287,paladin,retribution,6,3,3
Trevorion,argent-dawn,287,paladin,retribution,12,3,9
Bore,culte-de-la-rive-noire,287,paladin,retribution,12,3,9
Neftys,aegwynn,287,paladin,retribution,12,3,9
Cajikpal,drakthul,287,paladin,retribution,12,3,9
Voraxpa,draenor,287,paladin,retribution,12,3,9
Rsanchez,frostwolf,286,paladin,retribution,6,3,3
Brictom,tarren-mill,271,paladin,retribution,11,3,8
Рбгхил,howling-fjord,271,paladin,retribution,11,3,8
Tofrus,kazzak,271,paladin,retribution,11,3,8
Стилбич,gordunni,256,paladin,retribution,10,3,7
Msammus,kazzak,255,paladin,retribution,11,3,8
Bloodl,hakkar,255,paladin,retribution,11,3,8
Dodgemyhoj,kazzak,240,paladin,retribution,21,3,18
Manyouk,kazzak,239,paladin,retribution,5,3,2
Gõm,aegwynn,239,paladin,retribution,5,3,2
Kurasame,eredar,239,paladin,retribution,5,3,2
Erannor,kirin-tor,239,paladin,retribution,5,3,2
Papel,kul-tiras,239,paladin,retribution,5,3,2
Ксандэр,soulflayer,239,paladin,retribution,5,3,2
Pooncy,ragnaros,239,paladin,retribution,5,3,2
Aufstapelnx,hyjal,239,paladin,retribution,5,3,2
Tÿy,sylvanas,234,paladin,retribution,8,4,4
Dørvâp,culte-de-la-rive-noire,234,paladin,retribution,11,4,7
Andrøiz,dun-modr,234,paladin,retribution,15,4,11
Psykoosi,defias-brotherhood,232,paladin,retribution,11,4,7
Purpleháze,drekthar,220,paladin,retribution,19,9,10
Bigwings,stormscale,208,paladin,retribution,7,3,4
Valteryl,argent-dawn,192,paladin,retribution,4,3,1
Тазикчая,soulflayer,192,paladin,retribution,4,3,1
Denko,ravencrest,192,paladin,retribution,4,3,1
Casiimuero,los-errantes,192,paladin,retribution,4,3,1
Ryanretnolds,stormscale,192,paladin,retribution,4,3,1
Salthar,dun-modr,192,paladin,retribution,6,2,4
Arthacalan,silvermoon,192,paladin,retribution,6,2,4
Vikingensven,silvermoon,192,paladin,retribution,6,2,4
Pipifeng,silvermoon,192,paladin,retribution,6,2,4
Yumhi,dun-modr,192,paladin,retribution,6,2,4
Abellá,silvermoon,192,paladin,retribution,6,2,4
Alberix,tarren-mill,192,paladin,retribution,6,2,4
Daviaa,silvermoon,192,paladin,retribution,6,2,4
Doormat,stormreaver,192,paladin,retribution,6,2,4
Tópgee,ravencrest,192,paladin,retribution,6,2,4
Seradawn,ravencrest,192,paladin,retribution,6,2,4
Wzzy,ravencrest,192,paladin,retribution,6,2,4
Radiantblood,ravencrest,192,paladin,retribution,6,2,4
Louxoxo,ravencrest,192,paladin,retribution,6,2,4
Garzad,ravencrest,192,paladin,retribution,6,2,4
Timias,silvermoon,192,paladin,retribution,6,2,4
Rdypaladin,ravencrest,192,paladin,retribution,6,2,4
Hupson,dun-modr,192,paladin,retribution,6,2,4
Marshmallów,silvermoon,192,paladin,retribution,6,2,4
Yaxz,ravencrest,192,paladin,retribution,6,2,4
Lightsimper,silvermoon,192,paladin,retribution,6,2,4
Escanoir,azshara,192,paladin,retribution,6,2,4
Daizen,blackrock,192,paladin,retribution,6,2,4
Bigolcritty,silvermoon,192,paladin,retribution,6,2,4
Tindal,stormscale,192,paladin,retribution,6,2,4
Panomecon,magtheridon,192,paladin,retribution,6,2,4
Necrozi,stormscale,192,paladin,retribution,6,2,4
Azraise,stormscale,192,paladin,retribution,6,2,4
Cjis,kazzak,192,paladin,retribution,6,2,4
Retrikuc,stormscale,192,paladin,retribution,6,2,4
Cripxoo,sanguino,192,paladin,retribution,6,2,4
Vans,nazjatar,192,paladin,retribution,6,2,4
Reticles,ravencrest,192,paladin,retribution,6,2,4
Soralî,dethecus,192,paladin,retribution,6,2,4
Blindevotion,the-maelstrom,192,paladin,retribution,6,2,4
Antitodas,argent-dawn,192,paladin,retribution,6,2,4
Туларион,grom,192,paladin,retribution,6,2,4
Teenage,colinas-pardas,192,paladin,retribution,6,2,4
Eneomaos,blackrock,192,paladin,retribution,6,2,4
Arndt,lightbringer,192,paladin,retribution,6,2,4
Zephale,sunstrider,192,paladin,retribution,6,2,4
Onys,onyxia,192,paladin,retribution,6,2,4
Paladéán,malganis,192,paladin,retribution,6,2,4
Chizpal,silvermoon,192,paladin,retribution,6,2,4
Blurengo,blackrock,192,paladin,retribution,6,2,4
Nozgot,chromaggus,192,paladin,retribution,6,2,4
Yuri,voljin,192,paladin,retribution,6,2,4
Xoconuttv,ravencrest,192,paladin,retribution,6,2,4
Asthellis,kazzak,192,paladin,retribution,6,2,4
Trainwréck,ravencrest,192,paladin,retribution,6,2,4
Grømit,drakthul,192,paladin,retribution,6,2,4
Tybrain,blackhand,192,paladin,retribution,6,2,4
Kamas,antonidas,192,paladin,retribution,6,2,4
Thelinara,antonidas,192,paladin,retribution,6,2,4
Ibus,silvermoon,192,paladin,retribution,6,2,4
Yami,blackrock,192,paladin,retribution,6,2,4
Gottesbann,blackrock,192,paladin,retribution,6,2,4
Tpaktopuct,kazzak,192,paladin,retribution,6,2,4
Wingsftw,blackhand,192,paladin,retribution,6,2,4
Boturak,blackrock,192,paladin,retribution,6,2,4
Alto,nordrassil,192,paladin,retribution,6,2,4
Elites,arathor,192,paladin,retribution,6,2,4
Faithsealer,nordrassil,192,paladin,retribution,6,2,4
Strøb,antonidas,192,paladin,retribution,6,2,4
Heilgaharald,blackrock,192,paladin,retribution,6,2,4
Drasir,nemesis,192,paladin,retribution,6,2,4
Ráyøn,antonidas,192,paladin,retribution,6,2,4
Maxunius,antonidas,192,paladin,retribution,6,2,4
Liféféar,tarren-mill,192,paladin,retribution,6,2,4
Shirohige,pozzo-delleternità,192,paladin,retribution,6,2,4
Athomos,pozzo-delleternità,192,paladin,retribution,6,2,4
Кизайрус,soulflayer,192,paladin,retribution,6,2,4
Encoreret,kilrogg,192,paladin,retribution,6,2,4
Vrotkarpala,azjolnerub,192,paladin,retribution,6,2,4
Valanyr,kazzak,192,paladin,retribution,6,2,4
Hekta,wildhammer,192,paladin,retribution,6,2,4
Tusti,tarren-mill,192,paladin,retribution,6,2,4
Djstompyasis,blackmoore,192,paladin,retribution,6,2,4
Malbi,kazzak,192,paladin,retribution,6,2,4
Blazeê,blackrock,192,paladin,retribution,6,2,4
Kamaska,antonidas,192,paladin,retribution,6,2,4
Tsomoo,antonidas,192,paladin,retribution,6,2,4
Izõu,aegwynn,192,paladin,retribution,6,2,4
Kathly,madmortem,192,paladin,retribution,6,2,4
Гачипаладинн,galakrond,192,paladin,retribution,6,2,4
Kíamhalifa,twisting-nether,192,paladin,retribution,6,2,4
Saliver,frostwolf,192,paladin,retribution,6,2,4
Waramo,eredar,192,paladin,retribution,6,2,4
Présidential,grim-batol,192,paladin,retribution,6,2,4
Месатил,deathguard,192,paladin,retribution,6,2,4
Leelemon,frostmane,192,paladin,retribution,6,2,4
Rhonda,tarren-mill,192,paladin,retribution,6,2,4
Aal,eredar,192,paladin,retribution,6,2,4
Miscodepala,twisting-nether,192,paladin,retribution,6,2,4
Clerik,eredar,192,paladin,retribution,6,2,4
Dàk,grim-batol,192,paladin,retribution,6,2,4
Bpontes,aggra-português,192,paladin,retribution,6,2,4
Quennten,grim-batol,192,paladin,retribution,6,2,4
Hompra,outland,192,paladin,retribution,6,2,4
Beiluoshimen,archimonde,192,paladin,retribution,6,2,4
Legrandnain,archimonde,192,paladin,retribution,6,2,4
Bozznamaan,thrall,192,paladin,retribution,6,2,4
Pava,blackmoore,192,paladin,retribution,6,2,4
Raigun,sylvanas,192,paladin,retribution,6,2,4
Krhamos,archimonde,192,paladin,retribution,6,2,4
Xephiroxus,the-venture-co,192,paladin,retribution,6,2,4
Aragonm,outland,192,paladin,retribution,6,2,4
Zuldekk,sanguino,192,paladin,retribution,6,2,4
Xîndra,blackmoore,192,paladin,retribution,6,2,4
Galodina,blackmoore,192,paladin,retribution,6,2,4
Slymm,archimonde,192,paladin,retribution,6,2,4
Nickko,ysondre,192,paladin,retribution,6,2,4
Kårnaj,archimonde,192,paladin,retribution,6,2,4
Iamdurumrush,outland,192,paladin,retribution,6,2,4
Karnabahar,twisting-nether,192,paladin,retribution,6,2,4
Spellcrow,argent-dawn,192,paladin,retribution,6,2,4
Palacheatlol,ysondre,192,paladin,retribution,6,2,4
Brolaf,drakthul,192,paladin,retribution,6,2,4
Frías,zuljin,192,paladin,retribution,6,2,4
Dollicia,outland,192,paladin,retribution,6,2,4
Brihgiul,archimonde,192,paladin,retribution,6,2,4
Lorthaél,karazhan,192,paladin,retribution,6,2,4
Pipiczek,outland,192,paladin,retribution,6,2,4
Lùthér,argent-dawn,192,paladin,retribution,6,2,4
Sacrémounf,archimonde,192,paladin,retribution,6,2,4
Tomforøl,aggramar,192,paladin,retribution,6,2,4
Kapaeus,aggramar,192,paladin,retribution,6,2,4
Ejoz,suramar,192,paladin,retribution,6,2,4
Blauerwürger,blackmoore,192,paladin,retribution,6,2,4
Eisenbiaga,blackmoore,192,paladin,retribution,6,2,4
Антитеррор,greymane,192,paladin,retribution,6,2,4
Stupidgame,outland,192,paladin,retribution,6,2,4
Aksoû,hyjal,192,paladin,retribution,6,2,4
Zixxo,outland,192,paladin,retribution,6,2,4
Maxximuss,drekthar,192,paladin,retribution,6,2,4
Logmár,sanguino,192,paladin,retribution,6,2,4
Altoangelo,outland,192,paladin,retribution,6,2,4
Holyape,argent-dawn,192,paladin,retribution,6,2,4
Gryan,stormscale,192,paladin,retribution,6,2,4
Ðeswynd,hyjal,192,paladin,retribution,6,2,4
Meatslice,boulderfist,192,paladin,retribution,6,2,4
Everessa,sylvanas,192,paladin,retribution,6,2,4
Jÿnxx,hyjal,192,paladin,retribution,6,2,4
Dáimion,defias-brotherhood,192,paladin,retribution,6,2,4
Lionknight,sylvanas,192,paladin,retribution,6,2,4
Svåger,stormscale,192,paladin,retribution,6,2,4
Azapala,kazzak,192,paladin,retribution,6,2,4
Gornim,die-nachtwache,192,paladin,retribution,6,2,4
Hølly,twisting-nether,192,paladin,retribution,6,2,4
Светлолик,eversong,192,paladin,retribution,6,2,4
Kerplonk,burning-legion,192,paladin,retribution,6,2,4
Samypalouf,naxxramas,192,paladin,retribution,6,2,4
Razarus,sylvanas,192,paladin,retribution,6,2,4
Дэвайнэвил,gordunni,192,paladin,retribution,6,2,4
Drjudge,draenor,192,paladin,retribution,6,2,4
Пепескарлет,howling-fjord,192,paladin,retribution,6,2,4
Lightshedder,twisting-nether,192,paladin,retribution,6,2,4
Crownroyal,twisting-nether,192,paladin,retribution,6,2,4
Вишенций,howling-fjord,192,paladin,retribution,6,2,4
Sangrèin,nerathor,192,paladin,retribution,6,2,4
Breakafly,doomhammer,192,paladin,retribution,6,2,4
Загадзуга,howling-fjord,192,paladin,retribution,6,2,4
Starr,confrérie-du-thorium,192,paladin,retribution,6,2,4
Halori,ragnaros,192,paladin,retribution,6,2,4
Almiraj,conseil-des-ombres,192,paladin,retribution,6,2,4
Никитаберс,gordunni,192,paladin,retribution,6,2,4
Soxsnort,twisting-nether,192,paladin,retribution,6,2,4
Скруддж,howling-fjord,192,paladin,retribution,6,2,4
Светочпок,howling-fjord,192,paladin,retribution,6,2,4
Boonner,burning-legion,192,paladin,retribution,6,2,4
Всеволорд,howling-fjord,192,paladin,retribution,6,2,4
Thaldriel,la-croisade-écarlate,192,paladin,retribution,6,2,4
Apokalypson,draenor,192,paladin,retribution,6,2,4
Ashariah,die-aldor,192,paladin,retribution,6,2,4
Ainnamash,twisting-nether,192,paladin,retribution,6,2,4
Zbykmasta,burning-legion,192,paladin,retribution,6,2,4
Fizzyy,ragnaros,192,paladin,retribution,6,2,4
Shápzx,draenor,192,paladin,retribution,6,2,4
Paradice,ragnaros,192,paladin,retribution,6,2,4
Потрепал,blackscar,192,paladin,retribution,6,2,4
Элестаге,gordunni,192,paladin,retribution,6,2,4
Héraclèss,marécage-de-zangar,192,paladin,retribution,6,2,4
Kael,darkspear,192,paladin,retribution,6,2,4
Димаходж,blackscar,192,paladin,retribution,6,2,4
Canihavesome,sylvanas,192,paladin,retribution,6,2,4
Malvax,ragnaros,192,paladin,retribution,6,2,4
Palek,burning-legion,192,paladin,retribution,6,2,4
Lemarobebsi,draenor,192,paladin,retribution,6,2,4
Naylaeh,draenor,192,paladin,retribution,6,2,4
Розовыйужас,howling-fjord,192,paladin,retribution,6,2,4
Ярлд,gordunni,192,paladin,retribution,6,2,4
Palalightdfq,dalaran,192,paladin,retribution,6,2,4
Flashhèart,draenor,192,paladin,retribution,6,2,4
Сильверный,gordunni,192,paladin,retribution,6,2,4
Csvepanszul,ragnaros,192,paladin,retribution,6,2,4
Имраил,gordunni,192,paladin,retribution,6,2,4
Pallyman,arthas,192,paladin,retribution,6,2,4
Dorian,durotan,192,paladin,retribution,6,2,4
Pryzmath,burning-legion,192,paladin,retribution,6,2,4
Афликтшаман,howling-fjord,192,paladin,retribution,6,2,4
Эйлара,howling-fjord,192,paladin,retribution,6,2,4
Elfiama,draenor,192,paladin,retribution,6,2,4
Tecknó,ragnaros,192,paladin,retribution,6,2,4
Blinkdrink,ragnaros,192,paladin,retribution,6,2,4
Тайела,gordunni,192,paladin,retribution,10,3,7
Votiones,tarren-mill,192,paladin,retribution,7,2,5
Плат,gordunni,192,paladin,retribution,7,2,5
Aldèbaràn,pozzo-delleternità,192,paladin,retribution,11,3,8
Damelu,frostwhisper,192,paladin,retribution,8,2,6
Angeliqué,alakir,192,paladin,retribution,12,2,10
Samious,draenor,192,paladin,retribution,12,2,10
Rhyua,eredar,192,paladin,retribution,12,2,10
Galath,drakthul,192,paladin,retribution,12,2,10
Verix,thrall,192,paladin,retribution,12,2,10
Lihli,wildhammer,192,paladin,retribution,12,2,10
Cunix,draenor,192,paladin,retribution,12,2,10
Erathör,sanguino,192,paladin,retribution,12,2,10
Lâlexâ,blackrock,192,paladin,retribution,12,2,10
Kauto,aggra-português,192,paladin,retribution,12,2,10
Stefàn,sylvanas,192,paladin,retribution,12,2,10
Heavenfist,stormscale,192,paladin,retribution,12,2,10
Holythings,kazzak,192,paladin,retribution,12,2,10
Mommy,darksorrow,192,paladin,retribution,12,2,10
Bergalerga,frostmane,192,paladin,retribution,12,2,10
Lightian,twisting-nether,192,paladin,retribution,12,2,10
Stormtrooper,azuremyst,192,paladin,retribution,12,2,10
Tyrallan,ragnaros,192,paladin,retribution,12,2,10
Chitanta,sylvanas,192,paladin,retribution,12,2,10
Remedios,archimonde,192,paladin,retribution,12,2,10
Zimmt,blackmoore,192,paladin,retribution,12,2,10
Docdoolittle,magtheridon,192,paladin,retribution,12,2,10
Ultravíolett,kargath,192,paladin,retribution,12,2,10
Crawini,ragnaros,192,paladin,retribution,12,2,10
Mariuhûna,blackmoore,192,paladin,retribution,12,2,10
Ragneal,hyjal,192,paladin,retribution,12,2,10
Wigbilly,tarren-mill,192,paladin,retribution,12,2,10
Larialaya,thrall,192,paladin,retribution,12,2,10
Tressðr,dun-modr,192,paladin,retribution,12,2,10
Reinwaltz,the-maelstrom,192,paladin,retribution,12,2,10
Muuclear,twisting-nether,192,paladin,retribution,12,2,10
Jacare,ravencrest,192,paladin,retribution,12,2,10
Lunarrider,ravencrest,192,paladin,retribution,12,2,10
Ibubbleqt,outland,192,paladin,retribution,12,2,10
Hordium,doomhammer,192,paladin,retribution,12,2,10
Мунрейм,gordunni,192,paladin,retribution,12,2,10
Pârâsite,hyjal,192,paladin,retribution,12,2,10
Svddendeäthx,ragnaros,192,paladin,retribution,12,2,10
Lowfi,argent-dawn,192,paladin,retribution,12,2,10
Posidin,nemesis,192,paladin,retribution,12,2,10
Djasuo,burning-blade,192,paladin,retribution,12,2,10
Séntúrús,kazzak,192,paladin,retribution,12,2,10
Leriell,ravencrest,192,paladin,retribution,12,2,10
Ijego,silvermoon,192,paladin,retribution,12,2,10
Лимфома,goldrinn,192,paladin,retribution,12,2,10
Bubblekanta,antonidas,192,paladin,retribution,12,2,10
Kesra,die-todeskrallen,192,paladin,retribution,12,2,10
Палагэнг,howling-fjord,192,paladin,retribution,12,2,10
Poloqq,burning-legion,192,paladin,retribution,12,2,10
Berenguer,outland,192,paladin,retribution,12,2,10
Kökslaktarn,sylvanas,192,paladin,retribution,21,3,18
Stillgard,ghostlands,192,paladin,retribution,15,2,13
Cyxanacma,silvermoon,192,paladin,retribution,18,2,16
Snakedubaby,blackrock,192,paladin,retribution,24,2,22
Broziopath,blackrock,191,paladin,retribution,6,2,4
Zuklaus,hyjal,191,paladin,retribution,6,2,4
Zerocar,minahonda,191,paladin,retribution,6,2,4
Duckula,ravenholdt,191,paladin,retribution,6,2,4
Palazs,ravencrest,191,paladin,retribution,6,2,4
Skullreaper,mannoroth,185,paladin,retribution,12,4,8
Maitrelampe,argent-dawn,180,paladin,retribution,29,7,22
Thelronis,kelthuzad,175,paladin,retribution,11,2,9
Hegolas,terrordar,175,paladin,retribution,17,2,15
Blundd,tarren-mill,159,paladin,retribution,5,2,3
Geronimooh,vashj,159,paladin,retribution,5,2,3
Shoqzix,korgall,159,paladin,retribution,5,2,3
Heiemdall,azuremyst,159,paladin,retribution,5,2,3
Vâlthenea,dun-modr,159,paladin,retribution,5,2,3
Serita,archimonde,159,paladin,retribution,11,2,9
Trístesse,tarren-mill,159,paladin,retribution,11,2,9
Амнон,goldrinn,144,paladin,retribution,9,2,7
Tayun,blackmoore,144,paladin,retribution,21,2,19
Еребор,howling-fjord,143,paladin,retribution,15,2,13
Braiinafk,thrall,138,paladin,retribution,6,3,3
Скелфер,soulflayer,138,paladin,retribution,8,3,5
Gerisha,blackrock,138,paladin,retribution,9,3,6
Jesamine,blackmoore,138,paladin,retribution,9,3,6
Luzk,sanguino,138,paladin,retribution,22,4,18
Kaydou,the-maelstrom,128,paladin,retribution,4,2,2
Qpax,twisting-nether,128,paladin,retribution,4,2,2
Mouzimaru,tarren-mill,128,paladin,retribution,10,2,8
Aalyaah,zirkel-des-cenarius,96,paladin,retribution,3,2,1
Zenfuki,draenor,96,paladin,retribution,3,2,1
Nijówka,burning-legion,96,paladin,retribution,6,1,5
Methynox,khaz-modan,96,paladin,retribution,6,1,5
Røse,argent-dawn,96,paladin,retribution,6,1,5
Tibiscovus,silvermoon,96,paladin,retribution,6,1,5
Ansonia,ravencrest,96,paladin,retribution,6,1,5
Hiilton,silvermoon,96,paladin,retribution,6,1,5
Highlòrd,silvermoon,96,paladin,retribution,6,1,5
Holyherb,the-maelstrom,96,paladin,retribution,6,1,5
Serberen,ravencrest,96,paladin,retribution,6,1,5
Dildodin,ravencrest,96,paladin,retribution,6,1,5
Sanctùs,argent-dawn,96,paladin,retribution,6,1,5
Lyliananl,argent-dawn,96,paladin,retribution,6,1,5
Oepabakkez,burning-legion,96,paladin,retribution,6,1,5
Vittosbubu,ravencrest,96,paladin,retribution,6,1,5
Dumbala,ravencrest,96,paladin,retribution,6,1,5
Traxxces,ravencrest,96,paladin,retribution,6,1,5
Palatarlouze,khaz-modan,96,paladin,retribution,6,1,5
Dänie,silvermoon,96,paladin,retribution,6,1,5
Defuzes,twisting-nether,96,paladin,retribution,6,1,5
Bobsing,silvermoon,96,paladin,retribution,6,1,5
Молотуля,howling-fjord,96,paladin,retribution,6,1,5
Tíríón,nethersturm,96,paladin,retribution,6,1,5
Pussas,burning-legion,96,paladin,retribution,6,1,5
Zeroskills,tarren-mill,96,paladin,retribution,6,1,5
Shanilia,argent-dawn,96,paladin,retribution,6,1,5
Thozne,cthun,96,paladin,retribution,6,1,5
Subzery,blackrock,96,paladin,retribution,6,1,5
Graphpora,argent-dawn,96,paladin,retribution,6,1,5
Светиздырки,howling-fjord,96,paladin,retribution,6,1,5
Винзерг,ashenvale,96,paladin,retribution,6,1,5
Kefalas,ravencrest,96,paladin,retribution,6,1,5
Hyggë,sanguino,96,paladin,retribution,6,1,5
Donpascualo,dun-modr,96,paladin,retribution,6,1,5
Lezoom,draenor,96,paladin,retribution,6,1,5
Xblaj,draenor,96,paladin,retribution,6,1,5
Zefiehd,dun-modr,96,paladin,retribution,6,1,5
Ilaris,amanthul,96,paladin,retribution,6,1,5
Пилоттыч,gordunni,96,paladin,retribution,6,1,5
Fatalism,draenor,96,paladin,retribution,6,1,5
Friemelaar,silvermoon,96,paladin,retribution,6,1,5
Dawnbringer,stormscale,96,paladin,retribution,6,1,5
Akagami,ysondre,96,paladin,retribution,6,1,5
Vonadams,ysondre,96,paladin,retribution,6,1,5
Tifer,sanguino,96,paladin,retribution,6,1,5
Omranator,stormscale,96,paladin,retribution,6,1,5
Эльтарус,soulflayer,96,paladin,retribution,6,1,5
Старыйграф,gordunni,96,paladin,retribution,6,1,5
Rataxes,stormreaver,96,paladin,retribution,6,1,5
Stabilisator,blackrock,96,paladin,retribution,6,1,5
Késha,malganis,96,paladin,retribution,6,1,5
Schukow,blackhand,96,paladin,retribution,6,1,5
Sfantull,spinebreaker,96,paladin,retribution,6,1,5
Starcheto,silvermoon,96,paladin,retribution,6,1,5
Destya,eredar,96,paladin,retribution,6,1,5
Cazzanova,draenor,96,paladin,retribution,6,1,5
Notanother,ravencrest,96,paladin,retribution,6,1,5
Diggs,draenor,96,paladin,retribution,6,1,5
Pripravka,burning-blade,96,paladin,retribution,6,1,5
Brightboy,bronze-dragonflight,96,paladin,retribution,6,1,5
Kanollaras,tarren-mill,96,paladin,retribution,6,1,5
Palamaister,stormscale,96,paladin,retribution,6,1,5
Styleez,blackrock,96,paladin,retribution,6,1,5
Évo,drakthul,96,paladin,retribution,6,1,5
Rèdjàck,nemesis,96,paladin,retribution,6,1,5
Naska,nemesis,96,paladin,retribution,6,1,5
Eylina,ragnaros,96,paladin,retribution,6,1,5
Dunksunk,draenor,96,paladin,retribution,6,1,5
Miawyn,blackmoore,96,paladin,retribution,6,1,5
Holyloa,laughing-skull,96,paladin,retribution,6,1,5
Bráders,thunderhorn,96,paladin,retribution,6,1,5
Jehovaa,ragnaros,96,paladin,retribution,6,1,5
Karo,wildhammer,96,paladin,retribution,6,1,5
Amnell,marécage-de-zangar,96,paladin,retribution,6,1,5
Mèlow,dalaran,96,paladin,retribution,6,1,5
Tubie,draenor,96,paladin,retribution,6,1,5
Stealop,malfurion,96,paladin,retribution,6,1,5
Lightbreaker,alleria,96,paladin,retribution,6,1,5
Päyback,nagrand,96,paladin,retribution,6,1,5
Tamuz,chamber-of-aspects,96,paladin,retribution,6,1,5
Zandathor,chamber-of-aspects,96,paladin,retribution,6,1,5
Syfaria,eldrethalas,96,paladin,retribution,6,1,5
Tazsol,kazzak,96,paladin,retribution,6,1,5
Каридин,galakrond,96,paladin,retribution,6,1,5
Plasmadieter,blackrock,96,paladin,retribution,6,1,5
Holyhannes,blackmoore,96,paladin,retribution,6,1,5
Wingzko,draenor,96,paladin,retribution,6,1,5
Shabbyy,bronzebeard,96,paladin,retribution,6,1,5
Xôpâl,kazzak,96,paladin,retribution,6,1,5
Хам,razuvious,96,paladin,retribution,6,1,5
Týrone,blackrock,96,paladin,retribution,6,1,5
Hølyshøckz,blackmoore,96,paladin,retribution,6,1,5
Жмышенко,gordunni,96,paladin,retribution,6,1,5
Wiiso,grim-batol,96,paladin,retribution,6,1,5
Battlelord,terokkar,96,paladin,retribution,6,1,5
Ellisdee,kazzak,96,paladin,retribution,6,1,5
Equalizer,kilrogg,96,paladin,retribution,6,1,5
Brechtje,nagrand,96,paladin,retribution,6,1,5
Istani,twisting-nether,96,paladin,retribution,6,1,5
Édèn,les-sentinelles,96,paladin,retribution,6,1,5
Aggressìon,twisting-nether,96,paladin,retribution,6,1,5
Kambood,twisting-nether,96,paladin,retribution,6,1,5
Jûliâ,archimonde,96,paladin,retribution,6,1,5
Cherenpetur,neptulon,96,paladin,retribution,6,1,5
Zlätän,outland,96,paladin,retribution,6,1,5
Ogpullava,sylvanas,96,paladin,retribution,6,1,5
Tozzey,defias-brotherhood,96,paladin,retribution,6,1,5
Bôomayé,archimonde,96,paladin,retribution,6,1,5
Unkxd,outland,96,paladin,retribution,6,1,5
Xrilled,stormreaver,96,paladin,retribution,6,1,5
Bigorbøøbs,archimonde,96,paladin,retribution,6,1,5
Vindorus,archimonde,96,paladin,retribution,6,1,5
Zanszul,blackmoore,96,paladin,retribution,6,1,5
Liqudic,bloodscalp,96,paladin,retribution,6,1,5
Zala,culte-de-la-rive-noire,96,paladin,retribution,6,1,5
Thaderyl,auchindoun,96,paladin,retribution,6,1,5
Elisun,twisting-nether,96,paladin,retribution,6,1,5
Healsgoodman,twisting-nether,96,paladin,retribution,6,1,5
Humbatäterä,blackmoore,96,paladin,retribution,6,1,5
Ragie,twisting-nether,96,paladin,retribution,6,1,5
Paladzor,twisting-nether,96,paladin,retribution,6,1,5
Яшкино,soulflayer,96,paladin,retribution,6,1,5
Aluzza,sylvanas,96,paladin,retribution,6,1,5
Sínístre,hyjal,96,paladin,retribution,6,1,5
Хилтонепта,gordunni,96,paladin,retribution,6,1,5
Блейзр,ashenvale,96,paladin,retribution,6,1,5
Choppychop,defias-brotherhood,96,paladin,retribution,6,1,5
Skarium,hyjal,96,paladin,retribution,6,1,5
Fraubest,antonidas,96,paladin,retribution,6,1,5
Rekkt,ravenholdt,96,paladin,retribution,6,1,5
Монспьет,borean-tundra,96,paladin,retribution,6,1,5
Taraniah,argent-dawn,96,paladin,retribution,6,1,5
Jezrien,khazgoroth,96,paladin,retribution,6,1,5
Синодушка,howling-fjord,96,paladin,retribution,6,1,5
Reivah,silvermoon,96,paladin,retribution,6,1,5
Kurå,sargeras,96,paladin,retribution,6,1,5
Monmo,emerald-dream,96,paladin,retribution,6,1,5
Sâfcon,eredar,96,paladin,retribution,7,1,6
Borons,silvermoon,96,paladin,retribution,9,1,8
Xvoodoo,antonidas,96,paladin,retribution,11,1,10
Nauy,korgall,96,paladin,retribution,12,1,11
Kavíár,kazzak,96,paladin,retribution,12,1,11
Akinret,twisting-nether,96,paladin,retribution,12,1,11
Wârlørd,sylvanas,96,paladin,retribution,12,1,11
Jaexpaladin,draenor,96,paladin,retribution,12,1,11
Lokinder,pozzo-delleternità,96,paladin,retribution,12,1,11
Purgator,sanguino,96,paladin,retribution,12,1,11
Dawner,defias-brotherhood,96,paladin,retribution,12,1,11
Ляпкин,fordragon,96,paladin,retribution,12,1,11
Vali,burning-blade,96,paladin,retribution,12,1,11
Jayce,durotan,96,paladin,retribution,12,1,11
Zerosixsix,silvermoon,96,paladin,retribution,12,1,11
Kaelorian,silvermoon,96,paladin,retribution,12,1,11
Anemonaa,argent-dawn,96,paladin,retribution,12,1,11
Malvado,blackhand,96,paladin,retribution,12,1,11
Lylu,aggramar,96,paladin,retribution,12,1,11
Dondadajr,ysondre,96,paladin,retribution,12,1,11
Sèrgàs,blackhand,96,paladin,retribution,12,1,11
Brengier,dun-morogh,96,paladin,retribution,18,1,17
Charlybrown,archimonde,95,paladin,retribution,6,1,5
Mittyswag,kazzak,84,paladin,retribution,15,4,11
Albertina,silvermoon,79,paladin,retribution,5,1,4
Rhauk,dun-modr,79,paladin,retribution,5,1,4
Snobypala,onyxia,64,paladin,retribution,4,1,3
Pastaflwras,twisting-nether,64,paladin,retribution,4,1,3
Чиленикс,soulflayer,63,paladin,retribution,2,2,0
Reliikt,blackrock,48,paladin,retribution,3,1,2
Варкуш,soulflayer,48,paladin,retribution,3,1,2
Lafrogge,culte-de-la-rive-noire,48,paladin,retribution,3,1,2
Leköngen,ravencrest,48,paladin,retribution,3,1,2
Doruk,stormscale,48,paladin,retribution,9,1,8
Bálerion,bronze-dragonflight,42,paladin,retribution,11,3,8
Блейзблю,howling-fjord,42,paladin,retribution,8,2,6
Böserbube,tarren-mill,42,paladin,retribution,13,2,11
Alïstia,archimonde,42,paladin,retribution,16,2,14
Melkmy,laughing-skull,31,paladin,retribution,2,1,1
Hajzlbaba,outland,31,paladin,retribution,2,1,1
Tosuro,sunstrider,31,paladin,retribution,2,1,1
Davidas,drakthul,16,paladin,retribution,1,1,0
Exødius,sinstralis,16,paladin,retribution,1,1,0
Паланр,fordragon,16,paladin,retribution,1,1,0
Bjoorrn,hyjal,16,paladin,retribution,1,1,0
Ornsein,sylvanas,16,paladin,retribution,1,1,0
Arbuzno,draenor,1955,paladin,protection,72,53,19
Leotheron,boulderfist,1758,paladin,protection,233,153,80
Âmba,blackrock,1751,paladin,protection,69,45,24
Sterben,aegwynn,1750,paladin,protection,72,35,37
Sartshield,aerie-peak,1734,paladin,protection,54,34,20
Гниленький,razuvious,1712,paladin,protection,29,20,9
Arkhàn,ravencrest,1694,paladin,protection,47,32,15
Justífiéd,kazzak,1683,paladin,protection,42,20,22
Statscowski,thrall,1678,paladin,protection,37,22,15
Maximumtaste,ravencrest,1662,paladin,protection,30,22,8
Collinnawin,aegwynn,1661,paladin,protection,255,124,131
Tippressure,ravencrest,1630,paladin,protection,40,26,14
Sonnywalkman,twisting-nether,1620,paladin,protection,18,17,1
Timbadin,frostwolf,1608,paladin,protection,47,32,15
Elitest,hyjal,1560,paladin,protection,195,75,120
Schrikii,archimonde,1556,paladin,protection,72,44,28
Bariy,auchindoun,1550,paladin,protection,53,34,19
Phlakorn,blackhand,1525,paladin,protection,48,29,19
Mocnyreka,silvermoon,1503,paladin,protection,65,37,28
Силугор,soulflayer,1498,paladin,protection,48,26,22
Gabubex,tarren-mill,1482,paladin,protection,135,83,52
Supremerage,silvermoon,1474,paladin,protection,80,42,38
Баибар,soulflayer,1460,paladin,protection,120,65,55
Haringoth,argent-dawn,1459,paladin,protection,66,35,31
Uswieconyra,silvermoon,1459,paladin,protection,71,34,37
Ðivine,stormscale,1447,paladin,protection,113,57,56
Vivalabeef,stormscale,1431,paladin,protection,24,15,9
Ðizzmo,bloodfeather,1421,paladin,protection,46,23,23
Galevar,argent-dawn,1416,paladin,protection,134,65,69
Swiatlomiecz,silvermoon,1378,paladin,protection,48,18,30
Youness,ysondre,1371,paladin,protection,162,92,70
Medium,frostwolf,1362,paladin,protection,29,15,14
Хэбит,soulflayer,1343,paladin,protection,42,27,15
Lóu,hyjal,1340,paladin,protection,92,45,47
Vangorn,burning-legion,1334,paladin,protection,58,29,29
Shybia,kirin-tor,1327,paladin,protection,35,19,16
Galadrion,dun-modr,1321,paladin,protection,23,14,9
Helladin,haomarush,1321,paladin,protection,60,24,36
Velkar,frostmane,1310,paladin,protection,124,63,61
Zerhakz,ysondre,1310,paladin,protection,84,41,43
Бранв,gordunni,1305,paladin,protection,54,30,24
Jûstice,kirin-tor,1298,paladin,protection,134,63,71
Gaffel,dethecus,1288,paladin,protection,41,19,22
Leadfoot,argent-dawn,1286,paladin,protection,51,32,19
Trufetteuh,hyjal,1283,paladin,protection,178,90,88
Yunalêsca,mugthol,1283,paladin,protection,131,59,72
Krispce,bloodhoof,1281,paladin,protection,30,17,13
Manupierre,ysondre,1270,paladin,protection,48,22,26
Ragonas,mannoroth,1255,paladin,protection,36,15,21
Milliemaître,elune,1253,paladin,protection,90,41,49
Faranume,sylvanas,1227,paladin,protection,24,16,8
Augroni,antonidas,1227,paladin,protection,117,50,67
Flakkson,stormscale,1206,paladin,protection,131,49,82
Valeriu,stormreaver,1205,paladin,protection,36,14,22
Sutbeyaz,twisting-nether,1201,paladin,protection,20,14,6
Xrules,blackhand,1201,paladin,protection,47,21,26
Ichbin,sanguino,1194,paladin,protection,213,89,124
Celyne,kirin-tor,1180,paladin,protection,36,14,22
Проц,soulflayer,1179,paladin,protection,54,20,34
Neopronouns,minahonda,1144,paladin,protection,18,12,6
Oldsqlmofu,blackrock,1142,paladin,protection,19,12,7
Whiteraven,rexxar,1126,paladin,protection,24,12,12
Rudra,kiljaeden,1086,paladin,protection,29,12,17
Yruqrem,ravencrest,1055,paladin,protection,18,11,7
Шмыгапал,eversong,1049,paladin,protection,26,11,15
Vladium,argent-dawn,1046,paladin,protection,24,11,13
Lotheriem,argent-dawn,992,paladin,protection,42,11,31
Толинель,soulflayer,990,paladin,protection,17,11,6
Savión,silvermoon,957,paladin,protection,12,10,2
Maeltesar,kult-der-verdammten,955,paladin,protection,13,10,3
Dolff,argent-dawn,767,paladin,protection,12,8,4
Thraliss,hyjal,767,paladin,protection,12,8,4
Fumbz,alakir,767,paladin,protection,12,8,4
Tíríón,nethersturm,763,paladin,protection,18,8,10
Lägolas,thrall,701,paladin,protection,17,8,9
Mørfi,antonidas,687,paladin,protection,11,8,3
Kraljevic,silvermoon,672,paladin,protection,12,7,5
Ванябублгам,soulflayer,672,paladin,protection,18,7,11
Figustyle,archimonde,605,paladin,protection,16,7,9
Emistesia,stormscale,576,paladin,protection,6,6,0
Marihuána,ragnaros,576,paladin,protection,18,6,12
Casstiel,anetheron,575,paladin,protection,12,6,6
Ekenpala,kazzak,575,paladin,protection,12,6,6
Exion,ravenholdt,543,paladin,protection,11,6,5
Furiosio,ysondre,543,paladin,protection,15,7,8
Arkera,blackrock,494,paladin,protection,19,6,13
Кельдерик,howling-fjord,480,paladin,protection,6,5,1
Onefrostyboi,defias-brotherhood,479,paladin,protection,12,5,7
Thrinea,blackrock,479,paladin,protection,12,5,7
Такуан,fordragon,479,paladin,protection,12,5,7
Xairios,blackhand,479,paladin,protection,12,5,7
Quantox,frostwolf,478,paladin,protection,24,5,19
Aarrb,sylvanas,438,paladin,protection,27,8,19
Elkka,azjolnerub,415,paladin,protection,17,5,12
Eriellè,kazzak,384,paladin,protection,6,4,2
Æåæxâëæ,dun-modr,384,paladin,protection,6,4,2
Fleshoflight,arathor,384,paladin,protection,6,4,2
Testos,ulduar,384,paladin,protection,6,4,2
Røse,argent-dawn,384,paladin,protection,12,4,8
Palan,cthun,384,paladin,protection,12,4,8
Снайпик,azuregos,384,paladin,protection,12,4,8
Astragore,archimonde,384,paladin,protection,18,4,14
Valädar,sanguino,351,paladin,protection,11,4,7
Дюве,blackscar,351,paladin,protection,11,4,7
Butchertom,ravencrest,330,paladin,protection,11,5,6
Babaluga,blackrock,288,paladin,protection,6,3,3
Рустиктоп,gordunni,288,paladin,protection,6,3,3
Craft,frostwolf,288,paladin,protection,6,3,3
Æero,blackhand,288,paladin,protection,6,3,3
Swäagg,hyjal,288,paladin,protection,6,3,3
Zuplex,deathwing,288,paladin,protection,6,3,3
Aümagad,confrérie-du-thorium,288,paladin,protection,6,3,3
Ponce,los-errantes,288,paladin,protection,12,3,9
Duxbellorum,the-maelstrom,288,paladin,protection,12,3,9
Biffle,korgall,288,paladin,protection,12,3,9
Kawakai,blackrock,287,paladin,protection,12,3,9
Meneth,elune,240,paladin,protection,9,3,6
Yourmomz,kazzak,239,paladin,protection,5,3,2
Emakk,darksorrow,192,paladin,protection,6,2,4
Gornim,die-nachtwache,192,paladin,protection,6,2,4
Slainer,zuljin,192,paladin,protection,6,2,4
Derina,silvermoon,192,paladin,protection,6,2,4
Синерина,blackscar,192,paladin,protection,6,2,4
Khrak,conseil-des-ombres,192,paladin,protection,12,2,10
Palacaplaca,cthun,175,paladin,protection,11,2,9
Soxsnort,twisting-nether,159,paladin,protection,5,2,3
Taptreus,antonidas,96,paladin,protection,6,1,5
Чиксапомойка,gordunni,96,paladin,protection,6,1,5
Thôrwald,les-sentinelles,96,paladin,protection,12,1,11
Lokinder,pozzo-delleternità,96,paladin,protection,12,1,11
Bobilous,twisting-nether,79,paladin,protection,5,1,4
Солошафл,howling-fjord,42,paladin,protection,12,4,8
Candrä,archimonde,2213,priest,holy,96,52,44
Køzukï,ravencrest,2167,priest,holy,275,144,131
Itsmeminglee,ravencrest,2143,priest,holy,132,68,64
Lmnsqzy,ravencrest,2050,priest,holy,124,65,59
Yötönyö,ravencrest,2043,priest,holy,60,32,28
Leadeur,kazzak,2039,priest,holy,247,124,123
Кальвейт,deathweaver,2020,priest,holy,181,92,89
Ladá,stormscale,1993,priest,holy,180,96,84
Cosines,ravencrest,1970,priest,holy,113,61,52
Výra,der-rat-von-dalaran,1939,priest,holy,71,46,25
Шотыказау,blackscar,1919,priest,holy,141,74,67
Tangent,ravencrest,1909,priest,holy,224,121,103
Boonlai,ravencrest,1897,priest,holy,47,25,22
Grafius,stormscale,1885,priest,holy,48,26,22
Carlitastock,eredar,1885,priest,holy,53,28,25
Tmnstrtw,alakir,1879,priest,holy,126,63,63
Testdeath,ravencrest,1875,priest,holy,54,31,23
Zuniya,tarren-mill,1868,priest,holy,60,30,30
Fleischesser,ravencrest,1862,priest,holy,62,33,29
Lenyp,sanguino,1862,priest,holy,150,75,75
Beatrixz,twisting-nether,1852,priest,holy,384,199,185
Weezing,ysondre,1851,priest,holy,132,66,66
Rippertmepls,ravencrest,1850,priest,holy,124,73,51
Servêy,twisting-nether,1845,priest,holy,42,22,20
Finizkram,sylvanas,1840,priest,holy,48,25,23
Dmnz,blackrock,1836,priest,holy,87,39,48
Kaiikoo,ravencrest,1824,priest,holy,54,31,23
Yateh,blackmoore,1824,priest,holy,62,32,30
Катккат,soulflayer,1823,priest,holy,48,27,21
Лоаресс,gordunni,1820,priest,holy,90,40,50
Ancientalien,khadgar,1817,priest,holy,66,29,37
Sayne,arathor,1815,priest,holy,168,91,77
Maruh,malganis,1812,priest,holy,113,60,53
Dmnz,antonidas,1811,priest,holy,40,22,18
Eriónd,ravencrest,1811,priest,holy,66,34,32
Muchos,blackrock,1811,priest,holy,132,61,71
Kaalu,frostmane,1809,priest,holy,254,131,123
Мамкалол,soulflayer,1807,priest,holy,132,69,63
Lîrana,ravencrest,1803,priest,holy,136,82,54
Teatime,aegwynn,1800,priest,holy,84,42,42
Kunen,sanguino,1789,priest,holy,138,77,61
Psi,hakkar,1789,priest,holy,301,165,136
Друмги,gordunni,1787,priest,holy,173,80,93
Yhoundey,blackrock,1780,priest,holy,54,27,27
Imbitterx,stormscale,1777,priest,holy,30,21,9
Stanyú,tarren-mill,1770,priest,holy,48,21,27
Bigwik,tarren-mill,1764,priest,holy,77,36,41
Servey,twisting-nether,1764,priest,holy,48,20,28
Basilette,hyjal,1761,priest,holy,48,27,21
Holyholy,stormscale,1761,priest,holy,62,24,38
Weezïng,ysondre,1742,priest,holy,108,60,48
Siign,ravencrest,1740,priest,holy,72,32,40
Harmónia,outland,1739,priest,holy,187,99,88
Møhammed,wrathbringer,1734,priest,holy,341,171,170
Calithria,kazzak,1731,priest,holy,196,107,89
Sàweetie,archimonde,1721,priest,holy,54,27,27
Myste,nemesis,1715,priest,holy,91,48,43
Peisetti,stormscale,1712,priest,holy,48,24,24
Wåtrux,alakir,1711,priest,holy,411,218,193
Jim,saurfang,1711,priest,holy,257,127,130
Anníng,tarren-mill,1708,priest,holy,186,108,78
Thelunara,sanguino,1703,priest,holy,77,37,40
Pigdestroyin,frostmane,1701,priest,holy,66,38,28
Dolens,argent-dawn,1699,priest,holy,112,55,57
Sisko,stormscale,1699,priest,holy,66,32,34
Jâde,bloodhoof,1690,priest,holy,132,75,57
Shizzlol,silvermoon,1684,priest,holy,366,177,189
Meanbabe,argent-dawn,1683,priest,holy,48,22,26
Ilenna,dun-morogh,1682,priest,holy,78,46,32
Phobò,blackrock,1678,priest,holy,89,42,47
Gladíator,blackhand,1677,priest,holy,102,58,44
Гоплзнекст,gordunni,1676,priest,holy,372,187,185
Gokumødex,outland,1676,priest,holy,54,24,30
Каткааткат,soulflayer,1674,priest,holy,48,23,25
Alpháømegá,outland,1671,priest,holy,99,51,48
Kÿokó,ravencrest,1670,priest,holy,72,40,32
Limeslayerx,veklor,1668,priest,holy,48,35,13
Stickpas,ysondre,1661,priest,holy,41,18,23
Fízwow,stormscale,1659,priest,holy,88,38,50
Jiffie,twisting-nether,1655,priest,holy,54,23,31
Oide,area-52,1653,priest,holy,54,28,26
Simpadisco,ravencrest,1649,priest,holy,48,24,24
Câlyr,ragnaros,1647,priest,holy,48,21,27
Sausageboy,tarren-mill,1640,priest,holy,123,54,69
Dogshtpriest,ravencrest,1639,priest,holy,68,39,29
Gøkumodex,tarren-mill,1639,priest,holy,46,22,24
Løøney,kazzak,1638,priest,holy,48,30,18
Xianxia,twisting-nether,1636,priest,holy,154,77,77
Эльдиремонт,gordunni,1631,priest,holy,124,56,68
Инзора,gordunni,1624,priest,holy,135,74,61
Budgetdp,archimonde,1622,priest,holy,90,39,51
Dranbor,argent-dawn,1619,priest,holy,166,87,79
Malaki,ysondre,1618,priest,holy,62,34,28
Ksn,silvermoon,1618,priest,holy,110,58,52
Gnomemonk,stormscale,1618,priest,holy,150,74,76
Eleutheria,grim-batol,1618,priest,holy,57,27,30
Adare,sanguino,1618,priest,holy,48,22,26
Xxmybaxxo,archimonde,1617,priest,holy,30,21,9
Alchemïst,ravencrest,1617,priest,holy,46,21,25
Smïlë,ravencrest,1616,priest,holy,204,102,102
Coolwnbnamex,ravencrest,1614,priest,holy,36,19,17
Affro,drakthul,1613,priest,holy,54,27,27
Shanya,thrall,1613,priest,holy,257,127,130
Sïxsïxsïx,ravencrest,1613,priest,holy,43,21,22
Нубстрим,gordunni,1611,priest,holy,60,28,32
Bzzdontplay,ravencrest,1610,priest,holy,42,20,22
Alizeé,nazjatar,1609,priest,holy,179,100,79
Ysalute,sylvanas,1608,priest,holy,33,18,15
Ghettothug,darksorrow,1608,priest,holy,66,28,38
Salvatíon,sanguino,1607,priest,holy,106,46,60
Prëdz,stormscale,1606,priest,holy,238,129,109
Anabananaa,ravencrest,1604,priest,holy,88,50,38
Найтингеилл,gordunni,1604,priest,holy,36,17,19
Eox,kazzak,1602,priest,holy,42,23,19
Joeasaurs,ragnaros,1602,priest,holy,106,51,55
Zxø,ravencrest,1601,priest,holy,160,88,72
Camina,shattered-hand,1601,priest,holy,135,74,61
Cleoana,blackhand,1600,priest,holy,42,23,19
Çhéåtçødé,ravencrest,1594,priest,holy,72,33,39
Anaqt,silvermoon,1593,priest,holy,101,56,45
Aykò,blackmoore,1588,priest,holy,90,42,48
Dairox,blackrock,1584,priest,holy,143,77,66
Hiimgreen,blackhand,1580,priest,holy,126,62,64
Dìsclol,draenor,1576,priest,holy,75,40,35
Goytka,tarren-mill,1576,priest,holy,66,31,35
Преттисмайл,gordunni,1576,priest,holy,193,89,104
Dény,ravencrest,1573,priest,holy,102,56,46
Icybae,archimonde,1572,priest,holy,48,34,14
Xzklol,twisting-nether,1572,priest,holy,62,31,31
Cølï,ravencrest,1572,priest,holy,55,25,30
Highn,anetheron,1570,priest,holy,60,33,27
Gratcrug,stormrage,1570,priest,holy,48,26,22
Goofdookie,outland,1563,priest,holy,36,20,16
Overdosedtw,die-aldor,1561,priest,holy,36,24,12
Xïâ,hyjal,1561,priest,holy,42,19,23
Nastylex,magtheridon,1559,priest,holy,36,21,15
Elmaestrø,aegwynn,1558,priest,holy,48,25,23
Phobò,antonidas,1545,priest,holy,170,79,91
Senkín,aegwynn,1542,priest,holy,161,78,83
Isadriel,madmortem,1541,priest,holy,52,31,21
Èlysium,grim-batol,1540,priest,holy,48,28,20
Evabae,the-maelstrom,1537,priest,holy,54,29,25
Hyonra,kazzak,1536,priest,holy,66,34,32
Vregoa,twisting-nether,1532,priest,holy,36,17,19
Aethanira,ravencrest,1532,priest,holy,60,27,33
Seeyae,archimonde,1528,priest,holy,36,17,19
Xzklolz,twisting-nether,1527,priest,holy,59,28,31
Kubbarn,stormscale,1526,priest,holy,208,116,92
Koíré,defias-brotherhood,1523,priest,holy,321,166,155
Zellita,ravencrest,1522,priest,holy,60,26,34
Sehlia,kazzak,1520,priest,holy,211,108,103
Divinetouch,ravencrest,1516,priest,holy,78,35,43
Кодис,gordunni,1515,priest,holy,18,16,2
Dokkaebì,kazzak,1514,priest,holy,135,67,68
Mylini,silvermoon,1510,priest,holy,204,116,88
Eddíémorphin,kazzak,1509,priest,holy,30,16,14
Cartøøns,ravencrest,1506,priest,holy,66,39,27
Thalane,das-konsortium,1504,priest,holy,48,23,25
Wilby,archimonde,1503,priest,holy,48,21,27
Kotipope,silvermoon,1502,priest,holy,74,38,36
Voodoo,the-maelstrom,1502,priest,holy,108,46,62
Fjonnski,blackmoore,1500,priest,holy,61,33,28
Usw,outland,1496,priest,holy,69,23,46
Заволончик,blackscar,1494,priest,holy,102,48,54
Malkàv,hyjal,1493,priest,holy,54,28,26
Краббожий,greymane,1493,priest,holy,53,22,31
Draster,blackrock,1490,priest,holy,53,28,25
Rines,thrall,1488,priest,holy,183,92,91
Stinkydog,kazzak,1481,priest,holy,328,162,166
Justheal,stormscale,1481,priest,holy,54,23,31
Gigotdagneau,dalaran,1479,priest,holy,41,16,25
Karpiest,stormscale,1476,priest,holy,113,61,52
Zlejkadlec,drakthul,1476,priest,holy,93,47,46
Эилинг,gordunni,1474,priest,holy,192,105,87
Sïlvëräzz,drekthar,1472,priest,holy,53,25,28
Xnda,ravencrest,1472,priest,holy,36,16,20
Maah,defias-brotherhood,1471,priest,holy,80,46,34
Fatherliam,emerald-dream,1469,priest,holy,54,24,30
Symbolofhope,ravencrest,1465,priest,holy,201,105,96
Sixtyseven,blackhand,1464,priest,holy,78,39,39
Ilkar,archimonde,1461,priest,holy,60,29,31
Isilros,dalaran,1460,priest,holy,46,25,21
Liquoriced,tarren-mill,1460,priest,holy,43,23,20
Suxino,stormscale,1455,priest,holy,185,94,91
Пингзеро,soulflayer,1454,priest,holy,190,95,95
Mcdeady,tarren-mill,1454,priest,holy,42,19,23
Snåttabaias,stormscale,1451,priest,holy,35,19,16
Bubbleup,defias-brotherhood,1449,priest,holy,125,70,55
Mezegis,draenor,1449,priest,holy,48,26,22
Angrk,kazzak,1441,priest,holy,84,51,33
Jaisuu,ravencrest,1439,priest,holy,30,15,15
Sqwabblepee,stormscale,1438,priest,holy,53,27,26
Lylska,stormreaver,1437,priest,holy,36,15,21
Slakkieslak,archimonde,1435,priest,holy,67,39,28
Momopriesto,draenor,1435,priest,holy,47,20,27
Иссатея,galakrond,1434,priest,holy,48,23,25
Maerlene,nemesis,1433,priest,holy,54,31,23
Hyonzy,silvermoon,1433,priest,holy,159,84,75
Hoeneygodx,antonidas,1432,priest,holy,36,16,20
Tavra,stormscale,1428,priest,holy,48,20,28
Jinxa,draenor,1428,priest,holy,42,15,27
Ptiteminette,archimonde,1426,priest,holy,32,17,15
Fizzlesp,tarren-mill,1425,priest,holy,30,15,15
Alphacub,ragnaros,1425,priest,holy,82,36,46
Алеброн,gordunni,1421,priest,holy,36,19,17
Caihla,silvermoon,1421,priest,holy,30,15,15
Fabs,laughing-skull,1419,priest,holy,61,39,22
Lómesilme,dun-modr,1419,priest,holy,217,112,105
Bilbobanging,aggramar,1419,priest,holy,30,15,15
Kbakå,kazzak,1419,priest,holy,78,37,41
Pleistex,sylvanas,1418,priest,holy,30,16,14
Lädi,ravencrest,1416,priest,holy,96,53,43
Virginmaris,sanguino,1415,priest,holy,113,64,49
Penvon,ravencrest,1415,priest,holy,66,22,44
Markianos,silvermoon,1412,priest,holy,114,58,56
Ankî,aegwynn,1411,priest,holy,30,15,15
Hmanco,burning-legion,1408,priest,holy,263,140,123
Мектран,gordunni,1408,priest,holy,54,27,27
Hara,elune,1407,priest,holy,47,20,27
Bifs,blackmoore,1405,priest,holy,50,32,18
Scartay,outland,1405,priest,holy,29,15,14
Blacklemons,thrall,1403,priest,holy,48,26,22
Scrxppe,twisting-nether,1402,priest,holy,42,26,16
Вакидзачи,gordunni,1402,priest,holy,209,105,104
Swd,burning-blade,1400,priest,holy,34,15,19
Neoark,archimonde,1397,priest,holy,164,83,81
Certe,twisting-nether,1396,priest,holy,133,66,67
Elessee,the-maelstrom,1395,priest,holy,83,38,45
Rägà,archimonde,1388,priest,holy,85,46,39
Womanwonderf,ravencrest,1388,priest,holy,65,31,34
Penitence,drekthar,1385,priest,holy,44,18,26
Cøvu,draenor,1378,priest,holy,94,41,53
Insaner,ahnqiraj,1374,priest,holy,45,19,26
Seladine,ravencrest,1373,priest,holy,152,77,75
Veurjin,uldaman,1373,priest,holy,53,25,28
Madcole,blackhand,1371,priest,holy,85,43,42
Mianxpriest,tarren-mill,1370,priest,holy,36,17,19
Konstigadan,twisting-nether,1369,priest,holy,56,26,30
Góldfinger,norgannon,1365,priest,holy,181,85,96
Phénylanine,khaz-modan,1364,priest,holy,278,141,137
Nomakprst,sanguino,1362,priest,holy,60,31,29
Xytael,burning-legion,1360,priest,holy,96,49,47
Elunos,blackrock,1358,priest,holy,130,65,65
Tëmärï,ravencrest,1356,priest,holy,72,46,26
Возхд,soulflayer,1356,priest,holy,48,27,21
Zorea,twisting-nether,1356,priest,holy,153,76,77
Davìna,sunstrider,1354,priest,holy,73,36,37
Ebolaidman,ravencrest,1353,priest,holy,24,15,9
Tyene,voljin,1351,priest,holy,107,59,48
Owait,tarren-mill,1351,priest,holy,36,17,19
Judâspriest,twisting-nether,1351,priest,holy,72,33,39
Delphina,archimonde,1350,priest,holy,225,118,107
Juco,draenor,1348,priest,holy,54,24,30
Pridepriest,twisting-nether,1346,priest,holy,84,42,42
Prencø,sanguino,1345,priest,holy,34,16,18
Bierbändiger,blackhand,1345,priest,holy,120,56,64
Chibrausorus,archimonde,1344,priest,holy,118,61,57
Blazekk,sylvanas,1343,priest,holy,54,19,35
Moirgana,minahonda,1340,priest,holy,43,21,22
Skíps,sylvanas,1339,priest,holy,34,18,16
Daftî,twisting-nether,1339,priest,holy,36,18,18
Hydraximus,garrosh,1337,priest,holy,648,320,328
Nálá,nethersturm,1335,priest,holy,115,59,56
Nino,gorgonnash,1335,priest,holy,66,30,36
Tyrhaa,blackmoore,1334,priest,holy,163,81,82
Ангеланика,gordunni,1330,priest,holy,29,18,11
Fedorah,ragnaros,1330,priest,holy,114,63,51
Orcid,chogall,1327,priest,holy,146,75,71
Alú,draenor,1327,priest,holy,153,73,80
Luxtrii,blackrock,1326,priest,holy,48,20,28
Рилия,howling-fjord,1324,priest,holy,30,14,16
Libetha,ysondre,1323,priest,holy,41,23,18
Migam,kazzak,1321,priest,holy,66,30,36
Велост,gordunni,1319,priest,holy,60,31,29
Jaz,ysondre,1319,priest,holy,58,29,29
Bobitä,ravencrest,1318,priest,holy,30,15,15
Byzzi,draenor,1318,priest,holy,215,107,108
Hereticroka,ysondre,1318,priest,holy,80,35,45
Alros,elune,1315,priest,holy,60,28,32
Lasuora,nemesis,1315,priest,holy,60,26,34
Aïmée,ravencrest,1313,priest,holy,55,26,29
Cherron,argent-dawn,1305,priest,holy,61,27,34
Lupinx,terokkar,1304,priest,holy,24,14,10
Stàrlîght,chants-éternels,1300,priest,holy,30,17,13
Eazzyy,kazzak,1299,priest,holy,51,25,26
Eurydike,blackrock,1297,priest,holy,64,37,27
Åluneth,kazzak,1297,priest,holy,162,80,82
Emipriest,tarren-mill,1297,priest,holy,133,63,70
Маракеда,soulflayer,1295,priest,holy,41,18,23
Pasqualz,ravencrest,1290,priest,holy,83,39,44
Lazheal,khaz-modan,1288,priest,holy,78,44,34
Hølýðéåthjçç,tarren-mill,1285,priest,holy,41,21,20
Mashimaro,blackhand,1285,priest,holy,41,21,20
Sodatsu,cthun,1284,priest,holy,30,15,15
Midycine,ysondre,1282,priest,holy,199,98,101
Papadrak,kazzak,1278,priest,holy,83,43,40
Síuu,kazzak,1277,priest,holy,72,35,37
Tomassur,drakthul,1276,priest,holy,103,52,51
Draconux,terenas,1273,priest,holy,54,21,33
Wintercurse,twisting-nether,1272,priest,holy,52,24,28
Djdesha,tarren-mill,1272,priest,holy,35,16,19
Zakhun,stormrage,1271,priest,holy,82,42,40
Asare,outland,1269,priest,holy,124,66,58
Ezechiel,twisting-nether,1267,priest,holy,53,28,25
Ethery,argent-dawn,1266,priest,holy,65,33,32
Lykarion,argent-dawn,1265,priest,holy,72,37,35
Elynä,silvermoon,1261,priest,holy,70,44,26
Tudiiheals,frostwolf,1261,priest,holy,91,48,43
Vickepriest,stormreaver,1260,priest,holy,48,23,25
Dôppler,archimonde,1256,priest,holy,23,14,9
Yuhé,elune,1256,priest,holy,26,14,12
Nosgot,earthen-ring,1251,priest,holy,66,32,34
Sohryø,drekthar,1249,priest,holy,48,28,20
Soapie,defias-brotherhood,1249,priest,holy,24,14,10
Zên,argent-dawn,1248,priest,holy,21,14,7
Ayess,aegwynn,1248,priest,holy,47,24,23
Avelynn,ravencrest,1248,priest,holy,85,38,47
Misscure,draenor,1247,priest,holy,130,59,71
Maybelline,ravencrest,1245,priest,holy,48,23,25
Catstretch,ravencrest,1243,priest,holy,95,39,56
Boomixed,twisting-nether,1242,priest,holy,24,13,11
Shanny,kazzak,1239,priest,holy,24,13,11
Badguymike,ragnaros,1239,priest,holy,24,13,11
Бенигана,soulflayer,1239,priest,holy,48,25,23
Rozå,argent-dawn,1238,priest,holy,18,13,5
Fareeya,thrall,1235,priest,holy,30,15,15
Åzjol,magtheridon,1235,priest,holy,30,13,17
Nerfnerf,kazzak,1232,priest,holy,51,27,24
Holydolly,doomhammer,1229,priest,holy,48,27,21
Dazé,ravencrest,1219,priest,holy,72,39,33
Sapphos,ravencrest,1216,priest,holy,47,23,24
Neenä,ravencrest,1214,priest,holy,50,25,25
Dúréx,sanguino,1212,priest,holy,42,28,14
Speltmor,stormscale,1211,priest,holy,30,13,17
Atiyesh,arthas,1210,priest,holy,219,116,103
Sak,uldaman,1206,priest,holy,94,38,56
Omnissiiah,silvermoon,1203,priest,holy,30,13,17
Prästera,draenor,1202,priest,holy,24,13,11
Хилтихон,howling-fjord,1200,priest,holy,42,26,16
Dathlight,argent-dawn,1200,priest,holy,113,57,56
Скартэикс,howling-fjord,1200,priest,holy,42,20,22
Elián,silvermoon,1198,priest,holy,30,15,15
Testdeex,ravencrest,1197,priest,holy,23,13,10
Иннерон,soulflayer,1197,priest,holy,233,116,117
Kbakå,stormscale,1193,priest,holy,65,27,38
Benificent,argent-dawn,1192,priest,holy,76,38,38
Angelsdust,ravencrest,1190,priest,holy,34,14,20
Lhyria,baelgun,1189,priest,holy,48,21,27
Ripjuice,sylvanas,1186,priest,holy,84,44,40
Gummi,blackhand,1183,priest,holy,66,25,41
Холимыша,blackscar,1182,priest,holy,63,32,31
Nakali,the-maelstrom,1182,priest,holy,42,15,27
Карнотит,howling-fjord,1182,priest,holy,48,16,32
Avtarra,ravencrest,1181,priest,holy,70,34,36
Хасгерион,gordunni,1180,priest,holy,66,27,39
Крайл,blackscar,1180,priest,holy,93,27,66
Morrydin,stormreaver,1177,priest,holy,78,31,47
Nykah,antonidas,1177,priest,holy,73,26,47
Ниеса,lich-king,1174,priest,holy,110,52,58
Jarnary,blackmoore,1171,priest,holy,75,33,42
Голнар,deathguard,1168,priest,holy,32,15,17
Torcena,garrosh,1166,priest,holy,141,70,71
Meatyshaft,doomhammer,1166,priest,holy,51,19,32
Killtrew,ravencrest,1165,priest,holy,39,13,26
Gloxina,argent-dawn,1160,priest,holy,96,43,53
Nemista,hyjal,1160,priest,holy,70,26,44
Voreno,alonsus,1160,priest,holy,59,21,38
Lyla,frostwolf,1149,priest,holy,48,27,21
Willxzz,silvermoon,1149,priest,holy,30,12,18
Tansk,stormscale,1147,priest,holy,24,12,12
Kiånå,teldrassil,1142,priest,holy,125,51,74
Zrada,dalaran,1138,priest,holy,24,12,12
Morphuz,tarren-mill,1137,priest,holy,144,66,78
Асггард,borean-tundra,1134,priest,holy,39,25,14
Rastafaja,doomhammer,1133,priest,holy,83,34,49
Andreel,ravencrest,1131,priest,holy,24,12,12
Elëkträ,dalaran,1131,priest,holy,24,12,12
Ròka,ysondre,1131,priest,holy,36,12,24
Cazzîe,eredar,1129,priest,holy,18,12,6
Kímbérléy,argent-dawn,1128,priest,holy,93,49,44
Meowcakes,stormscale,1127,priest,holy,54,30,24
Nou,aegwynn,1127,priest,holy,30,12,18
Nicksiz,silvermoon,1126,priest,holy,34,13,21
Sücre,dalaran,1125,priest,holy,30,16,14
Quatorze,voljin,1124,priest,holy,34,19,15
Tákú,blackmoore,1118,priest,holy,92,45,47
Like,frostwolf,1114,priest,holy,24,12,12
Vitae,gorgonnash,1113,priest,holy,26,13,13
Mundwerk,malganis,1107,priest,holy,60,22,38
Crimatoriá,rajaxx,1105,priest,holy,66,36,30
Copperplume,ravenholdt,1104,priest,holy,132,58,74
Dotterin,draenor,1102,priest,holy,24,12,12
Anàriel,elune,1100,priest,holy,42,16,26
Balin,veklor,1096,priest,holy,27,12,15
Shaniqua,saurfang,1093,priest,holy,104,53,51
Holypowér,twisting-nether,1088,priest,holy,30,17,13
Ломаюключики,gordunni,1081,priest,holy,45,22,23
Pryna,dunemaul,1076,priest,holy,30,12,18
Deeforce,argent-dawn,1072,priest,holy,97,53,44
Larisä,uldum,1067,priest,holy,75,28,47
Xxanthos,ysondre,1058,priest,holy,169,92,77
Ludriel,turalyon,1056,priest,holy,54,26,28
Zen,talnivarr,1056,priest,holy,24,11,13
Seanoob,turalyon,1055,priest,holy,18,11,7
Миррен,gordunni,1055,priest,holy,18,11,7
Луилэнс,howling-fjord,1055,priest,holy,18,11,7
Narwarion,die-aldor,1055,priest,holy,60,28,32
Pandakhlys,ysondre,1055,priest,holy,24,11,13
Штанга,blackscar,1055,priest,holy,29,12,17
Cãlyr,ragnaros,1055,priest,holy,30,11,19
Hotforus,silvermoon,1054,priest,holy,18,11,7
Laewen,die-aldor,1054,priest,holy,45,22,23
Рейеан,soulflayer,1054,priest,holy,24,11,13
Rehnstek,wildhammer,1054,priest,holy,30,11,19
Uro,tirion,1053,priest,holy,30,11,19
Elinaa,die-aldor,1050,priest,holy,24,11,13
Тевтонка,goldrinn,1047,priest,holy,62,28,34
Ageo,sanguino,1046,priest,holy,18,11,7
Letmehêal,archimonde,1043,priest,holy,30,11,19
Harlemsfnest,blackrock,1042,priest,holy,24,13,11
Applecrumßle,ragnaros,1032,priest,holy,47,25,22
Leyea,kazzak,1029,priest,holy,49,24,25
Naieli,antonidas,1028,priest,holy,56,28,28
Nathamo,archimonde,1028,priest,holy,24,11,13
Haregnor,gorgonnash,1028,priest,holy,42,16,26
Baabaak,frostmane,1026,priest,holy,57,34,23
Kæos,blackrock,1026,priest,holy,78,32,46
Valdos,hyjal,1026,priest,holy,48,16,32
Orcü,tarren-mill,1021,priest,holy,60,27,33
Touddixz,blackrock,1020,priest,holy,32,12,20
Sickheals,doomhammer,1018,priest,holy,62,35,27
Brigied,turalyon,1018,priest,holy,99,43,56
Ankhepope,outland,1013,priest,holy,56,33,23
Lobogaust,kargath,1012,priest,holy,60,32,28
Bowie,frostwhisper,1012,priest,holy,36,11,25
Asraje,eredar,1007,priest,holy,21,16,5
Türapea,draenor,1006,priest,holy,36,17,19
Dampfwalze,nozdormu,1002,priest,holy,38,19,19
Zerula,outland,990,priest,holy,42,21,21
Covidios,twisting-nether,990,priest,holy,93,43,50
Hipnotika,nemesis,988,priest,holy,53,18,35
Valtessian,medivh,983,priest,holy,69,33,36
Siarai,pozzo-delleternità,964,priest,holy,43,21,22
Maxý,ravencrest,963,priest,holy,42,18,24
Sâtânica,kelthuzad,963,priest,holy,122,51,71
Yamai,thrall,960,priest,holy,24,10,14
Десемин,deathguard,960,priest,holy,47,18,29
Mcmuffin,runetotem,959,priest,holy,21,13,8
Dqt,ragnaros,959,priest,holy,18,10,8
Padisonpain,blackmoore,959,priest,holy,18,10,8
Ksn,argent-dawn,959,priest,holy,24,10,14
Xlhealscptn,arathor,959,priest,holy,60,19,41
Cånniekekw,tarren-mill,958,priest,holy,18,10,8
Mesticore,nethersturm,958,priest,holy,24,10,14
Lenneyqt,blackmoore,958,priest,holy,24,10,14
Bigpinkballs,tarren-mill,956,priest,holy,12,10,2
Byebee,stormscale,956,priest,holy,12,10,2
Melodyn,silvermoon,956,priest,holy,24,10,14
Rennic,stormscale,955,priest,holy,18,10,8
Melancholly,thunderhorn,951,priest,holy,41,19,22
Aureï,khaz-modan,938,priest,holy,24,10,14
Fatherted,nagrand,926,priest,holy,36,10,26
Discxqt,ysondre,924,priest,holy,14,11,3
Protegee,draenor,922,priest,holy,69,23,46
Archangel,terokkar,916,priest,holy,60,30,30
Авэнсис,howling-fjord,913,priest,holy,36,14,22
Thingsy,draenor,912,priest,holy,59,27,32
Infinitiy,sylvanas,905,priest,holy,36,18,18
Zêlestia,antonidas,905,priest,holy,22,11,11
Ламедрис,gordunni,904,priest,holy,41,10,31
Rahela,dun-modr,897,priest,holy,23,11,12
Sîanah,archimonde,886,priest,holy,28,11,17
Hegêan,argent-dawn,880,priest,holy,53,22,31
Сказочки,gordunni,864,priest,holy,18,9,9
Rhæveth,ravencrest,864,priest,holy,18,9,9
Âlolexx,archimonde,863,priest,holy,12,9,3
Wèèzing,ysondre,863,priest,holy,12,9,3
Azeeza,stormscale,863,priest,holy,12,9,3
Fomstable,outland,862,priest,holy,12,9,3
Kalkudis,blackmoore,862,priest,holy,18,9,9
Swdjack,blackrock,862,priest,holy,24,9,15
Pprxd,ysondre,862,priest,holy,24,9,15
Faelvirin,aegwynn,861,priest,holy,18,9,9
Hodza,frostmane,861,priest,holy,41,19,22
Kaleycuoco,blackhand,860,priest,holy,18,9,9
Hwren,auchindoun,860,priest,holy,18,9,9
Marey,blackmoore,860,priest,holy,24,9,15
Athissa,draenor,857,priest,holy,18,9,9
Ayahuascarli,ravencrest,847,priest,holy,17,9,8
Xal,drekthar,839,priest,holy,76,27,49
Beatla,khaz-modan,833,priest,holy,24,9,15
Kanki,haomarush,828,priest,holy,60,25,35
Eglantinna,ravencrest,809,priest,holy,14,10,4
Gertie,blackhand,807,priest,holy,28,9,19
Nokizzle,antonidas,795,priest,holy,14,9,5
Zongiz,azjolnerub,786,priest,holy,22,9,13
Methmakka,kazzak,778,priest,holy,19,10,9
Vyrá,der-rat-von-dalaran,768,priest,holy,12,8,4
Evílz,tarren-mill,768,priest,holy,12,8,4
Flyffi,tarren-mill,768,priest,holy,12,8,4
Dès,ravencrest,768,priest,holy,12,8,4
Dotzey,outland,768,priest,holy,12,8,4
Ltmp,ravencrest,768,priest,holy,18,8,10
Suili,twisting-nether,768,priest,holy,18,8,10
Heilop,kazzak,768,priest,holy,23,8,15
Ÿolo,nemesis,768,priest,holy,24,8,16
Маквиэлла,howling-fjord,767,priest,holy,12,8,4
Drunkshufler,stormscale,767,priest,holy,12,8,4
Weedony,hyjal,766,priest,holy,18,8,10
Knóld,draenor,766,priest,holy,24,8,16
Krilight,sargeras,765,priest,holy,24,8,16
Ахмох,gordunni,763,priest,holy,18,8,10
Melissasky,ragnaros,760,priest,holy,60,22,38
Båbak,frostmane,759,priest,holy,12,8,4
Fratio,krasus,758,priest,holy,18,8,10
Avinci,blackrock,757,priest,holy,18,8,10
Nakkenils,tarren-mill,751,priest,holy,17,8,9
Besmrtna,saurfang,749,priest,holy,23,8,15
Eternitiy,auchindoun,744,priest,holy,18,8,10
Blaulienchen,proudmoore,737,priest,holy,30,9,21
Englishheart,auchindoun,734,priest,holy,17,8,9
Adenisia,hyjal,733,priest,holy,19,9,10
Valentinus,dragonmaw,702,priest,holy,26,8,18
Mélínâ,blackmoore,691,priest,holy,28,9,19
Willzah,outland,672,priest,holy,12,7,5
Iiamx,antonidas,672,priest,holy,12,7,5
Dødy,hyjal,672,priest,holy,12,7,5
Jedimind,kazzak,672,priest,holy,12,7,5
Ladderpolice,blackmoore,672,priest,holy,12,7,5
Ainadaxz,ravencrest,672,priest,holy,12,7,5
Ðoxy,frostmane,672,priest,holy,12,7,5
Darkoul,conseil-des-ombres,672,priest,holy,12,7,5
Гшд,gordunni,672,priest,holy,12,7,5
Geilerheiler,dalvengyr,672,priest,holy,12,7,5
Ticklypriest,outland,672,priest,holy,18,7,11
Naïcos,dun-modr,672,priest,holy,18,7,11
Sehrhübsch,malygos,672,priest,holy,18,7,11
Valinoru,silvermoon,672,priest,holy,18,7,11
Russianpvp,outland,672,priest,holy,18,7,11
Gintøníc,blackmoore,671,priest,holy,12,7,5
Vibby,moonglade,671,priest,holy,18,7,11
Shannywen,nemesis,671,priest,holy,24,7,17
Zloop,tarren-mill,670,priest,holy,12,7,5
Qazar,draenor,670,priest,holy,12,7,5
Smolbøi,tarren-mill,670,priest,holy,24,7,17
Dwano,balnazzar,669,priest,holy,12,7,5
Fuloo,stormscale,669,priest,holy,24,7,17
Zinary,silvermoon,667,priest,holy,18,7,11
Isiriah,archimonde,666,priest,holy,12,7,5
Yayaxoxo,archimonde,660,priest,holy,26,10,16
Ledarz,dun-morogh,658,priest,holy,18,7,11
Sarafîsthole,ysondre,655,priest,holy,18,7,11
Naid,exodar,654,priest,holy,24,7,17
Iliridan,pozzo-delleternità,639,priest,holy,138,42,96
Killtrewerty,stormscale,638,priest,holy,17,7,10
Åshlol,ravencrest,617,priest,holy,21,8,13
Waycrest,ravencrest,614,priest,holy,14,8,6
Kirvane,outland,610,priest,holy,15,8,7
Blâdes,gorgonnash,589,priest,holy,17,7,10
Haineko,burning-legion,576,priest,holy,6,6,0
Darkoul,ravencrest,576,priest,holy,12,6,6
Priestok,archimonde,576,priest,holy,12,6,6
Ixxmp,blackrock,576,priest,holy,12,6,6
Nancey,draenor,576,priest,holy,12,6,6
Redy,drakthul,576,priest,holy,12,6,6
Квваззар,gordunni,576,priest,holy,12,6,6
Bij,outland,576,priest,holy,12,6,6
Danina,outland,576,priest,holy,12,6,6
Ahilarry,tarren-mill,576,priest,holy,12,6,6
Resuscitator,spinebreaker,576,priest,holy,12,6,6
Zoophobîa,stormscale,576,priest,holy,12,6,6
Gigamind,blackrock,576,priest,holy,12,6,6
Смайткен,gordunni,576,priest,holy,18,6,12
Мотд,gordunni,576,priest,holy,18,6,12
Altarboy,dun-modr,576,priest,holy,18,6,12
Gød,magtheridon,576,priest,holy,24,6,18
Waters,lightbringer,575,priest,holy,12,6,6
Кариелла,fordragon,575,priest,holy,12,6,6
Wasfürsaft,tarren-mill,575,priest,holy,12,6,6
Healiea,outland,575,priest,holy,18,6,12
Dokurochan,tarren-mill,575,priest,holy,24,6,18
Cayden,bloodfeather,573,priest,holy,12,6,6
Spàgno,nemesis,571,priest,holy,18,6,12
Proxypriest,the-maelstrom,571,priest,holy,20,6,14
Drop,los-errantes,569,priest,holy,12,6,6
Valves,saurfang,569,priest,holy,12,6,6
Carbonic,khaz-modan,568,priest,holy,20,10,10
Bloodelfoula,draenor,563,priest,holy,18,6,12
Alloktonos,ravencrest,544,priest,holy,101,44,57
Priestxx,twilights-hammer,543,priest,holy,11,6,5
Cherrih,argent-dawn,543,priest,holy,11,6,5
Rezzurrectum,doomhammer,527,priest,holy,15,6,9
Dotreveal,ravencrest,521,priest,holy,20,7,13
Madvortexe,kazzak,496,priest,holy,19,6,13
Ralek,hyjal,495,priest,holy,17,6,11
Secundis,silvermoon,480,priest,holy,6,5,1
Felaenna,argent-dawn,480,priest,holy,6,5,1
Shinesomnya,aegwynn,480,priest,holy,6,5,1
Эйттёрналинь,fordragon,480,priest,holy,6,5,1
Tokkzz,ragnaros,480,priest,holy,6,5,1
Celliapriest,antonidas,480,priest,holy,12,5,7
Darkoulito,dalaran,480,priest,holy,12,5,7
Nýkah,antonidas,480,priest,holy,12,5,7
Purist,arthas,480,priest,holy,12,5,7
Velenthan,ragnaros,480,priest,holy,12,5,7
Enèr,hyjal,480,priest,holy,12,5,7
Caz,cthun,480,priest,holy,12,5,7
Shâru,frostmourne,480,priest,holy,12,5,7
Quiwzx,blackrock,480,priest,holy,12,5,7
Onixa,tarren-mill,480,priest,holy,12,5,7
Ogiez,sylvanas,480,priest,holy,12,5,7
Mazeari,sylvanas,480,priest,holy,12,5,7
Holymamba,silvermoon,480,priest,holy,12,5,7
Neeyø,blackhand,480,priest,holy,12,5,7
Лайхтни,howling-fjord,480,priest,holy,12,5,7
Velfchurch,draenor,480,priest,holy,12,5,7
Bamboleon,blackrock,480,priest,holy,12,5,7
Mönster,cthun,480,priest,holy,13,5,8
Mayalolz,chogall,480,priest,holy,14,5,9
Jagardoden,stormscale,480,priest,holy,18,5,13
Minimalist,ravencrest,480,priest,holy,18,5,13
Vannax,arygos,479,priest,holy,6,5,1
Chabbe,ragnaros,479,priest,holy,12,5,7
Cocolasticot,garona,479,priest,holy,12,5,7
Datek,silvermoon,479,priest,holy,12,5,7
Двакамня,soulflayer,479,priest,holy,12,5,7
Novella,kult-der-verdammten,479,priest,holy,12,5,7
Inzané,doomhammer,479,priest,holy,12,5,7
Árcadoom,quelthalas,479,priest,holy,12,5,7
Бредяка,gordunni,479,priest,holy,12,5,7
Alaeddin,kazzak,479,priest,holy,24,5,19
Amemiya,ragnaros,478,priest,holy,12,5,7
Laxara,arthas,478,priest,holy,12,5,7
Monetaria,das-syndikat,477,priest,holy,18,5,13
Xaeo,burning-legion,477,priest,holy,26,5,21
Azaza,burning-legion,472,priest,holy,12,5,7
Nevermd,blackrock,426,priest,holy,21,6,15
Nannymcfee,stormscale,414,priest,holy,11,5,6
Даймэн,gordunni,384,priest,holy,6,4,2
Burnesenbois,chogall,384,priest,holy,6,4,2
Tëst,ravencrest,384,priest,holy,6,4,2
Experimentix,silvermoon,384,priest,holy,6,4,2
Макстин,howling-fjord,384,priest,holy,6,4,2
Wixzyx,ravencrest,384,priest,holy,6,4,2
Yredias,dalaran,384,priest,holy,6,4,2
Indrades,blackmoore,384,priest,holy,6,4,2
Пристотян,gordunni,384,priest,holy,6,4,2
Yanclown,tarren-mill,384,priest,holy,6,4,2
Piizzdiica,twisting-nether,384,priest,holy,6,4,2
Arithon,blackrock,384,priest,holy,6,4,2
Tyog,khazgoroth,384,priest,holy,6,4,2
Missdemerè,nemesis,384,priest,holy,12,4,8
Mydicine,ysondre,384,priest,holy,12,4,8
Sayash,chamber-of-aspects,384,priest,holy,12,4,8
Alterlight,twisting-nether,384,priest,holy,12,4,8
Bebwaz,kazzak,384,priest,holy,12,4,8
Zarez,stormscale,384,priest,holy,12,4,8
Flurri,tarren-mill,384,priest,holy,12,4,8
Jukester,stormscale,384,priest,holy,12,4,8
Disillusíon,tarren-mill,384,priest,holy,12,4,8
Chaendral,darkmoon-faire,384,priest,holy,12,4,8
Alshah,emerald-dream,384,priest,holy,12,4,8
Spamplague,stormscale,384,priest,holy,12,4,8
Aladriela,exodar,384,priest,holy,12,4,8
Bloodie,drakthul,384,priest,holy,12,4,8
Ripperdepip,magtheridon,384,priest,holy,12,4,8
Sinf,sanguino,384,priest,holy,12,4,8
Øbz,sylvanas,384,priest,holy,12,4,8
Clergy,hellfire,384,priest,holy,12,4,8
Avïlia,dalaran,384,priest,holy,12,4,8
Egozyp,kazzak,384,priest,holy,12,4,8
Skytheory,eredar,384,priest,holy,13,4,9
Virgosenpai,silvermoon,384,priest,holy,18,4,14
Ømegagødx,outland,384,priest,holy,18,4,14
Кэндимен,gordunni,384,priest,holy,18,4,14
Ðlcz,blackrock,384,priest,holy,18,4,14
Kheenah,argent-dawn,383,priest,holy,6,4,2
Fivequeens,tarren-mill,383,priest,holy,6,4,2
Allwhitte,confrérie-du-thorium,383,priest,holy,6,4,2
Taint,khadgar,383,priest,holy,6,4,2
Ruebi,blackmoore,383,priest,holy,12,4,8
Blackwidow,chromaggus,383,priest,holy,12,4,8
Tolteck,ravencrest,383,priest,holy,12,4,8
Ynnaria,blackmoore,383,priest,holy,12,4,8
Harukaa,aggra-português,383,priest,holy,12,4,8
Centauria,burning-legion,381,priest,holy,30,4,26
Amanthus,draenor,377,priest,holy,16,6,10
Эгнерия,eversong,367,priest,holy,17,4,13
Nxtlvl,stormscale,352,priest,holy,10,5,5
Pínacoladáqt,stormscale,352,priest,holy,10,4,6
Apuessii,dun-modr,351,priest,holy,11,4,7
Shyvi,ravencrest,319,priest,holy,5,4,1
Vídel,cthun,319,priest,holy,8,4,4
Zahadoom,stormscale,319,priest,holy,12,5,7
Aiewn,elune,288,priest,holy,6,3,3
Ariyia,argent-dawn,288,priest,holy,6,3,3
Badhêalz,aegwynn,288,priest,holy,6,3,3
Kyokaze,silvermoon,288,priest,holy,6,3,3
Verycute,argent-dawn,288,priest,holy,6,3,3
Tebzy,ravencrest,288,priest,holy,6,3,3
Pyropenance,twisting-nether,288,priest,holy,6,3,3
Shadowkym,blackrock,288,priest,holy,6,3,3
Elf,tarren-mill,288,priest,holy,6,3,3
Vanadii,blackhand,288,priest,holy,6,3,3
Dathanosp,outland,288,priest,holy,6,3,3
Хексорик,howling-fjord,288,priest,holy,6,3,3
Aevery,onyxia,288,priest,holy,6,3,3
Proteco,antonidas,288,priest,holy,6,3,3
Drdiscospec,tarren-mill,288,priest,holy,6,3,3
Xelivia,draenor,288,priest,holy,6,3,3
Hilerki,draenor,288,priest,holy,6,3,3
Arabpriest,draenor,288,priest,holy,6,3,3
Pristern,tarren-mill,288,priest,holy,6,3,3
Mcx,stormscale,288,priest,holy,6,3,3
ßestworld,draenor,288,priest,holy,6,3,3
Grindgames,pozzo-delleternità,288,priest,holy,6,3,3
Catrex,draenor,288,priest,holy,6,3,3
Góli,argent-dawn,288,priest,holy,6,3,3
Holyheartx,argent-dawn,288,priest,holy,6,3,3
Shmoly,stormscale,288,priest,holy,6,3,3
Juicedmaboi,tarren-mill,288,priest,holy,6,3,3
Asolan,drakthul,288,priest,holy,6,3,3
Dãrkmedic,silvermoon,288,priest,holy,6,3,3
Gimeurgold,destromath,288,priest,holy,6,3,3
Alaelis,burning-legion,288,priest,holy,6,3,3
Bambus,shattered-hand,288,priest,holy,6,3,3
Aruna,ravencrest,288,priest,holy,6,3,3
Mneme,aggramar,288,priest,holy,6,3,3
Подчинись,ashenvale,288,priest,holy,6,3,3
Lynéssa,silvermoon,288,priest,holy,6,3,3
Carnacia,tarren-mill,288,priest,holy,6,3,3
Zyrusen,sanguino,288,priest,holy,6,3,3
Atremius,dragonmaw,288,priest,holy,6,3,3
Аржан,soulflayer,288,priest,holy,6,3,3
Nimsi,ravencrest,288,priest,holy,6,3,3
Pharli,stormscale,288,priest,holy,6,3,3
Namsolo,kazzak,288,priest,holy,6,3,3
Шанэкс,howling-fjord,288,priest,holy,6,3,3
Tribz,kargath,288,priest,holy,6,3,3
Фионыч,blackscar,288,priest,holy,6,3,3
Salzholy,malygos,288,priest,holy,6,3,3
Jeboc,ravencrest,288,priest,holy,6,3,3
Alentissar,nemesis,288,priest,holy,6,3,3
Inà,thrall,288,priest,holy,6,3,3
Холихэйт,howling-fjord,288,priest,holy,6,3,3
Prisht,ravencrest,288,priest,holy,6,3,3
Egî,azshara,288,priest,holy,6,3,3
Hellhámmer,azshara,288,priest,holy,6,3,3
Sebbepriest,twisting-nether,288,priest,holy,10,3,7
Daenaerys,dun-morogh,288,priest,holy,12,3,9
Eihran,stormscale,288,priest,holy,12,3,9
Xver,dun-morogh,288,priest,holy,12,3,9
Drminduskâ,ysondre,288,priest,holy,12,3,9
Pretzioso,nemesis,288,priest,holy,12,3,9
Javvi,sylvanas,288,priest,holy,12,3,9
Parzivál,argent-dawn,288,priest,holy,12,3,9
Lurri,tarren-mill,288,priest,holy,12,3,9
Quami,dun-modr,288,priest,holy,12,3,9
Люблюкофе,deathguard,288,priest,holy,12,3,9
Farae,arathor,288,priest,holy,24,3,21
Ларуса,gordunni,287,priest,holy,6,3,3
Clerìc,argent-dawn,255,priest,holy,11,3,8
Elthrone,kazzak,240,priest,holy,9,4,5
Lr,aszune,240,priest,holy,9,3,6
Кэрия,blackscar,239,priest,holy,5,3,2
Azrpr,ravencrest,239,priest,holy,5,3,2
Outcast,korgall,224,priest,holy,10,3,7
Notatrap,outland,192,priest,holy,6,2,4
Dinma,argent-dawn,192,priest,holy,6,2,4
Dami,defias-brotherhood,192,priest,holy,6,2,4
Discobrill,silvermoon,192,priest,holy,6,2,4
Келебриана,deepholm,192,priest,holy,6,2,4
Eyllise,ragnaros,192,priest,holy,6,2,4
Solaclypsa,destromath,192,priest,holy,6,2,4
Zenholy,kazzak,192,priest,holy,6,2,4
Асуартхас,gordunni,192,priest,holy,6,2,4
Llounal,silvermoon,192,priest,holy,6,2,4
Shkzz,hyjal,192,priest,holy,6,2,4
Jinxies,twisting-nether,192,priest,holy,6,2,4
Burnex,thrall,192,priest,holy,6,2,4
Yukirito,drakthul,192,priest,holy,6,2,4
Utsuro,stormscale,192,priest,holy,6,2,4
Prästpojken,frostwhisper,192,priest,holy,6,2,4
Dîakon,antonidas,192,priest,holy,6,2,4
Krematorio,twisting-nether,192,priest,holy,6,2,4
Marrisa,khaz-modan,192,priest,holy,6,2,4
Tiphereth,blackmoore,192,priest,holy,6,2,4
Absórb,quelthalas,192,priest,holy,6,2,4
Lahammy,kazzak,192,priest,holy,6,2,4
Tygstycke,tarren-mill,192,priest,holy,6,2,4
Ibunnyqt,aegwynn,192,priest,holy,6,2,4
Soül,sylvanas,192,priest,holy,6,2,4
Korzec,dun-modr,192,priest,holy,6,2,4
Ihefyehvjrm,ravencrest,192,priest,holy,6,2,4
Micix,tarren-mill,192,priest,holy,6,2,4
Sinetrax,tarren-mill,192,priest,holy,6,2,4
Lutzki,the-maelstrom,192,priest,holy,6,2,4
Troedelsuppe,destromath,192,priest,holy,6,2,4
Hunfall,stormscale,192,priest,holy,6,2,4
Buzzy,twisting-nether,192,priest,holy,6,2,4
Skryllette,archimonde,192,priest,holy,6,2,4
Dertar,archimonde,192,priest,holy,6,2,4
Priesless,sylvanas,192,priest,holy,6,2,4
Djingischan,twisting-nether,192,priest,holy,6,2,4
Tinypump,silvermoon,192,priest,holy,6,2,4
Noukeé,blackrock,192,priest,holy,6,2,4
Grøums,blackmoore,192,priest,holy,6,2,4
Frvrfridayy,stormscale,192,priest,holy,6,2,4
Sigor,hellfire,192,priest,holy,6,2,4
Haxxøn,die-nachtwache,192,priest,holy,6,2,4
Cheefto,blackmoore,192,priest,holy,6,2,4
Dangerfred,stormscale,192,priest,holy,6,2,4
Crackbär,blackmoore,192,priest,holy,6,2,4
Луножрец,gordunni,192,priest,holy,6,2,4
Wyez,blackmoore,192,priest,holy,6,2,4
Бранлор,howling-fjord,192,priest,holy,8,2,6
Nøfear,tarren-mill,192,priest,holy,11,2,9
Jawjie,tarren-mill,192,priest,holy,12,2,10
Гидранист,soulflayer,192,priest,holy,12,2,10
Authentic,dalaran,192,priest,holy,12,2,10
Daedarkis,twisting-nether,192,priest,holy,12,2,10
Køzøxîä,dalaran,192,priest,holy,12,2,10
Ittei,stormscale,192,priest,holy,12,2,10
Twh,outland,192,priest,holy,12,2,10
Злыденькая,gordunni,192,priest,holy,12,2,10
Hónòr,sylvanas,192,priest,holy,12,2,10
Meynola,ysondre,191,priest,holy,6,2,4
Bianchi,los-errantes,191,priest,holy,6,2,4
Riogas,khaz-modan,191,priest,holy,12,2,10
Safiira,argent-dawn,190,priest,holy,12,2,10
Rankonejames,silvermoon,159,priest,holy,5,2,3
Pinkfloydx,lightbringer,138,priest,holy,9,4,5
Spae,twisting-nether,138,priest,holy,11,4,7
Paterlurki,blackhand,138,priest,holy,10,3,7
Пейлон,howling-fjord,137,priest,holy,10,4,6
Mavisqt,draenor,128,priest,holy,4,2,2
Ûñrêpørtablë,outland,96,priest,holy,3,2,1
Kipnuggetz,burning-legion,96,priest,holy,6,1,5
Superdude,stormscale,96,priest,holy,6,1,5
Яестькенни,soulflayer,96,priest,holy,6,1,5
Decimerad,kazzak,96,priest,holy,6,1,5
Lasanka,sylvanas,96,priest,holy,6,1,5
Peg,talnivarr,96,priest,holy,6,1,5
Lujka,outland,96,priest,holy,6,1,5
Isendriel,outland,96,priest,holy,6,1,5
Shicu,blackmoore,96,priest,holy,6,1,5
Rankoneprazt,stormscale,96,priest,holy,6,1,5
Saheila,defias-brotherhood,96,priest,holy,6,1,5
Remkoja,blackrock,96,priest,holy,6,1,5
Pattie,ragnaros,96,priest,holy,6,1,5
Goupillou,hyjal,96,priest,holy,6,1,5
Батлджес,gordunni,96,priest,holy,6,1,5
Tÿona,hyjal,96,priest,holy,6,1,5
Spoc,blackrock,96,priest,holy,6,1,5
Nuph,ravencrest,96,priest,holy,6,1,5
Elvedâ,blackhand,96,priest,holy,6,1,5
Blastor,ravencrest,96,priest,holy,6,1,5
Сакредлайв,gordunni,96,priest,holy,6,1,5
Эллвинг,howling-fjord,96,priest,holy,6,1,5
Valyreon,outland,96,priest,holy,6,1,5
Laadyybirkee,blackhand,96,priest,holy,6,1,5
Elfhelp,ravencrest,96,priest,holy,6,1,5
Mauralin,zirkel-des-cenarius,96,priest,holy,6,1,5
Lâughing,ravencrest,96,priest,holy,6,1,5
Мишатемный,gordunni,96,priest,holy,6,1,5
Itstooney,doomhammer,96,priest,holy,6,1,5
Myrrha,les-sentinelles,96,priest,holy,6,1,5
Wísp,die-aldor,96,priest,holy,6,1,5
Borá,twisting-nether,96,priest,holy,6,1,5
Eloundir,dalaran,96,priest,holy,6,1,5
Systerstål,twisting-nether,96,priest,holy,6,1,5
Venomrush,ravencrest,96,priest,holy,6,1,5
Kakuzuke,nemesis,96,priest,holy,6,1,5
Herwin,twisting-nether,96,priest,holy,6,1,5
Wrongwrong,draenor,96,priest,holy,6,1,5
Iirina,draenor,96,priest,holy,6,1,5
Jaesabøyx,twisting-nether,96,priest,holy,6,1,5
Ximenia,eredar,96,priest,holy,6,1,5
Vierfingerjo,eredar,96,priest,holy,6,1,5
Slêq,antonidas,96,priest,holy,6,1,5
Jaatjak,ravencrest,96,priest,holy,6,1,5
Ylenae,twisting-nether,96,priest,holy,6,1,5
Kasáya,thrall,96,priest,holy,14,2,12
Plaguestrike,darkspear,96,priest,holy,12,1,11
Onlyfans,burning-steppes,96,priest,holy,12,1,11
Åme,kirin-tor,96,priest,holy,12,1,11
Doublehealix,argent-dawn,96,priest,holy,12,1,11
Kæzm,blackrock,96,priest,holy,12,1,11
Felvytwo,stormscale,96,priest,holy,12,1,11
Mswagner,outland,79,priest,holy,5,1,4
Xaey,ravencrest,48,priest,holy,3,1,2
Freshpope,ravencrest,48,priest,holy,3,1,2
Darkyos,azshara,42,priest,holy,6,2,4
Tabítha,blackrock,42,priest,holy,9,2,7
Priestyo,blackrock,42,priest,holy,10,2,8
Bøij,pozzo-delleternità,42,priest,holy,10,2,8
Prêtresacré,archimonde,2244,priest,discipline,89,52,37
Gaalonikus,blackmoore,2235,priest,discipline,92,54,38
Vanostsp,kazzak,2230,priest,discipline,102,56,46
Jayti,ravencrest,2205,priest,discipline,115,65,50
Primayodbain,archimonde,2185,priest,discipline,82,47,35
Vengefulmaze,ravencrest,2174,priest,discipline,120,65,55
Dripcheck,draenor,2174,priest,discipline,337,178,159
Èfflux,ravencrest,2172,priest,discipline,86,54,32
Jackiqt,nemesis,2161,priest,discipline,119,77,42
Bedfirez,ravencrest,2161,priest,discipline,211,122,89
Jagardoden,stormscale,2144,priest,discipline,117,71,46
Jtî,ravencrest,2134,priest,discipline,72,47,25
Saentainen,kazzak,2133,priest,discipline,95,68,27
Cylizx,stormscale,2133,priest,discipline,114,62,52
Ltr,tarren-mill,2132,priest,discipline,61,39,22
Moonriver,archimonde,2132,priest,discipline,66,39,27
Jaywie,twisting-nether,2132,priest,discipline,156,79,77
Artle,sanguino,2131,priest,discipline,83,44,39
Izzý,antonidas,2129,priest,discipline,90,57,33
Efflúx,ravencrest,2128,priest,discipline,124,71,53
Azrpr,ravencrest,2128,priest,discipline,82,45,37
Релакз,soulflayer,2124,priest,discipline,120,66,54
Kleot,ragnaros,2124,priest,discipline,385,205,180
Cringê,ravencrest,2124,priest,discipline,89,46,43
Rébörn,tarren-mill,2123,priest,discipline,71,44,27
Asanti,die-aldor,2122,priest,discipline,252,145,107
Unréål,ravencrest,2122,priest,discipline,198,102,96
Hukkuvahirvi,ravencrest,2122,priest,discipline,99,50,49
Jidammy,ravencrest,2120,priest,discipline,80,41,39
Duckiethot,twisting-nether,2120,priest,discipline,196,99,97
Деадхостх,soulflayer,2117,priest,discipline,72,46,26
Jacknapier,kazzak,2117,priest,discipline,66,39,27
Rñd,ravencrest,2117,priest,discipline,78,40,38
Voxtwo,blackrock,2114,priest,discipline,66,41,25
Råcòøñ,ravencrest,2110,priest,discipline,109,55,54
Sfÿ,ysondre,2106,priest,discipline,84,43,41
Blessedmix,korgall,2105,priest,discipline,84,48,36
Swdswdswdswd,blackmoore,2105,priest,discipline,100,55,45
Wetnpuffy,ravencrest,2104,priest,discipline,274,145,129
Neverdome,ravencrest,2100,priest,discipline,405,218,187
Øbserverx,stormscale,2100,priest,discipline,114,61,53
Мамкалол,soulflayer,2096,priest,discipline,288,150,138
Chasx,ravencrest,2092,priest,discipline,136,67,69
Klonyaryk,ravencrest,2089,priest,discipline,90,52,38
Loví,twisting-nether,2081,priest,discipline,107,53,54
Prästpåven,stormscale,2078,priest,discipline,66,40,26
Gudóngmae,ravencrest,2076,priest,discipline,48,32,16
Luxurygirl,nemesis,2076,priest,discipline,54,35,19
Kangaroogodx,ravencrest,2070,priest,discipline,126,62,64
Pheen,kazzak,2065,priest,discipline,262,140,122
Thelïght,ravencrest,2062,priest,discipline,165,81,84
Twinkboyx,ragnaros,2060,priest,discipline,129,66,63
Mentalboom,emerald-dream,2060,priest,discipline,185,94,91
Shøy,nemesis,2059,priest,discipline,228,115,113
Holypoppa,ravencrest,2051,priest,discipline,295,146,149
Aist,ragnaros,2044,priest,discipline,90,44,46
Flongoletta,xavius,2042,priest,discipline,144,80,64
Schattenface,blackmoore,2041,priest,discipline,194,112,82
Plsdontnerf,onyxia,2039,priest,discipline,95,55,40
Imprøved,outland,2036,priest,discipline,102,70,32
Lloreen,ravencrest,2035,priest,discipline,131,72,59
Artístx,twisting-nether,2035,priest,discipline,83,44,39
Rhâpsødy,ravencrest,2033,priest,discipline,107,65,42
Bindw,tarren-mill,2025,priest,discipline,41,22,19
Reflector,sunstrider,2025,priest,discipline,93,44,49
Sèco,sylvanas,2024,priest,discipline,90,44,46
Faithz,ragnaros,2023,priest,discipline,84,39,45
Mavisqt,draenor,2022,priest,discipline,114,61,53
Crinji,blackmoore,2022,priest,discipline,169,83,86
Loaffeh,ragnaros,2021,priest,discipline,48,28,20
Leahbtw,ravencrest,2020,priest,discipline,216,114,102
Dakystepmom,stormreaver,2017,priest,discipline,119,57,62
Гопикзашквар,blackscar,2017,priest,discipline,104,47,57
Priestqtx,kelthuzad,2016,priest,discipline,60,34,26
Wet,twisting-nether,2015,priest,discipline,90,41,49
Gerryqt,draenor,2013,priest,discipline,72,38,34
Villagebike,shadowsong,2012,priest,discipline,42,22,20
Разрухаз,gordunni,2011,priest,discipline,95,48,47
Eau,quelthalas,2011,priest,discipline,142,71,71
Synxii,ravencrest,2010,priest,discipline,100,50,50
Trialight,ravencrest,2009,priest,discipline,89,57,32
Shadothat,turalyon,2008,priest,discipline,173,93,80
Фастэксп,razuvious,2008,priest,discipline,263,135,128
Nêxt,ravencrest,2007,priest,discipline,102,67,35
Timbsheal,tarren-mill,2007,priest,discipline,150,77,73
Ävbmârsík,kazzak,2006,priest,discipline,143,80,63
Shmoly,stormscale,2006,priest,discipline,97,50,47
Duckiethotx,ragnaros,2005,priest,discipline,108,53,55
Фанпау,soulflayer,2005,priest,discipline,84,39,45
Tanlytwo,ravencrest,2003,priest,discipline,76,38,38
Underdogx,eredar,2002,priest,discipline,551,282,269
Vajadisc,twisting-nether,2000,priest,discipline,136,59,77
Ðontargueok,blackmoore,1996,priest,discipline,90,50,40
Nothappy,ragnaros,1996,priest,discipline,66,32,34
Mentalist,dun-modr,1996,priest,discipline,189,91,98
Билетлолпро,borean-tundra,1995,priest,discipline,256,124,132
Rhauru,tyrande,1994,priest,discipline,146,69,77
Yânux,aegwynn,1991,priest,discipline,91,50,41
Хомяктьмы,gordunni,1991,priest,discipline,108,57,51
Stavfel,stormscale,1990,priest,discipline,117,63,54
Dabalthazar,ravencrest,1985,priest,discipline,163,83,80
Ilumiinatrix,dun-modr,1982,priest,discipline,696,345,351
Dpriesta,aegwynn,1979,priest,discipline,88,52,36
Painchampion,draenor,1978,priest,discipline,88,43,45
Acondisc,kazzak,1977,priest,discipline,76,43,33
Boltygnome,blades-edge,1977,priest,discipline,96,52,44
Flao,ravencrest,1977,priest,discipline,64,34,30
Ekman,twisting-nether,1977,priest,discipline,128,67,61
Önnÿ,dun-modr,1975,priest,discipline,149,76,73
Oioiio,kazzak,1975,priest,discipline,84,42,42
Sinetrax,tarren-mill,1973,priest,discipline,96,57,39
Clapped,ravencrest,1973,priest,discipline,78,38,40
Mercilégion,sargeras,1971,priest,discipline,66,34,32
Prådâshådëzz,blackmoore,1970,priest,discipline,59,36,23
Sleepypriest,frostmane,1970,priest,discipline,54,31,23
Хомячпочка,gordunni,1970,priest,discipline,82,42,40
Jawake,twisting-nether,1970,priest,discipline,54,27,27
Lyrvanax,ravencrest,1968,priest,discipline,241,119,122
Ziknait,sargeras,1967,priest,discipline,54,34,20
Comedii,blackmoore,1965,priest,discipline,477,247,230
Eukmassus,archimonde,1964,priest,discipline,82,43,39
Wernou,archimonde,1963,priest,discipline,60,36,24
Djsüssi,frostwolf,1963,priest,discipline,163,76,87
Kâiøxx,outland,1958,priest,discipline,228,120,108
Spinebuster,frostwolf,1958,priest,discipline,78,38,40
Líluqt,sanguino,1957,priest,discipline,93,46,47
Asdfgfhtjy,stormscale,1955,priest,discipline,84,40,44
Krawnz,dun-modr,1953,priest,discipline,54,29,25
Semagdnim,aggra-português,1951,priest,discipline,87,44,43
Rlyeh,argent-dawn,1949,priest,discipline,65,35,30
Klered,ragnaros,1948,priest,discipline,88,54,34
Secø,sylvanas,1948,priest,discipline,48,26,22
Salvinia,kelthuzad,1948,priest,discipline,114,57,57
Artle,dun-modr,1945,priest,discipline,88,61,27
Mainputa,pozzo-delleternità,1943,priest,discipline,113,54,59
Kekkons,sylvanas,1941,priest,discipline,119,61,58
Ebuglatatrov,ravencrest,1941,priest,discipline,120,57,63
Нтти,soulflayer,1940,priest,discipline,90,50,40
Místerbiceps,outland,1940,priest,discipline,95,48,47
Concetto,nazjatar,1939,priest,discipline,48,27,21
Sathie,ravencrest,1939,priest,discipline,114,57,57
Puckhorde,outland,1938,priest,discipline,96,59,37
Lyrvatwo,ravencrest,1938,priest,discipline,55,33,22
Mysterymucus,draenor,1938,priest,discipline,102,61,41
Porkhunt,stormscale,1938,priest,discipline,90,52,38
Scortie,blackrock,1938,priest,discipline,78,41,37
Senga,kazzak,1937,priest,discipline,78,38,40
Summerfinn,ravencrest,1937,priest,discipline,93,44,49
Tjackpanda,kazzak,1935,priest,discipline,54,30,24
Бенджаминлол,blackscar,1934,priest,discipline,60,27,33
Джагонх,soulflayer,1932,priest,discipline,72,40,32
Zularia,rexxar,1932,priest,discipline,132,70,62
Rngånxiety,ravencrest,1931,priest,discipline,142,72,70
Невертрикахд,gordunni,1931,priest,discipline,113,52,61
Healseri,defias-brotherhood,1929,priest,discipline,222,114,108
Mswagner,outland,1926,priest,discipline,65,36,29
Psyheea,stormscale,1926,priest,discipline,139,62,77
Лёнятреппер,blackscar,1925,priest,discipline,183,102,81
Trashedd,outland,1925,priest,discipline,123,58,65
Uwuslayerx,stormscale,1922,priest,discipline,137,70,67
Azoran,dentarg,1922,priest,discipline,78,39,39
Akaria,kelthuzad,1922,priest,discipline,66,30,36
Deadsloth,hyjal,1921,priest,discipline,71,37,34
Arthezz,ravencrest,1920,priest,discipline,92,50,42
Sharkouly,blackmoore,1920,priest,discipline,54,27,27
Алинкалол,howling-fjord,1916,priest,discipline,192,110,82
Niniell,blackmoore,1915,priest,discipline,66,43,23
Делреона,blackscar,1914,priest,discipline,102,58,44
Soloshuffle,draenor,1914,priest,discipline,76,40,36
Listrix,frostmane,1914,priest,discipline,180,91,89
Nirvz,silvermoon,1913,priest,discipline,78,56,22
Dermaul,kazzak,1913,priest,discipline,42,24,18
Shinjicum,kazzak,1912,priest,discipline,255,145,110
Justyø,archimonde,1909,priest,discipline,290,166,124
Eestpr,tarren-mill,1908,priest,discipline,69,37,32
Verti,outland,1906,priest,discipline,118,56,62
Hampådenbååd,kazzak,1905,priest,discipline,54,26,28
Bonzu,ravencrest,1904,priest,discipline,60,30,30
Georgeshxx,ravencrest,1903,priest,discipline,95,50,45
Kenzah,ysondre,1902,priest,discipline,48,28,20
Demora,ysondre,1901,priest,discipline,156,81,75
Evpisces,archimonde,1901,priest,discipline,333,164,169
Kevinsorbo,destromath,1899,priest,discipline,66,35,31
Bigextendo,blackmoore,1899,priest,discipline,144,76,68
Donvyto,blackmoore,1899,priest,discipline,48,24,24
Maxfly,archimonde,1898,priest,discipline,54,29,25
Notnøw,silvermoon,1897,priest,discipline,59,36,23
Лайбаси,howling-fjord,1897,priest,discipline,126,64,62
Rîeka,antonidas,1897,priest,discipline,83,40,43
Галюхах,soulflayer,1895,priest,discipline,48,25,23
Kêkwshádêzz,blackmoore,1895,priest,discipline,54,27,27
Citadelle,blackmoore,1894,priest,discipline,83,48,35
Discishârd,ravencrest,1893,priest,discipline,117,60,57
Fearxyz,aegwynn,1891,priest,discipline,66,34,32
Разорлайтх,gordunni,1890,priest,discipline,29,21,8
ßrb,sylvanas,1888,priest,discipline,174,98,76
Wangewover,ravencrest,1888,priest,discipline,147,82,65
Xghj,sylvanas,1887,priest,discipline,72,36,36
Potatojuicer,argent-dawn,1886,priest,discipline,165,82,83
Infamoussftw,drakthul,1886,priest,discipline,360,174,186
Ananous,hyjal,1885,priest,discipline,189,99,90
Fabzen,grim-batol,1884,priest,discipline,66,32,34
Йеэгер,soulflayer,1883,priest,discipline,70,31,39
Melphixia,stormscale,1882,priest,discipline,53,25,28
Voideffsucks,stormscale,1881,priest,discipline,60,32,28
Tweely,drakthul,1881,priest,discipline,87,46,41
Tazn,thrall,1880,priest,discipline,42,23,19
Merylle,ragnaros,1880,priest,discipline,60,29,31
Goldensp,sanguino,1878,priest,discipline,81,47,34
Nolnilian,archimonde,1877,priest,discipline,60,35,25
Faderfarbror,tarren-mill,1872,priest,discipline,109,68,41
Elethia,blackmoore,1872,priest,discipline,38,21,17
Yeetedmycat,stormscale,1872,priest,discipline,66,34,32
Onyoureyebal,vashj,1872,priest,discipline,132,61,71
Imsaltyxd,tarren-mill,1871,priest,discipline,66,39,27
Maybeexp,ravencrest,1871,priest,discipline,42,23,19
Svakkanxd,kazzak,1871,priest,discipline,70,33,37
Cdïs,tyrande,1870,priest,discipline,54,36,18
Rpriest,outland,1870,priest,discipline,60,34,26
Egî,azshara,1870,priest,discipline,42,20,22
Depridolens,argent-dawn,1869,priest,discipline,42,27,15
Limerençe,ravencrest,1869,priest,discipline,44,25,19
Интеллиджент,gordunni,1868,priest,discipline,42,24,18
ßlinkytwinky,outland,1868,priest,discipline,42,22,20
Zhadow,outland,1868,priest,discipline,150,78,72
Свэпи,blackscar,1868,priest,discipline,71,34,37
Nalakis,archimonde,1866,priest,discipline,115,67,48
Elsuzette,hyjal,1866,priest,discipline,58,30,28
Saniqt,kazzak,1865,priest,discipline,57,35,22
Jimpah,outland,1865,priest,discipline,112,49,63
Phosdia,festung-der-stürme,1864,priest,discipline,36,24,12
Moyoo,kazzak,1864,priest,discipline,100,45,55
Jellypie,blackrock,1863,priest,discipline,48,31,17
Asdfghqwezxc,twisting-nether,1863,priest,discipline,65,35,30
Neffty,aegwynn,1863,priest,discipline,138,73,65
Прощайдуде,gordunni,1863,priest,discipline,65,34,31
Asyncx,ravencrest,1862,priest,discipline,68,35,33
Xutira,silvermoon,1861,priest,discipline,207,118,89
Бенджаминлол,deathguard,1861,priest,discipline,66,33,33
Свдпро,soulflayer,1861,priest,discipline,150,70,80
Pricemg,thrall,1860,priest,discipline,48,29,19
Incaflamesex,sanguino,1860,priest,discipline,59,33,26
Debeo,ragnaros,1860,priest,discipline,133,74,59
Кошечка,deathguard,1860,priest,discipline,41,21,20
Thalanas,ravencrest,1859,priest,discipline,158,90,68
Sublab,kazzak,1859,priest,discipline,60,33,27
Artìst,ravencrest,1858,priest,discipline,30,20,10
Мефодийприст,howling-fjord,1858,priest,discipline,102,62,40
Cdplz,archimonde,1858,priest,discipline,119,59,60
Monopolygoat,arathor,1858,priest,discipline,181,84,97
Фрайонель,gordunni,1857,priest,discipline,42,32,10
Entenpanda,kazzak,1855,priest,discipline,122,66,56
Ðènnis,argent-dawn,1855,priest,discipline,139,71,68
Unfaithful,twisting-nether,1854,priest,discipline,70,43,27
Cellia,antonidas,1853,priest,discipline,42,25,17
Kripteksx,ravencrest,1853,priest,discipline,53,29,24
Enilion,draenor,1853,priest,discipline,56,29,27
Dieterdose,tarren-mill,1852,priest,discipline,44,29,15
Crushmyballs,ravencrest,1852,priest,discipline,60,36,24
Eolîn,draenor,1852,priest,discipline,60,35,25
Лэсивэснэс,soulflayer,1852,priest,discipline,72,30,42
Zêxy,stormscale,1851,priest,discipline,101,53,48
Djswdgodx,twisting-nether,1850,priest,discipline,84,43,41
Rynnegan,zuljin,1849,priest,discipline,72,31,41
Çhåosgòddess,kazzak,1848,priest,discipline,42,25,17
Карпинчо,soulflayer,1848,priest,discipline,186,91,95
Flensu,stormscale,1847,priest,discipline,94,54,40
Shonsized,argent-dawn,1847,priest,discipline,154,88,66
Çiione,archimonde,1847,priest,discipline,71,34,37
Aédeira,blackhand,1847,priest,discipline,83,34,49
Flokè,stormscale,1846,priest,discipline,42,26,16
Andrë,ragnaros,1845,priest,discipline,46,29,17
Malfredx,stormscale,1844,priest,discipline,33,21,12
Soyloverjuan,auchindoun,1843,priest,discipline,52,27,25
Аэтпио,soulflayer,1843,priest,discipline,126,64,62
Bæsts,ravencrest,1842,priest,discipline,47,35,12
Minilove,ravencrest,1842,priest,discipline,36,22,14
Maulerion,tarren-mill,1842,priest,discipline,92,53,39
Aiwass,twisting-nether,1842,priest,discipline,54,27,27
Indîcâ,outland,1842,priest,discipline,72,33,39
Kianprie,silvermoon,1842,priest,discipline,101,46,55
Trolldý,outland,1841,priest,discipline,54,33,21
Mend,tarren-mill,1841,priest,discipline,77,34,43
Danglar,defias-brotherhood,1840,priest,discipline,102,58,44
Луилэнс,howling-fjord,1840,priest,discipline,82,46,36
Tacochrist,kazzak,1840,priest,discipline,168,90,78
Bølzer,blackrock,1840,priest,discipline,360,180,180
Twinkerz,ravencrest,1839,priest,discipline,114,70,44
Kàrèm,blutkessel,1839,priest,discipline,48,28,20
Shîn,zirkel-des-cenarius,1839,priest,discipline,72,32,40
Втильте,blackscar,1838,priest,discipline,138,77,61
Sheelah,ravencrest,1838,priest,discipline,66,32,34
Kolerps,ravencrest,1838,priest,discipline,54,25,29
Xíøn,draenor,1837,priest,discipline,48,28,20
Fitu,drakthul,1837,priest,discipline,167,86,81
Drlovke,stormscale,1837,priest,discipline,114,54,60
Virulence,twisting-nether,1836,priest,discipline,223,124,99
Aeogon,kazzak,1836,priest,discipline,179,79,100
Nevercared,aegwynn,1835,priest,discipline,30,25,5
Некронево,howling-fjord,1835,priest,discipline,51,30,21
Indrades,blackmoore,1835,priest,discipline,54,31,23
Xraid,blackmoore,1835,priest,discipline,62,35,27
Trevorlahey,draenor,1835,priest,discipline,171,96,75
Giatros,kazzak,1835,priest,discipline,89,48,41
Видзар,blackscar,1834,priest,discipline,42,27,15
Alwaysøøm,kazzak,1834,priest,discipline,120,77,43
Níghty,ravencrest,1834,priest,discipline,48,28,20
Смотривнебоь,soulflayer,1834,priest,discipline,194,103,91
Gødsfåvørite,blackrock,1834,priest,discipline,264,140,124
Luvdisc,ysondre,1834,priest,discipline,68,34,34
Ксенонх,gordunni,1834,priest,discipline,66,30,36
Touchmypink,ragnaros,1833,priest,discipline,246,119,127
Azaciúx,sylvanas,1832,priest,discipline,48,29,19
Feeqamikka,ragnaros,1832,priest,discipline,61,32,29
Frida,blackrock,1832,priest,discipline,66,33,33
Sazuki,sylvanas,1830,priest,discipline,119,71,48
Discberg,kazzak,1830,priest,discipline,54,29,25
Лизагодх,howling-fjord,1830,priest,discipline,306,161,145
Kuusistöö,kazzak,1830,priest,discipline,110,57,53
Stazqt,conseil-des-ombres,1830,priest,discipline,328,167,161
Nasdaq,ravencrest,1830,priest,discipline,79,38,41
Swiftdemise,sylvanas,1830,priest,discipline,202,97,105
Kaizza,burning-legion,1829,priest,discipline,48,30,18
Alusiepriest,ravencrest,1829,priest,discipline,164,102,62
Chnechnechne,outland,1829,priest,discipline,58,35,23
Qhub,sylvanas,1829,priest,discipline,225,123,102
Minipõppy,ravencrest,1829,priest,discipline,250,132,118
Aliciaiscute,ravencrest,1829,priest,discipline,52,27,25
Bijaqt,blackmoore,1829,priest,discipline,54,27,27
Akeno,sylvanas,1829,priest,discipline,70,31,39
Pradrak,eredar,1828,priest,discipline,54,31,23
Illuminarexo,sylvanas,1828,priest,discipline,145,82,63
Chivalryy,argent-dawn,1828,priest,discipline,119,64,55
Ingelosi,eredar,1828,priest,discipline,220,118,102
Jconnelly,antonidas,1828,priest,discipline,62,32,30
Itayyxd,doomhammer,1828,priest,discipline,66,34,32
Poulet,sylvanas,1827,priest,discipline,52,30,22
Blazingad,kazzak,1827,priest,discipline,173,93,80
Fainttnt,stormscale,1827,priest,discipline,78,39,39
Noelretsof,jaedenar,1827,priest,discipline,62,31,31
Ltmp,ravencrest,1827,priest,discipline,48,24,24
Whýççpèrx,ravencrest,1826,priest,discipline,60,33,27
Nadøney,hyjal,1826,priest,discipline,172,87,85
Nissha,stormscale,1826,priest,discipline,66,32,34
Двачх,soulflayer,1826,priest,discipline,66,32,34
Sinetrax,draenor,1825,priest,discipline,48,30,18
Асверай,howling-fjord,1825,priest,discipline,90,55,35
Theythem,stormscale,1825,priest,discipline,42,25,17
Bebydaniwey,eredar,1825,priest,discipline,48,27,21
Moglimeister,blackrock,1825,priest,discipline,72,40,32
Myggsparv,stormscale,1825,priest,discipline,72,39,33
Nothic,blackmoore,1825,priest,discipline,196,105,91
Gimeurgold,destromath,1825,priest,discipline,66,32,34
Chechenkata,ravencrest,1825,priest,discipline,57,27,30
Undeathy,ravencrest,1825,priest,discipline,60,28,32
Charlotten,shattered-hand,1825,priest,discipline,196,89,107
Yourholynes,nemesis,1824,priest,discipline,39,24,15
Ayõu,ravencrest,1824,priest,discipline,60,36,24
Src,ravencrest,1824,priest,discipline,95,54,41
Collinna,aegwynn,1824,priest,discipline,105,57,48
Kirtarah,aegwynn,1824,priest,discipline,238,124,114
Holó,stormscale,1824,priest,discipline,54,25,29
Lanata,blackrock,1823,priest,discipline,60,34,26
Мухаглот,soulflayer,1823,priest,discipline,71,37,34
Sovereignp,aegwynn,1823,priest,discipline,60,28,32
Cener,ravencrest,1822,priest,discipline,38,31,7
Imahipstaqt,eredar,1822,priest,discipline,57,32,25
Mamaa,stormscale,1822,priest,discipline,72,40,32
Tecc,draenor,1822,priest,discipline,130,65,65
Mèlindra,tarren-mill,1821,priest,discipline,35,28,7
Билет,borean-tundra,1821,priest,discipline,42,26,16
Aâraks,khaz-modan,1821,priest,discipline,134,82,52
Tribz,kargath,1821,priest,discipline,36,22,14
Traxtoor,tarren-mill,1821,priest,discipline,141,81,60
Cyabish,twisting-nether,1821,priest,discipline,263,142,121
Miklós,die-aldor,1821,priest,discipline,54,28,26
Scaryolol,blackmoore,1821,priest,discipline,161,83,78
Yamai,thrall,1820,priest,discipline,42,24,18
Holyblóod,ravencrest,1820,priest,discipline,43,23,20
Tingoess,silvermoon,1820,priest,discipline,150,75,75
Dotzey,outland,1820,priest,discipline,101,43,58
Yunusgødx,kazzak,1819,priest,discipline,102,65,37
Силесттиль,gordunni,1819,priest,discipline,77,49,28
Øk,draenor,1819,priest,discipline,125,73,52
Омилая,gordunni,1819,priest,discipline,42,24,18
Изишвд,gordunni,1819,priest,discipline,59,33,26
Дорогасмеха,howling-fjord,1819,priest,discipline,66,36,30
Felaenna,argent-dawn,1819,priest,discipline,139,75,64
Ðês,ravencrest,1819,priest,discipline,120,62,58
Ilovelily,antonidas,1819,priest,discipline,60,30,30
Vibéz,outland,1819,priest,discipline,54,27,27
Lucyx,antonidas,1818,priest,discipline,36,25,11
Jaesabøyx,twisting-nether,1818,priest,discipline,168,100,68
Kimspriest,ragnaros,1818,priest,discipline,42,24,18
Dendegodx,kazzak,1818,priest,discipline,120,64,56
Egi,lothar,1818,priest,discipline,51,27,24
Cæsífer,senjin,1818,priest,discipline,78,41,37
Monsterzx,outland,1818,priest,discipline,90,44,46
Sakulus,malganis,1818,priest,discipline,66,31,35
Spiritina,darkmoon-faire,1817,priest,discipline,76,52,24
Lovdisc,ysondre,1817,priest,discipline,54,34,20
Inhibitor,tarren-mill,1817,priest,discipline,48,29,19
Holycuddles,ysondre,1817,priest,discipline,78,47,31
Williamz,ravencrest,1817,priest,discipline,57,31,26
Ashenflexj,draenor,1817,priest,discipline,226,115,111
Ferpy,ragnaros,1817,priest,discipline,66,31,35
Chekkó,blackrock,1817,priest,discipline,77,35,42
Deadandugly,eredar,1817,priest,discipline,84,36,48
Swd,dun-morogh,1816,priest,discipline,36,23,13
Hanniri,archimonde,1816,priest,discipline,48,28,20
Aenon,argent-dawn,1816,priest,discipline,129,72,57
Fatalx,grim-batol,1816,priest,discipline,70,37,33
Saygg,ysondre,1816,priest,discipline,120,63,57
Yzïam,ravencrest,1816,priest,discipline,86,45,41
Соникида,gordunni,1816,priest,discipline,76,39,37
Nedex,thrall,1816,priest,discipline,55,28,27
Semper,sylvanas,1816,priest,discipline,52,26,26
Sebbi,ragnaros,1816,priest,discipline,60,29,31
Thaeres,stormscale,1816,priest,discipline,65,31,34
Оченьнеочень,howling-fjord,1816,priest,discipline,72,33,39
Psychout,ravencrest,1816,priest,discipline,66,30,36
Fandac,sylvanas,1815,priest,discipline,60,39,21
Jowaba,ravencrest,1815,priest,discipline,60,38,22
Milamati,kazzak,1815,priest,discipline,90,50,40
Виллавелл,blackscar,1815,priest,discipline,48,24,24
Løs,argent-dawn,1815,priest,discipline,108,53,55
Skitspill,ravencrest,1815,priest,discipline,216,104,112
Zyzx,blackrock,1815,priest,discipline,66,29,37
Menarille,kazzak,1814,priest,discipline,30,25,5
Jannejanne,ravencrest,1814,priest,discipline,30,19,11
Анстахоуп,grom,1814,priest,discipline,192,121,71
Йуп,ashenvale,1814,priest,discipline,52,32,20
Bizqit,tarren-mill,1814,priest,discipline,311,168,143
Awön,stormscale,1814,priest,discipline,58,31,27
Discusting,anachronos,1814,priest,discipline,78,40,38
Sdn,twisting-nether,1814,priest,discipline,118,60,58
Syreet,silvermoon,1814,priest,discipline,428,216,212
Mobcal,twisting-nether,1814,priest,discipline,66,28,38
Daniweyy,eredar,1813,priest,discipline,30,19,11
Dzyxx,ravencrest,1813,priest,discipline,66,37,29
Iwariel,blackmoore,1813,priest,discipline,102,55,47
Architectx,ravencrest,1813,priest,discipline,119,60,59
Dhassy,sanguino,1812,priest,discipline,71,44,27
Elataqt,silvermoon,1812,priest,discipline,91,51,40
Viiu,eredar,1812,priest,discipline,45,25,20
Eedazap,argent-dawn,1812,priest,discipline,58,32,26
Discoqt,aegwynn,1812,priest,discipline,60,30,30
Isalvation,stormscale,1812,priest,discipline,78,38,40
Drillin,ravencrest,1812,priest,discipline,75,33,42
Mïserygødx,nemesis,1811,priest,discipline,84,57,27
Maxmoto,blackrock,1811,priest,discipline,92,56,36
Антошашвп,azuregos,1811,priest,discipline,42,25,17
Cæsifer,blackrock,1811,priest,discipline,100,55,45
Leahuwu,ravencrest,1811,priest,discipline,72,37,35
Miraña,kazzak,1810,priest,discipline,24,19,5
Holyshiiet,stormscale,1810,priest,discipline,138,81,57
Indulgence,eredar,1810,priest,discipline,57,30,27
Gaussqt,ravencrest,1810,priest,discipline,120,62,58
Xrq,stormscale,1809,priest,discipline,36,27,9
Delftware,tarren-mill,1809,priest,discipline,36,27,9
Thedisco,kazzak,1809,priest,discipline,84,56,28
Abdcefgihljk,tarren-mill,1809,priest,discipline,48,27,21
Leahx,dalvengyr,1809,priest,discipline,46,25,21
Qzrx,draenor,1809,priest,discipline,84,44,40
Kuxk,stormscale,1809,priest,discipline,48,24,24
Fønss,sanguino,1809,priest,discipline,77,34,43
Stola,archimonde,1809,priest,discipline,101,41,60
Ohlinsqt,outland,1808,priest,discipline,66,36,30
Уровеньб,soulflayer,1808,priest,discipline,114,60,54
Prips,bladefist,1808,priest,discipline,223,117,106
Aòo,twisting-nether,1808,priest,discipline,95,48,47
Ellinha,tarren-mill,1808,priest,discipline,71,34,37
Aprilfalls,blackmoore,1808,priest,discipline,54,25,29
Chaxxpriest,blackrock,1808,priest,discipline,113,51,62
Ðézø,twisting-nether,1807,priest,discipline,108,71,37
Ÿolo,nemesis,1807,priest,discipline,80,47,33
Вашачесть,gordunni,1807,priest,discipline,156,84,72
Immortalled,twisting-nether,1807,priest,discipline,144,77,67
Cucurulla,sanguino,1807,priest,discipline,90,47,43
Raw,dragonblight,1807,priest,discipline,72,36,36
Seasonf,tarren-mill,1807,priest,discipline,60,28,32
Priestdos,sanguino,1806,priest,discipline,49,32,17
Hexybtw,stormscale,1806,priest,discipline,30,19,11
Zarahard,draenor,1806,priest,discipline,120,65,55
Zeruhphin,eredar,1806,priest,discipline,54,28,26
Lucksy,antonidas,1806,priest,discipline,60,31,29
Karmev,twisting-nether,1806,priest,discipline,53,26,27
Brigittë,ravencrest,1806,priest,discipline,66,29,37
Jamienism,ravencrest,1806,priest,discipline,82,33,49
Youngfade,twisting-nether,1806,priest,discipline,76,30,46
Светжрец,blackscar,1805,priest,discipline,36,26,10
Tattum,ragnaros,1805,priest,discipline,84,57,27
Артфуул,howling-fjord,1805,priest,discipline,78,43,35
Поршкаенн,gordunni,1805,priest,discipline,60,32,28
Andaar,ravencrest,1805,priest,discipline,60,32,28
Ipâ,hyjal,1805,priest,discipline,417,207,210
Jeanprêtre,ysondre,1805,priest,discipline,66,30,36
Neems,twisting-nether,1805,priest,discipline,42,19,23
Ïcön,ravencrest,1804,priest,discipline,60,43,17
Ljusmor,silvermoon,1804,priest,discipline,99,62,37
Bennyjamin,kazzak,1804,priest,discipline,74,45,29
Coldyxz,blackrock,1804,priest,discipline,48,29,19
Floyyd,kazzak,1804,priest,discipline,42,24,18
Шэдоура,gordunni,1804,priest,discipline,135,76,59
Needsboorst,ravencrest,1804,priest,discipline,66,36,30
Nooxid,eredar,1804,priest,discipline,159,86,73
Rezzdar,lightnings-blade,1804,priest,discipline,121,62,59
Remkoja,blackrock,1804,priest,discipline,102,52,50
Altruistx,ravencrest,1804,priest,discipline,78,39,39
Aêalama,argent-dawn,1804,priest,discipline,54,27,27
Chochoo,argent-dawn,1804,priest,discipline,60,25,35
Fogel,turalyon,1803,priest,discipline,96,82,14
Laonar,silvermoon,1803,priest,discipline,181,115,66
Frëija,ravencrest,1803,priest,discipline,59,37,22
Lasêr,kazzak,1803,priest,discipline,133,73,60
Kàalyx,archimonde,1803,priest,discipline,107,55,52
Lunatique,shadowsong,1803,priest,discipline,56,28,28
Gehrke,silvermoon,1803,priest,discipline,105,51,54
Hamsicam,frostwolf,1803,priest,discipline,176,83,93
Deoxx,kazzak,1803,priest,discipline,126,58,68
Ebiso,ravencrest,1803,priest,discipline,90,41,49
Assiduous,stormreaver,1802,priest,discipline,40,25,15
Ronnyvandamm,destromath,1802,priest,discipline,136,78,58
Bassepriest,tarren-mill,1802,priest,discipline,101,53,48
Enteja,outland,1802,priest,discipline,898,456,442
Jpucciù,ysondre,1802,priest,discipline,66,31,35
Cx,mazrigos,1801,priest,discipline,65,42,23
Shínx,illidan,1801,priest,discipline,90,52,38
Rabbai,twisting-nether,1801,priest,discipline,66,37,29
Батлджес,gordunni,1801,priest,discipline,54,29,25
Reckxp,twisting-nether,1801,priest,discipline,114,52,62
Зулфар,razuvious,1800,priest,discipline,48,36,12
Wardshield,ravencrest,1800,priest,discipline,29,20,9
Felwy,stormscale,1800,priest,discipline,48,31,17
Hasnoaim,dun-morogh,1800,priest,discipline,66,41,25
Doublefreak,draenor,1800,priest,discipline,78,48,30
Soziy,silvermoon,1800,priest,discipline,33,19,14
Wóllo,stormscale,1800,priest,discipline,66,36,30
Mautiya,blackrock,1800,priest,discipline,96,52,44
Mpßx,tarren-mill,1800,priest,discipline,39,21,18
Enzineum,twisting-nether,1800,priest,discipline,54,28,26
Zuniqa,die-aldor,1800,priest,discipline,221,112,109
Cätälin,twisting-nether,1800,priest,discipline,386,195,191
Некрогуро,gordunni,1800,priest,discipline,54,27,27
Mafakor,ravencrest,1800,priest,discipline,357,176,181
Lazyx,tarren-mill,1800,priest,discipline,59,29,30
Mcdodgens,auchindoun,1800,priest,discipline,233,112,121
Stahpit,twisting-nether,1800,priest,discipline,65,31,34
Gothicpriest,blackrock,1799,priest,discipline,54,34,20
Discisiipeli,sylvanas,1799,priest,discipline,72,42,30
Prsx,ravencrest,1799,priest,discipline,126,63,63
Cnqz,archimonde,1799,priest,discipline,78,36,42
Jâde,bloodhoof,1798,priest,discipline,189,92,97
Фенджидисплх,blackscar,1798,priest,discipline,114,54,60
Dokwhite,blackrock,1797,priest,discipline,41,20,21
Sùzy,ravencrest,1797,priest,discipline,72,30,42
Alessana,antonidas,1796,priest,discipline,47,30,17
Georgesheenx,ravencrest,1796,priest,discipline,190,90,100
Seankingkong,ravencrest,1795,priest,discipline,37,23,14
Siezlababo,blackrock,1795,priest,discipline,35,21,14
Bigballer,stormscale,1795,priest,discipline,51,26,25
Bandulskii,twisting-nether,1795,priest,discipline,409,205,204
Sosûke,archimonde,1794,priest,discipline,54,33,21
Keijunâ,ravencrest,1794,priest,discipline,41,21,20
Nàlak,archimonde,1793,priest,discipline,72,34,38
Сайдвиндер,blackscar,1792,priest,discipline,115,59,56
Racecar,executus,1792,priest,discipline,144,71,73
Ihefyehvjrm,ravencrest,1792,priest,discipline,113,55,58
Lolylights,tarren-mill,1791,priest,discipline,216,109,107
Owrly,bladefist,1789,priest,discipline,178,89,89
Phyxiusx,stormscale,1788,priest,discipline,96,53,43
Drillinx,tarren-mill,1788,priest,discipline,66,32,34
Hopesallgone,stormscale,1787,priest,discipline,96,58,38
Amtoxic,stormscale,1786,priest,discipline,467,239,228
Alicanx,silvermoon,1785,priest,discipline,129,78,51
Holyholy,stormscale,1784,priest,discipline,60,40,20
Talbyslegacý,blackmoore,1784,priest,discipline,108,60,48
Ssjfoxyo,sylvanas,1783,priest,discipline,119,57,62
Maikzky,stormreaver,1780,priest,discipline,36,19,17
Zèl,blackmoore,1780,priest,discipline,52,26,26
Emryth,blackhand,1779,priest,discipline,294,152,142
Trickyteè,tarren-mill,1779,priest,discipline,42,19,23
Mindx,sylvanas,1777,priest,discipline,191,98,93
Eliana,blackrock,1777,priest,discipline,151,77,74
Stormmyy,kazzak,1777,priest,discipline,42,21,21
Alexsmite,twisting-nether,1777,priest,discipline,41,19,22
Lakeworth,argent-dawn,1776,priest,discipline,134,61,73
Mndvx,sylvanas,1775,priest,discipline,140,70,70
Tanly,outland,1774,priest,discipline,102,45,57
Vespbruv,kazzak,1773,priest,discipline,36,25,11
Wodpriest,ravencrest,1772,priest,discipline,30,20,10
Hellhammer,stormreaver,1772,priest,discipline,154,82,72
Андерприст,soulflayer,1772,priest,discipline,180,93,87
Отклонен,soulflayer,1772,priest,discipline,66,32,34
Tiphereth,blackmoore,1772,priest,discipline,48,23,25
Gajos,frostwolf,1771,priest,discipline,108,63,45
Леддигага,gordunni,1769,priest,discipline,48,27,21
Ironqt,malfurion,1769,priest,discipline,136,61,75
Jaytï,ravencrest,1766,priest,discipline,42,26,16
Øpra,nemesis,1766,priest,discipline,60,31,29
Magetrainer,tarren-mill,1765,priest,discipline,60,42,18
Denunciation,argent-dawn,1765,priest,discipline,215,115,100
Ohiofromntty,ravencrest,1764,priest,discipline,24,20,4
Hyw,hyjal,1764,priest,discipline,39,22,17
Swkunz,dun-modr,1764,priest,discipline,142,69,73
Nameit,eredar,1763,priest,discipline,194,91,103
Aridarpriest,silvermoon,1762,priest,discipline,86,37,49
Aruna,ravencrest,1761,priest,discipline,70,35,35
Ladderpolice,blackmoore,1761,priest,discipline,54,26,28
Justdänce,hyjal,1760,priest,discipline,52,25,27
Susaj,tarren-mill,1759,priest,discipline,41,23,18
Spaanseslof,silvermoon,1759,priest,discipline,174,82,92
Muncett,dun-modr,1758,priest,discipline,83,50,33
Filthyzx,argent-dawn,1758,priest,discipline,54,27,27
Legiondisc,blackmoore,1758,priest,discipline,157,71,86
Rogeron,blackrock,1758,priest,discipline,100,45,55
Aelisendi,draenor,1757,priest,discipline,83,46,37
Sekker,silvermoon,1757,priest,discipline,303,161,142
Bunnydisc,outland,1757,priest,discipline,77,37,40
Mgx,defias-brotherhood,1756,priest,discipline,54,25,29
Шкурюклады,gordunni,1756,priest,discipline,90,40,50
Roshmanoff,stormscale,1755,priest,discipline,54,27,27
Brilho,frostmane,1755,priest,discipline,183,90,93
Dreifearfünf,arygos,1754,priest,discipline,90,50,40
Duelistfied,blackrock,1754,priest,discipline,50,24,26
Кирюшасэмпай,gordunni,1753,priest,discipline,117,63,54
Khristo,illidan,1753,priest,discipline,84,36,48
Dès,ravencrest,1752,priest,discipline,165,80,85
ßçøûzýìñ,ravencrest,1751,priest,discipline,28,21,7
Merylle,outland,1751,priest,discipline,41,27,14
Jempi,argent-dawn,1751,priest,discipline,141,84,57
Destinychild,norgannon,1751,priest,discipline,64,34,30
Kîlo,sylvanas,1750,priest,discipline,42,19,23
Ytsal,stormscale,1750,priest,discipline,60,24,36
Isuckmattsd,aggramar,1749,priest,discipline,30,21,9
Uo,kilrogg,1749,priest,discipline,128,73,55
Healêl,sanguino,1749,priest,discipline,81,40,41
Sdlman,nemesis,1749,priest,discipline,60,29,31
Таравера,soulflayer,1748,priest,discipline,125,60,65
Iloveilka,madmortem,1747,priest,discipline,29,19,10
Holyblóod,kazzak,1747,priest,discipline,56,34,22
Pikaboom,the-maelstrom,1747,priest,discipline,48,27,21
Дъикиймвп,deepholm,1747,priest,discipline,48,24,24
Kèvin,das-syndikat,1746,priest,discipline,89,54,35
Devoura,sylvanas,1746,priest,discipline,48,23,25
Mystz,dun-modr,1744,priest,discipline,63,34,29
Rippertmepls,ravencrest,1744,priest,discipline,101,52,49
Rngamer,silvermoon,1743,priest,discipline,30,23,7
Ampara,thrall,1743,priest,discipline,102,52,50
Ðårkìnlol,ravencrest,1741,priest,discipline,23,19,4
Eliriya,thrall,1741,priest,discipline,290,148,142
Alpháømegá,outland,1741,priest,discipline,88,40,48
Abømination,hyjal,1740,priest,discipline,123,69,54
Tricavla,frostmane,1740,priest,discipline,108,59,49
Holytop,aegwynn,1740,priest,discipline,48,25,23
Øxxgodx,blackrock,1740,priest,discipline,87,43,44
Pâww,kazzak,1740,priest,discipline,54,26,28
Savta,ravencrest,1740,priest,discipline,42,19,23
Xeldrania,azshara,1739,priest,discipline,41,22,19
Darktemplarx,magtheridon,1739,priest,discipline,165,83,82
Lyrina,twisting-nether,1738,priest,discipline,364,199,165
Ostrogami,silvermoon,1738,priest,discipline,525,255,270
Massbimba,tarren-mill,1737,priest,discipline,289,161,128
Антошашвп,gordunni,1737,priest,discipline,48,25,23
Zërøx,ysondre,1737,priest,discipline,95,39,56
Twizl,hyjal,1736,priest,discipline,90,47,43
Holyasprin,sylvanas,1735,priest,discipline,72,44,28
Фокусшвд,soulflayer,1735,priest,discipline,132,68,64
Sydnex,blackmoore,1734,priest,discipline,77,45,32
Sausageboy,tarren-mill,1734,priest,discipline,54,30,24
Mommymilkrx,argent-dawn,1734,priest,discipline,251,125,126
Spatzdom,malygos,1734,priest,discipline,53,25,28
Aetas,hyjal,1732,priest,discipline,72,41,31
Pieceoftrash,stormscale,1731,priest,discipline,77,42,35
Lilypalmer,stormscale,1731,priest,discipline,72,36,36
Jøjmenejøj,ravencrest,1731,priest,discipline,150,73,77
Vigoria,stormreaver,1731,priest,discipline,101,49,52
Tÿona,hyjal,1730,priest,discipline,176,101,75
Mitha,tarren-mill,1730,priest,discipline,80,45,35
Lobbygriefer,ravencrest,1730,priest,discipline,436,231,205
Preme,blackhand,1730,priest,discipline,72,34,38
Snuskong,kazzak,1730,priest,discipline,54,25,29
Mamabeer,draenor,1727,priest,discipline,150,91,59
Teradros,blackhand,1727,priest,discipline,53,28,25
Pristern,tarren-mill,1727,priest,discipline,68,34,34
Nihpolz,ragnaros,1726,priest,discipline,105,59,46
Darkshdwbrst,malorne,1726,priest,discipline,271,148,123
Zwu,antonidas,1726,priest,discipline,70,38,32
Zoophobîa,stormscale,1726,priest,discipline,78,42,36
Namîxoxo,ysondre,1726,priest,discipline,66,33,33
Cedifanboyx,archimonde,1726,priest,discipline,66,33,33
Gailiugà,kazzak,1725,priest,discipline,40,26,14
Savagex,dun-modr,1725,priest,discipline,256,136,120
Akzar,blackrock,1725,priest,discipline,450,230,220
Roylian,ravencrest,1725,priest,discipline,45,23,22
Noviriel,argent-dawn,1725,priest,discipline,94,47,47
Felvytwo,stormscale,1725,priest,discipline,48,24,24
Hoses,twisting-nether,1725,priest,discipline,211,104,107
Keypo,khaz-modan,1725,priest,discipline,59,26,33
Ranchikswp,ravencrest,1724,priest,discipline,30,18,12
Rytmusqt,outland,1724,priest,discipline,42,20,22
Lucìanà,blackmoore,1723,priest,discipline,30,18,12
Mentaldeadp,draenor,1723,priest,discipline,147,88,59
Paterfisl,ragnaros,1723,priest,discipline,72,41,31
Alexpriest,twisting-nether,1723,priest,discipline,513,266,247
Rickerstrike,stormscale,1723,priest,discipline,143,71,72
Аскеронх,howling-fjord,1723,priest,discipline,87,41,46
Xians,alakir,1722,priest,discipline,30,18,12
Leåh,ravencrest,1722,priest,discipline,48,28,20
Naivah,dun-modr,1722,priest,discipline,127,68,59
Plsdontcry,blackrock,1722,priest,discipline,54,27,27
Duqes,stormreaver,1721,priest,discipline,45,33,12
Skevitche,hyjal,1721,priest,discipline,208,108,100
Neliica,silvermoon,1721,priest,discipline,90,37,53
Gwinzy,blackmoore,1720,priest,discipline,36,22,14
Legitha,blackmoore,1720,priest,discipline,45,26,19
Folelli,ysondre,1720,priest,discipline,113,58,55
Utrd,kazzak,1720,priest,discipline,251,119,132
Pinipom,kazzak,1719,priest,discipline,38,26,12
Leffie,outland,1719,priest,discipline,51,26,25
Cctw,archimonde,1718,priest,discipline,90,46,44
Kekkonh,sylvanas,1718,priest,discipline,47,23,24
Spodermen,ravencrest,1718,priest,discipline,54,25,29
Holymoly,talnivarr,1718,priest,discipline,120,55,65
Shdwxy,blackrock,1717,priest,discipline,90,53,37
Milchzáhn,frostwolf,1717,priest,discipline,74,38,36
Touddixz,blackrock,1716,priest,discipline,30,19,11
Fuzzymerge,ravencrest,1716,priest,discipline,76,42,34
Spìrít,ghostlands,1716,priest,discipline,48,24,24
Smiteyoudown,blackrock,1716,priest,discipline,42,21,21
Looney,shadowsong,1715,priest,discipline,36,25,11
Pehmoinen,korgall,1715,priest,discipline,147,75,72
Pestmorran,sylvanas,1715,priest,discipline,318,153,165
Holysjodin,tarren-mill,1714,priest,discipline,36,18,18
Zeröone,silvermoon,1714,priest,discipline,101,44,57
Lowhealing,kazzak,1713,priest,discipline,48,29,19
Lerdameur,arakarahm,1712,priest,discipline,155,78,77
Baptized,baelgun,1712,priest,discipline,102,47,55
Hannirï,archimonde,1711,priest,discipline,89,62,27
Holyarnold,silvermoon,1710,priest,discipline,155,70,85
Ðarkan,kaelthas,1709,priest,discipline,132,76,56
Furtnajebany,tarren-mill,1709,priest,discipline,63,29,34
Trashpriest,blackrock,1708,priest,discipline,47,19,28
Kijhun,uldaman,1707,priest,discipline,72,40,32
Bengtas,ravencrest,1707,priest,discipline,194,93,101
Obie,exodar,1707,priest,discipline,46,19,27
Scarylol,blackmoore,1706,priest,discipline,30,18,12
Irefutåbil,stormscale,1706,priest,discipline,120,70,50
Nyxoqtxd,ravencrest,1706,priest,discipline,94,54,40
Uivi,azjolnerub,1706,priest,discipline,42,22,20
Scarified,aggramar,1706,priest,discipline,72,36,36
Patriamore,jaedenar,1706,priest,discipline,64,30,34
Syntaria,pozzo-delleternità,1705,priest,discipline,48,28,20
Finiskram,sylvanas,1705,priest,discipline,42,24,18
Targolina,argent-dawn,1705,priest,discipline,417,214,203
Fulgus,sanguino,1705,priest,discipline,254,127,127
Krematorio,twisting-nether,1705,priest,discipline,36,18,18
Yukasa,silvermoon,1705,priest,discipline,78,34,44
Covidisc,outland,1705,priest,discipline,60,26,34
Kaldhor,ysondre,1705,priest,discipline,71,29,42
Sokratina,ragnaros,1704,priest,discipline,88,58,30
Splf,blackrock,1704,priest,discipline,90,56,34
Dállas,ravencrest,1704,priest,discipline,72,41,31
Pleadz,tarren-mill,1704,priest,discipline,54,25,29
Babibayle,arakarahm,1704,priest,discipline,60,24,36
Lîke,shattrath,1703,priest,discipline,36,18,18
Убикрофт,soulflayer,1703,priest,discipline,49,24,25
Calling,nozdormu,1702,priest,discipline,65,37,28
Bockx,ragnaros,1702,priest,discipline,66,27,39
Anotu,tarren-mill,1701,priest,discipline,48,28,20
Bekznfiend,ragnaros,1701,priest,discipline,48,22,26
Noxr,ravencrest,1701,priest,discipline,68,28,40
Kapts,twisting-nether,1700,priest,discipline,30,18,12
Healbotmvp,ravencrest,1700,priest,discipline,42,24,18
Nimb,blackrock,1700,priest,discipline,66,33,33
Ðeep,archimonde,1700,priest,discipline,48,23,25
Roxeal,archimonde,1699,priest,discipline,210,115,95
Naphell,outland,1699,priest,discipline,108,54,54
Nancey,draenor,1699,priest,discipline,36,18,18
Verjin,kazzak,1699,priest,discipline,90,36,54
Sîena,ravencrest,1698,priest,discipline,36,27,9
Reticlel,kazzak,1698,priest,discipline,140,80,60
Shieldyman,silvermoon,1698,priest,discipline,48,25,23
Jämar,archimonde,1698,priest,discipline,60,29,31
Закс,blackscar,1698,priest,discipline,48,22,26
Dqt,ragnaros,1698,priest,discipline,71,31,40
Areyqt,ravencrest,1697,priest,discipline,36,22,14
Gòldfinger,norgannon,1697,priest,discipline,162,76,86
Døppëlápfèl,tarren-mill,1696,priest,discipline,30,20,10
Kahir,ravencrest,1696,priest,discipline,98,52,46
Ssjx,ravencrest,1696,priest,discipline,48,25,23
Kolinamenuss,dun-morogh,1696,priest,discipline,60,27,33
Cptisus,draenor,1696,priest,discipline,72,31,41
Mixoo,throkferoth,1696,priest,discipline,95,40,55
Luckystar,grim-batol,1695,priest,discipline,102,54,48
Fizzy,arthas,1695,priest,discipline,82,42,40
Mezan,tarren-mill,1695,priest,discipline,71,36,35
Swdommeil,aegwynn,1695,priest,discipline,48,24,24
Mcdeady,tarren-mill,1695,priest,discipline,72,34,38
Эвэргарден,eversong,1695,priest,discipline,108,45,63
Mopriest,eredar,1694,priest,discipline,56,36,20
Seemedotin,aegwynn,1694,priest,discipline,41,23,18
Flào,draenor,1694,priest,discipline,42,20,22
Angrypiex,stormscale,1694,priest,discipline,83,38,45
Luxør,blackrock,1694,priest,discipline,42,18,24
Arlekin,ravencrest,1693,priest,discipline,114,70,44
Kyderr,blackrock,1693,priest,discipline,108,59,49
Windywendy,blackrock,1693,priest,discipline,141,75,66
Karanas,archimonde,1693,priest,discipline,66,34,32
Сонясоукьют,gordunni,1693,priest,discipline,54,26,28
Samaya,blackrock,1693,priest,discipline,147,68,79
Yroe,gorgonnash,1693,priest,discipline,48,22,26
Verweven,twisting-nether,1692,priest,discipline,47,26,21
Kavrack,dalaran,1692,priest,discipline,41,22,19
Pierrebourne,blackmoore,1692,priest,discipline,48,23,25
Шаастраха,gordunni,1692,priest,discipline,97,44,53
Rainbowroll,kazzak,1692,priest,discipline,52,23,29
Xulgarath,silvermoon,1691,priest,discipline,52,35,17
Shadowlander,dun-modr,1691,priest,discipline,87,46,41
Nidetha,draenor,1691,priest,discipline,42,18,24
Ayoutbt,ravencrest,1690,priest,discipline,48,24,24
Lexìì,archimonde,1690,priest,discipline,36,18,18
Alsalty,stormscale,1690,priest,discipline,65,26,39
Шестьнадцать,gordunni,1689,priest,discipline,107,60,47
Pixe,argent-dawn,1689,priest,discipline,66,27,39
Eagrh,ravencrest,1688,priest,discipline,328,185,143
Wérrýxs,kazzak,1688,priest,discipline,148,83,65
Афганский,gordunni,1688,priest,discipline,46,24,22
Прристуха,gordunni,1688,priest,discipline,66,27,39
Hrtbrxkn,ravencrest,1687,priest,discipline,64,39,25
Voidbone,stormscale,1687,priest,discipline,42,22,20
Berseenreikä,the-venture-co,1687,priest,discipline,60,29,31
Dorkama,silvermoon,1686,priest,discipline,30,18,12
Kuraimb,the-maelstrom,1686,priest,discipline,81,38,43
Dispelgodxx,eredar,1686,priest,discipline,60,27,33
Zychopriest,antonidas,1686,priest,discipline,48,21,27
Freddyprinze,ravencrest,1685,priest,discipline,87,50,37
Seherbazqt,twisting-nether,1685,priest,discipline,177,90,87
Wiguwigu,blackrock,1685,priest,discipline,66,26,40
Mantra,blackmoore,1684,priest,discipline,294,146,148
Hinorist,kazzak,1684,priest,discipline,154,74,80
Traicklebron,antonidas,1683,priest,discipline,33,21,12
Tabaç,stormscale,1683,priest,discipline,42,26,16
Zzbleh,stormscale,1683,priest,discipline,96,53,43
Пристижнаяя,gordunni,1683,priest,discipline,99,52,47
Barackomana,blackrock,1683,priest,discipline,120,56,64
Oscoolytb,archimonde,1683,priest,discipline,138,63,75
Mythrixia,draenor,1682,priest,discipline,99,54,45
Efeslol,dun-modr,1682,priest,discipline,214,107,107
Doorix,nethersturm,1682,priest,discipline,68,31,37
Prc,stormscale,1681,priest,discipline,60,41,19
Jumpàxx,archimonde,1681,priest,discipline,48,22,26
Blâdéira,ravencrest,1681,priest,discipline,141,64,77
Marôs,antonidas,1681,priest,discipline,60,26,34
Donipriest,ravencrest,1680,priest,discipline,72,42,30
Deathgodx,archimonde,1680,priest,discipline,154,85,69
Артжрец,soulflayer,1680,priest,discipline,82,45,37
Swdommeil,blackrock,1680,priest,discipline,36,19,17
Sheeash,kazzak,1679,priest,discipline,36,18,18
Grouptherpst,draenor,1679,priest,discipline,294,141,153
ßrûm,archimonde,1679,priest,discipline,48,23,25
Goodra,sylvanas,1678,priest,discipline,36,23,13
Junglemafia,nemesis,1678,priest,discipline,42,24,18
Céira,malganis,1678,priest,discipline,42,23,19
Anheduanna,outland,1678,priest,discipline,925,462,463
Sloee,kazzak,1677,priest,discipline,42,24,18
Майти,gordunni,1677,priest,discipline,172,98,74
Assacine,aegwynn,1677,priest,discipline,65,35,30
Шайтсунг,soulflayer,1677,priest,discipline,56,30,26
Приствалера,howling-fjord,1677,priest,discipline,407,204,203
Necronidas,burning-legion,1676,priest,discipline,97,53,44
Clownspec,twisting-nether,1676,priest,discipline,54,26,28
Holytopp,aegwynn,1675,priest,discipline,42,25,17
Glyss,draenor,1675,priest,discipline,72,40,32
Aloegarten,ravencrest,1675,priest,discipline,83,40,43
Scarletstory,ravencrest,1675,priest,discipline,148,70,78
Саммерфинн,gordunni,1675,priest,discipline,46,20,26
Apuessii,dun-modr,1675,priest,discipline,83,36,47
Файкахохо,soulflayer,1675,priest,discipline,59,24,35
Kaksel,blackrock,1674,priest,discipline,120,62,58
Meltmvp,thrall,1674,priest,discipline,66,33,33
Уэйнестелл,booty-bay,1674,priest,discipline,54,24,30
Geforcès,archimonde,1674,priest,discipline,113,45,68
Разрухаовнз,gordunni,1673,priest,discipline,36,22,14
Forcedtoheal,sylvanas,1673,priest,discipline,85,51,34
Mèix,ysondre,1673,priest,discipline,72,42,30
Scurrp,aegwynn,1673,priest,discipline,72,36,36
Lorimac,dun-modr,1673,priest,discipline,195,97,98
Awcute,kazzak,1673,priest,discipline,370,181,189
Xianstwo,alakir,1673,priest,discipline,54,24,30
Tmnetwo,ravencrest,1673,priest,discipline,42,18,24
Ggbenis,ragnaros,1672,priest,discipline,42,23,19
Devotedape,draenor,1672,priest,discipline,83,45,38
Byef,kazzak,1671,priest,discipline,56,31,25
Kæzm,blackrock,1671,priest,discipline,77,42,35
Finalprayer,silvermoon,1670,priest,discipline,53,38,15
Swoptoplong,blackhand,1670,priest,discipline,503,263,240
Mysticmäc,aegwynn,1670,priest,discipline,66,33,33
Сосиска,deathguard,1670,priest,discipline,41,20,21
Csúforck,ragnaros,1669,priest,discipline,48,26,22
Cestrial,sylvanas,1669,priest,discipline,104,55,49
Psjk,blackrock,1669,priest,discipline,100,51,49
Anbish,burning-legion,1668,priest,discipline,200,113,87
Cultaken,kazzak,1668,priest,discipline,82,45,37
Pokahonta,silvermoon,1668,priest,discipline,249,131,118
Títarie,aegwynn,1668,priest,discipline,42,22,20
Bilbobanging,aggramar,1668,priest,discipline,54,27,27
Sologrifer,sylvanas,1668,priest,discipline,39,19,20
Jarvinia,blackmoore,1668,priest,discipline,58,28,30
Zzoska,burning-legion,1668,priest,discipline,83,40,43
Lindvorm,tarren-mill,1667,priest,discipline,120,61,59
Toxp,kazzak,1667,priest,discipline,178,85,93
Hadis,tarren-mill,1667,priest,discipline,108,49,59
Kevokko,silvermoon,1667,priest,discipline,54,23,31
Maerlene,nemesis,1667,priest,discipline,74,31,43
Blerd,eredar,1666,priest,discipline,46,27,19
Мэдсанван,howling-fjord,1666,priest,discipline,209,116,93
Kollis,twilights-hammer,1666,priest,discipline,243,123,120
Coqa,blackrock,1666,priest,discipline,42,21,21
Salvatíon,sanguino,1666,priest,discipline,236,105,131
Plåtpriest,twisting-nether,1665,priest,discipline,46,35,11
Trntypr,senjin,1665,priest,discipline,84,48,36
Rêstlêss,blackrock,1665,priest,discipline,89,46,43
Obbdasknob,ravencrest,1665,priest,discipline,100,51,49
Tepevelf,dun-modr,1665,priest,discipline,324,156,168
Азмоддан,azuregos,1665,priest,discipline,95,42,53
Fsnx,sylvanas,1664,priest,discipline,40,26,14
Gehrketwo,silvermoon,1664,priest,discipline,42,24,18
Abudhabi,blackhand,1664,priest,discipline,409,206,203
Yro,gorgonnash,1664,priest,discipline,54,24,30
Фруктовыйса,gordunni,1663,priest,discipline,44,26,18
Lymhk,blackrock,1663,priest,discipline,48,24,24
Sinnestrike,tarren-mill,1663,priest,discipline,46,22,24
Elsieexø,ravencrest,1663,priest,discipline,102,47,55
Alahkazam,alakir,1663,priest,discipline,56,24,32
Fäke,dunemaul,1662,priest,discipline,179,105,74
Sikaanyo,blackhand,1662,priest,discipline,72,38,34
Raesd,argent-dawn,1662,priest,discipline,82,42,40
Dìsclol,draenor,1662,priest,discipline,55,28,27
Enzysama,sanguino,1662,priest,discipline,91,45,46
Ислейн,howling-fjord,1662,priest,discipline,59,24,35
Twirlylocks,emerald-dream,1662,priest,discipline,47,18,29
Malapriest,dalaran,1661,priest,discipline,66,38,28
Syntara,twisting-nether,1661,priest,discipline,424,223,201
Lethalhealz,outland,1661,priest,discipline,330,171,159
Бонзайка,blackscar,1660,priest,discipline,53,25,28
Алеброн,gordunni,1660,priest,discipline,54,25,29
Wikpriest,ravencrest,1660,priest,discipline,58,26,32
Ascendedpwnz,silvermoon,1659,priest,discipline,30,20,10
Priewyn,ragnaros,1659,priest,discipline,299,156,143
Krystynal,archimonde,1659,priest,discipline,47,24,23
Xzep,archimonde,1659,priest,discipline,422,208,214
Жентельмен,deathguard,1659,priest,discipline,96,41,55
Менестрели,gordunni,1658,priest,discipline,303,172,131
Athelsta,alleria,1658,priest,discipline,93,51,42
Seranà,hyjal,1658,priest,discipline,96,51,45
Yugemilkers,kazzak,1658,priest,discipline,131,66,65
Pepeflex,draenor,1658,priest,discipline,119,59,60
Ew,shattered-halls,1658,priest,discipline,58,26,32
Phamy,antonidas,1657,priest,discipline,53,30,23
Krottus,antonidas,1657,priest,discipline,53,28,25
Krokkete,archimonde,1657,priest,discipline,36,19,17
Вакариия,soulflayer,1657,priest,discipline,35,18,17
Nocdsusage,draenor,1657,priest,discipline,214,107,107
Gød,magtheridon,1657,priest,discipline,197,97,100
Virdeo,aegwynn,1657,priest,discipline,54,26,28
Notnowelf,silvermoon,1657,priest,discipline,54,22,32
Splís,ravencrest,1657,priest,discipline,65,24,41
Nyrziâ,archimonde,1656,priest,discipline,36,23,13
Valadaris,outland,1656,priest,discipline,114,61,53
Mald,ravencrest,1656,priest,discipline,108,57,51
Niagarafalls,ragnaros,1656,priest,discipline,135,71,64
Violentha,kazzak,1656,priest,discipline,232,118,114
Healdeal,stormscale,1656,priest,discipline,280,140,140
Drë,daggerspine,1656,priest,discipline,41,20,21
Obnoxious,sunstrider,1656,priest,discipline,174,84,90
Kaleycuoco,blackrock,1656,priest,discipline,78,36,42
Wonderdispel,ragnaros,1656,priest,discipline,83,34,49
Zsg,draenor,1655,priest,discipline,78,46,32
Йефа,gordunni,1655,priest,discipline,60,32,28
Beabanane,aegwynn,1655,priest,discipline,179,93,86
Gurgaue,argent-dawn,1655,priest,discipline,94,42,52
Фалд,gordunni,1654,priest,discipline,42,21,21
Wasnezov,blackhand,1654,priest,discipline,82,39,43
Prästmåns,tarren-mill,1654,priest,discipline,102,48,54
Hexonite,burning-legion,1653,priest,discipline,42,25,17
Bebwaz,kazzak,1653,priest,discipline,141,76,65
Kavrack,sargeras,1653,priest,discipline,42,22,20
Lowery,argent-dawn,1653,priest,discipline,48,22,26
Zaak,kazzak,1653,priest,discipline,71,31,40
Sutenör,kazzak,1653,priest,discipline,162,69,93
Tygstycke,tarren-mill,1652,priest,discipline,24,18,6
Nexìan,ravencrest,1652,priest,discipline,54,28,26
Ðiiez,ysondre,1652,priest,discipline,85,40,45
Tryhàrdx,stormscale,1652,priest,discipline,54,25,29
Blackbertha,ravencrest,1652,priest,discipline,144,66,78
Danina,outland,1651,priest,discipline,76,44,32
Alesthion,silvermoon,1651,priest,discipline,110,62,48
Danucd,ragnaros,1650,priest,discipline,206,124,82
Неох,gordunni,1650,priest,discipline,54,29,25
Pilgram,twilights-hammer,1650,priest,discipline,47,25,22
Анклфрост,gordunni,1650,priest,discipline,54,24,30
Dathanosp,outland,1649,priest,discipline,48,25,23
Элишана,deathguard,1649,priest,discipline,111,54,57
Chèéks,kazzak,1648,priest,discipline,72,43,29
Gravebrain,draenor,1648,priest,discipline,226,112,114
Пустотность,gordunni,1648,priest,discipline,351,172,179
Joeelz,blackmoore,1647,priest,discipline,36,25,11
Ðæððÿsgïrl,ravencrest,1647,priest,discipline,171,89,82
Ahpøual,archimonde,1647,priest,discipline,180,89,91
Sills,twisting-nether,1647,priest,discipline,53,23,30
Følísh,hyjal,1646,priest,discipline,54,38,16
Strawhât,eredar,1646,priest,discipline,53,31,22
Tøxicboy,ravencrest,1646,priest,discipline,89,48,41
Watchmedark,ravencrest,1646,priest,discipline,42,21,21
Urizal,defias-brotherhood,1646,priest,discipline,36,18,18
Yungblessing,stormscale,1646,priest,discipline,42,20,22
Yzina,archimonde,1646,priest,discipline,48,21,27
Drée,hyjal,1645,priest,discipline,48,24,24
Qpapi,quelthalas,1645,priest,discipline,36,18,18
Zyrean,bronzebeard,1645,priest,discipline,52,25,27
Gødisc,blackrock,1644,priest,discipline,36,23,13
Smitemachine,ysondre,1644,priest,discipline,33,19,14
Rmt,darksorrow,1644,priest,discipline,42,23,19
Feedergodx,dun-modr,1644,priest,discipline,42,21,21
Vardogz,tirion,1644,priest,discipline,95,44,51
Élsias,blackmoore,1644,priest,discipline,48,22,26
Эридия,soulflayer,1643,priest,discipline,84,43,41
Hwren,auchindoun,1643,priest,discipline,146,66,80
Нед,greymane,1642,priest,discipline,297,160,137
Shadowbread,tarren-mill,1642,priest,discipline,90,47,43
Тыкофка,gordunni,1642,priest,discipline,224,108,116
Cinnamoroll,ravencrest,1642,priest,discipline,54,26,28
Kuqezi,archimonde,1641,priest,discipline,96,53,43
Dyliz,stormscale,1641,priest,discipline,340,176,164
Репабликуес,gordunni,1641,priest,discipline,36,18,18
Babybeyle,arakarahm,1641,priest,discipline,107,48,59
Xtracheesy,ragnaros,1640,priest,discipline,72,45,27
Fluvnidi,ravencrest,1640,priest,discipline,66,38,28
Prästbaazil,ragnaros,1640,priest,discipline,72,40,32
Azrella,ravencrest,1640,priest,discipline,48,25,23
Phucme,deathwing,1640,priest,discipline,54,23,31
Cvp,twisting-nether,1640,priest,discipline,54,22,32
Pentøs,archimonde,1639,priest,discipline,32,18,14
Dapope,drakthul,1639,priest,discipline,47,20,27
Vigodis,alleria,1638,priest,discipline,150,83,67
Slimcharles,ravencrest,1638,priest,discipline,219,116,103
Eliverax,outland,1638,priest,discipline,122,58,64
Waaqa,outland,1638,priest,discipline,116,52,64
Zanshin,ravencrest,1637,priest,discipline,29,18,11
Painxd,stormscale,1637,priest,discipline,57,34,23
Tuitio,blackmoore,1637,priest,discipline,83,46,37
Discih,ragnaros,1637,priest,discipline,51,25,26
Schlämpie,blackmoore,1637,priest,discipline,73,32,41
Randmbare,nemesis,1636,priest,discipline,36,21,15
Gepeitschter,frostwolf,1636,priest,discipline,250,130,120
Voidtouched,drakthul,1636,priest,discipline,41,21,20
Ванальная,soulflayer,1636,priest,discipline,42,21,21
Milania,ravencrest,1636,priest,discipline,118,57,61
Mohammedx,tarren-mill,1636,priest,discipline,125,58,67
Klugzy,silvermoon,1636,priest,discipline,60,22,38
Nintendó,sylvanas,1635,priest,discipline,90,46,44
Yûnalescá,blackmoore,1634,priest,discipline,82,44,38
Eluveitieq,kazzak,1634,priest,discipline,166,87,79
Аая,blackscar,1634,priest,discipline,96,49,47
Wraithtrippz,stormscale,1634,priest,discipline,210,105,105
Echonic,aegwynn,1634,priest,discipline,231,113,118
Emopunkgodx,draenor,1633,priest,discipline,94,58,36
Sickboy,nordrassil,1633,priest,discipline,46,26,20
Eyecry,sylvanas,1633,priest,discipline,93,49,44
Giggí,malganis,1633,priest,discipline,95,48,47
Anzee,tarren-mill,1633,priest,discipline,72,35,37
Acidrops,hyjal,1633,priest,discipline,54,25,29
Yameru,stormreaver,1633,priest,discipline,60,22,38
Misántropo,dun-modr,1632,priest,discipline,59,38,21
Симпоз,howling-fjord,1632,priest,discipline,92,44,48
Yungmazikeen,archimonde,1631,priest,discipline,24,17,7
Babywayn,onyxia,1631,priest,discipline,194,105,89
Uppiediscyo,ravencrest,1631,priest,discipline,545,282,263
Nooway,kazzak,1631,priest,discipline,108,55,53
Snutz,draenor,1631,priest,discipline,42,21,21
Ankus,tarren-mill,1631,priest,discipline,48,23,25
Freezeage,stormscale,1630,priest,discipline,48,29,19
Elvibeast,twisting-nether,1630,priest,discipline,42,21,21
Choron,kult-der-verdammten,1630,priest,discipline,107,50,57
Burnesenbois,chogall,1630,priest,discipline,47,18,29
Лютаяшиза,gordunni,1629,priest,discipline,83,51,32
Kolinamenus,dun-morogh,1629,priest,discipline,142,73,69
Onaltnoqs,silvermoon,1629,priest,discipline,46,22,24
Frojka,outland,1629,priest,discipline,42,19,23
Superdude,stormscale,1629,priest,discipline,59,26,33
Japral,blackhand,1628,priest,discipline,36,25,11
Reäzx,archimonde,1628,priest,discipline,90,57,33
Réquell,twisting-nether,1628,priest,discipline,42,24,18
Såra,ravencrest,1628,priest,discipline,110,53,57
Leviakerman,blackrock,1628,priest,discipline,42,18,24
Estelle,silvermoon,1627,priest,discipline,72,47,25
Sølvfox,stormscale,1627,priest,discipline,42,25,17
Bambus,shattered-hand,1627,priest,discipline,48,28,20
Garbins,stormscale,1627,priest,discipline,42,24,18
Lauriinda,culte-de-la-rive-noire,1627,priest,discipline,219,113,106
Pshan,blackmoore,1627,priest,discipline,188,96,92
Женяшилд,howling-fjord,1627,priest,discipline,221,112,109
Krazuk,theradras,1627,priest,discipline,54,27,27
Нз,soulflayer,1627,priest,discipline,47,23,24
Kaiikoo,ravencrest,1627,priest,discipline,36,17,19
Brutalmaze,archimonde,1627,priest,discipline,36,17,19
Karmasmom,kazzak,1627,priest,discipline,48,21,27
Aleluia,alonsus,1627,priest,discipline,99,43,56
Aldebrand,dun-modr,1627,priest,discipline,66,27,39
Epa,zuljin,1626,priest,discipline,54,32,22
Tylér,stormscale,1626,priest,discipline,90,52,38
Skaliq,tarren-mill,1626,priest,discipline,201,108,93
Тоориал,howling-fjord,1626,priest,discipline,72,38,34
Inoru,stormreaver,1626,priest,discipline,198,104,94
Хомие,soulflayer,1626,priest,discipline,85,44,41
Chrïskz,archimonde,1626,priest,discipline,66,23,43
Discxqt,ysondre,1625,priest,discipline,83,51,32
Asgà,stormscale,1625,priest,discipline,30,17,13
Wiwzi,outland,1625,priest,discipline,84,43,41
Простосори,gordunni,1625,priest,discipline,540,267,273
Luziaa,outland,1625,priest,discipline,83,41,42
Chabih,ravencrest,1625,priest,discipline,54,23,31
Betatasty,dalaran,1624,priest,discipline,24,17,7
Labadudala,aegwynn,1624,priest,discipline,84,54,30
Garsdal,tarren-mill,1624,priest,discipline,78,43,35
Hâlez,antonidas,1624,priest,discipline,410,212,198
Darktheu,sanguino,1624,priest,discipline,39,20,19
Znàdix,silvermoon,1624,priest,discipline,252,128,124
Alicewhydel,blackhand,1624,priest,discipline,46,23,23
Deazypriest,blackrock,1624,priest,discipline,42,19,23
Farae,arathor,1624,priest,discipline,44,19,25
Iyannà,blackrock,1623,priest,discipline,36,24,12
Spbosse,aszune,1623,priest,discipline,54,33,21
Artist,outland,1623,priest,discipline,30,17,13
Kedrack,draenor,1623,priest,discipline,78,41,37
Yîrâ,antonidas,1623,priest,discipline,227,114,113
Cnqx,archimonde,1623,priest,discipline,48,21,27
Nelielto,stormscale,1622,priest,discipline,28,21,7
Djleffe,stormscale,1622,priest,discipline,39,23,16
Systerstål,twisting-nether,1622,priest,discipline,124,72,52
Mnu,blackrock,1622,priest,discipline,52,30,22
Lerión,ravencrest,1622,priest,discipline,108,62,46
Мплехибои,gordunni,1622,priest,discipline,54,30,24
Feed,burning-legion,1622,priest,discipline,84,45,39
Gûardianwisp,ravencrest,1622,priest,discipline,223,117,106
Кролс,gordunni,1622,priest,discipline,42,22,20
Grimdream,ragnaros,1622,priest,discipline,206,105,101
Waffur,twisting-nether,1622,priest,discipline,47,23,24
Двелегитоп,howling-fjord,1621,priest,discipline,36,23,13
Zinzor,archimonde,1621,priest,discipline,61,37,24
Eyesønyou,nemesis,1621,priest,discipline,33,19,14
Sicarium,aegwynn,1621,priest,discipline,102,56,46
Babybelle,arakarahm,1621,priest,discipline,61,33,28
Sotriggered,sylvanas,1621,priest,discipline,36,17,19
Mindfiend,stormscale,1621,priest,discipline,81,37,44
Dêmôn,stormscale,1620,priest,discipline,24,17,7
Pewpewpew,krasus,1620,priest,discipline,42,29,13
Fuzzybae,ravencrest,1620,priest,discipline,72,38,34
Veryfine,draenor,1620,priest,discipline,106,52,54
Shallteár,doomhammer,1620,priest,discipline,192,94,98
Soloqbob,kazzak,1620,priest,discipline,48,22,26
Outtloor,twisting-nether,1619,priest,discipline,39,25,14
Wifta,ravencrest,1619,priest,discipline,54,30,24
Roxxes,kazzak,1619,priest,discipline,42,23,19
Szelén,ragnaros,1619,priest,discipline,54,29,25
Eyllise,ragnaros,1619,priest,discipline,419,217,202
Nadoreille,hyjal,1619,priest,discipline,253,131,122
Dnsxx,thrall,1619,priest,discipline,890,453,437
Llamamepadre,dun-modr,1619,priest,discipline,84,42,42
Quïzzler,ragnaros,1619,priest,discipline,47,23,24
Naripriest,eredar,1619,priest,discipline,48,22,26
Melord,thunderhorn,1618,priest,discipline,44,27,17
Yoii,nemesis,1618,priest,discipline,64,38,26
Mønsterx,kazzak,1618,priest,discipline,64,37,27
Atothéèx,outland,1618,priest,discipline,48,26,22
Deathblind,blackmoore,1618,priest,discipline,36,17,19
Medipack,khaz-modan,1617,priest,discipline,54,38,16
Stargal,blackmoore,1617,priest,discipline,30,21,9
Биркох,blackscar,1617,priest,discipline,101,67,34
Prost,aerie-peak,1617,priest,discipline,71,47,24
Neverlandx,bladefist,1617,priest,discipline,52,30,22
Hamati,blackhand,1617,priest,discipline,138,77,61
Worldgamer,blackrock,1617,priest,discipline,142,69,73
Ödriaell,the-venture-co,1617,priest,discipline,150,72,78
Asherá,kazzak,1617,priest,discipline,94,41,53
Mikeypi,laughing-skull,1616,priest,discipline,36,25,11
Isweariheal,twisting-nether,1616,priest,discipline,58,37,21
Hötchick,outland,1616,priest,discipline,198,103,95
Xaey,ravencrest,1616,priest,discipline,234,119,115
Saniss,tarren-mill,1616,priest,discipline,78,39,39
Интенси,gordunni,1616,priest,discipline,119,59,60
Рнкх,lich-king,1616,priest,discipline,46,21,25
Binder,tarren-mill,1616,priest,discipline,60,26,34
Krolox,blackhand,1616,priest,discipline,60,25,35
Ñíò,archimonde,1615,priest,discipline,48,27,21
Èightsix,draenor,1615,priest,discipline,161,88,73
Softie,zuljin,1615,priest,discipline,120,65,55
Wencis,kazzak,1615,priest,discipline,96,50,46
Naberus,ragnaros,1615,priest,discipline,73,38,35
Deepsea,kazzak,1615,priest,discipline,473,233,240
Supemi,stormscale,1615,priest,discipline,42,18,24
Mythasz,archimonde,1615,priest,discipline,52,21,31
Woodywoodpkr,senjin,1614,priest,discipline,94,55,39
Absôlutvôdka,twisting-nether,1614,priest,discipline,66,37,29
Jmp,tarren-mill,1614,priest,discipline,40,21,19
Feardotexe,frostwolf,1614,priest,discipline,163,82,81
Parzivál,argent-dawn,1614,priest,discipline,122,58,64
Cøvu,draenor,1613,priest,discipline,39,25,14
Gnzysan,blackrock,1613,priest,discipline,66,39,27
Appuesi,dun-modr,1613,priest,discipline,30,17,13
Shyria,argent-dawn,1613,priest,discipline,91,47,44
Carnegi,burning-legion,1613,priest,discipline,170,86,84
Jp,gorgonnash,1613,priest,discipline,42,21,21
Swdjack,blackrock,1613,priest,discipline,192,92,100
Zýgzäg,hyjal,1613,priest,discipline,172,81,91
Louiepr,outland,1613,priest,discipline,54,22,32
Burningheatx,kazzak,1612,priest,discipline,71,47,24
Nwo,twisting-nether,1612,priest,discipline,36,23,13
Purplex,aggra-português,1612,priest,discipline,42,23,19
Няжик,azuregos,1612,priest,discipline,66,33,33
Cptatonement,draenor,1612,priest,discipline,60,30,30
Xoxogg,burning-blade,1611,priest,discipline,108,69,39
Matwucss,outland,1611,priest,discipline,48,28,20
Verminous,ravencrest,1611,priest,discipline,68,38,30
Shadowboness,twisting-nether,1611,priest,discipline,58,31,27
Xaeroow,archimonde,1611,priest,discipline,49,26,23
Ecg,silvermoon,1611,priest,discipline,48,23,25
Диспайзх,gordunni,1611,priest,discipline,204,97,107
Taslight,stormscale,1610,priest,discipline,60,40,20
Judgementdaý,kazzak,1610,priest,discipline,30,20,10
Sosabgd,azjolnerub,1610,priest,discipline,36,20,16
Lavendertown,tarren-mill,1610,priest,discipline,92,47,45
Jibrael,draenor,1610,priest,discipline,84,40,44
Viu,eredar,1610,priest,discipline,51,22,29
Rylpriest,blackmoore,1609,priest,discipline,36,21,15
Holyshiz,stormrage,1609,priest,discipline,42,24,18
Kdot,drakthul,1609,priest,discipline,86,48,38
Vregoa,twisting-nether,1609,priest,discipline,89,49,40
Fazzy,nagrand,1609,priest,discipline,76,41,35
Türsteherxxl,mannoroth,1608,priest,discipline,36,21,15
Tremrfinger,dun-modr,1608,priest,discipline,104,60,44
Dotreveal,ravencrest,1608,priest,discipline,113,58,55
Fakecats,sargeras,1608,priest,discipline,51,22,29
Monataamis,kazzak,1608,priest,discipline,47,20,27
Mightnáre,tarren-mill,1607,priest,discipline,36,21,15
Suxino,stormscale,1607,priest,discipline,264,149,115
Zehakky,tarren-mill,1607,priest,discipline,151,85,66
Шмэтар,gordunni,1607,priest,discipline,48,25,23
Aurosa,argent-dawn,1607,priest,discipline,123,64,59
Cizer,kazzak,1607,priest,discipline,116,57,59
Zloyvrach,ravencrest,1607,priest,discipline,126,60,66
Fricia,zuljin,1606,priest,discipline,82,45,37
Solaçe,antonidas,1606,priest,discipline,48,26,22
Stampo,draenor,1606,priest,discipline,75,35,40
Дардж,blackscar,1605,priest,discipline,24,17,7
Anabølixx,ravencrest,1605,priest,discipline,36,23,13
Dtpe,kazzak,1605,priest,discipline,93,59,34
Føxy,emerald-dream,1605,priest,discipline,41,23,18
Tárget,frostwolf,1605,priest,discipline,48,22,26
Shadowfishey,grim-batol,1605,priest,discipline,76,33,43
Tritíana,blackrock,1604,priest,discipline,192,110,82
Flurri,tarren-mill,1604,priest,discipline,160,91,69
Voleck,aegwynn,1604,priest,discipline,30,17,13
Saénna,burning-legion,1604,priest,discipline,44,22,22
Zofiiee,tarren-mill,1604,priest,discipline,80,38,42
Artì,kazzak,1604,priest,discipline,119,55,64
Lizka,kazzak,1604,priest,discipline,96,43,53
Thejambura,ragnaros,1603,priest,discipline,116,71,45
Ostberger,twisting-nether,1603,priest,discipline,227,130,97
Tiragosaure,arakarahm,1603,priest,discipline,48,26,22
Mcdced,archimonde,1603,priest,discipline,90,45,45
Troedelsuppe,destromath,1603,priest,discipline,282,130,152
Хилботгодикс,borean-tundra,1602,priest,discipline,42,32,10
Iløvelena,ravencrest,1602,priest,discipline,39,23,16
Zurlyne,ravencrest,1602,priest,discipline,39,22,17
Хеликси,gordunni,1602,priest,discipline,235,127,108
Horrðr,kazzak,1602,priest,discipline,108,58,50
Cadierna,argent-dawn,1602,priest,discipline,42,19,23
Flygar,outland,1602,priest,discipline,60,27,33
Jackboss,draenor,1602,priest,discipline,74,31,43
Märlborö,aggra-português,1602,priest,discipline,66,26,40
Jhaazx,nemesis,1601,priest,discipline,233,124,109
Ashuramaru,drakthul,1601,priest,discipline,47,24,23
Мастди,ashenvale,1601,priest,discipline,41,20,21
Smitebone,tarren-mill,1601,priest,discipline,90,40,50
Киллус,ashenvale,1601,priest,discipline,72,29,43
Lgbtgodx,archimonde,1600,priest,discipline,61,45,16
Discipleotl,stormscale,1600,priest,discipline,95,61,34
Ellfle,kazzak,1600,priest,discipline,42,26,16
Trì,thrall,1600,priest,discipline,35,20,15
Dêrbómbêr,guldan,1600,priest,discipline,54,30,24
Sinîra,frostwolf,1600,priest,discipline,110,59,51
Darkprist,sanguino,1600,priest,discipline,66,34,32
Старлайтх,gordunni,1600,priest,discipline,35,18,17
Shalvy,aegwynn,1600,priest,discipline,218,111,107
Xangha,burning-legion,1600,priest,discipline,264,133,131
Mirupriest,sanguino,1600,priest,discipline,42,20,22
Foh,antonidas,1600,priest,discipline,36,17,19
Shento,blackhand,1600,priest,discipline,48,21,27
Marícanqt,tarren-mill,1599,priest,discipline,30,23,7
Tashziehn,blackrock,1599,priest,discipline,123,65,58
Géèk,alakir,1599,priest,discipline,100,52,48
Blindmymind,malganis,1599,priest,discipline,87,44,43
Целитель,gordunni,1599,priest,discipline,86,43,43
Спсчтоживой,blackscar,1598,priest,discipline,108,57,51
Norganp,die-aldor,1598,priest,discipline,124,64,60
Srakabot,burning-legion,1598,priest,discipline,140,70,70
Raffá,blackhand,1597,priest,discipline,98,43,55
Sebikpri,ravencrest,1596,priest,discipline,60,34,26
Cav,archimonde,1596,priest,discipline,137,70,67
Fancytrash,ravencrest,1596,priest,discipline,94,41,53
Баблби,soulflayer,1596,priest,discipline,169,73,96
Alèxy,tarren-mill,1596,priest,discipline,48,19,29
Dush,draenor,1595,priest,discipline,56,31,25
Faintly,emeriss,1595,priest,discipline,48,23,25
Эскирия,gordunni,1595,priest,discipline,48,17,31
Cylantharia,eredar,1594,priest,discipline,135,69,66
Légít,argent-dawn,1594,priest,discipline,102,43,59
Haakon,tarren-mill,1593,priest,discipline,30,17,13
Døgfîsh,stormscale,1593,priest,discipline,78,41,37
Øbz,sylvanas,1593,priest,discipline,78,34,44
Padisonfire,blackmoore,1593,priest,discipline,48,19,29
Серью,booty-bay,1592,priest,discipline,47,28,19
Bercxu,ragnaros,1592,priest,discipline,105,53,52
Badorange,kazzak,1592,priest,discipline,59,29,30
Бэнжэминг,gordunni,1592,priest,discipline,101,43,58
Exoduz,stormscale,1591,priest,discipline,353,177,176
Priestqt,kelthuzad,1590,priest,discipline,57,31,26
Farnese,archimonde,1590,priest,discipline,395,212,183
Holycrapx,chromaggus,1589,priest,discipline,117,60,57
Armward,twisting-nether,1588,priest,discipline,34,25,9
Ичисанчик,howling-fjord,1588,priest,discipline,30,17,13
Yuuvi,ravencrest,1588,priest,discipline,216,117,99
Oecgreg,ysondre,1588,priest,discipline,76,41,35
Walkmydome,twisting-nether,1588,priest,discipline,168,83,85
Arvonpenaali,defias-brotherhood,1587,priest,discipline,42,25,17
Yassjr,archimonde,1587,priest,discipline,50,25,25
Hodgins,bloodscalp,1587,priest,discipline,36,18,18
Vänskap,kazzak,1587,priest,discipline,132,65,67
Gobblestick,draenor,1587,priest,discipline,47,21,26
Yugata,archimonde,1587,priest,discipline,112,50,62
Darknun,aggra-português,1587,priest,discipline,65,29,36
Astralscare,outland,1586,priest,discipline,133,77,56
Polymonkey,stormscale,1586,priest,discipline,41,17,24
Toba,hellscream,1585,priest,discipline,113,65,48
Aphroditê,blackrock,1585,priest,discipline,40,22,18
Intentoso,nemesis,1585,priest,discipline,42,21,21
Sahorie,archimonde,1584,priest,discipline,141,82,59
Copperpriest,draenor,1584,priest,discipline,74,38,36
Fatherlou,outland,1584,priest,discipline,42,21,21
Skynoxx,ragnaros,1584,priest,discipline,114,56,58
Dreythan,stormrage,1584,priest,discipline,74,33,41
Terno,sylvanas,1583,priest,discipline,438,220,218
Interrupted,kazzak,1583,priest,discipline,120,57,63
Omgitshuux,blackmoore,1583,priest,discipline,66,31,35
Rankoneprazt,stormscale,1583,priest,discipline,83,38,45
Соулвардинг,soulflayer,1583,priest,discipline,60,26,34
Buan,blackmoore,1582,priest,discipline,98,58,40
Logath,archimonde,1582,priest,discipline,30,17,13
Lekken,kazzak,1582,priest,discipline,69,36,33
Xaerroow,archimonde,1581,priest,discipline,36,23,13
Амберис,gordunni,1581,priest,discipline,54,27,27
Чилюнахиле,gordunni,1581,priest,discipline,71,23,48
Rhæveth,ravencrest,1580,priest,discipline,36,22,14
Slikjar,stormscale,1580,priest,discipline,58,24,34
Twosugars,sylvanas,1579,priest,discipline,144,74,70
Ínsäníty,outland,1578,priest,discipline,36,27,9
Holineß,burning-blade,1578,priest,discipline,84,51,33
Toiga,lightnings-blade,1578,priest,discipline,48,29,19
Psíquica,sanguino,1578,priest,discipline,45,23,22
Riptile,outland,1578,priest,discipline,70,33,37
Saturno,chogall,1578,priest,discipline,54,21,33
Tâmshi,dun-modr,1577,priest,discipline,54,26,28
Maccz,hyjal,1577,priest,discipline,68,32,36
Keryin,draenor,1577,priest,discipline,156,63,93
Макимасама,gordunni,1576,priest,discipline,49,26,23
Флафика,deathguard,1575,priest,discipline,78,45,33
Skyløl,dun-modr,1575,priest,discipline,36,19,17
Вилайф,galakrond,1575,priest,discipline,76,40,36
Botstyleswdx,ravencrest,1575,priest,discipline,190,88,102
Angelofdeàth,kazzak,1574,priest,discipline,132,76,56
Tifa,ravencrest,1574,priest,discipline,119,65,54
Leyasu,eredar,1574,priest,discipline,57,31,26
Limeslayerx,veklor,1574,priest,discipline,48,26,22
Avaichquirit,tarren-mill,1574,priest,discipline,130,70,60
Goky,kazzak,1574,priest,discipline,36,18,18
Люблюкофе,deathguard,1574,priest,discipline,89,44,45
Xîz,silvermoon,1574,priest,discipline,72,34,38
Olurin,rajaxx,1574,priest,discipline,78,30,48
Фотосз,soulflayer,1573,priest,discipline,35,19,16
Ptrspriest,twisting-nether,1573,priest,discipline,207,101,106
Aia,tyrande,1573,priest,discipline,88,41,47
Biophyzix,aegwynn,1573,priest,discipline,41,18,23
Остроухх,howling-fjord,1572,priest,discipline,132,73,59
Amysantiàgo,sylvanas,1572,priest,discipline,163,87,76
Foobi,the-maelstrom,1572,priest,discipline,409,215,194
Nyarlatothep,boulderfist,1572,priest,discipline,148,77,71
Alterlight,twisting-nether,1572,priest,discipline,352,169,183
Smilézz,eredar,1572,priest,discipline,132,59,73
Jpjp,gorgonnash,1571,priest,discipline,47,34,13
Acrio,die-ewige-wacht,1571,priest,discipline,78,39,39
Nzothapostle,baelgun,1571,priest,discipline,249,115,134
Licktheheal,outland,1570,priest,discipline,54,31,23
Deadwen,stormscale,1570,priest,discipline,252,139,113
Miikkap,blackhand,1570,priest,discipline,60,29,31
Макстин,howling-fjord,1570,priest,discipline,179,85,94
Bubbelchên,blackhand,1570,priest,discipline,72,32,40
Wâneis,stormscale,1569,priest,discipline,65,38,27
Holysheett,magtheridon,1569,priest,discipline,102,58,44
Alinone,uldum,1569,priest,discipline,99,53,46
Valfore,eldrethalas,1569,priest,discipline,58,31,27
Hèmera,tichondrius,1568,priest,discipline,55,41,14
Pipperxp,ravencrest,1568,priest,discipline,48,31,17
Ripperdepip,magtheridon,1568,priest,discipline,213,120,93
Piperxp,ravencrest,1568,priest,discipline,48,24,24
Dreê,hyjal,1568,priest,discipline,42,19,23
Yënâs,hyjal,1567,priest,discipline,109,63,46
Southyz,stormscale,1566,priest,discipline,111,61,50
Snusprällen,sylvanas,1566,priest,discipline,65,31,34
Denyz,blackrock,1566,priest,discipline,54,21,33
Этотьмадетка,howling-fjord,1565,priest,discipline,42,26,16
Aternia,draenor,1565,priest,discipline,89,48,41
Spirítbox,argent-dawn,1565,priest,discipline,213,114,99
Rizzlerx,blackmoore,1564,priest,discipline,66,40,26
Whattson,colinas-pardas,1564,priest,discipline,35,17,18
Hopepriest,magtheridon,1564,priest,discipline,42,20,22
Выдокбля,soulflayer,1563,priest,discipline,34,25,9
Redøm,stormreaver,1563,priest,discipline,42,23,19
Yacine,blackrock,1563,priest,discipline,126,60,66
Alicanx,twisting-nether,1563,priest,discipline,84,37,47
Zackshock,sanguino,1563,priest,discipline,66,23,43
Unfaker,drakthul,1562,priest,discipline,36,23,13
Марабудх,soulflayer,1562,priest,discipline,104,57,47
Ranevskiy,kazzak,1562,priest,discipline,189,96,93
Pvpalt,argent-dawn,1562,priest,discipline,69,33,36
Шатолюгран,soulflayer,1561,priest,discipline,124,73,51
Veltrag,sanguino,1560,priest,discipline,60,34,26
Raezi,defias-brotherhood,1560,priest,discipline,196,105,91
Lurri,tarren-mill,1560,priest,discipline,150,79,71
Cpzach,tarren-mill,1560,priest,discipline,82,39,43
Zlejkadlec,drakthul,1559,priest,discipline,103,59,44
Рвотка,gordunni,1559,priest,discipline,124,68,56
Aêbi,dalaran,1558,priest,discipline,48,28,20
Eördög,ragnaros,1558,priest,discipline,96,54,42
Luuña,ravencrest,1558,priest,discipline,179,98,81
Ftiersp,ravencrest,1558,priest,discipline,48,21,27
Daddydisc,tarren-mill,1557,priest,discipline,34,18,16
Dreamscapez,tarren-mill,1557,priest,discipline,67,35,32
Lishado,twisting-nether,1557,priest,discipline,96,49,47
Олдмэнсэйд,soulflayer,1557,priest,discipline,134,68,66
Shielddanke,blackmoore,1557,priest,discipline,84,40,44
Пальтишко,howling-fjord,1557,priest,discipline,96,45,51
Raawri,blackmoore,1557,priest,discipline,54,24,30
Валифа,gordunni,1556,priest,discipline,68,41,27
Lïnkz,kazzak,1556,priest,discipline,72,41,31
Tamy,draenor,1556,priest,discipline,62,33,29
Enimao,tarren-mill,1556,priest,discipline,55,29,26
Träskfarfar,tarren-mill,1556,priest,discipline,42,20,22
Ecrisis,twisting-nether,1556,priest,discipline,128,57,71
Ivÿx,ravencrest,1556,priest,discipline,89,38,51
Darkprofit,aegwynn,1555,priest,discipline,137,71,66
Mojmir,drakthul,1555,priest,discipline,66,32,34
Vhim,hyjal,1555,priest,discipline,52,24,28
Khrtp,silvermoon,1555,priest,discipline,48,22,26
Fearadelia,thrall,1554,priest,discipline,24,18,6
Priestin,dun-modr,1554,priest,discipline,35,20,15
Cathocrasty,draenor,1554,priest,discipline,123,69,54
Eßola,silvermoon,1554,priest,discipline,88,44,44
Frednshield,tarren-mill,1554,priest,discipline,69,34,35
Mustatomi,stormreaver,1554,priest,discipline,39,17,22
Rher,blackmoore,1553,priest,discipline,85,52,33
Sháady,ravencrest,1553,priest,discipline,78,41,37
Senosaurus,tarren-mill,1553,priest,discipline,84,43,41
Рэйкар,razuvious,1553,priest,discipline,65,33,32
Khâléd,kazzak,1553,priest,discipline,36,17,19
Juggster,bloodhoof,1552,priest,discipline,174,91,83
Cresellia,twisting-nether,1552,priest,discipline,170,81,89
Deathspren,stormscale,1552,priest,discipline,42,19,23
Расспутана,howling-fjord,1551,priest,discipline,320,158,162
Soraal,argent-dawn,1551,priest,discipline,79,39,40
Redpriestess,kazzak,1550,priest,discipline,41,24,17
Надийя,gordunni,1550,priest,discipline,132,74,58
Korzec,dun-modr,1550,priest,discipline,108,57,51
Jandice,blackrock,1550,priest,discipline,36,18,18
Zastyx,drakthul,1550,priest,discipline,42,20,22
Xaerah,blackmoore,1549,priest,discipline,78,41,37
Nêlumar,aegwynn,1549,priest,discipline,82,42,40
Arkkinunna,outland,1549,priest,discipline,124,59,65
Колдрексх,deathguard,1549,priest,discipline,72,31,41
Paìnz,blackhand,1548,priest,discipline,80,48,32
Олегстразза,howling-fjord,1548,priest,discipline,207,104,103
Húlda,auchindoun,1548,priest,discipline,48,24,24
Sctheal,outland,1548,priest,discipline,75,37,38
Runekpriest,tarren-mill,1548,priest,discipline,51,25,26
Sonics,antonidas,1548,priest,discipline,66,31,35
Delarus,perenolde,1547,priest,discipline,72,47,25
Arima,kargath,1547,priest,discipline,74,36,38
Aclass,outland,1547,priest,discipline,92,44,48
Máv,tarren-mill,1546,priest,discipline,64,42,22
Anarame,silvermoon,1546,priest,discipline,45,24,21
Èzì,burning-legion,1546,priest,discipline,173,89,84
Poonies,silvermoon,1546,priest,discipline,124,61,63
Numi,blackmoore,1545,priest,discipline,163,94,69
Alphabreyf,tarren-mill,1545,priest,discipline,83,43,40
Trénboloné,tarren-mill,1545,priest,discipline,90,44,46
Rezzurrectum,doomhammer,1545,priest,discipline,105,51,54
Dîablø,eredar,1545,priest,discipline,99,45,54
Pandalulz,turalyon,1544,priest,discipline,93,55,38
Aasgard,frostwolf,1544,priest,discipline,90,46,44
Disillusíon,tarren-mill,1544,priest,discipline,144,70,74
Diszi,norgannon,1544,priest,discipline,58,28,30
Jesuispasbon,hyjal,1543,priest,discipline,30,17,13
Kitanai,silvermoon,1543,priest,discipline,54,29,25
Arjak,stormscale,1543,priest,discipline,41,20,21
Mêmphìs,twisting-nether,1543,priest,discipline,83,38,45
Алуан,blackscar,1543,priest,discipline,66,23,43
Блексебет,soulflayer,1542,priest,discipline,148,80,68
Admiration,eredar,1542,priest,discipline,47,23,24
Батямелднул,blackscar,1541,priest,discipline,60,36,24
Mtbalt,tarren-mill,1541,priest,discipline,120,71,49
Gingerflexay,archimonde,1541,priest,discipline,36,21,15
Bublelicious,silvermoon,1541,priest,discipline,90,48,42
Ojh,defias-brotherhood,1541,priest,discipline,48,22,26
Tjat,silvermoon,1540,priest,discipline,66,34,32
Whiskie,twisting-nether,1540,priest,discipline,60,30,30
Psi,hakkar,1540,priest,discipline,36,18,18
Grzmocillaa,burning-legion,1540,priest,discipline,54,26,28
Шарадин,gordunni,1539,priest,discipline,157,86,71
Lahammy,kazzak,1539,priest,discipline,68,36,32
Vicwix,draenor,1539,priest,discipline,53,27,26
Keyfear,kazzak,1539,priest,discipline,87,44,43
Grautesk,chogall,1539,priest,discipline,48,23,25
Влажныйшп,soulflayer,1538,priest,discipline,66,37,29
Grêy,dun-modr,1538,priest,discipline,65,34,31
Джахия,soulflayer,1537,priest,discipline,307,161,146
Scodây,blackmoore,1537,priest,discipline,278,143,135
Ptsd,argent-dawn,1537,priest,discipline,96,46,50
Natapriest,antonidas,1536,priest,discipline,266,145,121
Styilepriest,twisting-nether,1536,priest,discipline,36,18,18
Treen,silvermoon,1535,priest,discipline,110,60,50
Saintpri,twisting-nether,1535,priest,discipline,96,52,44
Hérune,outland,1535,priest,discipline,80,41,39
Chamelthoe,the-maelstrom,1535,priest,discipline,114,54,60
Yuukii,kult-der-verdammten,1535,priest,discipline,36,17,19
Goblex,hyjal,1535,priest,discipline,63,28,35
Майндоф,howling-fjord,1534,priest,discipline,60,34,26
Discomacka,twisting-nether,1534,priest,discipline,48,26,22
Obeng,tarren-mill,1534,priest,discipline,30,16,14
Íhðly,silvermoon,1534,priest,discipline,102,54,48
Pmh,kazzak,1534,priest,discipline,120,60,60
Марина,howling-fjord,1534,priest,discipline,54,23,31
Tinre,ravenholdt,1533,priest,discipline,48,23,25
Voidsnitch,antonidas,1533,priest,discipline,96,44,52
Remlos,der-rat-von-dalaran,1532,priest,discipline,72,35,37
Valnor,pozzo-delleternità,1532,priest,discipline,57,27,30
Mysticforces,silvermoon,1532,priest,discipline,78,34,44
Zxèlá,tarren-mill,1531,priest,discipline,59,37,22
Володябигуди,howling-fjord,1531,priest,discipline,64,36,28
Sebekklawl,wrathbringer,1531,priest,discipline,97,52,45
Фыбра,soulflayer,1531,priest,discipline,30,16,14
Elämäntypy,stormscale,1531,priest,discipline,120,60,60
Wiildsy,tarren-mill,1531,priest,discipline,53,24,29
Ectria,ravencrest,1531,priest,discipline,54,22,32
Glaedahr,blackmoore,1531,priest,discipline,66,26,40
Asmodeux,alakir,1530,priest,discipline,24,19,5
Амбракадабра,blackscar,1530,priest,discipline,36,26,10
Psnextxp,eredar,1530,priest,discipline,87,51,36
Tutoress,stormscale,1530,priest,discipline,48,23,25
Swallowship,twisting-nether,1530,priest,discipline,36,16,20
Remkojatwo,blackrock,1529,priest,discipline,30,16,14
Onelovexx,thrall,1529,priest,discipline,60,28,32
Nevor,nemesis,1528,priest,discipline,124,57,67
Prioheal,hyjal,1527,priest,discipline,78,44,34
Ohbenji,ravencrest,1527,priest,discipline,140,67,73
Nightreaver,argent-dawn,1526,priest,discipline,63,35,28
Mautijr,blackrock,1526,priest,discipline,302,158,144
Discgodx,ravencrest,1526,priest,discipline,60,31,29
Kyseki,ravencrest,1526,priest,discipline,496,253,243
Eleatros,blackrock,1526,priest,discipline,106,52,54
Sethp,hyjal,1525,priest,discipline,30,21,9
Huffinctus,tarren-mill,1525,priest,discipline,112,59,53
Shînnøk,silvermoon,1525,priest,discipline,141,74,67
Gotikaa,blackrock,1525,priest,discipline,96,50,46
Kamiyasa,blackmoore,1525,priest,discipline,139,71,68
Данягантеля,gordunni,1525,priest,discipline,42,21,21
Sørcedote,dun-modr,1525,priest,discipline,36,16,20
Nurbanu,ravencrest,1524,priest,discipline,77,49,28
Skylar,xavius,1524,priest,discipline,48,29,19
Enoriya,blackrock,1524,priest,discipline,259,140,119
Zoe,aegwynn,1523,priest,discipline,213,112,101
Chôrdi,aegwynn,1523,priest,discipline,154,76,78
Виспх,eversong,1523,priest,discipline,269,120,149
Jackyz,tarren-mill,1523,priest,discipline,60,21,39
Raeratwo,archimonde,1522,priest,discipline,30,16,14
Юлих,booty-bay,1522,priest,discipline,160,80,80
Lythi,eredar,1522,priest,discipline,118,52,66
Deadthicc,hyjal,1521,priest,discipline,50,33,17
Árî,dun-modr,1521,priest,discipline,141,77,64
Prästpojken,frostwhisper,1521,priest,discipline,137,65,72
Yonkerz,frostmane,1521,priest,discipline,222,104,118
Nightsøul,ragnaros,1520,priest,discipline,30,19,11
Êvîlêvê,blackmoore,1520,priest,discipline,76,47,29
Chocoly,tarren-mill,1520,priest,discipline,98,52,46
Drxz,twilights-hammer,1520,priest,discipline,46,24,22
Evõmax,sylvanas,1520,priest,discipline,304,157,147
Mamis,anetheron,1520,priest,discipline,48,22,26
Benau,aegwynn,1519,priest,discipline,60,38,22
Dalylla,aggra-português,1519,priest,discipline,100,55,45
Lilpi,rexxar,1519,priest,discipline,105,56,49
Hateyeleison,burning-legion,1519,priest,discipline,72,34,38
Effectx,ravencrest,1519,priest,discipline,90,42,48
Durmadanbas,ravencrest,1518,priest,discipline,51,28,23
Badhêalz,aegwynn,1518,priest,discipline,109,55,54
Трихоманиаз,ashenvale,1518,priest,discipline,48,23,25
Greyanna,twisting-nether,1518,priest,discipline,42,20,22
Phasmöphobia,zuljin,1518,priest,discipline,150,70,80
Freaki,blackrock,1517,priest,discipline,48,28,20
Lemontea,frostwolf,1517,priest,discipline,48,27,21
Gojó,outland,1517,priest,discipline,57,25,32
Babloche,archimonde,1516,priest,discipline,48,27,21
Bornxgood,kazzak,1516,priest,discipline,42,18,24
Utsuro,stormscale,1515,priest,discipline,42,22,20
Tinypump,silvermoon,1514,priest,discipline,29,17,12
Гоплзнекст,gordunni,1514,priest,discipline,30,16,14
Lukéy,silvermoon,1514,priest,discipline,66,33,33
Burnex,thrall,1514,priest,discipline,108,53,55
Blackbox,burning-legion,1514,priest,discipline,175,84,91
Hiddenhealz,blackrock,1514,priest,discipline,60,25,35
Mêduse,ravencrest,1514,priest,discipline,69,23,46
Papkalácss,hellfire,1513,priest,discipline,32,19,13
Ticklypriest,outland,1513,priest,discipline,30,17,13
Colèy,blackhand,1513,priest,discipline,168,90,78
Kratzîgel,blackmoore,1512,priest,discipline,120,69,51
Mindfreakxx,twisting-nether,1512,priest,discipline,42,24,18
Erupyks,archimonde,1512,priest,discipline,36,18,18
Helalolsun,archimonde,1512,priest,discipline,97,48,49
Nerfpriest,tarren-mill,1512,priest,discipline,156,76,80
Buerak,tarren-mill,1511,priest,discipline,34,20,14
Ciri,die-aldor,1511,priest,discipline,31,18,13
Golletz,twisting-nether,1511,priest,discipline,84,48,36
Aestina,silvermoon,1511,priest,discipline,120,58,62
Blazekk,sylvanas,1511,priest,discipline,127,56,71
Shkzz,hyjal,1510,priest,discipline,36,26,10
Kirchhoffina,die-nachtwache,1510,priest,discipline,43,23,20
Axxul,blackrock,1510,priest,discipline,36,18,18
Опрометчивый,soulflayer,1510,priest,discipline,42,19,23
Pumpkin,aggramar,1509,priest,discipline,30,19,11
Aéríthx,ravencrest,1509,priest,discipline,153,78,75
Johen,terenas,1509,priest,discipline,144,72,72
Goldgot,tarren-mill,1509,priest,discipline,42,20,22
Фриерли,howling-fjord,1508,priest,discipline,30,21,9
Ledania,aegwynn,1508,priest,discipline,37,25,12
Knazh,twisting-nether,1508,priest,discipline,36,20,16
Dairox,blackrock,1508,priest,discipline,130,72,58
Arkatina,outland,1508,priest,discipline,70,38,32
Ethaz,twisting-nether,1508,priest,discipline,30,16,14
Axla,stormscale,1508,priest,discipline,59,29,30
Gulch,blackmoore,1508,priest,discipline,84,40,44
Mjamc,stormscale,1508,priest,discipline,129,60,69
Лоео,ashenvale,1508,priest,discipline,60,26,34
Crims,twisting-nether,1507,priest,discipline,108,62,46
Anyndra,twisting-nether,1507,priest,discipline,42,24,18
Healicious,teldrassil,1507,priest,discipline,30,16,14
Kurt,blackrock,1507,priest,discipline,136,66,70
Zealtron,darksorrow,1507,priest,discipline,47,19,28
Winnever,dun-modr,1506,priest,discipline,314,169,145
Edoran,ragnaros,1506,priest,discipline,115,59,56
Апититька,soulflayer,1506,priest,discipline,126,64,62
Исусиприст,deepholm,1506,priest,discipline,42,20,22
Safemode,ravencrest,1505,priest,discipline,47,25,22
Celiara,argent-dawn,1505,priest,discipline,160,85,75
Смайтвайфу,howling-fjord,1505,priest,discipline,54,27,27
Altargirl,defias-brotherhood,1505,priest,discipline,36,17,19
Mortarz,ragnaros,1505,priest,discipline,71,31,40
Dench,azjolnerub,1505,priest,discipline,60,25,35
Derylium,kazzak,1504,priest,discipline,63,42,21
Getötet,blackrock,1504,priest,discipline,78,47,31
Jumperlawl,khaz-modan,1504,priest,discipline,54,30,24
Akemmì,sylvanas,1504,priest,discipline,162,82,80
Аферона,soulflayer,1504,priest,discipline,48,24,24
Makemyday,dun-modr,1504,priest,discipline,76,36,40
Supernal,twisting-nether,1504,priest,discipline,72,34,38
Nomorelight,stormscale,1503,priest,discipline,157,88,69
Heilerharry,blackmoore,1503,priest,discipline,34,19,15
Antainis,silvermoon,1503,priest,discipline,185,99,86
Cinri,argent-dawn,1503,priest,discipline,247,118,129
Jamii,kazzak,1502,priest,discipline,95,62,33
Tansk,stormscale,1502,priest,discipline,204,107,97
Тэтэшник,ashenvale,1502,priest,discipline,200,104,96
Мэдмод,gordunni,1502,priest,discipline,142,64,78
Sundæ,antonidas,1502,priest,discipline,42,18,24
Maskinjundre,bronzebeard,1502,priest,discipline,51,21,30
Fartsponge,ragnaros,1501,priest,discipline,31,17,14
Makesnosense,kilrogg,1501,priest,discipline,60,31,29
Kobri,gilneas,1501,priest,discipline,126,65,61
Watchmedeath,sargeras,1501,priest,discipline,43,21,22
Laërhia,archimonde,1501,priest,discipline,98,44,54
Nextvbestapp,ravencrest,1501,priest,discipline,42,18,24
Sickwill,blackrock,1500,priest,discipline,52,29,23
Мьюсх,deathguard,1500,priest,discipline,77,42,35
Cúrt,sanguino,1500,priest,discipline,60,29,31
Sláin,outland,1500,priest,discipline,221,106,115
Nahni,teldrassil,1500,priest,discipline,211,97,114
Dreamhatcher,deathwing,1500,priest,discipline,42,18,24
Elwing,darkmoon-faire,1500,priest,discipline,48,18,30
Bromine,twisting-nether,1499,priest,discipline,39,29,10
Cursedme,blackrock,1499,priest,discipline,42,24,18
Ræpriestx,ragnaros,1499,priest,discipline,117,66,51
Anaqt,silvermoon,1499,priest,discipline,317,160,157
Noobpriest,blackrock,1499,priest,discipline,118,56,62
Dìsc,ravencrest,1499,priest,discipline,78,37,41
Архиэрей,soulflayer,1499,priest,discipline,51,24,27
Ixdeadxl,stormscale,1498,priest,discipline,79,48,31
Bloodie,drakthul,1498,priest,discipline,30,18,12
Мненосина,goldrinn,1498,priest,discipline,58,28,30
Пэрдёж,howling-fjord,1498,priest,discipline,35,16,19
Deki,outland,1498,priest,discipline,60,27,33
Diarolz,sanguino,1497,priest,discipline,81,46,35
Luznywiesiek,burning-legion,1496,priest,discipline,36,22,14
Энвиньяттар,howling-fjord,1496,priest,discipline,60,33,27
Холиблэк,blackscar,1496,priest,discipline,36,16,20
Massasax,kazzak,1495,priest,discipline,54,33,21
Knøw,ravencrest,1495,priest,discipline,68,36,32
Nubso,aegwynn,1495,priest,discipline,54,25,29
Aïezn,culte-de-la-rive-noire,1495,priest,discipline,206,93,113
Faouzia,argent-dawn,1495,priest,discipline,36,16,20
Towelie,stormscale,1495,priest,discipline,36,16,20
Шимату,howling-fjord,1495,priest,discipline,72,25,47
Onetwo,silvermoon,1494,priest,discipline,30,18,12
Drawun,burning-legion,1494,priest,discipline,116,67,49
Ballsbrawlz,sylvanas,1494,priest,discipline,42,24,18
Sheshan,destromath,1494,priest,discipline,53,29,24
Hïstërïä,silvermoon,1494,priest,discipline,57,28,29
Olio,outland,1494,priest,discipline,76,35,41
Tarîs,archimonde,1494,priest,discipline,72,31,41
Vorynax,silvermoon,1493,priest,discipline,86,40,46
Tinpr,sanguino,1492,priest,discipline,111,50,61
Blackheall,nemesis,1491,priest,discipline,42,22,20
Spoggle,kazzak,1491,priest,discipline,108,55,53
Holycrit,aszune,1491,priest,discipline,59,29,30
Aurunea,blackrock,1490,priest,discipline,45,30,15
Littleflash,lightbringer,1490,priest,discipline,87,43,44
Cárith,nemesis,1489,priest,discipline,46,26,20
Bleedingeyes,tarren-mill,1489,priest,discipline,51,27,24
Neagica,kazzak,1489,priest,discipline,126,65,61
Nastynina,frostwhisper,1489,priest,discipline,88,42,46
Loverxz,dun-modr,1489,priest,discipline,42,20,22
Лилатэль,blackscar,1489,priest,discipline,132,58,74
Dadheal,dalaran,1489,priest,discipline,48,21,27
Tynsxd,silvermoon,1488,priest,discipline,149,83,66
Ceraghk,tichondrius,1488,priest,discipline,144,76,68
Khazidhea,frostwolf,1488,priest,discipline,87,41,46
Sebbepriest,twisting-nether,1487,priest,discipline,42,27,15
Discomarcel,burning-legion,1487,priest,discipline,42,23,19
Céph,sylvanas,1487,priest,discipline,42,21,21
Radegast,jaedenar,1487,priest,discipline,204,100,104
Iqr,blackmoore,1487,priest,discipline,42,20,22
Fiskpung,draenor,1486,priest,discipline,48,28,20
Triuna,sylvanas,1486,priest,discipline,41,20,21
Nomakprst,sanguino,1486,priest,discipline,130,63,67
Mewpew,azjolnerub,1486,priest,discipline,54,23,31
Dímension,ragnaros,1485,priest,discipline,110,64,46
Viì,ravencrest,1485,priest,discipline,30,16,14
Senpumara,malganis,1485,priest,discipline,300,150,150
Stevep,tarren-mill,1485,priest,discipline,72,36,36
Aguerran,spinebreaker,1485,priest,discipline,36,16,20
Cbsad,madmortem,1484,priest,discipline,90,49,41
Daddyfinger,argent-dawn,1483,priest,discipline,109,63,46
Хахеха,gordunni,1483,priest,discipline,30,17,13
Snuifje,azjolnerub,1483,priest,discipline,155,77,78
Enzyme,drakthul,1482,priest,discipline,36,24,12
Jetlìfe,ysondre,1482,priest,discipline,42,18,24
Ihaveibs,doomhammer,1481,priest,discipline,77,36,41
Rikipope,ravencrest,1480,priest,discipline,42,25,17
Spiochpr,burning-legion,1480,priest,discipline,144,81,63
Zarozina,pozzo-delleternità,1480,priest,discipline,42,21,21
Neoni,blackmoore,1480,priest,discipline,216,107,109
Averagenoob,ragnaros,1480,priest,discipline,81,35,46
Sehek,sanguino,1480,priest,discipline,72,31,41
Джелесана,gordunni,1479,priest,discipline,99,45,54
Ømñyx,outland,1479,priest,discipline,36,16,20
Banaynay,bronzebeard,1479,priest,discipline,59,24,35
Myrmz,archimonde,1478,priest,discipline,30,16,14
Лимью,soulflayer,1478,priest,discipline,62,26,36
Yhraeliaegh,defias-brotherhood,1478,priest,discipline,69,26,43
Migaz,runetotem,1477,priest,discipline,60,37,23
Juîcycheeks,frostwolf,1477,priest,discipline,132,70,62
Scréam,eredar,1477,priest,discipline,72,33,39
Pumpmenow,drakthul,1477,priest,discipline,48,22,26
Chrispriest,argent-dawn,1477,priest,discipline,56,24,32
Pristerline,antonidas,1476,priest,discipline,37,24,13
Fluba,thrall,1476,priest,discipline,65,39,26
Ssol,tarren-mill,1476,priest,discipline,60,33,27
Zhenni,ravencrest,1476,priest,discipline,30,16,14
Ilovedisc,kazzak,1476,priest,discipline,56,29,27
Noany,ravencrest,1475,priest,discipline,92,50,42
Пеппаслав,soulflayer,1475,priest,discipline,42,22,20
Keewix,ysondre,1475,priest,discipline,95,46,49
Hailor,blackmoore,1474,priest,discipline,48,29,19
Devot,outland,1474,priest,discipline,126,68,58
Mzpriest,dalaran,1474,priest,discipline,76,41,35
Jakeow,auchindoun,1474,priest,discipline,87,46,41
Buzzy,twisting-nether,1474,priest,discipline,144,75,69
Hunfall,stormscale,1474,priest,discipline,70,34,36
Chuckline,eredar,1474,priest,discipline,90,43,47
Tinteolo,blackrock,1474,priest,discipline,45,21,24
Avgenjoyer,kazzak,1474,priest,discipline,180,83,97
Holymöly,archimonde,1474,priest,discipline,49,20,29
Санггвиний,soulflayer,1473,priest,discipline,108,55,53
Sannti,twisting-nether,1473,priest,discipline,48,24,24
Sorrybowtdat,tarren-mill,1473,priest,discipline,120,56,64
Джулибуба,borean-tundra,1473,priest,discipline,57,26,31
Chimara,eredar,1472,priest,discipline,166,89,77
Acik,bladefist,1472,priest,discipline,59,27,32
Rasha,kazzak,1471,priest,discipline,111,60,51
Themistia,kazzak,1471,priest,discipline,151,70,81
Veilon,defias-brotherhood,1471,priest,discipline,60,24,36
Isuckpriest,aegwynn,1471,priest,discipline,54,21,33
Вичкрафт,howling-fjord,1471,priest,discipline,60,23,37
Porklifer,tarren-mill,1470,priest,discipline,54,32,22
Maneipriest,drakthul,1470,priest,discipline,65,35,30
Loarderonx,stormscale,1470,priest,discipline,35,16,19
Karoopi,ysondre,1469,priest,discipline,203,105,98
Liviúss,draenor,1469,priest,discipline,144,70,74
Doktoritca,kazzak,1469,priest,discipline,66,27,39
Agatioxd,dun-modr,1468,priest,discipline,48,31,17
Mástermínd,kazzak,1468,priest,discipline,57,34,23
Battra,argent-dawn,1468,priest,discipline,78,41,37
Unpsofablé,outland,1468,priest,discipline,52,27,25
Pewkz,draenor,1468,priest,discipline,164,83,81
Niholie,sinstralis,1468,priest,discipline,78,32,46
Drwlad,archimonde,1468,priest,discipline,66,26,40
Ykiotonegawa,twisting-nether,1468,priest,discipline,117,45,72
Жариха,gordunni,1467,priest,discipline,54,31,23
Tallzoné,ravencrest,1467,priest,discipline,86,48,38
Shaov,archimonde,1467,priest,discipline,42,22,20
Mylini,silvermoon,1467,priest,discipline,153,80,73
Властьтени,gordunni,1467,priest,discipline,175,87,88
Ёджих,blackscar,1467,priest,discipline,133,65,68
Brutapriestx,stormscale,1467,priest,discipline,35,16,19
Emon,nemesis,1466,priest,discipline,54,32,22
Prezica,stormscale,1466,priest,discipline,155,81,74
Yákizå,darksorrow,1466,priest,discipline,72,30,42
Khaag,korgall,1465,priest,discipline,54,27,27
Defineless,outland,1465,priest,discipline,165,76,89
Kanî,eredar,1465,priest,discipline,78,35,43
Sochnaochen,outland,1464,priest,discipline,84,48,36
Vanadii,blackhand,1464,priest,discipline,66,37,29
Jupiter,silvermoon,1464,priest,discipline,125,67,58
Sînálà,antonidas,1464,priest,discipline,68,35,33
Могулас,soulflayer,1464,priest,discipline,430,214,216
ßabylexa,ravencrest,1464,priest,discipline,140,65,75
Syrell,sanguino,1464,priest,discipline,35,16,19
Geierlol,blackrock,1464,priest,discipline,42,17,25
Shilôz,hyjal,1463,priest,discipline,138,75,63
Scade,kazzak,1463,priest,discipline,98,47,51
Асуартхас,gordunni,1463,priest,discipline,211,101,110
Хербоб,howling-fjord,1463,priest,discipline,202,95,107
Galadrielkä,drakthul,1462,priest,discipline,121,67,54
Ботхесатва,deepholm,1462,priest,discipline,77,35,42
Amoxkys,nemesis,1462,priest,discipline,86,39,47
Mackópriest,ragnaros,1462,priest,discipline,151,68,83
Unsáinted,stormscale,1461,priest,discipline,24,16,8
Krayziest,tarren-mill,1461,priest,discipline,42,26,16
Suaakypriest,tyrande,1461,priest,discipline,48,24,24
Мдзшка,gordunni,1461,priest,discipline,752,375,377
Лэрикус,howling-fjord,1461,priest,discipline,36,16,20
Goodgirl,frostmane,1460,priest,discipline,40,27,13
Elizabéth,blackrock,1460,priest,discipline,43,26,17
Crowdd,turalyon,1460,priest,discipline,118,67,51
Трэй,deathguard,1459,priest,discipline,90,50,40
Ðiscobiscuit,argent-dawn,1459,priest,discipline,104,55,49
Arize,dun-modr,1459,priest,discipline,48,24,24
Nÿpô,hyjal,1459,priest,discipline,89,40,49
Laxímink,sylvanas,1459,priest,discipline,101,41,60
Elfarity,tarren-mill,1458,priest,discipline,35,21,14
Ivysaurus,ravencrest,1458,priest,discipline,74,42,32
Yvaini,xavius,1458,priest,discipline,90,49,41
Leerzeichen,aegwynn,1458,priest,discipline,48,24,24
Ruly,ragnaros,1458,priest,discipline,51,25,26
Moarein,twisting-nether,1458,priest,discipline,72,32,40
Дюшапинанс,soulflayer,1456,priest,discipline,56,33,23
Enigam,alakir,1456,priest,discipline,78,41,37
Unholyfield,draenor,1456,priest,discipline,144,71,73
Dotdotggwp,stormscale,1456,priest,discipline,96,45,51
Péntagón,festung-der-stürme,1456,priest,discipline,48,19,29
Ijzerehenk,outland,1456,priest,discipline,94,35,59
Nyxalia,silvermoon,1455,priest,discipline,30,18,12
Sémi,twisting-nether,1455,priest,discipline,60,34,26
Kåstå,archimonde,1455,priest,discipline,92,51,41
Dêxter,hyjal,1455,priest,discipline,126,63,63
Boostpriest,archimonde,1454,priest,discipline,111,59,52
Фейкай,blackscar,1454,priest,discipline,54,28,26
Apøcalypso,antonidas,1454,priest,discipline,138,71,67
Disturbdtwo,archimonde,1454,priest,discipline,66,31,35
Panoio,aggra-português,1454,priest,discipline,95,41,54
Walúpe,draenor,1453,priest,discipline,30,21,9
Pedopräst,stormscale,1453,priest,discipline,83,42,41
Dealtime,ysondre,1453,priest,discipline,32,16,16
Алуриэлия,gordunni,1453,priest,discipline,83,40,43
Holyshart,magtheridon,1453,priest,discipline,77,37,40
Mvuu,kazzak,1452,priest,discipline,42,25,17
Otuschpriest,blackmoore,1452,priest,discipline,36,20,16
Troublemaker,durotan,1451,priest,discipline,66,37,29
Okeymokey,malganis,1451,priest,discipline,54,29,25
Kätsulol,ysondre,1451,priest,discipline,48,24,24
Boarheals,blackmoore,1451,priest,discipline,59,28,31
Baloopriest,grim-batol,1450,priest,discipline,42,17,25
Ylvanna,arthas,1450,priest,discipline,52,21,31
Sweetxq,tarren-mill,1449,priest,discipline,102,57,45
Chigreru,uldum,1449,priest,discipline,29,16,13
Kimozabi,ravencrest,1448,priest,discipline,50,25,25
Schmatzy,blackmoore,1448,priest,discipline,48,24,24
Vanillå,silvermoon,1448,priest,discipline,84,41,43
Ryazz,blackrock,1448,priest,discipline,48,22,26
Adolin,onyxia,1447,priest,discipline,47,24,23
Frekio,eitrigg,1447,priest,discipline,155,79,76
Angelic,ragnaros,1447,priest,discipline,191,92,99
Mysticks,kirin-tor,1447,priest,discipline,36,17,19
Mòly,archimonde,1446,priest,discipline,27,17,10
Æsia,archimonde,1446,priest,discipline,45,25,20
Toorree,stormscale,1446,priest,discipline,137,70,67
Kâltak,aegwynn,1446,priest,discipline,48,24,24
Sáshagrey,arathor,1446,priest,discipline,49,24,25
Sameec,drakthul,1446,priest,discipline,129,60,69
Крутосанка,blackscar,1445,priest,discipline,42,22,20
Solaqt,tarren-mill,1445,priest,discipline,48,19,29
Miileys,arthas,1444,priest,discipline,43,26,17
Серыйлог,galakrond,1444,priest,discipline,90,49,41
Jazzmind,stormscale,1444,priest,discipline,150,77,73
Hypernym,eredar,1443,priest,discipline,32,20,12
Возрождающее,soulflayer,1443,priest,discipline,90,47,43
Arkkupiispa,stormreaver,1443,priest,discipline,459,228,231
Trekztwo,archimonde,1443,priest,discipline,66,32,34
Chankilolx,dun-modr,1443,priest,discipline,175,81,94
Arctoczax,ravencrest,1443,priest,discipline,66,27,39
Lâughing,ravencrest,1442,priest,discipline,36,24,12
Sombralúz,sanguino,1442,priest,discipline,36,20,16
Verzeichnis,thrall,1442,priest,discipline,148,81,67
Aizakku,frostmane,1442,priest,discipline,36,19,17
Benificent,argent-dawn,1442,priest,discipline,213,108,105
Shanny,kazzak,1442,priest,discipline,89,43,46
Kreador,twisting-nether,1442,priest,discipline,48,23,25
Chibrausorus,archimonde,1442,priest,discipline,60,27,33
Aeritha,blackmoore,1441,priest,discipline,30,19,11
Tarellia,argent-dawn,1441,priest,discipline,217,123,94
Laurent,sanguino,1441,priest,discipline,36,16,20
Pinkyladdy,argent-dawn,1441,priest,discipline,53,23,30
Svistis,ravencrest,1440,priest,discipline,28,20,8
Смегмачет,soulflayer,1440,priest,discipline,122,63,59
Yesdaddypls,draenor,1439,priest,discipline,36,21,15
Lyés,uldaman,1439,priest,discipline,247,141,106
Squidlicker,twisting-nether,1439,priest,discipline,46,23,23
Voxqt,blackrock,1439,priest,discipline,30,15,15
Cáss,archimonde,1439,priest,discipline,30,15,15
Zeraphïn,eredar,1439,priest,discipline,30,15,15
Bedkara,ravencrest,1439,priest,discipline,30,15,15
Sinfulmaze,outland,1439,priest,discipline,30,15,15
Zedrus,azshara,1439,priest,discipline,111,53,58
Youkounkoun,garona,1438,priest,discipline,41,26,15
Jerzay,hyjal,1438,priest,discipline,112,53,59
Åshbé,archimonde,1437,priest,discipline,18,15,3
Hopeso,silvermoon,1437,priest,discipline,18,15,3
Zooster,pozzo-delleternità,1437,priest,discipline,48,29,19
Helikipope,kazzak,1437,priest,discipline,30,17,13
Sadkitten,sylvanas,1437,priest,discipline,301,164,137
Чилюотферала,eversong,1437,priest,discipline,30,15,15
Mainhunter,aegwynn,1437,priest,discipline,30,15,15
Yøløswagg,silvermoon,1437,priest,discipline,116,49,67
Fotmape,stormscale,1437,priest,discipline,36,15,21
Rihx,ysondre,1436,priest,discipline,25,17,8
Syro,defias-brotherhood,1436,priest,discipline,45,26,19
Tony,agamaggan,1436,priest,discipline,71,38,33
Orophar,antonidas,1436,priest,discipline,221,111,110
Nolosme,blackrock,1436,priest,discipline,42,21,21
Rmpriest,blackhand,1436,priest,discipline,30,15,15
Feniyxa,die-aldor,1436,priest,discipline,30,15,15
Anotherdisc,aegwynn,1436,priest,discipline,244,115,129
Dzoo,kazzak,1436,priest,discipline,58,27,31
Kbakå,stormscale,1436,priest,discipline,84,37,47
Jàckîe,aegwynn,1436,priest,discipline,40,17,23
Xayrin,thrall,1435,priest,discipline,78,43,35
Darkoze,kazzak,1435,priest,discipline,54,29,25
Pàndoràh,nemesis,1435,priest,discipline,42,22,20
Carolyna,ravencrest,1435,priest,discipline,36,15,21
Mindcrackr,stormscale,1434,priest,discipline,36,22,14
Xubeqi,kazzak,1434,priest,discipline,213,112,101
Kæyc,blackmoore,1434,priest,discipline,71,35,36
Anniegelic,ravencrest,1434,priest,discipline,42,19,23
Cajolîne,archimonde,1434,priest,discipline,162,73,89
Villagegirlx,stormscale,1433,priest,discipline,30,18,12
Barcodes,kazzak,1433,priest,discipline,69,40,29
Selëne,blackrock,1433,priest,discipline,42,22,20
Simplesam,ravencrest,1433,priest,discipline,94,49,45
Prayxlol,outland,1433,priest,discipline,30,15,15
Størmblaze,stormreaver,1433,priest,discipline,30,15,15
Nirsis,dun-modr,1433,priest,discipline,93,45,48
Bochonok,stormrage,1433,priest,discipline,36,15,21
Bigwik,tarren-mill,1433,priest,discipline,42,15,27
Dimsim,kazzak,1432,priest,discipline,24,15,9
Elderiel,turalyon,1432,priest,discipline,331,173,158
Fantästic,kazzak,1432,priest,discipline,197,100,97
Swera,twisting-nether,1431,priest,discipline,24,15,9
Letmehêal,archimonde,1431,priest,discipline,48,28,20
Сашадвасм,gordunni,1431,priest,discipline,111,60,51
Ebashuvkashu,stormscale,1431,priest,discipline,45,24,21
Nazhara,hyjal,1431,priest,discipline,30,15,15
Scràppy,malganis,1431,priest,discipline,30,15,15
Mungam,draenor,1431,priest,discipline,81,38,43
Kâmy,archimonde,1430,priest,discipline,54,33,21
Altar,grim-batol,1430,priest,discipline,125,72,53
Гачибунта,blackscar,1430,priest,discipline,142,79,63
Vaetrilla,doomhammer,1430,priest,discipline,37,20,17
Soulreapper,blackhand,1430,priest,discipline,219,115,104
Черныйсписок,gordunni,1430,priest,discipline,54,27,27
Inzàné,kazzak,1430,priest,discipline,60,25,35
Delinsx,outland,1430,priest,discipline,36,15,21
Mírá,burning-blade,1429,priest,discipline,42,29,13
Lanaineuwu,archimonde,1429,priest,discipline,32,22,10
Эмжи,howling-fjord,1429,priest,discipline,24,15,9
Eladri,silvermoon,1429,priest,discipline,24,15,9
Lalgorithme,hyjal,1429,priest,discipline,30,18,12
Ashérs,ravencrest,1429,priest,discipline,99,58,41
ßrain,garona,1429,priest,discipline,30,15,15
Sbeecha,argent-dawn,1429,priest,discipline,108,48,60
Yurrij,thrall,1428,priest,discipline,39,23,16
Lucidluke,blackmoore,1428,priest,discipline,55,25,30
Ninetzz,tarren-mill,1427,priest,discipline,36,26,10
Nätrix,tarren-mill,1427,priest,discipline,24,15,9
Diddlefiddle,stormscale,1427,priest,discipline,64,36,28
Baybe,ravencrest,1427,priest,discipline,129,71,58
Illüminaty,sylvanas,1427,priest,discipline,115,60,55
Putinkuilo,outland,1427,priest,discipline,48,25,23
Azarseth,exodar,1427,priest,discipline,48,24,24
Klituriis,twisting-nether,1427,priest,discipline,89,44,45
Holydreed,ragnaros,1427,priest,discipline,36,17,19
Blaçkout,ravencrest,1427,priest,discipline,48,21,27
Randomm,shadowsong,1427,priest,discipline,60,23,37
Ylenae,twisting-nether,1427,priest,discipline,42,15,27
Amanojakü,ravencrest,1426,priest,discipline,48,34,14
Holymøly,earthen-ring,1426,priest,discipline,57,29,28
Joeasaurs,ragnaros,1426,priest,discipline,33,16,17
Viagrà,outland,1426,priest,discipline,120,53,67
Emala,hyjal,1426,priest,discipline,35,15,20
Massdispell,silvermoon,1425,priest,discipline,34,20,14
Нэилшери,gordunni,1425,priest,discipline,48,25,23
Jael,frostmane,1425,priest,discipline,62,30,32
Урголиафа,howling-fjord,1425,priest,discipline,54,25,29
Miris,ysondre,1425,priest,discipline,48,21,27
Maidie,stormscale,1424,priest,discipline,66,41,25
Whiskeyhaze,burning-legion,1424,priest,discipline,78,42,36
Berstkraft,blackmoore,1424,priest,discipline,30,15,15
Хальтэнис,gordunni,1424,priest,discipline,48,23,25
Zymai,ravencrest,1424,priest,discipline,42,15,27
Hónòr,sylvanas,1424,priest,discipline,59,20,39
Кэндимен,gordunni,1423,priest,discipline,321,165,156
Кхарли,howling-fjord,1423,priest,discipline,30,15,15
Nyxém,blackmoore,1423,priest,discipline,36,15,21
Huhu,defias-brotherhood,1422,priest,discipline,36,21,15
Юлечка,blackscar,1422,priest,discipline,36,19,17
Phreyst,draenor,1422,priest,discipline,177,91,86
Ahmnesia,archimonde,1422,priest,discipline,218,111,107
Pìkachù,stormscale,1422,priest,discipline,60,28,32
Îlkari,hyjal,1421,priest,discipline,24,17,7
Dankopriest,drakthul,1421,priest,discipline,54,28,26
Kathja,outland,1421,priest,discipline,30,15,15
Птист,azuregos,1421,priest,discipline,42,17,25
Halastrâ,tarren-mill,1420,priest,discipline,50,33,17
Kenzaiq,aegwynn,1420,priest,discipline,42,24,18
Lapinvicieux,archimonde,1420,priest,discipline,60,32,28
Klosso,anachronos,1420,priest,discipline,66,35,31
Тенсаи,howling-fjord,1420,priest,discipline,76,40,36
Bandgap,antonidas,1420,priest,discipline,176,88,88
Yorap,blackrock,1420,priest,discipline,36,17,19
Zarez,stormscale,1420,priest,discipline,50,17,33
Arthyria,archimonde,1419,priest,discipline,48,26,22
Сафири,blackscar,1419,priest,discipline,30,15,15
Meanazer,antonidas,1419,priest,discipline,66,30,36
Alianza,hellfire,1418,priest,discipline,36,25,11
Voltáren,blackmoore,1418,priest,discipline,50,33,17
Noreal,twisting-nether,1418,priest,discipline,36,23,13
Nazzghul,silvermoon,1418,priest,discipline,24,15,9
Нэстикус,gordunni,1418,priest,discipline,30,16,14
Aeternethy,ravencrest,1418,priest,discipline,36,18,18
Медиив,deepholm,1418,priest,discipline,66,32,34
Gbpjr,xavius,1418,priest,discipline,211,102,109
Banshzz,ragnaros,1418,priest,discipline,83,34,49
Holywann,argent-dawn,1417,priest,discipline,29,18,11
Eagleess,silvermoon,1417,priest,discipline,42,25,17
Sprutch,kazzak,1417,priest,discipline,56,30,26
Тучанх,greymane,1417,priest,discipline,49,24,25
Vividots,draenor,1417,priest,discipline,42,20,22
Malyzion,draenor,1416,priest,discipline,136,77,59
Hlyhoe,silvermoon,1415,priest,discipline,72,41,31
Zivy,silvermoon,1415,priest,discipline,110,61,49
Priesticchi,stormscale,1415,priest,discipline,101,56,45
Mertérésa,hyjal,1415,priest,discipline,67,36,31
Salyisra,draenor,1415,priest,discipline,119,63,56
Cryksî,eredar,1415,priest,discipline,96,46,50
Рейсина,gordunni,1415,priest,discipline,36,15,21
Теньраа,soulflayer,1415,priest,discipline,54,21,33
Bakony,ravencrest,1414,priest,discipline,60,41,19
Yukíø,antonidas,1414,priest,discipline,30,18,12
Praybro,blackmoore,1414,priest,discipline,41,24,17
Тесира,blackscar,1414,priest,discipline,42,23,19
Ghostroller,pozzo-delleternità,1414,priest,discipline,55,28,27
Vynivan,korgall,1414,priest,discipline,54,24,30
Lucéa,antonidas,1413,priest,discipline,38,26,12
Kaeldara,ysondre,1413,priest,discipline,24,15,9
Deathchicka,draenor,1413,priest,discipline,64,37,27
Ylivoima,stormscale,1413,priest,discipline,42,24,18
Zïn,silvermoon,1413,priest,discipline,58,29,29
Toratorap,burning-legion,1413,priest,discipline,30,15,15
Indicta,darksorrow,1413,priest,discipline,33,16,17
Joseantuan,sanguino,1412,priest,discipline,30,18,12
Vqny,archimonde,1412,priest,discipline,153,85,68
Cntrl,frostmane,1412,priest,discipline,164,91,73
Castalia,ravencrest,1412,priest,discipline,101,48,53
Bekareth,archimonde,1411,priest,discipline,119,65,54
Mortex,nemesis,1411,priest,discipline,66,36,30
Вестайс,gordunni,1411,priest,discipline,77,36,41
Rwaphouu,ysondre,1410,priest,discipline,66,39,27
Ецци,howling-fjord,1410,priest,discipline,44,23,21
Faelvirin,aegwynn,1410,priest,discipline,41,21,20
Shanya,thrall,1410,priest,discipline,42,20,22
Jóhnnybravó,kazzak,1410,priest,discipline,36,16,20
Krasawìtch,onyxia,1410,priest,discipline,113,50,63
Вутитути,howling-fjord,1410,priest,discipline,36,15,21
Èlysium,grim-batol,1410,priest,discipline,54,21,33
Munchies,scarshield-legion,1409,priest,discipline,30,17,13
Aiewn,elune,1409,priest,discipline,113,63,50
Undeabniss,nathrezim,1409,priest,discipline,29,16,13
Бомжскадилом,gordunni,1409,priest,discipline,237,125,112
Dunderprälle,outland,1409,priest,discipline,30,15,15
Slasherh,ravencrest,1409,priest,discipline,195,96,99
Vadhänder,the-maelstrom,1409,priest,discipline,60,29,31
Cainactor,drakthul,1409,priest,discipline,54,25,29
Acidpills,hyjal,1409,priest,discipline,52,23,29
Lévention,stormscale,1408,priest,discipline,36,20,16
Пакетикдот,gordunni,1408,priest,discipline,297,163,134
Lekadolplusc,doomhammer,1408,priest,discipline,414,220,194
Дядяврач,howling-fjord,1408,priest,discipline,194,97,97
Bananensuppe,kult-der-verdammten,1408,priest,discipline,72,33,39
Ascendare,tarren-mill,1408,priest,discipline,83,35,48
Tarana,mannoroth,1407,priest,discipline,32,18,14
Ensamstående,twisting-nether,1407,priest,discipline,108,57,51
Ysharrj,hyjal,1407,priest,discipline,42,22,20
Sensor,kazzak,1407,priest,discipline,105,52,53
Sppid,sanguino,1407,priest,discipline,350,170,180
Castpenance,blackrock,1407,priest,discipline,161,71,90
Некроликон,grom,1406,priest,discipline,30,18,12
Gothixs,draenor,1406,priest,discipline,44,26,18
Garfriest,aggra-português,1406,priest,discipline,78,46,32
Doctep,sargeras,1406,priest,discipline,52,30,22
Carlye,stormreaver,1406,priest,discipline,30,17,13
Tyrhaa,blackmoore,1406,priest,discipline,30,16,14
Medivs,blackmoore,1405,priest,discipline,30,17,13
Elosen,darkspear,1405,priest,discipline,48,27,21
ßowforme,aegwynn,1405,priest,discipline,66,37,29
Valeriana,stormreaver,1405,priest,discipline,192,102,90
Kappa,darksorrow,1405,priest,discipline,54,28,26
Marllen,twisting-nether,1405,priest,discipline,337,164,173
Holysquirt,twisting-nether,1405,priest,discipline,42,18,24
Трезида,gordunni,1404,priest,discipline,48,24,24
Летиин,gordunni,1404,priest,discipline,83,40,43
Dragovic,chogall,1404,priest,discipline,80,38,42
Flaskandeux,tarren-mill,1404,priest,discipline,194,76,118
Divinekat,tarren-mill,1403,priest,discipline,52,34,18
Chilie,ravencrest,1403,priest,discipline,44,23,21
Пэйтен,deathguard,1403,priest,discipline,30,15,15
Madkes,ravencrest,1403,priest,discipline,186,92,94
Eileengu,silvermoon,1402,priest,discipline,70,42,28
Ùçù,dalaran,1402,priest,discipline,70,40,30
Goosebot,stormscale,1402,priest,discipline,30,15,15
Kalestharia,blackmoore,1402,priest,discipline,192,90,102
Kbakå,kazzak,1402,priest,discipline,32,15,17
Dejica,kult-der-verdammten,1402,priest,discipline,102,46,56
Virulent,nemesis,1402,priest,discipline,36,15,21
Preachyjeg,ravencrest,1402,priest,discipline,114,46,68
Fireflowers,silvermoon,1401,priest,discipline,108,54,54
Dysko,alakir,1401,priest,discipline,30,15,15
Synoé,la-croisade-écarlate,1401,priest,discipline,101,49,52
Durinko,thunderhorn,1401,priest,discipline,72,31,41
Tsipaz,outland,1401,priest,discipline,35,15,20
Dènna,eldrethalas,1401,priest,discipline,54,22,32
Бархомелфой,gordunni,1400,priest,discipline,51,26,25
Рукатёмная,soulflayer,1400,priest,discipline,83,37,46
Cyberlunatic,antonidas,1400,priest,discipline,184,80,104
Вурти,howling-fjord,1400,priest,discipline,65,28,37
Crazyname,outland,1399,priest,discipline,235,119,116
Quetraxz,chogall,1398,priest,discipline,36,19,17
Laadyybirkee,blackhand,1398,priest,discipline,140,70,70
Diva,malfurion,1398,priest,discipline,52,24,28
Avázàr,stormscale,1398,priest,discipline,36,16,20
Fiilaaja,stormreaver,1397,priest,discipline,42,26,16
Vrynna,kazzak,1397,priest,discipline,138,74,64
Menda,eredar,1397,priest,discipline,130,68,62
Ventorina,die-aldor,1397,priest,discipline,62,32,30
Шпангл,gordunni,1397,priest,discipline,222,110,112
Marryisme,twisting-nether,1397,priest,discipline,102,46,56
Холишитс,gordunni,1396,priest,discipline,115,64,51
Sebatröz,ravencrest,1396,priest,discipline,42,23,19
Морикаа,lich-king,1396,priest,discipline,30,16,14
Crimsõn,kazzak,1396,priest,discipline,48,24,24
Hellscon,kazzak,1396,priest,discipline,42,21,21
Rahan,stormscale,1396,priest,discipline,93,46,47
Ministry,tirion,1396,priest,discipline,48,23,25
Darkest,ysondre,1396,priest,discipline,83,37,46
Rixis,la-croisade-écarlate,1396,priest,discipline,72,32,40
Nudavbrne,drakthul,1395,priest,discipline,18,15,3
Calisé,argent-dawn,1395,priest,discipline,24,15,9
Deadpxlz,ravencrest,1395,priest,discipline,30,17,13
Evilangèl,ravenholdt,1395,priest,discipline,83,45,38
Alakkiria,ravencrest,1394,priest,discipline,77,38,39
Fåtkidx,ravencrest,1394,priest,discipline,79,35,44
Бленди,howling-fjord,1394,priest,discipline,36,15,21
Kroa,ragnaros,1393,priest,discipline,24,15,9
Kiropap,silvermoon,1393,priest,discipline,43,26,17
Littleheal,ghostlands,1393,priest,discipline,49,24,25
Oxborn,thrall,1392,priest,discipline,95,45,50
Skarnir,uldaman,1392,priest,discipline,105,40,65
Xarxis,twisting-nether,1392,priest,discipline,54,20,34
Pøsæ,uldaman,1391,priest,discipline,26,16,10
Exila,rashgarroth,1391,priest,discipline,37,18,19
Animepfp,stormreaver,1391,priest,discipline,140,67,73
Anzil,dun-modr,1391,priest,discipline,146,67,79
Thorhammer,turalyon,1390,priest,discipline,36,22,14
Zombîe,draenor,1390,priest,discipline,42,16,26
Judine,kazzak,1389,priest,discipline,23,15,8
Paine,pozzo-delleternità,1389,priest,discipline,65,38,27
Hardcode,twisting-nether,1389,priest,discipline,96,45,51
Меинбиг,gordunni,1389,priest,discipline,52,21,31
Hashoko,draenor,1388,priest,discipline,30,22,8
Aaron,aegwynn,1388,priest,discipline,31,20,11
Amnesztia,ragnaros,1388,priest,discipline,53,28,25
Yeahr,kazzak,1388,priest,discipline,29,15,14
Уноханагодх,howling-fjord,1388,priest,discipline,92,46,46
Taiyöshin,silvermoon,1388,priest,discipline,106,52,54
Juco,draenor,1388,priest,discipline,36,17,19
Neverswap,blackmoore,1387,priest,discipline,26,16,10
Hidr,nemesis,1387,priest,discipline,84,46,38
Эйвиг,blackscar,1387,priest,discipline,75,32,43
Cooriolis,sylvanas,1386,priest,discipline,24,17,7
Nakali,the-maelstrom,1386,priest,discipline,30,16,14
Grravehheart,kazzak,1386,priest,discipline,85,45,40
Альфреска,gordunni,1386,priest,discipline,94,48,46
Blaelel,dun-modr,1386,priest,discipline,30,15,15
Aisha,rajaxx,1386,priest,discipline,87,42,45
Pyropenance,twisting-nether,1386,priest,discipline,83,35,48
Гшд,gordunni,1385,priest,discipline,78,43,35
Rosalina,ravencrest,1385,priest,discipline,228,120,108
Jaatjak,ravencrest,1385,priest,discipline,78,37,41
Kaémon,twisting-nether,1385,priest,discipline,118,51,67
Mazzekeen,burning-legion,1385,priest,discipline,43,17,26
Atremius,dragonmaw,1384,priest,discipline,54,24,30
Snuffanious,ragnaros,1384,priest,discipline,60,26,34
Borrex,sanguino,1383,priest,discipline,19,16,3
Vendormeq,darkspear,1383,priest,discipline,30,16,14
Holynelph,kazzak,1383,priest,discipline,32,16,16
Insekta,ragnaros,1383,priest,discipline,36,16,20
Predpriest,twisting-nether,1383,priest,discipline,43,16,27
Libido,outland,1382,priest,discipline,119,66,53
Tintapri,aszune,1382,priest,discipline,122,62,60
Naïlu,hyjal,1381,priest,discipline,66,38,28
Cring,kirin-tor,1381,priest,discipline,132,73,59
Ruderali,blackmoore,1381,priest,discipline,306,157,149
Selenee,scarshield-legion,1381,priest,discipline,102,47,55
Tiktokdancér,kazzak,1380,priest,discipline,132,72,60
Иванпугачев,soulflayer,1380,priest,discipline,36,18,18
Thrakoun,twilights-hammer,1380,priest,discipline,242,120,122
Lothyf,archimonde,1379,priest,discipline,52,29,23
Micobra,dalaran,1379,priest,discipline,41,22,19
Elderath,eredar,1379,priest,discipline,116,55,61
Phèbz,archimonde,1378,priest,discipline,48,29,19
Vaewyn,ravencrest,1378,priest,discipline,79,42,37
Лимоняшечка,soulflayer,1378,priest,discipline,110,58,52
Woid,aegwynn,1378,priest,discipline,30,15,15
Streety,nethersturm,1378,priest,discipline,90,43,47
Bubidiblumpr,twisting-nether,1377,priest,discipline,84,47,37
Gangreana,kazzak,1377,priest,discipline,78,42,36
Sílvana,nordrassil,1377,priest,discipline,154,82,72
Carnacia,tarren-mill,1376,priest,discipline,84,48,36
Annisa,kazzak,1376,priest,discipline,131,71,60
Vilanae,hyjal,1376,priest,discipline,110,57,53
Punkrockgirl,destromath,1376,priest,discipline,48,24,24
Эстрогенс,gordunni,1376,priest,discipline,60,22,38
Bacberon,skullcrusher,1375,priest,discipline,48,30,18
Джороко,howling-fjord,1375,priest,discipline,36,22,14
Dolifrius,dalaran,1375,priest,discipline,50,30,20
Ompala,shattered-hand,1375,priest,discipline,43,23,20
Dotterin,draenor,1375,priest,discipline,162,78,84
Invexx,tarren-mill,1375,priest,discipline,267,123,144
Synteria,gilneas,1375,priest,discipline,78,31,47
Dazé,ravencrest,1374,priest,discipline,59,43,16
Symeria,sylvanas,1374,priest,discipline,78,43,35
Qïx,ravencrest,1374,priest,discipline,45,24,21
Psyfir,outland,1374,priest,discipline,224,117,107
Spiriman,zuljin,1374,priest,discipline,30,15,15
Otheym,the-maelstrom,1374,priest,discipline,39,18,21
Pocketissue,ravencrest,1373,priest,discipline,32,21,11
Blackheal,sanguino,1373,priest,discipline,68,29,39
Juliane,trollbane,1373,priest,discipline,90,35,55
Waramoly,eredar,1372,priest,discipline,30,16,14
Majinme,kazzak,1372,priest,discipline,60,31,29
Rabbît,stormscale,1372,priest,discipline,82,42,40
Hiereia,khadgar,1372,priest,discipline,139,61,78
Geesuz,outland,1372,priest,discipline,39,16,23
Bomzhik,silvermoon,1371,priest,discipline,229,126,103
Скизма,gordunni,1370,priest,discipline,42,25,17
Smitey,terenas,1370,priest,discipline,124,68,56
Kayeen9DF0F1,tarren-mill,1370,priest,discipline,130,65,65
Kotipope,silvermoon,1369,priest,discipline,83,49,34
Nûwa,draenor,1369,priest,discipline,77,45,32
Feelmypainn,kazzak,1369,priest,discipline,96,51,45
Holypepper,outland,1369,priest,discipline,137,69,68
Baddly,silvermoon,1369,priest,discipline,170,81,89
Sâtânica,kelthuzad,1369,priest,discipline,119,55,64
Lunegrise,archimonde,1369,priest,discipline,60,27,33
Asprine,kazzak,1368,priest,discipline,72,44,28
Priesturz,aggramar,1368,priest,discipline,30,16,14
Zoose,defias-brotherhood,1368,priest,discipline,32,17,15
Aykò,blackmoore,1368,priest,discipline,38,16,22
Discobrill,silvermoon,1368,priest,discipline,84,34,50
Joxdox,archimonde,1367,priest,discipline,42,20,22
Aethana,ravencrest,1367,priest,discipline,40,18,22
Speltmor,stormscale,1367,priest,discipline,42,18,24
Burtarul,argent-dawn,1366,priest,discipline,27,16,11
Ghorfindel,kaelthas,1366,priest,discipline,53,30,23
Mamaoh,ravencrest,1366,priest,discipline,69,34,35
Minsie,silvermoon,1366,priest,discipline,59,26,33
Valythria,blackhand,1365,priest,discipline,74,38,36
Nattramnone,blackmoore,1365,priest,discipline,36,18,18
Xelivia,draenor,1365,priest,discipline,113,56,57
Berrylee,twisting-nether,1365,priest,discipline,61,26,35
Elûnä,ysondre,1364,priest,discipline,340,179,161
Carcaz,blackmoore,1364,priest,discipline,59,27,32
Hidary,ysondre,1364,priest,discipline,67,30,37
Veecna,the-maelstrom,1363,priest,discipline,144,77,67
Durness,argent-dawn,1363,priest,discipline,84,42,42
Raî,durotan,1363,priest,discipline,48,24,24
Manuba,antonidas,1363,priest,discipline,36,17,19
Priszt,arathor,1363,priest,discipline,36,15,21
Злюкыч,gordunni,1362,priest,discipline,84,48,36
Экспл,lich-king,1362,priest,discipline,28,15,13
Созвонимся,gordunni,1362,priest,discipline,97,47,50
Xyfas,azshara,1362,priest,discipline,54,25,29
Joniop,stormreaver,1362,priest,discipline,72,33,39
Bjornqt,ragnaros,1362,priest,discipline,86,35,51
Rzpa,blackhand,1361,priest,discipline,93,48,45
Grausami,zuluhed,1361,priest,discipline,48,24,24
Wish,blackmoore,1361,priest,discipline,134,65,69
Híppokrates,dethecus,1361,priest,discipline,85,37,48
Liaru,aegwynn,1361,priest,discipline,84,32,52
Darkweed,twilights-hammer,1360,priest,discipline,72,42,30
Matsipri,sylvanas,1360,priest,discipline,96,50,46
Carrhyks,archimonde,1360,priest,discipline,108,56,52
Morerespect,lothar,1360,priest,discipline,30,15,15
Chaosxo,draenor,1360,priest,discipline,102,49,53
Pètunia,ravencrest,1359,priest,discipline,314,164,150
Dooga,draenor,1359,priest,discipline,30,15,15
Ÿë,stormreaver,1359,priest,discipline,37,15,22
Prellish,draenor,1358,priest,discipline,72,33,39
Krìnzy,illidan,1358,priest,discipline,82,36,46
Priesless,sylvanas,1357,priest,discipline,34,20,14
Mércíless,ravencrest,1357,priest,discipline,71,39,32
Простойа,deathguard,1357,priest,discipline,134,71,63
Gïanna,archimonde,1357,priest,discipline,132,65,67
Элизабетшорт,soulflayer,1357,priest,discipline,60,26,34
Nerfy,tarren-mill,1356,priest,discipline,48,23,25
Xdthe,tarren-mill,1356,priest,discipline,144,68,76
Smilyface,sylvanas,1356,priest,discipline,73,34,39
Лакукарача,howling-fjord,1356,priest,discipline,60,24,36
Äkvä,ragnaros,1356,priest,discipline,66,26,40
Dànè,defias-brotherhood,1355,priest,discipline,30,21,9
Cé,magtheridon,1355,priest,discipline,85,43,42
Paterpaisios,kazzak,1355,priest,discipline,54,20,34
Sasabsi,malorne,1354,priest,discipline,48,27,21
Nésha,dun-modr,1354,priest,discipline,41,21,20
Byxoph,sanguino,1354,priest,discipline,95,47,48
Miabelle,argent-dawn,1354,priest,discipline,58,27,31
Тодохил,gordunni,1354,priest,discipline,149,69,80
Evolís,blackmoore,1354,priest,discipline,72,31,41
Vanillahaze,sylvanas,1353,priest,discipline,36,23,13
Sphero,kazzak,1353,priest,discipline,48,27,21
Keltalador,zuljin,1353,priest,discipline,47,21,26
Solarïah,garona,1352,priest,discipline,32,19,13
Priestige,spinebreaker,1352,priest,discipline,36,21,15
Adev,drakthul,1352,priest,discipline,71,35,36
Alliora,dalaran,1352,priest,discipline,122,52,70
Anaalipeura,stormreaver,1352,priest,discipline,72,30,42
Littlehelper,shendralar,1352,priest,discipline,39,16,23
Chealsey,thrall,1351,priest,discipline,57,36,21
Shîn,aegwynn,1351,priest,discipline,90,44,46
Zellia,frostmane,1351,priest,discipline,102,48,54
Jcnun,xavius,1351,priest,discipline,98,45,53
Brelett,the-maelstrom,1351,priest,discipline,36,16,20
Давалкасвета,gordunni,1351,priest,discipline,74,32,42
Torî,blackrock,1351,priest,discipline,66,26,40
Dirtydoc,area-52,1350,priest,discipline,48,27,21
Маимморта,howling-fjord,1350,priest,discipline,72,39,33
Bublies,silvermoon,1349,priest,discipline,43,24,19
Levy,azuremyst,1349,priest,discipline,37,20,17
Sytawa,blackmoore,1349,priest,discipline,104,55,49
Katrynax,ravencrest,1349,priest,discipline,121,63,58
Sabaxdxd,dun-modr,1349,priest,discipline,173,84,89
Anubisones,uldum,1349,priest,discipline,89,43,46
Девственен,soulflayer,1349,priest,discipline,54,26,28
Levinson,zuljin,1348,priest,discipline,60,40,20
Jerichó,blackmoore,1348,priest,discipline,58,38,20
Sykra,magtheridon,1348,priest,discipline,136,75,61
Styrbjörn,shattered-hand,1348,priest,discipline,91,48,43
Крашдайс,soulflayer,1348,priest,discipline,115,53,62
Dstars,archimonde,1348,priest,discipline,42,16,26
Cottyx,outland,1347,priest,discipline,69,42,27
Vzã,krasus,1347,priest,discipline,42,23,19
Fatishcribe,twisting-nether,1347,priest,discipline,261,135,126
Greedyaf,stormscale,1347,priest,discipline,101,48,53
Brênos,blackmoore,1346,priest,discipline,29,17,12
Хаварь,gordunni,1346,priest,discipline,134,71,63
Chowhone,archimonde,1346,priest,discipline,142,74,68
Holyfussell,antonidas,1346,priest,discipline,80,38,42
Iamfrosty,draenor,1346,priest,discipline,66,31,35
Шруня,howling-fjord,1346,priest,discipline,102,43,59
Boulotpas,hyjal,1345,priest,discipline,106,65,41
Lydrian,argent-dawn,1345,priest,discipline,28,17,11
Salzgehalt,antonidas,1345,priest,discipline,116,66,50
Pwjetlifelol,grim-batol,1345,priest,discipline,97,52,45
Hugeaf,antonidas,1344,priest,discipline,37,24,13
Smålbenör,stormreaver,1344,priest,discipline,51,27,24
Gothandor,der-rat-von-dalaran,1344,priest,discipline,42,22,20
Дэтметал,grom,1344,priest,discipline,254,127,127
Alz,rashgarroth,1344,priest,discipline,147,71,76
Batsu,hyjal,1344,priest,discipline,94,43,51
Dibelo,eredar,1344,priest,discipline,41,17,24
Disconsick,vashj,1344,priest,discipline,118,45,73
Buan,outland,1343,priest,discipline,24,14,10
Nëw,los-errantes,1343,priest,discipline,24,14,10
Rptr,ravencrest,1342,priest,discipline,18,14,4
Chuckbarry,kazzak,1342,priest,discipline,24,15,9
Zaradana,tarren-mill,1342,priest,discipline,96,51,45
Barracuda,burning-legion,1342,priest,discipline,104,52,52
Xandrial,blackmoore,1342,priest,discipline,30,14,16
Поднялбабки,deathguard,1342,priest,discipline,36,14,22
Rukiä,chogall,1341,priest,discipline,24,14,10
Nerfnerf,kazzak,1341,priest,discipline,574,291,283
Soreboners,stormscale,1341,priest,discipline,30,14,16
Nietzsche,area-52,1341,priest,discipline,128,59,69
Jagersmite,twisting-nether,1340,priest,discipline,120,64,56
Phórkys,kazzak,1340,priest,discipline,645,327,318
Cutename,burning-blade,1340,priest,discipline,36,18,18
Sephìrøth,malganis,1340,priest,discipline,66,32,34
Fakebob,draenor,1340,priest,discipline,42,20,22
Svevo,ravencrest,1340,priest,discipline,139,66,73
Далайна,galakrond,1340,priest,discipline,36,14,22
Дармирэль,gordunni,1340,priest,discipline,65,25,40
Ýbëzz,ravencrest,1339,priest,discipline,24,14,10
Staatsfeind,blackmoore,1339,priest,discipline,77,44,33
Nakenhäst,ravencrest,1339,priest,discipline,36,14,22
Guerilagusto,draenor,1339,priest,discipline,42,16,26
Stargóddess,kazzak,1338,priest,discipline,164,89,75
Батлграунтт,soulflayer,1338,priest,discipline,78,42,36
Ziaz,the-maelstrom,1338,priest,discipline,46,23,23
Zéntius,twisting-nether,1338,priest,discipline,30,14,16
Skelica,ragnaros,1337,priest,discipline,24,14,10
Yaoz,sanguino,1337,priest,discipline,24,14,10
Wortgottes,blackrock,1337,priest,discipline,40,23,17
Tumlaa,ravencrest,1337,priest,discipline,56,31,25
Holybunny,blackrock,1337,priest,discipline,98,54,44
Gimcho,magtheridon,1337,priest,discipline,42,23,19
Cheja,ravencrest,1337,priest,discipline,102,52,50
Ahree,sargeras,1337,priest,discipline,258,126,132
Îwi,archimonde,1337,priest,discipline,30,14,16
Pouffi,garona,1336,priest,discipline,24,14,10
Maryjanè,twisting-nether,1336,priest,discipline,24,14,10
Sariss,ravencrest,1336,priest,discipline,24,14,10
Halysis,chamber-of-aspects,1336,priest,discipline,28,14,14
Makkesfil,stormscale,1335,priest,discipline,24,14,10
Kojee,blackrock,1335,priest,discipline,48,18,30
Biscuits,ravencrest,1335,priest,discipline,48,14,34
Ràthaløs,sanguino,1334,priest,discipline,64,38,26
Esüna,ysondre,1334,priest,discipline,30,17,13
Convulsiveq,silvermoon,1334,priest,discipline,317,156,161
Весенняя,gordunni,1334,priest,discipline,87,41,46
Noneedpriest,stormscale,1333,priest,discipline,24,14,10
Аидкабтв,gordunni,1333,priest,discipline,24,14,10
Memoniia,ravencrest,1333,priest,discipline,48,27,21
Aeo,twisting-nether,1333,priest,discipline,116,61,55
Radiance,emeriss,1333,priest,discipline,40,15,25
Teedye,ravencrest,1332,priest,discipline,18,14,4
Amädeuss,tarren-mill,1331,priest,discipline,60,30,30
Miliane,twisting-nether,1331,priest,discipline,30,14,16
Waafa,kazzak,1331,priest,discipline,42,14,28
Happyprocs,dun-modr,1330,priest,discipline,29,15,14
Valaç,turalyon,1330,priest,discipline,149,76,73
Nuph,ravencrest,1330,priest,discipline,62,29,33
Hekro,thrall,1329,priest,discipline,79,40,39
Xieen,outland,1329,priest,discipline,198,100,98
Hellsaya,ysondre,1328,priest,discipline,48,27,21
Buszeekk,outland,1328,priest,discipline,40,22,18
Cleancf,blackhand,1328,priest,discipline,250,115,135
Peersh,ahnqiraj,1327,priest,discipline,18,14,4
Janclod,pozzo-delleternità,1327,priest,discipline,30,20,10
Spánkproof,kazzak,1327,priest,discipline,24,14,10
Starnote,auchindoun,1327,priest,discipline,36,18,18
Jimmbosmite,stormscale,1327,priest,discipline,54,26,28
Lanthypriest,hyjal,1327,priest,discipline,30,14,16
Jävlarottá,ravencrest,1327,priest,discipline,30,14,16
Gudrinieks,shattered-halls,1327,priest,discipline,44,20,24
Сатанчикгод,howling-fjord,1327,priest,discipline,32,14,18
Nou,aegwynn,1327,priest,discipline,36,14,22
Ximenia,eredar,1325,priest,discipline,43,25,18
Seinaruki,emerald-dream,1325,priest,discipline,34,18,16
Skrnz,turalyon,1325,priest,discipline,59,26,33
Absórb,quelthalas,1325,priest,discipline,54,23,31
Nidrana,drakthul,1325,priest,discipline,36,14,22
Германий,deathguard,1324,priest,discipline,35,21,14
Jodge,ravencrest,1324,priest,discipline,48,26,22
Chodia,silvermoon,1324,priest,discipline,89,48,41
Kalisy,ravencrest,1324,priest,discipline,52,27,25
Calsote,sanguino,1324,priest,discipline,60,25,35
Snylia,blackrock,1324,priest,discipline,36,14,22
Bolflo,khaz-modan,1323,priest,discipline,141,77,64
Reìdood,stormscale,1323,priest,discipline,110,59,51
Déspaír,silvermoon,1323,priest,discipline,173,90,83
Lexojam,ravencrest,1323,priest,discipline,29,14,15
Eîkro,blackmoore,1323,priest,discipline,30,14,16
Bakër,dalaran,1323,priest,discipline,51,23,28
Avengëd,nagrand,1323,priest,discipline,54,24,30
Buttafly,archimonde,1322,priest,discipline,42,23,19
Mercîlezz,eredar,1321,priest,discipline,18,14,4
Endlin,silvermoon,1321,priest,discipline,36,20,16
Tech,draenor,1321,priest,discipline,36,18,18
Filtro,eredar,1321,priest,discipline,232,114,118
Bottemg,defias-brotherhood,1321,priest,discipline,30,14,16
Lenanitro,blackrock,1321,priest,discipline,41,19,22
Никорете,soulflayer,1320,priest,discipline,50,29,21
Blackchrist,uldum,1320,priest,discipline,89,45,44
Nirvánabang,sylvanas,1320,priest,discipline,42,21,21
Выхилютебя,galakrond,1320,priest,discipline,57,27,30
Докторпэйн,howling-fjord,1320,priest,discipline,128,60,68
Fùkøff,stormscale,1319,priest,discipline,32,19,13
Nygel,kazzak,1319,priest,discipline,75,43,32
Soupana,darksorrow,1319,priest,discipline,103,52,51
Shadowsig,silvermoon,1319,priest,discipline,154,76,78
Damnatíon,ravencrest,1318,priest,discipline,18,14,4
Alaeddin,kazzak,1318,priest,discipline,404,196,208
Марджелла,howling-fjord,1318,priest,discipline,46,22,24
Eldrathir,burning-legion,1318,priest,discipline,66,27,39
Babbúb,tarren-mill,1318,priest,discipline,35,14,21
Khato,rexxar,1317,priest,discipline,27,17,10
Schlúckunweg,antonidas,1317,priest,discipline,24,14,10
Papynou,garona,1317,priest,discipline,24,14,10
Мидэрка,howling-fjord,1317,priest,discipline,72,39,33
Apeist,outland,1317,priest,discipline,98,51,47
Phobica,frostmane,1317,priest,discipline,30,14,16
Lizium,kazzak,1316,priest,discipline,42,16,26
Subha,drakthul,1315,priest,discipline,22,15,7
Drioz,ysondre,1315,priest,discipline,108,63,45
Radulfus,stormrage,1314,priest,discipline,24,14,10
Hewwo,sylvanas,1314,priest,discipline,162,83,79
Aboû,archimonde,1314,priest,discipline,51,26,25
Yugo,outland,1314,priest,discipline,41,15,26
Tritonis,draenor,1313,priest,discipline,30,16,14
Senorvåc,ravencrest,1313,priest,discipline,149,75,74
Nukksch,antonidas,1312,priest,discipline,271,131,140
Relaxmom,bloodhoof,1312,priest,discipline,30,14,16
Форсибучи,soulflayer,1312,priest,discipline,66,30,36
Aliciakeys,twilights-hammer,1312,priest,discipline,40,15,25
Quisira,aegwynn,1311,priest,discipline,24,16,8
Ассарх,lich-king,1311,priest,discipline,78,39,39
Spèrman,frostwolf,1311,priest,discipline,48,18,30
Suzziee,silvermoon,1310,priest,discipline,48,25,23
Violentha,silvermoon,1310,priest,discipline,30,15,15
Byebee,stormscale,1309,priest,discipline,23,15,8
Empí,sanguino,1309,priest,discipline,42,23,19
Clua,draenor,1309,priest,discipline,66,35,31
Noserenity,outland,1308,priest,discipline,23,14,9
Curanders,sanguino,1308,priest,discipline,54,26,28
Эннхэтэуэй,soulflayer,1308,priest,discipline,84,39,45
Deadonmyscrn,ravencrest,1307,priest,discipline,24,20,4
Txz,kazzak,1307,priest,discipline,24,14,10
Eowins,blackmoore,1307,priest,discipline,76,40,36
Mirelaw,stormscale,1307,priest,discipline,125,65,60
Chukapi,stormscale,1306,priest,discipline,54,31,23
Tlc,dragonmaw,1306,priest,discipline,103,50,53
Claudefrollo,the-maelstrom,1306,priest,discipline,90,39,51
Juiccyluccy,ravencrest,1306,priest,discipline,35,14,21
Faderken,tarren-mill,1305,priest,discipline,66,42,24
Якакиисус,gordunni,1305,priest,discipline,99,51,48
Щакактрахнем,gordunni,1305,priest,discipline,114,57,57
Shadowmend,aegwynn,1305,priest,discipline,29,14,15
Skuhlx,blackrock,1305,priest,discipline,90,39,51
Tigrok,burning-legion,1304,priest,discipline,101,53,48
Ангеланика,gordunni,1304,priest,discipline,42,22,20
Kutjeskopper,silvermoon,1304,priest,discipline,96,46,50
Fixyou,aggra-português,1303,priest,discipline,114,58,56
Ginebra,archimonde,1302,priest,discipline,42,24,18
Fkup,twisting-nether,1302,priest,discipline,36,20,16
Appox,amanthul,1302,priest,discipline,36,16,20
Missdreavus,draenor,1301,priest,discipline,40,24,16
Щявыхилим,howling-fjord,1301,priest,discipline,85,48,37
Genthus,kazzak,1301,priest,discipline,96,47,49
Overhealzz,blackmoore,1301,priest,discipline,126,59,67
Curlo,ravencrest,1300,priest,discipline,42,20,22
Морисгринх,gordunni,1300,priest,discipline,30,14,16
Xypri,nordrassil,1300,priest,discipline,115,52,63
Хъи,gordunni,1299,priest,discipline,24,16,8
Keimohansio,twisting-nether,1299,priest,discipline,102,57,45
Fatherliam,emerald-dream,1299,priest,discipline,54,24,30
Kidri,kilrogg,1298,priest,discipline,36,20,16
Agorasii,frostwolf,1298,priest,discipline,42,22,20
Voidvania,drakthul,1298,priest,discipline,35,18,17
Velles,nazjatar,1298,priest,discipline,507,255,252
Centaurio,nemesis,1298,priest,discipline,135,65,70
Chocopríest,blackmoore,1298,priest,discipline,52,25,27
Tiefergelegt,arthas,1298,priest,discipline,30,14,16
Nimuëh,ragnaros,1298,priest,discipline,52,24,28
Quecum,draenor,1297,priest,discipline,36,16,20
Matiagmenh,stormscale,1297,priest,discipline,42,18,24
Сайларс,howling-fjord,1297,priest,discipline,36,15,21
Шкуропльот,gordunni,1296,priest,discipline,88,46,42
Лоперамедик,gordunni,1296,priest,discipline,60,28,32
Eloapriest,blackhand,1295,priest,discipline,24,14,10
Nâmîz,blackrock,1295,priest,discipline,27,14,13
Nérôck,frostwolf,1295,priest,discipline,45,22,23
Ciordel,draenor,1295,priest,discipline,59,28,31
Vannax,arygos,1295,priest,discipline,78,35,43
Voidwaffel,blackmoore,1295,priest,discipline,38,17,21
Enduring,darksorrow,1295,priest,discipline,90,39,51
Hauntzer,veknilash,1295,priest,discipline,54,18,36
Powerless,blackmoore,1293,priest,discipline,33,22,11
Duaijhutari,outland,1293,priest,discipline,52,30,22
Oohopeoo,blackmoore,1293,priest,discipline,42,23,19
Pl,sunstrider,1293,priest,discipline,42,22,20
Várósh,blackmoore,1293,priest,discipline,63,32,31
Hensynsløs,draenor,1293,priest,discipline,48,24,24
Credor,blackrock,1293,priest,discipline,42,19,23
Thaiboimby,veknilash,1292,priest,discipline,98,57,41
Tsumu,archimonde,1292,priest,discipline,29,14,15
Nikotyna,doomhammer,1292,priest,discipline,107,51,56
Onicolla,terokkar,1292,priest,discipline,126,60,66
Khoria,drakthul,1292,priest,discipline,30,14,16
Blondi,darksorrow,1292,priest,discipline,46,20,26
Lighter,dragonblight,1291,priest,discipline,88,55,33
Асади,gordunni,1291,priest,discipline,70,37,33
Фурлена,blackscar,1291,priest,discipline,109,56,53
Pocketsimp,stormscale,1291,priest,discipline,56,25,31
Rotzpippn,blackhand,1291,priest,discipline,66,23,43
Gøðlìke,aegwynn,1290,priest,discipline,91,42,49
Relöaded,kazzak,1290,priest,discipline,72,28,44
Alfaböna,outland,1289,priest,discipline,122,66,56
Navid,ravencrest,1289,priest,discipline,45,24,21
Makariotatos,xavius,1289,priest,discipline,36,19,17
Brainwash,darksorrow,1289,priest,discipline,53,18,35
Henreita,darksorrow,1288,priest,discipline,42,23,19
Ebolaidman,ravencrest,1288,priest,discipline,48,24,24
Tristar,nethersturm,1287,priest,discipline,35,19,16
Veýýon,blackmoore,1287,priest,discipline,66,35,31
Nuklash,burning-legion,1287,priest,discipline,57,24,33
Pulttipiispa,ravencrest,1285,priest,discipline,47,24,23
Битуну,fordragon,1285,priest,discipline,84,40,44
Jaheim,tarren-mill,1285,priest,discipline,75,33,42
Liliashet,sanguino,1284,priest,discipline,69,39,30
Keppas,doomhammer,1284,priest,discipline,75,39,36
Pregrip,twisting-nether,1284,priest,discipline,236,116,120
Ufos,stormscale,1284,priest,discipline,62,25,37
Тэвиель,gordunni,1284,priest,discipline,90,36,54
Azazzel,nathrezim,1284,priest,discipline,36,14,22
Yourmann,quelthalas,1283,priest,discipline,54,27,27
Flayin,kazzak,1282,priest,discipline,51,26,25
Shidori,dalaran,1282,priest,discipline,36,17,19
Mynameisebe,twisting-nether,1282,priest,discipline,42,18,24
Gilfir,stormscale,1282,priest,discipline,71,29,42
Glärë,burning-legion,1281,priest,discipline,81,50,31
Jimmyhoffa,stormscale,1281,priest,discipline,54,32,22
Skyggepraest,stormscale,1281,priest,discipline,44,24,20
Makrophage,mannoroth,1281,priest,discipline,28,15,13
Инстенли,howling-fjord,1281,priest,discipline,60,25,35
Dinma,argent-dawn,1280,priest,discipline,197,106,91
Superfelyn,ragnaros,1280,priest,discipline,51,27,24
Doncamïllo,blackrock,1280,priest,discipline,47,22,25
Olereo,blackhand,1280,priest,discipline,84,39,45
Alexnator,malganis,1280,priest,discipline,60,26,34
Purityn,blackhand,1280,priest,discipline,42,14,28
Ûbér,darksorrow,1279,priest,discipline,28,15,13
Доминантрикс,soulflayer,1279,priest,discipline,67,34,33
Zthul,draenor,1279,priest,discipline,33,15,18
Pixelpriest,argent-dawn,1278,priest,discipline,80,52,28
Jokaël,ysondre,1278,priest,discipline,114,48,66
Kïmbo,kazzak,1278,priest,discipline,65,26,39
Spaghettoni,tarren-mill,1278,priest,discipline,35,14,21
Ilvia,antonidas,1277,priest,discipline,28,19,9
Freshpope,ravencrest,1277,priest,discipline,53,31,22
Токсичка,howling-fjord,1277,priest,discipline,36,19,17
Svartochelak,stormscale,1277,priest,discipline,48,19,29
Juhduss,tarren-mill,1276,priest,discipline,35,20,15
Скорлупкина,gordunni,1276,priest,discipline,47,26,21
Fullymetalz,defias-brotherhood,1276,priest,discipline,64,34,30
Asuriyan,ravenholdt,1276,priest,discipline,69,34,35
Zenoo,argent-dawn,1275,priest,discipline,36,22,14
Sinnzz,ysondre,1275,priest,discipline,30,14,16
Hardloker,ravencrest,1275,priest,discipline,84,38,46
Yinyangyø,eredar,1275,priest,discipline,36,16,20
Capriestun,hellfire,1274,priest,discipline,34,20,14
Jezlung,frostmane,1274,priest,discipline,105,59,46
Noodlesoup,daggerspine,1274,priest,discipline,157,81,76
Топчикс,gordunni,1274,priest,discipline,100,51,49
Arrlina,magtheridon,1274,priest,discipline,77,34,43
Snoopqt,dalaran,1274,priest,discipline,67,29,38
Harume,argent-dawn,1273,priest,discipline,24,14,10
Aladorius,la-croisade-écarlate,1273,priest,discipline,52,28,24
Æternadead,nemesis,1273,priest,discipline,185,94,91
Voidjutsu,draenor,1273,priest,discipline,182,92,90
Vedina,bronze-dragonflight,1273,priest,discipline,96,46,50
Nuvie,ravencrest,1273,priest,discipline,60,28,32
Styleexdd,ragnaros,1272,priest,discipline,74,40,34
Overshadowed,kazzak,1272,priest,discipline,175,80,95
Имудонка,gordunni,1272,priest,discipline,48,18,30
Amambo,chamber-of-aspects,1271,priest,discipline,48,26,22
Argaar,burning-legion,1271,priest,discipline,78,41,37
Eros,illidan,1271,priest,discipline,36,16,20
Filit,hyjal,1271,priest,discipline,36,15,21
Jerolol,sanguino,1271,priest,discipline,80,33,47
Skarn,blackmoore,1270,priest,discipline,48,31,17
Viroxian,outland,1270,priest,discipline,38,23,15
Mishas,draenor,1270,priest,discipline,42,24,18
Nerul,twisting-nether,1270,priest,discipline,70,35,35
Mediumheals,tarren-mill,1270,priest,discipline,107,53,54
Priestpvp,dun-modr,1270,priest,discipline,77,38,39
Zùt,ysondre,1269,priest,discipline,48,28,20
Holycowheals,the-maelstrom,1269,priest,discipline,119,67,52
Outcast,korgall,1269,priest,discipline,60,30,30
Haligato,archimonde,1269,priest,discipline,106,51,55
Mallkie,ysondre,1268,priest,discipline,36,21,15
Buzzingg,tarren-mill,1268,priest,discipline,65,36,29
Дюрэкс,soulflayer,1268,priest,discipline,48,22,26
Howaya,la-croisade-écarlate,1267,priest,discipline,78,42,36
Holyschidt,amanthul,1267,priest,discipline,415,205,210
Rodshun,dun-modr,1267,priest,discipline,146,67,79
Аришвд,gordunni,1267,priest,discipline,38,17,21
Пофанчику,gordunni,1266,priest,discipline,58,27,31
Amaloo,ravencrest,1266,priest,discipline,66,29,37
Blagovesta,ravencrest,1266,priest,discipline,42,14,28
Praizejeebus,auchindoun,1265,priest,discipline,24,14,10
Hêsêkiêl,eredar,1265,priest,discipline,48,23,25
Рискаль,borean-tundra,1265,priest,discipline,52,22,30
Jeanpipe,khaz-modan,1264,priest,discipline,24,18,6
Shadowpeste,aggra-português,1264,priest,discipline,156,86,70
Isore,culte-de-la-rive-noire,1264,priest,discipline,125,61,64
Maylà,aegwynn,1264,priest,discipline,106,43,63
Negcntsm,aegwynn,1263,priest,discipline,41,25,16
Акктуальная,deepholm,1263,priest,discipline,54,28,26
Nestélle,drakthul,1263,priest,discipline,153,76,77
Kaktosz,ragnaros,1263,priest,discipline,66,26,40
Ruîzz,sanguino,1262,priest,discipline,170,80,90
Nøheall,ysondre,1261,priest,discipline,101,39,62
Rhåenyra,ravencrest,1260,priest,discipline,36,23,13
Earnzy,outland,1260,priest,discipline,29,15,14
Virgosenpai,silvermoon,1260,priest,discipline,57,28,29
Euphorius,blackmoore,1260,priest,discipline,66,32,34
Brøwney,blackmoore,1260,priest,discipline,42,17,25
Vésph,draenor,1260,priest,discipline,67,24,43
Søînx,archimonde,1259,priest,discipline,27,17,10
Liasanya,kelthuzad,1259,priest,discipline,30,18,12
Popelings,twisting-nether,1259,priest,discipline,54,20,34
Luxumbra,quelthalas,1258,priest,discipline,39,15,24
Аэрэта,deathguard,1257,priest,discipline,60,36,24
Flokz,archimonde,1257,priest,discipline,24,14,10
Rog,norgannon,1257,priest,discipline,30,17,13
Añgêl,ravencrest,1257,priest,discipline,195,99,96
Jordí,darkspear,1257,priest,discipline,191,88,103
Piitixd,burning-legion,1257,priest,discipline,48,22,26
Удзумукец,howling-fjord,1257,priest,discipline,118,51,67
Aszneê,proudmoore,1256,priest,discipline,24,14,10
Øwlsoo,confrérie-du-thorium,1256,priest,discipline,136,70,66
Amphôra,archimonde,1256,priest,discipline,46,22,24
Møldark,silvermoon,1256,priest,discipline,116,48,68
Lothbruke,twisting-nether,1256,priest,discipline,48,17,31
Brach,nazjatar,1255,priest,discipline,90,47,43
Shieldyblaze,frostwolf,1255,priest,discipline,125,64,61
Dotsin,kazzak,1255,priest,discipline,271,137,134
Фрустрациия,soulflayer,1255,priest,discipline,34,17,17
Rightx,outland,1255,priest,discipline,125,60,65
Míllerzz,ragnaros,1255,priest,discipline,54,22,32
Pxescalol,aegwynn,1254,priest,discipline,23,14,9
Praystatîon,dragonblight,1254,priest,discipline,132,80,52
Mournus,defias-brotherhood,1253,priest,discipline,47,35,12
Feriant,argent-dawn,1253,priest,discipline,47,27,20
Buckless,kazzak,1253,priest,discipline,30,17,13
Одинокаягора,gordunni,1253,priest,discipline,72,36,36
Enerpriest,ysondre,1253,priest,discipline,42,21,21
Тварьгосподя,gordunni,1253,priest,discipline,344,170,174
Mercies,kazzak,1252,priest,discipline,23,14,9
Slitenprest,kazzak,1252,priest,discipline,42,24,18
Torcena,garrosh,1252,priest,discipline,48,16,32
Shaydi,todeswache,1251,priest,discipline,24,18,6
Kelras,grim-batol,1251,priest,discipline,104,63,41
Elyradp,dun-modr,1251,priest,discipline,78,43,35
Pindakong,dragonblight,1251,priest,discipline,55,28,27
Даркфолс,soulflayer,1251,priest,discipline,59,30,29
Eksel,silvermoon,1251,priest,discipline,72,33,39
Triksas,sylvanas,1250,priest,discipline,66,42,24
Pleistras,magtheridon,1250,priest,discipline,192,107,85
Spoc,blackrock,1250,priest,discipline,53,29,24
Healyourmum,stormscale,1250,priest,discipline,102,51,51
Seneth,twisting-nether,1250,priest,discipline,35,15,20
Deneye,thunderhorn,1249,priest,discipline,72,42,30
Lzmad,archimonde,1249,priest,discipline,60,34,26
Shomäre,ysondre,1249,priest,discipline,36,20,16
Arenarooky,eredar,1249,priest,discipline,42,22,20
Yojoyo,draenor,1249,priest,discipline,171,82,89
Suprenext,draenor,1248,priest,discipline,24,13,11
Mazikeen,stormscale,1248,priest,discipline,24,13,11
Pvpriestess,silvermoon,1248,priest,discipline,138,66,72
Dpxd,tarren-mill,1248,priest,discipline,36,16,20
Còsmo,ravencrest,1248,priest,discipline,30,13,17
Stmichael,silvermoon,1248,priest,discipline,38,15,23
Zolfiqar,tarren-mill,1247,priest,discipline,24,18,6
Møelester,antonidas,1247,priest,discipline,18,13,5
Niíall,skullcrusher,1247,priest,discipline,18,13,5
Lánî,blackmoore,1247,priest,discipline,20,13,7
Zathada,twisting-nether,1247,priest,discipline,30,19,11
Mqsx,stormscale,1247,priest,discipline,24,13,11
Swdömmel,aegwynn,1247,priest,discipline,24,13,11
Krautfunding,blackrock,1247,priest,discipline,24,13,11
Krokkete,hyjal,1247,priest,discipline,24,13,11
Nakenhäst,stormscale,1247,priest,discipline,24,13,11
Аквариусс,gordunni,1247,priest,discipline,82,40,42
Sissi,blackmoore,1247,priest,discipline,114,54,60
Garie,thrall,1247,priest,discipline,80,35,45
Эсминза,gordunni,1247,priest,discipline,30,13,17
Lasyran,outland,1247,priest,discipline,30,13,17
Xourin,blackrock,1247,priest,discipline,34,14,20
Smallsmilesx,blackrock,1247,priest,discipline,36,13,23
Noukeé,blackrock,1247,priest,discipline,36,13,23
Ørrak,hyjal,1246,priest,discipline,24,14,10
Bottom,blackmoore,1246,priest,discipline,24,13,11
Exola,outland,1246,priest,discipline,24,13,11
Quepimquepam,tarren-mill,1246,priest,discipline,41,18,23
Ishkà,stormscale,1246,priest,discipline,30,13,17
Arklim,burning-blade,1246,priest,discipline,80,32,48
Deliâz,aegwynn,1246,priest,discipline,36,14,22
Padregianni,nemesis,1246,priest,discipline,36,13,23
Оуаы,soulflayer,1245,priest,discipline,123,62,61
Умом,gordunni,1245,priest,discipline,30,13,17
Drïxit,illidan,1245,priest,discipline,36,13,23
Undeadpriest,aegwynn,1245,priest,discipline,36,13,23
Theycmedotin,blackhand,1245,priest,discipline,42,13,29
Hotdog,kult-der-verdammten,1244,priest,discipline,30,17,13
Egî,lothar,1244,priest,discipline,24,13,11
Jumby,outland,1244,priest,discipline,30,13,17
Doombrew,blackmoore,1244,priest,discipline,30,13,17
Tackerjoè,eredar,1244,priest,discipline,48,20,28
Шадоухоррор,gordunni,1244,priest,discipline,57,23,34
Wedoburgers,ravencrest,1243,priest,discipline,18,13,5
Takeoff,dun-morogh,1243,priest,discipline,36,23,13
Vokuheala,tarren-mill,1243,priest,discipline,29,16,13
Tjackballé,tarren-mill,1243,priest,discipline,24,13,11
Lalola,tarren-mill,1243,priest,discipline,77,41,36
Hurtless,ravencrest,1243,priest,discipline,33,13,20
Eitukaeitai,outland,1243,priest,discipline,36,13,23
Shadowburst,archimonde,1242,priest,discipline,24,13,11
Gumer,antonidas,1242,priest,discipline,24,13,11
Мсикатана,gordunni,1242,priest,discipline,24,13,11
Chîllipriest,draenor,1242,priest,discipline,24,13,11
Rrdisc,kazzak,1242,priest,discipline,69,31,38
Дцевгений,gordunni,1242,priest,discipline,36,13,23
Darkpræcher,hyjal,1241,priest,discipline,38,28,10
Romero,sylvanas,1241,priest,discipline,18,13,5
Herapeutic,argent-dawn,1241,priest,discipline,23,15,8
Педаньтяйка,gordunni,1241,priest,discipline,228,130,98
Deyxq,lothar,1241,priest,discipline,24,13,11
Striderz,outland,1241,priest,discipline,24,13,11
Bellanote,dalaran,1241,priest,discipline,171,83,88
Nashára,defias-brotherhood,1241,priest,discipline,90,42,48
Loreleì,sylvanas,1240,priest,discipline,18,13,5
Qoryn,ravencrest,1240,priest,discipline,30,13,17
Dartheon,twisting-nether,1240,priest,discipline,101,43,58
Aptz,twisting-nether,1240,priest,discipline,36,13,23
Rmp,stormscale,1240,priest,discipline,39,13,26
Nightfearqt,outland,1239,priest,discipline,20,13,7
Diçkhëad,ravencrest,1239,priest,discipline,67,35,32
Yante,ragnaros,1239,priest,discipline,69,34,35
Mamasmilk,draenor,1238,priest,discipline,40,25,15
Apèx,blackrock,1238,priest,discipline,78,40,38
Türapea,draenor,1238,priest,discipline,122,61,61
Crop,nemesis,1238,priest,discipline,54,21,33
Sordag,lordaeron,1238,priest,discipline,36,13,23
Джейнкелли,borean-tundra,1237,priest,discipline,150,90,60
Tephutes,ravencrest,1237,priest,discipline,27,14,13
Новокшан,soulflayer,1237,priest,discipline,36,18,18
Holydoughnut,stormscale,1237,priest,discipline,54,25,29
Sazo,drakthul,1237,priest,discipline,38,16,22
Djchinoix,archimonde,1236,priest,discipline,18,13,5
Kochepri,archimonde,1236,priest,discipline,36,21,15
Héntai,argent-dawn,1236,priest,discipline,30,15,15
Sahu,kult-der-verdammten,1236,priest,discipline,44,21,23
Bldnl,ragnaros,1236,priest,discipline,49,22,27
Xet,outland,1236,priest,discipline,56,24,32
Crazypablito,burning-legion,1236,priest,discipline,59,25,34
Jbte,silvermoon,1235,priest,discipline,102,57,45
Smellypecker,argent-dawn,1235,priest,discipline,36,19,17
Ticklebell,ravencrest,1235,priest,discipline,255,133,122
Discovery,aggra-português,1235,priest,discipline,54,28,26
Mivale,aszune,1234,priest,discipline,26,15,11
Palitox,kazzak,1234,priest,discipline,42,23,19
Holyswift,dun-morogh,1234,priest,discipline,173,91,82
Zofa,sunstrider,1234,priest,discipline,50,23,27
Divaz,eredar,1234,priest,discipline,48,18,30
Fetmeister,drakthul,1233,priest,discipline,24,13,11
Soehzz,khaz-modan,1233,priest,discipline,90,45,45
Wandéline,arathi,1233,priest,discipline,59,26,33
Самурайко,booty-bay,1233,priest,discipline,48,21,27
Pretee,nemesis,1233,priest,discipline,30,13,17
Anotherlife,stormscale,1232,priest,discipline,18,13,5
Felanris,blackmoore,1232,priest,discipline,42,26,16
Neytirinqt,doomhammer,1232,priest,discipline,108,56,52
Glaces,archimonde,1232,priest,discipline,47,24,23
Janinw,sylvanas,1232,priest,discipline,30,13,17
Samtig,malganis,1232,priest,discipline,57,23,34
Nogz,rashgarroth,1231,priest,discipline,56,34,22
Akingodxz,twisting-nether,1231,priest,discipline,24,13,11
Tristessê,tarren-mill,1231,priest,discipline,132,55,77
Пнух,soulflayer,1231,priest,discipline,36,13,23
Cöpahue,sanguino,1230,priest,discipline,18,13,5
Svartylol,outland,1230,priest,discipline,24,14,10
Lucianßk,sanguino,1230,priest,discipline,48,27,21
Asnur,argent-dawn,1230,priest,discipline,48,24,24
Darkheall,sanguino,1230,priest,discipline,81,35,46
Aroghul,eredar,1230,priest,discipline,108,46,62
Omnissiiah,silvermoon,1230,priest,discipline,42,14,28
Séfaron,blackmoore,1229,priest,discipline,28,20,8
Levimm,turalyon,1229,priest,discipline,103,52,51
Héternel,ysondre,1229,priest,discipline,80,39,41
Пенансиня,gordunni,1229,priest,discipline,36,13,23
Diff,thrall,1228,priest,discipline,75,37,38
Deathstrike,blackrock,1228,priest,discipline,36,15,21
Ggsus,outland,1228,priest,discipline,66,25,41
Felerman,kazzak,1228,priest,discipline,36,13,23
Holybestie,eredar,1227,priest,discipline,30,18,12
Selenar,neptulon,1227,priest,discipline,54,30,24
Мазка,galakrond,1227,priest,discipline,54,23,31
Ødelia,anubarak,1226,priest,discipline,18,13,5
Sytrix,frostwolf,1226,priest,discipline,30,18,12
Nioubèy,archimonde,1226,priest,discipline,35,19,16
Фрит,lich-king,1226,priest,discipline,93,50,43
Seum,ravencrest,1226,priest,discipline,92,48,44
Gacoo,silvermoon,1226,priest,discipline,150,70,80
Netomv,kazzak,1225,priest,discipline,41,21,20
Duem,kazzak,1225,priest,discipline,54,27,27
Kenderke,ragnaros,1225,priest,discipline,35,16,19
Nielar,onyxia,1225,priest,discipline,30,13,17
Saat,dalaran,1224,priest,discipline,32,21,11
Baglet,ravencrest,1224,priest,discipline,24,13,11
Chuwbakka,kazzak,1224,priest,discipline,100,53,47
Drennaria,draenor,1224,priest,discipline,65,31,34
Therezzer,burning-legion,1224,priest,discipline,36,16,20
Prodan,frostmane,1223,priest,discipline,66,37,29
Ästûr,sanguino,1223,priest,discipline,84,43,41
Angusbeêf,blackrock,1223,priest,discipline,212,108,104
Gobie,sunstrider,1223,priest,discipline,30,13,17
Miraev,argent-dawn,1223,priest,discipline,30,13,17
Dosentti,ragnaros,1222,priest,discipline,24,14,10
Csiillux,ragnaros,1222,priest,discipline,42,22,20
Дракулесса,gordunni,1221,priest,discipline,63,31,32
Сегуната,howling-fjord,1221,priest,discipline,36,13,23
Vès,stormscale,1220,priest,discipline,72,37,35
Aerosoll,drakthul,1220,priest,discipline,42,21,21
Verrottênd,frostwolf,1220,priest,discipline,94,40,54
Hopsalopsa,argent-dawn,1219,priest,discipline,18,13,5
Holyrage,frostwhisper,1219,priest,discipline,24,13,11
Карнотит,howling-fjord,1219,priest,discipline,180,82,98
Bigfnatlund,silvermoon,1219,priest,discipline,41,18,23
Elusivv,blackhand,1219,priest,discipline,30,13,17
Xghazo,sylvanas,1218,priest,discipline,45,25,20
Talonjean,conseil-des-ombres,1218,priest,discipline,24,13,11
Лолиэль,soulflayer,1218,priest,discipline,63,34,29
Залупский,gordunni,1218,priest,discipline,41,19,22
Shadowhawke,argent-dawn,1218,priest,discipline,35,15,20
Bzets,jaedenar,1217,priest,discipline,77,45,32
Eremit,silvermoon,1217,priest,discipline,115,58,57
Allotment,silvermoon,1217,priest,discipline,48,24,24
Attenna,ravencrest,1217,priest,discipline,81,34,47
Nìak,ysondre,1217,priest,discipline,100,39,61
Дайбчик,gordunni,1216,priest,discipline,44,25,19
Капляболи,gordunni,1216,priest,discipline,51,28,23
Xail,blackrock,1216,priest,discipline,54,23,31
Rngq,burning-blade,1215,priest,discipline,23,13,10
Patoroch,terokkar,1215,priest,discipline,48,26,22
Elfdarkholme,stormscale,1215,priest,discipline,48,26,22
Shadoomed,kazzak,1215,priest,discipline,72,29,43
Feydottir,draenor,1214,priest,discipline,36,19,17
Valnaya,draenor,1214,priest,discipline,146,77,69
Healsquad,draenor,1214,priest,discipline,106,53,53
Флэнсер,soulflayer,1214,priest,discipline,276,131,145
Astraniaa,blackmoore,1214,priest,discipline,42,19,23
Roosy,malganis,1214,priest,discipline,41,16,25
Nymrasus,ravencrest,1213,priest,discipline,24,13,11
Sandaal,drakthul,1213,priest,discipline,72,36,36
Littleabs,the-maelstrom,1213,priest,discipline,77,38,39
Antiexhile,kazzak,1213,priest,discipline,41,20,21
Lãwh,hyjal,1213,priest,discipline,89,43,46
Imbadancer,turalyon,1212,priest,discipline,78,42,36
Ðøð,dalaran,1210,priest,discipline,54,33,21
Vempress,neptulon,1210,priest,discipline,48,24,24
Nixxaa,drakthul,1210,priest,discipline,36,16,20
Swaggerboy,alakir,1210,priest,discipline,41,13,28
Äncient,ragnaros,1209,priest,discipline,24,13,11
Jeuwls,argent-dawn,1209,priest,discipline,121,64,57
Whitehusky,antonidas,1209,priest,discipline,42,21,21
Vèrcs,silvermoon,1209,priest,discipline,30,14,16
Thimble,blackhand,1209,priest,discipline,37,17,20
Лин,howling-fjord,1208,priest,discipline,22,13,9
Pestaso,shendralar,1208,priest,discipline,24,13,11
Iømÿnudir,archimonde,1208,priest,discipline,115,57,58
Confess,archimonde,1207,priest,discipline,36,20,16
Dúréx,sanguino,1207,priest,discipline,39,19,20
Nëophytë,zuljin,1207,priest,discipline,72,35,37
Жрицазла,soulflayer,1207,priest,discipline,60,28,32
Petitcaca,outland,1207,priest,discipline,99,45,54
Whiteshadöw,archimonde,1207,priest,discipline,36,13,23
Paulinka,auchindoun,1207,priest,discipline,36,13,23
Joebando,ravencrest,1206,priest,discipline,86,43,43
Marylin,senjin,1206,priest,discipline,219,107,112
Thyrandis,dragonblight,1206,priest,discipline,34,14,20
Nostramo,kirin-tor,1206,priest,discipline,54,19,35
Nethenielle,malganis,1205,priest,discipline,42,20,22
Texstil,blackmoore,1205,priest,discipline,30,14,16
Norlyset,silvermoon,1205,priest,discipline,102,46,56
Linara,frostmane,1204,priest,discipline,18,13,5
Asolan,drakthul,1204,priest,discipline,192,98,94
Mcbooee,outland,1204,priest,discipline,42,21,21
Kårejonny,tarren-mill,1204,priest,discipline,61,30,31
Crazyhemsire,twisting-nether,1203,priest,discipline,30,19,11
Nazo,sylvanas,1203,priest,discipline,83,46,37
Novilas,thrall,1203,priest,discipline,42,21,21
Werita,frostmane,1203,priest,discipline,122,54,68
Свежага,howling-fjord,1203,priest,discipline,76,33,43
Umbraya,blackhand,1203,priest,discipline,78,26,52
Beaglep,blackrock,1203,priest,discipline,53,13,40
Calah,frostwhisper,1202,priest,discipline,36,13,23
Pontifex,baelgun,1201,priest,discipline,126,73,53
Perdítá,thrall,1200,priest,discipline,219,107,112
Dementzia,argent-dawn,1200,priest,discipline,89,43,46
Shzuna,archimonde,1200,priest,discipline,54,26,28
Jeuhy,talnivarr,1200,priest,discipline,131,62,69
Balhlin,argent-dawn,1200,priest,discipline,88,38,50
Мегаствол,howling-fjord,1200,priest,discipline,66,28,38
Índica,stormreaver,1199,priest,discipline,18,13,5
Saru,uldaman,1199,priest,discipline,70,38,32
Leprie,draenor,1199,priest,discipline,39,15,24
Drtickomaru,drakthul,1197,priest,discipline,32,16,16
Adeeva,ravencrest,1196,priest,discipline,65,40,25
Sisdenna,doomhammer,1196,priest,discipline,272,141,131
Sacerfull,sanguino,1196,priest,discipline,100,46,54
Wynkx,zuljin,1196,priest,discipline,66,24,42
Zamurak,outland,1195,priest,discipline,75,35,40
Подчинись,ashenvale,1193,priest,discipline,150,81,69
Lyim,stormscale,1192,priest,discipline,23,13,10
Mandarinee,blackmoore,1192,priest,discipline,166,73,93
Mukake,burning-legion,1192,priest,discipline,82,36,46
Achillesheal,alakir,1192,priest,discipline,30,13,17
Xakala,cthun,1191,priest,discipline,93,52,41
Elronmcbông,ravencrest,1191,priest,discipline,72,32,40
Clergy,hellfire,1190,priest,discipline,78,50,28
Obeliskprist,kazzak,1190,priest,discipline,30,14,16
Perimortal,norgannon,1190,priest,discipline,57,26,31
Salves,blackmoore,1190,priest,discipline,53,24,29
Uro,tirion,1190,priest,discipline,41,14,27
Kovács,tarren-mill,1189,priest,discipline,75,42,33
Eník,blackrock,1189,priest,discipline,60,27,33
Radizzel,thrall,1189,priest,discipline,34,13,21
Zergo,karazhan,1189,priest,discipline,52,18,34
Galadríel,malganis,1188,priest,discipline,23,13,10
Megalodön,draenor,1187,priest,discipline,45,17,28
Lillthya,kazzak,1186,priest,discipline,58,24,34
Zranda,magtheridon,1185,priest,discipline,78,36,42
Devîlcry,nordrassil,1184,priest,discipline,96,55,41
Obito,outland,1183,priest,discipline,23,13,10
Freezydot,silvermoon,1183,priest,discipline,87,49,38
Sickz,blackrock,1183,priest,discipline,42,15,27
Камшотхил,gordunni,1182,priest,discipline,64,35,29
Holydörte,aegwynn,1182,priest,discipline,99,47,52
Výra,der-rat-von-dalaran,1182,priest,discipline,32,13,19
Dezriah,tarren-mill,1181,priest,discipline,157,81,76
Goldenapples,ravencrest,1181,priest,discipline,43,22,21
Praywingsebb,nazjatar,1181,priest,discipline,30,14,16
Swtt,sanguino,1180,priest,discipline,84,41,43
Dopemine,ragnaros,1179,priest,discipline,36,18,18
Medycus,blackrock,1179,priest,discipline,60,25,35
Riseandshine,draenor,1178,priest,discipline,36,15,21
Jaimeê,der-rat-von-dalaran,1177,priest,discipline,31,16,15
Nnaoy,ysondre,1177,priest,discipline,26,13,13
Whitepitch,doomhammer,1177,priest,discipline,89,39,50
Zentro,turalyon,1177,priest,discipline,79,34,45
Firstkiss,rexxar,1176,priest,discipline,42,24,18
Шуали,grom,1176,priest,discipline,54,28,26
Vrêth,blackmoore,1176,priest,discipline,39,15,24
Fimor,die-nachtwache,1175,priest,discipline,48,26,22
Fleamana,stormscale,1175,priest,discipline,60,25,35
Tyog,khazgoroth,1174,priest,discipline,25,14,11
Скорояпомощь,gordunni,1174,priest,discipline,107,58,49
Loetharion,archimonde,1174,priest,discipline,71,36,35
Nelvor,silvermoon,1174,priest,discipline,42,21,21
Silvdarr,hyjal,1174,priest,discipline,101,48,53
Elfhelp,ravencrest,1174,priest,discipline,68,28,40
Xkv,blackmoore,1173,priest,discipline,42,24,18
Rashyd,sylvanas,1173,priest,discipline,42,24,18
Забвениеждёт,gordunni,1173,priest,discipline,83,37,46
Gesucristò,pozzo-delleternità,1172,priest,discipline,24,14,10
Парикнахер,soulflayer,1171,priest,discipline,36,23,13
Ksiadzrydzyk,draenor,1171,priest,discipline,36,20,16
Captn,draenor,1171,priest,discipline,54,22,32
Cøøbrà,hyjal,1170,priest,discipline,70,38,32
Petshopboi,sylvanas,1170,priest,discipline,27,14,13
Antibiotic,auchindoun,1170,priest,discipline,106,52,54
Aetherah,outland,1170,priest,discipline,36,16,20
Àri,magtheridon,1170,priest,discipline,41,15,26
Allisandre,hellscream,1169,priest,discipline,24,13,11
Сайннз,howling-fjord,1169,priest,discipline,180,86,94
Ноубадди,howling-fjord,1169,priest,discipline,67,32,35
Gertie,blackhand,1168,priest,discipline,100,52,48
Elclasico,blackrock,1168,priest,discipline,68,28,40
Popegoat,ragnaros,1167,priest,discipline,53,38,15
Luedieniel,draenor,1167,priest,discipline,29,15,14
Kizzorde,ragnaros,1166,priest,discipline,98,49,49
Drsmort,blackrock,1166,priest,discipline,78,37,41
Cupcakes,ahnqiraj,1166,priest,discipline,60,26,34
Эски,howling-fjord,1165,priest,discipline,36,13,23
Szeky,ragnaros,1165,priest,discipline,36,13,23
Gooldan,draenor,1164,priest,discipline,66,39,27
Свапмиплиз,gordunni,1164,priest,discipline,175,81,94
Монесса,howling-fjord,1164,priest,discipline,44,20,24
Olîra,hyjal,1163,priest,discipline,30,14,16
Andhoras,dalaran,1163,priest,discipline,35,13,22
Ribbins,outland,1162,priest,discipline,54,22,32
Blàckângel,blackrock,1161,priest,discipline,312,156,156
Klaura,blackmoore,1161,priest,discipline,30,15,15
Worldjudge,kazzak,1160,priest,discipline,53,27,26
Flyingdutch,tarren-mill,1160,priest,discipline,263,123,140
Milessa,steamwheedle-cartel,1160,priest,discipline,66,29,37
Déxguard,silvermoon,1160,priest,discipline,70,26,44
Акимбопушка,howling-fjord,1159,priest,discipline,74,27,47
Javvi,sylvanas,1158,priest,discipline,78,44,34
Vebbysor,sylvanas,1158,priest,discipline,30,15,15
Myrmeen,silvermoon,1158,priest,discipline,97,46,51
Гуляль,howling-fjord,1157,priest,discipline,76,43,33
Brunestùd,pozzo-delleternità,1157,priest,discipline,68,33,35
Mjölkpelle,twisting-nether,1156,priest,discipline,24,18,6
Klaniara,silvermoon,1156,priest,discipline,76,41,35
Réborn,tarren-mill,1156,priest,discipline,36,19,17
Qyi,the-maelstrom,1156,priest,discipline,36,18,18
Kínson,the-maelstrom,1155,priest,discipline,67,37,30
Vecaya,blackrock,1155,priest,discipline,42,22,20
Døline,hyjal,1155,priest,discipline,29,13,16
Xyliqa,aegwynn,1155,priest,discipline,35,14,21
Chega,malganis,1154,priest,discipline,84,34,50
Гундяй,soulflayer,1153,priest,discipline,51,28,23
Karellian,silvermoon,1153,priest,discipline,36,17,19
Barbiemeth,silvermoon,1153,priest,discipline,144,66,78
Lidlpriest,frostwolf,1152,priest,discipline,18,12,6
Oldnbad,archimonde,1152,priest,discipline,18,12,6
Tobadforglad,khaz-modan,1152,priest,discipline,18,12,6
Fkitweball,argent-dawn,1152,priest,discipline,18,12,6
Keijuñâ,tarren-mill,1152,priest,discipline,24,12,12
Proxsjr,ravencrest,1152,priest,discipline,24,12,12
Heab,aegwynn,1152,priest,discipline,24,12,12
Найтингеилл,gordunni,1152,priest,discipline,24,12,12
Djros,magtheridon,1152,priest,discipline,24,12,12
Незерхэвэн,soulflayer,1152,priest,discipline,24,12,12
Tjackmackann,kazzak,1152,priest,discipline,24,12,12
Donpedrila,kazzak,1152,priest,discipline,24,12,12
Djrussia,tarren-mill,1152,priest,discipline,30,12,18
Djokui,uldum,1152,priest,discipline,30,12,18
Yarok,anubarak,1151,priest,discipline,18,12,6
Uncreative,ravencrest,1151,priest,discipline,18,12,6
Árnyékfing,ragnaros,1151,priest,discipline,47,24,23
Arythc,ahnqiraj,1151,priest,discipline,24,12,12
Dotctor,ysondre,1151,priest,discipline,49,24,25
Shadeblaze,draenor,1151,priest,discipline,38,16,22
Oesterput,stormscale,1151,priest,discipline,30,12,18
Кошкаенот,blackscar,1151,priest,discipline,30,12,18
Shììnx,hyjal,1151,priest,discipline,30,12,18
Ykwah,kazzak,1151,priest,discipline,30,12,18
Aerael,auchindoun,1150,priest,discipline,18,12,6
Хильдинда,soulflayer,1150,priest,discipline,54,27,27
Davóss,outland,1150,priest,discipline,24,12,12
Naomirussell,sylvanas,1150,priest,discipline,24,12,12
Reclue,silvermoon,1150,priest,discipline,24,12,12
Fléxéd,burning-legion,1150,priest,discipline,24,12,12
Trixtrex,aegwynn,1150,priest,discipline,30,12,18
Alptoxlôl,blackhand,1150,priest,discipline,36,14,22
Nuriva,frostmane,1150,priest,discipline,36,12,24
Dogfx,blackhand,1150,priest,discipline,42,12,30
Roskva,archimonde,1149,priest,discipline,21,13,8
Floorpovx,blackmoore,1149,priest,discipline,24,12,12
Ghoul,destromath,1149,priest,discipline,24,12,12
Denarne,blackrock,1149,priest,discipline,24,12,12
Simbaba,archimonde,1149,priest,discipline,66,30,36
Hialdo,bladefist,1149,priest,discipline,36,12,24
Discmoo,kazzak,1148,priest,discipline,20,12,8
Yörüichi,kazzak,1148,priest,discipline,24,12,12
Rokil,ravencrest,1148,priest,discipline,24,12,12
Skinandbones,sylvanas,1148,priest,discipline,36,12,24
Isendth,archimonde,1148,priest,discipline,42,12,30
Ribberull,burning-blade,1147,priest,discipline,24,12,12
Meganx,ravencrest,1147,priest,discipline,24,12,12
Hydroxizine,ragnaros,1147,priest,discipline,24,12,12
Уртримас,gordunni,1147,priest,discipline,128,59,69
Pakmopriest,ragnaros,1147,priest,discipline,30,12,18
Zêlða,ravencrest,1147,priest,discipline,30,12,18
Nack,marécage-de-zangar,1147,priest,discipline,30,12,18
Deicidex,blackrock,1147,priest,discipline,36,12,24
Badguymike,ragnaros,1146,priest,discipline,18,12,6
Tyrial,outland,1146,priest,discipline,18,12,6
Teirok,ambossar,1146,priest,discipline,60,29,31
Джоега,grom,1146,priest,discipline,41,12,29
Resgan,archimonde,1145,priest,discipline,22,13,9
Яестькенни,soulflayer,1145,priest,discipline,48,24,24
Saitani,stormscale,1145,priest,discipline,24,12,12
Фикспрайз,gordunni,1145,priest,discipline,24,12,12
Docpower,twisting-nether,1145,priest,discipline,24,12,12
Impecabllo,outland,1145,priest,discipline,24,12,12
Zielonymisiu,burning-legion,1145,priest,discipline,54,26,28
Floory,twisting-nether,1145,priest,discipline,151,70,81
Limpopon,doomhammer,1145,priest,discipline,45,19,26
Shadowkym,blackrock,1144,priest,discipline,18,12,6
Freazi,burning-blade,1144,priest,discipline,24,14,10
Johnnypleb,blackrock,1144,priest,discipline,114,58,56
Dêrp,frostwolf,1144,priest,discipline,24,12,12
Blacklemons,thrall,1144,priest,discipline,24,12,12
Штецель,howling-fjord,1144,priest,discipline,30,12,18
Loliheal,blackmoore,1144,priest,discipline,34,13,21
Ilovechildrn,silvermoon,1143,priest,discipline,18,12,6
Doomey,ravencrest,1142,priest,discipline,18,12,6
Ciqua,frostmane,1142,priest,discipline,18,12,6
Morava,tarren-mill,1142,priest,discipline,36,20,16
Plaguetale,archimonde,1142,priest,discipline,65,35,30
Саня,razuvious,1142,priest,discipline,24,12,12
Manau,culte-de-la-rive-noire,1142,priest,discipline,30,12,18
Barnicha,grim-batol,1141,priest,discipline,18,12,6
Talyie,argent-dawn,1141,priest,discipline,18,12,6
Noskan,silvermoon,1141,priest,discipline,21,13,8
Kinn,kaelthas,1141,priest,discipline,36,18,18
Aviz,tarren-mill,1141,priest,discipline,24,12,12
Karzin,aggra-português,1141,priest,discipline,66,32,34
Daesa,defias-brotherhood,1140,priest,discipline,24,14,10
Убивал,soulflayer,1140,priest,discipline,24,12,12
Dizpel,stormscale,1140,priest,discipline,35,13,22
Celina,quelthalas,1140,priest,discipline,36,12,24
Canthms,twisting-nether,1139,priest,discipline,42,25,17
Mädmän,draenor,1139,priest,discipline,72,38,34
Healmebaby,kiljaeden,1139,priest,discipline,24,12,12
Teleriah,blackmoore,1139,priest,discipline,47,16,31
Voldream,ravencrest,1139,priest,discipline,36,12,24
Kaydenkross,eredar,1139,priest,discipline,42,12,30
Dionegativ,draenor,1139,priest,discipline,42,12,30
Quinax,shattered-hand,1138,priest,discipline,24,12,12
Bauscia,nemesis,1138,priest,discipline,24,12,12
Clapclap,frostmourne,1138,priest,discipline,34,13,21
Chankro,sanguino,1137,priest,discipline,24,12,12
Æøí,blackmoore,1137,priest,discipline,31,15,16
Drüdkh,tarren-mill,1137,priest,discipline,36,12,24
Zenitsu,khadgar,1136,priest,discipline,76,35,41
Drissz,archimonde,1135,priest,discipline,24,12,12
Deneris,ravencrest,1135,priest,discipline,35,12,23
Dafemboi,ravencrest,1134,priest,discipline,18,12,6
Neosix,sanguino,1134,priest,discipline,48,24,24
Joncartagena,sanguino,1133,priest,discipline,24,12,12
Velosp,defias-brotherhood,1133,priest,discipline,30,12,18
Deliverme,frostmane,1132,priest,discipline,18,12,6
Ожившийприст,soulflayer,1132,priest,discipline,123,64,59
Dyrios,drakthul,1132,priest,discipline,30,13,17
Vrenel,burning-legion,1131,priest,discipline,29,15,14
Zák,sylvanas,1131,priest,discipline,24,12,12
Stclemens,defias-brotherhood,1130,priest,discipline,45,20,25
Iloa,dun-morogh,1129,priest,discipline,65,37,28
Gromalia,hyjal,1129,priest,discipline,24,12,12
Uncleben,grim-batol,1129,priest,discipline,31,14,17
Hasnaa,silvermoon,1128,priest,discipline,21,15,6
Paparockatos,sylvanas,1127,priest,discipline,36,24,12
Priestagon,azjolnerub,1127,priest,discipline,24,12,12
Nhajÿ,hyjal,1127,priest,discipline,30,12,18
Jeez,twilights-hammer,1127,priest,discipline,36,12,24
Carlotta,dalaran,1126,priest,discipline,69,32,37
Smooky,arakarahm,1126,priest,discipline,26,12,14
Хилогайка,howling-fjord,1126,priest,discipline,45,20,25
Whysomadx,stormscale,1126,priest,discipline,40,16,24
Таймыр,gordunni,1125,priest,discipline,173,79,94
Гандболист,soulflayer,1125,priest,discipline,30,12,18
Курумничек,gordunni,1124,priest,discipline,18,12,6
Frittê,anetheron,1124,priest,discipline,57,29,28
Чупатаявошь,soulflayer,1123,priest,discipline,78,39,39
Enaches,twisting-nether,1123,priest,discipline,61,30,31
Spookyfive,blackhand,1123,priest,discipline,73,26,47
Kurtse,archimonde,1121,priest,discipline,28,14,14
Biblebabe,tarren-mill,1121,priest,discipline,24,12,12
Fordead,krasus,1120,priest,discipline,72,22,50
Kenton,ysondre,1119,priest,discipline,24,12,12
Stigy,auchindoun,1119,priest,discipline,48,23,25
Killerkende,ragnaros,1119,priest,discipline,46,22,24
Neremin,argent-dawn,1118,priest,discipline,48,27,21
Jeus,malganis,1118,priest,discipline,36,14,22
Thiela,ravencrest,1117,priest,discipline,20,13,7
Spooka,ravencrest,1117,priest,discipline,23,12,11
Boyraz,argent-dawn,1117,priest,discipline,66,30,36
Pèrejoe,arathi,1117,priest,discipline,42,15,27
Devilscousin,aggra-português,1116,priest,discipline,25,16,9
Малмортис,soulflayer,1116,priest,discipline,54,26,28
Nyell,silvermoon,1115,priest,discipline,22,12,10
Pnokos,ravencrest,1115,priest,discipline,36,13,23
Bigwoopsie,stormscale,1114,priest,discipline,24,14,10
Mewdewrewrx,arathor,1114,priest,discipline,84,46,38
Ehrmantràut,draenor,1113,priest,discipline,31,17,14
Bluxon,kazzak,1113,priest,discipline,22,12,10
Draenera,silvermoon,1113,priest,discipline,93,46,47
Prognosis,frostwhisper,1112,priest,discipline,48,25,23
Qsandria,ravencrest,1112,priest,discipline,50,24,26
Maskia,sanguino,1112,priest,discipline,30,12,18
Латрам,greymane,1112,priest,discipline,88,35,53
Гролгул,eversong,1111,priest,discipline,24,12,12
Dalyn,zuljin,1110,priest,discipline,24,12,12
Miralou,ravencrest,1110,priest,discipline,338,168,170
Nykothp,ghostlands,1110,priest,discipline,30,12,18
Attiny,draenor,1110,priest,discipline,48,14,34
Zeuws,kazzak,1109,priest,discipline,36,13,23
Стаминабаф,gordunni,1108,priest,discipline,21,13,8
Moritura,nefarian,1108,priest,discipline,24,13,11
Ezrox,neptulon,1108,priest,discipline,30,13,17
Yoloh,sanguino,1108,priest,discipline,51,19,32
Dilbert,twilights-hammer,1107,priest,discipline,70,29,41
Taili,ysondre,1107,priest,discipline,32,13,19
Bangrinu,chamber-of-aspects,1107,priest,discipline,33,12,21
Nigellä,azjolnerub,1107,priest,discipline,36,12,24
Healheal,outland,1106,priest,discipline,78,42,36
Templanzaa,cthun,1106,priest,discipline,24,12,12
Deckardkain,pozzo-delleternità,1105,priest,discipline,60,33,27
Thörbjorn,confrérie-du-thorium,1105,priest,discipline,30,15,15
Valente,twisting-nether,1105,priest,discipline,60,22,38
Mambanero,nemesis,1104,priest,discipline,135,60,75
Elyssez,thrall,1104,priest,discipline,61,22,39
Fetuz,ravenholdt,1103,priest,discipline,76,34,42
Lydîâ,blackhand,1102,priest,discipline,23,12,11
Scotpriest,draenor,1101,priest,discipline,24,12,12
Bepbepp,archimonde,1101,priest,discipline,26,12,14
Kiieevv,blackrock,1101,priest,discipline,206,94,112
Velenthøs,argent-dawn,1100,priest,discipline,24,12,12
Plagegeist,blutkessel,1100,priest,discipline,24,12,12
Möd,ragnaros,1100,priest,discipline,30,13,17
Tutenhamonek,outland,1099,priest,discipline,30,14,16
Enlîl,zuljin,1098,priest,discipline,65,33,32
Imsöbäd,archimonde,1098,priest,discipline,30,12,18
Vaurork,stormscale,1096,priest,discipline,23,12,11
Crizto,argent-dawn,1094,priest,discipline,54,22,32
Ünholy,burning-legion,1093,priest,discipline,33,17,16
Healy,blackrock,1091,priest,discipline,114,48,66
Мояродная,howling-fjord,1091,priest,discipline,43,13,30
Necromania,cthun,1089,priest,discipline,123,58,65
Lerissea,argent-dawn,1088,priest,discipline,22,12,10
Lísan,ravencrest,1088,priest,discipline,30,14,16
Szalsza,arathor,1088,priest,discipline,84,39,45
Pilip,dragonmaw,1087,priest,discipline,24,13,11
Khai,tarren-mill,1087,priest,discipline,71,31,40
Sildane,kirin-tor,1087,priest,discipline,35,15,20
Artymox,sylvanas,1086,priest,discipline,41,13,28
Røläck,ragnaros,1085,priest,discipline,36,15,21
Эрьеро,gordunni,1085,priest,discipline,48,17,31
Clutchp,blackmoore,1084,priest,discipline,21,13,8
Dragthal,malganis,1084,priest,discipline,32,13,19
Xmassdispel,tarren-mill,1084,priest,discipline,36,14,22
Mundwerk,malganis,1081,priest,discipline,57,21,36
Nellytaa,dalaran,1080,priest,discipline,33,17,16
Waxosc,silvermoon,1080,priest,discipline,68,28,40
Salskagripme,ragnaros,1079,priest,discipline,18,12,6
Bojestvena,neptulon,1079,priest,discipline,46,25,21
Гомотряс,howling-fjord,1079,priest,discipline,102,54,48
Bálíé,blackmoore,1078,priest,discipline,72,35,37
Yelowsnowman,burning-legion,1078,priest,discipline,48,22,26
Jediminds,tarren-mill,1076,priest,discipline,22,12,10
Lapeür,archimonde,1076,priest,discipline,24,12,12
Lunacarle,zuljin,1075,priest,discipline,44,24,20
Dinamix,tarren-mill,1075,priest,discipline,48,25,23
Pénancé,defias-brotherhood,1075,priest,discipline,36,13,23
Deathspawn,hellscream,1073,priest,discipline,69,37,32
Makrit,outland,1073,priest,discipline,69,28,41
Dafúq,draenor,1072,priest,discipline,22,12,10
Seanoob,turalyon,1071,priest,discipline,31,12,19
Deppara,twisting-nether,1070,priest,discipline,38,23,15
Discoprillan,twisting-nether,1069,priest,discipline,43,23,20
Lunairess,silvermoon,1069,priest,discipline,84,28,56
Гальционна,gordunni,1068,priest,discipline,31,13,18
Unleet,sylvanas,1067,priest,discipline,69,33,36
Deeforce,argent-dawn,1067,priest,discipline,74,29,45
Malîken,silvermoon,1066,priest,discipline,30,15,15
Эйнрив,howling-fjord,1066,priest,discipline,113,53,60
Юкич,soulflayer,1065,priest,discipline,34,12,22
Hðly,doomhammer,1064,priest,discipline,18,12,6
Заплетальщик,howling-fjord,1064,priest,discipline,60,34,26
Celero,silvermoon,1063,priest,discipline,54,23,31
Avor,hellfire,1062,priest,discipline,24,16,8
Prazefin,twisting-nether,1060,priest,discipline,22,13,9
Ãbømînåtîøn,blackrock,1059,priest,discipline,28,22,6
Mocnymaco,burning-blade,1059,priest,discipline,193,98,95
Norah,kirin-tor,1058,priest,discipline,35,15,20
Swpain,argent-dawn,1056,priest,discipline,12,11,1
Yânùx,aegwynn,1056,priest,discipline,12,11,1
Surfingbird,ragnaros,1056,priest,discipline,18,11,7
Bindww,tarren-mill,1056,priest,discipline,18,11,7
Kirobreika,twisting-nether,1056,priest,discipline,18,11,7
Daskemaskinx,the-maelstrom,1056,priest,discipline,18,11,7
Schwypsvnr,garona,1056,priest,discipline,18,11,7
Lmnsqzy,ravencrest,1056,priest,discipline,18,11,7
Fatyoyo,frostwolf,1056,priest,discipline,18,11,7
Nyàh,stormscale,1056,priest,discipline,18,11,7
Drnoob,tarren-mill,1056,priest,discipline,50,25,25
Dexlolo,stormscale,1056,priest,discipline,24,11,13
Ðanilosp,dun-modr,1056,priest,discipline,24,11,13
Onceup,thrall,1056,priest,discipline,24,11,13
Carpathîan,blackhand,1056,priest,discipline,72,25,47
Kenobai,kazzak,1055,priest,discipline,18,11,7
Nelyø,destromath,1055,priest,discipline,18,11,7
Zælÿ,archimonde,1055,priest,discipline,18,11,7
Парадайси,gordunni,1055,priest,discipline,18,11,7
Балантайсх,soulflayer,1055,priest,discipline,18,11,7
Fractu,tarren-mill,1055,priest,discipline,24,11,13
Squishylol,tarren-mill,1055,priest,discipline,24,11,13
Ahun,taerar,1055,priest,discipline,24,11,13
Manäka,hyjal,1055,priest,discipline,24,11,13
Pureàngel,ravencrest,1055,priest,discipline,24,11,13
Haffination,frostmane,1055,priest,discipline,24,11,13
Redempt,nemesis,1055,priest,discipline,24,11,13
Deshka,tarren-mill,1055,priest,discipline,30,11,19
Dubai,silvermoon,1055,priest,discipline,36,11,25
Unstopp,blackhand,1054,priest,discipline,18,11,7
Ræwïllûñgøðx,ravencrest,1054,priest,discipline,18,11,7
Leleg,blackhand,1054,priest,discipline,18,11,7
Bäckay,silvermoon,1054,priest,discipline,24,11,13
Arya,dunemaul,1054,priest,discipline,24,11,13
Hòllymèdx,blackmoore,1054,priest,discipline,24,11,13
Peg,talnivarr,1054,priest,discipline,30,11,19
Auroree,stormscale,1054,priest,discipline,30,11,19
Szycho,burning-legion,1054,priest,discipline,36,11,25
Whopzi,blackmoore,1053,priest,discipline,18,11,7
Zeatt,ysera,1053,priest,discipline,18,11,7
Tsunadesaama,silvermoon,1053,priest,discipline,24,11,13
Залик,soulflayer,1053,priest,discipline,29,12,17
Aléhyl,la-croisade-écarlate,1053,priest,discipline,72,28,44
Stepsisstuck,ragnaros,1053,priest,discipline,30,11,19
Drwho,zuljin,1053,priest,discipline,33,12,21
Challengepro,burning-legion,1052,priest,discipline,18,11,7
Вайфими,gordunni,1052,priest,discipline,24,11,13
Købzar,tarren-mill,1052,priest,discipline,30,11,19
Chokmâh,sanguino,1051,priest,discipline,18,11,7
Пристохилю,gordunni,1051,priest,discipline,24,14,10
Bejud,tarren-mill,1051,priest,discipline,24,11,13
Nevermyndz,blackmoore,1051,priest,discipline,24,11,13
Monstretpr,dragonblight,1051,priest,discipline,24,11,13
Clæude,tarren-mill,1051,priest,discipline,30,11,19
Fakéy,draenor,1050,priest,discipline,12,11,1
Iiamx,antonidas,1050,priest,discipline,18,11,7
Cahuña,thrall,1050,priest,discipline,33,19,14
Junglepriest,ravencrest,1050,priest,discipline,24,11,13
Smokäy,blackhand,1050,priest,discipline,24,11,13
Rachelsz,ravencrest,1050,priest,discipline,24,11,13
Zatón,dun-modr,1050,priest,discipline,30,11,19
Celadriel,ravencrest,1050,priest,discipline,30,11,19
Lacrum,ragnaros,1049,priest,discipline,26,15,11
Ungeheuer,taerar,1049,priest,discipline,54,25,29
Grimor,talnivarr,1049,priest,discipline,24,11,13
Nimiqt,tarren-mill,1049,priest,discipline,24,11,13
Madilim,kazzak,1049,priest,discipline,29,13,16
Soupriest,ysondre,1049,priest,discipline,27,12,15
Varrês,kazzak,1049,priest,discipline,30,11,19
Nøwénna,ravencrest,1049,priest,discipline,42,11,31
Merendir,scarshield-legion,1049,priest,discipline,42,11,31
Icyc,outland,1049,priest,discipline,42,11,31
Ehther,dun-modr,1048,priest,discipline,18,11,7
Sophoula,silvermoon,1048,priest,discipline,18,11,7
Diskogoblin,drakthul,1048,priest,discipline,24,11,13
Sanril,ragnaros,1048,priest,discipline,24,11,13
Axewound,neptulon,1048,priest,discipline,25,11,14
Redlight,ysondre,1048,priest,discipline,30,11,19
Rredss,ravencrest,1047,priest,discipline,22,14,8
Neseig,blutkessel,1047,priest,discipline,18,11,7
Blasfemo,nemesis,1047,priest,discipline,24,11,13
Drumont,kelthuzad,1047,priest,discipline,24,11,13
Shæzè,antonidas,1047,priest,discipline,24,11,13
Ilostmybible,runetotem,1047,priest,discipline,28,12,16
Derathon,eredar,1046,priest,discipline,18,11,7
Broer,twisting-nether,1046,priest,discipline,18,11,7
Мерседулька,howling-fjord,1046,priest,discipline,22,12,10
Zerula,outland,1046,priest,discipline,225,115,110
Ichpvpeuch,eredar,1046,priest,discipline,24,11,13
Lightless,baelgun,1046,priest,discipline,84,38,46
Болътвоя,gordunni,1045,priest,discipline,18,11,7
Billypriest,argent-dawn,1044,priest,discipline,18,11,7
Pescá,cthun,1044,priest,discipline,25,13,12
Needmana,hyjal,1044,priest,discipline,36,15,21
Kaos,anetheron,1043,priest,discipline,15,13,2
Ráka,earthen-ring,1043,priest,discipline,26,13,13
Iluras,thunderhorn,1043,priest,discipline,24,11,13
Desperion,ragnaros,1043,priest,discipline,139,60,79
Эллвинг,howling-fjord,1042,priest,discipline,23,12,11
Malíficent,draenor,1042,priest,discipline,24,11,13
Rhésùs,archimonde,1041,priest,discipline,44,25,19
Nynren,doomhammer,1041,priest,discipline,50,22,28
Holyskull,magtheridon,1041,priest,discipline,124,51,73
Whitemané,argent-dawn,1040,priest,discipline,56,28,28
Prïstië,drakthul,1040,priest,discipline,62,29,33
Jonnyklebrig,aegwynn,1040,priest,discipline,47,18,29
Kranrekan,archimonde,1040,priest,discipline,54,18,36
Swdscript,drakthul,1039,priest,discipline,24,11,13
Worstdisceu,draenor,1039,priest,discipline,24,11,13
Priestar,madmortem,1038,priest,discipline,24,11,13
Myskou,ragnaros,1037,priest,discipline,12,11,1
Fingerblast,sanguino,1037,priest,discipline,24,12,12
Sphard,ysondre,1037,priest,discipline,104,39,65
Лилсейнтс,gordunni,1036,priest,discipline,42,11,31
Metapri,blackhand,1035,priest,discipline,41,20,21
Inaeries,argent-dawn,1034,priest,discipline,41,22,19
Dorisdiesel,ravencrest,1033,priest,discipline,30,11,19
Трахмэйстер,gordunni,1032,priest,discipline,23,17,6
Tokushiro,sylvanas,1031,priest,discipline,24,11,13
Pasalacabra,zuljin,1030,priest,discipline,24,11,13
Zdrowíé,todeswache,1029,priest,discipline,78,45,33
Nupzie,stormscale,1029,priest,discipline,39,15,24
Ahgnus,silvermoon,1029,priest,discipline,30,11,19
Kreem,frostmane,1028,priest,discipline,18,11,7
Rydzyk,laughing-skull,1028,priest,discipline,24,13,11
Hèlp,sanguino,1028,priest,discipline,24,12,12
Zbll,ragnaros,1028,priest,discipline,30,12,18
Marryjade,ragnaros,1026,priest,discipline,32,14,18
Leønix,malfurion,1025,priest,discipline,21,12,9
Bakris,twisting-nether,1024,priest,discipline,24,11,13
Galpriest,tarren-mill,1023,priest,discipline,17,11,6
Tmnewho,outland,1022,priest,discipline,22,12,10
Anethron,ragnaros,1022,priest,discipline,90,45,45
Tori,marécage-de-zangar,1021,priest,discipline,20,12,8
Sharae,malfurion,1020,priest,discipline,77,41,36
Psychoboris,outland,1020,priest,discipline,127,67,60
Äwësömë,aggra-português,1019,priest,discipline,66,34,32
Shnookfour,agamaggan,1019,priest,discipline,58,29,29
Sòsò,archimonde,1018,priest,discipline,60,25,35
Grgovan,kazzak,1017,priest,discipline,15,12,3
Rexxár,aszune,1016,priest,discipline,121,58,63
Verxalas,stormscale,1014,priest,discipline,16,12,4
Roshaltar,argent-dawn,1014,priest,discipline,104,54,50
Xanndro,argent-dawn,1014,priest,discipline,34,13,21
Kyrédan,dalaran,1013,priest,discipline,192,94,98
Gronni,argent-dawn,1012,priest,discipline,30,15,15
Варинган,howling-fjord,1011,priest,discipline,22,12,10
Fericul,argent-dawn,1011,priest,discipline,30,11,19
Howlscastie,stormscale,1010,priest,discipline,60,26,34
Morrydin,stormreaver,1009,priest,discipline,22,11,11
Trimégiste,hyjal,1009,priest,discipline,145,72,73
Seras,bloodfeather,1009,priest,discipline,143,67,76
Yøzø,blackhand,1009,priest,discipline,63,27,36
Awien,kazzak,1008,priest,discipline,27,12,15
Bicepvein,sylvanas,1007,priest,discipline,15,11,4
Discoruzki,ravencrest,1007,priest,discipline,23,11,12
Gutfroy,conseil-des-ombres,1006,priest,discipline,16,12,4
Priestør,onyxia,1006,priest,discipline,19,12,7
Boomhilde,aegwynn,1004,priest,discipline,218,108,110
Lamovtabrood,kazzak,1004,priest,discipline,23,11,12
Телоури,galakrond,1004,priest,discipline,27,12,15
Kallsen,ravencrest,1002,priest,discipline,45,28,17
Stahj,sanguino,1002,priest,discipline,23,11,12
Sixeus,outland,1002,priest,discipline,26,12,14
Slufse,alakir,1001,priest,discipline,29,13,16
Dirim,silvermoon,1001,priest,discipline,90,32,58
Steadyog,doomhammer,1000,priest,discipline,24,16,8
Mijuuk,zuljin,1000,priest,discipline,36,23,13
Buzzard,frostmourne,1000,priest,discipline,24,15,9
Nobbisnice,drakthul,1000,priest,discipline,88,36,52
Rrpriest,silvermoon,998,priest,discipline,68,23,45
Talbädar,draenor,997,priest,discipline,26,13,13
Îndura,drakthul,997,priest,discipline,99,44,55
Вальдемарс,howling-fjord,996,priest,discipline,29,11,18
Kilrog,blackrock,995,priest,discipline,27,13,14
Ccatchme,sylvanas,995,priest,discipline,91,41,50
Negativeapm,archimonde,991,priest,discipline,17,11,6
Absinthamos,eredar,989,priest,discipline,22,11,11
Góldfinger,norgannon,988,priest,discipline,27,11,16
Рыск,grom,986,priest,discipline,15,13,2
Hinkelstein,defias-brotherhood,983,priest,discipline,44,23,21
Huzlin,kazzak,983,priest,discipline,28,11,17
Aprima,culte-de-la-rive-noire,983,priest,discipline,48,17,31
Nabira,pozzo-delleternità,980,priest,discipline,19,12,7
Lichtelaaie,quelthalas,980,priest,discipline,24,15,9
Junkz,eredar,977,priest,discipline,42,19,23
Satanspawn,neptulon,977,priest,discipline,64,23,41
Shalacho,blackrock,976,priest,discipline,58,26,32
Арабет,galakrond,975,priest,discipline,107,57,50
Eronnsalis,burning-legion,975,priest,discipline,96,43,53
Yoóngí,ravencrest,973,priest,discipline,17,11,6
Havanna,dethecus,973,priest,discipline,30,18,12
Therealopa,blackmoore,973,priest,discipline,116,54,62
Vepa,blackrock,972,priest,discipline,52,27,25
Amaretta,perenolde,972,priest,discipline,85,43,42
Sigor,hellfire,970,priest,discipline,35,16,19
Васпохилить,howling-fjord,969,priest,discipline,32,15,17
Chaniu,throkferoth,967,priest,discipline,30,11,19
Priincess,ragnaros,966,priest,discipline,34,14,20
Rosilana,blackrock,966,priest,discipline,54,20,34
Teyranamin,defias-brotherhood,965,priest,discipline,25,11,14
Morgoh,die-arguswacht,962,priest,discipline,162,81,81
Holyheartx,argent-dawn,962,priest,discipline,34,12,22
Rizeup,darksorrow,961,priest,discipline,32,18,14
Presbyter,mazrigos,961,priest,discipline,21,11,10
Didinini,outland,961,priest,discipline,46,24,22
Piccolamorte,ysondre,960,priest,discipline,12,10,2
Lanat,ravencrest,960,priest,discipline,12,10,2
Ghettonelf,sylvanas,960,priest,discipline,12,10,2
Ilovesumecx,aegwynn,960,priest,discipline,18,10,8
Asýnc,ravencrest,960,priest,discipline,18,10,8
Sadsadsad,ravencrest,960,priest,discipline,18,10,8
Nelakya,blackmoore,960,priest,discipline,18,10,8
Пухлаясвинка,fordragon,960,priest,discipline,18,10,8
Lerrapriest,eredar,960,priest,discipline,18,10,8
Wyrofear,ragnaros,960,priest,discipline,18,10,8
Neska,antonidas,960,priest,discipline,18,10,8
Ринкуку,howling-fjord,960,priest,discipline,18,10,8
Mindhøven,veklor,960,priest,discipline,18,10,8
Theblank,pozzo-delleternità,960,priest,discipline,24,10,14
Dxlkekss,blackmoore,960,priest,discipline,24,10,14
ßestworld,draenor,960,priest,discipline,24,10,14
Mythaaz,archimonde,960,priest,discipline,27,10,17
Tmnstrtw,alakir,960,priest,discipline,30,10,20
Leykop,ravencrest,960,priest,discipline,36,10,26
Casic,blackhand,959,priest,discipline,12,10,2
Døtgdx,archimonde,959,priest,discipline,18,10,8
Yadif,tarren-mill,959,priest,discipline,18,10,8
Animalrescue,draenor,959,priest,discipline,18,10,8
Ðaala,blackrock,959,priest,discipline,18,10,8
Lèss,ysondre,959,priest,discipline,18,10,8
Dunderpriest,silvermoon,959,priest,discipline,18,10,8
Рыжаякискис,soulflayer,959,priest,discipline,18,10,8
Óói,outland,959,priest,discipline,19,10,9
Notpetya,kazzak,959,priest,discipline,24,10,14
Aurorä,burning-legion,959,priest,discipline,24,10,14
Alìsa,ravencrest,959,priest,discipline,24,10,14
Râây,blackrock,959,priest,discipline,24,10,14
Grimezot,ragnaros,959,priest,discipline,24,10,14
Surpsgodx,ravencrest,959,priest,discipline,30,10,20
Phucu,the-maelstrom,959,priest,discipline,30,10,20
Raphyx,blackhand,959,priest,discipline,36,10,26
Awakenedmyth,draenor,958,priest,discipline,12,10,2
Sadgelands,outland,958,priest,discipline,18,10,8
Elinaa,die-aldor,958,priest,discipline,18,10,8
Ezcobar,twilights-hammer,958,priest,discipline,18,10,8
Misspingle,sunstrider,958,priest,discipline,18,10,8
Vo,dentarg,958,priest,discipline,18,10,8
Thicolascage,draenor,958,priest,discipline,24,10,14
Faíht,blackrock,958,priest,discipline,24,10,14
Radiancekey,sanguino,958,priest,discipline,24,10,14
Narkofashist,sanguino,958,priest,discipline,84,33,51
Adallon,blackmoore,958,priest,discipline,30,10,20
Discönnect,kazzak,957,priest,discipline,12,10,2
Sws,throkferoth,957,priest,discipline,12,10,2
Reivno,ravencrest,957,priest,discipline,12,10,2
Vaßpera,tarren-mill,957,priest,discipline,18,10,8
Bougetonboul,archimonde,957,priest,discipline,18,10,8
Anetalol,zuluhed,957,priest,discipline,18,10,8
Попячебрило,gordunni,957,priest,discipline,88,45,43
Dexodus,sylvanas,957,priest,discipline,24,10,14
Hazedoktor,twisting-nether,957,priest,discipline,24,10,14
Anankea,malganis,957,priest,discipline,27,10,17
Вейтарен,gordunni,957,priest,discipline,30,10,20
Белыйшеколад,blackscar,956,priest,discipline,12,10,2
Cidrea,saurfang,956,priest,discipline,18,10,8
Zaein,malganis,956,priest,discipline,18,10,8
Chîlliz,draenor,956,priest,discipline,18,10,8
Myzaree,silvermoon,956,priest,discipline,18,10,8
Techipriest,ravencrest,955,priest,discipline,12,10,2
Abdibio,twisting-nether,955,priest,discipline,24,10,14
Evangelyne,tarren-mill,955,priest,discipline,24,10,14
Zyrexan,defias-brotherhood,955,priest,discipline,30,10,20
Slight,aggra-português,954,priest,discipline,18,10,8
Gîpsyjoe,ragnaros,954,priest,discipline,18,10,8
Suchetto,kazzak,954,priest,discipline,24,10,14
Hempukka,spinebreaker,954,priest,discipline,24,10,14
Kyuuma,ravencrest,954,priest,discipline,24,10,14
Chilltcaster,blackrock,954,priest,discipline,26,10,16
Юбич,soulflayer,953,priest,discipline,18,10,8
Aká,kazzak,953,priest,discipline,24,10,14
Подорваный,gordunni,953,priest,discipline,30,10,20
Votiqt,tarren-mill,952,priest,discipline,18,10,8
Ghøstyx,blackrock,952,priest,discipline,18,10,8
Abî,frostwolf,952,priest,discipline,21,11,10
Саксесфул,howling-fjord,952,priest,discipline,24,10,14
Kaleshiry,kazzak,952,priest,discipline,24,10,14
Eclaír,blackhand,952,priest,discipline,30,10,20
Hugerage,stormreaver,952,priest,discipline,42,10,32
Maiel,die-aldor,951,priest,discipline,24,10,14
Фионыч,blackscar,951,priest,discipline,24,10,14
Boniesmack,stormscale,951,priest,discipline,24,10,14
Немашка,blackscar,950,priest,discipline,18,10,8
Nasirjones,outland,950,priest,discipline,18,10,8
Guérissolog,kaelthas,950,priest,discipline,24,10,14
Gaidy,ravencrest,949,priest,discipline,18,10,8
Robiee,twisting-nether,949,priest,discipline,24,10,14
Senghe,argent-dawn,949,priest,discipline,36,14,22
Chris,laughing-skull,948,priest,discipline,12,10,2
Perxonx,twisting-nether,946,priest,discipline,12,10,2
Pínx,nerathor,946,priest,discipline,24,10,14
Raptichou,hyjal,945,priest,discipline,18,10,8
Jimcarre,eredar,945,priest,discipline,24,11,13
Sacristy,aggra-português,945,priest,discipline,62,23,39
Joblob,guldan,944,priest,discipline,20,10,10
Izaa,silvermoon,943,priest,discipline,30,10,20
Mønti,onyxia,942,priest,discipline,35,17,18
Pabli,argent-dawn,942,priest,discipline,24,10,14
Togx,silvermoon,942,priest,discipline,24,10,14
Lèviåthån,stormscale,942,priest,discipline,29,10,19
Søb,silvermoon,942,priest,discipline,29,10,19
Perlo,sanguino,940,priest,discipline,89,47,42
Lumartos,ungoro,939,priest,discipline,127,60,67
Priezeke,aggramar,937,priest,discipline,60,32,28
Энтанант,gordunni,935,priest,discipline,30,15,15
Felbs,defias-brotherhood,935,priest,discipline,69,25,44
Bolíngbroke,argent-dawn,935,priest,discipline,47,12,35
Eleveno,ravencrest,934,priest,discipline,54,26,28
Lhh,blackmoore,934,priest,discipline,26,12,14
Paradigma,outland,933,priest,discipline,59,30,29
Sednâ,conseil-des-ombres,931,priest,discipline,23,10,13
Satyxian,draenor,929,priest,discipline,18,10,8
Chukwundi,ravencrest,929,priest,discipline,84,29,55
Ifkströmsund,stormscale,928,priest,discipline,18,10,8
Pavyone,twisting-nether,926,priest,discipline,23,10,13
Aliasus,archimonde,924,priest,discipline,17,10,7
Meodor,antonidas,923,priest,discipline,24,14,10
Flaylol,stormscale,923,priest,discipline,23,10,13
Docoktokok,guldan,921,priest,discipline,30,14,16
Fordöbroo,ragnaros,921,priest,discipline,39,16,23
Kashmirweed,ravencrest,921,priest,discipline,54,20,34
Rickermortis,defias-brotherhood,917,priest,discipline,28,10,18
Goldische,dun-morogh,917,priest,discipline,56,18,38
Elba,defias-brotherhood,916,priest,discipline,24,10,14
Arondir,defias-brotherhood,914,priest,discipline,22,11,11
Аргла,soulflayer,912,priest,discipline,66,24,42
Nunnis,kazzak,911,priest,discipline,254,129,125
Clergy,nagrand,910,priest,discipline,30,11,19
Cesiom,culte-de-la-rive-noire,909,priest,discipline,48,25,23
Moinmeister,frostmourne,909,priest,discipline,47,22,25
Ryuuzaki,stormscale,909,priest,discipline,23,10,13
Titibolls,sanguino,908,priest,discipline,23,10,13
Immórtal,tarren-mill,908,priest,discipline,30,10,20
Koderpl,burning-legion,906,priest,discipline,93,45,48
Stórmén,kazzak,906,priest,discipline,34,11,23
Lubdub,drakthul,905,priest,discipline,24,10,14
Seidel,aggramar,904,priest,discipline,34,17,17
Theunknown,stormscale,903,priest,discipline,29,11,18
Pugnatorius,archimonde,900,priest,discipline,27,10,17
Beellzo,sylvanas,899,priest,discipline,107,44,63
Wørmiexz,stormscale,895,priest,discipline,20,10,10
Deshaz,tarren-mill,895,priest,discipline,34,10,24
Shidolah,antonidas,894,priest,discipline,36,15,21
Amoxí,blackmoore,892,priest,discipline,18,10,8
Nosgot,earthen-ring,889,priest,discipline,30,14,16
Abstauberin,blackrock,889,priest,discipline,28,11,17
Minnaq,burning-legion,888,priest,discipline,24,10,14
Caprice,kelthuzad,888,priest,discipline,36,13,23
Adolosh,thrall,886,priest,discipline,24,12,12
Chandria,veknilash,886,priest,discipline,54,24,30
Kenyka,silvermoon,883,priest,discipline,56,19,37
Sétsukó,aegwynn,880,priest,discipline,16,10,6
Blååb,draenor,879,priest,discipline,19,10,9
Voided,nemesis,879,priest,discipline,19,10,9
Chillx,blackmoore,878,priest,discipline,85,45,40
Madvortexe,kazzak,874,priest,discipline,19,10,9
Saskiaa,doomhammer,874,priest,discipline,60,28,32
Æç,malganis,871,priest,discipline,11,10,1
Daria,teldrassil,871,priest,discipline,213,104,109
Borgír,burning-legion,871,priest,discipline,27,11,16
Toks,stormscale,871,priest,discipline,45,10,35
Elfiontko,burning-legion,870,priest,discipline,24,11,13
Chaendral,darkmoon-faire,868,priest,discipline,19,10,9
Slovak,stormscale,864,priest,discipline,12,9,3
Ahilarry,tarren-mill,864,priest,discipline,12,9,3
Hemmis,ravencrest,864,priest,discipline,12,9,3
Ratapain,argent-dawn,864,priest,discipline,12,9,3
Zyç,der-rat-von-dalaran,864,priest,discipline,12,9,3
Littledoc,blackmoore,864,priest,discipline,12,9,3
Pohja,veknilash,864,priest,discipline,12,9,3
Flipflops,kirin-tor,864,priest,discipline,12,9,3
Chimpanzoo,kazzak,864,priest,discipline,12,9,3
Cyúxyúvteea,ravencrest,864,priest,discipline,12,9,3
Priestyboyuk,tarren-mill,864,priest,discipline,12,9,3
Tridus,eitrigg,864,priest,discipline,12,9,3
Moonacky,bronze-dragonflight,864,priest,discipline,12,9,3
Byzzi,draenor,864,priest,discipline,12,9,3
Vyrá,der-rat-von-dalaran,864,priest,discipline,12,9,3
Cbbigbape,thrall,864,priest,discipline,12,9,3
Skycity,silvermoon,864,priest,discipline,12,9,3
Monflouz,archimonde,864,priest,discipline,12,9,3
Priéstitude,kazzak,864,priest,discipline,12,9,3
Finalvirus,draenor,864,priest,discipline,12,9,3
Svetozarov,wildhammer,864,priest,discipline,18,9,9
Lâñàt,ravencrest,864,priest,discipline,18,9,9
Infandus,pozzo-delleternità,864,priest,discipline,18,9,9
Muant,twisting-nether,864,priest,discipline,18,9,9
Ilovepmr,outland,864,priest,discipline,18,9,9
Dreythan,alakir,864,priest,discipline,18,9,9
Celliapriest,antonidas,864,priest,discipline,18,9,9
Donvasco,kazzak,864,priest,discipline,18,9,9
Goldeagle,archimonde,864,priest,discipline,18,9,9
Ynys,dentarg,864,priest,discipline,18,9,9
Heavensfire,twisting-nether,864,priest,discipline,18,9,9
Ilovecala,ravencrest,864,priest,discipline,18,9,9
Gloffoló,ragnaros,864,priest,discipline,18,9,9
Shaneya,silvermoon,864,priest,discipline,18,9,9
Jtep,ravencrest,864,priest,discipline,18,9,9
Thaykza,blackmoore,864,priest,discipline,18,9,9
Ycvdfghrkynu,sylvanas,864,priest,discipline,18,9,9
Siign,ravencrest,864,priest,discipline,22,10,12
Падлез,howling-fjord,864,priest,discipline,24,9,15
Itsdiscobaby,auchindoun,864,priest,discipline,24,9,15
Aspertina,outland,864,priest,discipline,24,9,15
Azymi,ravencrest,864,priest,discipline,24,9,15
Frígídhealz,outland,864,priest,discipline,24,9,15
Péntagon,festung-der-stürme,864,priest,discipline,24,9,15
Próxs,ravencrest,864,priest,discipline,24,9,15
Víd,dun-morogh,864,priest,discipline,24,9,15
Teresie,argent-dawn,864,priest,discipline,24,9,15
Chocomiette,archimonde,864,priest,discipline,25,9,16
Spezzato,nemesis,864,priest,discipline,30,9,21
Neverswapx,kazzak,864,priest,discipline,30,9,21
Devastris,ravencrest,864,priest,discipline,30,9,21
Evabae,the-maelstrom,864,priest,discipline,30,9,21
Justtpro,twisting-nether,863,priest,discipline,12,9,3
Franciscus,bladefist,863,priest,discipline,12,9,3
Весёлыйкоил,gordunni,863,priest,discipline,12,9,3
Grishnat,ragnaros,863,priest,discipline,12,9,3
Dhalsim,the-shatar,863,priest,discipline,12,9,3
Grainbames,sylvanas,863,priest,discipline,12,9,3
Simza,azuremyst,863,priest,discipline,12,9,3
Magicdisco,nemesis,863,priest,discipline,12,9,3
Qjju,blackmoore,863,priest,discipline,12,9,3
Eustâche,suramar,863,priest,discipline,12,9,3
Grandpatea,silvermoon,863,priest,discipline,12,9,3
Lehava,archimonde,863,priest,discipline,13,9,4
Priestlol,outland,863,priest,discipline,18,9,9
Coldxzera,tarren-mill,863,priest,discipline,18,9,9
Sonoja,blackhand,863,priest,discipline,18,9,9
Gorti,ravencrest,863,priest,discipline,18,9,9
Markianos,silvermoon,863,priest,discipline,18,9,9
Nilera,frostwolf,863,priest,discipline,18,9,9
Fabuliciøus,blackrock,863,priest,discipline,18,9,9
Mïxa,eitrigg,863,priest,discipline,18,9,9
Pollution,ragnaros,863,priest,discipline,18,9,9
Smitelay,alleria,863,priest,discipline,18,9,9
Ratingfeeder,tarren-mill,863,priest,discipline,18,9,9
Alshah,emerald-dream,863,priest,discipline,18,9,9
Giily,archimonde,863,priest,discipline,18,9,9
Ache,defias-brotherhood,863,priest,discipline,18,9,9
Ромиопвп,gordunni,863,priest,discipline,18,9,9
Sacreth,ragnaros,863,priest,discipline,18,9,9
Mojoo,aggramar,863,priest,discipline,24,9,15
Senza,ysondre,863,priest,discipline,24,9,15
Униакт,gordunni,863,priest,discipline,24,9,15
Shadokzor,ragnaros,863,priest,discipline,30,9,21
Capslk,ravencrest,863,priest,discipline,30,9,21
Valyreon,outland,863,priest,discipline,36,9,27
Hymn,defias-brotherhood,862,priest,discipline,12,9,3
Rawelf,ravencrest,862,priest,discipline,12,9,3
Vizire,ravencrest,862,priest,discipline,12,9,3
Gnomeeater,silvermoon,862,priest,discipline,12,9,3
Jána,argent-dawn,862,priest,discipline,12,9,3
Eshania,frostwolf,862,priest,discipline,12,9,3
Søkariss,elune,862,priest,discipline,12,9,3
Joeshmoex,blackrock,862,priest,discipline,12,9,3
Kildöre,hyjal,862,priest,discipline,12,9,3
Vandansk,kazzak,862,priest,discipline,12,9,3
Бахчи,thermaplugg,862,priest,discipline,18,9,9
Bonzux,dethecus,862,priest,discipline,18,9,9
Trasslarn,tarren-mill,862,priest,discipline,18,9,9
Hiimpinxî,ragnaros,862,priest,discipline,18,9,9
Sandcastles,ravencrest,862,priest,discipline,18,9,9
Skyalpha,silvermoon,862,priest,discipline,18,9,9
Солнцева,greymane,862,priest,discipline,24,9,15
Kämels,ravencrest,862,priest,discipline,24,9,15
Mxcey,ravencrest,862,priest,discipline,24,9,15
Merrysmiting,ravencrest,862,priest,discipline,30,9,21
Söultaker,ravencrest,861,priest,discipline,12,9,3
Vædan,drakthul,861,priest,discipline,12,9,3
Ghostee,twisting-nether,861,priest,discipline,12,9,3
Yusepmikel,cthun,861,priest,discipline,12,9,3
Vierfingerjo,eredar,861,priest,discipline,18,9,9
Fatalyse,ysondre,861,priest,discipline,72,33,39
Rennic,stormscale,861,priest,discipline,24,9,15
Clastro,outland,861,priest,discipline,24,9,15
Sorrop,sanguino,860,priest,discipline,18,9,9
Voodoo,the-maelstrom,860,priest,discipline,18,9,9
Bhlad,silvermoon,860,priest,discipline,18,9,9
Xharyo,ravencrest,860,priest,discipline,22,9,13
Codeincindy,blackhand,860,priest,discipline,24,9,15
Rafikii,eredar,860,priest,discipline,24,9,15
Morgrith,twisting-nether,859,priest,discipline,18,9,9
ßlowska,hyjal,859,priest,discipline,24,9,15
Myxeh,ravencrest,859,priest,discipline,24,9,15
Скумизарг,gordunni,859,priest,discipline,24,9,15
Dotmaker,sanguino,858,priest,discipline,24,9,15
Plzhealme,stormscale,857,priest,discipline,12,9,3
Märx,conseil-des-ombres,857,priest,discipline,12,9,3
Healpapa,blackhand,857,priest,discipline,18,9,9
Merkabah,azjolnerub,857,priest,discipline,24,9,15
Madreöscura,cthun,857,priest,discipline,33,10,23
Хомячише,lich-king,857,priest,discipline,30,9,21
Slyntan,ragnaros,856,priest,discipline,18,9,9
Ellianore,les-sentinelles,856,priest,discipline,24,9,15
Magnificito,silvermoon,855,priest,discipline,18,9,9
Lunarg,die-ewige-wacht,855,priest,discipline,18,9,9
Calenberhtil,burning-legion,855,priest,discipline,18,9,9
Deliriumxd,ravencrest,855,priest,discipline,26,12,14
Шадия,ashenvale,852,priest,discipline,21,12,9
Tykhe,burning-blade,851,priest,discipline,12,9,3
Orbea,sinstralis,850,priest,discipline,12,9,3
Reighl,drakthul,850,priest,discipline,18,9,9
Míjagí,blackhand,850,priest,discipline,31,11,20
Tacko,tarren-mill,849,priest,discipline,30,9,21
Ruebi,blackmoore,848,priest,discipline,18,9,9
Drynte,blackmoore,847,priest,discipline,23,9,14
Socratés,antonidas,846,priest,discipline,72,30,42
Arîbeth,antonidas,846,priest,discipline,48,9,39
Durell,blackrock,845,priest,discipline,30,11,19
Seiigops,ysondre,839,priest,discipline,12,9,3
Evastemplar,turalyon,836,priest,discipline,24,9,15
Valinoru,silvermoon,831,priest,discipline,17,9,8
Mílérí,ravencrest,830,priest,discipline,23,9,14
Тэслос,howling-fjord,829,priest,discipline,23,9,14
Lightofsuny,alakir,828,priest,discipline,35,11,24
Waikiki,ambossar,827,priest,discipline,16,10,6
Yoloswaglørd,blackmoore,822,priest,discipline,26,11,15
Ladá,stormscale,815,priest,discipline,19,9,10
Solaní,antonidas,808,priest,discipline,26,11,15
Floydovka,ragnaros,804,priest,discipline,32,11,21
Majestíc,blackmoore,802,priest,discipline,27,10,17
Rhanira,aegwynn,800,priest,discipline,17,9,8
Pb,stormscale,799,priest,discipline,11,9,2
Pillian,nordrassil,799,priest,discipline,16,9,7
Shikibu,sylvanas,798,priest,discipline,11,9,2
Svetidjordje,tarren-mill,795,priest,discipline,17,9,8
Roqu,ravencrest,792,priest,discipline,15,10,5
Bartolómeo,hellfire,792,priest,discipline,38,9,29
Duwendu,drakthul,791,priest,discipline,17,9,8
Gandzaa,silvermoon,785,priest,discipline,21,9,12
Протомуу,gordunni,783,priest,discipline,11,9,2
Goatz,ragnaros,778,priest,discipline,24,17,7
Homxcxde,ravencrest,777,priest,discipline,26,10,16
Anabølix,ravencrest,768,priest,discipline,12,8,4
Dezless,tarren-mill,768,priest,discipline,12,8,4
Junglepls,burning-blade,768,priest,discipline,12,8,4
Arnn,hyjal,768,priest,discipline,12,8,4
Nitroze,stormscale,768,priest,discipline,12,8,4
Mewdi,outland,768,priest,discipline,12,8,4
Ewalouvia,drakthul,768,priest,discipline,12,8,4
Ewamlf,drakthul,768,priest,discipline,12,8,4
Bammerr,stormscale,768,priest,discipline,12,8,4
Abcdefghijk,sanguino,768,priest,discipline,12,8,4
Boogereater,kazzak,768,priest,discipline,12,8,4
Alexuwu,kazzak,768,priest,discipline,12,8,4
Zerovision,nemesis,768,priest,discipline,12,8,4
Røylian,ravencrest,768,priest,discipline,12,8,4
Katleiya,ysondre,768,priest,discipline,12,8,4
Gerrylol,draenor,768,priest,discipline,12,8,4
Appraiser,draenor,768,priest,discipline,12,8,4
Noxoth,amanthul,768,priest,discipline,12,8,4
Killafoolx,silvermoon,768,priest,discipline,12,8,4
Krecik,deathwing,768,priest,discipline,12,8,4
Meldgodx,das-konsortium,768,priest,discipline,12,8,4
Joeblowx,blackrock,768,priest,discipline,12,8,4
Soylaleche,ravencrest,768,priest,discipline,12,8,4
Jesster,sylvanas,768,priest,discipline,12,8,4
Jesslol,archimonde,768,priest,discipline,12,8,4
Celopital,archimonde,768,priest,discipline,12,8,4
Anticorona,twisting-nether,768,priest,discipline,12,8,4
Wasserbache,antonidas,768,priest,discipline,12,8,4
Orkanwal,ravencrest,768,priest,discipline,12,8,4
Bellrock,nemesis,768,priest,discipline,16,9,7
Tobijara,proudmoore,768,priest,discipline,18,8,10
Фростингшп,goldrinn,768,priest,discipline,18,8,10
Ttmlht,alakir,768,priest,discipline,18,8,10
Finizkram,sylvanas,768,priest,discipline,18,8,10
Alexwinkwink,kazzak,768,priest,discipline,18,8,10
Uanna,ravencrest,768,priest,discipline,18,8,10
Azpr,ravencrest,768,priest,discipline,18,8,10
Aelíth,archimonde,768,priest,discipline,18,8,10
Chrònos,das-konsortium,768,priest,discipline,18,8,10
Nstp,zuljin,768,priest,discipline,18,8,10
Kristianburn,arathi,768,priest,discipline,18,8,10
Skjelett,stormscale,768,priest,discipline,18,8,10
Stealtsøul,outland,768,priest,discipline,18,8,10
Mercila,drakthul,768,priest,discipline,18,8,10
Tanjaspano,twisting-nether,768,priest,discipline,18,8,10
Сандейрейн,gordunni,768,priest,discipline,24,8,16
Тёмныйвид,soulflayer,768,priest,discipline,24,8,16
Avp,the-maelstrom,768,priest,discipline,24,8,16
Brainbadly,aegwynn,768,priest,discipline,24,8,16
Prestigé,vashj,768,priest,discipline,24,8,16
Shyiox,frostwolf,768,priest,discipline,24,8,16
Neeti,kazzak,767,priest,discipline,12,8,4
Ðelftware,tarren-mill,767,priest,discipline,12,8,4
Srysx,nazjatar,767,priest,discipline,12,8,4
Sunfire,twisting-nether,767,priest,discipline,12,8,4
Unckus,defias-brotherhood,767,priest,discipline,12,8,4
Jappsolut,outland,767,priest,discipline,12,8,4
Aexlius,silvermoon,767,priest,discipline,12,8,4
Kletroll,archimonde,767,priest,discipline,12,8,4
Стромъяр,gordunni,767,priest,discipline,12,8,4
Lightmyshimy,silvermoon,767,priest,discipline,12,8,4
Szerelmi,ragnaros,767,priest,discipline,12,8,4
Leçke,ravencrest,767,priest,discipline,12,8,4
Reeta,stormscale,767,priest,discipline,12,8,4
Ingvár,blackrock,767,priest,discipline,12,8,4
Tothegrave,draenor,767,priest,discipline,18,8,10
Isadian,kazzak,767,priest,discipline,18,8,10
Jessijones,gorgonnash,767,priest,discipline,18,8,10
Dathanosx,outland,767,priest,discipline,18,8,10
Célaz,blackmoore,767,priest,discipline,18,8,10
Priestyo,blackrock,767,priest,discipline,18,8,10
Missandeí,frostmane,767,priest,discipline,18,8,10
Holyshifts,silvermoon,767,priest,discipline,18,8,10
Zelensky,stormscale,767,priest,discipline,18,8,10
Johnblack,dun-morogh,767,priest,discipline,18,8,10
Arwén,zuljin,767,priest,discipline,18,8,10
Joex,arathor,767,priest,discipline,18,8,10
Tryingtomc,archimonde,767,priest,discipline,18,8,10
Luminouzilla,tarren-mill,767,priest,discipline,18,8,10
Dfourc,blackhand,767,priest,discipline,18,8,10
Saurap,uldum,767,priest,discipline,18,8,10
Disclol,aegwynn,767,priest,discipline,24,8,16
Anadyia,aegwynn,767,priest,discipline,24,8,16
Ìstarï,sylvanas,767,priest,discipline,24,8,16
Healenax,ravencrest,767,priest,discipline,30,8,22
Eurocodex,antonidas,766,priest,discipline,12,8,4
Evangíline,stormreaver,766,priest,discipline,12,8,4
Okfartpå,ravencrest,766,priest,discipline,12,8,4
Chrissirr,culte-de-la-rive-noire,766,priest,discipline,12,8,4
Celrin,chamber-of-aspects,766,priest,discipline,12,8,4
Sameasal,kazzak,766,priest,discipline,12,8,4
Snickwomen,silvermoon,766,priest,discipline,14,8,6
Кфень,soulflayer,766,priest,discipline,16,9,7
Lianny,sylvanas,766,priest,discipline,18,8,10
Kaliboom,archimonde,766,priest,discipline,18,8,10
Børisheal,draenor,766,priest,discipline,18,8,10
Shimajo,steamwheedle-cartel,766,priest,discipline,18,8,10
Chuntriest,shadowsong,766,priest,discipline,18,8,10
Ezor,dalvengyr,766,priest,discipline,18,8,10
Kangkong,ravencrest,766,priest,discipline,18,8,10
Thesunbeam,silvermoon,766,priest,discipline,24,8,16
Paulina,auchindoun,766,priest,discipline,24,8,16
Metabeta,shattered-hand,766,priest,discipline,24,8,16
Chaosweavèr,outland,766,priest,discipline,24,8,16
Akadras,blackmoore,765,priest,discipline,12,8,4
Pure,kazzak,765,priest,discipline,12,8,4
Poxqt,thrall,765,priest,discipline,12,8,4
Addickted,defias-brotherhood,765,priest,discipline,12,8,4
Regenerous,bloodhoof,765,priest,discipline,22,11,11
Djmouniax,archimonde,765,priest,discipline,18,8,10
Julianpriest,nethersturm,765,priest,discipline,22,9,13
Ноатоэль,gordunni,765,priest,discipline,24,8,16
Thakjing,bladefist,765,priest,discipline,24,8,16
Uglypriest,grim-batol,764,priest,discipline,12,8,4
Demorog,stormscale,764,priest,discipline,12,8,4
Battleprey,the-maelstrom,764,priest,discipline,12,8,4
Irenedwen,silvermoon,764,priest,discipline,18,8,10
Вартэг,blackscar,764,priest,discipline,18,8,10
Aurea,deathwing,764,priest,discipline,18,8,10
Шелоу,deathguard,764,priest,discipline,27,9,18
Ishande,los-errantes,763,priest,discipline,12,8,4
Itokkzhul,draenor,763,priest,discipline,18,8,10
Кравос,soulflayer,763,priest,discipline,18,8,10
Mefeon,draenor,763,priest,discipline,18,8,10
Inoy,dun-modr,763,priest,discipline,18,8,10
Hmanco,burning-legion,763,priest,discipline,18,8,10
Biigy,hyjal,763,priest,discipline,18,8,10
Áphrodite,outland,763,priest,discipline,18,8,10
Nyuu,aggra-português,762,priest,discipline,12,8,4
Nightshådøw,silvermoon,762,priest,discipline,22,10,12
Tëmärï,ravencrest,762,priest,discipline,18,8,10
Fusiroxx,thrall,762,priest,discipline,22,9,13
Fillî,antonidas,761,priest,discipline,18,8,10
Urticaire,arathi,761,priest,discipline,18,8,10
Могвайи,soulflayer,761,priest,discipline,18,8,10
Velanrous,kazzak,760,priest,discipline,18,8,10
Arwen,azjolnerub,760,priest,discipline,18,8,10
Келебриана,deepholm,759,priest,discipline,12,8,4
Enchanttress,burning-legion,759,priest,discipline,12,8,4
Sîanah,archimonde,754,priest,discipline,12,8,4
Wisdoms,thrall,754,priest,discipline,37,8,29
Shattow,ravencrest,751,priest,discipline,17,8,9
Omened,nemesis,751,priest,discipline,17,8,9
Insaner,ahnqiraj,751,priest,discipline,17,8,9
Tïniebla,dun-modr,750,priest,discipline,18,8,10
Seypercillo,dun-modr,746,priest,discipline,24,8,16
Lazzariah,ravencrest,742,priest,discipline,18,8,10
Nilsatis,grim-batol,741,priest,discipline,71,26,45
Hombre,anetheron,734,priest,discipline,22,9,13
Blorpan,tarren-mill,734,priest,discipline,26,9,17
Bälöö,archimonde,733,priest,discipline,22,8,14
Amoorâ,twisting-nether,732,priest,discipline,11,8,3
Kipnuggetz,burning-legion,732,priest,discipline,17,8,9
Jashmin,eredar,732,priest,discipline,35,10,25
Killermoon,rexxar,728,priest,discipline,16,8,8
Cthultist,dun-modr,728,priest,discipline,26,9,17
Ortarn,defias-brotherhood,727,priest,discipline,25,10,15
Pnsl,dun-morogh,723,priest,discipline,36,11,25
Stormééz,bronzebeard,722,priest,discipline,32,9,23
Coldyx,blackrock,719,priest,discipline,11,8,3
Otacon,burning-legion,719,priest,discipline,15,8,7
Quintanaro,thrall,719,priest,discipline,33,8,25
Oprahpriest,ragnaros,718,priest,discipline,11,8,3
Sneed,moonglade,718,priest,discipline,36,9,27
Kikoke,sanguino,717,priest,discipline,15,8,7
Amanojaku,archimonde,716,priest,discipline,24,9,15
Sméctà,marécage-de-zangar,713,priest,discipline,16,9,7
Дакимакурах,gordunni,713,priest,discipline,23,9,14
Zubrowkâ,kazzak,712,priest,discipline,27,9,18
Telpriest,blackrock,710,priest,discipline,25,9,16
Anariell,ravencrest,706,priest,discipline,19,9,10
Jimmymcgill,ravencrest,704,priest,discipline,16,8,8
Greenlizard,stormreaver,704,priest,discipline,22,8,14
Nällytq,nefarian,703,priest,discipline,11,8,3
Ðøñtårmørýmë,der-abyssische-rat,703,priest,discipline,20,8,12
Sacerdotini,outland,702,priest,discipline,19,9,10
Khomic,archimonde,702,priest,discipline,17,8,9
Зиибак,soulflayer,699,priest,discipline,20,8,12
Sapieha,burning-legion,687,priest,discipline,11,8,3
Sollante,onyxia,686,priest,discipline,11,8,3
Wintersônne,kult-der-verdammten,684,priest,discipline,13,8,5
Trixix,ragnaros,684,priest,discipline,14,8,6
Renesmè,archimonde,684,priest,discipline,19,8,11
Holymoni,ragnaros,680,priest,discipline,16,8,8
Itachiuchiha,bloodfeather,677,priest,discipline,27,8,19
Womanwonderf,ravencrest,672,priest,discipline,12,7,5
Magiclands,twisting-nether,672,priest,discipline,12,7,5
Отменяю,howling-fjord,672,priest,discipline,12,7,5
Plåster,dunemaul,672,priest,discipline,12,7,5
Longheals,stormscale,672,priest,discipline,12,7,5
Bunnygxrl,ravencrest,672,priest,discipline,12,7,5
Êva,ravencrest,672,priest,discipline,12,7,5
Somai,aegwynn,672,priest,discipline,12,7,5
Sneboldìs,sylvanas,672,priest,discipline,12,7,5
Ранзегодх,soulflayer,672,priest,discipline,12,7,5
Touchypunk,ravencrest,672,priest,discipline,12,7,5
Ajioli,frostwolf,672,priest,discipline,12,7,5
Tortellìno,stormscale,672,priest,discipline,12,7,5
Xethh,stormscale,672,priest,discipline,12,7,5
Leronia,stormscale,672,priest,discipline,12,7,5
Gudjon,dragonblight,672,priest,discipline,12,7,5
Дефаенс,soulflayer,672,priest,discipline,12,7,5
Jaytî,ravencrest,672,priest,discipline,12,7,5
Fåye,ravencrest,672,priest,discipline,12,7,5
Pattie,ragnaros,672,priest,discipline,12,7,5
Dombili,frostmane,672,priest,discipline,12,7,5
Priestedy,ravencrest,672,priest,discipline,12,7,5
Ranocchio,the-maelstrom,672,priest,discipline,12,7,5
Excell,hellfire,672,priest,discipline,12,7,5
Gladíator,blackhand,672,priest,discipline,12,7,5
Monkeywave,stormscale,672,priest,discipline,12,7,5
Angemir,nemesis,672,priest,discipline,12,7,5
Têmplârx,stormscale,672,priest,discipline,12,7,5
Discmachinex,stormscale,672,priest,discipline,12,7,5
Nishto,twisting-nether,672,priest,discipline,12,7,5
Moppriest,twisting-nether,672,priest,discipline,12,7,5
Ahrimal,turalyon,672,priest,discipline,12,7,5
Barbïelolz,sargeras,672,priest,discipline,12,7,5
Petitogré,silvermoon,672,priest,discipline,12,7,5
Fortítude,draenor,672,priest,discipline,12,7,5
Agms,sanguino,672,priest,discipline,12,7,5
Dashxzz,silvermoon,672,priest,discipline,12,7,5
Dîàna,archimonde,672,priest,discipline,12,7,5
Pflanzenmann,nozdormu,672,priest,discipline,12,7,5
Shuya,archimonde,672,priest,discipline,12,7,5
Wurstpriest,silvermoon,672,priest,discipline,12,7,5
Ziz,outland,672,priest,discipline,12,7,5
Holymamba,silvermoon,672,priest,discipline,12,7,5
Morphics,silvermoon,672,priest,discipline,12,7,5
Zenfangirlx,kazzak,672,priest,discipline,12,7,5
Aevery,onyxia,672,priest,discipline,12,7,5
Shenkt,ravenholdt,672,priest,discipline,12,7,5
Smiteweaver,drakthul,672,priest,discipline,12,7,5
Binkx,tarren-mill,672,priest,discipline,12,7,5
Mdmaster,stormreaver,672,priest,discipline,12,7,5
Luuniisboost,blackmoore,672,priest,discipline,12,7,5
Blutleid,malfurion,672,priest,discipline,12,7,5
Discobeb,les-clairvoyants,672,priest,discipline,12,7,5
Kosa,tarren-mill,672,priest,discipline,12,7,5
Zsozsopapa,tarren-mill,672,priest,discipline,12,7,5
Evypriest,draenor,672,priest,discipline,12,7,5
Ganakenp,tarren-mill,672,priest,discipline,12,7,5
Sapholie,kirin-tor,672,priest,discipline,12,7,5
Néantine,ysondre,672,priest,discipline,12,7,5
Mahraxyr,hyjal,672,priest,discipline,12,7,5
Skallya,ysondre,672,priest,discipline,12,7,5
Rixfoulah,ysondre,672,priest,discipline,12,7,5
Deluxgodx,kazzak,672,priest,discipline,12,7,5
Uadedez,tarren-mill,672,priest,discipline,13,7,6
Ominoushell,twisting-nether,672,priest,discipline,15,7,8
Shockpriest,grim-batol,672,priest,discipline,18,7,11
Touchmé,blackmoore,672,priest,discipline,18,7,11
Comple,kazzak,672,priest,discipline,18,7,11
Solerona,blackmoore,672,priest,discipline,18,7,11
Zivl,blackrock,672,priest,discipline,18,7,11
Wyroofear,ragnaros,672,priest,discipline,18,7,11
Toxicx,aegwynn,672,priest,discipline,18,7,11
Люциусмелфой,howling-fjord,672,priest,discipline,18,7,11
Cház,sanguino,672,priest,discipline,18,7,11
Djariisimp,tarren-mill,672,priest,discipline,18,7,11
Bebsenpai,hyjal,672,priest,discipline,18,7,11
Venitate,kazzak,672,priest,discipline,18,7,11
Ârth,kirin-tor,672,priest,discipline,18,7,11
Bubblebuddy,draenor,672,priest,discipline,18,7,11
Byez,kazzak,672,priest,discipline,18,7,11
Sardine,ravencrest,672,priest,discipline,18,7,11
Bij,outland,672,priest,discipline,18,7,11
Vate,aszune,672,priest,discipline,18,7,11
Malpractîce,draenor,672,priest,discipline,18,7,11
Jimski,stormscale,672,priest,discipline,24,7,17
Sweity,dun-modr,672,priest,discipline,24,7,17
Exaneo,ragnaros,672,priest,discipline,24,7,17
Хексорик,howling-fjord,672,priest,discipline,24,7,17
Yaaoz,dun-modr,672,priest,discipline,24,7,17
Sàvia,pozzo-delleternità,672,priest,discipline,24,7,17
Lunærÿ,hyjal,672,priest,discipline,24,7,17
Колабезгаза,howling-fjord,671,priest,discipline,12,7,5
Giggidee,tarren-mill,671,priest,discipline,12,7,5
Szederina,outland,671,priest,discipline,12,7,5
Manî,quelthalas,671,priest,discipline,12,7,5
Rines,thrall,671,priest,discipline,12,7,5
Zzero,kazzak,671,priest,discipline,12,7,5
Löspajen,stormscale,671,priest,discipline,12,7,5
Boomboxk,darksorrow,671,priest,discipline,12,7,5
Атинка,gordunni,671,priest,discipline,12,7,5
Taksí,tarren-mill,671,priest,discipline,12,7,5
Chayz,thrall,671,priest,discipline,12,7,5
Taxprayer,blackmoore,671,priest,discipline,12,7,5
Роа,soulflayer,671,priest,discipline,12,7,5
Flode,draenor,671,priest,discipline,12,7,5
Gagai,ravencrest,671,priest,discipline,12,7,5
Lish,dun-modr,671,priest,discipline,12,7,5
Phoskitos,sanguino,671,priest,discipline,12,7,5
Saltfeskball,tarren-mill,671,priest,discipline,12,7,5
Dannebrog,eonar,671,priest,discipline,12,7,5
Xvpr,trollbane,671,priest,discipline,12,7,5
Reól,blackmoore,671,priest,discipline,12,7,5
Froboz,the-venture-co,671,priest,discipline,12,7,5
Oikus,minahonda,671,priest,discipline,12,7,5
Köftemcc,blackrock,671,priest,discipline,12,7,5
Liljohnny,silvermoon,671,priest,discipline,12,7,5
Aemi,draenor,671,priest,discipline,12,7,5
Highpriestqt,pozzo-delleternità,671,priest,discipline,12,7,5
Ezhealing,ravencrest,671,priest,discipline,12,7,5
Exorcizamus,khaz-modan,671,priest,discipline,12,7,5
Fargall,eonar,671,priest,discipline,12,7,5
Schnîttchen,blackrock,671,priest,discipline,12,7,5
Àlucárd,blackhand,671,priest,discipline,12,7,5
Zazeriño,dun-modr,671,priest,discipline,13,7,6
Ziap,dentarg,671,priest,discipline,20,8,12
Kasuny,outland,671,priest,discipline,18,7,11
Текилашотёп,soulflayer,671,priest,discipline,18,7,11
Lezz,ragnaros,671,priest,discipline,18,7,11
Lillaego,ragnaros,671,priest,discipline,18,7,11
Débthèønë,ravencrest,671,priest,discipline,18,7,11
Botoxo,zirkel-des-cenarius,671,priest,discipline,18,7,11
Lysium,sylvanas,671,priest,discipline,18,7,11
Pixa,dalaran,671,priest,discipline,18,7,11
Cronershadow,stormscale,671,priest,discipline,18,7,11
Маджори,azuregos,671,priest,discipline,18,7,11
Психоз,gordunni,671,priest,discipline,18,7,11
Nyù,kazzak,671,priest,discipline,18,7,11
Carlolol,blackmoore,671,priest,discipline,22,8,14
Holykebab,defias-brotherhood,671,priest,discipline,24,7,17
Maâti,kazzak,671,priest,discipline,24,7,17
Pandariel,argent-dawn,671,priest,discipline,24,7,17
Höfi,ragnaros,671,priest,discipline,24,7,17
Orqz,anetheron,670,priest,discipline,12,7,5
Exo,blackmoore,670,priest,discipline,12,7,5
Këkhtaräkh,tarren-mill,670,priest,discipline,12,7,5
Fathermaxii,stormrage,670,priest,discipline,12,7,5
Cheesegód,outland,670,priest,discipline,12,7,5
Byshadow,silvermoon,670,priest,discipline,12,7,5
Tilah,azjolnerub,670,priest,discipline,12,7,5
Хемех,soulflayer,670,priest,discipline,12,7,5
Reizer,argent-dawn,670,priest,discipline,12,7,5
Ремкомплект,soulflayer,670,priest,discipline,12,7,5
Mapplish,eredar,670,priest,discipline,12,7,5
Noralía,die-aldor,670,priest,discipline,12,7,5
Nekros,agamaggan,670,priest,discipline,14,7,7
Каратэк,howling-fjord,670,priest,discipline,17,7,10
Aggresivdisc,hyjal,670,priest,discipline,18,7,11
Cabuto,darksorrow,670,priest,discipline,18,7,11
Olikharma,archimonde,670,priest,discipline,18,7,11
Makkalisser,kazzak,670,priest,discipline,24,7,17
Nswqt,kazzak,669,priest,discipline,12,7,5
Freeak,hellfire,669,priest,discipline,12,7,5
Eentii,twisting-nether,669,priest,discipline,12,7,5
Belithia,argent-dawn,669,priest,discipline,12,7,5
Sadira,malganis,669,priest,discipline,18,7,11
Зашохэйт,soulflayer,669,priest,discipline,18,7,11
Дэйвора,ashenvale,669,priest,discipline,18,7,11
Dizdae,rashgarroth,669,priest,discipline,18,7,11
Йениферх,gordunni,669,priest,discipline,24,7,17
Æzy,burning-blade,669,priest,discipline,24,7,17
Абсорберша,gordunni,668,priest,discipline,12,7,5
Пакспамир,gordunni,668,priest,discipline,12,7,5
Wärtheur,sanguino,668,priest,discipline,18,7,11
Mescaminator,blackmoore,668,priest,discipline,18,7,11
Isoris,hyjal,668,priest,discipline,18,7,11
Lacaena,deathwing,668,priest,discipline,18,7,11
Darknëss,malganis,668,priest,discipline,18,7,11
Prgkek,sanguino,668,priest,discipline,24,7,17
Shyktar,sanguino,667,priest,discipline,12,7,5
Дуззер,howling-fjord,667,priest,discipline,12,7,5
Romelu,archimonde,666,priest,discipline,18,7,11
Святаядухота,soulflayer,664,priest,discipline,24,7,17
Timmemeep,outland,663,priest,discipline,18,7,11
Холисшит,gordunni,662,priest,discipline,18,7,11
Alminä,archimonde,661,priest,discipline,12,7,5
Camellight,stormscale,661,priest,discipline,18,7,11
Hiliom,ahnqiraj,660,priest,discipline,38,12,26
Willibad,executus,658,priest,discipline,18,7,11
Vatizinium,veklor,655,priest,discipline,17,7,10
Widöw,cthun,653,priest,discipline,31,11,20
Jaein,thrall,640,priest,discipline,16,8,8
Samimnot,ravencrest,639,priest,discipline,14,8,6
Øxx,blackrock,639,priest,discipline,17,7,10
Yazzyz,eredar,639,priest,discipline,23,7,16
Chooser,stormscale,638,priest,discipline,20,8,12
Nepheliel,ysondre,628,priest,discipline,12,8,4
Zuigen,lightbringer,624,priest,discipline,9,8,1
Ysteriagødx,twisting-nether,624,priest,discipline,15,8,7
Submexoxo,archimonde,624,priest,discipline,15,7,8
Yourholiness,rexxar,624,priest,discipline,15,7,8
Akril,silvermoon,622,priest,discipline,11,7,4
Cezzar,kazzak,622,priest,discipline,11,7,4
Рейаста,howling-fjord,622,priest,discipline,15,7,8
Zénack,stormscale,622,priest,discipline,17,7,10
Susee,nozdormu,621,priest,discipline,15,8,7
Darktattoo,twisting-nether,621,priest,discipline,21,8,13
Blastor,ravencrest,621,priest,discipline,21,7,14
Argôs,ravencrest,620,priest,discipline,14,8,6
Voilencia,kazzak,620,priest,discipline,21,7,14
Giibboo,emerald-dream,618,priest,discipline,22,9,13
Rallzken,stormscale,614,priest,discipline,29,10,19
Jumbe,eredar,607,priest,discipline,11,7,4
Shymouni,norgannon,606,priest,discipline,13,8,5
Atibarát,hellfire,605,priest,discipline,16,7,9
Dumstrut,twisting-nether,602,priest,discipline,17,7,10
Пофанчику,soulflayer,597,priest,discipline,35,14,21
Diccen,twilights-hammer,592,priest,discipline,13,7,6
Schnüschnü,blackmoore,592,priest,discipline,25,7,18
Maetena,archimonde,589,priest,discipline,13,7,6
Yummelol,dun-modr,585,priest,discipline,20,8,12
Nemex,jaedenar,576,priest,discipline,6,6,0
Illiest,ravencrest,576,priest,discipline,6,6,0
Cluelesstwo,ravencrest,576,priest,discipline,6,6,0
Rqx,stormscale,576,priest,discipline,6,6,0
Retardé,tarren-mill,576,priest,discipline,6,6,0
Måzikeen,stormscale,576,priest,discipline,6,6,0
Táliss,arthas,576,priest,discipline,6,6,0
Scrubydoo,ravencrest,576,priest,discipline,6,6,0
Nòvã,kazzak,576,priest,discipline,6,6,0
Willzah,outland,576,priest,discipline,6,6,0
Brainwashed,malorne,576,priest,discipline,10,7,3
Tifrahat,the-maelstrom,576,priest,discipline,12,6,6
Nicolovato,draenor,576,priest,discipline,12,6,6
Whynolove,ragnaros,576,priest,discipline,12,6,6
Seemywatch,ungoro,576,priest,discipline,12,6,6
Peign,eredar,576,priest,discipline,12,6,6
Roxxurios,khazgoroth,576,priest,discipline,12,6,6
Шарлизх,gordunni,576,priest,discipline,12,6,6
Nyxara,outland,576,priest,discipline,12,6,6
Ascindra,ravencrest,576,priest,discipline,12,6,6
Popor,archimonde,576,priest,discipline,12,6,6
Zyreenx,blackrock,576,priest,discipline,12,6,6
Mitasdi,stormscale,576,priest,discipline,12,6,6
Randpriets,nemesis,576,priest,discipline,12,6,6
Ènma,archimonde,576,priest,discipline,12,6,6
Healinrbglol,blackmoore,576,priest,discipline,12,6,6
Dødy,hyjal,576,priest,discipline,12,6,6
Wortmonster,malganis,576,priest,discipline,12,6,6
Вакидзачи,gordunni,576,priest,discipline,12,6,6
Corrâ,aegwynn,576,priest,discipline,12,6,6
Pukkadtfasz,ragnaros,576,priest,discipline,12,6,6
Eiw,drakthul,576,priest,discipline,12,6,6
Sensimiya,dalaran,576,priest,discipline,12,6,6
Notthatbad,draenor,576,priest,discipline,12,6,6
Ballarr,burning-legion,576,priest,discipline,12,6,6
Laddets,ravencrest,576,priest,discipline,12,6,6
Stuhlgänger,blackhand,576,priest,discipline,12,6,6
Menjo,silvermoon,576,priest,discipline,12,6,6
Apeminister,nemesis,576,priest,discipline,12,6,6
Çhéåtçødé,ravencrest,576,priest,discipline,12,6,6
Ryyne,ravencrest,576,priest,discipline,12,6,6
Steroidkidx,ravencrest,576,priest,discipline,12,6,6
Щещенская,gordunni,576,priest,discipline,12,6,6
Nogsn,kazzak,576,priest,discipline,12,6,6
Fästrak,dalaran,576,priest,discipline,12,6,6
Ranagöl,ragnaros,576,priest,discipline,12,6,6
Jogug,mannoroth,576,priest,discipline,12,6,6
Ahyha,ravencrest,576,priest,discipline,12,6,6
Zeksii,kazzak,576,priest,discipline,12,6,6
Pallimpallam,blackrock,576,priest,discipline,12,6,6
Visàge,silvermoon,576,priest,discipline,12,6,6
Kankstery,kazzak,576,priest,discipline,12,6,6
Holishiit,xavius,576,priest,discipline,12,6,6
Данке,soulflayer,576,priest,discipline,12,6,6
Densen,burning-legion,576,priest,discipline,12,6,6
Lafap,eredar,576,priest,discipline,12,6,6
Inánis,argent-dawn,576,priest,discipline,12,6,6
Pøh,kilrogg,576,priest,discipline,12,6,6
Wispyx,kazzak,576,priest,discipline,12,6,6
Hardstylewtf,chromaggus,576,priest,discipline,12,6,6
Dunkelseele,ahnqiraj,576,priest,discipline,12,6,6
Giygas,malganis,576,priest,discipline,12,6,6
Boysa,earthen-ring,576,priest,discipline,12,6,6
Vladhealsyou,outland,576,priest,discipline,12,6,6
Kaylaylaylay,draenor,576,priest,discipline,12,6,6
Jaduheart,ravencrest,576,priest,discipline,12,6,6
Aveix,silvermoon,576,priest,discipline,12,6,6
Awalneczarem,magtheridon,576,priest,discipline,12,6,6
Yllaenia,twisting-nether,576,priest,discipline,12,6,6
Kintsugí,ragnaros,576,priest,discipline,12,6,6
Becknarbritt,stormscale,576,priest,discipline,12,6,6
Zøid,ysondre,576,priest,discipline,12,6,6
Idisck,kazzak,576,priest,discipline,12,6,6
Nithraw,kazzak,576,priest,discipline,12,6,6
Vulreth,culte-de-la-rive-noire,576,priest,discipline,12,6,6
Resuscitator,spinebreaker,576,priest,discipline,12,6,6
Ordeal,tarren-mill,576,priest,discipline,12,6,6
Chalecø,dun-modr,576,priest,discipline,12,6,6
Jesper,outland,576,priest,discipline,12,6,6
Chira,thunderhorn,576,priest,discipline,12,6,6
Vorsie,tarren-mill,576,priest,discipline,12,6,6
Vhis,ragnaros,576,priest,discipline,12,6,6
Pigo,tarren-mill,576,priest,discipline,12,6,6
Shadowzrip,twilights-hammer,576,priest,discipline,12,6,6
Свао,howling-fjord,576,priest,discipline,12,6,6
Димавампирик,howling-fjord,576,priest,discipline,12,6,6
Редженерэйшн,gordunni,576,priest,discipline,12,6,6
Родохрозит,blackscar,576,priest,discipline,12,6,6
Steelbird,ravencrest,576,priest,discipline,12,6,6
Rune,ravencrest,576,priest,discipline,12,6,6
Manethø,twisting-nether,576,priest,discipline,12,6,6
Tâssên,kazzak,576,priest,discipline,12,6,6
Mârcwel,burning-legion,576,priest,discipline,12,6,6
Jaylove,frostwolf,576,priest,discipline,12,6,6
Йодтс,soulflayer,576,priest,discipline,12,6,6
Sejká,malganis,576,priest,discipline,12,6,6
Lectrá,kazzak,576,priest,discipline,12,6,6
Sleepzqt,blackrock,576,priest,discipline,12,6,6
Yunggoth,eredar,576,priest,discipline,12,6,6
Shttygame,nazjatar,576,priest,discipline,12,6,6
Msbald,shattered-hand,576,priest,discipline,12,6,6
Eviscerätor,draenor,576,priest,discipline,12,6,6
Whitemask,kazzak,576,priest,discipline,12,6,6
Belfu,twisting-nether,576,priest,discipline,12,6,6
Imaut,emerald-dream,576,priest,discipline,12,6,6
Oddarne,twisting-nether,576,priest,discipline,12,6,6
Wush,tarren-mill,576,priest,discipline,12,6,6
Stee,sylvanas,576,priest,discipline,12,6,6
Samerika,tarren-mill,576,priest,discipline,12,6,6
Abyl,nethersturm,576,priest,discipline,12,6,6
Rotulos,stormrage,576,priest,discipline,12,6,6
Ðèvì,ravencrest,576,priest,discipline,12,6,6
Vallstwo,zuljin,576,priest,discipline,12,6,6
Aethanira,silvermoon,576,priest,discipline,12,6,6
Maistuu,tarren-mill,576,priest,discipline,12,6,6
Melcarth,blades-edge,576,priest,discipline,12,6,6
Ранзерито,soulflayer,576,priest,discipline,17,8,9
Naìt,ragnaros,576,priest,discipline,15,7,8
Iqy,kazzak,576,priest,discipline,15,7,8
Chrisdorner,archimonde,576,priest,discipline,15,6,9
Wixzyx,ravencrest,576,priest,discipline,16,6,10
Волия,gordunni,576,priest,discipline,17,6,11
Respectwømen,ravencrest,576,priest,discipline,18,6,12
Бичиотаке,azuregos,576,priest,discipline,18,6,12
Deadbishop,kazzak,576,priest,discipline,18,6,12
Abrakahudder,tarren-mill,576,priest,discipline,18,6,12
Alros,elune,576,priest,discipline,18,6,12
Jph,thrall,576,priest,discipline,18,6,12
Velri,runetotem,576,priest,discipline,18,6,12
Hélgå,kazzak,576,priest,discipline,18,6,12
Швдшка,howling-fjord,576,priest,discipline,18,6,12
Broksigar,the-maelstrom,576,priest,discipline,18,6,12
Ballepresten,outland,576,priest,discipline,18,6,12
Sosionomi,argent-dawn,576,priest,discipline,18,6,12
ßøunty,dun-modr,576,priest,discipline,18,6,12
Сашашвд,howling-fjord,576,priest,discipline,18,6,12
Limbas,dun-modr,576,priest,discipline,18,6,12
Zinzo,frostwolf,576,priest,discipline,18,6,12
Thielaxx,ravencrest,576,priest,discipline,18,6,12
Achardia,argent-dawn,576,priest,discipline,18,6,12
Gødsmack,blackhand,576,priest,discipline,18,6,12
Decimerad,kazzak,576,priest,discipline,18,6,12
Prarch,sylvanas,576,priest,discipline,18,6,12
Stvilde,ragnaros,576,priest,discipline,18,6,12
Rabbai,ravencrest,576,priest,discipline,18,6,12
Венэма,azuregos,576,priest,discipline,18,6,12
Декорий,soulflayer,576,priest,discipline,18,6,12
Cinjá,thrall,576,priest,discipline,19,6,13
Twisty,malganis,576,priest,discipline,19,6,13
Alwiel,kazzak,576,priest,discipline,24,6,18
Dunbaltaris,blackrock,576,priest,discipline,24,6,18
Holytang,grim-batol,575,priest,discipline,6,6,0
Sørney,aegwynn,575,priest,discipline,9,7,2
Tira,darksorrow,575,priest,discipline,12,6,6
Чикхоп,blackscar,575,priest,discipline,12,6,6
Bandäid,ravencrest,575,priest,discipline,12,6,6
Handmännchen,kelthuzad,575,priest,discipline,12,6,6
Mithralas,doomhammer,575,priest,discipline,12,6,6
Insicompany,antonidas,575,priest,discipline,12,6,6
Kanketopries,korgall,575,priest,discipline,12,6,6
Grazz,grim-batol,575,priest,discipline,12,6,6
Doxs,terokkar,575,priest,discipline,12,6,6
Highlightss,outland,575,priest,discipline,12,6,6
Lichtl,ysera,575,priest,discipline,12,6,6
Gæxelademad,draenor,575,priest,discipline,12,6,6
Vastüdö,ragnaros,575,priest,discipline,12,6,6
Noyxz,frostmourne,575,priest,discipline,12,6,6
Hùrtyoux,outland,575,priest,discipline,12,6,6
Phexon,outland,575,priest,discipline,12,6,6
Montane,wrathbringer,575,priest,discipline,12,6,6
Лерасапорт,gordunni,575,priest,discipline,12,6,6
Ysharg,sinstralis,575,priest,discipline,12,6,6
Ðotgød,nemesis,575,priest,discipline,12,6,6
Hâmmel,blackrock,575,priest,discipline,12,6,6
Oversole,kazzak,575,priest,discipline,12,6,6
Flackiepi,tarren-mill,575,priest,discipline,12,6,6
Zembowae,drakthul,575,priest,discipline,12,6,6
Costhina,alakir,575,priest,discipline,12,6,6
Naid,exodar,575,priest,discipline,12,6,6
Grêndine,blackmoore,575,priest,discipline,12,6,6
Hanagaki,ragnaros,575,priest,discipline,12,6,6
Brronxx,frostwolf,575,priest,discipline,12,6,6
Priestvnr,hyjal,575,priest,discipline,12,6,6
Bigbootyheal,silvermoon,575,priest,discipline,12,6,6
Ponpon,onyxia,575,priest,discipline,12,6,6
Noxxill,eredar,575,priest,discipline,12,6,6
Hypnòz,archimonde,575,priest,discipline,12,6,6
Undeadv,twisting-nether,575,priest,discipline,15,6,9
Каэден,blackscar,575,priest,discipline,18,6,12
Thehealer,twisting-nether,575,priest,discipline,18,6,12
Sulla,draenor,575,priest,discipline,18,6,12
Estarôn,antonidas,575,priest,discipline,18,6,12
Skytheory,eredar,575,priest,discipline,18,6,12
Noncuro,tarren-mill,575,priest,discipline,18,6,12
Priestbiyy,sunstrider,575,priest,discipline,18,6,12
Castêr,silvermoon,575,priest,discipline,18,6,12
Kafrooss,silvermoon,575,priest,discipline,18,6,12
Хегендцп,galakrond,575,priest,discipline,18,6,12
Savíour,kazzak,575,priest,discipline,24,6,18
Вэстервилли,howling-fjord,575,priest,discipline,24,6,18
Drgrey,archimonde,575,priest,discipline,25,6,19
Бобадамс,gordunni,574,priest,discipline,12,6,6
Tindoriel,bronzebeard,574,priest,discipline,12,6,6
Leonard,nemesis,574,priest,discipline,12,6,6
Konstantyne,hyjal,574,priest,discipline,12,6,6
Nienni,mannoroth,574,priest,discipline,12,6,6
Preacia,twisting-nether,574,priest,discipline,12,6,6
Dontouch,nemesis,574,priest,discipline,12,6,6
Avinci,blackrock,574,priest,discipline,12,6,6
Vebuya,blackmoore,574,priest,discipline,12,6,6
Fréyja,sanguino,574,priest,discipline,18,6,12
Æisa,blackmoore,574,priest,discipline,18,6,12
Pæx,antonidas,574,priest,discipline,18,6,12
Muftl,thrall,574,priest,discipline,18,6,12
Zoratha,kazzak,574,priest,discipline,18,6,12
Prigart,sylvanas,574,priest,discipline,18,6,12
Easxyx,veklor,573,priest,discipline,6,6,0
Këller,hyjal,573,priest,discipline,12,6,6
Yeeni,doomhammer,573,priest,discipline,12,6,6
Tycrael,hyjal,573,priest,discipline,12,6,6
Lolenjoyer,ravencrest,573,priest,discipline,18,6,12
Priestmrt,doomhammer,573,priest,discipline,18,6,12
Esthea,malganis,573,priest,discipline,18,6,12
Hólyeárth,twisting-nether,573,priest,discipline,18,6,12
Ilynïa,quelthalas,573,priest,discipline,19,6,13
Wanah,ravencrest,573,priest,discipline,24,6,18
Kelthurus,die-nachtwache,572,priest,discipline,12,6,6
Saraph,argent-dawn,572,priest,discipline,12,6,6
Loriny,ragnaros,572,priest,discipline,14,6,8
Dathot,the-maelstrom,572,priest,discipline,18,6,12
Glutenhode,stormscale,571,priest,discipline,12,6,6
Крайне,soulflayer,571,priest,discipline,18,6,12
Destally,kirin-tor,570,priest,discipline,12,6,6
Thechieftain,twilights-hammer,570,priest,discipline,12,6,6
Rawkilla,stormrage,570,priest,discipline,12,6,6
Lyss,zirkel-des-cenarius,570,priest,discipline,18,6,12
Mijola,thrall,565,priest,discipline,12,6,6
Ahbe,stormscale,559,priest,discipline,11,6,5
Superbianka,stormscale,544,priest,discipline,10,7,3
Drlight,stormscale,543,priest,discipline,11,6,5
Cavadaya,eredar,543,priest,discipline,14,7,7
Jumpaxx,archimonde,543,priest,discipline,17,6,11
Jasty,nemesis,543,priest,discipline,23,6,17
Clescy,ravencrest,542,priest,discipline,11,6,5
Lemowae,doomhammer,542,priest,discipline,22,6,16
Imdeadxd,twisting-nether,528,priest,discipline,9,7,2
Nàvy,archimonde,528,priest,discipline,15,6,9
Nécromant,frostwolf,527,priest,discipline,9,7,2
Adare,sanguino,527,priest,discipline,11,6,5
Icecoldleap,grim-batol,527,priest,discipline,11,6,5
Splintplays,zuljin,527,priest,discipline,11,6,5
Craquylx,hyjal,527,priest,discipline,17,6,11
Lankydoc,blackmoore,522,priest,discipline,16,7,9
Demmi,dun-modr,522,priest,discipline,22,7,15
Полуниця,galakrond,522,priest,discipline,23,7,16
Xotz,thrall,521,priest,discipline,15,8,7
Teologen,outland,520,priest,discipline,19,7,12
Isson,earthen-ring,519,priest,discipline,19,7,12
Malorian,khadgar,512,priest,discipline,20,8,12
Cummask,silvermoon,512,priest,discipline,16,6,10
Spirina,terokkar,511,priest,discipline,14,6,8
Shadiè,sylvanas,511,priest,discipline,14,6,8
Figpucker,silvermoon,496,priest,discipline,13,6,7
Tarboba,tarren-mill,496,priest,discipline,13,6,7
Stàrlîght,chants-éternels,495,priest,discipline,11,6,5
Rulz,zuluhed,486,priest,discipline,22,7,15
Schustraja,blackrock,480,priest,discipline,6,5,1
Bendforpi,outland,480,priest,discipline,6,5,1
Vampiro,blackhand,480,priest,discipline,6,5,1
Instantcasts,ravencrest,480,priest,discipline,6,5,1
Bec,ragnaros,480,priest,discipline,6,5,1
Trippinorbs,stormscale,480,priest,discipline,6,5,1
Петрушка,gordunni,480,priest,discipline,6,5,1
Ounxx,blackrock,480,priest,discipline,6,5,1
Пристмиша,gordunni,480,priest,discipline,6,5,1
Loldisc,arthas,480,priest,discipline,6,5,1
Slowinmotion,twisting-nether,480,priest,discipline,6,5,1
Swep,ragnaros,480,priest,discipline,6,5,1
Usermane,ravencrest,480,priest,discipline,6,5,1
Nayballistic,tarren-mill,480,priest,discipline,6,5,1
Lightform,twisting-nether,480,priest,discipline,6,5,1
Chane,blackmoore,480,priest,discipline,6,5,1
Hannïri,archimonde,480,priest,discipline,6,5,1
Warm,auchindoun,480,priest,discipline,6,5,1
Qkidow,kult-der-verdammten,480,priest,discipline,6,5,1
Sorchad,hyjal,480,priest,discipline,6,5,1
Nttyfromohio,ravencrest,480,priest,discipline,6,5,1
Lamp,terokkar,480,priest,discipline,6,5,1
Våfflán,silvermoon,480,priest,discipline,6,5,1
Kemari,aegwynn,480,priest,discipline,6,5,1
Нэриэлл,gordunni,480,priest,discipline,6,5,1
Gydramist,ragnaros,480,priest,discipline,6,5,1
Kinkshamer,emeriss,480,priest,discipline,6,5,1
Naivegnome,draenor,480,priest,discipline,6,5,1
Gidy,blackmoore,480,priest,discipline,6,5,1
Confusedleaf,ragnaros,480,priest,discipline,6,5,1
Coloringßook,zuljin,480,priest,discipline,6,5,1
Гачидварфич,gordunni,480,priest,discipline,6,5,1
Ronnmoss,defias-brotherhood,480,priest,discipline,6,5,1
Åzjol,magtheridon,480,priest,discipline,6,5,1
Proteinsnack,auchindoun,480,priest,discipline,6,5,1
Daniriuz,minahonda,480,priest,discipline,6,5,1
Turboshadow,stormscale,480,priest,discipline,12,5,7
Chaapsbbq,archimonde,480,priest,discipline,12,5,7
Dogfacex,ravencrest,480,priest,discipline,12,5,7
Selí,die-aldor,480,priest,discipline,12,5,7
Amayko,kazzak,480,priest,discipline,12,5,7
Artemïsïa,ravencrest,480,priest,discipline,12,5,7
Mindblown,arthas,480,priest,discipline,12,5,7
Djleapgødx,twisting-nether,480,priest,discipline,12,5,7
Djplay,aegwynn,480,priest,discipline,12,5,7
Discokuken,outland,480,priest,discipline,12,5,7
Pdead,kazzak,480,priest,discipline,12,5,7
Wontdispel,ravencrest,480,priest,discipline,12,5,7
Immutable,twisting-nether,480,priest,discipline,12,5,7
Mariahscarey,blackhand,480,priest,discipline,12,5,7
Faloty,draenor,480,priest,discipline,12,5,7
Hôtseitdank,blackrock,480,priest,discipline,12,5,7
Seskipr,stormreaver,480,priest,discipline,12,5,7
Besmrtna,saurfang,480,priest,discipline,12,5,7
Romeqt,tarren-mill,480,priest,discipline,12,5,7
Alejandrothe,outland,480,priest,discipline,12,5,7
Playax,silvermoon,480,priest,discipline,12,5,7
Funzies,doomhammer,480,priest,discipline,12,5,7
Adrigodx,malganis,480,priest,discipline,12,5,7
Bonsoin,kirin-tor,480,priest,discipline,12,5,7
Skyland,emeriss,480,priest,discipline,12,5,7
Nizrå,archimonde,480,priest,discipline,12,5,7
Jumbypri,outland,480,priest,discipline,12,5,7
Wckd,tarren-mill,480,priest,discipline,12,5,7
Grozozo,tarren-mill,480,priest,discipline,12,5,7
Yö,stormscale,480,priest,discipline,12,5,7
Xeay,blackrock,480,priest,discipline,12,5,7
Лиэся,gordunni,480,priest,discipline,12,5,7
Buchânân,archimonde,480,priest,discipline,12,5,7
Hollylicious,kazzak,480,priest,discipline,12,5,7
Späxxi,amanthul,480,priest,discipline,12,5,7
Schnikki,mannoroth,480,priest,discipline,12,5,7
Caramello,stormscale,480,priest,discipline,12,5,7
Вайтбласт,howling-fjord,480,priest,discipline,12,5,7
Kde,burning-legion,480,priest,discipline,12,5,7
Libertero,drakthul,480,priest,discipline,12,5,7
Windieqt,drakthul,480,priest,discipline,12,5,7
Saphèa,burning-legion,480,priest,discipline,12,5,7
Sak,uldaman,480,priest,discipline,12,5,7
Smehp,outland,480,priest,discipline,12,5,7
Jeboc,ravencrest,480,priest,discipline,12,5,7
Mcx,stormscale,480,priest,discipline,12,5,7
Nayballsp,tarren-mill,480,priest,discipline,12,5,7
Холигард,grom,480,priest,discipline,12,5,7
Ghettothug,darksorrow,480,priest,discipline,12,5,7
Karpi,twisting-nether,480,priest,discipline,12,5,7
Theplague,kazzak,480,priest,discipline,12,5,7
Ðæthshaðow,dalaran,480,priest,discipline,12,5,7
Nibhou,dalaran,480,priest,discipline,12,5,7
Kolsy,twisting-nether,480,priest,discipline,12,5,7
Dsyleixa,archimonde,480,priest,discipline,12,5,7
Rutjake,stormscale,480,priest,discipline,12,5,7
Qtdorr,ravencrest,480,priest,discipline,12,5,7
Discgødx,thrall,480,priest,discipline,12,5,7
Donbas,tarren-mill,480,priest,discipline,12,5,7
Shyvi,ravencrest,480,priest,discipline,12,5,7
Phaedisc,defias-brotherhood,480,priest,discipline,12,5,7
Lunatrix,sanguino,480,priest,discipline,12,5,7
Kryckmongo,tarren-mill,480,priest,discipline,12,5,7
Уер,galakrond,480,priest,discipline,12,5,7
Rektom,archimonde,480,priest,discipline,12,5,7
Altarboi,veknilash,480,priest,discipline,12,5,7
Yukîna,blackrock,480,priest,discipline,12,5,7
Чотки,deepholm,480,priest,discipline,12,5,7
Prencø,sanguino,480,priest,discipline,12,5,7
Забейка,howling-fjord,480,priest,discipline,12,5,7
Supfamskrrt,stormscale,480,priest,discipline,12,5,7
Marypops,outland,480,priest,discipline,12,5,7
Абсорбиболь,howling-fjord,480,priest,discipline,12,5,7
Magthalor,twisting-nether,480,priest,discipline,12,5,7
Shadew,stormscale,480,priest,discipline,12,5,7
Darkfreak,malygos,480,priest,discipline,12,5,7
Chir,burning-legion,480,priest,discipline,12,5,7
Sagart,ravencrest,480,priest,discipline,12,5,7
Pwsx,draenor,480,priest,discipline,12,5,7
Ptipotam,archimonde,480,priest,discipline,12,5,7
Лизота,gordunni,480,priest,discipline,12,5,7
Tessaben,silvermoon,480,priest,discipline,12,5,7
Navihato,silvermoon,480,priest,discipline,12,5,7
Borgamor,frostmane,480,priest,discipline,12,5,7
Ajaxfreak,blackmoore,480,priest,discipline,12,5,7
Mayday,silvermoon,480,priest,discipline,12,5,7
Døtzillah,kazzak,480,priest,discipline,12,5,7
Ponting,kazzak,480,priest,discipline,12,5,7
Healysith,archimonde,480,priest,discipline,12,5,7
Jupilen,chogall,480,priest,discipline,12,5,7
Thonidas,das-syndikat,480,priest,discipline,12,5,7
Tîwele,dalvengyr,480,priest,discipline,12,5,7
Æðwyñ,ragnaros,480,priest,discipline,12,5,7
Cirøpriest,ravencrest,480,priest,discipline,12,5,7
Katsikatsika,silvermoon,480,priest,discipline,12,5,7
Вегельдэрс,gordunni,480,priest,discipline,12,5,7
Meheal,lothar,480,priest,discipline,12,5,7
Easyzx,tarren-mill,480,priest,discipline,12,5,7
Hyonra,kazzak,480,priest,discipline,12,5,7
Gooflord,ravencrest,480,priest,discipline,12,5,7
Muradawg,nemesis,480,priest,discipline,12,5,7
Terstyana,hyjal,480,priest,discipline,12,5,7
Graveyards,tarren-mill,480,priest,discipline,12,5,7
Litera,silvermoon,480,priest,discipline,12,5,7
Bimbax,dun-modr,480,priest,discipline,12,5,7
Schockerjr,blackmoore,480,priest,discipline,12,5,7
Åmåndå,ravencrest,480,priest,discipline,12,5,7
Soed,defias-brotherhood,480,priest,discipline,12,5,7
Teladorne,ravencrest,480,priest,discipline,12,5,7
Akhaida,argent-dawn,480,priest,discipline,12,5,7
Sbj,bronze-dragonflight,480,priest,discipline,12,5,7
Fardatxo,colinas-pardas,480,priest,discipline,12,5,7
Missbarbados,blackmoore,480,priest,discipline,12,5,7
Moeshy,kazzak,480,priest,discipline,12,5,7
Upo,kazzak,480,priest,discipline,12,5,7
Bibleenjoyer,blackmoore,480,priest,discipline,12,5,7
Chebaben,argent-dawn,480,priest,discipline,12,5,7
Allaría,bronze-dragonflight,480,priest,discipline,12,5,7
Twitty,argent-dawn,480,priest,discipline,12,5,7
Ameja,sylvanas,480,priest,discipline,13,5,8
Kimlie,baelgun,480,priest,discipline,16,6,10
Карбонит,fordragon,480,priest,discipline,18,5,13
Étesech,zuljin,480,priest,discipline,18,5,13
Kehz,ysondre,480,priest,discipline,18,5,13
Góli,argent-dawn,480,priest,discipline,18,5,13
Kalór,kult-der-verdammten,480,priest,discipline,18,5,13
Momopriesto,draenor,480,priest,discipline,18,5,13
Zeslash,suramar,480,priest,discipline,18,5,13
Calonex,kazzak,480,priest,discipline,18,5,13
Ча,thermaplugg,480,priest,discipline,18,5,13
Taimani,burning-legion,480,priest,discipline,18,5,13
Iskáral,frostmourne,480,priest,discipline,18,5,13
Saishi,rashgarroth,480,priest,discipline,18,5,13
Omnimento,blackrock,480,priest,discipline,18,5,13
Hodscha,aegwynn,480,priest,discipline,18,5,13
Notapriestx,ravencrest,480,priest,discipline,18,5,13
Seniya,argent-dawn,480,priest,discipline,18,5,13
Элдерле,gordunni,480,priest,discipline,24,5,19
Sarinà,archimonde,480,priest,discipline,24,5,19
Blackwidow,chromaggus,480,priest,discipline,24,5,19
Fictus,tarren-mill,480,priest,discipline,24,5,19
Elpitiimigré,sinstralis,479,priest,discipline,6,5,1
Colte,dalaran,479,priest,discipline,6,5,1
Elakith,bronze-dragonflight,479,priest,discipline,12,5,7
Sarafîsthole,ysondre,479,priest,discipline,12,5,7
Schatty,blackmoore,479,priest,discipline,12,5,7
Flappí,argent-dawn,479,priest,discipline,12,5,7
Haiga,zuljin,479,priest,discipline,12,5,7
Дигмана,soulflayer,479,priest,discipline,12,5,7
Ръасмурт,soulflayer,479,priest,discipline,12,5,7
Cobrix,nemesis,479,priest,discipline,12,5,7
Ethylene,ysondre,479,priest,discipline,12,5,7
Zonar,eitrigg,479,priest,discipline,12,5,7
Jessicar,the-maelstrom,479,priest,discipline,12,5,7
Eluñeblessed,silvermoon,479,priest,discipline,12,5,7
Piotrek,hyjal,479,priest,discipline,12,5,7
Serach,ravencrest,479,priest,discipline,12,5,7
Pontiff,the-maelstrom,479,priest,discipline,12,5,7
Helming,magtheridon,479,priest,discipline,12,5,7
Sastry,drakthul,479,priest,discipline,12,5,7
Kaladriel,die-aldor,479,priest,discipline,12,5,7
Sanoe,twisting-nether,479,priest,discipline,12,5,7
Хилюня,howling-fjord,479,priest,discipline,12,5,7
Haigoku,archimonde,479,priest,discipline,12,5,7
Tetukiss,zuljin,479,priest,discipline,12,5,7
Bòóny,ravencrest,479,priest,discipline,12,5,7
Lightbulp,draenor,479,priest,discipline,12,5,7
Грамыч,howling-fjord,479,priest,discipline,12,5,7
Aethiel,drakthul,479,priest,discipline,12,5,7
Tota,frostmane,479,priest,discipline,12,5,7
Miséricordïe,dalaran,479,priest,discipline,12,5,7
Шпалкоклоб,soulflayer,479,priest,discipline,12,5,7
Shyvannas,antonidas,479,priest,discipline,12,5,7
Velenthan,stormrage,479,priest,discipline,12,5,7
Pohyoloo,turalyon,479,priest,discipline,12,5,7
Upsbro,outland,479,priest,discipline,12,5,7
Tedcrilly,dentarg,479,priest,discipline,12,5,7
Konantenshi,doomhammer,479,priest,discipline,12,5,7
Elunerei,tarren-mill,479,priest,discipline,12,5,7
Thecraft,antonidas,479,priest,discipline,12,5,7
Pluf,nefarian,479,priest,discipline,12,5,7
Sewerperson,doomhammer,479,priest,discipline,12,5,7
Warkez,terokkar,479,priest,discipline,14,5,9
Nemista,hyjal,479,priest,discipline,18,5,13
Gaehla,silvermoon,479,priest,discipline,18,5,13
Seehz,ysondre,479,priest,discipline,18,5,13
Scarlovni,archimonde,479,priest,discipline,18,5,13
Alsyidan,khaz-modan,479,priest,discipline,18,5,13
Sleeyz,blackmoore,479,priest,discipline,24,5,19
Avesatana,khadgar,478,priest,discipline,6,5,1
Veryssra,archimonde,478,priest,discipline,12,5,7
Raitharin,argent-dawn,478,priest,discipline,12,5,7
Небеснаяроса,grom,478,priest,discipline,12,5,7
Tarik,nemesis,478,priest,discipline,12,5,7
Hotwheal,ysondre,478,priest,discipline,12,5,7
Morcana,gorgonnash,478,priest,discipline,12,5,7
Sadystica,kazzak,478,priest,discipline,12,5,7
Rastuvius,twisting-nether,478,priest,discipline,18,5,13
Bénjamín,outland,478,priest,discipline,18,5,13
Arathiell,nordrassil,477,priest,discipline,12,5,7
Oknelim,blackmoore,477,priest,discipline,12,5,7
Phosphorus,blackhand,476,priest,discipline,12,5,7
Marlite,stormscale,476,priest,discipline,12,5,7
Feloriya,antonidas,476,priest,discipline,12,5,7
Rettsche,eredar,475,priest,discipline,12,5,7
Wipipi,draenor,474,priest,discipline,12,5,7
Crenî,blackrock,463,priest,discipline,17,5,12
Madclownz,blackrock,448,priest,discipline,10,5,5
Woukitos,drekthar,448,priest,discipline,16,5,11
Hitaro,antonidas,447,priest,discipline,11,5,6
Zakkypriest,tarren-mill,447,priest,discipline,11,5,6
Dhed,turalyon,447,priest,discipline,14,6,8
Zumítø,zuljin,446,priest,discipline,11,5,6
Sandgambler,draenor,432,priest,discipline,9,5,4
Incorporeal,eredar,431,priest,discipline,11,5,6
Numatrash,stormscale,426,priest,discipline,16,8,8
Äliénør,khaz-modan,426,priest,discipline,17,7,10
Hoca,ravencrest,426,priest,discipline,17,7,10
Theboulshìts,ravencrest,426,priest,discipline,15,6,9
Kasáya,thrall,426,priest,discipline,18,6,12
Kak,gorgonnash,426,priest,discipline,19,6,13
Holybøi,ragnaros,426,priest,discipline,29,7,22
Capheny,ravencrest,425,priest,discipline,29,7,22
Snowlhad,argent-dawn,423,priest,discipline,21,6,15
Prisht,ravencrest,416,priest,discipline,10,5,5
Randomxdisc,draenor,415,priest,discipline,14,5,9
Kuïß,tarren-mill,394,priest,discipline,20,6,14
Amélianna,dalaran,384,priest,discipline,6,4,2
Leonardz,nemesis,384,priest,discipline,6,4,2
Kookpri,twisting-nether,384,priest,discipline,6,4,2
Darkoulito,dalaran,384,priest,discipline,6,4,2
Zumbae,tarren-mill,384,priest,discipline,6,4,2
Umbralx,ragnaros,384,priest,discipline,6,4,2
Jaisuu,ravencrest,384,priest,discipline,6,4,2
Toasttwo,kazzak,384,priest,discipline,6,4,2
Pankp,kazzak,384,priest,discipline,6,4,2
Heindl,ravencrest,384,priest,discipline,6,4,2
Flaiya,kazzak,384,priest,discipline,6,4,2
Sîlfa,hyjal,384,priest,discipline,6,4,2
Papêrcut,kazzak,384,priest,discipline,6,4,2
Patoon,ravencrest,384,priest,discipline,6,4,2
Verrou,hyjal,384,priest,discipline,6,4,2
Bòóni,ravencrest,384,priest,discipline,6,4,2
Above,hyjal,384,priest,discipline,6,4,2
Thean,twilights-hammer,384,priest,discipline,6,4,2
Vixös,silvermoon,384,priest,discipline,6,4,2
Rýzera,tarren-mill,384,priest,discipline,6,4,2
Kitågåwå,ravencrest,384,priest,discipline,6,4,2
Atomíc,eredar,384,priest,discipline,6,4,2
Frekko,outland,384,priest,discipline,6,4,2
Binno,outland,384,priest,discipline,6,4,2
Lergdaddy,zenedar,384,priest,discipline,6,4,2
Zenholy,kazzak,384,priest,discipline,6,4,2
Орбит,blackscar,384,priest,discipline,6,4,2
Iirina,draenor,384,priest,discipline,6,4,2
Topdamage,stormscale,384,priest,discipline,6,4,2
Xsp,dun-modr,384,priest,discipline,6,4,2
Badballs,doomhammer,384,priest,discipline,6,4,2
Elankä,terokkar,384,priest,discipline,6,4,2
Giffelgrethe,sylvanas,384,priest,discipline,6,4,2
Priestutute,tarren-mill,384,priest,discipline,6,4,2
Feedtherich,stormscale,384,priest,discipline,6,4,2
Inthemoöd,twisting-nether,384,priest,discipline,6,4,2
Mit,tarren-mill,384,priest,discipline,6,4,2
Experimentix,silvermoon,384,priest,discipline,6,4,2
Félrebarmok,ragnaros,384,priest,discipline,6,4,2
Hiela,outland,384,priest,discipline,6,4,2
Ðapperðan,draenor,384,priest,discipline,6,4,2
Neddeadlius,outland,384,priest,discipline,6,4,2
Mvce,outland,384,priest,discipline,6,4,2
Bootypillow,stormscale,384,priest,discipline,6,4,2
Piixld,aegwynn,384,priest,discipline,6,4,2
Pisso,outland,384,priest,discipline,6,4,2
Goblingøs,ravencrest,384,priest,discipline,6,4,2
Erfofthesop,chants-éternels,384,priest,discipline,6,4,2
Sede,silvermoon,384,priest,discipline,6,4,2
Yukirito,drakthul,384,priest,discipline,6,4,2
Seeyae,ravencrest,384,priest,discipline,6,4,2
Cerdapriesst,dun-modr,384,priest,discipline,6,4,2
Nesar,stormscale,384,priest,discipline,6,4,2
Acarru,stormscale,384,priest,discipline,6,4,2
Flaynbones,tarren-mill,384,priest,discipline,6,4,2
Büssi,blackrock,384,priest,discipline,6,4,2
Hadk,blackrock,384,priest,discipline,6,4,2
Larialool,malorne,384,priest,discipline,6,4,2
Sïgmund,draenor,384,priest,discipline,6,4,2
Xqzmydotz,outland,384,priest,discipline,6,4,2
Gravedoll,draenor,384,priest,discipline,6,4,2
ßlinkywinky,outland,384,priest,discipline,6,4,2
Deadlyhealer,draenor,384,priest,discipline,6,4,2
Sàyaa,draenor,384,priest,discipline,6,4,2
Dimentions,sylvanas,384,priest,discipline,6,4,2
Tipps,ravencrest,384,priest,discipline,6,4,2
Challa,magtheridon,384,priest,discipline,6,4,2
Hunnty,magtheridon,384,priest,discipline,6,4,2
Sixtyseven,blackhand,384,priest,discipline,6,4,2
Healywealy,stormrage,384,priest,discipline,6,4,2
Taypsi,kelthuzad,384,priest,discipline,6,4,2
Magicstarss,the-maelstrom,384,priest,discipline,6,4,2
Dshara,the-maelstrom,384,priest,discipline,6,4,2
Tntbigheal,silvermoon,384,priest,discipline,6,4,2
Terakes,kiljaeden,384,priest,discipline,6,4,2
Bosco,kult-der-verdammten,384,priest,discipline,6,4,2
Arduhil,burning-legion,384,priest,discipline,6,4,2
Halps,silvermoon,384,priest,discipline,6,4,2
Fxd,talnivarr,384,priest,discipline,6,4,2
Brobert,nerathor,384,priest,discipline,6,4,2
Floofz,auchindoun,384,priest,discipline,6,4,2
Noxx,kilrogg,384,priest,discipline,6,4,2
Shadowuknow,silvermoon,384,priest,discipline,9,4,5
Kloxy,archimonde,384,priest,discipline,15,5,10
Drdré,blackrock,384,priest,discipline,12,4,8
Uwupriestowo,kazzak,384,priest,discipline,12,4,8
Mérce,kazzak,384,priest,discipline,12,4,8
Corthas,sporeggar,384,priest,discipline,12,4,8
Babambaba,sylvanas,384,priest,discipline,12,4,8
Osteograhm,eldrethalas,384,priest,discipline,12,4,8
Mylox,blackrock,384,priest,discipline,12,4,8
Pwnance,twisting-nether,384,priest,discipline,12,4,8
Druzhok,sylvanas,384,priest,discipline,12,4,8
Asdfsds,kazzak,384,priest,discipline,12,4,8
Mariio,blackmoore,384,priest,discipline,12,4,8
Refuze,blackrock,384,priest,discipline,12,4,8
Zackher,dun-modr,384,priest,discipline,12,4,8
Harrymotter,blackrock,384,priest,discipline,12,4,8
Drzork,sylvanas,384,priest,discipline,12,4,8
Sls,sylvanas,384,priest,discipline,12,4,8
Raybangx,blackrock,384,priest,discipline,12,4,8
Goatrocker,kazzak,384,priest,discipline,12,4,8
Hyggêê,sanguino,384,priest,discipline,12,4,8
Stajp,blackrock,384,priest,discipline,12,4,8
Сайлентхилл,howling-fjord,384,priest,discipline,12,4,8
Dominos,thrall,384,priest,discipline,12,4,8
Trolar,zuljin,384,priest,discipline,12,4,8
Sedaris,blackrock,384,priest,discipline,12,4,8
Streptococus,sanguino,384,priest,discipline,12,4,8
Ревентонх,howling-fjord,384,priest,discipline,12,4,8
Заак,howling-fjord,384,priest,discipline,12,4,8
Vanisse,uldum,384,priest,discipline,12,4,8
Blumm,khaz-modan,384,priest,discipline,12,4,8
Renewa,kazzak,384,priest,discipline,12,4,8
Rîîper,khaz-modan,384,priest,discipline,12,4,8
Freepriest,darksorrow,384,priest,discipline,12,4,8
Braingames,kazzak,384,priest,discipline,12,4,8
Пристошке,gordunni,384,priest,discipline,12,4,8
Magras,xavius,384,priest,discipline,12,4,8
Kerzhul,blackhand,384,priest,discipline,12,4,8
Gstah,taerar,384,priest,discipline,12,4,8
Støney,xavius,384,priest,discipline,12,4,8
Santainphy,cthun,384,priest,discipline,12,4,8
Absolution,stormscale,384,priest,discipline,12,4,8
Oneheal,rexxar,384,priest,discipline,12,4,8
Велост,gordunni,384,priest,discipline,12,4,8
Фадб,howling-fjord,384,priest,discipline,12,4,8
Facemelterx,azjolnerub,384,priest,discipline,12,4,8
Dangerfred,stormscale,384,priest,discipline,12,4,8
Soleyy,outland,384,priest,discipline,12,4,8
Whatspray,drakthul,384,priest,discipline,12,4,8
Shadowful,drakthul,384,priest,discipline,12,4,8
Благовер,howling-fjord,384,priest,discipline,12,4,8
Holyorshadow,drakthul,384,priest,discipline,12,4,8
Vicetøne,stormscale,384,priest,discipline,12,4,8
Çelph,silvermoon,384,priest,discipline,12,4,8
Eba,daggerspine,384,priest,discipline,12,4,8
Jordbærtærte,outland,384,priest,discipline,12,4,8
Stòkkè,stormscale,384,priest,discipline,12,4,8
Seskip,stormreaver,384,priest,discipline,12,4,8
Арейша,gordunni,384,priest,discipline,12,4,8
Toasttrii,outland,384,priest,discipline,12,4,8
Xýz,tarren-mill,384,priest,discipline,12,4,8
Saemyra,tarren-mill,384,priest,discipline,12,4,8
Numa,stormscale,384,priest,discipline,12,4,8
Amèn,archimonde,384,priest,discipline,12,4,8
Mukkin,tarren-mill,384,priest,discipline,12,4,8
Linaklein,hyjal,384,priest,discipline,12,4,8
Nordrenalin,tarren-mill,384,priest,discipline,12,4,8
Misttpriest,hyjal,384,priest,discipline,12,4,8
Kourguette,hyjal,384,priest,discipline,12,4,8
Алурелис,blackscar,384,priest,discipline,12,4,8
Dìscìplìned,ravencrest,384,priest,discipline,12,4,8
Xayona,argent-dawn,384,priest,discipline,12,4,8
Хенели,blackscar,384,priest,discipline,12,4,8
Nariny,argent-dawn,384,priest,discipline,12,4,8
Flet,emerald-dream,384,priest,discipline,12,4,8
Hanrej,ravencrest,384,priest,discipline,12,4,8
Robgee,ravencrest,384,priest,discipline,12,4,8
Ankî,aegwynn,384,priest,discipline,12,4,8
Нахилета,soulflayer,384,priest,discipline,12,4,8
Derl,pozzo-delleternità,384,priest,discipline,12,4,8
Sarenko,turalyon,384,priest,discipline,12,4,8
Дэкспрут,soulflayer,384,priest,discipline,12,4,8
Azriael,draenor,384,priest,discipline,12,4,8
Rafaled,ravencrest,384,priest,discipline,12,4,8
Maquivel,aggra-português,384,priest,discipline,12,4,8
Teresalisbon,eredar,384,priest,discipline,12,4,8
Иннрей,soulflayer,384,priest,discipline,12,4,8
Sumecxo,aegwynn,384,priest,discipline,12,4,8
Lalock,grim-batol,384,priest,discipline,12,4,8
Deathtrapx,draenor,384,priest,discipline,12,4,8
Alyzée,aegwynn,384,priest,discipline,12,4,8
Sabakk,archimonde,384,priest,discipline,12,4,8
Bownsamdi,tarren-mill,384,priest,discipline,15,4,11
Celestias,sanguino,384,priest,discipline,15,4,11
Shyvàree,les-clairvoyants,384,priest,discipline,18,4,14
Sbubbi,ravencrest,384,priest,discipline,18,4,14
Ajcz,draenor,384,priest,discipline,18,4,14
Pbwser,silvermoon,384,priest,discipline,18,4,14
Ulquiørra,blackmoore,384,priest,discipline,18,4,14
Лилинтель,gordunni,384,priest,discipline,24,4,20
Tsuser,blackrock,384,priest,discipline,24,4,20
Hanic,kazzak,2326,priest,shadow,92,57,35
Permafeetup,aegwynn,2324,priest,shadow,102,59,43
Syedi,drakthul,2304,priest,shadow,315,160,155
Shåmssv,kazzak,2299,priest,shadow,90,52,38
Медовыедотки,soulflayer,2297,priest,shadow,143,78,65
Хедмэнмвп,gordunni,2287,priest,shadow,228,117,111
Darthlie,draenor,2275,priest,shadow,166,88,78
Yggdra,ragnaros,2229,priest,shadow,66,44,22
Standtall,blackrock,2226,priest,shadow,138,76,62
Dbeezy,tarren-mill,2217,priest,shadow,100,53,47
Польскийбуль,gordunni,2215,priest,shadow,96,53,43
Cheesecake,defias-brotherhood,2202,priest,shadow,102,58,44
Notsoholy,blackmoore,2186,priest,shadow,120,67,53
Deathlý,blackrock,2169,priest,shadow,114,62,52
Tentoumushi,ravencrest,2153,priest,shadow,72,42,30
Dollyboo,tarren-mill,2152,priest,shadow,125,77,48
Ilovemycat,silvermoon,2152,priest,shadow,78,47,31
Yuzuflex,hyjal,2151,priest,shadow,87,46,41
Rrj,ravencrest,2147,priest,shadow,106,64,42
Безрассудица,howling-fjord,2147,priest,shadow,91,49,42
Walterwhite,stormscale,2145,priest,shadow,96,51,45
Devoura,sylvanas,2138,priest,shadow,78,46,32
Randyrhoads,kazzak,2138,priest,shadow,71,41,30
Slimcharles,ravencrest,2137,priest,shadow,185,107,78
Crainoo,ravencrest,2137,priest,shadow,158,80,78
Blacktrain,burning-blade,2136,priest,shadow,118,60,58
Сделайсам,gordunni,2133,priest,shadow,105,59,46
Talbatex,blackmoore,2130,priest,shadow,102,51,51
Mérce,kazzak,2123,priest,shadow,78,43,35
Stjärtsten,tarren-mill,2118,priest,shadow,231,132,99
Xsß,dun-modr,2116,priest,shadow,107,59,48
Èxtêrmìnätör,kazzak,2114,priest,shadow,84,47,37
Bréézee,ravencrest,2114,priest,shadow,107,58,49
Шадоупуз,soulflayer,2114,priest,shadow,95,50,45
Voidfi,kult-der-verdammten,2111,priest,shadow,114,64,50
Infernión,tarren-mill,2110,priest,shadow,78,42,36
Rzkp,eredar,2110,priest,shadow,93,50,43
Даняпимпгадх,soulflayer,2109,priest,shadow,72,45,27
Pepeshadow,twisting-nether,2106,priest,shadow,169,89,80
Thanatae,kazzak,2105,priest,shadow,85,50,35
Dippy,blackrock,2101,priest,shadow,64,39,25
Sphero,earthen-ring,2101,priest,shadow,130,73,57
Ekkfwiedrice,ragnaros,2084,priest,shadow,96,54,42
Bidraget,ravencrest,2083,priest,shadow,94,57,37
Nousey,twisting-nether,2077,priest,shadow,148,81,67
Purpl,tarren-mill,2076,priest,shadow,138,75,63
Liptonolda,blackhand,2067,priest,shadow,202,107,95
Swdjkbad,kazzak,2063,priest,shadow,72,42,30
Sinthaa,mannoroth,2053,priest,shadow,72,36,36
Infuséd,aegwynn,2047,priest,shadow,66,36,30
Ottii,thrall,2046,priest,shadow,95,56,39
Rzktwo,eredar,2039,priest,shadow,65,37,28
Pu,outland,2039,priest,shadow,90,43,47
Синфал,blackscar,2034,priest,shadow,298,149,149
Genjutzux,kazzak,2026,priest,shadow,72,40,32
Даняпампгодх,soulflayer,2026,priest,shadow,223,108,115
Zodzín,ragnaros,2023,priest,shadow,60,30,30
Minblock,sanguino,2021,priest,shadow,150,78,72
Donenigma,stormscale,2019,priest,shadow,132,82,50
Bluxon,kazzak,2016,priest,shadow,172,100,72
Хьёх,blackscar,2015,priest,shadow,66,41,25
Zoodiacp,blackrock,2012,priest,shadow,124,61,63
Amtoxic,stormscale,2011,priest,shadow,77,42,35
Raikup,ravencrest,2011,priest,shadow,65,30,35
Миладиель,gordunni,2008,priest,shadow,137,69,68
Destinyhero,aegwynn,2007,priest,shadow,87,44,43
Zhadum,stormscale,2000,priest,shadow,136,72,64
Waltergoblin,sylvanas,1990,priest,shadow,36,27,9
Бвонсаамди,soulflayer,1988,priest,shadow,149,81,68
Nabøøbies,blackmoore,1986,priest,shadow,68,39,29
Sethÿr,sanguino,1983,priest,shadow,150,78,72
Qoryn,ravencrest,1981,priest,shadow,96,54,42
Bönfire,silvermoon,1981,priest,shadow,316,157,159
Huffle,argent-dawn,1964,priest,shadow,39,28,11
Akibom,drakthul,1963,priest,shadow,89,52,37
Lâughing,ravencrest,1962,priest,shadow,129,69,60
Rnkz,sanguino,1961,priest,shadow,66,41,25
Melábufeis,dun-modr,1960,priest,shadow,66,39,27
Mímou,kazzak,1955,priest,shadow,101,59,42
Moretti,ravencrest,1953,priest,shadow,54,32,22
Rýzera,aegwynn,1950,priest,shadow,36,25,11
Evazhang,outland,1950,priest,shadow,54,31,23
Justtpro,twisting-nether,1950,priest,shadow,205,117,88
Енотхд,soulflayer,1946,priest,shadow,84,45,39
Perché,silvermoon,1945,priest,shadow,66,48,18
Weekfortyone,blackhand,1945,priest,shadow,86,42,44
Demølishes,ravencrest,1942,priest,shadow,60,36,24
Smxkÿÿ,eredar,1939,priest,shadow,53,36,17
Physxd,blackrock,1938,priest,shadow,54,38,16
Dhurza,shendralar,1938,priest,shadow,66,39,27
Duzurîx,burning-blade,1938,priest,shadow,54,29,25
Rãpidi,hyjal,1932,priest,shadow,89,56,33
Buøbuarns,sanguino,1930,priest,shadow,63,31,32
Айсиоу,howling-fjord,1929,priest,shadow,42,26,16
Léandrä,magtheridon,1927,priest,shadow,90,45,45
Бхонсамди,blackscar,1926,priest,shadow,101,60,41
Elnyashka,ravencrest,1922,priest,shadow,121,72,49
Yoe,twisting-nether,1921,priest,shadow,60,31,29
Prøphetx,thrall,1916,priest,shadow,195,99,96
Estragon,quelthalas,1912,priest,shadow,75,40,35
Räke,blackrock,1912,priest,shadow,78,39,39
Manofonéway,outland,1909,priest,shadow,66,35,31
Shadowvoice,outland,1905,priest,shadow,48,30,18
Djalex,ravencrest,1905,priest,shadow,89,48,41
Термидор,booty-bay,1903,priest,shadow,107,66,41
Cathrix,kazzak,1900,priest,shadow,72,45,27
Heal,hyjal,1900,priest,shadow,248,137,111
Некрозмх,soulflayer,1899,priest,shadow,30,20,10
Hansmaul,thrall,1897,priest,shadow,36,20,16
Nanna,agamaggan,1896,priest,shadow,154,80,74
Voldemort,blackrock,1894,priest,shadow,36,23,13
Cornflays,outland,1894,priest,shadow,49,29,20
Newkidx,draenor,1892,priest,shadow,48,27,21
Døubtful,kazzak,1890,priest,shadow,36,20,16
Эсдаль,howling-fjord,1889,priest,shadow,60,41,19
Shádówý,kazzak,1889,priest,shadow,36,20,16
Tankeløs,kazzak,1884,priest,shadow,48,29,19
Ûñträînablê,outland,1882,priest,shadow,60,42,18
Yaboyboompie,blackrock,1874,priest,shadow,75,34,41
Lløthx,ravencrest,1870,priest,shadow,66,37,29
Ølle,ravencrest,1869,priest,shadow,84,51,33
Shuturmouth,ravencrest,1869,priest,shadow,96,57,39
Drarianna,nemesis,1868,priest,shadow,30,22,8
Vilayetko,ravencrest,1868,priest,shadow,48,25,23
Knútx,stormscale,1867,priest,shadow,60,30,30
Râvyn,silvermoon,1866,priest,shadow,44,35,9
Heffer,outland,1866,priest,shadow,123,73,50
Pandacore,frostmane,1864,priest,shadow,54,28,26
Simôc,eredar,1864,priest,shadow,66,34,32
Billybay,argent-dawn,1863,priest,shadow,32,28,4
Voideffsucks,stormscale,1863,priest,shadow,30,21,9
Sepharis,runetotem,1863,priest,shadow,209,124,85
Actionjezuz,shattered-hand,1861,priest,shadow,54,33,21
Hoesfavorite,onyxia,1861,priest,shadow,128,78,50
Zuhä,twisting-nether,1861,priest,shadow,60,34,26
Moonword,archimonde,1859,priest,shadow,36,21,15
Xayona,argent-dawn,1858,priest,shadow,54,26,28
Криптика,soulflayer,1856,priest,shadow,48,30,18
Milkysmite,twisting-nether,1856,priest,shadow,52,32,20
Iodjsaiojoij,kazzak,1856,priest,shadow,54,30,24
Rockness,blackmoore,1854,priest,shadow,137,91,46
Ptxd,alakir,1853,priest,shadow,64,38,26
Liloz,eredar,1852,priest,shadow,59,34,25
Angsty,blackrock,1851,priest,shadow,97,48,49
Ageyr,ragnaros,1848,priest,shadow,89,57,32
Dingopriest,blackrock,1848,priest,shadow,78,46,32
Either,kazzak,1848,priest,shadow,65,36,29
Mafiasnipers,ravencrest,1847,priest,shadow,36,21,15
Blindöts,tarren-mill,1847,priest,shadow,47,27,20
Rýzera,tarren-mill,1847,priest,shadow,35,20,15
Animesenpai,kazzak,1847,priest,shadow,60,32,28
Versio,dalvengyr,1847,priest,shadow,54,28,26
Pipf,blackmoore,1844,priest,shadow,65,41,24
Dreamhatcher,deathwing,1844,priest,shadow,90,51,39
Akolyte,blackmoore,1843,priest,shadow,36,22,14
Trisks,ravencrest,1843,priest,shadow,34,20,14
Voidgodx,blackrock,1842,priest,shadow,41,24,17
Lebronjay,ravencrest,1842,priest,shadow,94,53,41
Пристатеист,howling-fjord,1842,priest,shadow,72,35,37
Gymbró,kazzak,1841,priest,shadow,60,33,27
Velence,ravencrest,1839,priest,shadow,89,51,38
Arendt,blackhand,1837,priest,shadow,48,29,19
Птумерианец,gordunni,1837,priest,shadow,76,41,35
Yêl,thrall,1836,priest,shadow,253,140,113
Johnnybanana,argent-dawn,1835,priest,shadow,36,26,10
Sadix,ravencrest,1835,priest,shadow,66,38,28
Mýxir,burning-legion,1834,priest,shadow,89,45,44
Ымц,gordunni,1834,priest,shadow,78,39,39
Ezlife,blackrock,1832,priest,shadow,78,42,36
Холихэйт,howling-fjord,1831,priest,shadow,51,30,21
Shadowmate,silvermoon,1829,priest,shadow,56,31,25
Tupal,ysondre,1829,priest,shadow,78,43,35
Schmetter,tarren-mill,1829,priest,shadow,65,29,36
Dianaxd,dun-modr,1827,priest,shadow,41,25,16
Selëne,blackrock,1827,priest,shadow,72,43,29
Megamann,dun-morogh,1827,priest,shadow,54,32,22
Sÿrax,ysondre,1827,priest,shadow,61,34,27
Игорянатакуе,eversong,1826,priest,shadow,154,86,68
Rakamain,ravencrest,1825,priest,shadow,48,31,17
Zindrix,silvermoon,1825,priest,shadow,84,50,34
Anateoris,turalyon,1825,priest,shadow,76,43,33
Ансор,lich-king,1825,priest,shadow,95,52,43
Quezaris,stormscale,1825,priest,shadow,48,23,25
Cantsqell,silvermoon,1823,priest,shadow,48,34,14
Cnsnn,ysondre,1823,priest,shadow,114,76,38
Morseeii,baelgun,1823,priest,shadow,56,31,25
Djops,outland,1823,priest,shadow,84,45,39
Трейдарк,blackscar,1823,priest,shadow,60,31,29
Тарренмилл,gordunni,1822,priest,shadow,92,53,39
Ondskabsfuld,kazzak,1822,priest,shadow,60,26,34
Староезло,gordunni,1821,priest,shadow,68,33,35
Vaccineboost,silvermoon,1821,priest,shadow,102,45,57
Yirico,argent-dawn,1820,priest,shadow,47,31,16
Blóódfart,kazzak,1819,priest,shadow,89,43,46
Marbellexd,pozzo-delleternità,1818,priest,shadow,157,91,66
Voidshuffle,laughing-skull,1818,priest,shadow,42,24,18
Jeppehpräst,stormscale,1817,priest,shadow,66,40,26
Диспайзх,gordunni,1817,priest,shadow,66,38,28
Omedo,stormscale,1816,priest,shadow,36,19,17
Magicalme,kult-der-verdammten,1815,priest,shadow,42,26,16
Backpedaling,kazzak,1815,priest,shadow,84,42,42
Theunknown,thrall,1814,priest,shadow,42,30,12
Physx,blackrock,1814,priest,shadow,30,19,11
Øctawtöuch,kazzak,1814,priest,shadow,88,53,35
Depridolens,argent-dawn,1814,priest,shadow,49,28,21
Genjutzu,kazzak,1814,priest,shadow,36,19,17
Cutepangolin,khaz-modan,1813,priest,shadow,42,29,13
Kylähullu,ravencrest,1813,priest,shadow,80,46,34
Stèálth,sylvanas,1812,priest,shadow,24,19,5
Luvlyrah,draenor,1812,priest,shadow,81,52,29
Namsolo,kazzak,1811,priest,shadow,78,42,36
Shiannâ,malganis,1810,priest,shadow,44,24,20
Skillmåsterx,ravencrest,1810,priest,shadow,54,29,25
Drvoidit,blackrock,1809,priest,shadow,48,28,20
Magicstarss,the-maelstrom,1809,priest,shadow,78,42,36
Фростингшп,goldrinn,1808,priest,shadow,42,31,11
Necrofeel,silvermoon,1807,priest,shadow,30,20,10
Meatyshaft,doomhammer,1807,priest,shadow,99,64,35
Salkerer,stormscale,1807,priest,shadow,30,19,11
Stümpý,ravencrest,1807,priest,shadow,52,29,23
Megajuicy,blackmoore,1807,priest,shadow,258,143,115
Lr,aszune,1806,priest,shadow,36,25,11
Синатро,deathguard,1806,priest,shadow,190,119,71
Debbski,tarren-mill,1806,priest,shadow,48,30,18
Snarks,sylvanas,1806,priest,shadow,36,20,16
Claritycraft,twisting-nether,1805,priest,shadow,36,22,14
Galatea,les-sentinelles,1805,priest,shadow,78,44,34
Vajainap,outland,1804,priest,shadow,30,19,11
Aliocha,dalaran,1804,priest,shadow,54,27,27
Петушшара,gordunni,1804,priest,shadow,63,31,32
Solaclypsa,destromath,1803,priest,shadow,36,26,10
Mataî,kazzak,1803,priest,shadow,84,49,35
Jpd,outland,1803,priest,shadow,48,25,23
Stazia,ravencrest,1802,priest,shadow,36,22,14
Alfredosauce,ravencrest,1802,priest,shadow,64,34,30
Margots,kazzak,1802,priest,shadow,42,22,20
Mizulol,ravencrest,1801,priest,shadow,80,42,38
Akroama,archimonde,1801,priest,shadow,92,46,46
Maedhrós,ravencrest,1800,priest,shadow,30,24,6
Sleypriest,draenor,1800,priest,shadow,48,32,16
Theoniss,draenor,1799,priest,shadow,125,70,55
Tacøgxd,ravencrest,1796,priest,shadow,66,40,26
Pizzagigante,kazzak,1796,priest,shadow,48,29,19
Nyotux,blackrock,1794,priest,shadow,72,47,25
Homxcxde,ravencrest,1793,priest,shadow,48,26,22
Shøana,archimonde,1793,priest,shadow,60,26,34
Ревентонх,howling-fjord,1792,priest,shadow,211,119,92
Raisedbyrap,blackrock,1791,priest,shadow,60,33,27
Kujiua,ravencrest,1790,priest,shadow,124,69,55
Ecquidozx,ravencrest,1790,priest,shadow,41,22,19
Tbs,sylvanas,1788,priest,shadow,113,66,47
Uselessxasel,sanguino,1788,priest,shadow,48,28,20
Helín,hellfire,1786,priest,shadow,102,60,42
Shucks,stormscale,1785,priest,shadow,36,19,17
Insanious,skullcrusher,1785,priest,shadow,65,34,31
Erenndriel,twisting-nether,1784,priest,shadow,126,69,57
Тоних,deathguard,1784,priest,shadow,42,21,21
Babarøga,blackrock,1783,priest,shadow,47,28,19
Zabpriest,blackhand,1782,priest,shadow,54,31,23
Fläschheal,aegwynn,1781,priest,shadow,36,24,12
Свдпрох,soulflayer,1781,priest,shadow,51,26,25
Ounxx,blackrock,1779,priest,shadow,65,41,24
Spklooril,hyjal,1778,priest,shadow,360,188,172
Lostcause,alakir,1773,priest,shadow,78,46,32
Andreel,ravencrest,1773,priest,shadow,90,49,41
Maryhugette,archimonde,1770,priest,shadow,156,75,81
Мистериум,howling-fjord,1769,priest,shadow,89,50,39
Tremrfinger,dun-modr,1769,priest,shadow,98,53,45
Adub,tarren-mill,1769,priest,shadow,48,25,23
Schizophrens,outland,1766,priest,shadow,48,28,20
Vibéz,outland,1765,priest,shadow,48,24,24
Garycash,outland,1762,priest,shadow,111,57,54
Шандресса,deepholm,1761,priest,shadow,48,31,17
Fakecastguru,ravencrest,1761,priest,shadow,66,37,29
Cizer,kazzak,1760,priest,shadow,50,26,24
Heilsarmee,blackhand,1760,priest,shadow,119,61,58
Xiä,archimonde,1758,priest,shadow,72,37,35
Skeida,bloodhoof,1758,priest,shadow,77,39,38
Darthmantle,silvermoon,1758,priest,shadow,59,29,30
Sonâkî,archimonde,1757,priest,shadow,36,21,15
Hypnocat,blackrock,1754,priest,shadow,64,36,28
Ninjajane,sylvanas,1753,priest,shadow,53,32,21
Иннрей,soulflayer,1751,priest,shadow,69,29,40
Ансарм,gordunni,1744,priest,shadow,200,109,91
Voodkaa,drakthul,1743,priest,shadow,69,42,27
Spherics,ravencrest,1743,priest,shadow,54,27,27
Staljon,burning-legion,1742,priest,shadow,54,32,22
Anabølix,ravencrest,1741,priest,shadow,48,27,21
Sakuyasp,blackrock,1740,priest,shadow,174,89,85
Facemeltina,kiljaeden,1739,priest,shadow,42,20,22
Wérrýxs,kazzak,1738,priest,shadow,94,60,34
Víppe,stormreaver,1738,priest,shadow,65,40,25
Erdine,ravencrest,1738,priest,shadow,60,33,27
Máv,tarren-mill,1737,priest,shadow,104,63,41
Zeythz,ravencrest,1737,priest,shadow,179,100,79
Geløpr,eredar,1736,priest,shadow,102,58,44
Önnÿ,dun-modr,1736,priest,shadow,54,26,28
Mehtz,ravencrest,1735,priest,shadow,269,135,134
Zultor,ragnaros,1734,priest,shadow,43,24,19
Lindp,stormreaver,1732,priest,shadow,66,42,24
Wixzyx,ravencrest,1732,priest,shadow,48,26,22
Hasa,stormreaver,1730,priest,shadow,66,36,30
Barthólomew,doomhammer,1730,priest,shadow,114,61,53
Zhyn,turalyon,1729,priest,shadow,110,65,45
Edoran,ragnaros,1728,priest,shadow,35,19,16
Absolution,stormscale,1728,priest,shadow,269,146,123
Carmechanic,defias-brotherhood,1728,priest,shadow,94,49,45
Mackings,the-maelstrom,1726,priest,shadow,136,74,62
Казуямисима,gordunni,1723,priest,shadow,170,93,77
Ксерф,soulflayer,1723,priest,shadow,114,58,56
Waina,defias-brotherhood,1723,priest,shadow,138,67,71
Spamplague,stormscale,1721,priest,shadow,72,38,34
Flexzpriest,destromath,1720,priest,shadow,108,58,50
Miruh,malganis,1718,priest,shadow,161,101,60
Кломми,gordunni,1718,priest,shadow,84,45,39
Nukyo,blackmoore,1718,priest,shadow,44,21,23
Ктулсотум,soulflayer,1717,priest,shadow,46,28,18
Becknarbritt,stormscale,1717,priest,shadow,256,142,114
Klosso,anachronos,1717,priest,shadow,244,117,127
Перекованный,soulflayer,1716,priest,shadow,129,69,60
Всезнайка,soulflayer,1715,priest,shadow,114,61,53
Ðrßøtÿcûs,la-croisade-écarlate,1714,priest,shadow,30,18,12
Holyshadów,azjolnerub,1714,priest,shadow,89,52,37
Æßsåløønå,la-croisade-écarlate,1712,priest,shadow,30,18,12
Скайвэйуокер,howling-fjord,1712,priest,shadow,71,42,29
Массаракъш,razuvious,1709,priest,shadow,24,18,6
Whynolove,ragnaros,1708,priest,shadow,89,59,30
Dakotapriest,ravencrest,1706,priest,shadow,30,18,12
Xangha,burning-legion,1705,priest,shadow,114,67,47
Daisyduke,veknilash,1705,priest,shadow,69,37,32
Dümbledore,aggra-português,1704,priest,shadow,24,18,6
Voidlink,kazzak,1704,priest,shadow,36,21,15
Sheto,burning-legion,1704,priest,shadow,204,104,100
Fueguchi,anubarak,1703,priest,shadow,90,49,41
Ankî,aegwynn,1703,priest,shadow,84,44,40
Elishîa,ragnaros,1703,priest,shadow,54,24,30
Milania,ravencrest,1701,priest,shadow,42,33,9
Daspyen,silvermoon,1700,priest,shadow,67,37,30
Фиброз,blackscar,1697,priest,shadow,120,68,52
Miraçlê,kazzak,1696,priest,shadow,36,25,11
Соргоху,gordunni,1695,priest,shadow,54,32,22
Hiddenhealz,blackrock,1691,priest,shadow,53,30,23
Kamish,twisting-nether,1690,priest,shadow,138,74,64
Rumbo,lightnings-blade,1689,priest,shadow,59,34,25
Imaut,emerald-dream,1689,priest,shadow,56,31,25
Snoopý,dun-modr,1689,priest,shadow,90,49,41
Iessei,outland,1688,priest,shadow,84,42,42
Zahadoom,stormscale,1687,priest,shadow,78,46,32
Томрэдл,blackscar,1687,priest,shadow,64,33,31
Phucu,the-maelstrom,1684,priest,shadow,54,32,22
Rubín,sylvanas,1683,priest,shadow,44,28,16
Framesxøxø,ravencrest,1683,priest,shadow,48,29,19
Клаима,soulflayer,1683,priest,shadow,71,41,30
Rasha,kazzak,1683,priest,shadow,74,42,32
Sleeg,tarren-mill,1681,priest,shadow,35,19,16
Файерин,soulflayer,1676,priest,shadow,48,21,27
Cthultist,dun-modr,1675,priest,shadow,108,52,56
Yngp,blackmoore,1673,priest,shadow,66,36,30
Raspberrypíe,silvermoon,1672,priest,shadow,84,49,35
Reapzbolt,blackrock,1672,priest,shadow,60,28,32
Dreadest,blackhand,1671,priest,shadow,42,26,16
Peprama,stormscale,1670,priest,shadow,66,39,27
Papie,kazzak,1670,priest,shadow,42,23,19
Tsunadesaama,silvermoon,1668,priest,shadow,63,32,31
Флэшх,soulflayer,1666,priest,shadow,76,44,32
Mcdced,archimonde,1665,priest,shadow,61,38,23
Levitation,alakir,1665,priest,shadow,72,42,30
Raitwo,kazzak,1663,priest,shadow,101,55,46
Jóhnnybravó,kazzak,1662,priest,shadow,34,23,11
Goodsuck,tarren-mill,1662,priest,shadow,54,29,25
Tosem,antonidas,1661,priest,shadow,30,19,11
Sandcastles,ravencrest,1659,priest,shadow,90,58,32
Violatio,aegwynn,1658,priest,shadow,104,59,45
Киндзер,blackscar,1658,priest,shadow,54,29,25
Øxytøcin,ravencrest,1658,priest,shadow,168,87,81
Buffholy,dun-modr,1657,priest,shadow,66,39,27
Mentax,kazzak,1657,priest,shadow,42,24,18
Strunkiin,defias-brotherhood,1656,priest,shadow,108,60,48
Dotreveal,ravencrest,1656,priest,shadow,42,23,19
Пурпле,soulflayer,1655,priest,shadow,41,18,23
Anexxia,outland,1654,priest,shadow,42,20,22
Виталябард,gordunni,1654,priest,shadow,66,30,36
Healzonwiilz,tarren-mill,1652,priest,shadow,30,18,12
Sqwabblepee,stormscale,1652,priest,shadow,113,64,49
Galadrielkä,drakthul,1651,priest,shadow,42,24,18
Финдовский,gordunni,1649,priest,shadow,102,54,48
Ruhe,silvermoon,1648,priest,shadow,48,27,21
Cdplz,archimonde,1647,priest,shadow,30,20,10
Been,ravencrest,1646,priest,shadow,42,22,20
Malaíka,silvermoon,1645,priest,shadow,41,25,16
Eupz,argent-dawn,1644,priest,shadow,50,27,23
Atahalni,argent-dawn,1644,priest,shadow,156,71,85
Djariisimp,tarren-mill,1643,priest,shadow,36,21,15
Христианин,gordunni,1642,priest,shadow,96,54,42
Kiesp,tarren-mill,1642,priest,shadow,186,97,89
Rakkha,ravencrest,1642,priest,shadow,90,46,44
Rházael,blackrock,1642,priest,shadow,42,20,22
Pedopräst,stormscale,1640,priest,shadow,62,39,23
Weebi,silvermoon,1640,priest,shadow,65,39,26
Milo,argent-dawn,1640,priest,shadow,102,61,41
Bownsamdi,tarren-mill,1640,priest,shadow,39,23,16
Mirill,tarren-mill,1640,priest,shadow,151,79,72
Jacep,kazzak,1639,priest,shadow,36,23,13
Nøwmäck,archimonde,1639,priest,shadow,42,23,19
Ikaytsym,ravencrest,1638,priest,shadow,36,22,14
Priestfive,stormscale,1638,priest,shadow,48,28,20
Aaj,twisting-nether,1638,priest,shadow,57,29,28
Mikizu,die-aldor,1638,priest,shadow,42,21,21
Momomomomomo,blackrock,1637,priest,shadow,118,61,57
Djzerøgodx,frostwolf,1637,priest,shadow,41,18,23
Belialzs,blackrock,1636,priest,shadow,45,24,21
Dezerta,nozdormu,1636,priest,shadow,74,39,35
Asterixsu,sylvanas,1635,priest,shadow,42,28,14
Undefined,chamber-of-aspects,1634,priest,shadow,40,28,12
Mojibien,burning-legion,1633,priest,shadow,134,73,61
Дикаях,gordunni,1633,priest,shadow,106,51,55
Bigdogone,arathor,1632,priest,shadow,52,29,23
Sosûke,archimonde,1631,priest,shadow,36,22,14
Vaßpera,tarren-mill,1631,priest,shadow,111,60,51
Muyhuman,eredar,1630,priest,shadow,24,17,7
Jaimë,ravencrest,1630,priest,shadow,30,17,13
Ðanilox,dun-modr,1629,priest,shadow,24,17,7
Shåmssp,kazzak,1628,priest,shadow,18,17,1
Baldracca,shendralar,1628,priest,shadow,108,58,50
Ахаххааха,gordunni,1628,priest,shadow,60,32,28
Shreedx,stormscale,1627,priest,shadow,60,35,25
Билетлолпро,borean-tundra,1627,priest,shadow,30,17,13
Чикхоп,blackscar,1625,priest,shadow,108,69,39
Марриаза,blackscar,1625,priest,shadow,48,23,25
Lênax,arthas,1624,priest,shadow,46,25,21
Jønnybanana,blackrock,1623,priest,shadow,39,20,19
Affex,tarren-mill,1622,priest,shadow,30,18,12
Emala,hyjal,1622,priest,shadow,36,17,19
Pennywïse,kargath,1622,priest,shadow,108,50,58
Luphriest,ravencrest,1621,priest,shadow,36,17,19
Brøwnyez,zuljin,1620,priest,shadow,66,31,35
Shyasianpr,area-52,1619,priest,shadow,42,23,19
Malip,ragnaros,1619,priest,shadow,39,19,20
Rubzler,ravencrest,1618,priest,shadow,36,18,18
Najany,archimonde,1617,priest,shadow,36,20,16
Амбрелка,fordragon,1617,priest,shadow,193,98,95
Jegred,draenor,1616,priest,shadow,48,32,16
Toesxcker,stormscale,1616,priest,shadow,35,21,14
Priestazie,madmortem,1616,priest,shadow,96,57,39
Sweetepi,blackmoore,1616,priest,shadow,42,24,18
Педрец,howling-fjord,1616,priest,shadow,60,32,28
Cielavinja,aszune,1616,priest,shadow,44,23,21
Babarøqa,blackmoore,1616,priest,shadow,277,143,134
Алурелис,blackscar,1615,priest,shadow,30,17,13
Poposy,hyjal,1614,priest,shadow,36,23,13
Mukkin,tarren-mill,1614,priest,shadow,60,35,25
Knoffp,blackhand,1614,priest,shadow,72,41,31
Шпх,howling-fjord,1614,priest,shadow,36,20,16
Neitter,zuljin,1613,priest,shadow,72,40,32
Widdlprest,sylvanas,1613,priest,shadow,36,17,19
Svettvrede,sylvanas,1613,priest,shadow,75,35,40
Marsheil,blackhand,1612,priest,shadow,54,31,23
Пампнавечерх,blackscar,1612,priest,shadow,41,22,19
Nûtqt,archimonde,1612,priest,shadow,94,49,45
Charmebolzen,blackrock,1612,priest,shadow,96,50,46
Azæriø,rashgarroth,1612,priest,shadow,89,46,43
Asträlaws,archimonde,1611,priest,shadow,64,34,30
Ihu,nazjatar,1611,priest,shadow,131,62,69
Essumies,stormreaver,1610,priest,shadow,38,26,12
Bigblackdot,grim-batol,1610,priest,shadow,30,17,13
Адскийприст,gordunni,1610,priest,shadow,36,17,19
Fearocity,outland,1609,priest,shadow,42,23,19
Lenneyqt,blackmoore,1609,priest,shadow,48,26,22
Quezaris,kazzak,1607,priest,shadow,23,20,3
Vatikanet,ravencrest,1607,priest,shadow,111,65,46
Tùcøcø,archimonde,1607,priest,shadow,48,21,27
ßelfy,twisting-nether,1606,priest,shadow,25,19,6
Ittei,stormscale,1606,priest,shadow,69,47,22
Hòllymèdx,blackmoore,1605,priest,shadow,33,21,12
Waycrest,ravencrest,1605,priest,shadow,71,45,26
Øhlø,ysondre,1604,priest,shadow,27,19,8
Æäõ,turalyon,1604,priest,shadow,36,19,17
Mindtyson,dun-morogh,1603,priest,shadow,30,18,12
Trancemaster,dun-modr,1602,priest,shadow,30,18,12
Jonesy,blackmoore,1602,priest,shadow,82,46,36
Sunehxp,blackrock,1602,priest,shadow,47,20,27
Sadskîx,dun-modr,1601,priest,shadow,33,23,10
Sudeki,blackmoore,1601,priest,shadow,42,20,22
Satin,twilights-hammer,1600,priest,shadow,33,21,12
Caera,blackrock,1600,priest,shadow,36,21,15
Toba,hellscream,1600,priest,shadow,42,23,19
Willzah,outland,1600,priest,shadow,38,20,18
Cifhilis,ravencrest,1600,priest,shadow,66,32,34
Syam,dun-morogh,1600,priest,shadow,42,17,25
Shyvi,ravencrest,1598,priest,shadow,30,20,10
Fandac,sylvanas,1598,priest,shadow,36,20,16
Everdark,twisting-nether,1598,priest,shadow,172,92,80
Terrored,ravencrest,1598,priest,shadow,48,20,28
Энвиньяттар,howling-fjord,1597,priest,shadow,47,32,15
Llothx,ravencrest,1597,priest,shadow,62,34,28
Lavidu,antonidas,1597,priest,shadow,48,26,22
Трубишоп,howling-fjord,1595,priest,shadow,106,52,54
Cooldgreyjoy,archimonde,1594,priest,shadow,40,19,21
Ephara,outland,1593,priest,shadow,59,33,26
Makethemstop,bronzebeard,1591,priest,shadow,66,47,19
Priestgrade,darkspear,1590,priest,shadow,36,20,16
Даркфолс,soulflayer,1588,priest,shadow,48,29,19
Kimosabee,kazzak,1588,priest,shadow,48,25,23
Pombär,ragnaros,1587,priest,shadow,54,36,18
Chinko,blackmoore,1587,priest,shadow,86,54,32
Genthus,kazzak,1586,priest,shadow,78,41,37
Axelbre,blackrock,1585,priest,shadow,30,19,11
Meshen,ysondre,1585,priest,shadow,274,150,124
Faminé,outland,1584,priest,shadow,65,29,36
Бомжскадилом,gordunni,1583,priest,shadow,78,43,35
Lowisa,sylvanas,1580,priest,shadow,76,45,31
Энмунд,borean-tundra,1580,priest,shadow,159,91,68
Imøteph,ragnaros,1579,priest,shadow,77,44,33
Cryptoflame,silvermoon,1579,priest,shadow,45,25,20
Офелла,howling-fjord,1579,priest,shadow,454,234,220
Hemaplex,dun-modr,1578,priest,shadow,53,32,21
Lilakaii,chamber-of-aspects,1578,priest,shadow,98,53,45
Sakanade,twisting-nether,1576,priest,shadow,42,34,8
Kuddles,hyjal,1576,priest,shadow,128,77,51
Cykdwojeczka,burning-legion,1576,priest,shadow,101,51,50
Milamati,kazzak,1576,priest,shadow,60,28,32
Basxcbxtchx,ravencrest,1575,priest,shadow,30,19,11
Basicpr,ravencrest,1575,priest,shadow,63,38,25
Baihoi,twilights-hammer,1570,priest,shadow,108,65,43
Kêrrýgold,blackrock,1570,priest,shadow,115,62,53
Supahot,sylvanas,1569,priest,shadow,60,36,24
Skerduddle,stormscale,1568,priest,shadow,48,29,19
Phplaravel,tarren-mill,1568,priest,shadow,63,31,32
Kantar,ragnaros,1567,priest,shadow,106,58,48
Solaní,antonidas,1567,priest,shadow,132,72,60
Beonin,tarren-mill,1565,priest,shadow,55,34,21
Филяфан,gordunni,1565,priest,shadow,60,30,30
Саксесфул,howling-fjord,1564,priest,shadow,115,63,52
Insaniro,argent-dawn,1562,priest,shadow,66,34,32
Selaria,magtheridon,1562,priest,shadow,42,19,23
Умора,razuvious,1560,priest,shadow,29,17,12
Рэнфан,fordragon,1558,priest,shadow,52,35,17
Zayden,ragnaros,1557,priest,shadow,83,41,42
Kwolinger,norgannon,1557,priest,shadow,48,23,25
Эззи,soulflayer,1556,priest,shadow,90,50,40
Shivaja,aegwynn,1555,priest,shadow,30,17,13
Jonig,blackmoore,1555,priest,shadow,66,32,34
Lothlórien,dun-modr,1552,priest,shadow,42,31,11
Bubidiblumpr,twisting-nether,1552,priest,shadow,78,51,27
Malisna,argent-dawn,1551,priest,shadow,29,17,12
Vavulya,blackhand,1551,priest,shadow,147,80,67
Corruptx,ysondre,1550,priest,shadow,36,18,18
Healiea,outland,1549,priest,shadow,89,38,51
Anathemas,draenor,1548,priest,shadow,42,30,12
Xyo,alleria,1548,priest,shadow,72,35,37
Sebbepriest,twisting-nether,1544,priest,shadow,173,93,80
Coupdekaraté,sylvanas,1543,priest,shadow,36,18,18
Xooxl,ragnaros,1542,priest,shadow,102,60,42
Inferius,shadowsong,1542,priest,shadow,46,18,28
Hâicu,antonidas,1540,priest,shadow,60,38,22
Кхэрри,goldrinn,1540,priest,shadow,30,19,11
Амгар,galakrond,1540,priest,shadow,125,69,56
Warplague,argent-dawn,1539,priest,shadow,42,19,23
Hellscon,kazzak,1538,priest,shadow,125,62,63
Babydark,ravencrest,1535,priest,shadow,30,16,14
Ankhh,bloodscalp,1535,priest,shadow,90,42,48
Apèx,blackrock,1535,priest,shadow,40,18,22
Bøts,ravencrest,1534,priest,shadow,55,27,28
Sopsy,stormscale,1533,priest,shadow,42,21,21
Tekdogx,blackmoore,1533,priest,shadow,36,16,20
Putríd,sylvanas,1532,priest,shadow,30,19,11
Zekonja,doomhammer,1532,priest,shadow,82,42,40
Massbimba,tarren-mill,1531,priest,shadow,65,33,32
Lightform,twisting-nether,1530,priest,shadow,69,43,26
Kightz,twisting-nether,1530,priest,shadow,63,32,31
Ðrwiz,ravencrest,1528,priest,shadow,30,16,14
Thmas,outland,1525,priest,shadow,71,32,39
Thoryän,ragnaros,1523,priest,shadow,42,24,18
Psycos,kazzak,1523,priest,shadow,66,33,33
Cederpriest,tarren-mill,1522,priest,shadow,57,21,36
Мишатемный,gordunni,1520,priest,shadow,54,31,23
Valirda,twisting-nether,1520,priest,shadow,122,61,61
Прыст,howling-fjord,1519,priest,shadow,24,16,8
Kättare,stormscale,1519,priest,shadow,48,25,23
Nahyra,dalaran,1519,priest,shadow,113,58,55
Cannapriest,frostwolf,1518,priest,shadow,48,27,21
Рейвор,gordunni,1518,priest,shadow,35,19,16
Yoii,nemesis,1518,priest,shadow,36,16,20
Chrønös,hyjal,1517,priest,shadow,131,68,63
Whocare,tarren-mill,1517,priest,shadow,48,24,24
Leckpriest,sanguino,1517,priest,shadow,100,49,51
Rynsym,ravencrest,1517,priest,shadow,47,20,27
Stölpen,ravencrest,1515,priest,shadow,48,22,26
Flyp,stormscale,1514,priest,shadow,54,26,28
Discknight,kazzak,1514,priest,shadow,42,16,26
Umbralx,ragnaros,1513,priest,shadow,77,45,32
Fumiiko,stormscale,1511,priest,shadow,50,20,30
Beasteaksx,thrall,1510,priest,shadow,30,17,13
Êttân,ravencrest,1510,priest,shadow,56,30,26
Jingling,kazzak,1509,priest,shadow,24,16,8
Zászàsmaster,kazzak,1509,priest,shadow,96,55,41
Voidis,hyjal,1509,priest,shadow,30,16,14
Morsy,alleria,1509,priest,shadow,44,23,21
Skypray,burning-legion,1507,priest,shadow,99,50,49
Cylantharia,eredar,1506,priest,shadow,30,16,14
Ðòóm,archimonde,1505,priest,shadow,61,33,28
Йоййо,gordunni,1504,priest,shadow,112,58,54
Hinorist,kazzak,1503,priest,shadow,29,17,12
Ormarn,twisting-nether,1503,priest,shadow,48,28,20
Dyshexia,bronze-dragonflight,1503,priest,shadow,78,39,39
Деплитфофан,gordunni,1502,priest,shadow,83,50,33
Brighty,sylvanas,1502,priest,shadow,108,56,52
Shadowplay,theradras,1502,priest,shadow,64,30,34
Varjomies,ragnaros,1499,priest,shadow,96,50,46
Fiftyfives,hyjal,1496,priest,shadow,51,25,26
Bubbleup,defias-brotherhood,1494,priest,shadow,30,21,9
Sypnos,zuljin,1493,priest,shadow,36,21,15
Äiri,blackmoore,1492,priest,shadow,30,17,13
Blasphemiia,outland,1491,priest,shadow,72,44,28
Kajifoxi,frostmane,1490,priest,shadow,60,38,22
Skûggpräst,silvermoon,1490,priest,shadow,41,22,19
Miruvai,tarren-mill,1490,priest,shadow,36,18,18
Даняпампх,soulflayer,1489,priest,shadow,212,112,100
Bercxu,ragnaros,1487,priest,shadow,60,34,26
Bierbändiger,blackhand,1487,priest,shadow,30,17,13
Lëshder,sanguino,1487,priest,shadow,107,55,52
Juxtapose,argent-dawn,1485,priest,shadow,30,23,7
Lynseanna,ravencrest,1485,priest,shadow,29,18,11
Ryik,ravencrest,1484,priest,shadow,68,36,32
Castêr,silvermoon,1483,priest,shadow,54,29,25
Ankus,tarren-mill,1482,priest,shadow,66,36,30
Statìk,outland,1482,priest,shadow,66,33,33
Zeto,blackmoore,1479,priest,shadow,51,31,20
Shinesomnya,aegwynn,1478,priest,shadow,40,23,17
Mightyfool,aegwynn,1478,priest,shadow,102,49,53
Apfelrisotta,outland,1478,priest,shadow,69,33,36
Зонкк,thermaplugg,1477,priest,shadow,114,62,52
Baptizer,nemesis,1476,priest,shadow,110,69,41
Akris,ragnaros,1476,priest,shadow,66,35,31
Galilea,sanguino,1475,priest,shadow,20,17,3
Pregrip,twisting-nether,1473,priest,shadow,43,21,22
Thawx,stormscale,1472,priest,shadow,30,16,14
Hælmenøw,archimonde,1472,priest,shadow,54,28,26
Ariyáh,antonidas,1471,priest,shadow,114,60,54
Kisala,kazzak,1470,priest,shadow,47,32,15
Adaseth,tarren-mill,1469,priest,shadow,78,51,27
Wingufreebrø,sanguino,1468,priest,shadow,76,36,40
Hiyahen,silvermoon,1467,priest,shadow,60,34,26
Люблюкофе,deathguard,1467,priest,shadow,92,51,41
Sháady,ravencrest,1466,priest,shadow,60,29,31
Youguessedit,twisting-nether,1466,priest,shadow,36,16,20
Spideypap,ragnaros,1464,priest,shadow,58,33,25
Mozahn,ragnaros,1464,priest,shadow,39,20,19
Kayeen9DF0F1,tarren-mill,1464,priest,shadow,118,58,60
Xceliann,stormscale,1462,priest,shadow,30,18,12
Карбираторх,gordunni,1462,priest,shadow,59,30,29
Tyene,voljin,1461,priest,shadow,70,40,30
Maxhima,defias-brotherhood,1461,priest,shadow,72,39,33
Багбери,eversong,1460,priest,shadow,322,170,152
Lapinvicieux,archimonde,1460,priest,shadow,53,27,26
Erkay,kazzak,1459,priest,shadow,54,30,24
Psycoscream,blackmoore,1459,priest,shadow,47,23,24
Nomorelight,stormscale,1458,priest,shadow,48,23,25
Kellen,burning-blade,1457,priest,shadow,320,167,153
Xîneâ,outland,1456,priest,shadow,30,16,14
Дикрия,eversong,1456,priest,shadow,114,59,55
Venomspawn,ragnaros,1456,priest,shadow,36,18,18
Celz,kazzak,1455,priest,shadow,36,21,15
Îndura,drakthul,1455,priest,shadow,50,29,21
Hemovoid,nagrand,1454,priest,shadow,24,17,7
Kendea,silvermoon,1453,priest,shadow,139,76,63
Vedina,bronze-dragonflight,1453,priest,shadow,105,49,56
Lousp,tarren-mill,1452,priest,shadow,42,17,25
Chaddius,stormscale,1450,priest,shadow,122,63,59
Самаэльз,blackscar,1448,priest,shadow,62,31,31
Kurzik,zuljin,1447,priest,shadow,46,30,16
Vhayna,kazzak,1447,priest,shadow,77,45,32
Dípp,ravencrest,1447,priest,shadow,36,18,18
Veryssra,archimonde,1446,priest,shadow,48,37,11
Thebesp,ravencrest,1446,priest,shadow,42,19,23
Voidjeanzqt,blackmoore,1445,priest,shadow,30,21,9
Nygel,kazzak,1445,priest,shadow,112,59,53
Galle,frostmane,1444,priest,shadow,32,20,12
Cinaedus,stormreaver,1444,priest,shadow,63,33,30
Cringelørd,alakir,1441,priest,shadow,70,41,29
Palitox,kazzak,1439,priest,shadow,70,38,32
Otecduchovny,burning-blade,1437,priest,shadow,24,15,9
Taeraz,archimonde,1435,priest,shadow,24,15,9
Odium,alakir,1434,priest,shadow,80,46,34
Sanebassoff,kazzak,1433,priest,shadow,190,102,88
Tarantos,uldum,1433,priest,shadow,39,18,21
Jlox,stormscale,1433,priest,shadow,39,16,23
Valdiona,tarren-mill,1431,priest,shadow,36,22,14
Fish,arathor,1431,priest,shadow,66,29,37
Smiles,burning-steppes,1430,priest,shadow,36,20,16
Yaoshih,draenor,1430,priest,shadow,53,28,25
Hörror,twisting-nether,1430,priest,shadow,42,21,21
Astangia,nemesis,1429,priest,shadow,183,99,84
Forhandleren,draenor,1429,priest,shadow,72,34,38
Gyom,sargeras,1426,priest,shadow,24,15,9
Lamaovic,archimonde,1426,priest,shadow,59,31,28
Jaimee,zirkel-des-cenarius,1425,priest,shadow,24,15,9
Xbeau,bronze-dragonflight,1425,priest,shadow,60,31,29
Даркхон,howling-fjord,1423,priest,shadow,38,21,17
Fnúggí,kazzak,1423,priest,shadow,42,21,21
Afrophobia,archimonde,1422,priest,shadow,84,45,39
Skypez,blackhand,1419,priest,shadow,78,40,38
Sharmidix,kazzak,1419,priest,shadow,30,15,15
Ladouce,archimonde,1418,priest,shadow,33,17,16
Vøidtheorem,ragnaros,1417,priest,shadow,36,15,21
Элдерле,gordunni,1415,priest,shadow,36,18,18
Søcrax,blackrock,1414,priest,shadow,60,34,26
Старкстрим,gordunni,1413,priest,shadow,66,34,32
Îzî,sanguino,1412,priest,shadow,42,23,19
Shopify,nagrand,1412,priest,shadow,30,15,15
Xelathor,twisting-nether,1412,priest,shadow,82,39,43
Simplesam,ravencrest,1412,priest,shadow,76,35,41
Icyîce,kazzak,1411,priest,shadow,24,15,9
Flayin,kazzak,1411,priest,shadow,48,29,19
Saintethérez,archimonde,1410,priest,shadow,45,30,15
Iamreaper,outland,1409,priest,shadow,36,18,18
Токиото,gordunni,1408,priest,shadow,30,15,15
Сашашвд,howling-fjord,1407,priest,shadow,42,22,20
Dopey,kazzak,1406,priest,shadow,24,17,7
Dotsin,kazzak,1406,priest,shadow,124,61,63
Mojoo,aggramar,1405,priest,shadow,26,16,10
Niecheqt,tarren-mill,1403,priest,shadow,44,24,20
Tazera,boulderfist,1403,priest,shadow,66,33,33
Experimentix,silvermoon,1402,priest,shadow,30,16,14
Voidbro,grim-batol,1401,priest,shadow,29,15,14
Fosil,xavius,1400,priest,shadow,36,18,18
Isusgaspodi,argent-dawn,1399,priest,shadow,103,57,46
Nicorøbin,uldum,1398,priest,shadow,62,37,25
Nightshådøw,silvermoon,1398,priest,shadow,122,64,58
Lamess,drakthul,1397,priest,shadow,49,30,19
Ohboy,eredar,1397,priest,shadow,60,29,31
Xíøn,draenor,1397,priest,shadow,35,16,19
Divledann,lightnings-blade,1395,priest,shadow,30,18,12
Низара,deathguard,1395,priest,shadow,54,22,32
Sxynix,thrall,1394,priest,shadow,41,24,17
Zevulós,ravencrest,1393,priest,shadow,71,26,45
Дэспира,howling-fjord,1391,priest,shadow,28,16,12
Chokipoki,twisting-nether,1390,priest,shadow,30,17,13
Ammp,outland,1390,priest,shadow,124,66,58
Mylini,silvermoon,1390,priest,shadow,95,50,45
Nemw,chamber-of-aspects,1389,priest,shadow,34,21,13
Chillx,blackmoore,1389,priest,shadow,162,94,68
Voidpbody,nerathor,1388,priest,shadow,29,16,13
Squîzz,archimonde,1387,priest,shadow,57,27,30
Сариандра,gordunni,1386,priest,shadow,68,39,29
Superdude,stormscale,1386,priest,shadow,37,17,20
Ðotgød,nemesis,1385,priest,shadow,24,18,6
Hek,sylvanas,1384,priest,shadow,72,36,36
Fordöbroo,ragnaros,1383,priest,shadow,174,91,83
Daenie,elune,1383,priest,shadow,42,21,21
Damyo,eredar,1381,priest,shadow,54,29,25
Nairima,argent-dawn,1377,priest,shadow,30,15,15
Zinxe,ravencrest,1374,priest,shadow,31,19,12
Ðivinà,archimonde,1371,priest,shadow,30,16,14
Shinígamí,frostmane,1370,priest,shadow,54,28,26
Seneth,twisting-nether,1368,priest,shadow,100,49,51
Atheniss,drakthul,1366,priest,shadow,60,34,26
Rogmisa,cthun,1366,priest,shadow,54,30,24
Eryxial,antonidas,1365,priest,shadow,47,22,25
Shizo,blutkessel,1364,priest,shadow,29,20,9
Synexia,sylvanas,1364,priest,shadow,99,56,43
Bimboxo,argent-dawn,1363,priest,shadow,137,78,59
Sucukpriest,blackrock,1363,priest,shadow,42,23,19
Daltheria,daggerspine,1358,priest,shadow,77,44,33
Имморталрё,galakrond,1354,priest,shadow,42,29,13
Kourroucé,archimonde,1354,priest,shadow,137,70,67
Офинсия,deathguard,1354,priest,shadow,47,18,29
Вексион,goldrinn,1353,priest,shadow,36,19,17
Силесттиль,gordunni,1353,priest,shadow,58,29,29
Adssdfhjgh,outland,1350,priest,shadow,32,22,10
Aleetheia,silvermoon,1350,priest,shadow,155,77,78
Ulquiørra,blackmoore,1349,priest,shadow,60,31,29
Hoon,destromath,1345,priest,shadow,60,31,29
Nyróx,malganis,1345,priest,shadow,122,59,63
Gumayusi,ravencrest,1344,priest,shadow,24,14,10
Нинаврач,howling-fjord,1344,priest,shadow,24,14,10
ßeastx,nethersturm,1344,priest,shadow,36,19,17
Syreet,silvermoon,1342,priest,shadow,24,14,10
Alexwinkwink,kazzak,1342,priest,shadow,24,14,10
Amazingame,tarren-mill,1342,priest,shadow,30,14,16
Возрождающее,soulflayer,1342,priest,shadow,30,14,16
Vtspam,stormscale,1341,priest,shadow,24,14,10
Maysiex,twisting-nether,1341,priest,shadow,24,14,10
Slimshadey,malganis,1341,priest,shadow,24,14,10
Apuessii,dun-modr,1340,priest,shadow,59,31,28
Shadowsister,burning-blade,1340,priest,shadow,42,20,22
Velenthøs,argent-dawn,1338,priest,shadow,41,23,18
Morteous,twisting-nether,1338,priest,shadow,265,136,129
Wtrix,stormscale,1337,priest,shadow,24,14,10
Hecaté,blackhand,1337,priest,shadow,55,31,24
Emilyvvillis,outland,1337,priest,shadow,36,14,22
Весенняя,gordunni,1336,priest,shadow,44,25,19
Шаасит,soulflayer,1336,priest,shadow,30,17,13
Seni,gilneas,1336,priest,shadow,55,26,29
Zerovision,nemesis,1335,priest,shadow,24,14,10
Sleepyshadow,drakthul,1335,priest,shadow,60,29,31
Gød,magtheridon,1335,priest,shadow,30,14,16
Settemsen,tarren-mill,1334,priest,shadow,18,14,4
Morgoh,die-arguswacht,1334,priest,shadow,84,45,39
Broncos,twisting-nether,1331,priest,shadow,58,33,25
Inei,doomhammer,1331,priest,shadow,48,25,23
Donkyrobert,tarren-mill,1331,priest,shadow,30,14,16
Adägïo,dun-modr,1329,priest,shadow,96,41,55
Giruga,eredar,1327,priest,shadow,24,14,10
Dumámày,silvermoon,1326,priest,shadow,24,17,7
Callmegød,archimonde,1324,priest,shadow,24,14,10
Grouptherpst,draenor,1323,priest,shadow,24,14,10
Kertith,argent-dawn,1323,priest,shadow,153,75,78
Mellandoh,tarren-mill,1322,priest,shadow,53,31,22
Joniop,stormreaver,1322,priest,shadow,24,14,10
Khalphus,argent-dawn,1322,priest,shadow,36,15,21
Сэлунна,goldrinn,1321,priest,shadow,36,14,22
Shadowsig,silvermoon,1319,priest,shadow,30,14,16
Kdot,drakthul,1317,priest,shadow,24,16,8
Clergy,hellfire,1317,priest,shadow,55,33,22
Littlebugger,argent-dawn,1317,priest,shadow,63,28,35
Míjagí,blackhand,1314,priest,shadow,59,30,29
Meloo,dalaran,1313,priest,shadow,103,54,49
Gauge,frostmane,1312,priest,shadow,150,77,73
Lathas,bloodfeather,1311,priest,shadow,36,23,13
Saviour,spinebreaker,1311,priest,shadow,42,23,19
Prästpojken,frostwhisper,1311,priest,shadow,36,19,17
Lurmus,outland,1311,priest,shadow,30,15,15
Xxede,dun-modr,1310,priest,shadow,81,37,44
Kasyrra,sylvanas,1309,priest,shadow,79,42,37
Хоозяин,blackscar,1308,priest,shadow,18,14,4
Ggdoll,twisting-nether,1308,priest,shadow,191,97,94
Battlefog,turalyon,1307,priest,shadow,54,29,25
Redoubtablee,kazzak,1306,priest,shadow,42,16,26
Secundis,silvermoon,1305,priest,shadow,30,16,14
Kåz,argent-dawn,1301,priest,shadow,35,21,14
Inzàné,kazzak,1301,priest,shadow,82,46,36
Unerfedsp,archimonde,1297,priest,shadow,139,66,73
Aíushtha,frostmane,1295,priest,shadow,36,14,22
Røst,ravencrest,1294,priest,shadow,23,14,9
Shifune,blackhand,1293,priest,shadow,54,25,29
Hexmon,tarren-mill,1292,priest,shadow,30,21,9
Slenderdoom,stormscale,1291,priest,shadow,24,14,10
Цитамин,deathguard,1291,priest,shadow,85,39,46
Boomboxk,darksorrow,1290,priest,shadow,24,15,9
Абасали,howling-fjord,1290,priest,shadow,54,22,32
Васпохилить,howling-fjord,1289,priest,shadow,90,39,51
Eytrhfb,stormscale,1288,priest,shadow,24,14,10
Piixld,aegwynn,1288,priest,shadow,54,28,26
Prøfesor,nemesis,1284,priest,shadow,33,15,18
Eslo,outland,1280,priest,shadow,38,17,21
Nagatary,blackmoore,1279,priest,shadow,66,35,31
Psystorm,frostmane,1279,priest,shadow,36,18,18
Kíssme,archimonde,1277,priest,shadow,30,21,9
Неймхичгодх,gordunni,1277,priest,shadow,28,15,13
Chowhone,archimonde,1277,priest,shadow,42,14,28
Bonifacio,la-croisade-écarlate,1276,priest,shadow,30,14,16
Voidlord,hyjal,1275,priest,shadow,60,31,29
Fåith,twilights-hammer,1275,priest,shadow,90,46,44
Onskansmoder,shattered-hand,1274,priest,shadow,69,33,36
Oöm,hyjal,1271,priest,shadow,30,20,10
Seehz,ysondre,1271,priest,shadow,35,14,21
Kristiflicka,kazzak,1268,priest,shadow,42,26,16
Daretox,turalyon,1268,priest,shadow,34,15,19
Ваккарий,gordunni,1266,priest,shadow,106,55,51
Nûwa,draenor,1265,priest,shadow,24,18,6
Dazé,ravencrest,1263,priest,shadow,45,22,23
Evilspel,ravencrest,1261,priest,shadow,33,18,15
Controlled,tarren-mill,1261,priest,shadow,71,35,36
Mundwerk,malganis,1260,priest,shadow,153,70,83
Hëllokitty,sanguino,1253,priest,shadow,86,42,44
Soulsuckerr,silvermoon,1249,priest,shadow,48,24,24
Bensherman,dalaran,1248,priest,shadow,18,13,5
Balthe,defias-brotherhood,1248,priest,shadow,18,13,5
Bizzlebabe,lightbringer,1247,priest,shadow,18,13,5
Xktr,aggra-português,1247,priest,shadow,18,13,5
Sadgepriest,draenor,1247,priest,shadow,24,13,11
Rippeep,emerald-dream,1247,priest,shadow,24,13,11
Testorwp,ragnaros,1245,priest,shadow,48,30,18
Majinmadara,ravencrest,1245,priest,shadow,28,14,14
Because,nemesis,1244,priest,shadow,18,13,5
Scade,kazzak,1243,priest,shadow,30,13,17
Drakzx,kazzak,1242,priest,shadow,18,13,5
Пристаболик,gordunni,1242,priest,shadow,18,13,5
Henaheals,ragnaros,1242,priest,shadow,18,13,5
Shîn,aegwynn,1242,priest,shadow,139,68,71
Ruojatar,stormreaver,1241,priest,shadow,18,13,5
Greyford,blackhand,1240,priest,shadow,18,13,5
Peikkousva,twisting-nether,1240,priest,shadow,24,13,11
Lilyrosemary,arathor,1239,priest,shadow,24,13,11
Buan,blackmoore,1236,priest,shadow,24,13,11
Szalsza,arathor,1236,priest,shadow,41,18,23
Bonbonici,sylvanas,1235,priest,shadow,30,21,9
Horrðr,kazzak,1235,priest,shadow,24,13,11
Pehmoinen,korgall,1233,priest,shadow,24,13,11
Omnissiiah,silvermoon,1232,priest,shadow,54,24,30
Sodomix,tarren-mill,1227,priest,shadow,178,92,86
Delaiya,antonidas,1227,priest,shadow,60,27,33
Smâshëd,stormscale,1225,priest,shadow,42,19,23
Vilhiil,darksorrow,1224,priest,shadow,31,14,17
Enemypriest,argent-dawn,1223,priest,shadow,42,20,22
Powna,blackrock,1222,priest,shadow,42,21,21
Shadowchunks,argent-dawn,1222,priest,shadow,26,13,13
Seum,ravencrest,1218,priest,shadow,30,13,17
Tesz,perenolde,1217,priest,shadow,36,16,20
Bromiaris,dun-morogh,1217,priest,shadow,30,13,17
Yonaka,amanthul,1216,priest,shadow,102,44,58
Montane,wrathbringer,1215,priest,shadow,18,13,5
Skuggzter,outland,1215,priest,shadow,42,26,16
Kagarr,kazzak,1214,priest,shadow,33,17,16
Xanelor,tarren-mill,1213,priest,shadow,30,17,13
Damnedangel,drakthul,1212,priest,shadow,30,13,17
Mirelaw,stormscale,1210,priest,shadow,84,53,31
Neychen,blackrock,1209,priest,shadow,30,13,17
Cptnahab,blackmoore,1206,priest,shadow,49,35,14
Zedrus,azshara,1206,priest,shadow,29,13,16
Ayuntamiento,proudmoore,1202,priest,shadow,36,23,13
Mylox,blackrock,1200,priest,shadow,22,14,8
Gaidemar,blackmoore,1200,priest,shadow,48,24,24
Farseerx,ravencrest,1194,priest,shadow,135,74,61
Veshania,blackhand,1194,priest,shadow,56,25,31
Абсорб,gordunni,1193,priest,shadow,24,13,11
Avatars,kirin-tor,1188,priest,shadow,64,33,31
Ælîta,blackhand,1186,priest,shadow,42,26,16
Foxiekitten,tarren-mill,1178,priest,shadow,22,13,9
Alaeddin,kazzak,1177,priest,shadow,96,45,51
Cottyx,outland,1176,priest,shadow,22,13,9
Cronershadow,stormscale,1176,priest,shadow,32,15,17
Driptoohard,archimonde,1165,priest,shadow,19,14,5
Tiinia,hyjal,1165,priest,shadow,40,15,25
Mynithir,chants-éternels,1163,priest,shadow,36,18,18
Holymonstah,sanguino,1161,priest,shadow,46,24,22
Sayash,chamber-of-aspects,1158,priest,shadow,26,13,13
Scaryman,ravencrest,1157,priest,shadow,23,14,9
Миссклик,goldrinn,1156,priest,shadow,22,13,9
Thergozar,stormscale,1153,priest,shadow,60,37,23
Dogstav,kazzak,1152,priest,shadow,24,12,12
Aritrosp,kargath,1152,priest,shadow,24,12,12
Hotdog,kult-der-verdammten,1152,priest,shadow,42,20,22
Julîane,aegwynn,1151,priest,shadow,18,12,6
Мсикатана,gordunni,1151,priest,shadow,18,12,6
Cyrená,ravencrest,1151,priest,shadow,18,12,6
Grayraven,azjolnerub,1151,priest,shadow,36,12,24
Dingqt,chogall,1150,priest,shadow,24,12,12
Psychø,kazzak,1149,priest,shadow,24,12,12
Onlyfansp,ravencrest,1149,priest,shadow,30,12,18
Pórt,kazzak,1148,priest,shadow,21,13,8
Söörpriest,the-maelstrom,1148,priest,shadow,30,16,14
Harukaa,aggra-português,1147,priest,shadow,24,19,5
Zetapp,argent-dawn,1147,priest,shadow,24,12,12
Tweenitopg,les-clairvoyants,1146,priest,shadow,18,12,6
Turbosucc,burning-blade,1146,priest,shadow,30,12,18
Отчепадре,gordunni,1145,priest,shadow,24,12,12
Kirrako,tarren-mill,1145,priest,shadow,24,12,12
Abjure,silvermoon,1144,priest,shadow,24,12,12
Lasdrael,dun-modr,1141,priest,shadow,66,34,32
Medovina,silvermoon,1139,priest,shadow,18,12,6
Qsandria,ravencrest,1139,priest,shadow,24,12,12
Дитеприста,greymane,1138,priest,shadow,24,15,9
Hârlequin,draenor,1138,priest,shadow,281,141,140
Дикосвет,howling-fjord,1137,priest,shadow,48,15,33
Eliana,blackrock,1136,priest,shadow,18,12,6
Suurona,die-aldor,1135,priest,shadow,54,26,28
Evna,chogall,1135,priest,shadow,30,12,18
Fuzzydude,ravencrest,1135,priest,shadow,36,12,24
Evypriest,draenor,1133,priest,shadow,24,12,12
Cerbero,doomhammer,1128,priest,shadow,18,12,6
Семмэр,gordunni,1125,priest,shadow,73,31,42
Maximandreic,kazzak,1124,priest,shadow,42,13,29
Реврос,gordunni,1118,priest,shadow,26,13,13
Ocastia,antonidas,1116,priest,shadow,18,12,6
Druska,ragnaros,1116,priest,shadow,42,23,19
Spwin,silvermoon,1116,priest,shadow,36,16,20
Абракабра,howling-fjord,1116,priest,shadow,30,12,18
Cabalist,silvermoon,1115,priest,shadow,114,58,56
Shidoya,tarren-mill,1114,priest,shadow,23,12,11
Ziglinde,shattrath,1113,priest,shadow,30,16,14
Уртримас,gordunni,1110,priest,shadow,42,18,24
Angleka,argent-dawn,1105,priest,shadow,101,45,56
Nellytaa,dalaran,1103,priest,shadow,35,18,17
Yuhé,elune,1100,priest,shadow,24,16,8
Sáro,ravencrest,1099,priest,shadow,24,13,11
Акциуми,howling-fjord,1097,priest,shadow,76,43,33
Ðizzi,dun-modr,1096,priest,shadow,21,14,7
Bonka,sanguino,1093,priest,shadow,24,13,11
Ixdeadxl,stormscale,1093,priest,shadow,30,13,17
Cthulou,tarren-mill,1092,priest,shadow,200,100,100
Alsyidan,khaz-modan,1091,priest,shadow,19,17,2
Hellena,neptulon,1089,priest,shadow,42,21,21
Equalìzer,ravencrest,1087,priest,shadow,14,12,2
Crishroc,stormreaver,1084,priest,shadow,42,20,22
Brainwash,darksorrow,1084,priest,shadow,28,12,16
Frëyha,archimonde,1082,priest,shadow,49,28,21
Ниомана,gordunni,1077,priest,shadow,28,17,11
Амфетаминная,howling-fjord,1076,priest,shadow,32,18,14
Valdemar,alakir,1075,priest,shadow,33,18,15
Sacher,shendralar,1074,priest,shadow,72,34,38
Тэтсу,greymane,1073,priest,shadow,36,22,14
Некросиний,eversong,1072,priest,shadow,25,14,11
Løxi,blackmoore,1070,priest,shadow,19,13,6
Syfl,defias-brotherhood,1060,priest,shadow,30,13,17
Phasmofobia,ragnaros,1059,priest,shadow,38,20,18
Kishoengi,ravencrest,1056,priest,shadow,12,11,1
Gladinbedirl,ravencrest,1056,priest,shadow,12,11,1
Mindseven,emeriss,1056,priest,shadow,18,11,7
Draryanna,nemesis,1056,priest,shadow,18,11,7
Häst,the-maelstrom,1055,priest,shadow,15,12,3
Noyam,dun-morogh,1055,priest,shadow,24,11,13
Elyziz,tarren-mill,1054,priest,shadow,18,11,7
Нед,greymane,1054,priest,shadow,18,11,7
Uzü,ysondre,1054,priest,shadow,28,12,16
Khålyst,archimonde,1054,priest,shadow,30,11,19
Шанэкс,howling-fjord,1053,priest,shadow,12,11,1
Umyqt,ragnaros,1053,priest,shadow,18,11,7
Говорун,grom,1053,priest,shadow,18,11,7
Peaksp,stormscale,1053,priest,shadow,18,11,7
Dexploit,frostwolf,1053,priest,shadow,18,11,7
Yoggies,tarren-mill,1053,priest,shadow,21,12,9
Санятруу,blackscar,1053,priest,shadow,78,42,36
Блюмсик,blackscar,1052,priest,shadow,30,18,12
Jadæ,ragnaros,1052,priest,shadow,24,11,13
Simularcum,tarren-mill,1052,priest,shadow,24,11,13
Tigrok,burning-legion,1050,priest,shadow,18,11,7
Phobò,blackrock,1050,priest,shadow,24,11,13
Dardinio,ravencrest,1049,priest,shadow,30,11,19
Вэйворс,blackscar,1048,priest,shadow,22,12,10
Zák,sylvanas,1048,priest,shadow,30,16,14
Sundae,nemesis,1048,priest,shadow,30,11,19
Xatori,arthas,1047,priest,shadow,24,11,13
Zubrowkâ,kazzak,1043,priest,shadow,24,11,13
Missadventur,skullcrusher,1041,priest,shadow,18,11,7
Holypowér,twisting-nether,1041,priest,shadow,24,11,13
Mistaké,the-maelstrom,1039,priest,shadow,42,18,24
Sigor,hellfire,1039,priest,shadow,29,12,17
Atelstan,drakthul,1030,priest,shadow,72,29,43
Umbrazoid,sanguino,1030,priest,shadow,36,11,25
Festiz,tichondrius,1024,priest,shadow,30,14,16
Кинраналь,eversong,1021,priest,shadow,30,17,13
Shdwmeld,ravencrest,1020,priest,shadow,23,11,12
Mimox,kaelthas,1017,priest,shadow,24,14,10
Bodeeney,hellfire,1015,priest,shadow,68,28,40
Shíàpríést,kazzak,1015,priest,shadow,35,11,24
Tarissa,ravenholdt,1008,priest,shadow,24,12,12
Lisua,blackmoore,1008,priest,shadow,48,15,33
Phïljr,ravencrest,1007,priest,shadow,18,11,7
Iceys,stormscale,1005,priest,shadow,17,11,6
Jawoflash,antonidas,1004,priest,shadow,27,12,15
Froffzy,tarren-mill,1002,priest,shadow,30,12,18
Лапушок,borean-tundra,1001,priest,shadow,24,13,11
Fanberra,the-venture-co,1001,priest,shadow,24,11,13
Mydianá,aegwynn,999,priest,shadow,23,14,9
Beellzo,sylvanas,997,priest,shadow,57,21,36
Caballococo,dun-modr,994,priest,shadow,114,50,64
Серебрия,gordunni,991,priest,shadow,63,35,28
Pipen,stormscale,990,priest,shadow,29,11,18
Portvin,terenas,989,priest,shadow,56,21,35
Asdaprice,hellfire,986,priest,shadow,18,12,6
Minabonxx,silvermoon,984,priest,shadow,93,34,59
Zargoss,sylvanas,974,priest,shadow,19,11,8
Мргорсан,eversong,974,priest,shadow,30,16,14
Kasimobbel,alexstrasza,962,priest,shadow,55,16,39
Reimagined,sylvanas,960,priest,shadow,12,10,2
Sinsofmany,ragnaros,960,priest,shadow,12,10,2
Theythem,stormscale,960,priest,shadow,12,10,2
Achára,ravencrest,960,priest,shadow,18,10,8
Cometopastor,skullcrusher,960,priest,shadow,18,10,8
Drë,daggerspine,960,priest,shadow,18,10,8
Peep,emerald-dream,960,priest,shadow,18,10,8
Gbc,emerald-dream,960,priest,shadow,18,10,8
Swl,blackrock,960,priest,shadow,22,11,11
Tribz,kargath,959,priest,shadow,12,10,2
Aiewn,elune,959,priest,shadow,18,12,6
Gwyneth,archimonde,959,priest,shadow,24,14,10
Seankingkong,ravencrest,959,priest,shadow,18,10,8
Ialoricha,dun-modr,959,priest,shadow,18,10,8
Zapreyy,kazzak,959,priest,shadow,18,10,8
Fluffedup,twisting-nether,959,priest,shadow,18,10,8
Goodison,outland,959,priest,shadow,24,10,14
Supriest,alakir,959,priest,shadow,24,10,14
Ciqua,frostmane,958,priest,shadow,16,11,5
Ravenbell,chamber-of-aspects,958,priest,shadow,18,10,8
Diha,argent-dawn,958,priest,shadow,18,10,8
Qiandra,argent-dawn,958,priest,shadow,24,10,14
Seenoend,neptulon,957,priest,shadow,18,10,8
Vo,dentarg,957,priest,shadow,24,10,14
Deshaz,tarren-mill,957,priest,shadow,24,10,14
Taxthepoor,blackhand,955,priest,shadow,24,10,14
Khäñ,ravencrest,955,priest,shadow,36,10,26
Twisty,malganis,953,priest,shadow,26,15,11
Wewo,drakthul,952,priest,shadow,27,11,16
Nekemtenee,magtheridon,951,priest,shadow,18,10,8
Otheym,the-maelstrom,948,priest,shadow,24,10,14
Иннй,howling-fjord,947,priest,shadow,24,11,13
Brainmuscle,ravencrest,945,priest,shadow,12,10,2
Szpinx,stormscale,942,priest,shadow,30,10,20
Эсттелла,gordunni,941,priest,shadow,72,33,39
Ruhoniy,ysondre,934,priest,shadow,30,17,13
Abrakahudder,tarren-mill,927,priest,shadow,17,10,7
Умом,gordunni,927,priest,shadow,26,11,15
Xartasfen,archimonde,926,priest,shadow,20,11,9
Силабездны,deathguard,926,priest,shadow,67,34,33
Aezef,ysondre,926,priest,shadow,26,11,15
Satànâs,twisting-nether,919,priest,shadow,17,10,7
Kloown,conseil-des-ombres,917,priest,shadow,47,24,23
Dayowe,antonidas,916,priest,shadow,166,80,86
Fârge,elune,911,priest,shadow,17,10,7
Csksablanca,sargeras,911,priest,shadow,17,10,7
Priestoll,draenor,911,priest,shadow,21,10,11
Valaç,turalyon,910,priest,shadow,21,10,11
Shaaq,stormscale,905,priest,shadow,12,11,1
Reckpump,twisting-nether,891,priest,shadow,23,10,13
Triinkett,doomhammer,881,priest,shadow,75,31,44
Pneumay,tarren-mill,878,priest,shadow,18,10,8
Clori,argent-dawn,864,priest,shadow,12,9,3
Alinfinito,ravencrest,864,priest,shadow,12,9,3
Tailjob,silvermoon,864,priest,shadow,12,9,3
Raffá,blackhand,864,priest,shadow,12,9,3
Sonah,der-abyssische-rat,864,priest,shadow,12,9,3
Hanyk,kazzak,864,priest,shadow,12,9,3
Anabølixx,ravencrest,864,priest,shadow,12,9,3
Honeydots,ravencrest,864,priest,shadow,12,9,3
Tylb,tarren-mill,864,priest,shadow,12,9,3
Døtgdx,archimonde,864,priest,shadow,12,9,3
Фримекс,soulflayer,864,priest,shadow,12,9,3
Svagis,draenor,864,priest,shadow,18,9,9
Cruncher,ravencrest,864,priest,shadow,18,9,9
Spyrono,kazzak,864,priest,shadow,18,9,9
Felaenna,argent-dawn,864,priest,shadow,18,9,9
Manyus,archimonde,864,priest,shadow,18,9,9
Æåeåeåé,twisting-nether,864,priest,shadow,18,9,9
Brobox,blackmoore,864,priest,shadow,18,9,9
Fjonnski,blackmoore,864,priest,shadow,21,10,11
Ok,blackrock,864,priest,shadow,24,9,15
Schmatzy,blackmoore,864,priest,shadow,24,9,15
Späxxi,amanthul,863,priest,shadow,12,9,3
Pewkz,draenor,863,priest,shadow,12,9,3
Potati,defias-brotherhood,863,priest,shadow,12,9,3
Klayjamin,draenor,863,priest,shadow,12,9,3
Azsaryn,magtheridon,863,priest,shadow,18,9,9
Tygstycke,tarren-mill,863,priest,shadow,18,9,9
Ризорпанда,soulflayer,863,priest,shadow,18,9,9
Txypii,dun-modr,863,priest,shadow,18,9,9
Наярда,howling-fjord,863,priest,shadow,18,9,9
Вайзмейстер,blackscar,863,priest,shadow,18,9,9
Qzrx,outland,863,priest,shadow,18,9,9
Alterspflege,eredar,863,priest,shadow,18,9,9
Prodan,frostmane,862,priest,shadow,12,9,3
Kaleycuoco,blackrock,862,priest,shadow,12,9,3
Skaliq,tarren-mill,862,priest,shadow,12,9,3
Oblivita,twisting-nether,862,priest,shadow,18,9,9
Ilostmybible,runetotem,862,priest,shadow,24,9,15
Aelwïn,ysondre,861,priest,shadow,12,9,3
Dívíne,ravenholdt,861,priest,shadow,12,9,3
Dutchstuff,karazhan,861,priest,shadow,18,9,9
Kavie,ravencrest,861,priest,shadow,18,9,9
Claudefrollo,the-maelstrom,861,priest,shadow,19,9,10
Pristara,bloodhoof,860,priest,shadow,12,9,3
Priëstitute,stormscale,860,priest,shadow,12,9,3
Plimpi,blackmoore,860,priest,shadow,18,9,9
Rèd,antonidas,860,priest,shadow,30,9,21
Kìckurâss,aegwynn,859,priest,shadow,24,9,15
Дроус,borean-tundra,858,priest,shadow,30,12,18
Elfriede,twisting-nether,856,priest,shadow,12,9,3
Farilight,draenor,850,priest,shadow,12,9,3
Ethalia,kirin-tor,849,priest,shadow,18,9,9
Madizuluka,aggra-português,849,priest,shadow,27,10,17
Ftiersp,ravencrest,847,priest,shadow,17,9,8
Trencharse,draenor,845,priest,shadow,23,9,14
Shaddyr,thrall,828,priest,shadow,17,9,8
Endchor,eredar,826,priest,shadow,37,16,21
Happychap,stormreaver,815,priest,shadow,21,9,12
Boomhilde,aegwynn,813,priest,shadow,23,9,14
Stoffig,aggramar,806,priest,shadow,18,9,9
Bäckay,silvermoon,799,priest,shadow,16,9,7
Õðæßìùa,kazzak,799,priest,shadow,17,9,8
Arunp,magtheridon,799,priest,shadow,26,9,17
Alicanx,silvermoon,798,priest,shadow,17,9,8
Deadlymoda,zenedar,797,priest,shadow,20,9,11
Calor,nemesis,792,priest,shadow,16,9,7
Djstache,tarren-mill,768,priest,shadow,12,8,4
Nätrix,tarren-mill,768,priest,shadow,12,8,4
Jynii,eredar,768,priest,shadow,12,8,4
Evílshadows,tarren-mill,768,priest,shadow,12,8,4
Shadowirl,ravencrest,768,priest,shadow,12,8,4
Spriestisbad,hyjal,768,priest,shadow,12,8,4
Ktulsotum,twisting-nether,768,priest,shadow,12,8,4
Notthatbad,draenor,768,priest,shadow,12,8,4
Raëkon,nemesis,768,priest,shadow,12,8,4
Диградейшен,gordunni,768,priest,shadow,12,8,4
Шадоуприст,blackscar,768,priest,shadow,12,8,4
Inavea,hyjal,768,priest,shadow,12,8,4
Strvnge,stormreaver,768,priest,shadow,17,8,9
Hizumi,stormreaver,768,priest,shadow,18,8,10
Ahle,darkspear,768,priest,shadow,18,8,10
Hilerki,draenor,768,priest,shadow,18,8,10
Хелектро,deathweaver,768,priest,shadow,18,8,10
Gomor,mannoroth,768,priest,shadow,18,8,10
Jaanny,defias-brotherhood,768,priest,shadow,18,8,10
Jellypie,blackrock,768,priest,shadow,18,8,10
Джианитто,borean-tundra,767,priest,shadow,12,8,4
Zappikpriest,silvermoon,767,priest,shadow,12,8,4
Holineß,burning-blade,767,priest,shadow,12,8,4
Липоскай,howling-fjord,767,priest,shadow,12,8,4
Septembér,draenor,767,priest,shadow,12,8,4
Бравер,soulflayer,767,priest,shadow,12,8,4
Холиспирт,deathguard,767,priest,shadow,12,8,4
Симпоз,howling-fjord,767,priest,shadow,12,8,4
Leleg,blackhand,767,priest,shadow,15,9,6
Волкановская,eversong,767,priest,shadow,18,8,10
Unreal,nagrand,767,priest,shadow,18,8,10
Marcellina,argent-dawn,767,priest,shadow,18,8,10
Aereza,darkspear,767,priest,shadow,18,8,10
Dimorinny,silvermoon,767,priest,shadow,18,8,10
Urfkncringe,sylvanas,767,priest,shadow,18,8,10
Bigdumber,kazzak,767,priest,shadow,18,8,10
Maela,uldum,767,priest,shadow,18,8,10
Jyugins,alonsus,767,priest,shadow,18,8,10
Xuzilul,antonidas,767,priest,shadow,18,8,10
Priestlolx,aegwynn,767,priest,shadow,24,8,16
Maskinjundre,bronzebeard,767,priest,shadow,24,8,16
Ехереу,blackscar,766,priest,shadow,12,8,4
Kumpi,azjolnerub,766,priest,shadow,12,8,4
Mavaai,burning-legion,766,priest,shadow,12,8,4
Aducanpea,blackmoore,766,priest,shadow,12,8,4
Ihaveibs,doomhammer,766,priest,shadow,19,9,10
Dvärg,ravencrest,766,priest,shadow,18,8,10
Darkmayham,silvermoon,766,priest,shadow,18,8,10
Comptonzity,outland,766,priest,shadow,18,8,10
Ичисанчик,howling-fjord,766,priest,shadow,24,8,16
Derl,pozzo-delleternità,765,priest,shadow,12,8,4
Johnnysp,eredar,765,priest,shadow,12,8,4
Géèk,alakir,765,priest,shadow,19,8,11
Blååb,draenor,765,priest,shadow,24,8,16
Shalnorei,drakthul,764,priest,shadow,12,8,4
Holyface,twisting-nether,764,priest,shadow,12,8,4
Каратэк,howling-fjord,763,priest,shadow,12,8,4
Sammel,moonglade,763,priest,shadow,18,8,10
Zathada,twisting-nether,763,priest,shadow,18,8,10
Ruad,blackrock,762,priest,shadow,12,8,4
Zakkonnik,burning-legion,762,priest,shadow,18,8,10
Лайкшеди,soulflayer,761,priest,shadow,12,8,4
Никорете,soulflayer,759,priest,shadow,18,8,10
Святаятряпка,fordragon,754,priest,shadow,18,8,10
Намдандар,howling-fjord,753,priest,shadow,18,8,10
Treasons,tarren-mill,752,priest,shadow,30,8,22
Barcodes,kazzak,749,priest,shadow,20,9,11
Teleriah,blackmoore,735,priest,shadow,17,8,9
Aeo,twisting-nether,732,priest,shadow,17,8,9
Zennen,ragnaros,720,priest,shadow,19,9,10
Chas,argent-dawn,720,priest,shadow,27,8,19
Nightchime,silvermoon,717,priest,shadow,11,8,3
Nbayoungboy,the-maelstrom,714,priest,shadow,20,10,10
Fathedead,stormreaver,713,priest,shadow,30,10,20
Fleshcraft,ravencrest,703,priest,shadow,14,8,6
Raetwo,stormscale,703,priest,shadow,14,8,6
Манддалорец,gordunni,702,priest,shadow,22,8,14
Reptika,tichondrius,696,priest,shadow,16,8,8
Мараес,howling-fjord,686,priest,shadow,14,8,6
Ðarcø,archimonde,685,priest,shadow,25,8,17
Shendiva,nathrezim,681,priest,shadow,13,8,5
Libstik,hyjal,672,priest,shadow,12,7,5
Uria,moonglade,672,priest,shadow,12,7,5
Deethraa,argent-dawn,672,priest,shadow,12,7,5
Belìal,thrall,672,priest,shadow,12,7,5
Kíguwu,draenor,672,priest,shadow,12,7,5
Vladï,conseil-des-ombres,672,priest,shadow,12,7,5
Миррен,gordunni,672,priest,shadow,12,7,5
Xùÿø,culte-de-la-rive-noire,672,priest,shadow,12,7,5
Azazoth,sylvanas,672,priest,shadow,12,7,5
Cskgbénébéné,garona,672,priest,shadow,12,7,5
Påsøk,stormscale,672,priest,shadow,12,7,5
Roastie,frostmane,672,priest,shadow,12,7,5
Eriezel,shattered-halls,672,priest,shadow,12,7,5
Mcdutchy,arygos,672,priest,shadow,12,7,5
Extazia,ravencrest,672,priest,shadow,12,7,5
Mindboorst,kazzak,672,priest,shadow,12,7,5
Fairylite,outland,672,priest,shadow,12,7,5
Systerstål,twisting-nether,672,priest,shadow,12,7,5
Deform,argent-dawn,672,priest,shadow,12,7,5
Nordrenalin,tarren-mill,672,priest,shadow,12,7,5
Dolens,argent-dawn,672,priest,shadow,12,7,5
Moodzlol,eredar,672,priest,shadow,12,7,5
Laradiel,dun-modr,672,priest,shadow,12,7,5
Stevenfly,outland,672,priest,shadow,12,7,5
Vittelk,stormscale,672,priest,shadow,12,7,5
Leggat,draenor,672,priest,shadow,15,8,7
Рэйам,fordragon,672,priest,shadow,18,7,11
Клаенз,fordragon,672,priest,shadow,18,7,11
Crazyname,outland,672,priest,shadow,18,7,11
Heygoogle,ravencrest,672,priest,shadow,18,7,11
Umayyaa,sylvanas,672,priest,shadow,18,7,11
Majinbuù,sargeras,672,priest,shadow,18,7,11
Irlfatguy,ravencrest,672,priest,shadow,20,7,13
Serayhx,blackrock,672,priest,shadow,24,7,17
Scorbute,conseil-des-ombres,671,priest,shadow,12,7,5
Karnatia,burning-legion,671,priest,shadow,12,7,5
Xæe,blackrock,671,priest,shadow,12,7,5
Слышуфонк,howling-fjord,671,priest,shadow,12,7,5
Мариаглорум,gordunni,671,priest,shadow,12,7,5
Shiekma,norgannon,671,priest,shadow,12,7,5
Neeyø,blackhand,671,priest,shadow,12,7,5
Syntára,blackhand,671,priest,shadow,12,7,5
Kogarrashi,aegwynn,671,priest,shadow,12,7,5
Cryptoniite,kazzak,671,priest,shadow,12,7,5
Elarya,zenedar,671,priest,shadow,12,7,5
Allanna,talnivarr,671,priest,shadow,12,7,5
Badomens,draenor,671,priest,shadow,12,7,5
Bazazath,thrall,671,priest,shadow,15,8,7
Freshpope,ravencrest,671,priest,shadow,16,8,8
Idontmind,eredar,671,priest,shadow,18,7,11
Chaarronn,drakthul,671,priest,shadow,18,7,11
Jerolol,sanguino,671,priest,shadow,18,7,11
Gooflord,ravencrest,671,priest,shadow,18,7,11
Deriont,argent-dawn,671,priest,shadow,18,7,11
Neggan,chamber-of-aspects,671,priest,shadow,18,7,11
Wivienne,defias-brotherhood,671,priest,shadow,26,8,18
Haxxøn,die-nachtwache,670,priest,shadow,12,7,5
Voina,ravencrest,670,priest,shadow,12,7,5
Kitasia,tarren-mill,670,priest,shadow,12,7,5
Hiela,outland,670,priest,shadow,12,7,5
Rétestészta,arathor,670,priest,shadow,12,7,5
Copperplume,ravenholdt,670,priest,shadow,12,7,5
Antigospa,kazzak,670,priest,shadow,18,7,11
Ансин,azuregos,669,priest,shadow,12,7,5
Hotsanddots,auchindoun,668,priest,shadow,12,7,5
Hulluh,tarren-mill,665,priest,shadow,12,7,5
Nerfnerf,kazzak,663,priest,shadow,22,10,12
Redfield,frostmane,663,priest,shadow,24,7,17
Spaghettoni,tarren-mill,662,priest,shadow,12,7,5
Swarzie,outland,653,priest,shadow,17,7,10
Vregoa,twisting-nether,639,priest,shadow,17,7,10
Reeflix,blackmoore,607,priest,shadow,17,8,9
Thudre,ravencrest,606,priest,shadow,14,7,7
Lipzip,twisting-nether,591,priest,shadow,19,7,12
Deadandugly,eredar,576,priest,shadow,6,6,0
Адария,booty-bay,576,priest,shadow,6,6,0
Shacoat,draenor,576,priest,shadow,6,6,0
Viánná,sylvanas,576,priest,shadow,10,7,3
Noggorran,teldrassil,576,priest,shadow,10,7,3
Littlefräu,ravencrest,576,priest,shadow,10,7,3
Yixi,blackmoore,576,priest,shadow,12,6,6
Cluelêss,blackrock,576,priest,shadow,12,6,6
Lilsayx,blackrock,576,priest,shadow,12,6,6
Saliâ,blackmoore,576,priest,shadow,12,6,6
Шучунекошмар,soulflayer,576,priest,shadow,12,6,6
Submeplz,stormscale,576,priest,shadow,12,6,6
Бранлор,howling-fjord,576,priest,shadow,12,6,6
Lovelessp,stormscale,576,priest,shadow,12,6,6
Cocolasticot,garona,576,priest,shadow,12,6,6
Skillmåster,ravencrest,576,priest,shadow,12,6,6
Kunayu,ravencrest,576,priest,shadow,12,6,6
Dakystepmom,stormreaver,576,priest,shadow,12,6,6
Arratør,ysondre,576,priest,shadow,12,6,6
Shadoxx,malganis,576,priest,shadow,12,6,6
Старлайтх,gordunni,576,priest,shadow,12,6,6
Farotep,tarren-mill,576,priest,shadow,12,6,6
Deekon,argent-dawn,576,priest,shadow,12,6,6
Ztrolol,archimonde,576,priest,shadow,12,6,6
Prästjäväln,stormscale,576,priest,shadow,12,6,6
Despéri,ysondre,576,priest,shadow,12,6,6
Gorali,the-venture-co,576,priest,shadow,12,6,6
Toxxjq,sylvanas,576,priest,shadow,12,6,6
Skyfour,blackmoore,576,priest,shadow,12,6,6
Wakizashi,ravencrest,576,priest,shadow,12,6,6
Vogthon,aggra-português,576,priest,shadow,12,6,6
Mephiras,kult-der-verdammten,576,priest,shadow,12,6,6
Cultist,defias-brotherhood,576,priest,shadow,12,6,6
Noreal,twisting-nether,576,priest,shadow,12,6,6
Pepitzaftw,sylvanas,576,priest,shadow,12,6,6
Loldawg,stormscale,576,priest,shadow,12,6,6
Oniakusa,outland,576,priest,shadow,12,6,6
Kraanocska,outland,576,priest,shadow,12,6,6
Fluffieh,ravencrest,576,priest,shadow,12,6,6
Ellfle,kazzak,576,priest,shadow,12,6,6
Grapemachine,dentarg,576,priest,shadow,12,6,6
Dboi,tarren-mill,576,priest,shadow,12,6,6
Сакта,howling-fjord,576,priest,shadow,12,6,6
Sselycrem,dun-morogh,576,priest,shadow,12,6,6
Shadowpdots,sargeras,576,priest,shadow,12,6,6
Vardrium,antonidas,576,priest,shadow,12,6,6
Talandra,drakthul,576,priest,shadow,12,6,6
Landliebe,outland,576,priest,shadow,12,6,6
Balan,argent-dawn,576,priest,shadow,12,6,6
Styxpr,blackhand,576,priest,shadow,18,6,12
Ràvèn,dun-modr,576,priest,shadow,18,6,12
Øro,ysondre,576,priest,shadow,24,6,18
Shendilka,drakthul,575,priest,shadow,9,7,2
Лиройгеморой,gordunni,575,priest,shadow,12,6,6
Silverfate,outland,575,priest,shadow,12,6,6
Torquemad,sunstrider,575,priest,shadow,12,6,6
Bigorna,frostmane,575,priest,shadow,12,6,6
Sliey,blackrock,575,priest,shadow,12,6,6
Mariosee,wrathbringer,575,priest,shadow,12,6,6
Bozia,chamber-of-aspects,575,priest,shadow,12,6,6
Attaxx,dragonmaw,575,priest,shadow,12,6,6
Нитровина,howling-fjord,575,priest,shadow,12,6,6
Princéssà,aegwynn,575,priest,shadow,12,6,6
Husqvarnasåg,tarren-mill,575,priest,shadow,21,7,14
Wintercurse,twisting-nether,575,priest,shadow,18,6,12
Булькозавр,razuvious,574,priest,shadow,12,6,6
Luxumbra,pozzo-delleternità,574,priest,shadow,12,6,6
Azshanna,argent-dawn,574,priest,shadow,12,6,6
Sacreth,ragnaros,574,priest,shadow,24,6,18
Zerim,blackmoore,574,priest,shadow,24,6,18
Сендрагон,blackscar,572,priest,shadow,18,6,12
Karmapollys,silvermoon,570,priest,shadow,12,6,6
Karabin,culte-de-la-rive-noire,558,priest,shadow,18,6,12
Notcute,the-maelstrom,543,priest,shadow,11,6,5
Anshes,draenor,537,priest,shadow,10,7,3
Lildiggy,outland,511,priest,shadow,14,6,8
Нудная,galakrond,511,priest,shadow,16,6,10
Genjorss,pozzo-delleternità,480,priest,shadow,6,5,1
Arondir,defias-brotherhood,480,priest,shadow,6,5,1
Graveyards,tarren-mill,480,priest,shadow,6,5,1
Darkqt,ravencrest,480,priest,shadow,6,5,1
Disillusíon,tarren-mill,480,priest,shadow,6,5,1
Скизма,gordunni,480,priest,shadow,6,5,1
Qiguai,outland,480,priest,shadow,6,5,1
Fabulicious,blackrock,480,priest,shadow,6,5,1
Gladíator,blackhand,480,priest,shadow,6,5,1
Rinkahands,silvermoon,480,priest,shadow,6,5,1
Easyc,gorgonnash,480,priest,shadow,6,5,1
Pâww,kazzak,480,priest,shadow,6,5,1
Зоргдаркнесс,howling-fjord,480,priest,shadow,6,5,1
Attilerg,stormscale,480,priest,shadow,6,5,1
Zeawee,frostmane,480,priest,shadow,6,5,1
Алуриэлия,gordunni,480,priest,shadow,6,5,1
Nøskillzz,nemesis,480,priest,shadow,6,5,1
Boniesmack,stormscale,480,priest,shadow,6,5,1
Harkøn,draenor,480,priest,shadow,6,5,1
Qúetee,silvermoon,480,priest,shadow,10,6,4
Korzec,dun-modr,480,priest,shadow,12,5,7
Lyssandre,stormreaver,480,priest,shadow,12,5,7
Singularity,ravencrest,480,priest,shadow,12,5,7
Mondiie,drakthul,480,priest,shadow,12,5,7
Дакимакурах,gordunni,480,priest,shadow,12,5,7
Shadowful,drakthul,480,priest,shadow,12,5,7
Frv,tarren-mill,480,priest,shadow,12,5,7
Kidkuddo,blackmoore,480,priest,shadow,12,5,7
Megadima,norgannon,480,priest,shadow,12,5,7
Jarkk,ysondre,480,priest,shadow,12,5,7
Löspajen,stormscale,480,priest,shadow,12,5,7
Darkmus,quelthalas,480,priest,shadow,12,5,7
Tokkz,kelthuzad,480,priest,shadow,12,5,7
Prayypray,eredar,480,priest,shadow,12,5,7
Stickyjamxx,frostmane,480,priest,shadow,12,5,7
Neverfade,dun-modr,480,priest,shadow,12,5,7
Rovensin,ravencrest,480,priest,shadow,12,5,7
Sheerzo,twisting-nether,480,priest,shadow,12,5,7
Xpy,kazzak,480,priest,shadow,12,5,7
Mahist,ravencrest,480,priest,shadow,12,5,7
Bonsoin,kirin-tor,480,priest,shadow,12,5,7
Rokil,ravencrest,480,priest,shadow,12,5,7
Appraiser,draenor,480,priest,shadow,12,5,7
Lillclubbina,stormscale,480,priest,shadow,12,5,7
Taikki,stormreaver,480,priest,shadow,12,5,7
Qwertyuioasd,ravencrest,480,priest,shadow,12,5,7
Cmonbro,hyjal,480,priest,shadow,12,5,7
Shadowleech,ragnaros,480,priest,shadow,12,5,7
Dpyo,ravencrest,480,priest,shadow,12,5,7
Svenskabarn,twisting-nether,480,priest,shadow,12,5,7
Raeratwo,archimonde,480,priest,shadow,12,5,7
Drakharys,dun-modr,480,priest,shadow,12,5,7
Хенели,blackscar,480,priest,shadow,12,5,7
Elixier,frostmane,480,priest,shadow,12,5,7
Haiduka,burning-legion,480,priest,shadow,12,5,7
Môrtïciâ,tarren-mill,480,priest,shadow,12,5,7
Rexonaqq,kazzak,480,priest,shadow,12,5,7
Darrianna,outland,480,priest,shadow,12,5,7
Chibz,twisting-nether,480,priest,shadow,18,5,13
Moogie,archimonde,480,priest,shadow,18,5,13
Блэксикер,greymane,479,priest,shadow,12,5,7
Heinricht,ragnaros,479,priest,shadow,12,5,7
Rehpotsirhc,blackrock,479,priest,shadow,12,5,7
Tøucher,silvermoon,479,priest,shadow,12,5,7
Xieraxe,ravencrest,479,priest,shadow,12,5,7
Tronixcs,boulderfist,479,priest,shadow,12,5,7
Gimcho,magtheridon,479,priest,shadow,12,5,7
Балзик,blackscar,479,priest,shadow,12,5,7
Лейля,goldrinn,479,priest,shadow,18,5,13
Falbäla,suramar,473,priest,shadow,12,5,7
Wàks,dalaran,463,priest,shadow,11,6,5
Chïefpapi,twisting-nether,463,priest,shadow,11,5,6
Дзинкз,howling-fjord,448,priest,shadow,10,6,4
Sàd,thrall,447,priest,shadow,11,5,6
Kuusistöö,kazzak,430,priest,shadow,13,6,7
Bloodimand,terenas,422,priest,shadow,12,6,6
Elderath,eredar,409,priest,shadow,23,6,17
Grainbames,sylvanas,384,priest,shadow,6,4,2
Goldenapples,ravencrest,384,priest,shadow,6,4,2
Lysium,sylvanas,384,priest,shadow,6,4,2
Looó,los-errantes,384,priest,shadow,6,4,2
Virtualworld,ragnaros,384,priest,shadow,6,4,2
Stonymontana,ravencrest,384,priest,shadow,6,4,2
Majestíc,blackmoore,384,priest,shadow,6,4,2
Pinkfloydx,lightbringer,384,priest,shadow,6,4,2
Høly,chogall,384,priest,shadow,6,4,2
Вэстервилли,howling-fjord,384,priest,shadow,6,4,2
Atropin,silvermoon,384,priest,shadow,6,4,2
Олдмэнсэйд,soulflayer,384,priest,shadow,6,4,2
Éllipses,kazzak,384,priest,shadow,6,4,2
Jdotp,silvermoon,384,priest,shadow,6,4,2
Floodey,defias-brotherhood,384,priest,shadow,6,4,2
Daftî,twisting-nether,384,priest,shadow,6,4,2
Dokurochan,tarren-mill,384,priest,shadow,6,4,2
Napriest,kazzak,384,priest,shadow,6,4,2
Xxon,blackrock,384,priest,shadow,6,4,2
Viperbites,tarren-mill,384,priest,shadow,6,4,2
Ylenae,twisting-nether,384,priest,shadow,6,4,2
Awator,ysondre,384,priest,shadow,6,4,2
Rutah,the-maelstrom,384,priest,shadow,6,4,2
Lxz,twisting-nether,384,priest,shadow,6,4,2
Sekeios,sanguino,384,priest,shadow,6,4,2
Alicanx,twisting-nether,384,priest,shadow,6,4,2
Shadowboness,twisting-nether,384,priest,shadow,6,4,2
Spae,twisting-nether,384,priest,shadow,6,4,2
Clungeslag,argent-dawn,384,priest,shadow,6,4,2
Lorthonor,silvermoon,384,priest,shadow,6,4,2
Chamelthoe,the-maelstrom,384,priest,shadow,6,4,2
Usw,outland,384,priest,shadow,6,4,2
Трихоманиаз,ashenvale,384,priest,shadow,6,4,2
Текл,blackscar,384,priest,shadow,6,4,2
Nebunia,twisting-nether,384,priest,shadow,6,4,2
Cheryli,alleria,384,priest,shadow,6,4,2
Àæn,blackrock,384,priest,shadow,6,4,2
Torino,kazzak,384,priest,shadow,6,4,2
Coqa,blackrock,384,priest,shadow,6,4,2
Mønzie,stormscale,384,priest,shadow,6,4,2
Secretagentx,kazzak,384,priest,shadow,6,4,2
Mysticforces,silvermoon,384,priest,shadow,6,4,2
Jpxoxo,blackhand,384,priest,shadow,6,4,2
Dairox,blackrock,384,priest,shadow,6,4,2
Kobiden,stormreaver,384,priest,shadow,6,4,2
Pharli,stormscale,384,priest,shadow,6,4,2
Temtem,ravencrest,384,priest,shadow,6,4,2
Tøm,silvermoon,384,priest,shadow,6,4,2
Lumex,aegwynn,384,priest,shadow,6,4,2
Calsote,sanguino,384,priest,shadow,6,4,2
Sheid,zuljin,384,priest,shadow,6,4,2
Hotdoge,zenedar,384,priest,shadow,6,4,2
Alusiepriest,ravencrest,384,priest,shadow,6,4,2
Vantek,antonidas,384,priest,shadow,6,4,2
Metabeta,shattered-hand,384,priest,shadow,6,4,2
Syrïal,hyjal,384,priest,shadow,6,4,2
Arwen,azjolnerub,384,priest,shadow,6,4,2
Êlectron,ravencrest,384,priest,shadow,6,4,2
Torpedobæver,silvermoon,384,priest,shadow,6,4,2
Spum,ravencrest,384,priest,shadow,6,4,2
Thogrey,archimonde,384,priest,shadow,6,4,2
Nálá,nethersturm,384,priest,shadow,6,4,2
Pangoffy,burning-legion,384,priest,shadow,6,4,2
Jesuispasbon,hyjal,384,priest,shadow,6,4,2
Nìak,ysondre,384,priest,shadow,15,5,10
Xaphen,kirin-tor,384,priest,shadow,12,4,8
Арлектакль,blackscar,384,priest,shadow,12,4,8
Darkoze,kazzak,384,priest,shadow,12,4,8
Zaoza,dentarg,384,priest,shadow,12,4,8
Skilled,stormscale,384,priest,shadow,12,4,8
Fùkøff,stormscale,384,priest,shadow,12,4,8
Dellarien,stormscale,384,priest,shadow,12,4,8
Crimatoriá,rajaxx,384,priest,shadow,12,4,8
Gerase,blackrock,384,priest,shadow,12,4,8
Dotmaster,darkspear,384,priest,shadow,12,4,8
Voidknight,darkspear,384,priest,shadow,12,4,8
Xalgâzor,zuljin,384,priest,shadow,12,4,8
Созвонимся,gordunni,384,priest,shadow,12,4,8
Æro,malganis,384,priest,shadow,12,4,8
Râây,blackrock,384,priest,shadow,12,4,8
Preodek,kazzak,384,priest,shadow,12,4,8
Lfgarcatraz,aegwynn,384,priest,shadow,12,4,8
Obscurity,burning-steppes,384,priest,shadow,12,4,8
Dpriesta,aegwynn,384,priest,shadow,12,4,8
Datscrazi,ravencrest,384,priest,shadow,12,4,8
Shadøwz,grim-batol,384,priest,shadow,12,4,8
Elpsycongoro,aegwynn,384,priest,shadow,12,4,8
Swoptoplong,blackhand,384,priest,shadow,12,4,8
Oggiz,archimonde,384,priest,shadow,12,4,8
Kirtách,dun-modr,384,priest,shadow,12,4,8
Niikki,blackrock,384,priest,shadow,12,4,8
Morzâr,outland,384,priest,shadow,12,4,8
Thyrena,twisting-nether,384,priest,shadow,12,4,8
Bilalhassâni,archimonde,384,priest,shadow,12,4,8
Baubsy,ghostlands,384,priest,shadow,12,4,8
Ларчшп,gordunni,384,priest,shadow,12,4,8
Самоэль,gordunni,384,priest,shadow,12,4,8
Bacovia,tarren-mill,384,priest,shadow,12,4,8
Gonorreolga,tarren-mill,384,priest,shadow,12,4,8
Phycobabe,sylvanas,384,priest,shadow,12,4,8
Shroomza,blackmoore,384,priest,shadow,12,4,8
Chlorohhkine,chogall,384,priest,shadow,13,4,9
Iamshadow,blackrock,384,priest,shadow,17,4,13
Tobirama,stormscale,384,priest,shadow,17,4,13
Абрасд,gordunni,384,priest,shadow,18,4,14
Infliction,auchindoun,384,priest,shadow,18,4,14
Словаболь,gordunni,383,priest,shadow,6,4,2
Abnórmus,tarren-mill,383,priest,shadow,6,4,2
Newik,burning-legion,383,priest,shadow,6,4,2
Orochimaruh,pozzo-delleternità,383,priest,shadow,6,4,2
Хароки,howling-fjord,383,priest,shadow,6,4,2
Darettii,blackrock,383,priest,shadow,7,4,3
Exörcíst,outland,383,priest,shadow,9,5,4
Shikamarudmx,burning-legion,383,priest,shadow,15,5,10
Sphard,ysondre,383,priest,shadow,12,4,8
Perchédue,silvermoon,367,priest,shadow,11,4,7
Llounal,silvermoon,351,priest,shadow,11,4,7
Levitating,argent-dawn,336,priest,shadow,9,5,4
Tweediertie,argent-dawn,335,priest,shadow,11,4,7
Prìestìalìty,draenor,330,priest,shadow,11,6,5
Verbs,kazzak,330,priest,shadow,15,5,10
Zetara,archimonde,320,priest,shadow,10,4,6
Shagoku,blackmoore,319,priest,shadow,8,4,4
Флэнсер,soulflayer,288,priest,shadow,6,3,3
Canthms,twisting-nether,288,priest,shadow,6,3,3
Wizarxmentar,stormscale,288,priest,shadow,6,3,3
Papynou,garona,288,priest,shadow,6,3,3
Hollywoôd,draenor,288,priest,shadow,6,3,3
Злыденькая,gordunni,288,priest,shadow,6,3,3
Lutzki,the-maelstrom,288,priest,shadow,6,3,3
Skymning,tarren-mill,288,priest,shadow,6,3,3
Slight,aggra-português,288,priest,shadow,6,3,3
Неприст,ashenvale,288,priest,shadow,6,3,3
Imadîa,dalaran,288,priest,shadow,6,3,3
Cloudfactory,ravencrest,288,priest,shadow,6,3,3
Prastas,archimonde,288,priest,shadow,6,3,3
Lethaa,twisting-nether,288,priest,shadow,6,3,3
Voidkäfer,ravencrest,288,priest,shadow,6,3,3
Syntara,twisting-nether,288,priest,shadow,6,3,3
Eldrathir,burning-legion,288,priest,shadow,6,3,3
Mysticks,kirin-tor,288,priest,shadow,6,3,3
Lirrydoz,ravencrest,288,priest,shadow,6,3,3
Discmaskinen,aggramar,288,priest,shadow,6,3,3
Деняприст,gordunni,288,priest,shadow,6,3,3
Smerenia,tarren-mill,288,priest,shadow,6,3,3
Zzoska,burning-legion,288,priest,shadow,6,3,3
Whýççpèrx,ravencrest,288,priest,shadow,6,3,3
Дюрэкс,soulflayer,288,priest,shadow,6,3,3
Hélp,stormscale,288,priest,shadow,6,3,3
Gstah,taerar,288,priest,shadow,6,3,3
Taklamakan,alakir,288,priest,shadow,6,3,3
Kallsen,ravencrest,288,priest,shadow,6,3,3
Thimble,blackhand,288,priest,shadow,6,3,3
Miikkap,blackhand,288,priest,shadow,6,3,3
Byzzi,draenor,288,priest,shadow,6,3,3
Yazh,argent-dawn,288,priest,shadow,6,3,3
Wkid,draenor,288,priest,shadow,6,3,3
Trinnity,drakthul,288,priest,shadow,6,3,3
Stinkycreep,executus,288,priest,shadow,6,3,3
Aéltess,kirin-tor,288,priest,shadow,6,3,3
Ksiadzrydzyk,draenor,288,priest,shadow,6,3,3
Holybestie,eredar,288,priest,shadow,6,3,3
Roxfer,ysondre,288,priest,shadow,6,3,3
Dunkelseele,ahnqiraj,288,priest,shadow,6,3,3
Fionsacré,archimonde,288,priest,shadow,6,3,3
Shannannanna,darkspear,288,priest,shadow,6,3,3
Grimer,talnivarr,288,priest,shadow,6,3,3
Нечавкай,deathweaver,288,priest,shadow,6,3,3
Resgan,archimonde,288,priest,shadow,6,3,3
Забвениеждёт,gordunni,288,priest,shadow,6,3,3
Ragwitch,draenor,288,priest,shadow,6,3,3
Vampiro,blackhand,288,priest,shadow,6,3,3
Grootts,burning-blade,288,priest,shadow,6,3,3
Gesees,ravencrest,288,priest,shadow,6,3,3
Vividots,draenor,288,priest,shadow,6,3,3
Susaj,tarren-mill,288,priest,shadow,6,3,3
Worwp,burning-blade,288,priest,shadow,6,3,3
Noskillzz,nemesis,288,priest,shadow,6,3,3
Linara,frostmane,288,priest,shadow,6,3,3
Yukíø,antonidas,288,priest,shadow,6,3,3
Salzgehalt,antonidas,288,priest,shadow,6,3,3
Sofuny,neptulon,288,priest,shadow,6,3,3
Nhajÿ,hyjal,288,priest,shadow,6,3,3
Sanctimo,stormscale,288,priest,shadow,6,3,3
Zøid,ysondre,288,priest,shadow,6,3,3
Пристотян,gordunni,288,priest,shadow,6,3,3
Stepsisstuck,ragnaros,288,priest,shadow,6,3,3
Notra,shattrath,288,priest,shadow,6,3,3
Shasdöw,hyjal,288,priest,shadow,6,3,3
Runristad,ravencrest,288,priest,shadow,6,3,3
Смегмачет,soulflayer,288,priest,shadow,6,3,3
Neopriest,stormscale,288,priest,shadow,6,3,3
Sweedensp,hyjal,288,priest,shadow,6,3,3
Eyvvah,twisting-nether,288,priest,shadow,6,3,3
Sàyaa,draenor,288,priest,shadow,6,3,3
Liliashet,sanguino,288,priest,shadow,6,3,3
Grocx,kazzak,288,priest,shadow,6,3,3
Mgx,defias-brotherhood,288,priest,shadow,6,3,3
Plagegeist,blutkessel,288,priest,shadow,6,3,3
Freezydot,silvermoon,288,priest,shadow,6,3,3
Xaviá,blackrock,288,priest,shadow,6,3,3
Drynte,blackmoore,288,priest,shadow,6,3,3
Snoopydawgs,blackmoore,288,priest,shadow,6,3,3
Bhlad,silvermoon,288,priest,shadow,6,3,3
Cðsima,blackmoore,288,priest,shadow,6,3,3
Averye,kazzak,288,priest,shadow,6,3,3
Kilmmiis,defias-brotherhood,288,priest,shadow,6,3,3
Chuckbarry,kazzak,288,priest,shadow,6,3,3
Chandria,veknilash,288,priest,shadow,6,3,3
Voilencia,kazzak,288,priest,shadow,6,3,3
Pbwser,silvermoon,288,priest,shadow,6,3,3
Ggsus,outland,288,priest,shadow,6,3,3
Nahtod,blackmoore,288,priest,shadow,6,3,3
Lexivenera,silvermoon,288,priest,shadow,6,3,3
Covidisc,outland,288,priest,shadow,6,3,3
Nitza,silvermoon,288,priest,shadow,6,3,3
Poonies,silvermoon,288,priest,shadow,6,3,3
Presbyter,mazrigos,288,priest,shadow,6,3,3
Hasnaa,silvermoon,288,priest,shadow,6,3,3
Elreâ,blackrock,288,priest,shadow,6,3,3
Momet,defias-brotherhood,288,priest,shadow,6,3,3
Xotz,thrall,288,priest,shadow,6,3,3
Abyssonmind,dun-modr,288,priest,shadow,6,3,3
Sîçkzømßiê,kazzak,288,priest,shadow,6,3,3
Cé,magtheridon,288,priest,shadow,6,3,3
Kopfsache,blackmoore,288,priest,shadow,7,3,4
Kåstå,archimonde,288,priest,shadow,11,3,8
Amaretta,perenolde,288,priest,shadow,12,3,9
Elumi,the-maelstrom,288,priest,shadow,12,3,9
Aaluvor,blackmoore,288,priest,shadow,12,3,9
Xrystal,wrathbringer,288,priest,shadow,12,3,9
Shreedz,blackmoore,288,priest,shadow,12,3,9
Anariell,ravencrest,288,priest,shadow,12,3,9
Preast,aegwynn,288,priest,shadow,12,3,9
Goldische,dun-morogh,288,priest,shadow,12,3,9
Supermacy,eredar,288,priest,shadow,12,3,9
Hâstur,ravencrest,288,priest,shadow,12,3,9
Nesar,stormscale,288,priest,shadow,12,3,9
Powergodz,exodar,288,priest,shadow,12,3,9
Øzya,kirin-tor,288,priest,shadow,12,3,9
Kaenlin,the-maelstrom,288,priest,shadow,18,3,15
Jês,thrall,287,priest,shadow,6,3,3
Rulna,die-aldor,287,priest,shadow,12,3,9
Irrtum,nozdormu,286,priest,shadow,6,3,3
Nuger,tarren-mill,286,priest,shadow,6,3,3
Жруля,ashenvale,286,priest,shadow,18,3,15
Czikibriki,ravenholdt,256,priest,shadow,4,4,0
Shadepencoin,silvermoon,256,priest,shadow,10,3,7
Szelén,ragnaros,256,priest,shadow,10,3,7
Бледноват,ashenvale,255,priest,shadow,8,4,4
Guccimaane,twisting-nether,239,priest,shadow,5,3,2
Herro,thrall,239,priest,shadow,5,3,2
Caski,stormreaver,239,priest,shadow,5,3,2
Deeforce,argent-dawn,234,priest,shadow,6,4,2
Фьюриреидж,soulflayer,234,priest,shadow,8,4,4
Ainoa,grim-batol,234,priest,shadow,9,4,5
Coffíndodger,magtheridon,192,priest,shadow,4,3,1
Shadowflamè,outland,192,priest,shadow,4,3,1
Szycho,burning-legion,192,priest,shadow,9,3,6
Priath,magtheridon,192,priest,shadow,6,2,4
Misántropo,dun-modr,192,priest,shadow,6,2,4
Жрецдуши,gordunni,192,priest,shadow,6,2,4
Calïxløve,der-rat-von-dalaran,192,priest,shadow,6,2,4
Illordz,nemesis,192,priest,shadow,6,2,4
Shokkapriest,draenor,192,priest,shadow,6,2,4
Andérsón,magtheridon,192,priest,shadow,6,2,4
Lugburzz,draenor,192,priest,shadow,6,2,4
Phobò,antonidas,192,priest,shadow,6,2,4
Шарадин,gordunni,192,priest,shadow,6,2,4
Шестьнадцать,gordunni,192,priest,shadow,6,2,4
Нефрида,gordunni,192,priest,shadow,6,2,4
Jarnary,blackmoore,192,priest,shadow,6,2,4
Kharòn,grim-batol,192,priest,shadow,6,2,4
Amáni,die-aldor,192,priest,shadow,6,2,4
Madpandax,blackmoore,192,priest,shadow,6,2,4
Helheïm,chants-éternels,192,priest,shadow,6,2,4
Zootx,magtheridon,192,priest,shadow,6,2,4
Безмездная,gordunni,192,priest,shadow,6,2,4
Дашажмитучу,howling-fjord,192,priest,shadow,6,2,4
Makemyday,dun-modr,192,priest,shadow,6,2,4
Omejan,frostmane,192,priest,shadow,6,2,4
Встанислав,gordunni,192,priest,shadow,6,2,4
Crzzy,dun-modr,192,priest,shadow,6,2,4
Zikár,kazzak,192,priest,shadow,6,2,4
Сорвиголов,howling-fjord,192,priest,shadow,6,2,4
Bandgap,antonidas,192,priest,shadow,6,2,4
Yugata,archimonde,192,priest,shadow,6,2,4
Putoeinstein,sylvanas,192,priest,shadow,6,2,4
Keijuna,kazzak,192,priest,shadow,6,2,4
Getitoffme,auchindoun,192,priest,shadow,6,2,4
Lythra,burning-legion,192,priest,shadow,6,2,4
Harleyquiñ,burning-legion,192,priest,shadow,6,2,4
Elthrone,kazzak,192,priest,shadow,6,2,4
Ompala,shattered-hand,192,priest,shadow,6,2,4
Сайннз,howling-fjord,192,priest,shadow,6,2,4
Pleshiv,sanguino,192,priest,shadow,6,2,4
Sotriggered,sylvanas,192,priest,shadow,6,2,4
Mømmymilkers,archimonde,192,priest,shadow,6,2,4
Abî,frostwolf,192,priest,shadow,6,2,4
Ximenia,eredar,192,priest,shadow,6,2,4
Nõlîfer,archimonde,192,priest,shadow,6,2,4
Ørbänvîktôrx,ragnaros,192,priest,shadow,6,2,4
Xaeroow,archimonde,192,priest,shadow,6,2,4
Voidgasm,kazzak,192,priest,shadow,6,2,4
Периссвет,thermaplugg,192,priest,shadow,6,2,4
Øxyzën,marécage-de-zangar,192,priest,shadow,6,2,4
Oknelim,blackmoore,192,priest,shadow,6,2,4
Elëctra,vashj,192,priest,shadow,6,2,4
Hayvo,blackmoore,192,priest,shadow,6,2,4
Grimor,talnivarr,192,priest,shadow,6,2,4
Gidy,blackmoore,192,priest,shadow,6,2,4
Ðex,chromaggus,192,priest,shadow,6,2,4
Holycrapx,chromaggus,192,priest,shadow,6,2,4
Våfflán,silvermoon,192,priest,shadow,6,2,4
Cto,gorgonnash,192,priest,shadow,6,2,4
Yshaarjy,silvermoon,192,priest,shadow,6,2,4
Hans,thrall,192,priest,shadow,6,2,4
Funstopshere,ravencrest,192,priest,shadow,6,2,4
Tuljan,twisting-nether,192,priest,shadow,6,2,4
Wiglere,argent-dawn,192,priest,shadow,6,2,4
Vengigodxx,ravencrest,192,priest,shadow,6,2,4
Piizzdiica,twisting-nether,192,priest,shadow,6,2,4
Lollithu,argent-dawn,192,priest,shadow,6,2,4
Sïfën,tarren-mill,192,priest,shadow,6,2,4
Ràthaløs,sanguino,192,priest,shadow,6,2,4
Velansera,argent-dawn,192,priest,shadow,6,2,4
Alpharîus,argent-dawn,192,priest,shadow,6,2,4
Несущийсерп,soulflayer,192,priest,shadow,6,2,4
Гундяй,soulflayer,192,priest,shadow,6,2,4
Bòóny,ravencrest,192,priest,shadow,6,2,4
Wsp,tarren-mill,192,priest,shadow,6,2,4
Шиписс,soulflayer,192,priest,shadow,6,2,4
Hadsup,stormscale,192,priest,shadow,6,2,4
Aruna,ravencrest,192,priest,shadow,6,2,4
Eosar,blackhand,192,priest,shadow,6,2,4
Avowed,stormscale,192,priest,shadow,6,2,4
Joezero,the-maelstrom,192,priest,shadow,6,2,4
Voidreaver,stormscale,192,priest,shadow,6,2,4
Turah,the-maelstrom,192,priest,shadow,6,2,4
Deternity,stormscale,192,priest,shadow,6,2,4
Rustyroll,stormscale,192,priest,shadow,6,2,4
Clemexyo,stormscale,192,priest,shadow,6,2,4
Reïny,tarren-mill,192,priest,shadow,6,2,4
Notdespo,kazzak,192,priest,shadow,6,2,4
Nomarak,drakthul,192,priest,shadow,6,2,4
Lèviåthån,stormscale,192,priest,shadow,6,2,4
Shmoly,stormscale,192,priest,shadow,6,2,4
Esthea,malganis,192,priest,shadow,6,2,4
Daven,ysondre,192,priest,shadow,6,2,4
Wasgehtjungs,blackrock,192,priest,shadow,6,2,4
Zaop,blackhand,192,priest,shadow,6,2,4
Kaleshiry,kazzak,192,priest,shadow,6,2,4
Fqú,wrathbringer,192,priest,shadow,6,2,4
Purplereign,stormscale,192,priest,shadow,6,2,4
Sephìrøth,malganis,192,priest,shadow,6,2,4
Rallzken,stormscale,192,priest,shadow,6,2,4
Madclownz,blackrock,192,priest,shadow,6,2,4
Chekkó,blackrock,192,priest,shadow,6,2,4
Siezlababo,blackrock,192,priest,shadow,6,2,4
Shalacho,blackrock,192,priest,shadow,6,2,4
Бихар,gordunni,192,priest,shadow,10,2,8
Awcute,kazzak,192,priest,shadow,12,2,10
Господствуй,gordunni,192,priest,shadow,12,2,10
Wortmonster,malganis,192,priest,shadow,12,2,10
Hûndling,blackrock,192,priest,shadow,12,2,10
Noir,nemesis,192,priest,shadow,12,2,10
Anglaran,hellscream,192,priest,shadow,12,2,10
Andorelya,blackhand,191,priest,shadow,6,2,4
Luziz,blackmoore,159,priest,shadow,5,2,3
Girlidlion,twisting-nether,159,priest,shadow,5,2,3
Qku,ravencrest,144,priest,shadow,9,3,6
Føxy,emerald-dream,138,priest,shadow,7,3,4
Alswynn,draenor,138,priest,shadow,13,3,10
Yologrumples,tarren-mill,128,priest,shadow,4,2,2
Heeyø,drakthul,128,priest,shadow,4,2,2
Vampirski,kazzak,96,priest,shadow,3,2,1
Aureï,khaz-modan,96,priest,shadow,3,2,1
Slitenprest,kazzak,96,priest,shadow,6,2,4
Beckett,outland,96,priest,shadow,6,1,5
Arliston,draenor,96,priest,shadow,6,1,5
Bij,outland,96,priest,shadow,6,1,5
Prostamolle,conseil-des-ombres,96,priest,shadow,6,1,5
Izarath,outland,96,priest,shadow,6,1,5
Попячебрило,gordunni,96,priest,shadow,6,1,5
Radenox,stormscale,96,priest,shadow,6,1,5
Corefusion,blackrock,96,priest,shadow,6,1,5
Deicidex,blackrock,96,priest,shadow,6,1,5
Scrotoepalle,nemesis,96,priest,shadow,6,1,5
Катранасс,eversong,96,priest,shadow,6,1,5
Príêstjklòl,stormscale,96,priest,shadow,6,1,5
Vtqt,outland,96,priest,shadow,6,1,5
Vès,stormscale,96,priest,shadow,6,1,5
Soulmedic,draenor,96,priest,shadow,6,1,5
Maddøc,die-aldor,96,priest,shadow,6,1,5
Zukatana,tarren-mill,96,priest,shadow,6,1,5
Nestélle,drakthul,96,priest,shadow,6,1,5
Skitcy,ghostlands,96,priest,shadow,6,1,5
Гучии,gordunni,96,priest,shadow,6,1,5
Абсорбиболь,howling-fjord,96,priest,shadow,6,1,5
Ghostroller,pozzo-delleternità,96,priest,shadow,6,1,5
Adlareg,silvermoon,96,priest,shadow,6,1,5
Tryagain,ravencrest,96,priest,shadow,6,1,5
Daphne,thunderhorn,96,priest,shadow,6,1,5
Abudhabi,blackhand,96,priest,shadow,6,1,5
Nextdawn,kazzak,96,priest,shadow,6,1,5
Koíré,defias-brotherhood,96,priest,shadow,6,1,5
Мегаствол,howling-fjord,96,priest,shadow,6,1,5
Exila,rashgarroth,96,priest,shadow,6,1,5
Ölümsüz,blackmoore,96,priest,shadow,6,1,5
Hampådenbååd,kazzak,96,priest,shadow,6,1,5
Míllerzz,ragnaros,96,priest,shadow,6,1,5
Gobie,sunstrider,96,priest,shadow,6,1,5
Rines,thrall,96,priest,shadow,6,1,5
Bädx,silvermoon,96,priest,shadow,6,1,5
Jakepriest,twisting-nether,96,priest,shadow,6,1,5
Adev,drakthul,96,priest,shadow,6,1,5
Barbïelolz,sargeras,96,priest,shadow,6,1,5
Kales,grim-batol,96,priest,shadow,6,1,5
Baltrom,ravencrest,96,priest,shadow,6,1,5
Shonsized,argent-dawn,96,priest,shadow,6,1,5
Stola,archimonde,96,priest,shadow,6,1,5
Lubudu,burning-legion,96,priest,shadow,6,1,5
Higgle,argent-dawn,96,priest,shadow,6,1,5
Löô,archimonde,96,priest,shadow,6,1,5
Kianprie,silvermoon,96,priest,shadow,6,1,5
Enduring,darksorrow,96,priest,shadow,6,1,5
Uwucatgir,silvermoon,96,priest,shadow,6,1,5
Чупатаявошь,soulflayer,96,priest,shadow,6,1,5
Winstõn,sanguino,96,priest,shadow,6,1,5
Infâme,culte-de-la-rive-noire,96,priest,shadow,6,1,5
Nelpriest,hyjal,96,priest,shadow,6,1,5
Rastuvius,twisting-nether,96,priest,shadow,6,1,5
Serach,ravencrest,96,priest,shadow,6,1,5
Chimara,eredar,96,priest,shadow,6,1,5
Nukksch,antonidas,96,priest,shadow,6,1,5
Aerîs,veknilash,96,priest,shadow,6,1,5
Endlin,silvermoon,96,priest,shadow,6,1,5
Jannire,dun-modr,96,priest,shadow,12,1,11
Câtryona,sylvanas,96,priest,shadow,12,1,11
Darkspeech,arygos,96,priest,shadow,12,1,11
Tiras,argent-dawn,96,priest,shadow,12,1,11
Prästisjag,kazzak,84,priest,shadow,10,5,5
Peesussy,kazzak,79,priest,shadow,5,1,4
Xharyo,ravencrest,64,priest,shadow,4,1,3
Xavyos,eredar,64,priest,shadow,4,1,3
Gandals,shadowsong,64,priest,shadow,4,1,3
Immurrtal,arathor,63,priest,shadow,2,2,0
Møldark,silvermoon,48,priest,shadow,3,1,2
Achesita,sylvanas,48,priest,shadow,3,1,2
Psyp,kazzak,42,priest,shadow,8,2,6
Holyhigh,baelgun,31,priest,shadow,2,1,1
Mjuk,tarren-mill,16,priest,shadow,1,1,0
Rãz,stormscale,2130,rogue,outlaw,66,36,30
Макевин,gordunni,1876,rogue,outlaw,100,49,51
Krixor,ravencrest,1855,rogue,outlaw,134,66,68
Rivso,auchindoun,1821,rogue,outlaw,64,26,38
Kekuriix,vashj,1796,rogue,outlaw,130,66,64
Феинт,galakrond,1739,rogue,outlaw,48,19,29
Lidiaubaro,ravencrest,1725,rogue,outlaw,362,185,177
Yessa,argent-dawn,1721,rogue,outlaw,36,18,18
Déjávu,ravencrest,1704,rogue,outlaw,48,25,23
Дизелюжн,howling-fjord,1673,rogue,outlaw,326,159,167
Koopa,argent-dawn,1666,rogue,outlaw,60,29,31
Kreayx,ysondre,1666,rogue,outlaw,42,19,23
Radiogodx,stormscale,1660,rogue,outlaw,163,79,84
Jalsket,tarren-mill,1637,rogue,outlaw,48,25,23
Scotlander,argent-dawn,1627,rogue,outlaw,60,34,26
Kreay,ysondre,1620,rogue,outlaw,42,20,22
Ålûñàhlulz,kilrogg,1604,rogue,outlaw,48,30,18
Estriil,dalaran,1603,rogue,outlaw,42,24,18
Kreay,tarren-mill,1576,rogue,outlaw,40,29,11
Syrn,ravencrest,1559,rogue,outlaw,66,31,35
Nèwt,aggramar,1528,rogue,outlaw,132,68,64
Ранконх,lich-king,1528,rogue,outlaw,54,20,34
Chillo,ravencrest,1525,rogue,outlaw,52,25,27
Izzmonab,blackmoore,1519,rogue,outlaw,24,16,8
Bannedfrigid,outland,1501,rogue,outlaw,66,25,41
Зувер,blackscar,1494,rogue,outlaw,106,57,49
Bonelesschic,silvermoon,1491,rogue,outlaw,209,112,97
Arathir,ravencrest,1482,rogue,outlaw,50,25,25
Deevoll,tarren-mill,1481,rogue,outlaw,102,45,57
Sigleif,argent-dawn,1471,rogue,outlaw,111,57,54
Shredfngrz,garona,1455,rogue,outlaw,44,22,22
Loubina,silvermoon,1446,rogue,outlaw,36,16,20
Carvyn,defias-brotherhood,1443,rogue,outlaw,111,59,52
Delrøq,draenor,1435,rogue,outlaw,76,40,36
Zbojník,ravencrest,1434,rogue,outlaw,36,15,21
Röguetönerö,dun-modr,1429,rogue,outlaw,77,28,49
Cryneth,ravencrest,1373,rogue,outlaw,51,25,26
Åråmsëß,grim-batol,1370,rogue,outlaw,31,19,12
Pistolpete,grim-batol,1343,rogue,outlaw,30,14,16
Callmerose,ravencrest,1334,rogue,outlaw,24,14,10
Dritzdourden,dun-modr,1333,rogue,outlaw,30,15,15
Zep,auchindoun,1332,rogue,outlaw,24,14,10
Murkyy,gilneas,1329,rogue,outlaw,32,16,16
Djeud,archimonde,1325,rogue,outlaw,64,34,30
Tidløs,dun-morogh,1324,rogue,outlaw,71,30,41
Rasponi,ragnaros,1316,rogue,outlaw,82,45,37
Джулт,soulflayer,1309,rogue,outlaw,72,27,45
Örog,hyjal,1288,rogue,outlaw,47,26,21
Jasolo,silvermoon,1269,rogue,outlaw,408,212,196
Mawrat,mazrigos,1248,rogue,outlaw,30,13,17
Ðaegr,ravencrest,1226,rogue,outlaw,72,35,37
Dimmu,haomarush,1224,rogue,outlaw,53,24,29
Sqz,archimonde,1222,rogue,outlaw,30,18,12
Zapunk,argent-dawn,1221,rogue,outlaw,53,19,34
Cipusan,kazzak,1219,rogue,outlaw,24,13,11
Шторкаа,gordunni,1214,rogue,outlaw,33,19,14
Omgjkgtfo,ravencrest,1207,rogue,outlaw,30,13,17
Xsanji,kazzak,1140,rogue,outlaw,30,12,18
Pasarelo,dun-modr,1137,rogue,outlaw,59,26,33
Pidroseus,argent-dawn,1133,rogue,outlaw,30,13,17
Jinzou,blackmoore,1128,rogue,outlaw,57,27,30
Alatheril,argent-dawn,1101,rogue,outlaw,62,28,34
Mirajen,archimonde,1080,rogue,outlaw,35,13,22
Lättja,hyjal,1059,rogue,outlaw,24,12,12
Drdaggerstwo,outland,1056,rogue,outlaw,24,11,13
Terya,ragnaros,1052,rogue,outlaw,30,11,19
Bxtchslayer,blackmoore,1044,rogue,outlaw,35,21,14
Génn,silvermoon,1041,rogue,outlaw,44,21,23
Badabôôm,wrathbringer,1041,rogue,outlaw,24,11,13
Drunks,aegwynn,1036,rogue,outlaw,24,11,13
Svddendeath,ragnaros,1034,rogue,outlaw,24,11,13
Melahl,kazzak,1021,rogue,outlaw,77,42,35
Spiochrr,burning-legion,1020,rogue,outlaw,84,35,49
Soothinqq,emerald-dream,963,rogue,outlaw,23,15,8
Lïke,frostwolf,960,rogue,outlaw,18,10,8
Foulsteel,stormscale,951,rogue,outlaw,18,10,8
Shinõbikék,outland,938,rogue,outlaw,29,10,19
Neolamer,pozzo-delleternità,898,rogue,outlaw,74,31,43
Omuspan,magtheridon,881,rogue,outlaw,66,28,38
Sneakysteve,bloodfeather,864,rogue,outlaw,18,9,9
Rogiko,twisting-nether,864,rogue,outlaw,24,9,15
Жижель,howling-fjord,859,rogue,outlaw,18,9,9
Маллестар,ashenvale,856,rogue,outlaw,18,9,9
Mcgora,doomhammer,822,rogue,outlaw,36,15,21
Hânnäh,hyjal,805,rogue,outlaw,42,18,24
Blàckbèàrd,silvermoon,788,rogue,outlaw,42,17,25
Фораст,gordunni,768,rogue,outlaw,12,8,4
Bikrut,hyjal,768,rogue,outlaw,12,8,4
Vokhun,outland,768,rogue,outlaw,18,8,10
Gerzy,drakthul,768,rogue,outlaw,18,8,10
Alizwood,aegwynn,767,rogue,outlaw,18,10,8
Swaeard,ravencrest,767,rogue,outlaw,18,8,10
Kirby,kaelthas,767,rogue,outlaw,18,8,10
Okani,hyjal,761,rogue,outlaw,18,8,10
Dredge,kaelthas,761,rogue,outlaw,24,8,16
Shichi,archimonde,751,rogue,outlaw,23,8,15
Riviele,argent-dawn,732,rogue,outlaw,14,9,5
Viligar,kazzak,687,rogue,outlaw,21,8,13
Backstabjr,blackmoore,672,rogue,outlaw,12,7,5
Dían,ravencrest,672,rogue,outlaw,12,7,5
Dêlaral,der-rat-von-dalaran,672,rogue,outlaw,16,8,8
Kidneyou,ragnaros,672,rogue,outlaw,18,7,11
Trixnaz,silvermoon,671,rogue,outlaw,18,7,11
Skygann,burning-legion,670,rogue,outlaw,12,7,5
Redfinshadow,stormrage,661,rogue,outlaw,17,8,9
Cornvus,burning-legion,658,rogue,outlaw,12,7,5
Фофламидзе,gordunni,611,rogue,outlaw,15,7,8
Masteez,ahnqiraj,598,rogue,outlaw,11,7,4
Shåð,zuljin,576,rogue,outlaw,12,6,6
Anom,kargath,575,rogue,outlaw,12,6,6
Noodlegoose,tarren-mill,575,rogue,outlaw,12,6,6
Ружнуар,gordunni,575,rogue,outlaw,18,6,12
Кингксу,gordunni,575,rogue,outlaw,24,6,18
Rã,archimonde,574,rogue,outlaw,12,6,6
Тимареканец,eversong,572,rogue,outlaw,18,6,12
Helax,turalyon,569,rogue,outlaw,24,6,18
Aaronblade,aggra-português,557,rogue,outlaw,18,6,12
Gloomykenny,tarren-mill,543,rogue,outlaw,17,6,11
Tipok,tarren-mill,515,rogue,outlaw,23,7,16
Barisso,burning-legion,511,rogue,outlaw,14,6,8
Zômbiê,blackrock,491,rogue,outlaw,13,6,7
Tåxic,sylvanas,480,rogue,outlaw,6,5,1
Акаарикс,gordunni,480,rogue,outlaw,6,5,1
Fivepoint,blackmoore,480,rogue,outlaw,12,5,7
Cox,nagrand,480,rogue,outlaw,12,5,7
Faoil,defias-brotherhood,480,rogue,outlaw,12,5,7
Featfawkes,ragnaros,480,rogue,outlaw,12,5,7
Ладжо,gordunni,480,rogue,outlaw,18,5,13
Rujo,magtheridon,479,rogue,outlaw,12,5,7
Nocrath,blades-edge,479,rogue,outlaw,12,5,7
Gotfrey,darkspear,479,rogue,outlaw,12,5,7
Toxîne,archimonde,479,rogue,outlaw,12,5,7
Djsapblindx,archimonde,479,rogue,outlaw,18,5,13
Hosenpinkler,lordaeron,478,rogue,outlaw,12,5,7
Darkchomeur,archimonde,384,rogue,outlaw,6,4,2
Machmacan,thrall,384,rogue,outlaw,12,4,8
Кортикос,gordunni,384,rogue,outlaw,12,4,8
Synexo,sylvanas,384,rogue,outlaw,12,4,8
Minimælk,saurfang,383,rogue,outlaw,6,4,2
Alena,arathi,383,rogue,outlaw,6,4,2
Mïta,blackmoore,383,rogue,outlaw,6,4,2
Yoruichì,kazzak,383,rogue,outlaw,12,4,8
Groendienst,quelthalas,381,rogue,outlaw,12,4,8
Trímønâ,gorgonnash,351,rogue,outlaw,11,4,7
Играючестно,howling-fjord,288,rogue,outlaw,6,3,3
Cigarette,emeriss,288,rogue,outlaw,6,3,3
Spiike,culte-de-la-rive-noire,288,rogue,outlaw,6,3,3
Mol,defias-brotherhood,288,rogue,outlaw,6,3,3
Shadxwstep,ravencrest,288,rogue,outlaw,6,3,3
Onlyluvhurt,dun-modr,288,rogue,outlaw,6,3,3
Cobaka,blackrock,288,rogue,outlaw,12,3,9
Finisher,sanguino,288,rogue,outlaw,12,3,9
Heulleise,die-ewige-wacht,288,rogue,outlaw,12,3,9
Szpachela,burning-legion,288,rogue,outlaw,12,3,9
Ванэйти,gordunni,287,rogue,outlaw,6,3,3
Kedrus,turalyon,286,rogue,outlaw,6,3,3
Blackmetall,aegwynn,286,rogue,outlaw,12,3,9
Сереф,gordunni,239,rogue,outlaw,11,3,8
Cardsharkjoe,argent-dawn,223,rogue,outlaw,14,3,11
Banaulikode,twisting-nether,192,rogue,outlaw,6,2,4
Rashaz,blackhand,192,rogue,outlaw,6,2,4
Snøv,outland,192,rogue,outlaw,6,2,4
Knifeyknifey,ravencrest,192,rogue,outlaw,6,2,4
Razaah,ravencrest,192,rogue,outlaw,6,2,4
Invisage,grim-batol,192,rogue,outlaw,6,2,4
Cheapshotwin,nethersturm,192,rogue,outlaw,6,2,4
Nyxal,argent-dawn,192,rogue,outlaw,6,2,4
Dawnsaber,argent-dawn,192,rogue,outlaw,6,2,4
Shåggy,vashj,192,rogue,outlaw,6,2,4
Оргельна,gordunni,192,rogue,outlaw,6,2,4
Zind,dalaran,192,rogue,outlaw,6,2,4
Mycki,voljin,192,rogue,outlaw,6,2,4
Berneo,burning-legion,192,rogue,outlaw,6,2,4
Stunlock,silvermoon,192,rogue,outlaw,6,2,4
Paralisis,zuljin,192,rogue,outlaw,6,2,4
Zyhmø,archimonde,192,rogue,outlaw,6,2,4
Nomota,sanguino,192,rogue,outlaw,6,2,4
Vyze,blackmoore,192,rogue,outlaw,12,2,10
Alvoriace,hyjal,192,rogue,outlaw,12,2,10
Stabkanta,antonidas,192,rogue,outlaw,12,2,10
Valtesse,medivh,159,rogue,outlaw,5,2,3
Piperx,ravencrest,159,rogue,outlaw,11,2,9
Геопанк,howling-fjord,144,rogue,outlaw,3,3,0
Zyreanxy,blackrock,138,rogue,outlaw,10,3,7
Ñøway,archimonde,96,rogue,outlaw,3,2,1
Akira,outland,96,rogue,outlaw,6,1,5
Ciaordel,sylvanas,96,rogue,outlaw,6,1,5
Sty,aerie-peak,96,rogue,outlaw,6,1,5
Аутянин,soulflayer,96,rogue,outlaw,6,1,5
Vaze,ravencrest,96,rogue,outlaw,6,1,5
Feucht,argent-dawn,96,rogue,outlaw,6,1,5
Yüm,burning-blade,96,rogue,outlaw,6,1,5
Ótsutsukí,kazzak,96,rogue,outlaw,6,1,5
Леронда,deepholm,96,rogue,outlaw,6,1,5
Mallaurya,dalaran,96,rogue,outlaw,6,1,5
Øníxßtw,eitrigg,96,rogue,outlaw,6,1,5
Natillaa,dun-modr,96,rogue,outlaw,6,1,5
Jester,bladefist,96,rogue,outlaw,12,1,11
Tiltman,dun-morogh,79,rogue,outlaw,5,1,4
Nabatean,magtheridon,48,rogue,outlaw,3,1,2
Getbleeded,stormscale,31,rogue,outlaw,2,1,1
Howton,archimonde,2424,rogue,subtlety,86,57,29
Pridå,thrall,2380,rogue,subtlety,126,73,53
Ncroxd,ravencrest,2316,rogue,subtlety,72,56,16
Ncrø,aszune,2310,rogue,subtlety,85,54,31
Shoxy,ravencrest,2307,rogue,subtlety,94,56,38
Pridå,ravencrest,2299,rogue,subtlety,106,58,48
Sunø,archimonde,2276,rogue,subtlety,216,114,102
Naláa,ravencrest,2228,rogue,subtlety,228,121,107
Cazzette,ravencrest,2204,rogue,subtlety,81,48,33
Asumah,ravencrest,2200,rogue,subtlety,90,55,35
Pulvèr,dalaran,2159,rogue,subtlety,90,52,38
Лолелт,borean-tundra,2131,rogue,subtlety,104,53,51
Nothingleft,draenor,2130,rogue,subtlety,173,99,74
Ewynarog,silvermoon,2129,rogue,subtlety,65,37,28
Nàsklolz,hyjal,2117,rogue,subtlety,84,45,39
Lfgenjoyer,tarren-mill,2114,rogue,subtlety,126,77,49
Änanké,outland,2108,rogue,subtlety,90,47,43
Denjinx,culte-de-la-rive-noire,2107,rogue,subtlety,78,43,35
Vulkos,lightbringer,2101,rogue,subtlety,117,61,56
Пожилойпупь,gordunni,2095,rogue,subtlety,59,39,20
Лолелт,howling-fjord,2074,rogue,subtlety,89,51,38
Smøkyyx,eredar,2072,rogue,subtlety,88,47,41
Løre,blackrock,2041,rogue,subtlety,84,43,41
Asm,the-maelstrom,2024,rogue,subtlety,130,64,66
Vensq,drakthul,2021,rogue,subtlety,78,44,34
Tracersxrude,ravencrest,2018,rogue,subtlety,173,86,87
Эмилилавс,galakrond,2015,rogue,subtlety,182,107,75
Baboonx,burning-legion,2014,rogue,subtlety,54,37,17
Fîññ,ravencrest,2014,rogue,subtlety,60,35,25
Iqws,ravencrest,2014,rogue,subtlety,90,49,41
Makethemrog,archimonde,2014,rogue,subtlety,136,67,69
Troxerboxer,tarren-mill,2000,rogue,subtlety,60,32,28
Lkzx,archimonde,1998,rogue,subtlety,149,71,78
Chatbann,blackrock,1995,rogue,subtlety,190,109,81
Chatdisabled,drakthul,1991,rogue,subtlety,191,100,91
Смертьвсмоке,gordunni,1981,rogue,subtlety,284,141,143
Lówskill,outland,1967,rogue,subtlety,259,137,122
Çvß,kazzak,1966,rogue,subtlety,66,36,30
Guççí,blackrock,1958,rogue,subtlety,131,72,59
Aythusha,twisting-nether,1957,rogue,subtlety,54,31,23
Drydamage,kazzak,1957,rogue,subtlety,131,69,62
Máuul,ravencrest,1956,rogue,subtlety,78,36,42
Sfyr,ysondre,1951,rogue,subtlety,148,86,62
Magepèt,tarren-mill,1946,rogue,subtlety,130,73,57
Сильфитт,gordunni,1945,rogue,subtlety,76,44,32
Флексити,soulflayer,1939,rogue,subtlety,114,59,55
Kallelelel,tarren-mill,1933,rogue,subtlety,42,26,16
Terrorman,ravencrest,1932,rogue,subtlety,60,34,26
Unìque,sylvanas,1918,rogue,subtlety,96,51,45
Physic,silvermoon,1915,rogue,subtlety,70,39,31
Teskes,tyrande,1907,rogue,subtlety,114,66,48
Zuqzwang,outland,1901,rogue,subtlety,54,30,24
Clawdíte,blackrock,1895,rogue,subtlety,48,21,27
Çåñçér,sylvanas,1893,rogue,subtlety,78,38,40
Illmatíc,ravencrest,1892,rogue,subtlety,62,32,30
Shadezlöl,ravencrest,1889,rogue,subtlety,280,142,138
Çhimaev,ravencrest,1886,rogue,subtlety,28,21,7
Rãz,stormscale,1880,rogue,subtlety,48,31,17
Xiro,dalaran,1879,rogue,subtlety,66,32,34
Sbx,alakir,1877,rogue,subtlety,164,92,72
Престиж,greymane,1871,rogue,subtlety,42,23,19
Sariena,sylvanas,1869,rogue,subtlety,167,91,76
Randomidiot,ravencrest,1868,rogue,subtlety,60,36,24
Ладжо,gordunni,1867,rogue,subtlety,114,59,55
Sapécomejaja,archimonde,1866,rogue,subtlety,38,24,14
Социалистсс,gordunni,1866,rogue,subtlety,92,49,43
Critmakër,outland,1865,rogue,subtlety,107,57,50
Brensø,nemesis,1857,rogue,subtlety,99,60,39
Âkame,argent-dawn,1853,rogue,subtlety,59,32,27
Nahj,ravencrest,1851,rogue,subtlety,42,28,14
Renhri,burning-legion,1846,rogue,subtlety,266,141,125
Slapshot,das-konsortium,1845,rogue,subtlety,54,28,26
Lilaven,turalyon,1841,rogue,subtlety,156,80,76
Amén,sanguino,1833,rogue,subtlety,60,27,33
Nøctürnë,archimonde,1829,rogue,subtlety,42,26,16
Bleakhøuse,ravencrest,1829,rogue,subtlety,58,29,29
Dêlaral,der-mithrilorden,1828,rogue,subtlety,72,36,36
Lízåriñ,ravencrest,1827,rogue,subtlety,48,38,10
Rímen,archimonde,1826,rogue,subtlety,66,28,38
Chizué,sylvanas,1824,rogue,subtlety,54,34,20
Noraex,silvermoon,1822,rogue,subtlety,81,47,34
Asterisyup,silvermoon,1822,rogue,subtlety,107,61,46
Тохуо,lich-king,1822,rogue,subtlety,42,20,22
Погибайдуде,gordunni,1821,rogue,subtlety,41,34,7
Whaazlysnipz,tarren-mill,1821,rogue,subtlety,24,19,5
Роземсти,gordunni,1821,rogue,subtlety,180,95,85
Crøweta,argent-dawn,1821,rogue,subtlety,66,34,32
Radiogodx,stormscale,1817,rogue,subtlety,60,31,29
Abej,malygos,1813,rogue,subtlety,48,23,25
Kekful,defias-brotherhood,1811,rogue,subtlety,36,26,10
Deevoll,tarren-mill,1810,rogue,subtlety,95,58,37
Keophz,tarren-mill,1809,rogue,subtlety,140,90,50
Keeganx,tarren-mill,1808,rogue,subtlety,71,39,32
Gløøm,ravencrest,1806,rogue,subtlety,42,23,19
Ooqu,silvermoon,1804,rogue,subtlety,30,23,7
Xtoyo,zuljin,1804,rogue,subtlety,54,29,25
Liquidité,azuremyst,1803,rogue,subtlety,194,105,89
Knutten,wildhammer,1802,rogue,subtlety,123,72,51
Releaserage,draenor,1800,rogue,subtlety,49,26,23
Kenjí,silvermoon,1797,rogue,subtlety,143,73,70
Insomnla,silvermoon,1796,rogue,subtlety,126,67,59
Læffgøðx,stormscale,1794,rogue,subtlety,52,32,20
Лайнэл,deathweaver,1794,rogue,subtlety,83,48,35
Lhitriân,saurfang,1793,rogue,subtlety,73,40,33
Subzerõ,archimonde,1792,rogue,subtlety,262,124,138
Sly,emerald-dream,1789,rogue,subtlety,66,36,30
Featfawkes,ragnaros,1787,rogue,subtlety,78,41,37
Stonyhavana,ravencrest,1785,rogue,subtlety,84,49,35
Locgog,argent-dawn,1774,rogue,subtlety,36,25,11
Shadowprank,ravencrest,1774,rogue,subtlety,84,44,40
Zzemzza,kazzak,1772,rogue,subtlety,59,36,23
Ennvi,defias-brotherhood,1769,rogue,subtlety,30,19,11
Holaszemed,ragnaros,1757,rogue,subtlety,177,91,86
Deadraw,aegwynn,1756,rogue,subtlety,66,33,33
Stråwberrý,archimonde,1753,rogue,subtlety,57,28,29
Calestrian,tarren-mill,1750,rogue,subtlety,114,57,57
Trîçk,aegwynn,1747,rogue,subtlety,78,43,35
Sábros,ravencrest,1742,rogue,subtlety,126,60,66
Инфера,lich-king,1741,rogue,subtlety,72,33,39
Márto,archimonde,1740,rogue,subtlety,119,66,53
Иждолк,gordunni,1739,rogue,subtlety,126,66,60
Путьказаха,gordunni,1737,rogue,subtlety,54,31,23
Whøråcle,tarren-mill,1736,rogue,subtlety,53,26,27
Cheapshôt,archimonde,1734,rogue,subtlety,166,90,76
Cheapshotwin,nethersturm,1733,rogue,subtlety,36,20,16
Starfighter,pozzo-delleternità,1732,rogue,subtlety,121,67,54
Бладстейн,blackscar,1730,rogue,subtlety,112,63,49
Bruckmann,ragnaros,1730,rogue,subtlety,51,23,28
Ccedox,stormscale,1729,rogue,subtlety,30,20,10
Sunøbrain,archimonde,1729,rogue,subtlety,46,25,21
Krida,archimonde,1727,rogue,subtlety,66,32,34
Grifika,outland,1725,rogue,subtlety,87,56,31
Китей,howling-fjord,1723,rogue,subtlety,78,40,38
Läêkz,archimonde,1719,rogue,subtlety,36,18,18
Naïmitsu,hyjal,1717,rogue,subtlety,102,53,49
Брайнз,gordunni,1716,rogue,subtlety,78,53,25
Хавиа,gordunni,1712,rogue,subtlety,59,37,22
Морхалл,gordunni,1712,rogue,subtlety,66,36,30
Rinj,antonidas,1712,rogue,subtlety,42,22,20
Рели,blackscar,1711,rogue,subtlety,72,37,35
Tanssy,ragnaros,1710,rogue,subtlety,62,38,24
Namelless,twisting-nether,1708,rogue,subtlety,126,65,61
Tïnderhoe,dalaran,1705,rogue,subtlety,30,25,5
Malasap,archimonde,1705,rogue,subtlety,289,148,141
Architeggt,eredar,1700,rogue,subtlety,102,47,55
Yumiee,arygos,1697,rogue,subtlety,80,44,36
Rhayesh,silvermoon,1694,rogue,subtlety,106,51,55
Grindz,ravencrest,1693,rogue,subtlety,430,230,200
Knoffchad,blackhand,1692,rogue,subtlety,158,83,75
Nippzy,twisting-nether,1691,rogue,subtlety,108,69,39
Ninjaassasin,aegwynn,1691,rogue,subtlety,106,62,44
Ishízu,exodar,1690,rogue,subtlety,90,44,46
Kickcake,ravencrest,1688,rogue,subtlety,98,53,45
Lotorr,burning-legion,1687,rogue,subtlety,120,64,56
Azirios,kazzak,1687,rogue,subtlety,106,56,50
Denjastwo,archimonde,1686,rogue,subtlety,30,21,9
Dópamine,hyjal,1683,rogue,subtlety,52,29,23
Rantie,eredar,1675,rogue,subtlety,30,18,12
Rindar,dun-modr,1675,rogue,subtlety,176,95,81
Bloodsmell,outland,1673,rogue,subtlety,77,50,27
Anr,burning-legion,1673,rogue,subtlety,76,41,35
Susquehanna,ragnaros,1672,rogue,subtlety,96,51,45
Zayøn,outland,1671,rogue,subtlety,30,19,11
Xzr,stormscale,1668,rogue,subtlety,36,27,9
Notôríous,ravencrest,1668,rogue,subtlety,54,29,25
Ámbush,sylvanas,1668,rogue,subtlety,85,42,43
Воронкхал,ashenvale,1668,rogue,subtlety,60,29,31
Memphismp,drakthul,1667,rogue,subtlety,35,18,17
Ccedolol,stormscale,1666,rogue,subtlety,71,38,33
Kidneyyou,blackmoore,1660,rogue,subtlety,77,40,37
Mâêl,blackmoore,1659,rogue,subtlety,173,88,85
Fivepoint,blackmoore,1652,rogue,subtlety,30,20,10
Zerotyluv,silvermoon,1652,rogue,subtlety,30,20,10
Moroz,ravencrest,1652,rogue,subtlety,42,23,19
Handuil,blackmoore,1647,rogue,subtlety,205,108,97
Subsònik,tarren-mill,1645,rogue,subtlety,52,31,21
Txm,argent-dawn,1643,rogue,subtlety,42,22,20
Søllek,culte-de-la-rive-noire,1642,rogue,subtlety,36,22,14
Lânnïster,kazzak,1642,rogue,subtlety,48,23,25
Getschwîfty,ravencrest,1639,rogue,subtlety,27,18,9
Sodarogue,blackrock,1638,rogue,subtlety,38,22,16
Эдкенуэй,gordunni,1636,rogue,subtlety,131,77,54
Ratirl,kult-der-verdammten,1635,rogue,subtlety,71,41,30
Azziinoth,ragnaros,1635,rogue,subtlety,48,20,28
Dancex,kazzak,1634,rogue,subtlety,48,31,17
Rakzena,ravencrest,1634,rogue,subtlety,36,21,15
Tinylol,dun-morogh,1634,rogue,subtlety,73,42,31
Pheq,ravencrest,1633,rogue,subtlety,54,28,26
Дэмайо,gordunni,1632,rogue,subtlety,42,25,17
Slimshadyqt,terokkar,1631,rogue,subtlety,48,25,23
Ач,gordunni,1630,rogue,subtlety,54,27,27
Redcutter,silvermoon,1629,rogue,subtlety,48,27,21
Nihilix,dalaran,1629,rogue,subtlety,107,54,53
Doritomix,dun-modr,1628,rogue,subtlety,44,26,18
Кишмякх,howling-fjord,1627,rogue,subtlety,78,28,50
Weird,blackmoore,1624,rogue,subtlety,40,27,13
Mortecieca,ravencrest,1624,rogue,subtlety,36,17,19
Râpidø,elune,1624,rogue,subtlety,51,19,32
Whîspyr,blackmoore,1623,rogue,subtlety,42,21,21
Pcessleia,twisting-nether,1622,rogue,subtlety,30,17,13
Salakelmi,sylvanas,1620,rogue,subtlety,36,22,14
Plsðõntcry,ravencrest,1618,rogue,subtlety,60,33,27
Monero,thrall,1617,rogue,subtlety,73,44,29
Морзо,howling-fjord,1617,rogue,subtlety,72,43,29
Stormhardt,stormscale,1616,rogue,subtlety,51,21,30
Rmp,khaz-modan,1616,rogue,subtlety,54,21,33
Ålleyézonme,ravencrest,1615,rogue,subtlety,322,151,171
Ipøuli,quelthalas,1614,rogue,subtlety,30,17,13
Jëllyxøxø,twisting-nether,1614,rogue,subtlety,164,89,75
Oczku,burning-legion,1612,rogue,subtlety,30,17,13
Bahi,ysondre,1612,rogue,subtlety,72,34,38
Солевыегубки,gordunni,1610,rogue,subtlety,46,29,17
Zourkan,archimonde,1609,rogue,subtlety,283,158,125
Krsty,antonidas,1609,rogue,subtlety,36,20,16
Meccura,silvermoon,1607,rogue,subtlety,93,53,40
Åluñahtøpg,azjolnerub,1606,rogue,subtlety,54,23,31
Dìsørderx,ravencrest,1605,rogue,subtlety,82,44,38
Háttori,twisting-nether,1604,rogue,subtlety,42,24,18
Aszaryn,magtheridon,1601,rogue,subtlety,54,32,22
Sunå,archimonde,1600,rogue,subtlety,36,19,17
Хасилей,booty-bay,1596,rogue,subtlety,116,59,57
Dawnsaber,argent-dawn,1593,rogue,subtlety,36,21,15
Sÿkz,hyjal,1593,rogue,subtlety,56,25,31
Cøntrøl,stormreaver,1587,rogue,subtlety,120,66,54
Sniiky,kazzak,1586,rogue,subtlety,138,76,62
Evivalarte,burning-legion,1585,rogue,subtlety,61,34,27
Baldoh,kazzak,1584,rogue,subtlety,36,24,12
Вр,blackscar,1582,rogue,subtlety,30,18,12
Oxyrog,ravencrest,1580,rogue,subtlety,42,22,20
Chipicaua,silvermoon,1578,rogue,subtlety,42,19,23
Nitroxygen,outland,1572,rogue,subtlety,67,36,31
Smílèy,ravencrest,1572,rogue,subtlety,36,18,18
Shyy,dun-modr,1572,rogue,subtlety,54,26,28
Zømbië,kazzak,1571,rogue,subtlety,200,97,103
Màrto,archimonde,1570,rogue,subtlety,29,20,9
Madisonivyqt,blackmoore,1570,rogue,subtlety,88,46,42
Zilemjr,stormscale,1566,rogue,subtlety,104,59,45
Djswaghetti,stormscale,1566,rogue,subtlety,36,18,18
Зорго,deathguard,1564,rogue,subtlety,60,34,26
Carvyn,defias-brotherhood,1563,rogue,subtlety,30,17,13
Ÿøßø,archimonde,1562,rogue,subtlety,66,34,32
Злойкиллер,howling-fjord,1561,rogue,subtlety,48,24,24
Exiv,ragnaros,1561,rogue,subtlety,54,21,33
Quq,kazzak,1560,rogue,subtlety,147,80,67
Reezr,stormscale,1559,rogue,subtlety,78,33,45
Xkebyzlobg,outland,1558,rogue,subtlety,35,21,14
Deok,tarren-mill,1557,rogue,subtlety,30,19,11
Сармонн,howling-fjord,1556,rogue,subtlety,60,41,19
Liarø,archimonde,1555,rogue,subtlety,151,76,75
Røgger,ragnaros,1553,rogue,subtlety,141,65,76
Exanimu,ravencrest,1550,rogue,subtlety,132,58,74
Opaska,ravencrest,1549,rogue,subtlety,77,40,37
Frequenzalfa,silvermoon,1549,rogue,subtlety,40,20,20
Pfourtwenty,eredar,1547,rogue,subtlety,36,18,18
Voki,dalaran,1546,rogue,subtlety,105,58,47
Droomprins,stormscale,1541,rogue,subtlety,42,23,19
Старллесс,gordunni,1540,rogue,subtlety,256,137,119
Jaikka,archimonde,1539,rogue,subtlety,36,24,12
Meldee,burning-legion,1539,rogue,subtlety,42,21,21
Mxx,stormscale,1537,rogue,subtlety,151,89,62
Gøldzahn,antonidas,1536,rogue,subtlety,36,18,18
Kidneyou,ragnaros,1535,rogue,subtlety,30,18,12
Shadystabby,stormscale,1534,rogue,subtlety,89,48,41
Alexandra,kazzak,1534,rogue,subtlety,90,42,48
Ziqqi,thrall,1531,rogue,subtlety,78,37,41
Sinist,twisting-nether,1531,rogue,subtlety,50,23,27
Счастливое,howling-fjord,1529,rogue,subtlety,110,57,53
Нэйлио,deepholm,1527,rogue,subtlety,24,16,8
Súpremé,ravencrest,1526,rogue,subtlety,54,35,19
Ipresskidney,tarren-mill,1523,rogue,subtlety,158,84,74
Fivepointx,blackmoore,1523,rogue,subtlety,66,33,33
Zôuloulou,archimonde,1522,rogue,subtlety,63,35,28
Royalflüx,grim-batol,1522,rogue,subtlety,81,41,40
Kidknee,outland,1522,rogue,subtlety,36,18,18
Rogueas,stormscale,1521,rogue,subtlety,41,25,16
Ванэйти,gordunni,1520,rogue,subtlety,316,164,152
Skýfire,ravencrest,1519,rogue,subtlety,60,28,32
Шадовкилер,blackscar,1517,rogue,subtlety,90,48,42
Бэрнии,howling-fjord,1517,rogue,subtlety,176,89,87
Nopzs,outland,1516,rogue,subtlety,48,27,21
Trapstar,stormscale,1516,rogue,subtlety,90,44,46
Dölf,archimonde,1515,rogue,subtlety,164,90,74
Hoodrogue,blackrock,1514,rogue,subtlety,74,39,35
Loopermann,silvermoon,1514,rogue,subtlety,100,51,49
Îüçkÿmêñ,outland,1512,rogue,subtlety,31,19,12
Zodracir,scarshield-legion,1512,rogue,subtlety,36,17,19
Daggerdashx,ravencrest,1511,rogue,subtlety,455,246,209
Xãwé,kazzak,1509,rogue,subtlety,45,26,19
Shinzaoh,khaz-modan,1509,rogue,subtlety,64,33,31
Yourexwifey,ravencrest,1508,rogue,subtlety,92,52,40
Txf,aegwynn,1508,rogue,subtlety,36,20,16
Ripcurll,grim-batol,1507,rogue,subtlety,39,21,18
Onlyluvhurt,dun-modr,1506,rogue,subtlety,106,58,48
Säxnthecrity,blackmoore,1506,rogue,subtlety,306,154,152
Shâdowfreeze,onyxia,1505,rogue,subtlety,72,39,33
Вагнеса,howling-fjord,1504,rogue,subtlety,89,46,43
Falewyn,ragnaros,1503,rogue,subtlety,24,16,8
Vögue,burning-legion,1500,rogue,subtlety,61,27,34
Críppléz,ravencrest,1494,rogue,subtlety,90,47,43
Haikyu,blackhand,1493,rogue,subtlety,42,17,25
Абисиан,soulflayer,1490,rogue,subtlety,78,42,36
Dødgez,cthun,1489,rogue,subtlety,28,16,12
Akwaaba,ravencrest,1489,rogue,subtlety,81,38,43
Xok,draenor,1487,rogue,subtlety,52,26,26
Шпилля,gordunni,1487,rogue,subtlety,77,38,39
Leepz,outland,1486,rogue,subtlety,60,38,22
Miiløx,silvermoon,1484,rogue,subtlety,47,20,27
Пусякиллерх,gordunni,1482,rogue,subtlety,24,16,8
Diazz,aegwynn,1482,rogue,subtlety,36,20,16
Shízzel,blackhand,1481,rogue,subtlety,72,37,35
Roanz,stormreaver,1479,rogue,subtlety,49,24,25
Kire,daggerspine,1478,rogue,subtlety,65,30,35
Ramses,onyxia,1478,rogue,subtlety,60,25,35
Гэнт,soulflayer,1477,rogue,subtlety,42,20,22
Pérplèxîty,thrall,1475,rogue,subtlety,49,28,21
Maroshko,argent-dawn,1475,rogue,subtlety,36,20,16
Ömme,archimonde,1474,rogue,subtlety,84,44,40
Nâzaar,antonidas,1473,rogue,subtlety,84,49,35
Belwarx,darksorrow,1471,rogue,subtlety,49,16,33
Jqmie,ravencrest,1470,rogue,subtlety,50,28,22
Распяздяй,gordunni,1469,rogue,subtlety,48,30,18
Spr,malfurion,1468,rogue,subtlety,106,58,48
Xalupa,dun-modr,1468,rogue,subtlety,42,19,23
Jaydeeñ,ravencrest,1468,rogue,subtlety,36,16,20
Neirdà,hyjal,1468,rogue,subtlety,43,19,24
Ghøstkid,blackrock,1467,rogue,subtlety,78,40,38
Dígga,nemesis,1467,rogue,subtlety,66,32,34
Veryscaryguý,twisting-nether,1464,rogue,subtlety,54,33,21
Tripleníne,silvermoon,1464,rogue,subtlety,59,34,25
Röguelol,outland,1460,rogue,subtlety,42,20,22
Winwin,silvermoon,1459,rogue,subtlety,148,90,58
Ænutz,ysondre,1458,rogue,subtlety,33,18,15
Tonaxstab,ragnaros,1458,rogue,subtlety,42,21,21
Sashikorosu,archimonde,1457,rogue,subtlety,116,65,51
Absol,hellscream,1456,rogue,subtlety,48,29,19
Azovrouge,terokkar,1456,rogue,subtlety,159,88,71
Norlix,ravencrest,1455,rogue,subtlety,66,30,36
Johnnyprep,ravencrest,1454,rogue,subtlety,54,29,25
Sacrehptit,naxxramas,1450,rogue,subtlety,42,26,16
Nightq,tarren-mill,1450,rogue,subtlety,57,34,23
Unsullièd,kazzak,1449,rogue,subtlety,30,16,14
Helloimjohn,darksorrow,1449,rogue,subtlety,47,25,22
Critmaker,outland,1448,rogue,subtlety,24,16,8
Текин,howling-fjord,1448,rogue,subtlety,54,31,23
Peechiyy,blackmoore,1447,rogue,subtlety,69,39,30
Shaeni,silvermoon,1447,rogue,subtlety,205,105,100
Местьбучи,howling-fjord,1446,rogue,subtlety,78,42,36
Zerozsub,tarren-mill,1445,rogue,subtlety,111,64,47
Tinyshank,drakthul,1444,rogue,subtlety,50,28,22
Mortnoïre,naxxramas,1443,rogue,subtlety,72,36,36
Mont,nemesis,1443,rogue,subtlety,72,36,36
Rat,mazrigos,1440,rogue,subtlety,24,15,9
Calpic,sanguino,1439,rogue,subtlety,148,79,69
Panigalex,veknilash,1438,rogue,subtlety,33,19,14
Inyria,outland,1438,rogue,subtlety,118,61,57
Aläen,ravencrest,1437,rogue,subtlety,37,20,17
Dêlaral,blackhand,1437,rogue,subtlety,30,15,15
Тира,grom,1436,rogue,subtlety,30,15,15
Лютьер,soulflayer,1435,rogue,subtlety,120,62,58
Ruck,madmortem,1434,rogue,subtlety,30,18,12
Trashbàg,alakir,1432,rogue,subtlety,30,15,15
Achterom,tarren-mill,1432,rogue,subtlety,128,59,69
Morgan,argent-dawn,1431,rogue,subtlety,60,35,25
Nairobii,tarren-mill,1430,rogue,subtlety,30,19,11
Strangeboy,ravencrest,1430,rogue,subtlety,24,15,9
Jaqenhghar,pozzo-delleternità,1429,rogue,subtlety,97,51,46
Grzech,burning-legion,1429,rogue,subtlety,82,40,42
Mâtâtâ,die-ewige-wacht,1428,rogue,subtlety,77,42,35
Reprouvette,dalaran,1425,rogue,subtlety,24,16,8
Ilrunne,silvermoon,1425,rogue,subtlety,34,17,17
Ibizå,ravencrest,1423,rogue,subtlety,82,39,43
Smo,kargath,1422,rogue,subtlety,32,16,16
Givilwtf,eredar,1421,rogue,subtlety,66,33,33
Zx,frostmane,1420,rogue,subtlety,36,17,19
Sùbzerø,archimonde,1419,rogue,subtlety,36,18,18
Grimdoll,tarren-mill,1418,rogue,subtlety,193,108,85
Nìghtwalker,ravencrest,1416,rogue,subtlety,94,49,45
Darkxenojiva,blackmoore,1415,rogue,subtlety,54,22,32
Doperog,antonidas,1414,rogue,subtlety,78,45,33
Xblackhole,tarren-mill,1414,rogue,subtlety,104,52,52
Elfreyja,archimonde,1413,rogue,subtlety,69,33,36
Жабоклик,gordunni,1412,rogue,subtlety,92,47,45
Svddendeath,ragnaros,1412,rogue,subtlety,59,30,29
Самерон,howling-fjord,1411,rogue,subtlety,36,24,12
Xulem,silvermoon,1411,rogue,subtlety,58,34,24
Augustina,draenor,1410,rogue,subtlety,30,15,15
Сабик,howling-fjord,1408,rogue,subtlety,36,22,14
Râáy,blackrock,1408,rogue,subtlety,114,52,62
Doxxei,draenor,1407,rogue,subtlety,148,78,70
Kyssme,archimonde,1407,rogue,subtlety,36,15,21
Jamzyrogue,emerald-dream,1405,rogue,subtlety,36,19,17
Teba,cthun,1404,rogue,subtlety,40,19,21
Ворейн,howling-fjord,1402,rogue,subtlety,114,57,57
Sumsarx,ravencrest,1400,rogue,subtlety,77,38,39
Decoyed,sylvanas,1400,rogue,subtlety,36,17,19
Морнер,howling-fjord,1398,rogue,subtlety,54,27,27
Deathcvlt,hyjal,1398,rogue,subtlety,226,112,114
Jáyjay,antonidas,1395,rogue,subtlety,66,28,38
Galathea,turalyon,1394,rogue,subtlety,90,46,44
Zeiden,sanguino,1393,rogue,subtlety,48,23,25
Exbandit,sanguino,1392,rogue,subtlety,54,36,18
Rhûlf,ravencrest,1392,rogue,subtlety,55,27,28
Actualcarry,dentarg,1391,rogue,subtlety,50,28,22
Chipson,kazzak,1391,rogue,subtlety,36,17,19
Cortzy,stormscale,1391,rogue,subtlety,40,15,25
Skillissuex,tarren-mill,1389,rogue,subtlety,298,160,138
Midoa,nerathor,1388,rogue,subtlety,34,23,11
Ðàrx,archimonde,1388,rogue,subtlety,36,17,19
Billybang,outland,1387,rogue,subtlety,88,48,40
Daekrun,argent-dawn,1387,rogue,subtlety,56,30,26
Fullblind,tarren-mill,1387,rogue,subtlety,51,27,24
Бэтх,soulflayer,1386,rogue,subtlety,54,32,22
Rêve,the-maelstrom,1386,rogue,subtlety,34,19,15
Смекрус,soulflayer,1386,rogue,subtlety,117,59,58
Rexore,ravencrest,1385,rogue,subtlety,30,15,15
Lechatbotté,tarren-mill,1384,rogue,subtlety,48,29,19
Ryzem,archimonde,1383,rogue,subtlety,381,200,181
Tripoid,draenor,1381,rogue,subtlety,54,25,29
Дакоока,soulflayer,1378,rogue,subtlety,24,16,8
Óoo,outland,1377,rogue,subtlety,36,18,18
Trímønâ,gorgonnash,1374,rogue,subtlety,36,16,20
Crimatoria,rajaxx,1373,rogue,subtlety,51,23,28
Binbág,draenor,1372,rogue,subtlety,108,62,46
Дернирог,howling-fjord,1372,rogue,subtlety,67,33,34
Анивиана,howling-fjord,1371,rogue,subtlety,134,64,70
Appatras,tarren-mill,1369,rogue,subtlety,23,15,8
Kryptonite,nemesis,1368,rogue,subtlety,52,27,25
Behindü,frostmane,1368,rogue,subtlety,54,27,27
Ванябигпуш,blackscar,1367,rogue,subtlety,54,27,27
Subhub,ragnaros,1366,rogue,subtlety,48,21,27
Gankbang,frostmane,1363,rogue,subtlety,78,35,43
Dàwn,boulderfist,1361,rogue,subtlety,58,32,26
Эвисирейт,gordunni,1356,rogue,subtlety,36,17,19
Feinted,kazzak,1354,rogue,subtlety,80,40,40
Зенофар,soulflayer,1353,rogue,subtlety,190,88,102
Gamezcorex,aegwynn,1353,rogue,subtlety,52,22,30
Кэйтлис,howling-fjord,1353,rogue,subtlety,42,17,25
Trimøná,gorgonnash,1351,rogue,subtlety,24,15,9
Kãlí,blackmoore,1349,rogue,subtlety,42,19,23
Vexior,argent-dawn,1347,rogue,subtlety,51,22,29
Эквалири,gordunni,1345,rogue,subtlety,71,33,38
Lilrookie,argent-dawn,1344,rogue,subtlety,104,58,46
Freemmr,draenor,1344,rogue,subtlety,65,32,33
Evasión,aegwynn,1343,rogue,subtlety,42,22,20
Såj,tarren-mill,1343,rogue,subtlety,30,14,16
Stealthi,stormscale,1343,rogue,subtlety,36,14,22
Lilbubblegum,emerald-dream,1342,rogue,subtlety,24,14,10
Roguestuff,silvermoon,1341,rogue,subtlety,18,14,4
Lêmon,argent-dawn,1341,rogue,subtlety,40,24,16
Aati,the-maelstrom,1341,rogue,subtlety,48,25,23
Akyô,archimonde,1340,rogue,subtlety,24,14,10
Tripx,ravencrest,1340,rogue,subtlety,121,64,57
Althieves,ravencrest,1339,rogue,subtlety,94,51,43
Sapperinö,sylvanas,1338,rogue,subtlety,227,114,113
Venøøm,eredar,1338,rogue,subtlety,56,28,28
Эренх,gordunni,1337,rogue,subtlety,137,71,66
Simsub,tarren-mill,1337,rogue,subtlety,30,14,16
Nitelite,outland,1335,rogue,subtlety,30,14,16
Yakio,silvermoon,1334,rogue,subtlety,48,19,29
Isucu,burning-legion,1333,rogue,subtlety,72,40,32
Ñavy,archimonde,1332,rogue,subtlety,78,33,45
Maam,ravencrest,1331,rogue,subtlety,48,26,22
Пораменяться,gordunni,1328,rogue,subtlety,117,55,62
Akira,outland,1327,rogue,subtlety,78,46,32
Wraithh,minahonda,1327,rogue,subtlety,60,31,29
Bleeds,thrall,1324,rogue,subtlety,47,24,23
Jenz,blackmoore,1321,rogue,subtlety,30,14,16
Mercyã,outland,1316,rogue,subtlety,54,29,25
Knifeparty,silvermoon,1316,rogue,subtlety,30,16,14
Pidroseus,argent-dawn,1316,rogue,subtlety,35,16,19
Saptrinket,stormscale,1316,rogue,subtlety,337,154,183
Decrios,outland,1315,rogue,subtlety,36,14,22
Shiréz,blackmoore,1311,rogue,subtlety,54,29,25
Boorza,silvermoon,1309,rogue,subtlety,30,16,14
Ultraviølett,gorgonnash,1308,rogue,subtlety,46,20,26
Levíeus,blackrock,1305,rogue,subtlety,132,73,59
Bloodwraith,stormscale,1305,rogue,subtlety,36,14,22
Monoxid,eredar,1302,rogue,subtlety,63,31,32
Sicariø,argent-dawn,1301,rogue,subtlety,53,25,28
Luckeri,antonidas,1300,rogue,subtlety,66,32,34
Эйфуча,gordunni,1298,rogue,subtlety,52,26,26
Моямайя,eversong,1293,rogue,subtlety,53,25,28
Интерфи,blackscar,1293,rogue,subtlety,68,31,37
Roguebot,draenor,1290,rogue,subtlety,65,32,33
Cataleýa,outland,1289,rogue,subtlety,24,16,8
Qiiss,stormscale,1287,rogue,subtlety,48,26,22
Kouru,outland,1287,rogue,subtlety,42,20,22
Yokze,ravencrest,1287,rogue,subtlety,36,15,21
Cnac,stormscale,1286,rogue,subtlety,46,18,28
Йзвинись,howling-fjord,1284,rogue,subtlety,42,21,21
Jimaal,stormscale,1283,rogue,subtlety,42,20,22
Прошмандэ,gordunni,1282,rogue,subtlety,30,15,15
Тучёна,soulflayer,1281,rogue,subtlety,60,35,25
Ракфорн,howling-fjord,1281,rogue,subtlety,161,77,84
Fugly,ragnaros,1281,rogue,subtlety,37,14,23
Swâggerino,kazzak,1280,rogue,subtlety,62,32,30
Xeggy,turalyon,1279,rogue,subtlety,166,92,74
Niapro,dun-morogh,1277,rogue,subtlety,42,21,21
Лофиан,gordunni,1275,rogue,subtlety,60,28,32
Pixelrogue,argent-dawn,1274,rogue,subtlety,34,20,14
Backcracker,thunderhorn,1274,rogue,subtlety,30,15,15
Мипракн,fordragon,1273,rogue,subtlety,36,25,11
Ézzah,blackhand,1273,rogue,subtlety,110,47,63
Ouvrebwate,archimonde,1272,rogue,subtlety,23,14,9
Guiltythief,stormscale,1272,rogue,subtlety,37,18,19
Янимагу,soulflayer,1271,rogue,subtlety,55,24,31
Zanaken,stormscale,1270,rogue,subtlety,181,90,91
Sénsorium,draenor,1267,rogue,subtlety,119,58,61
Шикорро,soulflayer,1266,rogue,subtlety,36,18,18
Chãøs,silvermoon,1265,rogue,subtlety,24,15,9
Smeyra,magtheridon,1262,rogue,subtlety,114,63,51
Ултра,gordunni,1262,rogue,subtlety,141,69,72
Subzy,burning-legion,1260,rogue,subtlety,120,63,57
Usainßreak,chogall,1258,rogue,subtlety,24,14,10
Cesârion,antonidas,1258,rogue,subtlety,255,123,132
Callboy,turalyon,1256,rogue,subtlety,42,20,22
Yasu,outland,1256,rogue,subtlety,46,20,26
Фирмиана,howling-fjord,1253,rogue,subtlety,66,35,31
Axelaz,ravencrest,1247,rogue,subtlety,24,13,11
Xyúmopjoßblú,ravencrest,1247,rogue,subtlety,30,13,17
Missesinvis,blackmoore,1246,rogue,subtlety,18,13,5
Latscholol,malorne,1245,rogue,subtlety,96,50,46
Зити,blackscar,1243,rogue,subtlety,24,13,11
Masanari,die-nachtwache,1243,rogue,subtlety,38,15,23
Cørek,blackhand,1241,rogue,subtlety,24,13,11
Vanquishz,arathor,1240,rogue,subtlety,30,13,17
Gingahboy,doomhammer,1239,rogue,subtlety,161,93,68
Лэйкиро,gordunni,1239,rogue,subtlety,24,13,11
Sambä,sanguino,1238,rogue,subtlety,54,27,27
Cowmbat,tarren-mill,1238,rogue,subtlety,32,14,18
Злайа,blackscar,1238,rogue,subtlety,42,17,25
Eriksonn,drakthul,1237,rogue,subtlety,37,17,20
Лиргенвард,deathguard,1236,rogue,subtlety,64,25,39
Siktiritos,malganis,1232,rogue,subtlety,66,30,36
Sheldowws,tarren-mill,1231,rogue,subtlety,24,13,11
Alekkush,silvermoon,1231,rogue,subtlety,30,13,17
Nexieane,ravencrest,1230,rogue,subtlety,154,76,78
Jugalos,ravencrest,1230,rogue,subtlety,35,13,22
Djeud,archimonde,1229,rogue,subtlety,76,45,31
Kïdney,stormscale,1228,rogue,subtlety,48,26,22
Silnce,outland,1227,rogue,subtlety,78,36,42
Yamajinzu,blackmoore,1227,rogue,subtlety,72,33,39
Suikastman,silvermoon,1225,rogue,subtlety,22,14,8
Vorsix,tarren-mill,1222,rogue,subtlety,32,18,14
Wøølfgang,archimonde,1222,rogue,subtlety,83,39,44
Пузэн,howling-fjord,1221,rogue,subtlety,72,48,24
Misantropia,nemesis,1220,rogue,subtlety,96,41,55
Галиновна,soulflayer,1218,rogue,subtlety,67,33,34
Arrzhan,silvermoon,1217,rogue,subtlety,80,47,33
Inextricabil,stormscale,1217,rogue,subtlety,30,14,16
Эрихард,howling-fjord,1217,rogue,subtlety,35,16,19
Asine,boulderfist,1217,rogue,subtlety,30,13,17
Zergroidz,kazzak,1215,rogue,subtlety,140,67,73
Buttonsfly,silvermoon,1214,rogue,subtlety,74,49,25
Ксионас,gordunni,1212,rogue,subtlety,82,36,46
Zavebe,nathrezim,1212,rogue,subtlety,33,14,19
Stin,blackrock,1212,rogue,subtlety,94,39,55
Mealy,auchindoun,1211,rogue,subtlety,66,32,34
Duzhel,kazzak,1211,rogue,subtlety,29,14,15
Vanéry,ravencrest,1210,rogue,subtlety,24,13,11
Theriaeu,ravencrest,1207,rogue,subtlety,51,26,25
Gansull,nemesis,1207,rogue,subtlety,30,13,17
Ganker,antonidas,1202,rogue,subtlety,30,15,15
Heulleise,die-ewige-wacht,1201,rogue,subtlety,27,15,12
Трикстэд,soulflayer,1197,rogue,subtlety,24,14,10
Nínjutsu,ravencrest,1197,rogue,subtlety,32,14,18
Xaiko,baelgun,1196,rogue,subtlety,38,23,15
Erenyeagerx,kazzak,1194,rogue,subtlety,89,41,48
Zelìx,frostmane,1190,rogue,subtlety,48,29,19
Maxtnulaujeu,archimonde,1190,rogue,subtlety,59,29,30
Чайрлайн,blackscar,1190,rogue,subtlety,40,17,23
Zvarka,drakthul,1185,rogue,subtlety,18,13,5
Киржик,soulflayer,1183,rogue,subtlety,36,18,18
Рестинписер,soulflayer,1183,rogue,subtlety,135,65,70
Venom,stormscale,1182,rogue,subtlety,17,13,4
Adwl,archimonde,1182,rogue,subtlety,135,62,73
Hashlund,stormscale,1181,rogue,subtlety,38,17,21
Ithru,twisting-nether,1179,rogue,subtlety,225,118,107
Валанбалас,soulflayer,1179,rogue,subtlety,48,25,23
Попочке,soulflayer,1175,rogue,subtlety,36,23,13
Thehand,eonar,1175,rogue,subtlety,72,39,33
Tyrly,ravencrest,1175,rogue,subtlety,112,50,62
Shuffeyrt,frostmane,1172,rogue,subtlety,48,26,22
Сладкийперец,borean-tundra,1172,rogue,subtlety,52,24,28
Rogueseanne,blackrock,1171,rogue,subtlety,72,32,40
Jisz,doomhammer,1170,rogue,subtlety,78,39,39
Mckk,tarren-mill,1168,rogue,subtlety,71,36,35
Taniwa,archimonde,1167,rogue,subtlety,53,23,30
Ropedrink,stormscale,1161,rogue,subtlety,21,13,8
Heskmad,kazzak,1161,rogue,subtlety,50,22,28
Lêgòlàs,blackmoore,1160,rogue,subtlety,101,56,45
Ðarëk,dun-modr,1159,rogue,subtlety,48,19,29
Darkan,kaelthas,1158,rogue,subtlety,66,38,28
Instealth,draenor,1155,rogue,subtlety,108,45,63
Flambî,dalaran,1153,rogue,subtlety,82,41,41
Скорпеон,deathguard,1152,rogue,subtlety,48,32,16
Nasklagattv,hyjal,1152,rogue,subtlety,18,12,6
Skitzo,ravencrest,1152,rogue,subtlety,24,12,12
Озхоггер,gordunni,1151,rogue,subtlety,18,12,6
Vizifyx,ravencrest,1150,rogue,subtlety,18,12,6
Stepdancer,blackmoore,1150,rogue,subtlety,24,12,12
Нойсеен,gordunni,1150,rogue,subtlety,24,12,12
Hængøvèr,antonidas,1150,rogue,subtlety,30,12,18
Mecu,ravencrest,1149,rogue,subtlety,18,12,6
Byebyé,ravencrest,1149,rogue,subtlety,24,12,12
Narar,stormscale,1147,rogue,subtlety,36,23,13
Teralala,kazzak,1146,rogue,subtlety,24,12,12
Коффемолка,ashenvale,1146,rogue,subtlety,66,26,40
Sâybyëbæ,dun-modr,1142,rogue,subtlety,30,12,18
Jomoama,norgannon,1142,rogue,subtlety,36,14,22
Mitaktika,silvermoon,1140,rogue,subtlety,18,12,6
Lovetospoon,ravencrest,1140,rogue,subtlety,43,22,21
Turrok,ravencrest,1139,rogue,subtlety,36,17,19
Avøry,antonidas,1139,rogue,subtlety,48,15,33
Smoothiè,twisting-nether,1138,rogue,subtlety,82,37,45
Valiéna,dun-morogh,1136,rogue,subtlety,52,20,32
Ithilyien,blackmoore,1134,rogue,subtlety,62,21,41
Paveli,ravencrest,1133,rogue,subtlety,66,28,38
Berneo,burning-legion,1133,rogue,subtlety,36,13,23
Niinim,draenor,1129,rogue,subtlety,207,112,95
Duo,karazhan,1128,rogue,subtlety,54,18,36
Anala,stormreaver,1123,rogue,subtlety,24,14,10
Faelylanea,argent-dawn,1122,rogue,subtlety,36,16,20
Ambushmike,gorgonnash,1121,rogue,subtlety,87,40,47
Sebik,ravencrest,1118,rogue,subtlety,23,12,11
Neoly,outland,1117,rogue,subtlety,24,16,8
Mysies,ysondre,1117,rogue,subtlety,29,13,16
Coronababy,argent-dawn,1111,rogue,subtlety,24,13,11
Lånaya,sylvanas,1111,rogue,subtlety,42,17,25
Obsçuritý,ragnaros,1106,rogue,subtlety,56,31,25
Unreallx,silvermoon,1102,rogue,subtlety,80,36,44
Denjas,archimonde,1098,rogue,subtlety,28,15,13
Stuxothug,silvermoon,1097,rogue,subtlety,61,33,28
Coaraze,eldrethalas,1096,rogue,subtlety,30,12,18
Jailkaz,thrall,1093,rogue,subtlety,29,13,16
Koutzai,stormscale,1090,rogue,subtlety,53,20,33
Syneth,drakthul,1087,rogue,subtlety,21,13,8
Беточка,gordunni,1087,rogue,subtlety,54,31,23
Yüm,burning-blade,1087,rogue,subtlety,59,25,34
Blantek,defias-brotherhood,1083,rogue,subtlety,30,16,14
Dallrend,stormscale,1078,rogue,subtlety,36,16,20
Underarmor,kul-tiras,1078,rogue,subtlety,45,14,31
Fastspectre,ravencrest,1077,rogue,subtlety,54,29,25
Stâr,archimonde,1077,rogue,subtlety,28,13,15
Зацеп,gordunni,1073,rogue,subtlety,36,22,14
Zenajlz,outland,1073,rogue,subtlety,22,12,10
Streîk,hyjal,1072,rogue,subtlety,72,32,40
Löka,amanthul,1071,rogue,subtlety,117,59,58
Псиихооз,eversong,1070,rogue,subtlety,25,13,12
Vampor,sylvanas,1070,rogue,subtlety,42,13,29
Jacktripper,blackrock,1066,rogue,subtlety,30,12,18
Розбэйник,gordunni,1065,rogue,subtlety,42,23,19
Copoka,dun-morogh,1063,rogue,subtlety,30,16,14
Zkittlez,blackhand,1056,rogue,subtlety,18,11,7
Elnyasha,ravencrest,1056,rogue,subtlety,24,11,13
Sátyrícon,ravencrest,1056,rogue,subtlety,24,11,13
Roundrobin,ravencrest,1056,rogue,subtlety,30,11,19
Xyzonk,kazzak,1055,rogue,subtlety,18,11,7
Like,aegwynn,1055,rogue,subtlety,21,12,9
Сабанутый,howling-fjord,1055,rogue,subtlety,96,52,44
Aouron,archimonde,1055,rogue,subtlety,25,13,12
Флеймсфорт,gordunni,1055,rogue,subtlety,35,16,19
Hersuub,blackmoore,1055,rogue,subtlety,41,18,23
Adskydroch,ravencrest,1054,rogue,subtlety,18,11,7
Kleptomancy,sylvanas,1054,rogue,subtlety,18,11,7
Режупополам,howling-fjord,1052,rogue,subtlety,18,11,7
Murkyy,gilneas,1052,rogue,subtlety,18,11,7
Zappsarap,onyxia,1052,rogue,subtlety,24,11,13
Bamsejuicee,kazzak,1050,rogue,subtlety,18,11,7
Johnyqt,hyjal,1049,rogue,subtlety,18,11,7
Shirá,hyjal,1049,rogue,subtlety,18,11,7
Йованов,gordunni,1048,rogue,subtlety,18,11,7
Celendyl,ravencrest,1045,rogue,subtlety,24,13,11
Соважь,soulflayer,1044,rogue,subtlety,24,11,13
Meshay,kazzak,1043,rogue,subtlety,19,11,8
Вишнуизм,gordunni,1043,rogue,subtlety,30,11,19
Snack,burning-legion,1040,rogue,subtlety,27,12,15
Fodepalmas,sanguino,1040,rogue,subtlety,53,22,31
Pochîta,blackrock,1038,rogue,subtlety,53,24,29
Mojojina,theradras,1037,rogue,subtlety,24,12,12
Drakaess,archimonde,1032,rogue,subtlety,24,11,13
Protolink,zuljin,1032,rogue,subtlety,64,25,39
Bandèra,ragnaros,1032,rogue,subtlety,42,16,26
Whaiipy,ravencrest,1031,rogue,subtlety,95,53,42
Горланг,ashenvale,1031,rogue,subtlety,29,15,14
Calyon,hyjal,1031,rogue,subtlety,47,12,35
ßøß,ysondre,1030,rogue,subtlety,74,32,42
Shibaii,archimonde,1029,rogue,subtlety,54,17,37
Finkle,blackmoore,1027,rogue,subtlety,30,11,19
Nirvána,outland,1026,rogue,subtlety,73,35,38
Byonics,durotan,1024,rogue,subtlety,18,11,7
Зебол,howling-fjord,1024,rogue,subtlety,36,17,19
Yamoshí,sanguino,1024,rogue,subtlety,34,15,19
Рэйбэк,howling-fjord,1024,rogue,subtlety,30,11,19
Умбрен,lich-king,1016,rogue,subtlety,30,18,12
Mercìles,kazzak,1011,rogue,subtlety,43,25,18
Idrîl,rashgarroth,1009,rogue,subtlety,24,14,10
Вайлиция,ashenvale,1007,rogue,subtlety,39,21,18
Lyroth,silvermoon,1002,rogue,subtlety,17,11,6
Xoxoxoxoxoxö,archimonde,1001,rogue,subtlety,29,13,16
Skankky,ragnaros,1000,rogue,subtlety,18,12,6
Sênsus,antonidas,999,rogue,subtlety,86,30,56
Leylaris,argent-dawn,998,rogue,subtlety,30,12,18
Axeldarq,draenor,998,rogue,subtlety,39,11,28
Cuckboy,chogall,997,rogue,subtlety,55,31,24
Rêdbello,dun-morogh,997,rogue,subtlety,57,32,25
Drakhez,sanguino,995,rogue,subtlety,18,12,6
Bartolomew,hellscream,995,rogue,subtlety,27,12,15
Pitmaster,burning-legion,992,rogue,subtlety,71,35,36
Sassasine,amanthul,992,rogue,subtlety,58,26,32
Garretygdar,nazjatar,991,rogue,subtlety,30,14,16
Mïta,blackmoore,991,rogue,subtlety,30,11,19
Эбиб,soulflayer,987,rogue,subtlety,22,11,11
Jorppe,kazzak,986,rogue,subtlety,24,12,12
Charbiya,silvermoon,986,rogue,subtlety,24,12,12
Fizgaroth,argent-dawn,980,rogue,subtlety,55,31,24
Thicck,twisting-nether,980,rogue,subtlety,48,13,35
Gimliwitdega,doomhammer,977,rogue,subtlety,142,74,68
Sycko,alakir,976,rogue,subtlety,48,28,20
Dudemar,ravencrest,975,rogue,subtlety,24,11,13
Тайнушка,soulflayer,973,rogue,subtlety,42,17,25
Reginlief,argent-dawn,972,rogue,subtlety,47,21,26
Ratolí,dun-modr,970,rogue,subtlety,18,12,6
Mannheim,kazzak,968,rogue,subtlety,42,23,19
Asukabed,ravencrest,960,rogue,subtlety,18,10,8
Ripuli,alakir,960,rogue,subtlety,18,10,8
Katarïnä,khaz-modan,960,rogue,subtlety,36,19,17
Párbajkároj,ragnaros,960,rogue,subtlety,24,10,14
Mestarikélmi,ravencrest,960,rogue,subtlety,27,10,17
Noboorstsub,ravencrest,959,rogue,subtlety,12,10,2
Spykee,culte-de-la-rive-noire,959,rogue,subtlety,12,10,2
Doomdagger,chamber-of-aspects,959,rogue,subtlety,18,10,8
Bizzarerogue,tarren-mill,959,rogue,subtlety,18,10,8
Meowkek,kazzak,959,rogue,subtlety,24,10,14
Reichy,ravencrest,959,rogue,subtlety,24,10,14
Jussylol,stormscale,958,rogue,subtlety,18,10,8
Bountyhunter,malygos,958,rogue,subtlety,18,10,8
Jdç,tarren-mill,958,rogue,subtlety,18,10,8
Dedka,hyjal,958,rogue,subtlety,24,10,14
Ruckusxx,ravencrest,957,rogue,subtlety,15,11,4
Clinz,ravencrest,956,rogue,subtlety,24,10,14
Ilyrya,azuremyst,955,rogue,subtlety,18,10,8
Cozu,stormrage,955,rogue,subtlety,74,39,35
Øê,ravencrest,955,rogue,subtlety,21,10,11
Oazo,ysondre,954,rogue,subtlety,47,18,29
Stabymoose,draenor,953,rogue,subtlety,18,10,8
Káríc,draenor,953,rogue,subtlety,18,10,8
Ассаин,gordunni,952,rogue,subtlety,19,12,7
Helcof,emerald-dream,951,rogue,subtlety,24,10,14
Bzuco,tarren-mill,950,rogue,subtlety,12,10,2
Baldim,silvermoon,949,rogue,subtlety,19,10,9
Gìngèr,kazzak,948,rogue,subtlety,18,10,8
Cantseeme,anachronos,947,rogue,subtlety,30,10,20
Neymar,ysondre,943,rogue,subtlety,24,10,14
Синграйм,soulflayer,942,rogue,subtlety,48,26,22
Prøven,archimonde,940,rogue,subtlety,30,10,20
Mishøna,kazzak,939,rogue,subtlety,73,41,32
Ramone,ravencrest,935,rogue,subtlety,19,11,8
Sentaria,argent-dawn,930,rogue,subtlety,60,31,29
Hemorhoid,outland,928,rogue,subtlety,96,50,46
Owoaho,eonar,926,rogue,subtlety,24,14,10
Снарки,booty-bay,925,rogue,subtlety,64,31,33
Roguegutten,quelthalas,917,rogue,subtlety,20,11,9
Strikes,eredar,915,rogue,subtlety,30,16,14
Exi,elune,912,rogue,subtlety,27,11,16
Sensule,darkspear,908,rogue,subtlety,23,10,13
Petsakos,ravencrest,903,rogue,subtlety,27,11,16
Wìzléy,ravencrest,901,rogue,subtlety,63,32,31
Kezaay,silvermoon,900,rogue,subtlety,36,18,18
Trinchö,sanguino,894,rogue,subtlety,56,25,31
Bursthilde,blackmoore,893,rogue,subtlety,23,10,13
Lenwe,blackmoore,892,rogue,subtlety,24,10,14
Saroumani,eitrigg,891,rogue,subtlety,30,16,14
Dainhek,gilneas,889,rogue,subtlety,37,19,18
Lolblizard,gorgonnash,881,rogue,subtlety,21,12,9
Liquidgaba,ravencrest,878,rogue,subtlety,78,37,41
Mortdorei,argent-dawn,877,rogue,subtlety,79,39,40
Sneakysáp,ravencrest,864,rogue,subtlety,12,9,3
Фрозенденс,gordunni,864,rogue,subtlety,12,9,3
Kostik,ravencrest,864,rogue,subtlety,12,9,3
Hængøver,antonidas,864,rogue,subtlety,12,9,3
Rúckus,ravencrest,864,rogue,subtlety,18,9,9
Geá,ravencrest,864,rogue,subtlety,18,9,9
Axroa,blackmoore,864,rogue,subtlety,18,9,9
Ðéstr,ravencrest,864,rogue,subtlety,18,9,9
Nasklagatv,rashgarroth,864,rogue,subtlety,18,9,9
Ambulances,kazzak,863,rogue,subtlety,12,9,3
Visegrád,aggra-português,863,rogue,subtlety,12,9,3
Behêmoth,hyjal,863,rogue,subtlety,12,9,3
Skullboy,blackmoore,863,rogue,subtlety,18,9,9
Monstermads,kazzak,863,rogue,subtlety,18,9,9
Lenani,blackrock,863,rogue,subtlety,18,9,9
Рэкрейвон,gordunni,863,rogue,subtlety,18,9,9
Ryvz,ravencrest,863,rogue,subtlety,24,9,15
Oldschool,sanguino,862,rogue,subtlety,18,9,9
Ibizà,ravencrest,862,rogue,subtlety,18,9,9
Psg,argent-dawn,862,rogue,subtlety,19,9,10
Crixor,blackrock,861,rogue,subtlety,12,9,3
Orestes,pozzo-delleternità,861,rogue,subtlety,18,9,9
Duffbeer,silvermoon,861,rogue,subtlety,18,9,9
Isodad,kazzak,861,rogue,subtlety,18,9,9
Shinkillua,archimonde,860,rogue,subtlety,18,9,9
Eightball,frostmane,859,rogue,subtlety,18,9,9
Jäshin,hyjal,859,rogue,subtlety,30,9,21
Куцитар,gordunni,858,rogue,subtlety,18,9,9
Sequoja,blackrock,858,rogue,subtlety,24,9,15
Zhopsy,nemesis,857,rogue,subtlety,24,9,15
Davshadows,magtheridon,855,rogue,subtlety,42,18,24
Антиппод,razuvious,854,rogue,subtlety,15,10,5
Vanquish,laughing-skull,844,rogue,subtlety,12,9,3
Пандафей,deathweaver,831,rogue,subtlety,24,9,15
Lastkiss,aggramar,828,rogue,subtlety,17,9,8
Cabalion,draenor,828,rogue,subtlety,24,11,13
Aeønaxx,hyjal,827,rogue,subtlety,76,32,44
Муфдшы,gordunni,823,rogue,subtlety,16,10,6
Tnk,twisting-nether,817,rogue,subtlety,18,10,8
Jabbo,silvermoon,809,rogue,subtlety,29,9,20
Jénny,sylvanas,799,rogue,subtlety,74,34,40
Hahårry,ravencrest,797,rogue,subtlety,20,9,11
Singularität,silvermoon,796,rogue,subtlety,27,11,16
Houston,aegwynn,792,rogue,subtlety,20,9,11
Knifeex,ravencrest,788,rogue,subtlety,26,9,17
Ecray,burning-legion,784,rogue,subtlety,74,34,40
Skene,sanguino,780,rogue,subtlety,35,13,22
Danori,grim-batol,768,rogue,subtlety,12,8,4
Devourswine,argent-dawn,768,rogue,subtlety,12,8,4
Djdillá,kazzak,768,rogue,subtlety,12,8,4
Фрозенблейдс,gordunni,768,rogue,subtlety,12,8,4
Rannec,der-rat-von-dalaran,768,rogue,subtlety,12,8,4
Kerim,antonidas,768,rogue,subtlety,12,8,4
Tilikum,pozzo-delleternità,768,rogue,subtlety,12,8,4
Кишмякх,gordunni,768,rogue,subtlety,15,9,6
Whoton,archimonde,768,rogue,subtlety,16,9,7
Amuini,magtheridon,768,rogue,subtlety,18,8,10
Zygzäg,hyjal,768,rogue,subtlety,18,8,10
Slonerbrah,ravencrest,768,rogue,subtlety,18,8,10
Slayered,burning-legion,768,rogue,subtlety,24,8,16
Ferrãof,aggra-português,767,rogue,subtlety,12,8,4
Silesi,kazzak,767,rogue,subtlety,12,8,4
Huro,aggramar,767,rogue,subtlety,12,8,4
Thelones,antonidas,767,rogue,subtlety,12,8,4
Neyokqt,blackrock,767,rogue,subtlety,12,8,4
Zëkke,sanguino,767,rogue,subtlety,12,8,4
Ultriz,twisting-nether,767,rogue,subtlety,18,8,10
Aahz,tarren-mill,767,rogue,subtlety,18,8,10
Mdadx,stormreaver,767,rogue,subtlety,18,8,10
Neverdyingx,ragnaros,767,rogue,subtlety,18,8,10
Strangeboyxx,ravencrest,767,rogue,subtlety,18,8,10
Unbanmepls,ravencrest,767,rogue,subtlety,18,8,10
Evi,korgall,767,rogue,subtlety,18,8,10
Cirell,tarren-mill,767,rogue,subtlety,18,8,10
Whîspêr,ravencrest,767,rogue,subtlety,24,8,16
Mns,drakthul,767,rogue,subtlety,24,8,16
Иордани,gordunni,767,rogue,subtlety,24,8,16
Chazsakaï,chogall,766,rogue,subtlety,12,8,4
Чернабаев,soulflayer,766,rogue,subtlety,12,8,4
Ytaku,stormscale,766,rogue,subtlety,13,8,5
Dägorath,dun-modr,766,rogue,subtlety,16,9,7
Sokillu,silvermoon,766,rogue,subtlety,18,8,10
Jkrx,draenor,766,rogue,subtlety,18,8,10
Dræmz,twisting-nether,765,rogue,subtlety,12,8,4
Rhytmic,drakthul,765,rogue,subtlety,18,8,10
Poughkeepsie,outland,765,rogue,subtlety,18,8,10
Люняшка,booty-bay,765,rogue,subtlety,18,8,10
Лоулайф,soulflayer,765,rogue,subtlety,18,8,10
Pirry,sanguino,764,rogue,subtlety,12,8,4
Behiq,aggramar,764,rogue,subtlety,12,8,4
Purexrogue,dragonblight,764,rogue,subtlety,18,8,10
Johncéná,stormscale,764,rogue,subtlety,18,8,10
Chuckloriss,garona,764,rogue,subtlety,18,8,10
Darkral,nemesis,764,rogue,subtlety,27,10,17
Ojisanx,outland,764,rogue,subtlety,24,8,16
Akcell,silvermoon,762,rogue,subtlety,12,8,4
Deprress,silvermoon,762,rogue,subtlety,12,8,4
Djinnx,malganis,762,rogue,subtlety,24,8,16
Stabwøund,the-maelstrom,761,rogue,subtlety,12,8,4
Onemine,sanguino,752,rogue,subtlety,12,8,4
Всечтобыло,howling-fjord,748,rogue,subtlety,12,8,4
Abomïñatïøñ,ravencrest,731,rogue,subtlety,48,16,32
Gizr,haomarush,717,rogue,subtlety,47,17,30
Briggo,silvermoon,714,rogue,subtlety,23,9,14
Nakli,antonidas,713,rogue,subtlety,21,9,12
Anklash,blackrock,711,rogue,subtlety,33,9,24
Faable,silvermoon,709,rogue,subtlety,59,19,40
Allchatoff,drakthul,703,rogue,subtlety,11,8,3
Zygzåg,hyjal,703,rogue,subtlety,11,8,3
Войенх,gordunni,703,rogue,subtlety,22,8,14
Benvagin,hyjal,700,rogue,subtlety,26,8,18
Naiikaii,aegwynn,688,rogue,subtlety,14,8,6
Энбонни,gordunni,688,rogue,subtlety,19,8,11
Триплсап,howling-fjord,672,rogue,subtlety,12,7,5
Caípi,frostwolf,672,rogue,subtlety,12,7,5
Steal,nemesis,672,rogue,subtlety,12,7,5
Кумоо,gordunni,672,rogue,subtlety,12,7,5
Lemaroxd,tarren-mill,672,rogue,subtlety,12,7,5
Cucumber,laughing-skull,672,rogue,subtlety,12,7,5
Fibpatrool,ravencrest,672,rogue,subtlety,12,7,5
Zyggz,hyjal,672,rogue,subtlety,12,7,5
Natillaa,dun-modr,672,rogue,subtlety,12,7,5
Kolto,argent-dawn,672,rogue,subtlety,12,7,5
Lovethighs,argent-dawn,672,rogue,subtlety,12,7,5
Misttrogue,hyjal,672,rogue,subtlety,12,7,5
Käz,argent-dawn,672,rogue,subtlety,18,7,11
Rantie,onyxia,672,rogue,subtlety,18,7,11
Sxpped,stormscale,672,rogue,subtlety,18,7,11
Proilas,draenor,672,rogue,subtlety,18,7,11
Rîzer,ravencrest,672,rogue,subtlety,18,7,11
Hyake,zuljin,671,rogue,subtlety,12,7,5
Zep,auchindoun,671,rogue,subtlety,12,7,5
Казутора,lich-king,671,rogue,subtlety,12,7,5
Qylu,argent-dawn,671,rogue,subtlety,12,7,5
Faptastíc,blackmoore,671,rogue,subtlety,12,7,5
Zyhmø,archimonde,671,rogue,subtlety,12,7,5
Epi,stormrage,671,rogue,subtlety,12,7,5
Evadeez,tarren-mill,671,rogue,subtlety,18,7,11
Сабстил,soulflayer,671,rogue,subtlety,18,7,11
Shadowgraph,eredar,671,rogue,subtlety,18,7,11
Ellira,stormscale,671,rogue,subtlety,18,7,11
Roronao,sanguino,671,rogue,subtlety,18,7,11
Guzirogue,azshara,671,rogue,subtlety,18,7,11
Totentánz,silvermoon,671,rogue,subtlety,18,7,11
Daggoth,kiljaeden,671,rogue,subtlety,24,7,17
Princip,drakthul,671,rogue,subtlety,24,7,17
Nøtiçe,kazzak,671,rogue,subtlety,24,7,17
Gpóínt,blackmoore,670,rogue,subtlety,12,7,5
Shâdow,ravenholdt,670,rogue,subtlety,18,7,11
Edaniel,draenor,670,rogue,subtlety,18,7,11
Rekaens,sylvanas,670,rogue,subtlety,18,7,11
Lepreuchan,archimonde,669,rogue,subtlety,12,7,5
Elnos,conseil-des-ombres,668,rogue,subtlety,12,7,5
Shanos,ravencrest,667,rogue,subtlety,12,7,5
Pepperbox,twisting-nether,667,rogue,subtlety,12,7,5
Malfeasance,argent-dawn,667,rogue,subtlety,18,7,11
Natekoti,kazzak,667,rogue,subtlety,36,8,28
Cacucoxpahu,kazzak,666,rogue,subtlety,12,7,5
Энвитио,gordunni,665,rogue,subtlety,12,7,5
Posaydon,malorne,664,rogue,subtlety,18,7,11
Dellya,twisting-nether,660,rogue,subtlety,18,7,11
Shaadowz,ragnaros,658,rogue,subtlety,12,7,5
Waluuz,silvermoon,655,rogue,subtlety,11,7,4
Kikkshifter,zuluhed,650,rogue,subtlety,18,7,11
Snogri,burning-legion,648,rogue,subtlety,24,7,17
Nineball,frostmane,638,rogue,subtlety,17,7,10
Drspectres,tarren-mill,626,rogue,subtlety,78,20,58
Wurzelzepp,blackrock,622,rogue,subtlety,17,7,10
Ccrogue,nemesis,618,rogue,subtlety,15,7,8
Snake,nethersturm,609,rogue,subtlety,39,8,31
Alyannå,culte-de-la-rive-noire,607,rogue,subtlety,11,7,4
Кийян,howling-fjord,606,rogue,subtlety,11,7,4
Фогус,greymane,601,rogue,subtlety,14,8,6
Zervi,silvermoon,586,rogue,subtlety,13,7,6
Thiranor,cthun,583,rogue,subtlety,13,7,6
Naiikaii,antonidas,576,rogue,subtlety,6,6,0
Wítchblades,ravencrest,576,rogue,subtlety,6,6,0
Shinti,eredar,576,rogue,subtlety,12,6,6
Джокэссиди,blackscar,576,rogue,subtlety,12,6,6
Babøønx,burning-legion,576,rogue,subtlety,12,6,6
Nerfalliance,ravencrest,576,rogue,subtlety,12,6,6
Nephology,ravencrest,576,rogue,subtlety,12,6,6
Wraiith,chogall,576,rogue,subtlety,12,6,6
Àlleyezonme,ravencrest,576,rogue,subtlety,12,6,6
Veronkierto,stormreaver,576,rogue,subtlety,12,6,6
Radgaa,draenor,576,rogue,subtlety,12,6,6
Wtbmeld,tarren-mill,576,rogue,subtlety,12,6,6
Ðelvin,dalaran,576,rogue,subtlety,12,6,6
Уммиикк,goldrinn,576,rogue,subtlety,12,6,6
Jabbz,blackhand,576,rogue,subtlety,12,6,6
Nícks,tarren-mill,576,rogue,subtlety,12,6,6
Leanderrisin,ragnaros,576,rogue,subtlety,12,6,6
Feradelia,thrall,576,rogue,subtlety,12,6,6
Ciosy,blackrock,576,rogue,subtlety,12,6,6
Shreddera,ravencrest,576,rogue,subtlety,12,6,6
Sapco,ravencrest,576,rogue,subtlety,12,6,6
Marcel,blackrock,576,rogue,subtlety,12,6,6
Prky,doomhammer,576,rogue,subtlety,12,6,6
Daichi,onyxia,576,rogue,subtlety,12,6,6
Deceptionz,ravencrest,576,rogue,subtlety,12,6,6
Lesbinan,kazzak,576,rogue,subtlety,12,6,6
Shoamunj,archimonde,576,rogue,subtlety,12,6,6
Asäp,archimonde,576,rogue,subtlety,12,6,6
Dimidimi,wildhammer,576,rogue,subtlety,12,6,6
Coolbassoff,kazzak,576,rogue,subtlety,12,6,6
Jljr,twisting-nether,576,rogue,subtlety,12,6,6
Ghøßt,outland,576,rogue,subtlety,12,6,6
Cander,kazzak,576,rogue,subtlety,12,6,6
Hazero,frostmane,576,rogue,subtlety,12,6,6
Draytonlove,nemesis,576,rogue,subtlety,12,6,6
Rmp,outland,576,rogue,subtlety,12,6,6
Soulriver,kelthuzad,576,rogue,subtlety,15,7,8
Andrizle,blackmoore,576,rogue,subtlety,18,6,12
Хаймох,gordunni,576,rogue,subtlety,18,6,12
Kleptomaniac,aggra-português,576,rogue,subtlety,18,6,12
Åvírøñgðd,ravencrest,576,rogue,subtlety,18,6,12
Kerìon,nemesis,576,rogue,subtlety,18,6,12
Cobrâk,archimonde,576,rogue,subtlety,18,6,12
Blihhubba,silvermoon,576,rogue,subtlety,24,6,18
Batskcab,blackmoore,576,rogue,subtlety,24,6,18
Tason,argent-dawn,575,rogue,subtlety,12,6,6
Knivestikker,twisting-nether,575,rogue,subtlety,12,6,6
Botnet,blackmoore,575,rogue,subtlety,12,6,6
Igel,antonidas,575,rogue,subtlety,12,6,6
Mozzart,ragnaros,575,rogue,subtlety,12,6,6
Melfîce,blackhand,575,rogue,subtlety,12,6,6
Crispflake,frostwolf,575,rogue,subtlety,12,6,6
Exine,sanguino,575,rogue,subtlety,12,6,6
Фордрэн,deathguard,575,rogue,subtlety,16,7,9
Lookbehîndu,aegwynn,575,rogue,subtlety,18,6,12
Sombredagues,ysondre,575,rogue,subtlety,18,6,12
Varne,les-sentinelles,575,rogue,subtlety,18,6,12
Coolspot,archimonde,575,rogue,subtlety,18,6,12
Jaffar,mannoroth,575,rogue,subtlety,24,6,18
Zëd,draenor,574,rogue,subtlety,12,6,6
Тучс,gordunni,574,rogue,subtlety,13,6,7
Sylvielle,azshara,573,rogue,subtlety,12,6,6
Graymyst,outland,573,rogue,subtlety,18,6,12
Oboejoe,burning-legion,572,rogue,subtlety,18,6,12
Kucheenstab,blackrock,572,rogue,subtlety,18,6,12
Freddybst,twisting-nether,571,rogue,subtlety,12,6,6
Wolffgang,dalaran,571,rogue,subtlety,12,6,6
Lêvî,sanguino,569,rogue,subtlety,12,6,6
Demonrok,stormscale,569,rogue,subtlety,12,6,6
Mishana,thrall,567,rogue,subtlety,18,6,12
Geroge,sylvanas,566,rogue,subtlety,12,6,6
Frézzer,tirion,566,rogue,subtlety,12,6,6
Rhaacvar,magtheridon,566,rogue,subtlety,12,6,6
Grikra,argent-dawn,566,rogue,subtlety,12,6,6
Auarg,argent-dawn,565,rogue,subtlety,12,6,6
Owlcat,argent-dawn,559,rogue,subtlety,18,6,12
Grekén,bronze-dragonflight,558,rogue,subtlety,17,6,11
Puge,norgannon,557,rogue,subtlety,23,6,17
Sizzurp,kargath,555,rogue,subtlety,36,6,30
Brancovich,magtheridon,543,rogue,subtlety,11,6,5
Marryhim,blackhand,543,rogue,subtlety,17,6,11
Pavlo,nathrezim,543,rogue,subtlety,17,6,11
Zobrak,twisting-nether,542,rogue,subtlety,14,7,7
Notwhaazz,ravencrest,528,rogue,subtlety,9,7,2
Malignance,drakthul,511,rogue,subtlety,14,7,7
Saanka,eredar,511,rogue,subtlety,14,6,8
Stealthr,silvermoon,495,rogue,subtlety,11,6,5
Ripinpiece,outland,494,rogue,subtlety,19,6,13
Araniana,kazzak,480,rogue,subtlety,6,5,1
Deinorsin,outland,480,rogue,subtlety,6,5,1
Rngkillaz,archimonde,480,rogue,subtlety,6,5,1
Фэйкуои,gordunni,480,rogue,subtlety,6,5,1
Бонястелс,gordunni,480,rogue,subtlety,6,5,1
Astereex,sylvanas,480,rogue,subtlety,6,5,1
Ðoppex,blackmoore,480,rogue,subtlety,6,5,1
Beefboss,neptulon,480,rogue,subtlety,6,5,1
Mastrmind,twisting-nether,480,rogue,subtlety,6,5,1
Penetrantos,eredar,480,rogue,subtlety,6,5,1
Janx,aegwynn,480,rogue,subtlety,12,5,7
Рюджик,soulflayer,480,rogue,subtlety,12,5,7
Blazestórm,stormscale,480,rogue,subtlety,12,5,7
Øptì,ravencrest,480,rogue,subtlety,12,5,7
ßuha,stormscale,480,rogue,subtlety,12,5,7
Звиздаттый,blackscar,480,rogue,subtlety,12,5,7
Mzaa,ravencrest,480,rogue,subtlety,12,5,7
Lëmönhäzë,dun-modr,480,rogue,subtlety,12,5,7
Slicéndicé,wildhammer,480,rogue,subtlety,12,5,7
Kohakugawa,kazzak,480,rogue,subtlety,12,5,7
Menajerie,outland,480,rogue,subtlety,12,5,7
Cêline,silvermoon,480,rogue,subtlety,12,5,7
Khepaso,sanguino,480,rogue,subtlety,12,5,7
Стеллакокс,howling-fjord,480,rogue,subtlety,12,5,7
Protpaladin,sylvanas,480,rogue,subtlety,12,5,7
Киднитучер,fordragon,480,rogue,subtlety,12,5,7
Fragmint,aggra-português,480,rogue,subtlety,12,5,7
Soufraki,tarren-mill,480,rogue,subtlety,12,5,7
Khazren,ravencrest,480,rogue,subtlety,12,5,7
Фрозеншедов,gordunni,480,rogue,subtlety,12,5,7
Кашеварить,gordunni,480,rogue,subtlety,12,5,7
Lurk,saurfang,480,rogue,subtlety,12,5,7
Ddhelpra,blackrock,480,rogue,subtlety,12,5,7
Кмска,soulflayer,480,rogue,subtlety,12,5,7
Rsksrb,tarren-mill,480,rogue,subtlety,12,5,7
Loznah,outland,480,rogue,subtlety,12,5,7
Smörkniven,argent-dawn,480,rogue,subtlety,12,5,7
Served,twisting-nether,480,rogue,subtlety,12,5,7
Aluneran,silvermoon,480,rogue,subtlety,12,5,7
Tashunkosapa,xavius,480,rogue,subtlety,12,5,7
Xatra,hyjal,480,rogue,subtlety,12,5,7
Waakø,todeswache,480,rogue,subtlety,12,5,7
Akazuki,alleria,480,rogue,subtlety,12,5,7
Késs,aegwynn,480,rogue,subtlety,12,5,7
Srtumor,zuljin,480,rogue,subtlety,12,5,7
Takenòtes,nemesis,480,rogue,subtlety,12,5,7
Darkveil,xavius,480,rogue,subtlety,12,5,7
Nhonhonho,silvermoon,480,rogue,subtlety,12,5,7
Ajwenx,ravencrest,480,rogue,subtlety,18,5,13
Ðefsmøkêz,tyrande,480,rogue,subtlety,18,5,13
Typhoo,ravencrest,480,rogue,subtlety,30,5,25
Andayn,shattered-hand,479,rogue,subtlety,6,5,1
Giftdolken,outland,479,rogue,subtlety,12,5,7
Spinetapper,ravencrest,479,rogue,subtlety,12,5,7
Shiverbane,sargeras,479,rogue,subtlety,12,5,7
Smorcoolio,stormscale,479,rogue,subtlety,12,5,7
Raizø,argent-dawn,479,rogue,subtlety,12,5,7
Ryxon,arathor,479,rogue,subtlety,12,5,7
Tøxykø,archimonde,479,rogue,subtlety,12,5,7
Optoo,ragnaros,479,rogue,subtlety,12,5,7
Nanary,blackrock,479,rogue,subtlety,12,5,7
Abrhykoo,hyjal,479,rogue,subtlety,12,5,7
Emìlia,tarren-mill,479,rogue,subtlety,12,5,7
Grocco,doomhammer,479,rogue,subtlety,12,5,7
Nøxia,hyjal,479,rogue,subtlety,12,5,7
Ôzzi,draenor,479,rogue,subtlety,12,5,7
Smøth,ysondre,479,rogue,subtlety,15,6,9
Zyklvn,zuljin,479,rogue,subtlety,18,5,13
Bultars,argent-dawn,479,rogue,subtlety,18,5,13
Sayy,nemesis,479,rogue,subtlety,18,5,13
Lylestra,neptulon,479,rogue,subtlety,18,5,13
Misscash,ragnaros,478,rogue,subtlety,6,5,1
Soulreapeer,twisting-nether,478,rogue,subtlety,21,6,15
Mozenn,draenor,478,rogue,subtlety,19,5,14
Эльтаэрон,gordunni,477,rogue,subtlety,12,5,7
Приколдэсса,gordunni,477,rogue,subtlety,18,5,13
Shurkan,antonidas,475,rogue,subtlety,12,5,7
Mallaurya,dalaran,474,rogue,subtlety,12,5,7
Roguevatar,quelthalas,471,rogue,subtlety,18,5,13
Kalstab,silvermoon,447,rogue,subtlety,8,6,2
Кумаме,howling-fjord,447,rogue,subtlety,11,5,6
Sedái,twisting-nether,447,rogue,subtlety,14,6,8
Сексикаесу,soulflayer,431,rogue,subtlety,11,5,6
Райан,fordragon,431,rogue,subtlety,11,5,6
Iwillberone,ravencrest,431,rogue,subtlety,17,5,12
Itsforme,kazzak,415,rogue,subtlety,14,5,9
Yakku,drakthul,415,rogue,subtlety,20,5,15
Bystroscy,silvermoon,398,rogue,subtlety,10,5,5
Algopyrin,ragnaros,396,rogue,subtlety,13,5,8
Kilabre,twisting-nether,384,rogue,subtlety,6,4,2
Ocklol,archimonde,384,rogue,subtlety,6,4,2
Takiya,ysondre,384,rogue,subtlety,6,4,2
Lulune,frostmane,384,rogue,subtlety,6,4,2
Тенероби,soulflayer,384,rogue,subtlety,6,4,2
Yörgs,eredar,384,rogue,subtlety,6,4,2
Thedarkness,sylvanas,384,rogue,subtlety,6,4,2
Siele,twisting-nether,384,rogue,subtlety,6,4,2
Rakuwata,the-maelstrom,384,rogue,subtlety,6,4,2
Nxnja,silvermoon,384,rogue,subtlety,6,4,2
Rubberducky,argent-dawn,384,rogue,subtlety,6,4,2
Darx,sunstrider,384,rogue,subtlety,6,4,2
Иннхотеп,howling-fjord,384,rogue,subtlety,6,4,2
Ðazzrog,archimonde,384,rogue,subtlety,6,4,2
Supremacy,sylvanas,384,rogue,subtlety,6,4,2
Джеанит,gordunni,384,rogue,subtlety,6,4,2
Elyndri,archimonde,384,rogue,subtlety,6,4,2
Spyzie,hyjal,384,rogue,subtlety,6,4,2
Ënd,ravencrest,384,rogue,subtlety,6,4,2
Choclatéosol,archimonde,384,rogue,subtlety,6,4,2
Talayr,argent-dawn,384,rogue,subtlety,6,4,2
Okiboo,silvermoon,384,rogue,subtlety,6,4,2
Mega,nordrassil,384,rogue,subtlety,6,4,2
Arkblenderx,silvermoon,384,rogue,subtlety,6,4,2
Omeger,thrall,384,rogue,subtlety,6,4,2
Stabmaster,outland,384,rogue,subtlety,6,4,2
Shreya,blackrock,384,rogue,subtlety,6,4,2
Mol,defias-brotherhood,384,rogue,subtlety,6,4,2
Лолнайт,blackscar,384,rogue,subtlety,6,4,2
Körtel,tarren-mill,384,rogue,subtlety,6,4,2
Møgzu,blackmoore,384,rogue,subtlety,6,4,2
Djnelly,stormreaver,384,rogue,subtlety,6,4,2
Blckrogue,bloodfeather,384,rogue,subtlety,6,4,2
Pinnar,blackmoore,384,rogue,subtlety,6,4,2
Shadôwcraft,outland,384,rogue,subtlety,6,4,2
Seeralex,anetheron,384,rogue,subtlety,6,4,2
Kppz,burning-legion,384,rogue,subtlety,6,4,2
Snýz,darksorrow,384,rogue,subtlety,6,4,2
Артимидушка,gordunni,384,rogue,subtlety,6,4,2
Альтушкаа,gordunni,384,rogue,subtlety,6,4,2
Cawzi,silvermoon,384,rogue,subtlety,6,4,2
Дракакула,blackscar,384,rogue,subtlety,9,5,4
Nîmaj,hyjal,384,rogue,subtlety,12,6,6
Hyrule,onyxia,384,rogue,subtlety,12,4,8
Øzs,argent-dawn,384,rogue,subtlety,12,4,8
Kurichu,archimonde,384,rogue,subtlety,12,4,8
Senorino,tarren-mill,384,rogue,subtlety,12,4,8
Даняпрекринж,azuregos,384,rogue,subtlety,12,4,8
Fatedancer,outland,384,rogue,subtlety,12,4,8
Zélla,twisting-nether,384,rogue,subtlety,12,4,8
Нунас,soulflayer,384,rogue,subtlety,12,4,8
Battousai,burning-legion,384,rogue,subtlety,12,4,8
Lupos,anubarak,384,rogue,subtlety,12,4,8
Mînz,twisting-nether,384,rogue,subtlety,12,4,8
Kénzos,silvermoon,384,rogue,subtlety,12,4,8
Whiteløtûs,dun-modr,384,rogue,subtlety,12,4,8
Rekki,terokkar,384,rogue,subtlety,12,4,8
Misamia,nemesis,384,rogue,subtlety,12,4,8
Later,saurfang,384,rogue,subtlety,12,4,8
Huprâ,ravencrest,384,rogue,subtlety,12,4,8
Xanders,draenor,384,rogue,subtlety,12,4,8
Raglaron,draenor,384,rogue,subtlety,12,4,8
Taishani,thrall,384,rogue,subtlety,12,4,8
Dîspatchx,defias-brotherhood,384,rogue,subtlety,12,4,8
Szabina,outland,384,rogue,subtlety,12,4,8
Alleyezonme,stormscale,384,rogue,subtlety,12,4,8
Vanisha,outland,384,rogue,subtlety,12,4,8
Бейнс,howling-fjord,384,rogue,subtlety,12,4,8
Zordochrog,kazzak,384,rogue,subtlety,12,4,8
Ýýçyka,kazzak,384,rogue,subtlety,12,4,8
Skaúr,malganis,384,rogue,subtlety,12,4,8
Zhadowên,kazzak,384,rogue,subtlety,12,4,8
Asmodal,antonidas,384,rogue,subtlety,12,4,8
Saryotv,silvermoon,384,rogue,subtlety,12,4,8
Bagirä,sylvanas,384,rogue,subtlety,15,4,11
Galore,azjolnerub,384,rogue,subtlety,18,4,14
Очч,blackscar,384,rogue,subtlety,18,4,14
Бллейз,gordunni,384,rogue,subtlety,18,4,14
Backstabjr,blackmoore,384,rogue,subtlety,18,4,14
Vaelaestra,argent-dawn,384,rogue,subtlety,18,4,14
Plot,zenedar,384,rogue,subtlety,18,4,14
Haregan,gorgonnash,383,rogue,subtlety,6,4,2
Vanishdotcom,blackrock,383,rogue,subtlety,6,4,2
Alovina,stormscale,383,rogue,subtlety,6,4,2
Бекро,gordunni,383,rogue,subtlety,6,4,2
Nomota,sanguino,383,rogue,subtlety,12,4,8
Helsperd,draenor,383,rogue,subtlety,12,4,8
Delenor,stormscale,383,rogue,subtlety,18,4,14
Niceplan,frostmane,382,rogue,subtlety,7,6,1
Belina,draenor,382,rogue,subtlety,6,4,2
Ashâa,hyjal,382,rogue,subtlety,6,4,2
Madnessbg,tarren-mill,382,rogue,subtlety,6,4,2
Adelr,onyxia,382,rogue,subtlety,12,4,8
Rookierook,draenor,382,rogue,subtlety,12,4,8
Gobygoby,naxxramas,382,rogue,subtlety,12,4,8
Ergaviota,colinas-pardas,381,rogue,subtlety,30,4,26
Nekros,chromaggus,379,rogue,subtlety,12,4,8
Xeløe,hyjal,330,rogue,subtlety,14,5,9
Opiïum,ysondre,303,rogue,subtlety,7,4,3
Checkormate,aegwynn,288,rogue,subtlety,6,3,3
Cylizr,stormscale,288,rogue,subtlety,6,3,3
Ragroh,burning-legion,288,rogue,subtlety,6,3,3
Disembowel,ravencrest,288,rogue,subtlety,6,3,3
Vexxey,magtheridon,288,rogue,subtlety,6,3,3
Pøpsmoke,outland,288,rogue,subtlety,6,3,3
Synergize,stormreaver,288,rogue,subtlety,6,3,3
Skimpy,stormscale,288,rogue,subtlety,6,3,3
Sethr,blackmoore,288,rogue,subtlety,6,3,3
Natsukage,blackmoore,288,rogue,subtlety,6,3,3
Peeon,drakthul,288,rogue,subtlety,6,3,3
Royalflux,grim-batol,288,rogue,subtlety,6,3,3
Bízkit,stormscale,288,rogue,subtlety,6,3,3
Sáp,blackmoore,288,rogue,subtlety,6,3,3
Gvcci,aegwynn,288,rogue,subtlety,6,3,3
Roguanal,hyjal,288,rogue,subtlety,6,3,3
Sutisong,dun-modr,288,rogue,subtlety,6,3,3
Kaleigh,grim-batol,288,rogue,subtlety,6,3,3
Nhèl,stormscale,288,rogue,subtlety,6,3,3
Arydir,quelthalas,288,rogue,subtlety,6,3,3
Pocketpaw,stormreaver,288,rogue,subtlety,6,3,3
Garou,blackhand,288,rogue,subtlety,6,3,3
Shadxwstep,ravencrest,288,rogue,subtlety,6,3,3
Skrbke,tarren-mill,288,rogue,subtlety,6,3,3
Buffassa,ravencrest,288,rogue,subtlety,6,3,3
Nezukóchan,ravencrest,288,rogue,subtlety,6,3,3
Horvathzu,ravencrest,288,rogue,subtlety,6,3,3
Sâitama,zuljin,288,rogue,subtlety,6,3,3
Ezk,eredar,288,rogue,subtlety,6,3,3
Akamee,temple-noir,288,rogue,subtlety,6,3,3
Finanzamtlg,blackrock,288,rogue,subtlety,6,3,3
Jøwy,archimonde,288,rogue,subtlety,6,3,3
Baradiir,defias-brotherhood,288,rogue,subtlety,6,3,3
Qira,burning-blade,288,rogue,subtlety,6,3,3
Vultzy,draenor,288,rogue,subtlety,6,3,3
Пупичудо,howling-fjord,288,rogue,subtlety,6,3,3
Sweetcc,amanthul,288,rogue,subtlety,6,3,3
Seregolas,argent-dawn,288,rogue,subtlety,6,3,3
Sshaka,tarren-mill,288,rogue,subtlety,6,3,3
Кверест,howling-fjord,288,rogue,subtlety,6,3,3
Shythairogue,area-52,288,rogue,subtlety,6,3,3
Vanisshh,hyjal,288,rogue,subtlety,6,3,3
Candyshot,thrall,288,rogue,subtlety,6,3,3
Mekóz,draenor,288,rogue,subtlety,6,3,3
Jeanklanche,archimonde,288,rogue,subtlety,6,3,3
Pretylo,marécage-de-zangar,288,rogue,subtlety,6,3,3
Zenone,marécage-de-zangar,288,rogue,subtlety,6,3,3
Sadgexd,draenor,288,rogue,subtlety,6,3,3
Synthaetic,draenor,288,rogue,subtlety,6,3,3
Røguøross,archimonde,288,rogue,subtlety,6,3,3
Nerica,kazzak,288,rogue,subtlety,6,3,3
Waakie,frostmane,288,rogue,subtlety,6,3,3
Jáckz,twisting-nether,288,rogue,subtlety,6,3,3
Xhemil,tarren-mill,288,rogue,subtlety,6,3,3
Viiltäjäjack,stormscale,288,rogue,subtlety,6,3,3
Jechijr,silvermoon,288,rogue,subtlety,6,3,3
Элисандресса,gordunni,288,rogue,subtlety,6,3,3
Swiftyfan,silvermoon,288,rogue,subtlety,6,3,3
Кеспул,soulflayer,288,rogue,subtlety,6,3,3
Iöny,silvermoon,288,rogue,subtlety,6,3,3
Jawen,silvermoon,288,rogue,subtlety,6,3,3
Читэри,soulflayer,288,rogue,subtlety,6,3,3
Izzyb,auchindoun,288,rogue,subtlety,6,3,3
Стэйм,gordunni,288,rogue,subtlety,6,3,3
Hallogenic,silvermoon,288,rogue,subtlety,6,3,3
Кейнилин,gordunni,288,rogue,subtlety,6,3,3
Uareincombat,drakthul,288,rogue,subtlety,11,3,8
Chililôl,dun-modr,288,rogue,subtlety,12,3,9
Nohks,blackmoore,288,rogue,subtlety,12,3,9
Bîgbîzeps,thrall,288,rogue,subtlety,12,3,9
Snøv,outland,288,rogue,subtlety,12,3,9
Bú,nemesis,288,rogue,subtlety,12,3,9
Hikorust,drakthul,288,rogue,subtlety,12,3,9
Girlname,the-maelstrom,288,rogue,subtlety,12,3,9
Kongnognog,ragnaros,288,rogue,subtlety,12,3,9
Skíll,sanguino,288,rogue,subtlety,12,3,9
Faded,terokkar,288,rogue,subtlety,12,3,9
Zappdead,frostwolf,288,rogue,subtlety,12,3,9
Cbrook,sylvanas,288,rogue,subtlety,12,3,9
Vancleéf,sylvanas,288,rogue,subtlety,12,3,9
Rufinol,twisting-nether,288,rogue,subtlety,12,3,9
Kïbs,dalaran,288,rogue,subtlety,12,3,9
Donchichi,archimonde,288,rogue,subtlety,12,3,9
Тарний,gordunni,288,rogue,subtlety,12,3,9
Воробнальщик,soulflayer,288,rogue,subtlety,12,3,9
Izame,archimonde,288,rogue,subtlety,12,3,9
Byaow,ravencrest,288,rogue,subtlety,12,3,9
Ñú,ravencrest,288,rogue,subtlety,12,3,9
Zoldyck,bloodhoof,288,rogue,subtlety,12,3,9
Ристоврация,gordunni,288,rogue,subtlety,12,3,9
Pestctrl,argent-dawn,288,rogue,subtlety,12,3,9
Kiksi,ravencrest,288,rogue,subtlety,12,3,9
Nÿst,khaz-modan,288,rogue,subtlety,12,3,9
Xéshon,tarren-mill,288,rogue,subtlety,12,3,9
Envenoman,ravencrest,288,rogue,subtlety,12,3,9
Kenchio,elune,288,rogue,subtlety,12,3,9
Liirja,twisting-nether,288,rogue,subtlety,18,3,15
Sinxgødx,outland,288,rogue,subtlety,18,3,15
Grris,stormscale,288,rogue,subtlety,18,3,15
Leukhra,dun-modr,287,rogue,subtlety,6,3,3
Shåkø,tarren-mill,287,rogue,subtlety,6,3,3
Téhashcéé,archimonde,287,rogue,subtlety,6,3,3
Pummra,kul-tiras,287,rogue,subtlety,6,3,3
Styggvanas,tarren-mill,287,rogue,subtlety,15,4,11
Djsapblindx,archimonde,287,rogue,subtlety,12,3,9
Skeeto,blackmoore,287,rogue,subtlety,12,3,9
Котуй,borean-tundra,287,rogue,subtlety,12,3,9
Боузи,howling-fjord,287,rogue,subtlety,12,3,9
Darkolive,defias-brotherhood,287,rogue,subtlety,13,3,10
Furrooscuro,sanguino,287,rogue,subtlety,18,3,15
Celenium,chogall,287,rogue,subtlety,24,3,21
Ракельяр,blackscar,286,rogue,subtlety,6,3,3
Cesar,blackhand,286,rogue,subtlety,6,3,3
Jontor,deathwing,286,rogue,subtlety,12,3,9
Raneya,antonidas,286,rogue,subtlety,18,3,15
Pis,nagrand,255,rogue,subtlety,8,4,4
Madlain,jaedenar,255,rogue,subtlety,8,4,4
Шмарамышь,soulflayer,255,rogue,subtlety,8,4,4
Machmacan,thrall,239,rogue,subtlety,5,3,2
Trinketeflag,archimonde,239,rogue,subtlety,5,3,2
Juuzou,outland,239,rogue,subtlety,5,3,2
Boornys,burning-legion,224,rogue,subtlety,10,3,7
Piperx,ravencrest,223,rogue,subtlety,8,3,5
Loom,sylvanas,192,rogue,subtlety,9,3,6
Imnotnice,terenas,192,rogue,subtlety,9,3,6
Zte,frostmane,192,rogue,subtlety,6,2,4
Медиивэл,deepholm,192,rogue,subtlety,6,2,4
Knezr,silvermoon,192,rogue,subtlety,6,2,4
Breuss,elune,192,rogue,subtlety,6,2,4
Brinvilliers,aegwynn,192,rogue,subtlety,6,2,4
Mècr,outland,192,rogue,subtlety,6,2,4
Illmindofboo,twisting-nether,192,rogue,subtlety,6,2,4
Botsrogue,kazzak,192,rogue,subtlety,6,2,4
Stigh,twisting-nether,192,rogue,subtlety,6,2,4
Pottomzola,ragnaros,192,rogue,subtlety,6,2,4
Azkiel,archimonde,192,rogue,subtlety,6,2,4
Кеонетво,howling-fjord,192,rogue,subtlety,6,2,4
Kìnsley,archimonde,192,rogue,subtlety,6,2,4
Колстар,howling-fjord,192,rogue,subtlety,6,2,4
Рогаупорога,howling-fjord,192,rogue,subtlety,6,2,4
Ksunq,hyjal,192,rogue,subtlety,6,2,4
Bananashow,aegwynn,192,rogue,subtlety,6,2,4
Giftknirps,silvermoon,192,rogue,subtlety,6,2,4
Kyupi,hyjal,192,rogue,subtlety,6,2,4
Steálth,silvermoon,192,rogue,subtlety,6,2,4
Ayatsuji,nemesis,192,rogue,subtlety,6,2,4
Katara,antonidas,192,rogue,subtlety,6,2,4
Elthalulz,illidan,192,rogue,subtlety,6,2,4
Yulitz,dun-modr,192,rogue,subtlety,6,2,4
Voices,dentarg,192,rogue,subtlety,6,2,4
Kylìemirogue,blackrock,192,rogue,subtlety,6,2,4
Caská,blackhand,192,rogue,subtlety,6,2,4
Chokee,blackrock,192,rogue,subtlety,6,2,4
Evilbiscuit,quelthalas,192,rogue,subtlety,6,2,4
Malvaxxs,tarren-mill,192,rogue,subtlety,6,2,4
Recondite,doomhammer,192,rogue,subtlety,6,2,4
Skaterboy,stormscale,192,rogue,subtlety,6,2,4
Вэндиго,deathweaver,192,rogue,subtlety,6,2,4
Stealthyist,darkmoon-faire,192,rogue,subtlety,6,2,4
Blóodless,stormscale,192,rogue,subtlety,6,2,4
Gameøvr,sanguino,192,rogue,subtlety,6,2,4
Røxxilly,blackmoore,192,rogue,subtlety,6,2,4
Nefqq,stormscale,192,rogue,subtlety,6,2,4
Thriva,blackmoore,192,rogue,subtlety,6,2,4
Epidemic,stormscale,192,rogue,subtlety,6,2,4
Ggyoulowbro,blackmoore,192,rogue,subtlety,6,2,4
Ît,stormscale,192,rogue,subtlety,6,2,4
Gosleep,stormscale,192,rogue,subtlety,6,2,4
Aikaza,blackmoore,192,rogue,subtlety,6,2,4
Trytocapnoob,stormscale,192,rogue,subtlety,6,2,4
Hade,stormscale,192,rogue,subtlety,6,2,4
Rbgdowngrade,ravencrest,192,rogue,subtlety,6,2,4
Jæto,ravencrest,192,rogue,subtlety,6,2,4
Выебузадницу,soulflayer,192,rogue,subtlety,6,2,4
Ноумингод,gordunni,192,rogue,subtlety,6,2,4
Reyzumi,antonidas,192,rogue,subtlety,6,2,4
Грустныйрог,gordunni,192,rogue,subtlety,6,2,4
Pøggerhontas,antonidas,192,rogue,subtlety,6,2,4
Muzkek,argent-dawn,192,rogue,subtlety,6,2,4
Wrathed,stormreaver,192,rogue,subtlety,6,2,4
Enoìla,blackmoore,192,rogue,subtlety,6,2,4
Renyth,argent-dawn,192,rogue,subtlety,6,2,4
Subaslaw,ravencrest,192,rogue,subtlety,6,2,4
Fumai,blackmoore,192,rogue,subtlety,6,2,4
Lenây,blackmoore,192,rogue,subtlety,6,2,4
Canelitae,minahonda,192,rogue,subtlety,6,2,4
Deadchivalry,argent-dawn,192,rogue,subtlety,6,2,4
Дзендэр,soulflayer,192,rogue,subtlety,6,2,4
Navaton,sanguino,192,rogue,subtlety,6,2,4
Рикимартини,gordunni,192,rogue,subtlety,6,2,4
Sqc,ravencrest,192,rogue,subtlety,6,2,4
Aëlynn,la-croisade-écarlate,192,rogue,subtlety,6,2,4
Lilsalad,ravencrest,192,rogue,subtlety,6,2,4
Скиррона,gordunni,192,rogue,subtlety,6,2,4
Insidióus,sylvanas,192,rogue,subtlety,6,2,4
Sohnisch,azshara,192,rogue,subtlety,6,2,4
Le,stormreaver,192,rogue,subtlety,6,2,4
Голадриель,gordunni,192,rogue,subtlety,6,2,4
Feylia,terenas,192,rogue,subtlety,6,2,4
Dhayna,shendralar,192,rogue,subtlety,6,2,4
Sigleif,argent-dawn,192,rogue,subtlety,6,2,4
Ежикх,soulflayer,192,rogue,subtlety,6,2,4
Misimisi,sanguino,192,rogue,subtlety,6,2,4
Leviathann,doomhammer,192,rogue,subtlety,6,2,4
Ackyrogue,ysondre,192,rogue,subtlety,6,2,4
Inviscuz,draenor,192,rogue,subtlety,6,2,4
Selecta,bloodhoof,192,rogue,subtlety,6,2,4
Rehab,draenor,192,rogue,subtlety,6,2,4
Cälisto,drakthul,192,rogue,subtlety,6,2,4
Nïhal,suramar,192,rogue,subtlety,6,2,4
Isteria,sylvanas,192,rogue,subtlety,6,2,4
Гамбиит,gordunni,192,rogue,subtlety,6,2,4
Sykin,eredar,192,rogue,subtlety,6,2,4
Fatnutsac,eredar,192,rogue,subtlety,6,2,4
Isseen,burning-legion,192,rogue,subtlety,6,2,4
Greiskull,cthun,192,rogue,subtlety,15,3,12
Падинайди,howling-fjord,192,rogue,subtlety,12,2,10
Tàazz,archimonde,192,rogue,subtlety,12,2,10
Килрилон,lich-king,192,rogue,subtlety,12,2,10
Acheravar,antonidas,192,rogue,subtlety,12,2,10
Кингксу,gordunni,192,rogue,subtlety,12,2,10
Deróthus,arathor,192,rogue,subtlety,12,2,10
Destrektor,kazzak,192,rogue,subtlety,12,2,10
Pandagonstab,shadowsong,192,rogue,subtlety,12,2,10
Кизо,blackscar,192,rogue,subtlety,12,2,10
Thurgodd,silvermoon,192,rogue,subtlety,12,2,10
Bauwten,ravencrest,192,rogue,subtlety,12,2,10
Zappdaddy,frostwolf,192,rogue,subtlety,12,2,10
Erèlenn,draenor,192,rogue,subtlety,12,2,10
Shacopaco,zuljin,192,rogue,subtlety,12,2,10
Goldenblitz,blackmoore,192,rogue,subtlety,12,2,10
Бигсмурф,gordunni,192,rogue,subtlety,12,2,10
Nomad,sylvanas,192,rogue,subtlety,12,2,10
Shaklyn,antonidas,192,rogue,subtlety,12,2,10
Refundlands,kazzak,192,rogue,subtlety,12,2,10
Cramzes,defias-brotherhood,192,rogue,subtlety,12,2,10
Verstopt,azjolnerub,192,rogue,subtlety,12,2,10
Shènzo,tarren-mill,192,rogue,subtlety,12,2,10
Cøsmøz,dalaran,192,rogue,subtlety,12,2,10
Surinamort,voljin,192,rogue,subtlety,12,2,10
Мутина,galakrond,192,rogue,subtlety,12,2,10
Jackpot,sargeras,192,rogue,subtlety,12,2,10
Grogun,tyrande,192,rogue,subtlety,14,2,12
Afrodittan,dun-modr,192,rogue,subtlety,16,2,14
Kaynasi,hyjal,192,rogue,subtlety,24,2,22
Injux,blackmoore,191,rogue,subtlety,6,2,4
Mamus,tarren-mill,191,rogue,subtlety,6,2,4
Scratcheye,twisting-nether,191,rogue,subtlety,12,2,10
Røsenstërn,ravencrest,191,rogue,subtlety,12,2,10
Killboom,rexxar,191,rogue,subtlety,12,2,10
Roxley,der-mithrilorden,191,rogue,subtlety,12,2,10
Sephika,chants-éternels,180,rogue,subtlety,20,5,15
Cutscene,argent-dawn,159,rogue,subtlety,5,2,3
Maitrefurtif,argent-dawn,159,rogue,subtlety,5,2,3
Гароона,blackscar,159,rogue,subtlety,5,2,3
Julekos,ravenholdt,159,rogue,subtlety,5,2,3
Kidneyqt,thrall,159,rogue,subtlety,5,2,3
Biggut,khadgar,144,rogue,subtlety,3,3,0
Paranoiaqt,outland,144,rogue,subtlety,9,2,7
Sicu,malganis,138,rogue,subtlety,10,4,6
Projectindex,malganis,138,rogue,subtlety,10,4,6
Macon,arthas,138,rogue,subtlety,18,4,14
Fatzaky,turalyon,138,rogue,subtlety,14,3,11
Núb,burning-blade,138,rogue,subtlety,15,3,12
Earnedblood,kazzak,128,rogue,subtlety,4,2,2
Pzylol,anetheron,96,rogue,subtlety,3,2,1
Songoro,tirion,96,rogue,subtlety,3,2,1
Nixze,tarren-mill,96,rogue,subtlety,6,1,5
Schleichor,aegwynn,96,rogue,subtlety,6,1,5
Qikerip,drekthar,96,rogue,subtlety,6,1,5
Faso,thunderhorn,96,rogue,subtlety,6,1,5
Genesiz,sylvanas,96,rogue,subtlety,6,1,5
Dáydreamín,draenor,96,rogue,subtlety,6,1,5
Retaya,draenor,96,rogue,subtlety,6,1,5
Aasy,silvermoon,96,rogue,subtlety,6,1,5
Carnagè,dentarg,96,rogue,subtlety,6,1,5
Cabbagerolls,argent-dawn,96,rogue,subtlety,6,1,5
Гламурятина,gordunni,96,rogue,subtlety,6,1,5
Yaelynn,argent-dawn,96,rogue,subtlety,6,1,5
Trxë,twisting-nether,96,rogue,subtlety,6,1,5
Imbazed,azshara,96,rogue,subtlety,6,1,5
Intrix,draenor,96,rogue,subtlety,6,1,5
Neskagrall,aegwynn,96,rogue,subtlety,6,1,5
Verk,twilights-hammer,96,rogue,subtlety,6,1,5
Senzus,twisting-nether,96,rogue,subtlety,6,1,5
Элонли,gordunni,96,rogue,subtlety,6,1,5
Invisage,grim-batol,96,rogue,subtlety,6,1,5
Kkraken,dalaran,96,rogue,subtlety,6,1,5
Twinkyzzö,archimonde,96,rogue,subtlety,6,1,5
Menzo,ravencrest,96,rogue,subtlety,6,1,5
Настябэкстаб,gordunni,96,rogue,subtlety,6,1,5
Malborko,ravencrest,96,rogue,subtlety,6,1,5
Darkkstep,blackmoore,96,rogue,subtlety,6,1,5
Kødäy,hyjal,96,rogue,subtlety,6,1,5
Klingo,defias-brotherhood,96,rogue,subtlety,6,1,5
Kunigunde,shattered-hand,96,rogue,subtlety,6,1,5
Førtñîtégøðx,eredar,96,rogue,subtlety,6,1,5
Synsinte,silvermoon,96,rogue,subtlety,6,1,5
Àrléngødx,kazzak,96,rogue,subtlety,6,1,5
Тимкок,soulflayer,96,rogue,subtlety,6,1,5
Jokis,uldum,96,rogue,subtlety,6,1,5
Razcallz,arthas,96,rogue,subtlety,6,1,5
Daunt,antonidas,96,rogue,subtlety,6,1,5
Könän,dalaran,96,rogue,subtlety,6,1,5
Стронг,soulflayer,96,rogue,subtlety,6,1,5
Loulina,outland,96,rogue,subtlety,6,1,5
Sumcrit,ravencrest,96,rogue,subtlety,6,1,5
Outride,outland,96,rogue,subtlety,6,1,5
Nerkmind,ragnaros,96,rogue,subtlety,6,1,5
Shrèéd,blackmoore,96,rogue,subtlety,6,1,5
Proesis,ravencrest,96,rogue,subtlety,6,1,5
Slashendash,outland,96,rogue,subtlety,6,1,5
Sørä,ragnaros,96,rogue,subtlety,6,1,5
Depleter,outland,96,rogue,subtlety,6,1,5
Letheus,stormscale,96,rogue,subtlety,6,1,5
Мадарец,howling-fjord,96,rogue,subtlety,6,1,5
Deccosneak,defias-brotherhood,96,rogue,subtlety,6,1,5
Ðarkbleeds,ravencrest,96,rogue,subtlety,6,1,5
Tebzr,ravencrest,96,rogue,subtlety,6,1,5
Аквик,howling-fjord,96,rogue,subtlety,6,1,5
Øpti,ravencrest,96,rogue,subtlety,6,1,5
Clownsap,blackhand,96,rogue,subtlety,6,1,5
Ótsutsukí,kazzak,96,rogue,subtlety,6,1,5
Fintex,ravencrest,96,rogue,subtlety,6,1,5
Chøsen,stormscale,96,rogue,subtlety,6,1,5
Vellira,khaz-modan,96,rogue,subtlety,6,1,5
Lookbehindu,stormscale,96,rogue,subtlety,6,1,5
Щасбудетвайп,howling-fjord,96,rogue,subtlety,6,1,5
Tyranoxoth,stormscale,96,rogue,subtlety,6,1,5
Korteina,darkmoon-faire,96,rogue,subtlety,6,1,5
Тварьебаная,howling-fjord,96,rogue,subtlety,6,1,5
Stepbaack,silvermoon,96,rogue,subtlety,8,1,7
Nønchalan,twisting-nether,96,rogue,subtlety,12,1,11
Critneyspear,runetotem,96,rogue,subtlety,12,1,11
Gífti,norgannon,96,rogue,subtlety,12,1,11
Stabie,twisting-nether,96,rogue,subtlety,12,1,11
Calmrusgirl,ravenholdt,96,rogue,subtlety,12,1,11
Azzineth,silvermoon,96,rogue,subtlety,12,1,11
Rnghero,blackmoore,96,rogue,subtlety,12,1,11
Альдинг,howling-fjord,96,rogue,subtlety,12,1,11
Subzhero,draenor,96,rogue,subtlety,12,1,11
Nullname,ragnaros,96,rogue,subtlety,12,1,11
Xý,ysondre,96,rogue,subtlety,18,1,17
Swexlairone,outland,95,rogue,subtlety,12,1,11
Maláika,silvermoon,89,rogue,subtlety,8,3,5
Digmorre,drakthul,79,rogue,subtlety,5,1,4
Nesth,silvermoon,79,rogue,subtlety,5,1,4
Deadlybrew,twisting-nether,79,rogue,subtlety,5,1,4
Domiqs,blackhand,63,rogue,subtlety,2,2,0
Rylie,garona,63,rogue,subtlety,2,2,0
Ридлли,soulflayer,48,rogue,subtlety,3,1,2
Alvoriace,hyjal,48,rogue,subtlety,3,1,2
Ddlcmg,drakthul,48,rogue,subtlety,3,1,2
Shadowhelm,silvermoon,31,rogue,subtlety,8,1,7
Vlkyria,silvermoon,16,rogue,subtlety,13,1,12
Bestjkbetter,ravencrest,2155,rogue,assassination,111,57,54
Shadenax,ravencrest,2149,rogue,assassination,78,42,36
Shadeniz,ravencrest,2137,rogue,assassination,113,57,56
Heavý,argent-dawn,2135,rogue,assassination,133,71,62
Sub,kazzak,2117,rogue,assassination,114,56,58
Aæ,stormscale,2112,rogue,assassination,125,65,60
Rightplay,outland,2112,rogue,assassination,90,45,45
Naláa,ravencrest,2107,rogue,assassination,88,45,43
Shadenox,ravencrest,2104,rogue,assassination,329,164,165
Ewyna,silvermoon,2103,rogue,assassination,93,49,44
Fánsly,silvermoon,2102,rogue,assassination,78,40,38
Mortecieca,ravencrest,2050,rogue,assassination,131,63,68
Mentol,stormscale,2025,rogue,assassination,65,48,17
Vayyel,silvermoon,2021,rogue,assassination,284,143,141
Visuáls,antonidas,1950,rogue,assassination,81,38,43
Stepchildx,uldum,1939,rogue,assassination,146,101,45
Chínerox,thunderhorn,1938,rogue,assassination,252,127,125
Watchmeyoe,ravencrest,1904,rogue,assassination,78,44,34
Vulrin,argent-dawn,1899,rogue,assassination,77,44,33
Buffassa,ravencrest,1887,rogue,assassination,143,81,62
Shadeco,ravencrest,1887,rogue,assassination,66,33,33
Shadekin,ravencrest,1880,rogue,assassination,75,38,37
Stråt,ysondre,1879,rogue,assassination,66,30,36
Tyreall,drakthul,1878,rogue,assassination,167,80,87
Venomblood,sanguino,1872,rogue,assassination,65,29,36
Изифаза,deathguard,1858,rogue,assassination,61,33,28
Ålùnæh,azjolnerub,1849,rogue,assassination,54,28,26
Babøønx,burning-legion,1848,rogue,assassination,89,41,48
Asàd,draenor,1841,rogue,assassination,47,30,17
Prei,hyjal,1839,rogue,assassination,96,49,47
Baboonx,burning-legion,1839,rogue,assassination,72,31,41
Oggish,tarren-mill,1831,rogue,assassination,84,32,52
Aknana,vashj,1828,rogue,assassination,60,28,32
Snøv,outland,1825,rogue,assassination,132,56,76
Inly,ysondre,1823,rogue,assassination,110,58,52
Скварлет,howling-fjord,1818,rogue,assassination,66,30,36
Kidneyou,ragnaros,1816,rogue,assassination,48,31,17
Bytoku,chants-éternels,1816,rogue,assassination,44,24,20
Botsrogue,kazzak,1814,rogue,assassination,36,20,16
Sadgexd,draenor,1814,rogue,assassination,52,26,26
Grøax,ragnaros,1812,rogue,assassination,60,30,30
Пожилойпуп,gordunni,1811,rogue,assassination,54,26,28
Pyridoxin,blackmoore,1810,rogue,assassination,60,29,31
Shipshot,blackrock,1809,rogue,assassination,62,37,25
Çhïñêsémøñkè,argent-dawn,1808,rogue,assassination,238,128,110
Civarea,blackrock,1808,rogue,assassination,57,26,31
Lookåtme,ravencrest,1808,rogue,assassination,48,20,28
Eiscreme,blackmoore,1802,rogue,assassination,95,50,45
Lastsight,burning-legion,1798,rogue,assassination,65,35,30
Ohdaesu,aegwynn,1798,rogue,assassination,114,49,65
Ридлли,soulflayer,1783,rogue,assassination,59,29,30
Fíìp,drakthul,1778,rogue,assassination,234,113,121
Dáydreamín,draenor,1772,rogue,assassination,60,27,33
Иллвилл,soulflayer,1769,rogue,assassination,42,23,19
Семёнтус,gordunni,1767,rogue,assassination,54,30,24
Pheq,ravencrest,1765,rogue,assassination,83,33,50
Blindlol,emerald-dream,1762,rogue,assassination,149,77,72
Zlah,ravencrest,1752,rogue,assassination,54,22,32
Naiikaii,antonidas,1751,rogue,assassination,54,23,31
Cntrlld,ravencrest,1750,rogue,assassination,54,26,28
Goshîmoshî,stormscale,1747,rogue,assassination,70,29,41
Lacusdark,draenor,1738,rogue,assassination,65,33,32
Limítless,tarren-mill,1737,rogue,assassination,48,31,17
Пашавернись,gordunni,1728,rogue,assassination,71,25,46
Riskyx,draenor,1727,rogue,assassination,49,19,30
Rajigagi,silvermoon,1717,rogue,assassination,61,33,28
Винестрий,soulflayer,1715,rogue,assassination,42,23,19
Youcrymydear,outland,1711,rogue,assassination,66,31,35
Слаадкий,gordunni,1708,rogue,assassination,123,57,66
Awaaylol,stormscale,1701,rogue,assassination,172,82,90
Afto,argent-dawn,1695,rogue,assassination,54,21,33
Kreamy,tarren-mill,1694,rogue,assassination,95,42,53
Røler,ravencrest,1693,rogue,assassination,42,18,24
Rinj,antonidas,1693,rogue,assassination,89,37,52
Акиоми,gordunni,1691,rogue,assassination,102,57,45
Precious,sylvanas,1690,rogue,assassination,318,156,162
Mazeken,kazzak,1688,rogue,assassination,53,21,32
Играючестно,howling-fjord,1686,rogue,assassination,30,19,11
Gøldzahn,antonidas,1670,rogue,assassination,136,61,75
Vâleera,kazzak,1667,rogue,assassination,48,23,25
Twitchful,kazzak,1665,rogue,assassination,54,25,29
Trollmeat,twisting-nether,1663,rogue,assassination,66,25,41
Deadlybrew,twisting-nether,1662,rogue,assassination,54,23,31
Brunhityx,ravencrest,1661,rogue,assassination,29,18,11
Peeon,drakthul,1659,rogue,assassination,73,26,47
Йа,gordunni,1658,rogue,assassination,63,33,30
Awakeaf,outland,1658,rogue,assassination,48,23,25
Ândrey,ravencrest,1657,rogue,assassination,54,31,23
Dnee,ravencrest,1654,rogue,assassination,23,18,5
Richï,outland,1654,rogue,assassination,104,44,60
Yopti,tarren-mill,1647,rogue,assassination,90,32,58
Justkiddning,blackmoore,1641,rogue,assassination,102,60,42
Ockzy,archimonde,1639,rogue,assassination,105,56,49
Skali,tarren-mill,1639,rogue,assassination,92,45,47
Ocklol,archimonde,1637,rogue,assassination,99,55,44
Drenched,turalyon,1636,rogue,assassination,234,113,121
Juxtapose,ravencrest,1634,rogue,assassination,48,20,28
Ваася,gordunni,1632,rogue,assassination,60,25,35
Monski,ravencrest,1631,rogue,assassination,54,21,33
Кэпс,blackscar,1625,rogue,assassination,66,39,27
Howfastiam,ravencrest,1624,rogue,assassination,108,55,53
Icdeadpixelz,ysondre,1624,rogue,assassination,42,17,25
Мистеркрэпс,howling-fjord,1624,rogue,assassination,47,19,28
Костялом,howling-fjord,1623,rogue,assassination,36,17,19
Кайсити,gordunni,1619,rogue,assassination,42,23,19
Keeke,outland,1619,rogue,assassination,60,31,29
Shikamouflé,archimonde,1619,rogue,assassination,148,74,74
Shookyz,zuljin,1615,rogue,assassination,54,27,27
Iwillcapyou,twisting-nether,1614,rogue,assassination,54,25,29
Únk,dalaran,1611,rogue,assassination,63,32,31
Ру,galakrond,1610,rogue,assassination,42,22,20
Войенх,gordunni,1610,rogue,assassination,242,116,126
Amý,grim-batol,1610,rogue,assassination,57,27,30
Гесху,eversong,1608,rogue,assassination,41,23,18
Cander,kazzak,1607,rogue,assassination,107,49,58
Warbell,ravencrest,1606,rogue,assassination,96,35,61
Lelíth,ravencrest,1602,rogue,assassination,107,61,46
Ач,gordunni,1602,rogue,assassination,78,37,41
Fatnutsac,eredar,1602,rogue,assassination,54,21,33
Sumiftw,drakthul,1601,rogue,assassination,48,18,30
Moneylake,stormscale,1600,rogue,assassination,30,18,12
ßênz,archimonde,1600,rogue,assassination,120,63,57
Nîllá,blackmoore,1600,rogue,assassination,42,18,24
Sotro,dun-modr,1600,rogue,assassination,84,32,52
Загляденье,gordunni,1598,rogue,assassination,54,21,33
Wâter,silvermoon,1593,rogue,assassination,54,20,34
Hoodrogue,blackrock,1580,rogue,assassination,53,29,24
Misttrogue,hyjal,1576,rogue,assassination,72,33,39
Soxo,dun-modr,1576,rogue,assassination,59,27,32
Мастдаггер,goldrinn,1575,rogue,assassination,184,94,90
Shøz,kazzak,1574,rogue,assassination,138,62,76
Стеллакокс,howling-fjord,1571,rogue,assassination,80,38,42
Kãlí,blackmoore,1570,rogue,assassination,271,135,136
Liøø,antonidas,1565,rogue,assassination,41,21,20
Sadìra,echsenkessel,1560,rogue,assassination,53,22,31
Kannibalex,blackrock,1560,rogue,assassination,51,21,30
Miiløx,silvermoon,1558,rogue,assassination,54,30,24
Lannon,sylvanas,1552,rogue,assassination,93,41,52
Sid,dentarg,1539,rogue,assassination,62,31,31
Silesi,kazzak,1538,rogue,assassination,154,81,73
Stunco,ravencrest,1529,rogue,assassination,30,16,14
Knutten,wildhammer,1526,rogue,assassination,102,47,55
Зоти,lich-king,1525,rogue,assassination,56,27,29
Shaokiz,sylvanas,1523,rogue,assassination,54,29,25
Асиксх,blackscar,1520,rogue,assassination,125,67,58
Npkx,outland,1519,rogue,assassination,60,26,34
Lildretch,dun-morogh,1517,rogue,assassination,33,17,16
Ilrunne,silvermoon,1515,rogue,assassination,132,62,70
Flogue,area-52,1514,rogue,assassination,79,30,49
Hopejé,ravencrest,1511,rogue,assassination,62,34,28
Tez,malganis,1511,rogue,assassination,59,29,30
Weakrat,kult-der-verdammten,1508,rogue,assassination,36,22,14
Ñerøblacks,dun-modr,1507,rogue,assassination,30,16,14
Effectz,ravencrest,1505,rogue,assassination,77,46,31
Argapu,stormscale,1503,rogue,assassination,78,32,46
Artésia,archimonde,1502,rogue,assassination,54,30,24
Xeeana,ravencrest,1500,rogue,assassination,95,51,44
Zaintsas,tarren-mill,1500,rogue,assassination,62,31,31
Nùgz,area-52,1498,rogue,assassination,119,65,54
Пусякиллерх,gordunni,1497,rogue,assassination,127,54,73
Somaliapirat,eredar,1490,rogue,assassination,30,16,14
Reyzumi,antonidas,1488,rogue,assassination,54,27,27
Hidinginash,twisting-nether,1486,rogue,assassination,56,31,25
Vanisha,outland,1484,rogue,assassination,91,48,43
Søsaboy,nemesis,1483,rogue,assassination,60,29,31
Варэль,borean-tundra,1482,rogue,assassination,227,108,119
Synergize,stormreaver,1481,rogue,assassination,127,59,68
Элирэй,fordragon,1480,rogue,assassination,69,33,36
Eizan,outland,1478,rogue,assassination,48,27,21
Ритор,deathguard,1477,rogue,assassination,48,22,26
Candycc,burning-legion,1475,rogue,assassination,67,38,29
Intecto,twisting-nether,1473,rogue,assassination,82,47,35
Erion,silvermoon,1473,rogue,assassination,114,54,60
Diazz,aegwynn,1473,rogue,assassination,119,56,63
Poughkeepsie,outland,1464,rogue,assassination,60,32,28
Vennomous,darkspear,1463,rogue,assassination,225,114,111
Arkblenderx,silvermoon,1455,rogue,assassination,106,55,51
Шмарамышь,soulflayer,1454,rogue,assassination,95,45,50
Ethèrnal,twisting-nether,1454,rogue,assassination,72,31,41
Minjeaca,silvermoon,1453,rogue,assassination,96,42,54
Волнорес,eversong,1451,rogue,assassination,100,50,50
Ynohtna,blackhand,1445,rogue,assassination,86,43,43
Grzech,burning-legion,1443,rogue,assassination,82,44,38
Intrix,draenor,1438,rogue,assassination,48,16,32
Alnaddafrog,outland,1433,rogue,assassination,58,36,22
Axoic,ravencrest,1433,rogue,assassination,48,23,25
Tmpkboo,stormscale,1433,rogue,assassination,36,15,21
Dé,ragnaros,1432,rogue,assassination,36,16,20
Negrim,dun-modr,1431,rogue,assassination,143,68,75
Ppollito,hyjal,1429,rogue,assassination,102,52,50
Nìghtwalker,ravencrest,1426,rogue,assassination,70,34,36
Luftpumpe,blackrock,1425,rogue,assassination,63,35,28
Редфилд,blackscar,1425,rogue,assassination,48,24,24
Teseiga,aegwynn,1425,rogue,assassination,134,58,76
Лёнтролль,blackscar,1424,rogue,assassination,81,38,43
Belsazar,azshara,1418,rogue,assassination,138,67,71
Pieksig,blackmoore,1417,rogue,assassination,96,44,52
Ropedrink,stormscale,1409,rogue,assassination,36,22,14
Koreanrogue,archimonde,1406,rogue,assassination,24,15,9
Yokze,ravencrest,1403,rogue,assassination,139,69,70
Аренамастерх,blackscar,1402,rogue,assassination,24,15,9
Synthaetic,draenor,1401,rogue,assassination,130,69,61
Ванэйти,gordunni,1401,rogue,assassination,84,42,42
Ambushgirl,ravencrest,1395,rogue,assassination,50,19,31
Freemmr,draenor,1391,rogue,assassination,118,61,57
Watodoo,kazzak,1388,rogue,assassination,62,31,31
Caská,blackhand,1388,rogue,assassination,78,33,45
Yassu,archimonde,1385,rogue,assassination,36,18,18
Umciz,archimonde,1381,rogue,assassination,42,15,27
Roguening,tarren-mill,1381,rogue,assassination,65,23,42
Piñotxo,sanguino,1377,rogue,assassination,41,17,24
Pizzayamyam,aegwynn,1373,rogue,assassination,42,18,24
Ciaordel,sylvanas,1372,rogue,assassination,75,36,39
Unshaken,dun-modr,1370,rogue,assassination,42,15,27
Crípplé,ravencrest,1369,rogue,assassination,30,15,15
Nællya,archimonde,1367,rogue,assassination,36,23,13
Raiyqyu,archimonde,1362,rogue,assassination,117,59,58
Hanzo,vashj,1361,rogue,assassination,53,15,38
Nuguri,blackrock,1359,rogue,assassination,45,23,22
Givewallet,ravencrest,1359,rogue,assassination,36,18,18
Recondite,doomhammer,1358,rogue,assassination,59,32,27
Orcrogue,khadgar,1356,rogue,assassination,29,15,14
Haikyu,blackhand,1354,rogue,assassination,72,31,41
Синигурай,soulflayer,1353,rogue,assassination,36,18,18
Dreathefox,drakthul,1352,rogue,assassination,48,20,28
Yvÿ,archimonde,1351,rogue,assassination,100,54,46
Dirtyz,dun-modr,1351,rogue,assassination,67,35,32
Cýphia,amanthul,1351,rogue,assassination,69,32,37
Эксплис,ashenvale,1350,rogue,assassination,29,16,13
Education,aegwynn,1350,rogue,assassination,48,18,30
Batsu,alleria,1346,rogue,assassination,42,18,24
Djnelly,stormreaver,1345,rogue,assassination,81,48,33
Роземсти,gordunni,1345,rogue,assassination,116,62,54
Томасмразь,blackscar,1343,rogue,assassination,30,14,16
Lixht,the-maelstrom,1332,rogue,assassination,54,30,24
Stabbinu,burning-legion,1332,rogue,assassination,30,14,16
Nightnelly,archimonde,1331,rogue,assassination,30,14,16
Винерджи,gordunni,1329,rogue,assassination,50,23,27
Markø,twisting-nether,1329,rogue,assassination,94,42,52
Finanzamtlg,blackrock,1328,rogue,assassination,36,19,17
Совечица,gordunni,1327,rogue,assassination,30,14,16
Stôrpîx,drakthul,1323,rogue,assassination,36,17,19
Кайдарра,eversong,1317,rogue,assassination,54,26,28
Zobrak,twisting-nether,1315,rogue,assassination,92,44,48
Jaxck,sylvanas,1314,rogue,assassination,24,14,10
Dîspatchx,defias-brotherhood,1313,rogue,assassination,36,15,21
Траста,fordragon,1310,rogue,assassination,78,25,53
Sigleif,argent-dawn,1309,rogue,assassination,61,28,33
Lírìa,argent-dawn,1306,rogue,assassination,30,14,16
Sneakysloth,ravencrest,1300,rogue,assassination,57,21,36
Имилиона,blackscar,1298,rogue,assassination,31,18,13
Pathicus,stormreaver,1297,rogue,assassination,64,32,32
Gadûz,kazzak,1295,rogue,assassination,44,17,27
Flawlesser,kazzak,1294,rogue,assassination,39,19,20
Патайчик,soulflayer,1294,rogue,assassination,91,44,47
Анми,gordunni,1288,rogue,assassination,35,14,21
Röllz,ysondre,1286,rogue,assassination,54,22,32
Nojdobra,tarren-mill,1284,rogue,assassination,55,23,32
Petsakos,ravencrest,1279,rogue,assassination,47,16,31
Zizmo,deathwing,1278,rogue,assassination,72,26,46
Trollohlol,malganis,1276,rogue,assassination,54,27,27
Фикция,greymane,1270,rogue,assassination,37,15,22
Менрэйз,gordunni,1267,rogue,assassination,36,15,21
Izze,thrall,1265,rogue,assassination,48,17,31
Shadôwcraft,outland,1263,rogue,assassination,39,19,20
Akira,outland,1262,rogue,assassination,69,34,35
Келгар,soulflayer,1261,rogue,assassination,30,14,16
Veronkierto,stormreaver,1259,rogue,assassination,78,42,36
Snulle,ravencrest,1248,rogue,assassination,24,13,11
Сайгакк,galakrond,1248,rogue,assassination,58,30,28
Евгенийильич,gordunni,1247,rogue,assassination,24,13,11
Rubberducky,argent-dawn,1245,rogue,assassination,18,13,5
Mtb,ravencrest,1245,rogue,assassination,30,13,17
Stabdbyvegan,ragnaros,1245,rogue,assassination,79,31,48
Freijasap,ravencrest,1243,rogue,assassination,30,13,17
Satiiva,terokkar,1242,rogue,assassination,66,29,37
Droomprins,stormscale,1242,rogue,assassination,36,13,23
Zerocell,kazzak,1240,rogue,assassination,66,32,34
Mexxn,antonidas,1240,rogue,assassination,43,20,23
Dime,silvermoon,1239,rogue,assassination,90,47,43
Mewen,sanguino,1233,rogue,assassination,30,13,17
Sáinz,malganis,1233,rogue,assassination,35,15,20
Raetoc,turalyon,1230,rogue,assassination,30,15,15
Gankbang,frostmane,1225,rogue,assassination,54,21,33
Nukubu,draenor,1224,rogue,assassination,88,35,53
Nàrutò,thrall,1223,rogue,assassination,62,21,41
Mystykal,twisting-nether,1221,rogue,assassination,48,19,29
Behörnchen,eredar,1218,rogue,assassination,53,23,30
Sneakypeeki,sylvanas,1217,rogue,assassination,29,13,16
Ocktwo,archimonde,1213,rogue,assassination,35,13,22
Kronin,arakarahm,1213,rogue,assassination,42,15,27
Streetx,nethersturm,1211,rogue,assassination,42,21,21
Свёклапро,gordunni,1210,rogue,assassination,118,60,58
Ripgore,sylvanas,1210,rogue,assassination,35,13,22
Pitøu,outland,1205,rogue,assassination,48,23,25
Kariinthuul,aegwynn,1205,rogue,assassination,48,20,28
Bennyweth,argent-dawn,1205,rogue,assassination,42,16,26
Nargun,archimonde,1204,rogue,assassination,30,18,12
Тимкок,soulflayer,1203,rogue,assassination,75,33,42
Килларан,howling-fjord,1200,rogue,assassination,29,16,13
Nopz,outland,1199,rogue,assassination,36,21,15
Maelithas,archimonde,1197,rogue,assassination,83,38,45
Lovetospoon,ravencrest,1196,rogue,assassination,90,51,39
Næylá,kult-der-verdammten,1195,rogue,assassination,24,13,11
Narsoule,ysondre,1194,rogue,assassination,30,16,14
Фуллблайнд,gordunni,1194,rogue,assassination,33,13,20
Nitröx,tarren-mill,1194,rogue,assassination,35,13,22
Sùbzerø,archimonde,1186,rogue,assassination,23,13,10
Skrbke,tarren-mill,1186,rogue,assassination,102,51,51
Noxxra,blackhand,1181,rogue,assassination,59,21,38
Gigarogue,defias-brotherhood,1179,rogue,assassination,47,23,24
Экичу,howling-fjord,1177,rogue,assassination,48,28,20
Azovrouge,terokkar,1172,rogue,assassination,30,18,12
Jupitor,argent-dawn,1172,rogue,assassination,72,39,33
Цилана,gordunni,1161,rogue,assassination,45,25,20
Jeruna,veklor,1152,rogue,assassination,24,12,12
Emergence,ravencrest,1151,rogue,assassination,24,12,12
Unterweger,die-aldor,1145,rogue,assassination,23,13,10
Поздоровайся,howling-fjord,1139,rogue,assassination,54,26,28
Bonejaw,tarren-mill,1137,rogue,assassination,30,14,16
Kuttunga,ravencrest,1136,rogue,assassination,73,33,40
Zokush,archimonde,1134,rogue,assassination,39,15,24
Tootskie,outland,1128,rogue,assassination,126,59,67
Скулипёс,howling-fjord,1124,rogue,assassination,23,15,8
Phaîne,outland,1124,rogue,assassination,24,12,12
Ingesa,blackhand,1120,rogue,assassination,68,32,36
Krimos,archimonde,1119,rogue,assassination,54,30,24
Missesinvis,blackmoore,1118,rogue,assassination,25,14,11
Elysm,stormscale,1112,rogue,assassination,41,21,20
Jæto,ravencrest,1110,rogue,assassination,33,17,16
Sênsus,antonidas,1110,rogue,assassination,54,21,33
Edaniel,draenor,1109,rogue,assassination,24,12,12
Дисхар,soulflayer,1103,rogue,assassination,28,15,13
Oshä,dalaran,1102,rogue,assassination,30,13,17
Elûnè,silvermoon,1097,rogue,assassination,30,14,16
Swarge,silvermoon,1088,rogue,assassination,318,152,166
Gravestam,sunstrider,1085,rogue,assassination,36,17,19
Davotroz,dun-modr,1084,rogue,assassination,26,13,13
Носопыра,blackscar,1082,rogue,assassination,53,25,28
Undîsputed,blackmoore,1074,rogue,assassination,45,15,30
Mol,defias-brotherhood,1070,rogue,assassination,38,12,26
Лунари,blackscar,1068,rogue,assassination,48,19,29
Nighteshift,silvermoon,1064,rogue,assassination,36,14,22
Gamôra,arygos,1061,rogue,assassination,30,13,17
Dalailamer,gorgonnash,1060,rogue,assassination,38,12,26
Azonaticus,hyjal,1059,rogue,assassination,28,13,15
Undxrwrld,sylvanas,1055,rogue,assassination,18,11,7
Бонасера,blackscar,1052,rogue,assassination,24,11,13
Jimaal,stormscale,1051,rogue,assassination,30,11,19
Zélla,twisting-nether,1044,rogue,assassination,24,11,13
Pasarelo,dun-modr,1041,rogue,assassination,95,45,50
Madlain,jaedenar,1041,rogue,assassination,24,11,13
Кэйлфрут,gordunni,1040,rogue,assassination,18,11,7
Sæqq,blackmoore,1038,rogue,assassination,54,22,32
Subyo,eredar,1038,rogue,assassination,30,11,19
Chiàntì,blackrock,1037,rogue,assassination,185,88,97
Alpinestars,dun-modr,1037,rogue,assassination,29,12,17
Stonecold,twilights-hammer,1037,rogue,assassination,36,11,25
Alltaïr,ravencrest,1035,rogue,assassination,145,74,71
Sladen,ghostlands,1032,rogue,assassination,24,11,13
Julyshadows,kazzak,1031,rogue,assassination,36,15,21
Chalkbag,blackrock,1031,rogue,assassination,35,12,23
Tre,eredar,1030,rogue,assassination,47,22,25
Оскархартман,gordunni,1027,rogue,assassination,24,12,12
Seleyese,draenor,1027,rogue,assassination,36,15,21
Imissmop,darkspear,1026,rogue,assassination,30,11,19
Мяуровани,eversong,1025,rogue,assassination,30,16,14
Modulok,ulduar,1025,rogue,assassination,36,19,17
Dmfd,darksorrow,1022,rogue,assassination,182,88,94
Rogunelf,stormreaver,1021,rogue,assassination,56,28,28
Dykumah,sanguino,1016,rogue,assassination,24,11,13
Maroshko,argent-dawn,1015,rogue,assassination,23,11,12
Epidemic,stormscale,1013,rogue,assassination,133,54,79
Griveous,kazzak,1007,rogue,assassination,20,12,8
Lesale,turalyon,1005,rogue,assassination,48,22,26
Nevelon,chogall,1005,rogue,assassination,90,38,52
Sïdr,marécage-de-zangar,1003,rogue,assassination,47,25,22
Dezxxyox,dun-modr,1001,rogue,assassination,68,35,33
Boskönigt,ragnaros,998,rogue,assassination,46,20,26
Raikyo,argent-dawn,994,rogue,assassination,35,21,14
Чернаясоска,eversong,994,rogue,assassination,95,50,45
Imdma,defias-brotherhood,991,rogue,assassination,60,29,31
Майндтрикс,blackscar,991,rogue,assassination,26,11,15
Sorea,twisting-nether,987,rogue,assassination,75,32,43
Zzippi,blackmoore,987,rogue,assassination,49,20,29
Veliza,twisting-nether,962,rogue,assassination,91,37,54
Deceptio,gilneas,960,rogue,assassination,46,22,24
Gorgeousred,aegwynn,960,rogue,assassination,24,10,14
Ежикх,soulflayer,960,rogue,assassination,30,10,20
Madisonivyqt,blackmoore,960,rogue,assassination,30,10,20
Blawann,argent-dawn,959,rogue,assassination,18,10,8
Czêro,grim-batol,959,rogue,assassination,18,10,8
Ладжо,gordunni,959,rogue,assassination,30,10,20
Miistermaen,outland,959,rogue,assassination,30,10,20
Koopa,argent-dawn,959,rogue,assassination,42,10,32
Xalupa,dun-modr,957,rogue,assassination,24,10,14
Gârrík,blackhand,954,rogue,assassination,18,10,8
Eightball,frostmane,954,rogue,assassination,18,10,8
Szabina,outland,953,rogue,assassination,18,10,8
Finisher,sanguino,952,rogue,assassination,12,10,2
Skids,ravencrest,952,rogue,assassination,18,10,8
Tarox,eredar,952,rogue,assassination,24,10,14
Джэкман,soulflayer,950,rogue,assassination,12,10,2
Mahistt,archimonde,947,rogue,assassination,18,10,8
Tirgo,aegwynn,946,rogue,assassination,138,67,71
Zeduxino,outland,945,rogue,assassination,12,10,2
Havox,darksorrow,945,rogue,assassination,18,10,8
Джоннималыш,eversong,942,rogue,assassination,18,10,8
Прнхабочка,gordunni,941,rogue,assassination,36,20,16
Myk,xavius,928,rogue,assassination,22,11,11
Eniyah,tarren-mill,927,rogue,assassination,17,10,7
Практикиней,grom,925,rogue,assassination,30,10,20
Mythicog,twisting-nether,924,rogue,assassination,48,19,29
Cbrook,sylvanas,920,rogue,assassination,29,10,19
Snakeshiv,ravenholdt,919,rogue,assassination,24,12,12
Dredge,kaelthas,919,rogue,assassination,43,14,29
Tranxéne,hyjal,913,rogue,assassination,30,15,15
Heartripper,ravencrest,910,rogue,assassination,27,10,17
Zeuzo,xavius,907,rogue,assassination,17,10,7
Макггара,soulflayer,907,rogue,assassination,170,78,92
Tubes,dun-morogh,904,rogue,assassination,15,12,3
Lilze,ravencrest,897,rogue,assassination,72,33,39
Jústina,die-aldor,897,rogue,assassination,66,28,38
Márto,archimonde,896,rogue,assassination,22,10,12
Ороти,greymane,891,rogue,assassination,20,12,8
Darkkstep,blackmoore,890,rogue,assassination,24,11,13
Jacktripper,blackrock,885,rogue,assassination,38,11,27
Pinchoto,sanguino,883,rogue,assassination,60,27,33
Blackone,nemesis,883,rogue,assassination,24,10,14
Coastguard,twisting-nether,881,rogue,assassination,50,23,27
Løuvees,archimonde,881,rogue,assassination,64,29,35
Kaigodd,twisting-nether,879,rogue,assassination,38,20,18
Haregan,gorgonnash,876,rogue,assassination,18,10,8
Dallrend,stormscale,875,rogue,assassination,60,22,38
Bauwten,ravencrest,866,rogue,assassination,24,12,12
Skýhigh,ravencrest,864,rogue,assassination,12,9,3
Watergirlx,ravencrest,864,rogue,assassination,18,9,9
Sotri,dun-modr,864,rogue,assassination,24,9,15
Angeldarky,silvermoon,864,rogue,assassination,24,9,15
Аязлаая,blackscar,864,rogue,assassination,24,9,15
Moratz,blackmoore,864,rogue,assassination,30,9,21
Stepbrogue,tarren-mill,863,rogue,assassination,18,9,9
Gutter,sylvanas,863,rogue,assassination,18,9,9
Cloak,blackrock,863,rogue,assassination,18,9,9
Uzrigu,tarren-mill,863,rogue,assassination,18,9,9
Tiazx,outland,863,rogue,assassination,18,9,9
Леронда,deepholm,863,rogue,assassination,36,17,19
Fálke,dun-modr,863,rogue,assassination,30,9,21
Фанфистинга,gordunni,863,rogue,assassination,36,9,27
Жесть,howling-fjord,862,rogue,assassination,18,9,9
Йоио,howling-fjord,862,rogue,assassination,18,9,9
Purplereign,frostmane,860,rogue,assassination,84,40,44
Daggerz,outland,859,rogue,assassination,18,9,9
Вальпургина,borean-tundra,859,rogue,assassination,42,19,23
Sisoi,kazzak,859,rogue,assassination,24,9,15
Norlix,ravencrest,856,rogue,assassination,18,9,9
Babysteps,the-maelstrom,856,rogue,assassination,18,9,9
Silksneak,kazzak,856,rogue,assassination,18,9,9
Kampon,sanguino,855,rogue,assassination,18,9,9
Felvengeance,stormscale,855,rogue,assassination,30,9,21
Reginlief,argent-dawn,852,rogue,assassination,56,28,28
Вотымразь,howling-fjord,849,rogue,assassination,47,19,28
Scorpionkk,blackrock,848,rogue,assassination,162,77,85
Kuxion,zuljin,847,rogue,assassination,24,10,14
Madita,frostmourne,844,rogue,assassination,36,9,27
Ressputini,emeriss,841,rogue,assassination,17,9,8
Паштетмашин,booty-bay,841,rogue,assassination,18,9,9
Knockyz,khaz-modan,838,rogue,assassination,37,16,21
Dæadly,archimonde,828,rogue,assassination,23,9,14
Mackíe,antonidas,828,rogue,assassination,27,10,17
Lorena,ravencrest,826,rogue,assassination,17,9,8
Tc,doomhammer,824,rogue,assassination,18,9,9
Îlihad,zuljin,824,rogue,assassination,42,16,26
Yuffi,ysondre,803,rogue,assassination,29,11,18
Hadúr,stormscale,802,rogue,assassination,28,11,17
Areldis,drakthul,800,rogue,assassination,20,10,10
Folzen,archimonde,799,rogue,assassination,22,9,13
Jumbovanish,tarren-mill,796,rogue,assassination,21,11,10
Elfikill,elune,794,rogue,assassination,25,11,14
Fumai,blackmoore,790,rogue,assassination,30,11,19
Mores,anetheron,781,rogue,assassination,24,9,15
Sospiro,nemesis,779,rogue,assassination,22,9,13
Jamesdarmody,twisting-nether,775,rogue,assassination,27,9,18
Gillette,guldan,773,rogue,assassination,78,29,49
Myk,frostmane,768,rogue,assassination,12,8,4
Axelaz,ravencrest,768,rogue,assassination,12,8,4
Tallac,drekthar,768,rogue,assassination,18,8,10
Attylaria,rexxar,768,rogue,assassination,18,8,10
Фешнподпивом,gordunni,768,rogue,assassination,21,8,13
Саэрас,howling-fjord,768,rogue,assassination,24,8,16
Lipschitz,outland,768,rogue,assassination,24,8,16
Onlyluvhurt,dun-modr,768,rogue,assassination,24,8,16
Мелеша,blackscar,768,rogue,assassination,24,8,16
Lôre,blackrock,768,rogue,assassination,30,8,22
Piperx,ravencrest,768,rogue,assassination,30,8,22
Bläde,outland,767,rogue,assassination,12,8,4
Babouill,ysondre,767,rogue,assassination,12,8,4
Nevagonagiv,archimonde,767,rogue,assassination,18,8,10
Shadowcralls,blackmoore,767,rogue,assassination,18,8,10
Skiff,argent-dawn,767,rogue,assassination,18,8,10
Milenia,thrall,767,rogue,assassination,18,8,10
Röguelol,outland,767,rogue,assassination,18,8,10
Meldee,burning-legion,767,rogue,assassination,18,8,10
Serpez,anachronos,766,rogue,assassination,12,8,4
Bronxbomber,tarren-mill,766,rogue,assassination,18,8,10
Nhonhonho,silvermoon,766,rogue,assassination,18,8,10
Flaskan,tarren-mill,766,rogue,assassination,18,8,10
Obsçuritý,ragnaros,765,rogue,assassination,16,9,7
Revelith,nemesis,764,rogue,assassination,17,8,9
Jimzopf,eredar,762,rogue,assassination,18,8,10
Horvathzu,ravencrest,762,rogue,assassination,24,8,16
Giftknirps,silvermoon,758,rogue,assassination,18,8,10
Parker,frostmane,758,rogue,assassination,24,8,16
Куррвабобер,borean-tundra,756,rogue,assassination,18,8,10
Thedarkness,sylvanas,755,rogue,assassination,18,8,10
Энвитио,gordunni,751,rogue,assassination,18,8,10
Matarocho,ravencrest,751,rogue,assassination,24,8,16
Кейтллинн,galakrond,738,rogue,assassination,42,16,26
Медиивэл,deepholm,737,rogue,assassination,23,8,15
Deragur,antonidas,733,rogue,assassination,18,8,10
Rahes,stormscale,731,rogue,assassination,35,8,27
Fìíp,drakthul,720,rogue,assassination,21,8,13
Ghøßt,outland,714,rogue,assassination,23,10,13
Ninieu,kirin-tor,686,rogue,assassination,13,8,5
Ghøstkid,blackrock,686,rogue,assassination,22,8,14
Silass,marécage-de-zangar,672,rogue,assassination,12,7,5
Bluntyblades,silvermoon,672,rogue,assassination,12,7,5
Лиринэлла,soulflayer,672,rogue,assassination,12,7,5
Nightyx,blackmoore,672,rogue,assassination,12,7,5
Djpiglet,outland,672,rogue,assassination,12,7,5
Zwarciowa,burning-legion,672,rogue,assassination,18,7,11
Eeros,kazzak,672,rogue,assassination,18,7,11
Köna,archimonde,672,rogue,assassination,18,7,11
Jáckz,twisting-nether,672,rogue,assassination,18,7,11
Styxro,blackhand,672,rogue,assassination,18,7,11
Zilemjr,stormscale,672,rogue,assassination,18,7,11
Soulriver,kelthuzad,672,rogue,assassination,18,7,11
Scørp,ravencrest,672,rogue,assassination,18,7,11
Ogc,draenor,672,rogue,assassination,18,7,11
Like,aegwynn,672,rogue,assassination,18,7,11
Patryk,silvermoon,672,rogue,assassination,21,8,13
Jaqenhghar,pozzo-delleternità,672,rogue,assassination,24,7,17
Chokee,blackrock,672,rogue,assassination,24,7,17
Luketherogue,twisting-nether,672,rogue,assassination,24,7,17
Saboteur,antonidas,672,rogue,assassination,24,7,17
Featfawkes,ragnaros,672,rogue,assassination,24,7,17
Ámbush,sylvanas,672,rogue,assassination,30,7,23
Rikdy,kazzak,672,rogue,assassination,30,7,23
Jupezii,stormreaver,671,rogue,assassination,12,7,5
Роггбог,howling-fjord,671,rogue,assassination,12,7,5
Renaai,defias-brotherhood,671,rogue,assassination,18,7,11
Brazi,dalaran,671,rogue,assassination,18,7,11
Rîg,draenor,671,rogue,assassination,18,7,11
Friter,stormscale,671,rogue,assassination,18,7,11
Kuzmin,die-aldor,671,rogue,assassination,18,7,11
Shadowspike,sanguino,670,rogue,assassination,18,7,11
Barkai,kazzak,670,rogue,assassination,18,7,11
Valdengard,antonidas,669,rogue,assassination,12,7,5
Shinigamî,nemesis,668,rogue,assassination,12,7,5
Fizzkhalifa,zuljin,667,rogue,assassination,25,9,16
Ashami,genjuros,666,rogue,assassination,18,7,11
Rwaphou,ysondre,664,rogue,assassination,12,7,5
Azkiel,archimonde,660,rogue,assassination,12,7,5
Azotix,archimonde,659,rogue,assassination,18,7,11
Twotimess,stormscale,658,rogue,assassination,12,7,5
Onetwo,aggra-português,655,rogue,assassination,18,7,11
Sessanali,silvermoon,655,rogue,assassination,30,7,23
Niapro,dun-morogh,653,rogue,assassination,17,7,10
Rêdbello,dun-morogh,651,rogue,assassination,18,7,11
Якунька,soulflayer,637,rogue,assassination,17,7,10
Rossaporcona,nemesis,637,rogue,assassination,36,7,29
Mozenn,draenor,622,rogue,assassination,15,7,8
Bensollo,tarren-mill,622,rogue,assassination,17,7,10
Suley,blackrock,616,rogue,assassination,17,7,10
Лиргенвард,deathguard,576,rogue,assassination,12,6,6
Diagnoze,silvermoon,576,rogue,assassination,12,6,6
Flopsy,archimonde,576,rogue,assassination,12,6,6
Myk,ravencrest,576,rogue,assassination,12,6,6
Voetdown,blackmoore,576,rogue,assassination,12,6,6
Nekhâ,hyjal,576,rogue,assassination,12,6,6
Sussulto,nemesis,576,rogue,assassination,12,6,6
Blade,stormscale,576,rogue,assassination,12,6,6
Бейнс,howling-fjord,576,rogue,assassination,12,6,6
Necroli,kazzak,576,rogue,assassination,12,6,6
Wrestlér,sylvanas,576,rogue,assassination,12,6,6
Parawietje,twilights-hammer,576,rogue,assassination,12,6,6
Remindful,ravencrest,576,rogue,assassination,12,6,6
Schníttchen,antonidas,576,rogue,assassination,12,6,6
Sachsun,outland,576,rogue,assassination,12,6,6
Grimv,frostmane,576,rogue,assassination,12,6,6
Mollyperph,ravencrest,576,rogue,assassination,12,6,6
Tyranoxoth,stormscale,576,rogue,assassination,12,6,6
Blooddance,ragnaros,576,rogue,assassination,18,6,12
Dnw,ravencrest,576,rogue,assassination,18,6,12
Shredbull,ravencrest,576,rogue,assassination,18,6,12
Zte,frostmane,576,rogue,assassination,18,6,12
Liraia,eredar,576,rogue,assassination,18,6,12
Hmwow,kazzak,575,rogue,assassination,12,6,6
Ноубрэйкс,blackscar,575,rogue,assassination,12,6,6
Malvaxxs,tarren-mill,575,rogue,assassination,12,6,6
Blackmøré,argent-dawn,575,rogue,assassination,12,6,6
Rbgdowngrade,ravencrest,575,rogue,assassination,12,6,6
Peqpen,ravencrest,575,rogue,assassination,12,6,6
Zyrogue,silvermoon,575,rogue,assassination,12,6,6
Bambush,bronze-dragonflight,575,rogue,assassination,12,6,6
Shènz,ysondre,575,rogue,assassination,18,6,12
Fkuwu,dalaran,575,rogue,assassination,24,6,18
Davosslol,outland,575,rogue,assassination,24,6,18
Drillss,ravencrest,575,rogue,assassination,34,7,27
Жинпес,gordunni,574,rogue,assassination,12,6,6
Yasmineskye,silvermoon,574,rogue,assassination,12,6,6
Колдрейдж,soulflayer,574,rogue,assassination,12,6,6
Outofstuns,earthen-ring,574,rogue,assassination,18,7,11
Dahlinska,ravencrest,574,rogue,assassination,18,6,12
Whiss,blackmoore,573,rogue,assassination,12,6,6
Letheus,stormscale,573,rogue,assassination,18,6,12
Whiz,alexstrasza,572,rogue,assassination,21,7,14
Ranjual,blackhand,571,rogue,assassination,12,6,6
Xlongman,blackhand,571,rogue,assassination,24,6,18
Kahsorog,draenor,569,rogue,assassination,12,6,6
Симус,lich-king,568,rogue,assassination,12,6,6
Dimah,blackmoore,563,rogue,assassination,18,6,12
Наджийа,lich-king,560,rogue,assassination,18,6,12
Breattick,blackmoore,554,rogue,assassination,30,6,24
Givilwtf,eredar,543,rogue,assassination,17,6,11
Nÿst,khaz-modan,543,rogue,assassination,17,6,11
Stælf,argent-dawn,543,rogue,assassination,22,6,16
Ûltraaxx,ysondre,528,rogue,assassination,15,6,9
Stonyhavana,ravencrest,527,rogue,assassination,11,6,5
Vaeira,ravencrest,527,rogue,assassination,17,6,11
Bamboozledx,draenor,511,rogue,assassination,11,6,5
Стронг,soulflayer,511,rogue,assassination,15,6,9
Blueberry,sargeras,505,rogue,assassination,19,7,12
Ticklzepickl,silvermoon,480,rogue,assassination,6,5,1
Ðescartes,antonidas,480,rogue,assassination,6,5,1
Psychoxygen,nemesis,480,rogue,assassination,12,5,7
Кишмякх,howling-fjord,480,rogue,assassination,12,5,7
Рэкрейвон,gordunni,480,rogue,assassination,12,5,7
Sholace,blackrock,480,rogue,assassination,12,5,7
Kidalica,auchindoun,480,rogue,assassination,12,5,7
Мечтавелена,howling-fjord,480,rogue,assassination,12,5,7
Эрихард,howling-fjord,480,rogue,assassination,12,5,7
Zajii,eredar,480,rogue,assassination,12,5,7
Fixsap,aegwynn,480,rogue,assassination,12,5,7
Exiv,ragnaros,480,rogue,assassination,12,5,7
Anhduy,blackrock,480,rogue,assassination,12,5,7
Engetiran,defias-brotherhood,480,rogue,assassination,12,5,7
Gögel,draenor,480,rogue,assassination,12,5,7
Gðrdø,blackrock,480,rogue,assassination,12,5,7
Kendyx,kirin-tor,480,rogue,assassination,12,5,7
Aikaza,blackmoore,480,rogue,assassination,12,5,7
Backstabjr,blackmoore,480,rogue,assassination,12,5,7
Psg,argent-dawn,480,rogue,assassination,12,5,7
Shabakftw,twisting-nether,480,rogue,assassination,12,5,7
Ghðst,stormscale,480,rogue,assassination,12,5,7
Rylie,garona,480,rogue,assassination,12,5,7
Calve,tarren-mill,480,rogue,assassination,12,5,7
Nippzy,twisting-nether,480,rogue,assassination,12,5,7
Qwneêr,tarren-mill,480,rogue,assassination,12,5,7
Ридх,soulflayer,480,rogue,assassination,12,5,7
Morgan,argent-dawn,480,rogue,assassination,12,5,7
Hì,bronzebeard,480,rogue,assassination,12,5,7
Злобность,gordunni,480,rogue,assassination,12,5,7
Lämä,stormreaver,480,rogue,assassination,12,5,7
Trickfulz,stormscale,480,rogue,assassination,12,5,7
Malatang,thrall,480,rogue,assassination,12,5,7
Snurry,tarren-mill,480,rogue,assassination,12,5,7
Wrathed,stormreaver,480,rogue,assassination,18,5,13
Kenjí,silvermoon,480,rogue,assassination,18,5,13
Exanimu,ravencrest,480,rogue,assassination,18,5,13
Republicano,cthun,480,rogue,assassination,18,5,13
Ykw,tarren-mill,480,rogue,assassination,18,5,13
Stealthi,stormscale,480,rogue,assassination,18,5,13
Fawkkes,la-croisade-écarlate,480,rogue,assassination,18,5,13
Vizifyx,ravencrest,480,rogue,assassination,24,5,19
Waltër,tyrande,480,rogue,assassination,24,5,19
Noxxy,archimonde,480,rogue,assassination,24,5,19
Saptember,blackhand,479,rogue,assassination,6,5,1
Хэресс,soulflayer,479,rogue,assassination,6,5,1
Ganzord,dun-modr,479,rogue,assassination,12,5,7
Дамид,gordunni,479,rogue,assassination,12,5,7
Tossmysaladx,silvermoon,479,rogue,assassination,12,5,7
Shadowfangs,ravencrest,479,rogue,assassination,12,5,7
Jaymo,saurfang,479,rogue,assassination,12,5,7
Leÿji,archimonde,479,rogue,assassination,12,5,7
Dahlin,stormscale,479,rogue,assassination,12,5,7
Lescud,illidan,479,rogue,assassination,12,5,7
Некролз,gordunni,479,rogue,assassination,13,5,8
Hallogenic,silvermoon,479,rogue,assassination,18,5,13
Astefion,dalaran,479,rogue,assassination,24,5,19
Runár,proudmoore,478,rogue,assassination,10,6,4
Dravenfoot,defias-brotherhood,477,rogue,assassination,12,5,7
Jacksoon,dun-morogh,477,rogue,assassination,18,5,13
Lubor,thrall,476,rogue,assassination,12,5,7
Owlcat,argent-dawn,475,rogue,assassination,12,5,7
Razboy,dun-morogh,475,rogue,assassination,12,5,7
Eljana,amanthul,472,rogue,assassination,20,7,13
Рогнарек,blackscar,468,rogue,assassination,18,5,13
Getownédyo,aggramar,463,rogue,assassination,21,6,15
Síns,runetotem,448,rogue,assassination,10,5,5
Deevoll,tarren-mill,447,rogue,assassination,20,6,14
Элиссенда,deathguard,446,rogue,assassination,11,5,6
Sørä,ragnaros,444,rogue,assassination,10,5,5
Bhabì,uldaman,431,rogue,assassination,11,5,6
Rhâpsødýx,twisting-nether,426,rogue,assassination,14,6,8
Refundlands,kazzak,426,rogue,assassination,15,6,9
Mâêl,blackmoore,426,rogue,assassination,16,6,10
Rohalds,silvermoon,426,rogue,assassination,20,6,14
Bluehell,sanguino,415,rogue,assassination,10,5,5
Horóz,antonidas,400,rogue,assassination,7,5,2
Døpegame,ravencrest,400,rogue,assassination,13,5,8
Биокарлик,soulflayer,384,rogue,assassination,6,4,2
Hasansabbah,twisting-nether,384,rogue,assassination,6,4,2
Tebzr,ravencrest,384,rogue,assassination,6,4,2
Nineball,frostmane,384,rogue,assassination,6,4,2
Fûckínggød,outland,384,rogue,assassination,6,4,2
Obstechhawi,argent-dawn,384,rogue,assassination,6,4,2
Whosmanz,ragnaros,384,rogue,assassination,6,4,2
Путьказаха,gordunni,384,rogue,assassination,6,4,2
Mouchess,hyjal,384,rogue,assassination,6,4,2
Mïkasa,ysondre,384,rogue,assassination,6,4,2
Vögue,burning-legion,384,rogue,assassination,6,4,2
Brñ,ravencrest,384,rogue,assassination,6,4,2
Meldbroken,tarren-mill,384,rogue,assassination,6,4,2
Красаа,soulflayer,384,rogue,assassination,6,4,2
Sayianwho,ravencrest,384,rogue,assassination,6,4,2
Yoruichì,kazzak,384,rogue,assassination,6,4,2
Spolly,frostwolf,384,rogue,assassination,6,4,2
Gâla,elune,384,rogue,assassination,6,4,2
Eltitoedu,dun-modr,384,rogue,assassination,6,4,2
Sparv,jaedenar,384,rogue,assassination,6,4,2
Yuunr,kazzak,384,rogue,assassination,6,4,2
Mâriejânee,nozdormu,384,rogue,assassination,6,4,2
Mituxararr,blackrock,384,rogue,assassination,6,4,2
Ebayscammer,ravencrest,384,rogue,assassination,6,4,2
Ðoppex,blackmoore,384,rogue,assassination,6,4,2
Sîccarîus,ravencrest,384,rogue,assassination,6,4,2
Meccura,silvermoon,384,rogue,assassination,6,4,2
Painkeeper,stormscale,384,rogue,assassination,6,4,2
Synsinte,silvermoon,384,rogue,assassination,6,4,2
Leviathann,doomhammer,384,rogue,assassination,6,4,2
Дикийминус,howling-fjord,384,rogue,assassination,6,4,2
Мёртвыйанарх,soulflayer,384,rogue,assassination,6,4,2
Ddhelpra,blackrock,384,rogue,assassination,12,4,8
Wayñe,ravencrest,384,rogue,assassination,12,4,8
Артфулр,howling-fjord,384,rogue,assassination,12,4,8
Ксяосупдупао,howling-fjord,384,rogue,assassination,12,4,8
Галиновна,soulflayer,384,rogue,assassination,12,4,8
Honeycakes,ravencrest,384,rogue,assassination,12,4,8
Níterush,eredar,384,rogue,assassination,12,4,8
Röguetönerö,dun-modr,384,rogue,assassination,12,4,8
Zerfex,eredar,384,rogue,assassination,12,4,8
Bijâ,aegwynn,384,rogue,assassination,12,4,8
Redcutter,silvermoon,384,rogue,assassination,12,4,8
Ра,gordunni,384,rogue,assassination,12,4,8
Achterom,tarren-mill,384,rogue,assassination,12,4,8
Ланароудсс,gordunni,384,rogue,assassination,12,4,8
Kïdney,stormscale,384,rogue,assassination,12,4,8
Wickness,dun-modr,384,rogue,assassination,12,4,8
Lilrookie,argent-dawn,384,rogue,assassination,12,4,8
Doomdagger,chamber-of-aspects,384,rogue,assassination,12,4,8
Ryxon,arathor,384,rogue,assassination,12,4,8
Wééselby,blackrock,384,rogue,assassination,12,4,8
Obernik,draenor,384,rogue,assassination,12,4,8
Darkchomeur,archimonde,384,rogue,assassination,12,4,8
Sharkøo,eredar,384,rogue,assassination,12,4,8
Гранетанцор,blackscar,384,rogue,assassination,12,4,8
Gämèøvërkíd,archimonde,384,rogue,assassination,12,4,8
Izzyb,auchindoun,384,rogue,assassination,12,4,8
Jevo,kazzak,384,rogue,assassination,12,4,8
Paidaki,kazzak,384,rogue,assassination,12,4,8
Feucht,argent-dawn,384,rogue,assassination,12,4,8
Meimei,sanguino,384,rogue,assassination,12,4,8
Norpz,aggra-português,384,rogue,assassination,12,4,8
Нарежудольки,howling-fjord,384,rogue,assassination,12,4,8
Yakii,eredar,384,rogue,assassination,12,4,8
Kallelelel,tarren-mill,384,rogue,assassination,12,4,8
Stepkickgodx,blackmoore,384,rogue,assassination,12,4,8
Crimatoria,rajaxx,384,rogue,assassination,12,4,8
Gorgeousréd,aegwynn,384,rogue,assassination,18,4,14
Sythex,archimonde,384,rogue,assassination,18,4,14
Zerö,tarren-mill,384,rogue,assassination,18,4,14
Ристоврация,gordunni,384,rogue,assassination,18,4,14
Ibizà,ravencrest,384,rogue,assassination,18,4,14
Елианора,gordunni,384,rogue,assassination,18,4,14
Lïke,frostwolf,384,rogue,assassination,18,4,14
Лайнэл,deathweaver,384,rogue,assassination,18,4,14
Mindset,eredar,384,rogue,assassination,18,4,14
Ноумингод,gordunni,384,rogue,assassination,24,4,20
Opiïum,ysondre,383,rogue,assassination,6,4,2
Vexedancer,stormscale,383,rogue,assassination,6,4,2
Tedko,dun-modr,383,rogue,assassination,6,4,2
Horrogue,aggramar,383,rogue,assassination,6,4,2
Kyzzo,dalaran,383,rogue,assassination,12,4,8
Ppogg,pozzo-delleternità,383,rogue,assassination,12,4,8
Obbexd,outland,383,rogue,assassination,12,4,8
Töbïï,sylvanas,383,rogue,assassination,12,4,8
Algopyrin,ragnaros,383,rogue,assassination,12,4,8
Twinkyzzö,archimonde,382,rogue,assassination,12,4,8
Némésiss,archimonde,381,rogue,assassination,12,4,8
Pumpy,blades-edge,381,rogue,assassination,12,4,8
Møkkagnom,darkspear,381,rogue,assassination,12,4,8
Easy,kult-der-verdammten,376,rogue,assassination,18,4,14
Stealtheous,arathor,367,rogue,assassination,11,4,7
Firekry,stormscale,366,rogue,assassination,12,4,8
Lilbubblegum,emerald-dream,351,rogue,assassination,11,4,7
Gereon,drakthul,351,rogue,assassination,11,4,7
Морзо,howling-fjord,351,rogue,assassination,17,4,13
Клозо,galakrond,351,rogue,assassination,17,4,13
Voraq,blackhand,350,rogue,assassination,11,4,7
Háshírama,ravencrest,335,rogue,assassination,11,4,7
Arathir,ravencrest,330,rogue,assassination,15,5,10
Benh,ysondre,319,rogue,assassination,8,4,4
Fz,chants-éternels,319,rogue,assassination,16,5,11
Smorcoolio,stormscale,288,rogue,assassination,6,3,3
Ximenidriel,ravencrest,288,rogue,assassination,6,3,3
Luciferx,stormscale,288,rogue,assassination,6,3,3
Myxx,ravencrest,288,rogue,assassination,6,3,3
Nezukóchan,ravencrest,288,rogue,assassination,6,3,3
Langneurr,archimonde,288,rogue,assassination,6,3,3
Sâtýr,ravencrest,288,rogue,assassination,6,3,3
Jsprxo,stormscale,288,rogue,assassination,6,3,3
Reaventis,ravencrest,288,rogue,assassination,6,3,3
Zigaretz,ravencrest,288,rogue,assassination,6,3,3
Mordred,stormscale,288,rogue,assassination,6,3,3
Erdin,ravencrest,288,rogue,assassination,6,3,3
Steálth,silvermoon,288,rogue,assassination,6,3,3
Lïhtêñßërg,ravencrest,288,rogue,assassination,6,3,3
Keexy,ravencrest,288,rogue,assassination,6,3,3
Darák,thrall,288,rogue,assassination,6,3,3
Artyzoo,tarren-mill,288,rogue,assassination,6,3,3
Aska,antonidas,288,rogue,assassination,6,3,3
Tasster,frostwolf,288,rogue,assassination,6,3,3
Sît,twisting-nether,288,rogue,assassination,6,3,3
Зорго,deathguard,288,rogue,assassination,6,3,3
Jackpackáge,sylvanas,288,rogue,assassination,6,3,3
Labronka,sanguino,288,rogue,assassination,6,3,3
Kaylí,kazzak,288,rogue,assassination,6,3,3
Ultraxette,ysondre,288,rogue,assassination,6,3,3
Stroògz,ysondre,288,rogue,assassination,6,3,3
Heftychonk,doomhammer,288,rogue,assassination,6,3,3
Lättja,hyjal,288,rogue,assassination,6,3,3
Rodént,argent-dawn,288,rogue,assassination,6,3,3
Ацилия,galakrond,288,rogue,assassination,6,3,3
Олддеадроб,soulflayer,288,rogue,assassination,6,3,3
Gitguduwu,tarren-mill,288,rogue,assassination,6,3,3
Laojin,kiljaeden,288,rogue,assassination,6,3,3
Ракфорн,howling-fjord,288,rogue,assassination,6,3,3
Sorashna,agamaggan,288,rogue,assassination,6,3,3
Blades,blackmoore,288,rogue,assassination,6,3,3
Stealthyist,darkmoon-faire,288,rogue,assassination,6,3,3
Batta,drakthul,288,rogue,assassination,6,3,3
Котянкахд,howling-fjord,288,rogue,assassination,6,3,3
Охотникведьм,soulflayer,288,rogue,assassination,6,3,3
Illmindofboo,twisting-nether,288,rogue,assassination,6,3,3
Nevazutu,twisting-nether,288,rogue,assassination,6,3,3
Xãwé,kazzak,288,rogue,assassination,6,3,3
Ðaemøn,archimonde,288,rogue,assassination,12,4,8
Shadowprank,ravencrest,288,rogue,assassination,9,3,6
Vyllaftw,hyjal,288,rogue,assassination,10,3,7
Psybelette,khaz-modan,288,rogue,assassination,15,4,11
Rôst,ravencrest,288,rogue,assassination,12,3,9
Poerta,burning-blade,288,rogue,assassination,12,3,9
Hamer,eredar,288,rogue,assassination,12,3,9
Kyropth,eredar,288,rogue,assassination,12,3,9
Mxrbid,defias-brotherhood,288,rogue,assassination,12,3,9
Kylìemirogue,blackrock,288,rogue,assassination,12,3,9
Persës,outland,288,rogue,assassination,12,3,9
Søtez,ravencrest,288,rogue,assassination,12,3,9
Eriksonn,drakthul,288,rogue,assassination,12,3,9
Terya,ragnaros,288,rogue,assassination,12,3,9
Smokeyx,outland,288,rogue,assassination,12,3,9
Vessel,tarren-mill,288,rogue,assassination,12,3,9
Turbocandle,ravencrest,288,rogue,assassination,12,3,9
Teldã,archimonde,288,rogue,assassination,12,3,9
Fushimi,ravencrest,288,rogue,assassination,12,3,9
Курога,howling-fjord,288,rogue,assassination,12,3,9
Zip,alleria,288,rogue,assassination,12,3,9
Gløck,die-aldor,288,rogue,assassination,12,3,9
Howhigh,stormscale,288,rogue,assassination,12,3,9
Bumaqt,silvermoon,288,rogue,assassination,12,3,9
Redork,twisting-nether,288,rogue,assassination,12,3,9
Sickko,stormscale,288,rogue,assassination,12,3,9
Nezuko,gilneas,288,rogue,assassination,12,3,9
Ryurfy,archimonde,288,rogue,assassination,12,3,9
Hersuub,blackmoore,288,rogue,assassination,12,3,9
Netreck,dun-modr,288,rogue,assassination,12,3,9
Zeiden,sanguino,288,rogue,assassination,12,3,9
Bakalan,dun-modr,288,rogue,assassination,12,3,9
Onedance,blackrock,288,rogue,assassination,14,3,11
Altaár,dun-modr,288,rogue,assassination,18,3,15
Crittylohan,blackrock,288,rogue,assassination,18,3,15
Memphismp,drakthul,288,rogue,assassination,18,3,15
Jáyjay,antonidas,288,rogue,assassination,18,3,15
Killboom,rexxar,287,rogue,assassination,6,3,3
Умбрен,lich-king,287,rogue,assassination,6,3,3
Гламурятина,gordunni,287,rogue,assassination,6,3,3
Willin,kazzak,287,rogue,assassination,6,3,3
Yubleeding,kazzak,287,rogue,assassination,6,3,3
Vv,terokkar,287,rogue,assassination,6,3,3
Saleanos,die-aldor,287,rogue,assassination,12,3,9
Nastyrogue,burning-legion,287,rogue,assassination,12,3,9
Vendox,defias-brotherhood,287,rogue,assassination,12,3,9
Krymziàâ,hyjal,287,rogue,assassination,18,3,15
Bondina,nemesis,286,rogue,assassination,6,3,3
Фоксивнир,soulflayer,286,rogue,assassination,6,3,3
Clapslap,blackmoore,286,rogue,assassination,6,3,3
Ecilaa,conseil-des-ombres,285,rogue,assassination,12,3,9
Derrieretoî,archimonde,285,rogue,assassination,12,3,9
Bobydrift,khaz-modan,284,rogue,assassination,12,3,9
Verbb,turalyon,284,rogue,assassination,12,3,9
Layson,les-clairvoyants,271,rogue,assassination,11,3,8
Bloodhand,blackmoore,255,rogue,assassination,11,3,8
Candise,ysondre,253,rogue,assassination,11,3,8
Blckrogue,bloodfeather,240,rogue,assassination,9,3,6
Jimmybrä,draenor,239,rogue,assassination,5,3,2
Starkad,archimonde,239,rogue,assassination,5,3,2
Kebabgodx,sanguino,223,rogue,assassination,8,3,5
Goldenblitz,blackmoore,192,rogue,assassination,6,2,4
Кашеварить,gordunni,192,rogue,assassination,6,2,4
Сильфитт,gordunni,192,rogue,assassination,6,2,4
Weird,blackmoore,192,rogue,assassination,6,2,4
Shúrae,blackmoore,192,rogue,assassination,6,2,4
Killnoobs,kazzak,192,rogue,assassination,6,2,4
Saix,blackrock,192,rogue,assassination,6,2,4
Maedyv,magtheridon,192,rogue,assassination,6,2,4
Sêrgi,minahonda,192,rogue,assassination,6,2,4
Zhafira,magtheridon,192,rogue,assassination,6,2,4
Robtherobber,kazzak,192,rogue,assassination,6,2,4
Zømbië,kazzak,192,rogue,assassination,6,2,4
Redrumx,outland,192,rogue,assassination,6,2,4
Bórgós,blackrock,192,rogue,assassination,6,2,4
Garou,blackhand,192,rogue,assassination,6,2,4
Kersatos,silvermoon,192,rogue,assassination,6,2,4
Fälke,dun-modr,192,rogue,assassination,6,2,4
Bloodwraith,stormscale,192,rogue,assassination,6,2,4
Rãz,stormscale,192,rogue,assassination,6,2,4
Warbell,stormscale,192,rogue,assassination,6,2,4
Venom,stormscale,192,rogue,assassination,6,2,4
Syrn,ravencrest,192,rogue,assassination,6,2,4
Nudelholz,blackrock,192,rogue,assassination,6,2,4
Althieves,ravencrest,192,rogue,assassination,6,2,4
Maxrizzx,ravencrest,192,rogue,assassination,6,2,4
Niagram,dun-modr,192,rogue,assassination,6,2,4
Kikitaklk,uldum,192,rogue,assassination,6,2,4
Naí,zuljin,192,rogue,assassination,6,2,4
Hideout,ravencrest,192,rogue,assassination,6,2,4
Windhawkz,silvermoon,192,rogue,assassination,6,2,4
Sokillu,silvermoon,192,rogue,assassination,6,2,4
Sanzsa,ravencrest,192,rogue,assassination,6,2,4
Нойсеен,gordunni,192,rogue,assassination,6,2,4
Новиччокк,gordunni,192,rogue,assassination,6,2,4
Mobrac,silvermoon,192,rogue,assassination,6,2,4
Аренатрюки,soulflayer,192,rogue,assassination,6,2,4
Jonewrld,ravencrest,192,rogue,assassination,6,2,4
Хемофилия,grom,192,rogue,assassination,6,2,4
Katara,antonidas,192,rogue,assassination,6,2,4
Fîst,antonidas,192,rogue,assassination,6,2,4
Eazmode,outland,192,rogue,assassination,6,2,4
Brazzersx,antonidas,192,rogue,assassination,6,2,4
Reáper,frostwolf,192,rogue,assassination,6,2,4
Ikaze,kazzak,192,rogue,assassination,6,2,4
Gane,sanguino,192,rogue,assassination,6,2,4
Саулите,deathguard,192,rogue,assassination,6,2,4
Highz,zenedar,192,rogue,assassination,6,2,4
Hardkølle,ravencrest,192,rogue,assassination,6,2,4
Китей,howling-fjord,192,rogue,assassination,6,2,4
Xanyy,bloodfeather,192,rogue,assassination,6,2,4
Сабстрайк,soulflayer,192,rogue,assassination,6,2,4
Yanlu,ysondre,192,rogue,assassination,6,2,4
Xanders,draenor,192,rogue,assassination,6,2,4
Nïhal,suramar,192,rogue,assassination,6,2,4
Isucu,burning-legion,192,rogue,assassination,6,2,4
Oczku,burning-legion,192,rogue,assassination,6,2,4
Rearmer,burning-legion,192,rogue,assassination,6,2,4
Henlh,turalyon,192,rogue,assassination,6,2,4
Sycko,alakir,192,rogue,assassination,6,2,4
Helcof,emerald-dream,192,rogue,assassination,6,2,4
Grüeßseebach,todeswache,192,rogue,assassination,6,2,4
Díddz,tarren-mill,192,rogue,assassination,6,2,4
Habba,dragonblight,192,rogue,assassination,6,2,4
Tofix,tarren-mill,192,rogue,assassination,6,2,4
Ðelvin,dalaran,192,rogue,assassination,6,2,4
Diliu,doomhammer,192,rogue,assassination,6,2,4
Xeggy,turalyon,192,rogue,assassination,6,2,4
Хулиганнчег,galakrond,192,rogue,assassination,6,2,4
Аутянин,soulflayer,192,rogue,assassination,6,2,4
Люняшка,booty-bay,192,rogue,assassination,6,2,4
Mallaurya,dalaran,192,rogue,assassination,6,2,4
Zyphion,ragnaros,192,rogue,assassination,6,2,4
Noilek,sylvanas,192,rogue,assassination,6,2,4
Ichiegoichie,draenor,192,rogue,assassination,6,2,4
Warrdenn,draenor,192,rogue,assassination,6,2,4
Bangerstab,draenor,192,rogue,assassination,6,2,4
Synexo,sylvanas,192,rogue,assassination,6,2,4
Tinta,aszune,192,rogue,assassination,6,2,4
Totentánz,silvermoon,192,rogue,assassination,15,3,12
Hitogoroshi,hyjal,192,rogue,assassination,12,2,10
Yüm,burning-blade,192,rogue,assassination,12,2,10
Ayatsuji,nemesis,192,rogue,assassination,12,2,10
Neirdà,hyjal,192,rogue,assassination,12,2,10
Sylvanshadow,nemesis,192,rogue,assassination,12,2,10
Rasponi,ragnaros,192,rogue,assassination,12,2,10
Azzmodia,aegwynn,192,rogue,assassination,12,2,10
Vezinia,ravencrest,192,rogue,assassination,12,2,10
Romiel,ravencrest,192,rogue,assassination,12,2,10
Ôrígìnälnezo,drakthul,192,rogue,assassination,12,2,10
Sheyrrà,aegwynn,192,rogue,assassination,12,2,10
Withoutlove,drakthul,192,rogue,assassination,12,2,10
Nesä,hyjal,192,rogue,assassination,12,2,10
Mingzhu,ravencrest,192,rogue,assassination,12,2,10
Cacucoxpahu,kazzak,192,rogue,assassination,12,2,10
Skuggdunkarn,draenor,192,rogue,assassination,12,2,10
Hanteran,magtheridon,192,rogue,assassination,12,2,10
Лэйкиро,gordunni,192,rogue,assassination,12,2,10
Bolesnirogue,draenor,192,rogue,assassination,12,2,10
Rnghero,blackmoore,192,rogue,assassination,12,2,10
Sneakzy,sylvanas,192,rogue,assassination,12,2,10
Skilz,sylvanas,192,rogue,assassination,12,2,10
Coopér,argent-dawn,192,rogue,assassination,18,2,16
Nhot,kazzak,191,rogue,assassination,6,2,4
Токссиси,gordunni,191,rogue,assassination,6,2,4
Drexxo,drakthul,191,rogue,assassination,6,2,4
Thugore,thunderhorn,191,rogue,assassination,6,2,4
Вангельм,gordunni,191,rogue,assassination,12,2,10
Midô,dun-morogh,191,rogue,assassination,12,2,10
Snikrot,karazhan,190,rogue,assassination,12,2,10
Murant,twisting-nether,190,rogue,assassination,12,2,10
Icyicé,kazzak,175,rogue,assassination,11,2,9
Sanzoo,blackmoore,175,rogue,assassination,11,2,9
Зайт,howling-fjord,173,rogue,assassination,11,3,8
Nià,argent-dawn,158,rogue,assassination,10,2,8
Rascall,anetheron,138,rogue,assassination,8,3,5
Shâdowfreeze,onyxia,138,rogue,assassination,22,4,18
Ravenom,sylvanas,96,rogue,assassination,6,1,5
Stealthaldo,sylvanas,96,rogue,assassination,6,1,5
Hallowéén,turalyon,96,rogue,assassination,6,1,5
Kilabre,twisting-nether,96,rogue,assassination,6,1,5
Shåkø,tarren-mill,96,rogue,assassination,6,1,5
Helax,turalyon,96,rogue,assassination,6,1,5
Jamzyrogue,emerald-dream,96,rogue,assassination,6,1,5
Sly,emerald-dream,96,rogue,assassination,6,1,5
Bizzarerogue,tarren-mill,96,rogue,assassination,6,1,5
Tsoupoma,tarren-mill,96,rogue,assassination,6,1,5
Lefthook,argent-dawn,96,rogue,assassination,6,1,5
Møtivate,ragnaros,96,rogue,assassination,6,1,5
Lorinthel,argent-dawn,96,rogue,assassination,6,1,5
Рестинписер,soulflayer,96,rogue,assassination,6,1,5
Guzirogue,azshara,96,rogue,assassination,6,1,5
Pfaded,steamwheedle-cartel,96,rogue,assassination,6,1,5
Dachdagger,malfurion,96,rogue,assassination,6,1,5
Mortdorei,argent-dawn,96,rogue,assassination,6,1,5
Бларефул,eversong,96,rogue,assassination,6,1,5
Takiya,ysondre,96,rogue,assassination,6,1,5
Дизелюжн,howling-fjord,96,rogue,assassination,6,1,5
Salitra,die-aldor,96,rogue,assassination,6,1,5
Трисися,gordunni,96,rogue,assassination,6,1,5
Метаболикх,gordunni,96,rogue,assassination,6,1,5
Yörgs,eredar,96,rogue,assassination,6,1,5
Penetrantos,eredar,96,rogue,assassination,6,1,5
Roronao,sanguino,96,rogue,assassination,6,1,5
Yamoshí,sanguino,96,rogue,assassination,6,1,5
Msrogue,eredar,96,rogue,assassination,6,1,5
Flêxô,antonidas,96,rogue,assassination,6,1,5
Deceptionz,ravencrest,96,rogue,assassination,6,1,5
Tokyotears,ravencrest,96,rogue,assassination,6,1,5
Frequenzalfa,silvermoon,96,rogue,assassination,6,1,5
Natkatje,azjolnerub,96,rogue,assassination,6,1,5
Natillaa,dun-modr,96,rogue,assassination,6,1,5
Nexieane,ravencrest,96,rogue,assassination,6,1,5
Thiranor,cthun,96,rogue,assassination,6,1,5
Chøsen,stormscale,96,rogue,assassination,6,1,5
Mekóz,draenor,96,rogue,assassination,6,1,5
Vexior,argent-dawn,96,rogue,assassination,6,1,5
Barisso,burning-legion,96,rogue,assassination,6,1,5
Sbx,alakir,96,rogue,assassination,6,1,5
Faso,thunderhorn,96,rogue,assassination,6,1,5
Roguy,wildhammer,96,rogue,assassination,6,1,5
Janx,aegwynn,96,rogue,assassination,6,1,5
Finfcyn,burning-legion,96,rogue,assassination,6,1,5
Royalflüx,grim-batol,96,rogue,assassination,6,1,5
Dayanir,aggra-português,96,rogue,assassination,6,1,5
Invisage,grim-batol,96,rogue,assassination,6,1,5
Ðiè,frostmane,96,rogue,assassination,6,1,5
Nelji,archimonde,96,rogue,assassination,6,1,5
Expositiv,blackmoore,96,rogue,assassination,6,1,5
Ñavy,archimonde,96,rogue,assassination,6,1,5
Hendrikske,aggramar,96,rogue,assassination,6,1,5
Кейнилин,gordunni,96,rogue,assassination,6,1,5
Ohmydotz,archimonde,96,rogue,assassination,6,1,5
Wøølfgang,archimonde,96,rogue,assassination,6,1,5
Tyzla,blackrock,96,rogue,assassination,6,1,5
Missàh,archimonde,96,rogue,assassination,6,1,5
Miamalkova,zuluhed,96,rogue,assassination,6,1,5
Kenko,aerie-peak,96,rogue,assassination,6,1,5
Иордани,gordunni,96,rogue,assassination,6,1,5
Азунайт,ashenvale,96,rogue,assassination,6,1,5
Vanisshh,hyjal,96,rogue,assassination,6,1,5
Asmodal,antonidas,96,rogue,assassination,6,1,5
Роудхог,blackscar,96,rogue,assassination,6,1,5
Эстанга,grom,96,rogue,assassination,6,1,5
Куллтро,blackscar,96,rogue,assassination,6,1,5
Распяздяй,gordunni,96,rogue,assassination,7,1,6
Proilas,draenor,96,rogue,assassination,11,1,10
Kyoukaî,archimonde,96,rogue,assassination,12,1,11
Tybiereus,argent-dawn,96,rogue,assassination,12,1,11
Роророл,gordunni,96,rogue,assassination,12,1,11
Триплсап,howling-fjord,96,rogue,assassination,12,1,11
Jawen,silvermoon,96,rogue,assassination,12,1,11
Diededlmao,ragnaros,96,rogue,assassination,12,1,11
Engles,twisting-nether,96,rogue,assassination,12,1,11
Ønlylovcindy,drekthar,96,rogue,assassination,12,1,11
Barbuniarz,shadowsong,96,rogue,assassination,12,1,11
Calyon,hyjal,96,rogue,assassination,18,1,17
Crispflake,frostwolf,96,rogue,assassination,18,1,17
Ravéñ,silvermoon,96,rogue,assassination,24,1,23
Vicenzo,archimonde,95,rogue,assassination,3,2,1
Belina,draenor,95,rogue,assassination,6,1,5
Elvís,chamber-of-aspects,95,rogue,assassination,6,1,5
Trashcarlitâ,eredar,79,rogue,assassination,5,1,4
Vound,tarren-mill,64,rogue,assassination,4,1,3
Elgande,stormrage,63,rogue,assassination,2,2,0
Vanquishz,arathor,48,rogue,assassination,3,1,2
Rûzk,frostwolf,48,rogue,assassination,3,1,2
Latscholol,malorne,42,rogue,assassination,12,3,9
Kkraken,dalaran,41,rogue,assassination,10,2,8
Hímars,ragnaros,2151,shaman,restoration,101,52,49
Мефодийшаман,howling-fjord,2126,shaman,restoration,142,88,54
Shadrak,eredar,2123,shaman,restoration,84,46,38
Mininini,ravencrest,2120,shaman,restoration,133,70,63
Josë,twisting-nether,2119,shaman,restoration,137,73,64
Терату,howling-fjord,2118,shaman,restoration,84,46,38
Crnine,pozzo-delleternità,2112,shaman,restoration,75,49,26
Jackypink,ragnaros,2083,shaman,restoration,261,135,126
Benpai,eredar,2076,shaman,restoration,72,36,36
Ultrahound,twisting-nether,2057,shaman,restoration,48,39,9
Trashgame,kazzak,2050,shaman,restoration,66,36,30
Jelincic,ravencrest,2027,shaman,restoration,96,52,44
Chäväman,archimonde,2025,shaman,restoration,150,72,78
Unbrokeñ,stormscale,2024,shaman,restoration,93,45,48
Ggnore,kazzak,2017,shaman,restoration,176,107,69
Вишняблэйз,soulflayer,2007,shaman,restoration,77,44,33
Nickygodx,stormscale,2007,shaman,restoration,77,40,37
Libanô,archimonde,2002,shaman,restoration,859,421,438
Rogerscruton,blades-edge,2001,shaman,restoration,60,32,28
Yararsiz,twisting-nether,2001,shaman,restoration,249,132,117
Keenxd,burning-legion,2000,shaman,restoration,101,55,46
Carlpeant,drakthul,1998,shaman,restoration,191,100,91
Daretodream,blackrock,1996,shaman,restoration,53,29,24
Lavalavalava,blackrock,1993,shaman,restoration,447,244,203
Драгенхз,gordunni,1983,shaman,restoration,387,195,192
Frshprn,hyjal,1982,shaman,restoration,90,51,39
Кодитян,gordunni,1981,shaman,restoration,72,38,34
Swineflowing,ysondre,1974,shaman,restoration,96,50,46
Kisshots,the-maelstrom,1960,shaman,restoration,162,87,75
Дольчих,deathguard,1956,shaman,restoration,302,144,158
Deepwithyou,blackhand,1953,shaman,restoration,153,83,70
Epsylone,kazzak,1953,shaman,restoration,101,51,50
Ripperdoc,stormreaver,1950,shaman,restoration,78,38,40
Linkx,stormscale,1948,shaman,restoration,40,22,18
Трс,razuvious,1947,shaman,restoration,158,90,68
Fotmherøqtx,ravencrest,1946,shaman,restoration,132,75,57
Bobanrajovic,silvermoon,1943,shaman,restoration,48,31,17
Söd,dun-morogh,1943,shaman,restoration,84,42,42
Tallyx,ravencrest,1940,shaman,restoration,119,60,59
Adroda,kazzak,1939,shaman,restoration,117,66,51
Valko,hellfire,1931,shaman,restoration,42,27,15
Lavelover,tarren-mill,1927,shaman,restoration,66,41,25
Zhull,ravencrest,1927,shaman,restoration,400,197,203
Цукерок,soulflayer,1922,shaman,restoration,119,72,47
Skreewu,outland,1922,shaman,restoration,90,44,46
Señordoge,kazzak,1917,shaman,restoration,54,28,26
Shamidrak,eredar,1914,shaman,restoration,66,34,32
Милфшама,blackscar,1910,shaman,restoration,263,140,123
Lunarsloths,hyjal,1907,shaman,restoration,54,33,21
Greggyb,twisting-nether,1904,shaman,restoration,48,27,21
Vivaldi,varimathras,1899,shaman,restoration,56,29,27
Carlitosham,eredar,1899,shaman,restoration,68,33,35
Котенокмур,soulflayer,1899,shaman,restoration,48,20,28
Stensham,stormreaver,1896,shaman,restoration,66,37,29
Мефодийшама,howling-fjord,1893,shaman,restoration,132,63,69
Hugox,outland,1889,shaman,restoration,566,278,288
Izir,archimonde,1885,shaman,restoration,234,120,114
Bmbx,archimonde,1885,shaman,restoration,604,304,300
Fufupartyxx,blackrock,1883,shaman,restoration,60,37,23
Chokelord,archimonde,1882,shaman,restoration,36,22,14
Somethingnew,azuremyst,1882,shaman,restoration,64,32,32
Thunderrock,stormreaver,1880,shaman,restoration,211,102,109
Sèfìx,tarren-mill,1879,shaman,restoration,38,21,17
Natasz,burning-legion,1874,shaman,restoration,206,114,92
Kïllard,archimonde,1872,shaman,restoration,80,40,40
Кенкерх,gordunni,1871,shaman,restoration,84,38,46
Timide,ravencrest,1870,shaman,restoration,48,28,20
Killrogge,kazzak,1869,shaman,restoration,34,29,5
Iloveléa,ravencrest,1868,shaman,restoration,78,44,34
Rheax,tarren-mill,1868,shaman,restoration,60,27,33
Owrly,stormscale,1866,shaman,restoration,136,65,71
Keén,burning-legion,1865,shaman,restoration,51,29,22
Вавувоух,howling-fjord,1863,shaman,restoration,54,27,27
Teldathree,archimonde,1862,shaman,restoration,118,63,55
Онеоне,deathweaver,1861,shaman,restoration,71,41,30
Эоя,howling-fjord,1861,shaman,restoration,230,121,109
Louler,ragnaros,1860,shaman,restoration,124,69,55
Kalypsø,arthas,1858,shaman,restoration,77,44,33
Wíllz,ravencrest,1858,shaman,restoration,54,29,25
Yachiru,sylvanas,1854,shaman,restoration,73,59,14
Ghettero,ragnaros,1851,shaman,restoration,39,25,14
Иними,soulflayer,1851,shaman,restoration,258,125,133
Sugarfreé,ragnaros,1848,shaman,restoration,48,26,22
Zaru,sanguino,1846,shaman,restoration,63,31,32
Finaltotem,draenor,1844,shaman,restoration,60,28,32
Cæsífer,blackrock,1844,shaman,restoration,72,32,40
Shiranoye,blackrock,1842,shaman,restoration,144,77,67
Sentûn,blackrock,1842,shaman,restoration,138,68,70
Cylantarus,blackrock,1838,shaman,restoration,179,94,85
Cherepaha,stormscale,1838,shaman,restoration,70,32,38
Cellfury,kazzak,1837,shaman,restoration,46,36,10
Wernøz,archimonde,1837,shaman,restoration,80,37,43
Johncoltrane,archimonde,1835,shaman,restoration,132,84,48
Epsy,magtheridon,1834,shaman,restoration,66,46,20
Shockmelone,blackrock,1834,shaman,restoration,103,55,48
Inspektør,kazzak,1833,shaman,restoration,59,37,22
Swkx,dun-modr,1832,shaman,restoration,88,48,40
Alanus,draenor,1831,shaman,restoration,63,33,30
Sinzzu,ragnaros,1831,shaman,restoration,241,123,118
Gargro,kazzak,1831,shaman,restoration,109,54,55
Jawje,tarren-mill,1831,shaman,restoration,102,49,53
Westide,conseil-des-ombres,1830,shaman,restoration,48,26,22
Shamuunn,ravencrest,1830,shaman,restoration,54,28,26
Sethrøllins,hyjal,1829,shaman,restoration,114,53,61
Domo,stormscale,1827,shaman,restoration,60,29,31
Fitnessdavid,ravencrest,1826,shaman,restoration,53,29,24
Hexe,kazzak,1826,shaman,restoration,81,37,44
Askagain,sylvanas,1825,shaman,restoration,52,28,24
Zergønk,ravencrest,1824,shaman,restoration,42,28,14
Asynchund,ravencrest,1821,shaman,restoration,42,26,16
Centralc,twisting-nether,1820,shaman,restoration,47,28,19
Árés,sanguino,1820,shaman,restoration,63,34,29
Светшамка,howling-fjord,1817,shaman,restoration,30,19,11
Shamrockx,outland,1816,shaman,restoration,83,42,41
Sûckmytotem,ragnaros,1815,shaman,restoration,72,35,37
Arathoir,ravencrest,1814,shaman,restoration,36,23,13
Bladeyx,ragnaros,1813,shaman,restoration,231,129,102
Ixxmre,blackrock,1813,shaman,restoration,189,104,85
Meöw,nemesis,1813,shaman,restoration,232,120,112
Bunyie,ragnaros,1812,shaman,restoration,90,48,42
Carpetmaster,ragnaros,1812,shaman,restoration,51,27,24
Нойзблок,gordunni,1811,shaman,restoration,36,19,17
Ghostlights,doomhammer,1811,shaman,restoration,68,31,37
Reidzls,kazzak,1810,shaman,restoration,36,22,14
Awcchampion,stormscale,1810,shaman,restoration,287,160,127
Tidepog,ravencrest,1810,shaman,restoration,60,28,32
Rexatar,blackrock,1809,shaman,restoration,201,113,88
Triplewhoppa,thrall,1809,shaman,restoration,76,40,36
Remony,pozzo-delleternità,1808,shaman,restoration,128,83,45
Fuzzynuts,ravencrest,1808,shaman,restoration,132,74,58
Yannkee,ravencrest,1808,shaman,restoration,48,24,24
Tùiðhânâ,ravencrest,1807,shaman,restoration,197,107,90
Xelgrin,silvermoon,1807,shaman,restoration,66,30,36
Nokster,twisting-nether,1806,shaman,restoration,84,60,24
Voodoonerd,twisting-nether,1803,shaman,restoration,47,24,23
Neou,archimonde,1803,shaman,restoration,54,27,27
Viinny,dun-modr,1803,shaman,restoration,102,48,54
Luckymê,blackrock,1802,shaman,restoration,51,27,24
Bytheway,aegwynn,1802,shaman,restoration,127,56,71
Мимигор,razuvious,1801,shaman,restoration,35,27,8
Eras,ragnaros,1801,shaman,restoration,30,19,11
Kiansham,silvermoon,1801,shaman,restoration,47,26,21
Rckfeller,burning-legion,1801,shaman,restoration,60,31,29
Squixi,tarren-mill,1799,shaman,restoration,60,33,27
Hexewar,kazzak,1789,shaman,restoration,89,47,42
Harmony,outland,1785,shaman,restoration,42,30,12
Sprühkot,aegwynn,1781,shaman,restoration,46,28,18
Kreamcake,bladefist,1780,shaman,restoration,156,72,84
Holytidezx,aegwynn,1775,shaman,restoration,40,26,14
Moistpuss,kazzak,1773,shaman,restoration,78,49,29
Orcshaman,khadgar,1771,shaman,restoration,48,24,24
Palfe,khaz-modan,1769,shaman,restoration,142,72,70
Szellento,darksorrow,1769,shaman,restoration,96,47,49
Nübs,aegwynn,1769,shaman,restoration,101,47,54
Ize,sylvanas,1768,shaman,restoration,94,61,33
Чинанрук,howling-fjord,1767,shaman,restoration,119,61,58
Дыркавауре,soulflayer,1764,shaman,restoration,54,23,31
Daubidaubi,kazzak,1763,shaman,restoration,140,87,53
Bezixx,ravencrest,1763,shaman,restoration,198,111,87
Bstr,frostmane,1763,shaman,restoration,60,30,30
Ihealbro,blackrock,1762,shaman,restoration,66,41,25
Crymemore,stormscale,1760,shaman,restoration,47,24,23
Windfúhrèr,tarren-mill,1759,shaman,restoration,60,26,34
Eurocad,draenor,1758,shaman,restoration,42,22,20
Learningsham,destromath,1749,shaman,restoration,48,29,19
Machmacan,argent-dawn,1749,shaman,restoration,110,60,50
Variablelol,outland,1746,shaman,restoration,64,43,21
Kraksham,ravencrest,1745,shaman,restoration,112,60,52
Nestre,kazzak,1745,shaman,restoration,42,21,21
Karakoram,ysondre,1741,shaman,restoration,155,82,73
Midgetfizzle,kazzak,1741,shaman,restoration,314,153,161
Phaynozx,cthun,1741,shaman,restoration,96,39,57
Donv,blackmoore,1739,shaman,restoration,42,26,16
Helloiamdoni,ravencrest,1739,shaman,restoration,125,71,54
Rottulos,stormrage,1739,shaman,restoration,65,35,30
Squixi,ravencrest,1738,shaman,restoration,59,33,26
Waramors,eredar,1738,shaman,restoration,131,65,66
Purgeluxe,aegwynn,1733,shaman,restoration,125,65,60
Jíkkz,aegwynn,1729,shaman,restoration,66,32,34
Stylia,twisting-nether,1727,shaman,restoration,42,25,17
Darnast,draenor,1727,shaman,restoration,70,31,39
Агентхолинки,gordunni,1726,shaman,restoration,24,18,6
Tentacruel,sylvanas,1726,shaman,restoration,91,56,35
Bullezno,kazzak,1725,shaman,restoration,111,66,45
Arslos,twisting-nether,1723,shaman,restoration,30,24,6
Sheargodx,blackmoore,1723,shaman,restoration,42,21,21
Agnøt,khaz-modan,1722,shaman,restoration,120,70,50
Snusy,stormscale,1722,shaman,restoration,36,18,18
Wess,archimonde,1722,shaman,restoration,36,18,18
Morkyy,thrall,1721,shaman,restoration,38,19,19
Torxii,antonidas,1720,shaman,restoration,177,100,77
Слишкомплох,howling-fjord,1715,shaman,restoration,48,24,24
Светшам,howling-fjord,1715,shaman,restoration,47,23,24
Mltx,twilights-hammer,1714,shaman,restoration,44,19,25
Shamolili,stormscale,1713,shaman,restoration,108,52,56
Dmgaddict,kazzak,1712,shaman,restoration,54,32,22
Есперадох,blackscar,1712,shaman,restoration,41,19,22
Lahey,draenor,1711,shaman,restoration,140,73,67
Тафельшпиц,soulflayer,1710,shaman,restoration,58,27,31
Totembaws,blackmoore,1708,shaman,restoration,54,26,28
Holytidez,aegwynn,1707,shaman,restoration,48,24,24
Lsdhero,stormscale,1706,shaman,restoration,24,18,6
Nizzarrathur,argent-dawn,1706,shaman,restoration,30,18,12
Mamacitá,eredar,1706,shaman,restoration,500,242,258
Hydrolîc,blackrock,1705,shaman,restoration,66,36,30
Earthhulk,thrall,1704,shaman,restoration,104,64,40
Thyroideus,argent-dawn,1704,shaman,restoration,228,130,98
Connecting,hyjal,1704,shaman,restoration,39,21,18
Vajaele,twisting-nether,1703,shaman,restoration,113,56,57
Incase,burning-legion,1701,shaman,restoration,53,30,23
Ларкуш,howling-fjord,1701,shaman,restoration,118,61,57
Мвнз,soulflayer,1700,shaman,restoration,54,22,32
Garuga,dun-morogh,1699,shaman,restoration,36,18,18
Hexur,archimonde,1698,shaman,restoration,29,19,10
Bâbbub,tarren-mill,1697,shaman,restoration,45,27,18
Wawawoowee,archimonde,1696,shaman,restoration,54,27,27
Djtidex,conseil-des-ombres,1696,shaman,restoration,48,24,24
Bloodvaron,zuljin,1696,shaman,restoration,95,46,49
Ганинапална,soulflayer,1696,shaman,restoration,60,24,36
Nêmônin,perenolde,1694,shaman,restoration,44,28,16
Turboeddy,blackmoore,1694,shaman,restoration,105,60,45
Igly,antonidas,1694,shaman,restoration,42,21,21
Dóómhammer,jaedenar,1693,shaman,restoration,142,74,68
Сорит,blackscar,1692,shaman,restoration,57,34,23
Wacomtablet,kazzak,1690,shaman,restoration,24,18,6
Redomsh,stormreaver,1689,shaman,restoration,54,28,26
Скарфэйсх,soulflayer,1688,shaman,restoration,36,18,18
Googleme,veklor,1688,shaman,restoration,64,30,34
Goeller,stormscale,1687,shaman,restoration,54,29,25
Nellytko,aegwynn,1686,shaman,restoration,81,44,37
Виелетта,gordunni,1684,shaman,restoration,30,18,12
Itselectric,ravencrest,1683,shaman,restoration,136,77,59
Lexos,ravencrest,1682,shaman,restoration,54,32,22
Reäz,archimonde,1680,shaman,restoration,48,22,26
Simiann,outland,1678,shaman,restoration,30,22,8
Shoqt,les-sentinelles,1678,shaman,restoration,30,18,12
Lexxthree,blackrock,1677,shaman,restoration,36,23,13
Teldatwo,archimonde,1676,shaman,restoration,29,19,10
Fapmasterz,eredar,1675,shaman,restoration,60,29,31
Mbembe,blackhand,1674,shaman,restoration,48,26,22
Keisser,ravencrest,1674,shaman,restoration,48,26,22
Yakee,doomhammer,1674,shaman,restoration,56,28,28
Apexe,outland,1673,shaman,restoration,52,18,34
Wyrt,burning-legion,1672,shaman,restoration,48,24,24
Skrewu,stormscale,1671,shaman,restoration,79,39,40
Snickersx,blackrock,1670,shaman,restoration,78,46,32
Кикподхвост,soulflayer,1670,shaman,restoration,54,26,28
Wotan,ysondre,1669,shaman,restoration,54,32,22
Pakxø,malganis,1669,shaman,restoration,108,54,54
Loltotem,outland,1666,shaman,restoration,42,26,16
Sanamaxx,colinas-pardas,1666,shaman,restoration,62,36,26
Littletrall,outland,1666,shaman,restoration,60,34,26
Mishoshamana,tarren-mill,1664,shaman,restoration,30,20,10
Rapedtide,thrall,1664,shaman,restoration,136,63,73
Atwâ,ravencrest,1663,shaman,restoration,51,31,20
Brandiløve,nemesis,1663,shaman,restoration,36,19,17
Лехадабстеп,deathguard,1662,shaman,restoration,42,23,19
Gønuts,sylvanas,1660,shaman,restoration,48,26,22
Bombasthicc,ravencrest,1660,shaman,restoration,48,24,24
Questionable,antonidas,1660,shaman,restoration,54,24,30
Phoenííx,twisting-nether,1657,shaman,restoration,353,171,182
Мвнзх,gordunni,1656,shaman,restoration,54,24,30
Faridstreng,blackmoore,1655,shaman,restoration,99,54,45
Рамаксбосс,gordunni,1651,shaman,restoration,36,22,14
Levarázsol,outland,1648,shaman,restoration,48,27,21
Porkzzila,aggra-português,1647,shaman,restoration,66,36,30
Prizærn,tarren-mill,1647,shaman,restoration,96,44,52
Héxdóctór,ravencrest,1644,shaman,restoration,92,50,42
Shamandoino,wildhammer,1644,shaman,restoration,198,91,107
Reitar,burning-blade,1643,shaman,restoration,108,48,60
Allysidewtf,archimonde,1642,shaman,restoration,34,23,11
Trbhlk,blackrock,1642,shaman,restoration,42,21,21
Bonshaman,ahnqiraj,1642,shaman,restoration,120,55,65
Coöld,archimonde,1640,shaman,restoration,36,19,17
Kyogre,auchindoun,1640,shaman,restoration,72,36,36
Lavjar,stormscale,1640,shaman,restoration,58,26,32
Maestralink,aegwynn,1638,shaman,restoration,47,24,23
Jps,gorgonnash,1638,shaman,restoration,89,42,47
Jenkem,hyjal,1638,shaman,restoration,54,25,29
Octon,dun-modr,1637,shaman,restoration,46,23,23
Indeed,frostmourne,1635,shaman,restoration,48,28,20
Rxs,thunderhorn,1635,shaman,restoration,54,28,26
Aioñ,kazzak,1635,shaman,restoration,51,22,29
Velkin,thrall,1634,shaman,restoration,153,83,70
Kharvo,draenor,1633,shaman,restoration,70,34,36
Reinu,ragnaros,1632,shaman,restoration,42,21,21
Сладкийстас,soulflayer,1632,shaman,restoration,54,21,33
Nexian,kazzak,1631,shaman,restoration,71,41,30
Oldandslow,sylvanas,1631,shaman,restoration,42,21,21
Invadé,stormscale,1630,shaman,restoration,30,17,13
Batmanmain,twisting-nether,1629,shaman,restoration,34,21,13
Elmie,outland,1629,shaman,restoration,30,17,13
Pøwertoto,dalaran,1629,shaman,restoration,78,36,42
Draáx,ravencrest,1628,shaman,restoration,30,19,11
Elmezz,aggra-português,1628,shaman,restoration,30,17,13
Averya,blackmoore,1628,shaman,restoration,52,27,25
Yomuchacha,dun-modr,1628,shaman,restoration,112,57,55
Søtêx,ravencrest,1627,shaman,restoration,35,23,12
Zorcs,silvermoon,1627,shaman,restoration,183,93,90
Xclusiveqt,archimonde,1626,shaman,restoration,30,17,13
Putzè,blackrock,1625,shaman,restoration,61,38,23
Shamimüll,twisting-nether,1624,shaman,restoration,42,29,13
Urshak,alleria,1624,shaman,restoration,30,20,10
Xhanon,kazzak,1624,shaman,restoration,36,20,16
Fersok,zuljin,1624,shaman,restoration,36,17,19
Labûche,chogall,1623,shaman,restoration,36,24,12
Hexbeforesex,kazzak,1623,shaman,restoration,269,143,126
Shocklet,twisting-nether,1622,shaman,restoration,36,29,7
Shman,blackrock,1621,shaman,restoration,64,42,22
Atomstrom,frostwolf,1621,shaman,restoration,62,34,28
Ðenlos,destromath,1620,shaman,restoration,186,92,94
Hexmeqt,frostwolf,1619,shaman,restoration,113,63,50
Tether,twisting-nether,1619,shaman,restoration,48,26,22
Тубалкайн,soulflayer,1619,shaman,restoration,36,17,19
Tupato,kazzak,1618,shaman,restoration,110,57,53
Shamansh,draenor,1617,shaman,restoration,70,44,26
Пекубулких,soulflayer,1615,shaman,restoration,42,25,17
Maelynda,argent-dawn,1614,shaman,restoration,42,18,24
Urzza,stormscale,1611,shaman,restoration,24,20,4
Shoxý,draenor,1611,shaman,restoration,42,21,21
Djosershamy,draenor,1611,shaman,restoration,111,53,58
Koruga,frostwolf,1610,shaman,restoration,48,26,22
Makkalisse,kazzak,1609,shaman,restoration,24,17,7
Awumbahway,outland,1609,shaman,restoration,36,18,18
Blowlips,argent-dawn,1609,shaman,restoration,42,17,25
Jenyo,alakir,1608,shaman,restoration,54,30,24
Niesel,ravencrest,1608,shaman,restoration,72,38,34
Инкуль,howling-fjord,1608,shaman,restoration,60,28,32
Kardris,nemesis,1607,shaman,restoration,52,25,27
Prîce,blackmoore,1606,shaman,restoration,30,20,10
Ezilol,blackhand,1606,shaman,restoration,77,46,31
Wåvex,archimonde,1606,shaman,restoration,140,69,71
Bullfox,aszune,1606,shaman,restoration,90,42,48
Greenswag,drakthul,1605,shaman,restoration,48,31,17
Hypéra,kazzak,1605,shaman,restoration,216,112,104
Skanda,frostwolf,1604,shaman,restoration,24,17,7
Хужик,gordunni,1604,shaman,restoration,36,21,15
Blowxd,aegwynn,1604,shaman,restoration,134,75,59
Xtremeshaman,blackmoore,1604,shaman,restoration,42,22,20
Schamaster,antonidas,1604,shaman,restoration,120,59,61
Tôrcal,hyjal,1604,shaman,restoration,42,18,24
Turbobaboon,hyjal,1602,shaman,restoration,121,74,47
Lebis,outland,1602,shaman,restoration,60,35,25
Wíwi,kazzak,1602,shaman,restoration,36,20,16
Khroni,tarren-mill,1602,shaman,restoration,66,35,31
Upisi,burning-legion,1601,shaman,restoration,126,63,63
Whiskiy,kazzak,1598,shaman,restoration,26,18,8
Martuscielöl,drakthul,1598,shaman,restoration,88,32,56
Jawj,tarren-mill,1597,shaman,restoration,53,19,34
Startdie,kazzak,1595,shaman,restoration,143,64,79
Incredibade,stormscale,1594,shaman,restoration,42,20,22
Laskopivo,doomhammer,1593,shaman,restoration,60,37,23
Murmaiderz,draenor,1593,shaman,restoration,144,81,63
Mydpsrbad,stormscale,1592,shaman,restoration,160,89,71
Splashgodx,frostwolf,1590,shaman,restoration,41,22,19
Bîlunder,arygos,1590,shaman,restoration,83,37,46
Thorenal,blackmoore,1588,shaman,restoration,67,41,26
Discoranger,ravencrest,1588,shaman,restoration,306,154,152
Bezixx,argent-dawn,1587,shaman,restoration,126,58,68
Superthomas,archimonde,1587,shaman,restoration,65,29,36
Nêôô,blackrock,1587,shaman,restoration,47,19,28
Firenanajkm,dun-modr,1586,shaman,restoration,48,28,20
Paidactor,kazzak,1586,shaman,restoration,239,126,113
Arshak,stormscale,1586,shaman,restoration,45,21,24
Zetricek,drakthul,1585,shaman,restoration,42,20,22
Soffsittaren,kazzak,1584,shaman,restoration,34,17,17
Vioception,blackrock,1584,shaman,restoration,48,19,29
Mìcrøs,thrall,1581,shaman,restoration,59,33,26
Évileye,silvermoon,1580,shaman,restoration,42,20,22
Lustmasterx,grim-batol,1579,shaman,restoration,227,122,105
Zinjk,nemesis,1579,shaman,restoration,332,170,162
Juyina,ravencrest,1579,shaman,restoration,44,22,22
Yzeldan,hyjal,1578,shaman,restoration,248,142,106
Sérx,sanguino,1578,shaman,restoration,95,41,54
Dmgccbot,outland,1576,shaman,restoration,42,17,25
Melàniewalsh,archimonde,1575,shaman,restoration,96,52,44
Mjukiz,tarren-mill,1572,shaman,restoration,333,184,149
Sixtyone,stormscale,1569,shaman,restoration,75,42,33
Totoswich,tarren-mill,1567,shaman,restoration,30,19,11
Сёмабро,ashenvale,1567,shaman,restoration,468,253,215
Hjod,outland,1567,shaman,restoration,108,56,52
Bahane,frostwolf,1567,shaman,restoration,108,53,55
Шсаваннх,blackscar,1566,shaman,restoration,165,83,82
Shockair,frostwolf,1566,shaman,restoration,115,54,61
Zwergmann,blackrock,1565,shaman,restoration,60,37,23
Thald,ragnaros,1565,shaman,restoration,120,68,52
Tommin,silvermoon,1565,shaman,restoration,36,18,18
Madytz,eredar,1564,shaman,restoration,36,21,15
Jarona,twisting-nether,1564,shaman,restoration,93,45,48
Kuis,sanguino,1563,shaman,restoration,72,33,39
Pacho,alakir,1563,shaman,restoration,48,21,27
Foxy,alakir,1561,shaman,restoration,78,39,39
Koraél,dun-modr,1561,shaman,restoration,84,33,51
Tarchoanvahg,ragnaros,1560,shaman,restoration,53,28,25
Radrizzle,tichondrius,1559,shaman,restoration,66,36,30
Exolnard,twisting-nether,1558,shaman,restoration,119,59,60
Xintenggege,silvermoon,1557,shaman,restoration,40,24,16
Cobbel,argent-dawn,1557,shaman,restoration,168,92,76
Lechii,stormscale,1557,shaman,restoration,107,55,52
Lazerboy,twisting-nether,1557,shaman,restoration,47,22,25
Lzzo,ravencrest,1555,shaman,restoration,42,24,18
Nqz,ysondre,1553,shaman,restoration,43,26,17
Zimoneris,blackmoore,1551,shaman,restoration,36,17,19
Sêrø,eredar,1550,shaman,restoration,48,23,25
Cuzzer,drakthul,1548,shaman,restoration,109,59,50
Beastmodex,eredar,1548,shaman,restoration,263,134,129
Seasick,frostmane,1548,shaman,restoration,112,56,56
Noneedshaman,stormscale,1547,shaman,restoration,35,18,17
Ninetzj,tarren-mill,1547,shaman,restoration,54,26,28
Zanezu,stormscale,1547,shaman,restoration,102,45,57
Apocadwarf,auchindoun,1546,shaman,restoration,45,27,18
Lilcake,ravencrest,1546,shaman,restoration,60,31,29
Reilah,drakthul,1546,shaman,restoration,66,33,33
Märthalouise,twisting-nether,1546,shaman,restoration,43,18,25
Defibrillata,blackrock,1545,shaman,restoration,77,38,39
Craisaz,nemesis,1545,shaman,restoration,72,26,46
Korvsnärten,outland,1544,shaman,restoration,237,109,128
Zilheal,ysondre,1542,shaman,restoration,106,41,65
Кичисанчик,howling-fjord,1541,shaman,restoration,126,57,69
Nonotsikaan,blackhand,1540,shaman,restoration,42,24,18
Vallhur,burning-legion,1539,shaman,restoration,84,46,38
Denastyo,nemesis,1539,shaman,restoration,89,44,45
Mypakypa,outland,1539,shaman,restoration,58,25,33
Optitem,hyjal,1538,shaman,restoration,83,57,26
Charquanda,argent-dawn,1538,shaman,restoration,60,26,34
Отчима,howling-fjord,1537,shaman,restoration,125,67,58
Grumhild,blackmoore,1537,shaman,restoration,62,28,34
Banilikum,tarren-mill,1537,shaman,restoration,58,25,33
Багсбанних,soulflayer,1537,shaman,restoration,84,35,49
Louiesham,outland,1535,shaman,restoration,30,17,13
Horokeu,blackrock,1535,shaman,restoration,77,40,37
Coldlean,haomarush,1535,shaman,restoration,200,98,102
Cakedeux,grim-batol,1534,shaman,restoration,69,40,29
Uzze,drakthul,1534,shaman,restoration,90,39,51
Xerinas,eredar,1534,shaman,restoration,63,20,43
Soger,mannoroth,1533,shaman,restoration,36,18,18
Shamins,outland,1532,shaman,restoration,148,86,62
Ugard,burning-legion,1532,shaman,restoration,73,36,37
Reezex,silvermoon,1531,shaman,restoration,86,45,41
Jochenzulauf,blackrock,1530,shaman,restoration,42,27,15
Collînna,aegwynn,1529,shaman,restoration,62,34,28
Kacamaz,twisting-nether,1529,shaman,restoration,75,34,41
Linknvm,thrall,1528,shaman,restoration,105,71,34
Pädagogeig,antonidas,1528,shaman,restoration,66,36,30
Redoms,stormreaver,1527,shaman,restoration,105,55,50
Bumblebeec,tarren-mill,1526,shaman,restoration,60,32,28
Nassîî,antonidas,1526,shaman,restoration,140,59,81
Psychototem,twisting-nether,1526,shaman,restoration,84,27,57
Bordellgast,thrall,1525,shaman,restoration,95,50,45
Bzglsnkh,ravencrest,1525,shaman,restoration,36,16,20
Bénathon,ravencrest,1524,shaman,restoration,51,35,16
Yarali,argent-dawn,1524,shaman,restoration,30,16,14
Kuxoriu,stormscale,1524,shaman,restoration,84,44,40
Gjernhard,stormreaver,1524,shaman,restoration,78,38,40
Bumbersham,stormscale,1523,shaman,restoration,66,34,32
Remkoo,blackrock,1522,shaman,restoration,30,20,10
Ilovejamie,sylvanas,1522,shaman,restoration,54,30,24
Monstacookie,stormreaver,1520,shaman,restoration,72,32,40
Sixinchwilly,outland,1519,shaman,restoration,36,25,11
Lilililil,sanguino,1519,shaman,restoration,36,19,17
Schain,eredar,1518,shaman,restoration,36,24,12
Kuhnedy,blackrock,1517,shaman,restoration,118,60,58
Bomjspomoiki,outland,1516,shaman,restoration,35,16,19
Thecallviper,blackmoore,1515,shaman,restoration,55,30,25
Costakislolz,twisting-nether,1511,shaman,restoration,24,18,6
Bloodseeker,tarren-mill,1511,shaman,restoration,53,29,24
Тагхорн,soulflayer,1511,shaman,restoration,43,23,20
Pacio,alakir,1511,shaman,restoration,111,58,53
Ebøbøla,terokkar,1511,shaman,restoration,187,84,103
Mvvp,stormscale,1510,shaman,restoration,47,26,21
Gronash,sunstrider,1507,shaman,restoration,30,23,7
Nogag,kazzak,1507,shaman,restoration,72,35,37
Huux,blackmoore,1507,shaman,restoration,54,24,30
Enzopotenzo,blackrock,1506,shaman,restoration,42,22,20
Vaizii,silvermoon,1505,shaman,restoration,53,26,27
Miesepeter,mannoroth,1504,shaman,restoration,63,38,25
Jazzrod,stormscale,1503,shaman,restoration,234,120,114
Духсалата,grom,1503,shaman,restoration,59,29,30
Yemo,alonsus,1502,shaman,restoration,93,56,37
Biggiebig,ravencrest,1502,shaman,restoration,60,32,28
Vemvardetsom,stormreaver,1501,shaman,restoration,59,32,27
Нитрочка,soulflayer,1501,shaman,restoration,51,27,24
Skullår,tarren-mill,1500,shaman,restoration,48,25,23
Cannotdoit,burning-legion,1499,shaman,restoration,59,32,27
Vaweñ,ravencrest,1499,shaman,restoration,42,17,25
Anöuchkâ,ysondre,1498,shaman,restoration,174,84,90
Eksi,ahnqiraj,1496,shaman,restoration,30,16,14
Fridafrog,malganis,1495,shaman,restoration,131,71,60
Mcktavish,silvermoon,1495,shaman,restoration,89,46,43
Crmx,blackrock,1494,shaman,restoration,72,31,41
Хэйзл,ashenvale,1492,shaman,restoration,74,32,42
Cuchullaín,blackmoore,1491,shaman,restoration,24,17,7
Иоч,soulflayer,1491,shaman,restoration,35,18,17
Daykên,kazzak,1490,shaman,restoration,62,25,37
Чанголист,soulflayer,1489,shaman,restoration,65,28,37
Crasherz,sanguino,1488,shaman,restoration,91,51,40
Kalaris,stormscale,1488,shaman,restoration,36,20,16
Hopper,sylvanas,1488,shaman,restoration,61,30,31
Neovim,trollbane,1488,shaman,restoration,62,28,34
Tartorno,antonidas,1485,shaman,restoration,71,26,45
Pilinham,aggra-português,1485,shaman,restoration,48,17,31
Exhale,archimonde,1484,shaman,restoration,42,25,17
Hexoffender,alakir,1483,shaman,restoration,112,54,58
Flowèn,twisting-nether,1482,shaman,restoration,111,60,51
Dremlok,burning-legion,1480,shaman,restoration,24,16,8
Firestormx,drakthul,1480,shaman,restoration,47,28,19
Drumx,aegwynn,1478,shaman,restoration,30,17,13
Kaminarí,antonidas,1478,shaman,restoration,42,18,24
Kataclysm,nemesis,1477,shaman,restoration,71,35,36
Meneswave,blackhand,1475,shaman,restoration,48,16,32
Gützli,blackmoore,1474,shaman,restoration,93,35,58
Criæ,blackrock,1472,shaman,restoration,24,17,7
Orcshaman,the-maelstrom,1472,shaman,restoration,68,39,29
Cleptocracy,draenor,1472,shaman,restoration,35,18,17
Schamazon,tarren-mill,1471,shaman,restoration,57,32,25
Diix,archimonde,1471,shaman,restoration,84,35,49
Tow,der-rat-von-dalaran,1470,shaman,restoration,24,17,7
Shuzman,emeriss,1470,shaman,restoration,103,49,54
Enïgma,sylvanas,1469,shaman,restoration,94,54,40
Kêêqo,blackrock,1468,shaman,restoration,48,23,25
Ivøryz,arthas,1467,shaman,restoration,42,24,18
Eisei,stormscale,1467,shaman,restoration,42,23,19
Greenfatding,kazzak,1467,shaman,restoration,36,19,17
Andról,stormscale,1467,shaman,restoration,54,25,29
Smørbar,kazzak,1465,shaman,restoration,72,49,23
Crymere,chamber-of-aspects,1464,shaman,restoration,209,112,97
Ünknownz,archimonde,1464,shaman,restoration,71,37,34
Antey,ravencrest,1463,shaman,restoration,156,83,73
Sebubu,twisting-nether,1463,shaman,restoration,68,34,34
Apaorkaxyz,ragnaros,1462,shaman,restoration,231,111,120
Courtney,sylvanas,1462,shaman,restoration,240,114,126
Theshammy,vashj,1459,shaman,restoration,60,32,28
Yasharshammy,tarren-mill,1459,shaman,restoration,60,28,32
Diosberi,tichondrius,1458,shaman,restoration,24,18,6
Skrimisher,draenor,1456,shaman,restoration,65,37,28
Nøný,gorgonnash,1456,shaman,restoration,60,31,29
Schamfxx,blackrock,1456,shaman,restoration,96,49,47
Шарюпокд,soulflayer,1455,shaman,restoration,48,24,24
Xánin,thrall,1455,shaman,restoration,42,21,21
Zlingx,auchindoun,1454,shaman,restoration,48,22,26
Ларисашерсть,blackscar,1452,shaman,restoration,47,26,21
Ronell,argent-dawn,1451,shaman,restoration,120,63,57
Артёмлобов,gordunni,1450,shaman,restoration,77,37,40
Waterboi,blackmoore,1449,shaman,restoration,56,22,34
Mcbloob,kazzak,1448,shaman,restoration,68,33,35
Gspót,twisting-nether,1447,shaman,restoration,98,47,51
Djxyoloswag,silvermoon,1445,shaman,restoration,99,44,55
Tjpimp,draenor,1444,shaman,restoration,29,17,12
Fluuges,tarren-mill,1444,shaman,restoration,30,16,14
Sucøre,die-nachtwache,1444,shaman,restoration,52,27,25
Jimtrespies,dun-modr,1443,shaman,restoration,42,21,21
Bonraptor,kirin-tor,1443,shaman,restoration,41,20,21
Nonnative,stormscale,1442,shaman,restoration,53,21,32
Тирануксис,blackscar,1441,shaman,restoration,35,22,13
Schweízer,blackrock,1441,shaman,restoration,102,45,57
Бомжмувис,howling-fjord,1440,shaman,restoration,24,15,9
Helloitsmee,thrall,1439,shaman,restoration,40,20,20
Nyzo,tarren-mill,1438,shaman,restoration,30,15,15
Боунсе,howling-fjord,1438,shaman,restoration,36,15,21
Shamhingo,stormscale,1438,shaman,restoration,48,19,29
Vioceptîon,blackrock,1437,shaman,restoration,30,22,8
Kunsum,twisting-nether,1437,shaman,restoration,87,37,50
Roineé,draenor,1436,shaman,restoration,30,15,15
Electrífied,outland,1436,shaman,restoration,54,26,28
Амальтейх,soulflayer,1436,shaman,restoration,54,23,31
Okdar,stormscale,1435,shaman,restoration,54,34,20
Shamnox,blackrock,1435,shaman,restoration,57,34,23
Emochka,ravencrest,1435,shaman,restoration,130,60,70
Strïvïse,ysondre,1434,shaman,restoration,47,22,25
Мокос,howling-fjord,1434,shaman,restoration,42,16,26
Kataretic,kazzak,1433,shaman,restoration,24,17,7
Cleansing,nemesis,1433,shaman,restoration,30,21,9
Enharvest,stormscale,1433,shaman,restoration,28,18,10
Htagagain,archimonde,1433,shaman,restoration,24,15,9
Zaiyoxgodx,thrall,1433,shaman,restoration,49,26,23
Odiuum,draenor,1432,shaman,restoration,87,46,41
Mestgonee,draenor,1432,shaman,restoration,36,19,17
Sadfemecraft,aggramar,1432,shaman,restoration,165,74,91
Hexalicius,sylvanas,1432,shaman,restoration,36,15,21
Threnesham,kazzak,1432,shaman,restoration,42,15,27
Gards,sylvanas,1431,shaman,restoration,61,29,32
Kaptt,twisting-nether,1431,shaman,restoration,36,15,21
Kickmeheal,dalaran,1430,shaman,restoration,30,18,12
Wylly,aegwynn,1430,shaman,restoration,131,73,58
Umbraverfaa,twisting-nether,1430,shaman,restoration,54,30,24
Назульчике,razuvious,1430,shaman,restoration,59,30,29
Дагод,booty-bay,1427,shaman,restoration,48,32,16
Шоплифтер,gordunni,1427,shaman,restoration,48,27,21
Pcr,archimonde,1427,shaman,restoration,105,50,55
Stòrmbreakèr,nemesis,1427,shaman,restoration,91,42,49
Mightgethexd,tarren-mill,1426,shaman,restoration,39,21,18
Vickeshaman,stormreaver,1426,shaman,restoration,55,23,32
Малекулакота,soulflayer,1425,shaman,restoration,53,25,28
Amaizin,stormscale,1424,shaman,restoration,32,19,13
Ptiloup,varimathras,1423,shaman,restoration,48,22,26
Кислаябуба,howling-fjord,1420,shaman,restoration,172,81,91
Ripstorm,sylvanas,1420,shaman,restoration,37,16,21
Lyricks,outland,1418,shaman,restoration,36,15,21
Венжии,soulflayer,1418,shaman,restoration,54,18,36
Winøxiide,archimonde,1415,shaman,restoration,29,16,13
Goldhand,ravencrest,1415,shaman,restoration,69,24,45
Onkens,ravencrest,1414,shaman,restoration,57,29,28
Diya,karazhan,1414,shaman,restoration,84,39,45
Straehne,malganis,1414,shaman,restoration,94,43,51
Imshocky,burning-legion,1413,shaman,restoration,83,47,36
Виспепешам,gordunni,1413,shaman,restoration,194,94,100
Deadstill,ysondre,1412,shaman,restoration,24,15,9
Dergat,pozzo-delleternità,1412,shaman,restoration,44,21,23
Wôdân,blackrock,1412,shaman,restoration,54,21,33
Начилибосе,gordunni,1411,shaman,restoration,144,78,66
Dewasham,blackrock,1411,shaman,restoration,48,22,26
Fuzzywaagh,silvermoon,1411,shaman,restoration,58,26,32
Smukkere,twisting-nether,1410,shaman,restoration,24,15,9
Patuljak,outland,1409,shaman,restoration,91,48,43
Zhulnaar,hyjal,1409,shaman,restoration,42,21,21
Rawillman,kazzak,1408,shaman,restoration,24,16,8
Goodieesham,burning-blade,1408,shaman,restoration,30,18,12
Mouraïne,eredar,1403,shaman,restoration,29,20,9
Дердан,soulflayer,1402,shaman,restoration,30,17,13
Gaelic,frostmourne,1402,shaman,restoration,84,43,41
Tèysh,ysondre,1402,shaman,restoration,126,64,62
Mclóvín,twisting-nether,1401,shaman,restoration,42,21,21
Тандерфак,ashenvale,1401,shaman,restoration,38,18,20
Grende,sylvanas,1401,shaman,restoration,41,15,26
Shambulancex,tarren-mill,1400,shaman,restoration,30,15,15
Trustlemac,onyxia,1399,shaman,restoration,50,30,20
Beyp,sylvanas,1399,shaman,restoration,67,38,29
Greatørc,tarren-mill,1399,shaman,restoration,35,17,18
Linkedink,tarren-mill,1395,shaman,restoration,26,17,9
Shemanrolf,outland,1395,shaman,restoration,99,46,53
Pocahøntas,archimonde,1395,shaman,restoration,56,22,34
Swahilishock,the-maelstrom,1394,shaman,restoration,36,15,21
Yois,nemesis,1393,shaman,restoration,66,37,29
Гвинневра,azuregos,1392,shaman,restoration,125,74,51
Sjamanisme,silvermoon,1390,shaman,restoration,114,60,54
Qjie,argent-dawn,1389,shaman,restoration,206,117,89
Captaínduck,garrosh,1388,shaman,restoration,88,49,39
Elombrion,destromath,1387,shaman,restoration,42,21,21
Ярусскийй,howling-fjord,1387,shaman,restoration,247,118,129
Karlurban,outland,1387,shaman,restoration,39,15,24
Geneazytwo,silvermoon,1384,shaman,restoration,32,19,13
Фридомх,gordunni,1383,shaman,restoration,35,17,18
Gnackbretzn,eredar,1383,shaman,restoration,95,46,49
Vengatrox,antonidas,1381,shaman,restoration,59,30,29
Джонпсинаа,gordunni,1379,shaman,restoration,36,18,18
Saamira,pozzo-delleternità,1377,shaman,restoration,66,32,34
Ironkraw,stormscale,1377,shaman,restoration,90,33,57
Tonifo,nemesis,1376,shaman,restoration,23,18,5
Brigantino,burning-legion,1376,shaman,restoration,49,26,23
Axemodels,archimonde,1376,shaman,restoration,32,16,16
Roverlos,blackrock,1375,shaman,restoration,129,70,59
Warianis,ravencrest,1374,shaman,restoration,51,27,24
Damex,thunderhorn,1374,shaman,restoration,143,56,87
Alishie,outland,1373,shaman,restoration,117,64,53
Elamentaly,draenor,1371,shaman,restoration,54,29,25
Phêbz,archimonde,1371,shaman,restoration,48,25,23
Johnblånn,stormscale,1369,shaman,restoration,63,35,28
Xoxoheal,eredar,1368,shaman,restoration,36,15,21
Lupisregina,silvermoon,1365,shaman,restoration,41,19,22
Hulcky,grim-batol,1363,shaman,restoration,48,27,21
Acidtrip,hyjal,1363,shaman,restoration,48,24,24
Glopper,ravencrest,1363,shaman,restoration,89,40,49
Vorkanyx,ysondre,1362,shaman,restoration,106,51,55
Shimmyja,draenor,1362,shaman,restoration,36,17,19
Orcinterface,tarren-mill,1360,shaman,restoration,92,46,46
Akrobata,silvermoon,1360,shaman,restoration,180,83,97
Gunhyld,hyjal,1359,shaman,restoration,47,20,27
Kneggebrot,blackmoore,1359,shaman,restoration,78,33,45
Bíìerlip,twisting-nether,1357,shaman,restoration,35,20,15
Shinds,archimonde,1356,shaman,restoration,48,21,27
Subaki,die-aldor,1355,shaman,restoration,34,20,14
Ruvxy,twisting-nether,1354,shaman,restoration,65,38,27
Slowtem,draenor,1354,shaman,restoration,101,52,49
Vanquïsh,archimonde,1353,shaman,restoration,48,21,27
Ketzersend,alleria,1351,shaman,restoration,30,18,12
Krovogor,silvermoon,1351,shaman,restoration,60,34,26
Nosql,draenor,1351,shaman,restoration,28,15,13
Daboó,vashj,1350,shaman,restoration,115,63,52
Эрутеон,deathguard,1349,shaman,restoration,108,49,59
Panicsc,twisting-nether,1348,shaman,restoration,219,109,110
Stylix,tarren-mill,1347,shaman,restoration,93,44,49
Zevissh,outland,1346,shaman,restoration,54,28,26
Шиока,borean-tundra,1345,shaman,restoration,47,26,21
Purgerkìng,tarren-mill,1344,shaman,restoration,18,14,4
Mjahex,stormscale,1344,shaman,restoration,54,26,28
Сновидений,soulflayer,1344,shaman,restoration,49,23,26
Invade,darkspear,1343,shaman,restoration,18,14,4
Zenzua,twisting-nether,1343,shaman,restoration,35,24,11
Intoxed,sylvanas,1343,shaman,restoration,48,27,21
Фоэксген,deathguard,1342,shaman,restoration,20,15,5
Shrekcho,twisting-nether,1342,shaman,restoration,36,25,11
Henchtotem,draenor,1342,shaman,restoration,56,31,25
Dàazle,ravencrest,1342,shaman,restoration,36,14,22
Schïps,kirin-tor,1339,shaman,restoration,54,31,23
Maburst,silvermoon,1339,shaman,restoration,30,17,13
Teckan,tarren-mill,1339,shaman,restoration,30,14,16
Amrgl,earthen-ring,1339,shaman,restoration,36,15,21
Sørum,grim-batol,1339,shaman,restoration,36,14,22
Fußpilzmann,blackmoore,1338,shaman,restoration,139,76,63
Thunderson,daggerspine,1338,shaman,restoration,104,45,59
Brokgar,ragnaros,1337,shaman,restoration,24,14,10
Abx,draenor,1337,shaman,restoration,42,21,21
Shapperdin,darksorrow,1336,shaman,restoration,24,14,10
Chamika,dentarg,1336,shaman,restoration,60,24,36
Freizeitler,antonidas,1335,shaman,restoration,78,37,41
Shamanash,kazzak,1335,shaman,restoration,30,14,16
Flikus,aggra-português,1335,shaman,restoration,42,16,26
Bresidendo,frostwhisper,1334,shaman,restoration,95,39,56
Ongewasgone,defias-brotherhood,1333,shaman,restoration,30,16,14
Bloodburst,stormscale,1332,shaman,restoration,48,29,19
Lariralol,malorne,1332,shaman,restoration,67,37,30
Ксмо,gordunni,1331,shaman,restoration,24,14,10
Хотдевил,gordunni,1331,shaman,restoration,59,32,27
Beardling,auchindoun,1329,shaman,restoration,24,15,9
Powerhq,thrall,1329,shaman,restoration,24,14,10
Alàstor,kazzak,1329,shaman,restoration,55,24,31
Iamnyka,blackrock,1328,shaman,restoration,66,40,26
Drohx,ysondre,1327,shaman,restoration,24,14,10
Братишкапинг,soulflayer,1327,shaman,restoration,110,56,54
Vodoochild,hyjal,1327,shaman,restoration,55,23,32
Jarvís,gilneas,1327,shaman,restoration,50,19,31
Vuls,blackmoore,1323,shaman,restoration,123,66,57
Schaname,rajaxx,1323,shaman,restoration,30,14,16
Sdkpwns,draenor,1322,shaman,restoration,36,16,20
Georgieboi,sylvanas,1321,shaman,restoration,24,14,10
Bedouín,draenor,1321,shaman,restoration,91,51,40
Lerosh,twisting-nether,1321,shaman,restoration,54,30,24
Littledorf,ravencrest,1321,shaman,restoration,96,51,45
Mjöllnir,blackrock,1321,shaman,restoration,108,56,52
Breadtotem,tarren-mill,1321,shaman,restoration,30,14,16
Vaaggu,stormreaver,1321,shaman,restoration,36,14,22
Yegera,stormscale,1320,shaman,restoration,30,14,16
Роджермур,howling-fjord,1319,shaman,restoration,30,14,16
Götveren,eredar,1319,shaman,restoration,36,15,21
Swedishmeat,kazzak,1317,shaman,restoration,156,80,76
Corintho,blackmoore,1316,shaman,restoration,46,25,21
Threshðld,dun-modr,1316,shaman,restoration,30,14,16
Boneyka,ragnaros,1316,shaman,restoration,110,44,66
Lickmytôtem,frostmane,1314,shaman,restoration,30,14,16
Виртуосгодх,soulflayer,1313,shaman,restoration,54,25,29
Жижелье,howling-fjord,1312,shaman,restoration,128,68,60
Kbakasham,ravencrest,1312,shaman,restoration,50,24,26
Var,varimathras,1312,shaman,restoration,30,14,16
Keräx,cthun,1311,shaman,restoration,24,14,10
Awwey,stormscale,1310,shaman,restoration,18,14,4
Navezi,twisting-nether,1310,shaman,restoration,72,41,31
Шаманутый,gordunni,1308,shaman,restoration,73,40,33
Düsterlotus,dalvengyr,1308,shaman,restoration,196,106,90
Крэгнор,gordunni,1308,shaman,restoration,135,70,65
Shamingu,arathor,1308,shaman,restoration,152,77,75
Aceofraphy,thrall,1308,shaman,restoration,125,53,72
Eniesz,archimonde,1307,shaman,restoration,26,15,11
Thaarley,blackmoore,1305,shaman,restoration,34,22,12
Shafallen,tarren-mill,1305,shaman,restoration,40,24,16
Durek,aerie-peak,1304,shaman,restoration,24,14,10
Canhealu,nemesis,1303,shaman,restoration,169,85,84
Mandoloriana,sylvanas,1303,shaman,restoration,96,47,49
Санрэйн,soulflayer,1302,shaman,restoration,54,32,22
Samantouz,archimonde,1302,shaman,restoration,132,62,70
Monstermunch,ravencrest,1301,shaman,restoration,110,50,60
Ironmack,outland,1301,shaman,restoration,36,16,20
Quiec,kazzak,1300,shaman,restoration,60,21,39
Marrakei,aegwynn,1300,shaman,restoration,44,15,29
Panicblast,stormscale,1299,shaman,restoration,44,27,17
Nybz,sylvanas,1299,shaman,restoration,108,54,54
Шаеман,soulflayer,1298,shaman,restoration,36,20,16
Ærthgød,stormscale,1297,shaman,restoration,24,17,7
Kìra,darkmoon-faire,1296,shaman,restoration,51,28,23
Bluefacebaby,nemesis,1296,shaman,restoration,155,74,81
Harptwo,eredar,1295,shaman,restoration,47,28,19
Rhakhatheckh,nemesis,1295,shaman,restoration,58,26,32
Fernashaman,aggra-português,1295,shaman,restoration,42,18,24
Heyzal,aegwynn,1295,shaman,restoration,38,14,24
Fünkchn,zuluhed,1293,shaman,restoration,46,24,22
Shamanmode,twisting-nether,1292,shaman,restoration,42,17,25
Eduorde,silvermoon,1290,shaman,restoration,37,22,15
Kryuxs,blackrock,1290,shaman,restoration,48,24,24
Onlytides,doomhammer,1290,shaman,restoration,36,14,22
Stivishamy,blackmoore,1289,shaman,restoration,34,21,13
Lilshamano,ravencrest,1289,shaman,restoration,222,124,98
Zujaz,stormscale,1289,shaman,restoration,30,14,16
Xamic,twisting-nether,1287,shaman,restoration,47,21,26
Mêkyra,blackmoore,1286,shaman,restoration,58,27,31
Obêlixx,blackmoore,1284,shaman,restoration,42,20,22
Deadwoodz,tarren-mill,1284,shaman,restoration,124,59,65
Chadshaman,antonidas,1284,shaman,restoration,55,24,31
Chilliajin,tarren-mill,1284,shaman,restoration,59,25,34
Cudntreskobe,kazzak,1283,shaman,restoration,40,20,20
Nwäar,archimonde,1283,shaman,restoration,144,71,73
Gigawashed,archimonde,1279,shaman,restoration,23,14,9
Rokatotem,ysondre,1279,shaman,restoration,27,14,13
Morty,tarren-mill,1279,shaman,restoration,59,27,32
Akwa,stormscale,1278,shaman,restoration,32,14,18
Îolar,aegwynn,1277,shaman,restoration,72,28,44
Asaakira,blackmoore,1276,shaman,restoration,51,32,19
Deaslow,hyjal,1276,shaman,restoration,40,25,15
Shago,archimonde,1276,shaman,restoration,124,54,70
Tenny,haomarush,1276,shaman,restoration,54,20,34
Foximus,blackhand,1275,shaman,restoration,42,20,22
Alisàn,teldrassil,1272,shaman,restoration,163,77,86
Shôk,ravencrest,1271,shaman,restoration,74,37,37
Kivra,burning-legion,1271,shaman,restoration,107,46,61
Шайнинлайт,soulflayer,1271,shaman,restoration,107,42,65
Ishkadar,twisting-nether,1270,shaman,restoration,33,15,18
Stormcaster,argent-dawn,1267,shaman,restoration,70,34,36
Asumix,illidan,1263,shaman,restoration,89,44,45
Yuliy,arathor,1263,shaman,restoration,108,50,58
Størmbølt,draenor,1263,shaman,restoration,54,24,30
Ríko,argent-dawn,1262,shaman,restoration,64,33,31
Kelshaj,thrall,1262,shaman,restoration,33,15,18
Dregú,draenor,1261,shaman,restoration,81,44,37
Alakan,saurfang,1261,shaman,restoration,137,65,72
Zoolza,kirin-tor,1261,shaman,restoration,41,14,27
Azifox,hyjal,1260,shaman,restoration,25,14,11
Кразтор,howling-fjord,1259,shaman,restoration,161,71,90
Xerijan,pozzo-delleternità,1257,shaman,restoration,36,17,19
Дрекрош,howling-fjord,1257,shaman,restoration,71,28,43
Aldron,tirion,1256,shaman,restoration,42,21,21
Flambusier,hyjal,1253,shaman,restoration,175,102,73
Cømedian,ragnaros,1252,shaman,restoration,27,15,12
Ogrilza,uldaman,1252,shaman,restoration,136,74,62
Ðøminantx,stormscale,1249,shaman,restoration,55,28,27
Viallinen,stormreaver,1249,shaman,restoration,37,15,22
Navajito,tarren-mill,1248,shaman,restoration,18,13,5
Jävlajävel,draenor,1248,shaman,restoration,76,45,31
Chävaman,archimonde,1248,shaman,restoration,24,13,11
Shamtrix,drakthul,1248,shaman,restoration,77,34,43
Reparagos,sanguino,1246,shaman,restoration,25,14,11
Puffeh,emeriss,1246,shaman,restoration,30,13,17
Руикси,howling-fjord,1246,shaman,restoration,30,13,17
Велоун,soulflayer,1246,shaman,restoration,32,13,19
Bioleta,twisting-nether,1246,shaman,restoration,36,13,23
Cynthila,stormreaver,1245,shaman,restoration,18,13,5
Wernøzer,archimonde,1245,shaman,restoration,18,13,5
Shamiinn,ravencrest,1245,shaman,restoration,24,13,11
Smøul,sanguino,1245,shaman,restoration,30,13,17
Shamdude,archimonde,1243,shaman,restoration,24,13,11
Watashij,outland,1243,shaman,restoration,69,36,33
Kvolt,ysondre,1243,shaman,restoration,30,13,17
Nabo,archimonde,1243,shaman,restoration,40,16,24
Dgshîtdwarf,ravencrest,1242,shaman,restoration,30,13,17
Anlaki,silvermoon,1241,shaman,restoration,18,13,5
Leunam,draenor,1241,shaman,restoration,52,26,26
Djschamihaar,blackrock,1240,shaman,restoration,18,13,5
Spitta,ysondre,1240,shaman,restoration,24,13,11
Manitus,sylvanas,1240,shaman,restoration,64,33,31
Elijaá,nordrassil,1239,shaman,restoration,77,42,35
Skenflewds,alakir,1239,shaman,restoration,88,35,53
Zakuun,kazzak,1239,shaman,restoration,36,13,23
Bufuxx,kazzak,1238,shaman,restoration,18,13,5
Sîggý,eredar,1237,shaman,restoration,24,13,11
Woade,silvermoon,1236,shaman,restoration,60,28,32
Kèlls,la-croisade-écarlate,1236,shaman,restoration,54,25,29
Перегной,ashenvale,1236,shaman,restoration,99,43,56
Abercrômbx,blackmoore,1235,shaman,restoration,24,13,11
Эртирон,howling-fjord,1235,shaman,restoration,144,73,71
Semrix,blackhand,1235,shaman,restoration,110,48,62
Læh,archimonde,1235,shaman,restoration,48,14,34
Shameari,sylvanas,1234,shaman,restoration,18,13,5
Корольшомен,gordunni,1234,shaman,restoration,24,14,10
Thog,drakthul,1234,shaman,restoration,30,13,17
Energised,alonsus,1234,shaman,restoration,36,14,22
Kaletore,ragnaros,1233,shaman,restoration,60,34,26
Формацепт,ashenvale,1233,shaman,restoration,60,29,31
Aébi,dalaran,1232,shaman,restoration,24,13,11
Blackone,destromath,1232,shaman,restoration,24,13,11
Althayr,blackmoore,1232,shaman,restoration,28,14,14
Carnágé,blackrock,1230,shaman,restoration,42,24,18
Anakkynu,sylvanas,1230,shaman,restoration,31,14,17
Doriana,dalaran,1229,shaman,restoration,66,26,40
Sugardad,khaz-modan,1228,shaman,restoration,189,90,99
Shyrel,burning-legion,1228,shaman,restoration,136,61,75
Makaria,emerald-dream,1227,shaman,restoration,212,101,111
Alexmiamosch,thrall,1226,shaman,restoration,78,48,30
Clearwaters,tarren-mill,1225,shaman,restoration,40,14,26
Kavyzyoyo,twisting-nether,1222,shaman,restoration,71,31,40
Fulminare,ravencrest,1221,shaman,restoration,78,39,39
Energized,twilights-hammer,1221,shaman,restoration,30,15,15
Murmelï,stormreaver,1220,shaman,restoration,99,46,53
Schnessert,silvermoon,1220,shaman,restoration,30,13,17
Ошибся,deathguard,1219,shaman,restoration,36,19,17
Shioni,ravencrest,1219,shaman,restoration,104,44,60
Bigrambo,draenor,1218,shaman,restoration,65,37,28
Юляукраинка,gordunni,1216,shaman,restoration,55,24,31
Sickbrain,silvermoon,1216,shaman,restoration,45,19,26
Showman,archimonde,1215,shaman,restoration,287,138,149
Sizzurp,mugthol,1214,shaman,restoration,24,13,11
Merkàba,pozzo-delleternità,1214,shaman,restoration,37,19,18
Suze,hellfire,1214,shaman,restoration,60,25,35
Wieszcz,kazzak,1212,shaman,restoration,51,21,30
Thuknala,tarren-mill,1210,shaman,restoration,46,26,20
Goodmañ,eonar,1210,shaman,restoration,110,48,62
Sorcerus,burning-legion,1210,shaman,restoration,72,27,45
Kickvando,blackmoore,1209,shaman,restoration,44,22,22
Shèshe,uldaman,1208,shaman,restoration,36,20,16
Tilixs,draenor,1207,shaman,restoration,81,27,54
Ephase,burning-blade,1207,shaman,restoration,55,16,39
Loppish,silvermoon,1206,shaman,restoration,24,16,8
Xetri,ragnaros,1206,shaman,restoration,41,22,19
Morttes,burning-legion,1205,shaman,restoration,27,14,13
Kuddjah,twisting-nether,1205,shaman,restoration,36,17,19
Nakenfeigy,stormreaver,1204,shaman,restoration,29,16,13
Бичпак,howling-fjord,1203,shaman,restoration,56,25,31
Huldi,kazzak,1202,shaman,restoration,48,28,20
Icozy,stormscale,1202,shaman,restoration,51,27,24
Roxxo,frostwolf,1200,shaman,restoration,30,16,14
Blöödfist,drakthul,1200,shaman,restoration,35,14,21
Thundersioux,ravencrest,1198,shaman,restoration,63,33,30
Teccatwo,outland,1198,shaman,restoration,100,48,52
Snobas,kazzak,1198,shaman,restoration,29,13,16
Chamon,grim-batol,1195,shaman,restoration,42,19,23
Lolafløres,dun-modr,1194,shaman,restoration,53,37,16
Gauss,agamaggan,1192,shaman,restoration,31,14,17
Silko,wrathbringer,1189,shaman,restoration,63,24,39
Buzzingsham,tarren-mill,1188,shaman,restoration,42,23,19
Shockjob,kazzak,1188,shaman,restoration,32,14,18
Hunorth,stormscale,1185,shaman,restoration,40,20,20
Jimmybuffett,kazzak,1184,shaman,restoration,98,47,51
Oldrym,blackrock,1183,shaman,restoration,64,25,39
Târrocke,nethersturm,1181,shaman,restoration,54,24,30
Bigschamlipp,blackhand,1180,shaman,restoration,23,13,10
Biztor,jaedenar,1178,shaman,restoration,48,26,22
Weraeth,drakthul,1178,shaman,restoration,72,38,34
Thundrkrakn,blackhand,1177,shaman,restoration,77,39,38
Egí,azshara,1177,shaman,restoration,38,14,24
Mwnci,anachronos,1176,shaman,restoration,141,72,69
Kvekkis,argent-dawn,1175,shaman,restoration,30,17,13
Darnok,quelthalas,1173,shaman,restoration,60,29,31
Praise,auchindoun,1172,shaman,restoration,35,14,21
Kuiji,stormreaver,1168,shaman,restoration,94,55,39
Tegellera,ravencrest,1168,shaman,restoration,53,27,26
Ibkdalen,stormscale,1167,shaman,restoration,48,26,22
Dwarfofwar,ravencrest,1165,shaman,restoration,80,43,37
Быковат,booty-bay,1164,shaman,restoration,146,73,73
Bèx,twisting-nether,1159,shaman,restoration,30,13,17
Pituu,tarren-mill,1158,shaman,restoration,36,15,21
Shinui,twisting-nether,1157,shaman,restoration,51,26,25
Lechirurgien,elune,1157,shaman,restoration,121,59,62
Knasta,malygos,1156,shaman,restoration,42,20,22
Iltis,nazjatar,1156,shaman,restoration,36,14,22
Дисмон,ashenvale,1155,shaman,restoration,48,24,24
Mostachin,dun-modr,1155,shaman,restoration,64,28,36
Undin,burning-legion,1154,shaman,restoration,90,50,40
Alcam,twisting-nether,1154,shaman,restoration,77,33,44
Saviothewise,aggra-português,1153,shaman,restoration,24,15,9
Кодишам,howling-fjord,1152,shaman,restoration,18,12,6
Rostislav,ravencrest,1152,shaman,restoration,18,12,6
Olînours,archimonde,1152,shaman,restoration,36,20,16
Kalhoznik,ravencrest,1152,shaman,restoration,24,12,12
Терату,gordunni,1152,shaman,restoration,24,12,12
Pepegahex,blackmoore,1152,shaman,restoration,24,12,12
Snovii,drakthul,1152,shaman,restoration,30,12,18
Totembeard,frostmourne,1151,shaman,restoration,18,12,6
Snackerella,blackrock,1151,shaman,restoration,18,12,6
Dêblâzê,thrall,1151,shaman,restoration,24,12,12
Scriptx,blackmoore,1151,shaman,restoration,24,12,12
Ridemytotem,blackrock,1151,shaman,restoration,24,12,12
Ønepåc,hyjal,1151,shaman,restoration,24,12,12
Teldarian,archimonde,1151,shaman,restoration,24,12,12
Numbs,tarren-mill,1151,shaman,restoration,30,12,18
Souqixo,drakthul,1150,shaman,restoration,18,12,6
Zelent,thrall,1150,shaman,restoration,18,12,6
Sparkygrill,eredar,1150,shaman,restoration,24,12,12
Holyshamixz,dun-modr,1150,shaman,restoration,24,12,12
Lolalovexo,kazzak,1150,shaman,restoration,30,14,16
Poggsham,twisting-nether,1150,shaman,restoration,63,29,34
Killatotem,kazzak,1150,shaman,restoration,30,12,18
Balthasa,blackhand,1149,shaman,restoration,18,12,6
Rëazx,archimonde,1149,shaman,restoration,24,12,12
Mefl,tarren-mill,1148,shaman,restoration,24,12,12
Kaherad,antonidas,1148,shaman,restoration,72,33,39
Enzymex,sanguino,1148,shaman,restoration,36,12,24
Aviearn,ragnaros,1147,shaman,restoration,24,15,9
Kärríegold,blackrock,1146,shaman,restoration,18,12,6
Wibra,nagrand,1146,shaman,restoration,30,12,18
Kemh,nemesis,1146,shaman,restoration,30,12,18
Tvättpåse,tarren-mill,1144,shaman,restoration,18,12,6
Кайрн,gordunni,1144,shaman,restoration,30,12,18
Drman,shattered-hand,1143,shaman,restoration,60,33,27
Gehrké,silvermoon,1142,shaman,restoration,18,12,6
Trixsham,ragnaros,1140,shaman,restoration,25,13,12
Rêêza,blackhand,1140,shaman,restoration,54,28,26
Nafay,lordaeron,1140,shaman,restoration,78,39,39
Shadî,kiljaeden,1139,shaman,restoration,30,14,16
Guayotta,sanguino,1139,shaman,restoration,30,12,18
Macchiavelli,blades-edge,1137,shaman,restoration,131,57,74
Nephylim,grim-batol,1136,shaman,restoration,24,12,12
Laïnàà,archimonde,1136,shaman,restoration,65,27,38
Mosterx,stormscale,1135,shaman,restoration,75,41,34
Nftkal,emerald-dream,1134,shaman,restoration,24,13,11
Croku,thrall,1134,shaman,restoration,66,34,32
Spaceboy,archimonde,1133,shaman,restoration,30,12,18
Максибончик,soulflayer,1133,shaman,restoration,36,13,23
Cloovster,magtheridon,1132,shaman,restoration,24,12,12
Nextlvlplz,draenor,1132,shaman,restoration,79,38,41
Omgodofwar,burning-blade,1132,shaman,restoration,90,33,57
Suntpraf,kazzak,1131,shaman,restoration,35,14,21
Arabesk,arygos,1130,shaman,restoration,108,50,58
Áchilleus,kazzak,1129,shaman,restoration,42,13,29
Sarenity,hellfire,1127,shaman,restoration,29,16,13
Jéhil,hyjal,1127,shaman,restoration,24,12,12
Holshammy,nemesis,1127,shaman,restoration,90,39,51
Bruhin,ravencrest,1127,shaman,restoration,36,13,23
Anyxxia,aegwynn,1126,shaman,restoration,30,12,18
Bullit,zuljin,1125,shaman,restoration,36,13,23
Jimkopf,eredar,1122,shaman,restoration,34,17,17
Bendimina,chogall,1120,shaman,restoration,18,12,6
Nesjâ,blackhand,1120,shaman,restoration,30,12,18
Ulfom,silvermoon,1118,shaman,restoration,58,27,31
Khanokekw,twisting-nether,1116,shaman,restoration,118,64,54
Smyke,magtheridon,1116,shaman,restoration,96,51,45
Raincaller,archimonde,1115,shaman,restoration,35,12,23
Понбарон,gordunni,1113,shaman,restoration,46,19,27
Lemontea,burning-blade,1107,shaman,restoration,60,24,36
Säphïr,hyjal,1105,shaman,restoration,22,13,9
Polystrath,silvermoon,1104,shaman,restoration,48,22,26
Sáltý,ravencrest,1103,shaman,restoration,21,12,9
Lanzatotems,dun-modr,1102,shaman,restoration,84,39,45
Dubìff,hyjal,1101,shaman,restoration,15,13,2
Ivaccineyou,blackmoore,1099,shaman,restoration,24,12,12
Thenasil,stormscale,1097,shaman,restoration,64,28,36
Èxé,stormscale,1095,shaman,restoration,20,13,7
Sanktyx,blackhand,1094,shaman,restoration,28,13,15
Yasunari,sanguino,1094,shaman,restoration,30,12,18
Rusbeermen,silvermoon,1094,shaman,restoration,47,13,34
Thuns,stormscale,1093,shaman,restoration,29,14,15
Corbo,ysondre,1092,shaman,restoration,75,42,33
Badkidney,alakir,1092,shaman,restoration,24,12,12
Hayvack,hyjal,1091,shaman,restoration,50,24,26
Waskoelement,archimonde,1090,shaman,restoration,48,27,21
Hazufel,kaelthas,1090,shaman,restoration,50,23,27
Moonbotico,blackrock,1090,shaman,restoration,115,52,63
Cromosoma,dun-modr,1085,shaman,restoration,44,26,18
Baelee,sylvanas,1085,shaman,restoration,108,47,61
Purgérkíng,silvermoon,1084,shaman,restoration,27,13,14
Spartecøbra,dalaran,1083,shaman,restoration,36,16,20
Arienus,turalyon,1081,shaman,restoration,22,12,10
Vulkan,kirin-tor,1081,shaman,restoration,42,20,22
Bennycooch,silvermoon,1081,shaman,restoration,107,42,65
Shamandeadly,aggra-português,1075,shaman,restoration,24,12,12
Hephaisto,defias-brotherhood,1072,shaman,restoration,24,12,12
Shamone,stormreaver,1070,shaman,restoration,35,16,19
Totemkin,stormscale,1069,shaman,restoration,60,13,47
Xoxoxoxoa,twisting-nether,1068,shaman,restoration,71,22,49
Quîn,defias-brotherhood,1066,shaman,restoration,102,48,54
Ominouslove,twisting-nether,1066,shaman,restoration,105,49,56
Zuggerberg,defias-brotherhood,1063,shaman,restoration,33,12,21
Garifus,dun-modr,1062,shaman,restoration,162,84,78
Hikigane,marécage-de-zangar,1061,shaman,restoration,48,17,31
Thunderjax,laughing-skull,1057,shaman,restoration,34,19,15
Чоколав,howling-fjord,1057,shaman,restoration,60,32,28
Слишкомпох,howling-fjord,1056,shaman,restoration,18,11,7
Socialfailur,archimonde,1056,shaman,restoration,18,11,7
Elmezz,outland,1056,shaman,restoration,18,11,7
Wisplola,ravencrest,1056,shaman,restoration,24,11,13
Rôwdy,kazzak,1056,shaman,restoration,24,11,13
Magmera,argent-dawn,1056,shaman,restoration,138,58,80
Alnaddaf,outland,1055,shaman,restoration,18,11,7
Zuly,grim-batol,1055,shaman,restoration,18,11,7
Yashëa,ysondre,1055,shaman,restoration,18,11,7
Drmanathan,garona,1055,shaman,restoration,18,11,7
Alëxx,hyjal,1055,shaman,restoration,18,11,7
Lòómit,anetheron,1055,shaman,restoration,71,35,36
Blipster,tarren-mill,1055,shaman,restoration,24,11,13
Бунтх,howling-fjord,1055,shaman,restoration,24,11,13
Icecold,grim-batol,1055,shaman,restoration,24,11,13
Krolhok,hyjal,1055,shaman,restoration,24,11,13
Átòmíc,eredar,1055,shaman,restoration,24,11,13
Vælcya,archimonde,1054,shaman,restoration,18,11,7
Quòr,antonidas,1054,shaman,restoration,59,34,25
Shakgor,draenor,1054,shaman,restoration,48,27,21
Ehrling,ysondre,1054,shaman,restoration,30,16,14
Mêrowinger,blackhand,1054,shaman,restoration,24,11,13
Blóúb,blackmoore,1054,shaman,restoration,24,11,13
Ixthus,varimathras,1054,shaman,restoration,24,11,13
Nyfario,marécage-de-zangar,1054,shaman,restoration,24,11,13
Elshamino,ravencrest,1054,shaman,restoration,24,11,13
Protv,ravencrest,1053,shaman,restoration,24,18,6
Tiddles,arathor,1053,shaman,restoration,18,11,7
Emika,archimonde,1053,shaman,restoration,24,11,13
Тотембот,soulflayer,1053,shaman,restoration,24,11,13
Sarkathi,kazzak,1053,shaman,restoration,24,11,13
Begeshaman,sylvanas,1053,shaman,restoration,270,120,150
Salatmayoo,alakir,1053,shaman,restoration,27,12,15
Zerwurster,thrall,1053,shaman,restoration,30,13,17
Hyflex,alakir,1053,shaman,restoration,30,11,19
Manush,aszune,1052,shaman,restoration,36,16,20
Muril,argent-dawn,1052,shaman,restoration,30,11,19
Rouwa,korgall,1051,shaman,restoration,18,11,7
Kelvok,silvermoon,1051,shaman,restoration,18,11,7
Zackboing,thrall,1051,shaman,restoration,75,38,37
Ðevi,ravencrest,1051,shaman,restoration,24,11,13
Aliates,sanguino,1051,shaman,restoration,24,11,13
Tingyspanky,twisting-nether,1051,shaman,restoration,33,12,21
Kíkjo,aegwynn,1050,shaman,restoration,18,11,7
Quizx,blackrock,1050,shaman,restoration,24,11,13
Оперочек,howling-fjord,1050,shaman,restoration,42,12,30
Fatotato,outland,1049,shaman,restoration,24,11,13
Riverwin,silvermoon,1048,shaman,restoration,30,14,16
Slingz,auchindoun,1048,shaman,restoration,24,11,13
Zahké,stormscale,1048,shaman,restoration,24,11,13
Bakuga,ragnaros,1047,shaman,restoration,18,11,7
Oscar,khaz-modan,1046,shaman,restoration,18,11,7
Tyralià,draenor,1046,shaman,restoration,18,11,7
Chokeonme,blackrock,1046,shaman,restoration,63,37,26
Анашишка,borean-tundra,1046,shaman,restoration,30,11,19
Megumín,darksorrow,1045,shaman,restoration,18,11,7
Towokk,kazzak,1045,shaman,restoration,54,31,23
Adubsham,tarren-mill,1043,shaman,restoration,12,11,1
Tosaá,antonidas,1042,shaman,restoration,18,11,7
Grîzzou,les-clairvoyants,1042,shaman,restoration,42,25,17
Munjar,korgall,1039,shaman,restoration,24,11,13
Idkteam,stormscale,1037,shaman,restoration,24,11,13
Slutie,stormscale,1036,shaman,restoration,23,11,12
Gushgush,draenor,1032,shaman,restoration,18,11,7
Moglibard,grim-batol,1028,shaman,restoration,18,11,7
Silktotems,kazzak,1028,shaman,restoration,30,11,19
Jeezy,blackhand,1027,shaman,restoration,30,11,19
Лялори,gordunni,1025,shaman,restoration,60,28,32
Jazzcore,twisting-nether,1023,shaman,restoration,17,11,6
Pstpstpsst,azjolnerub,1022,shaman,restoration,29,11,18
Daseus,malygos,1021,shaman,restoration,30,14,16
Рёнтар,howling-fjord,1021,shaman,restoration,30,13,17
Hexinreflect,silvermoon,1021,shaman,restoration,96,41,55
Вашнюхтоптал,howling-fjord,1018,shaman,restoration,30,17,13
Магмарончик,gordunni,1017,shaman,restoration,60,24,36
Akimboo,kilrogg,1017,shaman,restoration,36,11,25
Сорнинай,soulflayer,1013,shaman,restoration,65,28,37
Mantoon,doomhammer,1013,shaman,restoration,30,12,18
Jhaky,dun-modr,1013,shaman,restoration,30,11,19
Paniio,stormscale,1013,shaman,restoration,36,11,25
Cukkerberg,ragnaros,1010,shaman,restoration,48,19,29
Blainehammer,arathor,1006,shaman,restoration,30,12,18
Saamjai,turalyon,1005,shaman,restoration,30,17,13
Mendiing,kazzak,1005,shaman,restoration,21,11,10
Noulol,aegwynn,1005,shaman,restoration,23,12,11
Bluelasso,ysondre,1002,shaman,restoration,35,11,24
Darkkshammy,silvermoon,1001,shaman,restoration,24,12,12
Broner,ravencrest,999,shaman,restoration,44,20,24
Skunazo,sanguino,995,shaman,restoration,18,14,4
Jänis,ragnaros,995,shaman,restoration,22,12,10
Shinigamy,kazzak,995,shaman,restoration,68,35,33
Мезонет,soulflayer,992,shaman,restoration,24,13,11
Haginathor,twisting-nether,989,shaman,restoration,78,41,37
Checkpoint,defias-brotherhood,988,shaman,restoration,42,18,24
Kéimohansio,draenor,988,shaman,restoration,168,64,104
Mearu,bronze-dragonflight,987,shaman,restoration,42,25,17
Nozer,arathor,987,shaman,restoration,39,21,18
Demelena,silvermoon,985,shaman,restoration,67,35,32
Teada,aegwynn,980,shaman,restoration,34,12,22
Bomboclat,azjolnerub,977,shaman,restoration,29,11,18
Ambrosioss,kazzak,975,shaman,restoration,30,17,13
Patites,twisting-nether,974,shaman,restoration,36,20,16
Thaun,blackrock,971,shaman,restoration,30,12,18
Schamannen,outland,970,shaman,restoration,43,23,20
Xenda,blackrock,970,shaman,restoration,30,13,17
Maflas,dun-modr,967,shaman,restoration,25,16,9
Tomtefaan,sylvanas,963,shaman,restoration,24,13,11
Snidge,kazzak,961,shaman,restoration,30,18,12
Милжон,soulflayer,961,shaman,restoration,31,17,14
Dasce,sylvanas,961,shaman,restoration,36,15,21
Qobq,ravencrest,960,shaman,restoration,12,10,2
Çare,drakthul,960,shaman,restoration,18,10,8
Снупдоггидог,howling-fjord,960,shaman,restoration,24,10,14
Còób,ravencrest,960,shaman,restoration,27,10,17
Sunjay,frostwolf,959,shaman,restoration,12,10,2
Aylookitsgam,magtheridon,959,shaman,restoration,12,10,2
Hyperieon,antonidas,959,shaman,restoration,12,10,2
Kaátori,eredar,959,shaman,restoration,12,10,2
Fourtwogodx,kazzak,959,shaman,restoration,12,10,2
Ðtxkeks,onyxia,959,shaman,restoration,13,10,3
Bananis,outland,959,shaman,restoration,18,10,8
Crysisx,sanguino,959,shaman,restoration,18,10,8
Cahyr,ravencrest,959,shaman,restoration,18,10,8
Ånny,blackmoore,959,shaman,restoration,18,10,8
Qoleck,aegwynn,959,shaman,restoration,18,10,8
Friski,silvermoon,959,shaman,restoration,18,10,8
Kilazz,twisting-nether,959,shaman,restoration,18,10,8
Frise,archimonde,959,shaman,restoration,24,12,12
Shivanea,blackrock,959,shaman,restoration,24,10,14
Loay,blackrock,959,shaman,restoration,24,10,14
Amnéshaman,ysondre,959,shaman,restoration,24,10,14
Ugáa,malganis,959,shaman,restoration,24,10,14
Páracetamol,blackmoore,958,shaman,restoration,18,10,8
Bosskwtt,kazzak,958,shaman,restoration,18,10,8
Jilyu,blackmoore,958,shaman,restoration,18,10,8
Prøxxy,ravencrest,958,shaman,restoration,18,10,8
Shamanistick,grim-batol,958,shaman,restoration,18,10,8
Bliksem,tarren-mill,958,shaman,restoration,18,10,8
Чаиро,howling-fjord,958,shaman,restoration,24,10,14
Neejtjak,ravencrest,958,shaman,restoration,24,10,14
Nerdshammyx,tarren-mill,957,shaman,restoration,12,10,2
Samant,neptulon,957,shaman,restoration,36,17,19
Гарантийный,lich-king,957,shaman,restoration,24,10,14
Drakahaar,burning-blade,956,shaman,restoration,30,10,20
Durekk,tarren-mill,955,shaman,restoration,18,10,8
Chaminoune,sargeras,955,shaman,restoration,18,10,8
Nøxylol,veklor,955,shaman,restoration,24,10,14
Zulwin,hyjal,954,shaman,restoration,18,10,8
Rhun,garona,954,shaman,restoration,18,10,8
Kasjer,ravencrest,953,shaman,restoration,24,10,14
Tauridus,blackrock,951,shaman,restoration,24,10,14
Shámpain,antonidas,950,shaman,restoration,18,10,8
Hacyria,archimonde,949,shaman,restoration,36,20,16
Mcdz,blackrock,948,shaman,restoration,24,13,11
Эйвуа,gordunni,947,shaman,restoration,28,13,15
Outerspace,silvermoon,947,shaman,restoration,24,10,14
Дартарион,gordunni,947,shaman,restoration,38,14,24
Avattar,twisting-nether,942,shaman,restoration,18,10,8
Xilquid,darksorrow,941,shaman,restoration,24,10,14
Эрэвия,gordunni,939,shaman,restoration,24,13,11
Bullvai,dun-morogh,929,shaman,restoration,74,34,40
Goldva,outland,928,shaman,restoration,79,42,37
Fivezax,tarren-mill,924,shaman,restoration,18,10,8
Zeidek,nemesis,922,shaman,restoration,60,33,27
Valdraxx,ravencrest,922,shaman,restoration,195,95,100
Killeras,deathwing,920,shaman,restoration,37,18,19
Bluesteel,bladefist,919,shaman,restoration,41,10,31
Asashi,blackhand,917,shaman,restoration,23,12,11
Selrin,blackrock,915,shaman,restoration,84,30,54
Xpone,blackrock,914,shaman,restoration,24,12,12
Xogor,kazzak,911,shaman,restoration,27,10,17
Jabena,draenor,910,shaman,restoration,106,48,58
Kircos,blackrock,904,shaman,restoration,27,11,16
Quigon,burning-legion,902,shaman,restoration,42,22,20
Suculenta,zuljin,902,shaman,restoration,35,16,19
Georgianaa,skullcrusher,900,shaman,restoration,84,40,44
Nîckîî,aegwynn,899,shaman,restoration,17,10,7
Nexolok,alleria,899,shaman,restoration,60,32,28
Алимика,deathguard,899,shaman,restoration,24,12,12
Thunderberg,antonidas,896,shaman,restoration,30,12,18
Notlinus,argent-dawn,895,shaman,restoration,14,10,4
Foxfyre,tarren-mill,893,shaman,restoration,18,10,8
Ухмылк,azuregos,892,shaman,restoration,201,106,95
Whatsup,aggramar,892,shaman,restoration,28,11,17
Isìs,norgannon,891,shaman,restoration,100,39,61
Kwitnac,silvermoon,889,shaman,restoration,20,10,10
Seyfüce,archimonde,885,shaman,restoration,23,10,13
Deesham,blackmoore,885,shaman,restoration,26,10,16
Vukroth,argent-dawn,879,shaman,restoration,72,34,38
Fashess,sunstrider,875,shaman,restoration,18,10,8
Mysterqt,nemesis,864,shaman,restoration,12,9,3
Shiliwhip,the-maelstrom,864,shaman,restoration,12,9,3
Enviø,sylvanas,864,shaman,restoration,12,9,3
Фатнир,soulflayer,864,shaman,restoration,18,9,9
Defonceboby,archimonde,864,shaman,restoration,18,9,9
Nothexy,stormscale,864,shaman,restoration,18,9,9
Феанорситх,gordunni,864,shaman,restoration,18,9,9
Dimront,gorgonnash,864,shaman,restoration,18,9,9
Shounx,hyjal,864,shaman,restoration,18,9,9
Beoka,dun-modr,864,shaman,restoration,21,10,11
Bigdamshear,outland,864,shaman,restoration,24,9,15
Jkoreanx,archimonde,864,shaman,restoration,24,9,15
Thefirebird,blackhand,864,shaman,restoration,24,9,15
Geminate,stormscale,863,shaman,restoration,12,9,3
Gorrissen,sylvanas,863,shaman,restoration,12,9,3
Blamy,auchindoun,863,shaman,restoration,12,9,3
Есю,howling-fjord,863,shaman,restoration,12,9,3
Shamantistik,ravencrest,863,shaman,restoration,12,9,3
Dréa,draenor,863,shaman,restoration,18,9,9
Alroq,blackrock,863,shaman,restoration,18,9,9
Bobaléh,ravencrest,863,shaman,restoration,18,9,9
Stormfreg,quelthalas,863,shaman,restoration,18,9,9
Loktarogar,sunstrider,863,shaman,restoration,24,9,15
Floki,emerald-dream,863,shaman,restoration,24,9,15
Thanasiss,kazzak,863,shaman,restoration,24,9,15
Fatmikex,stormreaver,863,shaman,restoration,30,9,21
Naphe,ysondre,863,shaman,restoration,30,9,21
Милыйдед,gordunni,863,shaman,restoration,36,9,27
Rugludalli,dragonblight,862,shaman,restoration,12,9,3
Бронепароход,soulflayer,862,shaman,restoration,12,9,3
Spammail,argent-dawn,862,shaman,restoration,12,9,3
Aredin,ysera,862,shaman,restoration,12,9,3
Pprx,tarren-mill,862,shaman,restoration,24,9,15
Salmôn,twisting-nether,862,shaman,restoration,24,9,15
Дрфэка,soulflayer,862,shaman,restoration,51,14,37
Cjay,dunemaul,861,shaman,restoration,12,9,3
Yánux,aegwynn,861,shaman,restoration,12,9,3
Эндипёсель,ashenvale,861,shaman,restoration,12,9,3
Shamanopaf,tarren-mill,861,shaman,restoration,18,9,9
Matsudah,ragnaros,861,shaman,restoration,18,9,9
Lindemánn,blackhand,861,shaman,restoration,24,9,15
Honollulu,drakthul,860,shaman,restoration,12,9,3
Amu,ravencrest,860,shaman,restoration,18,9,9
Mansquidgoat,darksorrow,859,shaman,restoration,15,10,5
Kosur,kazzak,859,shaman,restoration,18,9,9
Orchal,defias-brotherhood,859,shaman,restoration,18,9,9
Stkk,ravencrest,859,shaman,restoration,98,46,52
Sunsham,illidan,858,shaman,restoration,18,9,9
Proxysham,the-maelstrom,857,shaman,restoration,12,9,3
Shamanaman,stormscale,857,shaman,restoration,18,9,9
Kamichami,sanguino,857,shaman,restoration,24,9,15
Wayoa,defias-brotherhood,856,shaman,restoration,12,9,3
Chartersham,silvermoon,856,shaman,restoration,12,9,3
Wakka,wildhammer,856,shaman,restoration,42,12,30
Gleggy,turalyon,854,shaman,restoration,12,9,3
Zendrox,aegwynn,854,shaman,restoration,18,9,9
Picklechris,tarren-mill,851,shaman,restoration,24,10,14
Psyforce,argent-dawn,850,shaman,restoration,12,9,3
Temeres,drakthul,849,shaman,restoration,18,9,9
Qusek,turalyon,847,shaman,restoration,79,34,45
Lillitthya,elune,845,shaman,restoration,33,13,20
Gerlo,thrall,838,shaman,restoration,30,13,17
Yàra,throkferoth,834,shaman,restoration,54,24,30
Robgon,aggra-português,833,shaman,restoration,41,15,26
Numdog,stormreaver,831,shaman,restoration,17,9,8
Ayesapik,dalaran,831,shaman,restoration,46,21,25
Jeqs,twisting-nether,830,shaman,restoration,14,10,4
Soramat,aegwynn,830,shaman,restoration,23,9,14
Stormzug,twisting-nether,826,shaman,restoration,20,10,10
Lk,twilights-hammer,815,shaman,restoration,15,10,5
Kuubskii,ravencrest,815,shaman,restoration,17,9,8
Aspên,archimonde,815,shaman,restoration,17,9,8
Bountiti,dun-modr,810,shaman,restoration,18,10,8
Crixuss,argent-dawn,809,shaman,restoration,17,9,8
Pvegame,tarren-mill,809,shaman,restoration,20,10,10
Feizhousa,outland,799,shaman,restoration,26,9,17
Smugleaf,frostmane,793,shaman,restoration,30,9,21
Shàwyn,sylvanas,782,shaman,restoration,17,9,8
Vërÿßåðxd,silvermoon,768,shaman,restoration,12,8,4
Öyama,sinstralis,768,shaman,restoration,12,8,4
Cgjúng,ravencrest,768,shaman,restoration,12,8,4
Lontarita,tarren-mill,768,shaman,restoration,12,8,4
Enchancement,ragnaros,768,shaman,restoration,12,8,4
Vibesham,outland,768,shaman,restoration,12,8,4
Wolkî,aegwynn,768,shaman,restoration,12,8,4
Leykosh,ravencrest,768,shaman,restoration,12,8,4
Ivnashaman,drakthul,768,shaman,restoration,12,8,4
Mustabrutus,tarren-mill,768,shaman,restoration,16,9,7
Lorko,twisting-nether,768,shaman,restoration,18,8,10
Chimey,frostmane,768,shaman,restoration,18,8,10
Tâvôry,aegwynn,768,shaman,restoration,18,8,10
Papaver,zirkel-des-cenarius,768,shaman,restoration,18,8,10
Sehn,arathor,768,shaman,restoration,18,8,10
Qoekke,uldum,768,shaman,restoration,18,8,10
Infinitetide,doomhammer,768,shaman,restoration,18,8,10
Nøraa,ravencrest,768,shaman,restoration,18,8,10
Iphosham,twisting-nether,768,shaman,restoration,18,8,10
Зачикинимся,howling-fjord,768,shaman,restoration,18,8,10
Djtomp,kazzak,768,shaman,restoration,18,8,10
Dapawz,defias-brotherhood,767,shaman,restoration,12,8,4
Хъюстэн,gordunni,767,shaman,restoration,12,8,4
Кураж,howling-fjord,767,shaman,restoration,12,8,4
Berasham,dalaran,767,shaman,restoration,12,8,4
Magma,kazzak,767,shaman,restoration,12,8,4
Айскримтрак,gordunni,767,shaman,restoration,12,8,4
Karezza,azjolnerub,767,shaman,restoration,12,8,4
Mentaldead,draenor,767,shaman,restoration,12,8,4
Aeldrid,argent-dawn,767,shaman,restoration,12,8,4
Setac,stormscale,767,shaman,restoration,15,9,6
Quinlàn,ravencrest,767,shaman,restoration,18,8,10
Aliatës,sanguino,767,shaman,restoration,18,8,10
Zeewzblast,silvermoon,767,shaman,restoration,18,8,10
Gungo,deathwing,767,shaman,restoration,18,8,10
Iwaa,dalaran,767,shaman,restoration,18,8,10
Hàrdstûkgødx,uldaman,767,shaman,restoration,18,8,10
Lycburst,twisting-nether,767,shaman,restoration,24,8,16
Zìik,draenor,767,shaman,restoration,24,8,16
Sniipy,blackmoore,767,shaman,restoration,24,8,16
Rakân,ysondre,767,shaman,restoration,24,8,16
Pòcho,kazzak,767,shaman,restoration,29,8,21
Eero,darksorrow,766,shaman,restoration,12,8,4
Robbie,dentarg,766,shaman,restoration,12,8,4
Джоукх,howling-fjord,766,shaman,restoration,12,8,4
Schläck,outland,766,shaman,restoration,18,8,10
Binslagala,zuljin,765,shaman,restoration,12,8,4
Naargie,outland,765,shaman,restoration,20,8,12
Ironspine,sylvanas,764,shaman,restoration,18,8,10
Khattla,outland,763,shaman,restoration,12,8,4
Eveeöe,outland,763,shaman,restoration,18,8,10
Gundersen,stormscale,763,shaman,restoration,18,8,10
Mcslammer,kazzak,763,shaman,restoration,24,8,16
Arles,dun-modr,762,shaman,restoration,18,8,10
Rórekk,aegwynn,761,shaman,restoration,18,8,10
Greenguard,argent-dawn,759,shaman,restoration,59,17,42
Syreer,silvermoon,758,shaman,restoration,26,11,15
Mysapphie,kazzak,751,shaman,restoration,17,9,8
Sakoon,twisting-nether,751,shaman,restoration,18,8,10
Øzy,sanguino,749,shaman,restoration,14,8,6
Amarök,nerzhul,749,shaman,restoration,18,8,10
Дарьюша,fordragon,744,shaman,restoration,12,8,4
Muntark,thrall,719,shaman,restoration,27,8,19
Razeroø,ysondre,717,shaman,restoration,23,8,15
Scàráth,eredar,717,shaman,restoration,27,8,19
Агмень,howling-fjord,717,shaman,restoration,39,8,31
Katzubushi,pozzo-delleternità,715,shaman,restoration,38,11,27
Shäman,burning-blade,714,shaman,restoration,21,9,12
Stolen,skullcrusher,712,shaman,restoration,15,9,6
Флафен,howling-fjord,712,shaman,restoration,19,9,10
Lauree,terokkar,710,shaman,restoration,23,9,14
Thangog,ragnaros,703,shaman,restoration,16,8,8
Карбонатрикс,soulflayer,703,shaman,restoration,16,8,8
Тотемвуман,soulflayer,703,shaman,restoration,22,8,14
Грейсаша,howling-fjord,695,shaman,restoration,22,8,14
Turbohulk,blackrock,688,shaman,restoration,13,8,5
Cumulichan,ragnaros,687,shaman,restoration,11,8,3
Blackbeardxd,stormscale,672,shaman,restoration,12,7,5
Clickmeh,runetotem,672,shaman,restoration,12,7,5
Tjocknacke,tarren-mill,672,shaman,restoration,12,7,5
Teldariane,archimonde,672,shaman,restoration,12,7,5
Winshear,twisting-nether,672,shaman,restoration,12,7,5
Dôppel,archimonde,672,shaman,restoration,12,7,5
Qicholardon,archimonde,672,shaman,restoration,12,7,5
Healeugene,ravencrest,672,shaman,restoration,12,7,5
Berly,stormscale,672,shaman,restoration,12,7,5
Iamshamon,kazzak,672,shaman,restoration,12,7,5
Lêêmo,outland,672,shaman,restoration,12,7,5
Fupx,the-maelstrom,672,shaman,restoration,12,7,5
Pogchampz,nemesis,672,shaman,restoration,12,7,5
Esher,frostwolf,672,shaman,restoration,12,7,5
Nosno,ravencrest,672,shaman,restoration,12,7,5
Nansmasher,draenor,672,shaman,restoration,12,7,5
Popopopopor,archimonde,672,shaman,restoration,12,7,5
Boltkesh,draenor,672,shaman,restoration,12,7,5
Spiirit,tarren-mill,672,shaman,restoration,12,7,5
Nezug,ysondre,672,shaman,restoration,12,7,5
Raintlordx,twisting-nether,672,shaman,restoration,12,7,5
Doubleshamz,the-maelstrom,672,shaman,restoration,12,7,5
Shamounf,archimonde,672,shaman,restoration,12,7,5
Horcsog,ravencrest,672,shaman,restoration,18,7,11
Zulylol,outland,672,shaman,restoration,18,7,11
Sháme,azjolnerub,672,shaman,restoration,18,7,11
Reticlol,kazzak,672,shaman,restoration,18,7,11
Horkxina,frostmourne,672,shaman,restoration,18,7,11
Oningodx,drakthul,672,shaman,restoration,18,7,11
Kimsshaman,ragnaros,672,shaman,restoration,18,7,11
Agrok,jaedenar,672,shaman,restoration,18,7,11
Raiden,aegwynn,672,shaman,restoration,18,7,11
Barbebiendur,archimonde,672,shaman,restoration,18,7,11
Papskalla,ravencrest,672,shaman,restoration,18,7,11
Крэйвхх,howling-fjord,672,shaman,restoration,18,7,11
Horiq,kazzak,672,shaman,restoration,18,7,11
Arîya,blackrock,672,shaman,restoration,18,7,11
Çøynx,aegwynn,672,shaman,restoration,20,7,13
Recov,draenor,672,shaman,restoration,22,7,15
Rejax,blackmoore,672,shaman,restoration,24,7,17
Ådrixon,burning-legion,672,shaman,restoration,30,7,23
Ricid,nerathor,671,shaman,restoration,12,7,5
Gimzx,magtheridon,671,shaman,restoration,12,7,5
Bbc,dalaran,671,shaman,restoration,12,7,5
Räyznx,nozdormu,671,shaman,restoration,12,7,5
Lingz,auchindoun,671,shaman,restoration,12,7,5
Elshimano,ravencrest,671,shaman,restoration,12,7,5
Grosgourdin,la-croisade-écarlate,671,shaman,restoration,12,7,5
Cred,the-venture-co,671,shaman,restoration,12,7,5
Rooske,draenor,671,shaman,restoration,12,7,5
Bajslys,kazzak,671,shaman,restoration,12,7,5
Dominatorix,xavius,671,shaman,restoration,13,7,6
Brocksamson,dentarg,671,shaman,restoration,14,7,7
Nïshä,twisting-nether,671,shaman,restoration,18,7,11
Shâdôwlîght,antonidas,671,shaman,restoration,18,7,11
Flameshock,tarren-mill,671,shaman,restoration,18,7,11
Deadshammyx,ravencrest,671,shaman,restoration,18,7,11
Maab,arathor,671,shaman,restoration,18,7,11
Xentic,kazzak,671,shaman,restoration,18,7,11
Zippidizap,ulduar,671,shaman,restoration,18,7,11
Indennacken,blackmoore,671,shaman,restoration,18,7,11
Jedsham,stormscale,671,shaman,restoration,18,7,11
Skullføck,argent-dawn,671,shaman,restoration,21,8,13
Eaglesteaam,silvermoon,671,shaman,restoration,20,7,13
Mòónz,kazzak,671,shaman,restoration,24,7,17
Инкарнатор,deathguard,670,shaman,restoration,12,7,5
Aiuto,archimonde,670,shaman,restoration,12,7,5
Bjorhuk,ravencrest,670,shaman,restoration,12,7,5
Tidors,burning-legion,670,shaman,restoration,12,7,5
Plùx,antonidas,670,shaman,restoration,12,7,5
Bandyy,magtheridon,670,shaman,restoration,18,7,11
Irachal,rexxar,670,shaman,restoration,18,7,11
Aluweckerl,eredar,670,shaman,restoration,24,7,17
Kledorchick,twisting-nether,670,shaman,restoration,33,7,26
Shamaxwell,blackhand,669,shaman,restoration,12,7,5
Woew,tarren-mill,669,shaman,restoration,12,7,5
Линчон,soulflayer,669,shaman,restoration,18,7,11
Simph,uldum,669,shaman,restoration,24,7,17
Shacharcaspi,blackmoore,669,shaman,restoration,24,7,17
Brutalxl,tarren-mill,669,shaman,restoration,24,7,17
Marranota,cthun,668,shaman,restoration,12,7,5
Bloggurt,tarren-mill,668,shaman,restoration,18,7,11
Sorontar,twisting-nether,668,shaman,restoration,18,7,11
Raikage,elune,668,shaman,restoration,18,7,11
Aveet,kazzak,667,shaman,restoration,18,7,11
Millacki,blackrock,667,shaman,restoration,18,7,11
Omeletteoeuf,silvermoon,666,shaman,restoration,12,7,5
Zelgore,frostwhisper,666,shaman,restoration,18,7,11
Briindead,archimonde,665,shaman,restoration,12,7,5
Sneggels,wrathbringer,665,shaman,restoration,21,8,13
Jøw,dun-modr,661,shaman,restoration,12,7,5
Raketenrieke,blackrock,659,shaman,restoration,25,12,13
Bogmagnus,the-maelstrom,659,shaman,restoration,39,13,26
Lillink,stormscale,655,shaman,restoration,9,9,0
Draredemolen,archimonde,655,shaman,restoration,17,7,10
Mjollnier,stormscale,640,shaman,restoration,10,8,2
Eddiemorphin,kazzak,639,shaman,restoration,11,7,4
Неерззул,soulflayer,639,shaman,restoration,17,7,10
Nojiko,blackrock,638,shaman,restoration,17,7,10
Altesh,die-todeskrallen,634,shaman,restoration,16,7,9
Realiz,ysondre,622,shaman,restoration,16,7,9
Енотикусь,soulflayer,618,shaman,restoration,12,8,4
Chîllkrötè,blackmoore,618,shaman,restoration,12,8,4
Disharmony,outland,618,shaman,restoration,12,8,4
Mambokïngs,sanguino,617,shaman,restoration,16,8,8
Aesa,dun-modr,617,shaman,restoration,18,8,10
Randomuwu,stormscale,616,shaman,restoration,22,8,14
Мке,howling-fjord,615,shaman,restoration,29,11,18
Martiinii,dragonmaw,606,shaman,restoration,11,7,4
Amatero,drakthul,591,shaman,restoration,13,7,6
Zhead,aggramar,584,shaman,restoration,16,9,7
Ethixx,outland,576,shaman,restoration,6,6,0
Lerra,zirkel-des-cenarius,576,shaman,restoration,6,6,0
Bauch,tichondrius,576,shaman,restoration,6,6,0
Yacuzwerg,blackrock,576,shaman,restoration,6,6,0
Imdarat,hyjal,576,shaman,restoration,6,6,0
Oldveteran,eredar,576,shaman,restoration,6,6,0
Groquick,dalaran,576,shaman,restoration,12,6,6
Bigdaddyxo,tarren-mill,576,shaman,restoration,12,6,6
Wintradezki,tarren-mill,576,shaman,restoration,12,6,6
Jodel,tarren-mill,576,shaman,restoration,12,6,6
Канамаш,borean-tundra,576,shaman,restoration,12,6,6
Artîe,archimonde,576,shaman,restoration,12,6,6
Juicyy,ravencrest,576,shaman,restoration,12,6,6
Тирона,howling-fjord,576,shaman,restoration,12,6,6
Runbrorun,hyjal,576,shaman,restoration,12,6,6
Гоэл,ashenvale,576,shaman,restoration,12,6,6
Thaw,sylvanas,576,shaman,restoration,12,6,6
Dreamon,culte-de-la-rive-noire,576,shaman,restoration,12,6,6
Thatstheswag,blackmoore,576,shaman,restoration,12,6,6
Embodiment,blackrock,576,shaman,restoration,12,6,6
Kaluna,outland,576,shaman,restoration,12,6,6
Erepmad,ravencrest,576,shaman,restoration,12,6,6
Холинкаалло,deathguard,576,shaman,restoration,12,6,6
Komodski,kazzak,576,shaman,restoration,12,6,6
Mýthaz,archimonde,576,shaman,restoration,12,6,6
Chamanox,dalaran,576,shaman,restoration,12,6,6
Tsugu,kazzak,576,shaman,restoration,12,6,6
Chudygôdx,drakthul,576,shaman,restoration,12,6,6
Ruffin,stormscale,576,shaman,restoration,12,6,6
Lmnn,ravencrest,576,shaman,restoration,12,6,6
Tusseladden,tarren-mill,576,shaman,restoration,12,6,6
Gromaburst,stormscale,576,shaman,restoration,12,6,6
Брайбах,howling-fjord,576,shaman,restoration,12,6,6
Heatti,doomhammer,576,shaman,restoration,12,6,6
Oroastbeef,archimonde,576,shaman,restoration,12,6,6
Lortihalsen,outland,576,shaman,restoration,12,6,6
Gamixyx,magtheridon,576,shaman,restoration,12,6,6
Absot,dun-morogh,576,shaman,restoration,12,6,6
Алтезка,blackscar,576,shaman,restoration,12,6,6
Чиллаут,howling-fjord,576,shaman,restoration,12,6,6
Hamgroof,blackrock,576,shaman,restoration,12,6,6
Djsheargødx,twisting-nether,576,shaman,restoration,12,6,6
Hablibubli,kazzak,576,shaman,restoration,12,6,6
Gamixy,magtheridon,576,shaman,restoration,12,6,6
Enoughh,the-maelstrom,576,shaman,restoration,12,6,6
Neverqueue,defias-brotherhood,576,shaman,restoration,12,6,6
Ambuu,kazzak,576,shaman,restoration,12,6,6
Zûgzûg,ragnaros,576,shaman,restoration,12,6,6
Monamour,twisting-nether,576,shaman,restoration,12,6,6
Nimbs,tarren-mill,576,shaman,restoration,12,6,6
Rhêz,kazzak,576,shaman,restoration,12,6,6
Goodevening,tarren-mill,576,shaman,restoration,12,6,6
Khidon,silvermoon,576,shaman,restoration,12,6,6
Skottkärrà,ravencrest,576,shaman,restoration,12,6,6
Kilninshape,archimonde,576,shaman,restoration,12,6,6
Артэкриошам,soulflayer,576,shaman,restoration,12,6,6
Zalamlól,kazzak,576,shaman,restoration,12,6,6
Cardeâ,blackhand,576,shaman,restoration,12,6,6
Хоупосх,gordunni,576,shaman,restoration,12,6,6
Annoying,archimonde,576,shaman,restoration,12,6,6
Gotta,dethecus,576,shaman,restoration,12,6,6
Purgecleave,dalvengyr,576,shaman,restoration,12,6,6
Løktarøgàr,archimonde,576,shaman,restoration,12,6,6
Qwázú,silvermoon,576,shaman,restoration,12,6,6
Lågertha,sanguino,576,shaman,restoration,12,6,6
Tuorak,eredar,576,shaman,restoration,12,6,6
Modder,ragnaros,576,shaman,restoration,12,6,6
Kocaina,kazzak,576,shaman,restoration,12,6,6
Glücksbarren,die-aldor,576,shaman,restoration,12,6,6
Kameltotem,balnazzar,576,shaman,restoration,12,6,6
Shmøn,outland,576,shaman,restoration,12,6,6
Katwio,hyjal,576,shaman,restoration,12,6,6
Pjotrasmus,mannoroth,576,shaman,restoration,18,6,12
Embèr,silvermoon,576,shaman,restoration,18,6,12
Lifestorm,hyjal,576,shaman,restoration,18,6,12
Kioterasham,conseil-des-ombres,576,shaman,restoration,18,6,12
Tâkeda,blackmoore,576,shaman,restoration,18,6,12
Patsham,wildhammer,576,shaman,restoration,18,6,12
Боргирх,soulflayer,576,shaman,restoration,24,6,18
Aboveaverage,stormscale,576,shaman,restoration,30,6,24
Brandbombe,frostwolf,575,shaman,restoration,12,6,6
Sikro,frostwolf,575,shaman,restoration,12,6,6
Sjearthen,defias-brotherhood,575,shaman,restoration,12,6,6
Conor,kult-der-verdammten,575,shaman,restoration,12,6,6
Qona,emerald-dream,575,shaman,restoration,12,6,6
Flurpz,outland,575,shaman,restoration,12,6,6
Shazefin,twisting-nether,575,shaman,restoration,12,6,6
Kraugug,archimonde,575,shaman,restoration,12,6,6
Ghoraddu,drakthul,575,shaman,restoration,12,6,6
Pakasschami,frostwolf,575,shaman,restoration,12,6,6
Vascodagama,twisting-nether,575,shaman,restoration,12,6,6
Cadierno,argent-dawn,575,shaman,restoration,12,6,6
Cristhor,nemesis,575,shaman,restoration,12,6,6
Bíllý,onyxia,575,shaman,restoration,12,6,6
Pyxton,kazzak,575,shaman,restoration,12,6,6
Stortvloed,twisting-nether,575,shaman,restoration,12,6,6
Kyaz,ravencrest,575,shaman,restoration,12,6,6
Безрукан,howling-fjord,575,shaman,restoration,12,6,6
Aesonis,kazzak,575,shaman,restoration,14,6,8
Дохаку,booty-bay,575,shaman,restoration,17,6,11
Джусипуси,gordunni,575,shaman,restoration,18,6,12
Турелька,blackscar,575,shaman,restoration,18,6,12
Mystico,sanguino,575,shaman,restoration,18,6,12
Liferqt,nemesis,575,shaman,restoration,18,6,12
Аскирия,soulflayer,575,shaman,restoration,18,6,12
Kalvei,draenor,575,shaman,restoration,18,6,12
Lorthargol,chamber-of-aspects,575,shaman,restoration,18,6,12
Laftershamy,cthun,575,shaman,restoration,24,6,18
Tidushears,thrall,574,shaman,restoration,12,6,6
Kongapenes,tarren-mill,574,shaman,restoration,12,6,6
Turbokrapka,tarren-mill,574,shaman,restoration,12,6,6
Notwhoheals,executus,574,shaman,restoration,18,6,12
Ftsckpower,blackhand,574,shaman,restoration,18,6,12
Pépón,dun-modr,574,shaman,restoration,18,6,12
Bolski,stormreaver,573,shaman,restoration,12,6,6
Dobbi,dethecus,573,shaman,restoration,12,6,6
Muschi,culte-de-la-rive-noire,573,shaman,restoration,16,7,9
Horiun,sanguino,573,shaman,restoration,19,6,13
Shammzy,mannoroth,573,shaman,restoration,24,6,18
Морпат,soulflayer,571,shaman,restoration,10,7,3
Alïsyo,nemesis,570,shaman,restoration,18,6,12
Bunnîe,kazzak,565,shaman,restoration,18,6,12
Ongedierte,tarren-mill,543,shaman,restoration,11,6,5
Groundcslol,kazzak,543,shaman,restoration,14,7,7
Cotêaz,thrall,541,shaman,restoration,16,6,10
Totemglad,drakthul,528,shaman,restoration,9,7,2
Whibbler,ravencrest,528,shaman,restoration,21,7,14
Randomshamx,ravencrest,527,shaman,restoration,11,6,5
Télapou,ragnaros,527,shaman,restoration,11,6,5
Манрото,soulflayer,526,shaman,restoration,9,6,3
Glak,draenor,521,shaman,restoration,21,7,14
Elwynnpolice,argent-dawn,512,shaman,restoration,16,6,10
Arigolds,twilights-hammer,511,shaman,restoration,11,6,5
Zordox,zirkel-des-cenarius,511,shaman,restoration,16,6,10
Mynutz,outland,480,shaman,restoration,6,5,1
Keiro,burning-blade,480,shaman,restoration,6,5,1
Helloimblue,blackmoore,480,shaman,restoration,6,5,1
Bummexx,twisting-nether,480,shaman,restoration,6,5,1
Gadula,burning-legion,480,shaman,restoration,6,5,1
Ub,garona,480,shaman,restoration,6,5,1
Meeq,deathwing,480,shaman,restoration,6,5,1
Ranenmuija,outland,480,shaman,restoration,6,5,1
Joeexotictv,tarren-mill,480,shaman,restoration,6,5,1
Shamsteaks,thrall,480,shaman,restoration,6,5,1
Antikahraman,blackrock,480,shaman,restoration,6,5,1
Qwauzinator,silvermoon,480,shaman,restoration,6,5,1
Xêra,burning-legion,480,shaman,restoration,10,6,4
Styllz,uldaman,480,shaman,restoration,12,5,7
Nùggets,garona,480,shaman,restoration,12,5,7
Hexftw,khaz-modan,480,shaman,restoration,12,5,7
Sliiderr,draenor,480,shaman,restoration,12,5,7
Asschick,outland,480,shaman,restoration,12,5,7
Kïtten,tarren-mill,480,shaman,restoration,12,5,7
Kemmi,dalaran,480,shaman,restoration,12,5,7
Ghorall,ragnaros,480,shaman,restoration,12,5,7
Hogmodig,tarren-mill,480,shaman,restoration,12,5,7
Maybeyes,twisting-nether,480,shaman,restoration,12,5,7
Kfcmanagerzz,archimonde,480,shaman,restoration,12,5,7
Zougzy,uldaman,480,shaman,restoration,12,5,7
Volwerin,blackhand,480,shaman,restoration,12,5,7
Medistød,draenor,480,shaman,restoration,12,5,7
Zæus,ragnaros,480,shaman,restoration,12,5,7
Evííl,tarren-mill,480,shaman,restoration,12,5,7
Tobbey,tarren-mill,480,shaman,restoration,12,5,7
Adzkímo,tarren-mill,480,shaman,restoration,12,5,7
Maïtregïms,archimonde,480,shaman,restoration,12,5,7
Tigo,tarren-mill,480,shaman,restoration,12,5,7
Libano,archimonde,480,shaman,restoration,12,5,7
Zappyhog,turalyon,480,shaman,restoration,12,5,7
Daboo,the-venture-co,480,shaman,restoration,12,5,7
Caliqueños,sanguino,480,shaman,restoration,12,5,7
Nakertaako,kazzak,480,shaman,restoration,12,5,7
Cheerz,ravencrest,480,shaman,restoration,12,5,7
Shamania,grim-batol,480,shaman,restoration,12,5,7
Sojee,ysondre,480,shaman,restoration,12,5,7
Shadowmove,bronzebeard,480,shaman,restoration,12,5,7
Kempfer,blackrock,480,shaman,restoration,12,5,7
Egor,alakir,480,shaman,restoration,12,5,7
Mbx,ravencrest,480,shaman,restoration,12,5,7
Flandersx,ravencrest,480,shaman,restoration,12,5,7
Riptidegodx,archimonde,480,shaman,restoration,12,5,7
Uanl,stormscale,480,shaman,restoration,12,5,7
Lumière,alonsus,480,shaman,restoration,12,5,7
Biçi,steamwheedle-cartel,480,shaman,restoration,12,5,7
Markboymint,earthen-ring,480,shaman,restoration,12,5,7
Thyeori,stormscale,480,shaman,restoration,12,5,7
Windie,drakthul,480,shaman,restoration,12,5,7
Lontarsdaddy,twisting-nether,480,shaman,restoration,12,5,7
Totemiclol,aegwynn,480,shaman,restoration,12,5,7
Demeri,blackrock,480,shaman,restoration,12,5,7
Aeknor,ravencrest,480,shaman,restoration,12,5,7
Burrowabuser,nemesis,480,shaman,restoration,12,5,7
Qishwilu,ravencrest,480,shaman,restoration,12,5,7
Вардоус,soulflayer,480,shaman,restoration,12,5,7
Leafplsx,blackrock,480,shaman,restoration,12,5,7
Nevagonalink,archimonde,480,shaman,restoration,12,5,7
Бьерн,deepholm,480,shaman,restoration,12,5,7
Hakunax,twisting-nether,480,shaman,restoration,12,5,7
Jakeir,auchindoun,480,shaman,restoration,12,5,7
Tooltip,tarren-mill,480,shaman,restoration,12,5,7
Ravenshock,bloodfeather,480,shaman,restoration,12,5,7
Shamarco,nemesis,480,shaman,restoration,12,5,7
Unleashme,sylvanas,480,shaman,restoration,12,5,7
Селфлессх,soulflayer,480,shaman,restoration,18,5,13
Slasket,bloodscalp,480,shaman,restoration,18,5,13
Peremptor,alleria,480,shaman,restoration,18,5,13
Колбаскофф,gordunni,480,shaman,restoration,18,5,13
Кенниарт,howling-fjord,480,shaman,restoration,18,5,13
Krayton,tarren-mill,480,shaman,restoration,18,5,13
Bruho,mazrigos,480,shaman,restoration,18,5,13
Elepumper,outland,480,shaman,restoration,18,5,13
Nêgan,ravencrest,480,shaman,restoration,22,5,17
Savan,darkspear,480,shaman,restoration,24,5,19
Rawtex,draenor,480,shaman,restoration,26,5,21
Iebaznis,draenor,479,shaman,restoration,6,5,1
Tllz,kargath,479,shaman,restoration,6,5,1
Scamander,draenor,479,shaman,restoration,8,5,3
Sakar,auchindoun,479,shaman,restoration,12,5,7
Manolaz,kazzak,479,shaman,restoration,12,5,7
Bloodfist,drakthul,479,shaman,restoration,12,5,7
Amnistia,ragnaros,479,shaman,restoration,12,5,7
Hydrototem,archimonde,479,shaman,restoration,12,5,7
Donnerbubele,aegwynn,479,shaman,restoration,12,5,7
Gelaende,thrall,479,shaman,restoration,12,5,7
Róbbàn,agamaggan,479,shaman,restoration,12,5,7
Axéron,blackhand,479,shaman,restoration,12,5,7
Babyboomz,bronze-dragonflight,479,shaman,restoration,12,5,7
Weho,kazzak,479,shaman,restoration,12,5,7
Earthliving,zuljin,479,shaman,restoration,12,5,7
Joaléine,khaz-modan,479,shaman,restoration,12,5,7
Kyousek,drakthul,479,shaman,restoration,12,5,7
Scoobsz,thrall,479,shaman,restoration,15,5,10
Darthshox,outland,478,shaman,restoration,16,6,10
Jotuna,argent-dawn,478,shaman,restoration,18,5,13
Кезара,razuvious,478,shaman,restoration,18,5,13
Rixxa,stormscale,478,shaman,restoration,18,5,13
Darkstrong,alakir,477,shaman,restoration,12,5,7
Thrallallero,pozzo-delleternità,477,shaman,restoration,12,5,7
Porch,doomhammer,476,shaman,restoration,12,5,7
Killhorn,malganis,474,shaman,restoration,12,5,7
Wanryoku,kaelthas,472,shaman,restoration,12,5,7
Shamanarama,sylvanas,463,shaman,restoration,23,5,18
Tøøpåc,hyjal,462,shaman,restoration,13,6,7
Kortgat,kilrogg,431,shaman,restoration,17,5,12
Shamakerr,tarren-mill,426,shaman,restoration,17,7,10
Äppelpaj,earthen-ring,426,shaman,restoration,15,6,9
Etabeta,shattered-hand,415,shaman,restoration,8,5,3
Ulrichh,twisting-nether,415,shaman,restoration,8,5,3
Blixtlasse,magtheridon,400,shaman,restoration,13,5,8
Abøriginal,kazzak,399,shaman,restoration,5,5,0
Доргорн,grom,396,shaman,restoration,11,5,6
Sakulis,ravencrest,384,shaman,restoration,6,4,2
Bluetide,ravencrest,384,shaman,restoration,6,4,2
Volvíc,tichondrius,384,shaman,restoration,6,4,2
Grimdonut,argent-dawn,384,shaman,restoration,6,4,2
Idroptotems,drakthul,384,shaman,restoration,6,4,2
Hexyasf,ravencrest,384,shaman,restoration,6,4,2
Glóbal,sylvanas,384,shaman,restoration,6,4,2
Førcemajeure,kazzak,384,shaman,restoration,6,4,2
Chiio,draenor,384,shaman,restoration,6,4,2
Фредуизли,howling-fjord,384,shaman,restoration,6,4,2
Onionz,stormreaver,384,shaman,restoration,6,4,2
Thriveqt,nemesis,384,shaman,restoration,6,4,2
Laserra,sylvanas,384,shaman,restoration,6,4,2
Mole,jaedenar,384,shaman,restoration,6,4,2
Громкеш,howling-fjord,384,shaman,restoration,6,4,2
Karlsensham,stormscale,384,shaman,restoration,6,4,2
Fapwap,sylvanas,384,shaman,restoration,6,4,2
Амг,booty-bay,384,shaman,restoration,6,4,2
Zyrou,arthas,384,shaman,restoration,6,4,2
Chadhealer,thrall,384,shaman,restoration,6,4,2
Flùffy,nemesis,384,shaman,restoration,6,4,2
Xabat,nemesis,384,shaman,restoration,6,4,2
Blyxuhm,argent-dawn,384,shaman,restoration,6,4,2
Waterboy,tarren-mill,384,shaman,restoration,6,4,2
Bandulski,twisting-nether,384,shaman,restoration,6,4,2
Kekke,uldum,384,shaman,restoration,6,4,2
Стамма,borean-tundra,384,shaman,restoration,6,4,2
Ophís,ambossar,384,shaman,restoration,6,4,2
Тимтярра,gordunni,384,shaman,restoration,6,4,2
Yozgatlilan,aegwynn,384,shaman,restoration,6,4,2
Ravd,outland,384,shaman,restoration,6,4,2
Grimn,burning-legion,384,shaman,restoration,6,4,2
Johnnysîns,blackhand,384,shaman,restoration,6,4,2
Hamuksha,nerathor,384,shaman,restoration,6,4,2
Toasterbread,kazzak,384,shaman,restoration,6,4,2
Пакни,gordunni,384,shaman,restoration,6,4,2
Stormjvj,twisting-nether,384,shaman,restoration,6,4,2
Ысч,ashenvale,384,shaman,restoration,6,4,2
Shàyâ,ysondre,384,shaman,restoration,6,4,2
Снобу,gordunni,384,shaman,restoration,6,4,2
Prup,tarren-mill,384,shaman,restoration,6,4,2
Irônmaxx,antonidas,384,shaman,restoration,6,4,2
Pank,kazzak,384,shaman,restoration,6,4,2
Phobophobia,archimonde,384,shaman,restoration,6,4,2
Электро,thermaplugg,384,shaman,restoration,6,4,2
Imdax,hyjal,384,shaman,restoration,6,4,2
Eaglhex,silvermoon,384,shaman,restoration,6,4,2
Salsissimous,azjolnerub,384,shaman,restoration,6,4,2
Kundt,dalaran,384,shaman,restoration,6,4,2
Leyliner,blackhand,384,shaman,restoration,6,4,2
Criticalx,eredar,384,shaman,restoration,15,5,10
Porke,moonglade,384,shaman,restoration,12,4,8
Меготип,deathweaver,384,shaman,restoration,12,4,8
Cottoneyejoe,alexstrasza,384,shaman,restoration,12,4,8
Bigfatjay,stormscale,384,shaman,restoration,12,4,8
Daklickshamy,blackmoore,384,shaman,restoration,12,4,8
Smahamtwo,stormscale,384,shaman,restoration,12,4,8
Lanze,blackrock,384,shaman,restoration,12,4,8
Faìnt,stormscale,384,shaman,restoration,12,4,8
Serasol,sylvanas,384,shaman,restoration,12,4,8
Pasjeop,ravencrest,384,shaman,restoration,12,4,8
Shamdren,outland,384,shaman,restoration,12,4,8
Guccishadezz,blackmoore,384,shaman,restoration,12,4,8
Bolg,veklor,384,shaman,restoration,12,4,8
Kaffekask,stormscale,384,shaman,restoration,12,4,8
Insanebölt,ravencrest,384,shaman,restoration,12,4,8
Drakamaa,ravencrest,384,shaman,restoration,12,4,8
Lavababe,blackmoore,384,shaman,restoration,12,4,8
Sempaihentai,draenor,384,shaman,restoration,12,4,8
Zyphiz,twisting-nether,384,shaman,restoration,12,4,8
ßiggie,garona,384,shaman,restoration,12,4,8
Wagaluu,ravencrest,384,shaman,restoration,12,4,8
Râpzz,aegwynn,384,shaman,restoration,12,4,8
Kuyamii,blackrock,384,shaman,restoration,12,4,8
Enkou,blackmoore,384,shaman,restoration,12,4,8
Staxoman,daggerspine,384,shaman,restoration,12,4,8
Ранняяпташка,soulflayer,384,shaman,restoration,12,4,8
Энхай,azuregos,384,shaman,restoration,12,4,8
Девлиниум,fordragon,384,shaman,restoration,12,4,8
Nonie,arthas,384,shaman,restoration,12,4,8
Joeashock,ragnaros,384,shaman,restoration,12,4,8
Kerfo,ragnaros,384,shaman,restoration,12,4,8
Zídané,antonidas,384,shaman,restoration,12,4,8
Kashnar,tarren-mill,384,shaman,restoration,12,4,8
Voodz,nathrezim,384,shaman,restoration,12,4,8
Pyrotoad,blackmoore,384,shaman,restoration,12,4,8
Abdegor,burning-legion,384,shaman,restoration,12,4,8
Vey,hyjal,384,shaman,restoration,12,4,8
Tteïl,archimonde,384,shaman,restoration,12,4,8
Maluch,burning-legion,384,shaman,restoration,12,4,8
Gharn,sanguino,384,shaman,restoration,12,4,8
Saksyl,zuljin,384,shaman,restoration,12,4,8
Archsha,burning-legion,384,shaman,restoration,12,4,8
Theodorix,silvermoon,384,shaman,restoration,18,4,14
Ohheck,outland,384,shaman,restoration,18,4,14
Mauî,twisting-nether,384,shaman,restoration,18,4,14
Wtbtoes,ravencrest,384,shaman,restoration,18,4,14
Cølo,ravencrest,384,shaman,restoration,18,4,14
Shøckz,azjolnerub,383,shaman,restoration,6,4,2
Frosthamer,ragnaros,383,shaman,restoration,6,4,2
Abuzay,medivh,383,shaman,restoration,6,4,2
Duodin,defias-brotherhood,383,shaman,restoration,6,4,2
Grøzel,illidan,383,shaman,restoration,6,4,2
Sleyvarian,chamber-of-aspects,383,shaman,restoration,12,4,8
Cisd,tarren-mill,383,shaman,restoration,12,4,8
Rayitoss,tyrande,383,shaman,restoration,16,4,12
Shamanet,kazzak,383,shaman,restoration,18,4,14
Raiñdrops,silvermoon,382,shaman,restoration,6,4,2
Slippyjim,azshara,382,shaman,restoration,12,4,8
Avatarroku,blackhand,382,shaman,restoration,12,4,8
Koko,frostwhisper,382,shaman,restoration,12,4,8
Fessel,auchindoun,379,shaman,restoration,12,4,8
Icytide,kazzak,378,shaman,restoration,18,7,11
Mycameltotem,ravencrest,372,shaman,restoration,26,8,18
Фистинктотем,soulflayer,351,shaman,restoration,16,4,12
Zboubii,archimonde,351,shaman,restoration,17,4,13
Drakhrar,pozzo-delleternità,350,shaman,restoration,8,5,3
Jakesmistake,stormscale,344,shaman,restoration,11,7,4
Grübxxgg,frostmane,335,shaman,restoration,17,4,13
Agatiø,dun-modr,330,shaman,restoration,7,5,2
Arigato,eonar,330,shaman,restoration,16,5,11
Schamitwo,twisting-nether,319,shaman,restoration,5,4,1
Murog,dalaran,319,shaman,restoration,8,4,4
Ticutashaman,argent-dawn,288,shaman,restoration,6,3,3
Muddy,argent-dawn,288,shaman,restoration,6,3,3
Toteemikylpy,argent-dawn,288,shaman,restoration,6,3,3
Shamamamin,argent-dawn,288,shaman,restoration,6,3,3
Votie,tarren-mill,288,shaman,restoration,6,3,3
Bûttâ,archimonde,288,shaman,restoration,6,3,3
Surge,darksorrow,288,shaman,restoration,6,3,3
Tezeret,silvermoon,288,shaman,restoration,6,3,3
Rndshaman,thrall,288,shaman,restoration,6,3,3
Bandiitti,darksorrow,288,shaman,restoration,6,3,3
Tenror,ragnaros,288,shaman,restoration,6,3,3
Hyamala,chamber-of-aspects,288,shaman,restoration,6,3,3
Balúr,thrall,288,shaman,restoration,6,3,3
Tarzh,dalaran,288,shaman,restoration,6,3,3
Jogabonita,kaelthas,288,shaman,restoration,6,3,3
Corlysvelary,doomhammer,288,shaman,restoration,6,3,3
Søljar,draenor,288,shaman,restoration,6,3,3
Stinkyfînger,draenor,288,shaman,restoration,6,3,3
Ikeadamen,alakir,288,shaman,restoration,6,3,3
Yarvin,draenor,288,shaman,restoration,6,3,3
Richtigfies,kazzak,288,shaman,restoration,6,3,3
Kimunamatata,draenor,288,shaman,restoration,6,3,3
Blboz,grim-batol,288,shaman,restoration,6,3,3
Vaîjîn,aegwynn,288,shaman,restoration,6,3,3
Jäckö,archimonde,288,shaman,restoration,6,3,3
Eslu,blackhand,288,shaman,restoration,6,3,3
Rokxa,burning-legion,288,shaman,restoration,6,3,3
Shamoobob,archimonde,288,shaman,restoration,6,3,3
Soulsh,die-ewige-wacht,288,shaman,restoration,6,3,3
Ishin,burning-legion,288,shaman,restoration,6,3,3
Mikesinatra,tarren-mill,288,shaman,restoration,6,3,3
Bingo,tarren-mill,288,shaman,restoration,6,3,3
Rna,ragnaros,288,shaman,restoration,6,3,3
Аалрия,goldrinn,288,shaman,restoration,6,3,3
Totemboyuk,tarren-mill,288,shaman,restoration,6,3,3
Новогор,soulflayer,288,shaman,restoration,6,3,3
Abalenn,kazzak,288,shaman,restoration,6,3,3
Shamatto,nemesis,288,shaman,restoration,6,3,3
Туурукк,soulflayer,288,shaman,restoration,6,3,3
Ранкодин,soulflayer,288,shaman,restoration,6,3,3
Видсон,soulflayer,288,shaman,restoration,6,3,3
Nohealtilt,stormscale,288,shaman,restoration,6,3,3
Oldmanrena,stormscale,288,shaman,restoration,6,3,3
Origins,archimonde,288,shaman,restoration,6,3,3
Klösbräda,stormscale,288,shaman,restoration,6,3,3
Kalinn,sylvanas,288,shaman,restoration,6,3,3
Stibs,silvermoon,288,shaman,restoration,6,3,3
Twkupe,tarren-mill,288,shaman,restoration,6,3,3
Вэллкомм,gordunni,288,shaman,restoration,6,3,3
Ñx,ravencrest,288,shaman,restoration,6,3,3
Ампулаикс,gordunni,288,shaman,restoration,6,3,3
Wealey,drakthul,288,shaman,restoration,6,3,3
Ragnesch,aegwynn,288,shaman,restoration,6,3,3
Елемчикх,gordunni,288,shaman,restoration,6,3,3
Asstroy,sanguino,288,shaman,restoration,6,3,3
Ïllïïllïï,shadowsong,288,shaman,restoration,6,3,3
Testoshaman,ravencrest,288,shaman,restoration,6,3,3
Shohmon,silvermoon,288,shaman,restoration,6,3,3
Goldou,archimonde,288,shaman,restoration,6,3,3
Шамкасамка,gordunni,288,shaman,restoration,6,3,3
Crazywitcho,archimonde,288,shaman,restoration,6,3,3
Бриз,blackscar,288,shaman,restoration,6,3,3
Кхуздуфар,blackscar,288,shaman,restoration,6,3,3
Pokspoks,stormscale,288,shaman,restoration,6,3,3
Ханикс,blackscar,288,shaman,restoration,6,3,3
Моралсидней,blackscar,288,shaman,restoration,6,3,3
Zapyboye,grim-batol,288,shaman,restoration,6,3,3
Mya,frostwolf,288,shaman,restoration,6,3,3
Majinbeb,hyjal,288,shaman,restoration,6,3,3
Гарантииный,lich-king,288,shaman,restoration,6,3,3
Solotov,bronzebeard,288,shaman,restoration,6,3,3
Bharudor,antonidas,288,shaman,restoration,6,3,3
Драмкул,soulflayer,288,shaman,restoration,6,3,3
Diffrinity,tarren-mill,288,shaman,restoration,6,3,3
Ýípìÿøû,dun-modr,288,shaman,restoration,6,3,3
Shànnón,kazzak,288,shaman,restoration,6,3,3
Lvj,blackrock,288,shaman,restoration,6,3,3
Gemexi,kazzak,288,shaman,restoration,6,3,3
Rkeev,blackrock,288,shaman,restoration,6,3,3
Snakeeyéss,kazzak,288,shaman,restoration,6,3,3
Downiesham,kazzak,288,shaman,restoration,6,3,3
Cøkka,hyjal,288,shaman,restoration,6,3,3
Shagrax,anubarak,288,shaman,restoration,6,3,3
Robcurly,blackmoore,288,shaman,restoration,6,3,3
Prepegahex,blackmoore,288,shaman,restoration,6,3,3
Chainbeef,blackmoore,288,shaman,restoration,6,3,3
Misstremmers,outland,288,shaman,restoration,6,3,3
Haract,outland,288,shaman,restoration,6,3,3
Healhooper,hyjal,288,shaman,restoration,6,3,3
Jellyg,outland,288,shaman,restoration,11,3,8
ßasìkz,hyjal,288,shaman,restoration,12,3,9
Flameshock,area-52,288,shaman,restoration,12,3,9
Happyjuice,silvermoon,288,shaman,restoration,12,3,9
Lamarrus,malganis,288,shaman,restoration,12,3,9
Thísisrestø,sanguino,288,shaman,restoration,12,3,9
Magicflames,draenor,288,shaman,restoration,12,3,9
Бэкдафакапп,blackscar,288,shaman,restoration,12,3,9
Sörén,lothar,288,shaman,restoration,12,3,9
Nixxy,magtheridon,288,shaman,restoration,12,3,9
Cpthex,draenor,288,shaman,restoration,12,3,9
Thrallotido,sanguino,288,shaman,restoration,12,3,9
Shamgott,silvermoon,288,shaman,restoration,12,3,9
Kuzsham,archimonde,288,shaman,restoration,12,3,9
Hastabasta,sylvanas,288,shaman,restoration,12,3,9
Carthis,silvermoon,288,shaman,restoration,12,3,9
Keb,gorgonnash,288,shaman,restoration,12,3,9
Fee,silvermoon,288,shaman,restoration,12,3,9
Shammychris,argent-dawn,288,shaman,restoration,12,3,9
Hagelbrakan,stormscale,288,shaman,restoration,12,3,9
Афтршок,soulflayer,288,shaman,restoration,12,3,9
Shamerific,magtheridon,288,shaman,restoration,12,3,9
Shammyenh,burning-legion,288,shaman,restoration,12,3,9
Hobblefoot,stormscale,288,shaman,restoration,12,3,9
Ghanex,tarren-mill,288,shaman,restoration,12,3,9
Mazu,spinebreaker,288,shaman,restoration,12,3,9
Krugx,draenor,288,shaman,restoration,12,3,9
Kandrox,blackmoore,288,shaman,restoration,12,3,9
Ríleyx,twisting-nether,288,shaman,restoration,12,3,9
Thundertail,ragnaros,288,shaman,restoration,12,3,9
Billburr,aegwynn,288,shaman,restoration,12,3,9
Madrävëngodx,ragnaros,288,shaman,restoration,12,3,9
Cragouz,archimonde,288,shaman,restoration,18,3,15
Shankka,ragnaros,288,shaman,restoration,18,3,15
Oggyoggyoggy,outland,288,shaman,restoration,18,3,15
Zeiger,minahonda,287,shaman,restoration,12,3,9
Deeblu,nemesis,287,shaman,restoration,12,3,9
Emansh,twisting-nether,287,shaman,restoration,18,3,15
Rbghêâl,blackrock,287,shaman,restoration,18,3,15
Mimsy,hyjal,285,shaman,restoration,12,3,9
Mitica,ravencrest,276,shaman,restoration,16,7,9
Shamtime,aegwynn,275,shaman,restoration,18,6,12
Shâm,kazzak,271,shaman,restoration,11,3,8
Tonda,stormscale,256,shaman,restoration,4,4,0
Localicious,ragnaros,255,shaman,restoration,11,3,8
Crazypurgeqt,arathor,255,shaman,restoration,17,3,14
Yang,der-rat-von-dalaran,240,shaman,restoration,9,4,5
Kongx,blackhand,239,shaman,restoration,5,3,2
Elliesham,kazzak,239,shaman,restoration,5,3,2
Skoddy,blackmoore,234,shaman,restoration,8,5,3
Silden,thrall,234,shaman,restoration,10,5,5
Æxs,archimonde,234,shaman,restoration,8,4,4
Soyungordoqt,sanguino,234,shaman,restoration,8,4,4
Yukîmøn,hyjal,234,shaman,restoration,11,4,7
Ikó,kazzak,234,shaman,restoration,22,6,16
Drøgøs,dun-modr,234,shaman,restoration,18,4,14
Zinlay,tarren-mill,192,shaman,restoration,6,2,4
Joshan,frostmourne,192,shaman,restoration,6,2,4
Elektrikci,silvermoon,192,shaman,restoration,6,2,4
Noriqt,kazzak,192,shaman,restoration,6,2,4
Pip,outland,192,shaman,restoration,6,2,4
Agatons,twisting-nether,192,shaman,restoration,6,2,4
Hóonda,twisting-nether,192,shaman,restoration,6,2,4
Bumbummann,blackmoore,192,shaman,restoration,6,2,4
Okrall,twisting-nether,192,shaman,restoration,6,2,4
Rihi,twisting-nether,192,shaman,restoration,6,2,4
Booga,tarren-mill,192,shaman,restoration,6,2,4
Pûrge,tarren-mill,192,shaman,restoration,6,2,4
Tonnii,tarren-mill,192,shaman,restoration,6,2,4
Palarins,dalaran,192,shaman,restoration,6,2,4
Marjorie,archimonde,192,shaman,restoration,6,2,4
Huibäm,eredar,192,shaman,restoration,6,2,4
Thornyberrý,outland,192,shaman,restoration,6,2,4
Mitochondria,drakthul,192,shaman,restoration,6,2,4
Renátosz,ragnaros,192,shaman,restoration,6,2,4
Berascendz,argent-dawn,192,shaman,restoration,6,2,4
Lexus,nordrassil,192,shaman,restoration,6,2,4
Kärmá,lightbringer,192,shaman,restoration,6,2,4
Vyrá,onyxia,192,shaman,restoration,6,2,4
Iziisham,outland,192,shaman,restoration,6,2,4
Schmamane,blutkessel,192,shaman,restoration,6,2,4
Hagridheals,silvermoon,192,shaman,restoration,6,2,4
Mëowth,ragnaros,192,shaman,restoration,6,2,4
Baboss,blutkessel,192,shaman,restoration,6,2,4
Wåe,outland,192,shaman,restoration,6,2,4
Oladoda,archimonde,192,shaman,restoration,6,2,4
Pumanii,silvermoon,192,shaman,restoration,6,2,4
Bavalurst,doomhammer,192,shaman,restoration,6,2,4
Cynmaticsx,kargath,192,shaman,restoration,6,2,4
Proccazu,draenor,192,shaman,restoration,6,2,4
Agorasiya,frostwolf,192,shaman,restoration,6,2,4
Sëídhr,arathi,192,shaman,restoration,6,2,4
Fuchserl,aegwynn,192,shaman,restoration,6,2,4
Kevox,malganis,192,shaman,restoration,6,2,4
Doflamingo,aszune,192,shaman,restoration,6,2,4
Nassîî,blackhand,192,shaman,restoration,6,2,4
Kossborax,blackhand,192,shaman,restoration,6,2,4
Imbahlink,draenor,192,shaman,restoration,6,2,4
Chatbanned,blackmoore,192,shaman,restoration,6,2,4
Totemino,silvermoon,192,shaman,restoration,6,2,4
Ludiböris,kazzak,192,shaman,restoration,6,2,4
Sablolix,ravencrest,192,shaman,restoration,6,2,4
Jacquisham,archimonde,192,shaman,restoration,6,2,4
Ünnä,sanguino,192,shaman,restoration,6,2,4
Jsham,blackmoore,192,shaman,restoration,6,2,4
Matsish,sylvanas,192,shaman,restoration,6,2,4
Lêss,ysondre,192,shaman,restoration,6,2,4
Элементаликс,ashenvale,192,shaman,restoration,6,2,4
Smightys,kazzak,192,shaman,restoration,6,2,4
Smorclelx,khadgar,192,shaman,restoration,6,2,4
Демианна,eversong,192,shaman,restoration,6,2,4
Kàji,ravencrest,192,shaman,restoration,6,2,4
Урахарочка,soulflayer,192,shaman,restoration,6,2,4
Тотемо,gordunni,192,shaman,restoration,6,2,4
Southpaw,kult-der-verdammten,192,shaman,restoration,6,2,4
Wahya,stormscale,192,shaman,restoration,6,2,4
Buchânan,archimonde,192,shaman,restoration,6,2,4
Джейджона,soulflayer,192,shaman,restoration,6,2,4
Пучмек,gordunni,192,shaman,restoration,6,2,4
Lausimhaus,blackrock,192,shaman,restoration,6,2,4
Брбртолетчик,soulflayer,192,shaman,restoration,6,2,4
Sàs,zuljin,192,shaman,restoration,6,2,4
Chêlëx,silvermoon,192,shaman,restoration,6,2,4
Rhastasha,archimonde,192,shaman,restoration,6,2,4
Shupp,stormscale,192,shaman,restoration,6,2,4
Nuarishaman,kazzak,192,shaman,restoration,6,2,4
Linkxz,sylvanas,192,shaman,restoration,6,2,4
Gevitomeraw,sylvanas,192,shaman,restoration,6,2,4
Olmaz,ravencrest,192,shaman,restoration,6,2,4
Naneunsanai,jaedenar,192,shaman,restoration,6,2,4
Biggucci,sylvanas,192,shaman,restoration,6,2,4
Pebble,blackrock,192,shaman,restoration,6,2,4
Herru,blackrock,192,shaman,restoration,6,2,4
Nailos,dun-modr,192,shaman,restoration,6,2,4
Reinssay,ysondre,192,shaman,restoration,6,2,4
Ðiezz,ysondre,192,shaman,restoration,6,2,4
Srøgg,archimonde,192,shaman,restoration,6,2,4
Sanxon,blackrock,192,shaman,restoration,6,2,4
Khayac,ravencrest,192,shaman,restoration,6,2,4
Voodude,blackrock,192,shaman,restoration,6,2,4
Anteja,kazzak,192,shaman,restoration,6,2,4
Narevoqi,madmortem,192,shaman,restoration,6,2,4
Noxl,gorgonnash,192,shaman,restoration,6,2,4
Hìrnfrost,blackrock,192,shaman,restoration,6,2,4
Mikhey,archimonde,192,shaman,restoration,6,2,4
Basegrandpa,ravencrest,192,shaman,restoration,6,2,4
Brâshô,frostwolf,192,shaman,restoration,9,2,7
Ninffø,dun-modr,192,shaman,restoration,20,4,16
Dvärgenkajsa,stormreaver,192,shaman,restoration,10,2,8
Saarroo,ravencrest,192,shaman,restoration,12,2,10
Ibicc,twisting-nether,192,shaman,restoration,12,2,10
Ekxr,kazzak,192,shaman,restoration,12,2,10
Zarschu,burning-legion,192,shaman,restoration,12,2,10
Delvanjus,blackrock,192,shaman,restoration,12,2,10
Zeltron,grim-batol,192,shaman,restoration,12,2,10
Thunderjudge,twisting-nether,192,shaman,restoration,12,2,10
Gïzmö,tarren-mill,192,shaman,restoration,12,2,10
Samisu,blackmoore,192,shaman,restoration,12,2,10
Fatflop,sylvanas,192,shaman,restoration,12,2,10
Barean,ravencrest,192,shaman,restoration,12,2,10
Masham,darkspear,192,shaman,restoration,12,2,10
Nashashuk,runetotem,192,shaman,restoration,12,2,10
Nuekx,sanguino,192,shaman,restoration,12,2,10
Otuschsham,blackmoore,192,shaman,restoration,12,2,10
Cptnkirby,malganis,192,shaman,restoration,12,2,10
Soyun,frostwhisper,192,shaman,restoration,12,2,10
Epicoverlord,tarren-mill,192,shaman,restoration,12,2,10
Ezpz,frostmourne,192,shaman,restoration,12,2,10
Ozzlac,thrall,192,shaman,restoration,12,2,10
Zënga,kazzak,192,shaman,restoration,12,2,10
Wuchtzwerg,terrordar,192,shaman,restoration,18,2,16
Kanuw,kilrogg,191,shaman,restoration,6,2,4
Valuriya,blackhand,191,shaman,restoration,6,2,4
Koothe,dun-modr,191,shaman,restoration,6,2,4
Geishablue,defias-brotherhood,191,shaman,restoration,12,2,10
Penumbrah,kazzak,191,shaman,restoration,26,2,24
Андумиэль,soulflayer,190,shaman,restoration,12,2,10
Chaotikos,ravencrest,178,shaman,restoration,12,8,4
Krootox,sunstrider,170,shaman,restoration,18,4,14
Zhangliyi,ravencrest,169,shaman,restoration,9,5,4
Divazena,drakthul,159,shaman,restoration,5,2,3
Ghafo,norgannon,159,shaman,restoration,5,2,3
Nockedly,ragnaros,144,shaman,restoration,9,3,6
Jecastyle,sanguino,138,shaman,restoration,8,3,5
Ruzgork,nerzhul,138,shaman,restoration,9,3,6
Mcgrêgor,aegwynn,138,shaman,restoration,15,4,11
Volstorm,ysondre,138,shaman,restoration,12,3,9
Elunaxcc,eredar,137,shaman,restoration,11,4,7
Kswíss,outland,137,shaman,restoration,9,3,6
Cardenus,los-errantes,137,shaman,restoration,15,3,12
Belldandý,archimonde,128,shaman,restoration,4,2,2
Feetsniffax,outland,128,shaman,restoration,4,2,2
Shamaray,stormscale,127,shaman,restoration,8,2,6
Reflux,outland,96,shaman,restoration,6,1,5
Try,zuluhed,96,shaman,restoration,6,1,5
Swepx,ravencrest,96,shaman,restoration,6,1,5
Hotstorm,bronzebeard,96,shaman,restoration,6,1,5
Poliez,outland,96,shaman,restoration,6,1,5
Sërka,cthun,96,shaman,restoration,6,1,5
Efdemin,blackmoore,96,shaman,restoration,6,1,5
Rahuna,darksorrow,96,shaman,restoration,6,1,5
Fuchifu,eredar,96,shaman,restoration,6,1,5
Cirøsham,ravencrest,96,shaman,restoration,6,1,5
Kostex,rexxar,96,shaman,restoration,6,1,5
Lunarsloth,hyjal,96,shaman,restoration,6,1,5
Kimpa,minahonda,96,shaman,restoration,6,1,5
Cy,aszune,96,shaman,restoration,6,1,5
Moonlanced,aegwynn,96,shaman,restoration,6,1,5
Aguero,aegwynn,96,shaman,restoration,6,1,5
Trymytotems,drakthul,96,shaman,restoration,6,1,5
Justweirdaf,blackmoore,96,shaman,restoration,6,1,5
Andrewbéelko,drakthul,96,shaman,restoration,6,1,5
Radjus,kazzak,96,shaman,restoration,6,1,5
Greenbo,burning-blade,96,shaman,restoration,6,1,5
Cptcutíe,antonidas,96,shaman,restoration,6,1,5
Zethh,antonidas,96,shaman,restoration,6,1,5
Apolomaeuz,frostwolf,96,shaman,restoration,6,1,5
Shoar,twisting-nether,96,shaman,restoration,6,1,5
Jaeslin,tarren-mill,96,shaman,restoration,6,1,5
Zimzalabling,kazzak,96,shaman,restoration,6,1,5
Майайс,gordunni,96,shaman,restoration,6,1,5
Таззикшок,soulflayer,96,shaman,restoration,6,1,5
Geifmeat,kazzak,96,shaman,restoration,6,1,5
Proxjj,stormscale,96,shaman,restoration,6,1,5
Jawoburst,antonidas,96,shaman,restoration,6,1,5
Smorcxx,kazzak,96,shaman,restoration,6,1,5
Elchivo,blackrock,96,shaman,restoration,6,1,5
Chênoya,blackrock,96,shaman,restoration,6,1,5
Dälon,thrall,96,shaman,restoration,6,1,5
Dashakk,frostwhisper,96,shaman,restoration,6,1,5
Stormreach,ragnaros,96,shaman,restoration,6,1,5
Eclaîr,thrall,96,shaman,restoration,6,1,5
Металорд,howling-fjord,96,shaman,restoration,6,1,5
Dvrg,antonidas,96,shaman,restoration,6,1,5
Касьянкочка,blackscar,96,shaman,restoration,6,1,5
Сатангодхх,howling-fjord,96,shaman,restoration,6,1,5
Diabolous,drakthul,96,shaman,restoration,6,1,5
Getahex,draenor,96,shaman,restoration,6,1,5
Cupído,malganis,96,shaman,restoration,6,1,5
Ulfuz,silvermoon,96,shaman,restoration,6,1,5
Shammynox,draenor,96,shaman,restoration,6,1,5
Anieszka,malganis,96,shaman,restoration,6,1,5
Ниарата,greymane,96,shaman,restoration,6,1,5
Tinyboiler,stormscale,96,shaman,restoration,6,1,5
Кермдрог,gordunni,96,shaman,restoration,6,1,5
Yuimhi,sanguino,96,shaman,restoration,7,1,6
Yolototem,drakthul,96,shaman,restoration,9,1,8
Garulf,twisting-nether,96,shaman,restoration,12,1,11
Tiamât,culte-de-la-rive-noire,96,shaman,restoration,12,1,11
Chunkss,argent-dawn,96,shaman,restoration,12,1,11
Freeleys,silvermoon,96,shaman,restoration,12,1,11
Nizty,tarren-mill,96,shaman,restoration,12,1,11
Топмахвелл,soulflayer,96,shaman,restoration,12,1,11
Porre,zuljin,96,shaman,restoration,12,1,11
Íss,cthun,96,shaman,restoration,12,1,11
Akuha,dun-modr,96,shaman,restoration,12,1,11
Anstra,colinas-pardas,96,shaman,restoration,12,1,11
Hugzy,argent-dawn,96,shaman,restoration,12,1,11
Ikeaboy,eredar,96,shaman,restoration,12,1,11
Kvelertak,guldan,96,shaman,restoration,18,1,17
Hairball,turalyon,95,shaman,restoration,6,2,4
Twotwozero,defias-brotherhood,95,shaman,restoration,6,1,5
Taiki,sylvanas,90,shaman,restoration,13,4,9
Jamienisme,ravencrest,79,shaman,restoration,5,1,4
Kungachunga,pozzo-delleternità,79,shaman,restoration,5,1,4
Bursthand,sanguino,79,shaman,restoration,11,1,10
Destrosoul,kazzak,64,shaman,restoration,4,1,3
Nowái,tarren-mill,64,shaman,restoration,4,1,3
Drê,daggerspine,64,shaman,restoration,4,1,3
Rookwave,eredar,64,shaman,restoration,4,1,3
Zourhia,garona,48,shaman,restoration,3,1,2
Oyuun,rajaxx,42,shaman,restoration,11,3,8
Ånný,blackmoore,42,shaman,restoration,11,3,8
Icanbreathe,ravencrest,42,shaman,restoration,9,2,7
Pandatrials,turalyon,42,shaman,restoration,10,2,8
Strikerz,aggra-português,42,shaman,restoration,11,2,9
Shammez,ravencrest,42,shaman,restoration,11,2,9
Søpse,stormscale,42,shaman,restoration,15,2,13
Rngo,blackrock,2366,shaman,elemental,120,73,47
Silden,thrall,2303,shaman,elemental,121,72,49
Mcmxcvi,ravencrest,2293,shaman,elemental,131,81,50
Reibanit,twisting-nether,2284,shaman,elemental,147,86,61
Rungõo,blackrock,2281,shaman,elemental,174,101,73
Eupra,archimonde,2277,shaman,elemental,138,75,63
Shiggenbasta,kazzak,2255,shaman,elemental,90,52,38
Proccit,blackrock,2226,shaman,elemental,90,50,40
Drshock,blackmoore,2220,shaman,elemental,107,56,51
Ghostwolfgg,archimonde,2205,shaman,elemental,132,72,60
Маигваза,soulflayer,2198,shaman,elemental,66,46,20
Lexila,doomhammer,2194,shaman,elemental,394,211,183
Lavaole,blackrock,2185,shaman,elemental,78,42,36
Nyed,hyjal,2183,shaman,elemental,90,50,40
Connecting,hyjal,2171,shaman,elemental,108,56,52
Bärtigeberta,aegwynn,2170,shaman,elemental,102,54,48
Tommybanger,kazzak,2158,shaman,elemental,75,49,26
Shamanazor,twisting-nether,2153,shaman,elemental,66,41,25
Baldcreep,blackrock,2147,shaman,elemental,54,35,19
Space,stormscale,2144,shaman,elemental,126,66,60
Båkka,ysondre,2142,shaman,elemental,60,37,23
Trickful,kazzak,2136,shaman,elemental,60,42,18
Uselesslaso,sanguino,2136,shaman,elemental,117,59,58
Edshearen,stormscale,2127,shaman,elemental,68,42,26
Blyatifulday,malganis,2127,shaman,elemental,96,53,43
Theglue,kilrogg,2124,shaman,elemental,60,36,24
Matmodir,hyjal,2119,shaman,elemental,96,48,48
Autopanne,malganis,2117,shaman,elemental,78,48,30
Guzzelinare,tarren-mill,2115,shaman,elemental,48,30,18
Smorchamp,sanguino,2110,shaman,elemental,84,44,40
Jøhnnwick,archimonde,2106,shaman,elemental,83,47,36
Jøhnwick,ysondre,2103,shaman,elemental,72,39,33
Wisplol,ravencrest,2100,shaman,elemental,255,133,122
Langedinho,stormscale,2091,shaman,elemental,108,57,51
Ìløvêxÿú,ravencrest,2071,shaman,elemental,125,71,54
Pleasehealme,ravencrest,2067,shaman,elemental,42,33,9
Woof,culte-de-la-rive-noire,2037,shaman,elemental,60,32,28
Nokster,twisting-nether,2030,shaman,elemental,110,68,42
Lavayoshi,kazzak,2026,shaman,elemental,72,48,24
Mjorè,twisting-nether,2025,shaman,elemental,97,51,46
Iavalavalava,tarren-mill,2025,shaman,elemental,96,46,50
Satisfya,ambossar,2006,shaman,elemental,286,150,136
Eyi,ambossar,2005,shaman,elemental,92,50,42
Punished,blackrock,2000,shaman,elemental,107,62,45
Rottulos,stormrage,2000,shaman,elemental,60,33,27
Murdá,ravencrest,1999,shaman,elemental,90,43,47
Kärríegold,blackrock,1987,shaman,elemental,285,151,134
Onceinalife,ambossar,1978,shaman,elemental,155,83,72
Raintlordx,twisting-nether,1971,shaman,elemental,36,30,6
Бпокбастэр,gordunni,1970,shaman,elemental,69,40,29
Blackyx,cthun,1969,shaman,elemental,60,39,21
Thyeori,stormscale,1969,shaman,elemental,54,29,25
Shrmful,dun-modr,1964,shaman,elemental,47,32,15
Euprâ,archimonde,1964,shaman,elemental,53,31,22
Suldaro,aegwynn,1964,shaman,elemental,73,39,34
Jelvin,tarren-mill,1963,shaman,elemental,84,43,41
Houmpf,hyjal,1962,shaman,elemental,60,33,27
Pipousham,blackhand,1954,shaman,elemental,47,26,21
Pheazka,outland,1950,shaman,elemental,71,37,34
Élé,twisting-nether,1950,shaman,elemental,72,37,35
Elejizz,kazzak,1948,shaman,elemental,42,22,20
Kenaz,outland,1943,shaman,elemental,55,29,26
Haumx,blackrock,1938,shaman,elemental,102,51,51
Starelement,draenor,1938,shaman,elemental,72,30,42
Mèåtbåll,ravencrest,1935,shaman,elemental,59,36,23
Nevershearx,blackrock,1934,shaman,elemental,54,28,26
Nekhros,sargeras,1931,shaman,elemental,193,104,89
Teslashock,outland,1929,shaman,elemental,48,29,19
Штормкрашер,howling-fjord,1910,shaman,elemental,90,50,40
Anqe,twisting-nether,1910,shaman,elemental,114,62,52
Çð,ravencrest,1909,shaman,elemental,36,20,16
Matmonai,hyjal,1908,shaman,elemental,72,34,38
Dakyele,ravencrest,1902,shaman,elemental,59,32,27
Agrero,auchindoun,1897,shaman,elemental,108,52,56
Totemlié,ravencrest,1887,shaman,elemental,42,27,15
Elegodx,ravencrest,1885,shaman,elemental,59,34,25
Healyoa,blackmoore,1882,shaman,elemental,189,95,94
Gungo,deathwing,1880,shaman,elemental,36,20,16
Obryss,tarren-mill,1876,shaman,elemental,36,20,16
Psyku,outland,1875,shaman,elemental,42,20,22
Хеллбат,howling-fjord,1869,shaman,elemental,36,24,12
Paulbaniel,alonsus,1868,shaman,elemental,72,34,38
Midgetnatty,ravencrest,1867,shaman,elemental,70,39,31
Jacklupin,ravencrest,1867,shaman,elemental,48,25,23
Pxsquals,ravencrest,1863,shaman,elemental,72,40,32
Naskezz,kazzak,1863,shaman,elemental,131,66,65
Cïgänää,archimonde,1862,shaman,elemental,44,26,18
Monsuunibaba,tarren-mill,1861,shaman,elemental,57,31,26
Borbor,argent-dawn,1858,shaman,elemental,46,23,23
Flanax,hyjal,1852,shaman,elemental,78,44,34
Tellý,blackmoore,1846,shaman,elemental,53,31,22
Dretch,dun-morogh,1844,shaman,elemental,42,22,20
Eppîx,lightnings-blade,1844,shaman,elemental,58,29,29
Georgewhat,defias-brotherhood,1843,shaman,elemental,75,39,36
Lilmarco,stormreaver,1843,shaman,elemental,72,35,37
Sajma,silvermoon,1842,shaman,elemental,57,40,17
Eledelede,blackhand,1842,shaman,elemental,54,30,24
Owrly,stormscale,1841,shaman,elemental,185,92,93
Tasoro,sanguino,1840,shaman,elemental,71,34,37
Preshear,twisting-nether,1835,shaman,elemental,35,26,9
Doyah,eredar,1834,shaman,elemental,54,33,21
Bambustic,kazzak,1833,shaman,elemental,41,25,16
Dräpàrn,sylvanas,1833,shaman,elemental,60,32,28
Crazyshaman,ravencrest,1829,shaman,elemental,53,26,27
Hugebuttman,silvermoon,1829,shaman,elemental,78,37,41
Slogic,tarren-mill,1828,shaman,elemental,71,34,37
Crespó,alakir,1827,shaman,elemental,54,25,29
Transcendent,malorne,1826,shaman,elemental,84,63,21
Hazardhenry,argent-dawn,1826,shaman,elemental,42,30,12
Sourens,twisting-nether,1826,shaman,elemental,92,48,44
Kæzx,blackrock,1822,shaman,elemental,78,45,33
Ejx,arthas,1821,shaman,elemental,52,30,22
Novoz,ysondre,1819,shaman,elemental,59,31,28
Lavaproc,burning-legion,1817,shaman,elemental,48,28,20
Инимал,deathweaver,1817,shaman,elemental,36,21,15
Raknoxye,blackrock,1816,shaman,elemental,36,28,8
Achtungblitz,blackrock,1813,shaman,elemental,42,33,9
Stickix,malganis,1812,shaman,elemental,54,32,22
Chamel,draenor,1808,shaman,elemental,30,19,11
Kailash,defias-brotherhood,1808,shaman,elemental,54,26,28
Procc,nordrassil,1807,shaman,elemental,42,28,14
Faridstreng,blackmoore,1807,shaman,elemental,60,39,21
Smorclelx,khadgar,1807,shaman,elemental,158,83,75
Nykhara,sanguino,1805,shaman,elemental,54,30,24
Valgø,twisting-nether,1802,shaman,elemental,180,102,78
Barbarra,stormscale,1802,shaman,elemental,54,28,26
Lianitus,tarren-mill,1802,shaman,elemental,58,30,28
Nyzo,tarren-mill,1802,shaman,elemental,48,23,25
Burstraze,tarren-mill,1801,shaman,elemental,58,32,26
Nowmack,archimonde,1800,shaman,elemental,30,22,8
Spajry,drakthul,1800,shaman,elemental,48,32,16
Nalaadu,stormscale,1800,shaman,elemental,42,26,16
Йодаримару,howling-fjord,1796,shaman,elemental,42,22,20
Psÿkz,kazzak,1790,shaman,elemental,57,25,32
ßakingsoda,tarren-mill,1788,shaman,elemental,48,30,18
Thriveqt,nemesis,1787,shaman,elemental,60,28,32
Pitsamestari,frostmane,1780,shaman,elemental,122,68,54
Suirz,dun-modr,1774,shaman,elemental,59,40,19
Zaledria,argent-dawn,1770,shaman,elemental,54,35,19
Hothand,thrall,1764,shaman,elemental,42,21,21
Volcanò,outland,1763,shaman,elemental,193,95,98
Sunsong,twisting-nether,1757,shaman,elemental,84,49,35
Bûsta,ravencrest,1754,shaman,elemental,36,19,17
Шумноватт,howling-fjord,1753,shaman,elemental,48,23,25
Voydetesto,sanguino,1753,shaman,elemental,84,39,45
Ryysham,ravencrest,1749,shaman,elemental,98,51,47
Rungozvs,blackrock,1745,shaman,elemental,42,25,17
Korvsnärten,outland,1745,shaman,elemental,42,21,21
Seriux,twisting-nether,1744,shaman,elemental,60,40,20
Feetenjoyerx,kazzak,1740,shaman,elemental,50,27,23
Earthhulk,thrall,1739,shaman,elemental,42,27,15
Earthtjockis,ragnaros,1739,shaman,elemental,41,20,21
Prêxy,kazzak,1737,shaman,elemental,49,22,27
Карбонатрикс,soulflayer,1736,shaman,elemental,53,30,23
Mishoshamana,tarren-mill,1733,shaman,elemental,95,54,41
Lsdx,silvermoon,1731,shaman,elemental,42,25,17
Yiiro,argent-dawn,1730,shaman,elemental,48,26,22
Ungabungha,stormscale,1728,shaman,elemental,145,82,63
Hanatopikeur,grim-batol,1728,shaman,elemental,35,19,16
Djlavaburst,malganis,1728,shaman,elemental,263,129,134
Firella,the-maelstrom,1727,shaman,elemental,34,19,15
Daubidaubi,kazzak,1722,shaman,elemental,39,26,13
Matmons,hyjal,1721,shaman,elemental,37,18,19
Starpior,stormscale,1721,shaman,elemental,65,30,35
Ronfroggo,kazzak,1716,shaman,elemental,46,25,21
Fabslx,archimonde,1715,shaman,elemental,117,50,67
Jamzyshaman,emerald-dream,1713,shaman,elemental,30,19,11
Totemlyhot,blackrock,1713,shaman,elemental,48,28,20
Nöyrä,argent-dawn,1710,shaman,elemental,36,25,11
Xtremeshaman,blackmoore,1709,shaman,elemental,24,18,6
Sheamanus,ravencrest,1706,shaman,elemental,48,29,19
Cylantarus,blackrock,1705,shaman,elemental,36,25,11
Дашажмихекс,howling-fjord,1704,shaman,elemental,42,24,18
Чойсе,deathguard,1704,shaman,elemental,102,50,52
Lantbruk,twisting-nether,1703,shaman,elemental,49,28,21
Зэстус,soulflayer,1702,shaman,elemental,83,47,36
Farùk,ravencrest,1701,shaman,elemental,39,24,15
Obesisham,outland,1699,shaman,elemental,60,24,36
Horizons,the-maelstrom,1692,shaman,elemental,30,18,12
Cismine,twisting-nether,1690,shaman,elemental,42,28,14
Lavatherapy,grim-batol,1689,shaman,elemental,66,37,29
Braíntas,norgannon,1686,shaman,elemental,84,39,45
Ogrodi,burning-legion,1685,shaman,elemental,54,31,23
Ðreamz,kaelthas,1685,shaman,elemental,48,23,25
Chênoya,blackrock,1684,shaman,elemental,73,30,43
Adamyo,stormscale,1683,shaman,elemental,48,23,25
Sáàd,ravencrest,1681,shaman,elemental,42,20,22
Xorron,archimonde,1680,shaman,elemental,131,61,70
Nëllaqt,archimonde,1678,shaman,elemental,36,18,18
Kohnân,hyjal,1675,shaman,elemental,78,39,39
Wylly,aegwynn,1672,shaman,elemental,134,71,63
Xelphia,frostmane,1670,shaman,elemental,53,22,31
Vanrake,ravencrest,1669,shaman,elemental,109,62,47
Milotem,ysondre,1669,shaman,elemental,48,26,22
Mércander,kazzak,1668,shaman,elemental,36,23,13
Козаностро,howling-fjord,1668,shaman,elemental,30,19,11
Targoel,blackmoore,1668,shaman,elemental,109,54,55
Mezzoblu,sanguino,1667,shaman,elemental,210,110,100
Regnever,draenor,1667,shaman,elemental,125,53,72
Esal,blackrock,1665,shaman,elemental,31,21,10
Fellatia,baelgun,1665,shaman,elemental,54,36,18
Çð,twisting-nether,1661,shaman,elemental,41,23,18
Smashz,stormscale,1661,shaman,elemental,81,44,37
Elrayitos,shendralar,1659,shaman,elemental,114,63,51
Daemp,draenor,1658,shaman,elemental,24,18,6
Agreró,auchindoun,1658,shaman,elemental,27,19,8
Solosüper,ravencrest,1657,shaman,elemental,48,24,24
Kapïtão,aggra-português,1656,shaman,elemental,48,27,21
Lavalava,blackmoore,1656,shaman,elemental,60,33,27
Shamatto,nemesis,1654,shaman,elemental,64,42,22
Мэморисс,gordunni,1652,shaman,elemental,44,23,21
Hotsincezero,archimonde,1651,shaman,elemental,53,36,17
Deeck,ravencrest,1651,shaman,elemental,83,53,30
Malybou,ysondre,1651,shaman,elemental,36,18,18
Электро,thermaplugg,1648,shaman,elemental,47,24,23
Aureo,dun-modr,1644,shaman,elemental,34,20,14
Милфшама,blackscar,1643,shaman,elemental,47,26,21
Афтршок,soulflayer,1643,shaman,elemental,51,26,25
Zest,hyjal,1643,shaman,elemental,59,28,31
Axahavregryn,kazzak,1640,shaman,elemental,66,40,26
Urshak,alleria,1639,shaman,elemental,36,24,12
Zaarok,voljin,1639,shaman,elemental,91,41,50
Liluzivert,mannoroth,1638,shaman,elemental,77,40,37
Reignisover,silvermoon,1637,shaman,elemental,51,32,19
Кирагаз,gordunni,1637,shaman,elemental,64,32,32
Thorleíf,silvermoon,1636,shaman,elemental,90,42,48
Proccq,twisting-nether,1632,shaman,elemental,34,18,16
Qualitydoge,kazzak,1631,shaman,elemental,24,17,7
Shocknrun,sylvanas,1630,shaman,elemental,48,22,26
Tteïl,archimonde,1629,shaman,elemental,54,30,24
Hotis,onyxia,1629,shaman,elemental,88,43,45
Rrtyui,twisting-nether,1628,shaman,elemental,30,17,13
Shåmssagat,kazzak,1627,shaman,elemental,36,17,19
Huyø,stormscale,1625,shaman,elemental,90,40,50
Davinshhe,kazzak,1623,shaman,elemental,48,21,27
Testpapi,twisting-nether,1618,shaman,elemental,75,42,33
Løun,archimonde,1618,shaman,elemental,72,40,32
Vivaldi,varimathras,1618,shaman,elemental,96,42,54
Microb,blackmoore,1617,shaman,elemental,54,29,25
Vamali,draenor,1614,shaman,elemental,48,23,25
Basiletta,hyjal,1613,shaman,elemental,49,34,15
Zengã,kazzak,1613,shaman,elemental,71,30,41
Ânuk,blackrock,1612,shaman,elemental,162,78,84
Wàve,stormscale,1611,shaman,elemental,60,29,31
Ангустиа,galakrond,1610,shaman,elemental,29,20,9
Kemurus,kazzak,1610,shaman,elemental,77,42,35
Gammeldunder,shattered-hand,1610,shaman,elemental,53,22,31
Oneßuttøn,ravencrest,1609,shaman,elemental,42,20,22
Exxco,aegwynn,1606,shaman,elemental,29,20,9
Sházz,dun-modr,1606,shaman,elemental,47,25,22
Кислаябуба,howling-fjord,1606,shaman,elemental,36,17,19
Bigfrigid,outland,1606,shaman,elemental,54,24,30
Aviciix,sanguino,1605,shaman,elemental,84,36,48
Muscade,silvermoon,1604,shaman,elemental,30,22,8
Drainergødx,ragnaros,1604,shaman,elemental,54,29,25
Зиленый,soulflayer,1604,shaman,elemental,42,22,20
Vorteas,burning-blade,1603,shaman,elemental,36,20,16
Mcbloob,kazzak,1602,shaman,elemental,70,36,34
Naphe,ysondre,1602,shaman,elemental,59,27,32
Kilazz,twisting-nether,1598,shaman,elemental,36,19,17
Murmelï,stormreaver,1597,shaman,elemental,24,18,6
Neotrax,outland,1597,shaman,elemental,78,41,37
Elektron,malganis,1597,shaman,elemental,90,46,44
Jâydizzle,draenor,1594,shaman,elemental,101,42,59
Gúîtårgøð,sanguino,1592,shaman,elemental,42,21,21
Mariomental,draenor,1591,shaman,elemental,42,20,22
Johncoltrane,archimonde,1589,shaman,elemental,30,23,7
Ryhèn,stormscale,1586,shaman,elemental,54,30,24
Zðhan,azshara,1586,shaman,elemental,55,27,28
Гудлаик,soulflayer,1584,shaman,elemental,64,35,29
Essneces,burning-legion,1583,shaman,elemental,42,23,19
Porthex,kazzak,1582,shaman,elemental,30,18,12
Zoomar,tarren-mill,1582,shaman,elemental,60,29,31
Kankxx,stormscale,1580,shaman,elemental,30,18,12
Мистеркутёж,gordunni,1580,shaman,elemental,88,46,42
Baarona,neptulon,1577,shaman,elemental,51,30,21
Headthirst,ragnaros,1576,shaman,elemental,44,24,20
Anøüchkä,ysondre,1575,shaman,elemental,48,24,24
Shibol,ravencrest,1575,shaman,elemental,61,29,32
Brugdar,tarren-mill,1574,shaman,elemental,30,22,8
Shammyammy,tarren-mill,1574,shaman,elemental,111,61,50
Twiva,silvermoon,1572,shaman,elemental,76,45,31
Blízzilassø,malygos,1572,shaman,elemental,179,93,86
Ezala,blackhand,1571,shaman,elemental,48,26,22
Гивми,blackscar,1567,shaman,elemental,40,21,19
Тмх,ashenvale,1566,shaman,elemental,94,52,42
Qwilfish,blackmoore,1566,shaman,elemental,65,34,31
Valunii,lordaeron,1566,shaman,elemental,279,136,143
Fakehex,blackrock,1565,shaman,elemental,59,32,27
Robofat,ravencrest,1564,shaman,elemental,36,21,15
Magnetoe,ravencrest,1564,shaman,elemental,105,57,48
Тессельхоф,howling-fjord,1564,shaman,elemental,46,23,23
Naorgot,uldaman,1563,shaman,elemental,138,61,77
Ласара,eversong,1562,shaman,elemental,48,22,26
Grende,sylvanas,1561,shaman,elemental,63,35,28
Òoòoòoòoòoòo,silvermoon,1559,shaman,elemental,54,24,30
Harod,suramar,1558,shaman,elemental,72,37,35
Hapkin,defias-brotherhood,1558,shaman,elemental,54,27,27
Ринфан,fordragon,1558,shaman,elemental,40,20,20
Canjo,aegwynn,1557,shaman,elemental,69,36,33
Chinozukems,sanguino,1555,shaman,elemental,54,27,27
Jímmy,frostwhisper,1548,shaman,elemental,54,34,20
Fattmorte,hyjal,1547,shaman,elemental,27,19,8
Waaghbozz,eredar,1547,shaman,elemental,66,38,28
Nachtary,blackmoore,1544,shaman,elemental,59,32,27
Incredibade,stormscale,1542,shaman,elemental,36,20,16
Acces,stormscale,1541,shaman,elemental,36,23,13
Batan,kazzak,1535,shaman,elemental,71,31,40
Дестройбэйби,gordunni,1533,shaman,elemental,102,58,44
Zimtmann,teldrassil,1521,shaman,elemental,36,22,14
Cloony,khaz-modan,1519,shaman,elemental,33,21,12
Máui,korgall,1518,shaman,elemental,96,49,47
Fúth,ysondre,1516,shaman,elemental,64,34,30
Zna,archimonde,1513,shaman,elemental,94,48,46
Касикандрэра,soulflayer,1512,shaman,elemental,284,148,136
Belsazar,frostwolf,1511,shaman,elemental,48,20,28
Тыщатристах,howling-fjord,1505,shaman,elemental,56,38,18
Sgf,stormscale,1504,shaman,elemental,65,36,29
Crysenshocks,blackrock,1504,shaman,elemental,60,30,30
Diaba,sylvanas,1499,shaman,elemental,30,16,14
Cracklord,outland,1496,shaman,elemental,36,21,15
Naturexz,silvermoon,1495,shaman,elemental,32,18,14
Gorpdorp,ravencrest,1491,shaman,elemental,183,97,86
Voltyum,zuljin,1490,shaman,elemental,93,38,55
Думсия,gordunni,1489,shaman,elemental,48,23,25
Thebomber,guldan,1488,shaman,elemental,48,17,31
Sniffix,ysondre,1482,shaman,elemental,139,68,71
Rennji,argent-dawn,1482,shaman,elemental,84,40,44
Haasshaman,ravencrest,1480,shaman,elemental,121,50,71
Thazra,zirkel-des-cenarius,1478,shaman,elemental,47,24,23
Shaakez,kazzak,1476,shaman,elemental,35,17,18
Mö,ragnaros,1473,shaman,elemental,189,104,85
Oldaang,ravencrest,1470,shaman,elemental,30,23,7
Ralokar,blackrock,1465,shaman,elemental,48,25,23
Хэйзл,ashenvale,1463,shaman,elemental,74,39,35
Yang,der-rat-von-dalaran,1462,shaman,elemental,30,19,11
Pórçé,shattered-hand,1462,shaman,elemental,149,80,69
Smort,frostwolf,1462,shaman,elemental,36,17,19
Dzielnysham,silvermoon,1461,shaman,elemental,32,19,13
Vulcainn,marécage-de-zangar,1460,shaman,elemental,105,68,37
Bigrambo,draenor,1460,shaman,elemental,41,20,21
Faydasizsham,twisting-nether,1459,shaman,elemental,62,33,29
Teccatwo,outland,1458,shaman,elemental,52,28,24
Гексанол,soulflayer,1457,shaman,elemental,58,30,28
Шамвкроксах,gordunni,1456,shaman,elemental,36,19,17
Grimtol,magtheridon,1455,shaman,elemental,47,20,27
Mikecrybaby,tarren-mill,1454,shaman,elemental,36,16,20
Alwaysangry,silvermoon,1453,shaman,elemental,84,41,43
Fotmglad,blackrock,1452,shaman,elemental,34,16,18
Томёрк,gordunni,1448,shaman,elemental,118,55,63
Dawzed,hyjal,1443,shaman,elemental,36,21,15
Lizoo,ravencrest,1439,shaman,elemental,18,15,3
Hemradi,blackmoore,1438,shaman,elemental,48,28,20
Flubberman,blackrock,1438,shaman,elemental,51,28,23
Экслайнер,deathweaver,1438,shaman,elemental,47,19,28
Thëtis,chogall,1434,shaman,elemental,28,16,12
Ædshearan,blackmoore,1434,shaman,elemental,60,30,30
Tukino,burning-legion,1433,shaman,elemental,24,15,9
Ашьф,gordunni,1433,shaman,elemental,39,17,22
Anubisll,hyjal,1431,shaman,elemental,46,24,22
Chøurøx,hyjal,1430,shaman,elemental,49,30,19
Rekhtar,burning-legion,1430,shaman,elemental,145,81,64
Skrbkic,tarren-mill,1429,shaman,elemental,91,48,43
Lêmberger,eredar,1429,shaman,elemental,42,22,20
Amanishama,twisting-nether,1426,shaman,elemental,84,46,38
Aspên,archimonde,1426,shaman,elemental,30,15,15
Тагтар,howling-fjord,1426,shaman,elemental,45,19,26
Lafia,blackrock,1425,shaman,elemental,90,36,54
Aylar,zenedar,1424,shaman,elemental,24,15,9
Ulfuz,silvermoon,1424,shaman,elemental,28,17,11
Ríleyx,twisting-nether,1423,shaman,elemental,83,53,30
Ogkûshgödx,sylvanas,1423,shaman,elemental,24,15,9
Alèks,forscherliga,1418,shaman,elemental,107,62,45
Лартисс,howling-fjord,1417,shaman,elemental,30,15,15
Elexuz,blackrock,1416,shaman,elemental,24,15,9
Xesti,twisting-nether,1414,shaman,elemental,75,39,36
Shôcopan,los-errantes,1412,shaman,elemental,61,24,37
Elemefayo,outland,1410,shaman,elemental,54,28,26
Tvådje,silvermoon,1407,shaman,elemental,29,16,13
Gensehaut,aegwynn,1407,shaman,elemental,48,22,26
Ulfax,argent-dawn,1401,shaman,elemental,66,27,39
Støya,archimonde,1400,shaman,elemental,48,18,30
Athul,theradras,1399,shaman,elemental,49,24,25
Ðãvê,veknilash,1399,shaman,elemental,42,17,25
Kimpa,minahonda,1393,shaman,elemental,78,44,34
Torouk,rashgarroth,1393,shaman,elemental,30,16,14
Rharhahra,archimonde,1393,shaman,elemental,66,23,43
Coñfrico,tarren-mill,1391,shaman,elemental,48,22,26
Сепич,gordunni,1389,shaman,elemental,54,32,22
Apolomaeuz,frostwolf,1388,shaman,elemental,83,45,38
Couldar,stormscale,1386,shaman,elemental,42,23,19
Kirak,anetheron,1385,shaman,elemental,177,90,87
Spruehkot,aegwynn,1382,shaman,elemental,27,16,11
Furrymane,blackmoore,1382,shaman,elemental,51,27,24
Whome,aegwynn,1377,shaman,elemental,42,22,20
Rohknar,ragnaros,1374,shaman,elemental,30,17,13
Superkee,kazzak,1374,shaman,elemental,203,111,92
Novka,eredar,1374,shaman,elemental,47,22,25
Carusø,thrall,1373,shaman,elemental,61,39,22
Alfang,turalyon,1373,shaman,elemental,81,38,43
Vladraxes,draenor,1372,shaman,elemental,30,20,10
Xhahal,hyjal,1364,shaman,elemental,30,21,9
Teslasenpai,outland,1361,shaman,elemental,48,16,32
Lavabelly,twisting-nether,1359,shaman,elemental,42,16,26
Sojee,ysondre,1356,shaman,elemental,48,21,27
Urinja,outland,1354,shaman,elemental,36,20,16
Yezu,medivh,1354,shaman,elemental,60,28,32
Raigetsu,kazzak,1352,shaman,elemental,56,31,25
Sunraiser,blackmoore,1349,shaman,elemental,67,36,31
Rawside,thrall,1349,shaman,elemental,34,16,18
Руннольв,galakrond,1347,shaman,elemental,36,17,19
Tempest,kul-tiras,1346,shaman,elemental,41,23,18
Blancc,kazzak,1346,shaman,elemental,84,47,37
Bangou,archimonde,1344,shaman,elemental,79,38,41
Tâsty,blackmoore,1343,shaman,elemental,24,14,10
Volhalo,blackmoore,1343,shaman,elemental,24,14,10
Шутках,gordunni,1343,shaman,elemental,30,14,16
Херург,soulflayer,1342,shaman,elemental,30,14,16
Iraterrørist,kazzak,1340,shaman,elemental,30,14,16
Флоррэт,gordunni,1338,shaman,elemental,126,57,69
Sshaasam,tarren-mill,1337,shaman,elemental,24,14,10
Альтегро,blackscar,1337,shaman,elemental,55,29,26
Bâllz,anetheron,1335,shaman,elemental,135,64,71
Fâro,dun-modr,1335,shaman,elemental,41,18,23
Rakzhaza,blackmoore,1331,shaman,elemental,42,20,22
Saqerr,kazzak,1330,shaman,elemental,53,20,33
Крто,thermaplugg,1329,shaman,elemental,161,87,74
Olawizard,draenor,1328,shaman,elemental,49,22,27
Nerekiclej,ravencrest,1327,shaman,elemental,47,23,24
Voymir,kazzak,1323,shaman,elemental,24,15,9
Screwz,archimonde,1322,shaman,elemental,79,38,41
Faeldar,sanguino,1318,shaman,elemental,30,14,16
Талиесин,grom,1317,shaman,elemental,32,19,13
Краоми,soulflayer,1312,shaman,elemental,24,15,9
Nolawii,ragnaros,1312,shaman,elemental,24,14,10
Navyblue,sylvanas,1311,shaman,elemental,30,14,16
Doneteasy,blackrock,1310,shaman,elemental,52,24,28
Сосмыслом,howling-fjord,1310,shaman,elemental,48,20,28
Lavastriker,archimonde,1307,shaman,elemental,36,18,18
Pakwa,drakthul,1306,shaman,elemental,34,15,19
Klicken,tarren-mill,1302,shaman,elemental,23,14,9
Lavamann,blackmoore,1295,shaman,elemental,42,20,22
Enamo,blackrock,1293,shaman,elemental,23,14,9
Elshifotrem,throkferoth,1293,shaman,elemental,58,31,27
Dropdattotem,stormscale,1292,shaman,elemental,54,23,31
Griins,ravencrest,1289,shaman,elemental,36,20,16
Hatyatya,ragnaros,1284,shaman,elemental,30,16,14
Snusyy,ravencrest,1279,shaman,elemental,26,14,12
Xfiles,garona,1278,shaman,elemental,48,24,24
Onlyfansmod,uldum,1278,shaman,elemental,65,28,37
Tiqle,blackmoore,1277,shaman,elemental,65,31,34
Ankzul,exodar,1273,shaman,elemental,62,24,38
Destructør,norgannon,1268,shaman,elemental,42,20,22
Dëlkö,ravencrest,1267,shaman,elemental,80,37,43
Lechirurgien,elune,1264,shaman,elemental,159,79,80
Zbysiu,ravencrest,1258,shaman,elemental,51,28,23
Élémentyum,archimonde,1258,shaman,elemental,66,28,38
Leash,blackmoore,1257,shaman,elemental,30,14,16
Zapper,blackrock,1256,shaman,elemental,36,15,21
Zanyun,burning-legion,1256,shaman,elemental,38,14,24
Цет,soulflayer,1255,shaman,elemental,23,15,8
Mynutz,outland,1255,shaman,elemental,54,18,36
Noyá,argent-dawn,1252,shaman,elemental,57,27,30
Blackyx,dun-modr,1247,shaman,elemental,18,13,5
Сарцек,howling-fjord,1247,shaman,elemental,60,35,25
Plazmorc,stormscale,1247,shaman,elemental,24,13,11
Bloodseeker,tarren-mill,1247,shaman,elemental,24,13,11
Shiranoye,blackrock,1247,shaman,elemental,30,13,17
Blush,blackhand,1247,shaman,elemental,33,14,19
Rolftheswine,defias-brotherhood,1246,shaman,elemental,18,13,5
Ludo,lothar,1246,shaman,elemental,22,14,8
Kelvok,silvermoon,1246,shaman,elemental,24,13,11
Xiomora,argent-dawn,1246,shaman,elemental,27,14,13
Quizx,blackrock,1245,shaman,elemental,60,25,35
Fullavaids,grim-batol,1243,shaman,elemental,24,13,11
Xereús,kazzak,1243,shaman,elemental,34,14,20
Maggoshishi,blackmoore,1242,shaman,elemental,126,65,61
Djogg,sunstrider,1241,shaman,elemental,30,13,17
Gagné,hyjal,1239,shaman,elemental,24,13,11
Pawsh,dun-modr,1238,shaman,elemental,51,24,27
Makgoa,ysondre,1237,shaman,elemental,18,13,5
Лукаджун,howling-fjord,1231,shaman,elemental,18,13,5
Denadrios,blackhand,1228,shaman,elemental,82,34,48
Sniffa,ysondre,1226,shaman,elemental,30,16,14
Бумбумпаузр,borean-tundra,1226,shaman,elemental,42,13,29
Bigheal,quelthalas,1222,shaman,elemental,30,13,17
Shamíz,draenor,1219,shaman,elemental,36,21,15
Waterboi,blackmoore,1219,shaman,elemental,24,13,11
Aldonatello,blackrock,1219,shaman,elemental,82,40,42
Foxxyluv,stormscale,1215,shaman,elemental,20,14,6
Tiamât,culte-de-la-rive-noire,1215,shaman,elemental,66,34,32
Champïx,archimonde,1212,shaman,elemental,51,16,35
Tehpielover,bladefist,1211,shaman,elemental,28,15,13
Меменосный,gordunni,1211,shaman,elemental,42,20,22
Saarroo,ravencrest,1210,shaman,elemental,48,22,26
Skeiilz,hyjal,1208,shaman,elemental,36,13,23
Roxìe,blackmoore,1207,shaman,elemental,18,13,5
Bigboisham,outland,1202,shaman,elemental,65,28,37
Shamanns,lordaeron,1198,shaman,elemental,60,19,41
Pvpshaman,aszune,1195,shaman,elemental,29,13,16
Märthalouise,twisting-nether,1191,shaman,elemental,29,15,14
Scot,blackhand,1191,shaman,elemental,29,13,16
Charliiejoh,stormscale,1190,shaman,elemental,86,39,47
Valdera,dun-morogh,1189,shaman,elemental,24,14,10
Magath,nethersturm,1188,shaman,elemental,36,17,19
Chispa,darkmoon-faire,1187,shaman,elemental,23,13,10
Zalitz,sanguino,1186,shaman,elemental,24,13,11
Mòra,silvermoon,1183,shaman,elemental,68,32,36
Boiblaster,argent-dawn,1182,shaman,elemental,17,13,4
Zerodown,outland,1181,shaman,elemental,84,38,46
Scurvy,malganis,1179,shaman,elemental,128,66,62
Amarök,nerzhul,1177,shaman,elemental,65,30,35
Blackmuamba,tarren-mill,1173,shaman,elemental,120,60,60
Szvapotluk,ravencrest,1173,shaman,elemental,30,14,16
Nabo,archimonde,1173,shaman,elemental,32,13,19
Kungfuali,antonidas,1168,shaman,elemental,34,14,20
Zhinjo,kazzak,1166,shaman,elemental,36,19,17
Фистинктотем,soulflayer,1162,shaman,elemental,35,16,19
Амброски,gordunni,1161,shaman,elemental,42,28,14
Велгур,soulflayer,1161,shaman,elemental,50,23,27
Эфирад,blackscar,1157,shaman,elemental,133,64,69
Shellex,kazzak,1153,shaman,elemental,74,40,34
Azmerloth,outland,1152,shaman,elemental,18,12,6
Luchø,drakthul,1151,shaman,elemental,18,12,6
Дудивтф,soulflayer,1151,shaman,elemental,24,12,12
Neverplayele,kazzak,1151,shaman,elemental,24,12,12
Nobrac,rajaxx,1150,shaman,elemental,24,12,12
Stromdi,azshara,1149,shaman,elemental,22,13,9
Haarold,sylvanas,1149,shaman,elemental,24,12,12
Gojõ,dun-modr,1149,shaman,elemental,30,12,18
Justweirdaf,blackmoore,1148,shaman,elemental,45,20,25
Eðualc,hyjal,1147,shaman,elemental,18,12,6
Legended,tarren-mill,1147,shaman,elemental,24,12,12
Beefnale,bladefist,1147,shaman,elemental,42,14,28
Дзод,deathweaver,1146,shaman,elemental,24,12,12
Дваллинн,gordunni,1142,shaman,elemental,30,12,18
Unding,azshara,1138,shaman,elemental,42,12,30
Boxo,frostwolf,1137,shaman,elemental,70,38,32
Bahuq,antonidas,1134,shaman,elemental,18,12,6
Djent,outland,1133,shaman,elemental,24,12,12
Смоуктли,howling-fjord,1125,shaman,elemental,24,12,12
Bowtenstorm,ravencrest,1120,shaman,elemental,25,16,9
Peaksh,stormscale,1118,shaman,elemental,30,12,18
Mohàwk,eredar,1114,shaman,elemental,36,17,19
Homesickx,blackrock,1109,shaman,elemental,23,12,11
Gnark,dun-modr,1105,shaman,elemental,59,32,27
Бвансамдив,gordunni,1093,shaman,elemental,54,24,30
Озверею,goldrinn,1090,shaman,elemental,24,14,10
Kneggebrot,blackmoore,1090,shaman,elemental,27,13,14
Jagblade,neptulon,1089,shaman,elemental,46,23,23
Pedrototem,silvermoon,1071,shaman,elemental,30,19,11
Fàkecast,outland,1064,shaman,elemental,34,12,22
Cleandann,stormscale,1063,shaman,elemental,27,12,15
Procdaddy,eredar,1063,shaman,elemental,56,15,41
Nïà,kaelthas,1062,shaman,elemental,38,15,23
Thunderrbob,darkspear,1059,shaman,elemental,24,14,10
Trixxsham,twisting-nether,1056,shaman,elemental,18,11,7
Dòrfy,silvermoon,1056,shaman,elemental,18,11,7
Replicusele,doomhammer,1056,shaman,elemental,18,11,7
Tornado,ravencrest,1056,shaman,elemental,18,11,7
Øwlïshâm,archimonde,1056,shaman,elemental,18,11,7
Garythos,drakthul,1056,shaman,elemental,18,11,7
Loserlol,das-syndikat,1056,shaman,elemental,48,24,24
Retuu,uldaman,1056,shaman,elemental,24,11,13
Mehboul,hyjal,1055,shaman,elemental,24,11,13
Sayokô,grim-batol,1055,shaman,elemental,24,11,13
Furthehorde,frostmane,1054,shaman,elemental,18,11,7
Wlãdoo,archimonde,1054,shaman,elemental,18,11,7
Yraxara,draenor,1053,shaman,elemental,18,11,7
Èrò,blackhand,1053,shaman,elemental,24,11,13
Manaphi,arthas,1052,shaman,elemental,24,11,13
Elkyrie,alakir,1052,shaman,elemental,24,11,13
Whizjy,sanguino,1051,shaman,elemental,18,11,7
Tiji,eredar,1051,shaman,elemental,19,11,8
Chrached,kargath,1051,shaman,elemental,24,11,13
Louler,ragnaros,1049,shaman,elemental,24,11,13
Kylas,die-ewige-wacht,1047,shaman,elemental,18,11,7
Hugzy,argent-dawn,1046,shaman,elemental,53,31,22
Eleurii,burning-blade,1046,shaman,elemental,36,11,25
Эртирон,howling-fjord,1044,shaman,elemental,24,11,13
Tpainx,kazzak,1043,shaman,elemental,24,11,13
Djbruggìe,bloodhoof,1043,shaman,elemental,30,11,19
Дрекрош,howling-fjord,1042,shaman,elemental,91,36,55
Totempoo,the-maelstrom,1041,shaman,elemental,18,11,7
Ananasen,eonar,1041,shaman,elemental,24,11,13
Kapplos,gorgonnash,1039,shaman,elemental,23,11,12
Thrallotido,sanguino,1037,shaman,elemental,36,11,25
Laquium,blackmoore,1032,shaman,elemental,37,15,22
Oddsocks,stormscale,1032,shaman,elemental,61,21,40
Ormanthep,hyjal,1029,shaman,elemental,18,11,7
Flochy,argent-dawn,1027,shaman,elemental,53,31,22
Zjindi,shattered-hand,1027,shaman,elemental,24,11,13
Jumbototem,tarren-mill,1026,shaman,elemental,18,11,7
Avarela,argent-dawn,1023,shaman,elemental,42,12,30
Thunderstryk,sylvanas,1021,shaman,elemental,60,30,30
Treizelol,ysondre,1014,shaman,elemental,24,11,13
Goromar,kirin-tor,1012,shaman,elemental,91,36,55
Ximid,doomhammer,1008,shaman,elemental,170,85,85
Магмарончик,gordunni,1005,shaman,elemental,66,23,43
Demelena,silvermoon,1003,shaman,elemental,18,11,7
Ragnadim,silvermoon,1003,shaman,elemental,30,11,19
Bluéshirtguy,blackhand,994,shaman,elemental,48,22,26
Kobeye,thrall,982,shaman,elemental,58,31,27
Thatamazing,korgall,979,shaman,elemental,32,15,17
Pararrayøs,sanguino,975,shaman,elemental,29,11,18
Aslakki,turalyon,975,shaman,elemental,42,11,31
Dðt,stormscale,973,shaman,elemental,41,17,24
Lavadrak,eredar,960,shaman,elemental,12,10,2
Elemayó,tarren-mill,960,shaman,elemental,18,10,8
Strór,twisting-nether,960,shaman,elemental,18,10,8
Dshaman,aegwynn,960,shaman,elemental,24,10,14
Theodorix,silvermoon,960,shaman,elemental,24,10,14
Dumpaman,frostmane,959,shaman,elemental,18,10,8
Biccon,silvermoon,959,shaman,elemental,18,10,8
Namè,kazzak,959,shaman,elemental,18,10,8
Akukuu,kazzak,959,shaman,elemental,24,10,14
Blover,drakthul,958,shaman,elemental,12,10,2
Trastamar,dun-modr,958,shaman,elemental,12,10,2
Rokils,silvermoon,958,shaman,elemental,18,10,8
Rockstéady,outland,958,shaman,elemental,18,10,8
Naathir,magtheridon,958,shaman,elemental,18,10,8
Kønat,blackmoore,958,shaman,elemental,24,10,14
Леланай,blackscar,958,shaman,elemental,24,10,14
Minasa,saurfang,958,shaman,elemental,30,10,20
Raïgo,hyjal,957,shaman,elemental,18,10,8
Jazzrod,stormscale,957,shaman,elemental,24,10,14
Atuaßëlha,grim-batol,957,shaman,elemental,24,10,14
Elevlach,drakthul,957,shaman,elemental,30,10,20
Гидрокорыто,gordunni,956,shaman,elemental,18,10,8
Klunkespiser,stormscale,955,shaman,elemental,24,10,14
Dando,silvermoon,952,shaman,elemental,24,10,14
Unangemessen,silvermoon,951,shaman,elemental,18,10,8
Джанндис,booty-bay,951,shaman,elemental,24,10,14
Chilliajin,tarren-mill,950,shaman,elemental,24,10,14
Babathar,ysondre,949,shaman,elemental,24,10,14
Eustodia,minahonda,948,shaman,elemental,12,10,2
Блэкмаршал,howling-fjord,948,shaman,elemental,30,10,20
Ххенеси,soulflayer,947,shaman,elemental,24,10,14
Камам,gordunni,947,shaman,elemental,30,10,20
Шейпан,gordunni,940,shaman,elemental,42,20,22
Smorcxx,kazzak,934,shaman,elemental,30,10,20
Orishimaru,blackrock,932,shaman,elemental,23,10,13
Kiirø,ysondre,929,shaman,elemental,18,10,8
Kortgat,kilrogg,924,shaman,elemental,48,23,25
Федосик,galakrond,922,shaman,elemental,36,15,21
Lavalampa,magtheridon,920,shaman,elemental,18,10,8
Шоу,gordunni,906,shaman,elemental,27,11,16
Monstermunch,ravencrest,903,shaman,elemental,34,11,23
Lokasakke,tarren-mill,895,shaman,elemental,14,10,4
Lighttfeet,hyjal,864,shaman,elemental,12,9,3
Jeelypink,dalaran,864,shaman,elemental,12,9,3
Captaînhuge,dunemaul,864,shaman,elemental,12,9,3
Dwarfracial,blackrock,864,shaman,elemental,12,9,3
ßaraky,kazzak,864,shaman,elemental,12,9,3
Elvalya,archimonde,864,shaman,elemental,18,9,9
Kwanah,kaelthas,864,shaman,elemental,18,9,9
Suntaria,stormscale,864,shaman,elemental,18,9,9
Terobux,culte-de-la-rive-noire,864,shaman,elemental,24,9,15
Nitronigi,malganis,864,shaman,elemental,24,9,15
Krahg,garona,863,shaman,elemental,16,10,6
Blastersondy,outland,863,shaman,elemental,18,9,9
Luzzilol,garrosh,863,shaman,elemental,18,9,9
Dûmah,sanguino,863,shaman,elemental,25,10,15
Pomegranate,arthas,863,shaman,elemental,24,9,15
Pvegame,tarren-mill,863,shaman,elemental,24,9,15
Healocalypse,azuremyst,862,shaman,elemental,12,9,3
Gomoth,kazzak,862,shaman,elemental,18,9,9
Рэйвантотем,soulflayer,862,shaman,elemental,18,9,9
Shkook,archimonde,862,shaman,elemental,24,9,15
Bunnz,kazzak,861,shaman,elemental,12,9,3
Drækthør,thrall,860,shaman,elemental,19,11,8
Штормбайт,azuregos,858,shaman,elemental,12,9,3
Naix,silvermoon,858,shaman,elemental,24,9,15
Бронзород,grom,840,shaman,elemental,12,9,3
Незнаком,booty-bay,811,shaman,elemental,30,12,18
Lavaburstx,antonidas,810,shaman,elemental,28,10,18
Holdafstand,tarren-mill,798,shaman,elemental,14,9,5
Pappashaman,tarren-mill,768,shaman,elemental,10,9,1
Jåime,ravencrest,768,shaman,elemental,12,8,4
Grapefruit,blackmoore,768,shaman,elemental,12,8,4
Visboer,stormscale,768,shaman,elemental,12,8,4
Vygak,tarren-mill,768,shaman,elemental,12,8,4
Flam,outland,768,shaman,elemental,12,8,4
Wátermélon,stormscale,768,shaman,elemental,12,8,4
Rokils,tarren-mill,768,shaman,elemental,12,8,4
Palpazerr,archimonde,768,shaman,elemental,12,8,4
Atiix,eredar,768,shaman,elemental,12,8,4
Pieski,stormscale,768,shaman,elemental,12,8,4
Windspêaker,outland,768,shaman,elemental,18,8,10
Kronoxd,tarren-mill,768,shaman,elemental,18,8,10
Thundergødx,nemesis,768,shaman,elemental,18,8,10
Totemly,alakir,768,shaman,elemental,18,8,10
Nerdshockz,blackhand,768,shaman,elemental,18,8,10
Breezzkingg,twisting-nether,768,shaman,elemental,18,8,10
Lathisi,zenedar,768,shaman,elemental,19,8,11
Thorunir,sylvanas,768,shaman,elemental,24,8,16
Hobblefoot,stormscale,767,shaman,elemental,12,8,4
Brassefrasse,shattered-hand,767,shaman,elemental,12,8,4
Bourdieu,thrall,767,shaman,elemental,12,8,4
Sinirli,ravencrest,767,shaman,elemental,18,8,10
Beven,stormscale,767,shaman,elemental,18,8,10
Freizeitler,antonidas,767,shaman,elemental,18,8,10
Gaerth,aggramar,766,shaman,elemental,12,8,4
Runetera,ravencrest,765,shaman,elemental,12,8,4
Grambozz,blackrock,765,shaman,elemental,12,8,4
Umbraverfaa,twisting-nether,765,shaman,elemental,12,8,4
Parthon,ravencrest,765,shaman,elemental,12,8,4
Формацепт,ashenvale,763,shaman,elemental,24,8,16
Zham,kul-tiras,763,shaman,elemental,30,8,22
Itsnasty,blackmoore,753,shaman,elemental,18,8,10
Arabesk,arygos,748,shaman,elemental,23,8,15
Соленый,booty-bay,744,shaman,elemental,110,45,65
Wacomtablet,kazzak,703,shaman,elemental,11,8,3
Baschúrr,blackrock,702,shaman,elemental,17,9,8
Шиока,borean-tundra,685,shaman,elemental,13,9,4
Dócshock,blackmoore,672,shaman,elemental,12,7,5
Dynamodanny,blackmoore,672,shaman,elemental,12,7,5
Hekzen,tarren-mill,672,shaman,elemental,12,7,5
Reburdacoxis,sanguino,672,shaman,elemental,12,7,5
Guccifootjob,defias-brotherhood,672,shaman,elemental,12,7,5
Rokils,ravencrest,672,shaman,elemental,12,7,5
Cuddleball,moonglade,672,shaman,elemental,12,7,5
Eneru,nemesis,672,shaman,elemental,12,7,5
Labûche,chogall,672,shaman,elemental,12,7,5
Wamah,sargeras,672,shaman,elemental,12,7,5
Hanakokô,grim-batol,672,shaman,elemental,12,7,5
Bigblué,tarren-mill,672,shaman,elemental,12,7,5
Deepdamp,blackrock,672,shaman,elemental,12,7,5
Preciousxo,auchindoun,672,shaman,elemental,12,7,5
Kiirín,drakthul,672,shaman,elemental,12,7,5
Bhargonen,silvermoon,672,shaman,elemental,12,7,5
Shamandoino,wildhammer,672,shaman,elemental,12,7,5
Шамвкроксах,howling-fjord,672,shaman,elemental,12,7,5
Bosslikex,ravencrest,672,shaman,elemental,12,7,5
Glibbins,sylvanas,672,shaman,elemental,12,7,5
Ehlaina,outland,672,shaman,elemental,12,7,5
Jehae,archimonde,672,shaman,elemental,12,7,5
Isvk,ravencrest,672,shaman,elemental,12,7,5
Гарбаджи,galakrond,672,shaman,elemental,12,7,5
Koífish,ravencrest,672,shaman,elemental,12,7,5
Kæde,dun-morogh,672,shaman,elemental,12,7,5
Экспатриот,greymane,672,shaman,elemental,12,7,5
Thordes,forscherliga,672,shaman,elemental,12,7,5
Shammehboi,auchindoun,672,shaman,elemental,15,8,7
Caro,tarren-mill,672,shaman,elemental,18,7,11
Крушам,gordunni,672,shaman,elemental,18,7,11
Velkin,thrall,672,shaman,elemental,18,7,11
Боузета,soulflayer,672,shaman,elemental,18,7,11
Турелька,blackscar,672,shaman,elemental,18,7,11
Endry,elune,672,shaman,elemental,18,7,11
Paidactor,kazzak,672,shaman,elemental,18,7,11
Rexonaone,silvermoon,672,shaman,elemental,18,7,11
Феномх,deathguard,671,shaman,elemental,12,7,5
Ruvxy,twisting-nether,671,shaman,elemental,12,7,5
Pandamoniumm,moonglade,671,shaman,elemental,12,7,5
Zëngä,outland,671,shaman,elemental,12,7,5
Dogfrog,silvermoon,671,shaman,elemental,18,7,11
Drahka,kazzak,671,shaman,elemental,18,7,11
Schockbunny,blackrock,671,shaman,elemental,18,7,11
Рокутаро,gordunni,670,shaman,elemental,12,7,5
Raoult,ravencrest,670,shaman,elemental,18,7,11
Layonne,ysondre,670,shaman,elemental,18,7,11
Fosterzz,ravencrest,668,shaman,elemental,21,8,13
Coton,grim-batol,667,shaman,elemental,12,7,5
Eratore,xavius,666,shaman,elemental,18,7,11
Zarakuda,magtheridon,663,shaman,elemental,34,9,25
Aljorf,dun-modr,662,shaman,elemental,12,7,5
Watson,conseil-des-ombres,660,shaman,elemental,18,7,11
Kíá,silvermoon,660,shaman,elemental,18,7,11
Takkenuma,hyjal,640,shaman,elemental,22,7,15
Ztraz,blackhand,639,shaman,elemental,8,8,0
Blyátmán,twisting-nether,638,shaman,elemental,14,8,6
Yalac,archimonde,637,shaman,elemental,14,8,6
Айвимэдисон,howling-fjord,623,shaman,elemental,17,7,10
Вудвин,soulflayer,621,shaman,elemental,26,7,19
Easyplay,kazzak,607,shaman,elemental,14,7,7
Wurstblinker,ravencrest,606,shaman,elemental,11,7,4
Lavelover,tarren-mill,576,shaman,elemental,6,6,0
Elfenomeno,archimonde,576,shaman,elemental,6,6,0
Zimoneris,blackmoore,576,shaman,elemental,6,6,0
Shayal,defias-brotherhood,576,shaman,elemental,12,6,6
Jíkkz,aegwynn,576,shaman,elemental,12,6,6
Лучшийшаман,soulflayer,576,shaman,elemental,12,6,6
Ugáa,malganis,576,shaman,elemental,12,6,6
Kärdyo,archimonde,576,shaman,elemental,12,6,6
Totemkahmun,kazzak,576,shaman,elemental,12,6,6
Vix,argent-dawn,576,shaman,elemental,12,6,6
Electronova,magtheridon,576,shaman,elemental,12,6,6
Eddiemorphin,kazzak,576,shaman,elemental,12,6,6
Реалайзер,blackscar,576,shaman,elemental,12,6,6
Fholst,draenor,576,shaman,elemental,12,6,6
Localicious,ragnaros,576,shaman,elemental,12,6,6
Шлолка,gordunni,576,shaman,elemental,12,6,6
Yzeldan,hyjal,576,shaman,elemental,12,6,6
Windfúhrèr,tarren-mill,576,shaman,elemental,12,6,6
Forrak,argent-dawn,576,shaman,elemental,12,6,6
Дагод,booty-bay,576,shaman,elemental,12,6,6
Linshock,tarren-mill,576,shaman,elemental,12,6,6
Simppe,stormreaver,576,shaman,elemental,12,6,6
Zënga,kazzak,576,shaman,elemental,12,6,6
Веег,deathweaver,576,shaman,elemental,12,6,6
Хыйь,howling-fjord,576,shaman,elemental,18,6,12
Inyra,eredar,576,shaman,elemental,18,6,12
Тайорн,howling-fjord,576,shaman,elemental,18,6,12
Dsgrc,tarren-mill,576,shaman,elemental,18,6,12
Mûhzala,blackmoore,576,shaman,elemental,18,6,12
Chenoyaa,blackrock,576,shaman,elemental,18,6,12
Sheherezeday,aegwynn,576,shaman,elemental,18,6,12
Krakatoa,dunemaul,576,shaman,elemental,24,6,18
Shlby,blackrock,575,shaman,elemental,12,6,6
Syndia,das-konsortium,575,shaman,elemental,12,6,6
Dobär,madmortem,575,shaman,elemental,12,6,6
Бурехлест,howling-fjord,575,shaman,elemental,12,6,6
Helloitsmee,thrall,575,shaman,elemental,12,6,6
Lampard,magtheridon,575,shaman,elemental,17,6,11
Derblitz,baelgun,574,shaman,elemental,12,6,6
Fimir,archimonde,573,shaman,elemental,12,6,6
Zuman,the-maelstrom,573,shaman,elemental,12,6,6
Louisvgaal,kazzak,572,shaman,elemental,12,6,6
Attm,twisting-nether,570,shaman,elemental,20,10,10
Encourager,daggerspine,568,shaman,elemental,12,6,6
Disharmony,outland,554,shaman,elemental,17,8,9
Isheartears,outland,543,shaman,elemental,11,6,5
Trosy,burning-blade,540,shaman,elemental,14,7,7
Rezervoir,bladefist,522,shaman,elemental,15,9,6
Turbokrapka,tarren-mill,522,shaman,elemental,17,8,9
Squixi,tarren-mill,480,shaman,elemental,6,5,1
Shambulançe,silvermoon,480,shaman,elemental,6,5,1
Minimalist,stormscale,480,shaman,elemental,6,5,1
Rhonix,blackmoore,480,shaman,elemental,6,5,1
Phobiatics,thrall,480,shaman,elemental,6,5,1
Roskan,archimonde,480,shaman,elemental,6,5,1
Twists,sylvanas,480,shaman,elemental,6,5,1
Efdemin,blackmoore,480,shaman,elemental,6,5,1
Shaggé,tarren-mill,480,shaman,elemental,6,5,1
Zujaz,stormscale,480,shaman,elemental,6,5,1
Plsdontpress,stormscale,480,shaman,elemental,6,5,1
Hexina,ragnaros,480,shaman,elemental,6,5,1
Jarreau,turalyon,480,shaman,elemental,6,5,1
Ggnore,kazzak,480,shaman,elemental,6,5,1
Тандерхх,howling-fjord,480,shaman,elemental,6,5,1
Elemane,kazzak,480,shaman,elemental,6,5,1
Highfaî,tarren-mill,480,shaman,elemental,6,5,1
Izosha,hyjal,480,shaman,elemental,6,5,1
Bumstead,ragnaros,480,shaman,elemental,6,5,1
Lovelyshaman,silvermoon,480,shaman,elemental,7,5,2
Утебяпожар,blackscar,480,shaman,elemental,12,5,7
Végàs,ysondre,480,shaman,elemental,12,5,7
Dregú,draenor,480,shaman,elemental,12,5,7
Cptcutíe,antonidas,480,shaman,elemental,12,5,7
Синнити,blackscar,480,shaman,elemental,12,5,7
Rykarn,eredar,480,shaman,elemental,12,5,7
Havoc,boulderfist,480,shaman,elemental,12,5,7
Swapxy,outland,480,shaman,elemental,12,5,7
Наладчик,gordunni,480,shaman,elemental,12,5,7
Loshohealva,stormscale,480,shaman,elemental,12,5,7
Amcin,stormreaver,480,shaman,elemental,12,5,7
Cloovster,magtheridon,480,shaman,elemental,12,5,7
Flaskmus,haomarush,480,shaman,elemental,12,5,7
Skullføck,argent-dawn,480,shaman,elemental,12,5,7
Stòrm,ravencrest,480,shaman,elemental,12,5,7
Shockleted,stormscale,480,shaman,elemental,12,5,7
Wûcs,silvermoon,480,shaman,elemental,12,5,7
Raaborio,blackmoore,480,shaman,elemental,12,5,7
Neystee,archimonde,480,shaman,elemental,12,5,7
Bahane,frostwolf,480,shaman,elemental,15,6,9
Talg,defias-brotherhood,480,shaman,elemental,15,5,10
Clickerboy,ravencrest,480,shaman,elemental,18,5,13
Квелси,gordunni,480,shaman,elemental,18,5,13
Fûchsí,blackhand,479,shaman,elemental,6,5,1
Apád,ragnaros,479,shaman,elemental,12,5,7
Burnprof,nethersturm,479,shaman,elemental,12,5,7
Zaappyboii,azjolnerub,479,shaman,elemental,20,5,15
Sinwithin,ravencrest,478,shaman,elemental,12,5,7
Rayitoss,tyrande,456,shaman,elemental,18,7,11
Skengshammy,ragnaros,446,shaman,elemental,11,5,6
Kbds,outland,431,shaman,elemental,11,5,6
Charth,ravencrest,428,shaman,elemental,9,5,4
Envergur,eitrigg,417,shaman,elemental,13,6,7
Obêlixx,blackmoore,415,shaman,elemental,8,5,3
Stoned,sporeggar,415,shaman,elemental,10,5,5
Bèx,twisting-nether,400,shaman,elemental,13,5,8
Blùé,tarren-mill,399,shaman,elemental,5,5,0
Вашнюхтоптал,howling-fjord,384,shaman,elemental,6,4,2
Yerlas,burning-legion,384,shaman,elemental,6,4,2
Pvpmax,blackhand,384,shaman,elemental,6,4,2
Jacc,sunstrider,384,shaman,elemental,6,4,2
Euprathree,archimonde,384,shaman,elemental,6,4,2
Shamurky,kazzak,384,shaman,elemental,6,4,2
Greenswag,drakthul,384,shaman,elemental,6,4,2
Trustlemac,onyxia,384,shaman,elemental,6,4,2
Bkdgoodz,aegwynn,384,shaman,elemental,6,4,2
Sebubu,twisting-nether,384,shaman,elemental,6,4,2
Schamîx,blackrock,384,shaman,elemental,6,4,2
Finpower,kul-tiras,384,shaman,elemental,6,4,2
Xatis,aegwynn,384,shaman,elemental,6,4,2
Thunderman,the-maelstrom,384,shaman,elemental,6,4,2
Tóuka,uldum,384,shaman,elemental,6,4,2
Kévinn,draenor,384,shaman,elemental,6,4,2
Yacuzwerg,blackrock,384,shaman,elemental,6,4,2
Zippidizap,ulduar,384,shaman,elemental,6,4,2
Selonthyx,ravencrest,384,shaman,elemental,6,4,2
Føxï,pozzo-delleternità,384,shaman,elemental,6,4,2
Rahuna,darksorrow,384,shaman,elemental,6,4,2
Chocshock,tarren-mill,384,shaman,elemental,6,4,2
Shafallen,tarren-mill,384,shaman,elemental,6,4,2
Kraksham,ravencrest,384,shaman,elemental,6,4,2
Windberg,ysondre,384,shaman,elemental,6,4,2
Teckan,tarren-mill,384,shaman,elemental,6,4,2
Tonifo,nemesis,384,shaman,elemental,6,4,2
Alëxx,hyjal,384,shaman,elemental,6,4,2
Bumblebetuna,stormscale,384,shaman,elemental,6,4,2
Hispanoxd,sanguino,384,shaman,elemental,6,4,2
Апинсмок,soulflayer,384,shaman,elemental,12,4,8
Cùn,blackmoore,384,shaman,elemental,12,4,8
Rocktopus,outland,384,shaman,elemental,12,4,8
Karissah,silvermoon,384,shaman,elemental,12,4,8
Hí,bronzebeard,384,shaman,elemental,12,4,8
Вензеро,howling-fjord,384,shaman,elemental,12,4,8
Magicmekoz,draenor,384,shaman,elemental,12,4,8
Rompelukt,auchindoun,384,shaman,elemental,12,4,8
Jäck,ravencrest,384,shaman,elemental,12,4,8
Swart,hyjal,384,shaman,elemental,12,4,8
Réläx,kazzak,384,shaman,elemental,12,4,8
Setac,stormscale,384,shaman,elemental,12,4,8
Mawae,thrall,384,shaman,elemental,12,4,8
Xyckas,terrordar,384,shaman,elemental,12,4,8
Zoolza,kirin-tor,384,shaman,elemental,12,4,8
Maruno,stormscale,384,shaman,elemental,12,4,8
Tism,stormscale,384,shaman,elemental,12,4,8
Stlakañ,chants-éternels,384,shaman,elemental,12,4,8
Eskìmo,malganis,384,shaman,elemental,12,4,8
Nùrsegemy,nemesis,384,shaman,elemental,12,4,8
Totemtilda,tarren-mill,384,shaman,elemental,12,4,8
Ogmehu,stormreaver,384,shaman,elemental,12,4,8
Momine,stormscale,384,shaman,elemental,12,4,8
Goitbate,azuremyst,384,shaman,elemental,12,4,8
Kookaboo,blackrock,384,shaman,elemental,12,4,8
Boomfanboy,tarren-mill,384,shaman,elemental,12,4,8
Elothar,earthen-ring,384,shaman,elemental,12,4,8
Saggrox,kazzak,384,shaman,elemental,12,4,8
Snusy,stormscale,384,shaman,elemental,12,4,8
Zandali,tarren-mill,383,shaman,elemental,6,4,2
Zokah,emeriss,383,shaman,elemental,6,4,2
Slk,blackrock,383,shaman,elemental,6,4,2
Разодран,gordunni,383,shaman,elemental,6,4,2
Dudoras,doomhammer,383,shaman,elemental,18,4,14
Kennyo,uldum,379,shaman,elemental,12,4,8
Santy,silvermoon,352,shaman,elemental,10,4,6
Schamaster,antonidas,336,shaman,elemental,9,4,5
Khalamity,ravencrest,330,shaman,elemental,14,6,8
ßaßystärz,hyjal,319,shaman,elemental,5,4,1
Gigawats,sylvanas,319,shaman,elemental,5,4,1
Yasaburo,silvermoon,319,shaman,elemental,5,4,1
Gravépàct,blackrock,288,shaman,elemental,6,3,3
Symy,draenor,288,shaman,elemental,6,3,3
Kaptt,twisting-nether,288,shaman,elemental,6,3,3
Фарраон,deathguard,288,shaman,elemental,6,3,3
Neirdae,thunderhorn,288,shaman,elemental,6,3,3
Wilson,twisting-nether,288,shaman,elemental,6,3,3
Dünnbier,blackhand,288,shaman,elemental,6,3,3
Царьбер,soulflayer,288,shaman,elemental,6,3,3
Тотемныйчад,gordunni,288,shaman,elemental,6,3,3
Херургх,soulflayer,288,shaman,elemental,6,3,3
Sëídhr,arathi,288,shaman,elemental,6,3,3
Shamuzan,malfurion,288,shaman,elemental,6,3,3
Peneapunta,nemesis,288,shaman,elemental,6,3,3
Fufupartyxx,blackrock,288,shaman,elemental,6,3,3
Penesecco,nemesis,288,shaman,elemental,6,3,3
Энхай,azuregos,288,shaman,elemental,6,3,3
Yashëa,ysondre,288,shaman,elemental,6,3,3
Natureabuser,kazzak,288,shaman,elemental,6,3,3
Bas,nagrand,288,shaman,elemental,6,3,3
Фанковарнесы,gordunni,288,shaman,elemental,6,3,3
Санрэйн,soulflayer,288,shaman,elemental,6,3,3
Dagra,twisting-nether,288,shaman,elemental,6,3,3
Exolnard,twisting-nether,288,shaman,elemental,6,3,3
Hethne,kazzak,288,shaman,elemental,6,3,3
Gissary,drakthul,288,shaman,elemental,6,3,3
Whyisitspicy,kazzak,288,shaman,elemental,6,3,3
Styxsm,blackhand,288,shaman,elemental,6,3,3
Родохрозид,blackscar,288,shaman,elemental,6,3,3
Ghettero,ragnaros,288,shaman,elemental,6,3,3
Qenninka,drakthul,288,shaman,elemental,6,3,3
Cloudborne,draenor,288,shaman,elemental,6,3,3
Filigran,ragnaros,288,shaman,elemental,6,3,3
Begeshaman,sylvanas,288,shaman,elemental,6,3,3
Estexxsham,kazzak,288,shaman,elemental,6,3,3
Lefita,drakthul,288,shaman,elemental,6,3,3
Bharudor,antonidas,288,shaman,elemental,6,3,3
Asiorr,silvermoon,288,shaman,elemental,6,3,3
Shoewalker,ragnaros,288,shaman,elemental,6,3,3
Nurychic,twisting-nether,288,shaman,elemental,6,3,3
Shamanmans,grim-batol,288,shaman,elemental,6,3,3
Oroastbeef,archimonde,288,shaman,elemental,6,3,3
Dareos,anetheron,288,shaman,elemental,6,3,3
Rhastafarian,stormscale,288,shaman,elemental,6,3,3
Nightingäle,silvermoon,288,shaman,elemental,6,3,3
Khaleeya,blackmoore,288,shaman,elemental,6,3,3
Vukroth,argent-dawn,288,shaman,elemental,6,3,3
Bammë,archimonde,288,shaman,elemental,6,3,3
Whatsup,aggramar,288,shaman,elemental,6,3,3
Another,hakkar,288,shaman,elemental,6,3,3
Hotstorm,bronzebeard,288,shaman,elemental,6,3,3
Susais,outland,288,shaman,elemental,6,3,3
Shamanshow,eredar,288,shaman,elemental,6,3,3
Tiâna,archimonde,288,shaman,elemental,6,3,3
Joeyexe,outland,288,shaman,elemental,6,3,3
Volvíc,tichondrius,288,shaman,elemental,6,3,3
Brandbombe,frostwolf,288,shaman,elemental,6,3,3
Kapristylez,outland,288,shaman,elemental,6,3,3
Shaulic,ravencrest,288,shaman,elemental,6,3,3
Mogzu,blackmoore,288,shaman,elemental,6,3,3
Voodoodoouu,stormscale,288,shaman,elemental,6,3,3
Disneyplus,tarren-mill,288,shaman,elemental,6,3,3
Rokxa,burning-legion,288,shaman,elemental,6,3,3
Weåfy,outland,288,shaman,elemental,6,3,3
Peaktrim,tarren-mill,288,shaman,elemental,6,3,3
Kónjo,kazzak,288,shaman,elemental,6,3,3
Lunarsloth,hyjal,288,shaman,elemental,6,3,3
Crysham,tarren-mill,288,shaman,elemental,6,3,3
Pooch,archimonde,288,shaman,elemental,6,3,3
Mjukiz,tarren-mill,288,shaman,elemental,6,3,3
Amu,ravencrest,288,shaman,elemental,6,3,3
Jinbao,ravencrest,288,shaman,elemental,6,3,3
Putrìfy,ravencrest,288,shaman,elemental,6,3,3
Sykx,hyjal,288,shaman,elemental,6,3,3
Ironbuttrfly,magtheridon,288,shaman,elemental,6,3,3
Beastee,blackmoore,288,shaman,elemental,6,3,3
Faroh,ravencrest,288,shaman,elemental,6,3,3
Terranator,sanguino,288,shaman,elemental,6,3,3
Bigpinkpig,thunderhorn,288,shaman,elemental,7,3,4
Jaeslin,tarren-mill,288,shaman,elemental,12,3,9
Corlysvelary,doomhammer,288,shaman,elemental,12,3,9
Hboni,chamber-of-aspects,288,shaman,elemental,12,3,9
Berith,spinebreaker,288,shaman,elemental,12,3,9
Gethrok,rajaxx,288,shaman,elemental,12,3,9
Samlik,antonidas,288,shaman,elemental,12,3,9
Elemania,mugthol,288,shaman,elemental,12,3,9
Iceshockz,sylvanas,288,shaman,elemental,12,3,9
Renegad,archimonde,288,shaman,elemental,12,3,9
Qwunjin,ragnaros,288,shaman,elemental,12,3,9
Shourx,ravencrest,288,shaman,elemental,12,3,9
Mélb,eredar,288,shaman,elemental,12,3,9
Woolysocks,draenor,288,shaman,elemental,12,3,9
Allfathêr,ragnaros,288,shaman,elemental,12,3,9
Fouchin,outland,288,shaman,elemental,12,3,9
Practicetwo,argent-dawn,288,shaman,elemental,12,3,9
Tir,auchindoun,288,shaman,elemental,12,3,9
Bónkas,kazzak,288,shaman,elemental,12,3,9
Tonto,frostmane,288,shaman,elemental,12,3,9
Joeculdacier,hyjal,288,shaman,elemental,12,3,9
Fatyoe,eredar,288,shaman,elemental,12,3,9
Ронхот,soulflayer,288,shaman,elemental,18,3,15
Kcarlina,uldum,287,shaman,elemental,6,3,3
Megaherz,sanguino,287,shaman,elemental,6,3,3
Bogatyrk,twisting-nether,287,shaman,elemental,6,3,3
Óõ,dun-modr,287,shaman,elemental,6,3,3
Twotwozero,defias-brotherhood,286,shaman,elemental,6,3,3
Zalacrass,sanguino,286,shaman,elemental,6,3,3
Вещун,deathguard,284,shaman,elemental,12,3,9
Mareaspibas,zuljin,239,shaman,elemental,5,3,2
Plebzgodxkto,nemesis,239,shaman,elemental,7,4,3
Stíckíx,malganis,192,shaman,elemental,4,3,1
Zackyboi,tarren-mill,192,shaman,elemental,6,2,4
Hexlettin,twisting-nether,192,shaman,elemental,6,2,4
Präsi,die-aldor,192,shaman,elemental,6,2,4
Vandouille,archimonde,192,shaman,elemental,6,2,4
Dormido,sanguino,192,shaman,elemental,6,2,4
Димасечка,galakrond,192,shaman,elemental,6,2,4
Nuekx,sanguino,192,shaman,elemental,6,2,4
Exílium,tarren-mill,192,shaman,elemental,6,2,4
Лаваяшка,gordunni,192,shaman,elemental,6,2,4
Lethal,darksorrow,192,shaman,elemental,6,2,4
Smashsmash,the-maelstrom,192,shaman,elemental,6,2,4
Tuksy,darkspear,192,shaman,elemental,6,2,4
Shamanirl,tarren-mill,192,shaman,elemental,6,2,4
Тандерхем,gordunni,192,shaman,elemental,6,2,4
Rakermän,dun-modr,192,shaman,elemental,6,2,4
Seyumi,draenor,192,shaman,elemental,6,2,4
Quartodebue,nemesis,192,shaman,elemental,6,2,4
Zinlay,tarren-mill,192,shaman,elemental,6,2,4
Зуфар,howling-fjord,192,shaman,elemental,6,2,4
Шаеман,soulflayer,192,shaman,elemental,6,2,4
Ishkadar,twisting-nether,192,shaman,elemental,6,2,4
Cöökiekeeper,twisting-nether,192,shaman,elemental,6,2,4
Mehex,tarren-mill,192,shaman,elemental,6,2,4
Oldbuttgold,archimonde,192,shaman,elemental,6,2,4
Bjerknes,draenor,192,shaman,elemental,6,2,4
Stormzug,twisting-nether,192,shaman,elemental,6,2,4
Nnekalol,twisting-nether,192,shaman,elemental,6,2,4
Сновидений,soulflayer,192,shaman,elemental,6,2,4
Kolchidyalah,la-croisade-écarlate,192,shaman,elemental,6,2,4
Undae,ravencrest,192,shaman,elemental,6,2,4
Yiyi,boulderfist,192,shaman,elemental,6,2,4
Beletili,chogall,192,shaman,elemental,6,2,4
Squixi,ravencrest,192,shaman,elemental,6,2,4
Rindenmulch,eredar,192,shaman,elemental,6,2,4
Tigro,burning-legion,192,shaman,elemental,6,2,4
Purgegødxx,aegwynn,192,shaman,elemental,6,2,4
Garakh,argent-dawn,192,shaman,elemental,6,2,4
Ratatakéas,archimonde,192,shaman,elemental,6,2,4
Wawawoowee,archimonde,192,shaman,elemental,6,2,4
Драгенхз,gordunni,192,shaman,elemental,6,2,4
Éàsy,blackmoore,192,shaman,elemental,6,2,4
Firsttime,alakir,192,shaman,elemental,6,2,4
Amonshokz,tarren-mill,192,shaman,elemental,6,2,4
Ahrim,argent-dawn,192,shaman,elemental,6,2,4
Dodododfewal,stormscale,192,shaman,elemental,6,2,4
Thomz,aggra-português,192,shaman,elemental,6,2,4
Schockolade,blackmoore,192,shaman,elemental,6,2,4
Shàmeonyou,dun-morogh,192,shaman,elemental,6,2,4
Nuvet,argent-dawn,192,shaman,elemental,6,2,4
Makaria,emerald-dream,192,shaman,elemental,6,2,4
Hanakô,grim-batol,192,shaman,elemental,6,2,4
Macetoyaface,darksorrow,192,shaman,elemental,6,2,4
Rok,darkspear,192,shaman,elemental,6,2,4
Wulkanus,drakthul,192,shaman,elemental,6,2,4
Tates,jaedenar,192,shaman,elemental,6,2,4
Téwa,hyjal,192,shaman,elemental,6,2,4
Albatroz,the-maelstrom,192,shaman,elemental,6,2,4
Zulululul,burning-blade,192,shaman,elemental,6,2,4
Stivishamy,blackmoore,192,shaman,elemental,6,2,4
Гленкуллен,blackscar,192,shaman,elemental,6,2,4
Девлиниум,fordragon,192,shaman,elemental,6,2,4
Fuzzbolt,silvermoon,192,shaman,elemental,6,2,4
Casterzajx,kazzak,192,shaman,elemental,6,2,4
Cptsham,blackrock,192,shaman,elemental,6,2,4
Kappatotem,silvermoon,192,shaman,elemental,6,2,4
Krovogor,silvermoon,192,shaman,elemental,6,2,4
Remkoo,blackrock,192,shaman,elemental,6,2,4
Keisys,kazzak,192,shaman,elemental,6,2,4
Djxyoloswag,silvermoon,192,shaman,elemental,6,2,4
Melliska,silvermoon,192,shaman,elemental,6,2,4
Motorbreath,silvermoon,192,shaman,elemental,6,2,4
Shockbestie,eredar,192,shaman,elemental,7,2,5
Hogmodig,tarren-mill,192,shaman,elemental,7,2,5
Lycburst,twisting-nether,192,shaman,elemental,12,2,10
Неерззул,soulflayer,192,shaman,elemental,12,2,10
Zíp,archimonde,192,shaman,elemental,12,2,10
Kossborax,blackhand,192,shaman,elemental,12,2,10
Thornyberrý,outland,192,shaman,elemental,12,2,10
Nakenfeigy,stormreaver,192,shaman,elemental,12,2,10
Ærö,outland,192,shaman,elemental,12,2,10
Zæus,ragnaros,192,shaman,elemental,12,2,10
Максобман,howling-fjord,192,shaman,elemental,12,2,10
Виспепешам,gordunni,192,shaman,elemental,12,2,10
Sweetcåndy,stormscale,192,shaman,elemental,12,2,10
Ghostx,nemesis,192,shaman,elemental,18,2,16
Zeiger,minahonda,192,shaman,elemental,18,2,16
Aspirio,ravencrest,175,shaman,elemental,11,2,9
Thalgryn,twisting-nether,159,shaman,elemental,8,3,5
Kortën,khaz-modan,159,shaman,elemental,10,2,8
Amiashaman,stormscale,138,shaman,elemental,16,3,13
Корсика,gordunni,128,shaman,elemental,4,2,2
Shakgor,draenor,128,shaman,elemental,4,2,2
Thorcasso,azuremyst,96,shaman,elemental,3,2,1
Bram,aggra-português,96,shaman,elemental,3,2,1
Simpledream,tarren-mill,96,shaman,elemental,3,2,1
Zadrams,argent-dawn,96,shaman,elemental,3,2,1
Nopivøt,hyjal,96,shaman,elemental,7,2,5
Freexx,aegwynn,96,shaman,elemental,6,1,5
Papaver,zirkel-des-cenarius,96,shaman,elemental,6,1,5
Пэппивкашке,howling-fjord,96,shaman,elemental,6,1,5
Aguero,aegwynn,96,shaman,elemental,6,1,5
Moglibard,grim-batol,96,shaman,elemental,6,1,5
Dergat,pozzo-delleternità,96,shaman,elemental,6,1,5
Mittyzap,kazzak,96,shaman,elemental,6,1,5
Izir,archimonde,96,shaman,elemental,6,1,5
Korbas,burning-legion,96,shaman,elemental,6,1,5
Newÿorc,dalaran,96,shaman,elemental,6,1,5
Dizhkameduu,terokkar,96,shaman,elemental,6,1,5
Fatflop,sylvanas,96,shaman,elemental,6,1,5
Nìtratx,archimonde,96,shaman,elemental,6,1,5
Reäz,archimonde,96,shaman,elemental,6,1,5
Сентес,soulflayer,96,shaman,elemental,6,1,5
Growlêy,draenor,96,shaman,elemental,6,1,5
Ânne,blackrock,96,shaman,elemental,6,1,5
Hästdvärg,the-maelstrom,96,shaman,elemental,6,1,5
Ämbientador,sanguino,96,shaman,elemental,6,1,5
Skailzcham,hyjal,96,shaman,elemental,6,1,5
Châmanco,dun-modr,96,shaman,elemental,6,1,5
Vodoochild,hyjal,96,shaman,elemental,6,1,5
Flurpz,outland,96,shaman,elemental,6,1,5
Монамур,deathguard,96,shaman,elemental,6,1,5
Killhorn,malganis,96,shaman,elemental,6,1,5
Shamsteaks,ysera,96,shaman,elemental,6,1,5
Brryantblaks,colinas-pardas,96,shaman,elemental,6,1,5
Zerim,taerar,96,shaman,elemental,6,1,5
Elijaá,nordrassil,96,shaman,elemental,6,1,5
Samisu,blackmoore,96,shaman,elemental,6,1,5
Shamwowpow,stormscale,96,shaman,elemental,6,1,5
Bonestompamc,blackmoore,96,shaman,elemental,6,1,5
Jabena,draenor,96,shaman,elemental,6,1,5
Zaffyboi,draenor,96,shaman,elemental,6,1,5
Rakat,twisting-nether,96,shaman,elemental,6,1,5
Felcrushed,stormscale,96,shaman,elemental,6,1,5
Noru,ravencrest,96,shaman,elemental,6,1,5
Hagelbrakan,stormscale,96,shaman,elemental,6,1,5
Depucova,silvermoon,96,shaman,elemental,6,1,5
Vorkanyx,ysondre,96,shaman,elemental,6,1,5
Bärtigbaron,thrall,96,shaman,elemental,6,1,5
Cazzari,thrall,96,shaman,elemental,6,1,5
Pasjeop,ravencrest,96,shaman,elemental,6,1,5
Kilruk,ravencrest,96,shaman,elemental,6,1,5
Stiflersmôm,antonidas,96,shaman,elemental,6,1,5
Heheheyup,ravencrest,96,shaman,elemental,6,1,5
Dwarfofwar,ravencrest,96,shaman,elemental,6,1,5
Shamira,nethersturm,96,shaman,elemental,6,1,5
Shaminista,ravencrest,96,shaman,elemental,6,1,5
Magmamartin,antonidas,96,shaman,elemental,6,1,5
Zappypewpew,drakthul,96,shaman,elemental,12,1,11
Amaizin,stormscale,96,shaman,elemental,12,1,11
Äijä,chromaggus,96,shaman,elemental,12,1,11
Kyst,elune,95,shaman,elemental,6,1,5
Torxii,antonidas,79,shaman,elemental,5,1,4
Torepåsporet,deathwing,79,shaman,elemental,5,1,4
Rãgnãr,frostwolf,64,shaman,elemental,4,1,3
Tarzh,dalaran,63,shaman,elemental,2,2,0
Yukîmøn,hyjal,63,shaman,elemental,2,2,0
Agnøt,khaz-modan,63,shaman,elemental,2,2,0
Realiz,ysondre,48,shaman,elemental,4,1,3
Shammolino,nemesis,41,shaman,elemental,7,3,4
Gushgush,draenor,31,shaman,elemental,2,1,1
Memourian,drakthul,16,shaman,elemental,7,1,6
Bredare,ravencrest,2406,shaman,enhancement,136,104,32
Blaukraut,stormscale,2375,shaman,enhancement,115,75,40
Mûnch,kazzak,2369,shaman,enhancement,110,73,37
Дудивтф,soulflayer,2244,shaman,enhancement,194,105,89
Китрасст,soulflayer,2239,shaman,enhancement,78,43,35
Strippzz,stormscale,2238,shaman,enhancement,102,62,40
Fatpig,stormscale,2238,shaman,enhancement,83,47,36
Крааули,soulflayer,2231,shaman,enhancement,335,173,162
Axdn,ravencrest,2229,shaman,enhancement,80,47,33
Avines,twisting-nether,2211,shaman,enhancement,206,106,100
Kweng,stormreaver,2208,shaman,enhancement,193,109,84
Hermerejildo,stormscale,2200,shaman,enhancement,126,66,60
Dennismanone,tarren-mill,2195,shaman,enhancement,102,53,49
Azifox,hyjal,2183,shaman,enhancement,132,67,65
Buffdraventy,archimonde,2176,shaman,enhancement,90,53,37
Treyway,dun-modr,2174,shaman,enhancement,96,64,32
Lizoo,ravencrest,2169,shaman,enhancement,102,66,36
Stribbzz,stormscale,2149,shaman,enhancement,274,156,118
Baconbazooka,tarren-mill,2147,shaman,enhancement,101,60,41
Áä,stormscale,2146,shaman,enhancement,48,42,6
Joeyexe,outland,2133,shaman,enhancement,95,54,41
Qnanen,blackmoore,2131,shaman,enhancement,104,68,36
Shïnnkøk,stormscale,2130,shaman,enhancement,72,43,29
Mustakrakish,terokkar,2127,shaman,enhancement,78,53,25
Møldør,tarren-mill,2127,shaman,enhancement,126,82,44
Smorcshamyy,kazzak,2127,shaman,enhancement,111,63,48
Æerømachine,outland,2125,shaman,enhancement,81,42,39
Chancè,tarren-mill,2124,shaman,enhancement,84,50,34
Fckumen,blackmoore,2124,shaman,enhancement,106,61,45
Shadi,stormscale,2119,shaman,enhancement,84,44,40
Feetaddict,kazzak,2117,shaman,enhancement,112,67,45
Maelstrom,eredar,2113,shaman,enhancement,300,167,133
Lovèless,stormscale,2111,shaman,enhancement,36,26,10
Syllaas,ysondre,2109,shaman,enhancement,114,59,55
Бафамет,blackscar,2108,shaman,enhancement,66,39,27
Sparkygødx,twisting-nether,2104,shaman,enhancement,54,33,21
Автозакзак,soulflayer,2104,shaman,enhancement,89,45,44
Sparkyxd,twisting-nether,2102,shaman,enhancement,84,40,44
Etox,darksorrow,2101,shaman,enhancement,108,57,51
Zró,blackrock,2098,shaman,enhancement,144,78,66
Trulylove,tarren-mill,2085,shaman,enhancement,66,34,32
Swapxy,ravencrest,2084,shaman,enhancement,54,33,21
Voodoodoouu,stormscale,2079,shaman,enhancement,155,83,72
Shamanyxx,tarren-mill,2071,shaman,enhancement,155,83,72
Yashëa,ysondre,2069,shaman,enhancement,73,59,14
Ruffepuffe,twisting-nether,2047,shaman,enhancement,222,119,103
Shukhevych,kazzak,2043,shaman,enhancement,95,57,38
Wóllff,archimonde,2043,shaman,enhancement,72,42,30
Myguns,silvermoon,2043,shaman,enhancement,176,92,84
Shambolicc,kazzak,2042,shaman,enhancement,120,62,58
Читорра,gordunni,2038,shaman,enhancement,96,51,45
Китраст,soulflayer,2034,shaman,enhancement,63,33,30
Plsdontpress,stormscale,2029,shaman,enhancement,121,70,51
Critonian,twisting-nether,2026,shaman,enhancement,69,39,30
Sillaas,ysondre,2020,shaman,enhancement,120,55,65
Asaakira,blackmoore,2018,shaman,enhancement,211,112,99
Hexmex,stormreaver,2015,shaman,enhancement,142,77,65
Uhøfligeulf,draenor,2013,shaman,enhancement,65,35,30
Milheroj,tarren-mill,2013,shaman,enhancement,153,82,71
Gúîtårgøð,sanguino,2012,shaman,enhancement,83,42,41
Arslos,twisting-nether,2010,shaman,enhancement,50,39,11
Нарленд,gordunni,2003,shaman,enhancement,114,61,53
Yüri,stormscale,1998,shaman,enhancement,265,132,133
Lokes,drakthul,1996,shaman,enhancement,214,116,98
Horelio,sanguino,1995,shaman,enhancement,159,94,65
Nuarishaman,kazzak,1993,shaman,enhancement,48,33,15
Stensham,stormreaver,1989,shaman,enhancement,59,37,22
Chakafuyo,dun-modr,1986,shaman,enhancement,62,37,25
Acidtrips,thrall,1985,shaman,enhancement,54,30,24
Инсэйнгод,soulflayer,1983,shaman,enhancement,63,32,31
Viablous,ravencrest,1981,shaman,enhancement,154,99,55
Testosterone,dun-modr,1980,shaman,enhancement,71,44,27
Shadiqt,stormscale,1978,shaman,enhancement,66,33,33
Turbostruck,ravencrest,1977,shaman,enhancement,102,46,56
Wishsteen,stormscale,1973,shaman,enhancement,95,52,43
Nopre,blackrock,1973,shaman,enhancement,208,113,95
Babalahziz,ysondre,1972,shaman,enhancement,101,70,31
Karpsham,stormscale,1972,shaman,enhancement,133,64,69
Oldveteran,eredar,1968,shaman,enhancement,90,56,34
Hermerejildo,tarren-mill,1965,shaman,enhancement,60,35,25
Shambolicc,ravencrest,1963,shaman,enhancement,82,39,43
Noboorst,stormscale,1961,shaman,enhancement,66,36,30
Shadijr,stormscale,1956,shaman,enhancement,54,32,22
Ниу,thermaplugg,1949,shaman,enhancement,54,32,22
Pusspatrol,kazzak,1949,shaman,enhancement,72,35,37
Deaslow,hyjal,1946,shaman,enhancement,142,81,61
Skullstorm,talnivarr,1945,shaman,enhancement,73,44,29
Frankone,outland,1941,shaman,enhancement,186,106,80
Alterem,kazzak,1941,shaman,enhancement,144,79,65
Tosemist,stormscale,1932,shaman,enhancement,64,38,26
Shamarach,sylvanas,1931,shaman,enhancement,60,38,22
Nnele,sanguino,1925,shaman,enhancement,71,36,35
Brokenguyman,defias-brotherhood,1924,shaman,enhancement,52,31,21
Zulmalis,twisting-nether,1920,shaman,enhancement,94,56,38
Trulylove,outland,1913,shaman,enhancement,77,36,41
Shïnnøk,stormscale,1909,shaman,enhancement,460,230,230
Тандервульф,howling-fjord,1905,shaman,enhancement,125,68,57
Тиидишам,blackscar,1905,shaman,enhancement,143,72,71
Arhitopg,silvermoon,1903,shaman,enhancement,120,64,56
Curioustowel,kazzak,1902,shaman,enhancement,42,26,16
Taktouka,archimonde,1902,shaman,enhancement,65,31,34
Daybidaybi,stormscale,1898,shaman,enhancement,94,48,46
Panzarkamp,stormscale,1894,shaman,enhancement,95,58,37
Gottiy,blackhand,1893,shaman,enhancement,102,50,52
Gromzog,twisting-nether,1890,shaman,enhancement,48,31,17
Enhshamanop,draenor,1883,shaman,enhancement,204,102,102
Morguk,zuljin,1882,shaman,enhancement,97,54,43
Yombaï,archimonde,1880,shaman,enhancement,138,65,73
Blitzmann,outland,1879,shaman,enhancement,54,30,24
Spaltbart,blackmoore,1878,shaman,enhancement,96,58,38
Altarian,nemesis,1878,shaman,enhancement,76,43,33
Mëditåtïøñ,blackrock,1878,shaman,enhancement,42,22,20
Matchstíck,draenor,1875,shaman,enhancement,60,31,29
Вацунвец,goldrinn,1874,shaman,enhancement,163,86,77
Badmojø,silvermoon,1874,shaman,enhancement,76,36,40
Toteemikylpy,argent-dawn,1871,shaman,enhancement,78,51,27
Dhedge,draenor,1870,shaman,enhancement,90,54,36
Jtouni,outland,1869,shaman,enhancement,72,37,35
Херургх,soulflayer,1868,shaman,enhancement,80,52,28
Ятебясмету,gordunni,1867,shaman,enhancement,48,32,16
Jäy,twisting-nether,1867,shaman,enhancement,58,31,27
Ниокумибейт,soulflayer,1866,shaman,enhancement,52,34,18
Вудумастер,gordunni,1866,shaman,enhancement,107,62,45
Бренненд,howling-fjord,1865,shaman,enhancement,128,71,57
Falseshepard,kazzak,1863,shaman,enhancement,54,29,25
Disciplé,blackmoore,1862,shaman,enhancement,65,34,31
Turbostuck,ravencrest,1860,shaman,enhancement,54,28,26
Пеклоь,soulflayer,1860,shaman,enhancement,177,87,90
Ázøk,stormscale,1859,shaman,enhancement,190,99,91
Ganachimby,zuljin,1858,shaman,enhancement,47,34,13
Naochí,silvermoon,1857,shaman,enhancement,35,23,12
Hanrej,draenor,1856,shaman,enhancement,60,37,23
Shamhaár,blackmoore,1856,shaman,enhancement,100,61,39
Radåhn,outland,1854,shaman,enhancement,72,44,28
Løne,sylvanas,1853,shaman,enhancement,48,36,12
Zarkab,ysondre,1852,shaman,enhancement,70,50,20
Chatbanned,blackmoore,1849,shaman,enhancement,42,25,17
Boombastíc,ravencrest,1845,shaman,enhancement,106,53,53
Рэггдолл,soulflayer,1845,shaman,enhancement,102,47,55
Bullx,magtheridon,1843,shaman,enhancement,84,47,37
Totemofgreed,rexxar,1843,shaman,enhancement,84,40,44
Mittyzap,kazzak,1842,shaman,enhancement,72,43,29
Мсет,soulflayer,1841,shaman,enhancement,35,23,12
Сахарокь,soulflayer,1840,shaman,enhancement,42,27,15
Барракудах,razuvious,1840,shaman,enhancement,114,58,56
Shrektar,outland,1839,shaman,enhancement,36,22,14
Androck,tarren-mill,1839,shaman,enhancement,64,36,28
Stormlash,shattered-halls,1838,shaman,enhancement,48,36,12
Kulefesk,grim-batol,1837,shaman,enhancement,66,33,33
Jamdah,stormscale,1835,shaman,enhancement,43,32,11
Xa,blackrock,1835,shaman,enhancement,78,42,36
Actionhank,area-52,1834,shaman,enhancement,57,30,27
Zetorgg,burning-legion,1832,shaman,enhancement,71,36,35
Wacomtablet,kazzak,1830,shaman,enhancement,42,24,18
Друггрумилей,soulflayer,1828,shaman,enhancement,42,24,18
Mírídíuss,silvermoon,1827,shaman,enhancement,35,25,10
Rëalg,zuljin,1827,shaman,enhancement,90,59,31
Salvadr,zuljin,1827,shaman,enhancement,70,39,31
Stormkiler,defias-brotherhood,1826,shaman,enhancement,83,36,47
Шаманмиша,gordunni,1825,shaman,enhancement,36,25,11
Lavadelrey,drakthul,1824,shaman,enhancement,48,25,23
Moini,eredar,1824,shaman,enhancement,60,31,29
Shamflurry,ravencrest,1823,shaman,enhancement,48,33,15
Ananasanax,twisting-nether,1823,shaman,enhancement,114,63,51
Floorislava,culte-de-la-rive-noire,1822,shaman,enhancement,84,43,41
Høwlstørmx,ravencrest,1820,shaman,enhancement,43,31,12
Agathoulis,burning-legion,1820,shaman,enhancement,48,33,15
Phobiatics,thrall,1820,shaman,enhancement,41,28,13
Senroxx,blackrock,1818,shaman,enhancement,48,32,16
Пэппивкашке,howling-fjord,1818,shaman,enhancement,38,23,15
Argotan,drakthul,1817,shaman,enhancement,71,43,28
Thunberg,ravencrest,1817,shaman,enhancement,107,61,46
Mckoy,kazzak,1816,shaman,enhancement,40,27,13
Чаапалах,blackscar,1816,shaman,enhancement,174,87,87
Marohk,uldum,1815,shaman,enhancement,42,22,20
Вандерласт,howling-fjord,1814,shaman,enhancement,90,54,36
Meatballspam,stormscale,1814,shaman,enhancement,71,35,36
Слакербэдбой,gordunni,1814,shaman,enhancement,78,35,43
Stormasaurus,anachronos,1813,shaman,enhancement,52,34,18
Bikdig,dun-modr,1812,shaman,enhancement,78,47,31
Mèátßãllgøðx,kazzak,1812,shaman,enhancement,129,65,64
Medistød,draenor,1811,shaman,enhancement,131,82,49
Eysns,blackrock,1811,shaman,enhancement,70,42,28
Zulren,draenor,1811,shaman,enhancement,42,23,19
Вацустайл,goldrinn,1810,shaman,enhancement,48,32,16
Dshaman,aegwynn,1810,shaman,enhancement,36,23,13
Sangoma,frostmane,1810,shaman,enhancement,196,96,100
Wishstêên,stormscale,1809,shaman,enhancement,64,29,35
Pumpzuat,khadgar,1808,shaman,enhancement,24,20,4
Roxâm,hyjal,1808,shaman,enhancement,34,20,14
Xestil,blackmoore,1808,shaman,enhancement,67,36,31
Blastoiselol,ragnaros,1807,shaman,enhancement,52,34,18
Teknorave,dun-modr,1807,shaman,enhancement,54,29,25
Flappey,stormscale,1805,shaman,enhancement,54,33,21
Реактиватор,soulflayer,1803,shaman,enhancement,47,27,20
Raidwhipper,twisting-nether,1802,shaman,enhancement,84,57,27
Spicemélange,archimonde,1802,shaman,enhancement,64,37,27
Krónm,dun-modr,1801,shaman,enhancement,41,28,13
Sozetwo,tarren-mill,1801,shaman,enhancement,40,24,16
Sybred,twisting-nether,1800,shaman,enhancement,126,76,50
Calvey,magtheridon,1799,shaman,enhancement,82,37,45
Xôàrqt,eredar,1798,shaman,enhancement,262,139,123
Proccq,twisting-nether,1795,shaman,enhancement,48,24,24
Azrs,ravencrest,1794,shaman,enhancement,102,57,45
Veloudinos,twisting-nether,1793,shaman,enhancement,107,71,36
Kishock,tarren-mill,1793,shaman,enhancement,30,19,11
Acivich,frostmane,1793,shaman,enhancement,84,50,34
Shammyenh,burning-legion,1792,shaman,enhancement,48,31,17
Shockxy,norgannon,1792,shaman,enhancement,46,23,23
Talrall,twisting-nether,1790,shaman,enhancement,78,40,38
Shamtard,frostwhisper,1790,shaman,enhancement,169,85,84
Yacu,blackrock,1786,shaman,enhancement,77,43,34
Gelthan,zuljin,1785,shaman,enhancement,206,112,94
Schoølbøyq,blackrock,1784,shaman,enhancement,30,19,11
Pontifhkas,ragnaros,1783,shaman,enhancement,87,55,32
Purgerooni,haomarush,1781,shaman,enhancement,64,41,23
Basz,aegwynn,1781,shaman,enhancement,58,33,25
Ozilie,khaz-modan,1780,shaman,enhancement,71,45,26
Calveyy,magtheridon,1780,shaman,enhancement,45,28,17
Satanloveme,stormscale,1777,shaman,enhancement,42,22,20
Nevergroundx,perenolde,1776,shaman,enhancement,42,27,15
Corvux,tarren-mill,1776,shaman,enhancement,54,26,28
Wúh,twisting-nether,1775,shaman,enhancement,102,59,43
Pumpcok,durotan,1774,shaman,enhancement,42,30,12
Dóómd,kazzak,1772,shaman,enhancement,78,41,37
Pýthøn,silvermoon,1772,shaman,enhancement,54,27,27
Dzandell,silvermoon,1772,shaman,enhancement,68,32,36
Одтагад,gordunni,1771,shaman,enhancement,132,76,56
Vayshibro,turalyon,1770,shaman,enhancement,66,36,30
Rabalalaha,twisting-nether,1770,shaman,enhancement,170,89,81
Ryhèn,stormscale,1769,shaman,enhancement,186,105,81
Obrijames,tarren-mill,1765,shaman,enhancement,94,55,39
Sígrun,aegwynn,1758,shaman,enhancement,42,28,14
Ðrshock,blackmoore,1758,shaman,enhancement,48,28,20
Видарх,soulflayer,1756,shaman,enhancement,42,20,22
Hezdnalien,aegwynn,1750,shaman,enhancement,95,53,42
Ñøs,blackrock,1749,shaman,enhancement,102,55,47
Recaim,outland,1748,shaman,enhancement,47,24,23
Echoingshock,argent-dawn,1746,shaman,enhancement,48,32,16
Stormdrak,eredar,1741,shaman,enhancement,42,29,13
Максобман,howling-fjord,1741,shaman,enhancement,48,27,21
Narevoqi,madmortem,1736,shaman,enhancement,40,28,12
Экспл,ashenvale,1736,shaman,enhancement,48,21,27
Getahex,ravencrest,1735,shaman,enhancement,23,19,4
Tâktoukâ,archimonde,1734,shaman,enhancement,112,59,53
Shds,blackmoore,1733,shaman,enhancement,69,40,29
Totemilokum,stormscale,1732,shaman,enhancement,48,28,20
Tobanga,malganis,1730,shaman,enhancement,48,29,19
Kynaz,sanguino,1730,shaman,enhancement,147,71,76
Халльбьерн,howling-fjord,1726,shaman,enhancement,60,36,24
Sswf,kazzak,1725,shaman,enhancement,24,18,6
Obryss,tarren-mill,1725,shaman,enhancement,29,19,10
Madboys,kazzak,1723,shaman,enhancement,72,39,33
Dalgia,tarren-mill,1722,shaman,enhancement,42,25,17
Lersham,the-maelstrom,1721,shaman,enhancement,65,38,27
Grende,sylvanas,1721,shaman,enhancement,114,58,56
Painshock,outland,1720,shaman,enhancement,93,52,41
Шаманутый,soulflayer,1719,shaman,enhancement,129,62,67
Snëakyboom,stormscale,1717,shaman,enhancement,96,46,50
Nachosauce,tarren-mill,1716,shaman,enhancement,30,18,12
Ваншотстайлз,soulflayer,1716,shaman,enhancement,64,34,30
Jaimæ,ravencrest,1715,shaman,enhancement,24,18,6
Тралси,howling-fjord,1715,shaman,enhancement,24,18,6
Lavarage,kazzak,1715,shaman,enhancement,39,27,12
Yogan,dun-modr,1714,shaman,enhancement,68,38,30
Stormbreáker,twisting-nether,1711,shaman,enhancement,172,101,71
Ludwigson,tarren-mill,1709,shaman,enhancement,104,62,42
Tito,stormscale,1708,shaman,enhancement,66,28,38
Enhx,ravencrest,1707,shaman,enhancement,36,23,13
Joanna,frostwolf,1705,shaman,enhancement,66,31,35
Groyaboý,blackrock,1704,shaman,enhancement,24,18,6
Fotmburstwin,blackmoore,1704,shaman,enhancement,42,27,15
Fözk,outland,1704,shaman,enhancement,42,24,18
Stormfíst,tarren-mill,1703,shaman,enhancement,48,28,20
Mulf,darksorrow,1703,shaman,enhancement,70,36,34
Khamo,twisting-nether,1702,shaman,enhancement,47,25,22
Сидог,soulflayer,1701,shaman,enhancement,24,18,6
Маелштромс,soulflayer,1699,shaman,enhancement,54,26,28
Caelx,ragnaros,1698,shaman,enhancement,24,18,6
Monamour,twisting-nether,1698,shaman,enhancement,66,40,26
Enhahaha,tarren-mill,1697,shaman,enhancement,36,23,13
Javaburst,ragnaros,1697,shaman,enhancement,102,55,47
Nerfrets,malganis,1696,shaman,enhancement,72,46,26
Aswøg,kazzak,1695,shaman,enhancement,30,21,9
Skilltissue,executus,1694,shaman,enhancement,78,42,36
Khrin,blackmoore,1693,shaman,enhancement,42,27,15
Kaimountain,defias-brotherhood,1693,shaman,enhancement,42,26,16
Typhoön,sanguino,1691,shaman,enhancement,253,131,122
Халльбиорн,gordunni,1691,shaman,enhancement,67,32,35
Царьбер,soulflayer,1690,shaman,enhancement,80,45,35
Volvíc,tichondrius,1687,shaman,enhancement,42,22,20
Vartarius,arthas,1687,shaman,enhancement,102,53,49
Láynert,dun-modr,1685,shaman,enhancement,300,150,150
Ripstorm,sylvanas,1685,shaman,enhancement,48,24,24
Mehex,tarren-mill,1685,shaman,enhancement,54,26,28
Chêlëx,silvermoon,1684,shaman,enhancement,188,101,87
Thorâ,frostmane,1683,shaman,enhancement,65,48,17
Skyróxx,blackrock,1682,shaman,enhancement,51,30,21
Шанья,gordunni,1682,shaman,enhancement,108,52,56
Tinysalmon,hyjal,1681,shaman,enhancement,30,18,12
Взалходил,soulflayer,1680,shaman,enhancement,41,21,20
Hassebolt,draenor,1678,shaman,enhancement,42,25,17
Voodoohexman,kazzak,1678,shaman,enhancement,130,74,56
Naïda,conseil-des-ombres,1678,shaman,enhancement,216,108,108
Spetsnazz,archimonde,1678,shaman,enhancement,230,114,116
Кинговели,soulflayer,1677,shaman,enhancement,197,103,94
Wheygodx,ravencrest,1677,shaman,enhancement,111,58,53
Kedall,archimonde,1676,shaman,enhancement,66,32,34
Doomëd,drakthul,1675,shaman,enhancement,48,24,24
Ашхикиган,howling-fjord,1675,shaman,enhancement,144,67,77
Ewion,dalvengyr,1674,shaman,enhancement,54,40,14
Пойдипокури,howling-fjord,1674,shaman,enhancement,126,72,54
Matrixxer,aegwynn,1672,shaman,enhancement,27,19,8
Greythunda,archimonde,1672,shaman,enhancement,36,23,13
Гоэл,ashenvale,1672,shaman,enhancement,42,26,16
Bluetide,ravencrest,1671,shaman,enhancement,51,34,17
Shamerific,magtheridon,1671,shaman,enhancement,60,39,21
Pumanii,silvermoon,1669,shaman,enhancement,60,32,28
Lurkmon,twisting-nether,1669,shaman,enhancement,118,62,56
Чифсоса,soulflayer,1668,shaman,enhancement,54,26,28
Jabaraklol,stormscale,1665,shaman,enhancement,103,64,39
Isucklasso,aegwynn,1664,shaman,enhancement,54,32,22
Cåmilis,archimonde,1664,shaman,enhancement,60,33,27
Voodoodocter,kazzak,1664,shaman,enhancement,113,56,57
Neurax,sanguino,1663,shaman,enhancement,88,47,41
Grytkungen,daggerspine,1662,shaman,enhancement,56,34,22
Khelyyn,tarren-mill,1662,shaman,enhancement,76,39,37
Rayoton,burning-legion,1662,shaman,enhancement,72,35,37
Darkning,kazzak,1661,shaman,enhancement,48,29,19
Nibblez,aegwynn,1659,shaman,enhancement,78,50,28
Nînadobrevx,stormscale,1658,shaman,enhancement,141,80,61
Wafflë,ragnaros,1658,shaman,enhancement,69,37,32
Chehkhan,archimonde,1657,shaman,enhancement,40,19,21
Vargen,arygos,1655,shaman,enhancement,30,20,10
Элементи,gordunni,1655,shaman,enhancement,219,120,99
Athe,conseil-des-ombres,1654,shaman,enhancement,65,35,30
Faxsham,draenor,1652,shaman,enhancement,48,29,19
Лолимин,borean-tundra,1651,shaman,enhancement,51,33,18
Lekthar,draenor,1651,shaman,enhancement,67,38,29
Kilomanjaro,bloodfeather,1651,shaman,enhancement,60,32,28
Funkins,hyjal,1651,shaman,enhancement,55,29,26
Tdogfx,blackhand,1650,shaman,enhancement,42,26,16
Purgelord,tarren-mill,1650,shaman,enhancement,80,49,31
Trenhard,wildhammer,1648,shaman,enhancement,65,46,19
Groumgard,hyjal,1648,shaman,enhancement,50,30,20
Akhlýzz,ysondre,1647,shaman,enhancement,39,24,15
Testogodx,defias-brotherhood,1646,shaman,enhancement,87,48,39
Turbopuddi,kazzak,1646,shaman,enhancement,89,45,44
Plockepinn,ravencrest,1646,shaman,enhancement,84,38,46
Griins,ravencrest,1645,shaman,enhancement,87,53,34
Onebutton,archimonde,1644,shaman,enhancement,30,21,9
Ecclîpce,archimonde,1643,shaman,enhancement,84,49,35
Hayvaan,blackrock,1643,shaman,enhancement,192,110,82
Makaar,blackrock,1643,shaman,enhancement,54,28,26
Defiaz,stormscale,1642,shaman,enhancement,52,38,14
Stalkun,elune,1642,shaman,enhancement,54,29,25
Spacelazers,twisting-nether,1641,shaman,enhancement,29,19,10
Yobro,archimonde,1641,shaman,enhancement,60,36,24
Энха,howling-fjord,1641,shaman,enhancement,36,21,15
Порнёреф,howling-fjord,1638,shaman,enhancement,165,98,67
Shambamm,stormscale,1637,shaman,enhancement,54,31,23
Tornis,terokkar,1637,shaman,enhancement,102,55,47
Чесп,ashenvale,1636,shaman,enhancement,66,36,30
Elemoont,tarren-mill,1633,shaman,enhancement,48,28,20
Paintball,kazzak,1633,shaman,enhancement,132,71,61
Legitbro,ravencrest,1633,shaman,enhancement,48,22,26
Vforvendeta,defias-brotherhood,1632,shaman,enhancement,66,38,28
Botism,draenor,1631,shaman,enhancement,66,37,29
Argarok,argent-dawn,1630,shaman,enhancement,36,22,14
Sswfx,kazzak,1630,shaman,enhancement,30,17,13
Shamrún,sylvanas,1629,shaman,enhancement,60,37,23
Lilmozart,twisting-nether,1628,shaman,enhancement,35,18,17
Tartakos,ravencrest,1627,shaman,enhancement,73,41,32
Pvegame,tarren-mill,1627,shaman,enhancement,108,58,50
Djimin,sanguino,1627,shaman,enhancement,42,22,20
Johncoltrane,archimonde,1626,shaman,enhancement,54,36,18
Ùseless,archimonde,1626,shaman,enhancement,36,20,16
Traktorchox,draenor,1626,shaman,enhancement,45,24,21
Эбгерсон,soulflayer,1625,shaman,enhancement,222,119,103
Канамаш,borean-tundra,1624,shaman,enhancement,42,27,15
Ойрхин,greymane,1624,shaman,enhancement,48,24,24
Chamkalix,sanguino,1623,shaman,enhancement,72,37,35
Reparagos,sanguino,1622,shaman,enhancement,47,27,20
Secramas,ragnaros,1622,shaman,enhancement,145,80,65
Úpli,blackmoore,1621,shaman,enhancement,30,18,12
Twists,sylvanas,1621,shaman,enhancement,36,21,15
Hailele,argent-dawn,1620,shaman,enhancement,38,25,13
Zutemaster,stormscale,1619,shaman,enhancement,52,27,25
Ferconex,kazzak,1619,shaman,enhancement,136,70,66
Пучмек,gordunni,1618,shaman,enhancement,48,35,13
Зэбой,howling-fjord,1616,shaman,enhancement,50,33,17
Kæzx,blackrock,1616,shaman,enhancement,66,34,32
Commadore,korgall,1616,shaman,enhancement,42,20,22
Werdup,sunstrider,1616,shaman,enhancement,44,19,25
Kagurja,blackmoore,1614,shaman,enhancement,30,21,9
Kilnih,archimonde,1614,shaman,enhancement,30,20,10
Иннреи,howling-fjord,1614,shaman,enhancement,75,46,29
Björnbritta,outland,1614,shaman,enhancement,41,23,18
Царьколтрэйн,blackscar,1613,shaman,enhancement,107,56,51
Lassolasse,sylvanas,1612,shaman,enhancement,24,17,7
Sonnestorm,tarren-mill,1612,shaman,enhancement,30,20,10
Boltar,die-aldor,1612,shaman,enhancement,36,19,17
Ореганно,howling-fjord,1611,shaman,enhancement,72,40,32
Jondil,das-syndikat,1611,shaman,enhancement,71,37,34
Smozze,grim-batol,1611,shaman,enhancement,177,90,87
Toxicnux,nemesis,1610,shaman,enhancement,48,28,20
Чухансмент,gordunni,1610,shaman,enhancement,63,33,30
Лапища,soulflayer,1609,shaman,enhancement,103,62,41
Selticxz,blackrock,1609,shaman,enhancement,30,17,13
Benderbub,blackhand,1609,shaman,enhancement,130,70,60
Totemticks,aegwynn,1609,shaman,enhancement,48,25,23
Шокмужик,gordunni,1608,shaman,enhancement,60,28,32
Voodooms,laughing-skull,1607,shaman,enhancement,77,47,30
Cealdlynn,blackmoore,1607,shaman,enhancement,41,24,17
Elémenta,turalyon,1607,shaman,enhancement,54,30,24
Mõrax,ysondre,1607,shaman,enhancement,163,82,81
Reisti,stormscale,1606,shaman,enhancement,36,26,10
Ancestro,kazzak,1606,shaman,enhancement,60,32,28
Palmalecki,ravencrest,1605,shaman,enhancement,60,27,33
Grrud,draenor,1604,shaman,enhancement,42,23,19
Sêarix,aegwynn,1603,shaman,enhancement,48,31,17
Shocktopussi,stormscale,1603,shaman,enhancement,51,32,19
Bourdieu,thrall,1602,shaman,enhancement,75,45,30
Moaxtyr,blackmoore,1601,shaman,enhancement,42,29,13
Boradinn,hyjal,1601,shaman,enhancement,36,21,15
Vulkân,silvermoon,1601,shaman,enhancement,176,97,79
Venomos,kazzak,1601,shaman,enhancement,39,18,21
Tijae,ravencrest,1600,shaman,enhancement,24,19,5
Buuddha,drakthul,1600,shaman,enhancement,71,39,32
Mmsalatik,nemesis,1600,shaman,enhancement,36,19,17
Ïï,archimonde,1600,shaman,enhancement,195,102,93
Amelie,burning-steppes,1597,shaman,enhancement,42,24,18
Kosface,tarren-mill,1597,shaman,enhancement,160,85,75
Sndheal,kazzak,1596,shaman,enhancement,24,19,5
Loshohealva,stormscale,1596,shaman,enhancement,48,26,22
Patsham,wildhammer,1595,shaman,enhancement,125,72,53
Zakgar,ysondre,1594,shaman,enhancement,78,41,37
Ekinoz,outland,1593,shaman,enhancement,38,20,18
Elèon,blackrock,1593,shaman,enhancement,125,59,66
Galthazar,silvermoon,1591,shaman,enhancement,58,31,27
Belroc,ravencrest,1591,shaman,enhancement,36,19,17
Ðreamz,kaelthas,1588,shaman,enhancement,91,45,46
Joanno,aegwynn,1587,shaman,enhancement,24,19,5
Kammek,tarren-mill,1583,shaman,enhancement,81,48,33
Krassus,drakthul,1583,shaman,enhancement,53,31,22
Xxloon,blackrock,1583,shaman,enhancement,126,73,53
Äijä,chromaggus,1582,shaman,enhancement,96,51,45
Kachori,eredar,1581,shaman,enhancement,78,35,43
Цс,azuregos,1579,shaman,enhancement,116,63,53
Arkîmonde,silvermoon,1579,shaman,enhancement,47,23,24
Brenhilda,blackmoore,1578,shaman,enhancement,78,49,29
Razzuan,kazzak,1577,shaman,enhancement,36,20,16
Kættmæck,tarren-mill,1576,shaman,enhancement,72,37,35
Îzanami,ravencrest,1573,shaman,enhancement,138,77,61
Ubies,silvermoon,1573,shaman,enhancement,81,45,36
Madmadbro,tarren-mill,1572,shaman,enhancement,204,107,97
Wertih,burning-legion,1570,shaman,enhancement,56,35,21
Kijin,kirin-tor,1569,shaman,enhancement,108,56,52
Juniyaa,blackrock,1566,shaman,enhancement,53,29,24
Людоед,thermaplugg,1566,shaman,enhancement,108,58,50
Azzizael,argent-dawn,1566,shaman,enhancement,108,55,53
Earthhulk,thrall,1564,shaman,enhancement,40,21,19
Thrâwl,kazzak,1563,shaman,enhancement,24,19,5
Tescriamelio,ysondre,1561,shaman,enhancement,30,19,11
Ubramovitch,hyjal,1561,shaman,enhancement,48,25,23
Sûmmêrz,ravencrest,1560,shaman,enhancement,36,22,14
Pyrabolt,ravencrest,1560,shaman,enhancement,51,25,26
Ромчи,gordunni,1559,shaman,enhancement,30,17,13
Epicenter,bloodscalp,1559,shaman,enhancement,60,29,31
Элетеми,soulflayer,1558,shaman,enhancement,83,45,38
Bumbummann,blackmoore,1558,shaman,enhancement,112,55,57
Ghobi,blackrock,1557,shaman,enhancement,48,24,24
Gnubbzer,antonidas,1556,shaman,enhancement,48,24,24
Jameo,drakthul,1553,shaman,enhancement,66,30,36
Tiuzzo,alakir,1552,shaman,enhancement,42,23,19
Shawck,ravencrest,1552,shaman,enhancement,46,25,21
Alethea,frostmane,1552,shaman,enhancement,84,44,40
Jeki,ysondre,1552,shaman,enhancement,168,81,87
Juicewillis,defias-brotherhood,1551,shaman,enhancement,66,43,23
Тандеркок,soulflayer,1551,shaman,enhancement,68,33,35
Alwaysangry,silvermoon,1548,shaman,enhancement,33,18,15
Megazz,drakthul,1548,shaman,enhancement,48,26,22
Estasham,stormscale,1548,shaman,enhancement,150,81,69
Zayliha,ravencrest,1547,shaman,enhancement,36,20,16
Nuclearjohny,eredar,1547,shaman,enhancement,36,18,18
Apexpredlol,blackmoore,1546,shaman,enhancement,96,45,51
Garulf,twisting-nether,1541,shaman,enhancement,57,27,30
Soomx,hyjal,1539,shaman,enhancement,86,45,41
Explôsive,silvermoon,1539,shaman,enhancement,90,45,45
Heeze,doomhammer,1538,shaman,enhancement,190,102,88
Shaakez,kazzak,1538,shaman,enhancement,42,22,20
Kutipaperi,stormscale,1537,shaman,enhancement,60,33,27
Mesrines,archimonde,1536,shaman,enhancement,42,22,20
Kuzsham,archimonde,1534,shaman,enhancement,39,18,21
Politemanner,stormscale,1532,shaman,enhancement,30,16,14
Онеоне,deathweaver,1530,shaman,enhancement,36,17,19
Дефибо,howling-fjord,1529,shaman,enhancement,204,105,99
Mcbloob,kazzak,1529,shaman,enhancement,99,50,49
Шампуньхан,blackscar,1527,shaman,enhancement,76,33,43
Tóyzz,ravencrest,1526,shaman,enhancement,42,27,15
Yelawolf,shattered-hand,1526,shaman,enhancement,36,22,14
Thalir,aegwynn,1526,shaman,enhancement,67,30,37
Depucova,silvermoon,1525,shaman,enhancement,36,24,12
Axilary,tarren-mill,1525,shaman,enhancement,24,16,8
Kurdhran,blackmoore,1525,shaman,enhancement,75,42,33
Cripxo,sanguino,1523,shaman,enhancement,18,16,2
Szublime,stormscale,1523,shaman,enhancement,66,35,31
Gandy,the-maelstrom,1522,shaman,enhancement,114,55,59
Rehgar,frostwhisper,1522,shaman,enhancement,54,26,28
Raveell,defias-brotherhood,1522,shaman,enhancement,100,46,54
Robzn,blackrock,1521,shaman,enhancement,24,16,8
Sitkosham,burning-blade,1521,shaman,enhancement,47,28,19
Krovn,aszune,1521,shaman,enhancement,60,27,33
Thralgr,sylvanas,1521,shaman,enhancement,42,18,24
Флэшмэн,blackscar,1520,shaman,enhancement,24,19,5
Dunî,tarren-mill,1517,shaman,enhancement,48,32,16
Lupisregina,silvermoon,1517,shaman,enhancement,24,16,8
Puumbaa,defias-brotherhood,1517,shaman,enhancement,54,28,26
Pepernootje,sylvanas,1517,shaman,enhancement,70,34,36
Crowness,ragnaros,1516,shaman,enhancement,36,22,14
Veteroth,argent-dawn,1516,shaman,enhancement,54,25,29
Irønythar,drakthul,1514,shaman,enhancement,53,27,26
Cheetooth,ragnaros,1514,shaman,enhancement,48,24,24
Filiduttsham,ravencrest,1513,shaman,enhancement,24,16,8
Cowfeelings,ravencrest,1513,shaman,enhancement,30,16,14
Silden,thrall,1511,shaman,enhancement,18,16,2
Kuubskii,ravencrest,1511,shaman,enhancement,24,16,8
Romacherry,aegwynn,1511,shaman,enhancement,125,69,56
Духсалата,grom,1511,shaman,enhancement,36,16,20
Totemlover,draenor,1510,shaman,enhancement,100,59,41
Tarantan,eredar,1510,shaman,enhancement,61,32,29
Жуксик,greymane,1509,shaman,enhancement,66,31,35
Gøretterøg,ysondre,1507,shaman,enhancement,25,16,9
Miriam,stormreaver,1507,shaman,enhancement,48,28,20
Плаглорд,howling-fjord,1501,shaman,enhancement,72,40,32
Oronakgladx,ravencrest,1500,shaman,enhancement,90,46,44
Bolgrath,blackmoore,1500,shaman,enhancement,115,58,57
Hexwife,archimonde,1500,shaman,enhancement,121,59,62
Гексанол,soulflayer,1499,shaman,enhancement,66,36,30
Xilz,twisting-nether,1498,shaman,enhancement,89,47,42
Arkaos,exodar,1495,shaman,enhancement,49,29,20
Deathshamãn,stormscale,1495,shaman,enhancement,42,20,22
Earthshot,magtheridon,1494,shaman,enhancement,52,25,27
Sházam,destromath,1493,shaman,enhancement,24,16,8
Chendra,scarshield-legion,1493,shaman,enhancement,125,59,66
Пивототем,gordunni,1492,shaman,enhancement,44,25,19
Faltygo,drakthul,1492,shaman,enhancement,36,17,19
Freadorn,uldaman,1491,shaman,enhancement,24,16,8
Kanaky,hyjal,1491,shaman,enhancement,79,36,43
Nargrul,tarren-mill,1490,shaman,enhancement,50,31,19
Nexdown,archimonde,1490,shaman,enhancement,57,28,29
Atée,silvermoon,1490,shaman,enhancement,87,42,45
Electrify,aegwynn,1489,shaman,enhancement,30,21,9
Yasaburo,silvermoon,1488,shaman,enhancement,30,18,12
Vascodagama,twisting-nether,1488,shaman,enhancement,48,28,20
Stromkek,eredar,1488,shaman,enhancement,59,33,26
Proccazu,draenor,1487,shaman,enhancement,60,37,23
Fatflop,sylvanas,1486,shaman,enhancement,96,51,45
Kazing,outland,1485,shaman,enhancement,29,16,13
Boulggour,chogall,1485,shaman,enhancement,48,26,22
Shyne,vashj,1485,shaman,enhancement,30,16,14
Arashi,rashgarroth,1484,shaman,enhancement,60,32,28
Nyxoqtx,draenor,1481,shaman,enhancement,30,25,5
Rakermän,dun-modr,1480,shaman,enhancement,40,21,19
Convîcted,grim-batol,1479,shaman,enhancement,28,18,10
Hulcky,grim-batol,1479,shaman,enhancement,60,32,28
Bozzclqwnx,aegwynn,1478,shaman,enhancement,38,22,16
Shyrion,onyxia,1478,shaman,enhancement,72,33,39
Skut,zuljin,1476,shaman,enhancement,36,18,18
Opráwindfury,stormscale,1475,shaman,enhancement,44,27,17
Trendsetter,frostmane,1475,shaman,enhancement,44,26,18
Chimp,lightnings-blade,1475,shaman,enhancement,36,21,15
Rutil,blackhand,1475,shaman,enhancement,30,17,13
Justweirdaf,blackmoore,1475,shaman,enhancement,83,44,39
Rocktopus,outland,1475,shaman,enhancement,57,27,30
Filigran,ragnaros,1472,shaman,enhancement,83,46,37
Mjjx,blackrock,1471,shaman,enhancement,36,24,12
Enigmar,stormscale,1471,shaman,enhancement,93,43,50
Otacboziji,sylvanas,1470,shaman,enhancement,54,23,31
Ashmantle,twisting-nether,1469,shaman,enhancement,30,18,12
Vrontes,kazzak,1468,shaman,enhancement,48,29,19
Axahavregryn,kazzak,1467,shaman,enhancement,36,17,19
Shamãn,draenor,1467,shaman,enhancement,42,19,23
Tanjîrø,archimonde,1466,shaman,enhancement,36,20,16
Raíndra,twisting-nether,1466,shaman,enhancement,36,16,20
Амг,booty-bay,1465,shaman,enhancement,74,45,29
Дромгрон,howling-fjord,1463,shaman,enhancement,42,22,20
Apekeeper,silvermoon,1461,shaman,enhancement,66,29,37
Nubokesel,ragnaros,1460,shaman,enhancement,107,56,51
Itswoland,tarren-mill,1459,shaman,enhancement,40,21,19
Ðelenis,dun-modr,1459,shaman,enhancement,60,27,33
Masztaar,ragnaros,1458,shaman,enhancement,122,60,62
Pilcosham,frostwhisper,1453,shaman,enhancement,71,32,39
Рокмару,soulflayer,1453,shaman,enhancement,41,18,23
Chaeemerok,dun-modr,1453,shaman,enhancement,42,16,26
Шторсонг,gordunni,1451,shaman,enhancement,74,48,26
Моктрогтар,ashenvale,1449,shaman,enhancement,54,32,22
Løktarøgàr,archimonde,1448,shaman,enhancement,47,25,22
Gerethor,burning-legion,1448,shaman,enhancement,87,39,48
Naturfury,ravencrest,1447,shaman,enhancement,30,21,9
Yaar,alleria,1446,shaman,enhancement,88,51,37
Alphas,draenor,1445,shaman,enhancement,44,26,18
Lexyiasz,kazzak,1444,shaman,enhancement,28,22,6
Lokresh,azjolnerub,1444,shaman,enhancement,54,30,24
Xwitchdoctor,draenor,1444,shaman,enhancement,36,17,19
Dirtymiké,tarren-mill,1444,shaman,enhancement,41,16,25
Exolnard,twisting-nether,1442,shaman,enhancement,73,42,31
Jawoburst,antonidas,1442,shaman,enhancement,65,31,34
Furrymane,blackmoore,1439,shaman,enhancement,36,24,12
Shamxd,kazzak,1439,shaman,enhancement,71,35,36
Perunya,tarren-mill,1438,shaman,enhancement,53,27,26
Jasnäh,ysondre,1437,shaman,enhancement,72,33,39
Valaya,archimonde,1436,shaman,enhancement,128,72,56
Kyshka,tarren-mill,1436,shaman,enhancement,30,15,15
Shámi,gilneas,1435,shaman,enhancement,30,15,15
Stratholmee,drakthul,1432,shaman,enhancement,48,27,21
Roovenhance,aegwynn,1431,shaman,enhancement,34,23,11
Klintxbob,hyjal,1431,shaman,enhancement,30,15,15
Blackibird,garona,1431,shaman,enhancement,69,32,37
Лаваяшка,gordunni,1430,shaman,enhancement,48,19,29
Axemodels,archimonde,1429,shaman,enhancement,30,15,15
Dcanne,outland,1428,shaman,enhancement,99,52,47
Yurkën,uldum,1428,shaman,enhancement,60,29,31
Rockjuices,twisting-nether,1427,shaman,enhancement,72,42,30
Mcslammer,kazzak,1427,shaman,enhancement,114,54,60
Wolfwesti,outland,1426,shaman,enhancement,42,28,14
Джаабб,booty-bay,1426,shaman,enhancement,85,38,47
Twam,outland,1425,shaman,enhancement,30,19,11
Jarrek,draenor,1425,shaman,enhancement,42,20,22
Durek,sylvanas,1424,shaman,enhancement,47,30,17
Lehit,outland,1424,shaman,enhancement,30,15,15
Rether,nemesis,1424,shaman,enhancement,83,38,45
Reverbx,outland,1423,shaman,enhancement,24,15,9
Shockthat,draenor,1423,shaman,enhancement,124,69,55
Nwäar,archimonde,1423,shaman,enhancement,42,18,24
Kezron,aegwynn,1422,shaman,enhancement,24,15,9
Lëvi,archimonde,1421,shaman,enhancement,24,15,9
Ðezûga,antonidas,1421,shaman,enhancement,113,57,56
Vann,the-shatar,1421,shaman,enhancement,30,15,15
Procctor,kazzak,1420,shaman,enhancement,18,15,3
Zuvx,ravencrest,1420,shaman,enhancement,66,38,28
Mèshuggáh,ravencrest,1419,shaman,enhancement,36,17,19
Барракудах,gordunni,1418,shaman,enhancement,170,76,94
Nejbegrov,ravencrest,1417,shaman,enhancement,66,29,37
Гусан,booty-bay,1416,shaman,enhancement,80,36,44
Tyrox,kirin-tor,1413,shaman,enhancement,72,38,34
Hanumanas,kazzak,1412,shaman,enhancement,25,18,7
Атл,deathguard,1411,shaman,enhancement,74,46,28
Propanengtmr,stormscale,1406,shaman,enhancement,29,15,14
Фарраон,deathguard,1405,shaman,enhancement,54,29,25
Язма,grom,1404,shaman,enhancement,54,31,23
Курси,gordunni,1403,shaman,enhancement,198,95,103
Noiduttu,tarren-mill,1401,shaman,enhancement,88,55,33
Kpåshaman,tarren-mill,1400,shaman,enhancement,30,17,13
Arabesk,arygos,1399,shaman,enhancement,84,51,33
Lumii,azshara,1399,shaman,enhancement,48,21,27
Ghostkod,burning-legion,1396,shaman,enhancement,64,36,28
Bobonbu,forscherliga,1396,shaman,enhancement,29,15,14
Procdaddy,eredar,1396,shaman,enhancement,54,25,29
Kohnân,hyjal,1395,shaman,enhancement,36,23,13
Экспатриот,greymane,1395,shaman,enhancement,60,31,29
Frostýx,draenor,1394,shaman,enhancement,33,16,17
Argonautt,drakthul,1394,shaman,enhancement,119,52,67
Neptun,twisting-nether,1393,shaman,enhancement,107,53,54
Laix,khaz-modan,1392,shaman,enhancement,36,17,19
Kenseienh,kazzak,1391,shaman,enhancement,231,121,110
Shockbot,blackmoore,1388,shaman,enhancement,30,20,10
Kïngmuntje,sylvanas,1388,shaman,enhancement,60,32,28
Priora,argent-dawn,1383,shaman,enhancement,52,33,19
Лайтхальзен,howling-fjord,1383,shaman,enhancement,36,16,20
Rodneymullen,tarren-mill,1381,shaman,enhancement,35,17,18
Хрофайс,soulflayer,1379,shaman,enhancement,30,20,10
Mazokuu,ragnaros,1379,shaman,enhancement,139,74,65
Igniis,frostmane,1374,shaman,enhancement,42,28,14
Tahsus,blackmoore,1372,shaman,enhancement,42,20,22
Твалор,soulflayer,1371,shaman,enhancement,50,26,24
Cahuna,stormscale,1371,shaman,enhancement,63,24,39
Капарис,deathweaver,1369,shaman,enhancement,39,21,18
Enormo,eredar,1368,shaman,enhancement,30,16,14
Watzocham,archimonde,1366,shaman,enhancement,48,22,26
Panicblast,stormscale,1366,shaman,enhancement,35,15,20
Nøve,nemesis,1365,shaman,enhancement,24,16,8
Notoxus,antonidas,1364,shaman,enhancement,78,39,39
Elektrikci,silvermoon,1362,shaman,enhancement,66,30,36
Trîkill,hyjal,1360,shaman,enhancement,60,28,32
Басари,gordunni,1357,shaman,enhancement,41,20,21
Shaayys,archimonde,1356,shaman,enhancement,102,44,58
Chämalö,archimonde,1354,shaman,enhancement,151,78,73
Lavashnikov,burning-legion,1353,shaman,enhancement,150,79,71
Тленозавр,gordunni,1352,shaman,enhancement,93,46,47
Darhgan,argent-dawn,1350,shaman,enhancement,30,16,14
Nakenfeigy,stormreaver,1349,shaman,enhancement,54,32,22
Рыргаск,howling-fjord,1349,shaman,enhancement,28,16,12
Chamirox,ysondre,1348,shaman,enhancement,42,17,25
Exysen,kazzak,1344,shaman,enhancement,24,14,10
Enh,archimonde,1343,shaman,enhancement,24,14,10
Faydé,stormscale,1343,shaman,enhancement,30,14,16
Даблпамп,howling-fjord,1343,shaman,enhancement,35,16,19
Кгб,greymane,1341,shaman,enhancement,72,33,39
Дрегтан,howling-fjord,1341,shaman,enhancement,71,28,43
Akimó,ravencrest,1340,shaman,enhancement,18,14,4
Casualhex,argent-dawn,1340,shaman,enhancement,155,71,84
Hatchum,les-sentinelles,1339,shaman,enhancement,60,24,36
Chamel,draenor,1337,shaman,enhancement,30,14,16
Залатар,howling-fjord,1337,shaman,enhancement,63,26,37
Fingor,tarren-mill,1336,shaman,enhancement,24,17,7
Gurtok,drakthul,1336,shaman,enhancement,36,22,14
Bacheebg,darksorrow,1333,shaman,enhancement,101,54,47
Éàsy,blackmoore,1333,shaman,enhancement,38,20,18
Fotmglad,blackrock,1332,shaman,enhancement,24,14,10
Boidarbre,sargeras,1331,shaman,enhancement,42,15,27
Реалайзер,blackscar,1330,shaman,enhancement,24,14,10
Shreks,frostmane,1330,shaman,enhancement,48,26,22
Палачок,eversong,1328,shaman,enhancement,78,40,38
Moodoo,antonidas,1328,shaman,enhancement,53,20,33
Duhrak,argent-dawn,1327,shaman,enhancement,54,30,24
Shamanite,drakthul,1326,shaman,enhancement,42,22,20
Mhoriaak,stormscale,1326,shaman,enhancement,30,15,15
Magmamonster,tarren-mill,1326,shaman,enhancement,30,14,16
Akimboo,kilrogg,1324,shaman,enhancement,60,27,33
Iicks,blackrock,1323,shaman,enhancement,48,21,27
Kanabi,darkspear,1322,shaman,enhancement,30,14,16
Бигмамуля,booty-bay,1321,shaman,enhancement,36,18,18
Ошиндра,gordunni,1320,shaman,enhancement,28,15,13
Clembute,cthun,1319,shaman,enhancement,48,28,20
Hopefully,eredar,1316,shaman,enhancement,24,14,10
Другалёк,howling-fjord,1314,shaman,enhancement,52,30,22
Шабыч,deathguard,1312,shaman,enhancement,60,25,35
Агмень,howling-fjord,1310,shaman,enhancement,127,56,71
Outerspace,silvermoon,1309,shaman,enhancement,24,15,9
Persaunne,archimonde,1309,shaman,enhancement,42,23,19
Maajo,tarren-mill,1309,shaman,enhancement,54,21,33
Relampago,eredar,1307,shaman,enhancement,36,16,20
Lahur,blackmoore,1306,shaman,enhancement,30,19,11
Qauter,hellfire,1305,shaman,enhancement,30,14,16
Holten,outland,1302,shaman,enhancement,60,30,30
Blautorkel,amanthul,1302,shaman,enhancement,65,31,34
Groundead,alakir,1300,shaman,enhancement,40,16,24
Shamaray,stormscale,1299,shaman,enhancement,96,52,44
Rhastasho,archimonde,1299,shaman,enhancement,84,45,39
Wedís,outland,1299,shaman,enhancement,42,22,20
Barbebiendur,archimonde,1299,shaman,enhancement,36,16,20
Thormarg,archimonde,1296,shaman,enhancement,60,29,31
Kardyo,archimonde,1295,shaman,enhancement,21,14,7
Sunetee,kazzak,1294,shaman,enhancement,54,23,31
Verlas,kazzak,1293,shaman,enhancement,52,26,26
Апинсмок,soulflayer,1292,shaman,enhancement,75,36,39
Hexd,defias-brotherhood,1291,shaman,enhancement,66,28,38
Kunancementa,ravencrest,1289,shaman,enhancement,75,32,43
Shambambum,blackrock,1289,shaman,enhancement,113,48,65
Goatsandoats,doomhammer,1287,shaman,enhancement,24,15,9
Trollomatic,das-syndikat,1286,shaman,enhancement,54,28,26
Haldrim,blackmoore,1284,shaman,enhancement,27,15,12
Киллдрак,howling-fjord,1283,shaman,enhancement,36,19,17
Срувтапкии,deathguard,1282,shaman,enhancement,54,29,25
Juliaroberts,ragnaros,1282,shaman,enhancement,93,46,47
Zandali,tarren-mill,1280,shaman,enhancement,78,44,34
Idxbi,kazzak,1279,shaman,enhancement,114,63,51
Manrod,tarren-mill,1279,shaman,enhancement,66,34,32
Лэнгипас,gordunni,1278,shaman,enhancement,155,79,76
Shamomo,hyjal,1278,shaman,enhancement,85,38,47
Шрамуля,soulflayer,1277,shaman,enhancement,23,15,8
Броаркар,razuvious,1277,shaman,enhancement,106,56,50
Амфеминка,gordunni,1275,shaman,enhancement,28,14,14
Tzaish,blackmoore,1271,shaman,enhancement,28,14,14
Delgagalduos,kazzak,1267,shaman,enhancement,48,25,23
Vukroth,argent-dawn,1266,shaman,enhancement,48,25,23
Ørgus,aegwynn,1265,shaman,enhancement,274,146,128
Tornadozzer,burning-legion,1263,shaman,enhancement,54,29,25
Prømetheüs,sanguino,1262,shaman,enhancement,58,35,23
Shamaneo,outland,1260,shaman,enhancement,39,26,13
Чернышус,soulflayer,1259,shaman,enhancement,44,20,24
Baineoof,tarren-mill,1259,shaman,enhancement,41,18,23
Psychobarbie,outland,1255,shaman,enhancement,23,14,9
Адичал,soulflayer,1253,shaman,enhancement,36,20,16
Gõðzilla,blackmoore,1253,shaman,enhancement,34,17,17
Simularcum,kazzak,1252,shaman,enhancement,36,18,18
Тоннимонтана,howling-fjord,1250,shaman,enhancement,26,15,11
Тенав,blackscar,1249,shaman,enhancement,54,28,26
Darkstrong,alakir,1248,shaman,enhancement,30,17,13
Ostosmvp,ravencrest,1248,shaman,enhancement,24,13,11
Arcura,twisting-nether,1247,shaman,enhancement,36,21,15
Guqin,ravencrest,1247,shaman,enhancement,40,19,21
Eclaîr,thrall,1247,shaman,enhancement,30,13,17
Worstshamy,sanguino,1246,shaman,enhancement,18,13,5
Wylly,aegwynn,1246,shaman,enhancement,18,13,5
Purada,blackrock,1246,shaman,enhancement,24,13,11
Dumbasha,ravencrest,1245,shaman,enhancement,24,13,11
Ishokyou,thrall,1245,shaman,enhancement,55,24,31
Tauridus,blackrock,1244,shaman,enhancement,18,13,5
Murdá,ravencrest,1244,shaman,enhancement,24,13,11
Архивоитель,soulflayer,1243,shaman,enhancement,24,13,11
Windstørm,tarren-mill,1242,shaman,enhancement,21,14,7
Громовойбро,blackscar,1242,shaman,enhancement,24,13,11
Lavalordd,tarren-mill,1242,shaman,enhancement,24,13,11
Tryor,darksorrow,1242,shaman,enhancement,24,13,11
Виндфуриа,gordunni,1242,shaman,enhancement,72,36,36
Hichibane,archimonde,1242,shaman,enhancement,30,13,17
Krishun,blackmoore,1242,shaman,enhancement,30,13,17
Dropbax,khaz-modan,1242,shaman,enhancement,48,19,29
Nêmônin,perenolde,1241,shaman,enhancement,18,13,5
Morkyy,thrall,1241,shaman,enhancement,18,13,5
Katastrofuss,stormscale,1241,shaman,enhancement,53,29,24
Enoughh,the-maelstrom,1241,shaman,enhancement,24,13,11
Ql,twisting-nether,1241,shaman,enhancement,24,13,11
Noxstorm,frostwolf,1241,shaman,enhancement,48,23,25
Roastbeef,blackrock,1240,shaman,enhancement,38,21,17
Lava,haomarush,1240,shaman,enhancement,24,13,11
Beletili,chogall,1240,shaman,enhancement,65,27,38
Trollden,silvermoon,1239,shaman,enhancement,24,13,11
Níkíta,hyjal,1237,shaman,enhancement,18,13,5
Чёкнутое,soulflayer,1236,shaman,enhancement,45,26,19
Kolbászlelkü,ragnaros,1236,shaman,enhancement,24,13,11
Hodir,bronzebeard,1236,shaman,enhancement,40,20,20
Movex,arathor,1235,shaman,enhancement,24,13,11
Enkzäm,archimonde,1235,shaman,enhancement,47,23,24
Volltinus,tarren-mill,1235,shaman,enhancement,36,13,23
Видсон,soulflayer,1234,shaman,enhancement,30,14,16
Kargos,stormscale,1234,shaman,enhancement,30,13,17
Yasan,kazzak,1230,shaman,enhancement,49,23,26
Cowkiller,minahonda,1229,shaman,enhancement,30,17,13
Элетар,gordunni,1228,shaman,enhancement,60,26,34
Treizelol,ysondre,1227,shaman,enhancement,35,17,18
Elesilf,sanguino,1226,shaman,enhancement,24,13,11
Blitzviech,aegwynn,1226,shaman,enhancement,29,14,15
Эйнхарий,howling-fjord,1226,shaman,enhancement,30,13,17
Slaphappy,hellscream,1221,shaman,enhancement,27,14,13
Bachetobg,darksorrow,1220,shaman,enhancement,59,30,29
Thossa,draenor,1219,shaman,enhancement,88,48,40
Patites,twisting-nether,1217,shaman,enhancement,60,31,29
Ulvur,blackhand,1216,shaman,enhancement,30,13,17
Тандерхем,gordunni,1215,shaman,enhancement,30,15,15
Dendyre,outland,1214,shaman,enhancement,29,13,16
Théar,ravencrest,1212,shaman,enhancement,30,15,15
Rhakhatheckh,nemesis,1208,shaman,enhancement,30,13,17
Yeemayne,outland,1206,shaman,enhancement,18,13,5
Sg,la-croisade-écarlate,1203,shaman,enhancement,55,30,25
Литлсмурф,gordunni,1200,shaman,enhancement,51,21,30
Шамяра,blackscar,1199,shaman,enhancement,18,13,5
Tremuchamy,tyrande,1198,shaman,enhancement,39,23,16
Tashunka,twisting-nether,1198,shaman,enhancement,118,54,64
Saduria,antonidas,1194,shaman,enhancement,78,44,34
Gárrok,nerathor,1193,shaman,enhancement,24,13,11
Mahlga,argent-dawn,1192,shaman,enhancement,114,55,59
Sinkero,hellscream,1192,shaman,enhancement,44,17,27
Korzo,amanthul,1190,shaman,enhancement,28,19,9
Allakbarz,stormscale,1190,shaman,enhancement,94,39,55
Hyamala,chamber-of-aspects,1189,shaman,enhancement,30,18,12
Hedjin,argent-dawn,1187,shaman,enhancement,66,35,31
Humming,sanguino,1187,shaman,enhancement,63,33,30
Talf,tarren-mill,1186,shaman,enhancement,23,13,10
Ponzu,silvermoon,1184,shaman,enhancement,24,14,10
Mudwalker,ravencrest,1177,shaman,enhancement,27,13,14
Быковат,booty-bay,1176,shaman,enhancement,42,16,26
Grimtøtem,defias-brotherhood,1173,shaman,enhancement,42,18,24
Wolfshade,aggra-português,1172,shaman,enhancement,23,13,10
Vàlentina,blackmoore,1170,shaman,enhancement,41,24,17
Maulstrom,pozzo-delleternità,1169,shaman,enhancement,26,17,9
Exinos,sylvanas,1169,shaman,enhancement,35,15,20
Sounoukfrit,dalaran,1168,shaman,enhancement,45,22,23
Nòrgan,die-aldor,1167,shaman,enhancement,13,13,0
Skólt,blackrock,1166,shaman,enhancement,56,25,31
Veronikka,dalaran,1163,shaman,enhancement,31,14,17
Quartodebue,nemesis,1162,shaman,enhancement,24,13,11
Crespouu,doomhammer,1162,shaman,enhancement,56,30,26
Свистт,fordragon,1156,shaman,enhancement,76,31,45
Волкк,soulflayer,1154,shaman,enhancement,37,18,19
Nurychic,twisting-nether,1154,shaman,enhancement,63,24,39
Ипа,thermaplugg,1153,shaman,enhancement,48,26,22
Zerocarè,tarren-mill,1152,shaman,enhancement,18,12,6
Fyrkaz,aegwynn,1152,shaman,enhancement,18,12,6
Gorogoró,kazzak,1152,shaman,enhancement,18,12,6
Uselesstwo,archimonde,1152,shaman,enhancement,24,12,12
Тыпроиграл,gordunni,1152,shaman,enhancement,24,12,12
Shootinguard,kazzak,1151,shaman,enhancement,18,12,6
Cløke,stormscale,1151,shaman,enhancement,18,12,6
Seçretweapøn,kazzak,1151,shaman,enhancement,18,12,6
Gønêxt,ravencrest,1151,shaman,enhancement,18,12,6
Blyxuhm,argent-dawn,1151,shaman,enhancement,18,12,6
Buzz,stormscale,1151,shaman,enhancement,24,12,12
Sangvinus,outland,1151,shaman,enhancement,56,22,34
Altotem,blackmoore,1150,shaman,enhancement,18,12,6
Brotein,blackmoore,1150,shaman,enhancement,18,12,6
Scherolol,aegwynn,1149,shaman,enhancement,18,12,6
Litenrolixd,tarren-mill,1149,shaman,enhancement,18,12,6
Dmgaddict,kazzak,1149,shaman,enhancement,24,12,12
Магмарончик,gordunni,1149,shaman,enhancement,56,26,30
Onepatchman,silvermoon,1148,shaman,enhancement,24,12,12
Shamira,nethersturm,1148,shaman,enhancement,30,12,18
Porphy,kazzak,1147,shaman,enhancement,18,12,6
Famepolîce,blackrock,1147,shaman,enhancement,18,12,6
Kirtach,dun-modr,1146,shaman,enhancement,18,12,6
Bærserker,blackmoore,1146,shaman,enhancement,22,13,9
Дректаш,soulflayer,1146,shaman,enhancement,24,12,12
Ibicc,twisting-nether,1146,shaman,enhancement,24,12,12
Lilbantu,ravencrest,1145,shaman,enhancement,24,15,9
Zevissh,outland,1144,shaman,enhancement,24,12,12
Greatthrall,kazzak,1144,shaman,enhancement,30,14,16
Cillysha,ravencrest,1143,shaman,enhancement,18,12,6
Maurrigan,rashgarroth,1142,shaman,enhancement,18,12,6
Ðexx,stormscale,1141,shaman,enhancement,18,12,6
Shock,magtheridon,1140,shaman,enhancement,29,17,12
Brooce,sylvanas,1140,shaman,enhancement,30,12,18
Barthølømew,kazzak,1139,shaman,enhancement,24,12,12
Ipbar,blackrock,1137,shaman,enhancement,24,13,11
Cementatar,burning-blade,1136,shaman,enhancement,30,15,15
Zzadoxor,doomhammer,1134,shaman,enhancement,24,12,12
Pøllemodex,frostwhisper,1132,shaman,enhancement,25,13,12
Vaesk,auchindoun,1131,shaman,enhancement,30,15,15
Mustang,twilights-hammer,1131,shaman,enhancement,48,16,32
Madbud,stormscale,1129,shaman,enhancement,23,12,11
Cool,tarren-mill,1129,shaman,enhancement,33,13,20
Плюжка,greymane,1127,shaman,enhancement,122,62,60
Philcallings,tarren-mill,1127,shaman,enhancement,27,13,14
Даркгрон,thermaplugg,1126,shaman,enhancement,42,17,25
Stormrex,magtheridon,1124,shaman,enhancement,60,31,29
Namrdak,quelthalas,1123,shaman,enhancement,48,25,23
Ðragaø,kazzak,1122,shaman,enhancement,24,12,12
Draugrinns,tarren-mill,1121,shaman,enhancement,24,12,12
Jaykezap,kazzak,1118,shaman,enhancement,23,12,11
Precíous,sporeggar,1115,shaman,enhancement,34,19,15
Bumm,twisting-nether,1115,shaman,enhancement,36,15,21
Welgor,kult-der-verdammten,1112,shaman,enhancement,18,12,6
Акер,deathguard,1108,shaman,enhancement,24,14,10
Тотемныйчад,gordunni,1104,shaman,enhancement,28,13,15
Боргрим,eversong,1104,shaman,enhancement,46,17,29
Biglynx,sanguino,1103,shaman,enhancement,108,60,48
Dakotasham,ravencrest,1102,shaman,enhancement,17,12,5
Eneruswag,draenor,1098,shaman,enhancement,29,14,15
Kireekoura,tarren-mill,1097,shaman,enhancement,33,14,19
Isladinks,draenor,1096,shaman,enhancement,81,35,46
Windfury,sylvanas,1095,shaman,enhancement,51,23,28
Бойкийкот,gordunni,1094,shaman,enhancement,36,16,20
Janserey,burning-legion,1090,shaman,enhancement,30,12,18
Kertunsisko,emeriss,1089,shaman,enhancement,48,18,30
Varagun,argent-dawn,1088,shaman,enhancement,31,13,18
Kringspierce,twisting-nether,1086,shaman,enhancement,55,34,21
Eleboss,frostwolf,1082,shaman,enhancement,42,24,18
Oddsocks,stormscale,1082,shaman,enhancement,54,23,31
Интендо,soulflayer,1079,shaman,enhancement,21,12,9
Эсфира,ashenvale,1079,shaman,enhancement,41,20,21
Snoc,guldan,1077,shaman,enhancement,57,26,31
Bábbajaggí,blackrock,1077,shaman,enhancement,30,13,17
Esciamano,nemesis,1074,shaman,enhancement,41,27,14
Xarozz,blackmoore,1071,shaman,enhancement,42,20,22
Анашишка,borean-tundra,1069,shaman,enhancement,42,16,26
Zmech,chamber-of-aspects,1068,shaman,enhancement,25,12,13
Blutschrei,tarren-mill,1063,shaman,enhancement,75,26,49
Харрум,soulflayer,1061,shaman,enhancement,56,29,27
Rorenth,blackhand,1061,shaman,enhancement,74,38,36
Daelements,shadowsong,1059,shaman,enhancement,27,13,14
Kärmá,stormscale,1056,shaman,enhancement,18,11,7
Axiiom,draenor,1056,shaman,enhancement,18,11,7
Fòóxi,ravencrest,1056,shaman,enhancement,156,82,74
Юрахафанбой,blackscar,1055,shaman,enhancement,18,11,7
Kelvok,silvermoon,1055,shaman,enhancement,18,11,7
Pay,stormscale,1055,shaman,enhancement,18,11,7
Иллюминэйшн,soulflayer,1055,shaman,enhancement,24,11,13
Trobø,ravencrest,1055,shaman,enhancement,33,12,21
Cch,kazzak,1054,shaman,enhancement,18,11,7
Berserked,emeriss,1054,shaman,enhancement,18,11,7
Eliaap,antonidas,1054,shaman,enhancement,153,71,82
Kral,defias-brotherhood,1053,shaman,enhancement,18,11,7
Razush,draenor,1053,shaman,enhancement,18,11,7
Electricgødx,tarren-mill,1053,shaman,enhancement,18,11,7
Drexx,thrall,1053,shaman,enhancement,18,11,7
Hitmeagain,blackhand,1053,shaman,enhancement,24,11,13
Othu,ragnaros,1053,shaman,enhancement,24,11,13
Хмелецкий,soulflayer,1052,shaman,enhancement,42,23,19
Onefurall,ragnaros,1052,shaman,enhancement,24,11,13
Swooch,shattered-hand,1051,shaman,enhancement,12,11,1
Satisfya,ambossar,1051,shaman,enhancement,18,11,7
Foulecamp,archimonde,1050,shaman,enhancement,24,11,13
Apócalypsee,ravencrest,1050,shaman,enhancement,24,11,13
Splat,burning-blade,1049,shaman,enhancement,18,11,7
Andrewbéelko,drakthul,1049,shaman,enhancement,18,11,7
Erupted,draenor,1049,shaman,enhancement,30,11,19
Кесмар,soulflayer,1048,shaman,enhancement,18,11,7
Щцц,soulflayer,1047,shaman,enhancement,18,11,7
Burstorama,alleria,1047,shaman,enhancement,18,11,7
Navy,frostwolf,1046,shaman,enhancement,18,11,7
Aquæ,suramar,1045,shaman,enhancement,156,83,73
Shamrøck,archimonde,1045,shaman,enhancement,36,18,18
Tênzo,ysondre,1043,shaman,enhancement,24,11,13
Шамвкроксах,gordunni,1043,shaman,enhancement,24,11,13
Wargriman,kelthuzad,1042,shaman,enhancement,29,16,13
Puncochar,zuljin,1042,shaman,enhancement,24,11,13
Burghezu,magtheridon,1038,shaman,enhancement,36,20,16
Murog,dalaran,1035,shaman,enhancement,19,12,7
Wioda,silvermoon,1025,shaman,enhancement,47,27,20
Pïdòrás,kazzak,1023,shaman,enhancement,17,11,6
Шалман,thermaplugg,1023,shaman,enhancement,257,120,137
Åkra,kazzak,1021,shaman,enhancement,22,11,11
Øzy,sanguino,1020,shaman,enhancement,24,15,9
Zugzie,draenor,1016,shaman,enhancement,36,14,22
Kushme,silvermoon,1014,shaman,enhancement,84,36,48
Totkodem,twisting-nether,1013,shaman,enhancement,32,14,18
Pelorta,zuljin,1004,shaman,enhancement,17,11,6
Chamtroulku,ysondre,1001,shaman,enhancement,23,11,12
Vegà,thrall,1000,shaman,enhancement,21,13,8
Tism,stormscale,999,shaman,enhancement,22,11,11
Whizjy,sanguino,993,shaman,enhancement,34,14,20
Freizeitler,antonidas,988,shaman,enhancement,17,11,6
Izaarleus,argent-dawn,986,shaman,enhancement,29,11,18
Yunero,argent-dawn,975,shaman,enhancement,19,11,8
Gixor,silvermoon,960,shaman,enhancement,12,10,2
Tätschentim,blackrock,960,shaman,enhancement,12,10,2
Miøn,kazzak,960,shaman,enhancement,12,10,2
Dumhuvud,stormscale,960,shaman,enhancement,12,10,2
Billburr,aegwynn,960,shaman,enhancement,12,10,2
Shaddoo,stormscale,960,shaman,enhancement,12,10,2
Биттерлинкс,blackscar,960,shaman,enhancement,18,10,8
Crysis,sanguino,960,shaman,enhancement,18,10,8
Bullet,blackmoore,960,shaman,enhancement,18,10,8
Dwarfstil,blackmoore,960,shaman,enhancement,21,11,10
Рыганский,blackscar,960,shaman,enhancement,30,10,20
Ræi,drakthul,959,shaman,enhancement,12,10,2
Акаварри,gordunni,959,shaman,enhancement,12,10,2
Flameshock,stormreaver,959,shaman,enhancement,12,10,2
Майндшторм,blackscar,959,shaman,enhancement,18,10,8
Hariboo,arthas,959,shaman,enhancement,18,10,8
Asçele,kazzak,959,shaman,enhancement,18,10,8
Atis,the-maelstrom,959,shaman,enhancement,18,10,8
Sûckmytotem,ragnaros,959,shaman,enhancement,18,10,8
Windypops,tarren-mill,959,shaman,enhancement,18,10,8
Evííl,tarren-mill,958,shaman,enhancement,12,10,2
Numeschnäu,eredar,958,shaman,enhancement,12,10,2
Ugory,die-aldor,958,shaman,enhancement,12,10,2
Myngo,thrall,958,shaman,enhancement,18,10,8
Hurb,malorne,958,shaman,enhancement,18,10,8
Таиров,soulflayer,956,shaman,enhancement,12,10,2
Shockndawe,kazzak,956,shaman,enhancement,18,10,8
Pushs,archimonde,956,shaman,enhancement,18,10,8
Towi,krasus,955,shaman,enhancement,12,10,2
Stlakañ,chants-éternels,955,shaman,enhancement,12,10,2
Krakennm,dalaran,955,shaman,enhancement,61,28,33
Nâs,kazzak,955,shaman,enhancement,24,10,14
Pureflame,silvermoon,955,shaman,enhancement,24,10,14
Tufftnamn,frostmane,955,shaman,enhancement,24,10,14
Promethxis,silvermoon,955,shaman,enhancement,24,10,14
Charth,ravencrest,954,shaman,enhancement,49,18,31
Carcksn,nerathor,951,shaman,enhancement,18,10,8
Nazma,blackhand,949,shaman,enhancement,12,10,2
Rushfabi,aegwynn,948,shaman,enhancement,24,10,14
Wuchtzwerg,terrordar,945,shaman,enhancement,12,10,2
Xakum,stormscale,944,shaman,enhancement,12,10,2
Nezuka,turalyon,944,shaman,enhancement,22,11,11
Ogmehu,stormreaver,944,shaman,enhancement,33,10,23
Chronochrome,chamber-of-aspects,939,shaman,enhancement,75,38,37
Zerandolix,blackrock,936,shaman,enhancement,26,10,16
Чухмандос,gordunni,932,shaman,enhancement,23,11,12
Nethershock,blackmoore,928,shaman,enhancement,84,44,40
Elrayitos,shendralar,927,shaman,enhancement,22,10,12
Practicetwo,argent-dawn,924,shaman,enhancement,23,10,13
Rylidare,khaz-modan,921,shaman,enhancement,53,24,29
Ryujìñjakka,culte-de-la-rive-noire,919,shaman,enhancement,24,12,12
Gruldo,tarren-mill,915,shaman,enhancement,35,10,25
Sardemar,defias-brotherhood,914,shaman,enhancement,24,13,11
Cimer,sargeras,914,shaman,enhancement,87,37,50
Hellskon,silvermoon,909,shaman,enhancement,17,10,7
Twotwozero,defias-brotherhood,908,shaman,enhancement,35,14,21
Тыщатристах,howling-fjord,903,shaman,enhancement,18,11,7
Stubby,nagrand,903,shaman,enhancement,31,14,17
Stormkëëpër,stormscale,897,shaman,enhancement,33,11,22
Cràfty,blackrock,893,shaman,enhancement,20,10,10
Awsomo,ravencrest,891,shaman,enhancement,29,10,19
Mimsy,hyjal,876,shaman,enhancement,53,21,32
Mendoz,nazjatar,875,shaman,enhancement,74,35,39
Йодаримару,howling-fjord,864,shaman,enhancement,12,9,3
Khylejenner,kazzak,864,shaman,enhancement,12,9,3
Alainralso,archimonde,864,shaman,enhancement,12,9,3
Turbothea,blackmoore,864,shaman,enhancement,12,9,3
Blackyx,dun-modr,864,shaman,enhancement,12,9,3
Faroh,ravencrest,864,shaman,enhancement,12,9,3
Martini,tichondrius,864,shaman,enhancement,15,10,5
Tswiftx,tarren-mill,864,shaman,enhancement,18,9,9
Dwarfovic,ravencrest,864,shaman,enhancement,18,9,9
Шамунчез,gordunni,863,shaman,enhancement,12,9,3
Maddogxz,frostwolf,863,shaman,enhancement,12,9,3
Keisys,kazzak,863,shaman,enhancement,18,9,9
Nëÿrën,drakthul,863,shaman,enhancement,18,9,9
Réläx,kazzak,863,shaman,enhancement,18,9,9
Purgey,ravencrest,863,shaman,enhancement,18,9,9
Taraesh,blackhand,863,shaman,enhancement,18,9,9
Jhagy,archimonde,863,shaman,enhancement,18,9,9
Хаммерн,gordunni,863,shaman,enhancement,18,9,9
Nìno,azshara,863,shaman,enhancement,18,9,9
Zðhan,azshara,863,shaman,enhancement,18,9,9
Khanaky,hyjal,863,shaman,enhancement,18,9,9
Shockrates,pozzo-delleternità,863,shaman,enhancement,18,9,9
Sgtspyke,ragnaros,863,shaman,enhancement,24,9,15
Jabja,antonidas,862,shaman,enhancement,18,9,9
Brigantino,burning-legion,862,shaman,enhancement,18,9,9
Tuncha,runetotem,862,shaman,enhancement,18,9,9
Shoockwave,twisting-nether,862,shaman,enhancement,18,9,9
Pissluffer,tarren-mill,862,shaman,enhancement,18,9,9
Azrodas,defias-brotherhood,862,shaman,enhancement,18,9,9
Gagné,hyjal,862,shaman,enhancement,18,9,9
Айбывайбы,howling-fjord,862,shaman,enhancement,18,9,9
Tunae,azjolnerub,862,shaman,enhancement,23,11,12
Jaydc,silvermoon,862,shaman,enhancement,22,9,13
Ордосус,gordunni,862,shaman,enhancement,24,9,15
Yabadabadoo,burning-legion,861,shaman,enhancement,18,9,9
Seriux,twisting-nether,860,shaman,enhancement,15,10,5
Lottery,ragnaros,860,shaman,enhancement,18,9,9
Rashtar,ravencrest,860,shaman,enhancement,18,9,9
Ягном,soulflayer,860,shaman,enhancement,24,9,15
Jockin,tarren-mill,860,shaman,enhancement,24,9,15
Gälädhan,ysondre,859,shaman,enhancement,24,12,12
Doclava,twisting-nether,859,shaman,enhancement,18,9,9
Hexrated,draenor,859,shaman,enhancement,21,10,11
Shockaibo,drakthul,859,shaman,enhancement,24,9,15
Furioous,ravencrest,857,shaman,enhancement,18,9,9
Yzeed,argent-dawn,856,shaman,enhancement,18,9,9
Shamsterr,karazhan,852,shaman,enhancement,18,9,9
Shamaniak,tarren-mill,851,shaman,enhancement,30,9,21
Рэйпушка,gordunni,847,shaman,enhancement,23,9,14
Fika,the-venture-co,845,shaman,enhancement,18,9,9
Biphrost,nemesis,837,shaman,enhancement,30,12,18
Shaminista,ravencrest,836,shaman,enhancement,18,9,9
Мигнтз,soulflayer,831,shaman,enhancement,17,9,8
Deeblu,nemesis,821,shaman,enhancement,24,9,15
Draabada,stormscale,816,shaman,enhancement,15,9,6
Paschol,aegwynn,816,shaman,enhancement,21,9,12
Pocahøntas,archimonde,810,shaman,enhancement,27,10,17
Мамонтшам,howling-fjord,808,shaman,enhancement,17,9,8
Ìkarus,eredar,804,shaman,enhancement,40,17,23
Elcoustillou,throkferoth,800,shaman,enhancement,52,16,36
Vix,argent-dawn,799,shaman,enhancement,14,9,5
Nuluadroguri,twisting-nether,793,shaman,enhancement,22,9,13
Hamstéole,hyjal,784,shaman,enhancement,16,9,7
Razgriz,confrérie-du-thorium,784,shaman,enhancement,19,9,10
Koiru,argent-dawn,782,shaman,enhancement,19,9,10
Achtungblitz,blackrock,768,shaman,enhancement,12,8,4
Драгенхз,gordunni,768,shaman,enhancement,12,8,4
Khorgam,twisting-nether,768,shaman,enhancement,12,8,4
Sleven,twisting-nether,768,shaman,enhancement,12,8,4
Махош,blackscar,768,shaman,enhancement,12,8,4
Thunderdøme,stormscale,768,shaman,enhancement,12,8,4
Dêblâzê,thrall,768,shaman,enhancement,12,8,4
Cocolopez,tichondrius,768,shaman,enhancement,12,8,4
Maksimon,blackrock,768,shaman,enhancement,12,8,4
Trulor,stormscale,768,shaman,enhancement,12,8,4
Бурапи,howling-fjord,768,shaman,enhancement,12,8,4
Flamii,burning-legion,768,shaman,enhancement,12,8,4
Bufalan,uldum,768,shaman,enhancement,12,8,4
Qätär,ravencrest,768,shaman,enhancement,12,8,4
Healníx,ravencrest,768,shaman,enhancement,12,8,4
Kuse,blackmoore,768,shaman,enhancement,12,8,4
Lytningx,ravencrest,768,shaman,enhancement,12,8,4
Kwengi,stormreaver,768,shaman,enhancement,12,8,4
Drade,aegwynn,768,shaman,enhancement,14,8,6
Gnomecake,vashj,768,shaman,enhancement,18,8,10
Bmtotem,twisting-nether,768,shaman,enhancement,18,8,10
Toobiib,culte-de-la-rive-noire,768,shaman,enhancement,18,8,10
Kàffkalafká,blackrock,768,shaman,enhancement,18,8,10
Babal,outland,768,shaman,enhancement,24,8,16
Айспик,ashenvale,768,shaman,enhancement,24,8,16
Naahma,hyjal,768,shaman,enhancement,24,8,16
Windshockah,tarren-mill,767,shaman,enhancement,12,8,4
Complete,hyjal,767,shaman,enhancement,12,8,4
Wawawoowee,archimonde,767,shaman,enhancement,12,8,4
Wonderman,jaedenar,767,shaman,enhancement,12,8,4
Ericlomax,frostwhisper,767,shaman,enhancement,12,8,4
Ichboxdich,madmortem,767,shaman,enhancement,12,8,4
Bantzer,twisting-nether,767,shaman,enhancement,15,8,7
Pinkylol,stormscale,767,shaman,enhancement,18,8,10
Tonifo,nemesis,767,shaman,enhancement,18,8,10
Rázzìm,eredar,767,shaman,enhancement,18,8,10
Szamanito,turalyon,767,shaman,enhancement,18,8,10
Neroty,blackmoore,767,shaman,enhancement,18,8,10
Carlos,magtheridon,767,shaman,enhancement,18,8,10
Tschacô,malganis,767,shaman,enhancement,18,8,10
Nínive,zuljin,767,shaman,enhancement,18,8,10
Zaappyboii,azjolnerub,767,shaman,enhancement,18,8,10
Икзок,soulflayer,766,shaman,enhancement,18,8,10
Târu,blackrock,766,shaman,enhancement,24,8,16
Niveamann,eredar,765,shaman,enhancement,12,8,4
Runeksham,tarren-mill,765,shaman,enhancement,18,8,10
Lôù,archimonde,765,shaman,enhancement,18,8,10
Энхким,soulflayer,765,shaman,enhancement,32,8,24
Ronctaha,blackrock,764,shaman,enhancement,12,8,4
Carusø,thrall,764,shaman,enhancement,18,8,10
Strygwyrl,doomhammer,764,shaman,enhancement,18,8,10
Hectoraïus,ysondre,763,shaman,enhancement,18,8,10
Зулкунд,soulflayer,763,shaman,enhancement,18,8,10
Fourbevent,archimonde,762,shaman,enhancement,12,8,4
Gibspark,twisting-nether,762,shaman,enhancement,12,8,4
Jangal,die-nachtwache,762,shaman,enhancement,13,8,5
Màverìck,nemesis,761,shaman,enhancement,12,8,4
Sifu,ragnaros,761,shaman,enhancement,12,8,4
Грейсаша,howling-fjord,760,shaman,enhancement,12,8,4
Ironsidé,ragnaros,760,shaman,enhancement,24,8,16
Шамблабла,soulflayer,756,shaman,enhancement,30,8,22
Нуишам,soulflayer,755,shaman,enhancement,12,8,4
Fotmslave,laughing-skull,749,shaman,enhancement,15,10,5
Ластыч,borean-tundra,744,shaman,enhancement,18,8,10
Asogg,archimonde,743,shaman,enhancement,24,9,15
Залазани,soulflayer,735,shaman,enhancement,18,8,10
Argueaner,eonar,721,shaman,enhancement,28,9,19
Negårn,tarren-mill,719,shaman,enhancement,11,8,3
Glibnica,draenor,718,shaman,enhancement,15,8,7
Xereús,kazzak,718,shaman,enhancement,23,8,15
Ihealbro,blackrock,714,shaman,enhancement,16,11,5
Slímshámmy,twisting-nether,714,shaman,enhancement,20,10,10
Pospodrol,ragnaros,704,shaman,enhancement,16,8,8
Faridstreng,blackmoore,703,shaman,enhancement,11,8,3
Spajry,drakthul,702,shaman,enhancement,14,8,6
Lavashock,tarren-mill,700,shaman,enhancement,28,8,20
Chàrlord,twisting-nether,688,shaman,enhancement,19,8,11
Jeppoh,tarren-mill,686,shaman,enhancement,13,8,5
Tiamât,culte-de-la-rive-noire,685,shaman,enhancement,19,8,11
Bärtigeberta,aegwynn,672,shaman,enhancement,10,8,2
Djonebutton,kazzak,672,shaman,enhancement,12,7,5
Raketsven,dentarg,672,shaman,enhancement,12,7,5
Vutututututu,ragnaros,672,shaman,enhancement,12,7,5
Sìberiano,pozzo-delleternità,672,shaman,enhancement,12,7,5
Инсэйнгодх,soulflayer,672,shaman,enhancement,12,7,5
Trixey,mazrigos,672,shaman,enhancement,12,7,5
Roineé,draenor,672,shaman,enhancement,12,7,5
Aspên,archimonde,672,shaman,enhancement,12,7,5
Relentlessqt,aegwynn,672,shaman,enhancement,12,7,5
Eomsham,magtheridon,672,shaman,enhancement,12,7,5
Runè,azjolnerub,672,shaman,enhancement,12,7,5
Metalbeef,xavius,672,shaman,enhancement,12,7,5
Preams,blackrock,672,shaman,enhancement,12,7,5
Virrogs,argent-dawn,672,shaman,enhancement,12,7,5
Эоя,howling-fjord,672,shaman,enhancement,12,7,5
Fernik,sanguino,672,shaman,enhancement,12,7,5
Proper,tichondrius,672,shaman,enhancement,12,7,5
Primez,twilights-hammer,672,shaman,enhancement,12,7,5
Akatuseiwah,blackrock,672,shaman,enhancement,12,7,5
Oneshotunía,burning-legion,672,shaman,enhancement,12,7,5
Jaszczurka,stormrage,672,shaman,enhancement,12,7,5
Likê,aegwynn,672,shaman,enhancement,12,7,5
Lightning,aszune,672,shaman,enhancement,18,7,11
Tzivati,draenor,672,shaman,enhancement,18,7,11
Shougaku,blackrock,672,shaman,enhancement,18,7,11
Ghettocheff,blackmoore,672,shaman,enhancement,18,7,11
Boulestraan,silvermoon,672,shaman,enhancement,18,7,11
Horiq,kazzak,672,shaman,enhancement,18,7,11
Irmax,stormscale,672,shaman,enhancement,18,7,11
Élisabethtwo,culte-de-la-rive-noire,672,shaman,enhancement,18,7,11
Нерезшок,soulflayer,672,shaman,enhancement,18,7,11
Swoltz,argent-dawn,672,shaman,enhancement,24,7,17
Dwarfofwar,ravencrest,671,shaman,enhancement,12,7,5
Meangreen,stormscale,671,shaman,enhancement,12,7,5
Kejazal,blackrock,671,shaman,enhancement,12,7,5
Okmogar,khaz-modan,671,shaman,enhancement,12,7,5
Жезуш,galakrond,671,shaman,enhancement,12,7,5
Outhell,sylvanas,671,shaman,enhancement,12,7,5
Stormfury,balnazzar,671,shaman,enhancement,12,7,5
Dénekha,zuljin,671,shaman,enhancement,12,7,5
Джоннси,howling-fjord,671,shaman,enhancement,12,7,5
Birnenpfeffi,malfurion,671,shaman,enhancement,12,7,5
Thalmorius,argent-dawn,671,shaman,enhancement,12,7,5
Gyuksz,arathor,671,shaman,enhancement,15,7,8
Bigmassage,blackmoore,671,shaman,enhancement,18,7,11
Götveren,eredar,671,shaman,enhancement,18,7,11
Sajma,silvermoon,671,shaman,enhancement,18,7,11
Cbshaman,sylvanas,671,shaman,enhancement,18,7,11
Teenx,auchindoun,671,shaman,enhancement,18,7,11
Fanatroka,ravencrest,671,shaman,enhancement,18,7,11
Lumpp,kazzak,671,shaman,enhancement,24,7,17
Florgegoyd,eredar,670,shaman,enhancement,12,7,5
Silko,wrathbringer,670,shaman,enhancement,18,7,11
Shockýbalboa,ragnaros,670,shaman,enhancement,18,7,11
Phizzik,ravencrest,670,shaman,enhancement,18,7,11
Elijaá,nordrassil,670,shaman,enhancement,18,7,11
Sacrx,dalaran,670,shaman,enhancement,24,7,17
Munnar,dalaran,669,shaman,enhancement,12,7,5
Slavazsu,draenor,668,shaman,enhancement,12,7,5
Spirites,drakthul,667,shaman,enhancement,12,7,5
Viandehachee,dalaran,667,shaman,enhancement,12,7,5
Wartay,doomhammer,667,shaman,enhancement,12,7,5
Zoghzog,elune,667,shaman,enhancement,18,7,11
Weaslêy,frostwolf,660,shaman,enhancement,18,7,11
Shelara,drakthul,658,shaman,enhancement,12,7,5
Фролыч,deathguard,645,shaman,enhancement,23,9,14
Tacøshock,ravencrest,639,shaman,enhancement,8,8,0
Maskiimon,blackrock,639,shaman,enhancement,14,8,6
Hemradi,blackmoore,638,shaman,enhancement,11,7,4
Tianoele,drakthul,624,shaman,enhancement,9,8,1
Ивми,gordunni,623,shaman,enhancement,11,7,4
Oldstorm,ravencrest,618,shaman,enhancement,22,10,12
Zerodown,outland,614,shaman,enhancement,20,8,12
Skillxdxdxd,outland,608,shaman,enhancement,16,7,9
Перегной,ashenvale,607,shaman,enhancement,22,7,15
Buffmepls,sanguino,607,shaman,enhancement,24,7,17
Mowjo,la-croisade-écarlate,576,shaman,enhancement,6,6,0
Thunderwill,sanguino,576,shaman,enhancement,12,6,6
ßaßystärz,hyjal,576,shaman,enhancement,12,6,6
Thëhêxfäçtør,tarren-mill,576,shaman,enhancement,12,6,6
Szelenamoonx,outland,576,shaman,enhancement,12,6,6
Jmpapa,tarren-mill,576,shaman,enhancement,12,6,6
Lurtax,outland,576,shaman,enhancement,12,6,6
Биттерлинкс,soulflayer,576,shaman,enhancement,12,6,6
Вайгачи,soulflayer,576,shaman,enhancement,12,6,6
Lafia,blackrock,576,shaman,enhancement,12,6,6
Gruggosh,argent-dawn,576,shaman,enhancement,12,6,6
Noneedshaman,stormscale,576,shaman,enhancement,12,6,6
Searfang,korgall,576,shaman,enhancement,12,6,6
Рскувосемь,soulflayer,576,shaman,enhancement,12,6,6
Imotii,burning-legion,576,shaman,enhancement,12,6,6
Bichîk,archimonde,576,shaman,enhancement,12,6,6
Detestable,eredar,576,shaman,enhancement,12,6,6
Degstaerian,ysera,576,shaman,enhancement,12,6,6
Dami,die-aldor,576,shaman,enhancement,12,6,6
Sherlokholms,ravencrest,576,shaman,enhancement,12,6,6
Elemefayoh,tarren-mill,576,shaman,enhancement,12,6,6
Tharma,blackmoore,576,shaman,enhancement,12,6,6
Barneyflight,ravencrest,576,shaman,enhancement,12,6,6
Zerak,twisting-nether,576,shaman,enhancement,15,7,8
Bloodlusts,archimonde,576,shaman,enhancement,13,6,7
Deadwölf,outland,576,shaman,enhancement,18,6,12
Haasshaman,ravencrest,576,shaman,enhancement,18,6,12
Dagoahgra,sanguino,576,shaman,enhancement,18,6,12
Elektekk,blackrock,575,shaman,enhancement,10,7,3
Fashess,sunstrider,575,shaman,enhancement,12,6,6
Apolomaeuz,frostwolf,575,shaman,enhancement,12,6,6
Rink,frostmane,575,shaman,enhancement,12,6,6
Dergat,pozzo-delleternità,575,shaman,enhancement,12,6,6
Tatyabis,drekthar,575,shaman,enhancement,12,6,6
Finni,hyjal,575,shaman,enhancement,12,6,6
Rykarn,eredar,575,shaman,enhancement,15,7,8
Shawnmendes,kazzak,575,shaman,enhancement,15,7,8
Saulty,archimonde,575,shaman,enhancement,18,6,12
Ashgar,drakthul,575,shaman,enhancement,18,6,12
Shockybalbóa,blackmoore,575,shaman,enhancement,18,6,12
Tholatir,silvermoon,575,shaman,enhancement,24,6,18
Jorny,burning-legion,575,shaman,enhancement,24,6,18
Chamaiko,kaelthas,574,shaman,enhancement,18,6,12
Zuziki,argent-dawn,573,shaman,enhancement,12,6,6
Дядяшаман,gordunni,573,shaman,enhancement,24,6,18
Vainerish,malygos,571,shaman,enhancement,12,6,6
Laghärta,dun-modr,566,shaman,enhancement,12,6,6
Агирук,goldrinn,564,shaman,enhancement,13,6,7
Hurtigtotem,ravencrest,558,shaman,enhancement,15,7,8
Teyshtwö,archimonde,522,shaman,enhancement,14,7,7
Xhahal,hyjal,521,shaman,enhancement,19,7,12
Тмх,ashenvale,512,shaman,enhancement,16,6,10
Guzguzguz,blackhand,511,shaman,enhancement,14,6,8
Ruintotems,twisting-nether,510,shaman,enhancement,11,7,4
Svetosham,wildhammer,480,shaman,enhancement,6,5,1
Ðevi,ravencrest,480,shaman,enhancement,6,5,1
Ybbarcs,eredar,480,shaman,enhancement,6,5,1
Synergizer,kazzak,480,shaman,enhancement,6,5,1
Genrok,burning-blade,480,shaman,enhancement,6,5,1
Magharro,kazzak,480,shaman,enhancement,6,5,1
Nargaz,burning-legion,480,shaman,enhancement,6,5,1
Bârtmân,blackmoore,480,shaman,enhancement,6,5,1
Wooyoungsham,sylvanas,480,shaman,enhancement,6,5,1
Earthquaker,the-maelstrom,480,shaman,enhancement,6,5,1
Øutfox,silvermoon,480,shaman,enhancement,6,5,1
Podoroschnik,blackmoore,480,shaman,enhancement,6,5,1
Jumborumbo,quelthalas,480,shaman,enhancement,6,5,1
Windsòng,stormscale,480,shaman,enhancement,6,5,1
Velkin,thrall,480,shaman,enhancement,6,5,1
Medoje,argent-dawn,480,shaman,enhancement,6,5,1
Seaview,silvermoon,480,shaman,enhancement,6,5,1
Deådwolf,stormscale,480,shaman,enhancement,11,6,5
Thunderpath,ragnaros,480,shaman,enhancement,12,5,7
Hobblefoot,stormscale,480,shaman,enhancement,12,5,7
Madzÿ,archimonde,480,shaman,enhancement,12,5,7
Rahtafary,sanguino,480,shaman,enhancement,12,5,7
Duhdelido,ravencrest,480,shaman,enhancement,12,5,7
Ñax,silvermoon,480,shaman,enhancement,12,5,7
Эрхус,soulflayer,480,shaman,enhancement,12,5,7
Xoul,aegwynn,480,shaman,enhancement,12,5,7
Rejrax,ravencrest,480,shaman,enhancement,12,5,7
Jonnykaye,outland,480,shaman,enhancement,12,5,7
Kabard,silvermoon,480,shaman,enhancement,12,5,7
Teaboï,hyjal,480,shaman,enhancement,12,5,7
Btray,ravencrest,480,shaman,enhancement,12,5,7
Tholdrin,outland,480,shaman,enhancement,12,5,7
Sinwithin,ravencrest,480,shaman,enhancement,12,5,7
Batan,kazzak,480,shaman,enhancement,12,5,7
Xelphia,frostmane,480,shaman,enhancement,12,5,7
Skrewu,stormscale,480,shaman,enhancement,12,5,7
Feetsniffax,outland,480,shaman,enhancement,12,5,7
Дротчим,soulflayer,480,shaman,enhancement,12,5,7
Guzz,cthun,480,shaman,enhancement,12,5,7
Fiden,drakthul,480,shaman,enhancement,12,5,7
Shuyö,kazzak,480,shaman,enhancement,12,5,7
Neystee,archimonde,480,shaman,enhancement,12,5,7
Bowtenstorm,ravencrest,480,shaman,enhancement,12,5,7
Volcanò,outland,480,shaman,enhancement,12,5,7
Shooktide,blackrock,480,shaman,enhancement,12,5,7
Åkee,kazzak,480,shaman,enhancement,12,5,7
Xssanimo,draenor,480,shaman,enhancement,12,5,7
Lilmarco,stormreaver,480,shaman,enhancement,12,5,7
Djsnéak,blackrock,480,shaman,enhancement,12,5,7
Zarosh,los-errantes,480,shaman,enhancement,12,5,7
Grosgourdin,la-croisade-écarlate,480,shaman,enhancement,12,5,7
Mistahbeard,stormscale,480,shaman,enhancement,12,5,7
Grolifer,archimonde,480,shaman,enhancement,12,5,7
Getahex,draenor,480,shaman,enhancement,12,5,7
Thorcc,kazzak,480,shaman,enhancement,12,5,7
Pank,kazzak,480,shaman,enhancement,12,5,7
Смокдог,razuvious,480,shaman,enhancement,12,5,7
Tempóralex,blackhand,480,shaman,enhancement,12,5,7
Tordenlars,ragnaros,480,shaman,enhancement,12,5,7
Bananaspliit,stormscale,480,shaman,enhancement,12,5,7
Djosershamy,draenor,480,shaman,enhancement,12,5,7
Hurik,sylvanas,480,shaman,enhancement,12,5,7
Crilath,ysondre,480,shaman,enhancement,18,5,13
Hiron,sylvanas,480,shaman,enhancement,18,5,13
Halliane,ysondre,480,shaman,enhancement,24,5,19
Brassefrasse,shattered-hand,479,shaman,enhancement,6,5,1
Durotansan,ragnaros,479,shaman,enhancement,12,5,7
Chamrøck,hyjal,479,shaman,enhancement,12,5,7
Loko,terokkar,479,shaman,enhancement,12,5,7
Aznan,burning-legion,479,shaman,enhancement,12,5,7
Shamananas,antonidas,479,shaman,enhancement,18,5,13
Electricmon,stormscale,478,shaman,enhancement,6,5,1
Kaybiel,magtheridon,478,shaman,enhancement,12,5,7
Rockymarciia,dalaran,477,shaman,enhancement,6,5,1
Asstroy,sanguino,477,shaman,enhancement,6,5,1
Shockdx,dun-modr,463,shaman,enhancement,11,5,6
Zaffyboi,draenor,448,shaman,enhancement,16,5,11
Buldozar,blackmoore,448,shaman,enhancement,16,5,11
Ayrá,ulduar,447,shaman,enhancement,8,6,2
Vicinitysham,twisting-nether,447,shaman,enhancement,11,5,6
Bigpapi,azjolnerub,447,shaman,enhancement,11,5,6
Tookaageeroo,burning-legion,446,shaman,enhancement,14,6,8
Macoox,drakthul,432,shaman,enhancement,9,5,4
Monstermunch,ravencrest,432,shaman,enhancement,15,5,10
Warjuice,stormscale,430,shaman,enhancement,11,5,6
Electrical,kazzak,426,shaman,enhancement,15,6,9
Gigamuscle,ravencrest,400,shaman,enhancement,13,5,8
Thoshir,silvermoon,399,shaman,enhancement,5,5,0
Shamanman,kazzak,384,shaman,enhancement,6,4,2
Mustabrutus,tarren-mill,384,shaman,enhancement,6,4,2
Totems,the-venture-co,384,shaman,enhancement,6,4,2
Nøxz,blackmoore,384,shaman,enhancement,6,4,2
Aloeverayo,defias-brotherhood,384,shaman,enhancement,6,4,2
Raindx,draenor,384,shaman,enhancement,6,4,2
Piripolkka,defias-brotherhood,384,shaman,enhancement,6,4,2
Gameblast,thunderhorn,384,shaman,enhancement,6,4,2
Ilkim,hyjal,384,shaman,enhancement,6,4,2
Kaingar,ravencrest,384,shaman,enhancement,6,4,2
Thundersioux,ravencrest,384,shaman,enhancement,6,4,2
Taroc,nethersturm,384,shaman,enhancement,6,4,2
Baldurr,sylvanas,384,shaman,enhancement,6,4,2
Нийрагонго,gordunni,384,shaman,enhancement,6,4,2
Алимика,deathguard,384,shaman,enhancement,6,4,2
Isogrind,archimonde,384,shaman,enhancement,6,4,2
Abdegor,burning-legion,384,shaman,enhancement,6,4,2
Mikesinatra,tarren-mill,384,shaman,enhancement,6,4,2
Hextazy,archimonde,384,shaman,enhancement,6,4,2
Procbly,tarren-mill,384,shaman,enhancement,6,4,2
Richtigfies,kazzak,384,shaman,enhancement,6,4,2
Vallchan,kazzak,384,shaman,enhancement,6,4,2
Proccity,stormscale,384,shaman,enhancement,6,4,2
Xalta,eldrethalas,384,shaman,enhancement,6,4,2
Нэдсон,greymane,384,shaman,enhancement,6,4,2
Alexmahone,dun-morogh,384,shaman,enhancement,6,4,2
Олешао,howling-fjord,384,shaman,enhancement,6,4,2
Tonitøtem,onyxia,384,shaman,enhancement,6,4,2
Rèxxar,stormscale,384,shaman,enhancement,6,4,2
Abordoga,twisting-nether,384,shaman,enhancement,6,4,2
Nabq,hyjal,384,shaman,enhancement,6,4,2
Krytonian,twisting-nether,384,shaman,enhancement,6,4,2
Aitch,blackmoore,384,shaman,enhancement,6,4,2
Yeruna,arthas,384,shaman,enhancement,6,4,2
Россаврн,galakrond,384,shaman,enhancement,6,4,2
Lethz,hyjal,384,shaman,enhancement,6,4,2
Tàvèrnellø,nemesis,384,shaman,enhancement,6,4,2
Zenzua,twisting-nether,384,shaman,enhancement,6,4,2
Frrostshockk,outland,384,shaman,enhancement,6,4,2
Thornaim,hyjal,384,shaman,enhancement,6,4,2
Weåfy,outland,384,shaman,enhancement,6,4,2
Мистерэнх,soulflayer,384,shaman,enhancement,6,4,2
Элемуэль,soulflayer,384,shaman,enhancement,6,4,2
Kärmá,lightbringer,384,shaman,enhancement,6,4,2
Tornado,ravencrest,384,shaman,enhancement,6,4,2
Vønhørk,dalaran,384,shaman,enhancement,6,4,2
Claodze,stormscale,384,shaman,enhancement,12,4,8
Ennuii,blackrock,384,shaman,enhancement,12,4,8
Дюнволкер,razuvious,384,shaman,enhancement,12,4,8
Votie,tarren-mill,384,shaman,enhancement,12,4,8
Johnisplay,tarren-mill,384,shaman,enhancement,12,4,8
Discoshort,kazzak,384,shaman,enhancement,12,4,8
Kiwanuká,draenor,384,shaman,enhancement,12,4,8
Shôcopan,los-errantes,384,shaman,enhancement,12,4,8
Limech,dalaran,384,shaman,enhancement,12,4,8
Waterboi,blackmoore,384,shaman,enhancement,12,4,8
Yasunari,sanguino,384,shaman,enhancement,12,4,8
Powder,tichondrius,384,shaman,enhancement,12,4,8
Cptcutíe,antonidas,384,shaman,enhancement,12,4,8
Purgérkíng,silvermoon,384,shaman,enhancement,12,4,8
Kayalii,silvermoon,384,shaman,enhancement,12,4,8
Türak,tarren-mill,384,shaman,enhancement,12,4,8
Rykon,teldrassil,384,shaman,enhancement,12,4,8
Courtney,sylvanas,384,shaman,enhancement,12,4,8
Blixtnedslag,shattered-hand,384,shaman,enhancement,12,4,8
Sourens,twisting-nether,384,shaman,enhancement,12,4,8
Крепуксх,soulflayer,384,shaman,enhancement,12,4,8
Ódicen,dun-modr,384,shaman,enhancement,12,4,8
Jaéto,ravencrest,384,shaman,enhancement,12,4,8
Zabojad,stormscale,384,shaman,enhancement,12,4,8
Domiro,ravencrest,384,shaman,enhancement,18,4,14
Derryo,silvermoon,384,shaman,enhancement,18,4,14
Wkretarka,burning-legion,384,shaman,enhancement,18,4,14
Скерлайн,blackscar,384,shaman,enhancement,18,4,14
Fàkecast,outland,384,shaman,enhancement,18,4,14
Bubbschock,antonidas,383,shaman,enhancement,6,4,2
Shafallen,tarren-mill,383,shaman,enhancement,6,4,2
Goblaman,pozzo-delleternità,383,shaman,enhancement,6,4,2
Йовва,soulflayer,383,shaman,enhancement,6,4,2
Wolkano,zuljin,383,shaman,enhancement,10,5,5
Châmanco,dun-modr,383,shaman,enhancement,12,4,8
Hightotem,sanguino,383,shaman,enhancement,12,4,8
Аеесо,gordunni,383,shaman,enhancement,12,4,8
Джусипуси,gordunni,383,shaman,enhancement,12,4,8
Blutshock,zuluhed,382,shaman,enhancement,12,4,8
Nalàar,hyjal,368,shaman,enhancement,11,6,5
Lamoulastorm,chogall,351,shaman,enhancement,11,4,7
Kpvn,blackrock,351,shaman,enhancement,17,4,13
Piaoliang,ravencrest,336,shaman,enhancement,9,4,5
Akash,culte-de-la-rive-noire,336,shaman,enhancement,15,4,11
Johnyexe,drakthul,328,shaman,enhancement,8,5,3
Zaeh,antonidas,319,shaman,enhancement,5,4,1
Macchiavelli,blades-edge,319,shaman,enhancement,8,4,4
Trent,tarren-mill,288,shaman,enhancement,6,3,3
Làvagdx,archimonde,288,shaman,enhancement,6,3,3
Vaexi,doomhammer,288,shaman,enhancement,6,3,3
Xfiles,garona,288,shaman,enhancement,6,3,3
Borbor,argent-dawn,288,shaman,enhancement,6,3,3
Renjín,tarren-mill,288,shaman,enhancement,6,3,3
Håõkåh,hyjal,288,shaman,enhancement,6,3,3
Moebius,hellscream,288,shaman,enhancement,6,3,3
Karazrok,draenor,288,shaman,enhancement,6,3,3
Ostbumsdirne,stormscale,288,shaman,enhancement,6,3,3
Ednard,silvermoon,288,shaman,enhancement,6,3,3
Malcolmhex,ysondre,288,shaman,enhancement,6,3,3
Qzaah,garona,288,shaman,enhancement,6,3,3
Danthesham,draenor,288,shaman,enhancement,6,3,3
Venterlofeu,archimonde,288,shaman,enhancement,6,3,3
Chrisbrownx,outland,288,shaman,enhancement,6,3,3
Mefhaman,tarren-mill,288,shaman,enhancement,6,3,3
Reggard,drakthul,288,shaman,enhancement,6,3,3
Yerlas,burning-legion,288,shaman,enhancement,6,3,3
Kemurus,kazzak,288,shaman,enhancement,6,3,3
Kafese,uldaman,288,shaman,enhancement,6,3,3
Mørwayn,ysondre,288,shaman,enhancement,6,3,3
Neterö,la-croisade-écarlate,288,shaman,enhancement,6,3,3
Olej,burning-legion,288,shaman,enhancement,6,3,3
Whyisitspicy,kazzak,288,shaman,enhancement,6,3,3
Shoewalker,ragnaros,288,shaman,enhancement,6,3,3
Blazingfiré,tarren-mill,288,shaman,enhancement,6,3,3
Ønlýsîn,eredar,288,shaman,enhancement,6,3,3
Tidalflow,stormscale,288,shaman,enhancement,6,3,3
Daubidaubi,kazzak,288,shaman,enhancement,6,3,3
Buffresto,kazzak,288,shaman,enhancement,6,3,3
Totoostoy,burning-legion,288,shaman,enhancement,6,3,3
Zokah,emeriss,288,shaman,enhancement,6,3,3
Millesabords,dun-morogh,288,shaman,enhancement,6,3,3
Bluemyst,outland,288,shaman,enhancement,6,3,3
Surge,darksorrow,288,shaman,enhancement,6,3,3
Рокутаро,gordunni,288,shaman,enhancement,6,3,3
Xélania,argent-dawn,288,shaman,enhancement,6,3,3
Мэлик,howling-fjord,288,shaman,enhancement,6,3,3
Odelagga,sylvanas,288,shaman,enhancement,6,3,3
Hansdieter,antonidas,288,shaman,enhancement,6,3,3
Ccedtodeath,sylvanas,288,shaman,enhancement,6,3,3
Varion,tichondrius,288,shaman,enhancement,6,3,3
Fattywopwop,alakir,288,shaman,enhancement,6,3,3
Yacuzwerg,blackrock,288,shaman,enhancement,6,3,3
Айбьорн,gordunni,288,shaman,enhancement,6,3,3
Weltr,drakthul,288,shaman,enhancement,6,3,3
Âlphan,silvermoon,288,shaman,enhancement,6,3,3
Remkoo,blackrock,288,shaman,enhancement,6,3,3
Deadwôlf,stormscale,288,shaman,enhancement,6,3,3
Magosh,blackmoore,288,shaman,enhancement,6,3,3
Sodor,laughing-skull,288,shaman,enhancement,6,3,3
Zahadumia,blackrock,288,shaman,enhancement,6,3,3
Wiev,blackmoore,288,shaman,enhancement,6,3,3
Шамвкроксах,howling-fjord,288,shaman,enhancement,6,3,3
Ric,nemesis,288,shaman,enhancement,6,3,3
Nojiko,blackrock,288,shaman,enhancement,6,3,3
Kulho,stormscale,288,shaman,enhancement,6,3,3
Зуфар,howling-fjord,288,shaman,enhancement,6,3,3
Vainzxsham,ravencrest,288,shaman,enhancement,6,3,3
Saro,destromath,288,shaman,enhancement,6,3,3
Wakoteh,quelthalas,288,shaman,enhancement,6,3,3
Нерфшок,gordunni,288,shaman,enhancement,6,3,3
Kaareh,frostmourne,288,shaman,enhancement,6,3,3
Миддей,blackscar,288,shaman,enhancement,6,3,3
Freekster,die-ewige-wacht,288,shaman,enhancement,6,3,3
Ñtk,dun-modr,288,shaman,enhancement,6,3,3
Uomae,dun-modr,288,shaman,enhancement,6,3,3
Рэкквием,howling-fjord,288,shaman,enhancement,6,3,3
Lilkazamm,blackrock,288,shaman,enhancement,6,3,3
Имфеллиар,howling-fjord,288,shaman,enhancement,6,3,3
Сюсуй,blackscar,288,shaman,enhancement,6,3,3
Läzy,sanguino,288,shaman,enhancement,6,3,3
Pelicius,sanguino,288,shaman,enhancement,6,3,3
Xesti,twisting-nether,288,shaman,enhancement,6,3,3
Неутолимыйх,blackscar,288,shaman,enhancement,6,3,3
Shambamty,thrall,288,shaman,enhancement,12,3,9
Æskalatiøn,aegwynn,288,shaman,enhancement,12,3,9
Сторниер,howling-fjord,288,shaman,enhancement,12,3,9
Kappatotem,silvermoon,288,shaman,enhancement,12,3,9
Dastarus,archimonde,288,shaman,enhancement,12,3,9
Hurbi,twisting-nether,288,shaman,enhancement,12,3,9
Teldathree,archimonde,288,shaman,enhancement,12,3,9
Bonestompamc,blackmoore,288,shaman,enhancement,12,3,9
Avattar,twisting-nether,288,shaman,enhancement,12,3,9
Indan,kazzak,288,shaman,enhancement,12,3,9
Brunütansol,sylvanas,288,shaman,enhancement,12,3,9
Drshockit,blackrock,288,shaman,enhancement,12,3,9
Занги,soulflayer,288,shaman,enhancement,12,3,9
Maybeyes,twisting-nether,288,shaman,enhancement,12,3,9
Darkcleaver,drakthul,288,shaman,enhancement,12,3,9
Georgewhat,defias-brotherhood,288,shaman,enhancement,12,3,9
Kobzol,draenor,288,shaman,enhancement,12,3,9
Garash,draenor,288,shaman,enhancement,12,3,9
Amonshokz,tarren-mill,288,shaman,enhancement,12,3,9
Titiprosop,stormscale,288,shaman,enhancement,12,3,9
Lorthargol,chamber-of-aspects,288,shaman,enhancement,12,3,9
Лорикок,grom,288,shaman,enhancement,18,3,15
Dökowski,nemesis,288,shaman,enhancement,18,3,15
Ultaz,ravencrest,288,shaman,enhancement,18,3,15
Slappybag,ravencrest,287,shaman,enhancement,6,3,3
Стакок,soulflayer,287,shaman,enhancement,6,3,3
Trotzig,aegwynn,287,shaman,enhancement,6,3,3
Sshaasam,tarren-mill,287,shaman,enhancement,6,3,3
Nothìnto,pozzo-delleternità,287,shaman,enhancement,6,3,3
Heálmaster,sanguino,255,shaman,enhancement,11,3,8
Jehae,archimonde,239,shaman,enhancement,5,3,2
Kaátori,eredar,239,shaman,enhancement,5,3,2
Буряя,blackscar,234,shaman,enhancement,12,4,8
Nefasti,stormscale,223,shaman,enhancement,8,3,5
Mooshock,balnazzar,223,shaman,enhancement,8,3,5
Gaerth,aggramar,192,shaman,enhancement,6,2,4
Urshak,alleria,192,shaman,enhancement,6,2,4
Bloodfist,drakthul,192,shaman,enhancement,6,2,4
Shiggenbasta,kazzak,192,shaman,enhancement,6,2,4
Dalgorr,magtheridon,192,shaman,enhancement,6,2,4
Pulvêrizêr,agamaggan,192,shaman,enhancement,6,2,4
Sgf,stormscale,192,shaman,enhancement,6,2,4
Diya,karazhan,192,shaman,enhancement,6,2,4
Holybrolyy,malfurion,192,shaman,enhancement,6,2,4
Какашисан,howling-fjord,192,shaman,enhancement,6,2,4
Azzizael,chamber-of-aspects,192,shaman,enhancement,6,2,4
Yompo,archimonde,192,shaman,enhancement,6,2,4
Shamohd,ravencrest,192,shaman,enhancement,6,2,4
Haugren,eredar,192,shaman,enhancement,6,2,4
Schamikraut,silvermoon,192,shaman,enhancement,6,2,4
Bennycooch,silvermoon,192,shaman,enhancement,6,2,4
Starik,ravencrest,192,shaman,enhancement,6,2,4
Cptnbbl,blackmoore,192,shaman,enhancement,6,2,4
Eshami,tarren-mill,192,shaman,enhancement,6,2,4
Wòóshy,ravencrest,192,shaman,enhancement,6,2,4
Turbinká,burning-legion,192,shaman,enhancement,6,2,4
Cuchullaín,blackmoore,192,shaman,enhancement,6,2,4
Elementhor,archimonde,192,shaman,enhancement,6,2,4
Bonethugdex,bladefist,192,shaman,enhancement,6,2,4
Golfrick,hyjal,192,shaman,enhancement,6,2,4
Savan,darkspear,192,shaman,enhancement,6,2,4
Shalý,antonidas,192,shaman,enhancement,6,2,4
Shamalamadi,ragnaros,192,shaman,enhancement,6,2,4
Бьерн,deepholm,192,shaman,enhancement,6,2,4
Stub,nemesis,192,shaman,enhancement,6,2,4
Dogfrog,silvermoon,192,shaman,enhancement,6,2,4
Snapbábe,blackmoore,192,shaman,enhancement,6,2,4
Restmuell,blackmoore,192,shaman,enhancement,6,2,4
Santy,silvermoon,192,shaman,enhancement,6,2,4
Rodfrugten,draenor,192,shaman,enhancement,6,2,4
Shámyé,silvermoon,192,shaman,enhancement,6,2,4
Stiflersmôm,antonidas,192,shaman,enhancement,6,2,4
Layonne,ysondre,192,shaman,enhancement,6,2,4
Tâw,blackhand,192,shaman,enhancement,6,2,4
Suicidesheep,grim-batol,192,shaman,enhancement,6,2,4
Трупелмен,soulflayer,192,shaman,enhancement,6,2,4
Bram,aggra-português,192,shaman,enhancement,6,2,4
Kwitnac,silvermoon,192,shaman,enhancement,6,2,4
Rûngard,aegwynn,192,shaman,enhancement,6,2,4
Iloveléa,ravencrest,192,shaman,enhancement,6,2,4
Khon,eredar,192,shaman,enhancement,6,2,4
Pakasschami,frostwolf,192,shaman,enhancement,6,2,4
Lovros,kazzak,192,shaman,enhancement,6,2,4
Louvreparis,frostwolf,192,shaman,enhancement,6,2,4
Yezu,medivh,192,shaman,enhancement,6,2,4
Wertu,ragnaros,192,shaman,enhancement,6,2,4
Zows,kazzak,192,shaman,enhancement,6,2,4
Shoar,twisting-nether,192,shaman,enhancement,6,2,4
Volkar,auchindoun,192,shaman,enhancement,6,2,4
Kohzen,outland,192,shaman,enhancement,6,2,4
Ogshaman,archimonde,192,shaman,enhancement,6,2,4
Shocknrun,sylvanas,192,shaman,enhancement,6,2,4
Aubesombre,dalaran,192,shaman,enhancement,6,2,4
Palarins,dalaran,192,shaman,enhancement,6,2,4
Thunderstørm,chogall,192,shaman,enhancement,6,2,4
Родохрозид,blackscar,192,shaman,enhancement,6,2,4
Destroilleur,archimonde,192,shaman,enhancement,6,2,4
Mycameltotem,ravencrest,192,shaman,enhancement,6,2,4
Kassyoh,hyjal,192,shaman,enhancement,6,2,4
Штурвальный,blackscar,192,shaman,enhancement,6,2,4
Türzumachen,outland,192,shaman,enhancement,6,2,4
Bladeyx,ragnaros,192,shaman,enhancement,6,2,4
Саксаул,fordragon,192,shaman,enhancement,6,2,4
Søló,stormscale,192,shaman,enhancement,6,2,4
Laserra,sylvanas,192,shaman,enhancement,6,2,4
Peaksh,stormscale,192,shaman,enhancement,6,2,4
Shockinghell,sylvanas,192,shaman,enhancement,6,2,4
Fufupartyxx,blackrock,192,shaman,enhancement,6,2,4
Thoráck,stormscale,192,shaman,enhancement,6,2,4
Kaptt,twisting-nether,192,shaman,enhancement,6,2,4
Spiritualx,argent-dawn,192,shaman,enhancement,6,2,4
Пакни,gordunni,192,shaman,enhancement,6,2,4
Elé,ravenholdt,192,shaman,enhancement,6,2,4
Nìtratx,archimonde,192,shaman,enhancement,6,2,4
Acces,stormscale,192,shaman,enhancement,6,2,4
Gundsthunder,ravencrest,192,shaman,enhancement,6,2,4
Xharnel,defias-brotherhood,192,shaman,enhancement,6,2,4
Locosonik,kazzak,192,shaman,enhancement,6,2,4
Ðøminantx,stormscale,192,shaman,enhancement,6,2,4
Råkk,argent-dawn,192,shaman,enhancement,6,2,4
Hugzy,argent-dawn,192,shaman,enhancement,6,2,4
Cleptocracy,draenor,192,shaman,enhancement,6,2,4
Lokkrag,archimonde,192,shaman,enhancement,6,2,4
Crazo,tarren-mill,192,shaman,enhancement,6,2,4
Skullføck,argent-dawn,192,shaman,enhancement,6,2,4
Дортманшам,gordunni,192,shaman,enhancement,6,2,4
Vorkanyx,ysondre,192,shaman,enhancement,7,2,5
Vollt,kazzak,192,shaman,enhancement,9,2,7
Elementarxss,blackmoore,192,shaman,enhancement,12,2,10
Khakazis,ravencrest,192,shaman,enhancement,12,2,10
Stormstriker,arathor,192,shaman,enhancement,12,2,10
Zarakuda,magtheridon,192,shaman,enhancement,12,2,10
Sïlvek,sanguino,192,shaman,enhancement,12,2,10
Shÿmä,dalaran,192,shaman,enhancement,12,2,10
Borindor,silvermoon,192,shaman,enhancement,12,2,10
Pachamane,archimonde,192,shaman,enhancement,12,2,10
Lavalew,lightbringer,192,shaman,enhancement,12,2,10
Elsassi,ravencrest,192,shaman,enhancement,12,2,10
Nuao,perenolde,138,shaman,enhancement,9,3,6
Theshame,ravencrest,128,shaman,enhancement,4,2,2
Bux,khaz-modan,127,shaman,enhancement,10,2,8
Bambustic,kazzak,96,shaman,enhancement,6,1,5
Epicoverlord,tarren-mill,96,shaman,enhancement,6,1,5
Porthex,kazzak,96,shaman,enhancement,6,1,5
Fiskätarn,kazzak,96,shaman,enhancement,6,1,5
Hóonda,twisting-nether,96,shaman,enhancement,6,1,5
Ghaargrim,tarren-mill,96,shaman,enhancement,6,1,5
Mikecrybaby,tarren-mill,96,shaman,enhancement,6,1,5
Lawdjeezes,draenor,96,shaman,enhancement,6,1,5
Malvik,tarren-mill,96,shaman,enhancement,6,1,5
Agrok,jaedenar,96,shaman,enhancement,6,1,5
Cryptotem,ragnaros,96,shaman,enhancement,6,1,5
Разодран,gordunni,96,shaman,enhancement,6,1,5
Keräx,cthun,96,shaman,enhancement,6,1,5
Rækwon,tarren-mill,96,shaman,enhancement,6,1,5
Élémentyum,archimonde,96,shaman,enhancement,6,1,5
Ацитра,gordunni,96,shaman,enhancement,6,1,5
Stòrm,ravencrest,96,shaman,enhancement,6,1,5
Цукерок,soulflayer,96,shaman,enhancement,6,1,5
Urubus,kazzak,96,shaman,enhancement,6,1,5
Shøckz,azjolnerub,96,shaman,enhancement,6,1,5
Hazles,ragnaros,96,shaman,enhancement,6,1,5
Maskinett,stormscale,96,shaman,enhancement,6,1,5
Shaamz,tarren-mill,96,shaman,enhancement,6,1,5
Malabestia,archimonde,96,shaman,enhancement,6,1,5
Baaruch,kazzak,96,shaman,enhancement,6,1,5
Grabmytotemz,tarren-mill,96,shaman,enhancement,6,1,5
Xhøxy,outland,96,shaman,enhancement,6,1,5
Thoreign,burning-legion,96,shaman,enhancement,6,1,5
Preshear,twisting-nether,96,shaman,enhancement,6,1,5
Amarök,nerzhul,96,shaman,enhancement,6,1,5
Criæ,blackrock,96,shaman,enhancement,6,1,5
Afterlife,alakir,96,shaman,enhancement,6,1,5
Vilberoo,ravencrest,96,shaman,enhancement,6,1,5
Hí,bronzebeard,96,shaman,enhancement,6,1,5
Zoélement,nerzhul,96,shaman,enhancement,6,1,5
Thormyr,dalaran,96,shaman,enhancement,6,1,5
Shåmssagat,kazzak,96,shaman,enhancement,6,1,5
Gewieft,azshara,96,shaman,enhancement,6,1,5
Zoogang,ragnaros,96,shaman,enhancement,6,1,5
Mástà,onyxia,96,shaman,enhancement,6,1,5
Ragnadim,silvermoon,96,shaman,enhancement,6,1,5
Sekane,archimonde,96,shaman,enhancement,6,1,5
Eneel,blackmoore,96,shaman,enhancement,6,1,5
Goldhand,ravencrest,96,shaman,enhancement,6,1,5
Thoranis,kazzak,96,shaman,enhancement,6,1,5
Casarú,arthas,96,shaman,enhancement,6,1,5
Vladraxes,draenor,96,shaman,enhancement,6,1,5
Winiepuuh,antonidas,96,shaman,enhancement,6,1,5
Freexx,aegwynn,96,shaman,enhancement,8,1,7
Хэллшам,howling-fjord,96,shaman,enhancement,12,1,11
Xzan,tarren-mill,96,shaman,enhancement,12,1,11
Ymiras,argent-dawn,96,shaman,enhancement,12,1,11
Sycophant,stormscale,96,shaman,enhancement,12,1,11
Reyax,aegwynn,96,shaman,enhancement,12,1,11
Volgue,kaelthas,96,shaman,enhancement,12,1,11
Эншам,blackscar,96,shaman,enhancement,12,1,11
Jacklupin,ravencrest,79,shaman,enhancement,5,1,4
Choltaj,burning-legion,79,shaman,enhancement,7,1,6
Sìrenia,tarren-mill,63,shaman,enhancement,2,2,0
Daboo,the-venture-co,48,shaman,enhancement,3,1,2
Biggie,pozzo-delleternità,48,shaman,enhancement,3,1,2
Rký,outland,48,shaman,enhancement,3,1,2
Wenesday,ysondre,48,shaman,enhancement,3,1,2
Адскийсон,gordunni,42,shaman,enhancement,9,2,7
Lesnitt,kazzak,42,shaman,enhancement,9,2,7
Aleshade,argent-dawn,31,shaman,enhancement,2,1,1
Kimkold,twisting-nether,2247,warlock,demonology,144,84,60
Pogbõss,kazzak,2221,warlock,demonology,183,96,87
Rikkërt,draenor,2207,warlock,demonology,89,49,40
Dotjürgen,blackrock,2205,warlock,demonology,84,48,36
Ambitions,hyjal,2182,warlock,demonology,106,59,47
Амеаль,eversong,2181,warlock,demonology,363,190,173
Млечный,blackscar,2177,warlock,demonology,189,103,86
Whøknøws,twisting-nether,2176,warlock,demonology,84,45,39
Cònq,tarren-mill,2175,warlock,demonology,90,50,40
Setyouinfear,ravencrest,2174,warlock,demonology,106,63,43
Dæhli,argent-dawn,2166,warlock,demonology,102,56,46
Tuskawl,stormreaver,2154,warlock,demonology,91,51,40
Nayolana,argent-dawn,2150,warlock,demonology,72,46,26
Firochektro,ravencrest,2141,warlock,demonology,69,42,27
Sad,lightnings-blade,2134,warlock,demonology,178,97,81
Maintarget,blackrock,2131,warlock,demonology,159,85,74
Favorizlmp,archimonde,2123,warlock,demonology,107,74,33
Lankycheese,kazzak,2121,warlock,demonology,83,46,37
Syntaxzwo,blackmoore,2116,warlock,demonology,78,44,34
Dotyboi,tarren-mill,2115,warlock,demonology,72,44,28
Rumour,sunstrider,2115,warlock,demonology,72,39,33
Jimboneutron,stormscale,2113,warlock,demonology,53,30,23
Supergeîl,blackrock,2112,warlock,demonology,71,38,33
Xerkh,thrall,2111,warlock,demonology,78,43,35
Malddog,turalyon,2103,warlock,demonology,108,61,47
Britneÿ,stormscale,2096,warlock,demonology,90,46,44
Neverfearjk,aegwynn,2085,warlock,demonology,53,39,14
Voldby,kazzak,2083,warlock,demonology,55,34,21
Droguri,darkspear,2079,warlock,demonology,96,64,32
Anthh,doomhammer,2076,warlock,demonology,66,36,30
Purplemonkey,burning-blade,2058,warlock,demonology,68,37,31
Nyotu,antonidas,2058,warlock,demonology,72,39,33
Smaúg,archimonde,2058,warlock,demonology,126,63,63
Firochek,ravencrest,2052,warlock,demonology,84,44,40
Smdtwo,drakthul,2050,warlock,demonology,53,31,22
Wspolnax,ravencrest,2050,warlock,demonology,60,34,26
Locktrainer,tarren-mill,2040,warlock,demonology,212,104,108
Thardik,azuremyst,2037,warlock,demonology,84,42,42
Krøl,nemesis,2036,warlock,demonology,54,35,19
Zerulian,ragnaros,2035,warlock,demonology,78,48,30
Onlylock,outland,2034,warlock,demonology,60,38,22
Shablagoo,twisting-nether,2032,warlock,demonology,90,51,39
Ffpiiras,dunemaul,2023,warlock,demonology,95,50,45
Capsloq,la-croisade-écarlate,2017,warlock,demonology,90,48,42
Ðïÿëñbïëñfüû,suramar,2014,warlock,demonology,147,75,72
Cørpse,burning-legion,2012,warlock,demonology,100,55,45
Bibiflexberg,eredar,2011,warlock,demonology,47,30,17
Britneý,stormscale,2008,warlock,demonology,118,58,60
Ogrez,nemesis,2006,warlock,demonology,77,38,39
Хаосболик,gordunni,2002,warlock,demonology,84,45,39
Raspalakuja,kazzak,2002,warlock,demonology,66,32,34
Synthiax,silvermoon,1986,warlock,demonology,66,39,27
Dabezdwl,outland,1973,warlock,demonology,78,45,33
Badapow,stormscale,1971,warlock,demonology,54,29,25
Адво,howling-fjord,1968,warlock,demonology,71,37,34
Rïñ,ravencrest,1968,warlock,demonology,60,28,32
Аоепампгодх,howling-fjord,1967,warlock,demonology,36,24,12
Тёмабиль,gordunni,1967,warlock,demonology,343,184,159
Ишла,gordunni,1959,warlock,demonology,77,41,36
Zàk,twisting-nether,1956,warlock,demonology,60,41,19
Конидэмико,blackscar,1954,warlock,demonology,83,38,45
Онлидемон,gordunni,1946,warlock,demonology,56,33,23
Alotami,frostwolf,1942,warlock,demonology,48,30,18
Døwz,ysondre,1932,warlock,demonology,60,30,30
Xenastro,silvermoon,1931,warlock,demonology,54,30,24
Apple,scarshield-legion,1930,warlock,demonology,133,69,64
Khavar,antonidas,1926,warlock,demonology,82,46,36
Lokmonji,perenolde,1923,warlock,demonology,60,34,26
Фламмэнх,soulflayer,1920,warlock,demonology,49,28,21
Vultzbolt,draenor,1920,warlock,demonology,66,36,30
Juicybolt,chogall,1917,warlock,demonology,76,43,33
Kamorilock,blackhand,1912,warlock,demonology,36,20,16
Skillførçé,kazzak,1911,warlock,demonology,36,26,10
Demoner,tarren-mill,1910,warlock,demonology,108,52,56
Blacklock,argent-dawn,1908,warlock,demonology,54,34,20
Shadowvirus,auchindoun,1908,warlock,demonology,41,23,18
Тьмазвёздная,gordunni,1907,warlock,demonology,93,51,42
Годнодх,gordunni,1902,warlock,demonology,54,29,25
Anúki,kazzak,1900,warlock,demonology,25,21,4
Ravendoor,grim-batol,1900,warlock,demonology,76,39,37
Indrâxx,hyjal,1899,warlock,demonology,36,31,5
Keybump,outland,1899,warlock,demonology,72,48,24
Neinbosa,tarren-mill,1899,warlock,demonology,60,30,30
Bonnieparkêr,onyxia,1898,warlock,demonology,48,26,22
Désolaté,kazzak,1893,warlock,demonology,47,29,18
Stafar,kazzak,1891,warlock,demonology,66,34,32
Дёмын,howling-fjord,1890,warlock,demonology,96,46,50
Makkez,outland,1876,warlock,demonology,30,20,10
Шекигами,gordunni,1874,warlock,demonology,48,33,15
Höfmänn,kazzak,1865,warlock,demonology,39,25,14
Dispeluapls,blackmoore,1865,warlock,demonology,54,28,26
Zouglougou,archimonde,1864,warlock,demonology,78,37,41
Delius,eitrigg,1863,warlock,demonology,67,47,20
Tyrantlol,sylvanas,1862,warlock,demonology,54,32,22
Bluh,twisting-nether,1860,warlock,demonology,36,22,14
Weso,grim-batol,1859,warlock,demonology,60,31,29
Fearrari,ragnaros,1857,warlock,demonology,108,59,49
Stankaemayne,blackhand,1856,warlock,demonology,55,31,24
Оброссыш,gordunni,1855,warlock,demonology,60,34,26
Dhärc,sanguino,1854,warlock,demonology,54,31,23
Infïnitýx,silvermoon,1851,warlock,demonology,38,25,13
Stalowwy,silvermoon,1849,warlock,demonology,108,59,49
Ägony,blackrock,1848,warlock,demonology,54,31,23
Jopasiski,draenor,1848,warlock,demonology,54,28,26
Höfmänn,grim-batol,1847,warlock,demonology,48,31,17
Shakuroz,frostwolf,1847,warlock,demonology,68,41,27
Динодотз,howling-fjord,1847,warlock,demonology,54,27,27
Immaginare,sylvanas,1845,warlock,demonology,60,29,31
Артисона,gordunni,1842,warlock,demonology,48,27,21
Attritiona,stormscale,1838,warlock,demonology,60,32,28
Инфезиус,deathweaver,1834,warlock,demonology,59,33,26
Purplereîgn,stormscale,1834,warlock,demonology,57,31,26
Outofcurses,earthen-ring,1834,warlock,demonology,83,42,41
Djmäkish,outland,1828,warlock,demonology,42,23,19
Санявахтовик,blackscar,1827,warlock,demonology,72,39,33
Benne,stormscale,1825,warlock,demonology,49,31,18
Арон,soulflayer,1824,warlock,demonology,47,25,22
Malificus,silvermoon,1823,warlock,demonology,114,67,47
Kennyfõx,ysondre,1819,warlock,demonology,24,19,5
Ismenia,silvermoon,1819,warlock,demonology,60,39,21
Cellfear,kazzak,1818,warlock,demonology,42,24,18
Skrana,kazzak,1818,warlock,demonology,47,25,22
Musallat,argent-dawn,1818,warlock,demonology,65,34,31
Fiveyearque,sylvanas,1817,warlock,demonology,54,33,21
Hellguards,silvermoon,1817,warlock,demonology,60,33,27
Ravenglass,argent-dawn,1817,warlock,demonology,54,25,29
Warth,silvermoon,1816,warlock,demonology,42,28,14
Painowgee,kazzak,1816,warlock,demonology,36,20,16
Crathar,kazzak,1816,warlock,demonology,76,38,38
Jackyfalls,blackmoore,1815,warlock,demonology,42,27,15
Bualock,tarren-mill,1815,warlock,demonology,36,22,14
Devilfluffy,blackhand,1815,warlock,demonology,59,35,24
Cigänä,archimonde,1815,warlock,demonology,36,19,17
Blackdog,argent-dawn,1814,warlock,demonology,48,23,25
Malzeva,ravencrest,1813,warlock,demonology,71,33,38
Zypzanti,antonidas,1810,warlock,demonology,155,97,58
Kopfkissen,azshara,1810,warlock,demonology,51,29,22
Кварий,howling-fjord,1810,warlock,demonology,401,200,201
Tagzi,ravencrest,1809,warlock,demonology,47,29,18
Cuteyess,shadowsong,1808,warlock,demonology,30,19,11
Smâûhg,blackrock,1807,warlock,demonology,42,28,14
Nécron,ysondre,1806,warlock,demonology,59,32,27
Lúcìfér,stormscale,1806,warlock,demonology,66,34,32
Фэлмор,howling-fjord,1805,warlock,demonology,54,33,21
Thugsupreme,ravencrest,1805,warlock,demonology,65,36,29
Nerigo,senjin,1805,warlock,demonology,48,24,24
Dontargetme,draenor,1804,warlock,demonology,38,26,12
Nemwl,draenor,1804,warlock,demonology,66,36,30
Splicer,eredar,1803,warlock,demonology,49,29,20
Киёкка,howling-fjord,1803,warlock,demonology,90,53,37
Arkanyks,dalaran,1802,warlock,demonology,72,32,40
Htaedfo,tarren-mill,1802,warlock,demonology,74,32,42
Мутгодх,soulflayer,1800,warlock,demonology,30,19,11
Кайзершлафен,fordragon,1800,warlock,demonology,58,28,30
Gv,ragnaros,1795,warlock,demonology,36,19,17
Sanguinis,theradras,1794,warlock,demonology,106,57,49
Dâedra,argent-dawn,1793,warlock,demonology,54,31,23
Дьяволзаплач,howling-fjord,1793,warlock,demonology,48,26,22
Lïñglïñg,twisting-nether,1791,warlock,demonology,36,25,11
Mustasheen,stormscale,1790,warlock,demonology,36,21,15
Äåäåäåäåäåäå,ravencrest,1789,warlock,demonology,47,26,21
Tamaduitoru,dragonblight,1782,warlock,demonology,66,43,23
Proßlock,kazzak,1780,warlock,demonology,123,73,50
Shadowflamez,argent-dawn,1771,warlock,demonology,30,27,3
Glavy,burning-legion,1765,warlock,demonology,131,71,60
Zehirisalari,twisting-nether,1761,warlock,demonology,42,24,18
Omnípotens,silvermoon,1755,warlock,demonology,60,33,27
Егосяхаос,soulflayer,1755,warlock,demonology,144,78,66
Alphalock,mannoroth,1755,warlock,demonology,72,35,37
Catchlock,tarren-mill,1752,warlock,demonology,36,20,16
Císuh,stormreaver,1747,warlock,demonology,56,30,26
Пухи,blackscar,1741,warlock,demonology,55,23,32
Kolskegg,doomhammer,1740,warlock,demonology,90,48,42
Этожедру,howling-fjord,1734,warlock,demonology,47,32,15
Kennÿfõx,ysondre,1732,warlock,demonology,24,19,5
Zezo,stormscale,1731,warlock,demonology,29,21,8
Naarnust,defias-brotherhood,1727,warlock,demonology,42,28,14
Adafbhf,tichondrius,1723,warlock,demonology,41,22,19
Помечте,soulflayer,1723,warlock,demonology,94,41,53
Dalamon,draenor,1721,warlock,demonology,48,24,24
Храбзар,gordunni,1721,warlock,demonology,112,51,61
Dadcrush,antonidas,1720,warlock,demonology,84,42,42
Moffguldan,sanguino,1719,warlock,demonology,48,28,20
Louên,dun-modr,1715,warlock,demonology,48,24,24
Zelieknight,ysondre,1711,warlock,demonology,60,28,32
Synlockiax,silvermoon,1709,warlock,demonology,56,38,18
Despépêche,garona,1709,warlock,demonology,42,24,18
Зажиженный,soulflayer,1707,warlock,demonology,40,26,14
Izhi,ragnaros,1705,warlock,demonology,66,38,28
Фортэр,ashenvale,1705,warlock,demonology,60,31,29
Scaevóla,ravencrest,1703,warlock,demonology,233,125,108
Nâzgrel,tarren-mill,1703,warlock,demonology,72,35,37
Zezca,draenor,1702,warlock,demonology,48,27,21
Gazdruul,culte-de-la-rive-noire,1701,warlock,demonology,30,20,10
Hexdrix,thrall,1701,warlock,demonology,45,20,25
Slockoló,ragnaros,1701,warlock,demonology,54,21,33
Drerlord,tarren-mill,1699,warlock,demonology,48,21,27
Kuloo,blackmoore,1698,warlock,demonology,30,18,12
Totephia,kazzak,1696,warlock,demonology,72,33,39
Rune,aegwynn,1695,warlock,demonology,52,29,23
Tjockoloco,tarren-mill,1695,warlock,demonology,164,89,75
Kazzy,grim-batol,1693,warlock,demonology,30,21,9
Zatella,ravencrest,1693,warlock,demonology,84,45,39
Malowix,outland,1690,warlock,demonology,42,20,22
Zoreck,uldum,1689,warlock,demonology,36,20,16
Бриант,gordunni,1689,warlock,demonology,47,19,28
Yamadea,stormscale,1686,warlock,demonology,48,25,23
Grimmwald,stormreaver,1685,warlock,demonology,46,22,24
Eluinees,silvermoon,1684,warlock,demonology,36,25,11
Jinusek,burning-legion,1682,warlock,demonology,43,23,20
Grêenbull,eredar,1680,warlock,demonology,49,27,22
Варикай,gordunni,1678,warlock,demonology,42,27,15
Жериновсский,gordunni,1677,warlock,demonology,36,18,18
Terrorrize,draenor,1673,warlock,demonology,36,21,15
Fandirxd,draenor,1672,warlock,demonology,120,57,63
Iskieel,ravencrest,1671,warlock,demonology,44,26,18
Bloodlock,onyxia,1670,warlock,demonology,42,22,20
Osbaa,bladefist,1668,warlock,demonology,42,22,20
Snackstickz,twisting-nether,1665,warlock,demonology,54,33,21
Impaler,tarren-mill,1664,warlock,demonology,188,91,97
Lottopallo,arathor,1663,warlock,demonology,121,77,44
Анрали,soulflayer,1662,warlock,demonology,41,23,18
Xtyran,blackmoore,1661,warlock,demonology,42,20,22
Lockmex,outland,1658,warlock,demonology,42,26,16
Kemel,thrall,1655,warlock,demonology,30,21,9
Нафлэпил,gordunni,1655,warlock,demonology,54,31,23
Гурджес,soulflayer,1655,warlock,demonology,98,52,46
Niyyu,blackmoore,1654,warlock,demonology,48,22,26
Shugglock,draenor,1653,warlock,demonology,42,23,19
Deamonsmith,silvermoon,1652,warlock,demonology,58,36,22
Mjor,twisting-nether,1650,warlock,demonology,30,18,12
Chromagnus,drakthul,1649,warlock,demonology,36,21,15
Utsus,tarren-mill,1645,warlock,demonology,36,23,13
Hypotax,ragnaros,1644,warlock,demonology,54,33,21
Môrgán,draenor,1640,warlock,demonology,180,91,89
Tekron,blackhand,1639,warlock,demonology,54,36,18
Requeims,outland,1638,warlock,demonology,48,22,26
Fîgøk,conseil-des-ombres,1638,warlock,demonology,48,21,27
Tiffyilock,blackrock,1637,warlock,demonology,42,20,22
Scottware,draenor,1635,warlock,demonology,38,23,15
Darcîa,destromath,1633,warlock,demonology,100,56,44
Règis,antonidas,1633,warlock,demonology,42,22,20
Tenshirou,blackrock,1631,warlock,demonology,35,21,14
Zzooxx,silvermoon,1631,warlock,demonology,30,17,13
Лвнг,gordunni,1628,warlock,demonology,48,29,19
Dimmybyrger,stormreaver,1627,warlock,demonology,30,17,13
Abdelkarime,khaz-modan,1627,warlock,demonology,42,23,19
Summonit,blackmoore,1627,warlock,demonology,54,29,25
Interceptêr,blackrock,1627,warlock,demonology,42,22,20
Neuth,draenor,1627,warlock,demonology,50,21,29
Erkai,kazzak,1624,warlock,demonology,45,24,21
Dasda,defias-brotherhood,1623,warlock,demonology,89,49,40
Мешшугга,howling-fjord,1623,warlock,demonology,38,20,18
Dualla,aegwynn,1623,warlock,demonology,36,17,19
Элси,howling-fjord,1622,warlock,demonology,30,17,13
Capsloq,sargeras,1622,warlock,demonology,33,18,15
Нэкрил,howling-fjord,1621,warlock,demonology,35,22,13
Xanatas,nemesis,1620,warlock,demonology,42,25,17
Icò,ravencrest,1620,warlock,demonology,36,17,19
Fedpikkefar,kazzak,1619,warlock,demonology,36,17,19
Golborg,draenor,1619,warlock,demonology,75,33,42
Kûraiko,blackrock,1614,warlock,demonology,30,17,13
Vêzor,twisting-nether,1612,warlock,demonology,34,19,15
Eroszakolock,ragnaros,1611,warlock,demonology,24,17,7
Kody,blackmoore,1609,warlock,demonology,24,17,7
Mendozaah,kazzak,1607,warlock,demonology,188,92,96
Ahollic,frostwolf,1606,warlock,demonology,30,19,11
Shuggul,draenor,1606,warlock,demonology,37,22,15
Hellbboy,azjolnerub,1605,warlock,demonology,79,45,34
Darkenlock,burning-legion,1605,warlock,demonology,42,22,20
Tamatóax,tarren-mill,1605,warlock,demonology,51,26,25
Demonjoker,blackhand,1604,warlock,demonology,51,31,20
Deaddydoo,kazzak,1604,warlock,demonology,42,20,22
Havexis,tichondrius,1602,warlock,demonology,42,32,10
Prekt,ragnaros,1601,warlock,demonology,36,19,17
Positivitywl,stormscale,1600,warlock,demonology,24,17,7
Zzooxxie,silvermoon,1600,warlock,demonology,42,19,23
Djshyasiañ,perenolde,1599,warlock,demonology,176,90,86
Гвоздяшка,blackscar,1597,warlock,demonology,47,22,25
Nàughty,ragnaros,1594,warlock,demonology,33,17,16
Sokyra,tarren-mill,1594,warlock,demonology,54,25,29
Eleriya,argent-dawn,1591,warlock,demonology,92,45,47
Yumiblood,tarren-mill,1589,warlock,demonology,47,25,22
Malumbra,argent-dawn,1589,warlock,demonology,40,19,21
Филоняша,gordunni,1583,warlock,demonology,42,25,17
Sublînê,blackmoore,1582,warlock,demonology,82,41,41
Potatowl,ravencrest,1582,warlock,demonology,36,18,18
Míkæ,ravencrest,1582,warlock,demonology,72,34,38
Tonin,antonidas,1581,warlock,demonology,53,33,20
Longdickie,ravencrest,1581,warlock,demonology,36,20,16
Insídíous,tarren-mill,1581,warlock,demonology,36,19,17
Felsturm,twisting-nether,1579,warlock,demonology,42,30,12
Мамхаус,howling-fjord,1579,warlock,demonology,36,22,14
Endherkonk,sanguino,1578,warlock,demonology,60,31,29
Sörlewiis,the-maelstrom,1576,warlock,demonology,48,29,19
Gulzot,turalyon,1575,warlock,demonology,42,28,14
Kalinowa,burning-legion,1573,warlock,demonology,95,53,42
Erøne,archimonde,1569,warlock,demonology,217,111,106
Шэдоубёрн,soulflayer,1567,warlock,demonology,101,58,43
Iovol,korgall,1566,warlock,demonology,60,36,24
Azthral,nemesis,1566,warlock,demonology,141,73,68
Agâshh,blackrock,1565,warlock,demonology,32,20,12
Silenozz,ragnaros,1564,warlock,demonology,91,49,42
Gemors,ravenholdt,1562,warlock,demonology,83,42,41
Зарлог,soulflayer,1560,warlock,demonology,42,22,20
Чернаяскала,howling-fjord,1560,warlock,demonology,78,40,38
Dotsyoudown,kelthuzad,1560,warlock,demonology,36,18,18
Itspoint,draenor,1558,warlock,demonology,65,33,32
Hâres,anetheron,1550,warlock,demonology,241,116,125
Sedryn,turalyon,1547,warlock,demonology,660,337,323
Костикк,howling-fjord,1546,warlock,demonology,37,21,16
Hamnam,blackrock,1543,warlock,demonology,42,23,19
Nerzhull,stormscale,1539,warlock,demonology,87,44,43
Stormytrumpy,twisting-nether,1537,warlock,demonology,33,18,15
Redshíne,hyjal,1537,warlock,demonology,54,24,30
Solitariøus,arathi,1536,warlock,demonology,60,30,30
Nuwdles,tarren-mill,1535,warlock,demonology,42,23,19
Repah,doomhammer,1534,warlock,demonology,30,17,13
Fsandtwo,ravencrest,1534,warlock,demonology,30,16,14
Kaamosliha,frostwhisper,1532,warlock,demonology,101,51,50
Харакула,fordragon,1531,warlock,demonology,24,17,7
Altffeer,blackmoore,1531,warlock,demonology,47,27,20
Wëndigo,stormscale,1530,warlock,demonology,41,19,22
Tochka,archimonde,1523,warlock,demonology,36,18,18
Bunne,twisting-nether,1523,warlock,demonology,36,16,20
Sïlïthuss,ravencrest,1522,warlock,demonology,111,58,53
Indiasummerx,turalyon,1521,warlock,demonology,46,26,20
Lockaria,zuljin,1519,warlock,demonology,42,24,18
Benzakenta,sylvanas,1518,warlock,demonology,36,22,14
Skitless,blackmoore,1514,warlock,demonology,39,19,20
Ájszmen,ravencrest,1512,warlock,demonology,99,48,51
Seriasa,blackmoore,1511,warlock,demonology,66,27,39
Грешъник,gordunni,1508,warlock,demonology,37,19,18
Theolock,ragnaros,1508,warlock,demonology,60,28,32
Ayóó,doomhammer,1504,warlock,demonology,302,155,147
Rafael,stormscale,1503,warlock,demonology,60,33,27
Bß,argent-dawn,1495,warlock,demonology,47,28,19
Srhal,blackmoore,1492,warlock,demonology,96,53,43
Morgan,jaedenar,1491,warlock,demonology,66,28,38
Dabulock,blackmoore,1487,warlock,demonology,33,17,16
Beloezoloto,deathwing,1484,warlock,demonology,36,16,20
Эволюционист,gordunni,1483,warlock,demonology,42,22,20
Absúrd,turalyon,1481,warlock,demonology,228,127,101
Khalkazar,darkspear,1477,warlock,demonology,30,16,14
Roedin,tarren-mill,1477,warlock,demonology,112,43,69
Felburrn,twisting-nether,1475,warlock,demonology,83,40,43
Мормир,deathguard,1473,warlock,demonology,46,23,23
Béastmodex,eredar,1470,warlock,demonology,33,18,15
Иллугис,gordunni,1468,warlock,demonology,36,17,19
Паникс,gordunni,1463,warlock,demonology,42,18,24
Mephysteroth,dalaran,1462,warlock,demonology,30,16,14
Enviroq,burning-legion,1454,warlock,demonology,36,22,14
Deprecated,burning-blade,1453,warlock,demonology,29,17,12
Валентинчик,galakrond,1452,warlock,demonology,57,32,25
Jondi,blackmoore,1452,warlock,demonology,43,23,20
Rpez,archimonde,1451,warlock,demonology,202,107,95
Нгага,howling-fjord,1443,warlock,demonology,227,111,116
Esgül,draenor,1442,warlock,demonology,76,40,36
Igõr,draenor,1439,warlock,demonology,24,15,9
Razzguul,blackmoore,1439,warlock,demonology,34,19,15
Nachtreich,thrall,1438,warlock,demonology,24,15,9
Priszcilla,twisting-nether,1438,warlock,demonology,108,59,49
Benvyx,twisting-nether,1438,warlock,demonology,30,15,15
Rektube,sanguino,1437,warlock,demonology,18,15,3
Easycheasy,ravencrest,1437,warlock,demonology,30,15,15
Jesez,aegwynn,1436,warlock,demonology,24,15,9
Чутьчутьзлая,gordunni,1436,warlock,demonology,54,25,29
Æternallock,nemesis,1433,warlock,demonology,42,26,16
Ganjubass,tarren-mill,1432,warlock,demonology,24,15,9
Kukcaryfuk,drakthul,1431,warlock,demonology,54,27,27
Dhraven,thrall,1427,warlock,demonology,42,21,21
Lockned,outland,1426,warlock,demonology,24,15,9
Corbiejr,tarren-mill,1425,warlock,demonology,70,29,41
Algolagniac,stormscale,1424,warlock,demonology,24,15,9
Hyphonos,blackmoore,1422,warlock,demonology,30,15,15
Ruinovino,outland,1422,warlock,demonology,42,18,24
Джердхаус,fordragon,1419,warlock,demonology,30,15,15
Épidémie,outland,1419,warlock,demonology,47,18,29
Stormblast,azshara,1417,warlock,demonology,42,27,15
Carlss,sanguino,1416,warlock,demonology,24,15,9
Nattû,outland,1415,warlock,demonology,30,15,15
Lunden,drakthul,1414,warlock,demonology,46,22,24
Malganas,sylvanas,1414,warlock,demonology,95,42,53
Smallpee,kazzak,1413,warlock,demonology,36,17,19
Shalazar,dun-modr,1412,warlock,demonology,60,36,24
Героуд,howling-fjord,1407,warlock,demonology,30,15,15
Qullnius,kazzak,1402,warlock,demonology,42,24,18
Tudii,frostwolf,1401,warlock,demonology,54,32,22
Morgána,outland,1401,warlock,demonology,30,15,15
Søcraqt,blackrock,1399,warlock,demonology,31,15,16
Profylaxis,arathor,1396,warlock,demonology,46,23,23
Bonemetz,blackmoore,1393,warlock,demonology,30,16,14
Peremi,grim-batol,1388,warlock,demonology,30,15,15
Бельведерчи,blackscar,1388,warlock,demonology,132,65,67
Panic,stormrage,1384,warlock,demonology,132,69,63
Кайрана,blackscar,1376,warlock,demonology,36,20,16
Расмурът,soulflayer,1375,warlock,demonology,42,23,19
Nagash,zuljin,1370,warlock,demonology,23,16,7
Wítchær,blackhand,1370,warlock,demonology,48,28,20
Dedalus,zuluhed,1367,warlock,demonology,148,85,63
Wåfa,kazzak,1364,warlock,demonology,60,34,26
Sevastus,argent-dawn,1363,warlock,demonology,96,48,48
Гулдарий,howling-fjord,1362,warlock,demonology,219,112,107
Ädarä,cthun,1359,warlock,demonology,60,30,30
Ilarizium,ysondre,1359,warlock,demonology,83,41,42
Tsumde,dalaran,1358,warlock,demonology,60,27,33
Чингинсхан,howling-fjord,1357,warlock,demonology,35,25,10
Камнилока,booty-bay,1355,warlock,demonology,41,24,17
Mesîkatayut,outland,1351,warlock,demonology,75,43,32
Cahoa,archimonde,1349,warlock,demonology,24,15,9
Olsel,draenor,1349,warlock,demonology,36,16,20
Сладкийпир,soulflayer,1346,warlock,demonology,30,15,15
Scallington,shattered-hand,1344,warlock,demonology,24,14,10
Malkoran,sylvanas,1344,warlock,demonology,24,14,10
Афинц,deathguard,1343,warlock,demonology,24,14,10
Quadraxer,antonidas,1342,warlock,demonology,24,14,10
Lacape,dalaran,1340,warlock,demonology,28,15,13
Thorash,moonglade,1339,warlock,demonology,24,16,8
Gattlingan,eredar,1337,warlock,demonology,24,14,10
Evilbuba,burning-legion,1337,warlock,demonology,58,30,28
Nimh,azjolnerub,1336,warlock,demonology,63,33,30
Tomlingen,terenas,1335,warlock,demonology,48,25,23
Kosoki,burning-legion,1335,warlock,demonology,30,14,16
Darkdagor,blackrock,1334,warlock,demonology,24,14,10
Vanskor,argent-dawn,1331,warlock,demonology,100,42,58
Ппинг,soulflayer,1328,warlock,demonology,30,14,16
Letzman,ravencrest,1321,warlock,demonology,25,16,9
Kwanzaa,ravencrest,1319,warlock,demonology,24,14,10
Fujiitøra,ysondre,1319,warlock,demonology,61,34,27
Sineko,twisting-nether,1319,warlock,demonology,172,80,92
Gulldan,bloodfeather,1315,warlock,demonology,54,27,27
Дуклок,howling-fjord,1313,warlock,demonology,70,37,33
Forthewin,stormreaver,1313,warlock,demonology,30,15,15
Auxi,the-maelstrom,1310,warlock,demonology,87,48,39
Waltrude,conseil-des-ombres,1310,warlock,demonology,60,23,37
Dominvs,silvermoon,1306,warlock,demonology,162,80,82
Valadair,sanguino,1286,warlock,demonology,168,87,81
Cmzdalock,ravencrest,1279,warlock,demonology,36,23,13
Void,pozzo-delleternità,1273,warlock,demonology,52,24,28
Инсип,blackscar,1256,warlock,demonology,42,18,24
Eatherial,twilights-hammer,1255,warlock,demonology,30,18,12
Trellaras,bloodfeather,1249,warlock,demonology,29,14,15
Rikkért,draenor,1248,warlock,demonology,24,13,11
Smadrekas,ravencrest,1247,warlock,demonology,18,13,5
Déus,forscherliga,1245,warlock,demonology,155,70,85
Greeylock,blackhand,1243,warlock,demonology,24,13,11
Æyna,thrall,1242,warlock,demonology,24,13,11
Tarilinwelli,les-sentinelles,1242,warlock,demonology,24,13,11
Стокыч,soulflayer,1241,warlock,demonology,36,13,23
Icq,ravencrest,1240,warlock,demonology,27,14,13
Chedipes,stormscale,1240,warlock,demonology,33,14,19
Thralka,burning-legion,1237,warlock,demonology,24,13,11
Lokko,nemesis,1237,warlock,demonology,65,26,39
Áutísm,silvermoon,1235,warlock,demonology,18,13,5
Andid,frostwolf,1231,warlock,demonology,38,18,20
Sargaerot,draenor,1230,warlock,demonology,72,33,39
Truckpunch,defias-brotherhood,1228,warlock,demonology,42,18,24
Dernaxz,argent-dawn,1225,warlock,demonology,26,15,11
Honetia,ravencrest,1225,warlock,demonology,29,13,16
Mefistosx,draenor,1224,warlock,demonology,30,13,17
Армдэд,galakrond,1222,warlock,demonology,30,13,17
Bíü,tarren-mill,1219,warlock,demonology,30,13,17
Gnometefurax,hyjal,1218,warlock,demonology,30,14,16
Jag,neptulon,1214,warlock,demonology,32,19,13
Rüwel,mannoroth,1214,warlock,demonology,47,20,27
Tunrîda,illidan,1206,warlock,demonology,33,14,19
Netcownt,silvermoon,1199,warlock,demonology,31,15,16
Шимара,eversong,1198,warlock,demonology,21,14,7
Lugdan,blackmoore,1198,warlock,demonology,36,13,23
Kharless,kazzak,1197,warlock,demonology,32,15,17
Lifesteal,auchindoun,1196,warlock,demonology,42,18,24
Azraëlle,drekthar,1195,warlock,demonology,21,14,7
Vreyax,aegwynn,1195,warlock,demonology,29,13,16
Nekrosd,tarren-mill,1193,warlock,demonology,27,14,13
Силаскверна,deathguard,1185,warlock,demonology,30,14,16
Rngmåchinêx,ravencrest,1183,warlock,demonology,22,13,9
Vorgoth,argent-dawn,1179,warlock,demonology,28,13,15
Filø,dalaran,1173,warlock,demonology,47,14,33
Decayez,thrall,1168,warlock,demonology,19,13,6
Mundunugu,sanguino,1160,warlock,demonology,19,13,6
Jomitoisback,nemesis,1152,warlock,demonology,12,12,0
Lyndi,nerathor,1152,warlock,demonology,18,12,6
Syntax,blackmoore,1152,warlock,demonology,18,12,6
Ðåñtåy,ravencrest,1152,warlock,demonology,18,12,6
Gyzmo,outland,1152,warlock,demonology,24,12,12
Glooness,burning-legion,1152,warlock,demonology,24,12,12
Инфес,deathweaver,1151,warlock,demonology,18,12,6
Парачо,eversong,1151,warlock,demonology,24,12,12
Nargøf,outland,1151,warlock,demonology,24,12,12
Topmodelx,eredar,1150,warlock,demonology,18,12,6
Майдум,soulflayer,1150,warlock,demonology,18,12,6
Нистл,gordunni,1149,warlock,demonology,18,12,6
Desolador,tyrande,1148,warlock,demonology,30,12,18
Sizezero,tarren-mill,1147,warlock,demonology,18,12,6
Ashzu,quelthalas,1145,warlock,demonology,24,12,12
Penske,sanguino,1143,warlock,demonology,30,12,18
Brryant,colinas-pardas,1141,warlock,demonology,18,12,6
Szetbaszlock,ragnaros,1137,warlock,demonology,18,12,6
Rövsmärta,ragnaros,1135,warlock,demonology,21,13,8
Aldhelm,draenor,1130,warlock,demonology,28,13,15
Warlockyo,blackrock,1118,warlock,demonology,23,12,11
Erwynna,conseil-des-ombres,1118,warlock,demonology,30,12,18
Scarly,nordrassil,1103,warlock,demonology,41,21,20
Tripleshache,elune,1101,warlock,demonology,66,33,33
Cwyn,ravencrest,1088,warlock,demonology,30,13,17
Flocca,archimonde,1085,warlock,demonology,26,12,14
Evanore,burning-legion,1083,warlock,demonology,26,12,14
Sipsirica,ragnaros,1061,warlock,demonology,42,15,27
Bicuriousdad,tarren-mill,1056,warlock,demonology,12,11,1
Absurdity,twisting-nether,1056,warlock,demonology,16,12,4
Dotosgyörgy,ragnaros,1056,warlock,demonology,18,11,7
Bigbagelbob,archimonde,1056,warlock,demonology,18,11,7
Ahkan,argent-dawn,1056,warlock,demonology,18,11,7
Adellara,draenor,1056,warlock,demonology,18,11,7
ßualock,sylvanas,1056,warlock,demonology,18,11,7
Nazw,ravencrest,1056,warlock,demonology,24,11,13
Dirtytyrant,sanguino,1055,warlock,demonology,18,11,7
Tiendi,blackhand,1055,warlock,demonology,24,11,13
Lonelock,blackrock,1055,warlock,demonology,24,11,13
Tìdùs,nethersturm,1054,warlock,demonology,12,11,1
Idezis,ragnaros,1054,warlock,demonology,18,11,7
Froschhaxen,blackhand,1054,warlock,demonology,18,11,7
Dàrksoul,thrall,1054,warlock,demonology,18,11,7
Thorky,blackrock,1054,warlock,demonology,24,11,13
Katâra,tarren-mill,1054,warlock,demonology,24,11,13
Shînîgamî,draenor,1053,warlock,demonology,18,11,7
Agathaharkne,minahonda,1053,warlock,demonology,24,11,13
Fenrixlol,zuljin,1052,warlock,demonology,18,11,7
Törtidotcom,blackrock,1051,warlock,demonology,24,11,13
Емс,gordunni,1051,warlock,demonology,24,11,13
Remthorn,frostmane,1050,warlock,demonology,65,35,30
Zanzarismo,nemesis,1049,warlock,demonology,21,12,9
Ambralia,blackmoore,1048,warlock,demonology,24,12,12
Дулаан,blackscar,1042,warlock,demonology,18,11,7
Themengh,stormscale,1038,warlock,demonology,45,14,31
Sabiocalvo,dun-modr,1036,warlock,demonology,64,29,35
Imadovich,silvermoon,1029,warlock,demonology,41,20,21
Krushell,sanguino,1021,warlock,demonology,18,11,7
Shadowppl,outland,1021,warlock,demonology,26,12,14
Demonfaris,turalyon,1007,warlock,demonology,21,11,10
Dreamnyâsha,tarren-mill,1002,warlock,demonology,21,13,8
Discomugg,stormscale,991,warlock,demonology,17,11,6
Мембер,thermaplugg,990,warlock,demonology,26,11,15
Veganlifter,ravencrest,960,warlock,demonology,12,10,2
Syñdrome,ragnaros,960,warlock,demonology,12,10,2
Демоник,deathguard,960,warlock,demonology,18,10,8
Oggelock,tarren-mill,960,warlock,demonology,18,10,8
Sêrø,aegwynn,960,warlock,demonology,18,10,8
Jegfaller,wildhammer,960,warlock,demonology,24,10,14
Кьютсанни,howling-fjord,960,warlock,demonology,24,10,14
Velativ,silvermoon,959,warlock,demonology,12,10,2
Xartul,tarren-mill,959,warlock,demonology,12,10,2
Oozi,tarren-mill,959,warlock,demonology,12,10,2
Нэваблэйз,howling-fjord,959,warlock,demonology,18,10,8
Nainbusdemil,dalaran,959,warlock,demonology,18,10,8
Bigballerguy,sylvanas,959,warlock,demonology,18,10,8
Ipetsincl,kazzak,958,warlock,demonology,18,10,8
Astéfion,dalaran,958,warlock,demonology,18,10,8
Davyjonessx,twisting-nether,958,warlock,demonology,18,10,8
Pipoûc,archimonde,958,warlock,demonology,24,10,14
Güulran,les-clairvoyants,954,warlock,demonology,18,10,8
Degdeehei,draenor,953,warlock,demonology,12,10,2
Kalhija,medivh,953,warlock,demonology,18,10,8
Kawapow,azjolnerub,952,warlock,demonology,18,10,8
Ablas,bladefist,940,warlock,demonology,35,10,25
Thyron,gorgonnash,938,warlock,demonology,24,10,14
Fearmydear,alleria,926,warlock,demonology,17,10,7
Agonyzed,argent-dawn,923,warlock,demonology,16,11,5
Migyardondup,exodar,916,warlock,demonology,75,41,34
Ixal,hyjal,914,warlock,demonology,36,17,19
Zaross,khaz-modan,910,warlock,demonology,26,13,13
Acuacx,drakthul,909,warlock,demonology,17,10,7
Djadizpunish,stormscale,894,warlock,demonology,15,11,4
Snoggä,antonidas,885,warlock,demonology,36,17,19
Öbsury,hyjal,864,warlock,demonology,12,9,3
Yazurí,ravencrest,864,warlock,demonology,12,9,3
Stafar,outland,864,warlock,demonology,12,9,3
Ooroothothz,frostwolf,864,warlock,demonology,12,9,3
Aladèèn,tarren-mill,864,warlock,demonology,12,9,3
Простохаос,howling-fjord,864,warlock,demonology,12,9,3
Dogdrakex,tarren-mill,864,warlock,demonology,12,9,3
Dadylock,silvermoon,864,warlock,demonology,12,9,3
Youseenbølt,veklor,864,warlock,demonology,12,9,3
Demosteaks,thrall,864,warlock,demonology,12,9,3
Boomlok,tarren-mill,864,warlock,demonology,18,9,9
Nekrofille,outland,864,warlock,demonology,18,9,9
Nunhesh,defias-brotherhood,864,warlock,demonology,18,9,9
Rikmeyzter,burning-blade,864,warlock,demonology,18,9,9
Darksoll,hyjal,864,warlock,demonology,24,9,15
Nastýføxÿ,ysondre,863,warlock,demonology,12,9,3
Zèlêph,archimonde,863,warlock,demonology,12,9,3
Kritrouilles,sargeras,863,warlock,demonology,18,9,9
Cardinall,drakthul,863,warlock,demonology,18,9,9
Nosoulnoprob,sylvanas,863,warlock,demonology,24,9,15
Édøras,archimonde,863,warlock,demonology,24,9,15
Nomakqlock,dun-modr,862,warlock,demonology,15,10,5
Mmorgana,sanguino,862,warlock,demonology,24,9,15
Xoky,argent-dawn,861,warlock,demonology,18,9,9
Allotropìa,ravencrest,861,warlock,demonology,24,9,15
Kazzulina,ravenholdt,861,warlock,demonology,24,9,15
Haitech,dalaran,858,warlock,demonology,12,9,3
Nikhusadark,draenor,856,warlock,demonology,19,9,10
Диффиндо,galakrond,854,warlock,demonology,12,9,3
Screamo,sylvanas,844,warlock,demonology,18,9,9
Аттропа,gordunni,840,warlock,demonology,30,15,15
Jendzababa,burning-legion,827,warlock,demonology,17,9,8
Дакиса,gordunni,815,warlock,demonology,17,9,8
Гупперлок,howling-fjord,810,warlock,demonology,27,12,15
Бирел,soulflayer,799,warlock,demonology,16,9,7
Fuark,teldrassil,798,warlock,demonology,11,9,2
Простоседой,gordunni,798,warlock,demonology,23,9,14
Йотунхейм,ashenvale,792,warlock,demonology,20,9,11
Devildodo,elune,768,warlock,demonology,12,8,4
Hannen,blackrock,768,warlock,demonology,12,8,4
Xjms,darksorrow,768,warlock,demonology,12,8,4
Аскамардва,gordunni,768,warlock,demonology,12,8,4
Azaêl,azshara,768,warlock,demonology,12,8,4
Cappaoow,ravencrest,768,warlock,demonology,12,8,4
Котрх,gordunni,768,warlock,demonology,12,8,4
Lywov,stormscale,768,warlock,demonology,12,8,4
Hyöká,kazzak,768,warlock,demonology,12,8,4
Killning,medivh,768,warlock,demonology,12,8,4
Hyòkà,kazzak,768,warlock,demonology,12,8,4
Rozn,ravencrest,768,warlock,demonology,12,8,4
Boltimoore,magtheridon,768,warlock,demonology,12,8,4
Gilfhaunter,malganis,768,warlock,demonology,12,8,4
Staenkymayne,blackhand,768,warlock,demonology,12,8,4
Døtzz,blackmoore,768,warlock,demonology,12,8,4
Maevoni,blackmoore,768,warlock,demonology,12,8,4
Idkdot,ravencrest,768,warlock,demonology,18,8,10
Koldarr,blackmoore,768,warlock,demonology,18,8,10
Ívânguldán,twisting-nether,768,warlock,demonology,18,8,10
Biest,drakthul,768,warlock,demonology,18,8,10
Jarodshadow,stormscale,768,warlock,demonology,18,8,10
Djezzick,stormscale,768,warlock,demonology,18,8,10
Noytan,nemesis,768,warlock,demonology,18,8,10
Dryaxc,frostwolf,768,warlock,demonology,18,8,10
Narsok,blackrock,768,warlock,demonology,18,8,10
Øupas,ysondre,768,warlock,demonology,18,8,10
Sovrìn,blackrock,767,warlock,demonology,12,8,4
Ðelðish,draenor,767,warlock,demonology,12,8,4
Eizon,tarren-mill,767,warlock,demonology,12,8,4
Tojezlo,drakthul,767,warlock,demonology,12,8,4
Евнухоидизм,gordunni,767,warlock,demonology,14,8,6
Alotadot,ravencrest,767,warlock,demonology,18,8,10
Chimera,mugthol,767,warlock,demonology,18,8,10
Xanatar,blackhand,767,warlock,demonology,24,8,16
Otemlock,sanguino,766,warlock,demonology,12,8,4
Lethellin,antonidas,766,warlock,demonology,12,8,4
Guccie,ravencrest,766,warlock,demonology,17,10,7
Zeddy,draenor,766,warlock,demonology,18,8,10
Britneyféars,emeriss,766,warlock,demonology,18,8,10
Merzavka,kazzak,765,warlock,demonology,12,8,4
Njutbar,ragnaros,765,warlock,demonology,18,8,10
Bachmut,ravencrest,765,warlock,demonology,18,8,10
Gúldn,outland,763,warlock,demonology,30,8,22
Ясяшотлав,soulflayer,761,warlock,demonology,22,11,11
Wanderingowl,blackmoore,760,warlock,demonology,12,8,4
Lokisi,die-aldor,752,warlock,demonology,24,8,16
Nedivh,stormscale,751,warlock,demonology,23,8,15
Dotwhat,ravencrest,719,warlock,demonology,17,8,9
Ромаколдун,howling-fjord,704,warlock,demonology,16,8,8
Lifetap,tarren-mill,703,warlock,demonology,14,8,6
Ponçeur,ysondre,687,warlock,demonology,19,9,10
Papilena,turalyon,687,warlock,demonology,19,8,11
Eviloverlord,silvermoon,672,warlock,demonology,12,7,5
Thereya,dun-morogh,672,warlock,demonology,12,7,5
Kosfáce,tarren-mill,672,warlock,demonology,12,7,5
Immolleria,frostmane,672,warlock,demonology,12,7,5
Flamidien,archimonde,672,warlock,demonology,12,7,5
Plâytïmè,stormscale,672,warlock,demonology,12,7,5
Кале,goldrinn,672,warlock,demonology,12,7,5
Styxwl,blackhand,672,warlock,demonology,12,7,5
Spongebobx,kazzak,672,warlock,demonology,12,7,5
Ruhuen,stormscale,672,warlock,demonology,12,7,5
Ballerlock,ravencrest,672,warlock,demonology,12,7,5
Fearfearfear,archimonde,672,warlock,demonology,12,7,5
Circe,draenor,672,warlock,demonology,12,7,5
Likilaka,draenor,672,warlock,demonology,12,7,5
Dzodeep,kazzak,672,warlock,demonology,12,7,5
Blekspel,outland,672,warlock,demonology,12,7,5
Framelock,draenor,672,warlock,demonology,12,7,5
Hannens,blackrock,672,warlock,demonology,12,7,5
Mythoman,ravencrest,672,warlock,demonology,12,7,5
Slurvefar,kazzak,672,warlock,demonology,12,7,5
Kerídiin,twisting-nether,672,warlock,demonology,12,7,5
Marador,drakthul,672,warlock,demonology,12,7,5
Zagreos,tarren-mill,672,warlock,demonology,12,7,5
Wiitchdoktor,twisting-nether,672,warlock,demonology,12,7,5
Dwoorf,ravencrest,672,warlock,demonology,12,7,5
Guldchan,drakthul,672,warlock,demonology,12,7,5
Khaleth,dun-modr,672,warlock,demonology,12,7,5
Líí,burning-blade,672,warlock,demonology,12,7,5
Cringetamer,silvermoon,672,warlock,demonology,18,7,11
Fearu,kazzak,672,warlock,demonology,18,7,11
Shortyi,thrall,672,warlock,demonology,18,7,11
Xfz,stormscale,672,warlock,demonology,18,7,11
Baldazar,dun-modr,672,warlock,demonology,18,7,11
Klaab,hyjal,672,warlock,demonology,18,7,11
Сч,ashenvale,671,warlock,demonology,12,7,5
Dedobozhe,ravencrest,671,warlock,demonology,12,7,5
Адилея,howling-fjord,671,warlock,demonology,12,7,5
Pestilus,thrall,671,warlock,demonology,18,7,11
Indifférence,archimonde,671,warlock,demonology,18,7,11
Bewbys,draenor,671,warlock,demonology,24,7,17
Баммес,galakrond,671,warlock,demonology,24,7,17
Williamford,dun-modr,669,warlock,demonology,18,7,11
Darlanis,draenor,668,warlock,demonology,12,7,5
Farasuflet,burning-steppes,658,warlock,demonology,12,7,5
Raez,burning-blade,654,warlock,demonology,23,7,16
Ryks,terrordar,624,warlock,demonology,15,7,8
Kavalierr,stormscale,624,warlock,demonology,21,8,13
Kïng,elune,622,warlock,demonology,15,8,7
Warlockxx,ravencrest,607,warlock,demonology,11,7,4
Sethtarr,draenor,607,warlock,demonology,14,7,7
Solidwarlock,archimonde,576,warlock,demonology,6,6,0
Onewarlock,kazzak,576,warlock,demonology,6,6,0
Labreego,aggra-português,576,warlock,demonology,6,6,0
Boldielocks,tarren-mill,576,warlock,demonology,6,6,0
Тапкидеда,gordunni,576,warlock,demonology,6,6,0
Beebs,aegwynn,576,warlock,demonology,6,6,0
Werzel,frostmane,576,warlock,demonology,6,6,0
Kasztyk,grim-batol,576,warlock,demonology,12,6,6
Darcol,archimonde,576,warlock,demonology,12,6,6
Тевон,gordunni,576,warlock,demonology,12,6,6
Deflagrate,kazzak,576,warlock,demonology,12,6,6
Malathrom,garona,576,warlock,demonology,12,6,6
Wacamolymojo,tarren-mill,576,warlock,demonology,12,6,6
Rivmuu,argent-dawn,576,warlock,demonology,12,6,6
Mombo,the-maelstrom,576,warlock,demonology,12,6,6
Gruldran,khaz-modan,576,warlock,demonology,12,6,6
Líely,ravencrest,576,warlock,demonology,12,6,6
Ilovebronko,blackrock,576,warlock,demonology,12,6,6
Ðêmøñîc,ravencrest,576,warlock,demonology,12,6,6
Cresen,tarren-mill,576,warlock,demonology,12,6,6
Hyóká,kazzak,576,warlock,demonology,12,6,6
Zerx,malganis,576,warlock,demonology,12,6,6
Teflondione,stormreaver,576,warlock,demonology,12,6,6
Dracsu,dun-modr,576,warlock,demonology,12,6,6
Lifedriller,drakthul,576,warlock,demonology,12,6,6
Øbéydêmøn,silvermoon,576,warlock,demonology,12,6,6
Rîas,hyjal,576,warlock,demonology,12,6,6
Lamboo,tarren-mill,576,warlock,demonology,12,6,6
Vîmø,antonidas,576,warlock,demonology,12,6,6
Devour,magtheridon,576,warlock,demonology,12,6,6
Nephystø,archimonde,576,warlock,demonology,12,6,6
Lacus,voljin,576,warlock,demonology,18,6,12
Morwëk,ysondre,576,warlock,demonology,18,6,12
Yeatso,blackmoore,576,warlock,demonology,18,6,12
Oldasianman,blackrock,576,warlock,demonology,18,6,12
Фэлдред,soulflayer,576,warlock,demonology,18,6,12
Haillun,twisting-nether,576,warlock,demonology,18,6,12
Deadleth,blackrock,575,warlock,demonology,10,7,3
Сквордин,gordunni,575,warlock,demonology,12,6,6
Kropi,blackhand,575,warlock,demonology,12,6,6
Факлок,gordunni,575,warlock,demonology,12,6,6
Heximexi,malganis,575,warlock,demonology,18,6,12
Xerxia,blackrock,575,warlock,demonology,18,6,12
Ахпорбес,gordunni,574,warlock,demonology,10,7,3
Ragedrop,malygos,574,warlock,demonology,12,6,6
Methmuncher,twisting-nether,574,warlock,demonology,24,6,18
Petrosk,sanguino,569,warlock,demonology,12,6,6
Absurdd,turalyon,568,warlock,demonology,14,9,5
Кхадгард,howling-fjord,544,warlock,demonology,16,6,10
Sourpatchkid,the-maelstrom,543,warlock,demonology,11,6,5
Gutras,ragnaros,527,warlock,demonology,11,6,5
Tvmpzwl,ravencrest,527,warlock,demonology,17,6,11
Shazem,tarren-mill,522,warlock,demonology,12,7,5
Mércé,stormscale,480,warlock,demonology,6,5,1
Racursed,outland,480,warlock,demonology,6,5,1
Joinx,tarren-mill,480,warlock,demonology,6,5,1
Олимта,blackscar,480,warlock,demonology,6,5,1
Felgødx,nemesis,480,warlock,demonology,6,5,1
Уанбаттон,gordunni,480,warlock,demonology,6,5,1
Jinxme,tarren-mill,480,warlock,demonology,6,5,1
Гнильсен,borean-tundra,480,warlock,demonology,6,5,1
Saganelle,hyjal,480,warlock,demonology,6,5,1
Miauwu,stormscale,480,warlock,demonology,6,5,1
Vitalyk,sanguino,480,warlock,demonology,6,5,1
Boomloc,tarren-mill,480,warlock,demonology,6,5,1
Evalin,aggra-português,480,warlock,demonology,6,5,1
Köftemec,blackrock,480,warlock,demonology,6,5,1
Hiloqtlock,blackmoore,480,warlock,demonology,6,5,1
Bibilockbert,aegwynn,480,warlock,demonology,6,5,1
Cazul,archimonde,480,warlock,demonology,6,5,1
Chromex,dentarg,480,warlock,demonology,6,5,1
Mudwalkin,ravencrest,480,warlock,demonology,6,5,1
Xarica,garona,480,warlock,demonology,6,5,1
Voídzero,hyjal,480,warlock,demonology,6,5,1
Deadmanwlkin,aggra-português,480,warlock,demonology,6,5,1
Baloc,kirin-tor,480,warlock,demonology,6,5,1
Фирвебало,soulflayer,480,warlock,demonology,6,5,1
Swagzz,silvermoon,480,warlock,demonology,6,5,1
Лираума,howling-fjord,480,warlock,demonology,9,6,3
Durátor,ravencrest,480,warlock,demonology,12,5,7
Tepelkwastje,twisting-nether,480,warlock,demonology,12,5,7
Morshax,ysondre,480,warlock,demonology,12,5,7
Landii,ragnaros,480,warlock,demonology,12,5,7
Agaton,twisting-nether,480,warlock,demonology,12,5,7
Nastychâtøn,ysondre,480,warlock,demonology,12,5,7
Векстах,gordunni,480,warlock,demonology,12,5,7
Zoodaddy,grim-batol,480,warlock,demonology,12,5,7
Destroc,blackrock,480,warlock,demonology,12,5,7
Msßeckinsale,tarren-mill,480,warlock,demonology,12,5,7
Anturia,garona,480,warlock,demonology,12,5,7
Purepkbob,quelthalas,480,warlock,demonology,12,5,7
Mty,bronze-dragonflight,480,warlock,demonology,12,5,7
Hogheru,kazzak,480,warlock,demonology,12,5,7
Gulderrf,kirin-tor,480,warlock,demonology,12,5,7
Khâmélÿa,culte-de-la-rive-noire,480,warlock,demonology,12,5,7
Irnx,tarren-mill,480,warlock,demonology,12,5,7
Moslock,kazzak,480,warlock,demonology,12,5,7
Nécromancér,doomhammer,480,warlock,demonology,12,5,7
Rushkush,ravencrest,480,warlock,demonology,13,5,8
Vanmorgoth,nazjatar,480,warlock,demonology,18,5,13
Zartax,kazzak,480,warlock,demonology,18,5,13
Déemón,draenor,480,warlock,demonology,18,5,13
Brodoh,dun-modr,480,warlock,demonology,18,5,13
Acererak,thunderhorn,480,warlock,demonology,18,5,13
Ascètic,kazzak,480,warlock,demonology,18,5,13
Délidumrul,stormscale,480,warlock,demonology,18,5,13
Ezekîél,blackhand,479,warlock,demonology,6,5,1
Limfus,terokkar,479,warlock,demonology,6,5,1
Aluy,blackmoore,479,warlock,demonology,12,5,7
Gunca,sylvanas,479,warlock,demonology,12,5,7
Lewd,dragonblight,479,warlock,demonology,12,5,7
Oblutak,draenor,479,warlock,demonology,12,5,7
Cròwly,area-52,416,warlock,demonology,10,5,5
Broxsz,blackrock,415,warlock,demonology,8,5,3
Zàkx,silvermoon,384,warlock,demonology,6,4,2
Gigoberto,kazzak,384,warlock,demonology,6,4,2
Dèsaad,stormscale,384,warlock,demonology,6,4,2
Cosec,silvermoon,384,warlock,demonology,6,4,2
Cleyandra,arathor,384,warlock,demonology,6,4,2
Fredé,kazzak,384,warlock,demonology,6,4,2
Незерлок,soulflayer,384,warlock,demonology,6,4,2
Felhaen,silvermoon,384,warlock,demonology,6,4,2
Náwwk,blackmoore,384,warlock,demonology,6,4,2
Llilithh,draenor,384,warlock,demonology,6,4,2
Колмидедди,gordunni,384,warlock,demonology,6,4,2
Imissbolt,outland,384,warlock,demonology,6,4,2
Bankstair,stormscale,384,warlock,demonology,6,4,2
Likeqtz,thrall,384,warlock,demonology,6,4,2
Kikeriki,blackhand,384,warlock,demonology,6,4,2
Slerpmami,ragnaros,384,warlock,demonology,6,4,2
Flxzshort,kazzak,384,warlock,demonology,6,4,2
Lémonz,stormscale,384,warlock,demonology,6,4,2
Maleficious,silvermoon,384,warlock,demonology,6,4,2
Ôlo,rajaxx,384,warlock,demonology,6,4,2
Exitlock,thrall,384,warlock,demonology,6,4,2
Mayden,uldum,384,warlock,demonology,6,4,2
Gödisdëäd,sanguino,384,warlock,demonology,6,4,2
Mindzsonghó,ragnaros,384,warlock,demonology,6,4,2
Vornex,sporeggar,384,warlock,demonology,6,4,2
Absoul,defias-brotherhood,384,warlock,demonology,6,4,2
Tropìcal,grim-batol,384,warlock,demonology,6,4,2
Bitshlog,draenor,384,warlock,demonology,6,4,2
Xuloth,ravencrest,384,warlock,demonology,6,4,2
Gryme,dalaran,384,warlock,demonology,6,4,2
Zakuri,blackmoore,384,warlock,demonology,6,4,2
Sep,aegwynn,384,warlock,demonology,6,4,2
Itrix,aegwynn,384,warlock,demonology,6,4,2
Lockmybllz,baelgun,384,warlock,demonology,6,4,2
Bluenote,colinas-pardas,384,warlock,demonology,6,4,2
Cardyw,ravencrest,384,warlock,demonology,6,4,2
Nekhar,twisting-nether,384,warlock,demonology,6,4,2
Keibo,drakthul,384,warlock,demonology,6,4,2
Freyzul,twisting-nether,384,warlock,demonology,6,4,2
Ahollic,antonidas,384,warlock,demonology,6,4,2
Aniq,eredar,384,warlock,demonology,6,4,2
Roglash,eredar,384,warlock,demonology,6,4,2
Куськысь,gordunni,384,warlock,demonology,9,5,4
Muninnus,archimonde,384,warlock,demonology,15,5,10
Focalorx,tarren-mill,384,warlock,demonology,12,4,8
Vextos,draenor,384,warlock,demonology,12,4,8
Xvron,tarren-mill,384,warlock,demonology,12,4,8
Tolgaa,draenor,384,warlock,demonology,12,4,8
Graveshaker,quelthalas,384,warlock,demonology,12,4,8
Tuz,blackrock,384,warlock,demonology,12,4,8
Lagyna,wildhammer,384,warlock,demonology,12,4,8
Hsp,dun-modr,384,warlock,demonology,12,4,8
Babayagâ,sanguino,384,warlock,demonology,12,4,8
Heexmex,blackmoore,384,warlock,demonology,12,4,8
Nulo,aggra-português,384,warlock,demonology,12,4,8
Prestoc,wrathbringer,384,warlock,demonology,12,4,8
Kfo,ragnaros,384,warlock,demonology,12,4,8
Alucena,silvermoon,384,warlock,demonology,18,4,14
Millhaus,gorgonnash,384,warlock,demonology,18,4,14
Denzeal,argent-dawn,384,warlock,demonology,24,4,20
Myxâ,tarren-mill,383,warlock,demonology,6,4,2
Кингпинг,soulflayer,367,warlock,demonology,11,4,7
Monroé,hellfire,367,warlock,demonology,11,4,7
Nili,dethecus,351,warlock,demonology,11,4,7
Hadrianor,sanguino,336,warlock,demonology,9,4,5
Amrafel,draenor,335,warlock,demonology,15,5,10
Floriae,silvermoon,329,warlock,demonology,13,5,8
Ghachi,draenor,319,warlock,demonology,5,4,1
Shadaw,kilrogg,319,warlock,demonology,5,4,1
Sleethy,destromath,288,warlock,demonology,6,3,3
Сантизи,gordunni,288,warlock,demonology,6,3,3
Yerslock,twisting-nether,288,warlock,demonology,6,3,3
Bionic,eredar,288,warlock,demonology,6,3,3
Wendetta,stormreaver,288,warlock,demonology,6,3,3
Legiozock,draenor,288,warlock,demonology,6,3,3
Рашчер,gordunni,288,warlock,demonology,6,3,3
Дядяджонн,gordunni,288,warlock,demonology,6,3,3
Cthxil,frostwolf,288,warlock,demonology,6,3,3
Theronas,tarren-mill,288,warlock,demonology,6,3,3
Pidka,drakthul,288,warlock,demonology,6,3,3
Журанайсбой,blackscar,288,warlock,demonology,6,3,3
Osyx,ravencrest,288,warlock,demonology,6,3,3
Nineinchlock,silvermoon,288,warlock,demonology,6,3,3
Buserella,eredar,288,warlock,demonology,6,3,3
Yoplen,drakthul,288,warlock,demonology,6,3,3
Askanios,twisting-nether,288,warlock,demonology,6,3,3
Xiraq,nathrezim,288,warlock,demonology,6,3,3
Xenq,ravencrest,288,warlock,demonology,6,3,3
Локистраик,borean-tundra,288,warlock,demonology,6,3,3
Sofias,tarren-mill,288,warlock,demonology,6,3,3
Дотботх,howling-fjord,288,warlock,demonology,6,3,3
Plague,twisting-nether,288,warlock,demonology,6,3,3
Afflimoomoo,tarren-mill,288,warlock,demonology,6,3,3
Sidragasoss,drakthul,288,warlock,demonology,6,3,3
Ronniee,moonglade,288,warlock,demonology,6,3,3
Lebaa,burning-steppes,288,warlock,demonology,6,3,3
Akumako,stormscale,288,warlock,demonology,6,3,3
Elmîr,blackmoore,288,warlock,demonology,6,3,3
Ezy,auchindoun,288,warlock,demonology,6,3,3
Zeromaker,kazzak,288,warlock,demonology,6,3,3
Slytofhandio,silvermoon,288,warlock,demonology,6,3,3
Ilililii,ravencrest,288,warlock,demonology,6,3,3
Väladar,sanguino,288,warlock,demonology,6,3,3
Alcringe,kazzak,288,warlock,demonology,6,3,3
Cptdotalot,tarren-mill,288,warlock,demonology,6,3,3
Drogoon,blackmoore,288,warlock,demonology,6,3,3
Áiram,the-maelstrom,288,warlock,demonology,6,3,3
Myliege,kilrogg,288,warlock,demonology,6,3,3
Hasselbalch,azshara,288,warlock,demonology,6,3,3
Plocke,aegwynn,288,warlock,demonology,6,3,3
Hotdogvendor,kazzak,288,warlock,demonology,6,3,3
Комочеро,soulflayer,288,warlock,demonology,6,3,3
Darkpush,outland,288,warlock,demonology,6,3,3
Drarken,sylvanas,288,warlock,demonology,6,3,3
Dispelpls,dun-morogh,288,warlock,demonology,6,3,3
Zloezlo,ravencrest,288,warlock,demonology,6,3,3
Mattihoh,rexxar,288,warlock,demonology,6,3,3
Tathyanna,archimonde,288,warlock,demonology,6,3,3
Moelock,frostmane,288,warlock,demonology,6,3,3
Karädoc,chogall,288,warlock,demonology,6,3,3
Zìì,silvermoon,288,warlock,demonology,6,3,3
Cainn,kilrogg,288,warlock,demonology,6,3,3
Waîdo,blackhand,288,warlock,demonology,6,3,3
Shjzzkl,blackmoore,288,warlock,demonology,6,3,3
Лысыйлокоть,soulflayer,288,warlock,demonology,6,3,3
Wombsa,blackmoore,288,warlock,demonology,6,3,3
Mingingclass,stormscale,288,warlock,demonology,6,3,3
Suucc,draenor,288,warlock,demonology,6,3,3
Infernion,stormscale,288,warlock,demonology,6,3,3
Silås,hyjal,288,warlock,demonology,6,3,3
Matheus,zenedar,288,warlock,demonology,6,3,3
Drainurlife,zenedar,288,warlock,demonology,6,3,3
Nürgle,stormscale,288,warlock,demonology,6,3,3
Gyroib,stormscale,288,warlock,demonology,6,3,3
Xalé,blackrock,288,warlock,demonology,6,3,3
Noobgg,kazzak,288,warlock,demonology,6,3,3
Antuan,sanguino,288,warlock,demonology,6,3,3
Opiumers,kazzak,288,warlock,demonology,6,3,3
Evalya,archimonde,288,warlock,demonology,6,3,3
Vladov,ravencrest,288,warlock,demonology,6,3,3
Evilonion,outland,288,warlock,demonology,6,3,3
Ноанс,howling-fjord,288,warlock,demonology,6,3,3
Nerdbane,blackrock,288,warlock,demonology,6,3,3
Гвадривер,howling-fjord,288,warlock,demonology,6,3,3
Bono,frostwhisper,288,warlock,demonology,6,3,3
Sánas,blackhand,288,warlock,demonology,6,3,3
Talindra,stormscale,288,warlock,demonology,6,3,3
Horststenzl,blackrock,288,warlock,demonology,6,3,3
Эссминет,soulflayer,288,warlock,demonology,12,3,9
Laveau,outland,288,warlock,demonology,12,3,9
Jkz,blackrock,288,warlock,demonology,12,3,9
Ftpete,argent-dawn,288,warlock,demonology,12,3,9
Cassen,outland,288,warlock,demonology,12,3,9
Surgelock,draenor,288,warlock,demonology,12,3,9
Ohnoitsnepss,chamber-of-aspects,288,warlock,demonology,12,3,9
Kamí,sanguino,288,warlock,demonology,12,3,9
Ønyzukral,hyjal,288,warlock,demonology,12,3,9
Ïvar,ysondre,288,warlock,demonology,12,3,9
Dardec,hyjal,288,warlock,demonology,12,3,9
Chaosbolts,balnazzar,288,warlock,demonology,12,3,9
Ydidntuwait,ragnaros,288,warlock,demonology,18,3,15
Hartee,argent-dawn,288,warlock,demonology,18,3,15
Lìlitu,malfurion,287,warlock,demonology,6,3,3
Dust,argent-dawn,287,warlock,demonology,12,3,9
Hasla,stormreaver,256,warlock,demonology,10,3,7
Calypso,korgall,239,warlock,demonology,5,3,2
Ánderx,dun-modr,239,warlock,demonology,5,3,2
Hokoreuw,echsenkessel,234,warlock,demonology,9,4,5
Watii,stormscale,234,warlock,demonology,10,4,6
Никошо,gordunni,223,warlock,demonology,8,3,5
Streganni,nemesis,192,warlock,demonology,4,3,1
Fatkkroth,ravencrest,192,warlock,demonology,6,2,4
Zyréx,eredar,192,warlock,demonology,6,2,4
Retrosatanas,archimonde,192,warlock,demonology,6,2,4
Azurma,tarren-mill,192,warlock,demonology,6,2,4
Vitrolizz,twilights-hammer,192,warlock,demonology,6,2,4
Händerå,ragnaros,192,warlock,demonology,6,2,4
Morgainé,arygos,192,warlock,demonology,6,2,4
Branduir,ragnaros,192,warlock,demonology,6,2,4
Fortheend,twisting-nether,192,warlock,demonology,6,2,4
Baradür,sanguino,192,warlock,demonology,6,2,4
Fearlessgødx,ravencrest,192,warlock,demonology,6,2,4
Sneptics,draenor,192,warlock,demonology,6,2,4
Yôi,nemesis,192,warlock,demonology,6,2,4
Bowti,ravencrest,192,warlock,demonology,6,2,4
Hodille,argent-dawn,192,warlock,demonology,6,2,4
Telyfol,ragnaros,192,warlock,demonology,6,2,4
Хэлласс,blackscar,192,warlock,demonology,6,2,4
Kaobolt,archimonde,192,warlock,demonology,6,2,4
Democraft,the-maelstrom,192,warlock,demonology,6,2,4
Surfingbirdz,ragnaros,192,warlock,demonology,6,2,4
Médeâ,ravencrest,192,warlock,demonology,6,2,4
Анрали,deathguard,192,warlock,demonology,6,2,4
Incesticide,ragnaros,192,warlock,demonology,6,2,4
Slowfatlock,ravencrest,192,warlock,demonology,6,2,4
Salvatoríy,outland,192,warlock,demonology,6,2,4
Ukjjkhj,frostmane,192,warlock,demonology,6,2,4
Darkdax,dethecus,192,warlock,demonology,6,2,4
Tàkaz,drekthar,192,warlock,demonology,6,2,4
Nastychãtøn,ysondre,192,warlock,demonology,6,2,4
Andrealphus,outland,192,warlock,demonology,6,2,4
Prestige,nemesis,192,warlock,demonology,6,2,4
Iblis,grim-batol,192,warlock,demonology,6,2,4
Ribbed,frostmane,192,warlock,demonology,6,2,4
Cräwley,ragnaros,192,warlock,demonology,6,2,4
Gammalgubbe,stormscale,192,warlock,demonology,6,2,4
Кощун,goldrinn,192,warlock,demonology,6,2,4
Nerfwarriors,stormscale,192,warlock,demonology,6,2,4
Minidiction,ravencrest,192,warlock,demonology,6,2,4
Kumamoto,tarren-mill,192,warlock,demonology,6,2,4
Ekispekis,tarren-mill,192,warlock,demonology,6,2,4
Fløkee,blackmoore,192,warlock,demonology,6,2,4
Dotcha,ravencrest,192,warlock,demonology,6,2,4
Artys,tarren-mill,192,warlock,demonology,6,2,4
Бешентумай,goldrinn,192,warlock,demonology,6,2,4
Liwerno,dunemaul,192,warlock,demonology,6,2,4
Luckylocked,kazzak,192,warlock,demonology,6,2,4
Вериберри,gordunni,192,warlock,demonology,6,2,4
Nècrøphila,kazzak,192,warlock,demonology,6,2,4
Àbraxàs,nemesis,192,warlock,demonology,6,2,4
Amerihell,pozzo-delleternità,192,warlock,demonology,6,2,4
Seldonn,pozzo-delleternità,192,warlock,demonology,6,2,4
Lokelicious,ragnaros,192,warlock,demonology,6,2,4
Jiy,senjin,192,warlock,demonology,6,2,4
Pablø,silvermoon,192,warlock,demonology,6,2,4
Bu,zirkel-des-cenarius,192,warlock,demonology,6,2,4
Belzedan,blackrock,192,warlock,demonology,6,2,4
Oldasiangirl,blackrock,192,warlock,demonology,6,2,4
Flatwolenzy,blackrock,192,warlock,demonology,6,2,4
Epoku,stormscale,192,warlock,demonology,6,2,4
Azgaroth,kazzak,192,warlock,demonology,6,2,4
Neijihbolt,blackrock,192,warlock,demonology,6,2,4
Drith,blades-edge,192,warlock,demonology,6,2,4
Omegachad,draenor,192,warlock,demonology,6,2,4
Gtxtreme,kazzak,192,warlock,demonology,6,2,4
Isanê,blackrock,192,warlock,demonology,6,2,4
Cali,ahnqiraj,192,warlock,demonology,6,2,4
Stromzii,silvermoon,192,warlock,demonology,6,2,4
Скверногрик,fordragon,192,warlock,demonology,6,2,4
Chram,uldum,192,warlock,demonology,7,2,5
Манапчик,soulflayer,192,warlock,demonology,12,2,10
Henriett,ravencrest,192,warlock,demonology,12,2,10
Saruna,azshara,192,warlock,demonology,12,2,10
Etherbit,burning-legion,192,warlock,demonology,12,2,10
Déadwish,ravencrest,192,warlock,demonology,12,2,10
Arciam,kazzak,192,warlock,demonology,12,2,10
Rayanna,twisting-nether,192,warlock,demonology,18,2,16
Letzterlude,thrall,159,warlock,demonology,5,2,3
Myskul,burning-legion,138,warlock,demonology,10,4,6
Omaleinfluch,antonidas,138,warlock,demonology,9,3,6
Commas,outland,128,warlock,demonology,4,2,2
Happycadaver,blackrock,96,warlock,demonology,3,2,1
Myristica,die-todeskrallen,96,warlock,demonology,3,2,1
Utuklululu,archimonde,96,warlock,demonology,6,1,5
Melfos,blackmoore,96,warlock,demonology,6,1,5
Bolt,stormscale,96,warlock,demonology,6,1,5
Аффликатор,soulflayer,96,warlock,demonology,6,1,5
Militianu,sylvanas,96,warlock,demonology,6,1,5
Emethia,darksorrow,96,warlock,demonology,6,1,5
Catherine,garrosh,96,warlock,demonology,6,1,5
Marann,dun-morogh,96,warlock,demonology,6,1,5
Diseased,darksorrow,96,warlock,demonology,6,1,5
Messire,ragnaros,96,warlock,demonology,6,1,5
Krútéús,perenolde,96,warlock,demonology,6,1,5
Elyraah,hyjal,96,warlock,demonology,6,1,5
Nethros,ragnaros,96,warlock,demonology,6,1,5
Lovromalt,kazzak,96,warlock,demonology,6,1,5
Ðßøhßäøùí,blackmoore,96,warlock,demonology,6,1,5
Yourdeaath,ravencrest,96,warlock,demonology,6,1,5
Ароматныйх,howling-fjord,96,warlock,demonology,6,1,5
Tid,burning-legion,96,warlock,demonology,6,1,5
Darkbazul,burning-legion,96,warlock,demonology,6,1,5
Маверрикк,gordunni,96,warlock,demonology,6,1,5
Бестий,fordragon,96,warlock,demonology,6,1,5
Jawoxoxo,rexxar,96,warlock,demonology,6,1,5
Necroless,shadowsong,96,warlock,demonology,6,1,5
Chuntlock,shadowsong,96,warlock,demonology,6,1,5
Árkan,thrall,96,warlock,demonology,6,1,5
Burzak,azshara,96,warlock,demonology,6,1,5
Divvaa,tarren-mill,96,warlock,demonology,6,1,5
Méetoo,thrall,96,warlock,demonology,6,1,5
Zebauron,twisting-nether,96,warlock,demonology,6,1,5
Ruvy,twisting-nether,96,warlock,demonology,6,1,5
Wolramir,thrall,96,warlock,demonology,12,1,11
Kàiser,sanguino,96,warlock,demonology,12,1,11
Tchytcha,archimonde,79,warlock,demonology,5,1,4
Waryald,dun-modr,64,warlock,demonology,4,1,3
Boccu,magtheridon,64,warlock,demonology,4,1,3
Кусокплети,grom,63,warlock,demonology,2,2,0
Tequendama,ysera,42,warlock,demonology,10,3,7
Xydar,stormscale,42,warlock,demonology,10,2,8
Berris,argent-dawn,31,warlock,demonology,2,1,1
Агрессивная,soulflayer,31,warlock,demonology,2,1,1
Lollock,teldrassil,31,warlock,demonology,2,1,1
Ravenmore,kazzak,16,warlock,demonology,1,1,0
Loghit,ravencrest,16,warlock,demonology,1,1,0
Creatúre,drakthul,2446,warlock,destruction,66,53,13
Inferniøn,ravencrest,2422,warlock,destruction,93,68,25
Erutaerc,drakthul,2379,warlock,destruction,102,65,37
Фаерморн,blackscar,2345,warlock,destruction,132,83,49
Infý,ravencrest,2332,warlock,destruction,130,83,47
Jâzggz,twisting-nether,2317,warlock,destruction,78,51,27
Tjl,kazzak,2302,warlock,destruction,185,107,78
Anihli,kazzak,2298,warlock,destruction,197,109,88
Canabolic,stormscale,2288,warlock,destruction,102,63,39
Geluwu,tarren-mill,2284,warlock,destruction,90,52,38
Тагочи,gordunni,2281,warlock,destruction,110,62,48
Steckenpferd,blackmoore,2277,warlock,destruction,60,42,18
Snapperz,stormscale,2277,warlock,destruction,150,84,66
Lopari,aegwynn,2275,warlock,destruction,106,65,41
Indraxx,hyjal,2266,warlock,destruction,110,60,50
Acentro,stormscale,2246,warlock,destruction,77,47,30
Lhestér,outland,2243,warlock,destruction,87,56,31
Боуман,howling-fjord,2243,warlock,destruction,96,56,40
Xeremas,blackrock,2237,warlock,destruction,83,62,21
Umbraz,blackmoore,2236,warlock,destruction,84,49,35
Zélroth,argent-dawn,2230,warlock,destruction,192,111,81
Azurma,tarren-mill,2211,warlock,destruction,78,47,31
Yùna,frostwolf,2209,warlock,destruction,72,48,24
Dæhli,argent-dawn,2204,warlock,destruction,102,56,46
Brokenearman,defias-brotherhood,2199,warlock,destruction,41,36,5
Rootzlx,ravencrest,2197,warlock,destruction,120,70,50
Fsandtwo,ravencrest,2195,warlock,destruction,114,74,40
Bualock,stormscale,2193,warlock,destruction,71,41,30
Amdead,sylvanas,2186,warlock,destruction,114,77,37
Zèlêph,archimonde,2185,warlock,destruction,186,118,68
Ìpen,bloodfeather,2179,warlock,destruction,89,52,37
Фримех,soulflayer,2167,warlock,destruction,65,51,14
Handicapped,burning-legion,2158,warlock,destruction,78,47,31
Kuckacocucka,outland,2156,warlock,destruction,113,70,43
Voldby,kazzak,2155,warlock,destruction,196,102,94
Veganlifter,ravencrest,2151,warlock,destruction,48,38,10
Glooness,burning-legion,2151,warlock,destruction,78,43,35
Djdampening,bloodhoof,2150,warlock,destruction,172,106,66
Bäle,stormreaver,2150,warlock,destruction,107,64,43
Chromosomex,dentarg,2149,warlock,destruction,54,41,13
Yúnalesca,aegwynn,2148,warlock,destruction,89,60,29
Johanan,ravencrest,2148,warlock,destruction,53,35,18
Absurdity,twisting-nether,2148,warlock,destruction,102,53,49
Varaxxis,twisting-nether,2147,warlock,destruction,120,70,50
Tekrowdy,blackmoore,2144,warlock,destruction,48,33,15
Ilovemimi,hyjal,2144,warlock,destruction,65,38,27
Soulboltx,ragnaros,2144,warlock,destruction,84,46,38
Kimkold,twisting-nether,2144,warlock,destruction,96,50,46
Koisk,tarren-mill,2142,warlock,destruction,82,47,35
Телола,gordunni,2141,warlock,destruction,102,61,41
Tópdogg,twisting-nether,2140,warlock,destruction,54,43,11
Боумонн,howling-fjord,2140,warlock,destruction,54,40,14
Velv,nagrand,2138,warlock,destruction,114,58,56
Veganlifter,blackhand,2136,warlock,destruction,72,45,27
Dogdrakex,tarren-mill,2133,warlock,destruction,81,47,34
Císuh,stormreaver,2133,warlock,destruction,120,69,51
Lockisbadx,draenor,2132,warlock,destruction,72,43,29
Эвилакс,gordunni,2131,warlock,destruction,78,50,28
Fyxs,talnivarr,2129,warlock,destruction,60,42,18
Tàkaz,drekthar,2129,warlock,destruction,130,80,50
Zila,sylvanas,2129,warlock,destruction,89,49,40
Legionlockxd,twisting-nether,2129,warlock,destruction,88,48,40
Xxjz,ravencrest,2128,warlock,destruction,150,86,64
Шархихохо,gordunni,2125,warlock,destruction,102,53,49
Nògg,frostwhisper,2120,warlock,destruction,66,42,24
Gulwer,blackmoore,2120,warlock,destruction,66,40,26
Vîmø,antonidas,2120,warlock,destruction,203,123,80
Djwarlock,kazzak,2119,warlock,destruction,100,55,45
Rune,aegwynn,2118,warlock,destruction,72,51,21
Dayken,silvermoon,2117,warlock,destruction,63,44,19
Boltilicious,kazzak,2117,warlock,destruction,90,52,38
Блакхен,blackscar,2117,warlock,destruction,66,38,28
Рашчер,gordunni,2116,warlock,destruction,101,58,43
Lyâ,ravencrest,2116,warlock,destruction,66,35,31
Onekxz,blackrock,2115,warlock,destruction,56,45,11
Djmcwarlock,kazzak,2115,warlock,destruction,68,40,28
Alphazero,zuluhed,2112,warlock,destruction,112,63,49
Bluefungirl,stormscale,2111,warlock,destruction,120,73,47
Рауваскх,howling-fjord,2110,warlock,destruction,53,31,22
Motcha,kazzak,2110,warlock,destruction,66,38,28
Cryzzbad,stormscale,2109,warlock,destruction,36,29,7
Nellyvato,eredar,2109,warlock,destruction,90,53,37
Drdoit,blackrock,2109,warlock,destruction,84,46,38
Силорий,howling-fjord,2108,warlock,destruction,85,54,31
Инферналках,gordunni,2106,warlock,destruction,71,48,23
Nògg,kazzak,2106,warlock,destruction,66,35,31
Bankstair,stormscale,2105,warlock,destruction,66,44,22
Hladankurac,twisting-nether,2105,warlock,destruction,60,35,25
Drainsouls,stormscale,2105,warlock,destruction,189,105,84
Lywov,stormscale,2103,warlock,destruction,60,34,26
Skillførçé,kazzak,2102,warlock,destruction,54,41,13
Wldot,ravencrest,2102,warlock,destruction,84,53,31
Kerídiin,twisting-nether,2102,warlock,destruction,108,61,47
Wester,blackmoore,2102,warlock,destruction,108,61,47
Артик,gordunni,2101,warlock,destruction,48,37,11
Kamoriwl,blackhand,2101,warlock,destruction,78,45,33
Gorillabolts,tarren-mill,2101,warlock,destruction,102,51,51
Zilalol,sylvanas,2100,warlock,destruction,90,51,39
Bfaexpert,ravencrest,2099,warlock,destruction,48,29,19
Sterlock,sylvanas,2093,warlock,destruction,73,40,33
Sehk,stormreaver,2077,warlock,destruction,60,43,17
Dabzw,twisting-nether,2075,warlock,destruction,67,43,24
Паилка,galakrond,2075,warlock,destruction,135,74,61
Chaosbuster,magtheridon,2069,warlock,destruction,114,72,42
Påsqúåls,ravencrest,2069,warlock,destruction,96,56,40
Haedache,tarren-mill,2069,warlock,destruction,101,57,44
Xesh,kiljaeden,2069,warlock,destruction,150,81,69
Panda,aegwynn,2068,warlock,destruction,54,34,20
Bualock,sylvanas,2068,warlock,destruction,60,33,27
Vileclass,ravencrest,2066,warlock,destruction,92,51,41
Ánderxyo,dun-modr,2065,warlock,destruction,42,32,10
Arfdispo,hyjal,2064,warlock,destruction,149,77,72
Блудгэнг,blackscar,2062,warlock,destruction,90,60,30
Bewegen,frostwolf,2061,warlock,destruction,90,50,40
Якурюимнепох,gordunni,2060,warlock,destruction,217,123,94
Osîrîs,aegwynn,2058,warlock,destruction,90,47,43
Válýrá,blackhand,2057,warlock,destruction,65,43,22
Malddog,turalyon,2056,warlock,destruction,126,72,54
Кериген,gordunni,2053,warlock,destruction,66,34,32
Простишутках,gordunni,2051,warlock,destruction,48,30,18
Rhüd,twisting-nether,2050,warlock,destruction,95,54,41
Omegazero,zuluhed,2048,warlock,destruction,72,43,29
Rexløck,nozdormu,2048,warlock,destruction,183,108,75
Faermorn,kazzak,2046,warlock,destruction,66,39,27
Мспечень,howling-fjord,2044,warlock,destruction,60,41,19
Héffer,outland,2044,warlock,destruction,121,80,41
Ez,emeriss,2042,warlock,destruction,61,45,16
Èlton,tarren-mill,2041,warlock,destruction,168,100,68
Whatamellown,aegwynn,2037,warlock,destruction,60,37,23
Anniefuchsia,ravencrest,2036,warlock,destruction,81,45,36
Deßra,stormscale,2033,warlock,destruction,72,42,30
Кириланскил,gordunni,2031,warlock,destruction,54,33,21
Bóbtown,stormscale,2030,warlock,destruction,270,148,122
Necromanya,ravencrest,2029,warlock,destruction,192,108,84
Онлидемон,gordunni,2028,warlock,destruction,159,84,75
Corbbolt,drakthul,2027,warlock,destruction,90,51,39
Чудастрх,azuregos,2025,warlock,destruction,96,53,43
Mangolicious,twisting-nether,2025,warlock,destruction,164,88,76
Jadesud,archimonde,2024,warlock,destruction,48,33,15
Кишмякхб,howling-fjord,2024,warlock,destruction,91,47,44
Влицотьмой,gordunni,2023,warlock,destruction,66,37,29
Superlocken,ragnaros,2022,warlock,destruction,65,37,28
Nëismz,hyjal,2019,warlock,destruction,54,32,22
Кенгарь,howling-fjord,2019,warlock,destruction,132,72,60
Felcamino,outland,2019,warlock,destruction,72,36,36
Avenueat,kazzak,2018,warlock,destruction,63,35,28
Тевон,gordunni,2017,warlock,destruction,72,50,22
Bigbolt,arathor,2017,warlock,destruction,113,61,52
Ryûsuke,dun-modr,2015,warlock,destruction,96,55,41
Xiraq,nathrezim,2014,warlock,destruction,66,39,27
Кобре,howling-fjord,2010,warlock,destruction,72,42,30
Epzi,outland,2008,warlock,destruction,47,27,20
Stefcheto,twilights-hammer,2008,warlock,destruction,96,54,42
Portlock,kazzak,2008,warlock,destruction,78,43,35
Achluophobiå,ravencrest,2007,warlock,destruction,67,41,26
Жасминдос,blackscar,2006,warlock,destruction,63,42,21
Decimus,darkspear,2006,warlock,destruction,138,81,57
Bryanz,sanguino,2000,warlock,destruction,100,50,50
Boltzer,archimonde,1996,warlock,destruction,96,58,38
Salvabolter,outland,1994,warlock,destruction,66,42,24
Isuckwarlock,aegwynn,1994,warlock,destruction,66,34,32
Rockbèll,blackmoore,1992,warlock,destruction,48,36,12
Dsï,outland,1991,warlock,destruction,77,38,39
Nyotu,antonidas,1988,warlock,destruction,131,73,58
Gøzù,antonidas,1985,warlock,destruction,54,32,22
Andtheysay,outland,1985,warlock,destruction,254,142,112
Kwoleriker,norgannon,1985,warlock,destruction,70,39,31
Logicdotexé,tarren-mill,1983,warlock,destruction,67,42,25
Onuurbro,kult-der-verdammten,1982,warlock,destruction,60,41,19
Shangalar,burning-legion,1980,warlock,destruction,90,51,39
Supergeîl,blackrock,1980,warlock,destruction,84,46,38
Tuplajekku,sylvanas,1980,warlock,destruction,77,37,40
Sqx,veklor,1978,warlock,destruction,60,39,21
Beebs,aegwynn,1977,warlock,destruction,58,40,18
Laedreth,argent-dawn,1977,warlock,destruction,212,115,97
Rmpfarmer,kazzak,1976,warlock,destruction,36,23,13
Wällaar,ragnaros,1976,warlock,destruction,84,50,34
Vitus,malganis,1976,warlock,destruction,180,98,82
Sjödin,tarren-mill,1975,warlock,destruction,36,27,9
Klnr,ravencrest,1975,warlock,destruction,116,70,46
Блейдап,razuvious,1975,warlock,destruction,66,37,29
Hotdoghomie,tarren-mill,1974,warlock,destruction,36,28,8
Xwíng,stormscale,1974,warlock,destruction,48,35,13
Acanthis,outland,1974,warlock,destruction,66,34,32
Wotlkenjoyer,ravencrest,1973,warlock,destruction,48,32,16
Gnargamehl,nemesis,1973,warlock,destruction,66,39,27
Ffpiiras,dunemaul,1972,warlock,destruction,63,37,26
Noomaca,drakthul,1972,warlock,destruction,143,80,63
Garlan,dun-modr,1972,warlock,destruction,232,126,106
Whakkx,blackrock,1969,warlock,destruction,90,49,41
Rohyna,archimonde,1968,warlock,destruction,48,34,14
Bladey,ragnaros,1968,warlock,destruction,149,86,63
Asáel,blackrock,1968,warlock,destruction,84,47,37
Exhäle,archimonde,1966,warlock,destruction,59,37,22
Balding,blackhand,1966,warlock,destruction,42,25,17
Pørtal,aggra-português,1964,warlock,destruction,107,57,50
Conditions,tarren-mill,1963,warlock,destruction,213,109,104
Avogeiñ,tarren-mill,1963,warlock,destruction,59,29,30
Miauwu,stormscale,1961,warlock,destruction,47,33,14
Zarisya,blackmoore,1961,warlock,destruction,48,29,19
Drowlý,twisting-nether,1961,warlock,destruction,54,32,22
Guciflipflop,twisting-nether,1961,warlock,destruction,72,40,32
Suprezz,sylvanas,1958,warlock,destruction,72,43,29
Sëngir,drakthul,1958,warlock,destruction,140,72,68
Benne,stormscale,1957,warlock,destruction,54,35,19
Взорг,soulflayer,1957,warlock,destruction,114,62,52
Madridistaß,outland,1957,warlock,destruction,164,82,82
Тьмазвёздная,gordunni,1956,warlock,destruction,96,63,33
Looneytoonz,blackrock,1956,warlock,destruction,84,50,34
Malgarøth,tarren-mill,1955,warlock,destruction,60,28,32
Сумракк,gordunni,1954,warlock,destruction,66,35,31
Nayolana,argent-dawn,1954,warlock,destruction,87,45,42
Freddaxd,outland,1953,warlock,destruction,76,48,28
Hømïcîðæl,ravencrest,1953,warlock,destruction,72,45,27
Tikondrus,ravencrest,1952,warlock,destruction,42,28,14
Ashlÿn,draenor,1952,warlock,destruction,47,31,16
Davyjonessx,twisting-nether,1951,warlock,destruction,110,52,58
Kumamoto,tarren-mill,1950,warlock,destruction,48,32,16
Mxdojsrvqxzq,ravencrest,1949,warlock,destruction,183,97,86
Tschapatalpi,blackhand,1947,warlock,destruction,70,35,35
Exitlock,thrall,1945,warlock,destruction,78,46,32
Rabasta,blackmoore,1945,warlock,destruction,60,33,27
Jøkèr,stormscale,1943,warlock,destruction,30,21,9
Сильвиос,howling-fjord,1943,warlock,destruction,100,49,51
Smaúg,archimonde,1942,warlock,destruction,111,58,53
Brødo,dun-modr,1941,warlock,destruction,57,34,23
Fearo,kazzak,1937,warlock,destruction,82,48,34
Ashmodéus,defias-brotherhood,1935,warlock,destruction,53,32,21
Obrusik,burning-legion,1933,warlock,destruction,83,38,45
Gregwyn,hellscream,1931,warlock,destruction,36,26,10
Kenachaos,twisting-nether,1931,warlock,destruction,155,92,63
Vvj,ravencrest,1929,warlock,destruction,144,74,70
Staenkymayne,blackhand,1927,warlock,destruction,28,21,7
Fornaio,nemesis,1927,warlock,destruction,36,24,12
Cujo,draenor,1927,warlock,destruction,120,60,60
Kitchiarû,uldaman,1925,warlock,destruction,48,30,18
Ethiq,blackrock,1925,warlock,destruction,42,24,18
Macchíato,ragnaros,1925,warlock,destruction,84,44,40
Isodjdojk,ravencrest,1924,warlock,destruction,41,33,8
Yukokotier,archimonde,1924,warlock,destruction,179,103,76
Dersdog,twisting-nether,1924,warlock,destruction,51,29,22
Габана,gordunni,1923,warlock,destruction,48,33,15
Fîgøk,conseil-des-ombres,1923,warlock,destruction,108,63,45
Гивмисоул,soulflayer,1918,warlock,destruction,60,36,24
Deezbolts,kazzak,1917,warlock,destruction,60,33,27
Blakstorm,archimonde,1915,warlock,destruction,60,35,25
Magonyth,ravencrest,1914,warlock,destruction,153,81,72
Doturanal,blackmoore,1913,warlock,destruction,66,36,30
Zàkx,silvermoon,1913,warlock,destruction,313,168,145
Wewondak,drakthul,1912,warlock,destruction,190,111,79
Lsr,argent-dawn,1912,warlock,destruction,77,44,33
Wäisted,ravencrest,1911,warlock,destruction,42,26,16
Drututt,the-maelstrom,1910,warlock,destruction,54,30,24
Mohihi,ravencrest,1910,warlock,destruction,60,31,29
Mýlìfêbélike,kazzak,1909,warlock,destruction,40,29,11
Necorinexx,silvermoon,1909,warlock,destruction,30,20,10
Sarthrax,argent-dawn,1907,warlock,destruction,60,38,22
Djhanzó,outland,1907,warlock,destruction,45,28,17
Xfz,stormscale,1906,warlock,destruction,54,30,24
Спаводах,soulflayer,1905,warlock,destruction,35,25,10
Raepist,terokkar,1905,warlock,destruction,78,46,32
Zoodíac,blackrock,1904,warlock,destruction,48,32,16
Carelock,chamber-of-aspects,1904,warlock,destruction,60,36,24
Healylockx,stormscale,1904,warlock,destruction,48,28,20
Mafteryo,blackrock,1901,warlock,destruction,84,45,39
Xunzu,drakthul,1901,warlock,destruction,60,30,30
Buâlock,stormscale,1900,warlock,destruction,24,20,4
Nineinchlock,silvermoon,1900,warlock,destruction,72,33,39
Файрик,blackscar,1897,warlock,destruction,42,26,16
Rúbs,sylvanas,1897,warlock,destruction,102,55,47
Mxxmmllm,kargath,1896,warlock,destruction,101,62,39
Хауда,gordunni,1895,warlock,destruction,136,77,59
Kikeri,blackhand,1895,warlock,destruction,66,37,29
Kaktakto,ravencrest,1895,warlock,destruction,54,30,24
Бжк,gordunni,1895,warlock,destruction,210,115,95
Tarilinwelli,les-sentinelles,1894,warlock,destruction,40,36,4
Kurono,silvermoon,1894,warlock,destruction,78,41,37
Зеленаямразь,soulflayer,1894,warlock,destruction,55,26,29
Kelthedral,tarren-mill,1893,warlock,destruction,73,36,37
Vregor,twisting-nether,1892,warlock,destruction,36,26,10
Fakegodx,ravencrest,1892,warlock,destruction,42,29,13
Hellíc,kazzak,1892,warlock,destruction,48,30,18
Laokoon,blackmoore,1891,warlock,destruction,66,42,24
Sad,lightnings-blade,1891,warlock,destruction,96,57,39
Twisted,malganis,1891,warlock,destruction,90,51,39
Aestheatic,draenor,1890,warlock,destruction,293,151,142
Stankaemayne,blackhand,1889,warlock,destruction,48,29,19
Armellixd,dun-modr,1888,warlock,destruction,62,34,28
Juhpz,blackrock,1888,warlock,destruction,52,24,28
Djfearbot,kazzak,1887,warlock,destruction,84,53,31
Deadpapi,outland,1886,warlock,destruction,53,35,18
Feardotbye,stormscale,1886,warlock,destruction,49,30,19
Bambkin,twisting-nether,1884,warlock,destruction,78,46,32
Whøîäm,kazzak,1883,warlock,destruction,42,31,11
Hânex,ravencrest,1883,warlock,destruction,42,28,14
Immaginare,sylvanas,1883,warlock,destruction,114,66,48
Zelieknight,ysondre,1883,warlock,destruction,168,96,72
Someonepro,tarren-mill,1882,warlock,destruction,89,41,48
Shadowrey,blackrock,1881,warlock,destruction,52,29,23
Laolife,twisting-nether,1880,warlock,destruction,72,35,37
Deathfløw,draenor,1879,warlock,destruction,90,58,32
Henmur,stormscale,1879,warlock,destruction,64,37,27
Badloljk,stormscale,1878,warlock,destruction,40,26,14
Theronas,tarren-mill,1878,warlock,destruction,54,34,20
Bónz,outland,1877,warlock,destruction,54,28,26
Alphå,blackmoore,1875,warlock,destruction,36,28,8
Eboyclass,twisting-nether,1875,warlock,destruction,33,23,10
Ulora,zirkel-des-cenarius,1875,warlock,destruction,59,33,26
Deadlyrust,ragnaros,1875,warlock,destruction,117,56,61
Lifetapped,tarren-mill,1874,warlock,destruction,47,25,22
Habdruck,blackmoore,1873,warlock,destruction,249,146,103
Raverboyy,blackrock,1873,warlock,destruction,60,34,26
Brodoh,dun-modr,1871,warlock,destruction,42,22,20
Twork,tarren-mill,1871,warlock,destruction,54,28,26
Ðènnis,tarren-mill,1870,warlock,destruction,42,28,14
Èmøgøðqt,ravencrest,1870,warlock,destruction,54,28,26
Tokodi,ragnaros,1869,warlock,destruction,60,34,26
Dooms,antonidas,1868,warlock,destruction,42,31,11
Аоепампгодх,howling-fjord,1866,warlock,destruction,82,58,24
Limoges,archimonde,1865,warlock,destruction,35,26,9
Extingul,tarren-mill,1865,warlock,destruction,59,38,21
Plâytïmè,stormscale,1865,warlock,destruction,78,39,39
Spookytouch,draenor,1864,warlock,destruction,94,47,47
Sheitana,ysondre,1863,warlock,destruction,60,39,21
Rokkarn,kazzak,1863,warlock,destruction,48,29,19
Osbaa,darksorrow,1861,warlock,destruction,50,31,19
Исверон,howling-fjord,1861,warlock,destruction,60,34,26
Stopdaddyplz,ravencrest,1860,warlock,destruction,36,24,12
Silmerion,twilights-hammer,1860,warlock,destruction,85,52,33
Xarfoul,grim-batol,1859,warlock,destruction,48,33,15
Phoyk,blackmoore,1859,warlock,destruction,48,29,19
Шрэкс,blackscar,1859,warlock,destruction,48,25,23
Nekrosd,tarren-mill,1858,warlock,destruction,141,76,65
Homerbamboom,hyjal,1857,warlock,destruction,41,32,9
Kayloo,archimonde,1856,warlock,destruction,54,34,20
Holiax,archimonde,1856,warlock,destruction,48,29,19
Zâyo,ravencrest,1856,warlock,destruction,54,31,23
Cmdxo,malganis,1856,warlock,destruction,71,38,33
Sluba,stormscale,1855,warlock,destruction,109,59,50
Pôhzz,archimonde,1854,warlock,destruction,30,21,9
Aniq,eredar,1854,warlock,destruction,60,29,31
Darksoll,hyjal,1853,warlock,destruction,41,31,10
Junakot,silvermoon,1852,warlock,destruction,54,30,24
Johnylock,draenor,1850,warlock,destruction,116,71,45
Debbskidjur,tarren-mill,1850,warlock,destruction,85,49,36
Depressedkid,ravencrest,1850,warlock,destruction,60,30,30
Likeqtz,thrall,1849,warlock,destruction,74,41,33
Chaoscrit,eredar,1848,warlock,destruction,85,48,37
Visceris,ravencrest,1848,warlock,destruction,66,29,37
Руктал,howling-fjord,1847,warlock,destruction,54,34,20
Ayperos,tyrande,1847,warlock,destruction,72,38,34
Gis,laughing-skull,1843,warlock,destruction,54,31,23
Rumour,sunstrider,1843,warlock,destruction,54,30,24
Dogoon,sylvanas,1842,warlock,destruction,185,103,82
Артисона,gordunni,1842,warlock,destruction,54,27,27
Ràzek,kazzak,1841,warlock,destruction,95,52,43
Andrewdaniel,twisting-nether,1841,warlock,destruction,60,31,29
Lzoo,ravencrest,1840,warlock,destruction,36,29,7
Kalaslars,draenor,1840,warlock,destruction,60,34,26
Attilergg,stormscale,1839,warlock,destruction,32,23,9
Ecoxx,aegwynn,1839,warlock,destruction,48,34,14
Fiddyp,kazzak,1839,warlock,destruction,42,28,14
Ñila,ravencrest,1839,warlock,destruction,36,23,13
Ripnsew,ravencrest,1839,warlock,destruction,41,26,15
Syviwl,outland,1839,warlock,destruction,53,30,23
Ty,earthen-ring,1838,warlock,destruction,60,41,19
Nutyx,twisting-nether,1838,warlock,destruction,78,40,38
Tharaqt,kazzak,1837,warlock,destruction,41,26,15
Angst,tarren-mill,1836,warlock,destruction,42,30,12
Ispankmysuc,korgall,1836,warlock,destruction,69,42,27
Bloodworth,arathor,1836,warlock,destruction,114,64,50
Sharhý,kazzak,1835,warlock,destruction,40,24,16
Belial,minahonda,1835,warlock,destruction,63,36,27
Bobop,sanguino,1834,warlock,destruction,106,60,46
Médeâ,ravencrest,1834,warlock,destruction,76,42,34
Кром,howling-fjord,1834,warlock,destruction,48,26,22
Drerlord,tarren-mill,1833,warlock,destruction,53,34,19
Asyncbuddy,azjolnerub,1832,warlock,destruction,48,32,16
Oldasianman,blackrock,1832,warlock,destruction,30,20,10
Kiwibob,defias-brotherhood,1832,warlock,destruction,65,41,24
Skarløck,blackmoore,1832,warlock,destruction,42,26,16
Temnamagna,silvermoon,1832,warlock,destruction,147,80,67
Ftpete,argent-dawn,1831,warlock,destruction,98,58,40
Lémonz,stormscale,1831,warlock,destruction,52,26,26
Worgonzolâ,madmortem,1830,warlock,destruction,221,134,87
Shadöwmäre,draenor,1830,warlock,destruction,54,31,23
Ðeface,nefarian,1830,warlock,destruction,54,31,23
Veríty,kazzak,1829,warlock,destruction,30,20,10
Trainindummy,ravencrest,1828,warlock,destruction,83,61,22
Ícekíss,hyjal,1828,warlock,destruction,48,33,15
Pepitogodx,khaz-modan,1828,warlock,destruction,48,33,15
Pprwl,tarren-mill,1828,warlock,destruction,126,77,49
Latia,argent-dawn,1828,warlock,destruction,46,28,18
Хэлмок,howling-fjord,1827,warlock,destruction,42,31,11
Coilxo,ravencrest,1827,warlock,destruction,52,36,16
Plaguee,outland,1827,warlock,destruction,68,40,28
Envizer,ravencrest,1827,warlock,destruction,42,24,18
Gogmorok,dunemaul,1827,warlock,destruction,257,127,130
Brainac,blackrock,1826,warlock,destruction,36,24,12
Véstheim,saurfang,1825,warlock,destruction,72,46,26
Oggelock,tarren-mill,1825,warlock,destruction,79,45,34
Соргосор,gordunni,1825,warlock,destruction,53,30,23
Saffíe,ravencrest,1825,warlock,destruction,70,39,31
Imforcedtowl,aegwynn,1824,warlock,destruction,42,31,11
Asilock,eredar,1824,warlock,destruction,48,32,16
Ìambottger,silvermoon,1824,warlock,destruction,48,30,18
Tôpsecret,aegwynn,1823,warlock,destruction,36,29,7
Worse,kazzak,1823,warlock,destruction,48,29,19
Coeurnichon,archimonde,1823,warlock,destruction,58,32,26
Maderto,burning-legion,1823,warlock,destruction,185,101,84
Watchdots,blackrock,1822,warlock,destruction,66,37,29
Røiheenøk,archimonde,1822,warlock,destruction,156,80,76
Kalagorn,azshara,1821,warlock,destruction,36,27,9
Кале,goldrinn,1821,warlock,destruction,136,87,49
Killáksi,ravencrest,1821,warlock,destruction,42,26,16
Juïcylucy,kazzak,1821,warlock,destruction,122,74,48
Atmosfèar,silvermoon,1821,warlock,destruction,66,37,29
Stepwarlock,kazzak,1821,warlock,destruction,81,42,39
Framelock,draenor,1820,warlock,destruction,48,37,11
Hauntit,chogall,1820,warlock,destruction,36,21,15
Korupcijax,kazzak,1820,warlock,destruction,36,21,15
Merçedesa,tarren-mill,1820,warlock,destruction,35,20,15
Qaripidia,ravencrest,1820,warlock,destruction,46,26,20
Koldarr,blackmoore,1820,warlock,destruction,160,90,70
Gorthunz,kazzak,1820,warlock,destruction,59,28,31
Trashløckx,blackrock,1819,warlock,destruction,42,30,12
Howtofake,doomhammer,1819,warlock,destruction,42,29,13
Mocha,ravencrest,1819,warlock,destruction,48,31,17
Reznör,archimonde,1819,warlock,destruction,30,19,11
Incesticide,ragnaros,1819,warlock,destruction,60,37,23
Juppi,blackrock,1819,warlock,destruction,138,82,56
Ôlo,rajaxx,1819,warlock,destruction,54,30,24
Fearing,malganis,1819,warlock,destruction,101,51,50
Fizzydark,malganis,1819,warlock,destruction,60,30,30
Selassie,blackmoore,1818,warlock,destruction,78,48,30
Кюратор,howling-fjord,1818,warlock,destruction,57,30,27
Lockróck,silvermoon,1817,warlock,destruction,30,22,8
Ziigouigouii,archimonde,1817,warlock,destruction,42,28,14
Jupp,blackrock,1817,warlock,destruction,48,29,19
Хастла,ashenvale,1817,warlock,destruction,54,32,22
Richerdgir,ravencrest,1817,warlock,destruction,45,26,19
Srkzlol,durotan,1817,warlock,destruction,66,35,31
Alcringe,kazzak,1816,warlock,destruction,158,90,68
Porchpirate,draenor,1816,warlock,destruction,72,41,31
Empra,stormscale,1816,warlock,destruction,54,28,26
Matsuei,tarren-mill,1816,warlock,destruction,48,23,25
Barneyboi,tarren-mill,1815,warlock,destruction,87,59,28
Louloudots,ragnaros,1815,warlock,destruction,36,22,14
Kivilock,dun-modr,1815,warlock,destruction,79,48,31
Tehkorrum,archimonde,1815,warlock,destruction,53,30,23
Kerway,outland,1815,warlock,destruction,96,54,42
Magicsin,aerie-peak,1814,warlock,destruction,36,31,5
Jappér,silvermoon,1814,warlock,destruction,36,30,6
Olsel,draenor,1814,warlock,destruction,47,30,17
Manhart,burning-legion,1814,warlock,destruction,58,33,25
Nemwl,draenor,1814,warlock,destruction,66,31,35
Doodle,the-maelstrom,1813,warlock,destruction,66,38,28
Фейкгодх,soulflayer,1813,warlock,destruction,54,30,24
Neoe,stormscale,1813,warlock,destruction,76,40,36
Tbs,blackhand,1813,warlock,destruction,54,25,29
Slytherim,stormscale,1812,warlock,destruction,87,57,30
Todesgurke,alleria,1812,warlock,destruction,36,22,14
Whisperer,defias-brotherhood,1812,warlock,destruction,54,29,25
Linuviel,argent-dawn,1811,warlock,destruction,41,29,12
Bono,frostwhisper,1811,warlock,destruction,86,54,32
Araqt,thrall,1810,warlock,destruction,35,26,9
Jaimstar,ravencrest,1810,warlock,destruction,35,25,10
Noobgg,kazzak,1810,warlock,destruction,90,53,37
Makîø,hyjal,1810,warlock,destruction,136,65,71
Boterham,kilrogg,1809,warlock,destruction,54,38,16
Fiearstyle,tarren-mill,1808,warlock,destruction,30,23,7
Senbolts,tarren-mill,1808,warlock,destruction,42,27,15
Pederpan,stormscale,1808,warlock,destruction,30,19,11
Чупачупакаб,soulflayer,1808,warlock,destruction,59,34,25
Darkleci,archimonde,1808,warlock,destruction,60,34,26
Purexlock,dragonblight,1807,warlock,destruction,53,34,19
Бауглирх,howling-fjord,1807,warlock,destruction,71,38,33
Titimon,tarren-mill,1806,warlock,destruction,94,52,42
Abbzey,tarren-mill,1806,warlock,destruction,132,70,62
Rûttna,kazzak,1806,warlock,destruction,53,27,26
Pumpelumpe,twisting-nether,1806,warlock,destruction,45,20,25
Yøshinø,wildhammer,1805,warlock,destruction,48,36,12
Justfamous,archimonde,1805,warlock,destruction,60,41,19
Lockchonk,kazzak,1805,warlock,destruction,84,52,32
Rivmuu,argent-dawn,1805,warlock,destruction,130,78,52
Delumia,tarren-mill,1805,warlock,destruction,113,64,49
Osbaa,bladefist,1804,warlock,destruction,48,31,17
Sïeur,archimonde,1804,warlock,destruction,113,69,44
Kasualdot,stormscale,1804,warlock,destruction,42,25,17
Фирбог,soulflayer,1804,warlock,destruction,60,31,29
Ниезвестнно,soulflayer,1804,warlock,destruction,47,24,23
Vøid,hellscream,1803,warlock,destruction,89,40,49
Ertogrul,draenor,1802,warlock,destruction,24,19,5
Loel,blackrock,1802,warlock,destruction,36,23,13
Pornhubx,stormscale,1802,warlock,destruction,48,30,18
Pilock,stormscale,1802,warlock,destruction,36,22,14
Morcey,sylvanas,1801,warlock,destruction,79,49,30
Alxor,archimonde,1801,warlock,destruction,78,44,34
Tuskawl,stormreaver,1800,warlock,destruction,36,22,14
Skrana,kazzak,1800,warlock,destruction,65,39,26
Lashyra,aszune,1800,warlock,destruction,48,24,24
Anabolicbaby,draenor,1799,warlock,destruction,30,23,7
Бонибеннет,gordunni,1799,warlock,destruction,56,35,21
Аймох,gordunni,1798,warlock,destruction,48,29,19
Jamb,bloodfeather,1796,warlock,destruction,24,19,5
Daubi,ravencrest,1796,warlock,destruction,48,28,20
Dualla,aegwynn,1796,warlock,destruction,108,61,47
Wankdiesel,der-rat-von-dalaran,1796,warlock,destruction,156,77,79
Hachishaku,ravencrest,1794,warlock,destruction,82,50,32
Eltharis,burning-legion,1794,warlock,destruction,60,33,27
Bàbyløck,archimonde,1792,warlock,destruction,78,44,34
Robertóó,burning-legion,1792,warlock,destruction,64,34,30
Slipx,aegwynn,1791,warlock,destruction,60,34,26
Rotangel,ragnaros,1791,warlock,destruction,60,33,27
Bianchii,stormscale,1790,warlock,destruction,38,27,11
Høliax,archimonde,1790,warlock,destruction,48,33,15
Warlockoloco,blackmoore,1788,warlock,destruction,114,70,44
Uddze,pozzo-delleternità,1787,warlock,destruction,71,38,33
Whøknøws,twisting-nether,1786,warlock,destruction,36,25,11
Çamille,ulduar,1786,warlock,destruction,97,53,44
Elyö,dalaran,1786,warlock,destruction,269,132,137
Ërîkå,ravencrest,1785,warlock,destruction,99,59,40
Marador,drakthul,1785,warlock,destruction,83,43,40
Keybump,outland,1784,warlock,destruction,146,83,63
Wlistoohard,stormscale,1784,warlock,destruction,53,30,23
Кейкегенкай,gordunni,1783,warlock,destruction,135,72,63
Corano,ravencrest,1782,warlock,destruction,36,23,13
Vankraken,silvermoon,1782,warlock,destruction,66,40,26
Knoxwhite,stormscale,1781,warlock,destruction,42,28,14
Felerok,drakthul,1780,warlock,destruction,30,22,8
Nunomendes,archimonde,1780,warlock,destruction,48,28,20
Rêctûmsêêkêr,ravencrest,1780,warlock,destruction,48,25,23
Cwz,ysondre,1775,warlock,destruction,26,20,6
Xerxeus,drakthul,1775,warlock,destruction,36,27,9
Themut,draenor,1775,warlock,destruction,82,49,33
Diablist,kazzak,1775,warlock,destruction,118,64,54
Halaïa,outland,1773,warlock,destruction,40,27,13
Vultzbolt,draenor,1773,warlock,destruction,165,93,72
Tajit,eredar,1773,warlock,destruction,66,32,34
Sunjal,stormscale,1772,warlock,destruction,36,24,12
Crse,antonidas,1772,warlock,destruction,79,52,27
Zxò,twisting-nether,1771,warlock,destruction,135,71,64
Veridy,kazzak,1771,warlock,destruction,82,43,39
Fredé,kazzak,1770,warlock,destruction,59,28,31
Demoner,tarren-mill,1769,warlock,destruction,156,90,66
Kmeta,twilights-hammer,1769,warlock,destruction,54,27,27
Ondarian,grim-batol,1768,warlock,destruction,56,37,19
Ragdoll,twisting-nether,1768,warlock,destruction,46,28,18
Fluugew,tarren-mill,1768,warlock,destruction,54,27,27
Gigachaos,outland,1766,warlock,destruction,107,69,38
Hebbxw,kazzak,1766,warlock,destruction,146,80,66
Онлифан,soulflayer,1765,warlock,destruction,64,40,24
Pöhz,archimonde,1764,warlock,destruction,48,27,21
Olympïe,archimonde,1763,warlock,destruction,70,44,26
Демоник,deathguard,1763,warlock,destruction,42,24,18
Autocannon,stormscale,1763,warlock,destruction,60,32,28
Helldoom,drakthul,1763,warlock,destruction,247,122,125
Sololock,ravencrest,1762,warlock,destruction,76,46,30
Ceu,tarren-mill,1762,warlock,destruction,129,70,59
Nëismz,ravencrest,1761,warlock,destruction,37,23,14
Løckwood,blackrock,1761,warlock,destruction,34,21,13
Jegfaller,wildhammer,1761,warlock,destruction,242,123,119
Xuthil,korgall,1760,warlock,destruction,78,45,33
Мишастрах,gordunni,1756,warlock,destruction,36,24,12
Razek,eredar,1754,warlock,destruction,47,27,20
Brainwashed,the-maelstrom,1753,warlock,destruction,57,33,24
Artys,tarren-mill,1752,warlock,destruction,36,25,11
Warlockery,argent-dawn,1750,warlock,destruction,84,48,36
Хирацука,howling-fjord,1749,warlock,destruction,45,31,14
Valthorion,arthas,1749,warlock,destruction,42,23,19
Рипхард,soulflayer,1749,warlock,destruction,57,31,26
Mércé,stormscale,1748,warlock,destruction,30,22,8
Kalwyn,stormscale,1748,warlock,destruction,30,22,8
Hydrôlîc,blackrock,1748,warlock,destruction,36,20,16
Kaijim,aegwynn,1747,warlock,destruction,121,78,43
Шеизла,borean-tundra,1747,warlock,destruction,90,57,33
Хйу,galakrond,1747,warlock,destruction,42,20,22
Lugnalennart,tarren-mill,1746,warlock,destruction,132,73,59
Muleerox,kazzak,1745,warlock,destruction,48,27,21
Nyiks,blackhand,1743,warlock,destruction,34,19,15
Nqa,outland,1743,warlock,destruction,41,22,19
Fearfearfear,archimonde,1743,warlock,destruction,84,41,43
Belastiz,blackmoore,1742,warlock,destruction,60,37,23
Gjallarbrù,archimonde,1742,warlock,destruction,51,29,22
Spectarlock,tarren-mill,1742,warlock,destruction,48,25,23
Guldån,twisting-nether,1741,warlock,destruction,42,24,18
Kasualix,ravencrest,1740,warlock,destruction,52,33,19
Shadeisblack,tarren-mill,1740,warlock,destruction,36,22,14
Бриант,gordunni,1740,warlock,destruction,42,24,18
Ketzu,hyjal,1739,warlock,destruction,36,21,15
Limity,nozdormu,1739,warlock,destruction,78,45,33
Боуманн,howling-fjord,1738,warlock,destruction,42,22,20
Flatwolenzy,blackrock,1736,warlock,destruction,30,19,11
Сумракз,soulflayer,1736,warlock,destruction,36,19,17
Ghachi,draenor,1735,warlock,destruction,72,33,39
Wintheirl,argent-dawn,1734,warlock,destruction,124,67,57
Dotalike,kazzak,1734,warlock,destruction,42,22,20
Ditàà,archimonde,1733,warlock,destruction,41,26,15
Dótstuff,draenor,1733,warlock,destruction,36,22,14
Моргоника,howling-fjord,1733,warlock,destruction,91,48,43
Plsbuffme,ravencrest,1731,warlock,destruction,39,27,12
Десло,thermaplugg,1731,warlock,destruction,42,25,17
Daeyon,ravencrest,1731,warlock,destruction,38,19,19
Wismer,kazzak,1730,warlock,destruction,30,20,10
Acrion,blackrock,1730,warlock,destruction,39,20,19
Asbest,blackrock,1730,warlock,destruction,82,42,40
Upsahl,twisting-nether,1729,warlock,destruction,110,61,49
Vmorghuliss,sanguino,1729,warlock,destruction,114,52,62
Imbalockzwei,aegwynn,1728,warlock,destruction,36,25,11
Entropyboost,stormscale,1728,warlock,destruction,42,21,21
Jûgøbænned,aegwynn,1727,warlock,destruction,45,33,12
Тумнуктхай,gordunni,1727,warlock,destruction,42,27,15
Depressor,ragnaros,1727,warlock,destruction,90,44,46
Жизньтлён,gordunni,1726,warlock,destruction,60,35,25
Pixelz,twisting-nether,1725,warlock,destruction,72,35,37
Boccebelle,pozzo-delleternità,1724,warlock,destruction,24,18,6
Айхопъюдай,blackscar,1724,warlock,destruction,30,18,12
Senkai,kelthuzad,1723,warlock,destruction,36,24,12
Мерседэсс,gordunni,1723,warlock,destruction,48,30,18
Äåäåäåäåäåäå,ravencrest,1723,warlock,destruction,30,18,12
Spõk,ysondre,1722,warlock,destruction,226,125,101
Orgebixx,blackmoore,1722,warlock,destruction,60,33,27
Ñøêssä,outland,1721,warlock,destruction,36,22,14
Sznyes,ragnaros,1721,warlock,destruction,36,19,17
Jawoxoxo,rexxar,1721,warlock,destruction,60,21,39
Killerbolt,blackmoore,1720,warlock,destruction,42,28,14
Лордандрюха,soulflayer,1719,warlock,destruction,36,23,13
Nekrofille,outland,1719,warlock,destruction,30,18,12
Ganjubass,tarren-mill,1718,warlock,destruction,91,54,37
Lockostock,kazzak,1718,warlock,destruction,71,34,37
Fiddlestickz,gilneas,1716,warlock,destruction,71,41,30
Urururustyle,hyjal,1715,warlock,destruction,48,27,21
Öbsury,hyjal,1715,warlock,destruction,49,26,23
Precogdiet,draenor,1714,warlock,destruction,24,18,6
Acilock,outland,1714,warlock,destruction,42,23,19
Nybbx,frostmane,1714,warlock,destruction,201,100,101
Ignittes,ragnaros,1713,warlock,destruction,42,29,13
Блэклаш,soulflayer,1713,warlock,destruction,30,18,12
Reidonk,blackrock,1713,warlock,destruction,30,18,12
Mekanix,kazzak,1712,warlock,destruction,36,21,15
Korbendallas,anubarak,1711,warlock,destruction,30,21,9
Soundmagic,silvermoon,1711,warlock,destruction,36,22,14
Fatburner,draenor,1710,warlock,destruction,42,26,16
Amited,drakthul,1710,warlock,destruction,59,35,24
Berkobaggins,ravencrest,1710,warlock,destruction,70,38,32
Fløkee,blackmoore,1710,warlock,destruction,36,19,17
Tierzxc,ravencrest,1709,warlock,destruction,42,24,18
Габаныч,soulflayer,1708,warlock,destruction,24,18,6
Cetreros,minahonda,1708,warlock,destruction,24,18,6
Cørpse,burning-legion,1708,warlock,destruction,46,33,13
Stickdüse,eredar,1708,warlock,destruction,54,29,25
Boumbye,ysondre,1707,warlock,destruction,38,23,15
Precogbtw,ravencrest,1707,warlock,destruction,30,18,12
Trîppîn,blackrock,1707,warlock,destruction,36,20,16
Uzzi,dun-modr,1707,warlock,destruction,141,77,64
Shádóws,nagrand,1707,warlock,destruction,173,93,80
Hairyporta,blackmoore,1707,warlock,destruction,162,84,78
Læsy,archimonde,1706,warlock,destruction,24,18,6
Lokmonji,perenolde,1706,warlock,destruction,45,27,18
Mallevs,outland,1705,warlock,destruction,84,48,36
Коилсестры,blackscar,1702,warlock,destruction,39,24,15
Isata,ravencrest,1702,warlock,destruction,96,58,38
Nëismz,azuremyst,1700,warlock,destruction,30,20,10
Kavalierr,stormscale,1699,warlock,destruction,38,25,13
Ðemonsoul,stormscale,1699,warlock,destruction,285,141,144
Tîllz,kargath,1698,warlock,destruction,24,22,2
Djfearfullx,archimonde,1698,warlock,destruction,54,30,24
Алистрен,fordragon,1698,warlock,destruction,125,67,58
Märtas,burning-blade,1698,warlock,destruction,89,47,42
Æhtrex,blackrock,1697,warlock,destruction,69,44,25
Twiseqtt,stormscale,1697,warlock,destruction,30,18,12
Чернокок,blackscar,1697,warlock,destruction,48,24,24
Brútality,nethersturm,1696,warlock,destruction,90,41,49
Gloon,burning-legion,1695,warlock,destruction,42,23,19
Âkâl,ravencrest,1694,warlock,destruction,63,40,23
Limecqt,dun-morogh,1694,warlock,destruction,40,19,21
Lichlolock,outland,1693,warlock,destruction,64,39,25
Juanwick,grim-batol,1692,warlock,destruction,31,24,7
Døtàndrun,archimonde,1692,warlock,destruction,48,28,20
Destinyz,dun-modr,1691,warlock,destruction,36,27,9
Marti,blackrock,1691,warlock,destruction,42,27,15
Domdon,stormscale,1691,warlock,destruction,48,26,22
Ødräcïe,twisting-nether,1691,warlock,destruction,36,18,18
Ðôtgøðx,ravencrest,1691,warlock,destruction,60,28,32
Ekispekis,tarren-mill,1690,warlock,destruction,36,22,14
Väladar,sanguino,1690,warlock,destruction,47,23,24
Shutupkid,ravencrest,1689,warlock,destruction,48,29,19
Variu,blackhand,1689,warlock,destruction,158,90,68
Wilog,silvermoon,1688,warlock,destruction,43,27,16
Boyyano,tarren-mill,1688,warlock,destruction,30,18,12
Инфезиус,deathweaver,1686,warlock,destruction,30,18,12
Strikeførce,ravencrest,1686,warlock,destruction,81,46,35
Rénio,stormrage,1685,warlock,destruction,32,22,10
Worro,eredar,1685,warlock,destruction,48,27,21
Ilovebronko,blackrock,1685,warlock,destruction,101,53,48
Krestox,blackmoore,1684,warlock,destruction,77,44,33
Opiumers,kazzak,1684,warlock,destruction,119,61,58
Kêkèkékêk,kazzak,1683,warlock,destruction,31,25,6
Инсинирейтх,gordunni,1682,warlock,destruction,36,24,12
Critchlock,tarren-mill,1682,warlock,destruction,53,29,24
Lolock,archimonde,1681,warlock,destruction,32,19,13
Ludé,eredar,1680,warlock,destruction,105,54,51
Mizxxta,zuljin,1679,warlock,destruction,35,23,12
Tanón,sanguino,1679,warlock,destruction,73,45,28
Redshíne,hyjal,1678,warlock,destruction,30,20,10
Óop,outland,1678,warlock,destruction,54,28,26
Fulcanelli,sargeras,1678,warlock,destruction,39,20,19
Loulou,nagrand,1678,warlock,destruction,42,20,22
Darlih,ravencrest,1678,warlock,destruction,192,90,102
Pinacholadá,norgannon,1678,warlock,destruction,78,35,43
Whiteðevil,draenor,1677,warlock,destruction,36,21,15
Exorbïtant,blackrock,1677,warlock,destruction,226,120,106
Morathy,drekthar,1676,warlock,destruction,28,19,9
Testoorc,frostwolf,1676,warlock,destruction,104,55,49
Acidmvp,ravencrest,1676,warlock,destruction,72,38,34
Danidelarge,aegwynn,1676,warlock,destruction,70,36,34
Шедон,soulflayer,1675,warlock,destruction,30,22,8
Exephia,laughing-skull,1675,warlock,destruction,36,22,14
Rádiz,blackhand,1674,warlock,destruction,48,25,23
Wåfa,kazzak,1673,warlock,destruction,24,18,6
Babáyàgá,blackhand,1673,warlock,destruction,128,80,48
Lockdest,outland,1673,warlock,destruction,71,39,32
Neirah,stormscale,1672,warlock,destruction,47,26,21
Нгага,howling-fjord,1672,warlock,destruction,279,148,131
Boomsparkle,blackrock,1671,warlock,destruction,36,23,13
Гвоздяшка,blackscar,1670,warlock,destruction,54,27,27
Gogonash,ravencrest,1670,warlock,destruction,48,20,28
Curzed,emerald-dream,1669,warlock,destruction,50,29,21
Колодун,gordunni,1669,warlock,destruction,36,20,16
Mønarch,argent-dawn,1669,warlock,destruction,85,46,39
Ванадий,soulflayer,1667,warlock,destruction,59,26,33
Pelea,silvermoon,1666,warlock,destruction,48,27,21
Lokic,draenor,1665,warlock,destruction,52,24,28
Shadock,scarshield-legion,1664,warlock,destruction,30,20,10
Orcwarlock,khadgar,1664,warlock,destruction,66,35,31
Dotshok,aegwynn,1664,warlock,destruction,42,22,20
Dotsfired,aegwynn,1664,warlock,destruction,72,34,38
Sargus,drakthul,1664,warlock,destruction,146,68,78
Aajora,malganis,1662,warlock,destruction,84,53,31
Danidelarge,kazzak,1662,warlock,destruction,38,23,15
Mayev,garrosh,1662,warlock,destruction,76,37,39
Беллулар,howling-fjord,1660,warlock,destruction,36,22,14
Palihatschi,eredar,1660,warlock,destruction,59,24,35
Síggýy,eredar,1659,warlock,destruction,41,21,20
Chaosxd,outland,1658,warlock,destruction,30,20,10
Eviil,tarren-mill,1658,warlock,destruction,36,22,14
Pestílentía,silvermoon,1657,warlock,destruction,60,39,21
Chaozvx,kazzak,1656,warlock,destruction,71,41,30
Avogein,tarren-mill,1656,warlock,destruction,36,19,17
Miller,stormscale,1655,warlock,destruction,48,29,19
Enyras,nemesis,1655,warlock,destruction,42,22,20
Rustos,ravencrest,1654,warlock,destruction,36,21,15
Sneptics,draenor,1654,warlock,destruction,163,94,69
Büm,kazzak,1654,warlock,destruction,90,43,47
Badguldan,blackmoore,1653,warlock,destruction,57,30,27
Despayr,tarren-mill,1653,warlock,destruction,72,36,36
Nijva,silvermoon,1653,warlock,destruction,60,29,31
Jïñ,ravencrest,1652,warlock,destruction,27,24,3
Peacedust,grim-batol,1652,warlock,destruction,36,28,8
Magonyth,tarren-mill,1652,warlock,destruction,31,22,9
Kärme,archimonde,1652,warlock,destruction,30,19,11
Pelkopeelo,tarren-mill,1652,warlock,destruction,65,38,27
Saloninus,argent-dawn,1652,warlock,destruction,54,31,23
Finsterfluch,conseil-des-ombres,1652,warlock,destruction,54,30,24
Deathcoîl,the-maelstrom,1652,warlock,destruction,42,22,20
Sleethy,destromath,1651,warlock,destruction,54,27,27
Koffey,twisting-nether,1650,warlock,destruction,36,25,11
Kaspersdame,ravencrest,1650,warlock,destruction,47,24,23
Profesorr,defias-brotherhood,1650,warlock,destruction,42,21,21
Murdee,kazzak,1650,warlock,destruction,54,22,32
Søulcä,uldum,1649,warlock,destruction,30,23,7
Паинбрингер,soulflayer,1649,warlock,destruction,30,18,12
Quarimathras,antonidas,1649,warlock,destruction,66,34,32
Lichlolocked,outland,1649,warlock,destruction,78,40,38
Fatzké,kargath,1649,warlock,destruction,101,49,52
Psýcholoc,kazzak,1648,warlock,destruction,38,25,13
Jawdrop,blackrock,1648,warlock,destruction,51,31,20
Schrimz,blackrock,1648,warlock,destruction,57,26,31
Oldasiangirl,blackrock,1647,warlock,destruction,30,20,10
Willthehoe,alonsus,1647,warlock,destruction,35,20,15
Bh,ragnaros,1647,warlock,destruction,81,43,38
Marieejoana,nozdormu,1646,warlock,destruction,72,41,31
Ðemise,antonidas,1646,warlock,destruction,54,29,25
Fearlessgødx,ravencrest,1646,warlock,destruction,88,46,42
Zekarat,blackrock,1646,warlock,destruction,60,30,30
Nøl,sargeras,1645,warlock,destruction,339,172,167
Pumpfake,ravencrest,1644,warlock,destruction,23,18,5
Spcnz,stormscale,1644,warlock,destruction,57,29,28
Jetsetmehmet,aegwynn,1644,warlock,destruction,60,29,31
Slf,the-maelstrom,1644,warlock,destruction,54,23,31
Yoplen,drakthul,1643,warlock,destruction,104,61,43
Cigarrette,draenor,1642,warlock,destruction,42,21,21
Skyamino,hyjal,1641,warlock,destruction,42,27,15
Lovromalt,kazzak,1641,warlock,destruction,48,29,19
Shérlock,ravencrest,1640,warlock,destruction,42,22,20
Муза,gordunni,1639,warlock,destruction,42,26,16
Nøxxlock,blackhand,1639,warlock,destruction,95,55,40
Forcas,archimonde,1638,warlock,destruction,142,78,64
Evylock,draenor,1638,warlock,destruction,36,18,18
Tóuché,aegwynn,1637,warlock,destruction,84,46,38
Flawzo,blackmoore,1636,warlock,destruction,48,29,19
Shugglock,draenor,1636,warlock,destruction,42,23,19
Nerfmebro,tarren-mill,1635,warlock,destruction,24,19,5
Enragelock,tarren-mill,1634,warlock,destruction,59,39,20
Dotrulez,nemesis,1634,warlock,destruction,31,18,13
Warlololock,malganis,1634,warlock,destruction,42,24,18
Elvània,eredar,1633,warlock,destruction,54,31,23
Lókkíi,silvermoon,1633,warlock,destruction,157,89,68
Brodir,aszune,1633,warlock,destruction,36,19,17
Lonelock,blackrock,1632,warlock,destruction,50,32,18
Кишмякхб,gordunni,1632,warlock,destruction,47,21,26
Kaeb,archimonde,1631,warlock,destruction,24,17,7
Gruggenbach,twisting-nether,1630,warlock,destruction,24,17,7
Lockukaracha,malganis,1630,warlock,destruction,51,34,17
Augge,tarren-mill,1630,warlock,destruction,58,33,25
Mihø,hyjal,1630,warlock,destruction,80,42,38
Таксидермия,gordunni,1630,warlock,destruction,180,92,88
Funcky,terokkar,1630,warlock,destruction,48,19,29
Verixdots,antonidas,1629,warlock,destruction,38,25,13
Telodotto,nemesis,1629,warlock,destruction,30,17,13
Invoke,burning-blade,1628,warlock,destruction,24,20,4
Wreky,thrall,1628,warlock,destruction,24,17,7
Raxan,stormscale,1628,warlock,destruction,29,19,10
Порртвейн,howling-fjord,1628,warlock,destruction,29,18,11
Aspas,outland,1628,warlock,destruction,77,43,34
Salvatoríy,outland,1628,warlock,destruction,41,21,20
Nherthul,sanguino,1628,warlock,destruction,261,133,128
Woòkz,argent-dawn,1627,warlock,destruction,148,84,64
Flyingjakob,argent-dawn,1627,warlock,destruction,30,17,13
Hepheisto,blackmoore,1627,warlock,destruction,37,20,17
Kigro,burning-legion,1627,warlock,destruction,72,38,34
Litox,twisting-nether,1627,warlock,destruction,63,32,31
Kyliân,blackmoore,1627,warlock,destruction,36,18,18
Edrahil,lordaeron,1626,warlock,destruction,66,37,29
Fluch,area-52,1626,warlock,destruction,60,26,34
Соикулейн,gordunni,1625,warlock,destruction,29,23,6
Mobikagodx,drakthul,1625,warlock,destruction,27,19,8
Luwuock,twisting-nether,1625,warlock,destruction,30,21,9
Wryy,nemesis,1624,warlock,destruction,44,29,15
Bmblockerina,blackrock,1624,warlock,destruction,54,35,19
Khoug,blackmoore,1624,warlock,destruction,60,27,33
Анрали,deathguard,1623,warlock,destruction,24,17,7
Nekros,archimonde,1623,warlock,destruction,54,34,20
Stazox,drakthul,1623,warlock,destruction,30,18,12
Quickccast,draenor,1623,warlock,destruction,97,58,39
Thebigsuck,tarren-mill,1623,warlock,destruction,96,53,43
Weso,grim-batol,1623,warlock,destruction,55,28,27
Isata,blackhand,1622,warlock,destruction,36,20,16
Killning,medivh,1622,warlock,destruction,186,94,92
Kasztyk,grim-batol,1621,warlock,destruction,47,27,20
Essealaes,stormscale,1621,warlock,destruction,35,18,17
Ayrefik,kazzak,1621,warlock,destruction,72,36,36
Мураса,grom,1620,warlock,destruction,35,22,13
Smegwlock,tarren-mill,1620,warlock,destruction,48,28,20
Nimbin,taerar,1620,warlock,destruction,165,92,73
Zebauron,twisting-nether,1620,warlock,destruction,36,20,16
Kìmar,amanthul,1620,warlock,destruction,78,42,36
Neburlock,dun-modr,1620,warlock,destruction,42,21,21
Beåtrìce,archimonde,1620,warlock,destruction,57,28,29
Reeween,argent-dawn,1619,warlock,destruction,30,18,12
Надсх,soulflayer,1619,warlock,destruction,30,17,13
Whitebøy,hyjal,1619,warlock,destruction,45,25,20
Delru,aegwynn,1618,warlock,destruction,30,20,10
Zikozor,ravencrest,1618,warlock,destruction,28,18,10
Dzey,drakthul,1618,warlock,destruction,69,41,28
Stavrogina,ravencrest,1618,warlock,destruction,30,17,13
Börsenborisq,aegwynn,1618,warlock,destruction,35,19,16
Локдлячепухи,soulflayer,1617,warlock,destruction,30,19,11
Aspass,kazzak,1617,warlock,destruction,83,44,39
Husaì,laughing-skull,1616,warlock,destruction,88,58,30
Nerfbolts,archimonde,1615,warlock,destruction,24,17,7
Turbonion,archimonde,1615,warlock,destruction,72,40,32
Laciewaifu,silvermoon,1615,warlock,destruction,36,20,16
Biest,drakthul,1615,warlock,destruction,36,17,19
Anomen,sanguino,1615,warlock,destruction,53,24,29
Ltheory,aegwynn,1614,warlock,destruction,60,34,26
Malame,hyjal,1614,warlock,destruction,118,64,54
Jisera,kiljaeden,1614,warlock,destruction,36,17,19
Uralya,kazzak,1613,warlock,destruction,36,20,16
Smíkz,blackhand,1612,warlock,destruction,53,32,21
Gusvitori,sanguino,1612,warlock,destruction,36,20,16
Meatbot,tarren-mill,1609,warlock,destruction,46,31,15
Lockyswag,draenor,1609,warlock,destruction,66,37,29
Nitmoredots,dun-modr,1609,warlock,destruction,48,24,24
Skrabblel,tarren-mill,1609,warlock,destruction,36,18,18
Boltonez,outland,1609,warlock,destruction,66,29,37
Shaterz,dun-modr,1608,warlock,destruction,27,21,6
Ryssäbotti,stormscale,1608,warlock,destruction,31,23,8
Esmuel,argent-dawn,1608,warlock,destruction,71,43,28
Spykoosi,stormscale,1608,warlock,destruction,40,24,16
Xenq,ravencrest,1608,warlock,destruction,42,25,17
Ketamol,ravencrest,1608,warlock,destruction,57,32,25
Селикта,gordunni,1607,warlock,destruction,30,17,13
Maxlox,tarren-mill,1607,warlock,destruction,35,17,18
Kognah,defias-brotherhood,1606,warlock,destruction,30,21,9
Гурджес,soulflayer,1606,warlock,destruction,42,29,13
Zoradiale,twisting-nether,1606,warlock,destruction,36,24,12
Мицуру,howling-fjord,1606,warlock,destruction,100,59,41
Ðêmøñîc,ravencrest,1606,warlock,destruction,30,17,13
Märkähuikka,stormreaver,1605,warlock,destruction,24,17,7
Холичорт,howling-fjord,1605,warlock,destruction,69,37,32
Felttofel,stormscale,1604,warlock,destruction,49,28,21
Garbageclass,outland,1604,warlock,destruction,36,20,16
Moelock,frostmane,1604,warlock,destruction,135,74,61
Zeinth,sanguino,1603,warlock,destruction,36,23,13
Sotapen,ragnaros,1603,warlock,destruction,92,56,36
Дэнаа,fordragon,1603,warlock,destruction,167,85,82
Dreamnyâsha,tarren-mill,1603,warlock,destruction,42,19,23
Gishor,burning-legion,1602,warlock,destruction,24,19,5
Xtleonidas,uldum,1602,warlock,destruction,78,41,37
Bufflockspls,outland,1601,warlock,destruction,24,17,7
Sickening,twilights-hammer,1601,warlock,destruction,55,38,17
Skrikipanik,kazzak,1601,warlock,destruction,36,21,15
Wumz,sylvanas,1601,warlock,destruction,53,27,26
Dastey,stormscale,1601,warlock,destruction,36,18,18
Rensayy,ysondre,1600,warlock,destruction,30,21,9
Øßey,magtheridon,1600,warlock,destruction,30,19,11
Letswreck,outland,1600,warlock,destruction,84,43,41
Gash,malganis,1599,warlock,destruction,37,22,15
Kenthal,nemesis,1599,warlock,destruction,57,28,29
Bazoo,nathrezim,1597,warlock,destruction,135,68,67
Golgir,draenor,1596,warlock,destruction,106,59,47
Schøkøbasher,blackrock,1596,warlock,destruction,36,20,16
Napoloen,kazzak,1596,warlock,destruction,36,19,17
Blackiouz,stormscale,1596,warlock,destruction,167,83,84
Zetsubo,drakthul,1595,warlock,destruction,55,34,21
Sibora,eredar,1594,warlock,destruction,42,23,19
Liqûid,destromath,1593,warlock,destruction,118,69,49
Ðîâblô,silvermoon,1593,warlock,destruction,80,41,39
Enzyw,drakthul,1591,warlock,destruction,36,27,9
Bolt,stormscale,1591,warlock,destruction,82,50,32
Nerfwarriors,stormscale,1587,warlock,destruction,52,30,22
Craynos,die-arguswacht,1587,warlock,destruction,56,32,24
Plamena,neptulon,1586,warlock,destruction,55,36,19
Réxz,ravencrest,1586,warlock,destruction,72,36,36
Hexdoctor,ravencrest,1586,warlock,destruction,48,18,30
Dödkärringx,auchindoun,1585,warlock,destruction,30,19,11
Грань,ashenvale,1585,warlock,destruction,212,115,97
Zoh,archimonde,1585,warlock,destruction,72,38,34
Uneedtherapy,silvermoon,1584,warlock,destruction,54,33,21
Gimlidota,tarren-mill,1584,warlock,destruction,83,48,35
Kenjix,blackrock,1584,warlock,destruction,54,23,31
Chaosbolt,kelthuzad,1583,warlock,destruction,24,18,6
Brugo,zuljin,1583,warlock,destruction,36,20,16
Unethicalx,ragnaros,1583,warlock,destruction,36,20,16
Banishedone,stormreaver,1583,warlock,destruction,92,51,41
Voidzero,hyjal,1583,warlock,destruction,41,19,22
Hellguards,silvermoon,1583,warlock,destruction,83,38,45
Scallington,shattered-hand,1582,warlock,destruction,30,18,12
Aloof,outland,1582,warlock,destruction,201,105,96
Icritmore,stormscale,1582,warlock,destruction,72,37,35
Flocca,archimonde,1582,warlock,destruction,41,21,20
Oz,uldum,1581,warlock,destruction,78,49,29
Mogwaï,blackhand,1581,warlock,destruction,51,27,24
Иренхх,gordunni,1581,warlock,destruction,72,34,38
Idfearthat,ragnaros,1580,warlock,destruction,48,28,20
Грэтиэн,howling-fjord,1580,warlock,destruction,54,31,23
Marenov,kazzak,1580,warlock,destruction,60,33,27
Stromzii,silvermoon,1579,warlock,destruction,120,58,62
Ìzanamí,archimonde,1578,warlock,destruction,72,44,28
Simony,ravencrest,1578,warlock,destruction,30,18,12
Verson,silvermoon,1578,warlock,destruction,97,53,44
Хеельхейм,gordunni,1577,warlock,destruction,54,31,23
Bonemetz,blackmoore,1577,warlock,destruction,142,75,67
Blackmagic,stormscale,1577,warlock,destruction,170,88,82
Htaedfo,tarren-mill,1576,warlock,destruction,102,45,57
Mariahscary,auchindoun,1575,warlock,destruction,36,21,15
Babakrake,alleria,1573,warlock,destruction,36,22,14
Hongkonger,kazzak,1573,warlock,destruction,296,154,142
Nàchtt,archimonde,1572,warlock,destruction,36,20,16
Ánárchy,stormscale,1572,warlock,destruction,42,22,20
Sûdh,sanguino,1571,warlock,destruction,60,37,23
Spoíl,tarren-mill,1571,warlock,destruction,48,27,21
Rakshazza,eredar,1571,warlock,destruction,102,53,49
Hellfire,haomarush,1570,warlock,destruction,30,18,12
Sxtynine,outland,1570,warlock,destruction,42,24,18
Áutísm,silvermoon,1570,warlock,destruction,138,71,67
Fandirxd,draenor,1569,warlock,destruction,71,39,32
Dotsyoudown,kelthuzad,1568,warlock,destruction,97,52,45
Visable,kazzak,1568,warlock,destruction,36,19,17
Noahh,kazzak,1567,warlock,destruction,107,63,44
Fatkkroth,ravencrest,1565,warlock,destruction,49,30,19
Акэти,borean-tundra,1565,warlock,destruction,42,21,21
Necrobtch,quelthalas,1564,warlock,destruction,30,19,11
Konradcurz,silvermoon,1562,warlock,destruction,45,20,25
Аркейнмизери,howling-fjord,1561,warlock,destruction,34,23,11
Shóx,blackmoore,1561,warlock,destruction,30,18,12
Drakedoge,draenor,1561,warlock,destruction,82,45,37
Striks,ragnaros,1561,warlock,destruction,64,33,31
Nagassh,arathor,1560,warlock,destruction,23,17,6
Contemtus,frostwhisper,1559,warlock,destruction,30,19,11
Azthral,nemesis,1558,warlock,destruction,259,129,130
Morgan,jaedenar,1557,warlock,destruction,90,51,39
Rackare,darksorrow,1556,warlock,destruction,27,19,8
Baz,frostmane,1556,warlock,destruction,102,56,46
Wisdomness,aszune,1556,warlock,destruction,72,36,36
Britneyfears,burning-legion,1556,warlock,destruction,36,18,18
Beepbepp,grim-batol,1555,warlock,destruction,52,37,15
Ajgreedyy,grim-batol,1555,warlock,destruction,60,30,30
Chaøs,thrall,1554,warlock,destruction,30,22,8
Славеномен,howling-fjord,1554,warlock,destruction,174,89,85
Atraped,zuljin,1553,warlock,destruction,126,68,58
Articfox,outland,1553,warlock,destruction,104,54,50
Joemontana,blackrock,1552,warlock,destruction,36,17,19
Vicktorious,stormscale,1551,warlock,destruction,102,59,43
Afflimoomoo,tarren-mill,1549,warlock,destruction,78,37,41
Päwzy,kazzak,1548,warlock,destruction,66,34,32
Chaosboltlol,ravencrest,1547,warlock,destruction,36,22,14
Zarastro,sunstrider,1547,warlock,destruction,147,73,74
Lysanruth,la-croisade-écarlate,1547,warlock,destruction,96,47,49
Slàsh,hyjal,1546,warlock,destruction,42,29,13
Necradin,defias-brotherhood,1546,warlock,destruction,45,25,20
Salazaros,die-silberne-hand,1545,warlock,destruction,66,37,29
Chubson,tarren-mill,1545,warlock,destruction,50,23,27
Gulleigh,draenor,1543,warlock,destruction,40,19,21
Rawsauce,outland,1542,warlock,destruction,20,17,3
Beerdurschd,antonidas,1541,warlock,destruction,35,24,11
Wÿvërnn,archimonde,1540,warlock,destruction,33,17,16
Frilante,terokkar,1537,warlock,destruction,86,55,31
Deathscréam,burning-legion,1537,warlock,destruction,96,48,48
Banelock,dentarg,1536,warlock,destruction,36,17,19
Alucena,silvermoon,1536,warlock,destruction,46,21,25
Anderxyo,sanguino,1535,warlock,destruction,24,16,8
Nkwango,blackmoore,1535,warlock,destruction,24,16,8
Cronice,ravencrest,1535,warlock,destruction,80,37,43
Bustabrinka,aggra-português,1534,warlock,destruction,18,16,2
Potatowl,ravencrest,1534,warlock,destruction,18,16,2
Dslap,grim-batol,1534,warlock,destruction,24,16,8
Михасяпевпев,gordunni,1534,warlock,destruction,27,17,10
Akumako,stormscale,1533,warlock,destruction,24,16,8
Shortyi,thrall,1533,warlock,destruction,24,16,8
Zloezlo,ravencrest,1533,warlock,destruction,124,63,61
Zamahell,marécage-de-zangar,1532,warlock,destruction,24,17,7
Höfmänn,kazzak,1532,warlock,destruction,55,35,20
Debz,twisting-nether,1531,warlock,destruction,25,16,9
Unrealia,hyjal,1530,warlock,destruction,126,68,58
Kvanmor,kaelthas,1530,warlock,destruction,60,29,31
Notben,outland,1529,warlock,destruction,18,16,2
Felcollíns,ravencrest,1529,warlock,destruction,24,16,8
Aoea,draenor,1529,warlock,destruction,24,16,8
Chyther,ragnaros,1528,warlock,destruction,42,26,16
Slëydark,sanguino,1528,warlock,destruction,32,17,15
Merdotz,outland,1527,warlock,destruction,28,19,9
Kerthan,malorne,1527,warlock,destruction,131,73,58
Jinxme,tarren-mill,1527,warlock,destruction,101,54,47
Cursedotexe,ragnaros,1527,warlock,destruction,60,32,28
Nospamcliqu,ysondre,1527,warlock,destruction,30,16,14
Dotxalot,blackrock,1526,warlock,destruction,40,27,13
Kiros,ravencrest,1526,warlock,destruction,24,16,8
Fullxlock,hyjal,1526,warlock,destruction,24,16,8
Шекигами,gordunni,1526,warlock,destruction,30,16,14
Kaedinx,twisting-nether,1524,warlock,destruction,365,188,177
Zéphon,blades-edge,1524,warlock,destruction,82,37,45
Nÿhf,kirin-tor,1523,warlock,destruction,47,21,26
Nebulus,lightnings-blade,1522,warlock,destruction,79,41,38
Sadixxqt,ravencrest,1521,warlock,destruction,24,16,8
Инкубычь,gordunni,1521,warlock,destruction,24,16,8
Nitecro,blackmoore,1521,warlock,destruction,43,23,20
Bisacodyl,outland,1521,warlock,destruction,101,53,48
Сорзи,thermaplugg,1521,warlock,destruction,41,20,21
Malinki,silvermoon,1521,warlock,destruction,42,20,22
Proßlock,kazzak,1521,warlock,destruction,116,54,62
Rohlikov,drakthul,1520,warlock,destruction,24,16,8
Zombpunk,sanguino,1520,warlock,destruction,45,28,17
Cencible,twisting-nether,1520,warlock,destruction,91,49,42
Exiled,dragonblight,1519,warlock,destruction,28,17,11
Героуд,howling-fjord,1519,warlock,destruction,141,75,66
Fatbëlly,argent-dawn,1518,warlock,destruction,97,47,50
Doomwrath,tarren-mill,1518,warlock,destruction,36,16,20
Perius,zuluhed,1518,warlock,destruction,42,18,24
Rozibolt,draenor,1517,warlock,destruction,24,16,8
Hasibe,ravencrest,1516,warlock,destruction,36,24,12
Vegetita,stormscale,1515,warlock,destruction,179,100,79
Robertóoo,burning-legion,1514,warlock,destruction,65,35,30
Lottopallo,arathor,1514,warlock,destruction,30,16,14
Lockteb,tarren-mill,1513,warlock,destruction,29,18,11
Usianbølts,blackmoore,1513,warlock,destruction,30,16,14
Маларгас,soulflayer,1512,warlock,destruction,132,72,60
Mellisandre,hellfire,1510,warlock,destruction,42,25,17
Artannas,elune,1508,warlock,destruction,31,19,12
Pipêz,blackmoore,1508,warlock,destruction,83,50,33
Darcîa,destromath,1507,warlock,destruction,30,19,11
Sertdene,ravencrest,1507,warlock,destruction,54,31,23
Пъё,howling-fjord,1507,warlock,destruction,101,46,55
Kasuni,sanguino,1507,warlock,destruction,72,30,42
Sylvxgodx,kazzak,1506,warlock,destruction,60,37,23
Чернокнжник,soulflayer,1506,warlock,destruction,42,22,20
Boccu,magtheridon,1504,warlock,destruction,66,37,29
Ностра,gordunni,1504,warlock,destruction,66,34,32
Hipiwl,silvermoon,1504,warlock,destruction,72,37,35
Abnørmus,tarren-mill,1503,warlock,destruction,78,46,32
Deruud,defias-brotherhood,1503,warlock,destruction,92,46,46
Alexutzu,sylvanas,1501,warlock,destruction,36,22,14
Enei,drakthul,1501,warlock,destruction,30,17,13
Tzeeñtch,tarren-mill,1501,warlock,destruction,65,31,34
Azaêl,azshara,1501,warlock,destruction,54,23,31
Auxi,the-maelstrom,1499,warlock,destruction,40,27,13
Dôtski,kazzak,1499,warlock,destruction,72,48,24
Voidislife,alakir,1499,warlock,destruction,201,104,97
Gillgarres,twisting-nether,1498,warlock,destruction,96,52,44
Nicodemo,tarren-mill,1498,warlock,destruction,30,16,14
Hokmor,blutkessel,1497,warlock,destruction,42,21,21
Lînden,magtheridon,1496,warlock,destruction,30,16,14
Interceptêr,blackrock,1496,warlock,destruction,36,18,18
Dxfive,tarren-mill,1495,warlock,destruction,30,19,11
Naemys,archimonde,1495,warlock,destruction,57,36,21
Marklock,drakthul,1495,warlock,destruction,62,38,24
Diåbló,stormscale,1495,warlock,destruction,126,72,54
Kïng,elune,1494,warlock,destruction,66,34,32
Balgo,blackmoore,1493,warlock,destruction,54,30,24
Mazaear,stormscale,1493,warlock,destruction,51,28,23
Jumbodot,tarren-mill,1493,warlock,destruction,44,23,21
Dotzéro,ravencrest,1493,warlock,destruction,42,21,21
Warlocat,the-maelstrom,1493,warlock,destruction,72,34,38
Белвет,blackscar,1493,warlock,destruction,63,29,34
Falel,das-konsortium,1492,warlock,destruction,24,19,5
Ноубрейкс,blackscar,1491,warlock,destruction,52,33,19
Ketriicken,argent-dawn,1490,warlock,destruction,96,51,45
Колдунишка,fordragon,1490,warlock,destruction,117,62,55
Chaosprophet,argent-dawn,1489,warlock,destruction,50,28,22
Brokengodx,dun-modr,1489,warlock,destruction,30,16,14
Fiveyearque,sylvanas,1489,warlock,destruction,36,16,20
Fêâr,dun-modr,1488,warlock,destruction,22,17,5
Zerøskil,blackrock,1488,warlock,destruction,24,16,8
Valcan,ragnaros,1488,warlock,destruction,85,49,36
Onetwobolt,archimonde,1487,warlock,destruction,133,68,65
Magicstick,eredar,1487,warlock,destruction,77,36,41
Kamí,sanguino,1487,warlock,destruction,65,30,35
Кулутха,soulflayer,1486,warlock,destruction,31,19,12
Scaevóla,ravencrest,1486,warlock,destruction,252,129,123
Diabló,outland,1485,warlock,destruction,36,18,18
Jaimê,thrall,1484,warlock,destruction,88,48,40
Asmonmald,stormscale,1484,warlock,destruction,178,93,85
Fearster,twisting-nether,1483,warlock,destruction,71,42,29
Xârtôr,blackrock,1482,warlock,destruction,176,96,80
Cronai,silvermoon,1482,warlock,destruction,33,18,15
Czx,twisting-nether,1479,warlock,destruction,36,22,14
Ammathrel,moonglade,1479,warlock,destruction,48,24,24
Inoculum,xavius,1478,warlock,destruction,30,16,14
Kiritsugi,aszune,1476,warlock,destruction,65,38,27
Иванфаков,soulflayer,1475,warlock,destruction,29,17,12
Zeddy,draenor,1475,warlock,destruction,120,67,53
Farlier,draenor,1474,warlock,destruction,95,47,48
Samyoung,kazzak,1472,warlock,destruction,66,38,28
Pufulet,sylvanas,1472,warlock,destruction,54,31,23
Егосяхаос,soulflayer,1472,warlock,destruction,84,42,42
Törtidotcom,blackrock,1472,warlock,destruction,42,20,22
Раздирающая,gordunni,1471,warlock,destruction,46,30,16
Èrmes,eldrethalas,1469,warlock,destruction,59,31,28
Бомбшелл,soulflayer,1469,warlock,destruction,38,17,21
Onono,eredar,1468,warlock,destruction,30,16,14
Lobotomic,argent-dawn,1467,warlock,destruction,33,21,12
Kartanos,stormscale,1466,warlock,destruction,23,16,7
Адоха,howling-fjord,1466,warlock,destruction,66,34,32
Сайзэр,soulflayer,1466,warlock,destruction,117,58,59
Wedlock,stormscale,1465,warlock,destruction,60,36,24
Bivör,blackmoore,1465,warlock,destruction,50,20,30
Holaw,tarren-mill,1464,warlock,destruction,84,41,43
Mvpðøtx,ravencrest,1463,warlock,destruction,45,28,17
Cørleen,eredar,1462,warlock,destruction,88,36,52
Snackstickz,twisting-nether,1461,warlock,destruction,48,25,23
Гуслин,soulflayer,1458,warlock,destruction,30,19,11
Spaså,kazzak,1458,warlock,destruction,42,23,19
Моориус,soulflayer,1458,warlock,destruction,48,23,25
Nedivh,stormscale,1458,warlock,destruction,47,22,25
Nokickplz,nemesis,1457,warlock,destruction,42,22,20
Wurdulock,silvermoon,1457,warlock,destruction,48,24,24
Horsewarlock,stormscale,1457,warlock,destruction,95,44,51
Sirmic,hyjal,1457,warlock,destruction,90,41,49
Aleê,twisting-nether,1454,warlock,destruction,47,23,24
Lockybàlboa,tarren-mill,1453,warlock,destruction,48,29,19
Moonpoxlock,nerathor,1453,warlock,destruction,38,20,18
Shaxlock,draenor,1451,warlock,destruction,82,43,39
Геролин,goldrinn,1451,warlock,destruction,61,30,31
Wicherson,burning-legion,1451,warlock,destruction,37,18,19
Banshore,ysondre,1450,warlock,destruction,47,29,18
Nerzhull,stormscale,1449,warlock,destruction,188,92,96
Алхун,razuvious,1447,warlock,destruction,72,36,36
Cazzo,burning-blade,1446,warlock,destruction,42,20,22
Shêrlöck,stormscale,1446,warlock,destruction,42,20,22
Nèrfxløl,ragnaros,1444,warlock,destruction,30,22,8
Trickyy,azjolnerub,1444,warlock,destruction,39,25,14
Helkásh,tarren-mill,1443,warlock,destruction,66,31,35
Stürmer,thrall,1442,warlock,destruction,60,32,28
Birimbau,outland,1442,warlock,destruction,67,32,35
Scrim,laughing-skull,1441,warlock,destruction,50,34,16
Smoudini,blackrock,1439,warlock,destruction,24,15,9
Простишуткаь,gordunni,1439,warlock,destruction,24,15,9
Fearbeachx,ravencrest,1438,warlock,destruction,24,15,9
Mowxll,blackrock,1438,warlock,destruction,24,15,9
Dzimmi,kazzak,1438,warlock,destruction,42,22,20
Ignorantduck,sunstrider,1438,warlock,destruction,51,25,26
Навидд,howling-fjord,1437,warlock,destruction,24,15,9
Igneutz,twisting-nether,1437,warlock,destruction,24,15,9
Nádjá,ravencrest,1437,warlock,destruction,24,15,9
Thugsupreme,ravencrest,1437,warlock,destruction,78,41,37
Veoxohr,argent-dawn,1436,warlock,destruction,99,60,39
Iriepathie,nozdormu,1436,warlock,destruction,30,16,14
Holeraa,stormscale,1436,warlock,destruction,110,58,52
Rhss,stormscale,1436,warlock,destruction,30,15,15
Elldialock,draenor,1436,warlock,destruction,30,15,15
Fearoclock,nemesis,1435,warlock,destruction,30,15,15
Fynxo,blackmoore,1433,warlock,destruction,24,16,8
Noxsix,gorgonnash,1433,warlock,destruction,54,28,26
Vulluin,blackrock,1433,warlock,destruction,30,15,15
Calli,blackrock,1432,warlock,destruction,22,16,6
Datendariza,kazzak,1432,warlock,destruction,104,53,51
Horridum,draenor,1432,warlock,destruction,42,16,26
Flockyy,draenor,1431,warlock,destruction,28,16,12
Pouletmicuie,archimonde,1431,warlock,destruction,50,26,24
Slavecry,silvermoon,1430,warlock,destruction,24,15,9
Trâsto,cthun,1430,warlock,destruction,24,15,9
Softcøre,blackmoore,1430,warlock,destruction,48,29,19
Cráxx,onyxia,1430,warlock,destruction,175,89,86
Peardrax,draenor,1430,warlock,destruction,67,34,33
Blackwizard,theradras,1429,warlock,destruction,81,42,39
Antoniolm,cthun,1429,warlock,destruction,54,27,27
Kwoh,saurfang,1429,warlock,destruction,30,15,15
Koonlock,kazzak,1428,warlock,destruction,43,22,21
Misscringe,silvermoon,1428,warlock,destruction,54,23,31
Micheller,ravencrest,1427,warlock,destruction,24,15,9
Xoraith,runetotem,1426,warlock,destruction,24,15,9
Gango,outland,1426,warlock,destruction,29,18,11
Gigabolt,turalyon,1426,warlock,destruction,30,17,13
Lewdrumpslap,kazzak,1425,warlock,destruction,48,31,17
Gengada,blackhand,1425,warlock,destruction,48,26,22
Nosoulnoprob,sylvanas,1425,warlock,destruction,48,24,24
Puppylover,outland,1424,warlock,destruction,30,21,9
Shufflous,ghostlands,1424,warlock,destruction,28,16,12
Bte,draenor,1424,warlock,destruction,34,19,15
Krukke,tarren-mill,1424,warlock,destruction,54,28,26
Sesoumaru,azshara,1424,warlock,destruction,42,16,26
Vimb,archimonde,1423,warlock,destruction,30,15,15
Danishpistol,draenor,1423,warlock,destruction,30,15,15
Belnea,draenor,1421,warlock,destruction,24,15,9
Nibblez,shadowsong,1421,warlock,destruction,119,65,54
Ablas,bladefist,1421,warlock,destruction,118,53,65
Míkæ,ravencrest,1420,warlock,destruction,90,49,41
Demonkïng,archimonde,1420,warlock,destruction,60,32,28
Сатенекс,soulflayer,1419,warlock,destruction,59,36,23
Diablotiin,hyjal,1419,warlock,destruction,239,122,117
Eatmabolt,alleria,1417,warlock,destruction,30,18,12
Mty,bronze-dragonflight,1417,warlock,destruction,53,28,25
Bruzzlbube,blackhand,1417,warlock,destruction,30,15,15
Diablesse,dun-modr,1417,warlock,destruction,62,30,32
Rakoru,blackmoore,1416,warlock,destruction,30,15,15
Waandi,ravencrest,1415,warlock,destruction,34,20,14
Wauwish,stormscale,1415,warlock,destruction,47,27,20
Zöyarüm,outland,1414,warlock,destruction,30,16,14
Мирмех,gordunni,1414,warlock,destruction,42,21,21
Sublînê,blackmoore,1413,warlock,destruction,99,58,41
Barro,das-syndikat,1410,warlock,destruction,32,17,15
Holodream,stormreaver,1410,warlock,destruction,78,38,40
Бирел,soulflayer,1409,warlock,destruction,24,15,9
Azzoaa,defias-brotherhood,1408,warlock,destruction,60,29,31
Chroll,nerathor,1407,warlock,destruction,46,32,14
Naavii,bloodscalp,1407,warlock,destruction,42,21,21
Natsume,ragnaros,1407,warlock,destruction,43,21,22
Backdrip,ragnaros,1406,warlock,destruction,37,21,16
Kumas,hyjal,1406,warlock,destruction,30,16,14
Xârdâs,blackrock,1406,warlock,destruction,30,15,15
Zlohell,drakthul,1405,warlock,destruction,48,30,18
Kospar,dun-morogh,1405,warlock,destruction,93,50,43
Evaksiá,draenor,1405,warlock,destruction,48,23,25
Smadrekas,ravencrest,1404,warlock,destruction,58,25,33
Enydible,frostmane,1403,warlock,destruction,24,15,9
Proctolock,garona,1403,warlock,destruction,34,20,14
Skruios,anetheron,1403,warlock,destruction,64,35,29
Азерок,howling-fjord,1403,warlock,destruction,42,21,21
Zeelotko,drakthul,1401,warlock,destruction,54,32,22
Dotacy,kazzak,1400,warlock,destruction,30,15,15
Гупперлок,howling-fjord,1400,warlock,destruction,48,21,27
Faro,trollbane,1398,warlock,destruction,98,42,56
Kar,haomarush,1398,warlock,destruction,42,17,25
Nomakqlock,dun-modr,1397,warlock,destruction,36,23,13
Вроман,fordragon,1397,warlock,destruction,80,47,33
Dhraven,thrall,1395,warlock,destruction,96,53,43
Dobonard,sylvanas,1395,warlock,destruction,38,19,19
Rhaelgar,kazzak,1395,warlock,destruction,30,15,15
Tomiaa,burning-legion,1395,warlock,destruction,36,15,21
Fandusttwo,drakthul,1394,warlock,destruction,30,16,14
Satanizm,silvermoon,1393,warlock,destruction,95,46,49
Kolosh,twisting-nether,1392,warlock,destruction,24,15,9
Ghostflame,tarren-mill,1392,warlock,destruction,34,19,15
Çhãøsførÿã,blackmoore,1392,warlock,destruction,90,43,47
Warlockholms,archimonde,1391,warlock,destruction,24,15,9
Pogrom,burning-legion,1391,warlock,destruction,36,21,15
Chaoxz,outland,1391,warlock,destruction,54,31,23
Шелруа,howling-fjord,1390,warlock,destruction,52,31,21
Pommeslock,blackmoore,1390,warlock,destruction,42,20,22
Seagelock,silvermoon,1390,warlock,destruction,78,36,42
Zollon,norgannon,1389,warlock,destruction,23,17,6
Corbiejr,tarren-mill,1389,warlock,destruction,98,62,36
Zivalelia,silvermoon,1389,warlock,destruction,102,49,53
Яжбатько,howling-fjord,1389,warlock,destruction,36,15,21
Lynchian,draenor,1387,warlock,destruction,49,26,23
Gehirnwäsche,frostwolf,1385,warlock,destruction,28,18,10
Dracsu,dun-modr,1383,warlock,destruction,49,26,23
Unkash,zuljin,1382,warlock,destruction,102,57,45
Boomlock,dun-morogh,1382,warlock,destruction,42,17,25
Калестонх,soulflayer,1380,warlock,destruction,42,25,17
Dreadnogg,tarren-mill,1380,warlock,destruction,100,50,50
Kosfáce,tarren-mill,1377,warlock,destruction,77,35,42
Adoy,tarren-mill,1375,warlock,destruction,54,31,23
Galardodric,outland,1373,warlock,destruction,30,16,14
Lucifa,arthas,1371,warlock,destruction,36,17,19
Pookabee,ravencrest,1369,warlock,destruction,36,19,17
Sidragasoss,drakthul,1369,warlock,destruction,30,15,15
Cahetel,nemesis,1368,warlock,destruction,47,24,23
Kaamosliha,frostwhisper,1367,warlock,destruction,52,29,23
Biotic,dun-modr,1366,warlock,destruction,36,16,20
Эот,soulflayer,1365,warlock,destruction,27,16,11
Vakgu,blackmoore,1362,warlock,destruction,47,28,19
Hamskurken,silvermoon,1362,warlock,destruction,28,15,13
Nyriat,tarren-mill,1361,warlock,destruction,24,16,8
Quasimodó,aegwynn,1361,warlock,destruction,48,29,19
Salastro,ragnaros,1361,warlock,destruction,27,15,12
Gricorby,drakthul,1360,warlock,destruction,23,16,7
Uelimueli,onyxia,1360,warlock,destruction,53,23,30
Lockedaway,ravencrest,1359,warlock,destruction,42,22,20
Noctiz,pozzo-delleternità,1358,warlock,destruction,73,36,37
Islazoldyck,draenor,1356,warlock,destruction,78,33,45
Demoz,sanguino,1354,warlock,destruction,70,40,30
Voltadol,dun-modr,1353,warlock,destruction,126,65,61
Emalk,tarren-mill,1353,warlock,destruction,36,15,21
Boltexpert,twisting-nether,1351,warlock,destruction,30,15,15
Zzombie,sylvanas,1350,warlock,destruction,38,17,21
Mîjagî,blackhand,1349,warlock,destruction,60,36,24
Zesekk,blackmoore,1349,warlock,destruction,54,20,34
Soulgünter,blackmoore,1348,warlock,destruction,40,27,13
Disrupted,blackmoore,1348,warlock,destruction,30,16,14
Hell,twisting-nether,1347,warlock,destruction,54,22,32
Bankley,khaz-modan,1346,warlock,destruction,42,21,21
Talindra,stormscale,1345,warlock,destruction,50,28,22
Warlockgødx,silvermoon,1345,warlock,destruction,66,36,30
Простшутка,gordunni,1344,warlock,destruction,18,14,4
Nerokin,blackrock,1344,warlock,destruction,60,41,19
Plocke,aegwynn,1344,warlock,destruction,24,14,10
Potatowl,ragnaros,1344,warlock,destruction,24,14,10
Maxiabe,hyjal,1344,warlock,destruction,54,27,27
Kokainas,dun-modr,1344,warlock,destruction,36,18,18
Dotloca,draenor,1344,warlock,destruction,30,15,15
Freshademic,tarren-mill,1343,warlock,destruction,18,14,4
Bowti,ravencrest,1343,warlock,destruction,64,40,24
Anthraxus,argent-dawn,1343,warlock,destruction,24,14,10
Setyouinfear,ravencrest,1343,warlock,destruction,30,14,16
Mudwalkin,ravencrest,1343,warlock,destruction,30,14,16
Britnèyfears,twisting-nether,1343,warlock,destruction,30,14,16
Happsõr,eredar,1342,warlock,destruction,18,14,4
Ghastlyy,aggra-português,1342,warlock,destruction,18,14,4
Odenbest,silvermoon,1342,warlock,destruction,24,14,10
Badapow,stormscale,1342,warlock,destruction,24,14,10
Nanotrik,draenor,1342,warlock,destruction,24,14,10
Cigänä,archimonde,1342,warlock,destruction,24,14,10
Verderbnis,malganis,1341,warlock,destruction,53,31,22
Haltros,stormscale,1341,warlock,destruction,24,14,10
Gravemxney,tarren-mill,1341,warlock,destruction,24,14,10
Mompets,stormscale,1341,warlock,destruction,36,14,22
Fearu,kazzak,1340,warlock,destruction,18,14,4
Zacurse,kazzak,1340,warlock,destruction,48,28,20
Khano,twisting-nether,1340,warlock,destruction,75,38,37
Love,alexstrasza,1339,warlock,destruction,30,18,12
Flaming,ravencrest,1339,warlock,destruction,24,14,10
Dimmybyrger,stormreaver,1339,warlock,destruction,30,14,16
Wazze,azuremyst,1338,warlock,destruction,23,15,8
Ryurans,cthun,1338,warlock,destruction,98,49,49
Кварий,howling-fjord,1337,warlock,destruction,36,14,22
Gyroib,stormscale,1335,warlock,destruction,23,15,8
Cyanur,silvermoon,1335,warlock,destruction,24,14,10
Póssiblyreef,silvermoon,1334,warlock,destruction,24,14,10
Rúbedo,thrall,1334,warlock,destruction,24,14,10
Boglock,argent-dawn,1333,warlock,destruction,24,14,10
Fivestars,tarren-mill,1332,warlock,destruction,40,20,20
Vincewl,ravencrest,1330,warlock,destruction,36,16,20
Talriun,kazzak,1330,warlock,destruction,38,16,22
Mooncrushed,stormscale,1329,warlock,destruction,18,14,4
Ínsidióus,tarren-mill,1329,warlock,destruction,24,14,10
Lyconidas,magtheridon,1329,warlock,destruction,24,14,10
Dieger,thunderhorn,1328,warlock,destruction,24,14,10
Äsmødée,dalaran,1328,warlock,destruction,54,31,23
Nàughty,ragnaros,1328,warlock,destruction,67,28,39
Stonysalami,turalyon,1327,warlock,destruction,41,28,13
Benzakenta,sylvanas,1327,warlock,destruction,24,14,10
Кискатёмная,blackscar,1327,warlock,destruction,60,30,30
Problemchild,sunstrider,1324,warlock,destruction,30,19,11
Carthagî,blackmoore,1324,warlock,destruction,48,30,18
Xshay,dun-modr,1324,warlock,destruction,45,16,29
Sneps,azshara,1323,warlock,destruction,24,14,10
Melow,sanguino,1323,warlock,destruction,44,21,23
Микурочка,gordunni,1323,warlock,destruction,59,25,34
Xtkeks,blackmoore,1322,warlock,destruction,24,14,10
Эннинотбэд,howling-fjord,1322,warlock,destruction,29,14,15
Kromosonen,ravencrest,1322,warlock,destruction,36,15,21
Арцах,soulflayer,1321,warlock,destruction,36,16,20
Elhäbedehä,blackrock,1319,warlock,destruction,18,14,4
Nhéon,archimonde,1319,warlock,destruction,24,14,10
Ymersai,stormscale,1318,warlock,destruction,71,36,35
Mempricious,ravencrest,1318,warlock,destruction,30,14,16
Exitumos,eredar,1316,warlock,destruction,24,14,10
Mohawkyz,chamber-of-aspects,1316,warlock,destruction,32,17,15
Tuz,blackrock,1316,warlock,destruction,90,40,50
Plööp,malganis,1315,warlock,destruction,92,47,45
Олдхалапеньо,soulflayer,1314,warlock,destruction,54,24,30
Ghostfiend,tarren-mill,1313,warlock,destruction,21,15,6
Baalthazar,jaedenar,1312,warlock,destruction,24,15,9
Demirchayan,twisting-nether,1312,warlock,destruction,66,41,25
Dìablò,sylvanas,1312,warlock,destruction,60,35,25
Chram,uldum,1311,warlock,destruction,53,33,20
Starlok,nemesis,1309,warlock,destruction,23,14,9
Somanydots,twisting-nether,1309,warlock,destruction,90,44,46
Rotinhell,kazzak,1309,warlock,destruction,123,57,66
Divvaa,tarren-mill,1308,warlock,destruction,94,45,49
Altffeer,blackmoore,1307,warlock,destruction,30,14,16
Блэкмайндер,howling-fjord,1306,warlock,destruction,38,23,15
Kìnvaras,tarren-mill,1305,warlock,destruction,22,15,7
Sinsemilla,turalyon,1305,warlock,destruction,47,24,23
Лоредо,howling-fjord,1304,warlock,destruction,38,15,23
Shadeshanox,blackmoore,1302,warlock,destruction,36,23,13
Lokajci,outland,1302,warlock,destruction,37,22,15
Øpaco,khazgoroth,1302,warlock,destruction,42,17,25
Covariance,nemesis,1302,warlock,destruction,36,14,22
Janemba,ysondre,1300,warlock,destruction,30,14,16
Fêars,blackrock,1299,warlock,destruction,62,34,28
Kïrah,ysondre,1299,warlock,destruction,62,24,38
Lodem,darksorrow,1298,warlock,destruction,36,15,21
Sîlverdîze,thrall,1297,warlock,destruction,53,29,24
Pensiblesie,runetotem,1297,warlock,destruction,456,224,232
Мамкадгара,howling-fjord,1297,warlock,destruction,29,14,15
Dexterr,sylvanas,1295,warlock,destruction,110,55,55
Cardinall,drakthul,1295,warlock,destruction,48,24,24
Ädarä,cthun,1294,warlock,destruction,60,30,30
Arnoediad,twisting-nether,1291,warlock,destruction,39,18,21
Azrail,anubarak,1290,warlock,destruction,66,31,35
Биохозард,deathguard,1289,warlock,destruction,81,41,40
Galath,wrathbringer,1289,warlock,destruction,64,32,32
Sorxez,thrall,1287,warlock,destruction,54,25,29
Drillingsdad,dun-morogh,1282,warlock,destruction,42,20,22
Парачо,eversong,1280,warlock,destruction,34,15,19
Patirass,sanguino,1279,warlock,destruction,36,20,16
Sylrathas,burning-legion,1279,warlock,destruction,75,41,34
Docik,kazzak,1279,warlock,destruction,31,15,16
Southylol,stormscale,1278,warlock,destruction,17,14,3
Terris,khaz-modan,1278,warlock,destruction,81,40,41
Nopower,dun-morogh,1277,warlock,destruction,35,20,15
Denasty,nemesis,1277,warlock,destruction,28,14,14
Demohoror,stormscale,1276,warlock,destruction,42,20,22
Felbunni,silvermoon,1276,warlock,destruction,69,31,38
Easybolt,blackrock,1276,warlock,destruction,32,14,18
Chaotìc,nemesis,1275,warlock,destruction,24,18,6
Ocaya,kazzak,1275,warlock,destruction,30,16,14
Гринлайм,howling-fjord,1274,warlock,destruction,33,19,14
Dreamage,exodar,1274,warlock,destruction,54,27,27
Делегент,deathguard,1272,warlock,destruction,84,34,50
Shinamna,tarren-mill,1270,warlock,destruction,30,15,15
Mavelya,blackmoore,1266,warlock,destruction,40,17,23
Чиназис,gordunni,1265,warlock,destruction,102,49,53
Sovrìn,blackrock,1264,warlock,destruction,20,14,6
Tsumde,dalaran,1264,warlock,destruction,86,43,43
Proflock,drakthul,1264,warlock,destruction,36,18,18
Tabarnak,archimonde,1264,warlock,destruction,30,14,16
Jossim,outland,1263,warlock,destruction,66,38,28
Necrolock,tarren-mill,1263,warlock,destruction,47,23,24
Гангстахохо,soulflayer,1263,warlock,destruction,40,16,24
Voiyane,silvermoon,1261,warlock,destruction,30,14,16
Xoram,kult-der-verdammten,1260,warlock,destruction,24,15,9
Хиёрис,eversong,1260,warlock,destruction,51,29,22
Symbiosis,kazzak,1260,warlock,destruction,102,50,52
Julsey,kazzak,1259,warlock,destruction,17,14,3
Дольпико,howling-fjord,1259,warlock,destruction,30,16,14
Üserper,chamber-of-aspects,1259,warlock,destruction,143,64,79
Mefistto,drakthul,1258,warlock,destruction,24,14,10
Zuyox,silvermoon,1256,warlock,destruction,53,22,31
Blackjackk,tarren-mill,1256,warlock,destruction,72,27,45
Вешка,azuregos,1254,warlock,destruction,21,14,7
Maveri,tarren-mill,1254,warlock,destruction,33,16,17
Untactful,tarren-mill,1253,warlock,destruction,53,31,22
Hárdí,tarren-mill,1252,warlock,destruction,18,14,4
Jobbymancer,twisting-nether,1252,warlock,destruction,42,25,17
Askanios,twisting-nether,1252,warlock,destruction,61,34,27
Oxsen,hyjal,1249,warlock,destruction,54,26,28
Scherzinger,archimonde,1248,warlock,destruction,18,13,5
Thesnakë,ravencrest,1248,warlock,destruction,18,13,5
Calypso,korgall,1248,warlock,destruction,24,13,11
Dotg,blackrock,1247,warlock,destruction,24,13,11
Dobromír,kazzak,1247,warlock,destruction,24,13,11
Shiammetrý,kazzak,1247,warlock,destruction,24,13,11
Rizzbolt,ravencrest,1247,warlock,destruction,99,49,50
Lokibra,antonidas,1247,warlock,destruction,90,42,48
Kresyda,dun-modr,1247,warlock,destruction,30,13,17
Thorolock,blackhand,1246,warlock,destruction,18,13,5
Osyx,ravencrest,1246,warlock,destruction,28,15,13
Hardnes,kazzak,1246,warlock,destruction,30,13,17
Rünek,tarren-mill,1245,warlock,destruction,18,13,5
Morrowgleam,outland,1245,warlock,destruction,18,13,5
Shutdown,sylvanas,1245,warlock,destruction,42,26,16
Pherlet,sylvanas,1245,warlock,destruction,24,13,11
Boltgodx,thrall,1245,warlock,destruction,24,13,11
Zuldanius,stormscale,1245,warlock,destruction,24,13,11
Withered,nagrand,1244,warlock,destruction,18,13,5
Bellicus,tarren-mill,1244,warlock,destruction,18,13,5
Krachol,emeriss,1244,warlock,destruction,24,13,11
Fidlesticks,ragnaros,1244,warlock,destruction,33,15,18
Dreggsow,blackmoore,1243,warlock,destruction,18,13,5
Hannahowo,garona,1243,warlock,destruction,24,13,11
Cajnik,sylvanas,1242,warlock,destruction,24,13,11
Filianore,azjolnerub,1242,warlock,destruction,61,28,33
Salouppio,archimonde,1242,warlock,destruction,30,13,17
Lacape,dalaran,1241,warlock,destruction,18,13,5
Cursecannon,outland,1241,warlock,destruction,18,13,5
Pyroplasmic,tarren-mill,1241,warlock,destruction,65,40,25
Dreameater,twilights-hammer,1240,warlock,destruction,24,13,11
Drfóx,draenor,1240,warlock,destruction,41,16,25
Запрещаю,galakrond,1239,warlock,destruction,66,30,36
Ragequit,xavius,1238,warlock,destruction,24,13,11
Unstablemind,nemesis,1238,warlock,destruction,27,14,13
Mootay,drekthar,1237,warlock,destruction,24,13,11
Sepulturá,thrall,1237,warlock,destruction,24,13,11
Darkeds,dun-modr,1237,warlock,destruction,24,13,11
Локкрис,blackscar,1237,warlock,destruction,74,38,36
Møärdötd,aggra-português,1236,warlock,destruction,18,13,5
Thorenss,medivh,1235,warlock,destruction,72,35,37
Siyruz,eredar,1234,warlock,destruction,24,13,11
Apôpis,archimonde,1233,warlock,destruction,30,17,13
Demojun,silvermoon,1233,warlock,destruction,30,13,17
Zhoxx,outland,1233,warlock,destruction,30,13,17
Oloki,kazzak,1232,warlock,destruction,56,29,27
Asmodaî,anubarak,1232,warlock,destruction,71,36,35
Crysy,confrérie-du-thorium,1232,warlock,destruction,30,13,17
Bottmbolt,blackhand,1231,warlock,destruction,25,13,12
Инсип,blackscar,1230,warlock,destruction,24,14,10
Левсекси,eversong,1230,warlock,destruction,27,14,13
Карьерщица,booty-bay,1230,warlock,destruction,79,40,39
Keibo,drakthul,1228,warlock,destruction,30,13,17
Rottend,aggra-português,1228,warlock,destruction,81,35,46
Wolferand,argent-dawn,1228,warlock,destruction,42,17,25
Trollgubbe,twilights-hammer,1225,warlock,destruction,18,13,5
Dubbzy,outland,1223,warlock,destruction,32,15,17
Eotlid,shattered-hand,1221,warlock,destruction,24,13,11
Гулдас,thermaplugg,1221,warlock,destruction,42,21,21
Diseased,darksorrow,1219,warlock,destruction,96,57,39
Chickoz,eredar,1219,warlock,destruction,103,54,49
Babayagâ,sanguino,1218,warlock,destruction,24,14,10
Stunspectoo,turalyon,1217,warlock,destruction,24,17,7
Westfaliu,blackhand,1217,warlock,destruction,66,24,42
Borrìs,blackhand,1216,warlock,destruction,160,83,77
Oldemoilépti,hyjal,1216,warlock,destruction,30,14,16
Gigoberto,kazzak,1214,warlock,destruction,23,13,10
Эктос,soulflayer,1213,warlock,destruction,18,13,5
Puiia,draenor,1212,warlock,destruction,33,20,13
Artyrus,burning-legion,1212,warlock,destruction,96,49,47
Guntok,tarren-mill,1211,warlock,destruction,37,22,15
Senaida,sylvanas,1211,warlock,destruction,70,40,30
Dominvs,silvermoon,1211,warlock,destruction,42,17,25
Vulgrim,kirin-tor,1208,warlock,destruction,57,27,30
Oxypvp,ravencrest,1207,warlock,destruction,51,19,32
Fredysimo,silvermoon,1206,warlock,destruction,18,13,5
Sargal,sylvanas,1206,warlock,destruction,30,13,17
Lokko,nemesis,1205,warlock,destruction,42,23,19
Xhartus,argent-dawn,1205,warlock,destruction,30,13,17
Valkiá,earthen-ring,1203,warlock,destruction,42,20,22
Ayóó,doomhammer,1202,warlock,destruction,107,58,49
Pekkoperkele,ravenholdt,1202,warlock,destruction,66,29,37
Aurelíá,ravencrest,1201,warlock,destruction,29,13,16
Hyphonos,blackmoore,1199,warlock,destruction,26,14,12
Bløødwins,burning-legion,1198,warlock,destruction,17,13,4
Íntikam,blackrock,1198,warlock,destruction,30,15,15
Kneereap,antonidas,1197,warlock,destruction,30,17,13
Nicolino,doomhammer,1196,warlock,destruction,48,27,21
Zenondoros,arthas,1195,warlock,destruction,21,13,8
Зюзерг,soulflayer,1195,warlock,destruction,30,14,16
Dededimons,stormscale,1193,warlock,destruction,68,32,36
Maxxilla,twisting-nether,1191,warlock,destruction,173,84,89
Emoriy,blackmoore,1190,warlock,destruction,64,34,30
Binkybabes,outland,1190,warlock,destruction,39,18,21
Plague,twisting-nether,1188,warlock,destruction,27,14,13
Neffy,sinstralis,1188,warlock,destruction,76,31,45
Neetlock,suramar,1185,warlock,destruction,30,14,16
Idleglance,outland,1181,warlock,destruction,17,13,4
Vitrolizz,twilights-hammer,1181,warlock,destruction,32,13,19
Присесть,razuvious,1180,warlock,destruction,27,15,12
Insanely,kazzak,1179,warlock,destruction,81,45,36
Kääk,sylvanas,1178,warlock,destruction,60,29,31
Kaeos,ravencrest,1176,warlock,destruction,24,15,9
Niszoght,dun-modr,1172,warlock,destruction,65,40,25
Lovrog,twisting-nether,1169,warlock,destruction,21,13,8
Wildo,grim-batol,1169,warlock,destruction,24,14,10
Arkatraz,blackhand,1165,warlock,destruction,42,19,23
Loptous,dunemaul,1160,warlock,destruction,25,14,11
Saereda,kazzak,1160,warlock,destruction,42,20,22
Kritcheq,alakir,1156,warlock,destruction,98,48,50
Modzal,kazzak,1155,warlock,destruction,24,13,11
Hulagirl,ravencrest,1152,warlock,destruction,18,12,6
Dotjürgen,blackrock,1152,warlock,destruction,18,12,6
Youngtyrant,blackrock,1152,warlock,destruction,18,12,6
Noskillfox,outland,1152,warlock,destruction,18,12,6
Ekàti,ravencrest,1152,warlock,destruction,24,12,12
Purplemafia,burning-blade,1152,warlock,destruction,24,12,12
Ánderx,dun-modr,1152,warlock,destruction,24,12,12
Teiser,nemesis,1152,warlock,destruction,24,12,12
Вайнпрессх,gordunni,1152,warlock,destruction,30,12,18
Консидёро,gordunni,1152,warlock,destruction,30,12,18
Hifiz,grim-batol,1151,warlock,destruction,18,12,6
Hasselbalch,azshara,1151,warlock,destruction,18,12,6
Элси,howling-fjord,1151,warlock,destruction,18,12,6
Leman,sylvanas,1151,warlock,destruction,18,12,6
Cloud,kazzak,1151,warlock,destruction,18,12,6
Jkz,blackrock,1151,warlock,destruction,21,13,8
Wspolnax,ravencrest,1151,warlock,destruction,24,12,12
Wìtçhßlåðes,ysondre,1151,warlock,destruction,24,12,12
Nightìngale,silvermoon,1151,warlock,destruction,24,12,12
Kikaikek,stormscale,1150,warlock,destruction,18,12,6
Zenii,nemesis,1150,warlock,destruction,18,12,6
Shazem,tarren-mill,1150,warlock,destruction,18,12,6
Estefanía,tarren-mill,1150,warlock,destruction,18,12,6
Scadar,kazzak,1149,warlock,destruction,18,12,6
Steelock,kazzak,1149,warlock,destruction,21,13,8
Gravedîgger,aggra-português,1149,warlock,destruction,24,12,12
Мегаклещ,soulflayer,1149,warlock,destruction,24,12,12
Felgød,ravencrest,1149,warlock,destruction,24,12,12
Maikus,stormscale,1148,warlock,destruction,18,12,6
Mignetto,nemesis,1148,warlock,destruction,18,12,6
Aljohno,twisting-nether,1148,warlock,destruction,24,12,12
Sushilock,stormrage,1147,warlock,destruction,18,12,6
Felhaen,silvermoon,1147,warlock,destruction,24,12,12
Sædotern,stormscale,1147,warlock,destruction,24,12,12
Flumez,stormscale,1146,warlock,destruction,12,12,0
Favorizlmp,archimonde,1146,warlock,destruction,24,12,12
Solomohn,steamwheedle-cartel,1145,warlock,destruction,18,13,5
Postymalony,kazzak,1145,warlock,destruction,18,12,6
Falock,tarren-mill,1145,warlock,destruction,18,12,6
Sippe,laughing-skull,1145,warlock,destruction,24,12,12
Ezdotggwp,stormscale,1145,warlock,destruction,24,12,12
Puujäbäxd,stormscale,1145,warlock,destruction,30,12,18
Mortuáry,drakthul,1144,warlock,destruction,24,12,12
Jinxzed,frostwhisper,1143,warlock,destruction,18,12,6
Гулдарий,howling-fjord,1143,warlock,destruction,136,72,64
Smileyfacè,silvermoon,1143,warlock,destruction,42,12,30
Toliver,drakthul,1142,warlock,destruction,18,12,6
Зажиженный,soulflayer,1142,warlock,destruction,21,12,9
Воттоваара,azuregos,1142,warlock,destruction,24,12,12
Línkéd,blackmoore,1142,warlock,destruction,30,12,18
Хубаскис,soulflayer,1141,warlock,destruction,24,12,12
Orisess,bronze-dragonflight,1140,warlock,destruction,95,53,42
Hymirr,arathor,1140,warlock,destruction,31,12,19
Trivalis,frostwolf,1139,warlock,destruction,24,12,12
Fathernurgle,hellfire,1138,warlock,destruction,79,42,37
Parley,frostmane,1138,warlock,destruction,30,12,18
Halacska,arathor,1137,warlock,destruction,24,12,12
Скул,soulflayer,1137,warlock,destruction,30,12,18
Kamehamehaa,stormscale,1136,warlock,destruction,18,12,6
Féar,doomhammer,1136,warlock,destruction,24,12,12
Pcbbwarlock,sylvanas,1136,warlock,destruction,30,12,18
Rampelnicka,burning-blade,1135,warlock,destruction,24,12,12
Mîtskî,argent-dawn,1132,warlock,destruction,38,17,21
Harrykan,blackrock,1130,warlock,destruction,18,12,6
Kresnyk,kazzak,1130,warlock,destruction,23,12,11
Toffifae,argent-dawn,1129,warlock,destruction,18,12,6
Fiendy,tarren-mill,1129,warlock,destruction,24,12,12
Riitaall,khaz-modan,1125,warlock,destruction,49,18,31
Marann,dun-morogh,1122,warlock,destruction,38,25,13
Darkà,rexxar,1121,warlock,destruction,24,13,11
Soultwist,twisting-nether,1120,warlock,destruction,30,12,18
Shagrab,nemesis,1119,warlock,destruction,33,17,16
Paranoid,sylvanas,1119,warlock,destruction,24,12,12
Fiddlock,draenor,1117,warlock,destruction,22,13,9
Lánfeár,draenor,1114,warlock,destruction,29,12,17
Yhwäch,archimonde,1114,warlock,destruction,30,12,18
Shadowbolt,outland,1104,warlock,destruction,27,12,15
Règis,antonidas,1102,warlock,destruction,21,13,8
Schöp,der-rat-von-dalaran,1101,warlock,destruction,34,16,18
Sicktir,aerie-peak,1101,warlock,destruction,34,14,20
Fromfuneral,anetheron,1093,warlock,destruction,107,60,47
Cozyboi,thrall,1091,warlock,destruction,165,82,83
Buserella,eredar,1085,warlock,destruction,30,12,18
Atruruz,antonidas,1084,warlock,destruction,65,32,33
Öyo,outland,1084,warlock,destruction,132,64,68
Vendømlørd,archimonde,1083,warlock,destruction,36,12,24
Бигтедок,gordunni,1079,warlock,destruction,158,80,78
Ruul,sanguino,1079,warlock,destruction,50,20,30
Tchytcha,archimonde,1078,warlock,destruction,30,17,13
Makaspam,stormscale,1074,warlock,destruction,34,12,22
Pff,emeriss,1073,warlock,destruction,29,16,13
Jinckslock,anachronos,1072,warlock,destruction,13,12,1
Wuhdun,burning-legion,1072,warlock,destruction,29,12,17
Thicklock,twisting-nether,1071,warlock,destruction,24,12,12
Whitebanshee,turalyon,1069,warlock,destruction,36,21,15
Jimbrown,eredar,1066,warlock,destruction,22,12,10
Batráz,tarren-mill,1059,warlock,destruction,78,31,47
Bk,alexstrasza,1056,warlock,destruction,12,11,1
Datty,grim-batol,1056,warlock,destruction,12,11,1
Hexiønløck,archimonde,1056,warlock,destruction,12,11,1
Oarz,blackrock,1056,warlock,destruction,18,11,7
Catchlock,tarren-mill,1056,warlock,destruction,18,11,7
Tessalizz,aegwynn,1056,warlock,destruction,18,11,7
Secretx,kazzak,1056,warlock,destruction,18,11,7
Незерлок,soulflayer,1056,warlock,destruction,18,11,7
Dotbotx,grim-batol,1056,warlock,destruction,18,11,7
Кремация,blackscar,1056,warlock,destruction,18,11,7
Fjutta,outland,1056,warlock,destruction,18,11,7
Flayør,ravencrest,1056,warlock,destruction,18,11,7
Sizexl,silvermoon,1056,warlock,destruction,18,11,7
Rénna,twisting-nether,1056,warlock,destruction,18,11,7
Rüjï,sanguino,1056,warlock,destruction,54,19,35
Deadmoneyz,twisting-nether,1055,warlock,destruction,12,11,1
Kawanoski,kazzak,1055,warlock,destruction,12,11,1
Trooverx,ravencrest,1055,warlock,destruction,12,11,1
Resterx,blackhand,1055,warlock,destruction,12,11,1
Веберх,howling-fjord,1055,warlock,destruction,18,11,7
Razzalock,eredar,1055,warlock,destruction,18,11,7
Collectiòn,kazzak,1055,warlock,destruction,18,11,7
Raknoxyeyeye,blackrock,1055,warlock,destruction,18,11,7
Лешабетон,gordunni,1055,warlock,destruction,18,11,7
Krøl,nemesis,1055,warlock,destruction,18,11,7
Shena,chogall,1055,warlock,destruction,24,11,13
Dalyvan,blackrock,1055,warlock,destruction,24,11,13
Блэкфлэймх,gordunni,1055,warlock,destruction,30,11,19
Kieman,tarren-mill,1055,warlock,destruction,30,11,19
Drarken,sylvanas,1054,warlock,destruction,12,11,1
Naniika,blackmoore,1054,warlock,destruction,36,24,12
Highimhi,kazzak,1054,warlock,destruction,18,11,7
Коломо,soulflayer,1054,warlock,destruction,18,11,7
Archí,twisting-nether,1054,warlock,destruction,18,11,7
Jørdanna,blackrock,1054,warlock,destruction,18,11,7
Ronniee,moonglade,1054,warlock,destruction,18,11,7
Анкхзул,howling-fjord,1054,warlock,destruction,18,11,7
Ileeo,kazzak,1054,warlock,destruction,42,23,19
Helvetica,darksorrow,1054,warlock,destruction,24,11,13
Xydar,stormscale,1054,warlock,destruction,30,12,18
Trickslock,kazzak,1053,warlock,destruction,18,11,7
Shadowthrone,ragnaros,1053,warlock,destruction,24,11,13
Yenex,blackhand,1053,warlock,destruction,32,14,18
Костикк,howling-fjord,1052,warlock,destruction,18,11,7
Gentoo,xavius,1052,warlock,destruction,18,11,7
Бигбрейн,soulflayer,1051,warlock,destruction,18,11,7
Hejhana,drakthul,1051,warlock,destruction,102,39,63
Katâra,tarren-mill,1051,warlock,destruction,30,11,19
Peterpaîn,blackmoore,1050,warlock,destruction,22,14,8
Sopingsop,chants-éternels,1050,warlock,destruction,18,11,7
Willibolt,blackhand,1050,warlock,destruction,24,11,13
Gâlvâtorix,frostmourne,1050,warlock,destruction,58,26,32
Whine,uldum,1050,warlock,destruction,54,24,30
Gåylørd,ravencrest,1050,warlock,destruction,30,11,19
Setta,argent-dawn,1050,warlock,destruction,36,11,25
Bangbrös,stormscale,1049,warlock,destruction,18,11,7
Gdkw,tarren-mill,1049,warlock,destruction,24,11,13
Margincalled,kazzak,1048,warlock,destruction,24,11,13
Jpjpjp,gorgonnash,1046,warlock,destruction,18,11,7
Faitless,stormscale,1046,warlock,destruction,18,11,7
Yénnéfér,ravencrest,1046,warlock,destruction,33,11,22
Quentex,antonidas,1045,warlock,destruction,24,11,13
Cängrë,dun-modr,1042,warlock,destruction,18,11,7
Surfot,kazzak,1041,warlock,destruction,30,11,19
Sindown,the-maelstrom,1041,warlock,destruction,30,11,19
Тарналор,gordunni,1032,warlock,destruction,24,11,13
Heximexi,malganis,1029,warlock,destruction,24,11,13
Demonoulis,bloodhoof,1026,warlock,destruction,18,11,7
Woudstok,ysondre,1026,warlock,destruction,23,12,11
Nava,stormscale,1024,warlock,destruction,28,12,16
Vinilio,kazzak,1019,warlock,destruction,56,21,35
Avati,sargeras,1018,warlock,destruction,30,14,16
Klasikas,kazzak,1016,warlock,destruction,27,12,15
Kharzug,alakir,1015,warlock,destruction,27,12,15
Àtreyù,daggerspine,1015,warlock,destruction,71,27,44
Amon,suramar,1011,warlock,destruction,25,13,12
Omnigul,grim-batol,1010,warlock,destruction,36,14,22
Zardøx,khaz-modan,1009,warlock,destruction,18,12,6
Gødprotøtýpe,ragnaros,1008,warlock,destruction,25,13,12
Ðæthpäct,dalaran,1007,warlock,destruction,23,11,12
Satyrilian,tarren-mill,1006,warlock,destruction,17,11,6
Esthrella,thrall,1006,warlock,destruction,25,14,11
Jaqqy,blackmoore,1005,warlock,destruction,18,12,6
Lazyblue,hyjal,1004,warlock,destruction,43,12,31
Babayagaa,drakthul,1002,warlock,destruction,26,11,15
Baskakov,zuljin,1001,warlock,destruction,21,11,10
Iltharian,die-todeskrallen,1000,warlock,destruction,17,11,6
Архидрако,gordunni,997,warlock,destruction,36,16,20
Чпокерша,deepholm,994,warlock,destruction,29,11,18
Loveløck,blackrock,991,warlock,destruction,29,11,18
Rasputia,thunderhorn,989,warlock,destruction,22,12,10
Yudy,burning-legion,987,warlock,destruction,20,11,9
Lynchéd,argent-dawn,986,warlock,destruction,17,11,6
Líok,eredar,982,warlock,destruction,29,11,18
Шайтанарба,blackscar,977,warlock,destruction,42,17,25
Шейп,fordragon,977,warlock,destruction,36,11,25
Scrabblee,dun-morogh,976,warlock,destruction,30,11,19
Thorins,sinstralis,972,warlock,destruction,30,12,18
Demox,arathor,962,warlock,destruction,26,11,15
Gilfhaunter,malganis,960,warlock,destruction,12,10,2
Graystache,blackhand,960,warlock,destruction,12,10,2
Nerfmeplz,archimonde,960,warlock,destruction,12,10,2
Nefariousz,bloodfeather,960,warlock,destruction,12,10,2
Jamuhlee,der-abyssische-rat,960,warlock,destruction,12,10,2
Sakkrethxd,hyjal,960,warlock,destruction,12,10,2
Ñia,ravencrest,960,warlock,destruction,12,10,2
Aritrosyo,ravencrest,960,warlock,destruction,12,10,2
Kozaras,tarren-mill,960,warlock,destruction,12,10,2
Stecksen,blackmoore,960,warlock,destruction,12,10,2
Jazggzkxx,twisting-nether,960,warlock,destruction,12,10,2
Flxzshort,kazzak,960,warlock,destruction,12,10,2
Joinx,tarren-mill,960,warlock,destruction,12,10,2
Slomg,sylvanas,960,warlock,destruction,12,10,2
Isco,ysondre,960,warlock,destruction,12,10,2
Garb,stormreaver,960,warlock,destruction,12,10,2
Korialstraz,sylvanas,960,warlock,destruction,12,10,2
Harefrøken,ravencrest,960,warlock,destruction,12,10,2
Hopéléss,aggra-português,960,warlock,destruction,12,10,2
Destrolockz,tarren-mill,960,warlock,destruction,16,11,5
Imissbfa,stormscale,960,warlock,destruction,16,11,5
Teezeye,ragnaros,960,warlock,destruction,17,10,7
Blazed,dentarg,960,warlock,destruction,18,10,8
Chaotick,burning-legion,960,warlock,destruction,18,10,8
Lìmè,silvermoon,960,warlock,destruction,18,10,8
Trickytée,tarren-mill,960,warlock,destruction,18,10,8
Mirenli,kazzak,960,warlock,destruction,18,10,8
Meepx,nordrassil,960,warlock,destruction,18,10,8
Adoxilock,twisting-nether,960,warlock,destruction,18,10,8
Britneÿ,stormscale,960,warlock,destruction,18,10,8
Abuu,ravencrest,960,warlock,destruction,18,10,8
Lillemarkus,tarren-mill,960,warlock,destruction,18,10,8
Turdy,sylvanas,960,warlock,destruction,18,10,8
Ммоохх,gordunni,960,warlock,destruction,18,10,8
Gödisdëäd,sanguino,960,warlock,destruction,18,10,8
Хихихи,blackscar,960,warlock,destruction,18,10,8
Kyiüû,archimonde,960,warlock,destruction,22,12,10
Jopil,stormreaver,960,warlock,destruction,22,11,11
Flatulenzus,blackrock,960,warlock,destruction,24,10,14
Tentigo,blackmoore,960,warlock,destruction,24,10,14
Bailerlock,antonidas,960,warlock,destruction,24,10,14
Zízýéró,sylvanas,959,warlock,destruction,12,10,2
Demonqueens,kazzak,959,warlock,destruction,12,10,2
Cringelord,vashj,959,warlock,destruction,12,10,2
Ammilock,aszune,959,warlock,destruction,12,10,2
Hellraiserir,twisting-nether,959,warlock,destruction,12,10,2
Melyagang,hyjal,959,warlock,destruction,12,10,2
Hajslaktarn,twisting-nether,959,warlock,destruction,18,10,8
Helgorak,ragnaros,959,warlock,destruction,18,10,8
Kekbólt,twisting-nether,959,warlock,destruction,18,10,8
Vät,kirin-tor,959,warlock,destruction,18,10,8
Positivitywl,stormscale,959,warlock,destruction,18,10,8
Dotáhoe,twisting-nether,959,warlock,destruction,18,10,8
Deathpoid,draenor,959,warlock,destruction,18,10,8
Alexindorf,silvermoon,959,warlock,destruction,18,10,8
Chaosborn,ravencrest,959,warlock,destruction,24,10,14
Adipure,blackrock,959,warlock,destruction,24,10,14
Колмидедди,gordunni,959,warlock,destruction,24,10,14
Slâyâ,blackrock,958,warlock,destruction,12,10,2
Shadaw,kilrogg,958,warlock,destruction,12,10,2
Dotys,sanguino,958,warlock,destruction,12,10,2
Drainurlife,zenedar,958,warlock,destruction,18,10,8
Phît,kilrogg,958,warlock,destruction,18,10,8
Kenybalajze,the-maelstrom,958,warlock,destruction,18,10,8
Vanmorgoth,nazjatar,958,warlock,destruction,18,10,8
Numidia,tarren-mill,958,warlock,destruction,18,10,8
Annihilatîon,aegwynn,958,warlock,destruction,18,10,8
Адво,howling-fjord,958,warlock,destruction,18,10,8
Kwei,nemesis,958,warlock,destruction,18,10,8
Ottu,thrall,958,warlock,destruction,18,10,8
Cryks,blackmoore,958,warlock,destruction,21,11,10
Dèv,draenor,958,warlock,destruction,24,10,14
Zorlon,frostmane,957,warlock,destruction,12,10,2
Troyana,chants-éternels,957,warlock,destruction,56,35,21
Inhúman,kazzak,957,warlock,destruction,18,10,8
Klimsonxd,burning-legion,957,warlock,destruction,18,10,8
Hexdoc,alakir,957,warlock,destruction,18,10,8
Schmexer,blutkessel,957,warlock,destruction,18,10,8
Baloc,kirin-tor,957,warlock,destruction,18,10,8
Allêgrâ,blackrock,957,warlock,destruction,20,10,10
Absurdd,turalyon,955,warlock,destruction,16,11,5
Seymor,amanthul,955,warlock,destruction,18,10,8
Банкапевка,howling-fjord,955,warlock,destruction,24,10,14
Thranerm,ravencrest,955,warlock,destruction,24,10,14
Vâgg,blackmoore,955,warlock,destruction,30,10,20
Firinmalazor,blackrock,954,warlock,destruction,18,10,8
Realshady,kazzak,954,warlock,destruction,18,10,8
Chlöê,hyjal,954,warlock,destruction,18,10,8
Panicbolt,ravencrest,954,warlock,destruction,18,10,8
Izhi,ragnaros,954,warlock,destruction,21,10,11
Kriplock,twisting-nether,954,warlock,destruction,24,10,14
Sehere,ragnaros,953,warlock,destruction,18,10,8
Gerart,tarren-mill,953,warlock,destruction,18,10,8
Scandalfogel,frostmane,952,warlock,destruction,18,10,8
Millhaus,gorgonnash,952,warlock,destruction,18,10,8
Tzimice,hyjal,952,warlock,destruction,24,10,14
Aftxrlife,arathor,951,warlock,destruction,16,11,5
Zow,dun-modr,950,warlock,destruction,24,10,14
Drthc,kazzak,949,warlock,destruction,18,10,8
Synnox,blackrock,949,warlock,destruction,24,11,13
Fbomber,ravencrest,948,warlock,destruction,12,10,2
Rikkai,anubarak,948,warlock,destruction,18,10,8
Nirây,thrall,945,warlock,destruction,37,10,27
Vraduk,malygos,944,warlock,destruction,20,11,9
Крутизол,fordragon,944,warlock,destruction,25,11,14
Hyòx,aegwynn,939,warlock,destruction,23,10,13
Äzarel,khaz-modan,933,warlock,destruction,12,10,2
Silkgates,kazzak,933,warlock,destruction,29,10,19
Eisenkiefer,thrall,933,warlock,destruction,71,24,47
Boltgodx,blackrock,930,warlock,destruction,24,10,14
Zøhaz,burning-legion,929,warlock,destruction,60,24,36
Racursed,outland,927,warlock,destruction,16,10,6
Wizdoom,outland,924,warlock,destruction,22,11,11
Dotcha,ravencrest,921,warlock,destruction,18,10,8
Arlu,blackrock,920,warlock,destruction,58,28,30
Фламмэнх,soulflayer,911,warlock,destruction,23,10,13
Cruckz,nathrezim,910,warlock,destruction,15,10,5
Jamzywarlock,kazzak,910,warlock,destruction,23,10,13
Demowlition,archimonde,908,warlock,destruction,24,10,14
Telaldrah,argent-dawn,906,warlock,destruction,17,10,7
Реалсамка,gordunni,895,warlock,destruction,17,10,7
Bèkshà,blackrock,894,warlock,destruction,20,10,10
Buddyparty,blackrock,892,warlock,destruction,14,10,4
Felcollins,sylvanas,892,warlock,destruction,20,10,10
Blâckmagíc,thrall,887,warlock,destruction,16,10,6
Äbsalom,hyjal,882,warlock,destruction,80,39,41
Charmine,tarren-mill,877,warlock,destruction,13,10,3
Oddchap,magtheridon,875,warlock,destruction,53,21,32
Narkstzhki,kazzak,866,warlock,destruction,20,11,9
Projectlock,draenor,864,warlock,destruction,12,9,3
Watchmecutt,terenas,864,warlock,destruction,12,9,3
Niiaa,archimonde,864,warlock,destruction,12,9,3
Веномхх,lich-king,864,warlock,destruction,12,9,3
Boltmaster,burning-legion,864,warlock,destruction,12,9,3
Vamanos,stormscale,864,warlock,destruction,12,9,3
Trimar,archimonde,864,warlock,destruction,12,9,3
Lcollector,outland,864,warlock,destruction,12,9,3
Trashxø,tarren-mill,864,warlock,destruction,12,9,3
Ahollic,frostwolf,864,warlock,destruction,12,9,3
Ilbidello,nemesis,864,warlock,destruction,12,9,3
Chàsx,archimonde,864,warlock,destruction,12,9,3
Elmáestro,aegwynn,864,warlock,destruction,12,9,3
Kaakmasta,der-abyssische-rat,864,warlock,destruction,12,9,3
Dst,ravencrest,864,warlock,destruction,12,9,3
Chaosboba,silvermoon,864,warlock,destruction,12,9,3
Letmecast,sylvanas,864,warlock,destruction,12,9,3
Peon,blackrock,864,warlock,destruction,12,9,3
Qwyncess,archimonde,864,warlock,destruction,12,9,3
Menocast,archimonde,864,warlock,destruction,12,9,3
Zakazal,argent-dawn,864,warlock,destruction,12,9,3
Predlocktwo,twisting-nether,864,warlock,destruction,12,9,3
Mêgasn,blackhand,864,warlock,destruction,12,9,3
Darkwíngduck,aegwynn,864,warlock,destruction,12,9,3
Reizouka,twisting-nether,864,warlock,destruction,12,9,3
Chãn,ravencrest,864,warlock,destruction,12,9,3
Hupet,ragnaros,864,warlock,destruction,12,9,3
Aggressivé,twisting-nether,864,warlock,destruction,17,9,8
Царьдарк,soulflayer,864,warlock,destruction,18,9,9
Fearfearfear,blackhand,864,warlock,destruction,18,9,9
Köftemec,blackrock,864,warlock,destruction,18,9,9
Mcdonkus,chamber-of-aspects,864,warlock,destruction,18,9,9
Southylolz,stormscale,864,warlock,destruction,18,9,9
Bionic,eredar,864,warlock,destruction,18,9,9
Ashh,ravencrest,864,warlock,destruction,18,9,9
Gulzot,turalyon,864,warlock,destruction,18,9,9
Joleptem,outland,864,warlock,destruction,18,9,9
Gremmus,outland,864,warlock,destruction,18,9,9
Voukserys,tarren-mill,863,warlock,destruction,12,9,3
Narzok,kazzak,863,warlock,destruction,12,9,3
Höglund,twisting-nether,863,warlock,destruction,12,9,3
Phicon,silvermoon,863,warlock,destruction,12,9,3
Bergerac,archimonde,863,warlock,destruction,12,9,3
Psykokwette,kirin-tor,863,warlock,destruction,12,9,3
Zelyx,archimonde,863,warlock,destruction,12,9,3
Locque,kazzak,863,warlock,destruction,12,9,3
Elerodril,ysondre,863,warlock,destruction,12,9,3
Elissa,skullcrusher,863,warlock,destruction,12,9,3
Chaosbørn,twisting-nether,863,warlock,destruction,16,10,6
Demoslik,hyjal,863,warlock,destruction,18,9,9
Nobodyknows,outland,863,warlock,destruction,18,9,9
Mjuklock,ravencrest,863,warlock,destruction,18,9,9
Furchtnervt,dun-morogh,863,warlock,destruction,18,9,9
Andrealphus,outland,863,warlock,destruction,18,9,9
Байронет,gordunni,863,warlock,destruction,18,9,9
Nazrõth,stormscale,863,warlock,destruction,18,9,9
Uezzalock,nemesis,863,warlock,destruction,18,9,9
Burningdemon,kazzak,863,warlock,destruction,18,9,9
Moardotts,ravencrest,863,warlock,destruction,19,9,10
Meningitis,tyrande,863,warlock,destruction,24,9,15
Getfeared,draenor,863,warlock,destruction,24,9,15
Krastey,malfurion,862,warlock,destruction,12,9,3
Miltuast,blackrock,862,warlock,destruction,12,9,3
Kirillkaá,blackhand,862,warlock,destruction,12,9,3
Bíggun,outland,862,warlock,destruction,12,9,3
Wormies,doomhammer,862,warlock,destruction,18,9,9
Sateerik,draenor,862,warlock,destruction,18,9,9
Deamions,ravencrest,862,warlock,destruction,18,9,9
Otemlock,sanguino,862,warlock,destruction,18,9,9
Palmangel,draenor,862,warlock,destruction,24,9,15
Girldoom,silvermoon,862,warlock,destruction,24,9,15
Grolder,terokkar,861,warlock,destruction,18,11,7
Сеннир,ashenvale,861,warlock,destruction,18,9,9
Darkremorsez,alakir,861,warlock,destruction,24,9,15
Adafbhf,tichondrius,859,warlock,destruction,18,9,9
Zakuri,blackmoore,859,warlock,destruction,18,9,9
Глянемче,deathguard,859,warlock,destruction,18,9,9
Hôjâm,twisting-nether,858,warlock,destruction,18,9,9
Castingsmth,draenor,855,warlock,destruction,15,11,4
Müdür,burning-legion,854,warlock,destruction,18,9,9
Fearmex,turalyon,854,warlock,destruction,18,9,9
Llilith,bronzebeard,853,warlock,destruction,18,9,9
Joopz,ravencrest,847,warlock,destruction,22,12,10
Ternisia,draenor,846,warlock,destruction,20,10,10
Tid,burning-legion,830,warlock,destruction,17,9,8
Lokelicious,ragnaros,829,warlock,destruction,23,9,14
Dÿf,kazzak,828,warlock,destruction,16,9,7
Smithlock,blackrock,816,warlock,destruction,15,10,5
Zengrow,ravencrest,815,warlock,destruction,15,10,5
Indynamo,blackrock,815,warlock,destruction,17,9,8
Kkomradee,kazzak,815,warlock,destruction,21,9,12
Shakuroz,frostwolf,815,warlock,destruction,27,10,17
Merloc,magtheridon,801,warlock,destruction,20,10,10
Châmp,stormscale,799,warlock,destruction,11,9,2
Slerpmami,ragnaros,799,warlock,destruction,14,10,4
Infernion,stormscale,768,warlock,destruction,10,9,1
Dadylock,silvermoon,768,warlock,destruction,12,8,4
Ullalol,magtheridon,768,warlock,destruction,12,8,4
Квейдсан,howling-fjord,768,warlock,destruction,12,8,4
Gebkan,hyjal,768,warlock,destruction,12,8,4
Detoxa,outland,768,warlock,destruction,12,8,4
Maenas,ravencrest,768,warlock,destruction,12,8,4
Trembly,alakir,768,warlock,destruction,12,8,4
Tharaya,ravencrest,768,warlock,destruction,12,8,4
Gravewatcher,twisting-nether,768,warlock,destruction,12,8,4
Dbwl,kazzak,768,warlock,destruction,12,8,4
Wårlørd,ragnaros,768,warlock,destruction,12,8,4
Dejin,tarren-mill,768,warlock,destruction,12,8,4
Emolord,ravencrest,768,warlock,destruction,12,8,4
Bigpoodleman,twisting-nether,768,warlock,destruction,12,8,4
Sniffy,stormreaver,768,warlock,destruction,12,8,4
Topmidbusta,draenor,768,warlock,destruction,12,8,4
Firecast,kazzak,768,warlock,destruction,12,8,4
Dmonlock,hyjal,768,warlock,destruction,12,8,4
Straydots,grim-batol,768,warlock,destruction,12,8,4
Supermaus,blackrock,768,warlock,destruction,12,8,4
Overbuffed,wildhammer,768,warlock,destruction,12,8,4
Namarin,die-aldor,768,warlock,destruction,12,8,4
Aket,kazzak,768,warlock,destruction,12,8,4
Миражлок,gordunni,768,warlock,destruction,12,8,4
Шархилол,gordunni,768,warlock,destruction,12,8,4
Benafflock,veknilash,768,warlock,destruction,12,8,4
Vezmollo,stormscale,768,warlock,destruction,12,8,4
Nephystø,archimonde,768,warlock,destruction,12,8,4
Psychoduck,stormscale,768,warlock,destruction,12,8,4
Чернокай,gordunni,768,warlock,destruction,12,8,4
Gambos,kazzak,768,warlock,destruction,12,8,4
Traicklock,eredar,768,warlock,destruction,12,8,4
Nodavé,stormscale,768,warlock,destruction,12,8,4
Crunel,ragnaros,768,warlock,destruction,12,8,4
Doublebolt,the-maelstrom,768,warlock,destruction,12,8,4
Ламэ,gordunni,768,warlock,destruction,12,8,4
Ogiez,draenor,768,warlock,destruction,12,8,4
Фаердирка,blackscar,768,warlock,destruction,12,8,4
Phobilock,guldan,768,warlock,destruction,12,8,4
Kàjah,outland,768,warlock,destruction,12,8,4
Inagony,twisting-nether,768,warlock,destruction,12,8,4
Maedx,outland,768,warlock,destruction,15,9,6
Mosskok,kazzak,768,warlock,destruction,16,9,7
Dirtyjoe,doomhammer,768,warlock,destruction,18,8,10
Стоишьвфире,gordunni,768,warlock,destruction,18,8,10
Horststenzl,blackrock,768,warlock,destruction,18,8,10
Némésiø,archimonde,768,warlock,destruction,18,8,10
Xarica,garona,768,warlock,destruction,18,8,10
Melforius,tarren-mill,768,warlock,destruction,18,8,10
Tseva,aggra-português,768,warlock,destruction,18,8,10
ßenäfflock,ragnaros,768,warlock,destruction,18,8,10
Unkid,tarren-mill,767,warlock,destruction,12,8,4
Goodclass,tarren-mill,767,warlock,destruction,12,8,4
Экспло,ashenvale,767,warlock,destruction,12,8,4
Gimmê,dun-morogh,767,warlock,destruction,12,8,4
Palatical,terokkar,767,warlock,destruction,12,8,4
Stopfëar,ysondre,767,warlock,destruction,12,8,4
Яичнаялапша,soulflayer,767,warlock,destruction,12,8,4
Azaïdun,khaz-modan,767,warlock,destruction,12,8,4
Mentaldeadw,draenor,767,warlock,destruction,12,8,4
Ромзесхх,howling-fjord,767,warlock,destruction,12,8,4
Chía,thunderhorn,767,warlock,destruction,12,8,4
Xoregar,nemesis,767,warlock,destruction,12,8,4
Nili,dethecus,767,warlock,destruction,12,8,4
Redroach,doomhammer,767,warlock,destruction,12,8,4
Lorelèi,silvermoon,767,warlock,destruction,12,8,4
Aribethion,draenor,767,warlock,destruction,12,8,4
Ragïa,archimonde,767,warlock,destruction,12,8,4
Wushi,aggra-português,767,warlock,destruction,12,8,4
Shadowburst,outland,767,warlock,destruction,12,8,4
Murishani,durotan,767,warlock,destruction,12,8,4
Finlock,kult-der-verdammten,767,warlock,destruction,15,9,6
Toryon,archimonde,767,warlock,destruction,17,8,9
Chochliko,silvermoon,767,warlock,destruction,18,8,10
Debex,ravencrest,767,warlock,destruction,18,8,10
Ráklock,ragnaros,767,warlock,destruction,18,8,10
Wichtl,die-ewige-wacht,767,warlock,destruction,18,8,10
Ebolara,aegwynn,767,warlock,destruction,18,8,10
Donmajor,amanthul,767,warlock,destruction,24,8,16
Légréy,blackmoore,766,warlock,destruction,12,8,4
Келебрах,howling-fjord,766,warlock,destruction,12,8,4
Lowkeyfed,stormscale,766,warlock,destruction,12,8,4
Hydrochloric,emerald-dream,766,warlock,destruction,12,8,4
Discordîân,twisting-nether,766,warlock,destruction,12,8,4
Yôi,nemesis,766,warlock,destruction,18,8,10
Jillyãen,hyjal,766,warlock,destruction,18,8,10
Devoto,stormscale,766,warlock,destruction,22,9,13
Рисли,deathweaver,765,warlock,destruction,12,8,4
Bravehearrt,burning-legion,765,warlock,destruction,12,8,4
Dregx,twisting-nether,765,warlock,destruction,12,8,4
Soldmygranny,kazzak,765,warlock,destruction,15,9,6
Drestan,twisting-nether,765,warlock,destruction,18,8,10
Hexahydraten,draenor,764,warlock,destruction,18,8,10
Ezekîél,blackhand,764,warlock,destruction,24,8,16
Luckynòób,ravencrest,764,warlock,destruction,24,8,16
Xfear,blackrock,763,warlock,destruction,12,8,4
Staynecro,malfurion,763,warlock,destruction,18,8,10
Юникна,gordunni,763,warlock,destruction,24,8,16
Hurn,thunderhorn,762,warlock,destruction,12,8,4
Nuckki,antonidas,761,warlock,destruction,30,8,22
Bloodyknight,draenor,759,warlock,destruction,12,8,4
Oonz,sylvanas,759,warlock,destruction,24,8,16
Petrosk,sanguino,757,warlock,destruction,18,8,10
Happysrme,thrall,756,warlock,destruction,36,8,28
Sweetlõck,ravencrest,750,warlock,destruction,17,8,9
Веномзхх,lich-king,735,warlock,destruction,17,8,9
Shaodul,stormscale,735,warlock,destruction,17,8,9
Шадофлок,deathweaver,735,warlock,destruction,17,8,9
Xaok,dun-modr,732,warlock,destruction,23,8,15
Kárdur,blackmoore,731,warlock,destruction,14,9,5
Sladurana,eredar,721,warlock,destruction,18,8,10
Salvatoriy,outland,719,warlock,destruction,11,8,3
Кореопсис,azuregos,718,warlock,destruction,11,8,3
Kelek,anachronos,718,warlock,destruction,11,8,3
Mïllâïneeqtx,archimonde,714,warlock,destruction,13,10,3
Ironserious,blackrock,714,warlock,destruction,16,9,7
Тёмабиль,gordunni,714,warlock,destruction,23,10,13
Warlocklordx,ravencrest,713,warlock,destruction,22,9,13
Amyw,magtheridon,712,warlock,destruction,20,9,11
Rikta,stormscale,703,warlock,destruction,11,8,3
Джастсак,gordunni,703,warlock,destruction,11,8,3
Kycknosa,archimonde,703,warlock,destruction,20,8,12
Saleus,argent-dawn,701,warlock,destruction,16,8,8
Wacastwo,tarren-mill,672,warlock,destruction,12,7,5
Scud,frostwolf,672,warlock,destruction,12,7,5
Filippö,eredar,672,warlock,destruction,12,7,5
Kashdrakor,twisting-nether,672,warlock,destruction,12,7,5
Numlockz,jaedenar,672,warlock,destruction,12,7,5
Sötsugen,argent-dawn,672,warlock,destruction,12,7,5
Lilbolty,outland,672,warlock,destruction,12,7,5
Kronesx,tarren-mill,672,warlock,destruction,12,7,5
Frèija,ravencrest,672,warlock,destruction,12,7,5
Pukemistress,tarren-mill,672,warlock,destruction,12,7,5
Reuhn,kazzak,672,warlock,destruction,12,7,5
Vilenia,doomhammer,672,warlock,destruction,12,7,5
Itiswhatitis,ravencrest,672,warlock,destruction,12,7,5
Archimitros,blackmoore,672,warlock,destruction,12,7,5
Aoeenjoer,tarren-mill,672,warlock,destruction,12,7,5
Lockismymain,eredar,672,warlock,destruction,12,7,5
Anicetuslol,lightnings-blade,672,warlock,destruction,12,7,5
Skipperw,blackmoore,672,warlock,destruction,12,7,5
Irwene,argent-dawn,672,warlock,destruction,12,7,5
Galeriana,twilights-hammer,672,warlock,destruction,12,7,5
Qumbaja,alleria,672,warlock,destruction,12,7,5
Demodan,aegwynn,672,warlock,destruction,12,7,5
Psykøø,shendralar,672,warlock,destruction,12,7,5
Purplemonkey,burning-blade,672,warlock,destruction,12,7,5
Тарои,howling-fjord,672,warlock,destruction,12,7,5
Монтадон,howling-fjord,672,warlock,destruction,12,7,5
Aunsá,archimonde,672,warlock,destruction,12,7,5
Fraky,frostwhisper,672,warlock,destruction,12,7,5
Misleev,pozzo-delleternità,672,warlock,destruction,12,7,5
Nmmnmmnnmnmm,blackmoore,672,warlock,destruction,12,7,5
Jaleels,kazzak,672,warlock,destruction,12,7,5
Inflicts,frostmane,672,warlock,destruction,12,7,5
Çüñ,shattered-hand,672,warlock,destruction,12,7,5
Hehexd,steamwheedle-cartel,672,warlock,destruction,12,7,5
Nürgle,stormscale,672,warlock,destruction,12,7,5
Xjay,malorne,672,warlock,destruction,12,7,5
Sneltjej,draenor,672,warlock,destruction,12,7,5
Midnigthh,sanguino,672,warlock,destruction,12,7,5
Abdulrahim,archimonde,672,warlock,destruction,12,7,5
Fellord,chants-éternels,672,warlock,destruction,12,7,5
Мэрджис,soulflayer,672,warlock,destruction,12,7,5
Chapo,alleria,672,warlock,destruction,12,7,5
Gruldran,khaz-modan,672,warlock,destruction,12,7,5
Lúcìfér,stormscale,672,warlock,destruction,12,7,5
Demonälskare,kazzak,672,warlock,destruction,12,7,5
Numwiki,draenor,672,warlock,destruction,12,7,5
Матрикспз,soulflayer,672,warlock,destruction,12,7,5
Vixlock,tarren-mill,672,warlock,destruction,15,8,7
Skali,stormrage,672,warlock,destruction,18,7,11
Smallpee,kazzak,672,warlock,destruction,18,7,11
Геоматика,gordunni,672,warlock,destruction,18,7,11
Argenus,khazgoroth,672,warlock,destruction,18,7,11
Mocfernando,ravencrest,672,warlock,destruction,18,7,11
Mewarlock,bronze-dragonflight,672,warlock,destruction,18,7,11
Topmodelx,eredar,672,warlock,destruction,18,7,11
Lêxia,shattrath,672,warlock,destruction,18,7,11
Haedri,kazzak,672,warlock,destruction,18,7,11
Apokalyps,eldrethalas,672,warlock,destruction,18,7,11
Локизло,gordunni,672,warlock,destruction,18,7,11
Milfhaunter,aegwynn,672,warlock,destruction,18,7,11
Chromagnus,drakthul,672,warlock,destruction,18,7,11
Belakh,draenor,672,warlock,destruction,18,7,11
Hædês,antonidas,672,warlock,destruction,18,7,11
Haccu,ragnaros,672,warlock,destruction,18,7,11
Mixu,hakkar,672,warlock,destruction,21,8,13
Marripa,sanguino,672,warlock,destruction,24,7,17
Spikemasterd,doomhammer,672,warlock,destruction,24,7,17
Barbyqueue,kazzak,671,warlock,destruction,10,8,2
Amadéth,twisting-nether,671,warlock,destruction,12,7,5
Baladas,nemesis,671,warlock,destruction,12,7,5
Hampter,blackmoore,671,warlock,destruction,12,7,5
Skitless,blackmoore,671,warlock,destruction,12,7,5
Bkp,dun-modr,671,warlock,destruction,12,7,5
Saadq,draenor,671,warlock,destruction,12,7,5
Xlara,argent-dawn,671,warlock,destruction,12,7,5
Zaruman,turalyon,671,warlock,destruction,12,7,5
Quebone,tarren-mill,671,warlock,destruction,12,7,5
Afflicted,trollbane,671,warlock,destruction,12,7,5
Poulebar,ysondre,671,warlock,destruction,12,7,5
Cømps,blackrock,671,warlock,destruction,12,7,5
Fireburner,der-mithrilorden,671,warlock,destruction,12,7,5
Drexo,drakthul,671,warlock,destruction,12,7,5
Regularbag,ravencrest,671,warlock,destruction,12,7,5
Raddock,ysondre,671,warlock,destruction,12,7,5
Fauxshow,ravencrest,671,warlock,destruction,12,7,5
Mystereo,bloodscalp,671,warlock,destruction,12,7,5
Zillinzy,frostmane,671,warlock,destruction,12,7,5
Leídernein,blutkessel,671,warlock,destruction,18,7,11
Tce,ravencrest,671,warlock,destruction,18,7,11
Vengidotcom,outland,671,warlock,destruction,18,7,11
Nexpoze,drakthul,671,warlock,destruction,18,7,11
Ziloc,silvermoon,671,warlock,destruction,18,7,11
Гнумосятина,booty-bay,671,warlock,destruction,18,7,11
Cancerdotcom,kazzak,671,warlock,destruction,18,7,11
Kàiser,sanguino,671,warlock,destruction,23,7,16
Eriken,tarren-mill,671,warlock,destruction,24,7,17
Нафлэпил,gordunni,670,warlock,destruction,12,7,5
Qloss,burning-legion,670,warlock,destruction,12,7,5
Зародыш,razuvious,670,warlock,destruction,18,7,11
Mângo,thunderhorn,669,warlock,destruction,12,7,5
Samigina,argent-dawn,669,warlock,destruction,24,7,17
Sheshii,argent-dawn,669,warlock,destruction,24,7,17
Mortori,tarren-mill,668,warlock,destruction,12,7,5
Сатаната,deepholm,668,warlock,destruction,12,7,5
Подликерная,howling-fjord,668,warlock,destruction,12,7,5
Hodille,argent-dawn,668,warlock,destruction,18,7,11
Мракодел,deathguard,668,warlock,destruction,18,7,11
Buzztoon,doomhammer,668,warlock,destruction,24,7,17
Johntrabolta,chogall,667,warlock,destruction,12,7,5
Vladlevad,argent-dawn,667,warlock,destruction,12,7,5
Garbagebarge,krasus,666,warlock,destruction,12,7,5
Bësly,khaz-modan,665,warlock,destruction,12,7,5
Lefttorot,garrosh,665,warlock,destruction,16,8,8
Мааверш,soulflayer,665,warlock,destruction,24,7,17
Ахпорбес,gordunni,661,warlock,destruction,12,7,5
Destri,blackmoore,660,warlock,destruction,12,7,5
Janneraut,terokkar,660,warlock,destruction,18,7,11
Dorothy,steamwheedle-cartel,658,warlock,destruction,12,7,5
Vinet,burning-legion,657,warlock,destruction,12,7,5
Bowhite,silvermoon,655,warlock,destruction,15,8,7
Alsseharr,blackhand,623,warlock,destruction,11,7,4
Tydra,die-aldor,618,warlock,destruction,20,8,12
Garimberas,silvermoon,618,warlock,destruction,20,8,12
Delen,ravencrest,608,warlock,destruction,16,7,9
Würrzag,kazzak,607,warlock,destruction,11,7,4
Érunali,archimonde,607,warlock,destruction,11,7,4
Shadowppl,outland,606,warlock,destruction,20,7,13
Krokator,draenor,605,warlock,destruction,11,7,4
Какойтолок,blackscar,591,warlock,destruction,13,7,6
Lomis,wrathbringer,588,warlock,destruction,19,7,12
Bedep,sanguino,576,warlock,destruction,6,6,0
Sinofbum,stormscale,576,warlock,destruction,6,6,0
Hibachi,twisting-nether,576,warlock,destruction,6,6,0
Sulnar,burning-legion,576,warlock,destruction,6,6,0
Whaii,ravencrest,576,warlock,destruction,6,6,0
Solosuperr,ravencrest,576,warlock,destruction,6,6,0
Cafardcancer,archimonde,576,warlock,destruction,6,6,0
Dahisx,ravencrest,576,warlock,destruction,6,6,0
Baked,outland,576,warlock,destruction,6,6,0
Nighttusk,burning-legion,576,warlock,destruction,6,6,0
Popecandy,archimonde,576,warlock,destruction,6,6,0
Felgibson,destromath,576,warlock,destruction,6,6,0
Xute,ragnaros,576,warlock,destruction,6,6,0
Adellaragg,draenor,576,warlock,destruction,6,6,0
Agonymaster,twisting-nether,576,warlock,destruction,6,6,0
Skuvee,archimonde,576,warlock,destruction,6,6,0
Ceryss,argent-dawn,576,warlock,destruction,6,6,0
Дуэлистка,soulflayer,576,warlock,destruction,6,6,0
Menescurse,blackhand,576,warlock,destruction,6,6,0
Zìì,silvermoon,576,warlock,destruction,6,6,0
Greeylock,blackhand,576,warlock,destruction,6,6,0
Kennyfõx,ysondre,576,warlock,destruction,6,6,0
Zevranøss,dalaran,576,warlock,destruction,6,6,0
Yamadea,stormscale,576,warlock,destruction,6,6,0
Klaier,dun-modr,576,warlock,destruction,9,7,2
Silenozz,ragnaros,576,warlock,destruction,12,6,6
Noobtamer,kazzak,576,warlock,destruction,12,6,6
Maevax,stormscale,576,warlock,destruction,12,6,6
Avoidsun,kazzak,576,warlock,destruction,12,6,6
Irukandji,chants-éternels,576,warlock,destruction,12,6,6
Boltyboi,chamber-of-aspects,576,warlock,destruction,12,6,6
Tøtøf,sargeras,576,warlock,destruction,12,6,6
Tropìcal,grim-batol,576,warlock,destruction,12,6,6
Chaostrain,sylvanas,576,warlock,destruction,12,6,6
Voidstim,stormscale,576,warlock,destruction,12,6,6
Mothor,blackrock,576,warlock,destruction,12,6,6
Erimdur,sanguino,576,warlock,destruction,12,6,6
Koramu,blackrock,576,warlock,destruction,12,6,6
Jjejo,ragnaros,576,warlock,destruction,12,6,6
Herador,draenor,576,warlock,destruction,12,6,6
Mayden,uldum,576,warlock,destruction,12,6,6
Депрессыш,gordunni,576,warlock,destruction,12,6,6
Hasigome,blackmoore,576,warlock,destruction,12,6,6
Issyl,kazzak,576,warlock,destruction,12,6,6
Fearbót,kazzak,576,warlock,destruction,12,6,6
Ðåñtåy,ravencrest,576,warlock,destruction,12,6,6
Felrazer,silvermoon,576,warlock,destruction,12,6,6
Forgepower,ghostlands,576,warlock,destruction,12,6,6
Bitshlog,draenor,576,warlock,destruction,12,6,6
Seya,azuremyst,576,warlock,destruction,12,6,6
Ralyz,archimonde,576,warlock,destruction,12,6,6
Sécret,blackmoore,576,warlock,destruction,12,6,6
Cokelight,thrall,576,warlock,destruction,12,6,6
Gatewatcher,argent-dawn,576,warlock,destruction,12,6,6
Chafir,kazzak,576,warlock,destruction,12,6,6
Embercurse,ravencrest,576,warlock,destruction,12,6,6
Teemzen,tarren-mill,576,warlock,destruction,12,6,6
Staudi,eredar,576,warlock,destruction,12,6,6
Goosebumps,aggramar,576,warlock,destruction,12,6,6
Slonertw,ragnaros,576,warlock,destruction,12,6,6
Shlipshlap,ravencrest,576,warlock,destruction,12,6,6
Nutopia,stormreaver,576,warlock,destruction,12,6,6
Edgyrpname,argent-dawn,576,warlock,destruction,12,6,6
Rylewl,draenor,576,warlock,destruction,12,6,6
Laanik,twisting-nether,576,warlock,destruction,12,6,6
Diabolics,twisting-nether,576,warlock,destruction,12,6,6
Мерзея,soulflayer,576,warlock,destruction,12,6,6
Mosslock,silvermoon,576,warlock,destruction,12,6,6
Petitcayou,archimonde,576,warlock,destruction,12,6,6
Mozo,stormscale,576,warlock,destruction,12,6,6
Súícìdèbøy,colinas-pardas,576,warlock,destruction,12,6,6
Ilikebolts,blackmoore,576,warlock,destruction,12,6,6
Liwerno,dunemaul,576,warlock,destruction,12,6,6
Cali,ahnqiraj,576,warlock,destruction,12,6,6
Drainforlife,blackrock,576,warlock,destruction,12,6,6
Jasdemonly,stormscale,576,warlock,destruction,12,6,6
Bountyqt,outland,576,warlock,destruction,12,6,6
Jazggzkekw,twisting-nether,576,warlock,destruction,12,6,6
Chaudor,archimonde,576,warlock,destruction,12,6,6
Enaio,mannoroth,576,warlock,destruction,12,6,6
Dmnw,antonidas,576,warlock,destruction,12,6,6
Ðuß,nemesis,576,warlock,destruction,12,6,6
Warlockxx,ravencrest,576,warlock,destruction,12,6,6
Aranax,thrall,576,warlock,destruction,12,6,6
Ooze,kazzak,576,warlock,destruction,12,6,6
Ðiavel,kazzak,576,warlock,destruction,12,6,6
Kukkojapallo,ravencrest,576,warlock,destruction,12,6,6
Нежныйафлик,gordunni,576,warlock,destruction,12,6,6
Ilovethena,hyjal,576,warlock,destruction,12,6,6
Krebares,draenor,576,warlock,destruction,12,6,6
Warlockyo,blackrock,576,warlock,destruction,12,6,6
Gangleader,ravencrest,576,warlock,destruction,12,6,6
Спанчгэри,soulflayer,576,warlock,destruction,15,7,8
Телкадрейнх,gordunni,576,warlock,destruction,15,7,8
Azmondan,ahnqiraj,576,warlock,destruction,18,6,12
Kriemias,malygos,576,warlock,destruction,18,6,12
Naitix,argent-dawn,576,warlock,destruction,18,6,12
Icq,ravencrest,576,warlock,destruction,18,6,12
Zartax,kazzak,576,warlock,destruction,18,6,12
Pämppää,stormscale,576,warlock,destruction,18,6,12
Morwëk,ysondre,576,warlock,destruction,18,6,12
Alexcurse,draenor,576,warlock,destruction,18,6,12
Tartaros,bronzebeard,576,warlock,destruction,18,6,12
Zerx,malganis,576,warlock,destruction,18,6,12
Shreedlock,blackmoore,576,warlock,destruction,18,6,12
Мглавечная,soulflayer,576,warlock,destruction,25,6,19
Huaraches,stormscale,575,warlock,destruction,12,6,6
Brarvile,zuljin,575,warlock,destruction,12,6,6
Sweetfire,ragnaros,575,warlock,destruction,12,6,6
Warlockzor,auchindoun,575,warlock,destruction,12,6,6
Swagzz,silvermoon,575,warlock,destruction,12,6,6
Yumala,frostmourne,575,warlock,destruction,12,6,6
Lisànna,nemesis,575,warlock,destruction,12,6,6
Dottad,silvermoon,575,warlock,destruction,12,6,6
Rhaznor,frostwolf,575,warlock,destruction,12,6,6
Cocottee,la-croisade-écarlate,575,warlock,destruction,12,6,6
Дракшара,soulflayer,575,warlock,destruction,12,6,6
Zevil,emerald-dream,575,warlock,destruction,12,6,6
Nemssy,dun-modr,575,warlock,destruction,18,6,12
Mÿxin,blackhand,575,warlock,destruction,18,6,12
Ramurox,rexxar,575,warlock,destruction,18,6,12
Klone,die-todeskrallen,575,warlock,destruction,18,6,12
Евнухоидизм,gordunni,575,warlock,destruction,18,6,12
Yasagoth,chamber-of-aspects,575,warlock,destruction,24,6,18
Pederlock,defias-brotherhood,575,warlock,destruction,24,6,18
Tommies,die-nachtwache,574,warlock,destruction,12,6,6
Ванфирмен,gordunni,574,warlock,destruction,12,6,6
Валак,greymane,574,warlock,destruction,15,7,8
Haysang,khaz-modan,574,warlock,destruction,18,6,12
Nathgar,drakthul,574,warlock,destruction,18,6,12
Taxalias,draenor,572,warlock,destruction,12,6,6
Sitosa,todeswache,572,warlock,destruction,12,6,6
Nizha,sanguino,566,warlock,destruction,12,6,6
Олимта,blackscar,558,warlock,destruction,23,6,17
Weexi,kazzak,543,warlock,destruction,8,7,1
Hasábqtja,ragnaros,543,warlock,destruction,11,6,5
Amakusa,archimonde,543,warlock,destruction,16,6,10
Srbritoboy,burning-legion,540,warlock,destruction,11,6,5
Rozn,ravencrest,527,warlock,destruction,11,6,5
Стафилокок,deepholm,527,warlock,destruction,11,6,5
Tarhatar,tarren-mill,527,warlock,destruction,11,6,5
Yasa,khaz-modan,526,warlock,destruction,23,6,17
Брузир,gordunni,522,warlock,destruction,15,7,8
Тива,lich-king,522,warlock,destruction,21,7,14
Llilithh,draenor,511,warlock,destruction,10,6,4
Wanhëda,tarren-mill,511,warlock,destruction,11,6,5
Evilhippie,kazzak,511,warlock,destruction,11,6,5
Diddia,malganis,511,warlock,destruction,11,6,5
Baxiaz,kazzak,511,warlock,destruction,11,6,5
Noskillclass,stormscale,511,warlock,destruction,14,6,8
Watchlock,burning-legion,488,warlock,destruction,19,6,13
Doomdog,hyjal,480,warlock,destruction,6,5,1
Saganelle,hyjal,480,warlock,destruction,6,5,1
Mellown,blackrock,480,warlock,destruction,6,5,1
Hotdogvendor,kazzak,480,warlock,destruction,6,5,1
Verminosiss,stormscale,480,warlock,destruction,6,5,1
Failtráin,blackhand,480,warlock,destruction,6,5,1
Ionesdot,ravencrest,480,warlock,destruction,6,5,1
Sep,aegwynn,480,warlock,destruction,6,5,1
Sumstone,kazzak,480,warlock,destruction,6,5,1
Yzzie,drakthul,480,warlock,destruction,6,5,1
Xeró,quelthalas,480,warlock,destruction,6,5,1
Destrodmitri,blackmoore,480,warlock,destruction,6,5,1
Höfmänn,grim-batol,480,warlock,destruction,6,5,1
Nerdlockx,tarren-mill,480,warlock,destruction,6,5,1
Журанайсбой,blackscar,480,warlock,destruction,6,5,1
Sgaitxd,ravencrest,480,warlock,destruction,6,5,1
Fearpuss,dun-modr,480,warlock,destruction,6,5,1
Sgait,ravencrest,480,warlock,destruction,6,5,1
Zurael,mannoroth,480,warlock,destruction,6,5,1
Lyndi,nerathor,480,warlock,destruction,6,5,1
Demonmilf,ysondre,480,warlock,destruction,6,5,1
Chibbe,twisting-nether,480,warlock,destruction,6,5,1
Avadakèdavra,kazzak,480,warlock,destruction,6,5,1
ßualock,sylvanas,480,warlock,destruction,6,5,1
Lazytown,silvermoon,480,warlock,destruction,6,5,1
Disgraced,stormscale,480,warlock,destruction,6,5,1
Sizezero,tarren-mill,480,warlock,destruction,6,5,1
Buffdemolock,executus,480,warlock,destruction,6,5,1
Файрусх,soulflayer,480,warlock,destruction,6,5,1
Shoøt,dalaran,480,warlock,destruction,6,5,1
Kevinbolter,kult-der-verdammten,480,warlock,destruction,6,5,1
Селфдестракт,howling-fjord,480,warlock,destruction,6,5,1
Djløckgødx,ravencrest,480,warlock,destruction,6,5,1
Levinbrz,ravencrest,480,warlock,destruction,6,5,1
Sénsemann,madmortem,480,warlock,destruction,6,5,1
Beltazhor,kazzak,480,warlock,destruction,6,5,1
Xtasyslock,archimonde,480,warlock,destruction,6,5,1
Lísbeth,sylvanas,480,warlock,destruction,6,5,1
Asreaël,uldum,480,warlock,destruction,6,5,1
Kirtaçh,dun-modr,480,warlock,destruction,6,5,1
Garbrandt,tarren-mill,480,warlock,destruction,6,5,1
Darkbasilet,hyjal,480,warlock,destruction,6,5,1
Måracujå,kazzak,480,warlock,destruction,6,5,1
Mazuto,outland,480,warlock,destruction,6,5,1
Djolagourde,archimonde,480,warlock,destruction,6,5,1
Hinsu,the-maelstrom,480,warlock,destruction,6,5,1
Náwwk,blackmoore,480,warlock,destruction,6,5,1
Bánánbánd,draenor,480,warlock,destruction,6,5,1
Luccifer,ravencrest,480,warlock,destruction,6,5,1
Jûnkz,ysondre,480,warlock,destruction,6,5,1
Altfdrölf,blackhand,480,warlock,destruction,6,5,1
Hydock,twisting-nether,480,warlock,destruction,6,5,1
Sâlty,stormscale,480,warlock,destruction,6,5,1
Севербрянск,soulflayer,480,warlock,destruction,6,5,1
Ashid,chamber-of-aspects,480,warlock,destruction,6,5,1
Ампе,blackscar,480,warlock,destruction,6,5,1
Андаинг,soulflayer,480,warlock,destruction,6,5,1
Hargart,ysondre,480,warlock,destruction,6,5,1
Хэлласс,blackscar,480,warlock,destruction,6,5,1
Hannens,blackrock,480,warlock,destruction,6,5,1
Mannemus,tarren-mill,480,warlock,destruction,6,5,1
Dogbolt,stormscale,480,warlock,destruction,6,5,1
Vyku,burning-legion,480,warlock,destruction,12,5,7
Graveshaker,quelthalas,480,warlock,destruction,12,5,7
Axapnon,ragnaros,480,warlock,destruction,12,5,7
Phántom,frostmane,480,warlock,destruction,12,5,7
Rikudoua,malfurion,480,warlock,destruction,12,5,7
Sadisticlól,burning-legion,480,warlock,destruction,12,5,7
Boohyakka,tarren-mill,480,warlock,destruction,12,5,7
Zerozwolf,tarren-mill,480,warlock,destruction,12,5,7
Käristäjä,outland,480,warlock,destruction,12,5,7
Sidius,archimonde,480,warlock,destruction,12,5,7
Yokûjin,twisting-nether,480,warlock,destruction,12,5,7
Ratnu,ragnaros,480,warlock,destruction,12,5,7
Facépalm,draenor,480,warlock,destruction,12,5,7
Toutseul,eitrigg,480,warlock,destruction,12,5,7
Kimwexler,ravencrest,480,warlock,destruction,12,5,7
Pewmlock,antonidas,480,warlock,destruction,12,5,7
Sokyra,tarren-mill,480,warlock,destruction,12,5,7
Pliagaa,drakthul,480,warlock,destruction,12,5,7
Arthesia,archimonde,480,warlock,destruction,12,5,7
Icony,blackhand,480,warlock,destruction,12,5,7
Zeanort,zuljin,480,warlock,destruction,12,5,7
Tiwtera,draenor,480,warlock,destruction,12,5,7
Branduir,ragnaros,480,warlock,destruction,12,5,7
Динодотз,howling-fjord,480,warlock,destruction,12,5,7
Fluxlight,frostmourne,480,warlock,destruction,12,5,7
Cerberus,anetheron,480,warlock,destruction,12,5,7
Feardotfive,frostwolf,480,warlock,destruction,12,5,7
Cursè,stormscale,480,warlock,destruction,12,5,7
Меркус,howling-fjord,480,warlock,destruction,12,5,7
Snoreghast,tarren-mill,480,warlock,destruction,12,5,7
Bricktot,ragnaros,480,warlock,destruction,12,5,7
Кайдзуки,howling-fjord,480,warlock,destruction,12,5,7
Braegnok,ravencrest,480,warlock,destruction,12,5,7
Nefalya,hyjal,480,warlock,destruction,12,5,7
Corruptcoil,argent-dawn,480,warlock,destruction,12,5,7
Lyleath,ravencrest,480,warlock,destruction,12,5,7
Thorky,blackrock,480,warlock,destruction,12,5,7
Asper,ragnaros,480,warlock,destruction,12,5,7
Crokorc,ysondre,480,warlock,destruction,12,5,7
Yeluna,alleria,480,warlock,destruction,12,5,7
Kontanthjælp,tarren-mill,480,warlock,destruction,12,5,7
Bajsibyx,tarren-mill,480,warlock,destruction,12,5,7
Elmetro,ragnaros,480,warlock,destruction,12,5,7
Dabolt,archimonde,480,warlock,destruction,12,5,7
Southyx,stormscale,480,warlock,destruction,12,5,7
Zlok,silvermoon,480,warlock,destruction,12,5,7
Zêngâ,kazzak,480,warlock,destruction,12,5,7
Shadowscurse,sylvanas,480,warlock,destruction,12,5,7
Claralock,silvermoon,480,warlock,destruction,12,5,7
Жижакабра,soulflayer,480,warlock,destruction,12,5,7
Вериберри,gordunni,480,warlock,destruction,12,5,7
Infïnitýx,silvermoon,480,warlock,destruction,12,5,7
Danzil,silvermoon,480,warlock,destruction,12,5,7
Voodooskull,kazzak,480,warlock,destruction,12,5,7
Rhev,trollbane,480,warlock,destruction,14,5,9
Händerå,ragnaros,480,warlock,destruction,18,5,13
Lockned,outland,480,warlock,destruction,18,5,13
Maledictio,blackrock,480,warlock,destruction,18,5,13
Infectius,kazzak,480,warlock,destruction,18,5,13
Fujiitøra,ysondre,479,warlock,destruction,9,5,4
Сенсация,ashenvale,479,warlock,destruction,12,5,7
Rumpelelse,blackrock,479,warlock,destruction,12,5,7
Kokonix,defias-brotherhood,479,warlock,destruction,12,5,7
Archélion,silvermoon,479,warlock,destruction,12,5,7
Chaosboltfm,silvermoon,479,warlock,destruction,17,5,12
Intina,dragonblight,479,warlock,destruction,18,5,13
Bope,the-maelstrom,479,warlock,destruction,18,5,13
Yenkorov,blackmoore,479,warlock,destruction,18,5,13
Fesse,draenor,479,warlock,destruction,18,5,13
Слававдвх,blackscar,478,warlock,destruction,6,5,1
Лавамес,eversong,478,warlock,destruction,10,6,4
Soulsdeads,sylvanas,478,warlock,destruction,12,5,7
Yourdeaath,ravencrest,478,warlock,destruction,18,5,13
Safirae,blackmoore,478,warlock,destruction,19,5,14
Espilocka,dun-modr,477,warlock,destruction,6,5,1
Grumrah,argent-dawn,468,warlock,destruction,30,10,20
Helikopter,shattered-hand,463,warlock,destruction,12,6,6
Góblér,blackrock,463,warlock,destruction,11,5,6
Снчч,soulflayer,463,warlock,destruction,11,5,6
Lokicica,karazhan,463,warlock,destruction,17,5,12
Winterx,argent-dawn,447,warlock,destruction,11,5,6
Favris,antonidas,447,warlock,destruction,11,5,6
Hahahahah,draenor,447,warlock,destruction,11,5,6
Даркинсоул,soulflayer,432,warlock,destruction,9,6,3
Силксонг,soulflayer,431,warlock,destruction,11,5,6
Chornota,ravencrest,431,warlock,destruction,17,5,12
Cooldowns,ravencrest,424,warlock,destruction,19,7,12
Skadz,blackmoore,416,warlock,destruction,10,5,5
Hønneyjckk,hyjal,415,warlock,destruction,8,5,3
Fearylia,aegwynn,393,warlock,destruction,11,8,3
Hirasawa,archimonde,384,warlock,destruction,6,4,2
Zéik,archimonde,384,warlock,destruction,6,4,2
Spacecarry,archimonde,384,warlock,destruction,6,4,2
Ineri,hyjal,384,warlock,destruction,6,4,2
Azae,outland,384,warlock,destruction,6,4,2
Anyfears,outland,384,warlock,destruction,6,4,2
Raddikal,archimonde,384,warlock,destruction,6,4,2
Voídzero,hyjal,384,warlock,destruction,6,4,2
Nilsa,eredar,384,warlock,destruction,6,4,2
Onyw,onyxia,384,warlock,destruction,6,4,2
Kankbae,stormscale,384,warlock,destruction,6,4,2
Gemja,onyxia,384,warlock,destruction,6,4,2
Dübêl,gorgonnash,384,warlock,destruction,6,4,2
Nosferatia,kult-der-verdammten,384,warlock,destruction,6,4,2
Mcdotnálds,thrall,384,warlock,destruction,6,4,2
Cokkà,dalaran,384,warlock,destruction,6,4,2
Ez,frostmane,384,warlock,destruction,6,4,2
Døxz,blackrock,384,warlock,destruction,6,4,2
Shaarak,blackrock,384,warlock,destruction,6,4,2
Shindubelore,aggra-português,384,warlock,destruction,6,4,2
Darklobos,aggra-português,384,warlock,destruction,6,4,2
Schluépfêr,blackrock,384,warlock,destruction,6,4,2
Vae,doomhammer,384,warlock,destruction,6,4,2
Äri,blackmoore,384,warlock,destruction,6,4,2
Ðotbot,grim-batol,384,warlock,destruction,6,4,2
Hiloqtlock,blackmoore,384,warlock,destruction,6,4,2
Fatbaldold,ravencrest,384,warlock,destruction,6,4,2
Sêro,aegwynn,384,warlock,destruction,6,4,2
Bwc,aegwynn,384,warlock,destruction,6,4,2
Feyreah,blackmoore,384,warlock,destruction,6,4,2
Aldiac,aegwynn,384,warlock,destruction,6,4,2
Xskyrov,blackmoore,384,warlock,destruction,6,4,2
Острогриф,gordunni,384,warlock,destruction,6,4,2
Трудзастафф,gordunni,384,warlock,destruction,6,4,2
Cursier,blackmoore,384,warlock,destruction,6,4,2
Анрали,soulflayer,384,warlock,destruction,6,4,2
Кичи,gordunni,384,warlock,destruction,6,4,2
Zzooxxie,silvermoon,384,warlock,destruction,6,4,2
Dikkdickens,ravencrest,384,warlock,destruction,6,4,2
Anicetus,ravencrest,384,warlock,destruction,6,4,2
Mikthelock,nemesis,384,warlock,destruction,6,4,2
Cappaoow,ravencrest,384,warlock,destruction,6,4,2
Дыханиетени,soulflayer,384,warlock,destruction,6,4,2
Sunlicht,kazzak,384,warlock,destruction,6,4,2
Penorr,silvermoon,384,warlock,destruction,6,4,2
Unfeared,blackhand,384,warlock,destruction,6,4,2
Xenastro,silvermoon,384,warlock,destruction,6,4,2
Taon,ravencrest,384,warlock,destruction,6,4,2
Rngmåchinêx,ravencrest,384,warlock,destruction,6,4,2
Yifu,ravencrest,384,warlock,destruction,6,4,2
Cadrega,nemesis,384,warlock,destruction,6,4,2
Darkwìngduck,ravencrest,384,warlock,destruction,6,4,2
Drshegs,darkspear,384,warlock,destruction,6,4,2
Droguri,darkspear,384,warlock,destruction,6,4,2
Destroylol,draenor,384,warlock,destruction,6,4,2
Egiriefo,twisting-nether,384,warlock,destruction,6,4,2
Malthiria,silvermoon,384,warlock,destruction,6,4,2
Iulu,sylvanas,384,warlock,destruction,6,4,2
Xolìe,azshara,384,warlock,destruction,6,4,2
Jägerlock,draenor,384,warlock,destruction,6,4,2
Dashirø,drakthul,384,warlock,destruction,6,4,2
Zexan,drakthul,384,warlock,destruction,6,4,2
Nechli,malganis,384,warlock,destruction,6,4,2
Vêzor,twisting-nether,384,warlock,destruction,6,4,2
Shreklock,burning-blade,384,warlock,destruction,6,4,2
Sïlïthuss,ravencrest,384,warlock,destruction,6,4,2
Sfwicked,tarren-mill,384,warlock,destruction,6,4,2
Côr,twisting-nether,384,warlock,destruction,6,4,2
Pujatia,tarren-mill,384,warlock,destruction,6,4,2
Dotritos,tarren-mill,384,warlock,destruction,6,4,2
Skâald,senjin,384,warlock,destruction,6,4,2
Elayjalock,twisting-nether,384,warlock,destruction,6,4,2
Boltsofdoom,kazzak,384,warlock,destruction,6,4,2
Пчелокнижник,howling-fjord,384,warlock,destruction,6,4,2
Pantry,tarren-mill,384,warlock,destruction,6,4,2
Bellatrìxx,madmortem,384,warlock,destruction,6,4,2
Ðênnis,tarren-mill,384,warlock,destruction,6,4,2
Критокнижник,lich-king,384,warlock,destruction,6,4,2
Uqrlock,twisting-nether,384,warlock,destruction,6,4,2
Deathmahed,kazzak,384,warlock,destruction,6,4,2
Grixius,argent-dawn,384,warlock,destruction,6,4,2
Warchilly,twisting-nether,384,warlock,destruction,6,4,2
Blyskawicar,silvermoon,384,warlock,destruction,6,4,2
Хелентесс,goldrinn,384,warlock,destruction,6,4,2
Auchaos,argent-dawn,384,warlock,destruction,6,4,2
Nãshor,kazzak,384,warlock,destruction,6,4,2
Fearlólz,stormscale,384,warlock,destruction,6,4,2
Zilthon,dragonblight,384,warlock,destruction,6,4,2
Элнуар,soulflayer,384,warlock,destruction,6,4,2
Watchmecut,terenas,384,warlock,destruction,6,4,2
Siyaa,eredar,384,warlock,destruction,6,4,2
Чернаяскала,howling-fjord,384,warlock,destruction,6,4,2
Notloveless,stormscale,384,warlock,destruction,6,4,2
Apeliction,eredar,384,warlock,destruction,6,4,2
Krekk,ragnaros,384,warlock,destruction,6,4,2
Biihz,ysondre,384,warlock,destruction,6,4,2
Dampini,ravencrest,384,warlock,destruction,6,4,2
Suicidekings,draenor,384,warlock,destruction,6,4,2
Déemón,draenor,384,warlock,destruction,6,4,2
Rayfears,draenor,384,warlock,destruction,6,4,2
Candleburner,khaz-modan,384,warlock,destruction,6,4,2
Traickolock,antonidas,384,warlock,destruction,6,4,2
Cräwley,ragnaros,384,warlock,destruction,6,4,2
Born,ravencrest,384,warlock,destruction,6,4,2
Ahylleslook,antonidas,384,warlock,destruction,6,4,2
Harrydóttár,draenor,384,warlock,destruction,6,4,2
Mèsmerize,tarren-mill,384,warlock,destruction,9,5,4
Рыжевласочка,eversong,384,warlock,destruction,9,5,4
Omnípotens,silvermoon,384,warlock,destruction,12,6,6
Lockpup,draenor,384,warlock,destruction,12,4,8
Ieatfel,archimonde,384,warlock,destruction,12,4,8
Atúm,auchindoun,384,warlock,destruction,12,4,8
Closetlock,the-maelstrom,384,warlock,destruction,12,4,8
Darkmaw,drakthul,384,warlock,destruction,12,4,8
Darthvder,sylvanas,384,warlock,destruction,12,4,8
Lilkit,kazzak,384,warlock,destruction,12,4,8
Chäös,outland,384,warlock,destruction,12,4,8
Lîlu,hyjal,384,warlock,destruction,12,4,8
Zvinto,the-maelstrom,384,warlock,destruction,12,4,8
Waryald,dun-modr,384,warlock,destruction,12,4,8
Tdoggydog,ragnaros,384,warlock,destruction,12,4,8
Yandihimir,silvermoon,384,warlock,destruction,12,4,8
Lünatix,archimonde,384,warlock,destruction,12,4,8
Nicetime,nefarian,384,warlock,destruction,12,4,8
Kaobolt,archimonde,384,warlock,destruction,12,4,8
Novkan,eredar,384,warlock,destruction,12,4,8
Cirihexer,area-52,384,warlock,destruction,12,4,8
Марэд,howling-fjord,384,warlock,destruction,12,4,8
Чиззихаос,soulflayer,384,warlock,destruction,12,4,8
Бешентумай,goldrinn,384,warlock,destruction,12,4,8
Vanskor,argent-dawn,384,warlock,destruction,12,4,8
Impvader,argent-dawn,384,warlock,destruction,12,4,8
Oimera,frostwolf,384,warlock,destruction,12,4,8
Roedin,tarren-mill,384,warlock,destruction,12,4,8
Hheavens,ragnaros,384,warlock,destruction,12,4,8
Nahamma,tarren-mill,384,warlock,destruction,12,4,8
Ksenìa,khaz-modan,384,warlock,destruction,12,4,8
Scheprick,twisting-nether,384,warlock,destruction,12,4,8
Vextalock,drakthul,384,warlock,destruction,12,4,8
Harrydotterx,alakir,384,warlock,destruction,12,4,8
Andrewtaint,twisting-nether,384,warlock,destruction,12,4,8
Falakros,ravencrest,384,warlock,destruction,12,4,8
Legiozock,draenor,384,warlock,destruction,12,4,8
Waîdo,blackhand,384,warlock,destruction,12,4,8
Vsmna,ragnaros,384,warlock,destruction,12,4,8
Tekron,blackhand,384,warlock,destruction,12,4,8
Thigh,burning-legion,384,warlock,destruction,12,4,8
Wajiggity,ravencrest,384,warlock,destruction,12,4,8
Mustalol,outland,384,warlock,destruction,12,4,8
Мазаффак,gordunni,384,warlock,destruction,12,4,8
Hòbó,outland,384,warlock,destruction,12,4,8
Gacknur,zuljin,384,warlock,destruction,12,4,8
Lonestar,sanguino,384,warlock,destruction,12,4,8
Лоллиторпеда,gordunni,384,warlock,destruction,12,4,8
Sellinia,culte-de-la-rive-noire,384,warlock,destruction,12,4,8
Axy,dun-modr,384,warlock,destruction,12,4,8
Demoncius,dun-modr,384,warlock,destruction,12,4,8
Tiitz,blackmoore,384,warlock,destruction,12,4,8
Muninnus,archimonde,384,warlock,destruction,12,4,8
Shadowflare,blackmoore,384,warlock,destruction,12,4,8
Уфц,grom,384,warlock,destruction,12,4,8
Стокыч,soulflayer,384,warlock,destruction,12,4,8
Narstia,archimonde,384,warlock,destruction,12,4,8
Nazmordith,argent-dawn,384,warlock,destruction,18,4,14
Thinio,argent-dawn,384,warlock,destruction,18,4,14
Korne,nemesis,384,warlock,destruction,18,4,14
Okulus,quelthalas,383,warlock,destruction,6,4,2
Angrynoob,silvermoon,383,warlock,destruction,6,4,2
Injecter,stormscale,383,warlock,destruction,6,4,2
Avel,dun-morogh,383,warlock,destruction,15,5,10
Dathos,ragnaros,383,warlock,destruction,12,4,8
Lagoren,draenor,383,warlock,destruction,12,4,8
Olympos,draenor,383,warlock,destruction,12,4,8
Orcboltz,tarren-mill,383,warlock,destruction,12,4,8
Pidka,drakthul,382,warlock,destruction,6,4,2
Сатари,blackscar,378,warlock,destruction,20,9,11
Драуктар,eversong,365,warlock,destruction,11,4,7
Tolgaa,draenor,352,warlock,destruction,17,4,13
Britneyfear,aegwynn,351,warlock,destruction,8,5,3
Damßalla,cthun,330,warlock,destruction,11,8,3
Destroc,blackrock,330,warlock,destruction,11,5,6
Рейнджр,eversong,330,warlock,destruction,15,6,9
Velativ,silvermoon,330,warlock,destruction,16,5,11
Lockpz,sylvanas,330,warlock,destruction,18,5,13
Gomezz,dalaran,320,warlock,destruction,10,4,6
Лвнг,gordunni,320,warlock,destruction,10,4,6
Malganas,sylvanas,320,warlock,destruction,16,4,12
Sapheâ,burning-legion,319,warlock,destruction,5,4,1
Chev,nemesis,319,warlock,destruction,5,4,1
Tibzx,stormscale,288,warlock,destruction,6,3,3
Ghosthound,stormscale,288,warlock,destruction,6,3,3
Palmtri,stormscale,288,warlock,destruction,6,3,3
Marakh,stormscale,288,warlock,destruction,6,3,3
Goatpuss,stormrage,288,warlock,destruction,6,3,3
Hazzikosby,ravencrest,288,warlock,destruction,6,3,3
Epoku,stormscale,288,warlock,destruction,6,3,3
Drith,blades-edge,288,warlock,destruction,6,3,3
Bestwarlock,ravencrest,288,warlock,destruction,6,3,3
Neveah,festung-der-stürme,288,warlock,destruction,6,3,3
Brambam,stormrage,288,warlock,destruction,6,3,3
Maevex,stormscale,288,warlock,destruction,6,3,3
Bribon,sanguino,288,warlock,destruction,6,3,3
Vaimex,stormscale,288,warlock,destruction,6,3,3
Chedipes,stormscale,288,warlock,destruction,6,3,3
Belite,archimonde,288,warlock,destruction,6,3,3
Rokudaime,stormscale,288,warlock,destruction,6,3,3
Zabani,das-syndikat,288,warlock,destruction,6,3,3
Kaîdö,archimonde,288,warlock,destruction,6,3,3
Slem,aerie-peak,288,warlock,destruction,6,3,3
Demonologyz,ravencrest,288,warlock,destruction,6,3,3
Akdan,ragnaros,288,warlock,destruction,6,3,3
Nargøf,outland,288,warlock,destruction,6,3,3
Nêstêe,archimonde,288,warlock,destruction,6,3,3
Hammern,haomarush,288,warlock,destruction,6,3,3
Винстролман,blackscar,288,warlock,destruction,6,3,3
Dekawa,ravencrest,288,warlock,destruction,6,3,3
Besthun,drakthul,288,warlock,destruction,6,3,3
Ðanilock,dun-modr,288,warlock,destruction,6,3,3
Løvesøsa,ravencrest,288,warlock,destruction,6,3,3
Lotud,drakthul,288,warlock,destruction,6,3,3
Oldefar,ravencrest,288,warlock,destruction,6,3,3
Рипхард,gordunni,288,warlock,destruction,6,3,3
Bluh,twisting-nether,288,warlock,destruction,6,3,3
Rindo,conseil-des-ombres,288,warlock,destruction,6,3,3
Ascètic,kazzak,288,warlock,destruction,6,3,3
Cálamity,magtheridon,288,warlock,destruction,6,3,3
Gïzzmo,tarren-mill,288,warlock,destruction,6,3,3
Volontáry,stormscale,288,warlock,destruction,6,3,3
Arakaali,dentarg,288,warlock,destruction,6,3,3
Jeepsee,outland,288,warlock,destruction,6,3,3
Sleive,ravencrest,288,warlock,destruction,6,3,3
Zzooxx,silvermoon,288,warlock,destruction,6,3,3
Lockskalle,tarren-mill,288,warlock,destruction,6,3,3
Raggnarlock,ravencrest,288,warlock,destruction,6,3,3
Tschiko,blackrock,288,warlock,destruction,6,3,3
Frankieboi,drakthul,288,warlock,destruction,6,3,3
Widot,ravencrest,288,warlock,destruction,6,3,3
Vladov,ravencrest,288,warlock,destruction,6,3,3
Mentalx,outland,288,warlock,destruction,6,3,3
Deamheòlas,ravencrest,288,warlock,destruction,6,3,3
Флорэтт,gordunni,288,warlock,destruction,6,3,3
Darkspiros,tarren-mill,288,warlock,destruction,6,3,3
Aghmar,ravencrest,288,warlock,destruction,6,3,3
Jiruga,blackrock,288,warlock,destruction,6,3,3
Hiroyukí,frostmane,288,warlock,destruction,6,3,3
Ромаколдун,howling-fjord,288,warlock,destruction,6,3,3
Lamboo,tarren-mill,288,warlock,destruction,6,3,3
Dragmetohêll,blackhand,288,warlock,destruction,6,3,3
Amdownbad,kazzak,288,warlock,destruction,6,3,3
Demónfire,sylvanas,288,warlock,destruction,6,3,3
Anniemoon,silvermoon,288,warlock,destruction,6,3,3
Brolter,blackhand,288,warlock,destruction,6,3,3
Useidûm,ravencrest,288,warlock,destruction,6,3,3
Impsgalore,ravencrest,288,warlock,destruction,6,3,3
Jörd,ravencrest,288,warlock,destruction,6,3,3
Truckpunch,defias-brotherhood,288,warlock,destruction,6,3,3
Mightnáré,tarren-mill,288,warlock,destruction,6,3,3
Исусилок,deathguard,288,warlock,destruction,6,3,3
Пачимучка,gordunni,288,warlock,destruction,6,3,3
Boltez,twisting-nether,288,warlock,destruction,6,3,3
Pekenina,outland,288,warlock,destruction,6,3,3
Vech,blackmoore,288,warlock,destruction,6,3,3
Shayexen,tarren-mill,288,warlock,destruction,6,3,3
Omaleinfluch,antonidas,288,warlock,destruction,6,3,3
Húxy,silvermoon,288,warlock,destruction,6,3,3
Yippz,kazzak,288,warlock,destruction,6,3,3
Ремайка,gordunni,288,warlock,destruction,6,3,3
Dexterlol,blackmoore,288,warlock,destruction,6,3,3
Soulslugger,twisting-nether,288,warlock,destruction,6,3,3
Silås,hyjal,288,warlock,destruction,6,3,3
Toutanpapier,ysondre,288,warlock,destruction,6,3,3
Elmîr,blackmoore,288,warlock,destruction,6,3,3
Ruinovino,outland,288,warlock,destruction,6,3,3
Дядяджонн,gordunni,288,warlock,destruction,6,3,3
Celphboss,twisting-nether,288,warlock,destruction,6,3,3
Maquan,blackmoore,288,warlock,destruction,6,3,3
Saymore,ragnaros,288,warlock,destruction,6,3,3
Brudergottes,blackmoore,288,warlock,destruction,6,3,3
Ubinaz,blackmoore,288,warlock,destruction,6,3,3
Fearylicious,burning-legion,288,warlock,destruction,6,3,3
Seldonn,pozzo-delleternità,288,warlock,destruction,6,3,3
Adreal,burning-legion,288,warlock,destruction,6,3,3
Dement,sanguino,288,warlock,destruction,6,3,3
Ogrez,nemesis,288,warlock,destruction,6,3,3
Snowflakesxs,draenor,288,warlock,destruction,6,3,3
Динодотх,gordunni,288,warlock,destruction,6,3,3
Kírth,blackmoore,288,warlock,destruction,6,3,3
Hairylock,outland,288,warlock,destruction,6,3,3
Kradrog,nemesis,288,warlock,destruction,6,3,3
Уанбаттон,gordunni,288,warlock,destruction,6,3,3
Adacheezzee,tyrande,288,warlock,destruction,6,3,3
Skizofrenia,zuljin,288,warlock,destruction,6,3,3
Глотающий,gordunni,288,warlock,destruction,6,3,3
Zozano,draenor,288,warlock,destruction,6,3,3
Cpump,twisting-nether,288,warlock,destruction,6,3,3
Гвадривер,howling-fjord,288,warlock,destruction,6,3,3
Talt,dalaran,288,warlock,destruction,6,3,3
Seyzz,eredar,288,warlock,destruction,6,3,3
Nethros,ragnaros,288,warlock,destruction,6,3,3
Drozhna,kaelthas,288,warlock,destruction,6,3,3
Нэрфир,soulflayer,288,warlock,destruction,6,3,3
Huaian,darksorrow,288,warlock,destruction,6,3,3
Lokdok,draenor,288,warlock,destruction,6,3,3
Djshyasiañ,perenolde,288,warlock,destruction,6,3,3
Biancalawson,argent-dawn,288,warlock,destruction,6,3,3
Fazol,terokkar,288,warlock,destruction,6,3,3
Gharloch,argent-dawn,288,warlock,destruction,6,3,3
Zizzbrah,ragnaros,288,warlock,destruction,6,3,3
Dmger,twisting-nether,288,warlock,destruction,6,3,3
Sodadogpìn,nemesis,288,warlock,destruction,6,3,3
Læssêkøñgð,twisting-nether,288,warlock,destruction,6,3,3
Некусайсасай,galakrond,288,warlock,destruction,6,3,3
Jabalock,mazrigos,288,warlock,destruction,6,3,3
Toskanoamani,blackmoore,288,warlock,destruction,6,3,3
Kuntdotz,draenor,288,warlock,destruction,6,3,3
Lubomirek,turalyon,288,warlock,destruction,6,3,3
Demofox,ragnaros,288,warlock,destruction,6,3,3
Aches,sylvanas,288,warlock,destruction,6,3,3
Taylorg,blackmoore,288,warlock,destruction,6,3,3
Данябандит,soulflayer,288,warlock,destruction,6,3,3
Fearhealer,blackmoore,288,warlock,destruction,6,3,3
Jazggzgirl,blackmoore,288,warlock,destruction,6,3,3
Пучкова,azuregos,288,warlock,destruction,12,3,9
Киёкка,howling-fjord,288,warlock,destruction,12,3,9
Nímdaa,stormscale,288,warlock,destruction,12,3,9
Quief,silvermoon,288,warlock,destruction,12,3,9
Ladodida,darkspear,288,warlock,destruction,12,3,9
Daeneerys,skullcrusher,288,warlock,destruction,12,3,9
Dreadbøt,blackrock,288,warlock,destruction,12,3,9
Dotzillâ,blackhand,288,warlock,destruction,12,3,9
Phéar,deathwing,288,warlock,destruction,12,3,9
Mitrela,ravencrest,288,warlock,destruction,12,3,9
Tepelkwastje,twisting-nether,288,warlock,destruction,12,3,9
Svartalfen,outland,288,warlock,destruction,12,3,9
Matheus,zenedar,288,warlock,destruction,12,3,9
Варикай,gordunni,288,warlock,destruction,12,3,9
Jaines,forscherliga,288,warlock,destruction,12,3,9
Merelock,eonar,288,warlock,destruction,12,3,9
Shelbys,tyrande,288,warlock,destruction,12,3,9
Valgg,tarren-mill,288,warlock,destruction,12,3,9
Leatherfvce,blackmoore,288,warlock,destruction,12,3,9
Voib,silvermoon,288,warlock,destruction,12,3,9
Swoksáar,blackmoore,288,warlock,destruction,12,3,9
Gooey,magtheridon,288,warlock,destruction,12,3,9
Killerbeez,burning-blade,288,warlock,destruction,12,3,9
Werlock,sanguino,288,warlock,destruction,12,3,9
Xrathis,thunderhorn,288,warlock,destruction,12,3,9
Адомать,lich-king,288,warlock,destruction,12,3,9
Tiffyilock,blackrock,288,warlock,destruction,12,3,9
Skyrender,argent-dawn,288,warlock,destruction,12,3,9
Arizyoxot,twisting-nether,288,warlock,destruction,12,3,9
Sebi,kirin-tor,288,warlock,destruction,12,3,9
Peggybrown,turalyon,288,warlock,destruction,12,3,9
Aloxer,sanguino,288,warlock,destruction,12,3,9
Jaír,turalyon,288,warlock,destruction,12,3,9
Нагибатель,howling-fjord,288,warlock,destruction,18,3,15
Fewton,eonar,288,warlock,destruction,18,3,15
Wegart,sylvanas,287,warlock,destruction,6,3,3
Грашек,soulflayer,287,warlock,destruction,6,3,3
Lárgo,chamber-of-aspects,271,warlock,destruction,11,3,8
Dollmak,hyjal,270,warlock,destruction,11,4,7
Армдэд,galakrond,255,warlock,destruction,11,3,8
Absúrd,turalyon,240,warlock,destruction,9,3,6
Insertchaos,draenor,239,warlock,destruction,5,3,2
Brushiè,kazzak,239,warlock,destruction,5,3,2
Darthdotz,outland,234,warlock,destruction,7,4,3
Diemilch,blackmoore,234,warlock,destruction,8,4,4
Тиранчухан,howling-fjord,234,warlock,destruction,15,4,11
Sineko,twisting-nether,233,warlock,destruction,11,6,5
Ðankan,aegwynn,192,warlock,destruction,4,3,1
Vexsir,kazzak,192,warlock,destruction,9,3,6
Vortëxx,tarren-mill,192,warlock,destruction,9,3,6
Хоратхе,soulflayer,192,warlock,destruction,6,2,4
Ralys,draenor,192,warlock,destruction,6,2,4
Angrythots,draenor,192,warlock,destruction,6,2,4
Degdeehei,draenor,192,warlock,destruction,6,2,4
Майдум,soulflayer,192,warlock,destruction,6,2,4
Elfex,ragnaros,192,warlock,destruction,6,2,4
Haxs,ravencrest,192,warlock,destruction,6,2,4
Mákas,draenor,192,warlock,destruction,6,2,4
Saabnoolock,ragnaros,192,warlock,destruction,6,2,4
Selur,ragnaros,192,warlock,destruction,6,2,4
Sherrÿ,ragnaros,192,warlock,destruction,6,2,4
Piouturass,hyjal,192,warlock,destruction,6,2,4
Vextos,draenor,192,warlock,destruction,6,2,4
Whórélóck,ravencrest,192,warlock,destruction,6,2,4
Øupas,ysondre,192,warlock,destruction,6,2,4
Cindela,eredar,192,warlock,destruction,6,2,4
Tragus,ghostlands,192,warlock,destruction,6,2,4
Splojf,the-maelstrom,192,warlock,destruction,6,2,4
Levitibus,argent-dawn,192,warlock,destruction,6,2,4
Kleing,dragonblight,192,warlock,destruction,6,2,4
Шэдоубёрн,soulflayer,192,warlock,destruction,6,2,4
Ðaddyy,stormscale,192,warlock,destruction,6,2,4
Shuggul,draenor,192,warlock,destruction,6,2,4
Meapx,ragnaros,192,warlock,destruction,6,2,4
Purplehelmet,argent-dawn,192,warlock,destruction,6,2,4
Nazw,ravencrest,192,warlock,destruction,6,2,4
Efekentli,frostwolf,192,warlock,destruction,6,2,4
Zòóf,stormscale,192,warlock,destruction,6,2,4
Nasiegboch,frostwolf,192,warlock,destruction,6,2,4
Ангебор,howling-fjord,192,warlock,destruction,6,2,4
Zkrwl,kazzak,192,warlock,destruction,6,2,4
Guldãn,silvermoon,192,warlock,destruction,6,2,4
Somalidog,ravencrest,192,warlock,destruction,6,2,4
Lightswitchz,ravencrest,192,warlock,destruction,6,2,4
Zenaidaa,doomhammer,192,warlock,destruction,6,2,4
Dinolock,antonidas,192,warlock,destruction,6,2,4
Zmataryn,doomhammer,192,warlock,destruction,6,2,4
Turbofamilly,hyjal,192,warlock,destruction,6,2,4
Snoggä,antonidas,192,warlock,destruction,6,2,4
Локеда,deathguard,192,warlock,destruction,6,2,4
Kedrat,die-aldor,192,warlock,destruction,6,2,4
Ainzlok,tarren-mill,192,warlock,destruction,6,2,4
Caiiden,kazzak,192,warlock,destruction,6,2,4
Agonux,twisting-nether,192,warlock,destruction,6,2,4
Kabowie,twisting-nether,192,warlock,destruction,6,2,4
Revvolt,tarren-mill,192,warlock,destruction,6,2,4
Bulgyeøng,archimonde,192,warlock,destruction,6,2,4
Grandulf,ravencrest,192,warlock,destruction,6,2,4
Werkx,archimonde,192,warlock,destruction,6,2,4
Ashhlock,silvermoon,192,warlock,destruction,6,2,4
Nâzgrel,tarren-mill,192,warlock,destruction,6,2,4
Prydzor,archimonde,192,warlock,destruction,6,2,4
Sinlockz,tarren-mill,192,warlock,destruction,6,2,4
Creamcleaner,tarren-mill,192,warlock,destruction,6,2,4
Dødheim,malganis,192,warlock,destruction,6,2,4
Incubith,ravencrest,192,warlock,destruction,6,2,4
Wezen,stormscale,192,warlock,destruction,6,2,4
Cosec,silvermoon,192,warlock,destruction,6,2,4
Benztruck,blackhand,192,warlock,destruction,6,2,4
Whydidudotha,ravencrest,192,warlock,destruction,6,2,4
Jöhanan,twisting-nether,192,warlock,destruction,6,2,4
Durátor,ravencrest,192,warlock,destruction,6,2,4
Necrochiller,tarren-mill,192,warlock,destruction,6,2,4
Semhein,twisting-nether,192,warlock,destruction,6,2,4
Qullnius,kazzak,192,warlock,destruction,6,2,4
Уставок,soulflayer,192,warlock,destruction,6,2,4
Zhulthan,ravencrest,192,warlock,destruction,6,2,4
Cptdotalot,tarren-mill,192,warlock,destruction,6,2,4
Longchamp,stormscale,192,warlock,destruction,6,2,4
Ght,outland,192,warlock,destruction,6,2,4
Siìre,ravencrest,192,warlock,destruction,6,2,4
Cuufi,silvermoon,192,warlock,destruction,6,2,4
Necrofearz,sylvanas,192,warlock,destruction,6,2,4
Rojas,trollbane,192,warlock,destruction,6,2,4
Fixwarlock,blackmoore,192,warlock,destruction,6,2,4
Ravendoor,grim-batol,192,warlock,destruction,6,2,4
Ívânguldán,twisting-nether,192,warlock,destruction,6,2,4
Locknroll,terokkar,192,warlock,destruction,6,2,4
Sôshy,thrall,192,warlock,destruction,6,2,4
Kemel,thrall,192,warlock,destruction,6,2,4
Jaliyah,outland,192,warlock,destruction,6,2,4
Nedhriix,drakthul,192,warlock,destruction,6,2,4
Æyna,thrall,192,warlock,destruction,6,2,4
Aváne,outland,192,warlock,destruction,6,2,4
Nerflocks,aggra-português,192,warlock,destruction,6,2,4
Bigusdicus,aszune,192,warlock,destruction,6,2,4
Belzedan,blackrock,192,warlock,destruction,6,2,4
Atomik,drakthul,192,warlock,destruction,6,2,4
Grilljédén,blackrock,192,warlock,destruction,6,2,4
Öhö,blackrock,192,warlock,destruction,6,2,4
Laynih,blackrock,192,warlock,destruction,6,2,4
Kuzimu,aerie-peak,192,warlock,destruction,6,2,4
Houndread,kazzak,192,warlock,destruction,6,2,4
Negoda,defias-brotherhood,192,warlock,destruction,6,2,4
Astralvoid,outland,192,warlock,destruction,6,2,4
Toshiku,aggra-português,192,warlock,destruction,6,2,4
Sôlon,azshara,192,warlock,destruction,6,2,4
Zigfipszen,blackmoore,192,warlock,destruction,6,2,4
Smoulville,sanguino,192,warlock,destruction,6,2,4
Chuntlock,shadowsong,192,warlock,destruction,6,2,4
Guldän,quelthalas,192,warlock,destruction,6,2,4
Zagana,neptulon,192,warlock,destruction,6,2,4
Malfari,zuljin,192,warlock,destruction,6,2,4
Merengue,uldum,192,warlock,destruction,6,2,4
Prestige,nemesis,192,warlock,destruction,6,2,4
Hacknator,aegwynn,192,warlock,destruction,6,2,4
Faustes,alakir,192,warlock,destruction,6,2,4
Lockerby,kazzak,192,warlock,destruction,6,2,4
Емс,gordunni,192,warlock,destruction,6,2,4
Хашонмвп,gordunni,192,warlock,destruction,6,2,4
Bloodysûgar,blackmoore,192,warlock,destruction,6,2,4
Thîras,tarren-mill,192,warlock,destruction,7,2,5
Xjms,darksorrow,192,warlock,destruction,9,2,7
Kiriforce,blackmoore,192,warlock,destruction,12,2,10
Srhal,blackmoore,192,warlock,destruction,12,2,10
Agathaharkne,minahonda,192,warlock,destruction,12,2,10
Themits,executus,192,warlock,destruction,12,2,10
Skratti,lightnings-blade,192,warlock,destruction,12,2,10
Shallän,dun-modr,192,warlock,destruction,12,2,10
Nimwyn,argent-dawn,192,warlock,destruction,12,2,10
Punishteens,blackmoore,192,warlock,destruction,12,2,10
Àbraxàs,nemesis,192,warlock,destruction,12,2,10
Naginii,sanguino,192,warlock,destruction,12,2,10
Kopfkissen,azshara,192,warlock,destruction,12,2,10
Titoss,archimonde,192,warlock,destruction,12,2,10
Amnésïa,eldrethalas,192,warlock,destruction,12,2,10
Mambra,sylvanas,192,warlock,destruction,12,2,10
Нэйрокризиз,howling-fjord,192,warlock,destruction,12,2,10
Michtv,hyjal,192,warlock,destruction,12,2,10
Sarómán,ravencrest,192,warlock,destruction,12,2,10
Rafael,stormscale,192,warlock,destruction,13,2,11
Zùrghan,elune,191,warlock,destruction,4,3,1
Flisiakm,exodar,191,warlock,destruction,6,2,4
Karjarock,hyjal,191,warlock,destruction,12,2,10
Gaios,skullcrusher,191,warlock,destruction,18,2,16
Lockbubs,draenor,175,warlock,destruction,11,2,9
Pewnedmpx,archimonde,159,warlock,destruction,5,2,3
Jiltoks,blackmoore,159,warlock,destruction,5,2,3
Grimlòck,antonidas,159,warlock,destruction,5,2,3
Dony,dun-morogh,159,warlock,destruction,5,2,3
Neg,sylvanas,159,warlock,destruction,5,2,3
Hp,ysondre,159,warlock,destruction,5,2,3
Lemonzx,stormscale,159,warlock,destruction,5,2,3
Smolpussgodx,ragnaros,144,warlock,destruction,3,3,0
Lockki,blades-edge,138,warlock,destruction,7,3,4
Vahk,uldum,138,warlock,destruction,7,3,4
Rb,anachronos,138,warlock,destruction,8,3,5
Wdauwg,nazjatar,138,warlock,destruction,9,3,6
Hhogyoku,dentarg,138,warlock,destruction,10,3,7
Belzzebuth,silvermoon,128,warlock,destruction,10,2,8
Перегном,blackscar,127,warlock,destruction,8,2,6
Mqsxw,stormscale,112,warlock,destruction,7,2,5
Neijihbolt,blackrock,112,warlock,destruction,7,2,5
Mergon,ravencrest,96,warlock,destruction,3,2,1
Dannyboi,drakthul,96,warlock,destruction,3,2,1
Áéé,kazzak,96,warlock,destruction,3,2,1
Mulimarus,die-todeskrallen,96,warlock,destruction,3,2,1
Ozzycrøwly,illidan,96,warlock,destruction,9,2,7
Feliciousx,draenor,96,warlock,destruction,6,1,5
Dabezdwl,outland,96,warlock,destruction,6,1,5
Pichwise,draenor,96,warlock,destruction,6,1,5
Daemonic,shattered-hand,96,warlock,destruction,6,1,5
Xanth,eldrethalas,96,warlock,destruction,6,1,5
Aenygma,jaedenar,96,warlock,destruction,6,1,5
Empod,ragnaros,96,warlock,destruction,6,1,5
Eleriya,argent-dawn,96,warlock,destruction,6,1,5
Chaotick,bronze-dragonflight,96,warlock,destruction,6,1,5
Raest,arygos,96,warlock,destruction,6,1,5
Wt,twisting-nether,96,warlock,destruction,6,1,5
Xuloth,ravencrest,96,warlock,destruction,6,1,5
Neuth,draenor,96,warlock,destruction,6,1,5
Redî,kazzak,96,warlock,destruction,6,1,5
Gothgul,sanguino,96,warlock,destruction,6,1,5
Deathdawning,draenor,96,warlock,destruction,6,1,5
Omnath,alakir,96,warlock,destruction,6,1,5
Gutras,ragnaros,96,warlock,destruction,6,1,5
Musallat,argent-dawn,96,warlock,destruction,6,1,5
Trinox,teldrassil,96,warlock,destruction,6,1,5
Cleoputra,sylvanas,96,warlock,destruction,6,1,5
Chaostheory,stormscale,96,warlock,destruction,6,1,5
Löck,kirin-tor,96,warlock,destruction,6,1,5
Lilskunk,draenor,96,warlock,destruction,6,1,5
Elnïa,conseil-des-ombres,96,warlock,destruction,6,1,5
Dalfgan,wildhammer,96,warlock,destruction,6,1,5
Язлаякиска,soulflayer,96,warlock,destruction,6,1,5
Mattihoh,rexxar,96,warlock,destruction,6,1,5
Ariyala,alleria,96,warlock,destruction,6,1,5
Fuglylock,the-maelstrom,96,warlock,destruction,6,1,5
Gulzgan,kazzak,96,warlock,destruction,6,1,5
Mortvivants,kirin-tor,96,warlock,destruction,6,1,5
Azgaroth,kazzak,96,warlock,destruction,6,1,5
Krabauf,eredar,96,warlock,destruction,6,1,5
Reiukh,frostwolf,96,warlock,destruction,6,1,5
Utuklululu,archimonde,96,warlock,destruction,6,1,5
Kærastan,sylvanas,96,warlock,destruction,6,1,5
Selok,outland,96,warlock,destruction,6,1,5
Нотимба,gordunni,96,warlock,destruction,6,1,5
Satânius,les-sentinelles,96,warlock,destruction,6,1,5
Walchia,kazzak,96,warlock,destruction,6,1,5
Shompaqzan,kazzak,96,warlock,destruction,6,1,5
Маверрикк,gordunni,96,warlock,destruction,6,1,5
Növnöv,madmortem,96,warlock,destruction,6,1,5
Désolaté,kazzak,96,warlock,destruction,6,1,5
Seriasa,blackmoore,96,warlock,destruction,6,1,5
Сквиртонитх,howling-fjord,96,warlock,destruction,6,1,5
Cruello,ragnaros,96,warlock,destruction,6,1,5
Lomendro,blackmoore,96,warlock,destruction,6,1,5
Ramuhn,antonidas,96,warlock,destruction,6,1,5
Kathuum,outland,96,warlock,destruction,6,1,5
Fell,outland,96,warlock,destruction,6,1,5
Bytethisx,aggra-português,96,warlock,destruction,6,1,5
Fearmighty,kazzak,96,warlock,destruction,6,1,5
Gendo,twisting-nether,96,warlock,destruction,6,1,5
Zeirat,tarren-mill,96,warlock,destruction,6,1,5
Hørcrux,ravencrest,96,warlock,destruction,6,1,5
Dadcrush,antonidas,96,warlock,destruction,6,1,5
Ackorax,kilrogg,96,warlock,destruction,6,1,5
Tyranuzz,norgannon,96,warlock,destruction,6,1,5
Snollerboy,antonidas,96,warlock,destruction,6,1,5
Infinitefire,ravencrest,96,warlock,destruction,6,1,5
Иммолэйтх,gordunni,96,warlock,destruction,6,1,5
Discolocken,outland,96,warlock,destruction,6,1,5
Indifférence,archimonde,96,warlock,destruction,6,1,5
Jynni,blackhand,96,warlock,destruction,6,1,5
Whiskeycola,blackmoore,96,warlock,destruction,6,1,5
Камнилока,booty-bay,96,warlock,destruction,6,1,5
Bigbabalock,frostwolf,96,warlock,destruction,6,1,5
Meisterhexe,taerar,96,warlock,destruction,6,1,5
Czteryka,silvermoon,96,warlock,destruction,6,1,5
Jujalari,stormscale,96,warlock,destruction,6,1,5
Thaliä,tarren-mill,96,warlock,destruction,6,1,5
Maidson,blackrock,96,warlock,destruction,6,1,5
Darkironhuan,blackrock,96,warlock,destruction,6,1,5
Rigour,silvermoon,96,warlock,destruction,6,1,5
Mursha,auchindoun,96,warlock,destruction,6,1,5
Mahishi,ravencrest,96,warlock,destruction,6,1,5
Nulo,aggra-português,96,warlock,destruction,6,1,5
Tiig,blackrock,96,warlock,destruction,6,1,5
Pablø,silvermoon,96,warlock,destruction,6,1,5
Znaj,tarren-mill,96,warlock,destruction,6,1,5
Nècrøphila,kazzak,96,warlock,destruction,6,1,5
Enmakorogi,twisting-nether,96,warlock,destruction,6,1,5
Isanê,blackrock,96,warlock,destruction,6,1,5
Buyala,stormscale,96,warlock,destruction,6,1,5
Vîerdotcom,blackrock,96,warlock,destruction,6,1,5
Tanatos,tarren-mill,96,warlock,destruction,6,1,5
Yerslock,twisting-nether,96,warlock,destruction,6,1,5
Methmuncher,twisting-nether,96,warlock,destruction,8,1,7
Gainel,exodar,96,warlock,destruction,12,1,11
Alithia,sylvanas,96,warlock,destruction,12,1,11
Keilahkang,aerie-peak,96,warlock,destruction,12,1,11
Реймей,blackscar,96,warlock,destruction,12,1,11
Democraft,the-maelstrom,96,warlock,destruction,12,1,11
Malagate,sylvanas,96,warlock,destruction,12,1,11
Wuahlock,doomhammer,96,warlock,destruction,12,1,11
Grêenbull,eredar,96,warlock,destruction,15,1,14
Magosnik,archimonde,79,warlock,destruction,5,1,4
Mesîkatayut,outland,79,warlock,destruction,11,1,10
Néca,blackmoore,64,warlock,destruction,4,1,3
Tranas,ragnaros,64,warlock,destruction,4,1,3
Malariaa,defias-brotherhood,63,warlock,destruction,2,2,0
Ruvy,twisting-nether,48,warlock,destruction,3,1,2
Coblac,outland,48,warlock,destruction,3,1,2
Colevid,blackmoore,42,warlock,destruction,6,2,4
Anthor,tarren-mill,42,warlock,destruction,8,2,6
Stonedup,alonsus,42,warlock,destruction,8,2,6
Obichamcici,tarren-mill,42,warlock,destruction,8,2,6
Rockstarr,dalaran,42,warlock,destruction,10,2,8
Kotihoitaja,stormreaver,42,warlock,destruction,10,2,8
Zuldiá,stormscale,32,warlock,destruction,2,2,0
Chandelierh,kazzak,31,warlock,destruction,2,1,1
Reconnected,drakthul,31,warlock,destruction,2,1,1
Kemmler,steamwheedle-cartel,16,warlock,destruction,1,1,0
Níkâ,aegwynn,16,warlock,destruction,1,1,0
Orkamorfin,silvermoon,16,warlock,destruction,1,1,0
Langneur,ysondre,2225,warlock,affliction,102,56,46
Bualock,sylvanas,2167,warlock,affliction,84,52,32
Tágsy,ravencrest,2130,warlock,affliction,90,47,43
Fruits,ysondre,2108,warlock,affliction,89,44,45
Micol,doomhammer,2091,warlock,affliction,90,44,46
Kärme,archimonde,2066,warlock,affliction,305,158,147
Arukekz,blackmoore,2058,warlock,affliction,84,43,41
Boogeyboyx,stormscale,2056,warlock,affliction,101,59,42
Southylolz,stormscale,2015,warlock,affliction,71,36,35
Härèsß,dun-modr,1997,warlock,affliction,96,53,43
Nickrosh,terokkar,1989,warlock,affliction,66,39,27
Darksooul,xavius,1987,warlock,affliction,72,44,28
Arussj,blackrock,1984,warlock,affliction,62,33,29
Chobitas,ravencrest,1978,warlock,affliction,120,60,60
Hædês,antonidas,1972,warlock,affliction,102,51,51
Magonyth,tarren-mill,1963,warlock,affliction,71,41,30
Celebí,blackmoore,1959,warlock,affliction,66,40,26
Southyx,stormscale,1928,warlock,affliction,77,40,37
Kaspersdame,ravencrest,1927,warlock,affliction,201,100,101
Steckenpferd,blackmoore,1924,warlock,affliction,48,27,21
Qyburn,drekthar,1923,warlock,affliction,66,40,26
Southy,stormscale,1918,warlock,affliction,48,25,23
Rutena,ravencrest,1918,warlock,affliction,72,37,35
Mïta,hyjal,1904,warlock,affliction,48,27,21
Kasoy,doomhammer,1894,warlock,affliction,139,75,64
Infernion,stormscale,1891,warlock,affliction,51,33,18
Nesme,sylvanas,1890,warlock,affliction,59,28,31
Gezer,tarren-mill,1880,warlock,affliction,98,54,44
Skrumpis,draenor,1880,warlock,affliction,209,106,103
Garebigger,blackrock,1880,warlock,affliction,132,62,70
Тагочи,gordunni,1876,warlock,affliction,53,28,25
Gulzot,turalyon,1866,warlock,affliction,71,37,34
Debz,twisting-nether,1864,warlock,affliction,118,71,47
Plsdîe,twisting-nether,1862,warlock,affliction,65,37,28
Southylol,stormscale,1858,warlock,affliction,90,45,45
Perpetual,eredar,1857,warlock,affliction,42,23,19
Fsandtwo,ravencrest,1848,warlock,affliction,62,33,29
Блудгэнг,blackscar,1847,warlock,affliction,48,21,27
Xfz,stormscale,1835,warlock,affliction,102,57,45
Cassen,outland,1833,warlock,affliction,60,31,29
Getfaked,nordrassil,1832,warlock,affliction,54,28,26
Bäle,stormreaver,1831,warlock,affliction,48,29,19
Пчелокнижник,howling-fjord,1831,warlock,affliction,42,25,17
Mediumpotato,blackhand,1824,warlock,affliction,48,26,22
Sad,lightnings-blade,1821,warlock,affliction,82,32,50
Xvq,twisting-nether,1819,warlock,affliction,106,67,39
Malddog,turalyon,1813,warlock,affliction,131,75,56
Angryfránk,outland,1811,warlock,affliction,161,77,84
Limoges,archimonde,1809,warlock,affliction,66,41,25
Nightìngale,silvermoon,1808,warlock,affliction,92,51,41
Nêverse,archimonde,1805,warlock,affliction,30,19,11
Мрорбит,howling-fjord,1804,warlock,affliction,42,19,23
Wldot,ravencrest,1802,warlock,affliction,42,24,18
Monsterz,archimonde,1801,warlock,affliction,88,47,41
Alliyâh,archimonde,1795,warlock,affliction,118,54,64
Bankstair,stormscale,1779,warlock,affliction,105,58,47
Oldboy,auchindoun,1771,warlock,affliction,36,24,12
Infïnitýx,silvermoon,1732,warlock,affliction,89,46,43
Zodiiacc,ravencrest,1723,warlock,affliction,66,32,34
Demonkïng,archimonde,1722,warlock,affliction,54,29,25
Trâshxd,sanguino,1719,warlock,affliction,66,42,24
Kajanova,stormscale,1717,warlock,affliction,66,40,26
Baz,anubarak,1717,warlock,affliction,56,24,32
Neoe,stormscale,1705,warlock,affliction,108,54,54
Архкингсдум,galakrond,1704,warlock,affliction,58,27,31
Hladankurac,twisting-nether,1700,warlock,affliction,38,22,16
Graveflesh,burning-blade,1700,warlock,affliction,191,93,98
Methroz,burning-legion,1680,warlock,affliction,48,25,23
Oarz,blackrock,1678,warlock,affliction,59,35,24
Fear,auchindoun,1676,warlock,affliction,41,22,19
Vîmø,antonidas,1658,warlock,affliction,96,53,43
Emreys,argent-dawn,1656,warlock,affliction,139,73,66
Yokûjin,twisting-nether,1650,warlock,affliction,49,22,27
Nekrosd,tarren-mill,1646,warlock,affliction,84,46,38
Локбезног,soulflayer,1639,warlock,affliction,48,30,18
Zeinth,sanguino,1636,warlock,affliction,78,43,35
Dondot,frostmane,1630,warlock,affliction,66,39,27
Ketzu,hyjal,1626,warlock,affliction,118,59,59
Rottndot,stormscale,1624,warlock,affliction,72,40,32
Termss,ravencrest,1622,warlock,affliction,286,147,139
Prelest,arathor,1620,warlock,affliction,24,17,7
Ржоммба,soulflayer,1618,warlock,affliction,66,38,28
Brainsoup,burning-blade,1616,warlock,affliction,66,31,35
Acentro,stormscale,1615,warlock,affliction,51,32,19
Ashhlock,silvermoon,1613,warlock,affliction,42,24,18
Htaedfo,tarren-mill,1612,warlock,affliction,60,34,26
Сзот,howling-fjord,1612,warlock,affliction,42,22,20
Mortvivants,kirin-tor,1610,warlock,affliction,79,43,36
Orsoyopoyo,nemesis,1607,warlock,affliction,30,20,10
Mîná,ravencrest,1607,warlock,affliction,51,30,21
Фламмэнх,soulflayer,1604,warlock,affliction,36,21,15
Ремайка,gordunni,1603,warlock,affliction,134,68,66
Magonyth,ravencrest,1600,warlock,affliction,30,19,11
Асальвэйд,gordunni,1600,warlock,affliction,58,32,26
Нэрфир,soulflayer,1600,warlock,affliction,42,22,20
Журанайсбой,blackscar,1598,warlock,affliction,30,21,9
Shayexen,tarren-mill,1596,warlock,affliction,47,28,19
Smøkê,tarren-mill,1596,warlock,affliction,308,165,143
Corbbolt,drakthul,1586,warlock,affliction,44,24,20
Винстролман,blackscar,1576,warlock,affliction,90,59,31
Modernmisery,kazzak,1574,warlock,affliction,186,93,93
Müdür,burning-legion,1573,warlock,affliction,154,90,64
Ascètic,kazzak,1572,warlock,affliction,78,41,37
Auxi,the-maelstrom,1568,warlock,affliction,43,29,14
Jlcreverso,eredar,1563,warlock,affliction,28,18,10
Trevium,nemesis,1555,warlock,affliction,76,43,33
Soezzlock,archimonde,1551,warlock,affliction,141,77,64
Lollock,teldrassil,1549,warlock,affliction,24,17,7
Farzokonan,archimonde,1549,warlock,affliction,138,75,63
Yosiya,draenor,1546,warlock,affliction,69,34,35
Waatschnbaam,eredar,1540,warlock,affliction,48,22,26
Gneticz,aegwynn,1534,warlock,affliction,42,24,18
Сентимент,gordunni,1534,warlock,affliction,59,29,30
Osyx,ravencrest,1534,warlock,affliction,36,16,20
Slf,the-maelstrom,1533,warlock,affliction,52,32,20
Itiswhatitis,ravencrest,1532,warlock,affliction,36,16,20
Vregor,twisting-nether,1527,warlock,affliction,28,17,11
Nightsnake,deathwing,1516,warlock,affliction,114,50,64
Dezznut,blackhand,1513,warlock,affliction,65,36,29
Сайденас,gordunni,1508,warlock,affliction,59,26,33
Nerfwarriors,stormscale,1505,warlock,affliction,36,24,12
Robertóoo,burning-legion,1505,warlock,affliction,56,31,25
Katâra,tarren-mill,1505,warlock,affliction,80,36,44
Soffie,blackrock,1501,warlock,affliction,48,23,25
Soulslugger,twisting-nether,1500,warlock,affliction,36,17,19
Olympïe,archimonde,1500,warlock,affliction,42,17,25
Kayako,kul-tiras,1499,warlock,affliction,68,28,40
Drekkrog,chogall,1490,warlock,affliction,30,16,14
Franta,chromaggus,1488,warlock,affliction,35,21,14
Cringetamer,silvermoon,1488,warlock,affliction,36,17,19
Боризыч,gordunni,1487,warlock,affliction,125,67,58
Tøpdmg,die-aldor,1486,warlock,affliction,41,21,20
Saraconnor,burning-legion,1482,warlock,affliction,60,34,26
Разъелвал,blackscar,1478,warlock,affliction,90,53,37
Exorbïtant,blackrock,1477,warlock,affliction,150,76,74
Лысыйлокоть,soulflayer,1475,warlock,affliction,36,18,18
Mty,bronze-dragonflight,1475,warlock,affliction,105,51,54
Belíos,stormscale,1469,warlock,affliction,51,31,20
Spiritawayx,lightbringer,1467,warlock,affliction,24,18,6
Floron,silvermoon,1465,warlock,affliction,67,33,34
Lánfeár,draenor,1464,warlock,affliction,275,138,137
Depresive,aggra-português,1463,warlock,affliction,119,66,53
Влицотьмой,gordunni,1462,warlock,affliction,43,23,20
Олимта,blackscar,1461,warlock,affliction,94,45,49
Адоха,howling-fjord,1460,warlock,affliction,42,22,20
Yôi,nemesis,1457,warlock,affliction,36,19,17
Zèlêph,archimonde,1456,warlock,affliction,36,24,12
Zakuri,blackmoore,1452,warlock,affliction,48,32,16
Titoss,archimonde,1451,warlock,affliction,78,40,38
Potterhotter,outland,1446,warlock,affliction,57,30,27
Äsmødée,dalaran,1440,warlock,affliction,157,79,78
Azurma,tarren-mill,1439,warlock,affliction,24,15,9
Hivxherpes,ravencrest,1439,warlock,affliction,121,57,64
Dispellthat,burning-legion,1438,warlock,affliction,31,16,15
Прогнившая,blackscar,1437,warlock,affliction,111,63,48
Dracsu,dun-modr,1436,warlock,affliction,160,82,78
Wezen,stormscale,1435,warlock,affliction,95,50,45
Kakiamagisa,twisting-nether,1431,warlock,affliction,52,35,17
Ebolara,aegwynn,1427,warlock,affliction,47,23,24
Нафлэпил,gordunni,1425,warlock,affliction,59,32,27
Candyman,bronze-dragonflight,1424,warlock,affliction,92,44,48
Zêngâ,kazzak,1422,warlock,affliction,42,23,19
Demonologyz,ravencrest,1416,warlock,affliction,24,19,5
Marklock,drakthul,1412,warlock,affliction,60,37,23
Lockwkrok,burning-legion,1407,warlock,affliction,92,44,48
Talt,dalaran,1406,warlock,affliction,56,34,22
Brustlino,nemesis,1405,warlock,affliction,24,15,9
Шизуи,borean-tundra,1403,warlock,affliction,55,34,21
Axapnon,ragnaros,1403,warlock,affliction,207,100,107
Tarilinwelli,les-sentinelles,1401,warlock,affliction,116,65,51
Apokalyps,eldrethalas,1401,warlock,affliction,250,130,120
Nate,stormscale,1399,warlock,affliction,64,30,34
Mendozaah,kazzak,1397,warlock,affliction,48,20,28
Dannyel,mazrigos,1395,warlock,affliction,147,75,72
Murua,silvermoon,1387,warlock,affliction,30,15,15
Dondada,aggra-português,1386,warlock,affliction,55,27,28
Gaminex,kazzak,1386,warlock,affliction,90,43,47
Phelola,sylvanas,1384,warlock,affliction,63,33,30
Сартеккс,gordunni,1382,warlock,affliction,59,34,25
Dropxpvp,blackrock,1381,warlock,affliction,54,26,28
Pcbbwarlock,sylvanas,1380,warlock,affliction,180,100,80
Kavalierr,stormscale,1377,warlock,affliction,70,35,35
Teddyruineur,khaz-modan,1376,warlock,affliction,42,25,17
Pokifanone,tarren-mill,1376,warlock,affliction,29,16,13
Rottenbooty,argent-dawn,1374,warlock,affliction,30,15,15
Balgo,blackmoore,1372,warlock,affliction,30,17,13
Киёкка,howling-fjord,1371,warlock,affliction,48,29,19
Infectius,kazzak,1367,warlock,affliction,61,30,31
Délidumrul,stormscale,1364,warlock,affliction,30,20,10
Øprøx,sanguino,1356,warlock,affliction,17,15,2
Nîghtmare,outland,1353,warlock,affliction,35,20,15
Hòbó,outland,1353,warlock,affliction,51,28,23
Gash,malganis,1353,warlock,affliction,168,86,82
Akdan,ragnaros,1351,warlock,affliction,50,21,29
Hathatchi,sylvanas,1343,warlock,affliction,52,29,23
Hirasawa,archimonde,1343,warlock,affliction,40,15,25
Ммоохх,gordunni,1340,warlock,affliction,30,14,16
Whaii,ravencrest,1339,warlock,affliction,24,14,10
Anabolicbaby,draenor,1339,warlock,affliction,27,15,12
Degdeehei,draenor,1339,warlock,affliction,58,30,28
Дестроварлок,blackscar,1337,warlock,affliction,24,14,10
Itsfiftycent,outland,1337,warlock,affliction,66,36,30
Primdåhl,ravencrest,1335,warlock,affliction,64,34,30
Gryme,dalaran,1333,warlock,affliction,72,30,42
Vivek,grim-batol,1328,warlock,affliction,72,28,44
Assuz,eredar,1327,warlock,affliction,36,19,17
Лейссина,eversong,1327,warlock,affliction,89,43,46
Sublînê,blackmoore,1326,warlock,affliction,54,21,33
Maidson,blackrock,1325,warlock,affliction,24,14,10
Trythislock,crushridge,1325,warlock,affliction,29,16,13
Mayline,kult-der-verdammten,1322,warlock,affliction,30,17,13
Sánas,blackhand,1322,warlock,affliction,54,26,28
Grimus,azuremyst,1322,warlock,affliction,30,14,16
Warlokk,tarren-mill,1318,warlock,affliction,90,45,45
Cgane,archimonde,1317,warlock,affliction,34,20,14
Themits,executus,1314,warlock,affliction,34,15,19
Перегном,blackscar,1311,warlock,affliction,60,28,32
Getfeared,stormscale,1308,warlock,affliction,36,14,22
Deathpoid,draenor,1307,warlock,affliction,45,17,28
Sleethy,destromath,1306,warlock,affliction,36,18,18
Roglash,eredar,1304,warlock,affliction,92,50,42
Nihale,arakarahm,1304,warlock,affliction,64,29,35
Колдунишка,fordragon,1299,warlock,affliction,209,112,97
Jegfaller,wildhammer,1299,warlock,affliction,78,39,39
Scaevóla,ravencrest,1297,warlock,affliction,42,24,18
Bästkusten,kazzak,1294,warlock,affliction,28,16,12
Nesveti,kazzak,1290,warlock,affliction,18,14,4
Ketem,zuljin,1279,warlock,affliction,84,43,41
Lokic,draenor,1278,warlock,affliction,36,14,22
Izyguldamn,blackmoore,1276,warlock,affliction,48,16,32
Voost,aegwynn,1275,warlock,affliction,43,15,28
Zetsubo,drakthul,1270,warlock,affliction,105,55,50
Ukicha,burning-blade,1268,warlock,affliction,48,22,26
Hatenkou,silvermoon,1263,warlock,affliction,60,30,30
Diseez,bronzebeard,1262,warlock,affliction,45,24,21
Mooncrásh,blackrock,1261,warlock,affliction,66,32,34
Самантаглу,blackscar,1260,warlock,affliction,58,33,25
Датри,grom,1254,warlock,affliction,48,25,23
Tiwtera,draenor,1252,warlock,affliction,36,14,22
Стафилокок,deepholm,1248,warlock,affliction,36,19,17
Kitingguru,stormscale,1247,warlock,affliction,24,13,11
ßualock,sylvanas,1247,warlock,affliction,24,13,11
Рашчер,gordunni,1247,warlock,affliction,30,13,17
Yamadea,stormscale,1246,warlock,affliction,24,13,11
Apathia,stormscale,1245,warlock,affliction,18,13,5
Nhw,archimonde,1245,warlock,affliction,24,14,10
Shannzo,stormscale,1245,warlock,affliction,24,13,11
Hiimsûso,dun-modr,1240,warlock,affliction,41,21,20
Крэдоу,soulflayer,1239,warlock,affliction,24,13,11
Fearing,malganis,1239,warlock,affliction,30,13,17
Sïeur,archimonde,1238,warlock,affliction,24,13,11
Оксси,fordragon,1238,warlock,affliction,24,13,11
Kerthan,malorne,1237,warlock,affliction,68,31,37
Actelia,the-venture-co,1237,warlock,affliction,38,15,23
Yowifeinmedm,draenor,1234,warlock,affliction,36,13,23
Irnx,tarren-mill,1232,warlock,affliction,32,16,16
Shakuroz,frostwolf,1229,warlock,affliction,28,14,14
Dotieks,draenor,1228,warlock,affliction,114,58,56
Solitariøus,arathi,1227,warlock,affliction,36,17,19
Soultire,ravencrest,1227,warlock,affliction,66,29,37
Лютыйглад,blackscar,1226,warlock,affliction,31,16,15
Бенлоел,borean-tundra,1220,warlock,affliction,36,13,23
Томрэдл,howling-fjord,1218,warlock,affliction,236,120,116
Vîerdotcom,blackrock,1215,warlock,affliction,18,13,5
Локистраик,borean-tundra,1214,warlock,affliction,47,19,28
Lockinasock,stormscale,1208,warlock,affliction,18,13,5
Tsumde,dalaran,1207,warlock,affliction,44,16,28
Yasa,khaz-modan,1205,warlock,affliction,30,23,7
Xerxia,blackrock,1205,warlock,affliction,42,25,17
Etsanctum,blackmoore,1204,warlock,affliction,48,17,31
Draklack,turalyon,1202,warlock,affliction,66,34,32
Âkâl,ravencrest,1194,warlock,affliction,23,13,10
Kyiüû,archimonde,1194,warlock,affliction,27,14,13
Nexyra,silvermoon,1194,warlock,affliction,195,95,100
Vaukras,stormscale,1194,warlock,affliction,62,29,33
Qena,outland,1194,warlock,affliction,42,18,24
Malagate,sylvanas,1190,warlock,affliction,48,20,28
Swagzz,silvermoon,1185,warlock,affliction,60,33,27
Sunetta,silvermoon,1182,warlock,affliction,68,34,34
Gamunkul,destromath,1179,warlock,affliction,55,21,34
Ainos,twisting-nether,1178,warlock,affliction,35,18,17
Nydek,cthun,1178,warlock,affliction,36,16,20
Luzi,arthas,1172,warlock,affliction,30,14,16
Wedlock,stormscale,1171,warlock,affliction,29,19,10
Huaian,darksorrow,1170,warlock,affliction,56,26,30
Blackmagic,stormscale,1168,warlock,affliction,72,36,36
Robodot,eredar,1166,warlock,affliction,42,17,25
Sluba,stormscale,1155,warlock,affliction,24,14,10
Toppluva,shattered-hand,1151,warlock,affliction,21,13,8
Xskyrov,blackmoore,1151,warlock,affliction,24,12,12
Sehk,stormreaver,1151,warlock,affliction,24,12,12
Dhraven,thrall,1151,warlock,affliction,87,41,46
Thereya,dun-morogh,1150,warlock,affliction,24,12,12
Darkrorr,drakthul,1150,warlock,affliction,24,12,12
Cdztuwu,outland,1147,warlock,affliction,18,12,6
Walchia,kazzak,1147,warlock,affliction,83,44,39
Trinox,teldrassil,1144,warlock,affliction,24,15,9
Suskive,kaelthas,1141,warlock,affliction,24,12,12
Asmonmald,stormscale,1139,warlock,affliction,120,52,68
Zeotrixie,stormscale,1138,warlock,affliction,24,12,12
Whocarezlock,stormscale,1135,warlock,affliction,27,13,14
Requeims,outland,1119,warlock,affliction,22,12,10
Squadala,kaelthas,1115,warlock,affliction,30,15,15
Slowfatlock,ravencrest,1115,warlock,affliction,24,12,12
Felboar,quelthalas,1113,warlock,affliction,24,15,9
Hacklock,silvermoon,1110,warlock,affliction,78,34,44
Cokoladuocka,silvermoon,1107,warlock,affliction,48,21,27
Toké,blackmoore,1106,warlock,affliction,28,14,14
Yahata,nethersturm,1104,warlock,affliction,36,20,16
Dótcom,draenor,1104,warlock,affliction,42,21,21
Vahgaz,burning-legion,1103,warlock,affliction,121,62,59
Nicetime,nefarian,1102,warlock,affliction,24,13,11
Araphel,twisting-nether,1101,warlock,affliction,30,16,14
Favris,antonidas,1101,warlock,affliction,128,66,62
Cahoa,archimonde,1093,warlock,affliction,39,17,22
Горенджо,eversong,1092,warlock,affliction,26,13,13
Fraky,frostwhisper,1087,warlock,affliction,23,16,7
Консидёро,gordunni,1086,warlock,affliction,26,12,14
Modéus,ysondre,1086,warlock,affliction,36,16,20
Mæphysto,blackrock,1083,warlock,affliction,109,53,56
Сувала,soulflayer,1082,warlock,affliction,17,12,5
Ladodida,darkspear,1081,warlock,affliction,30,17,13
Diegomojes,silvermoon,1080,warlock,affliction,98,53,45
Аксиманд,howling-fjord,1069,warlock,affliction,35,17,18
Fealer,magtheridon,1065,warlock,affliction,198,101,97
Rhyana,sylvanas,1065,warlock,affliction,28,12,16
Mowxll,blackrock,1056,warlock,affliction,24,11,13
Fräddan,draenor,1054,warlock,affliction,12,11,1
Mjabowf,outland,1054,warlock,affliction,18,11,7
Bigdamndots,twisting-nether,1054,warlock,affliction,18,11,7
Císuh,stormreaver,1053,warlock,affliction,24,11,13
Мокито,grom,1052,warlock,affliction,24,11,13
Дотдозор,howling-fjord,1051,warlock,affliction,24,11,13
Zevil,emerald-dream,1047,warlock,affliction,24,11,13
Vladov,ravencrest,1045,warlock,affliction,24,11,13
Møärdötd,aggra-português,1044,warlock,affliction,24,11,13
Глянемче,deathguard,1040,warlock,affliction,27,14,13
Urssul,kazzak,1038,warlock,affliction,18,11,7
Blaizen,outland,1038,warlock,affliction,22,12,10
Тафуби,deathweaver,1037,warlock,affliction,18,11,7
Selenene,norgannon,1036,warlock,affliction,51,25,26
Nerdbane,blackrock,1033,warlock,affliction,18,11,7
Klone,die-todeskrallen,1026,warlock,affliction,27,12,15
Шайтанарба,blackscar,1025,warlock,affliction,42,25,17
Øzze,ysondre,1025,warlock,affliction,24,11,13
Gate,blackrock,1022,warlock,affliction,17,11,6
Бауглирх,howling-fjord,1019,warlock,affliction,23,11,12
Cutt,chogall,1018,warlock,affliction,53,23,30
Bësly,khaz-modan,1013,warlock,affliction,18,12,6
Олдриг,ashenvale,1013,warlock,affliction,39,18,21
Xlara,argent-dawn,1010,warlock,affliction,100,47,53
Venoc,kazzak,1007,warlock,affliction,108,54,54
Oonz,sylvanas,1006,warlock,affliction,56,28,28
Skufi,uldum,1004,warlock,affliction,42,20,22
Vendømlørd,archimonde,1003,warlock,affliction,31,17,14
Bluenote,colinas-pardas,1002,warlock,affliction,48,24,24
Sovrìn,blackrock,1002,warlock,affliction,23,11,12
Prekt,ragnaros,1001,warlock,affliction,17,11,6
Навидд,howling-fjord,995,warlock,affliction,30,15,15
Бестий,fordragon,989,warlock,affliction,14,11,3
Brítneyfears,azjolnerub,986,warlock,affliction,17,11,6
Bu,zirkel-des-cenarius,982,warlock,affliction,17,11,6
Qullnius,kazzak,971,warlock,affliction,34,12,22
Principle,dunemaul,965,warlock,affliction,36,21,15
Peonpedro,malganis,960,warlock,affliction,12,10,2
Murdee,kazzak,960,warlock,affliction,18,10,8
Dreamnyâsha,tarren-mill,960,warlock,affliction,18,10,8
Likee,eredar,960,warlock,affliction,30,10,20
Дагира,booty-bay,959,warlock,affliction,12,10,2
Pinacholadá,norgannon,959,warlock,affliction,12,10,2
Hannen,blackrock,959,warlock,affliction,24,10,14
Drstyx,anetheron,959,warlock,affliction,30,10,20
Azaïdun,khaz-modan,958,warlock,affliction,18,10,8
Коплюнапони,blackscar,958,warlock,affliction,18,10,8
Flyps,stormscale,958,warlock,affliction,18,10,8
Bowti,ravencrest,957,warlock,affliction,30,10,20
Снэйк,deathguard,956,warlock,affliction,18,10,8
Kyyuss,burning-legion,956,warlock,affliction,24,10,14
Dxz,silvermoon,956,warlock,affliction,30,10,20
Omnath,alakir,955,warlock,affliction,24,10,14
Sylrathas,burning-legion,953,warlock,affliction,24,10,14
Prickster,kazzak,952,warlock,affliction,18,10,8
Grimréaper,outland,950,warlock,affliction,24,10,14
Waryald,dun-modr,945,warlock,affliction,30,10,20
Carlman,hyjal,940,warlock,affliction,18,10,8
Darkháte,blackhand,936,warlock,affliction,18,10,8
Uthdae,archimonde,933,warlock,affliction,36,13,23
Дакиса,gordunni,925,warlock,affliction,35,10,25
Richrichy,outland,921,warlock,affliction,36,15,21
Слававдвх,blackscar,914,warlock,affliction,53,25,28
Ashgron,burning-legion,909,warlock,affliction,18,10,8
Rasputia,thunderhorn,906,warlock,affliction,45,24,21
Letoupet,la-croisade-écarlate,904,warlock,affliction,42,21,21
Murphloc,silvermoon,888,warlock,affliction,26,10,16
Artyrus,burning-legion,875,warlock,affliction,24,12,12
Мракодел,deathguard,872,warlock,affliction,21,11,10
Nukeem,karazhan,869,warlock,affliction,109,50,59
Парачо,eversong,864,warlock,affliction,12,9,3
Abinsur,drakthul,864,warlock,affliction,12,9,3
Gøzù,antonidas,864,warlock,affliction,18,9,9
Marcoil,kazzak,863,warlock,affliction,12,9,3
Boglock,argent-dawn,863,warlock,affliction,18,9,9
Mundunugu,sanguino,863,warlock,affliction,18,9,9
Mykóla,terokkar,863,warlock,affliction,18,9,9
Gaargamelo,blackmoore,863,warlock,affliction,24,9,15
Bh,ragnaros,862,warlock,affliction,18,9,9
Esmuel,argent-dawn,862,warlock,affliction,18,9,9
Aagon,antonidas,862,warlock,affliction,24,9,15
Tolgaa,draenor,862,warlock,affliction,28,10,18
Hitomitanaká,kazzak,862,warlock,affliction,28,9,19
Ívânguldán,twisting-nether,861,warlock,affliction,12,9,3
Darkwootex,draenor,861,warlock,affliction,15,10,5
Zelhala,draenor,861,warlock,affliction,18,9,9
Clungesuck,argent-dawn,861,warlock,affliction,18,9,9
Graell,drakthul,860,warlock,affliction,12,9,3
Mumutoaster,blackrock,860,warlock,affliction,12,9,3
Iml,grim-batol,859,warlock,affliction,28,10,18
Локомания,gordunni,859,warlock,affliction,30,9,21
Twnia,the-maelstrom,858,warlock,affliction,18,9,9
Ностра,gordunni,856,warlock,affliction,12,9,3
Цзинкэ,gordunni,855,warlock,affliction,18,9,9
Gulgash,blackrock,854,warlock,affliction,18,9,9
Iyna,blackmoore,853,warlock,affliction,18,9,9
Alithia,sylvanas,851,warlock,affliction,12,9,3
Sinsemilla,kazzak,846,warlock,affliction,18,9,9
Lemuriel,arthas,846,warlock,affliction,22,9,13
Luckriel,draenor,839,warlock,affliction,18,9,9
Shazem,tarren-mill,830,warlock,affliction,23,9,14
Pøzzi,hyjal,807,warlock,affliction,22,10,12
Pipêz,blackmoore,795,warlock,affliction,28,9,19
Sakkrethxd,hyjal,768,warlock,affliction,12,8,4
Zlomozg,laughing-skull,768,warlock,affliction,12,8,4
Noxtarius,thrall,768,warlock,affliction,12,8,4
Cârmondai,alleria,768,warlock,affliction,12,8,4
Bwc,aegwynn,768,warlock,affliction,18,8,10
Rudikiaz,sanguino,768,warlock,affliction,18,8,10
Демонтёлка,grom,767,warlock,affliction,14,10,4
Heavylock,sylvanas,767,warlock,affliction,12,8,4
Avoidsun,kazzak,767,warlock,affliction,18,8,10
Jinchi,outland,767,warlock,affliction,18,8,10
Dreggsow,blackmoore,767,warlock,affliction,24,8,16
Cêebêry,frostwolf,765,warlock,affliction,12,8,4
Deamheòlas,ravencrest,765,warlock,affliction,18,8,10
Promethazine,nemesis,764,warlock,affliction,18,8,10
Matheus,zenedar,763,warlock,affliction,18,8,10
Tzimice,hyjal,763,warlock,affliction,18,8,10
Diablotiin,hyjal,763,warlock,affliction,18,8,10
Smuutil,drakthul,762,warlock,affliction,12,8,4
Samigina,argent-dawn,762,warlock,affliction,24,8,16
Warlocker,anachronos,745,warlock,affliction,18,8,10
Hellseven,emeriss,735,warlock,affliction,23,8,15
Savith,defias-brotherhood,721,warlock,affliction,24,8,16
Friendlylock,quelthalas,720,warlock,affliction,15,8,7
Diwi,area-52,720,warlock,affliction,102,35,67
Öxygen,outland,672,warlock,affliction,12,7,5
Purplemafia,burning-blade,672,warlock,affliction,12,7,5
Turdy,sylvanas,672,warlock,affliction,12,7,5
Мануил,eversong,672,warlock,affliction,12,7,5
Kimkold,twisting-nether,672,warlock,affliction,12,7,5
Elleanor,los-errantes,672,warlock,affliction,12,7,5
Tôpsecret,aegwynn,672,warlock,affliction,12,7,5
Gnargamehl,nemesis,672,warlock,affliction,12,7,5
Hazelock,draenor,672,warlock,affliction,12,7,5
Langneur,archimonde,672,warlock,affliction,12,7,5
Йоранс,gordunni,672,warlock,affliction,12,7,5
Ilikebolts,blackmoore,672,warlock,affliction,12,7,5
Chaostrain,sylvanas,672,warlock,affliction,16,8,8
Tanón,sanguino,672,warlock,affliction,18,7,11
Кокобан,howling-fjord,672,warlock,affliction,18,7,11
Venaarus,antonidas,672,warlock,affliction,18,7,11
Lurkkis,ravencrest,672,warlock,affliction,18,7,11
Муза,gordunni,672,warlock,affliction,18,7,11
Beleghost,sylvanas,672,warlock,affliction,18,7,11
Mønarch,argent-dawn,672,warlock,affliction,18,7,11
Äri,blackmoore,671,warlock,affliction,12,7,5
Azalock,ragnaros,671,warlock,affliction,12,7,5
Drozhna,kaelthas,671,warlock,affliction,24,7,17
Моргррет,soulflayer,670,warlock,affliction,12,7,5
Proctolock,garona,670,warlock,affliction,12,7,5
Lockgamerx,ravencrest,670,warlock,affliction,12,7,5
Bakal,vashj,670,warlock,affliction,18,7,11
Sesshouin,alakir,670,warlock,affliction,18,7,11
Eveline,onyxia,670,warlock,affliction,28,8,20
Алануэйк,deathguard,669,warlock,affliction,12,7,5
Greenlock,la-croisade-écarlate,668,warlock,affliction,12,7,5
Нэйрокризиз,howling-fjord,668,warlock,affliction,12,7,5
Juod,frostmane,667,warlock,affliction,12,7,5
Дольпико,howling-fjord,665,warlock,affliction,12,7,5
Vinilio,kazzak,660,warlock,affliction,18,7,11
Morgan,jaedenar,659,warlock,affliction,18,7,11
Тэйлок,gordunni,658,warlock,affliction,12,7,5
Arlu,blackrock,645,warlock,affliction,18,7,11
Krismer,silvermoon,618,warlock,affliction,19,8,11
Bäcck,silvermoon,607,warlock,affliction,17,7,10
Dimmybyrger,stormreaver,576,warlock,affliction,12,6,6
Nicker,antonidas,576,warlock,affliction,12,6,6
Boonzor,ravencrest,576,warlock,affliction,12,6,6
Multibuyer,tarren-mill,576,warlock,affliction,12,6,6
Alcringe,kazzak,576,warlock,affliction,12,6,6
Ackorax,kilrogg,576,warlock,affliction,12,6,6
Dededot,ysondre,576,warlock,affliction,12,6,6
Demónfire,sylvanas,576,warlock,affliction,12,6,6
Hasla,stormreaver,576,warlock,affliction,12,6,6
Christoph,tichondrius,576,warlock,affliction,12,6,6
Plâytïmè,stormscale,576,warlock,affliction,12,6,6
Çüñ,shattered-hand,576,warlock,affliction,12,6,6
Nineinchlock,silvermoon,576,warlock,affliction,12,6,6
Shaarak,blackrock,576,warlock,affliction,12,6,6
Keybump,outland,576,warlock,affliction,12,6,6
Зензирил,galakrond,576,warlock,affliction,12,6,6
Skuvee,archimonde,576,warlock,affliction,12,6,6
Smaúg,archimonde,576,warlock,affliction,12,6,6
Snackstickz,twisting-nether,576,warlock,affliction,12,6,6
Aches,sylvanas,576,warlock,affliction,15,7,8
Kresyda,dun-modr,576,warlock,affliction,18,6,12
Solomohn,steamwheedle-cartel,575,warlock,affliction,12,6,6
Demonoulis,bloodhoof,575,warlock,affliction,12,6,6
Talindra,stormscale,575,warlock,affliction,12,6,6
Raggnarlock,ravencrest,575,warlock,affliction,12,6,6
Tedor,ysondre,575,warlock,affliction,12,6,6
Guccie,ravencrest,575,warlock,affliction,12,6,6
Hodille,argent-dawn,575,warlock,affliction,12,6,6
Phenolock,blackhand,575,warlock,affliction,12,6,6
Toskanoamani,blackmoore,575,warlock,affliction,18,6,12
Lulokko,nemesis,574,warlock,affliction,18,6,12
Consfearacy,executus,574,warlock,affliction,24,6,18
Lökjävel,twisting-nether,572,warlock,affliction,12,6,6
ßatt,dalaran,571,warlock,affliction,12,6,6
Цветника,deathguard,569,warlock,affliction,12,6,6
Cencible,twisting-nether,564,warlock,affliction,16,9,7
Lockyy,karazhan,543,warlock,affliction,14,7,7
Parley,frostmane,542,warlock,affliction,16,6,10
Saymore,ragnaros,522,warlock,affliction,13,7,6
Бриант,gordunni,512,warlock,affliction,22,6,16
Скверногрик,fordragon,511,warlock,affliction,10,6,4
Muc,sanguino,511,warlock,affliction,11,6,5
Díablø,blackmoore,480,warlock,affliction,6,5,1
Faermorn,kazzak,480,warlock,affliction,6,5,1
Kopfschmerz,twisting-nether,480,warlock,affliction,6,5,1
Upsahl,twisting-nether,480,warlock,affliction,6,5,1
Passwoord,kazzak,480,warlock,affliction,6,5,1
Kazyn,archimonde,480,warlock,affliction,6,5,1
Uqrlock,twisting-nether,480,warlock,affliction,6,5,1
Wäisted,ravencrest,480,warlock,affliction,6,5,1
Ranchiëk,ravencrest,480,warlock,affliction,6,5,1
Lolock,archimonde,480,warlock,affliction,6,5,1
Веномхх,lich-king,480,warlock,affliction,6,5,1
Dualla,aegwynn,480,warlock,affliction,6,5,1
Azkarr,defias-brotherhood,480,warlock,affliction,12,5,7
Wällaar,ragnaros,480,warlock,affliction,12,5,7
Covidbolt,outland,480,warlock,affliction,12,5,7
Druno,archimonde,480,warlock,affliction,12,5,7
Zukau,argent-dawn,480,warlock,affliction,12,5,7
Hyøsei,hyjal,480,warlock,affliction,12,5,7
Werkx,archimonde,480,warlock,affliction,12,5,7
Daubi,ravencrest,480,warlock,affliction,12,5,7
Golhok,archimonde,480,warlock,affliction,12,5,7
Rtsnmt,alakir,480,warlock,affliction,12,5,7
Chaøsbølt,archimonde,480,warlock,affliction,12,5,7
Chaozvx,kazzak,480,warlock,affliction,12,5,7
Kwoleriker,norgannon,480,warlock,affliction,12,5,7
Nybbx,frostmane,480,warlock,affliction,12,5,7
Exerji,twisting-nether,480,warlock,affliction,12,5,7
Iatedora,ahnqiraj,480,warlock,affliction,12,5,7
Ethiq,blackrock,480,warlock,affliction,12,5,7
Pumpfake,ravencrest,480,warlock,affliction,12,5,7
Enzyw,drakthul,480,warlock,affliction,12,5,7
Moredøts,blackrock,480,warlock,affliction,14,5,9
Dráintráin,burning-blade,480,warlock,affliction,18,5,13
Affllction,auchindoun,480,warlock,affliction,18,5,13
Wumz,sylvanas,480,warlock,affliction,24,5,19
Lókí,nagrand,479,warlock,affliction,6,5,1
Silås,hyjal,479,warlock,affliction,9,6,3
Trickyy,azjolnerub,479,warlock,affliction,12,5,7
Kiégetlek,ragnaros,479,warlock,affliction,12,5,7
Demonflickan,silvermoon,479,warlock,affliction,12,5,7
Dreamage,exodar,479,warlock,affliction,12,5,7
Jacobí,defias-brotherhood,479,warlock,affliction,12,5,7
Üserper,chamber-of-aspects,478,warlock,affliction,30,5,25
Hunbeliever,ragnaros,477,warlock,affliction,6,5,1
Guttate,chamber-of-aspects,476,warlock,affliction,12,5,7
Dóni,chamber-of-aspects,447,warlock,affliction,11,5,6
Garbrandt,tarren-mill,432,warlock,affliction,9,6,3
Danidelarge,blackmoore,426,warlock,affliction,21,6,15
Migyardondup,exodar,416,warlock,affliction,14,6,8
Lazyblue,hyjal,415,warlock,affliction,14,5,9
Stromzii,silvermoon,400,warlock,affliction,7,5,2
Ariyasuke,drakthul,399,warlock,affliction,7,5,2
Deathfløw,draenor,384,warlock,affliction,6,4,2
Lopari,aegwynn,384,warlock,affliction,6,4,2
Enyras,nemesis,384,warlock,affliction,6,4,2
Jujalari,stormscale,384,warlock,affliction,6,4,2
Thesnakë,ravencrest,384,warlock,affliction,6,4,2
Tøtøf,sargeras,384,warlock,affliction,6,4,2
Benafflockk,kirin-tor,384,warlock,affliction,6,4,2
Noemia,defias-brotherhood,384,warlock,affliction,6,4,2
Tekrowdy,blackmoore,384,warlock,affliction,6,4,2
Turbonion,archimonde,384,warlock,affliction,6,4,2
Dotritos,tarren-mill,384,warlock,affliction,6,4,2
Патокдрысни,howling-fjord,384,warlock,affliction,6,4,2
Hopéléss,aggra-português,384,warlock,affliction,6,4,2
Hacknator,aegwynn,384,warlock,affliction,6,4,2
Arizyoxot,twisting-nether,384,warlock,affliction,6,4,2
Aljonah,antonidas,384,warlock,affliction,6,4,2
Adotroz,magtheridon,384,warlock,affliction,6,4,2
Discordîân,twisting-nether,384,warlock,affliction,6,4,2
Фейкгодх,soulflayer,384,warlock,affliction,6,4,2
Uselèss,die-arguswacht,384,warlock,affliction,6,4,2
Pablø,silvermoon,384,warlock,affliction,6,4,2
Zerøskil,blackrock,384,warlock,affliction,6,4,2
Векста,gordunni,384,warlock,affliction,6,4,2
Брилс,grom,384,warlock,affliction,6,4,2
Felrazer,silvermoon,384,warlock,affliction,6,4,2
Ашимал,soulflayer,384,warlock,affliction,6,4,2
Helventti,sylvanas,384,warlock,affliction,6,4,2
Wizdoom,outland,384,warlock,affliction,6,4,2
Psychoduck,stormscale,384,warlock,affliction,7,4,3
Djhanzó,outland,384,warlock,affliction,7,4,3
Freshplanga,kazzak,384,warlock,affliction,10,5,5
Eleriya,argent-dawn,384,warlock,affliction,12,4,8
Thepureone,blades-edge,384,warlock,affliction,12,4,8
Doomkicksin,haomarush,384,warlock,affliction,12,4,8
Purplemonkey,burning-blade,384,warlock,affliction,12,4,8
Bobleechaos,darkspear,384,warlock,affliction,12,4,8
Zoh,archimonde,384,warlock,affliction,12,4,8
Сатенекс,soulflayer,384,warlock,affliction,12,4,8
Zeddy,draenor,384,warlock,affliction,12,4,8
Braneiotqq,kazzak,384,warlock,affliction,12,4,8
Славеномен,howling-fjord,384,warlock,affliction,12,4,8
Náwwk,blackmoore,384,warlock,affliction,12,4,8
Shazes,blutkessel,384,warlock,affliction,12,4,8
Mortibal,dalvengyr,384,warlock,affliction,12,4,8
Xyzzy,silvermoon,384,warlock,affliction,12,4,8
Zatella,ravencrest,384,warlock,affliction,12,4,8
Muninnus,archimonde,384,warlock,affliction,12,4,8
Slàsh,hyjal,384,warlock,affliction,12,4,8
Filianore,azjolnerub,384,warlock,affliction,12,4,8
Roedin,tarren-mill,384,warlock,affliction,18,4,14
Nokzhul,blackrock,384,warlock,affliction,18,4,14
Sanas,blackhand,384,warlock,affliction,18,4,14
Backblech,wrathbringer,383,warlock,affliction,6,4,2
Whisperswerd,blackrock,383,warlock,affliction,6,4,2
Phéar,deathwing,383,warlock,affliction,6,4,2
Divvaa,tarren-mill,383,warlock,affliction,12,4,8
Lünatix,archimonde,383,warlock,affliction,18,4,14
Аннирина,eversong,382,warlock,affliction,6,4,2
Sladurana,eredar,379,warlock,affliction,12,4,8
Gonzoqt,tarren-mill,352,warlock,affliction,10,5,5
Dotyboi,tarren-mill,351,warlock,affliction,8,5,3
Disrupted,blackmoore,351,warlock,affliction,11,4,7
Fearu,kazzak,336,warlock,affliction,15,4,11
Marakh,stormscale,320,warlock,affliction,10,4,6
Shalazar,dun-modr,319,warlock,affliction,8,4,4
Mjuklock,ravencrest,319,warlock,affliction,14,4,10
Mordonna,blades-edge,304,warlock,affliction,13,4,9
Nainbusdemil,dalaran,304,warlock,affliction,19,4,15
Nøx,quelthalas,297,warlock,affliction,11,6,5
Lubomirek,turalyon,288,warlock,affliction,8,4,4
Darksoll,hyjal,288,warlock,affliction,6,3,3
Kenthal,nemesis,288,warlock,affliction,6,3,3
Feyreah,blackmoore,288,warlock,affliction,6,3,3
Damira,blackmoore,288,warlock,affliction,6,3,3
Retrosatanas,archimonde,288,warlock,affliction,6,3,3
Dubbzy,outland,288,warlock,affliction,6,3,3
Dabolt,archimonde,288,warlock,affliction,6,3,3
Clonia,nemesis,288,warlock,affliction,6,3,3
Madridistaß,outland,288,warlock,affliction,6,3,3
Eldrinar,twisting-nether,288,warlock,affliction,6,3,3
Ðæthpäct,dalaran,288,warlock,affliction,6,3,3
Imphugger,kazzak,288,warlock,affliction,6,3,3
Xristianos,ravencrest,288,warlock,affliction,6,3,3
Databricks,kazzak,288,warlock,affliction,6,3,3
Vigget,burning-legion,288,warlock,affliction,6,3,3
Babayagâ,sanguino,288,warlock,affliction,6,3,3
Darkgrave,the-maelstrom,288,warlock,affliction,6,3,3
Zagren,antonidas,288,warlock,affliction,6,3,3
Ethanolix,burning-blade,288,warlock,affliction,6,3,3
Decayez,thrall,288,warlock,affliction,6,3,3
Môzoc,frostwolf,288,warlock,affliction,6,3,3
Siyaa,eredar,288,warlock,affliction,6,3,3
Полтарашкаа,blackscar,288,warlock,affliction,6,3,3
Zélroth,argent-dawn,288,warlock,affliction,6,3,3
Фримех,soulflayer,288,warlock,affliction,6,3,3
Ooze,kazzak,288,warlock,affliction,6,3,3
Marenov,kazzak,288,warlock,affliction,6,3,3
Twisted,malganis,288,warlock,affliction,6,3,3
Smoulville,sanguino,288,warlock,affliction,6,3,3
Sazamia,ravencrest,288,warlock,affliction,6,3,3
Шрэкс,blackscar,288,warlock,affliction,6,3,3
Kumamoto,tarren-mill,288,warlock,affliction,6,3,3
Демоник,deathguard,288,warlock,affliction,6,3,3
Dontargetme,draenor,288,warlock,affliction,6,3,3
Azmondan,ahnqiraj,288,warlock,affliction,6,3,3
Raevax,ravencrest,288,warlock,affliction,6,3,3
Dxfive,tarren-mill,288,warlock,affliction,6,3,3
Drainsouls,stormscale,288,warlock,affliction,6,3,3
Anthh,doomhammer,288,warlock,affliction,6,3,3
Manikalinka,stormscale,288,warlock,affliction,6,3,3
Nayolana,argent-dawn,288,warlock,affliction,6,3,3
Veoxohr,argent-dawn,288,warlock,affliction,6,3,3
Джастсак,gordunni,288,warlock,affliction,6,3,3
Gigabolt,turalyon,288,warlock,affliction,6,3,3
Nachtreich,thrall,288,warlock,affliction,6,3,3
Zzooxx,silvermoon,288,warlock,affliction,6,3,3
Absúrd,turalyon,288,warlock,affliction,6,3,3
Slavecry,silvermoon,288,warlock,affliction,6,3,3
Mariahscary,auchindoun,288,warlock,affliction,6,3,3
Bixik,ravencrest,288,warlock,affliction,8,3,5
Lifedriller,drakthul,288,warlock,affliction,10,3,7
Ymersai,stormscale,288,warlock,affliction,12,3,9
Этожедру,howling-fjord,288,warlock,affliction,12,3,9
Zìì,silvermoon,288,warlock,affliction,12,3,9
Zdrac,stormscale,288,warlock,affliction,12,3,9
Сварожевич,galakrond,288,warlock,affliction,12,3,9
Lifesteal,auchindoun,287,warlock,affliction,6,3,3
Priszcilla,twisting-nether,287,warlock,affliction,6,3,3
Korlox,antonidas,287,warlock,affliction,6,3,3
Lewdrumpslap,kazzak,287,warlock,affliction,9,4,5
Márinho,aggra-português,276,warlock,affliction,16,6,10
Alarmlock,silvermoon,233,warlock,affliction,6,4,2
Snaga,culte-de-la-rive-noire,233,warlock,affliction,15,5,10
Lockas,ravencrest,222,warlock,affliction,8,3,5
Shore,ragnaros,192,warlock,affliction,6,2,4
Soundmagic,silvermoon,192,warlock,affliction,6,2,4
Bowhite,silvermoon,192,warlock,affliction,6,2,4
Lacruum,ragnaros,192,warlock,affliction,6,2,4
Berkobaggins,ravencrest,192,warlock,affliction,6,2,4
Kivilock,dun-modr,192,warlock,affliction,6,2,4
Kortsoet,silvermoon,192,warlock,affliction,6,2,4
Désolaté,kazzak,192,warlock,affliction,6,2,4
Vibori,twisting-nether,192,warlock,affliction,6,2,4
Kastón,dun-modr,192,warlock,affliction,6,2,4
Meisterhexe,taerar,192,warlock,affliction,6,2,4
Potatowl,ravencrest,192,warlock,affliction,6,2,4
Ruvy,twisting-nether,192,warlock,affliction,6,2,4
Хастла,ashenvale,192,warlock,affliction,6,2,4
Supergeîl,blackrock,192,warlock,affliction,6,2,4
Vhordrai,kazzak,192,warlock,affliction,6,2,4
Midgetlockx,ravencrest,192,warlock,affliction,6,2,4
Therelda,sanguino,192,warlock,affliction,6,2,4
Мамхаус,howling-fjord,192,warlock,affliction,6,2,4
Marroux,malganis,192,warlock,affliction,6,2,4
Гумал,howling-fjord,192,warlock,affliction,6,2,4
Born,ravencrest,192,warlock,affliction,6,2,4
Zartax,kazzak,192,warlock,affliction,6,2,4
ßatocko,kazzak,192,warlock,affliction,6,2,4
Fredé,kazzak,192,warlock,affliction,6,2,4
Сатаната,deepholm,192,warlock,affliction,6,2,4
Imatión,sylvanas,192,warlock,affliction,6,2,4
Recko,zuljin,192,warlock,affliction,6,2,4
Necroless,shadowsong,192,warlock,affliction,6,2,4
Freyjå,confrérie-du-thorium,192,warlock,affliction,6,2,4
Tørcal,hyjal,192,warlock,affliction,6,2,4
Hellcatherin,ghostlands,192,warlock,affliction,6,2,4
Funcky,terokkar,192,warlock,affliction,6,2,4
Cptdotalot,tarren-mill,192,warlock,affliction,6,2,4
Norgebrur,draenor,192,warlock,affliction,6,2,4
Endherkonk,sanguino,192,warlock,affliction,6,2,4
Жериновсский,gordunni,192,warlock,affliction,6,2,4
Enviroq,burning-legion,192,warlock,affliction,6,2,4
Setharon,burning-legion,192,warlock,affliction,6,2,4
Маларгас,soulflayer,192,warlock,affliction,6,2,4
Shreklock,burning-blade,192,warlock,affliction,6,2,4
Weedmaniac,kazzak,192,warlock,affliction,6,2,4
Wutili,dun-morogh,192,warlock,affliction,6,2,4
Flockyy,draenor,192,warlock,affliction,6,2,4
Healél,sanguino,192,warlock,affliction,6,2,4
Бирел,soulflayer,192,warlock,affliction,6,2,4
Чернокнжник,soulflayer,192,warlock,affliction,6,2,4
Cafardcancer,archimonde,192,warlock,affliction,6,2,4
Dotsfired,aegwynn,192,warlock,affliction,6,2,4
Necrolon,senjin,192,warlock,affliction,6,2,4
Elvània,eredar,192,warlock,affliction,6,2,4
Legend,trollbane,192,warlock,affliction,6,2,4
Lakasytos,sanguino,192,warlock,affliction,6,2,4
Скверножмых,gordunni,192,warlock,affliction,6,2,4
Армдэд,galakrond,192,warlock,affliction,6,2,4
Millhaus,gorgonnash,192,warlock,affliction,6,2,4
Ðankan,aegwynn,192,warlock,affliction,6,2,4
Bigbagelbob,archimonde,192,warlock,affliction,6,2,4
Saltybagel,draenor,192,warlock,affliction,6,2,4
Twistedfate,norgannon,192,warlock,affliction,6,2,4
Myristica,die-todeskrallen,192,warlock,affliction,6,2,4
Pichwise,draenor,192,warlock,affliction,6,2,4
Lockingcute,tarren-mill,192,warlock,affliction,6,2,4
Razkann,confrérie-du-thorium,192,warlock,affliction,6,2,4
Kotihoitaja,stormreaver,192,warlock,affliction,6,2,4
Tokarrus,blackmoore,192,warlock,affliction,6,2,4
Portyx,archimonde,192,warlock,affliction,6,2,4
Yhazel,archimonde,192,warlock,affliction,6,2,4
Ozax,doomhammer,192,warlock,affliction,6,2,4
Adafbhf,tichondrius,192,warlock,affliction,8,2,6
Djadizpunish,stormscale,192,warlock,affliction,12,2,10
Баммес,galakrond,192,warlock,affliction,12,2,10
Pøx,nemesis,192,warlock,affliction,12,2,10
Рыжевласочка,eversong,192,warlock,affliction,12,2,10
Müsli,kiljaeden,192,warlock,affliction,12,2,10
Nozzos,zuluhed,192,warlock,affliction,12,2,10
Dupony,antonidas,192,warlock,affliction,12,2,10
Trinxs,blackmoore,191,warlock,affliction,12,2,10
Ryurans,cthun,159,warlock,affliction,5,2,3
Overbuffed,wildhammer,159,warlock,affliction,5,2,3
Аоепампгодх,howling-fjord,159,warlock,affliction,11,2,9
Nürgle,stormscale,138,warlock,affliction,8,3,5
Ghachi,draenor,138,warlock,affliction,15,3,12
Paveru,tarren-mill,128,warlock,affliction,4,2,2
Malariaa,defias-brotherhood,128,warlock,affliction,4,2,2
Hokoreuw,echsenkessel,112,warlock,affliction,7,2,5
Mergon,ravencrest,96,warlock,affliction,3,2,1
Carelock,chamber-of-aspects,96,warlock,affliction,3,2,1
Infernó,aerie-peak,96,warlock,affliction,3,2,1
Laokoon,blackmoore,96,warlock,affliction,3,2,1
Gemja,onyxia,96,warlock,affliction,6,1,5
Blackwizard,theradras,96,warlock,affliction,6,1,5
Branduir,ragnaros,96,warlock,affliction,6,1,5
Jagerlock,doomhammer,96,warlock,affliction,6,1,5
Kretuss,silvermoon,96,warlock,affliction,6,1,5
Nevergladtra,darksorrow,96,warlock,affliction,6,1,5
Tyranuzz,norgannon,96,warlock,affliction,6,1,5
Дарунг,greymane,96,warlock,affliction,6,1,5
Fearrari,ragnaros,96,warlock,affliction,6,1,5
Fêâr,dun-modr,96,warlock,affliction,6,1,5
Noahh,kazzak,96,warlock,affliction,6,1,5
Icritmore,stormscale,96,warlock,affliction,6,1,5
Händerå,ragnaros,96,warlock,affliction,6,1,5
Ottu,thrall,96,warlock,affliction,6,1,5
Doturanal,blackmoore,96,warlock,affliction,6,1,5
Coilxo,ravencrest,96,warlock,affliction,6,1,5
Robertóó,burning-legion,96,warlock,affliction,6,1,5
Ðemise,antonidas,96,warlock,affliction,6,1,5
Zozano,draenor,96,warlock,affliction,6,1,5
Усубени,greymane,96,warlock,affliction,6,1,5
Werzel,frostmane,96,warlock,affliction,6,1,5
Belial,minahonda,96,warlock,affliction,6,1,5
Vicktorious,stormscale,96,warlock,affliction,6,1,5
Pederlock,defias-brotherhood,96,warlock,affliction,6,1,5
Goefaz,blackrock,96,warlock,affliction,6,1,5
Бигсмоук,howling-fjord,96,warlock,affliction,6,1,5
Veridy,kazzak,96,warlock,affliction,6,1,5
Merelock,eonar,96,warlock,affliction,6,1,5
Killerbeez,burning-blade,96,warlock,affliction,6,1,5
Mîjagî,blackhand,96,warlock,affliction,6,1,5
Zxò,twisting-nether,96,warlock,affliction,8,1,7
Adøume,ysondre,96,warlock,affliction,15,1,14
Guldauni,tarren-mill,96,warlock,affliction,18,1,17
Warlockholms,archimonde,79,warlock,affliction,5,1,4
Poulebar,ysondre,64,warlock,affliction,4,1,3
Natpoesje,azjolnerub,64,warlock,affliction,4,1,3
Nedivh,stormscale,48,warlock,affliction,3,1,2
Araqt,thrall,48,warlock,affliction,3,1,2
Petrosk,sanguino,42,warlock,affliction,6,2,4
Omegachad,draenor,31,warlock,affliction,2,1,1
Dailylock,kazzak,31,warlock,affliction,2,1,1
Tepelkwastje,twisting-nether,31,warlock,affliction,8,1,7
Хичхкок,gordunni,16,warlock,affliction,1,1,0
Dyingdog,kazzak,2231,warrior,fury,79,45,34
Wodwod,kazzak,2203,warrior,fury,66,51,15
Syltetballe,kazzak,2203,warrior,fury,84,56,28
Dõxlol,kazzak,2179,warrior,fury,72,45,27
Corvínus,blackrock,2137,warrior,fury,170,93,77
Vitezandro,stormscale,2131,warrior,fury,66,47,19
Gottdustin,lothar,2124,warrior,fury,143,78,65
Uretirips,archimonde,2115,warrior,fury,168,101,67
Thorana,twisting-nether,2108,warrior,fury,424,213,211
Joeférnandes,ragnaros,2107,warrior,fury,72,43,29
Quanny,die-aldor,2102,warrior,fury,114,67,47
Níghtfúry,ravencrest,2102,warrior,fury,84,43,41
Ðunhammer,blackmoore,2100,warrior,fury,114,67,47
Dyingdogs,kazzak,2071,warrior,fury,72,39,33
Dõxqt,kazzak,2067,warrior,fury,78,46,32
Stephabibi,kazzak,2052,warrior,fury,94,55,39
Blîxtgordon,tarren-mill,2045,warrior,fury,66,40,26
Sockerbagarn,zenedar,2038,warrior,fury,196,105,91
Nodrip,stormscale,2002,warrior,fury,114,70,44
Sporctaco,nemesis,1983,warrior,fury,160,87,73
Elsensor,sylvanas,1974,warrior,fury,107,49,58
Gregorez,silvermoon,1937,warrior,fury,102,57,45
Elsensør,thrall,1937,warrior,fury,75,38,37
Thezug,blackmoore,1935,warrior,fury,96,48,48
Sublex,blackrock,1933,warrior,fury,60,34,26
Shinychan,silvermoon,1913,warrior,fury,48,30,18
Богвойны,razuvious,1909,warrior,fury,108,58,50
Robycoleman,nemesis,1895,warrior,fury,277,146,131
Plackø,draenor,1890,warrior,fury,162,88,74
Faraam,sunstrider,1886,warrior,fury,51,25,26
Picciocino,nemesis,1877,warrior,fury,107,58,49
Варплеер,gordunni,1875,warrior,fury,76,39,37
Schultze,kazzak,1875,warrior,fury,166,73,93
Schlauberg,azshara,1871,warrior,fury,72,42,30
Дахирарг,fordragon,1871,warrior,fury,90,46,44
Insanedmg,dun-modr,1864,warrior,fury,72,40,32
Dwarfsteel,stormscale,1864,warrior,fury,42,23,19
Émalkay,tarren-mill,1863,warrior,fury,48,26,22
Релайк,gordunni,1860,warrior,fury,60,33,27
Bloodhorn,blackhand,1857,warrior,fury,54,36,18
Brythwyn,blackrock,1856,warrior,fury,54,30,24
Wruxar,bronzebeard,1856,warrior,fury,54,29,25
Ironbound,silvermoon,1853,warrior,fury,36,25,11
Pflanzling,nozdormu,1851,warrior,fury,106,52,54
Kwesta,kazzak,1850,warrior,fury,60,34,26
Morganãrogán,ragnaros,1850,warrior,fury,42,23,19
Yaler,alakir,1847,warrior,fury,48,33,15
Cesr,bloodhoof,1847,warrior,fury,126,71,55
Jeco,tarren-mill,1846,warrior,fury,66,39,27
Ørìgíñälgøðx,archimonde,1845,warrior,fury,48,32,16
Yawalad,stormscale,1845,warrior,fury,66,35,31
Анжинерх,gordunni,1843,warrior,fury,66,39,27
Oneoneseven,archimonde,1841,warrior,fury,78,49,29
Sublex,aegwynn,1838,warrior,fury,60,36,24
Frozenliøn,twisting-nether,1836,warrior,fury,48,32,16
Ibunnyone,blackrock,1836,warrior,fury,60,32,28
Lair,zuljin,1835,warrior,fury,106,67,39
Elian,ragnaros,1835,warrior,fury,72,36,36
Méido,argent-dawn,1833,warrior,fury,325,172,153
Imolderthenu,blackrock,1825,warrior,fury,166,91,75
Zidbi,argent-dawn,1825,warrior,fury,126,68,58
Kenryu,argent-dawn,1825,warrior,fury,60,32,28
Dronikos,ravencrest,1824,warrior,fury,54,35,19
Köftemecx,blackrock,1824,warrior,fury,127,82,45
Sonnyzz,sanguino,1824,warrior,fury,36,21,15
Timewarrior,ravencrest,1824,warrior,fury,54,30,24
Xark,drakthul,1824,warrior,fury,90,49,41
Deatheart,ysondre,1824,warrior,fury,76,41,35
Трэйдар,blackscar,1823,warrior,fury,48,27,21
Gladius,blutkessel,1819,warrior,fury,156,80,76
Тиран,howling-fjord,1817,warrior,fury,48,27,21
Letiis,blackrock,1816,warrior,fury,105,57,48
Jaý,draenor,1815,warrior,fury,56,35,21
Adian,ravencrest,1813,warrior,fury,42,26,16
Badon,burning-legion,1812,warrior,fury,60,39,21
Zednos,twilights-hammer,1812,warrior,fury,184,102,82
Arthoc,sanguino,1811,warrior,fury,60,36,24
Злопиканка,gordunni,1811,warrior,fury,67,34,33
Xzwarr,silvermoon,1810,warrior,fury,38,21,17
Мигнт,howling-fjord,1810,warrior,fury,42,23,19
Hawkman,outland,1809,warrior,fury,41,25,16
Cuzyxtwo,blackrock,1809,warrior,fury,60,35,25
Capitalista,das-konsortium,1809,warrior,fury,90,51,39
Clellin,silvermoon,1807,warrior,fury,139,80,59
Leelazero,argent-dawn,1807,warrior,fury,78,44,34
Späns,ragnaros,1807,warrior,fury,71,34,37
Zyalen,stormscale,1806,warrior,fury,60,32,28
Beasterbunny,outland,1804,warrior,fury,109,63,46
Kizzyo,draenor,1804,warrior,fury,96,51,45
Nóvamh,draenor,1802,warrior,fury,42,24,18
Kocmochka,tarren-mill,1802,warrior,fury,60,32,28
Heartmemphis,stormscale,1801,warrior,fury,41,24,17
Dreams,auchindoun,1801,warrior,fury,48,28,20
Vykoz,sylvanas,1800,warrior,fury,42,24,18
Sonnylolxd,dun-modr,1800,warrior,fury,54,29,25
Дестингл,gordunni,1797,warrior,fury,42,26,16
Grulbash,stormscale,1792,warrior,fury,42,22,20
Apacolata,outland,1790,warrior,fury,36,19,17
Basiletha,hyjal,1788,warrior,fury,41,20,21
Geez,burning-blade,1787,warrior,fury,42,23,19
Budgetassa,stormscale,1784,warrior,fury,42,23,19
Castlevania,ravencrest,1784,warrior,fury,73,38,35
Goorila,kazzak,1776,warrior,fury,48,28,20
Âshnâzgðûr,burning-blade,1776,warrior,fury,99,48,51
Yserá,auchindoun,1775,warrior,fury,58,27,31
Zadirich,burning-blade,1774,warrior,fury,66,35,31
Tóffèl,thrall,1773,warrior,fury,48,32,16
Rïmxøxø,haomarush,1773,warrior,fury,48,32,16
Warrez,azuremyst,1773,warrior,fury,125,72,53
Ryonâgai,aegwynn,1773,warrior,fury,54,30,24
Luxurious,argent-dawn,1770,warrior,fury,72,40,32
Stansmash,kazzak,1768,warrior,fury,36,22,14
Tanja,bronzebeard,1767,warrior,fury,48,28,20
Футжисубо,razuvious,1760,warrior,fury,126,65,61
Nozuki,archimonde,1751,warrior,fury,172,98,74
Rocketx,blackrock,1750,warrior,fury,36,19,17
Løktær,blackmoore,1747,warrior,fury,60,27,33
Rãzmø,hyjal,1744,warrior,fury,78,42,36
Rhynot,argent-dawn,1741,warrior,fury,42,32,10
Thundersword,sylvanas,1741,warrior,fury,92,50,42
Ðønøvan,sanguino,1733,warrior,fury,106,60,46
Джакир,howling-fjord,1733,warrior,fury,54,29,25
Luigistar,naxxramas,1733,warrior,fury,144,73,71
Едигейй,gordunni,1732,warrior,fury,96,58,38
Рыгатрон,galakrond,1732,warrior,fury,36,19,17
Çon,ravencrest,1731,warrior,fury,60,35,25
Propanex,kazzak,1729,warrior,fury,54,33,21
Gatts,krasus,1729,warrior,fury,66,39,27
Eddíemòrphin,kazzak,1728,warrior,fury,58,34,24
Irontouch,draenor,1728,warrior,fury,75,42,33
Хенгард,gordunni,1727,warrior,fury,72,41,31
Pouckette,hyjal,1726,warrior,fury,84,46,38
Wgdx,ravencrest,1726,warrior,fury,54,28,26
Juna,hellscream,1726,warrior,fury,91,47,44
Даймонддогс,gordunni,1725,warrior,fury,64,36,28
Biturboo,blackrock,1725,warrior,fury,73,35,38
Agrias,burning-legion,1722,warrior,fury,60,35,25
Honzakesl,drakthul,1721,warrior,fury,63,37,26
Risara,outland,1720,warrior,fury,49,31,18
Грамол,soulflayer,1719,warrior,fury,66,36,30
Кавайтити,blackscar,1718,warrior,fury,39,19,20
Варынеопэ,gordunni,1717,warrior,fury,65,35,30
Koljach,sylvanas,1717,warrior,fury,162,87,75
Soakmybeet,archimonde,1716,warrior,fury,71,37,34
Ironmásk,tarren-mill,1716,warrior,fury,42,21,21
Silq,zuljin,1713,warrior,fury,36,18,18
Тьмасвятая,gordunni,1710,warrior,fury,42,22,20
Ampw,ravencrest,1707,warrior,fury,36,24,12
Osha,hyjal,1707,warrior,fury,326,166,160
Tooski,sylvanas,1707,warrior,fury,65,31,34
Wismerx,kazzak,1706,warrior,fury,30,19,11
Читора,blackscar,1702,warrior,fury,65,35,30
Дарккардинал,deathguard,1699,warrior,fury,76,38,38
Oldcockball,argent-dawn,1698,warrior,fury,90,51,39
Bigbugatti,draenor,1698,warrior,fury,71,32,39
Durif,argent-dawn,1697,warrior,fury,36,24,12
Violentfunky,ravencrest,1697,warrior,fury,84,40,44
Discoklaus,blackmoore,1696,warrior,fury,282,144,138
Kiha,argent-dawn,1695,warrior,fury,42,24,18
Margon,aegwynn,1692,warrior,fury,48,29,19
Bananapower,aszune,1692,warrior,fury,54,30,24
Bözzy,stormreaver,1690,warrior,fury,192,103,89
Yodabär,blackmoore,1690,warrior,fury,120,62,58
Jinrok,turalyon,1685,warrior,fury,114,69,45
Dödgrävarn,stormscale,1685,warrior,fury,102,57,45
Hangart,argent-dawn,1683,warrior,fury,36,20,16
Дейдулус,soulflayer,1682,warrior,fury,42,23,19
Oogaboogadps,silvermoon,1682,warrior,fury,175,93,82
Vesnãpusic,draenor,1680,warrior,fury,63,39,24
Slaycon,sanguino,1680,warrior,fury,69,29,40
Эйримор,gordunni,1679,warrior,fury,161,83,78
Kibb,sylvanas,1678,warrior,fury,56,35,21
Galenthor,ravencrest,1678,warrior,fury,42,24,18
Байсал,gordunni,1677,warrior,fury,127,68,59
Gôrilla,kazzak,1674,warrior,fury,32,19,13
Даркслеерх,howling-fjord,1674,warrior,fury,36,18,18
Бубаигавар,gordunni,1673,warrior,fury,42,22,20
Протектор,soulflayer,1673,warrior,fury,160,79,81
Neopronouns,stormscale,1672,warrior,fury,36,22,14
Råzor,blackhand,1672,warrior,fury,215,117,98
Gewyon,ragnaros,1669,warrior,fury,29,18,11
Decapitatëd,outland,1668,warrior,fury,36,19,17
Walexmaryk,ragnaros,1666,warrior,fury,161,87,74
Telrion,silvermoon,1666,warrior,fury,48,24,24
Ranmaru,kazzak,1665,warrior,fury,97,46,51
Aleextrasza,silvermoon,1664,warrior,fury,43,24,19
Xeraaya,kirin-tor,1664,warrior,fury,96,45,51
Níká,bronzebeard,1663,warrior,fury,52,30,22
Берззлой,gordunni,1661,warrior,fury,52,30,22
Gigatscheb,eredar,1659,warrior,fury,78,41,37
Averenx,frostwolf,1659,warrior,fury,110,57,53
Titza,silvermoon,1659,warrior,fury,68,31,37
Iagô,argent-dawn,1655,warrior,fury,60,35,25
Jetman,ravencrest,1654,warrior,fury,58,29,29
Toptier,drakthul,1653,warrior,fury,53,30,23
Pizdatos,ravencrest,1653,warrior,fury,54,30,24
Очепенец,soulflayer,1652,warrior,fury,129,66,63
Noproblem,ragnaros,1650,warrior,fury,65,34,31
Мамкингерой,howling-fjord,1649,warrior,fury,54,32,22
Xzurgster,twisting-nether,1649,warrior,fury,52,23,29
Harbee,stormscale,1647,warrior,fury,170,96,74
Dangeruos,ragnaros,1646,warrior,fury,36,20,16
Antismoke,silvermoon,1645,warrior,fury,105,59,46
Zerberos,drakthul,1645,warrior,fury,131,69,62
Swayzze,frostwolf,1642,warrior,fury,48,27,21
Unstopablle,twisting-nether,1638,warrior,fury,96,52,44
Темнозорь,ashenvale,1638,warrior,fury,61,31,30
Mybigcow,darkspear,1638,warrior,fury,53,25,28
Боссберс,soulflayer,1636,warrior,fury,78,44,34
Хуфхорнс,soulflayer,1636,warrior,fury,39,21,18
Элинглир,gordunni,1635,warrior,fury,69,37,32
Вадло,soulflayer,1635,warrior,fury,54,27,27
Bastquirage,dalaran,1633,warrior,fury,42,24,18
Ðènlos,destromath,1632,warrior,fury,84,43,41
Кладбошаа,gordunni,1632,warrior,fury,133,66,67
Ifir,hyjal,1632,warrior,fury,70,33,37
Susugar,ysondre,1631,warrior,fury,72,35,37
Sanngridr,defias-brotherhood,1629,warrior,fury,66,32,34
Pòóòóòóòópz,dun-modr,1628,warrior,fury,30,17,13
Peli,burning-blade,1628,warrior,fury,228,114,114
Nerfrend,stormscale,1627,warrior,fury,30,17,13
Broley,blackhand,1627,warrior,fury,76,43,33
Vágópityu,ragnaros,1627,warrior,fury,48,24,24
Megalann,silvermoon,1627,warrior,fury,84,41,43
Ананаслорд,blackscar,1625,warrior,fury,36,25,11
Azazelslayer,dethecus,1625,warrior,fury,66,43,23
Вимор,soulflayer,1624,warrior,fury,36,19,17
Skylexs,burning-legion,1624,warrior,fury,48,22,26
Swofty,arygos,1622,warrior,fury,24,17,7
Raoh,archimonde,1621,warrior,fury,48,34,14
Металлие,howling-fjord,1621,warrior,fury,48,21,27
Aramý,argent-dawn,1620,warrior,fury,24,17,7
Vulcán,aerie-peak,1620,warrior,fury,36,21,15
Shhimbanned,doomhammer,1619,warrior,fury,30,21,9
Jésusiskíng,amanthul,1619,warrior,fury,31,18,13
Котаче,soulflayer,1619,warrior,fury,130,65,65
Savarøx,blackmoore,1618,warrior,fury,42,26,16
Flexbot,blackmoore,1617,warrior,fury,38,23,15
Poggsaron,kazzak,1617,warrior,fury,105,52,53
Shilix,twisting-nether,1616,warrior,fury,30,20,10
Borndet,eredar,1616,warrior,fury,63,37,26
Nobodyx,tarren-mill,1616,warrior,fury,120,69,51
Vegilhenvin,stormscale,1616,warrior,fury,111,62,49
Discølove,frostwolf,1615,warrior,fury,35,19,16
Êssâ,stormscale,1612,warrior,fury,30,17,13
Vÿnk,ysondre,1611,warrior,fury,116,61,55
Dracømort,dalaran,1610,warrior,fury,42,24,18
Monbun,silvermoon,1610,warrior,fury,43,24,19
Mezen,stormscale,1609,warrior,fury,69,41,28
Шлифую,howling-fjord,1609,warrior,fury,72,35,37
Celn,silvermoon,1608,warrior,fury,145,80,65
Неуно,howling-fjord,1607,warrior,fury,66,41,25
Хёда,eversong,1607,warrior,fury,60,32,28
Wabisabì,silvermoon,1607,warrior,fury,63,33,30
Ёнморт,gordunni,1606,warrior,fury,30,20,10
Джоулирэдблу,howling-fjord,1606,warrior,fury,42,22,20
Notvisionary,ravencrest,1606,warrior,fury,36,17,19
Eekz,haomarush,1605,warrior,fury,30,19,11
Boos,burning-legion,1605,warrior,fury,30,17,13
Radamantys,drakthul,1603,warrior,fury,63,34,29
Halalmeat,minahonda,1603,warrior,fury,59,29,30
Гронвер,soulflayer,1601,warrior,fury,134,75,59
Явараа,howling-fjord,1600,warrior,fury,72,41,31
Bourbimrgllr,hyjal,1600,warrior,fury,45,25,20
Halfbroken,moonglade,1600,warrior,fury,78,37,41
Littlebugger,ravencrest,1599,warrior,fury,30,17,13
Ebonheart,argent-dawn,1599,warrior,fury,59,32,27
Hanìbal,ravencrest,1599,warrior,fury,177,89,88
Høvdingen,outland,1598,warrior,fury,30,19,11
Rofos,hellscream,1597,warrior,fury,55,29,26
Гринфинч,galakrond,1597,warrior,fury,130,66,64
Abnôrmus,tarren-mill,1594,warrior,fury,114,53,61
Dasdabane,twisting-nether,1593,warrior,fury,64,38,26
Lífelover,tarren-mill,1593,warrior,fury,66,30,36
Gantór,blackrock,1593,warrior,fury,48,21,27
Roxxyy,stormreaver,1592,warrior,fury,59,33,26
Sköldpaddor,tarren-mill,1592,warrior,fury,40,22,18
Methodxd,outland,1592,warrior,fury,78,38,40
Hynish,doomhammer,1589,warrior,fury,82,44,38
Zbra,draenor,1588,warrior,fury,47,23,24
Zupkaztrópka,burning-legion,1587,warrior,fury,89,47,42
Jeepzinc,blackmoore,1587,warrior,fury,36,19,17
Gromex,stormscale,1587,warrior,fury,75,31,44
Тралмош,razuvious,1581,warrior,fury,57,35,22
Bursch,ravencrest,1580,warrior,fury,42,21,21
Илийя,razuvious,1579,warrior,fury,48,21,27
Wornag,argent-dawn,1578,warrior,fury,83,40,43
Тактоядобрый,ashenvale,1578,warrior,fury,47,20,27
Yousainsbolt,blackrock,1577,warrior,fury,68,35,33
Xåb,dun-morogh,1577,warrior,fury,44,17,27
Dizzyndumb,draenor,1575,warrior,fury,165,93,72
Латахо,gordunni,1574,warrior,fury,54,27,27
Asmoche,archimonde,1571,warrior,fury,60,29,31
Uwuwarrior,alleria,1570,warrior,fury,64,35,29
Pepegle,argent-dawn,1569,warrior,fury,36,21,15
Garlogar,twisting-nether,1569,warrior,fury,108,59,49
Криккс,greymane,1568,warrior,fury,72,33,39
Narukeratnik,draenor,1567,warrior,fury,66,38,28
Иктиннос,gordunni,1565,warrior,fury,57,21,36
Stahlhund,silvermoon,1564,warrior,fury,87,47,40
Lyrv,ravencrest,1563,warrior,fury,30,17,13
Wøokz,argent-dawn,1563,warrior,fury,172,87,85
Касюлин,gordunni,1562,warrior,fury,53,31,22
Æç,argent-dawn,1562,warrior,fury,36,19,17
Alexandrrior,rexxar,1561,warrior,fury,69,41,28
Senshin,sanguino,1561,warrior,fury,92,46,46
Flippingout,stormscale,1560,warrior,fury,60,27,33
Нордгаар,howling-fjord,1559,warrior,fury,42,27,15
Bønecleaver,blackrock,1558,warrior,fury,110,56,54
Thorken,ragnaros,1557,warrior,fury,59,29,30
Сариату,soulflayer,1556,warrior,fury,72,34,38
Monnee,silvermoon,1555,warrior,fury,42,26,16
Вундеркитти,soulflayer,1555,warrior,fury,86,43,43
Mikogød,ravencrest,1553,warrior,fury,54,31,23
Waralert,kazzak,1553,warrior,fury,36,19,17
Bartins,magtheridon,1550,warrior,fury,66,39,27
Груббоб,booty-bay,1548,warrior,fury,102,53,49
Zwareboy,frostmane,1546,warrior,fury,48,20,28
Zhenshii,blackmoore,1544,warrior,fury,71,36,35
Goomby,argent-dawn,1544,warrior,fury,48,22,26
Dævedoff,sanguino,1543,warrior,fury,65,35,30
Horovoko,kazzak,1541,warrior,fury,24,18,6
Karentneuf,khaz-modan,1541,warrior,fury,35,23,12
Baldemort,antonidas,1541,warrior,fury,105,57,48
Владикчардж,gordunni,1535,warrior,fury,41,22,19
Hejduk,frostmane,1533,warrior,fury,30,20,10
Вменяемый,gordunni,1533,warrior,fury,88,44,44
Белославный,gordunni,1532,warrior,fury,55,38,17
ßbç,ysondre,1532,warrior,fury,84,41,43
Anakhas,archimonde,1531,warrior,fury,30,16,14
Альмас,galakrond,1531,warrior,fury,59,29,30
Féélmyfury,tarren-mill,1528,warrior,fury,23,16,7
Erosdulko,silvermoon,1528,warrior,fury,54,24,30
Spokowar,hyjal,1527,warrior,fury,47,23,24
Тегриско,goldrinn,1527,warrior,fury,72,34,38
Grâkul,twisting-nether,1526,warrior,fury,263,134,129
Bigbibbs,tarren-mill,1526,warrior,fury,68,32,36
Certavus,antonidas,1525,warrior,fury,60,31,29
Indicaflower,ahnqiraj,1525,warrior,fury,101,51,50
Stérkkû,stormscale,1525,warrior,fury,102,46,56
Linzao,archimonde,1524,warrior,fury,30,16,14
Bobitybob,ravencrest,1520,warrior,fury,60,36,24
Jeronimoe,blackmoore,1520,warrior,fury,41,24,17
Inconcussae,drakthul,1519,warrior,fury,30,19,11
Mirpz,doomhammer,1519,warrior,fury,47,24,23
Berré,ragnaros,1518,warrior,fury,48,23,25
Hemèra,hyjal,1517,warrior,fury,62,33,29
Oravedenes,draenor,1514,warrior,fury,110,66,44
Zwecko,malganis,1513,warrior,fury,30,16,14
Pokopo,blackrock,1510,warrior,fury,42,23,19
Bleaja,tarren-mill,1509,warrior,fury,24,16,8
Wärlør,ravencrest,1509,warrior,fury,78,49,29
Slidmacka,twisting-nether,1509,warrior,fury,42,26,16
Втораянатура,howling-fjord,1508,warrior,fury,36,22,14
Gids,silvermoon,1506,warrior,fury,34,21,13
Xiny,blackrock,1506,warrior,fury,42,24,18
Craghak,twisting-nether,1506,warrior,fury,100,52,48
Truckfury,ravencrest,1504,warrior,fury,88,46,42
Gronos,silvermoon,1504,warrior,fury,74,38,36
Thrallhall,kazzak,1503,warrior,fury,131,59,72
Мурмадонио,soulflayer,1503,warrior,fury,78,35,43
Арристокррат,soulflayer,1501,warrior,fury,42,23,19
Jarggyül,culte-de-la-rive-noire,1500,warrior,fury,36,21,15
Crriminal,ravencrest,1498,warrior,fury,24,16,8
Sebastian,ravencrest,1498,warrior,fury,60,29,31
Bäiley,drakthul,1497,warrior,fury,54,18,36
Магрейн,grom,1496,warrior,fury,110,54,56
Gely,silvermoon,1495,warrior,fury,30,16,14
Cortix,blackmoore,1493,warrior,fury,34,20,14
Лазба,gordunni,1493,warrior,fury,58,31,27
Enzja,nazjatar,1492,warrior,fury,31,18,13
Evrybodydown,draenor,1492,warrior,fury,148,77,71
Bloodmyst,kazzak,1489,warrior,fury,60,33,27
Nemecic,arathor,1489,warrior,fury,36,18,18
Zaximos,twisting-nether,1488,warrior,fury,62,30,32
Fizzywarrior,blackmoore,1488,warrior,fury,60,29,31
Лимор,howling-fjord,1488,warrior,fury,42,16,26
Ärmodäuss,norgannon,1486,warrior,fury,69,34,35
Чиллх,gordunni,1485,warrior,fury,58,33,25
Corrin,frostmourne,1485,warrior,fury,122,68,54
Ууша,soulflayer,1485,warrior,fury,59,29,30
Rimvar,alleria,1484,warrior,fury,60,28,32
Жироштемп,gordunni,1483,warrior,fury,58,30,28
Варрвик,howling-fjord,1483,warrior,fury,57,28,29
Perinel,draenor,1483,warrior,fury,82,32,50
Blaktarr,dunemaul,1482,warrior,fury,51,28,23
Jorund,archimonde,1482,warrior,fury,54,26,28
Чпонькмашина,soulflayer,1474,warrior,fury,92,53,39
Roidspam,outland,1471,warrior,fury,71,28,43
Broksigarr,ragnaros,1470,warrior,fury,30,17,13
Auglok,twisting-nether,1468,warrior,fury,120,61,59
Мундэфэндэр,lich-king,1467,warrior,fury,46,18,28
Cocojumbo,azuremyst,1466,warrior,fury,42,23,19
Nurti,silvermoon,1465,warrior,fury,36,21,15
Straya,malorne,1463,warrior,fury,60,30,30
Chrissey,argent-dawn,1462,warrior,fury,45,21,24
Анакронокс,howling-fjord,1461,warrior,fury,58,29,29
Hrodulf,moonglade,1461,warrior,fury,83,38,45
Gozgu,stormscale,1460,warrior,fury,26,16,10
Tweegles,argent-dawn,1460,warrior,fury,71,35,36
Grubshak,burning-legion,1460,warrior,fury,47,22,25
Kobeni,ysondre,1457,warrior,fury,50,30,20
Mustar,alexstrasza,1457,warrior,fury,77,45,32
Stratoz,ragnaros,1457,warrior,fury,61,27,34
Bluemango,ragnaros,1454,warrior,fury,36,19,17
Èscøbar,dalaran,1454,warrior,fury,49,23,26
Zugbro,stormscale,1452,warrior,fury,48,25,23
Скехит,blackscar,1449,warrior,fury,66,32,34
Aeyon,burning-blade,1449,warrior,fury,37,17,20
Tyrâdus,kiljaeden,1445,warrior,fury,36,22,14
Добиватель,howling-fjord,1445,warrior,fury,72,37,35
Eygón,silvermoon,1445,warrior,fury,66,28,38
Gìlgamesh,dun-modr,1444,warrior,fury,55,30,25
Rîiper,ysondre,1444,warrior,fury,42,22,20
Toundrâa,archimonde,1444,warrior,fury,169,86,83
Vandalismee,draenor,1443,warrior,fury,28,19,9
Старопрамен,thermaplugg,1443,warrior,fury,225,119,106
Krigarjag,kazzak,1442,warrior,fury,42,28,14
Syfér,grim-batol,1441,warrior,fury,34,20,14
Dragão,kazzak,1440,warrior,fury,60,28,32
Golias,argent-dawn,1439,warrior,fury,48,30,18
Tatabaf,ysondre,1437,warrior,fury,42,23,19
Bukisan,sylvanas,1437,warrior,fury,107,53,54
Rëvenge,burning-legion,1437,warrior,fury,90,44,46
Floppikatten,kazzak,1432,warrior,fury,24,17,7
Спайкуссь,goldrinn,1431,warrior,fury,78,42,36
Wätras,drakthul,1431,warrior,fury,30,16,14
Xalont,doomhammer,1431,warrior,fury,36,17,19
Borntothis,zuljin,1430,warrior,fury,92,53,39
Honör,sylvanas,1430,warrior,fury,48,23,25
Pinkíe,blackmoore,1428,warrior,fury,30,15,15
Shadroq,auchindoun,1427,warrior,fury,24,15,9
Fridaax,lightbringer,1427,warrior,fury,24,15,9
Akînos,kazzak,1427,warrior,fury,69,34,35
Shadowcacau,aggra-português,1426,warrior,fury,59,29,30
Faylania,tarren-mill,1425,warrior,fury,42,25,17
Dajnatarcze,burning-legion,1425,warrior,fury,36,19,17
Emcix,aszune,1425,warrior,fury,30,15,15
Лаинвуд,soulflayer,1425,warrior,fury,51,25,26
Reidunøks,kazzak,1422,warrior,fury,83,44,39
Touguro,aggra-português,1422,warrior,fury,57,26,31
Madaxe,kazzak,1421,warrior,fury,24,15,9
Profär,archimonde,1419,warrior,fury,30,16,14
Alexdgreat,tarren-mill,1418,warrior,fury,26,15,11
Divyx,tarren-mill,1417,warrior,fury,42,21,21
Flexecutie,silvermoon,1414,warrior,fury,30,17,13
Bravestarrz,ungoro,1414,warrior,fury,92,43,49
Hervor,les-sentinelles,1413,warrior,fury,78,44,34
Æsterius,blackmoore,1411,warrior,fury,95,47,48
Overgear,twisting-nether,1410,warrior,fury,30,15,15
Артен,ashenvale,1407,warrior,fury,32,15,17
Voffsen,tarren-mill,1407,warrior,fury,54,24,30
Sonyd,tarren-mill,1405,warrior,fury,36,22,14
Zeliøn,elune,1405,warrior,fury,90,51,39
Varyian,sporeggar,1405,warrior,fury,98,53,45
Terisá,blackmoore,1405,warrior,fury,46,24,22
Rìsàs,draenor,1405,warrior,fury,150,74,76
Gamepresa,silvermoon,1404,warrior,fury,61,30,31
Torok,antonidas,1402,warrior,fury,36,25,11
Борзило,howling-fjord,1402,warrior,fury,36,21,15
Каган,gordunni,1402,warrior,fury,45,26,19
Krauus,silvermoon,1402,warrior,fury,109,59,50
Raoh,blackrock,1400,warrior,fury,24,15,9
Realz,malganis,1400,warrior,fury,90,49,41
Ikkr,kazzak,1400,warrior,fury,72,39,33
Hidaykus,bronzebeard,1399,warrior,fury,70,35,35
Imora,silvermoon,1398,warrior,fury,36,21,15
Botgrinder,blackhand,1396,warrior,fury,95,54,41
Нириэла,howling-fjord,1396,warrior,fury,66,31,35
Prîde,kazzak,1394,warrior,fury,36,22,14
Kwedrowar,burning-legion,1393,warrior,fury,133,61,72
Keriane,garona,1389,warrior,fury,65,33,32
Dríppy,aegwynn,1388,warrior,fury,33,20,13
Штормскейл,soulflayer,1388,warrior,fury,30,16,14
Дралк,gordunni,1384,warrior,fury,34,16,18
Skefe,archimonde,1383,warrior,fury,46,29,17
Reccey,blackrock,1379,warrior,fury,30,16,14
Ligthblâd,hyjal,1378,warrior,fury,57,31,26
Rèckless,argent-dawn,1377,warrior,fury,24,18,6
Tigron,burning-legion,1377,warrior,fury,54,33,21
Антурим,howling-fjord,1377,warrior,fury,32,17,15
Warrouner,khaz-modan,1377,warrior,fury,48,22,26
Rakherus,silvermoon,1376,warrior,fury,30,16,14
Shán,defias-brotherhood,1375,warrior,fury,60,33,27
Unchåined,burning-legion,1372,warrior,fury,69,34,35
Rommick,guldan,1372,warrior,fury,60,27,33
Thagzar,burning-legion,1371,warrior,fury,162,76,86
Whimbux,stormscale,1371,warrior,fury,51,23,28
Ralzung,twisting-nether,1370,warrior,fury,54,26,28
Васильна,soulflayer,1369,warrior,fury,36,21,15
Чюнилингус,soulflayer,1369,warrior,fury,43,15,28
Enderyx,blackhand,1363,warrior,fury,30,15,15
Gruttak,aegwynn,1361,warrior,fury,24,16,8
Diioxyde,temple-noir,1360,warrior,fury,30,17,13
Килджаеден,deathguard,1358,warrior,fury,34,17,17
Èrzà,sanguino,1358,warrior,fury,76,35,41
Wärfäcë,blades-edge,1357,warrior,fury,40,23,17
Ribastur,blackmoore,1355,warrior,fury,168,89,79
Hagoxfit,los-errantes,1355,warrior,fury,41,19,22
Midvînter,silvermoon,1354,warrior,fury,45,19,26
Gromrigg,draenor,1348,warrior,fury,95,41,54
Somalisktjur,tarren-mill,1347,warrior,fury,60,31,29
Habaneroo,zuljin,1345,warrior,fury,36,15,21
Bráïnléss,silvermoon,1343,warrior,fury,32,15,17
Zêke,thrall,1342,warrior,fury,24,18,6
Stretch,thrall,1341,warrior,fury,31,15,16
Hatenest,argent-dawn,1341,warrior,fury,198,94,104
Krieg,garrosh,1341,warrior,fury,61,21,40
Mitu,sanguino,1338,warrior,fury,24,14,10
Brigitá,argent-dawn,1338,warrior,fury,30,14,16
Raynhorn,silvermoon,1337,warrior,fury,24,14,10
Jisoowar,blackhand,1337,warrior,fury,36,15,21
Moggorr,nemesis,1334,warrior,fury,46,24,22
Màrduk,pozzo-delleternità,1333,warrior,fury,36,19,17
Hirbz,silvermoon,1333,warrior,fury,66,34,32
Schuy,silvermoon,1333,warrior,fury,78,40,38
Taoke,ravencrest,1333,warrior,fury,30,14,16
Hobbó,draenor,1333,warrior,fury,78,31,47
Killhound,argent-dawn,1332,warrior,fury,24,14,10
Акози,fordragon,1332,warrior,fury,60,33,27
Nmwar,turalyon,1332,warrior,fury,39,20,19
Üzzy,dun-modr,1331,warrior,fury,78,46,32
Вардеспетчер,razuvious,1331,warrior,fury,36,19,17
Thaddaus,ravencrest,1331,warrior,fury,123,58,65
Kundrak,blackhand,1330,warrior,fury,55,28,27
Kragar,anetheron,1329,warrior,fury,45,25,20
Skaurmosh,argent-dawn,1329,warrior,fury,60,31,29
Luunk,ravencrest,1329,warrior,fury,72,36,36
Ganaroth,tarren-mill,1328,warrior,fury,42,21,21
Роконишу,gordunni,1326,warrior,fury,30,18,12
Джелорд,howling-fjord,1326,warrior,fury,30,14,16
Tweran,drakthul,1323,warrior,fury,29,14,15
Gudvin,terokkar,1322,warrior,fury,47,29,18
Imorphius,silvermoon,1321,warrior,fury,30,14,16
Кроуфури,gordunni,1318,warrior,fury,54,31,23
Ðèxs,ravencrest,1318,warrior,fury,30,17,13
Buzzingwarr,tarren-mill,1318,warrior,fury,60,29,31
Usz,thunderhorn,1317,warrior,fury,48,29,19
Svênsk,argent-dawn,1317,warrior,fury,32,17,15
Achonar,draenor,1317,warrior,fury,29,15,14
Xsasuke,ragnaros,1317,warrior,fury,36,17,19
Nighat,sanguino,1316,warrior,fury,23,18,5
Temprament,ravencrest,1316,warrior,fury,54,31,23
Hellguarrd,silvermoon,1316,warrior,fury,65,29,36
Fortësque,uldaman,1315,warrior,fury,59,22,37
Sway,eonar,1314,warrior,fury,42,23,19
Zíreael,ravencrest,1314,warrior,fury,72,34,38
Chidòri,tarren-mill,1314,warrior,fury,33,14,19
Вархаус,blackscar,1313,warrior,fury,39,21,18
Offpants,drakthul,1313,warrior,fury,48,22,26
Dírectdash,draenor,1313,warrior,fury,33,15,18
Ælvstan,argent-dawn,1310,warrior,fury,59,30,29
Ryù,dun-modr,1310,warrior,fury,30,14,16
Optimai,kazzak,1309,warrior,fury,86,41,45
Painswift,blackhand,1309,warrior,fury,30,14,16
Bigmercy,ragnaros,1305,warrior,fury,41,23,18
Gèrralt,hyjal,1305,warrior,fury,47,18,29
Гаррим,blackscar,1304,warrior,fury,28,14,14
Xugzug,blackmoore,1304,warrior,fury,30,14,16
Grimli,burning-legion,1303,warrior,fury,42,24,18
Bigrooster,argent-dawn,1303,warrior,fury,102,52,50
Меняло,fordragon,1302,warrior,fury,41,20,21
Кровостокхх,gordunni,1301,warrior,fury,42,17,25
Reckless,tarren-mill,1300,warrior,fury,42,22,20
Tragix,hyjal,1300,warrior,fury,42,18,24
Умфи,howling-fjord,1299,warrior,fury,83,46,37
Warinator,ravencrest,1297,warrior,fury,49,28,21
Kastraveci,outland,1295,warrior,fury,78,32,46
Арестант,soulflayer,1291,warrior,fury,137,69,68
Машамеч,blackscar,1289,warrior,fury,84,42,42
Reylanor,argent-dawn,1288,warrior,fury,34,19,15
Kllinac,kazzak,1288,warrior,fury,60,32,28
Ninja,bronze-dragonflight,1288,warrior,fury,93,44,49
Roxxón,teldrassil,1285,warrior,fury,23,14,9
Buzzingorc,tarren-mill,1285,warrior,fury,60,32,28
Sammäel,eldrethalas,1281,warrior,fury,36,19,17
Haewon,burning-legion,1280,warrior,fury,53,25,28
Andij,blackmoore,1278,warrior,fury,48,24,24
Trollboii,ravencrest,1274,warrior,fury,27,14,13
Fîlzlaus,area-52,1274,warrior,fury,89,38,51
Exeldians,burning-legion,1273,warrior,fury,20,14,6
Барабумм,soulflayer,1273,warrior,fury,107,55,52
Tarrior,shattered-halls,1273,warrior,fury,65,32,33
Fenr,sanguino,1272,warrior,fury,52,34,18
Wariio,khaz-modan,1272,warrior,fury,47,27,20
Runkkusukka,defias-brotherhood,1271,warrior,fury,65,36,29
Furyre,ysondre,1271,warrior,fury,37,17,20
Honeymew,draenor,1271,warrior,fury,66,27,39
Dènethor,draenor,1269,warrior,fury,78,39,39
Kerando,tirion,1269,warrior,fury,29,14,15
Watntietnn,burning-blade,1268,warrior,fury,49,24,25
Осгаард,gordunni,1268,warrior,fury,45,21,24
Akkamagosh,argent-dawn,1266,warrior,fury,68,30,38
Deusi,garrosh,1265,warrior,fury,60,32,28
Cokeaddict,argent-dawn,1265,warrior,fury,48,20,28
Azzog,archimonde,1264,warrior,fury,86,48,38
Grák,bronze-dragonflight,1263,warrior,fury,24,14,10
Zerm,draenor,1262,warrior,fury,24,15,9
Gritzi,dragonblight,1262,warrior,fury,60,29,31
Wilæm,argent-dawn,1261,warrior,fury,71,34,37
Бормормуш,gordunni,1261,warrior,fury,73,30,43
Taurenboii,ravencrest,1259,warrior,fury,25,14,11
Федорссумкин,gordunni,1258,warrior,fury,50,23,27
Hangovar,thrall,1257,warrior,fury,33,18,15
Mortalclaw,kazzak,1256,warrior,fury,63,27,36
Drswing,kazzak,1255,warrior,fury,33,15,18
Dundulinka,outland,1255,warrior,fury,46,17,29
Kurko,blackmoore,1254,warrior,fury,29,14,15
Toughwar,tarren-mill,1253,warrior,fury,66,35,31
Unn,ragnaros,1250,warrior,fury,75,36,39
Аштау,howling-fjord,1250,warrior,fury,154,71,83
Oughn,silvermoon,1248,warrior,fury,68,31,37
Immørtálx,tarren-mill,1248,warrior,fury,30,13,17
Рагнарульв,gordunni,1248,warrior,fury,36,15,21
Мигнт,blackscar,1247,warrior,fury,18,13,5
Фктп,blackscar,1247,warrior,fury,24,13,11
Stóna,blackmoore,1247,warrior,fury,36,13,23
Agitoyami,defias-brotherhood,1246,warrior,fury,115,62,53
Warrzor,auchindoun,1246,warrior,fury,30,13,17
Moknar,alonsus,1246,warrior,fury,53,22,31
Tidarius,twisting-nether,1245,warrior,fury,24,13,11
Crandalius,kazzak,1245,warrior,fury,24,13,11
Balltas,drakthul,1243,warrior,fury,30,13,17
Divinvibra,dalaran,1242,warrior,fury,25,13,12
Ragnurk,draenor,1242,warrior,fury,60,20,40
Tàuruss,blackhand,1241,warrior,fury,34,18,16
Рсдрпб,eversong,1241,warrior,fury,30,15,15
Timidman,kazzak,1240,warrior,fury,24,13,11
Lâmy,khaz-modan,1240,warrior,fury,60,26,34
Astreimehns,sanguino,1239,warrior,fury,18,13,5
Слайдус,gordunni,1239,warrior,fury,62,31,31
Ipes,blackmoore,1237,warrior,fury,33,17,16
Lepetitwar,hyjal,1237,warrior,fury,30,13,17
Mamox,archimonde,1236,warrior,fury,25,14,11
Рекиро,blackscar,1236,warrior,fury,24,13,11
Alevucerdaa,draenor,1236,warrior,fury,36,15,21
Goldenarm,doomhammer,1234,warrior,fury,26,15,11
Насувака,deathguard,1231,warrior,fury,47,22,25
Larvalis,blackmoore,1229,warrior,fury,37,15,22
Кимиюки,gordunni,1228,warrior,fury,30,13,17
Ffrostwolff,azjolnerub,1227,warrior,fury,18,13,5
Skullfondler,argent-dawn,1226,warrior,fury,24,13,11
Quigatron,frostmane,1225,warrior,fury,42,25,17
Säl,ragnaros,1225,warrior,fury,67,36,31
Schmetterina,proudmoore,1223,warrior,fury,49,28,21
Warrmax,darksorrow,1223,warrior,fury,78,41,37
Rayeron,sanguino,1221,warrior,fury,95,47,48
Anubisra,alakir,1220,warrior,fury,26,16,10
Kebra,blackmoore,1220,warrior,fury,87,49,38
Toecutter,defias-brotherhood,1220,warrior,fury,27,14,13
Izmadfurax,archimonde,1218,warrior,fury,77,41,36
Shieldlord,kazzak,1218,warrior,fury,129,59,70
Ouryuu,hyjal,1218,warrior,fury,56,25,31
Nubá,burning-legion,1213,warrior,fury,48,31,17
Atrôcithy,silvermoon,1211,warrior,fury,22,14,8
Coyle,eredar,1207,warrior,fury,146,65,81
Warriorc,hellfire,1205,warrior,fury,48,26,22
Yildiz,kargath,1204,warrior,fury,103,57,46
Vivaladirt,argent-dawn,1203,warrior,fury,30,13,17
Larrydankin,draenor,1201,warrior,fury,35,21,14
Vhy,antonidas,1201,warrior,fury,48,22,26
Toporceanul,kazzak,1201,warrior,fury,41,14,27
Barsok,sanguino,1198,warrior,fury,36,16,20
Отнулядоста,gordunni,1198,warrior,fury,61,25,36
Жужащий,howling-fjord,1197,warrior,fury,74,31,43
Marklarstar,ragnaros,1195,warrior,fury,36,16,20
Andjuu,doomhammer,1193,warrior,fury,29,13,16
Antraex,zuljin,1193,warrior,fury,36,15,21
Blaying,ravencrest,1192,warrior,fury,23,13,10
Kirkwood,terokkar,1192,warrior,fury,71,34,37
Номер,eversong,1192,warrior,fury,139,64,75
Moustachu,kirin-tor,1189,warrior,fury,33,18,15
Bolss,silvermoon,1188,warrior,fury,73,28,45
Gardom,doomhammer,1187,warrior,fury,70,41,29
Азктор,soulflayer,1186,warrior,fury,35,15,20
Delinde,cthun,1180,warrior,fury,105,50,55
Saey,malorne,1174,warrior,fury,56,25,31
Flaggerware,stormscale,1171,warrior,fury,30,13,17
Суммрак,grom,1166,warrior,fury,38,16,22
Tato,frostmourne,1165,warrior,fury,23,13,10
Дедсдрыном,howling-fjord,1162,warrior,fury,140,68,72
Варёнок,soulflayer,1160,warrior,fury,51,25,26
Gorgulg,stormscale,1159,warrior,fury,30,15,15
Saîx,garrosh,1159,warrior,fury,175,85,90
Drolaret,zuljin,1155,warrior,fury,39,16,23
Dreasus,ragnaros,1151,warrior,fury,18,12,6
Krazosh,die-aldor,1151,warrior,fury,24,12,12
Исскатель,gordunni,1150,warrior,fury,12,12,0
Slamborghini,twisting-nether,1150,warrior,fury,18,12,6
Miko,ysondre,1148,warrior,fury,24,12,12
Spitonem,blackrock,1148,warrior,fury,24,12,12
Баджераа,soulflayer,1147,warrior,fury,18,12,6
Wotulko,blackrock,1147,warrior,fury,23,13,10
Neoballâc,uldum,1144,warrior,fury,24,12,12
Baoni,hyjal,1144,warrior,fury,30,12,18
Yopa,draenor,1143,warrior,fury,33,13,20
Inflacija,grim-batol,1143,warrior,fury,36,12,24
Shadowfiend,argent-dawn,1142,warrior,fury,24,12,12
Waroworgen,terokkar,1142,warrior,fury,26,12,14
Ragecap,rexxar,1142,warrior,fury,44,18,26
Армсец,howling-fjord,1141,warrior,fury,24,12,12
Инфиль,howling-fjord,1140,warrior,fury,30,12,18
Bouafia,archimonde,1138,warrior,fury,24,12,12
Itchiiz,alonsus,1138,warrior,fury,24,12,12
Андервульф,booty-bay,1137,warrior,fury,30,12,18
Exhumator,blackhand,1135,warrior,fury,36,12,24
Madhardy,chamber-of-aspects,1133,warrior,fury,24,12,12
Hazarku,colinas-pardas,1133,warrior,fury,24,12,12
Illydan,turalyon,1132,warrior,fury,18,12,6
Thors,deathwing,1131,warrior,fury,154,75,79
Oxascand,kazzak,1131,warrior,fury,87,36,51
Armirtile,twisting-nether,1130,warrior,fury,24,12,12
Ranndall,blackrock,1129,warrior,fury,48,23,25
Sekecmazec,turalyon,1129,warrior,fury,63,22,41
Pybal,stormscale,1128,warrior,fury,18,12,6
Thibow,hyjal,1127,warrior,fury,24,14,10
Rudor,la-croisade-écarlate,1127,warrior,fury,24,12,12
Berseak,dalaran,1125,warrior,fury,31,15,16
Sadjoke,draenor,1125,warrior,fury,30,13,17
Damonx,draenor,1123,warrior,fury,54,25,29
Cuuz,outland,1122,warrior,fury,30,12,18
Well,kult-der-verdammten,1121,warrior,fury,24,12,12
Nykyro,draenor,1119,warrior,fury,66,29,37
Téldrus,blackrock,1116,warrior,fury,18,12,6
Ульданианин,gordunni,1115,warrior,fury,24,12,12
Pahanâ,arygos,1111,warrior,fury,24,12,12
Иллидансер,howling-fjord,1110,warrior,fury,24,12,12
Gabbz,aggra-português,1109,warrior,fury,33,13,20
Zetsurin,sylvanas,1105,warrior,fury,66,23,43
Ragedotcom,archimonde,1104,warrior,fury,46,20,26
Красемир,deepholm,1097,warrior,fury,47,23,24
Sabrewølf,blackmoore,1096,warrior,fury,48,24,24
Killpieric,krasus,1095,warrior,fury,36,13,23
Shalren,nordrassil,1092,warrior,fury,44,23,21
Джэкмен,soulflayer,1091,warrior,fury,28,16,12
Grobler,blackhand,1091,warrior,fury,42,16,26
Mistawolf,ravencrest,1090,warrior,fury,30,16,14
Аесоо,gordunni,1090,warrior,fury,243,113,130
Moonkak,hyjal,1090,warrior,fury,30,13,17
Копенгаген,ashenvale,1087,warrior,fury,30,16,14
Dramiél,tarren-mill,1083,warrior,fury,23,13,10
Draxxann,ravencrest,1077,warrior,fury,18,13,5
Wrathchild,blackrock,1069,warrior,fury,35,14,21
Justviktor,ravencrest,1068,warrior,fury,47,17,30
Селттик,grom,1064,warrior,fury,47,24,23
Giimlii,hyjal,1060,warrior,fury,36,12,24
Eidzo,tarren-mill,1056,warrior,fury,12,11,1
Luphrek,ysondre,1056,warrior,fury,30,11,19
Зенобий,gordunni,1055,warrior,fury,12,11,1
Sparkzu,twisting-nether,1055,warrior,fury,18,11,7
Эпитафорх,blackscar,1055,warrior,fury,18,11,7
Maroux,malganis,1055,warrior,fury,18,11,7
Кофесмолоком,ashenvale,1055,warrior,fury,18,11,7
Prixor,grim-batol,1055,warrior,fury,24,11,13
Ntouziera,silvermoon,1055,warrior,fury,30,11,19
Izurritea,tarren-mill,1054,warrior,fury,18,11,7
Ciuez,tarren-mill,1054,warrior,fury,18,11,7
Мастерион,soulflayer,1054,warrior,fury,18,11,7
Circumcist,dragonblight,1053,warrior,fury,18,11,7
Snuzzygeezer,ravencrest,1053,warrior,fury,18,11,7
Лордэнгри,howling-fjord,1053,warrior,fury,22,12,10
Byedriver,kazzak,1053,warrior,fury,24,11,13
Oksimbillah,blackrock,1053,warrior,fury,24,11,13
Bloodwatchêr,kazzak,1051,warrior,fury,24,11,13
Amagaddon,draenor,1050,warrior,fury,28,12,16
Rum,talnivarr,1049,warrior,fury,18,11,7
Vazzile,silvermoon,1049,warrior,fury,23,13,10
Драмур,gordunni,1049,warrior,fury,30,11,19
Obox,ravencrest,1048,warrior,fury,18,11,7
Wowbert,frostwolf,1048,warrior,fury,24,11,13
Baluste,culte-de-la-rive-noire,1047,warrior,fury,30,11,19
Buffury,twisting-nether,1045,warrior,fury,18,11,7
Whysospicey,lightbringer,1043,warrior,fury,21,12,9
Ragnòk,eredar,1043,warrior,fury,54,20,34
Tiapollo,dun-modr,1043,warrior,fury,40,12,28
Romanondo,doomhammer,1039,warrior,fury,18,11,7
Эфириад,soulflayer,1036,warrior,fury,24,11,13
Златоцветта,gordunni,1034,warrior,fury,24,11,13
Tdanielt,burning-legion,1032,warrior,fury,18,11,7
Anastor,ragnaros,1026,warrior,fury,24,11,13
Valhrann,dalaran,1024,warrior,fury,24,11,13
Orcgrim,nozdormu,1019,warrior,fury,42,20,22
Громорашман,grom,1017,warrior,fury,20,12,8
Жиестьдон,soulflayer,1015,warrior,fury,38,17,21
Sairos,kirin-tor,1014,warrior,fury,90,47,43
Whiteebeardd,draenor,1014,warrior,fury,72,34,38
Hazl,balnazzar,1009,warrior,fury,44,27,17
Sperta,frostmourne,1009,warrior,fury,47,25,22
Kungeen,silvermoon,1008,warrior,fury,132,58,74
Grimic,quelthalas,1004,warrior,fury,27,11,16
Рыджеральд,howling-fjord,1003,warrior,fury,37,17,20
Macgull,ysondre,1003,warrior,fury,66,27,39
Zhear,kazzak,999,warrior,fury,29,11,18
Fknmoo,kazzak,997,warrior,fury,78,39,39
Edwsan,cthun,990,warrior,fury,42,20,22
Fatspacka,argent-dawn,989,warrior,fury,20,11,9
Solatika,alexstrasza,985,warrior,fury,183,95,88
Dolora,ragnaros,984,warrior,fury,30,15,15
Nicperh,dun-modr,984,warrior,fury,29,12,17
Lobotomywar,drakthul,981,warrior,fury,18,12,6
Niozihex,the-maelstrom,981,warrior,fury,39,16,23
Krlebajker,tarren-mill,977,warrior,fury,27,14,13
Nogo,nagrand,975,warrior,fury,50,29,21
Seka,nozdormu,975,warrior,fury,186,93,93
Falaliss,elune,975,warrior,fury,56,26,30
Snoopdad,ravencrest,966,warrior,fury,27,15,12
Эребб,howling-fjord,966,warrior,fury,60,29,31
Помойник,gordunni,965,warrior,fury,175,91,84
Торакусу,gordunni,963,warrior,fury,48,24,24
Inexo,blackrock,961,warrior,fury,24,11,13
Pj,sanguino,960,warrior,fury,12,10,2
Ástriax,ravencrest,960,warrior,fury,18,10,8
Kût,les-sentinelles,959,warrior,fury,12,10,2
Emune,blackhand,959,warrior,fury,15,11,4
Galatan,kazzak,959,warrior,fury,18,10,8
Unqlolz,kazzak,959,warrior,fury,18,10,8
Tenicx,ravencrest,959,warrior,fury,18,10,8
Solaje,dun-modr,959,warrior,fury,18,10,8
Cøbain,eredar,959,warrior,fury,18,10,8
Highoverlord,aggra-português,959,warrior,fury,18,10,8
Oowar,burning-legion,959,warrior,fury,18,10,8
Raicho,dentarg,959,warrior,fury,18,10,8
Scelletonx,silvermoon,959,warrior,fury,18,10,8
Theolcostaud,archimonde,959,warrior,fury,24,10,14
Sumis,stormreaver,959,warrior,fury,36,10,26
Xurainlol,eredar,958,warrior,fury,12,10,2
Agoobagoo,alakir,958,warrior,fury,12,10,2
Svënja,ysondre,958,warrior,fury,18,10,8
Punks,ravencrest,958,warrior,fury,18,10,8
Søil,tarren-mill,958,warrior,fury,18,10,8
Achérus,varimathras,958,warrior,fury,23,10,13
Taaø,ravencrest,958,warrior,fury,24,10,14
Razoo,stormscale,958,warrior,fury,30,10,20
Rarrio,kazzak,957,warrior,fury,18,10,8
Budwise,stormscale,957,warrior,fury,18,10,8
Youups,twisting-nether,957,warrior,fury,18,10,8
Etelä,stormreaver,957,warrior,fury,18,10,8
Hellocritty,blackmoore,957,warrior,fury,18,10,8
Orcarinté,draenor,957,warrior,fury,27,11,16
Fortressa,ravencrest,957,warrior,fury,30,10,20
Bördz,blackhand,956,warrior,fury,18,10,8
Settin,silvermoon,956,warrior,fury,18,10,8
Рэкла,grom,956,warrior,fury,18,10,8
Янесними,soulflayer,956,warrior,fury,18,10,8
Thodak,blackrock,956,warrior,fury,30,10,20
Kurenn,tarren-mill,956,warrior,fury,30,10,20
Razza,ravencrest,955,warrior,fury,18,10,8
Zeppek,dalaran,955,warrior,fury,94,49,45
Onga,frostwolf,954,warrior,fury,18,10,8
Merdé,blackhand,954,warrior,fury,60,32,28
Murgrimm,die-silberne-hand,954,warrior,fury,93,47,46
Ампутиль,gordunni,953,warrior,fury,18,10,8
Xonnico,ravencrest,953,warrior,fury,30,11,19
Taurras,nathrezim,952,warrior,fury,86,45,41
Darriuso,kazzak,952,warrior,fury,24,10,14
Exsomnis,outland,951,warrior,fury,18,10,8
Thebiggreen,twisting-nether,951,warrior,fury,18,10,8
Фейловый,gordunni,951,warrior,fury,24,10,14
Madfu,draenor,950,warrior,fury,18,10,8
Лизерус,eversong,949,warrior,fury,12,10,2
Gahal,tyrande,948,warrior,fury,24,10,14
Morishcrak,kazzak,948,warrior,fury,33,11,22
Prime,outland,946,warrior,fury,24,10,14
Erenowski,twisting-nether,945,warrior,fury,24,10,14
Xaturesw,twisting-nether,943,warrior,fury,12,10,2
Solidier,archimonde,931,warrior,fury,24,10,14
Pufy,ravencrest,930,warrior,fury,23,10,13
Асау,ashenvale,924,warrior,fury,17,10,7
Kratosz,bloodscalp,920,warrior,fury,56,29,27
Arzes,draenor,920,warrior,fury,29,10,19
Sonnyammo,turalyon,917,warrior,fury,38,13,25
Dirtybugga,nagrand,916,warrior,fury,16,11,5
Nukêr,dun-modr,915,warrior,fury,35,10,25
Дерзкаяфурия,gordunni,913,warrior,fury,23,10,13
Ranyl,blackmoore,911,warrior,fury,23,10,13
Rédsonja,chamber-of-aspects,909,warrior,fury,52,25,27
Noseringer,frostwolf,902,warrior,fury,15,10,5
Ogerit,blackmoore,898,warrior,fury,30,14,16
Суферна,howling-fjord,894,warrior,fury,27,13,14
Gnompower,archimonde,892,warrior,fury,17,10,7
Bëlzé,les-clairvoyants,887,warrior,fury,38,14,24
Mélin,ravencrest,876,warrior,fury,19,10,9
Лилслайм,gordunni,875,warrior,fury,30,15,15
Jâbs,hyjal,875,warrior,fury,36,11,25
Kabbuki,die-aldor,871,warrior,fury,24,12,12
Stroj,aerie-peak,868,warrior,fury,65,32,33
Granlach,sunstrider,864,warrior,fury,12,9,3
Kihili,twisting-nether,864,warrior,fury,12,9,3
Studzianki,argent-dawn,864,warrior,fury,12,9,3
Брокскрим,soulflayer,864,warrior,fury,12,9,3
Licious,outland,864,warrior,fury,12,9,3
Føxis,aegwynn,864,warrior,fury,12,9,3
Lzdmfckmeazy,blackmoore,864,warrior,fury,15,10,5
Warzzor,auchindoun,864,warrior,fury,18,9,9
Рэйвисмашина,gordunni,864,warrior,fury,24,9,15
Веоленс,gordunni,863,warrior,fury,12,9,3
Discordîan,twisting-nether,863,warrior,fury,12,9,3
Therealskull,grim-batol,863,warrior,fury,18,9,9
Bxnx,aegwynn,863,warrior,fury,18,9,9
Showerfresh,silvermoon,863,warrior,fury,18,9,9
Lunätic,sylvanas,863,warrior,fury,18,9,9
Нейв,blackscar,863,warrior,fury,18,9,9
Dontrundie,kazzak,863,warrior,fury,18,9,9
Zyzie,argent-dawn,863,warrior,fury,24,9,15
Chadgarrosh,tarren-mill,863,warrior,fury,24,9,15
Синнэр,blackscar,863,warrior,fury,24,9,15
Sodium,pozzo-delleternità,863,warrior,fury,24,9,15
Tandrall,rexxar,863,warrior,fury,24,9,15
Bigpapapap,kazzak,863,warrior,fury,28,9,19
Cianna,silvermoon,862,warrior,fury,12,9,3
Exzecute,outland,862,warrior,fury,12,9,3
Claptheheal,silvermoon,862,warrior,fury,18,9,9
Gypsykìng,darksorrow,862,warrior,fury,18,9,9
Cemule,doomhammer,862,warrior,fury,18,9,9
Grimleaper,twisting-nether,862,warrior,fury,18,9,9
Vìbe,archimonde,862,warrior,fury,24,9,15
Denshyel,dun-modr,861,warrior,fury,15,10,5
Throck,drakthul,861,warrior,fury,18,9,9
Свободатоп,howling-fjord,859,warrior,fury,18,9,9
Valkirya,arthas,859,warrior,fury,24,9,15
Ragecrit,ragnaros,859,warrior,fury,24,9,15
Tharokk,blackmoore,858,warrior,fury,18,9,9
Zalumorth,magtheridon,856,warrior,fury,26,13,13
Rqyz,tarren-mill,856,warrior,fury,18,9,9
Saykage,blackhand,854,warrior,fury,18,9,9
Mocagressiva,draenor,854,warrior,fury,18,9,9
Warfield,draenor,853,warrior,fury,24,9,15
Блиблоб,eversong,852,warrior,fury,18,9,9
Pollverizer,ghostlands,851,warrior,fury,36,16,20
Manneen,outland,851,warrior,fury,30,9,21
Sparkss,sylvanas,850,warrior,fury,18,9,9
Kharzak,ungoro,849,warrior,fury,18,9,9
Спунжио,ashenvale,848,warrior,fury,18,9,9
Tiscanno,nemesis,842,warrior,fury,49,24,25
Amsti,doomhammer,839,warrior,fury,12,9,3
Ânaxi,silvermoon,831,warrior,fury,14,10,4
Warallari,khaz-modan,829,warrior,fury,18,9,9
Evasni,magtheridon,823,warrior,fury,14,10,4
Incense,silvermoon,816,warrior,fury,15,9,6
Børomir,silvermoon,815,warrior,fury,15,9,6
Jøtawarrior,sanguino,815,warrior,fury,17,9,8
Варриорнир,howling-fjord,814,warrior,fury,14,10,4
Miina,blutkessel,802,warrior,fury,18,9,9
Ocelote,elune,794,warrior,fury,18,9,9
Guinnasse,khaz-modan,794,warrior,fury,21,9,12
Ironfangs,argent-dawn,768,warrior,fury,12,8,4
Crîxús,silvermoon,768,warrior,fury,12,8,4
Jengaa,draenor,768,warrior,fury,12,8,4
Aléxsandra,ravencrest,768,warrior,fury,12,8,4
Blizo,tarren-mill,768,warrior,fury,12,8,4
Cathériné,drakthul,768,warrior,fury,12,8,4
Projectchad,draenor,768,warrior,fury,12,8,4
Jokkul,tarren-mill,768,warrior,fury,12,8,4
Нарезаю,blackscar,768,warrior,fury,12,8,4
Connorzqt,ravencrest,768,warrior,fury,12,8,4
Zern,draenor,768,warrior,fury,12,8,4
Уэсгар,blackscar,768,warrior,fury,12,8,4
Chelby,argent-dawn,768,warrior,fury,12,8,4
Untiltèd,ravencrest,768,warrior,fury,18,8,10
Immørtalx,area-52,768,warrior,fury,18,8,10
Krathox,kazzak,768,warrior,fury,18,8,10
Zimbabakunda,ravencrest,768,warrior,fury,18,8,10
Joéfernandés,sylvanas,768,warrior,fury,18,8,10
Xguildone,magtheridon,768,warrior,fury,38,14,24
Alpairx,aegwynn,768,warrior,fury,24,8,16
Мастерпве,blackscar,767,warrior,fury,12,8,4
Largeblade,kazzak,767,warrior,fury,12,8,4
Míngxuan,tarren-mill,767,warrior,fury,12,8,4
Rooflolly,argent-dawn,767,warrior,fury,12,8,4
Schmackes,terrordar,767,warrior,fury,12,8,4
Báshx,outland,767,warrior,fury,12,8,4
Skeptikal,argent-dawn,767,warrior,fury,12,8,4
Skillclapped,ravencrest,767,warrior,fury,15,9,6
Онатолька,eversong,767,warrior,fury,16,9,7
Ðíscøwârrìør,nethersturm,767,warrior,fury,18,8,10
Elainax,eredar,767,warrior,fury,18,8,10
Rowr,argent-dawn,767,warrior,fury,18,8,10
Thørïn,dun-modr,767,warrior,fury,18,8,10
Philatou,antonidas,767,warrior,fury,18,8,10
Warthur,silvermoon,767,warrior,fury,18,8,10
Rndname,malganis,767,warrior,fury,18,8,10
Cyruk,blackmoore,767,warrior,fury,18,8,10
Dallion,azjolnerub,767,warrior,fury,18,8,10
Ødên,frostmane,767,warrior,fury,18,8,10
Глинм,gordunni,767,warrior,fury,24,8,16
Algethar,archimonde,766,warrior,fury,12,8,4
Fivejee,ravencrest,766,warrior,fury,12,8,4
Warriur,silvermoon,766,warrior,fury,12,8,4
Himä,burning-legion,766,warrior,fury,12,8,4
Deadwaifu,ragnaros,766,warrior,fury,18,8,10
Развалочка,howling-fjord,766,warrior,fury,18,8,10
Arlan,dragonblight,766,warrior,fury,30,8,22
Сэч,gordunni,765,warrior,fury,12,8,4
Knussnacker,sanguino,765,warrior,fury,12,8,4
Blairne,burning-blade,765,warrior,fury,24,8,16
Malasortë,sylvanas,764,warrior,fury,18,8,10
Furginox,argent-dawn,764,warrior,fury,24,8,16
Greatsword,turalyon,763,warrior,fury,12,8,4
Cazzpowa,frostmane,762,warrior,fury,12,8,4
Motorhead,tirion,762,warrior,fury,18,8,10
Kaerz,ysondre,762,warrior,fury,18,8,10
Giemb,doomhammer,761,warrior,fury,60,17,43
Khaalo,blackhand,760,warrior,fury,12,8,4
Czarian,ragnaros,759,warrior,fury,36,8,28
Солоовей,gordunni,758,warrior,fury,18,8,10
Ошинай,gordunni,756,warrior,fury,18,8,10
Uleixoshark,argent-dawn,754,warrior,fury,18,8,10
Zarkos,onyxia,754,warrior,fury,24,8,16
Destrzadora,exodar,750,warrior,fury,18,8,10
Aedin,ravencrest,734,warrior,fury,17,8,9
Арнвальд,galakrond,728,warrior,fury,18,8,10
Вагранна,soulflayer,719,warrior,fury,17,8,9
Bragush,shattrath,718,warrior,fury,11,8,3
Dranosha,nemesis,718,warrior,fury,17,8,9
Стано,booty-bay,715,warrior,fury,14,9,5
Jakedo,outland,703,warrior,fury,17,8,9
Kilkov,emeriss,701,warrior,fury,16,8,8
Grekowar,dalaran,700,warrior,fury,17,8,9
Amédé,ysondre,697,warrior,fury,17,8,9
Bubbsi,turalyon,674,warrior,fury,24,8,16
Дмидрашх,howling-fjord,672,warrior,fury,10,8,2
Googas,aegwynn,672,warrior,fury,12,7,5
Orwarrio,thrall,672,warrior,fury,12,7,5
Осадчийофдес,soulflayer,672,warrior,fury,12,7,5
Фомори,howling-fjord,672,warrior,fury,12,7,5
Ðeadyet,mugthol,672,warrior,fury,12,7,5
Brbtoilet,kazzak,672,warrior,fury,12,7,5
Xurainzone,eredar,672,warrior,fury,12,7,5
Quadfather,kazzak,672,warrior,fury,12,7,5
Paynzx,blackrock,672,warrior,fury,12,7,5
Деимосин,howling-fjord,672,warrior,fury,12,7,5
Fraq,tarren-mill,672,warrior,fury,12,7,5
Alkuwaity,outland,672,warrior,fury,12,7,5
Doronas,der-rat-von-dalaran,672,warrior,fury,12,7,5
Седунг,gordunni,672,warrior,fury,12,7,5
Где,blackscar,672,warrior,fury,12,7,5
Yuuta,ravencrest,672,warrior,fury,12,7,5
Khrtw,silvermoon,672,warrior,fury,12,7,5
Инкула,gordunni,672,warrior,fury,12,7,5
Hàssard,outland,672,warrior,fury,12,7,5
Avgorcgodx,stormscale,672,warrior,fury,12,7,5
Xxeqtr,kazzak,672,warrior,fury,12,7,5
Seraphys,ravencrest,672,warrior,fury,12,7,5
Duarel,blackmoore,672,warrior,fury,12,7,5
Lildaddypump,ravencrest,672,warrior,fury,12,7,5
Nerfslam,stormscale,672,warrior,fury,17,8,9
Gramrosh,eredar,672,warrior,fury,18,7,11
Omcat,dun-modr,672,warrior,fury,18,7,11
Szpindah,ragnaros,672,warrior,fury,18,7,11
Foboa,archimonde,672,warrior,fury,18,7,11
Учихагодх,howling-fjord,672,warrior,fury,18,7,11
Кэйкан,gordunni,672,warrior,fury,18,7,11
Shintuargar,blackrock,672,warrior,fury,18,7,11
Stormíe,outland,671,warrior,fury,12,7,5
Теокрафт,howling-fjord,671,warrior,fury,12,7,5
Dgyfh,dun-morogh,671,warrior,fury,12,7,5
Zehirjin,sargeras,671,warrior,fury,12,7,5
Rryba,blackrock,671,warrior,fury,12,7,5
Bruxus,blackhand,671,warrior,fury,12,7,5
Sargonas,burning-blade,671,warrior,fury,12,7,5
Pépêloup,archimonde,671,warrior,fury,12,7,5
Broknagar,draenor,671,warrior,fury,12,7,5
Sniperwølf,tyrande,671,warrior,fury,12,7,5
Timmyda,dalaran,671,warrior,fury,12,7,5
Arturdayne,sanguino,671,warrior,fury,12,7,5
Septymyya,eredar,671,warrior,fury,15,8,7
Jaowa,blackmoore,671,warrior,fury,18,7,11
Sunzí,alakir,671,warrior,fury,18,7,11
Kolxoz,doomhammer,671,warrior,fury,18,7,11
Мембершримп,howling-fjord,671,warrior,fury,18,7,11
Têtebruler,archimonde,671,warrior,fury,18,7,11
Bonnejournée,stormscale,671,warrior,fury,18,7,11
Bwonsàmdí,ragnaros,671,warrior,fury,18,7,11
Vagor,draenor,670,warrior,fury,12,7,5
Thunderage,stormscale,670,warrior,fury,12,7,5
Drexx,ragnaros,670,warrior,fury,12,7,5
Chadchadsson,ravencrest,670,warrior,fury,12,7,5
Izrael,alakir,670,warrior,fury,12,7,5
Напутанность,soulflayer,670,warrior,fury,18,7,11
Mouliard,archimonde,670,warrior,fury,18,7,11
Grahatia,magtheridon,670,warrior,fury,18,7,11
Dabliu,burning-legion,670,warrior,fury,18,7,11
Djiozz,khaz-modan,669,warrior,fury,18,7,11
Bankaju,burning-legion,669,warrior,fury,18,7,11
Orengo,blackrock,668,warrior,fury,12,7,5
Ganian,stormscale,668,warrior,fury,18,7,11
Garosh,drakthul,666,warrior,fury,12,7,5
Titanhaut,frostwolf,666,warrior,fury,12,7,5
Telamonas,haomarush,665,warrior,fury,12,7,5
Dj,ragnaros,664,warrior,fury,12,7,5
Onslaught,pozzo-delleternità,663,warrior,fury,24,7,17
Horymir,ravencrest,655,warrior,fury,17,7,10
Albabhaltair,quelthalas,654,warrior,fury,18,7,11
Shedzo,tarren-mill,639,warrior,fury,14,8,6
Thezug,twisting-nether,639,warrior,fury,17,7,10
Pitii,burning-legion,638,warrior,fury,14,8,6
Ентил,gordunni,623,warrior,fury,17,7,10
Autümn,argent-dawn,618,warrior,fury,21,8,13
Djranji,kazzak,607,warrior,fury,16,7,9
Scofiéld,lordaeron,601,warrior,fury,11,7,4
Parteyunques,sanguino,592,warrior,fury,13,7,6
Quarantino,ysondre,590,warrior,fury,23,7,16
Thomasman,nerathor,576,warrior,fury,6,6,0
Dimethefoxx,argent-dawn,576,warrior,fury,6,6,0
Каосвар,howling-fjord,576,warrior,fury,6,6,0
Артэкриогг,soulflayer,576,warrior,fury,6,6,0
Âshkä,ysondre,576,warrior,fury,6,6,0
Cêlty,aegwynn,576,warrior,fury,6,6,0
Dhloos,kazzak,576,warrior,fury,12,6,6
Bloodyedge,sanguino,576,warrior,fury,12,6,6
Bstgame,frostmane,576,warrior,fury,12,6,6
Zkb,zuljin,576,warrior,fury,12,6,6
Yenkonov,blackmoore,576,warrior,fury,12,6,6
Bulgrash,blackmoore,576,warrior,fury,12,6,6
Rylbrah,blackmoore,576,warrior,fury,12,6,6
Palmexwar,drakthul,576,warrior,fury,12,6,6
Ellissari,tirion,576,warrior,fury,12,6,6
Gnomet,auchindoun,576,warrior,fury,12,6,6
Aurélus,rexxar,576,warrior,fury,12,6,6
Роудс,soulflayer,576,warrior,fury,12,6,6
Виттурус,howling-fjord,576,warrior,fury,12,6,6
Thogrêy,archimonde,576,warrior,fury,12,6,6
Änvil,tarren-mill,576,warrior,fury,12,6,6
Stanfury,sylvanas,576,warrior,fury,12,6,6
Àlexander,ravencrest,576,warrior,fury,12,6,6
Lathsmash,zenedar,576,warrior,fury,12,6,6
Engalxsol,tarren-mill,576,warrior,fury,12,6,6
Timagno,nemesis,576,warrior,fury,12,6,6
Lecorrecteur,archimonde,576,warrior,fury,12,6,6
Kalakalle,twisting-nether,576,warrior,fury,12,6,6
Rândy,confrérie-du-thorium,576,warrior,fury,12,6,6
Obitron,argent-dawn,576,warrior,fury,12,6,6
Humanboi,ravencrest,576,warrior,fury,12,6,6
Shurubel,outland,576,warrior,fury,12,6,6
Broxshar,shendralar,576,warrior,fury,12,6,6
Redwraith,stormscale,576,warrior,fury,12,6,6
Waterquéen,outland,576,warrior,fury,12,6,6
Асгинор,gordunni,576,warrior,fury,12,6,6
Вульрайс,deepholm,576,warrior,fury,12,6,6
Faithless,azshara,576,warrior,fury,12,6,6
Sakumo,sylvanas,576,warrior,fury,12,6,6
Nallepúh,silvermoon,576,warrior,fury,12,6,6
Фелёр,gordunni,576,warrior,fury,12,6,6
Vatolocoese,dun-morogh,576,warrior,fury,12,6,6
Rudvard,hyjal,576,warrior,fury,12,6,6
Rarcus,chamber-of-aspects,576,warrior,fury,12,6,6
Kristinas,tarren-mill,576,warrior,fury,12,6,6
Рэйлет,gordunni,576,warrior,fury,12,6,6
Sêrên,dun-modr,576,warrior,fury,12,6,6
Cleaner,blackmoore,576,warrior,fury,12,6,6
Эксихард,gordunni,576,warrior,fury,18,6,12
Massiveape,argent-dawn,576,warrior,fury,18,6,12
Prettyangel,aegwynn,576,warrior,fury,18,6,12
Mazzkze,silvermoon,576,warrior,fury,18,6,12
Сталиран,gordunni,576,warrior,fury,18,6,12
Hulkzmash,tarren-mill,576,warrior,fury,18,6,12
Getonxnxx,quelthalas,576,warrior,fury,18,6,12
Килоагр,gordunni,576,warrior,fury,18,6,12
Durrüti,sanguino,575,warrior,fury,12,6,6
Roninwar,the-maelstrom,575,warrior,fury,12,6,6
Моргаур,howling-fjord,575,warrior,fury,12,6,6
Xenesthis,dun-morogh,575,warrior,fury,12,6,6
Esegryel,argent-dawn,575,warrior,fury,12,6,6
Bloódángel,frostwolf,575,warrior,fury,12,6,6
Nihroxis,blackrock,575,warrior,fury,12,6,6
Djayson,hyjal,575,warrior,fury,12,6,6
Daramir,turalyon,575,warrior,fury,12,6,6
Конвержн,howling-fjord,575,warrior,fury,12,6,6
Vmnbgh,aszune,575,warrior,fury,12,6,6
Jâmâli,malganis,575,warrior,fury,12,6,6
Happyhour,sargeras,575,warrior,fury,12,6,6
Zulien,sanguino,575,warrior,fury,12,6,6
Leorx,draenor,575,warrior,fury,12,6,6
Дизроуз,gordunni,575,warrior,fury,12,6,6
Tsu,karazhan,575,warrior,fury,12,6,6
Fightinghell,stormrage,575,warrior,fury,12,6,6
Йомхар,howling-fjord,575,warrior,fury,12,6,6
Ffrancis,eldrethalas,575,warrior,fury,12,6,6
Richymorty,los-errantes,575,warrior,fury,12,6,6
Akäme,ysondre,575,warrior,fury,18,6,12
Argomor,stormscale,575,warrior,fury,18,6,12
Juanvaco,tarren-mill,575,warrior,fury,18,6,12
Вкусныисыр,soulflayer,574,warrior,fury,12,6,6
Bruko,silvermoon,574,warrior,fury,12,6,6
Exødiä,hyjal,574,warrior,fury,12,6,6
Kvintor,bloodscalp,574,warrior,fury,12,6,6
Admiràl,azuremyst,573,warrior,fury,12,6,6
Зарган,howling-fjord,573,warrior,fury,24,6,18
Waltharius,das-syndikat,572,warrior,fury,12,6,6
Джомалкович,deathweaver,572,warrior,fury,12,6,6
Deushill,sylvanas,570,warrior,fury,12,6,6
Khrund,burning-legion,566,warrior,fury,14,6,8
Mokwo,chogall,543,warrior,fury,14,7,7
Zionto,draenor,543,warrior,fury,23,6,17
Piinte,naxxramas,536,warrior,fury,14,7,7
Pinkvae,doomhammer,527,warrior,fury,11,6,5
Мегамегаогр,howling-fjord,527,warrior,fury,11,6,5
Skeptikal,tarren-mill,527,warrior,fury,11,6,5
Narkololzz,marécage-de-zangar,527,warrior,fury,15,6,9
Balsor,frostmane,526,warrior,fury,11,6,5
Ausrastus,blackhand,522,warrior,fury,16,7,9
Retmain,draenor,522,warrior,fury,20,8,12
Boxersene,blackmoore,516,warrior,fury,22,7,15
Xienia,dun-morogh,510,warrior,fury,22,6,16
Blutwar,kazzak,499,warrior,fury,25,11,14
Ishbosheth,stormscale,480,warrior,fury,6,5,1
Warsteng,ragnaros,480,warrior,fury,6,5,1
Ptp,argent-dawn,480,warrior,fury,6,5,1
Дайбек,howling-fjord,480,warrior,fury,6,5,1
Griswarr,draenor,480,warrior,fury,6,5,1
Easypoîntsx,tarren-mill,480,warrior,fury,6,5,1
Melted,ravencrest,480,warrior,fury,6,5,1
Röell,draenor,480,warrior,fury,6,5,1
Вульфычч,gordunni,480,warrior,fury,6,5,1
Megabrux,colinas-pardas,480,warrior,fury,6,5,1
Gguts,archimonde,480,warrior,fury,6,5,1
Ézélya,dalaran,480,warrior,fury,6,5,1
Escapeartíst,ravencrest,480,warrior,fury,6,5,1
Ravenpaw,burning-legion,480,warrior,fury,6,5,1
Ганахан,soulflayer,480,warrior,fury,6,5,1
Exeter,nagrand,480,warrior,fury,6,5,1
Bârney,ravencrest,480,warrior,fury,6,5,1
Xtu,kazzak,480,warrior,fury,6,5,1
Obîwan,dalaran,480,warrior,fury,6,5,1
Aldébbarann,archimonde,480,warrior,fury,8,6,2
Pihvikostaja,stormreaver,480,warrior,fury,8,5,3
Orkoje,argent-dawn,480,warrior,fury,12,5,7
Nazdrago,draenor,480,warrior,fury,12,5,7
Donvasto,sylvanas,480,warrior,fury,12,5,7
Stkacha,sanguino,480,warrior,fury,12,5,7
Ulthrak,archimonde,480,warrior,fury,12,5,7
Jhoakim,argent-dawn,480,warrior,fury,12,5,7
Darthmalgus,stormscale,480,warrior,fury,12,5,7
Rohc,kazzak,480,warrior,fury,12,5,7
Bøgatyr,draenor,480,warrior,fury,12,5,7
Forerunner,silvermoon,480,warrior,fury,12,5,7
Suknur,silvermoon,480,warrior,fury,12,5,7
Beznacaj,outland,480,warrior,fury,12,5,7
Punahabe,draenor,480,warrior,fury,12,5,7
Daymio,twisting-nether,480,warrior,fury,12,5,7
Petrixens,drakthul,480,warrior,fury,12,5,7
Лысыч,gordunni,480,warrior,fury,12,5,7
Kagsteelfist,twisting-nether,480,warrior,fury,12,5,7
Helleon,twisting-nether,480,warrior,fury,12,5,7
Bløckqt,archimonde,480,warrior,fury,12,5,7
Lánse,ravencrest,480,warrior,fury,12,5,7
Chrobochrot,burning-blade,480,warrior,fury,12,5,7
Dauderup,aerie-peak,480,warrior,fury,12,5,7
Léonie,arakarahm,480,warrior,fury,12,5,7
Eiche,kazzak,480,warrior,fury,12,5,7
Bîmbämboom,blackmoore,480,warrior,fury,12,5,7
Wallach,darkspear,480,warrior,fury,12,5,7
Трис,fordragon,480,warrior,fury,12,5,7
Dyspó,sanguino,480,warrior,fury,12,5,7
Riac,lothar,480,warrior,fury,12,5,7
Soullmike,drakthul,480,warrior,fury,12,5,7
Friendlytwo,quelthalas,480,warrior,fury,12,5,7
Jugg,emerald-dream,480,warrior,fury,12,5,7
Eliyahu,ghostlands,480,warrior,fury,12,5,7
Гатал,howling-fjord,480,warrior,fury,12,5,7
Kondomi,stormreaver,480,warrior,fury,12,5,7
Ruixxted,stormreaver,480,warrior,fury,12,5,7
Arthayl,eredar,480,warrior,fury,12,5,7
Dayz,draenor,480,warrior,fury,12,5,7
Damáge,doomhammer,480,warrior,fury,12,5,7
Кэфтэмэ,soulflayer,480,warrior,fury,12,5,7
Rageaholic,blackmoore,480,warrior,fury,12,5,7
Corlo,uldaman,480,warrior,fury,12,5,7
Axamo,ragnaros,480,warrior,fury,12,5,7
Gagatchar,die-silberne-hand,480,warrior,fury,12,5,7
Mouldyclunge,argent-dawn,480,warrior,fury,17,5,12
Nightmareb,magtheridon,480,warrior,fury,18,5,13
Bindera,silvermoon,480,warrior,fury,18,5,13
Delonathor,drakthul,480,warrior,fury,18,5,13
Ukloth,sanguino,480,warrior,fury,18,5,13
Artheim,silvermoon,480,warrior,fury,18,5,13
Sambucá,blackmoore,480,warrior,fury,18,5,13
Лимэй,blackscar,480,warrior,fury,18,5,13
Fluffeh,argent-dawn,480,warrior,fury,18,5,13
Murotan,dalaran,480,warrior,fury,18,5,13
Porrter,silvermoon,479,warrior,fury,6,5,1
Galdir,ravencrest,479,warrior,fury,6,5,1
Haregos,gorgonnash,479,warrior,fury,6,5,1
Cosmoses,mazrigos,479,warrior,fury,12,5,7
Maidenless,quelthalas,479,warrior,fury,12,5,7
Miotyz,ahnqiraj,479,warrior,fury,12,5,7
Hynekiller,silvermoon,479,warrior,fury,12,5,7
Brutalz,kazzak,479,warrior,fury,12,5,7
Pipsysimp,ragnaros,479,warrior,fury,12,5,7
Wilmazutschn,nethersturm,479,warrior,fury,12,5,7
Элейд,thermaplugg,479,warrior,fury,12,5,7
Granrubin,dun-modr,479,warrior,fury,12,5,7
Чорныгвард,gordunni,479,warrior,fury,12,5,7
Keaile,tarren-mill,479,warrior,fury,12,5,7
Luciferkhan,twisting-nether,479,warrior,fury,12,5,7
Zenìa,argent-dawn,479,warrior,fury,12,5,7
Jeembo,blackmoore,479,warrior,fury,18,5,13
Мутобой,soulflayer,479,warrior,fury,18,5,13
Harny,silvermoon,477,warrior,fury,10,6,4
Roostai,shattered-hand,476,warrior,fury,12,5,7
Mane,thunderhorn,475,warrior,fury,12,5,7
Iæ,perenolde,472,warrior,fury,12,5,7
Workout,nemesis,447,warrior,fury,11,5,6
Branzei,darkspear,447,warrior,fury,16,5,11
Greensmash,hyjal,447,warrior,fury,20,6,14
Autumnfálls,kazzak,446,warrior,fury,10,6,4
Valrathion,ravencrest,426,warrior,fury,17,8,9
Yugoslav,argent-dawn,426,warrior,fury,16,6,10
Lykevil,medivh,414,warrior,fury,14,5,9
Famous,argent-dawn,400,warrior,fury,7,5,2
Kurzen,voljin,384,warrior,fury,6,4,2
Айфилшок,gordunni,384,warrior,fury,6,4,2
Gotnuub,tarren-mill,384,warrior,fury,6,4,2
Devìlscandy,stormscale,384,warrior,fury,6,4,2
Infernall,burning-legion,384,warrior,fury,6,4,2
Имбасенпай,howling-fjord,384,warrior,fury,6,4,2
Dominikhasek,stormscale,384,warrior,fury,6,4,2
Нерморрог,howling-fjord,384,warrior,fury,6,4,2
Nobelisarius,norgannon,384,warrior,fury,6,4,2
Extasceh,turalyon,384,warrior,fury,6,4,2
Daldiee,ravencrest,384,warrior,fury,6,4,2
Viqi,alleria,384,warrior,fury,6,4,2
Дугмар,gordunni,384,warrior,fury,6,4,2
Drittsekken,sylvanas,384,warrior,fury,6,4,2
Warbigboss,draenor,384,warrior,fury,6,4,2
Bersurker,draenor,384,warrior,fury,6,4,2
Tweaked,argent-dawn,384,warrior,fury,6,4,2
Ronipickerin,stormscale,384,warrior,fury,6,4,2
Gonutz,sylvanas,384,warrior,fury,6,4,2
Впижаме,gordunni,384,warrior,fury,6,4,2
Strähne,malganis,384,warrior,fury,6,4,2
Orkboii,ravencrest,384,warrior,fury,6,4,2
Dominow,ysondre,384,warrior,fury,6,4,2
Mornog,blackhand,384,warrior,fury,6,4,2
Chipstjuven,tarren-mill,384,warrior,fury,6,4,2
Ymaa,argent-dawn,384,warrior,fury,6,4,2
Oluwafunmila,tarren-mill,384,warrior,fury,6,4,2
Lôreex,ravencrest,384,warrior,fury,6,4,2
Axislips,draenor,384,warrior,fury,6,4,2
Evilez,ravencrest,384,warrior,fury,6,4,2
Hofftor,eredar,384,warrior,fury,6,4,2
Даювзадницу,soulflayer,384,warrior,fury,6,4,2
Shará,eredar,384,warrior,fury,6,4,2
Zeldius,ravencrest,384,warrior,fury,6,4,2
Кайзерчиф,soulflayer,384,warrior,fury,6,4,2
Executte,zuljin,384,warrior,fury,6,4,2
Zoink,burning-blade,384,warrior,fury,6,4,2
Craíne,antonidas,384,warrior,fury,6,4,2
Geckoo,emerald-dream,384,warrior,fury,6,4,2
Cleavnseagal,ravencrest,384,warrior,fury,6,4,2
Ränchiëk,ravencrest,384,warrior,fury,6,4,2
Stickifrån,darkspear,384,warrior,fury,6,4,2
Korghar,xavius,384,warrior,fury,6,4,2
Dollystyle,kazzak,384,warrior,fury,6,4,2
Histe,thrall,384,warrior,fury,6,4,2
Mórdér,blackmoore,384,warrior,fury,6,4,2
Suzzon,hyjal,384,warrior,fury,6,4,2
Mvi,frostmane,384,warrior,fury,6,4,2
Madvlad,twisting-nether,384,warrior,fury,6,4,2
Roadsick,outland,384,warrior,fury,6,4,2
Bravest,ragnaros,384,warrior,fury,6,4,2
Asuross,dalaran,384,warrior,fury,6,4,2
Ryghar,silvermoon,384,warrior,fury,6,4,2
Irondahr,silvermoon,384,warrior,fury,6,4,2
Zillrog,kazzak,384,warrior,fury,6,4,2
Razzani,nathrezim,384,warrior,fury,6,4,2
Vullgrîm,blackmoore,384,warrior,fury,6,4,2
Thôras,anetheron,384,warrior,fury,6,4,2
Humanoç,dun-modr,384,warrior,fury,6,4,2
Shuriká,blackmoore,384,warrior,fury,6,4,2
Lôcutus,thrall,384,warrior,fury,6,4,2
Чосо,razuvious,384,warrior,fury,6,4,2
Beached,outland,384,warrior,fury,6,4,2
Gandosh,blackmoore,384,warrior,fury,6,4,2
Satabasse,marécage-de-zangar,384,warrior,fury,6,4,2
Shalahed,outland,384,warrior,fury,6,4,2
Pierøne,nemesis,384,warrior,fury,6,4,2
Eliyel,silvermoon,384,warrior,fury,6,4,2
Truepassion,outland,384,warrior,fury,6,4,2
Svinarghulk,twisting-nether,384,warrior,fury,6,4,2
Saurens,twisting-nether,384,warrior,fury,6,4,2
Deamonn,kazzak,384,warrior,fury,6,4,2
Swàck,mazrigos,384,warrior,fury,6,4,2
Trôth,kazzak,384,warrior,fury,6,4,2
Sanhaevel,ravencrest,384,warrior,fury,10,4,6
Golward,grim-batol,384,warrior,fury,11,4,7
Slaktârn,ragnaros,384,warrior,fury,12,4,8
Tanalias,outland,384,warrior,fury,12,4,8
Аркашевич,gordunni,384,warrior,fury,12,4,8
Katmos,baelgun,384,warrior,fury,12,4,8
Sabak,archimonde,384,warrior,fury,12,4,8
Bealin,the-venture-co,384,warrior,fury,12,4,8
Барнетт,gordunni,384,warrior,fury,12,4,8
Цикламея,blackscar,384,warrior,fury,12,4,8
Garstus,die-silberne-hand,384,warrior,fury,12,4,8
Yaune,ravencrest,384,warrior,fury,12,4,8
Zargala,stormscale,384,warrior,fury,12,4,8
Shabir,sylvanas,384,warrior,fury,12,4,8
Bastrick,argent-dawn,384,warrior,fury,12,4,8
Neekero,burning-legion,384,warrior,fury,12,4,8
Grisettê,archimonde,384,warrior,fury,12,4,8
Изберг,soulflayer,384,warrior,fury,12,4,8
Ñegan,proudmoore,384,warrior,fury,12,4,8
Деспазитыч,fordragon,384,warrior,fury,12,4,8
Aynerin,silvermoon,384,warrior,fury,12,4,8
Thorgaz,blackmoore,384,warrior,fury,12,4,8
Scrin,ravenholdt,384,warrior,fury,12,4,8
Himarsenko,silvermoon,384,warrior,fury,12,4,8
Fistawarrior,nemesis,384,warrior,fury,12,4,8
Колобочек,eversong,384,warrior,fury,12,4,8
Suichôken,archimonde,384,warrior,fury,12,4,8
Aprilis,thrall,384,warrior,fury,12,4,8
Poniroula,burning-legion,384,warrior,fury,12,4,8
Bulletpants,argent-dawn,384,warrior,fury,12,4,8
Råkeff,tarren-mill,384,warrior,fury,12,4,8
Betonica,burning-legion,384,warrior,fury,12,4,8
Potátonerd,kazzak,384,warrior,fury,12,4,8
Ganzaésábi,aggra-português,384,warrior,fury,12,4,8
Tagavaga,tarren-mill,384,warrior,fury,12,4,8
Agnetta,burning-legion,384,warrior,fury,12,4,8
Garradoom,stormscale,384,warrior,fury,17,5,12
Siltiel,marécage-de-zangar,383,warrior,fury,6,4,2
Arta,arthas,383,warrior,fury,6,4,2
Bulbumbo,twisting-nether,383,warrior,fury,6,4,2
Ronda,nemesis,383,warrior,fury,6,4,2
Voa,stormscale,383,warrior,fury,6,4,2
Dullegriet,veknilash,383,warrior,fury,12,4,8
Xhasan,sylvanas,383,warrior,fury,12,4,8
Basingaa,pozzo-delleternità,383,warrior,fury,12,4,8
Jún,dun-modr,383,warrior,fury,12,4,8
Grenad,kazzak,383,warrior,fury,12,4,8
Ruuddy,draenor,382,warrior,fury,12,4,8
Colliderbody,dun-modr,367,warrior,fury,9,5,4
Beogor,grim-batol,367,warrior,fury,11,4,7
Toxîn,dalaran,351,warrior,fury,11,4,7
Hembränt,hellfire,351,warrior,fury,17,4,13
Bossít,doomhammer,336,warrior,fury,9,4,5
Blackseven,ravencrest,330,warrior,fury,9,6,3
Skillissues,argent-dawn,330,warrior,fury,11,7,4
Fleshwerk,silvermoon,320,warrior,fury,10,4,6
Zazate,archimonde,319,warrior,fury,5,4,1
Manelar,draenor,319,warrior,fury,8,4,4
Хоркан,blackscar,319,warrior,fury,8,4,4
Phòbos,stormrage,319,warrior,fury,11,4,7
Groullomus,archimonde,318,warrior,fury,10,4,6
Anaba,voljin,318,warrior,fury,10,4,6
Padzwarr,kazzak,288,warrior,fury,6,3,3
Zarrgash,blackhand,288,warrior,fury,6,3,3
Kapuchino,twisting-nether,288,warrior,fury,6,3,3
Skullsmasher,stormscale,288,warrior,fury,6,3,3
Hayahol,kazzak,288,warrior,fury,6,3,3
Haryssa,blackhand,288,warrior,fury,6,3,3
Гацс,soulflayer,288,warrior,fury,6,3,3
Jasperr,nemesis,288,warrior,fury,6,3,3
Auauau,arthas,288,warrior,fury,6,3,3
Wunderwaffle,xavius,288,warrior,fury,6,3,3
Грош,deepholm,288,warrior,fury,6,3,3
Trìnítÿ,anubarak,288,warrior,fury,6,3,3
Arnoldalois,neptulon,288,warrior,fury,6,3,3
Nifrediel,trollbane,288,warrior,fury,6,3,3
Imabeatyoass,kazzak,288,warrior,fury,6,3,3
Rägnât,dun-modr,288,warrior,fury,6,3,3
Wärlight,nemesis,288,warrior,fury,6,3,3
Зандур,eversong,288,warrior,fury,6,3,3
Previse,argent-dawn,288,warrior,fury,6,3,3
Griffar,malorne,288,warrior,fury,6,3,3
Mïîäm,archimonde,288,warrior,fury,6,3,3
Lilenrage,stormscale,288,warrior,fury,6,3,3
Neíd,malganis,288,warrior,fury,6,3,3
Kopfnusskali,thrall,288,warrior,fury,6,3,3
Zilg,twisting-nether,288,warrior,fury,6,3,3
Васяжелезо,gordunni,288,warrior,fury,6,3,3
Taeshalach,der-abyssische-rat,288,warrior,fury,6,3,3
Blackwólf,bloodhoof,288,warrior,fury,6,3,3
Tabboonishka,draenor,288,warrior,fury,6,3,3
Schildwall,aegwynn,288,warrior,fury,6,3,3
Dorya,aegwynn,288,warrior,fury,6,3,3
Sørêy,aegwynn,288,warrior,fury,6,3,3
Marlßørø,twisting-nether,288,warrior,fury,6,3,3
Barrocket,aegwynn,288,warrior,fury,6,3,3
Sulemanslay,silvermoon,288,warrior,fury,6,3,3
Ivailowar,ravencrest,288,warrior,fury,6,3,3
Dollybúrster,aegwynn,288,warrior,fury,6,3,3
Manký,kazzak,288,warrior,fury,6,3,3
Immera,silvermoon,288,warrior,fury,6,3,3
Kronmw,dun-modr,288,warrior,fury,6,3,3
Vory,ravencrest,288,warrior,fury,6,3,3
Cryze,ravencrest,288,warrior,fury,6,3,3
Ijzerekast,sylvanas,288,warrior,fury,6,3,3
Cleavyera,tarren-mill,288,warrior,fury,6,3,3
Nightmareowl,tarren-mill,288,warrior,fury,6,3,3
Bernieboi,tarren-mill,288,warrior,fury,6,3,3
Smâllpackage,silvermoon,288,warrior,fury,6,3,3
Xerone,doomhammer,288,warrior,fury,6,3,3
Grinrok,thrall,288,warrior,fury,6,3,3
Whàtsup,stormscale,288,warrior,fury,6,3,3
Mfdoöm,draenor,288,warrior,fury,6,3,3
Feydal,thrall,288,warrior,fury,6,3,3
Keffboi,draenor,288,warrior,fury,6,3,3
Drfeelgud,twisting-nether,288,warrior,fury,6,3,3
Ölaff,ravencrest,288,warrior,fury,6,3,3
Shaxov,draenor,288,warrior,fury,6,3,3
Slg,tarren-mill,288,warrior,fury,6,3,3
Döömed,drakthul,288,warrior,fury,6,3,3
Ironlol,ravencrest,288,warrior,fury,6,3,3
Corychase,ravencrest,288,warrior,fury,6,3,3
Uncledazzo,quelthalas,288,warrior,fury,6,3,3
Arachnoyd,drakthul,288,warrior,fury,6,3,3
Oombac,lordaeron,288,warrior,fury,6,3,3
Nitheriá,draenor,288,warrior,fury,6,3,3
Priceswex,ravencrest,288,warrior,fury,6,3,3
Iwts,archimonde,288,warrior,fury,6,3,3
Xial,ravencrest,288,warrior,fury,6,3,3
Kåïdø,ravencrest,288,warrior,fury,6,3,3
Geicoo,dalaran,288,warrior,fury,6,3,3
Berzzerker,tarren-mill,288,warrior,fury,6,3,3
Wåks,dalaran,288,warrior,fury,6,3,3
Peon,eredar,288,warrior,fury,6,3,3
Nèssa,outland,288,warrior,fury,6,3,3
Aìrwave,blackmoore,288,warrior,fury,6,3,3
Снакихснаки,gordunni,288,warrior,fury,6,3,3
Jamiex,marécage-de-zangar,288,warrior,fury,6,3,3
Eleborn,tarren-mill,288,warrior,fury,6,3,3
Frankytank,antonidas,288,warrior,fury,6,3,3
Elyozz,silvermoon,288,warrior,fury,6,3,3
Hortswarr,drakthul,288,warrior,fury,6,3,3
Lâppön,blackmoore,288,warrior,fury,6,3,3
Sathom,hyjal,288,warrior,fury,6,3,3
Tidùs,nethersturm,288,warrior,fury,6,3,3
Didgedelik,archimonde,288,warrior,fury,6,3,3
Sargul,ragnaros,288,warrior,fury,6,3,3
Harimà,antonidas,288,warrior,fury,6,3,3
Wárríor,ragnaros,288,warrior,fury,6,3,3
Shaanks,archimonde,288,warrior,fury,6,3,3
Afk,emeriss,288,warrior,fury,6,3,3
Mumbojumbo,uldum,288,warrior,fury,6,3,3
Lundehund,dalaran,288,warrior,fury,6,3,3
Gnarrwarr,eredar,288,warrior,fury,6,3,3
Uthric,azuremyst,288,warrior,fury,6,3,3
Azotz,archimonde,288,warrior,fury,6,3,3
Arthagore,archimonde,288,warrior,fury,6,3,3
Rangnarr,doomhammer,288,warrior,fury,6,3,3
Bobshaggins,stormscale,288,warrior,fury,12,3,9
Urabrask,stormscale,288,warrior,fury,12,3,9
Gorkill,bladefist,288,warrior,fury,12,3,9
Phovoss,stormscale,288,warrior,fury,12,3,9
Hördê,zuljin,288,warrior,fury,12,3,9
Devso,ravencrest,288,warrior,fury,12,3,9
Naspy,stormscale,288,warrior,fury,12,3,9
Nightvision,skullcrusher,288,warrior,fury,12,3,9
Гхазгхкалл,howling-fjord,288,warrior,fury,12,3,9
Ôrcboi,tarren-mill,288,warrior,fury,12,3,9
Confliction,outland,288,warrior,fury,12,3,9
Lyfttokyo,tarren-mill,288,warrior,fury,12,3,9
Malvred,eredar,288,warrior,fury,12,3,9
Zyn,outland,288,warrior,fury,12,3,9
Xeonair,kazzak,288,warrior,fury,12,3,9
Skykrow,ysondre,288,warrior,fury,12,3,9
Valldi,argent-dawn,288,warrior,fury,12,3,9
Zercher,tarren-mill,288,warrior,fury,12,3,9
Waríos,blackrock,288,warrior,fury,12,3,9
Ireincarnate,argent-dawn,288,warrior,fury,12,3,9
Conânan,blackrock,288,warrior,fury,12,3,9
Pamila,outland,288,warrior,fury,12,3,9
Aphae,defias-brotherhood,288,warrior,fury,12,3,9
Slayfox,dun-morogh,288,warrior,fury,12,3,9
Xanatos,khazgoroth,288,warrior,fury,12,3,9
Daye,zuluhed,288,warrior,fury,12,3,9
Pekknekck,outland,288,warrior,fury,12,3,9
Kiryn,draenor,288,warrior,fury,12,3,9
Theunknown,eonar,288,warrior,fury,12,3,9
Mash,hyjal,288,warrior,fury,12,3,9
Джондо,gordunni,288,warrior,fury,12,3,9
Grommer,dentarg,288,warrior,fury,12,3,9
Zwheind,silvermoon,288,warrior,fury,12,3,9
Jasonnes,argent-dawn,288,warrior,fury,17,3,14
Tbones,kazzak,288,warrior,fury,18,3,15
Gartenzwerge,kelthuzad,287,warrior,fury,6,3,3
Atelier,magtheridon,287,warrior,fury,6,3,3
Arnnau,dun-modr,287,warrior,fury,6,3,3
Luw,twisting-nether,287,warrior,fury,12,3,9
Ragghatt,draenor,287,warrior,fury,12,3,9
Xentos,kirin-tor,286,warrior,fury,10,5,5
Agunnai,karazhan,286,warrior,fury,6,3,3
Raffael,pozzo-delleternità,286,warrior,fury,12,3,9
Kilsorrow,silvermoon,240,warrior,fury,9,4,5
Execute,sanguino,239,warrior,fury,5,3,2
Xgs,archimonde,234,warrior,fury,9,5,4
Zeldaixi,twisting-nether,234,warrior,fury,10,5,5
Xqt,laughing-skull,234,warrior,fury,9,4,5
Fetidoman,zuljin,224,warrior,fury,10,3,7
Iarsonn,drakthul,223,warrior,fury,8,3,5
Флокт,howling-fjord,208,warrior,fury,7,3,4
Цезарь,greymane,192,warrior,fury,4,3,1
Mudryk,burning-blade,192,warrior,fury,4,3,1
Имбанутыйвар,soulflayer,192,warrior,fury,4,3,1
Балласёж,gordunni,192,warrior,fury,9,3,6
Themachine,burning-blade,192,warrior,fury,9,3,6
Elendurel,outland,192,warrior,fury,6,2,4
Gregórry,eredar,192,warrior,fury,6,2,4
Wembley,proudmoore,192,warrior,fury,6,2,4
Гудмунт,borean-tundra,192,warrior,fury,6,2,4
Bruks,antonidas,192,warrior,fury,6,2,4
Врэкклив,gordunni,192,warrior,fury,6,2,4
Shreedshot,blackmoore,192,warrior,fury,6,2,4
Dorwarhoof,ravencrest,192,warrior,fury,6,2,4
Kennzz,ravencrest,192,warrior,fury,6,2,4
Boostbywar,archimonde,192,warrior,fury,6,2,4
Piixxz,hyjal,192,warrior,fury,6,2,4
Gomblin,blackmoore,192,warrior,fury,6,2,4
Армгрид,gordunni,192,warrior,fury,6,2,4
Raizy,frostwolf,192,warrior,fury,6,2,4
Zirvey,tarren-mill,192,warrior,fury,6,2,4
Kmag,ravencrest,192,warrior,fury,6,2,4
Suduri,drakthul,192,warrior,fury,6,2,4
Трапсир,gordunni,192,warrior,fury,6,2,4
Alxqt,outland,192,warrior,fury,6,2,4
Ellchefe,aggra-português,192,warrior,fury,6,2,4
Mîcî,tarren-mill,192,warrior,fury,6,2,4
Singekipu,hyjal,192,warrior,fury,6,2,4
Crocbait,ravencrest,192,warrior,fury,6,2,4
Ruz,defias-brotherhood,192,warrior,fury,6,2,4
Wlâdimir,eredar,192,warrior,fury,6,2,4
Jambaz,ravencrest,192,warrior,fury,6,2,4
Pappasmurfy,outland,192,warrior,fury,6,2,4
Raksor,hyjal,192,warrior,fury,6,2,4
Jriddyzug,ravencrest,192,warrior,fury,6,2,4
Sefty,tarren-mill,192,warrior,fury,6,2,4
Grimdur,kirin-tor,192,warrior,fury,6,2,4
Walkers,frostmane,192,warrior,fury,6,2,4
Oxxi,outland,192,warrior,fury,6,2,4
Shownomercy,blackrock,192,warrior,fury,6,2,4
Pemex,stormreaver,192,warrior,fury,6,2,4
Kaveli,tarren-mill,192,warrior,fury,6,2,4
Onykat,aegwynn,192,warrior,fury,6,2,4
Velgur,ravencrest,192,warrior,fury,6,2,4
Malalulu,burning-legion,192,warrior,fury,6,2,4
Xiiver,burning-legion,192,warrior,fury,6,2,4
Кунгфурик,soulflayer,192,warrior,fury,6,2,4
Kímbo,tarren-mill,192,warrior,fury,6,2,4
Siuzy,blackrock,192,warrior,fury,6,2,4
Freddie,baelgun,192,warrior,fury,6,2,4
Skullxy,talnivarr,192,warrior,fury,6,2,4
Rayyes,stormscale,192,warrior,fury,6,2,4
Даммодар,howling-fjord,192,warrior,fury,6,2,4
Oueban,doomhammer,192,warrior,fury,6,2,4
Glupakrava,sylvanas,192,warrior,fury,6,2,4
Khòrne,sanguino,192,warrior,fury,6,2,4
Evilweraz,turalyon,192,warrior,fury,6,2,4
Fookyoup,stormscale,192,warrior,fury,6,2,4
Queak,kazzak,192,warrior,fury,6,2,4
Holdemhammer,sanguino,192,warrior,fury,6,2,4
Eyolf,thunderhorn,192,warrior,fury,6,2,4
Искристый,howling-fjord,192,warrior,fury,6,2,4
Qiz,silvermoon,192,warrior,fury,6,2,4
Karkun,gilneas,192,warrior,fury,6,2,4
Picklejuicer,argent-dawn,192,warrior,fury,6,2,4
Maniaco,kazzak,192,warrior,fury,6,2,4
Whitescale,silvermoon,192,warrior,fury,6,2,4
Dieselengine,draenor,192,warrior,fury,6,2,4
Lianore,sanguino,192,warrior,fury,6,2,4
Саркон,ashenvale,192,warrior,fury,6,2,4
Martins,doomhammer,192,warrior,fury,6,2,4
Optitt,dethecus,192,warrior,fury,6,2,4
Vikiox,das-konsortium,192,warrior,fury,6,2,4
Троммтар,howling-fjord,192,warrior,fury,6,2,4
Like,blackrock,192,warrior,fury,6,2,4
Versionx,stormscale,192,warrior,fury,6,2,4
Tyranitar,pozzo-delleternità,192,warrior,fury,6,2,4
Fuwy,argent-dawn,192,warrior,fury,6,2,4
Akril,kelthuzad,192,warrior,fury,6,2,4
Zugzugcleave,blackrock,192,warrior,fury,6,2,4
Sgàthach,silvermoon,192,warrior,fury,6,2,4
Dupnica,kazzak,192,warrior,fury,6,2,4
Aler,alakir,192,warrior,fury,6,2,4
Nabucadnozor,illidan,192,warrior,fury,6,2,4
Nokturnâl,silvermoon,192,warrior,fury,6,2,4
Chrymiiee,blutkessel,192,warrior,fury,6,2,4
Ragelust,twisting-nether,192,warrior,fury,6,2,4
Raoh,malganis,192,warrior,fury,6,2,4
Zalazain,burning-legion,192,warrior,fury,6,2,4
Korama,emerald-dream,192,warrior,fury,6,2,4
Sertigan,dun-modr,192,warrior,fury,6,2,4
Deathrazór,stormscale,192,warrior,fury,6,2,4
Азаргатан,soulflayer,192,warrior,fury,6,2,4
Falnah,sargeras,192,warrior,fury,6,2,4
Nexyycleave,kazzak,192,warrior,fury,6,2,4
Souler,burning-legion,192,warrior,fury,6,2,4
Cesaro,blackhand,192,warrior,fury,6,2,4
Buntstift,thrall,192,warrior,fury,6,2,4
Ezlx,stormscale,192,warrior,fury,6,2,4
Кентафурик,soulflayer,192,warrior,fury,6,2,4
Shíranuí,blackhand,192,warrior,fury,10,3,7
Karmok,hyjal,192,warrior,fury,7,2,5
Ochocinco,quelthalas,192,warrior,fury,7,2,5
Schneklinge,blutkessel,192,warrior,fury,8,2,6
Ikaroshi,silvermoon,192,warrior,fury,9,2,7
Thordis,sylvanas,192,warrior,fury,11,2,9
Korova,blackrock,192,warrior,fury,12,2,10
Sycon,chamber-of-aspects,192,warrior,fury,12,2,10
Stonlocked,blackhand,192,warrior,fury,12,2,10
Pakusrage,defias-brotherhood,192,warrior,fury,12,2,10
Rageside,draenor,192,warrior,fury,12,2,10
Minotaureeni,silvermoon,192,warrior,fury,12,2,10
Boofhoof,nordrassil,192,warrior,fury,12,2,10
Сажень,blackscar,192,warrior,fury,12,2,10
Altroox,malorne,192,warrior,fury,12,2,10
Davetsiz,burning-legion,192,warrior,fury,12,2,10
Angrethar,tarren-mill,192,warrior,fury,12,2,10
Andrjuscha,blackrock,192,warrior,fury,12,2,10
Frowenn,ravencrest,192,warrior,fury,12,2,10
Tömahawk,defias-brotherhood,191,warrior,fury,6,2,4
Dorinaz,die-aldor,191,warrior,fury,6,2,4
Omosha,burning-legion,191,warrior,fury,6,2,4
Sakaî,temple-noir,191,warrior,fury,6,2,4
Alvis,nathrezim,191,warrior,fury,6,2,4
Loty,drakthul,175,warrior,fury,11,2,9
Кереешка,howling-fjord,175,warrior,fury,11,2,9
Limejuicer,argent-dawn,169,warrior,fury,12,5,7
Marranu,cthun,159,warrior,fury,5,2,3
Brülldozer,kargath,159,warrior,fury,5,2,3
Vlaax,ravencrest,138,warrior,fury,14,3,11
Æxcoast,ravencrest,128,warrior,fury,4,2,2
Pivcuga,kazzak,128,warrior,fury,4,2,2
Ög,archimonde,96,warrior,fury,3,2,1
Текайко,eversong,96,warrior,fury,3,2,1
Krunchä,ragnaros,96,warrior,fury,3,2,1
Ларджсворд,eversong,96,warrior,fury,11,2,9
Модныйклык,eversong,96,warrior,fury,6,1,5
Kerpi,silvermoon,96,warrior,fury,6,1,5
Riptide,aggra-português,96,warrior,fury,6,1,5
Swordluw,argent-dawn,96,warrior,fury,6,1,5
Greekazi,kazzak,96,warrior,fury,6,1,5
Høxy,outland,96,warrior,fury,6,1,5
Stratic,blackmoore,96,warrior,fury,6,1,5
Dp,area-52,96,warrior,fury,6,1,5
Woghard,drakthul,96,warrior,fury,6,1,5
Спаццифика,soulflayer,96,warrior,fury,6,1,5
Fraeydís,silvermoon,96,warrior,fury,6,1,5
Kronstris,veklor,96,warrior,fury,6,1,5
Marícan,blackmoore,96,warrior,fury,6,1,5
Mot,terenas,96,warrior,fury,6,1,5
Azrail,xavius,96,warrior,fury,6,1,5
Malebolia,mugthol,96,warrior,fury,6,1,5
Sagethi,blackrock,96,warrior,fury,6,1,5
Misiaczek,the-maelstrom,96,warrior,fury,6,1,5
Znorro,trollbane,96,warrior,fury,6,1,5
Stromzy,silvermoon,96,warrior,fury,6,1,5
Анстасмэш,soulflayer,96,warrior,fury,6,1,5
Feltias,drakthul,96,warrior,fury,6,1,5
Фиббоначи,deathguard,96,warrior,fury,6,1,5
Oxandrolona,argent-dawn,96,warrior,fury,6,1,5
Армапипец,soulflayer,96,warrior,fury,6,1,5
Bladewound,draenor,96,warrior,fury,6,1,5
Skîêl,archimonde,96,warrior,fury,6,1,5
Furyfame,darksorrow,96,warrior,fury,6,1,5
Spacemachine,kazzak,96,warrior,fury,6,1,5
Киссмиплис,gordunni,96,warrior,fury,6,1,5
Karreg,hyjal,96,warrior,fury,6,1,5
Moldamis,blackhand,96,warrior,fury,6,1,5
Coldstory,draenor,96,warrior,fury,6,1,5
Kaij,draenor,96,warrior,fury,6,1,5
Дуухаст,gordunni,96,warrior,fury,6,1,5
Rammaxx,tarren-mill,96,warrior,fury,6,1,5
Xenowarr,tarren-mill,96,warrior,fury,6,1,5
Narkzsthki,kazzak,96,warrior,fury,6,1,5
Callipsa,argent-dawn,96,warrior,fury,6,1,5
Grimmrock,gorgonnash,96,warrior,fury,6,1,5
Raakalainen,vashj,96,warrior,fury,6,1,5
Wardruine,dun-modr,96,warrior,fury,6,1,5
Gameera,aerie-peak,96,warrior,fury,6,1,5
Bokth,archimonde,96,warrior,fury,6,1,5
Hordox,archimonde,96,warrior,fury,6,1,5
Xirár,sylvanas,96,warrior,fury,6,1,5
Utharis,stormscale,96,warrior,fury,6,1,5
Денеур,gordunni,96,warrior,fury,6,1,5
Рагкар,gordunni,96,warrior,fury,6,1,5
Wanzzeur,hyjal,96,warrior,fury,6,1,5
Sorkk,kazzak,96,warrior,fury,6,1,5
Elesharde,sanguino,96,warrior,fury,6,1,5
Ðý,silvermoon,96,warrior,fury,6,1,5
Wiliamwalace,zuljin,96,warrior,fury,6,1,5
Rawne,kirin-tor,96,warrior,fury,6,1,5
Batourga,marécage-de-zangar,96,warrior,fury,6,1,5
Savedsky,zuljin,96,warrior,fury,6,1,5
Hammerfall,uldum,96,warrior,fury,6,1,5
Jessepinkman,kirin-tor,96,warrior,fury,6,1,5
Corpsecount,stormrage,96,warrior,fury,6,1,5
Wifioffline,silvermoon,96,warrior,fury,6,1,5
Raixxon,ragnaros,96,warrior,fury,6,1,5
Quandaledngl,silvermoon,96,warrior,fury,12,1,11
Анури,eversong,96,warrior,fury,12,1,11
Hágríd,ragnaros,96,warrior,fury,12,1,11
Zarolk,rashgarroth,96,warrior,fury,12,1,11
Kaodes,outland,96,warrior,fury,17,1,16
Bladewolf,khadgar,95,warrior,fury,12,1,11
Krachz,draenor,63,warrior,fury,2,2,0
Elkatar,stormscale,46,warrior,fury,23,6,17
Hurlcroc,silvermoon,41,warrior,fury,9,2,7
Vivrya,silvermoon,31,warrior,fury,2,1,1
Olriksen,dentarg,31,warrior,fury,2,1,1
Dreyker,sanguino,31,warrior,fury,2,1,1
Kiljhimari,twisting-nether,31,warrior,fury,2,1,1
Giltiné,runetotem,16,warrior,fury,1,1,0
Marcus,ravencrest,2254,warrior,arms,150,79,71
Réckx,twisting-nether,2233,warrior,arms,93,52,41
Dõxqt,kazzak,2204,warrior,arms,86,49,37
Scardrex,defias-brotherhood,2172,warrior,arms,94,49,45
Sickjackenn,executus,2166,warrior,arms,111,58,53
Midgetdamis,blackhand,2147,warrior,arms,137,87,50
Gewyon,ragnaros,2137,warrior,arms,66,40,26
Blîxtgordon,tarren-mill,2133,warrior,arms,78,42,36
Elwarroo,dun-modr,2125,warrior,arms,166,93,73
Palianytsia,ravencrest,2125,warrior,arms,77,40,37
Sharpen,chamber-of-aspects,2116,warrior,arms,116,60,56
Noragrets,stormscale,2116,warrior,arms,80,41,39
Tpyñåöädxzd,the-maelstrom,2116,warrior,arms,82,42,40
Mastodøntes,hyjal,2115,warrior,arms,91,50,41
Кокдиллак,soulflayer,2113,warrior,arms,160,82,78
Скварх,howling-fjord,2112,warrior,arms,120,74,46
Yorgal,arakarahm,2106,warrior,arms,96,47,49
Grkpwh,silvermoon,2105,warrior,arms,88,48,40
Immørtálx,tarren-mill,2102,warrior,arms,72,38,34
Лёшавор,howling-fjord,2096,warrior,arms,108,55,53
Regnarok,sylvanas,2086,warrior,arms,208,116,92
Savesta,dalaran,2085,warrior,arms,186,96,90
Zugzugcleave,blackrock,2084,warrior,arms,84,48,36
Nikkí,naxxramas,2074,warrior,arms,96,50,46
Thomasman,nerathor,2073,warrior,arms,102,48,54
Gabrijel,draenor,2071,warrior,arms,174,86,88
Ðênnis,ravencrest,2062,warrior,arms,54,31,23
Seifcham,ragnaros,2052,warrior,arms,221,108,113
Zhrey,stormscale,2048,warrior,arms,137,67,70
Dunecrab,tarren-mill,2042,warrior,arms,113,63,50
Оркабал,howling-fjord,2038,warrior,arms,142,77,65
Semmino,nemesis,2030,warrior,arms,72,39,33
Cerry,ravencrest,2016,warrior,arms,123,63,60
Wingüi,dun-modr,2006,warrior,arms,84,40,44
Соджиро,howling-fjord,2004,warrior,arms,72,36,36
Karny,ravencrest,2002,warrior,arms,108,61,47
Quotx,stormscale,2001,warrior,arms,129,61,68
Ässholedamis,blackhand,1999,warrior,arms,60,46,14
Trâshwarriør,blackhand,1998,warrior,arms,62,27,35
Ulrid,draenor,1996,warrior,arms,108,55,53
Joeférnandes,ragnaros,1996,warrior,arms,77,38,39
Wràthfúl,kazzak,1995,warrior,arms,143,74,69
Galeron,kazzak,1992,warrior,arms,90,42,48
Sickjackenx,executus,1990,warrior,arms,150,76,74
Therealman,kazzak,1986,warrior,arms,68,36,32
Вэшикх,soulflayer,1984,warrior,arms,89,48,41
Zak,stormscale,1980,warrior,arms,96,43,53
Emix,arygos,1975,warrior,arms,72,39,33
Wargoth,draenor,1971,warrior,arms,87,51,36
Qtcockxx,stormscale,1969,warrior,arms,66,33,33
Schaufelørc,blackrock,1966,warrior,arms,72,40,32
Kartha,stormscale,1964,warrior,arms,66,34,32
Pürporc,archimonde,1963,warrior,arms,76,40,36
Mitu,sanguino,1959,warrior,arms,239,120,119
Alegral,ravencrest,1958,warrior,arms,265,131,134
Merked,kazzak,1958,warrior,arms,72,34,38
Shilix,twisting-nether,1956,warrior,arms,139,65,74
Pentagramlol,twisting-nether,1955,warrior,arms,64,34,30
Palmexwar,drakthul,1954,warrior,arms,150,76,74
Hasbullá,kazzak,1953,warrior,arms,278,147,131
Purporcc,archimonde,1950,warrior,arms,63,32,31
Bàrbandit,archimonde,1946,warrior,arms,102,52,50
Disarmed,auchindoun,1945,warrior,arms,54,31,23
Schwän,twisting-nether,1943,warrior,arms,60,32,28
Myonmyonmyon,blackmoore,1937,warrior,arms,68,41,27
Markers,twisting-nether,1937,warrior,arms,109,49,60
Manaskhan,tarren-mill,1936,warrior,arms,195,100,95
Джерамин,blackscar,1934,warrior,arms,77,35,42
Dabr,stormscale,1933,warrior,arms,54,29,25
Kwasimodo,blackmoore,1933,warrior,arms,70,30,40
Bigboyx,kazzak,1932,warrior,arms,116,56,60
Velcorn,ravencrest,1931,warrior,arms,54,26,28
Infernion,jaedenar,1930,warrior,arms,48,30,18
Belver,argent-dawn,1929,warrior,arms,38,22,16
Jenkinzz,stormscale,1928,warrior,arms,102,59,43
Thenx,tarren-mill,1926,warrior,arms,159,78,81
Hulksmsh,hyjal,1925,warrior,arms,71,32,39
Kapuchino,twisting-nether,1921,warrior,arms,48,27,21
Ønogal,archimonde,1919,warrior,arms,84,40,44
Комочекгнева,howling-fjord,1912,warrior,arms,139,70,69
Timpey,kazzak,1911,warrior,arms,54,30,24
Sagethi,blackrock,1911,warrior,arms,83,41,42
Whýsøsîleñt,ragnaros,1909,warrior,arms,40,29,11
Theryk,sanguino,1909,warrior,arms,171,80,91
Böggzbunny,tarren-mill,1908,warrior,arms,54,32,22
Ragestarved,ragnaros,1908,warrior,arms,83,40,43
Apacolata,outland,1903,warrior,arms,57,29,28
Длоордпро,soulflayer,1900,warrior,arms,65,29,36
Wasro,norgannon,1897,warrior,arms,106,55,51
Nedåh,blackrock,1896,warrior,arms,90,47,43
Banîsher,drakthul,1896,warrior,arms,140,70,70
Çatàclysmíc,kazzak,1896,warrior,arms,138,69,69
Rhâpsodyw,ravencrest,1895,warrior,arms,82,44,38
Фокатоп,blackscar,1895,warrior,arms,54,28,26
Saurens,twisting-nether,1895,warrior,arms,84,38,46
Julololo,archimonde,1893,warrior,arms,72,40,32
Benzemá,sanguino,1892,warrior,arms,82,50,32
Otp,ravencrest,1890,warrior,arms,108,54,54
Courageous,ravencrest,1889,warrior,arms,66,39,27
Tsuperman,tarren-mill,1888,warrior,arms,72,37,35
Notthateasy,blackrock,1887,warrior,arms,42,24,18
Лилиофаныч,soulflayer,1886,warrior,arms,53,29,24
Tozzhug,ragnaros,1885,warrior,arms,54,31,23
Drclapit,blackrock,1884,warrior,arms,42,23,19
Aerês,tarren-mill,1884,warrior,arms,174,89,85
Liptonxecute,blackhand,1883,warrior,arms,59,32,27
Naronnas,drakthul,1883,warrior,arms,140,75,65
Аэска,deathweaver,1881,warrior,arms,66,31,35
Куесэс,howling-fjord,1880,warrior,arms,36,20,16
Compétiteub,archimonde,1879,warrior,arms,84,38,46
Gnømércy,stormscale,1878,warrior,arms,42,22,20
Gulläx,burning-legion,1878,warrior,arms,42,20,22
Флагмэн,gordunni,1876,warrior,arms,89,50,39
Cathériné,drakthul,1875,warrior,arms,48,27,21
Purpórc,archimonde,1875,warrior,arms,54,30,24
Бэнчпресс,soulflayer,1875,warrior,arms,60,29,31
Oswáld,defias-brotherhood,1874,warrior,arms,50,37,13
Downpippuri,silvermoon,1874,warrior,arms,84,58,26
Фрейз,blackscar,1874,warrior,arms,70,34,36
Mckinseybcg,outland,1873,warrior,arms,107,67,40
Doomqt,terokkar,1873,warrior,arms,47,27,20
Hellguard,archimonde,1872,warrior,arms,84,47,37
Endagon,ravencrest,1871,warrior,arms,103,49,54
Nukerz,kirin-tor,1870,warrior,arms,72,39,33
Хиро,deathweaver,1870,warrior,arms,72,37,35
Nipes,nozdormu,1870,warrior,arms,78,38,40
Regnarøk,sylvanas,1869,warrior,arms,71,44,27
Daredevìl,eredar,1869,warrior,arms,107,53,54
Gguts,archimonde,1867,warrior,arms,97,53,44
Zhoti,outland,1866,warrior,arms,64,33,31
Xvlanter,silvermoon,1865,warrior,arms,127,65,62
Mercey,stormscale,1865,warrior,arms,47,24,23
Stupidz,hyjal,1865,warrior,arms,54,26,28
Рвбстох,blackscar,1864,warrior,arms,72,38,34
Irherklek,stormscale,1863,warrior,arms,47,28,19
Екзобайт,gordunni,1862,warrior,arms,95,52,43
Xåb,dun-morogh,1862,warrior,arms,66,28,38
Брокскрим,soulflayer,1861,warrior,arms,60,30,30
Summerkarma,wildhammer,1860,warrior,arms,132,68,64
Lostday,blackrock,1858,warrior,arms,174,87,87
Sekwar,twisting-nether,1858,warrior,arms,42,21,21
Grimogør,stormscale,1857,warrior,arms,48,27,21
Pivcuga,kazzak,1857,warrior,arms,307,155,152
Europ,silvermoon,1857,warrior,arms,162,78,84
Mirageous,tarren-mill,1854,warrior,arms,83,46,37
Mômsboy,tarren-mill,1853,warrior,arms,64,33,31
Ланро,gordunni,1853,warrior,arms,65,33,32
Prymebeevz,blackmoore,1852,warrior,arms,53,36,17
Àlexander,ravencrest,1852,warrior,arms,35,20,15
Reacôn,twisting-nether,1851,warrior,arms,52,28,24
Balthew,defias-brotherhood,1851,warrior,arms,48,24,24
Skorm,mugthol,1849,warrior,arms,36,27,9
Reckqtw,eredar,1849,warrior,arms,92,50,42
Xxeqtr,kazzak,1849,warrior,arms,95,45,50
Аоетакси,soulflayer,1848,warrior,arms,104,59,45
Valoo,malganis,1847,warrior,arms,92,47,45
Krônm,dun-modr,1847,warrior,arms,78,33,45
Connorzw,blackmoore,1846,warrior,arms,42,25,17
Nihe,stormreaver,1846,warrior,arms,66,30,36
Goatie,frostwhisper,1844,warrior,arms,42,30,12
Kaieh,argent-dawn,1844,warrior,arms,48,31,17
Messermozart,blackmoore,1844,warrior,arms,48,25,23
Civok,kult-der-verdammten,1844,warrior,arms,66,31,35
Jessicaday,archimonde,1843,warrior,arms,42,21,21
Крипочёк,gordunni,1842,warrior,arms,42,25,17
Istyos,hyjal,1842,warrior,arms,89,44,45
Zéox,baelgun,1840,warrior,arms,53,30,23
Jriddyzug,ravencrest,1840,warrior,arms,62,33,29
Enøt,kazzak,1839,warrior,arms,53,25,28
Xiro,hellscream,1838,warrior,arms,70,45,25
Орданис,deathguard,1838,warrior,arms,66,33,33
Демолишеер,howling-fjord,1838,warrior,arms,77,37,40
Hitt,ysondre,1838,warrior,arms,102,49,53
Rhagnok,archimonde,1838,warrior,arms,84,39,45
Dominikhasek,stormscale,1837,warrior,arms,52,33,19
Sneakydrm,kazzak,1837,warrior,arms,40,23,17
Eidzo,tarren-mill,1837,warrior,arms,84,45,39
Kanté,burning-blade,1834,warrior,arms,41,24,17
Æriø,dalaran,1833,warrior,arms,48,27,21
Purporcfr,archimonde,1833,warrior,arms,64,32,32
Karpzug,stormscale,1832,warrior,arms,39,22,17
Pawnerlol,mannoroth,1832,warrior,arms,59,28,31
Trapoulas,kazzak,1832,warrior,arms,107,48,59
Blåvingad,kazzak,1831,warrior,arms,56,34,22
Боссберс,soulflayer,1831,warrior,arms,89,44,45
Watrux,outland,1831,warrior,arms,66,31,35
Воинлета,howling-fjord,1830,warrior,arms,101,60,41
Brogre,stormrage,1830,warrior,arms,77,40,37
Qapper,kazzak,1830,warrior,arms,57,28,29
Khÿze,ysondre,1829,warrior,arms,58,39,19
Mirpz,doomhammer,1829,warrior,arms,48,31,17
Klearr,silvermoon,1829,warrior,arms,91,56,35
Läerezh,ysondre,1829,warrior,arms,54,32,22
Вуриор,howling-fjord,1829,warrior,arms,114,64,50
Nelios,sylvanas,1829,warrior,arms,60,33,27
Njn,argent-dawn,1829,warrior,arms,48,23,25
Kamked,burning-legion,1828,warrior,arms,107,50,57
Nightmareowl,tarren-mill,1827,warrior,arms,136,76,60
Blazefüry,ravencrest,1827,warrior,arms,61,33,28
Rînus,aegwynn,1827,warrior,arms,54,26,28
Wuifly,dun-modr,1826,warrior,arms,69,35,34
Варбоссец,soulflayer,1825,warrior,arms,66,35,31
Nurekin,argent-dawn,1825,warrior,arms,66,32,34
Javakt,stormscale,1825,warrior,arms,218,103,115
Rivah,tarren-mill,1824,warrior,arms,63,34,29
Crawly,aegwynn,1824,warrior,arms,177,95,82
Reysleys,mazrigos,1823,warrior,arms,69,32,37
Ðior,bronze-dragonflight,1822,warrior,arms,53,29,24
Марльин,howling-fjord,1822,warrior,arms,59,29,30
Crîxús,silvermoon,1822,warrior,arms,60,25,35
Seifchamqt,ragnaros,1821,warrior,arms,52,31,21
Escapematrix,kazzak,1821,warrior,arms,95,48,47
Asçrðth,kazzak,1821,warrior,arms,54,26,28
Dortenz,ragnaros,1821,warrior,arms,54,24,30
Куртфорренс,gordunni,1821,warrior,arms,79,31,48
Urmack,ravencrest,1820,warrior,arms,48,37,11
Rngmonster,kazzak,1820,warrior,arms,100,68,32
Uzamaki,bronzebeard,1820,warrior,arms,48,32,16
Knutrex,tarren-mill,1820,warrior,arms,61,35,26
Drahkor,baelgun,1819,warrior,arms,60,39,21
Лимпс,gordunni,1819,warrior,arms,30,19,11
Flinta,blackmoore,1819,warrior,arms,90,51,39
Maarshl,ysondre,1819,warrior,arms,225,121,104
Pürporcc,archimonde,1818,warrior,arms,97,48,49
Hunkz,sylvanas,1818,warrior,arms,65,32,33
Имеравета,gordunni,1818,warrior,arms,150,71,79
Мелькорт,gordunni,1817,warrior,arms,48,29,19
Chaddimus,draenor,1817,warrior,arms,63,36,27
Поршекаен,howling-fjord,1817,warrior,arms,101,50,51
Liferuiner,rexxar,1816,warrior,arms,133,73,60
Kiyomaro,stormscale,1816,warrior,arms,66,36,30
Экзекьютлол,soulflayer,1816,warrior,arms,47,25,22
Joéfernandés,sylvanas,1816,warrior,arms,36,19,17
Klonyarik,ravencrest,1815,warrior,arms,36,19,17
Шурпач,deathguard,1815,warrior,arms,72,37,35
Dnoire,ravencrest,1815,warrior,arms,60,28,32
Nelthôr,alleria,1814,warrior,arms,156,94,62
Aeyon,burning-blade,1814,warrior,arms,45,27,18
Thorana,twisting-nether,1814,warrior,arms,59,32,27
Naskez,kazzak,1814,warrior,arms,81,41,40
Darshan,grim-batol,1814,warrior,arms,66,33,33
Leethal,outland,1814,warrior,arms,60,27,33
Juank,minahonda,1814,warrior,arms,48,21,27
Арма,howling-fjord,1813,warrior,arms,54,39,15
Doloresvp,zuljin,1813,warrior,arms,66,36,30
Mtc,blackrock,1813,warrior,arms,68,34,34
Pummelthru,burning-legion,1813,warrior,arms,65,32,33
Vic,tarren-mill,1813,warrior,arms,47,20,27
Zcell,kazzak,1812,warrior,arms,36,23,13
Xurainzone,eredar,1812,warrior,arms,48,27,21
Mystylez,silvermoon,1812,warrior,arms,60,28,32
Gucciwarrior,blackhand,1812,warrior,arms,90,41,49
Vvulf,eredar,1812,warrior,arms,60,25,35
Axinit,blackrock,1811,warrior,arms,42,23,19
Стефанидзе,soulflayer,1811,warrior,arms,42,22,20
Ozrenac,kazzak,1811,warrior,arms,196,100,96
Idiotplay,drekthar,1811,warrior,arms,42,19,23
Johnmeadows,ravencrest,1810,warrior,arms,36,23,13
Artøria,archimonde,1810,warrior,arms,96,54,42
Ðiscordia,blackhand,1810,warrior,arms,84,43,41
Оксенфурт,soulflayer,1810,warrior,arms,140,70,70
Kragrâu,kazzak,1810,warrior,arms,71,33,38
Jínro,draenor,1810,warrior,arms,48,22,26
Jokkul,tarren-mill,1810,warrior,arms,46,21,25
Cherserker,ragnaros,1809,warrior,arms,69,41,28
Yarilolx,outland,1808,warrior,arms,49,28,21
Drilley,blackmoore,1807,warrior,arms,50,34,16
Oldchap,nordrassil,1807,warrior,arms,48,31,17
Олдборовс,soulflayer,1807,warrior,arms,53,29,24
Zeddone,drakthul,1807,warrior,arms,90,46,44
Bloodhorn,blackhand,1807,warrior,arms,107,54,53
Варзила,blackscar,1807,warrior,arms,53,22,31
Nìmera,nemesis,1806,warrior,arms,36,26,10
Yelanx,twisting-nether,1806,warrior,arms,48,34,14
Ðennis,argent-dawn,1806,warrior,arms,48,33,15
Juggernãut,ravencrest,1806,warrior,arms,102,58,44
Гатсберсерк,gordunni,1806,warrior,arms,167,91,76
Wayneson,tarren-mill,1806,warrior,arms,108,58,50
Книфэк,howling-fjord,1806,warrior,arms,76,40,36
Brutilda,antonidas,1806,warrior,arms,53,25,28
Дуглимон,gordunni,1805,warrior,arms,65,37,28
Toscothegoat,ravencrest,1804,warrior,arms,36,24,12
Greenblób,kazzak,1804,warrior,arms,66,27,39
Hanìbal,ravencrest,1803,warrior,arms,60,32,28
Gigadot,arathor,1803,warrior,arms,186,97,89
Nazrihk,ravencrest,1803,warrior,arms,49,25,24
Ghakra,kazzak,1802,warrior,arms,36,25,11
Westwyde,hyjal,1802,warrior,arms,48,30,18
Drittsekken,sylvanas,1802,warrior,arms,105,60,45
Thyréc,blackmoore,1802,warrior,arms,60,34,26
Fràgile,ravencrest,1802,warrior,arms,113,61,52
Мопк,howling-fjord,1801,warrior,arms,84,48,36
Элетий,soulflayer,1801,warrior,arms,36,19,17
Shortcvnt,ravencrest,1800,warrior,arms,48,28,20
Phalek,argent-dawn,1800,warrior,arms,48,28,20
Azudaddy,blackmoore,1800,warrior,arms,59,34,25
Dairøx,blackrock,1800,warrior,arms,60,31,29
Ástriax,ravencrest,1799,warrior,arms,159,77,82
Cerßere,archimonde,1798,warrior,arms,120,61,59
Беренса,howling-fjord,1796,warrior,arms,107,63,44
Kamatâ,kazzak,1796,warrior,arms,60,32,28
Nitheriá,draenor,1796,warrior,arms,355,180,175
Хэйре,howling-fjord,1795,warrior,arms,172,88,84
Злопиканка,gordunni,1794,warrior,arms,58,29,29
Стилерин,gordunni,1794,warrior,arms,48,22,26
Заликмортал,soulflayer,1793,warrior,arms,186,100,86
Blademir,aegwynn,1793,warrior,arms,70,31,39
Atrôcithy,silvermoon,1791,warrior,arms,48,25,23
Perinel,draenor,1789,warrior,arms,147,80,67
Kënnyföx,ysondre,1789,warrior,arms,36,19,17
Røidrage,stormscale,1789,warrior,arms,96,45,51
Nímera,nemesis,1788,warrior,arms,36,19,17
Фрейз,deathweaver,1785,warrior,arms,48,29,19
Zheaks,kazzak,1785,warrior,arms,95,45,50
Древилгод,gordunni,1783,warrior,arms,57,31,26
Kennyföx,ysondre,1782,warrior,arms,38,24,14
Khalimov,tarren-mill,1781,warrior,arms,102,52,50
Бодибилдерыч,gordunni,1779,warrior,arms,113,60,53
Selenez,outland,1779,warrior,arms,67,30,37
Venres,blackhand,1777,warrior,arms,88,47,41
Damagz,tarren-mill,1776,warrior,arms,89,44,45
Shookyx,ravencrest,1775,warrior,arms,42,24,18
Троммтар,howling-fjord,1774,warrior,arms,100,44,56
Raley,ragnaros,1773,warrior,arms,166,93,73
Zombossio,tarren-mill,1773,warrior,arms,74,38,36
Dõxlol,kazzak,1771,warrior,arms,36,20,16
Jackyred,silvermoon,1771,warrior,arms,71,31,40
Drxeqtit,blackrock,1770,warrior,arms,53,29,24
Kurbá,stormscale,1768,warrior,arms,42,26,16
Ändrow,dalaran,1768,warrior,arms,54,33,21
Lyriae,argent-dawn,1768,warrior,arms,66,39,27
Jengaa,draenor,1768,warrior,arms,126,65,61
Prøject,archimonde,1768,warrior,arms,54,27,27
Bravopla,silvermoon,1767,warrior,arms,54,28,26
Komissarecks,aegwynn,1767,warrior,arms,63,31,32
Pangowar,elune,1766,warrior,arms,69,38,31
Ехрерау,gordunni,1765,warrior,arms,66,27,39
Loty,drakthul,1764,warrior,arms,113,49,64
Craanked,aegwynn,1763,warrior,arms,58,25,33
Chucho,argent-dawn,1761,warrior,arms,48,26,22
Kûrûmî,blackmoore,1760,warrior,arms,55,36,19
Wardruine,dun-modr,1760,warrior,arms,179,90,89
Saidi,outland,1760,warrior,arms,174,80,94
Okcool,twisting-nether,1757,warrior,arms,42,26,16
Downpipe,twisting-nether,1757,warrior,arms,125,62,63
Nassir,stormscale,1756,warrior,arms,96,47,49
Grimlok,sylvanas,1756,warrior,arms,99,44,55
Konebankærn,ravencrest,1756,warrior,arms,60,24,36
Allthèwayup,kazzak,1755,warrior,arms,35,19,16
Nonow,silvermoon,1755,warrior,arms,48,24,24
Yellowjuice,stormscale,1754,warrior,arms,144,85,59
Warounet,hyjal,1753,warrior,arms,54,26,28
Cleaver,tarren-mill,1752,warrior,arms,54,29,25
Asenine,sylvanas,1752,warrior,arms,391,195,196
Pathocend,kazzak,1752,warrior,arms,59,29,30
Ущипнузатитю,deathguard,1752,warrior,arms,66,29,37
Yosiwa,draenor,1751,warrior,arms,78,45,33
Хенеар,howling-fjord,1751,warrior,arms,62,30,32
Trôth,kazzak,1750,warrior,arms,36,23,13
Skylåw,archimonde,1750,warrior,arms,109,52,57
Pj,sanguino,1750,warrior,arms,68,30,38
Роули,blackscar,1747,warrior,arms,81,46,35
Everdipper,outland,1742,warrior,arms,70,31,39
Lanstus,silvermoon,1740,warrior,arms,102,54,48
Blademir,blackrock,1739,warrior,arms,41,26,15
Mojotsche,taerar,1738,warrior,arms,64,36,28
Hulkensmash,kazzak,1738,warrior,arms,175,87,88
Cesr,bloodhoof,1738,warrior,arms,106,47,59
Klynd,nemesis,1738,warrior,arms,54,22,32
Cisataker,hyjal,1737,warrior,arms,24,20,4
Rageco,ravencrest,1737,warrior,arms,48,31,17
Raidek,dragonmaw,1737,warrior,arms,82,46,36
Ðezia,tarren-mill,1737,warrior,arms,144,79,65
Даскул,gordunni,1737,warrior,arms,66,28,38
Augustus,runetotem,1736,warrior,arms,138,76,62
Chargeyou,ragnaros,1734,warrior,arms,48,28,20
Dragondeznut,ravencrest,1734,warrior,arms,54,26,28
Oktharu,silvermoon,1734,warrior,arms,48,23,25
Wrecktal,eredar,1733,warrior,arms,54,32,22
Pazùzu,twisting-nether,1733,warrior,arms,60,27,33
Bôlufonâ,dun-modr,1732,warrior,arms,101,52,49
ßloodz,hyjal,1732,warrior,arms,102,51,51
Bigboomer,frostmane,1732,warrior,arms,192,86,106
Wake,eredar,1731,warrior,arms,42,23,19
Magnî,auchindoun,1731,warrior,arms,54,29,25
Døkidøki,silvermoon,1731,warrior,arms,80,40,40
Fruiittyy,ravencrest,1730,warrior,arms,114,58,56
Ezøn,aegwynn,1730,warrior,arms,65,32,33
Маклецкий,gordunni,1730,warrior,arms,150,68,82
Kelhim,blackrock,1728,warrior,arms,108,57,51
Reccey,blackrock,1728,warrior,arms,140,69,71
Thafold,eredar,1727,warrior,arms,36,19,17
Vathaleron,alakir,1727,warrior,arms,63,33,30
Zhangbeihai,ravencrest,1726,warrior,arms,132,65,67
Oluwafunmila,tarren-mill,1726,warrior,arms,68,33,35
Штурмгешутц,deathweaver,1723,warrior,arms,138,76,62
Brunodressed,aegwynn,1723,warrior,arms,60,31,29
Fosler,frostmane,1723,warrior,arms,48,22,26
Oplarxigos,kazzak,1723,warrior,arms,48,20,28
Dannyp,twisting-nether,1722,warrior,arms,36,18,18
Shchoor,ravencrest,1722,warrior,arms,36,18,18
Bigdamtosco,ravencrest,1721,warrior,arms,30,18,12
Rexonawarr,kazzak,1720,warrior,arms,30,18,12
Naskwar,archimonde,1720,warrior,arms,48,24,24
Skädy,dun-modr,1720,warrior,arms,60,29,31
Fantasý,burning-legion,1720,warrior,arms,71,28,43
Bordi,nemesis,1719,warrior,arms,235,110,125
Mortalfist,stormscale,1718,warrior,arms,67,33,34
Urasli,doomhammer,1717,warrior,arms,42,24,18
Getsmokedjr,ravencrest,1717,warrior,arms,44,22,22
Барсток,soulflayer,1716,warrior,arms,107,53,54
Криккс,greymane,1714,warrior,arms,45,25,20
Виттурус,howling-fjord,1714,warrior,arms,48,25,23
Apacho,outland,1714,warrior,arms,42,21,21
Malebolia,mugthol,1713,warrior,arms,247,128,119
Cazaril,kazzak,1712,warrior,arms,166,84,82
Ogurok,frostwolf,1712,warrior,arms,63,29,34
Badgenius,nemesis,1711,warrior,arms,24,18,6
Maldark,scarshield-legion,1711,warrior,arms,141,68,73
Quetrax,chogall,1711,warrior,arms,60,22,38
Dógmòdex,stormscale,1710,warrior,arms,48,30,18
Mertik,twisting-nether,1710,warrior,arms,48,28,20
Mintys,sylvanas,1710,warrior,arms,62,33,29
Fulgrimu,archimonde,1710,warrior,arms,45,23,22
Brizeis,malganis,1710,warrior,arms,145,74,71
Palmsweaty,stormrage,1710,warrior,arms,72,31,41
Karuck,tarren-mill,1709,warrior,arms,30,19,11
Raikaz,ravencrest,1709,warrior,arms,72,32,40
Фктпх,blackscar,1708,warrior,arms,48,29,19
Karkatoes,twisting-nether,1708,warrior,arms,50,26,24
Saetásh,argent-dawn,1708,warrior,arms,72,34,38
Ðöç,argent-dawn,1708,warrior,arms,42,18,24
Anthalar,argent-dawn,1707,warrior,arms,108,53,55
Avalinqt,blackrock,1706,warrior,arms,44,32,12
Goorila,kazzak,1706,warrior,arms,36,18,18
Кхаррнн,gordunni,1705,warrior,arms,99,49,50
Креспекс,soulflayer,1705,warrior,arms,91,36,55
Poolboyx,tarren-mill,1704,warrior,arms,123,63,60
Вандэрбой,howling-fjord,1703,warrior,arms,222,103,119
Feckdech,blackrock,1702,warrior,arms,36,22,14
Thebigshow,the-maelstrom,1702,warrior,arms,94,41,53
Corvy,ravencrest,1702,warrior,arms,42,18,24
Киссмиплис,gordunni,1701,warrior,arms,117,61,56
Туранк,howling-fjord,1701,warrior,arms,181,93,88
Хеликат,soulflayer,1701,warrior,arms,60,27,33
Louana,outland,1700,warrior,arms,24,18,6
Robou,hyjal,1700,warrior,arms,186,86,100
Klonyarika,ravencrest,1699,warrior,arms,36,20,16
Гримг,lich-king,1699,warrior,arms,69,37,32
Oldcockball,argent-dawn,1699,warrior,arms,89,47,42
Aemox,silvermoon,1697,warrior,arms,77,43,34
Luphrek,ysondre,1697,warrior,arms,36,20,16
Nerfmyrage,hyjal,1697,warrior,arms,96,49,47
Ахиллслэм,howling-fjord,1697,warrior,arms,83,35,48
Lexiliuz,twisting-nether,1696,warrior,arms,36,22,14
Incendix,stormscale,1696,warrior,arms,99,56,43
Shiqo,ravencrest,1696,warrior,arms,109,54,55
Ijzerekast,sylvanas,1696,warrior,arms,67,31,36
Veav,norgannon,1696,warrior,arms,60,25,35
Shaked,dun-modr,1696,warrior,arms,47,19,28
Трешконтент,gordunni,1695,warrior,arms,102,54,48
Sepuko,stormscale,1695,warrior,arms,78,41,37
Reìvah,silvermoon,1695,warrior,arms,63,32,31
Secondwarri,frostwolf,1694,warrior,arms,66,37,29
Sorkk,kazzak,1694,warrior,arms,86,47,39
Noxeeql,tarren-mill,1693,warrior,arms,113,67,46
Kalacher,draenor,1693,warrior,arms,68,30,38
Donquiexote,ravencrest,1692,warrior,arms,90,49,41
Брок,soulflayer,1692,warrior,arms,96,39,57
Snðw,outland,1692,warrior,arms,73,29,44
Odenscolddry,kazzak,1691,warrior,arms,173,87,86
Дайбайхенд,howling-fjord,1691,warrior,arms,60,30,30
Zexa,tarren-mill,1690,warrior,arms,42,21,21
Mazaharine,archimonde,1690,warrior,arms,69,33,36
Vayné,ravencrest,1690,warrior,arms,78,35,43
Randomdmg,stormscale,1689,warrior,arms,24,18,6
Slowann,argent-dawn,1689,warrior,arms,102,51,51
Cassândrä,dalaran,1689,warrior,arms,66,28,38
Hangart,argent-dawn,1687,warrior,arms,48,20,28
Preliator,outland,1686,warrior,arms,24,18,6
Вокилог,soulflayer,1686,warrior,arms,559,276,283
Æç,argent-dawn,1686,warrior,arms,72,35,37
Spártacus,kazzak,1686,warrior,arms,88,40,48
Xgs,archimonde,1685,warrior,arms,279,142,137
Rolo,antonidas,1684,warrior,arms,69,35,34
Makgorei,outland,1684,warrior,arms,129,64,65
Nozuki,archimonde,1684,warrior,arms,243,120,123
Азктор,soulflayer,1683,warrior,arms,34,19,15
Nargez,outland,1682,warrior,arms,36,22,14
Rbbx,tarren-mill,1682,warrior,arms,44,24,20
Huyer,stormscale,1682,warrior,arms,36,18,18
Shooky,blackrock,1681,warrior,arms,41,22,19
Tyrasîà,hyjal,1680,warrior,arms,54,24,30
Kronmw,dun-modr,1680,warrior,arms,54,20,34
Blackbiird,blackmoore,1679,warrior,arms,53,27,26
Zoefernandes,kazzak,1679,warrior,arms,66,28,38
Ридиусх,gordunni,1678,warrior,arms,43,24,19
Воованыч,gordunni,1678,warrior,arms,48,22,26
Bronn,defias-brotherhood,1676,warrior,arms,51,31,20
Сажень,blackscar,1675,warrior,arms,74,34,40
Krigipigi,antonidas,1675,warrior,arms,78,34,44
Yandan,ysondre,1674,warrior,arms,48,24,24
Planina,ravencrest,1673,warrior,arms,77,38,39
Woobaby,outland,1672,warrior,arms,54,30,24
Gatts,krasus,1671,warrior,arms,282,134,148
Amokdamis,blackhand,1671,warrior,arms,51,23,28
Nîmera,nemesis,1670,warrior,arms,24,19,5
Бисовыйармен,soulflayer,1670,warrior,arms,42,23,19
Lîlsaint,dun-morogh,1670,warrior,arms,36,19,17
Chromoly,aegwynn,1670,warrior,arms,90,43,47
Лилиофанныч,soulflayer,1670,warrior,arms,66,25,41
Dríx,hyjal,1669,warrior,arms,66,34,32
Riyan,lothar,1668,warrior,arms,48,28,20
Shhimbanned,doomhammer,1668,warrior,arms,85,43,42
Nikoma,silvermoon,1667,warrior,arms,36,20,16
Дугмар,gordunni,1667,warrior,arms,205,102,103
Bruxus,blackhand,1665,warrior,arms,208,108,100
Геркавоин,eversong,1665,warrior,arms,96,45,51
Krionos,ravencrest,1665,warrior,arms,66,30,36
Иктиннос,gordunni,1664,warrior,arms,78,41,37
Cyruk,blackmoore,1664,warrior,arms,147,75,72
Ignyz,stormscale,1663,warrior,arms,48,27,21
Learningwarr,eredar,1663,warrior,arms,50,26,24
Màkáveli,stormscale,1662,warrior,arms,83,46,37
Kotechnik,ysondre,1661,warrior,arms,42,25,17
Bronix,blackrock,1661,warrior,arms,100,52,48
Дроктул,howling-fjord,1661,warrior,arms,340,169,171
Arms,earthen-ring,1661,warrior,arms,86,41,45
Jaythegodx,blackrock,1661,warrior,arms,60,22,38
Reapersrage,twisting-nether,1660,warrior,arms,45,22,23
Huscar,thrall,1659,warrior,arms,58,31,27
Erikeverhard,nathrezim,1659,warrior,arms,42,20,22
Xendyo,frostmourne,1659,warrior,arms,125,58,67
Velgrim,ravencrest,1659,warrior,arms,54,25,29
Nalx,tarren-mill,1658,warrior,arms,87,47,40
Bastrick,argent-dawn,1658,warrior,arms,116,62,54
Zugstorm,outland,1658,warrior,arms,46,23,23
Cyanerd,bronzebeard,1658,warrior,arms,42,21,21
Béastmødexz,eredar,1657,warrior,arms,53,25,28
Кибервайфу,howling-fjord,1656,warrior,arms,36,22,14
Crandalius,kazzak,1656,warrior,arms,87,51,36
Mazutov,outland,1655,warrior,arms,36,25,11
Wasdwarr,aegwynn,1655,warrior,arms,50,31,19
Asquare,stormscale,1655,warrior,arms,40,18,22
Луновоин,gordunni,1654,warrior,arms,54,35,19
Facestomper,onyxia,1654,warrior,arms,78,44,34
Шагах,soulflayer,1654,warrior,arms,164,81,83
Skillissues,argent-dawn,1653,warrior,arms,48,26,22
Vôx,sylvanas,1653,warrior,arms,120,55,65
Dragnil,twisting-nether,1653,warrior,arms,48,22,26
Romanul,terokkar,1652,warrior,arms,114,61,53
Зотлолпромвп,booty-bay,1652,warrior,arms,47,21,26
Prestà,archimonde,1651,warrior,arms,75,41,34
Linkx,lightnings-blade,1651,warrior,arms,36,19,17
Донтрелиз,howling-fjord,1651,warrior,arms,64,30,34
Chádtóurps,drakthul,1651,warrior,arms,41,19,22
Rhinobob,kazzak,1651,warrior,arms,50,22,28
Anakhas,archimonde,1651,warrior,arms,48,21,27
Hli,tarren-mill,1650,warrior,arms,42,24,18
Skrawarr,das-syndikat,1650,warrior,arms,156,82,74
Sørêy,aegwynn,1650,warrior,arms,78,39,39
Smkms,kazzak,1649,warrior,arms,54,26,28
Asç,kazzak,1647,warrior,arms,42,21,21
Blizo,tarren-mill,1646,warrior,arms,42,21,21
Nardoch,archimonde,1646,warrior,arms,162,80,82
Martins,doomhammer,1644,warrior,arms,50,28,22
Fruitdealer,shattrath,1644,warrior,arms,70,30,40
Morbaac,archimonde,1644,warrior,arms,54,22,32
Нифро,fordragon,1643,warrior,arms,48,29,19
Doksziqqt,ragnaros,1642,warrior,arms,36,22,14
Ckz,ysondre,1641,warrior,arms,36,26,10
Remen,archimonde,1641,warrior,arms,84,37,47
Bîmbämboom,blackmoore,1640,warrior,arms,106,67,39
Diamonddogs,draenor,1640,warrior,arms,52,32,20
Renwíck,burning-legion,1639,warrior,arms,35,18,17
Bamme,archimonde,1639,warrior,arms,47,24,23
Фенилэфрин,gordunni,1639,warrior,arms,140,71,69
Voxz,stormscale,1639,warrior,arms,195,93,102
Paranoiás,ragnaros,1639,warrior,arms,50,22,28
Ironbutter,ravencrest,1638,warrior,arms,80,51,29
Samîr,arthas,1638,warrior,arms,36,21,15
Sonnethrash,tarren-mill,1638,warrior,arms,49,22,27
Витодпс,howling-fjord,1638,warrior,arms,54,24,30
Sefty,tarren-mill,1638,warrior,arms,46,18,28
Pachipachi,blackmoore,1637,warrior,arms,44,23,21
Babovic,aegwynn,1636,warrior,arms,42,29,13
Lizzybigtits,kazzak,1636,warrior,arms,60,40,20
Jøtawarrior,sanguino,1636,warrior,arms,48,27,21
Blackfrosty,stormscale,1636,warrior,arms,74,41,33
Hatestørm,kazzak,1636,warrior,arms,42,22,20
Garthock,stormscale,1636,warrior,arms,42,20,22
Ítikovan,aegwynn,1636,warrior,arms,156,73,83
Тролльвоен,gordunni,1635,warrior,arms,51,31,20
Sydian,burning-legion,1635,warrior,arms,36,21,15
Ryofu,stormscale,1635,warrior,arms,42,22,20
Омепразол,gordunni,1635,warrior,arms,250,125,125
Килафх,blackscar,1635,warrior,arms,84,41,43
Off,archimonde,1634,warrior,arms,30,18,12
Олдизаер,soulflayer,1634,warrior,arms,42,23,19
Meistersykes,silvermoon,1634,warrior,arms,44,21,23
Fattysw,argent-dawn,1634,warrior,arms,61,29,32
Старварлорд,soulflayer,1634,warrior,arms,41,18,23
Nazhar,kult-der-verdammten,1633,warrior,arms,54,27,27
Lyroe,blackrock,1633,warrior,arms,42,21,21
Capigo,tarren-mill,1632,warrior,arms,30,19,11
Atlizz,twisting-nether,1632,warrior,arms,90,47,43
Psychlolz,burning-legion,1632,warrior,arms,48,24,24
Reapo,blackhand,1632,warrior,arms,137,67,70
Yaune,ravencrest,1632,warrior,arms,42,19,23
Orn,tarren-mill,1632,warrior,arms,54,24,30
Zijsûû,chogall,1632,warrior,arms,55,23,32
Zëhef,hyjal,1631,warrior,arms,108,59,49
Bélløne,dalaran,1631,warrior,arms,96,46,50
Naait,draenor,1630,warrior,arms,51,28,23
Çon,ravencrest,1630,warrior,arms,121,63,58
Acaleus,the-maelstrom,1630,warrior,arms,66,31,35
Aestheticon,burning-blade,1629,warrior,arms,36,21,15
Furanos,blackrock,1629,warrior,arms,65,34,31
Estarotte,ravencrest,1629,warrior,arms,37,19,18
Puremëtal,silvermoon,1629,warrior,arms,54,25,29
Wismerx,kazzak,1629,warrior,arms,48,21,27
Darksídex,silvermoon,1628,warrior,arms,339,176,163
Watashilfy,ravencrest,1628,warrior,arms,72,36,36
Thrux,dalaran,1628,warrior,arms,119,59,60
Кимлий,deathweaver,1628,warrior,arms,36,17,19
Mellîødas,blackmoore,1627,warrior,arms,48,27,21
Gonutz,sylvanas,1627,warrior,arms,36,20,16
Belattor,silvermoon,1627,warrior,arms,36,17,19
Iameconomist,twisting-nether,1627,warrior,arms,36,17,19
Klinga,bladefist,1626,warrior,arms,42,24,18
Trust,darksorrow,1626,warrior,arms,54,30,24
Xzm,stormscale,1626,warrior,arms,33,18,15
Chadsmorc,twisting-nether,1626,warrior,arms,149,78,71
Agoobagoo,alakir,1626,warrior,arms,41,20,21
Ebonheart,argent-dawn,1626,warrior,arms,104,50,54
Rootmagnet,twisting-nether,1625,warrior,arms,30,20,10
Asipositas,eredar,1625,warrior,arms,42,19,23
Beevzyn,blackmoore,1624,warrior,arms,24,17,7
Zufzuf,twisting-nether,1624,warrior,arms,36,22,14
Xiiver,burning-legion,1624,warrior,arms,131,71,60
Wlãð,archimonde,1624,warrior,arms,48,23,25
Frozenliøn,twisting-nether,1624,warrior,arms,42,19,23
Xurainlol,eredar,1623,warrior,arms,30,17,13
Жестокус,gordunni,1623,warrior,arms,42,22,20
Lusan,sylvanas,1623,warrior,arms,42,21,21
Айфилшок,gordunni,1623,warrior,arms,42,20,22
Høtsky,twisting-nether,1622,warrior,arms,30,18,12
Nstx,dun-modr,1622,warrior,arms,30,17,13
Methodxd,outland,1622,warrior,arms,72,36,36
Letmeteachya,kazzak,1622,warrior,arms,72,36,36
Basemode,twisting-nether,1622,warrior,arms,58,29,29
Фурианка,galakrond,1622,warrior,arms,63,31,32
Spartaz,eredar,1622,warrior,arms,66,30,36
Salpaaja,frostwhisper,1622,warrior,arms,42,17,25
Solaje,dun-modr,1621,warrior,arms,39,22,17
Kût,les-sentinelles,1621,warrior,arms,41,22,19
Оргрриммар,soulflayer,1621,warrior,arms,339,169,170
Blayr,tarren-mill,1621,warrior,arms,122,58,64
Wigsplitterx,twisting-nether,1620,warrior,arms,150,70,80
Rumer,tarren-mill,1620,warrior,arms,83,38,45
Takatoa,argent-dawn,1620,warrior,arms,48,21,27
Scherø,aegwynn,1619,warrior,arms,24,17,7
Nyxz,blackhand,1619,warrior,arms,77,39,38
Sickslamzyø,ravencrest,1619,warrior,arms,42,17,25
Mxrdvr,kazzak,1618,warrior,arms,54,35,19
Hasmocaru,silvermoon,1618,warrior,arms,66,33,33
Белхэнд,soulflayer,1618,warrior,arms,169,80,89
Bj,blackrock,1617,warrior,arms,36,21,15
Thundranium,kazzak,1616,warrior,arms,37,22,15
Liper,silvermoon,1616,warrior,arms,103,56,47
Shavoi,die-aldor,1616,warrior,arms,47,21,26
Borthuk,tarren-mill,1616,warrior,arms,107,45,62
Khireebonk,hyjal,1615,warrior,arms,36,24,12
Рекиро,blackscar,1615,warrior,arms,40,21,19
Gladius,ysera,1615,warrior,arms,86,43,43
Manoito,argent-dawn,1615,warrior,arms,48,22,26
Lyarinsky,tyrande,1614,warrior,arms,96,58,38
Daigoro,ravencrest,1614,warrior,arms,30,17,13
Untiltèd,ravencrest,1613,warrior,arms,89,60,29
Extazsion,stormscale,1613,warrior,arms,35,20,15
Фелпир,soulflayer,1613,warrior,arms,179,95,84
Hamez,thunderhorn,1613,warrior,arms,70,34,36
Kwaiha,kazzak,1613,warrior,arms,80,37,43
Vandarms,archimonde,1612,warrior,arms,36,18,18
Maikouyes,archimonde,1612,warrior,arms,125,62,63
Pyrul,antonidas,1612,warrior,arms,42,18,24
Termonsa,stormscale,1611,warrior,arms,42,25,17
Ïnahö,hyjal,1611,warrior,arms,36,19,17
Surthur,magtheridon,1611,warrior,arms,48,24,24
Lockmagewar,burning-legion,1611,warrior,arms,45,22,23
Cráft,silvermoon,1611,warrior,arms,48,23,25
Куэсес,howling-fjord,1610,warrior,arms,39,19,20
Strife,ravencrest,1609,warrior,arms,81,51,30
Ranoth,hellfire,1609,warrior,arms,30,17,13
Enzja,nazjatar,1609,warrior,arms,54,25,29
Biscuitoliva,hyjal,1608,warrior,arms,31,17,14
Whoosah,ragnaros,1608,warrior,arms,105,54,51
Guts,frostwhisper,1608,warrior,arms,173,83,90
Caméltoe,frostwolf,1608,warrior,arms,143,67,76
Sjozug,tarren-mill,1608,warrior,arms,42,17,25
Кофесмолоком,ashenvale,1608,warrior,arms,53,20,33
Diz,terokkar,1607,warrior,arms,103,64,39
Únkqt,dalaran,1607,warrior,arms,63,35,28
Bursch,ravencrest,1607,warrior,arms,137,69,68
Хоркан,blackscar,1607,warrior,arms,60,30,30
Jambaz,ravencrest,1607,warrior,arms,47,23,24
Krew,drakthul,1607,warrior,arms,78,38,40
Bigdstance,outland,1607,warrior,arms,72,33,39
Убитаякорова,soulflayer,1606,warrior,arms,36,20,16
Oppressíon,silvermoon,1606,warrior,arms,46,22,24
Golmmash,draenor,1606,warrior,arms,64,25,39
Orcassmus,blackrock,1605,warrior,arms,36,23,13
Nameless,ysondre,1605,warrior,arms,72,41,31
Unbrauchbar,silvermoon,1605,warrior,arms,94,53,41
Напутанность,soulflayer,1605,warrior,arms,371,194,177
Haraldjuhnke,frostwolf,1605,warrior,arms,53,27,26
Giannizugzug,nemesis,1605,warrior,arms,129,65,64
Arnoldr,ysondre,1605,warrior,arms,48,24,24
Nakro,hyjal,1604,warrior,arms,30,21,9
Ayraw,eredar,1604,warrior,arms,36,20,16
Ronoh,kazzak,1604,warrior,arms,42,23,19
Jakim,tarren-mill,1604,warrior,arms,154,77,77
Lazytowl,outland,1604,warrior,arms,130,65,65
Exoblade,silvermoon,1604,warrior,arms,76,35,41
Bloodx,archimonde,1603,warrior,arms,36,20,16
Màb,antonidas,1603,warrior,arms,72,38,34
Андреевич,blackscar,1603,warrior,arms,146,74,72
Седлайккеану,howling-fjord,1603,warrior,arms,87,44,43
Атаир,deathweaver,1603,warrior,arms,64,32,32
Mypzo,kazzak,1603,warrior,arms,90,44,46
Buckiesøde,twisting-nether,1603,warrior,arms,36,17,19
Eskiler,burning-legion,1603,warrior,arms,54,23,31
Deadlyanger,kazzak,1602,warrior,arms,42,24,18
Oweiko,blackrock,1602,warrior,arms,72,39,33
Eselhirte,blackmoore,1602,warrior,arms,85,46,39
Freelongx,stormscale,1602,warrior,arms,42,17,25
Wítts,ravencrest,1601,warrior,arms,30,20,10
Kupr,outland,1601,warrior,arms,40,21,19
Khanox,twisting-nether,1601,warrior,arms,148,74,74
Crystallake,blackrock,1601,warrior,arms,114,52,62
Wtchmyblade,blackmoore,1600,warrior,arms,94,56,38
Sumprunkare,stormscale,1599,warrior,arms,52,29,23
Breaken,silvermoon,1599,warrior,arms,54,30,24
Армсег,soulflayer,1599,warrior,arms,50,26,24
Shadokaa,stormscale,1598,warrior,arms,59,35,24
Вагранна,soulflayer,1597,warrior,arms,54,26,28
Морнстар,gordunni,1597,warrior,arms,115,55,60
Jumpilawl,khaz-modan,1597,warrior,arms,104,46,58
Кладбошаа,gordunni,1596,warrior,arms,138,70,68
Земибор,soulflayer,1596,warrior,arms,48,20,28
Arandyr,archimonde,1596,warrior,arms,60,24,36
Kobeni,ysondre,1595,warrior,arms,85,40,45
Каниме,howling-fjord,1594,warrior,arms,24,18,6
Renbaka,marécage-de-zangar,1594,warrior,arms,30,19,11
Бурчун,deathguard,1594,warrior,arms,54,34,20
Aranill,tarren-mill,1593,warrior,arms,44,22,22
Phóó,thrall,1593,warrior,arms,72,32,40
Gargaflike,aggra-português,1593,warrior,arms,72,30,42
Haanok,ravencrest,1591,warrior,arms,59,34,25
Capitalista,das-konsortium,1591,warrior,arms,42,20,22
Troma,archimonde,1591,warrior,arms,53,22,31
Neoballac,uldum,1590,warrior,arms,54,24,30
Rilor,burning-legion,1589,warrior,arms,124,53,71
Noitoved,outland,1589,warrior,arms,44,18,26
Thundersword,sylvanas,1589,warrior,arms,84,30,54
Balltas,drakthul,1588,warrior,arms,116,54,62
Btr,archimonde,1588,warrior,arms,42,19,23
Gailko,sanguino,1587,warrior,arms,40,18,22
Héda,tarren-mill,1587,warrior,arms,49,22,27
Aeldran,argent-dawn,1586,warrior,arms,48,25,23
Shwreck,kazzak,1586,warrior,arms,50,25,25
Blondboomer,neptulon,1586,warrior,arms,48,21,27
Biggerer,blackrock,1586,warrior,arms,54,23,31
Aizy,blackhand,1585,warrior,arms,36,21,15
Bufdefstance,kazzak,1584,warrior,arms,86,43,43
Bérsérk,blackmoore,1583,warrior,arms,34,20,14
Hortswarr,drakthul,1582,warrior,arms,37,24,13
Fragmeista,ragnaros,1582,warrior,arms,36,17,19
Ragëë,tarren-mill,1581,warrior,arms,78,42,36
Lilgozga,stormscale,1581,warrior,arms,48,20,28
Rogersrage,ragnaros,1580,warrior,arms,72,40,32
Архиватор,gordunni,1580,warrior,arms,114,60,54
Каосвар,howling-fjord,1579,warrior,arms,30,19,11
Solezte,tarren-mill,1579,warrior,arms,102,56,46
Kamilfury,burning-legion,1579,warrior,arms,46,18,28
Cãngo,die-todeskrallen,1578,warrior,arms,42,26,16
Grántor,eredar,1578,warrior,arms,60,34,26
Mävïs,ravencrest,1578,warrior,arms,78,42,36
Tiwâz,eredar,1578,warrior,arms,93,50,43
Денеур,gordunni,1577,warrior,arms,128,52,76
Sýkz,exodar,1577,warrior,arms,53,19,34
Vullgrîm,blackmoore,1576,warrior,arms,102,51,51
Taistelumage,stormreaver,1576,warrior,arms,35,17,18
Furukawa,ravencrest,1575,warrior,arms,51,24,27
Oxay,alakir,1575,warrior,arms,70,30,40
Erotixboi,blackrock,1573,warrior,arms,48,29,19
Оргнар,ashenvale,1573,warrior,arms,48,27,21
Lpa,stormscale,1573,warrior,arms,71,37,34
Batïk,blackmoore,1573,warrior,arms,83,36,47
Endeawour,ravencrest,1572,warrior,arms,201,114,87
Jailapatate,khaz-modan,1572,warrior,arms,36,20,16
Анакронокс,howling-fjord,1572,warrior,arms,38,20,18
Reider,twisting-nether,1571,warrior,arms,149,63,86
Monbun,silvermoon,1570,warrior,arms,101,51,50
Мастерион,soulflayer,1570,warrior,arms,78,38,40
Lewh,blackmoore,1570,warrior,arms,67,32,35
Natis,drakthul,1570,warrior,arms,78,28,50
Celphboss,tarren-mill,1569,warrior,arms,63,36,27
Rîdler,ravencrest,1569,warrior,arms,193,97,96
Xanco,ravencrest,1569,warrior,arms,54,26,28
Devidz,outland,1569,warrior,arms,48,18,30
Skorz,kazzak,1568,warrior,arms,42,20,22
Zaedt,tarren-mill,1568,warrior,arms,41,19,22
Ganzaésábi,aggra-português,1567,warrior,arms,108,57,51
Zeepp,ravencrest,1567,warrior,arms,60,25,35
Pra,antonidas,1566,warrior,arms,60,38,22
Gely,silvermoon,1566,warrior,arms,119,59,60
Гуорг,howling-fjord,1566,warrior,arms,87,39,48
Дейдулус,soulflayer,1566,warrior,arms,78,33,45
Serastul,rajaxx,1565,warrior,arms,86,42,44
Ansi,argent-dawn,1565,warrior,arms,60,28,32
Giganza,outland,1565,warrior,arms,66,29,37
Едигейй,gordunni,1564,warrior,arms,58,32,26
Ajax,defias-brotherhood,1564,warrior,arms,95,46,49
Abrash,ysondre,1564,warrior,arms,78,36,42
Ssnakeess,silvermoon,1563,warrior,arms,54,32,22
Sobii,ravencrest,1563,warrior,arms,53,28,25
Evrybodydown,draenor,1563,warrior,arms,172,87,85
Tarkosha,terokkar,1563,warrior,arms,502,253,249
Gaisorg,die-aldor,1562,warrior,arms,31,20,11
Stepa,sylvanas,1562,warrior,arms,54,28,26
Lyes,uldaman,1562,warrior,arms,256,127,129
Eggsecutor,stormscale,1562,warrior,arms,47,22,25
Cleopatra,frostwhisper,1561,warrior,arms,36,22,14
Pepegle,argent-dawn,1561,warrior,arms,54,31,23
Rongh,saurfang,1561,warrior,arms,36,17,19
Néxtlølz,twisting-nether,1561,warrior,arms,62,29,33
Айсиёу,howling-fjord,1561,warrior,arms,50,21,29
Daýz,draenor,1561,warrior,arms,48,18,30
Greenpanzer,archimonde,1560,warrior,arms,51,28,23
Krîspie,archimonde,1560,warrior,arms,71,38,33
Miz,dun-modr,1560,warrior,arms,33,17,16
Протектор,soulflayer,1560,warrior,arms,60,29,31
Хэлслэйтэр,gordunni,1559,warrior,arms,130,65,65
Арткес,gordunni,1558,warrior,arms,176,91,85
Malgár,argent-dawn,1558,warrior,arms,59,30,29
Imfiñe,outland,1558,warrior,arms,107,51,56
Vizn,emerald-dream,1558,warrior,arms,47,17,30
Тише,deathweaver,1557,warrior,arms,60,29,31
Corlo,uldaman,1557,warrior,arms,92,40,52
Spijkerbroek,alakir,1555,warrior,arms,287,146,141
Люцц,gordunni,1555,warrior,arms,176,85,91
Phovoss,stormscale,1555,warrior,arms,72,31,41
Gravityfalls,blackmoore,1554,warrior,arms,84,43,41
Nyokosuzi,grim-batol,1554,warrior,arms,60,28,32
Mélindà,silvermoon,1553,warrior,arms,63,38,25
Xecutie,antonidas,1553,warrior,arms,77,40,37
Cirenax,draenor,1551,warrior,arms,48,23,25
Skokuxx,silvermoon,1551,warrior,arms,90,41,49
Shirøx,blackrock,1550,warrior,arms,78,42,36
Kfc,chamber-of-aspects,1549,warrior,arms,30,17,13
Philatou,antonidas,1549,warrior,arms,53,29,24
Wanzzeur,hyjal,1549,warrior,arms,91,47,44
Wazraf,khaz-modan,1549,warrior,arms,144,73,71
Jake,rajaxx,1549,warrior,arms,42,18,24
Genjutsubeat,blackmoore,1548,warrior,arms,54,31,23
Arcreign,kazzak,1547,warrior,arms,96,47,49
Conanh,pozzo-delleternità,1546,warrior,arms,140,75,65
Trenôdeca,stormscale,1546,warrior,arms,48,23,25
Alexandrrior,rexxar,1546,warrior,arms,114,53,61
Herigan,burning-legion,1546,warrior,arms,45,20,25
Sahl,sylvanas,1545,warrior,arms,172,85,87
Morthôr,grim-batol,1545,warrior,arms,69,34,35
Maniackz,tarren-mill,1544,warrior,arms,36,19,17
Massiveape,argent-dawn,1544,warrior,arms,69,35,34
Мираксус,soulflayer,1544,warrior,arms,36,18,18
Warmâchine,burning-legion,1544,warrior,arms,207,95,112
Huullkk,nazjatar,1543,warrior,arms,60,28,32
Lücifer,dun-modr,1542,warrior,arms,48,34,14
Cryhoof,ragnaros,1542,warrior,arms,106,54,52
Fatmikez,aggra-português,1541,warrior,arms,48,26,22
Малаятварь,gordunni,1541,warrior,arms,34,17,17
Wrynir,archimonde,1541,warrior,arms,78,38,40
Dragoons,tyrande,1541,warrior,arms,68,30,38
Rakuna,tarren-mill,1540,warrior,arms,114,55,59
Jeonsoyeon,argent-dawn,1540,warrior,arms,36,17,19
Ayasana,argent-dawn,1539,warrior,arms,30,18,12
Kleidaria,stormscale,1539,warrior,arms,36,19,17
Crissx,silvermoon,1538,warrior,arms,127,66,61
Farrusco,nemesis,1538,warrior,arms,107,55,52
ßamßam,draenor,1538,warrior,arms,58,29,29
Riann,silvermoon,1538,warrior,arms,42,20,22
Alexamazing,lordaeron,1538,warrior,arms,79,37,42
Boldinq,ravencrest,1538,warrior,arms,117,51,66
Zhulgar,azjolnerub,1537,warrior,arms,60,32,28
Stancenation,draenor,1537,warrior,arms,70,31,39
Èzekiel,dalaran,1536,warrior,arms,90,46,44
Armsbull,twisting-nether,1536,warrior,arms,66,32,34
Gantsrip,stormscale,1536,warrior,arms,46,22,24
Billorc,twisting-nether,1536,warrior,arms,75,35,40
Bstgame,frostmane,1535,warrior,arms,36,17,19
Hobo,ravencrest,1535,warrior,arms,71,32,39
Luffydono,stormscale,1535,warrior,arms,66,28,38
Zyzy,arathor,1533,warrior,arms,42,23,19
Riptack,anetheron,1533,warrior,arms,160,84,76
Gigasmash,pozzo-delleternità,1533,warrior,arms,144,67,77
Micromachine,argent-dawn,1533,warrior,arms,54,20,34
Hollydeffs,blackmoore,1532,warrior,arms,66,29,37
Тэйкмисофтли,blackscar,1531,warrior,arms,48,26,22
Trashman,bronzebeard,1531,warrior,arms,114,55,59
Rabaozi,blackhand,1530,warrior,arms,95,45,50
Áäáäáäáä,aegwynn,1529,warrior,arms,30,16,14
Toroespaña,draenor,1529,warrior,arms,139,67,72
Громпузан,galakrond,1529,warrior,arms,60,27,33
Proxxyyqt,blackrock,1529,warrior,arms,68,30,38
Bullrug,blackrock,1528,warrior,arms,36,18,18
Vallahan,argent-dawn,1528,warrior,arms,267,131,136
Waf,hakkar,1527,warrior,arms,108,61,47
Leeches,aggramar,1527,warrior,arms,30,16,14
Eren,todeswache,1527,warrior,arms,54,28,26
Mentôr,sargeras,1527,warrior,arms,41,21,20
Nexpwns,blackhand,1527,warrior,arms,153,78,75
Zirêael,kazzak,1527,warrior,arms,42,16,26
Lollydhur,nemesis,1526,warrior,arms,66,34,32
Bumoletroll,draenor,1526,warrior,arms,33,17,16
Grimzot,ragnaros,1525,warrior,arms,60,30,30
Zarakï,zuljin,1525,warrior,arms,60,30,30
Icekissx,hyjal,1524,warrior,arms,135,69,66
Lrb,tarren-mill,1524,warrior,arms,109,52,57
Абырабыр,howling-fjord,1523,warrior,arms,24,16,8
Vilass,silvermoon,1523,warrior,arms,36,19,17
Skullrage,tarren-mill,1523,warrior,arms,53,22,31
Zheq,ragnaros,1522,warrior,arms,30,16,14
Shrekwarr,kazzak,1522,warrior,arms,137,67,70
Stormcoil,stormscale,1521,warrior,arms,47,24,23
Norwegian,silvermoon,1521,warrior,arms,80,37,43
Xorlog,thrall,1520,warrior,arms,41,24,17
Devilpanic,outland,1520,warrior,arms,30,16,14
Gervvand,burning-legion,1519,warrior,arms,48,26,22
Мэйрил,lich-king,1519,warrior,arms,190,99,91
Nighat,sanguino,1519,warrior,arms,162,83,79
Shownomercy,blackrock,1519,warrior,arms,48,23,25
Стенденсх,howling-fjord,1519,warrior,arms,41,19,22
Authar,tarren-mill,1518,warrior,arms,61,33,28
Yukizz,ravencrest,1518,warrior,arms,30,16,14
Адво,gordunni,1517,warrior,arms,96,50,46
Savedsky,zuljin,1517,warrior,arms,48,16,32
Vauster,draenor,1516,warrior,arms,62,35,27
Trilon,blackrock,1516,warrior,arms,50,21,29
Vory,ravencrest,1515,warrior,arms,24,16,8
Spärtan,dun-modr,1515,warrior,arms,66,34,32
Skeletor,draenor,1515,warrior,arms,61,30,31
Gipsyjoe,ragnaros,1515,warrior,arms,82,39,43
Vayndral,kazzak,1514,warrior,arms,78,39,39
Laavapoeg,outland,1514,warrior,arms,48,23,25
Execútioner,sylvanas,1513,warrior,arms,35,19,16
Dárkhammer,tarren-mill,1513,warrior,arms,72,35,37
Heltslut,tarren-mill,1513,warrior,arms,66,26,40
Mezugzugyou,draenor,1512,warrior,arms,44,23,21
Velinde,outland,1512,warrior,arms,46,23,23
Thaldrys,blackhand,1512,warrior,arms,167,81,86
Скрежет,gordunni,1512,warrior,arms,66,32,34
Elder,darkmoon-faire,1512,warrior,arms,137,66,71
Ødên,frostmane,1511,warrior,arms,30,16,14
Duncán,auchindoun,1511,warrior,arms,53,27,26
Ilovealma,kiljaeden,1511,warrior,arms,65,29,36
Scormash,burning-legion,1510,warrior,arms,36,16,20
Mazzkze,silvermoon,1509,warrior,arms,237,122,115
Grumpy,lightbringer,1509,warrior,arms,64,30,34
Tinkaton,sylvanas,1509,warrior,arms,36,16,20
Geforce,hellscream,1508,warrior,arms,178,88,90
Nøsyo,blackrock,1507,warrior,arms,30,18,12
Üs,ravencrest,1507,warrior,arms,65,35,30
Garwarr,twisting-nether,1507,warrior,arms,43,22,21
Kestialezin,archimonde,1506,warrior,arms,72,46,26
Sonìe,kazzak,1506,warrior,arms,89,51,38
Notinfa,draenor,1506,warrior,arms,138,73,65
Bloodbrother,blackmoore,1506,warrior,arms,79,40,39
Zergalot,stormscale,1505,warrior,arms,35,17,18
Otzi,sargeras,1505,warrior,arms,65,24,41
Tweran,drakthul,1504,warrior,arms,30,16,14
Pied,krasus,1504,warrior,arms,36,19,17
Волрок,howling-fjord,1504,warrior,arms,67,34,33
Pptickler,argent-dawn,1504,warrior,arms,83,41,42
Raakalainen,vashj,1504,warrior,arms,59,29,30
Melliug,ysondre,1504,warrior,arms,46,19,27
Savh,silvermoon,1503,warrior,arms,48,28,20
Bävling,kazzak,1503,warrior,arms,37,20,17
Craghak,twisting-nether,1502,warrior,arms,175,88,87
Alyx,mugthol,1501,warrior,arms,104,54,50
Crayz,twisting-nether,1501,warrior,arms,54,26,28
Агрегат,goldrinn,1501,warrior,arms,77,34,43
Räzorleaf,kul-tiras,1500,warrior,arms,96,50,46
Рыгулька,gordunni,1500,warrior,arms,198,96,102
Asuramaru,aegwynn,1499,warrior,arms,89,47,42
Battlemaster,die-aldor,1499,warrior,arms,34,17,17
Грэйм,gordunni,1498,warrior,arms,64,33,31
Tgabor,ragnaros,1498,warrior,arms,35,18,17
Ragnou,tarren-mill,1498,warrior,arms,82,38,44
Crriminal,ravencrest,1498,warrior,arms,48,20,28
Marcnky,stormscale,1497,warrior,arms,145,75,70
Дозен,soulflayer,1496,warrior,arms,46,26,20
Arktharion,antonidas,1495,warrior,arms,60,28,32
Киллдекс,gordunni,1495,warrior,arms,96,43,53
Slidmacka,twisting-nether,1495,warrior,arms,97,42,55
Думхаммер,howling-fjord,1494,warrior,arms,77,44,33
Рэмпи,soulflayer,1494,warrior,arms,32,17,15
Thiccbra,burning-legion,1494,warrior,arms,66,34,32
Shadowbôxer,onyxia,1494,warrior,arms,68,35,33
Whátsup,stormscale,1494,warrior,arms,48,24,24
Rohc,kazzak,1494,warrior,arms,64,30,34
Fáro,ravencrest,1494,warrior,arms,46,19,27
Aurélus,rexxar,1493,warrior,arms,36,22,14
Ardmoo,burning-legion,1493,warrior,arms,59,31,28
Jonukas,argent-dawn,1493,warrior,arms,54,23,31
Ммайдаен,goldrinn,1492,warrior,arms,66,32,34
Bladrun,frostmane,1492,warrior,arms,36,16,20
Starscourge,tarren-mill,1491,warrior,arms,53,43,10
Kímó,silvermoon,1491,warrior,arms,48,24,24
Pumpadzhîja,outland,1491,warrior,arms,66,32,34
Séphi,archimonde,1491,warrior,arms,54,24,30
Picciocino,nemesis,1491,warrior,arms,88,36,52
Hùmøngöúslåm,ravencrest,1490,warrior,arms,30,19,11
Gozga,twisting-nether,1490,warrior,arms,159,79,80
Blackwólf,bloodhoof,1490,warrior,arms,154,72,82
Vohnkar,emeriss,1490,warrior,arms,60,26,34
Bucketheadde,thrall,1490,warrior,arms,42,16,26
Шлифую,howling-fjord,1489,warrior,arms,43,26,17
Calmdownbrú,frostmane,1489,warrior,arms,65,33,32
Succel,drakthul,1489,warrior,arms,36,18,18
Crangle,draenor,1489,warrior,arms,45,21,24
Hefthyn,sanguino,1488,warrior,arms,36,20,16
Khemen,kazzak,1488,warrior,arms,42,22,20
Gorocpt,doomhammer,1488,warrior,arms,44,20,24
Teronth,burning-legion,1488,warrior,arms,48,17,31
Hindbærsaft,stormscale,1487,warrior,arms,55,32,23
Bloodrain,twilights-hammer,1487,warrior,arms,68,34,34
Zaurzyfang,burning-legion,1487,warrior,arms,36,18,18
Paow,tarren-mill,1487,warrior,arms,41,19,22
Сика,blackscar,1487,warrior,arms,66,30,36
Cryonix,drakthul,1486,warrior,arms,49,27,22
Jimei,temple-noir,1486,warrior,arms,30,16,14
Голдибитч,gordunni,1486,warrior,arms,84,41,43
Mfdoöm,draenor,1485,warrior,arms,149,73,76
Omgihithard,draenor,1484,warrior,arms,57,28,29
Audítóre,proudmoore,1484,warrior,arms,36,17,19
Fizzywarrior,blackmoore,1484,warrior,arms,63,29,34
Lortèn,stormscale,1482,warrior,arms,48,24,24
Stormfist,tarren-mill,1481,warrior,arms,60,33,27
Runhex,veknilash,1481,warrior,arms,53,26,27
Daelator,ravencrest,1480,warrior,arms,56,30,26
Gramr,silvermoon,1480,warrior,arms,71,36,35
Nurfbolt,kazzak,1480,warrior,arms,41,19,22
Nàsher,frostwolf,1480,warrior,arms,89,40,49
Altimáte,antonidas,1479,warrior,arms,30,18,12
Dariman,aegwynn,1479,warrior,arms,72,32,40
Gromkarg,draenor,1479,warrior,arms,66,24,42
Lezgar,ragnaros,1477,warrior,arms,24,18,6
Boshim,ravencrest,1477,warrior,arms,36,20,16
Нетконечно,howling-fjord,1477,warrior,arms,38,19,19
Bracki,ysondre,1477,warrior,arms,46,21,25
Ollyaa,ravencrest,1476,warrior,arms,24,16,8
Trenbullone,kazzak,1476,warrior,arms,51,32,19
Джасткипинг,gordunni,1476,warrior,arms,221,118,103
Ràkar,stormscale,1476,warrior,arms,66,32,34
Pajalousta,elune,1476,warrior,arms,102,47,55
Vegilhenvin,stormscale,1476,warrior,arms,57,24,33
Valíon,outland,1475,warrior,arms,94,53,41
Medaur,frostmane,1475,warrior,arms,73,40,33
Dagouor,twisting-nether,1474,warrior,arms,73,35,38
Leomance,hyjal,1473,warrior,arms,30,18,12
Melfis,aegwynn,1471,warrior,arms,40,21,19
Malalulu,burning-legion,1471,warrior,arms,143,72,71
Hazzael,ravencrest,1471,warrior,arms,66,31,35
Divyx,tarren-mill,1470,warrior,arms,66,33,33
Gíu,blackhand,1469,warrior,arms,29,17,12
Clellin,silvermoon,1469,warrior,arms,75,37,38
Hellzint,sanguino,1468,warrior,arms,303,146,157
Heubba,hyjal,1467,warrior,arms,42,16,26
Богадорога,howling-fjord,1465,warrior,arms,33,19,14
Dafrang,kazzak,1465,warrior,arms,54,23,31
Заверчу,soulflayer,1464,warrior,arms,66,34,32
Keksspec,ungoro,1464,warrior,arms,48,20,28
Hellespont,hellscream,1464,warrior,arms,101,37,64
Grroom,tarren-mill,1463,warrior,arms,51,24,27
Svënja,ysondre,1463,warrior,arms,144,66,78
Grezlyk,drakthul,1463,warrior,arms,95,42,53
Thâarnar,frostwolf,1463,warrior,arms,48,21,27
Сеш,lich-king,1462,warrior,arms,116,54,62
Nukebomb,dun-modr,1462,warrior,arms,54,25,29
Nèssa,outland,1462,warrior,arms,41,16,25
Gorejaws,draenor,1461,warrior,arms,30,19,11
Hôrn,stormscale,1461,warrior,arms,66,37,29
Juoppó,tarren-mill,1461,warrior,arms,128,67,61
Reider,kazzak,1460,warrior,arms,57,29,28
Азаргатан,soulflayer,1460,warrior,arms,62,31,31
Brutøs,conseil-des-ombres,1460,warrior,arms,36,18,18
Lachandrius,blackhand,1460,warrior,arms,90,43,47
Trajkovic,ravencrest,1459,warrior,arms,200,108,92
Togas,silvermoon,1459,warrior,arms,182,93,89
Кефтеме,fordragon,1459,warrior,arms,141,69,72
Pakusrage,defias-brotherhood,1459,warrior,arms,80,38,42
Kèrrysmâsh,blackrock,1457,warrior,arms,54,31,23
Drushíí,shattrath,1457,warrior,arms,71,35,36
Ènteqt,antonidas,1456,warrior,arms,61,39,22
Настрамо,gordunni,1456,warrior,arms,30,16,14
Phenowarri,blackhand,1456,warrior,arms,115,60,55
Лисерк,howling-fjord,1456,warrior,arms,42,16,26
Weareinspace,stormscale,1455,warrior,arms,75,44,31
Golonko,burning-legion,1455,warrior,arms,36,21,15
Ordwinz,silvermoon,1455,warrior,arms,74,39,35
Bluto,dunemaul,1455,warrior,arms,227,113,114
Ladoz,ragnaros,1454,warrior,arms,48,22,26
Кизуми,gordunni,1454,warrior,arms,63,27,36
Meistarinn,draenor,1454,warrior,arms,60,22,38
Onee,terrordar,1453,warrior,arms,55,30,25
Dundulinka,outland,1453,warrior,arms,93,47,46
Yeahq,kazzak,1453,warrior,arms,144,65,79
Гардринг,howling-fjord,1450,warrior,arms,102,59,43
Scarloc,archimonde,1450,warrior,arms,92,42,50
Mordeukay,hyjal,1450,warrior,arms,42,18,24
Peack,ravencrest,1449,warrior,arms,166,87,79
Miko,ysondre,1449,warrior,arms,120,56,64
Alborozie,archimonde,1448,warrior,arms,54,25,29
Norinhell,ravencrest,1448,warrior,arms,48,20,28
Jigsar,argent-dawn,1447,warrior,arms,111,63,48
Gakgora,twisting-nether,1447,warrior,arms,36,18,18
Endan,kelthuzad,1446,warrior,arms,66,37,29
Dokô,twisting-nether,1446,warrior,arms,72,36,36
Derentis,echsenkessel,1446,warrior,arms,198,94,104
Argaskurken,ravencrest,1446,warrior,arms,42,19,23
Informatica,doomhammer,1445,warrior,arms,48,25,23
Megtorló,ragnaros,1445,warrior,arms,80,40,40
Мерсилессх,gordunni,1445,warrior,arms,90,43,47
Zhadsnark,blackrock,1444,warrior,arms,26,16,10
Разрубателл,soulflayer,1444,warrior,arms,60,27,33
Дообрыйшмель,soulflayer,1443,warrior,arms,51,32,19
Рагаксес,blackscar,1443,warrior,arms,82,36,46
Акумираг,soulflayer,1443,warrior,arms,72,31,41
Arriess,drakthul,1441,warrior,arms,48,27,21
Jumbodolmen,tarren-mill,1441,warrior,arms,48,26,22
Gnomop,ravencrest,1441,warrior,arms,42,20,22
Эпитафорх,blackscar,1440,warrior,arms,29,16,13
Karimlebrave,hyjal,1440,warrior,arms,68,33,35
Tucomessuelo,cthun,1439,warrior,arms,53,29,24
Greekazi,kazzak,1439,warrior,arms,75,39,36
Tmp,blackrock,1439,warrior,arms,60,30,30
Ricssonz,burning-legion,1439,warrior,arms,60,29,31
Makerrw,ravencrest,1438,warrior,arms,50,26,24
Чпокерз,gordunni,1438,warrior,arms,88,43,45
Sebeastian,ravencrest,1438,warrior,arms,48,23,25
Мадс,howling-fjord,1437,warrior,arms,18,15,3
Garouzo,hellfire,1437,warrior,arms,64,32,32
Mtctwo,blackrock,1437,warrior,arms,30,15,15
Gìlgamesh,dun-modr,1437,warrior,arms,121,59,62
Ryle,anubarak,1437,warrior,arms,136,60,76
Josgrout,silvermoon,1437,warrior,arms,64,28,36
Нунара,eversong,1437,warrior,arms,47,19,28
Anarki,kaelthas,1437,warrior,arms,50,19,31
Banshe,ragnaros,1437,warrior,arms,48,16,32
Мираккл,borean-tundra,1436,warrior,arms,24,15,9
Aza,burning-blade,1436,warrior,arms,42,23,19
Kaîsaschnitt,malganis,1436,warrior,arms,94,47,47
Pokopo,blackrock,1436,warrior,arms,217,107,110
Goldins,drakthul,1436,warrior,arms,53,26,27
Friskos,dalaran,1436,warrior,arms,118,55,63
Varyian,sporeggar,1436,warrior,arms,131,59,72
Vrykhul,silvermoon,1436,warrior,arms,58,22,36
Сладкаяхурма,howling-fjord,1436,warrior,arms,42,15,27
Andzone,alakir,1435,warrior,arms,30,15,15
Bigboibeeper,draenor,1435,warrior,arms,72,35,37
Hackamore,suramar,1435,warrior,arms,102,49,53
Mograinê,blackmoore,1434,warrior,arms,126,66,60
Dzvenyhora,darkspear,1434,warrior,arms,96,44,52
Dafok,rashgarroth,1434,warrior,arms,42,19,23
Гопниг,deepholm,1433,warrior,arms,89,40,49
Slunecniq,azjolnerub,1433,warrior,arms,63,28,35
Илди,soulflayer,1433,warrior,arms,36,15,21
Shoesmith,outland,1432,warrior,arms,92,36,56
Pelicos,grim-batol,1431,warrior,arms,30,17,13
Yayoflauta,sanguino,1431,warrior,arms,54,28,26
Luküs,dun-modr,1431,warrior,arms,76,36,40
Dragão,kazzak,1431,warrior,arms,42,17,25
Otiep,blackmoore,1430,warrior,arms,36,24,12
Dataçasé,silvermoon,1430,warrior,arms,24,15,9
Wolvéshôwl,aegwynn,1430,warrior,arms,79,33,46
Hellrokk,drakthul,1429,warrior,arms,30,18,12
Architectman,twisting-nether,1429,warrior,arms,131,63,68
Irén,hellfire,1429,warrior,arms,69,32,37
Gorzan,dragonmaw,1429,warrior,arms,71,31,40
Ormert,sylvanas,1429,warrior,arms,42,18,24
Garroxx,blackrock,1429,warrior,arms,42,15,27
Niiol,burning-blade,1428,warrior,arms,30,15,15
Spridan,ravencrest,1428,warrior,arms,42,15,27
Alinash,aegwynn,1427,warrior,arms,51,24,27
Arreat,chogall,1427,warrior,arms,130,59,71
Elbutanero,tarren-mill,1427,warrior,arms,36,15,21
Farianna,burning-legion,1426,warrior,arms,87,43,44
Bráïnléss,silvermoon,1426,warrior,arms,36,17,19
Rightversion,sylvanas,1425,warrior,arms,30,15,15
Zerberos,drakthul,1425,warrior,arms,76,37,39
Alpairx,aegwynn,1425,warrior,arms,50,18,32
Raizy,frostwolf,1424,warrior,arms,126,67,59
Ahzrok,draenor,1424,warrior,arms,48,25,23
Thickslam,argent-dawn,1424,warrior,arms,64,29,35
Lostbull,kazzak,1424,warrior,arms,42,18,24
Инелутабл,eversong,1423,warrior,arms,29,19,10
Kriegernuss,blackmoore,1423,warrior,arms,48,27,21
Murandin,outland,1423,warrior,arms,36,19,17
Ball,zirkel-des-cenarius,1423,warrior,arms,131,67,64
Уэсгар,blackscar,1423,warrior,arms,48,15,33
Petrixens,drakthul,1422,warrior,arms,48,26,22
Doba,madmortem,1422,warrior,arms,71,32,39
Zkou,wrathbringer,1422,warrior,arms,42,15,27
Smoothbrian,ravencrest,1421,warrior,arms,24,15,9
Трафалльгар,gordunni,1421,warrior,arms,142,77,65
Judditsbx,draenor,1421,warrior,arms,41,22,19
Tarbhfathach,draenor,1421,warrior,arms,48,25,23
Зеленыйжмых,thermaplugg,1421,warrior,arms,57,28,29
Skumslag,blackmoore,1421,warrior,arms,42,15,27
Mljecho,kazzak,1420,warrior,arms,155,79,76
Pishpy,sylvanas,1420,warrior,arms,32,16,16
Jáson,kazzak,1420,warrior,arms,71,33,38
Dargonedt,blackrock,1420,warrior,arms,42,18,24
Maxxiwumms,amanthul,1420,warrior,arms,36,15,21
Ähäkutti,frostmane,1419,warrior,arms,77,44,33
Zellxd,stormscale,1418,warrior,arms,36,20,16
Madkill,twisting-nether,1418,warrior,arms,30,16,14
Avelyr,pozzo-delleternità,1418,warrior,arms,30,15,15
Nyamnyamnyam,blackmoore,1418,warrior,arms,35,15,20
Josem,sanguino,1418,warrior,arms,39,16,23
Gridra,dun-morogh,1417,warrior,arms,60,28,32
Hoomeer,sylvanas,1417,warrior,arms,78,36,42
Nuahka,blackmoore,1416,warrior,arms,28,17,11
Leroxius,ragnaros,1416,warrior,arms,168,86,82
Llestatl,hyjal,1416,warrior,arms,83,42,41
Ciocaboca,draenor,1415,warrior,arms,30,17,13
Markorok,kazzak,1415,warrior,arms,30,15,15
Zugzugernaut,stormscale,1415,warrior,arms,36,16,20
Flurie,sylvanas,1415,warrior,arms,46,20,26
Madaxe,kazzak,1414,warrior,arms,24,20,4
Størpïx,drakthul,1414,warrior,arms,60,34,26
Berzzerker,tarren-mill,1414,warrior,arms,66,35,31
Shïn,kaelthas,1414,warrior,arms,66,26,40
Nøcturnaqq,silvermoon,1413,warrior,arms,72,34,38
Lahzar,krasus,1413,warrior,arms,36,15,21
Oruka,mannoroth,1412,warrior,arms,48,27,21
Ugardosh,burning-legion,1412,warrior,arms,40,16,24
Гетрайт,galakrond,1411,warrior,arms,38,21,17
Vratranzhul,kirin-tor,1411,warrior,arms,229,108,121
Латексник,booty-bay,1411,warrior,arms,63,26,37
Kantarion,stormscale,1411,warrior,arms,54,22,32
Hamonbophis,kirin-tor,1410,warrior,arms,30,17,13
Абабоба,gordunni,1410,warrior,arms,100,50,50
Паракур,soulflayer,1410,warrior,arms,84,40,44
Эксихард,gordunni,1409,warrior,arms,78,34,44
Ferpylél,ragnaros,1408,warrior,arms,31,17,14
Deadyet,mugthol,1407,warrior,arms,24,15,9
Yuriko,onyxia,1407,warrior,arms,48,25,23
Taylorswifty,twisting-nether,1406,warrior,arms,96,52,44
Nocton,blackhand,1406,warrior,arms,72,35,37
Chaosedge,terokkar,1406,warrior,arms,36,16,20
Spargebuci,draenor,1406,warrior,arms,48,17,31
Esegryel,argent-dawn,1405,warrior,arms,65,26,39
Gritch,ysondre,1404,warrior,arms,30,15,15
Неосим,gordunni,1403,warrior,arms,48,29,19
Beelzebuu,blackhand,1403,warrior,arms,85,45,40
Bjösk,stormscale,1403,warrior,arms,45,23,22
Raznon,magtheridon,1403,warrior,arms,42,17,25
Mgw,blackrock,1402,warrior,arms,30,17,13
Chakrator,la-croisade-écarlate,1402,warrior,arms,96,47,49
Cutting,burning-legion,1402,warrior,arms,61,29,32
Fraggiz,auchindoun,1402,warrior,arms,36,16,20
Hílfiger,kazzak,1402,warrior,arms,71,29,42
Befit,quelthalas,1401,warrior,arms,36,19,17
Saofang,twisting-nether,1401,warrior,arms,30,15,15
Андэрс,gordunni,1401,warrior,arms,124,59,65
Северот,deepholm,1401,warrior,arms,35,16,19
Bloodmyst,kazzak,1401,warrior,arms,60,27,33
Strapnslap,argent-dawn,1401,warrior,arms,107,48,59
Tamesulo,silvermoon,1401,warrior,arms,59,26,33
Peldreas,silvermoon,1400,warrior,arms,64,31,33
Казгримм,howling-fjord,1400,warrior,arms,48,23,25
Caelgarn,twisting-nether,1399,warrior,arms,45,27,18
Synrosh,hyjal,1399,warrior,arms,39,23,16
Grimoire,drakthul,1399,warrior,arms,32,17,15
Sidiøøus,hyjal,1399,warrior,arms,66,31,35
Zíreael,ravencrest,1399,warrior,arms,53,22,31
Zaatar,draenor,1398,warrior,arms,184,97,87
Qvate,twisting-nether,1398,warrior,arms,65,33,32
Moowar,defias-brotherhood,1398,warrior,arms,36,17,19
Atälànte,ysondre,1397,warrior,arms,42,25,17
Garrodan,doomhammer,1397,warrior,arms,36,15,21
Doxinator,silvermoon,1396,warrior,arms,81,33,48
Nevergladx,kazzak,1396,warrior,arms,57,23,34
ßladex,azshara,1395,warrior,arms,47,27,20
Rodenet,dun-modr,1395,warrior,arms,66,33,33
Mortalgrim,ravencrest,1395,warrior,arms,58,29,29
Zbra,draenor,1395,warrior,arms,65,32,33
Bládez,ravencrest,1394,warrior,arms,66,36,30
Dolphini,argent-dawn,1394,warrior,arms,52,23,29
Akenrun,eredar,1394,warrior,arms,64,28,36
Royoxo,blackrock,1393,warrior,arms,59,31,28
Deadlycalm,blackrock,1393,warrior,arms,120,54,66
Hørror,nemesis,1392,warrior,arms,60,30,30
Алексвайтт,gordunni,1391,warrior,arms,47,23,24
Folsack,sanguino,1391,warrior,arms,66,31,35
Elyozz,silvermoon,1391,warrior,arms,49,23,26
Hradball,twilights-hammer,1390,warrior,arms,60,28,32
Glakias,silvermoon,1390,warrior,arms,36,16,20
Okoru,stormscale,1390,warrior,arms,57,22,35
Fokra,draenor,1389,warrior,arms,42,25,17
Nuclearrage,outland,1389,warrior,arms,61,28,33
Ordovis,silvermoon,1388,warrior,arms,30,15,15
Антурим,howling-fjord,1388,warrior,arms,42,20,22
Nabul,thunderhorn,1387,warrior,arms,48,26,22
Binsaueramk,ravencrest,1387,warrior,arms,48,20,28
Icybladez,kazzak,1386,warrior,arms,106,55,51
Matti,magtheridon,1386,warrior,arms,29,15,14
Rumbldore,ragnaros,1386,warrior,arms,54,22,32
Prolyx,doomhammer,1385,warrior,arms,24,15,9
Tolga,draenor,1385,warrior,arms,42,19,23
Sokarbey,twisting-nether,1384,warrior,arms,30,17,13
Дикийппц,gordunni,1384,warrior,arms,54,30,24
Diástasi,twisting-nether,1384,warrior,arms,90,48,42
Казньшалав,gordunni,1384,warrior,arms,111,54,57
Éls,argent-dawn,1383,warrior,arms,46,22,24
Keshâr,blackhand,1383,warrior,arms,42,20,22
Einherjer,burning-legion,1382,warrior,arms,103,56,47
Adzipotlewap,burning-legion,1382,warrior,arms,48,23,25
Zetorc,burning-legion,1382,warrior,arms,129,61,68
Cêlty,aegwynn,1382,warrior,arms,100,41,59
Alopunch,kazzak,1381,warrior,arms,33,17,16
Мастхэв,gordunni,1381,warrior,arms,42,21,21
Reidunøks,kazzak,1381,warrior,arms,113,53,60
Niouswar,kazzak,1381,warrior,arms,42,19,23
Gëaldýr,kazzak,1381,warrior,arms,88,39,49
Faugh,tarren-mill,1380,warrior,arms,54,32,22
Ingensan,lightbringer,1379,warrior,arms,86,43,43
Orgazam,xavius,1379,warrior,arms,41,20,21
Pikkemaát,stormscale,1377,warrior,arms,27,15,12
Warrouner,khaz-modan,1377,warrior,arms,151,74,77
Shagara,defias-brotherhood,1377,warrior,arms,36,15,21
Xaheld,blackrock,1376,warrior,arms,30,16,14
Temprament,ravencrest,1375,warrior,arms,36,21,15
Давилкагеев,howling-fjord,1375,warrior,arms,49,23,26
Варгана,soulflayer,1375,warrior,arms,88,41,47
Nezruslone,dun-modr,1374,warrior,arms,35,26,9
Zargor,kazzak,1374,warrior,arms,58,35,23
Booj,silvermoon,1374,warrior,arms,66,32,34
Hitmanler,frostmane,1374,warrior,arms,36,17,19
Cléàvage,silvermoon,1374,warrior,arms,81,32,49
Dødsdonny,draenor,1373,warrior,arms,30,19,11
Iljaana,blackrock,1373,warrior,arms,60,30,30
Hogu,nemesis,1373,warrior,arms,54,21,33
Раздолбатель,razuvious,1372,warrior,arms,37,21,16
Srbinator,turalyon,1371,warrior,arms,131,64,67
Lexras,blackhand,1371,warrior,arms,56,27,29
Dixo,nathrezim,1370,warrior,arms,18,15,3
Морталвлицо,gordunni,1370,warrior,arms,23,15,8
Mercedesamg,blackmoore,1370,warrior,arms,56,28,28
Shædøw,archimonde,1370,warrior,arms,30,15,15
Sorosterv,twisting-nether,1370,warrior,arms,59,29,30
Ayelsyssup,silvermoon,1370,warrior,arms,139,67,72
Bellator,arakarahm,1370,warrior,arms,59,27,32
Rakwarrior,blackhand,1369,warrior,arms,30,20,10
Mëc,twisting-nether,1369,warrior,arms,88,47,41
Leonidæs,frostwolf,1369,warrior,arms,87,42,45
Tyrax,blackrock,1368,warrior,arms,29,15,14
Matchoo,archimonde,1367,warrior,arms,59,27,32
Drekh,kazzak,1367,warrior,arms,36,16,20
Luusto,stormscale,1366,warrior,arms,42,16,26
Erzotz,kazzak,1365,warrior,arms,33,20,13
Lægend,hyjal,1365,warrior,arms,74,37,37
Lyfttokyo,tarren-mill,1365,warrior,arms,90,43,47
Xmartha,tarren-mill,1364,warrior,arms,36,22,14
Nobelisarius,norgannon,1364,warrior,arms,53,27,26
Gacel,dun-modr,1364,warrior,arms,54,24,30
Qweoamsd,sylvanas,1363,warrior,arms,30,15,15
Ragestick,stormscale,1363,warrior,arms,42,20,22
Rázgriz,argent-dawn,1363,warrior,arms,76,31,45
Qiz,silvermoon,1362,warrior,arms,140,71,69
Lomu,bloodscalp,1362,warrior,arms,44,22,22
Propanex,kazzak,1361,warrior,arms,42,26,16
Youokhun,kazzak,1361,warrior,arms,72,38,34
Кэфтэмэ,soulflayer,1361,warrior,arms,85,41,44
Hatefury,twisting-nether,1361,warrior,arms,102,48,54
Vølverinwar,thrall,1361,warrior,arms,82,37,45
Bulwrak,eredar,1359,warrior,arms,132,65,67
Kosttya,argent-dawn,1359,warrior,arms,71,33,38
Panggy,ragnaros,1359,warrior,arms,36,15,21
Grahatia,magtheridon,1358,warrior,arms,99,54,45
Газрош,howling-fjord,1358,warrior,arms,76,35,41
Kymari,sanguino,1358,warrior,arms,63,28,35
Nucleargrab,twilights-hammer,1356,warrior,arms,145,70,75
Sinbuay,malygos,1356,warrior,arms,36,16,20
Banshor,ysondre,1355,warrior,arms,38,18,20
Xanatos,khazgoroth,1355,warrior,arms,56,19,37
Агтеррокк,deathweaver,1353,warrior,arms,60,30,30
Duce,kirin-tor,1353,warrior,arms,43,18,25
Eyesonly,blackmoore,1352,warrior,arms,52,28,24
Kioskmupp,ravencrest,1352,warrior,arms,102,50,52
Авентадорх,deathguard,1352,warrior,arms,89,35,54
Tedbuckland,blackrock,1351,warrior,arms,30,19,11
Espröc,kazzak,1350,warrior,arms,198,101,97
Mogolaki,twilights-hammer,1349,warrior,arms,126,60,66
Pavard,arakarahm,1349,warrior,arms,36,16,20
Bumbx,kazzak,1348,warrior,arms,44,23,21
Grolbein,blackhand,1348,warrior,arms,71,35,36
Toxicmade,drakthul,1347,warrior,arms,48,22,26
Брозя,gordunni,1347,warrior,arms,42,19,23
Èscøbar,dalaran,1347,warrior,arms,45,17,28
Tazkax,archimonde,1346,warrior,arms,52,23,29
Blackblades,defias-brotherhood,1345,warrior,arms,54,33,21
Мускулатор,soulflayer,1345,warrior,arms,126,58,68
Imondiet,ragnaros,1344,warrior,arms,18,14,4
Pummelpete,grim-batol,1344,warrior,arms,24,14,10
Jasperr,nemesis,1344,warrior,arms,127,69,58
Pazl,outland,1344,warrior,arms,36,17,19
Скользкийбро,gordunni,1343,warrior,arms,139,67,72
Tyëlin,elune,1343,warrior,arms,107,50,57
Whýsøsîlêñt,ragnaros,1343,warrior,arms,30,14,16
Colard,ravencrest,1343,warrior,arms,30,14,16
Marex,grim-batol,1343,warrior,arms,30,14,16
Ysgrammorr,magtheridon,1343,warrior,arms,36,16,20
Galganiec,burning-legion,1342,warrior,arms,30,20,10
Buyya,ravencrest,1342,warrior,arms,58,31,27
Carras,confrérie-du-thorium,1342,warrior,arms,222,106,116
Anahkas,archimonde,1342,warrior,arms,30,14,16
Germantank,ravencrest,1341,warrior,arms,24,14,10
Хазгора,howling-fjord,1341,warrior,arms,106,58,48
Zzeed,auchindoun,1341,warrior,arms,48,19,29
Elénir,dalaran,1340,warrior,arms,30,18,12
Pag,hyjal,1339,warrior,arms,23,15,8
Gnarok,archimonde,1339,warrior,arms,69,41,28
Norganw,die-aldor,1339,warrior,arms,24,14,10
Hoxxywar,drakthul,1339,warrior,arms,59,33,26
Dranush,onyxia,1339,warrior,arms,253,127,126
Kaliroll,ysondre,1339,warrior,arms,104,51,53
Голдфингер,gordunni,1339,warrior,arms,130,62,68
Nylseana,turalyon,1339,warrior,arms,60,26,34
Pinkblast,sylvanas,1339,warrior,arms,36,14,22
Hundar,archimonde,1338,warrior,arms,54,29,25
Палачубийца,deathguard,1338,warrior,arms,97,51,46
Cássándráh,argent-dawn,1338,warrior,arms,97,47,50
Kimura,archimonde,1338,warrior,arms,30,14,16
Тритиан,soulflayer,1338,warrior,arms,34,15,19
Toby,rexxar,1337,warrior,arms,33,19,14
Lågærtha,blackmoore,1337,warrior,arms,53,28,25
Puurplecloud,kazzak,1337,warrior,arms,66,28,38
Littlebugger,ravencrest,1336,warrior,arms,24,14,10
Neverkind,twisting-nether,1336,warrior,arms,84,47,37
Фикпопадешь,lich-king,1336,warrior,arms,69,30,39
Iluwar,ragnaros,1335,warrior,arms,397,193,204
Bonesz,jaedenar,1334,warrior,arms,141,71,70
Dirtyjoe,khaz-modan,1333,warrior,arms,246,124,122
Isenstrider,burning-legion,1333,warrior,arms,30,14,16
Critwar,silvermoon,1333,warrior,arms,54,25,29
Brokenqt,ravencrest,1332,warrior,arms,27,16,11
Шизам,howling-fjord,1332,warrior,arms,54,20,34
Флэксик,soulflayer,1331,warrior,arms,24,14,10
Carljøhnson,dalaran,1331,warrior,arms,290,136,154
Rutch,hyjal,1331,warrior,arms,42,18,24
Kalregg,outland,1331,warrior,arms,48,19,29
Bovingus,tarren-mill,1330,warrior,arms,24,16,8
Aiarm,twisting-nether,1330,warrior,arms,192,104,88
Pezuñaloca,shendralar,1330,warrior,arms,60,31,29
Sugmanutz,argent-dawn,1329,warrior,arms,24,14,10
Agamemnon,frostmane,1328,warrior,arms,32,19,13
Shádówfáxí,outland,1328,warrior,arms,30,14,16
Haewon,burning-legion,1328,warrior,arms,42,16,26
Behemothwr,kazzak,1327,warrior,arms,75,37,38
Leopoldx,outland,1326,warrior,arms,40,21,19
Oneshót,norgannon,1326,warrior,arms,71,36,35
Flawla,blackmoore,1326,warrior,arms,30,14,16
Wargak,stormscale,1326,warrior,arms,30,14,16
Maidenlless,ravencrest,1326,warrior,arms,134,61,73
Swefy,sanguino,1326,warrior,arms,139,62,77
Xsann,argent-dawn,1326,warrior,arms,36,16,20
Smashtv,ragnaros,1326,warrior,arms,36,15,21
Vagor,aegwynn,1325,warrior,arms,102,49,53
Iuska,malganis,1325,warrior,arms,54,21,33
Zuchtrind,blackrock,1324,warrior,arms,48,29,19
Bxnx,aegwynn,1324,warrior,arms,42,23,19
Äzathoth,silvermoon,1324,warrior,arms,30,14,16
Mortalik,silvermoon,1324,warrior,arms,166,77,89
Highz,grim-batol,1323,warrior,arms,36,18,18
Безбожник,eversong,1322,warrior,arms,60,33,27
Franzbardon,archimonde,1322,warrior,arms,196,95,101
Лютобор,gordunni,1322,warrior,arms,39,16,23
Frankius,ravencrest,1321,warrior,arms,30,14,16
Raixxon,ragnaros,1321,warrior,arms,109,49,60
Ashiku,zuljin,1321,warrior,arms,54,23,31
Throck,drakthul,1320,warrior,arms,41,18,23
Мобсто,soulflayer,1320,warrior,arms,53,23,30
Swaxx,ravencrest,1320,warrior,arms,36,14,22
Tealbell,chamber-of-aspects,1319,warrior,arms,143,71,72
Razoo,stormscale,1319,warrior,arms,60,23,37
Kianit,ravencrest,1318,warrior,arms,231,110,121
Krigarjag,kazzak,1317,warrior,arms,35,20,15
Martøswarr,uldum,1317,warrior,arms,30,14,16
Narkololzz,marécage-de-zangar,1317,warrior,arms,80,37,43
Grimhew,argent-dawn,1317,warrior,arms,42,17,25
Kilsorrow,silvermoon,1317,warrior,arms,42,14,28
Dreamkil,archimonde,1316,warrior,arms,205,106,99
Zhenshii,blackmoore,1316,warrior,arms,42,21,21
Gintonnic,sanguino,1316,warrior,arms,36,18,18
Papipulki,zuljin,1316,warrior,arms,86,35,51
Astven,blackmoore,1316,warrior,arms,40,16,24
Ральдвин,gordunni,1315,warrior,arms,77,43,34
Guruntar,kirin-tor,1315,warrior,arms,62,29,33
Ríta,silvermoon,1315,warrior,arms,30,14,16
Chrekk,khaz-modan,1315,warrior,arms,30,14,16
Ангрол,grom,1315,warrior,arms,47,20,27
Ràgnarok,chogall,1314,warrior,arms,72,39,33
Ragark,quelthalas,1314,warrior,arms,111,59,52
Bleckwarrior,ravencrest,1314,warrior,arms,96,46,50
Kmica,khadgar,1314,warrior,arms,61,27,34
Equality,ragnaros,1314,warrior,arms,58,25,33
Дагмар,howling-fjord,1314,warrior,arms,36,14,22
Blitz,archimonde,1313,warrior,arms,24,14,10
Eekz,haomarush,1313,warrior,arms,36,19,17
Lácrima,dun-modr,1313,warrior,arms,36,18,18
Oceangg,silvermoon,1312,warrior,arms,39,16,23
Evilrage,ravencrest,1311,warrior,arms,41,25,16
Ankzz,archimonde,1311,warrior,arms,36,21,15
Кентаныч,howling-fjord,1311,warrior,arms,56,28,28
Deckluhm,sinstralis,1311,warrior,arms,36,17,19
Оморальный,soulflayer,1311,warrior,arms,88,39,49
Nicperh,dun-modr,1310,warrior,arms,72,32,40
Тандэр,borean-tundra,1310,warrior,arms,36,15,21
Megatronman,ravencrest,1309,warrior,arms,24,14,10
Tyragon,thrall,1309,warrior,arms,40,23,17
Roctah,auchindoun,1309,warrior,arms,46,24,22
Матумбо,gordunni,1309,warrior,arms,38,16,22
Сырилисуп,soulflayer,1308,warrior,arms,68,37,31
Lø,chogall,1308,warrior,arms,65,32,33
Yolal,twisting-nether,1308,warrior,arms,72,34,38
Kronstris,veklor,1308,warrior,arms,36,16,20
Gamöra,kirin-tor,1307,warrior,arms,60,28,32
Aomen,ravencrest,1306,warrior,arms,24,15,9
Rajä,anubarak,1306,warrior,arms,36,15,21
Lûckystríké,blackmoore,1305,warrior,arms,52,25,27
Thisguyfax,the-venture-co,1304,warrior,arms,66,34,32
Foxaz,burning-legion,1304,warrior,arms,66,33,33
Ludjack,tarren-mill,1304,warrior,arms,39,18,21
Мэднас,howling-fjord,1304,warrior,arms,66,28,38
Sixteen,darkmoon-faire,1303,warrior,arms,24,14,10
Glørïn,hyjal,1303,warrior,arms,66,32,34
Zosska,burning-legion,1302,warrior,arms,81,36,45
Fàlconry,kazzak,1302,warrior,arms,120,51,69
Halsandre,hyjal,1302,warrior,arms,60,23,37
Jastreb,blackrock,1302,warrior,arms,48,14,34
Bossít,doomhammer,1301,warrior,arms,80,44,36
Ragnacore,ravencrest,1301,warrior,arms,53,29,24
Geraltf,tarren-mill,1301,warrior,arms,137,65,72
Tazdingowar,antonidas,1301,warrior,arms,58,23,35
Zeldaixi,twisting-nether,1300,warrior,arms,34,19,15
Katxirulo,tyrande,1300,warrior,arms,72,34,38
Staribrko,outland,1300,warrior,arms,236,111,125
Lepka,drakthul,1300,warrior,arms,30,14,16
Kaidewarr,kazzak,1299,warrior,arms,24,16,8
Bolski,ravencrest,1299,warrior,arms,70,38,32
Shuraj,hyjal,1299,warrior,arms,46,24,22
Neekero,burning-legion,1299,warrior,arms,82,38,44
Borga,blackrock,1297,warrior,arms,42,19,23
Atlantia,ravencrest,1297,warrior,arms,42,15,27
Cárbo,silvermoon,1296,warrior,arms,73,40,33
Рестат,soulflayer,1296,warrior,arms,143,61,82
Sertigan,dun-modr,1296,warrior,arms,44,17,27
Армсец,howling-fjord,1296,warrior,arms,42,16,26
Seliasbro,kazzak,1295,warrior,arms,30,15,15
Arithael,dun-modr,1295,warrior,arms,240,118,122
Сэлфиш,lich-king,1295,warrior,arms,29,14,15
Bobloblaww,doomhammer,1295,warrior,arms,30,14,16
Knussnacker,sanguino,1295,warrior,arms,67,25,42
Chippéd,draenor,1294,warrior,arms,23,14,9
Kalarar,blackrock,1294,warrior,arms,56,19,37
Wolfgladius,cthun,1293,warrior,arms,30,15,15
Oyv,tarren-mill,1293,warrior,arms,30,15,15
Шпингалетыч,howling-fjord,1293,warrior,arms,36,14,22
Faløn,archimonde,1293,warrior,arms,62,24,38
Koliastra,magtheridon,1292,warrior,arms,48,29,19
Donátos,aegwynn,1292,warrior,arms,92,44,48
Semanor,aegwynn,1291,warrior,arms,30,16,14
Zeroskllz,outland,1291,warrior,arms,76,36,40
Iarsonn,drakthul,1291,warrior,arms,42,18,24
Inelegant,tarren-mill,1290,warrior,arms,60,32,28
Issatank,frostmane,1290,warrior,arms,60,30,30
Ghorglukk,lightnings-blade,1290,warrior,arms,60,28,32
Garganelli,tarren-mill,1290,warrior,arms,68,30,38
Elyrax,dun-modr,1290,warrior,arms,36,15,21
Брэмбур,goldrinn,1290,warrior,arms,35,14,21
Piksitron,silvermoon,1289,warrior,arms,66,40,26
Xraider,ragnaros,1289,warrior,arms,60,27,33
Euforija,kazzak,1289,warrior,arms,36,16,20
Степанычь,gordunni,1288,warrior,arms,41,22,19
Anaxiam,drakthul,1288,warrior,arms,39,17,22
Вениамин,deathweaver,1288,warrior,arms,47,15,32
Ninebites,chamber-of-aspects,1287,warrior,arms,125,63,62
Taikyokuken,hyjal,1287,warrior,arms,66,29,37
Olesbawro,ragnaros,1287,warrior,arms,90,34,56
Treze,sanguino,1287,warrior,arms,68,23,45
Gorchak,blackmoore,1286,warrior,arms,194,92,102
Vegäpunk,nemesis,1286,warrior,arms,42,19,23
Gantór,blackrock,1286,warrior,arms,54,23,31
Minoke,antonidas,1286,warrior,arms,36,15,21
Daddie,silvermoon,1286,warrior,arms,39,15,24
Unarde,silvermoon,1285,warrior,arms,227,113,114
Perkoulator,archimonde,1285,warrior,arms,93,42,51
Rayguerrero,blackrock,1285,warrior,arms,42,14,28
Soulcleaver,stormreaver,1284,warrior,arms,68,36,32
Bonnaventure,hyjal,1284,warrior,arms,102,50,52
Klanky,draenor,1284,warrior,arms,68,33,35
Dutteh,tarren-mill,1283,warrior,arms,24,15,9
Tíabeanie,silvermoon,1283,warrior,arms,30,14,16
Ylana,eldrethalas,1283,warrior,arms,111,48,63
Bluntsword,twisting-nether,1282,warrior,arms,36,17,19
Почтитайсон,howling-fjord,1282,warrior,arms,32,15,17
Brabüs,kazzak,1282,warrior,arms,56,26,30
Hatethisgame,frostwolf,1282,warrior,arms,93,42,51
Tonifox,nemesis,1281,warrior,arms,42,14,28
Fedevalverde,sanguino,1280,warrior,arms,49,32,17
Wørgenn,hyjal,1280,warrior,arms,44,23,21
Kirowarrior,silvermoon,1280,warrior,arms,72,35,37
Kloppnîx,blackmoore,1279,warrior,arms,56,34,22
Гогрикк,ashenvale,1279,warrior,arms,72,35,37
Malevolént,silvermoon,1279,warrior,arms,66,31,35
Drbanner,hyjal,1278,warrior,arms,28,16,12
Колятурбо,gordunni,1278,warrior,arms,36,19,17
Silabozija,ravencrest,1278,warrior,arms,82,41,41
Ovcharq,steamwheedle-cartel,1278,warrior,arms,73,36,37
Geckoo,emerald-dream,1278,warrior,arms,143,62,81
Lëime,ravencrest,1277,warrior,arms,48,25,23
Colosius,stormscale,1275,warrior,arms,60,36,24
Reichas,ragnaros,1275,warrior,arms,61,31,30
Pacosky,burning-legion,1275,warrior,arms,57,28,29
Kultigin,ravencrest,1275,warrior,arms,122,53,69
Dodgeslam,eredar,1275,warrior,arms,58,23,35
Contrariety,ravencrest,1274,warrior,arms,53,30,23
Mödhan,archimonde,1274,warrior,arms,88,43,45
Bhallts,tarren-mill,1274,warrior,arms,32,14,18
Xunaakt,nemesis,1273,warrior,arms,69,34,35
Kolxoz,doomhammer,1273,warrior,arms,36,15,21
Sunney,tarren-mill,1272,warrior,arms,23,14,9
Taurosk,burning-legion,1272,warrior,arms,66,31,35
Rahaaxhia,kaelthas,1271,warrior,arms,24,15,9
Nakkelam,twisting-nether,1270,warrior,arms,24,14,10
Sigmundsdotr,outland,1270,warrior,arms,54,28,26
Zøom,ysondre,1269,warrior,arms,88,46,42
Джондо,gordunni,1269,warrior,arms,30,14,16
Nårgaí,kargath,1269,warrior,arms,78,36,42
Mfull,tarren-mill,1268,warrior,arms,66,31,35
Kravaiski,argent-dawn,1267,warrior,arms,170,82,88
Âdept,tarren-mill,1267,warrior,arms,72,27,45
Погоныч,soulflayer,1264,warrior,arms,42,21,21
Дрейсен,gordunni,1264,warrior,arms,48,23,25
Aliasus,outland,1264,warrior,arms,36,16,20
Ranran,emerald-dream,1264,warrior,arms,32,14,18
Abnôrmus,tarren-mill,1262,warrior,arms,48,25,23
Rochful,frostwolf,1260,warrior,arms,42,23,19
Tozz,azuremyst,1260,warrior,arms,48,26,22
Vagor,draenor,1260,warrior,arms,46,22,24
Zool,madmortem,1260,warrior,arms,113,54,59
Téldrus,blackrock,1260,warrior,arms,42,16,26
Démigodx,stormscale,1259,warrior,arms,40,15,25
Plt,talnivarr,1258,warrior,arms,47,29,18
Razzimak,eredar,1257,warrior,arms,22,17,5
Matrafox,stormscale,1257,warrior,arms,73,34,39
Balyndâ,aegwynn,1256,warrior,arms,44,25,19
Xaqt,die-nachtwache,1255,warrior,arms,29,14,15
Maraximus,ragnaros,1255,warrior,arms,29,14,15
Narox,arathor,1255,warrior,arms,56,26,30
Buntstift,thrall,1254,warrior,arms,42,14,28
Morrzerk,sylvanas,1253,warrior,arms,35,20,15
Orcanism,nozdormu,1253,warrior,arms,65,32,33
Рейнджровер,howling-fjord,1252,warrior,arms,40,17,23
Kirus,ravencrest,1252,warrior,arms,75,31,44
Lebronjones,sylvanas,1251,warrior,arms,72,34,38
Ðræms,eldrethalas,1251,warrior,arms,89,42,47
Dicaprios,silvermoon,1250,warrior,arms,72,36,36
Phantastix,dun-modr,1249,warrior,arms,42,25,17
Фоссбро,gordunni,1249,warrior,arms,39,15,24
Бигдэмс,soulflayer,1248,warrior,arms,30,13,17
Wetrx,stormscale,1247,warrior,arms,18,13,5
Midnightrain,archimonde,1247,warrior,arms,24,13,11
Daymio,twisting-nether,1247,warrior,arms,30,13,17
Kásúxøxøw,ravencrest,1247,warrior,arms,30,13,17
Aixer,archimonde,1247,warrior,arms,30,13,17
Hellspin,argent-dawn,1247,warrior,arms,42,18,24
Sfarpi,burning-legion,1246,warrior,arms,66,38,28
Aggamemnus,ravencrest,1246,warrior,arms,68,38,30
Hirurg,thrall,1246,warrior,arms,24,13,11
Бигдэм,howling-fjord,1246,warrior,arms,24,13,11
Kardinell,blackhand,1246,warrior,arms,66,30,36
Cavo,drakthul,1246,warrior,arms,30,13,17
Sponkss,tarren-mill,1246,warrior,arms,30,13,17
Shará,eredar,1246,warrior,arms,114,49,65
Luunk,ravencrest,1245,warrior,arms,78,43,35
Atus,dun-modr,1245,warrior,arms,77,38,39
Grinrok,thrall,1245,warrior,arms,78,36,42
Ken,twisting-nether,1245,warrior,arms,46,14,32
Джагенвард,soulflayer,1244,warrior,arms,42,22,20
Garosh,drakthul,1244,warrior,arms,66,33,33
Weezing,argent-dawn,1244,warrior,arms,48,18,30
Nazgrosh,burning-legion,1244,warrior,arms,36,13,23
Rhazeél,blackrock,1243,warrior,arms,18,13,5
Kiriwarr,dun-modr,1243,warrior,arms,24,13,11
Zaerna,draenor,1243,warrior,arms,24,13,11
Кунгфурик,soulflayer,1243,warrior,arms,30,14,16
Istenn,stormscale,1243,warrior,arms,30,13,17
Rocktastic,blackrock,1243,warrior,arms,41,16,25
Soundso,blackmoore,1242,warrior,arms,26,15,11
Narcx,kazzak,1242,warrior,arms,24,13,11
Холипротовар,fordragon,1242,warrior,arms,48,22,26
Átlás,blackmoore,1242,warrior,arms,43,19,24
Arowbaze,archimonde,1242,warrior,arms,30,13,17
Akáme,frostwolf,1242,warrior,arms,66,24,42
Bhallts,twisting-nether,1242,warrior,arms,36,13,23
Notvisionary,ravencrest,1241,warrior,arms,24,13,11
Kekrah,burning-legion,1241,warrior,arms,30,13,17
Eyeslicer,quelthalas,1241,warrior,arms,30,13,17
Cárlsberg,pozzo-delleternità,1241,warrior,arms,58,24,34
Jaru,alleria,1240,warrior,arms,57,30,27
Kookwr,aggra-português,1240,warrior,arms,36,13,23
Отключатель,howling-fjord,1239,warrior,arms,23,14,9
Donfidel,tarren-mill,1239,warrior,arms,24,13,11
Zappstorm,frostwolf,1238,warrior,arms,31,17,14
Fiveboy,tarren-mill,1238,warrior,arms,24,13,11
Randix,antonidas,1238,warrior,arms,24,13,11
Faustà,nemesis,1238,warrior,arms,102,40,62
Xlings,auchindoun,1238,warrior,arms,48,15,33
Jésusiskíng,amanthul,1237,warrior,arms,24,13,11
Rorix,blackrock,1237,warrior,arms,24,13,11
Redow,stormreaver,1237,warrior,arms,52,20,32
Fractale,kirin-tor,1236,warrior,arms,22,14,8
Smackaroon,draenor,1235,warrior,arms,24,13,11
Krodunn,argent-dawn,1235,warrior,arms,29,13,16
Earshy,ragnaros,1234,warrior,arms,24,13,11
Serakhan,argent-dawn,1234,warrior,arms,90,46,44
Братишкаа,gordunni,1234,warrior,arms,53,21,32
Batalius,dalaran,1234,warrior,arms,36,14,22
Imorphius,silvermoon,1234,warrior,arms,36,13,23
Funknîco,wrathbringer,1233,warrior,arms,37,19,18
Drahtalger,hyjal,1233,warrior,arms,30,13,17
Joewahl,ragnaros,1233,warrior,arms,48,15,33
Szelenamoon,outland,1232,warrior,arms,32,14,18
Khilax,ragnaros,1231,warrior,arms,73,38,35
Waegon,twisting-nether,1230,warrior,arms,30,13,17
Vymd,archimonde,1230,warrior,arms,34,14,20
Lûxn,silvermoon,1229,warrior,arms,187,93,94
Xennor,argent-dawn,1229,warrior,arms,30,13,17
Cramatao,shadowsong,1229,warrior,arms,59,25,34
Huuln,outland,1229,warrior,arms,38,14,24
Кимиюки,gordunni,1228,warrior,arms,62,28,34
Thehans,grim-batol,1228,warrior,arms,44,18,26
Gunga,ravenholdt,1227,warrior,arms,24,13,11
Colq,doomhammer,1227,warrior,arms,41,18,23
Leàn,nemesis,1226,warrior,arms,36,13,23
Mifuune,argent-dawn,1225,warrior,arms,43,23,20
Элейд,thermaplugg,1225,warrior,arms,47,23,24
Синнэр,blackscar,1225,warrior,arms,36,13,23
Izestyi,blackrock,1224,warrior,arms,90,39,51
Larrydankin,draenor,1224,warrior,arms,78,30,48
Sphínxx,malfurion,1223,warrior,arms,38,16,22
Solaría,garona,1222,warrior,arms,30,15,15
Mysteryman,defias-brotherhood,1222,warrior,arms,83,41,42
Energo,drakthul,1222,warrior,arms,36,17,19
Slaughteredd,kazzak,1222,warrior,arms,66,27,39
Krigsdunken,draenor,1221,warrior,arms,87,40,47
Orwêll,uldum,1221,warrior,arms,122,55,67
Worstplàyer,tarren-mill,1221,warrior,arms,30,13,17
Gachiwarri,blackhand,1221,warrior,arms,30,13,17
Bulduzer,kazzak,1221,warrior,arms,71,30,41
Gèrralt,hyjal,1221,warrior,arms,41,16,25
Garthro,antonidas,1221,warrior,arms,36,14,22
Reb,thunderhorn,1220,warrior,arms,24,13,11
Goldenward,silvermoon,1220,warrior,arms,42,21,21
Draleckx,sanguino,1220,warrior,arms,148,70,78
Nixtor,defias-brotherhood,1220,warrior,arms,61,25,36
Mesmash,uldum,1220,warrior,arms,36,13,23
Клайминг,soulflayer,1219,warrior,arms,48,29,19
Reezax,blackrock,1219,warrior,arms,24,14,10
Maggisauce,aegwynn,1218,warrior,arms,100,54,46
Bigtulipe,archimonde,1218,warrior,arms,59,30,29
Jisoowar,blackhand,1217,warrior,arms,54,23,31
Dianâ,der-abyssische-rat,1216,warrior,arms,30,16,14
Lazaza,tarren-mill,1216,warrior,arms,30,13,17
Ismellurfeet,ravencrest,1215,warrior,arms,24,14,10
Zuggizug,draenor,1215,warrior,arms,60,30,30
Ghostwarx,blackmoore,1215,warrior,arms,38,19,19
Sudosolo,burning-blade,1215,warrior,arms,78,38,40
Despacitus,burning-legion,1215,warrior,arms,53,20,33
Kriticah,sanguino,1215,warrior,arms,36,13,23
Crocbait,ravencrest,1214,warrior,arms,36,19,17
Khalghara,dun-modr,1214,warrior,arms,36,14,22
Gallows,blackmoore,1214,warrior,arms,36,13,23
Ckx,kazzak,1213,warrior,arms,26,16,10
Дрейтон,eversong,1213,warrior,arms,58,31,27
Shihoh,blackhand,1213,warrior,arms,124,50,74
Calel,ravencrest,1213,warrior,arms,38,14,24
Киефси,howling-fjord,1212,warrior,arms,66,38,28
Sway,eonar,1212,warrior,arms,120,57,63
Ферхар,galakrond,1211,warrior,arms,30,18,12
Бруталдэз,deathguard,1211,warrior,arms,36,13,23
Voidteen,argent-dawn,1210,warrior,arms,30,13,17
Robsuéy,blackmoore,1210,warrior,arms,72,23,49
Tabboonishka,draenor,1209,warrior,arms,22,14,8
Thunderage,stormscale,1209,warrior,arms,30,14,16
Asmongnome,ravencrest,1208,warrior,arms,24,13,11
Nurychïc,twisting-nether,1208,warrior,arms,45,24,21
Рагнарг,goldrinn,1207,warrior,arms,48,26,22
Donetenk,silvermoon,1206,warrior,arms,32,16,16
Karden,doomhammer,1206,warrior,arms,68,29,39
Delenia,twisting-nether,1205,warrior,arms,55,26,29
Крешер,howling-fjord,1205,warrior,arms,93,43,50
Crotoss,ravencrest,1205,warrior,arms,37,17,20
Rhonack,ragnaros,1205,warrior,arms,50,20,30
Pawn,twisting-nether,1204,warrior,arms,36,14,22
Protecc,burning-legion,1203,warrior,arms,68,31,37
Totalterror,ragnaros,1203,warrior,arms,72,31,41
Frézzér,blackrock,1203,warrior,arms,33,14,19
Excutíé,twisting-nether,1202,warrior,arms,30,18,12
Cecill,silvermoon,1202,warrior,arms,29,17,12
Крахгал,soulflayer,1201,warrior,arms,159,80,79
Exot,eredar,1200,warrior,arms,60,30,30
Rikistrike,tarren-mill,1200,warrior,arms,40,18,22
Thylegorn,argent-dawn,1199,warrior,arms,25,16,9
Skyowner,twisting-nether,1199,warrior,arms,27,14,13
Mañtís,argent-dawn,1198,warrior,arms,80,41,39
Clashblood,outland,1198,warrior,arms,27,13,14
Данилатитич,howling-fjord,1198,warrior,arms,57,27,30
Buffettleapx,kazzak,1198,warrior,arms,50,21,29
Rayeron,sanguino,1198,warrior,arms,39,16,23
Vlader,dun-modr,1198,warrior,arms,66,26,40
Ксапур,soulflayer,1198,warrior,arms,36,14,22
Tontonsmoky,hyjal,1197,warrior,arms,94,43,51
Mozterwar,ravencrest,1197,warrior,arms,66,28,38
Mllmmxxm,kargath,1197,warrior,arms,36,13,23
Arouga,blackrock,1196,warrior,arms,21,13,8
Brondir,archimonde,1196,warrior,arms,29,14,15
Sandalwood,wildhammer,1195,warrior,arms,27,16,11
Berserkpwnz,silvermoon,1194,warrior,arms,60,32,28
Nøiir,malfurion,1194,warrior,arms,30,15,15
Агамемнан,soulflayer,1194,warrior,arms,200,95,105
Horsewarrior,stormscale,1194,warrior,arms,29,13,16
Rèâpèr,kazzak,1193,warrior,arms,42,27,15
Wutend,nemesis,1190,warrior,arms,23,13,10
Opseagull,defias-brotherhood,1189,warrior,arms,30,15,15
Kllinac,kazzak,1189,warrior,arms,71,33,38
Anaerion,argent-dawn,1189,warrior,arms,29,13,16
Kerisandra,silvermoon,1188,warrior,arms,37,22,15
Лысыч,gordunni,1188,warrior,arms,33,17,16
Korvjnus,burning-blade,1186,warrior,arms,42,20,22
Pyret,outland,1185,warrior,arms,40,14,26
Enface,ragnaros,1184,warrior,arms,28,14,14
Epepseyer,sanguino,1184,warrior,arms,30,14,16
Górut,zuljin,1184,warrior,arms,39,17,22
Scrèàm,tarren-mill,1184,warrior,arms,67,29,38
Gathika,arathor,1183,warrior,arms,24,14,10
Pegazón,outland,1182,warrior,arms,45,18,27
Kriegerkraut,silvermoon,1180,warrior,arms,28,21,7
Neltharon,silvermoon,1179,warrior,arms,27,17,10
Disturbance,eredar,1178,warrior,arms,36,17,19
Chilp,archimonde,1178,warrior,arms,73,30,43
Crook,doomhammer,1178,warrior,arms,72,28,44
Radîtz,blackmoore,1177,warrior,arms,32,15,17
Виднокрай,gordunni,1177,warrior,arms,36,13,23
Аузерг,soulflayer,1175,warrior,arms,27,13,14
Beans,argent-dawn,1175,warrior,arms,102,42,60
Tempii,ragnaros,1175,warrior,arms,36,13,23
Elyalol,ragnaros,1174,warrior,arms,33,15,18
Etelä,stormreaver,1172,warrior,arms,37,17,20
Harska,ragnaros,1171,warrior,arms,53,27,26
Wyshh,silvermoon,1171,warrior,arms,119,57,62
Wâtchmefear,blackrock,1171,warrior,arms,33,14,19
Cremas,cthun,1171,warrior,arms,84,33,51
Muetzchen,blackhand,1170,warrior,arms,48,27,21
Wyes,kazzak,1170,warrior,arms,34,13,21
Gilettepenge,draenor,1169,warrior,arms,121,59,62
Warriornrv,ysondre,1169,warrior,arms,51,23,28
Imora,silvermoon,1169,warrior,arms,54,22,32
Белриэль,gordunni,1169,warrior,arms,66,24,42
Бавовник,howling-fjord,1169,warrior,arms,38,13,25
Роккар,gordunni,1168,warrior,arms,42,22,20
Атон,gordunni,1168,warrior,arms,80,35,45
Ordínaryname,blackrock,1166,warrior,arms,478,245,233
Whàtsup,stormscale,1166,warrior,arms,36,17,19
Sistabossen,magtheridon,1165,warrior,arms,24,13,11
Галактозар,soulflayer,1165,warrior,arms,126,56,70
Daguangming,outland,1165,warrior,arms,59,23,36
Râsk,kazzak,1162,warrior,arms,26,15,11
Parasite,the-maelstrom,1161,warrior,arms,36,19,17
Mågne,tarren-mill,1160,warrior,arms,42,16,26
Слуфен,galakrond,1158,warrior,arms,24,14,10
Claytøn,khaz-modan,1158,warrior,arms,55,25,30
Regna,eredar,1157,warrior,arms,90,42,48
Rühlsbester,thrall,1154,warrior,arms,71,31,40
Tommia,burning-legion,1154,warrior,arms,30,13,17
Акнаранд,soulflayer,1152,warrior,arms,18,12,6
Devìlscandy,stormscale,1152,warrior,arms,18,12,6
Belfodiris,stormscale,1152,warrior,arms,18,12,6
Azotz,archimonde,1152,warrior,arms,24,12,12
Uselessblâme,archimonde,1152,warrior,arms,24,12,12
Porsea,ravencrest,1152,warrior,arms,24,12,12
Taÿ,stormscale,1152,warrior,arms,24,12,12
Hellthõr,silvermoon,1152,warrior,arms,48,19,29
Shinnok,stormreaver,1151,warrior,arms,48,33,15
Jethiss,ravencrest,1151,warrior,arms,18,12,6
Tranqtum,ravencrest,1151,warrior,arms,31,12,19
Wutraa,kazzak,1150,warrior,arms,18,12,6
Jackzx,twisting-nether,1150,warrior,arms,18,12,6
Zidbi,argent-dawn,1150,warrior,arms,24,12,12
Crazykind,kazzak,1150,warrior,arms,24,12,12
Astrid,rajaxx,1150,warrior,arms,27,13,14
Warmegedon,frostmane,1149,warrior,arms,18,12,6
Hoggle,runetotem,1149,warrior,arms,76,43,33
Crushonyou,aegwynn,1149,warrior,arms,24,12,12
Azjolnerub,kazzak,1149,warrior,arms,30,12,18
Kâine,blackmoore,1149,warrior,arms,68,27,41
ßigarms,ravencrest,1148,warrior,arms,18,12,6
Kampfente,blackrock,1148,warrior,arms,18,12,6
Соловейч,howling-fjord,1148,warrior,arms,24,13,11
Jonalina,gilneas,1148,warrior,arms,84,42,42
Chillycheesy,blackmoore,1148,warrior,arms,42,12,30
Razyk,zuljin,1147,warrior,arms,22,14,8
Zwerk,rajaxx,1147,warrior,arms,24,12,12
Хирошка,gordunni,1147,warrior,arms,30,12,18
Neoh,onyxia,1146,warrior,arms,51,29,22
Ragedotcom,archimonde,1146,warrior,arms,30,16,14
Draemmer,minahonda,1146,warrior,arms,30,15,15
Senshin,sanguino,1146,warrior,arms,24,12,12
Ragetotem,doomhammer,1146,warrior,arms,24,12,12
Ashecröft,sylvanas,1146,warrior,arms,30,12,18
Rieku,kazzak,1146,warrior,arms,36,12,24
Totenkrieger,draenor,1145,warrior,arms,24,12,12
Gerrmund,silvermoon,1145,warrior,arms,24,12,12
Argadea,archimonde,1145,warrior,arms,42,19,23
Belzebud,kazzak,1145,warrior,arms,36,12,24
Orgi,drakthul,1145,warrior,arms,36,12,24
Aesiva,die-aldor,1144,warrior,arms,30,13,17
Whimbux,stormscale,1144,warrior,arms,32,13,19
Garodis,blackmoore,1144,warrior,arms,30,12,18
Smashu,outland,1143,warrior,arms,18,12,6
Karnacîer,archimonde,1143,warrior,arms,30,19,11
Sephirotth,burning-legion,1142,warrior,arms,24,12,12
Kurzen,voljin,1142,warrior,arms,65,28,37
Brahlus,frostwolf,1142,warrior,arms,31,13,18
Футжисубо,razuvious,1142,warrior,arms,30,12,18
Monsterborn,bloodhoof,1142,warrior,arms,39,15,24
Freestýlz,archimonde,1141,warrior,arms,18,13,5
Auroree,ragnaros,1141,warrior,arms,30,12,18
Онлихелл,howling-fjord,1140,warrior,arms,52,22,30
Alphachadwar,azjolnerub,1140,warrior,arms,30,12,18
Ironsteve,blackmoore,1139,warrior,arms,225,100,125
Realstars,tichondrius,1139,warrior,arms,33,13,20
Анманерка,ashenvale,1137,warrior,arms,30,12,18
Баварриор,greymane,1137,warrior,arms,30,12,18
Kromt,shendralar,1136,warrior,arms,24,15,9
Dödslängtan,terokkar,1136,warrior,arms,46,25,21
Azëlls,archimonde,1136,warrior,arms,100,48,52
Mkazy,kirin-tor,1135,warrior,arms,24,12,12
Addy,twisting-nether,1135,warrior,arms,24,12,12
Shehalk,stormscale,1134,warrior,arms,18,12,6
Xyum,pozzo-delleternità,1133,warrior,arms,72,40,32
Vandnox,nozdormu,1133,warrior,arms,28,13,15
Xensation,kult-der-verdammten,1131,warrior,arms,24,12,12
Medov,outland,1131,warrior,arms,54,23,31
Kratosgr,defias-brotherhood,1129,warrior,arms,24,12,12
Cloudstomper,ravenholdt,1129,warrior,arms,53,23,30
Kugghalfswor,doomhammer,1128,warrior,arms,352,169,183
Katyparry,ragnaros,1127,warrior,arms,36,12,24
Tajiri,alakir,1126,warrior,arms,64,32,32
Gladiattus,drakthul,1126,warrior,arms,42,21,21
Varzeluu,sylvanas,1126,warrior,arms,36,15,21
Сифончик,ashenvale,1126,warrior,arms,30,12,18
Methaniwths,twisting-nether,1125,warrior,arms,42,17,25
Nøøbisator,archimonde,1123,warrior,arms,36,17,19
Пифс,soulflayer,1122,warrior,arms,36,21,15
Yüle,uldaman,1121,warrior,arms,30,15,15
Piedbot,archimonde,1121,warrior,arms,51,18,33
Pøps,hyjal,1120,warrior,arms,26,14,12
Truxiw,silvermoon,1120,warrior,arms,42,19,23
Infusione,nemesis,1119,warrior,arms,18,12,6
Madsizen,ravencrest,1119,warrior,arms,30,12,18
Satanås,silvermoon,1118,warrior,arms,48,25,23
Hofftor,eredar,1118,warrior,arms,24,12,12
Thiccrich,argent-dawn,1117,warrior,arms,48,25,23
Hammerfall,uldum,1117,warrior,arms,54,23,31
Creezê,blackmoore,1117,warrior,arms,30,12,18
Draktul,aegwynn,1116,warrior,arms,24,14,10
Мутобой,soulflayer,1116,warrior,arms,58,25,33
Loosecanon,ravencrest,1116,warrior,arms,29,12,17
Palthor,drakthul,1116,warrior,arms,101,39,62
Vurux,blackrock,1114,warrior,arms,20,13,7
Ärama,sanguino,1114,warrior,arms,30,16,14
Thorkell,genjuros,1114,warrior,arms,30,15,15
Arinator,les-sentinelles,1114,warrior,arms,39,13,26
Diggawhat,antonidas,1109,warrior,arms,78,31,47
Sûgma,blackhand,1108,warrior,arms,44,23,21
Noomel,twisting-nether,1108,warrior,arms,96,48,48
Nyu,kirin-tor,1106,warrior,arms,35,19,16
Smeshh,burning-legion,1105,warrior,arms,42,22,20
Quarantino,ysondre,1105,warrior,arms,110,49,61
Doveloo,kazzak,1104,warrior,arms,31,16,15
Ruppydeluxe,frostwolf,1104,warrior,arms,38,13,25
Inticam,durotan,1103,warrior,arms,43,24,19
Prs,defias-brotherhood,1103,warrior,arms,24,12,12
Миранир,soulflayer,1102,warrior,arms,62,30,32
Røiivar,hyjal,1102,warrior,arms,169,74,95
Керсантус,gordunni,1101,warrior,arms,17,12,5
Dübèl,blackrock,1100,warrior,arms,30,16,14
Доминатори,grom,1100,warrior,arms,55,21,34
Tiopollo,sanguino,1099,warrior,arms,30,12,18
Rutrah,ysondre,1099,warrior,arms,30,12,18
Фастод,greymane,1098,warrior,arms,66,30,36
Zarad,stormreaver,1096,warrior,arms,23,12,11
Crixusxx,sanguino,1096,warrior,arms,25,13,12
Whitebêârd,antonidas,1096,warrior,arms,40,16,24
Fdmachine,kazzak,1095,warrior,arms,48,21,27
Набосуюногу,gordunni,1095,warrior,arms,29,12,17
Vannié,blackhand,1094,warrior,arms,32,14,18
Тонкрик,goldrinn,1093,warrior,arms,30,14,16
Sloppychoppy,silvermoon,1093,warrior,arms,47,19,28
Чухануспрайм,howling-fjord,1093,warrior,arms,34,13,21
Crasher,dentarg,1091,warrior,arms,42,21,21
Копенгаген,ashenvale,1091,warrior,arms,33,13,20
Бижек,gordunni,1085,warrior,arms,20,12,8
Krostapunk,colinas-pardas,1085,warrior,arms,30,13,17
Бежа,gordunni,1083,warrior,arms,66,37,29
Bullburzt,ragnaros,1083,warrior,arms,29,12,17
Uclat,archimonde,1082,warrior,arms,96,42,54
Zogyall,ysondre,1079,warrior,arms,30,12,18
Ezsnacks,blackrock,1078,warrior,arms,62,32,30
Áosr,ravencrest,1076,warrior,arms,82,42,40
Stuble,blackhand,1076,warrior,arms,41,19,22
Jebzmiecza,kazzak,1075,warrior,arms,30,13,17
Chépérøs,kaelthas,1075,warrior,arms,36,13,23
Корофер,galakrond,1072,warrior,arms,29,17,12
Teraa,the-maelstrom,1072,warrior,arms,54,30,24
Brandylover,outland,1071,warrior,arms,26,12,14
Difalco,archimonde,1069,warrior,arms,89,43,46
Joka,dun-modr,1069,warrior,arms,59,26,33
Вилькария,eversong,1067,warrior,arms,28,12,16
Optitt,dethecus,1066,warrior,arms,35,12,23
Obscurìa,argent-dawn,1065,warrior,arms,198,93,105
Diliul,doomhammer,1065,warrior,arms,40,18,22
Endermite,magtheridon,1065,warrior,arms,59,26,33
Дикийлёха,soulflayer,1064,warrior,arms,36,18,18
Etharedon,kul-tiras,1062,warrior,arms,70,28,42
Милославский,gordunni,1061,warrior,arms,52,25,27
Katzz,dun-morogh,1061,warrior,arms,44,15,29
Atelier,magtheridon,1059,warrior,arms,48,24,24
Keksparrow,antonidas,1059,warrior,arms,36,16,20
Рексторм,soulflayer,1056,warrior,arms,12,11,1
Klnrk,ravencrest,1056,warrior,arms,18,11,7
Proeliator,argent-dawn,1056,warrior,arms,24,11,13
Magmos,terenas,1056,warrior,arms,24,11,13
Êphêý,kazzak,1056,warrior,arms,24,11,13
Tyrasia,hyjal,1056,warrior,arms,24,11,13
Recklesnes,kazzak,1056,warrior,arms,30,11,19
Gotural,ravencrest,1055,warrior,arms,12,11,1
Ufu,outland,1055,warrior,arms,18,11,7
Sanerion,antonidas,1055,warrior,arms,18,11,7
Hannìbal,ravencrest,1055,warrior,arms,18,11,7
Тарартзу,soulflayer,1055,warrior,arms,18,11,7
Анархорок,howling-fjord,1055,warrior,arms,18,11,7
Détaire,archimonde,1055,warrior,arms,18,11,7
Maisner,stormscale,1055,warrior,arms,21,12,9
Justyòqt,archimonde,1055,warrior,arms,24,11,13
Quotxwar,stormscale,1055,warrior,arms,24,11,13
Bikgusdickus,drakthul,1055,warrior,arms,24,11,13
Лимор,howling-fjord,1055,warrior,arms,24,11,13
Taoke,ravencrest,1055,warrior,arms,24,11,13
Амаззони,howling-fjord,1055,warrior,arms,24,11,13
Falconer,ravencrest,1055,warrior,arms,36,11,25
Beanzz,blackmoore,1054,warrior,arms,18,11,7
Ramlosa,stormscale,1054,warrior,arms,18,11,7
Imglad,ragnaros,1054,warrior,arms,18,11,7
Tiimbs,tarren-mill,1054,warrior,arms,18,11,7
Gorelaw,turalyon,1054,warrior,arms,24,11,13
Багрон,goldrinn,1054,warrior,arms,24,11,13
Trohr,blackmoore,1054,warrior,arms,24,11,13
Râmi,perenolde,1054,warrior,arms,24,11,13
Chàrgex,blackrock,1054,warrior,arms,27,12,15
Apollos,der-mithrilorden,1054,warrior,arms,30,11,19
Guter,kazzak,1054,warrior,arms,30,11,19
Сабствер,howling-fjord,1054,warrior,arms,30,11,19
Vallenwar,twisting-nether,1053,warrior,arms,18,11,7
Astost,silvermoon,1053,warrior,arms,18,11,7
Fullkraft,tarren-mill,1053,warrior,arms,60,29,31
Skaylulz,ragnaros,1053,warrior,arms,24,11,13
Khoroc,die-aldor,1053,warrior,arms,30,11,19
Scusi,burning-blade,1053,warrior,arms,30,11,19
Amarthon,sylvanas,1053,warrior,arms,33,12,21
Salamandar,zenedar,1053,warrior,arms,36,11,25
Polak,tirion,1052,warrior,arms,24,11,13
Каутто,howling-fjord,1052,warrior,arms,24,11,13
Opticsynfel,argent-dawn,1052,warrior,arms,24,11,13
Artheim,silvermoon,1052,warrior,arms,24,11,13
Някитила,gordunni,1052,warrior,arms,43,18,25
Gnomekek,sylvanas,1052,warrior,arms,30,11,19
Swayzze,frostwolf,1052,warrior,arms,30,11,19
Deathwingx,azuremyst,1052,warrior,arms,33,12,21
Jamakun,magtheridon,1051,warrior,arms,18,11,7
Blackaxe,sylvanas,1051,warrior,arms,18,11,7
Deviousjr,ragnaros,1051,warrior,arms,18,11,7
Ramhadat,hyjal,1051,warrior,arms,18,11,7
Kundan,antonidas,1051,warrior,arms,24,14,10
Hgfe,doomhammer,1051,warrior,arms,24,11,13
Suksori,kazzak,1051,warrior,arms,24,11,13
Bønecleaver,blackrock,1051,warrior,arms,24,11,13
Шорпит,howling-fjord,1051,warrior,arms,66,26,40
Pwettygal,tarren-mill,1051,warrior,arms,54,21,33
Rebiy,ravencrest,1050,warrior,arms,24,11,13
Grimarg,drakthul,1050,warrior,arms,24,11,13
Chocoroko,draenor,1050,warrior,arms,48,21,27
Ironsíde,alakir,1050,warrior,arms,30,11,19
Ètc,ravencrest,1049,warrior,arms,18,11,7
Blackin,blackmoore,1049,warrior,arms,18,11,7
Bämoida,eredar,1049,warrior,arms,24,11,13
Nêithan,dun-modr,1049,warrior,arms,30,12,18
Warrmax,darksorrow,1048,warrior,arms,24,11,13
Clukao,kazzak,1047,warrior,arms,30,11,19
Darksworn,alleria,1046,warrior,arms,18,11,7
Askawar,sylvanas,1046,warrior,arms,24,11,13
Supersonîc,aegwynn,1046,warrior,arms,24,11,13
Velikan,tarren-mill,1046,warrior,arms,30,11,19
Sàt,kazzak,1045,warrior,arms,18,11,7
Roponmatsu,draenor,1045,warrior,arms,24,11,13
Ninja,bronze-dragonflight,1045,warrior,arms,24,11,13
Orquewarrior,stormscale,1045,warrior,arms,30,11,19
Perry,proudmoore,1044,warrior,arms,18,11,7
Arkcules,ghostlands,1044,warrior,arms,24,11,13
Darkwa,azjolnerub,1044,warrior,arms,24,11,13
Pitii,burning-legion,1044,warrior,arms,26,11,15
Тассэй,eversong,1044,warrior,arms,30,11,19
Masster,argent-dawn,1043,warrior,arms,18,11,7
Nocturia,archimonde,1043,warrior,arms,30,11,19
Unstorm,drakthul,1043,warrior,arms,36,11,25
Gpointt,lordaeron,1042,warrior,arms,54,19,35
Ethem,twisting-nether,1041,warrior,arms,109,59,50
Pips,minahonda,1041,warrior,arms,42,13,29
Talaganos,twisting-nether,1040,warrior,arms,31,17,14
Blufurys,nemesis,1040,warrior,arms,50,22,28
Stweye,frostmane,1038,warrior,arms,24,11,13
Nokturnâl,silvermoon,1037,warrior,arms,18,11,7
Каргром,howling-fjord,1036,warrior,arms,23,11,12
Stampsalot,deathwing,1036,warrior,arms,24,11,13
Twinblyat,defias-brotherhood,1036,warrior,arms,24,11,13
Koorkhan,outland,1036,warrior,arms,24,11,13
Ariéz,tarren-mill,1035,warrior,arms,23,12,11
Metawar,blackhand,1035,warrior,arms,30,11,19
Kval,kazzak,1034,warrior,arms,24,11,13
Ferrum,sunstrider,1033,warrior,arms,24,11,13
Wargasm,burning-blade,1032,warrior,arms,18,11,7
Глинм,gordunni,1032,warrior,arms,107,46,61
Zugpump,tarren-mill,1031,warrior,arms,22,12,10
Dardi,blackrock,1030,warrior,arms,24,11,13
Raizø,aegwynn,1030,warrior,arms,31,13,18
Brvbert,antonidas,1029,warrior,arms,24,11,13
Téarz,blackrock,1029,warrior,arms,54,20,34
Утонаган,fordragon,1029,warrior,arms,30,11,19
Beserk,defias-brotherhood,1027,warrior,arms,46,28,18
Merdé,blackhand,1027,warrior,arms,135,67,68
Cliwar,ragnaros,1026,warrior,arms,30,17,13
Fatbeard,twilights-hammer,1026,warrior,arms,24,11,13
Dariusvolt,argent-dawn,1025,warrior,arms,65,33,32
Tochka,kazzak,1024,warrior,arms,36,11,25
Lanahan,argent-dawn,1023,warrior,arms,17,11,6
Sanhaevel,ravencrest,1023,warrior,arms,33,15,18
Lakes,eredar,1023,warrior,arms,35,11,24
Carsannies,stormscale,1022,warrior,arms,121,53,68
Acestrike,defias-brotherhood,1021,warrior,arms,18,11,7
Matthaeos,nemesis,1019,warrior,arms,17,13,4
Xxoorrwarr,tarren-mill,1018,warrior,arms,25,13,12
Клавиатурный,soulflayer,1018,warrior,arms,29,11,18
Oralinde,silvermoon,1017,warrior,arms,78,43,35
Ironfists,kilrogg,1017,warrior,arms,24,11,13
Тычо,soulflayer,1016,warrior,arms,48,20,28
Troncodepino,nemesis,1016,warrior,arms,30,11,19
Tercio,exodar,1015,warrior,arms,91,38,53
Henzelhoff,stormreaver,1013,warrior,arms,16,11,5
Rabiolika,sanguino,1012,warrior,arms,23,11,12
Tobigforu,draenor,1012,warrior,arms,28,13,15
Addicty,sylvanas,1012,warrior,arms,67,31,36
Smkw,kazzak,1011,warrior,arms,30,19,11
Raldjorn,hyjal,1010,warrior,arms,24,13,11
Chatoon,elune,1010,warrior,arms,45,24,21
Shinydjuwlz,turalyon,1008,warrior,arms,18,11,7
Бейесличё,deathguard,1007,warrior,arms,27,12,15
Зарган,howling-fjord,1007,warrior,arms,59,24,35
Falcowar,minahonda,1006,warrior,arms,24,11,13
Розети,gordunni,1005,warrior,arms,23,11,12
Antraex,zuljin,1004,warrior,arms,30,13,17
Gatlok,kazzak,1001,warrior,arms,24,11,13
Dénis,onyxia,1000,warrior,arms,30,15,15
Seraphys,ravencrest,998,warrior,arms,28,12,16
Voltrim,blackmoore,995,warrior,arms,24,11,13
Gunka,tarren-mill,995,warrior,arms,56,23,33
Orchëstre,eitrigg,994,warrior,arms,155,82,73
Adrï,draenor,993,warrior,arms,70,38,32
Ezjau,blackmoore,993,warrior,arms,96,48,48
Sepsys,eredar,991,warrior,arms,48,15,33
Párta,ravencrest,990,warrior,arms,22,11,11
Knotteddickk,teldrassil,989,warrior,arms,23,11,12
Larkor,frostwolf,989,warrior,arms,79,31,48
Geicoo,dalaran,988,warrior,arms,56,29,27
Vyctimz,ravencrest,988,warrior,arms,22,11,11
Lithanør,silvermoon,984,warrior,arms,32,11,21
Odonko,blackmoore,982,warrior,arms,42,20,22
Dazed,kazzak,981,warrior,arms,26,14,12
Nélow,khaz-modan,980,warrior,arms,30,11,19
Oldhatreds,twisting-nether,979,warrior,arms,22,11,11
Fairly,burning-blade,977,warrior,arms,24,12,12
Braûsepulver,guldan,970,warrior,arms,36,17,19
Tinkley,quelthalas,969,warrior,arms,21,11,10
Ruga,echsenkessel,969,warrior,arms,61,29,32
Hammerfíst,kazzak,966,warrior,arms,83,40,43
Chipstjuven,tarren-mill,963,warrior,arms,25,11,14
Valtýr,skullcrusher,961,warrior,arms,29,17,12
Dreadshanks,doomhammer,961,warrior,arms,60,31,29
Executeme,sylvanas,961,warrior,arms,36,18,18
Bigschnäbi,blackhand,960,warrior,arms,12,10,2
Schero,aegwynn,960,warrior,arms,12,10,2
Pyrit,blackhand,960,warrior,arms,12,10,2
Wintertimex,stormscale,960,warrior,arms,12,10,2
Каоссвар,howling-fjord,960,warrior,arms,18,10,8
Broarextiger,ragnaros,960,warrior,arms,18,10,8
Jà,kazzak,960,warrior,arms,18,10,8
Milant,antonidas,960,warrior,arms,18,10,8
Joelopes,archimonde,960,warrior,arms,18,10,8
Фокатопх,blackscar,960,warrior,arms,18,10,8
Andabad,silvermoon,960,warrior,arms,24,10,14
Meovv,saurfang,960,warrior,arms,24,10,14
Belfodil,outland,960,warrior,arms,24,10,14
Trâshcârlitâ,eredar,960,warrior,arms,24,10,14
Salpaaja,tarren-mill,960,warrior,arms,24,10,14
Tomsom,sanguino,960,warrior,arms,24,10,14
Sindrener,ysondre,960,warrior,arms,30,10,20
Sereiz,tarren-mill,960,warrior,arms,30,10,20
Anahkäs,archimonde,960,warrior,arms,30,10,20
Mbappé,dragonblight,959,warrior,arms,12,10,2
Bjergo,drakthul,959,warrior,arms,16,11,5
Badwarr,blackhand,959,warrior,arms,18,10,8
Экспла,ashenvale,959,warrior,arms,18,10,8
Boonur,arthas,959,warrior,arms,18,10,8
Fearmedear,sylvanas,959,warrior,arms,18,10,8
Axxtm,ravencrest,959,warrior,arms,18,10,8
Zdi,blackrock,959,warrior,arms,18,10,8
Mocomomo,argent-dawn,959,warrior,arms,18,10,8
Ym,twisting-nether,959,warrior,arms,18,10,8
Chadgrave,argent-dawn,959,warrior,arms,18,10,8
Брюслипве,gordunni,959,warrior,arms,18,10,8
Yoñtuk,twisting-nether,959,warrior,arms,18,10,8
Najjs,eredar,959,warrior,arms,18,10,8
Duckyone,zenedar,959,warrior,arms,18,10,8
Rookian,blackrock,959,warrior,arms,24,10,14
Grdez,archimonde,959,warrior,arms,24,10,14
Оманко,howling-fjord,959,warrior,arms,24,10,14
Vlorgboi,drakthul,959,warrior,arms,24,10,14
Warhero,burning-legion,959,warrior,arms,24,10,14
Tenvee,outland,959,warrior,arms,24,10,14
Creativenot,outland,959,warrior,arms,24,10,14
Nolóve,archimonde,959,warrior,arms,24,10,14
Kryszii,ragnaros,959,warrior,arms,24,10,14
Carksn,blackmoore,959,warrior,arms,28,11,17
Péridotruite,hyjal,959,warrior,arms,30,10,20
Garou,uldum,958,warrior,arms,12,10,2
Fiverare,stormscale,958,warrior,arms,18,10,8
Shorrag,outland,958,warrior,arms,18,10,8
Darlith,azshara,958,warrior,arms,18,10,8
Hyogan,malganis,958,warrior,arms,18,10,8
Nainculay,kaelthas,958,warrior,arms,18,10,8
Rswar,archimonde,958,warrior,arms,18,10,8
Gorlemar,blackmoore,958,warrior,arms,18,10,8
Braindeady,burning-legion,958,warrior,arms,18,10,8
Krônôs,thrall,958,warrior,arms,18,10,8
Hanna,argent-dawn,958,warrior,arms,18,10,8
Xilquib,darksorrow,958,warrior,arms,18,10,8
Betonica,burning-legion,958,warrior,arms,18,10,8
Hamilton,bronzebeard,958,warrior,arms,18,10,8
Порицающий,soulflayer,958,warrior,arms,22,11,11
Ghettogødx,outland,958,warrior,arms,24,10,14
Warristyles,arygos,958,warrior,arms,24,10,14
Gruxx,ragnaros,958,warrior,arms,24,10,14
Yatõ,blackmoore,958,warrior,arms,24,10,14
Onidrake,nemesis,958,warrior,arms,24,10,14
Leapling,blackmoore,958,warrior,arms,24,10,14
Хамерртайм,goldrinn,958,warrior,arms,24,10,14
Geroldius,silvermoon,958,warrior,arms,30,10,20
Rowr,argent-dawn,958,warrior,arms,30,10,20
Adamchen,blackmoore,958,warrior,arms,30,10,20
Teljii,blackmoore,957,warrior,arms,16,11,5
Дотаветеран,soulflayer,957,warrior,arms,18,10,8
Makote,uldum,957,warrior,arms,18,10,8
Каштоуны,howling-fjord,957,warrior,arms,18,10,8
Клоузер,blackscar,957,warrior,arms,23,11,12
Draer,sanguino,957,warrior,arms,23,11,12
Becca,rexxar,957,warrior,arms,24,10,14
Grokalus,eredar,957,warrior,arms,24,10,14
Ðam,kazzak,957,warrior,arms,24,10,14
Testonator,outland,957,warrior,arms,24,10,14
Sanguìnius,nemesis,957,warrior,arms,30,10,20
Cucøriedka,burning-blade,957,warrior,arms,36,10,26
Lucasqt,magtheridon,956,warrior,arms,18,10,8
Roshas,twisting-nether,956,warrior,arms,18,10,8
Quihc,outland,956,warrior,arms,24,10,14
Utero,drakthul,956,warrior,arms,24,10,14
Асхана,howling-fjord,955,warrior,arms,18,10,8
Deanx,ragnaros,955,warrior,arms,18,10,8
Nightbeard,twisting-nether,955,warrior,arms,18,10,8
Gramrosh,eredar,955,warrior,arms,24,10,14
Onefourthree,silvermoon,955,warrior,arms,24,10,14
Xarmog,hyjal,955,warrior,arms,24,10,14
Genç,ysondre,955,warrior,arms,24,10,14
Scill,silvermoon,955,warrior,arms,30,11,19
Neíd,malganis,955,warrior,arms,30,10,20
Heavenheart,bronzebeard,954,warrior,arms,19,13,6
Smob,ragnaros,954,warrior,arms,18,10,8
Solle,blackrock,954,warrior,arms,18,10,8
Brutalz,kazzak,954,warrior,arms,18,10,8
Lapyy,drakthul,954,warrior,arms,30,16,14
Труперсила,howling-fjord,954,warrior,arms,24,10,14
Protecmoo,drakthul,954,warrior,arms,24,10,14
Ôwndbylx,aegwynn,954,warrior,arms,27,11,16
Vlajko,kazzak,954,warrior,arms,36,13,23
Yngvar,darksorrow,954,warrior,arms,30,10,20
Rukkeg,silvermoon,954,warrior,arms,30,10,20
Zelwar,drakthul,953,warrior,arms,19,13,6
Camaon,outland,953,warrior,arms,18,10,8
Spaceløl,archimonde,953,warrior,arms,24,11,13
Mangonneau,archimonde,953,warrior,arms,24,10,14
Vrokoda,quelthalas,953,warrior,arms,24,10,14
Blanchysnow,hyjal,952,warrior,arms,18,10,8
Decreased,dun-modr,952,warrior,arms,18,10,8
Ginò,stormscale,952,warrior,arms,18,10,8
Unkmòr,pozzo-delleternità,952,warrior,arms,42,22,20
Rayenna,dalaran,951,warrior,arms,12,10,2
Zerm,draenor,949,warrior,arms,18,10,8
Хьялдэргодр,deathguard,949,warrior,arms,24,10,14
Zargala,stormscale,948,warrior,arms,18,10,8
Зуботычник,gordunni,948,warrior,arms,18,10,8
Qvil,sanguino,948,warrior,arms,93,31,62
Obitron,argent-dawn,947,warrior,arms,24,10,14
Omglolnoob,magtheridon,946,warrior,arms,26,10,16
Mistawolf,ravencrest,946,warrior,arms,30,10,20
Jackycoke,blackhand,943,warrior,arms,30,10,20
Dorya,aegwynn,942,warrior,arms,23,10,13
Arschal,khaz-modan,941,warrior,arms,20,12,8
Pedergun,defias-brotherhood,940,warrior,arms,18,10,8
Илийя,razuvious,940,warrior,arms,29,10,19
Ugbruk,blackhand,938,warrior,arms,27,12,15
Иалаи,howling-fjord,934,warrior,arms,20,10,10
Pigleto,ravencrest,933,warrior,arms,45,20,25
Vooice,sylvanas,933,warrior,arms,29,10,19
Bubciu,burning-legion,932,warrior,arms,30,10,20
Välkyries,archimonde,931,warrior,arms,16,11,5
Йомхар,howling-fjord,931,warrior,arms,30,10,20
Kvanyrius,archimonde,930,warrior,arms,36,10,26
Bòónki,ravencrest,929,warrior,arms,84,38,46
Thewitcher,stormscale,928,warrior,arms,24,10,14
Ganik,malganis,927,warrior,arms,23,10,13
Arowpoint,doomhammer,925,warrior,arms,23,10,13
Тибат,howling-fjord,924,warrior,arms,23,10,13
Léonie,arakarahm,924,warrior,arms,23,10,13
Avïlîa,dalaran,922,warrior,arms,30,10,20
Dearmooses,stormscale,920,warrior,arms,36,18,18
Orcaz,eredar,920,warrior,arms,30,10,20
Shãne,ysondre,918,warrior,arms,22,10,12
Abelgf,exodar,918,warrior,arms,32,12,20
Tengriy,wildhammer,915,warrior,arms,14,11,3
Takashia,ravencrest,915,warrior,arms,22,11,11
Midgardsormr,blackrock,913,warrior,arms,23,10,13
Avgålöfvén,stormscale,912,warrior,arms,15,11,4
Rejectofrage,ragnaros,912,warrior,arms,54,24,30
Zouo,blackhand,911,warrior,arms,23,10,13
Mölntuss,emeriss,911,warrior,arms,29,10,19
Dolforden,burning-legion,907,warrior,arms,23,10,13
Durmithor,silvermoon,906,warrior,arms,35,10,25
Энлами,gordunni,905,warrior,arms,21,10,11
Zêrklatscher,lordaeron,905,warrior,arms,48,12,36
Искристый,howling-fjord,903,warrior,arms,18,11,7
Cryze,ravencrest,903,warrior,arms,21,10,11
Cowlunderowl,tarren-mill,900,warrior,arms,32,11,21
Warsky,archimonde,898,warrior,arms,36,18,18
Zalhym,archimonde,898,warrior,arms,33,10,23
Брамон,gordunni,896,warrior,arms,16,10,6
Manymen,outland,896,warrior,arms,66,27,39
Dreadstyle,burning-legion,895,warrior,arms,21,10,11
Razecraz,ysondre,894,warrior,arms,18,11,7
Rapidinhas,aggra-português,890,warrior,arms,16,10,6
Биграма,howling-fjord,890,warrior,arms,26,10,16
Tynyas,dalaran,888,warrior,arms,36,18,18
Perseó,minahonda,888,warrior,arms,54,16,38
Рагнарульв,gordunni,885,warrior,arms,14,10,4
Elendurel,outland,884,warrior,arms,17,10,7
Дотрен,galakrond,883,warrior,arms,42,20,22
Артэгиусх,blackscar,880,warrior,arms,51,19,32
Lynton,sylvanas,879,warrior,arms,25,10,15
Обиванкенобя,soulflayer,879,warrior,arms,32,10,22
Ехасе,gordunni,875,warrior,arms,22,10,12
Spartazo,turalyon,873,warrior,arms,48,18,30
Авврорра,gordunni,871,warrior,arms,54,27,27
Sangarane,archimonde,868,warrior,arms,27,14,13
Bazsika,ragnaros,865,warrior,arms,66,23,43
Warmupfirst,ravencrest,864,warrior,arms,12,9,3
Zäløøpå,kazzak,864,warrior,arms,12,9,3
Antìcìdè,ravencrest,864,warrior,arms,12,9,3
Marqinios,archimonde,864,warrior,arms,12,9,3
Jhoakim,argent-dawn,864,warrior,arms,12,9,3
Naum,draenor,864,warrior,arms,12,9,3
Drvx,twisting-nether,864,warrior,arms,12,9,3
Тьмасвятая,gordunni,864,warrior,arms,18,9,9
Precel,burning-legion,864,warrior,arms,18,9,9
Легендор,howling-fjord,864,warrior,arms,18,9,9
Melogranod,nemesis,864,warrior,arms,18,9,9
Knoutt,burning-legion,864,warrior,arms,18,9,9
Bonza,blackrock,864,warrior,arms,18,9,9
Bâyer,burning-legion,864,warrior,arms,18,9,9
Albwarr,kazzak,864,warrior,arms,18,9,9
Джамалли,howling-fjord,864,warrior,arms,18,9,9
Quadfather,kazzak,864,warrior,arms,18,9,9
Jeax,rexxar,864,warrior,arms,18,9,9
Данзетар,howling-fjord,864,warrior,arms,18,9,9
Émalkay,tarren-mill,864,warrior,arms,18,9,9
Firience,silvermoon,864,warrior,arms,18,9,9
Necrio,kazzak,864,warrior,arms,18,9,9
Donkeymeta,frostmane,864,warrior,arms,18,9,9
Zorn,blackmoore,864,warrior,arms,18,9,9
Vampviv,tarren-mill,864,warrior,arms,18,9,9
Erickson,tarren-mill,864,warrior,arms,24,9,15
Dmgsponge,stormscale,864,warrior,arms,24,9,15
Yseras,aegwynn,864,warrior,arms,24,9,15
Catrine,drakthul,864,warrior,arms,24,9,15
Сетт,howling-fjord,864,warrior,arms,24,9,15
Vikktor,doomhammer,864,warrior,arms,24,9,15
Brigitá,argent-dawn,864,warrior,arms,24,9,15
Vajira,blackrock,864,warrior,arms,24,9,15
Tenthøusand,sylvanas,864,warrior,arms,24,9,15
Спуллае,soulflayer,863,warrior,arms,12,9,3
Пиапиа,gordunni,863,warrior,arms,12,9,3
Bigbosscho,draenor,863,warrior,arms,12,9,3
Ølolo,stormscale,863,warrior,arms,12,9,3
Theolcostaud,archimonde,863,warrior,arms,18,9,9
Warbigboss,draenor,863,warrior,arms,18,9,9
Wisemanx,draenor,863,warrior,arms,18,9,9
Дейниксис,howling-fjord,863,warrior,arms,18,9,9
Bladesmiths,argent-dawn,863,warrior,arms,18,9,9
Zuuk,malganis,863,warrior,arms,18,9,9
Punisherhulk,stormscale,863,warrior,arms,18,9,9
Elpap,draenor,863,warrior,arms,18,9,9
Астерио,blackscar,863,warrior,arms,18,9,9
Kaloche,hyjal,863,warrior,arms,18,9,9
Pacheco,eredar,863,warrior,arms,21,10,11
Ajhogan,ravencrest,863,warrior,arms,24,9,15
Getjuiced,tarren-mill,863,warrior,arms,24,9,15
Øzak,outland,863,warrior,arms,24,9,15
Johnfogerty,twisting-nether,863,warrior,arms,24,9,15
Belmont,doomhammer,863,warrior,arms,24,9,15
Sanca,naxxramas,863,warrior,arms,24,9,15
Nârmøra,thrall,863,warrior,arms,24,9,15
Nyxo,argent-dawn,863,warrior,arms,30,9,21
Mecaguarro,dun-modr,862,warrior,arms,12,9,3
Adalyn,azjolnerub,862,warrior,arms,12,9,3
Ratko,blackmoore,862,warrior,arms,20,12,8
Prag,silvermoon,862,warrior,arms,22,11,11
Bedryl,burning-legion,862,warrior,arms,18,9,9
Манхув,gordunni,862,warrior,arms,18,9,9
Veeg,blackmoore,862,warrior,arms,18,9,9
Mòrdréd,kazzak,862,warrior,arms,18,9,9
Onkra,malganis,862,warrior,arms,18,9,9
Delarosa,drakthul,862,warrior,arms,18,9,9
Bekkey,lightbringer,862,warrior,arms,24,9,15
Fluffycute,blackhand,862,warrior,arms,24,9,15
Realdrdob,kazzak,862,warrior,arms,24,9,15
Vazzle,nethersturm,862,warrior,arms,30,9,21
Diablozhørs,ysondre,861,warrior,arms,12,9,3
Slowfeet,stormscale,861,warrior,arms,12,9,3
Nêgan,stormscale,861,warrior,arms,18,9,9
Legendfury,ravencrest,861,warrior,arms,18,9,9
Sax,ravencrest,861,warrior,arms,18,9,9
Axemurdererr,draenor,861,warrior,arms,18,9,9
Santorro,drakthul,861,warrior,arms,24,9,15
Amar,defias-brotherhood,861,warrior,arms,29,10,19
Bigbaduglyy,twisting-nether,861,warrior,arms,30,9,21
Bravest,ragnaros,860,warrior,arms,18,9,9
Hexzo,ravencrest,860,warrior,arms,18,9,9
Andoror,nemesis,860,warrior,arms,18,9,9
Bezark,kazzak,860,warrior,arms,18,9,9
Казырной,soulflayer,860,warrior,arms,24,9,15
Gealt,outland,860,warrior,arms,24,9,15
Woopzi,twisting-nether,860,warrior,arms,36,9,27
Dautis,dun-modr,859,warrior,arms,15,10,5
Stits,chromaggus,859,warrior,arms,18,9,9
Фогивэн,gordunni,859,warrior,arms,18,9,9
Маханхет,soulflayer,859,warrior,arms,24,9,15
Brúgar,antonidas,859,warrior,arms,24,9,15
Дрекзот,howling-fjord,858,warrior,arms,15,10,5
Crud,die-silberne-hand,858,warrior,arms,18,9,9
Ozok,blackrock,858,warrior,arms,24,9,15
Radge,hyjal,858,warrior,arms,24,9,15
Rojobull,stormscale,858,warrior,arms,24,9,15
Kronnosh,tarren-mill,857,warrior,arms,12,9,3
Варбыкмашина,howling-fjord,857,warrior,arms,18,9,9
Marcusk,thunderhorn,857,warrior,arms,24,9,15
Goragthor,thrall,856,warrior,arms,18,9,9
Raivorouva,stormreaver,856,warrior,arms,18,9,9
Chrimo,silvermoon,856,warrior,arms,30,9,21
Бравурный,gordunni,855,warrior,arms,18,9,9
Gucix,tarren-mill,855,warrior,arms,18,9,9
Wfx,kazzak,855,warrior,arms,18,9,9
Kixx,twisting-nether,855,warrior,arms,30,14,16
Pvpstyle,bloodscalp,855,warrior,arms,24,9,15
Lurádin,kargath,855,warrior,arms,24,9,15
Kreaten,chamber-of-aspects,855,warrior,arms,66,18,48
Demonraze,hyjal,854,warrior,arms,12,9,3
Discogoon,twilights-hammer,854,warrior,arms,87,32,55
Ruuster,norgannon,853,warrior,arms,30,9,21
Janeu,nozdormu,852,warrior,arms,18,9,9
Syforce,ravencrest,850,warrior,arms,18,9,9
Nakroll,sanguino,850,warrior,arms,24,9,15
Goodvibez,silvermoon,848,warrior,arms,30,9,21
Owarr,grim-batol,847,warrior,arms,12,9,3
Bashion,ghostlands,846,warrior,arms,30,10,20
Aemirage,doomhammer,842,warrior,arms,54,27,27
Badazz,thunderhorn,842,warrior,arms,24,9,15
Xienia,dun-morogh,841,warrior,arms,30,10,20
Îwar,ysondre,837,warrior,arms,42,9,33
Marciano,dalaran,835,warrior,arms,18,9,9
Discotrosan,outland,833,warrior,arms,25,9,16
Takeashower,hyjal,831,warrior,arms,20,10,10
Leesh,ravenholdt,830,warrior,arms,24,10,14
Ajgreedy,grim-batol,829,warrior,arms,23,9,14
Greeneroi,khaz-modan,829,warrior,arms,35,9,26
Overdose,anetheron,827,warrior,arms,17,10,7
Зед,blackscar,827,warrior,arms,25,13,12
Nelfx,aggra-português,822,warrior,arms,48,21,27
Рукзуф,razuvious,815,warrior,arms,11,9,2
Rødprincê,ravencrest,815,warrior,arms,15,9,6
Tanoras,kazzak,815,warrior,arms,17,9,8
Airowar,drakthul,815,warrior,arms,17,9,8
Madswarrior,tarren-mill,814,warrior,arms,17,9,8
Athérøs,outland,814,warrior,arms,23,9,14
Андервульф,booty-bay,814,warrior,arms,23,9,14
Erenowski,twisting-nether,813,warrior,arms,18,9,9
Математик,razuvious,802,warrior,arms,21,10,11
Actuallyorc,twisting-nether,799,warrior,arms,14,9,5
Слэймодх,howling-fjord,799,warrior,arms,17,9,8
Skullhammer,burning-legion,799,warrior,arms,24,9,15
Ahmedmohsen,kazzak,796,warrior,arms,20,9,11
Scud,frostwhisper,796,warrior,arms,22,9,13
Knego,ragnaros,793,warrior,arms,11,9,2
Kallor,burning-legion,793,warrior,arms,17,9,8
Fknmoo,kazzak,793,warrior,arms,24,9,15
Кейнорин,howling-fjord,789,warrior,arms,28,9,19
Finalsmasher,thrall,784,warrior,arms,42,16,26
Diolucido,shattered-hand,782,warrior,arms,19,9,10
Panduf,rashgarroth,781,warrior,arms,11,9,2
Dlstroyer,eonar,776,warrior,arms,24,10,14
Bulfwart,zuljin,768,warrior,arms,12,8,4
Éliøkor,outland,768,warrior,arms,12,8,4
Rageside,draenor,768,warrior,arms,12,8,4
Curelia,malganis,768,warrior,arms,12,8,4
Kultywator,silvermoon,768,warrior,arms,12,8,4
Steelride,silvermoon,768,warrior,arms,12,8,4
Sevenheavy,draenor,768,warrior,arms,12,8,4
Bíanco,blackrock,768,warrior,arms,12,8,4
Chíppéd,draenor,768,warrior,arms,12,8,4
Muyubu,eredar,768,warrior,arms,12,8,4
Piré,tarren-mill,768,warrior,arms,12,8,4
Shreedshot,blackmoore,768,warrior,arms,12,8,4
Отвечай,gordunni,768,warrior,arms,12,8,4
Trensexual,twisting-nether,768,warrior,arms,12,8,4
Fizé,blackmoore,768,warrior,arms,12,8,4
Бигбэйбитейп,greymane,768,warrior,arms,12,8,4
Epyøn,stormscale,768,warrior,arms,12,8,4
Liked,tarren-mill,768,warrior,arms,12,8,4
Mâlitek,archimonde,768,warrior,arms,12,8,4
Psinovich,sylvanas,768,warrior,arms,12,8,4
Bigdøngfur,archimonde,768,warrior,arms,12,8,4
Rayner,illidan,768,warrior,arms,12,8,4
Audrin,twisting-nether,768,warrior,arms,12,8,4
Beebsy,aegwynn,768,warrior,arms,12,8,4
Ballin,dragonblight,768,warrior,arms,12,8,4
Doritoslove,sanguino,768,warrior,arms,12,8,4
Эсфор,howling-fjord,768,warrior,arms,12,8,4
Wardrior,stormscale,768,warrior,arms,12,8,4
Zamorák,twisting-nether,768,warrior,arms,12,8,4
Smorccroms,stormscale,768,warrior,arms,12,8,4
Madßud,ravencrest,768,warrior,arms,14,8,6
Xdpromtius,dun-modr,768,warrior,arms,18,8,10
Hønks,antonidas,768,warrior,arms,18,8,10
Dréngr,blackrock,768,warrior,arms,18,8,10
Howdoyouløse,stormscale,768,warrior,arms,18,8,10
Styxwr,blackhand,768,warrior,arms,18,8,10
Kehnan,blackrock,768,warrior,arms,18,8,10
Dedewawa,ysondre,768,warrior,arms,18,8,10
Dreadbanga,blackmoore,768,warrior,arms,18,8,10
Vermis,stormscale,768,warrior,arms,18,8,10
Winabella,tarren-mill,768,warrior,arms,18,8,10
Borndet,eredar,768,warrior,arms,18,8,10
Arsinal,blackhand,768,warrior,arms,18,8,10
Кисямур,soulflayer,768,warrior,arms,18,8,10
Visari,kiljaeden,768,warrior,arms,18,8,10
Määh,frostmane,768,warrior,arms,18,8,10
Belmønt,archimonde,768,warrior,arms,18,8,10
Aauv,twisting-nether,768,warrior,arms,18,8,10
Груббоб,booty-bay,768,warrior,arms,18,8,10
Ваншотч,blackscar,768,warrior,arms,18,8,10
Гатсх,blackscar,768,warrior,arms,18,8,10
Caffeinë,ravencrest,768,warrior,arms,24,8,16
Elinyar,aegwynn,768,warrior,arms,24,8,16
Пробуюстерву,soulflayer,768,warrior,arms,24,8,16
Leavyu,silvermoon,768,warrior,arms,24,8,16
Galiusx,malganis,768,warrior,arms,24,8,16
Фуджитаку,gordunni,768,warrior,arms,36,8,28
Anndersen,defias-brotherhood,767,warrior,arms,12,8,4
Yoilenno,argent-dawn,767,warrior,arms,12,8,4
Atzex,blackmoore,767,warrior,arms,12,8,4
Sená,stormscale,767,warrior,arms,12,8,4
Sankuto,kazzak,767,warrior,arms,12,8,4
Pílot,ravencrest,767,warrior,arms,12,8,4
Helenius,ravencrest,767,warrior,arms,12,8,4
Kante,frostmane,767,warrior,arms,12,8,4
Alexwar,draenor,767,warrior,arms,18,8,10
Nadelicious,kazzak,767,warrior,arms,18,8,10
Recklessness,drakthul,767,warrior,arms,18,8,10
Hermosse,dalaran,767,warrior,arms,18,8,10
Kunodontas,draenor,767,warrior,arms,18,8,10
Whiteowlx,argent-dawn,767,warrior,arms,18,8,10
Litlijón,ravencrest,767,warrior,arms,18,8,10
Akim,ysondre,767,warrior,arms,18,8,10
Craíne,antonidas,767,warrior,arms,18,8,10
Warbringer,burning-blade,767,warrior,arms,18,8,10
Dtraque,kaelthas,767,warrior,arms,18,8,10
Барнаул,gordunni,767,warrior,arms,18,8,10
Broxiw,darkspear,767,warrior,arms,18,8,10
Frcwar,kazzak,767,warrior,arms,18,8,10
Kàinen,nemesis,767,warrior,arms,18,8,10
Horseye,eredar,767,warrior,arms,18,8,10
Арбузикхаха,soulflayer,767,warrior,arms,18,8,10
Jjokkerr,magtheridon,767,warrior,arms,18,8,10
Ericmontana,draenor,767,warrior,arms,18,8,10
Juicyglutes,turalyon,767,warrior,arms,18,8,10
Tomhankz,ravencrest,767,warrior,arms,18,8,10
Бокалпивка,soulflayer,767,warrior,arms,21,9,12
Davari,ravencrest,767,warrior,arms,21,8,13
Fullzugzug,kazzak,767,warrior,arms,24,8,16
Øfè,ysondre,767,warrior,arms,24,8,16
Crizby,twisting-nether,767,warrior,arms,24,8,16
Bonkonator,stormscale,766,warrior,arms,12,8,4
Newgáte,silvermoon,766,warrior,arms,12,8,4
Celean,darksorrow,766,warrior,arms,12,8,4
Brutalx,twisting-nether,766,warrior,arms,14,8,6
Rageaholic,blackmoore,766,warrior,arms,18,8,10
Lydianite,stormrage,766,warrior,arms,18,8,10
Beamis,ragnaros,766,warrior,arms,18,8,10
Romzz,malganis,766,warrior,arms,18,8,10
Vohok,jaedenar,766,warrior,arms,18,8,10
Хэлвид,soulflayer,766,warrior,arms,18,8,10
Zerxees,tarren-mill,766,warrior,arms,18,8,10
Gùts,stormreaver,766,warrior,arms,18,8,10
Тевивар,gordunni,766,warrior,arms,18,8,10
Jeronimoe,blackmoore,766,warrior,arms,19,8,11
Tuskyr,silvermoon,766,warrior,arms,24,8,16
Alkuwaity,outland,766,warrior,arms,24,8,16
Нэиро,howling-fjord,766,warrior,arms,24,8,16
Roykór,auchindoun,766,warrior,arms,30,8,22
Lîliana,ysondre,765,warrior,arms,12,8,4
Xongoku,blackrock,765,warrior,arms,12,8,4
Bladestorm,dun-morogh,765,warrior,arms,18,8,10
Rindermett,eredar,765,warrior,arms,18,8,10
Smaxi,kazzak,765,warrior,arms,18,8,10
Tidrick,argent-dawn,765,warrior,arms,18,8,10
Exeqty,the-maelstrom,765,warrior,arms,18,8,10
Wärfäcë,blades-edge,765,warrior,arms,18,8,10
Fortësque,uldaman,765,warrior,arms,18,8,10
Apashe,drakthul,765,warrior,arms,24,8,16
Younes,ravencrest,765,warrior,arms,24,8,16
Hirbus,ravencrest,765,warrior,arms,25,8,17
Kotto,defias-brotherhood,765,warrior,arms,30,8,22
Havooc,ragnaros,764,warrior,arms,12,8,4
Lucciouss,sylvanas,764,warrior,arms,12,8,4
Berree,outland,764,warrior,arms,18,8,10
Lìón,blackhand,764,warrior,arms,24,8,16
Bangbros,archimonde,763,warrior,arms,12,8,4
Ireincarnate,argent-dawn,763,warrior,arms,18,8,10
Darkchao,madmortem,763,warrior,arms,18,8,10
Giggadaddy,tarren-mill,763,warrior,arms,18,8,10
Ripper,scarshield-legion,763,warrior,arms,30,8,22
Leyon,blades-edge,762,warrior,arms,12,8,4
Rogirb,drakthul,762,warrior,arms,18,8,10
Previse,argent-dawn,762,warrior,arms,18,8,10
Даммодар,howling-fjord,762,warrior,arms,18,8,10
Suolijumppa,stormreaver,762,warrior,arms,18,8,10
Turmund,turalyon,762,warrior,arms,24,8,16
Danoriix,drakthul,762,warrior,arms,24,8,16
Øruch,draenor,761,warrior,arms,18,8,10
Warbringer,ravencrest,761,warrior,arms,24,8,16
Encounter,nefarian,760,warrior,arms,12,8,4
Ríght,auchindoun,760,warrior,arms,13,8,5
Gnuhl,eredar,760,warrior,arms,21,9,12
Alysa,ravencrest,760,warrior,arms,24,8,16
Glevran,turalyon,760,warrior,arms,24,8,16
Грруд,galakrond,760,warrior,arms,24,8,16
Машамеч,blackscar,760,warrior,arms,30,8,22
Upturn,ravencrest,757,warrior,arms,24,8,16
Pappkopf,rexxar,753,warrior,arms,24,8,16
Jesperharle,ravencrest,751,warrior,arms,17,8,9
Calipp,die-aldor,750,warrior,arms,24,8,16
Ispor,shattered-halls,749,warrior,arms,104,46,58
Batourga,marécage-de-zangar,749,warrior,arms,23,8,15
Shadrassil,eonar,747,warrior,arms,18,8,10
Дедсдрыном,howling-fjord,747,warrior,arms,23,8,15
Рф,thermaplugg,745,warrior,arms,26,9,17
Roninwar,the-maelstrom,742,warrior,arms,18,8,10
Vcorvin,dun-modr,741,warrior,arms,24,8,16
Alothar,khaz-modan,738,warrior,arms,60,24,36
Furraxx,elune,736,warrior,arms,18,8,10
Hazzaogx,draenor,735,warrior,arms,23,8,15
Broarexlion,ragnaros,735,warrior,arms,23,8,15
Gaarrossh,kazzak,735,warrior,arms,23,8,15
Rawenz,drakthul,735,warrior,arms,23,8,15
Eltaré,hyjal,734,warrior,arms,14,9,5
Megaloddon,ravencrest,734,warrior,arms,17,8,9
Grimsong,antonidas,733,warrior,arms,14,9,5
Madict,outland,733,warrior,arms,18,8,10
Jäime,dun-modr,732,warrior,arms,16,8,8
Imbakarimbá,blackrock,732,warrior,arms,17,8,9
Бургерс,soulflayer,720,warrior,arms,15,8,7
Mugteef,der-rat-von-dalaran,719,warrior,arms,17,8,9
Karbeg,ravencrest,718,warrior,arms,21,8,13
Spoofie,doomhammer,718,warrior,arms,21,8,13
Железныйбард,gordunni,717,warrior,arms,23,8,15
Ahlda,hyjal,716,warrior,arms,27,8,19
Patriotdk,runetotem,709,warrior,arms,42,11,31
Ferv,tarren-mill,703,warrior,arms,17,8,9
Fürchtenix,blackmoore,703,warrior,arms,20,8,12
Goringbame,draenor,703,warrior,arms,20,8,12
Kyösti,defias-brotherhood,702,warrior,arms,14,8,6
Daxhter,sanguino,702,warrior,arms,20,8,12
Isoton,kazzak,702,warrior,arms,20,8,12
Màndø,archimonde,702,warrior,arms,21,8,13
Bàhàmût,anetheron,701,warrior,arms,11,8,3
Shieldwall,norgannon,701,warrior,arms,15,9,6
Parabellum,dun-modr,701,warrior,arms,14,8,6
Stratic,blackmoore,697,warrior,arms,26,8,18
Melców,eredar,687,warrior,arms,11,8,3
Zecelei,tarren-mill,687,warrior,arms,13,8,5
Pemex,stormreaver,686,warrior,arms,13,8,5
Xiennas,stormscale,679,warrior,arms,19,9,10
Shînsø,dalaran,672,warrior,arms,12,7,5
Ragelol,aegwynn,672,warrior,arms,12,7,5
Roadsick,outland,672,warrior,arms,12,7,5
Хашонвар,gordunni,672,warrior,arms,12,7,5
Каррагор,howling-fjord,672,warrior,arms,12,7,5
Бардеон,gordunni,672,warrior,arms,12,7,5
Engalxsol,tarren-mill,672,warrior,arms,12,7,5
Tandrak,ravencrest,672,warrior,arms,12,7,5
Choklatballz,tarren-mill,672,warrior,arms,12,7,5
Zøllka,dalaran,672,warrior,arms,12,7,5
Bubawarrior,silvermoon,672,warrior,arms,12,7,5
Bigbmh,tarren-mill,672,warrior,arms,12,7,5
Ironmásk,tarren-mill,672,warrior,arms,12,7,5
Hekkarí,kazzak,672,warrior,arms,12,7,5
Garkathar,draenor,672,warrior,arms,12,7,5
Cleppepx,blackmoore,672,warrior,arms,12,7,5
Дуухаст,gordunni,672,warrior,arms,12,7,5
Minimcgregor,sanguino,672,warrior,arms,12,7,5
Трэйдар,blackscar,672,warrior,arms,12,7,5
Creekwarrior,twisting-nether,672,warrior,arms,12,7,5
Utz,blackrock,672,warrior,arms,12,7,5
Trembolonio,sanguino,672,warrior,arms,12,7,5
Фалькр,soulflayer,672,warrior,arms,12,7,5
Андрюхабш,soulflayer,672,warrior,arms,12,7,5
Динамикс,soulflayer,672,warrior,arms,12,7,5
Ðalf,sargeras,672,warrior,arms,12,7,5
Orelus,darkspear,672,warrior,arms,12,7,5
Drøgma,tyrande,672,warrior,arms,12,7,5
Tbomb,stormscale,672,warrior,arms,12,7,5
Арсон,soulflayer,672,warrior,arms,12,7,5
Dantius,nemesis,672,warrior,arms,12,7,5
Mòrzàr,outland,672,warrior,arms,12,7,5
Pexqt,blackmoore,672,warrior,arms,12,7,5
Itsamewario,outland,672,warrior,arms,12,7,5
Slâkkxz,outland,672,warrior,arms,12,7,5
Zellóx,stormscale,672,warrior,arms,12,7,5
Azarek,blackmoore,672,warrior,arms,12,7,5
Cleavnseagal,ravencrest,672,warrior,arms,12,7,5
Srambo,ragnaros,672,warrior,arms,12,7,5
Ryse,nemesis,672,warrior,arms,12,7,5
Iamouz,ravencrest,672,warrior,arms,12,7,5
Джераса,borean-tundra,672,warrior,arms,12,7,5
Warriovar,draenor,672,warrior,arms,12,7,5
Neíd,antonidas,672,warrior,arms,12,7,5
Faimy,tarren-mill,672,warrior,arms,12,7,5
Yoz,uldaman,672,warrior,arms,12,7,5
Deathgreyø,nemesis,672,warrior,arms,12,7,5
Minitizzr,stormscale,672,warrior,arms,12,7,5
Smèdbérg,ravencrest,672,warrior,arms,12,7,5
Lisera,thrall,672,warrior,arms,12,7,5
Sholong,antonidas,672,warrior,arms,12,7,5
Unverbal,silvermoon,672,warrior,arms,12,7,5
Morvar,sanguino,672,warrior,arms,12,7,5
Jäky,ragnaros,672,warrior,arms,12,7,5
Cruor,stormscale,672,warrior,arms,12,7,5
Morkzul,sanguino,672,warrior,arms,12,7,5
Fearmyrage,ragnaros,672,warrior,arms,12,7,5
Antïsøcial,thrall,672,warrior,arms,12,7,5
Crøwñd,twisting-nether,672,warrior,arms,12,7,5
Sreym,dun-modr,672,warrior,arms,12,7,5
Chazbo,arakarahm,672,warrior,arms,12,7,5
Thomasw,argent-dawn,672,warrior,arms,12,7,5
Masakerr,ragnaros,672,warrior,arms,12,7,5
Thebigtosco,ravencrest,672,warrior,arms,12,7,5
Кросвуд,gordunni,672,warrior,arms,12,7,5
Proffsét,ravencrest,672,warrior,arms,12,7,5
Tìera,ravencrest,672,warrior,arms,15,8,7
Yakhshar,silvermoon,672,warrior,arms,18,7,11
Warrieron,stormscale,672,warrior,arms,18,7,11
Silencxý,blackrock,672,warrior,arms,18,7,11
Manký,kazzak,672,warrior,arms,18,7,11
Slappcuzz,blackrock,672,warrior,arms,18,7,11
Warriorri,haomarush,672,warrior,arms,18,7,11
Kåïdø,ravencrest,672,warrior,arms,18,7,11
Rec,thrall,672,warrior,arms,18,7,11
Delfrion,pozzo-delleternità,672,warrior,arms,18,7,11
Kamapulya,ravencrest,672,warrior,arms,18,7,11
Twoonewin,ragnaros,672,warrior,arms,18,7,11
Karreg,hyjal,672,warrior,arms,18,7,11
Rylbrah,blackmoore,672,warrior,arms,18,7,11
Skullsmasher,stormscale,672,warrior,arms,18,7,11
Marablind,drakthul,672,warrior,arms,18,7,11
Kennzz,ravencrest,672,warrior,arms,18,7,11
Swàck,mazrigos,672,warrior,arms,18,7,11
Pända,archimonde,672,warrior,arms,18,7,11
Ishi,archimonde,672,warrior,arms,18,7,11
Lalilulelo,argent-dawn,672,warrior,arms,18,7,11
Kiha,argent-dawn,672,warrior,arms,18,7,11
Kieranx,silvermoon,672,warrior,arms,18,7,11
Бизэмэйкер,gordunni,672,warrior,arms,18,7,11
Luxurious,argent-dawn,672,warrior,arms,27,8,19
Vøidwalker,ragnaros,672,warrior,arms,24,7,17
Kaylì,ravencrest,672,warrior,arms,24,7,17
Syfér,grim-batol,672,warrior,arms,24,7,17
Izurritea,tarren-mill,672,warrior,arms,24,7,17
Unßörn,archimonde,672,warrior,arms,24,7,17
Gôrilla,kazzak,672,warrior,arms,30,7,23
Stèalthy,stormscale,671,warrior,arms,12,7,5
Когарт,gordunni,671,warrior,arms,12,7,5
Zonash,kazzak,671,warrior,arms,12,7,5
Dukhe,sanguino,671,warrior,arms,12,7,5
Bootyclapper,runetotem,671,warrior,arms,12,7,5
Greifax,eredar,671,warrior,arms,12,7,5
Gamôrà,eitrigg,671,warrior,arms,12,7,5
Ogvico,stormscale,671,warrior,arms,12,7,5
Bendeur,ysondre,671,warrior,arms,12,7,5
Kelmyst,ragnaros,671,warrior,arms,12,7,5
Reykingar,outland,671,warrior,arms,12,7,5
Fluxerella,azjolnerub,671,warrior,arms,12,7,5
Schneklinge,blutkessel,671,warrior,arms,12,7,5
Vez,arathor,671,warrior,arms,12,7,5
Escà,archimonde,671,warrior,arms,12,7,5
Dosenbier,gorgonnash,671,warrior,arms,12,7,5
Aëne,kirin-tor,671,warrior,arms,12,7,5
Сайлентлайтх,soulflayer,671,warrior,arms,12,7,5
Wårlord,ragnaros,671,warrior,arms,12,7,5
Shedzo,tarren-mill,671,warrior,arms,12,7,5
Skullcrasher,draenor,671,warrior,arms,12,7,5
Rawne,kirin-tor,671,warrior,arms,12,7,5
Pihvikostaja,stormreaver,671,warrior,arms,12,7,5
Valí,drakthul,671,warrior,arms,12,7,5
Hades,kazzak,671,warrior,arms,12,7,5
Schawar,draenor,671,warrior,arms,12,7,5
Wvanp,tarren-mill,671,warrior,arms,12,7,5
Grudu,la-croisade-écarlate,671,warrior,arms,12,7,5
Altroox,malorne,671,warrior,arms,12,7,5
Дисфория,soulflayer,671,warrior,arms,15,8,7
Akorax,frostwolf,671,warrior,arms,16,8,8
Zarolk,rashgarroth,671,warrior,arms,18,7,11
Doragon,nemesis,671,warrior,arms,18,7,11
Ayawa,silvermoon,671,warrior,arms,18,7,11
Titanioa,draenor,671,warrior,arms,18,7,11
Kattyparry,tarren-mill,671,warrior,arms,18,7,11
Salsetti,nemesis,671,warrior,arms,18,7,11
Sydre,nerathor,671,warrior,arms,18,7,11
Donczaszka,turalyon,671,warrior,arms,18,7,11
Schwarzkoviç,hyjal,671,warrior,arms,18,7,11
Segovaxx,twisting-nether,671,warrior,arms,18,7,11
Ruzbie,silvermoon,671,warrior,arms,18,7,11
Текайко,eversong,671,warrior,arms,18,7,11
Haris,malganis,671,warrior,arms,18,7,11
Kekwd,burning-legion,671,warrior,arms,18,7,11
Feydal,thrall,671,warrior,arms,18,7,11
Kishkamen,ravencrest,671,warrior,arms,18,7,11
Ishíì,twisting-nether,671,warrior,arms,18,7,11
Jerololz,dun-modr,671,warrior,arms,24,7,17
Bisuko,archimonde,671,warrior,arms,24,7,17
Бубаигавар,gordunni,671,warrior,arms,24,7,17
Williamx,archimonde,671,warrior,arms,24,7,17
Sadex,blackmoore,671,warrior,arms,24,7,17
Lightit,aegwynn,670,warrior,arms,12,7,5
Haymaker,auchindoun,670,warrior,arms,12,7,5
Eldfast,bladefist,670,warrior,arms,12,7,5
Kilsera,blackmoore,670,warrior,arms,12,7,5
Grunwi,burning-legion,670,warrior,arms,12,7,5
Cortix,blackmoore,670,warrior,arms,16,8,8
Grafted,argent-dawn,670,warrior,arms,18,7,11
Høxy,outland,670,warrior,arms,18,7,11
Therapyst,sylvanas,670,warrior,arms,18,7,11
Tartadwarf,blackhand,670,warrior,arms,18,7,11
Sibbo,destromath,670,warrior,arms,18,7,11
Mortus,baelgun,670,warrior,arms,22,8,14
Чсвпони,blackscar,670,warrior,arms,24,7,17
Laude,ragnaros,669,warrior,arms,12,7,5
Gakosh,sanguino,669,warrior,arms,12,7,5
Pyxis,argent-dawn,669,warrior,arms,18,7,11
Slappie,kiljaeden,669,warrior,arms,18,7,11
Brisky,tarren-mill,669,warrior,arms,18,7,11
Méfiat,hyjal,668,warrior,arms,12,7,5
Árkantos,ravencrest,668,warrior,arms,12,7,5
Warclone,ravencrest,668,warrior,arms,12,7,5
Thok,blades-edge,668,warrior,arms,18,7,11
Woukong,blackmoore,668,warrior,arms,18,7,11
Releave,draenor,668,warrior,arms,18,7,11
Director,aegwynn,667,warrior,arms,12,7,5
Strânge,gorgonnash,667,warrior,arms,12,7,5
Piixxz,hyjal,667,warrior,arms,12,7,5
Láviana,aegwynn,667,warrior,arms,12,7,5
Papati,twisting-nether,667,warrior,arms,18,7,11
Rèlion,pozzo-delleternità,666,warrior,arms,15,8,7
Djiozz,khaz-modan,666,warrior,arms,30,7,23
Rimz,blackmoore,663,warrior,arms,18,7,11
Buullz,twisting-nether,662,warrior,arms,18,7,11
Robthebruce,ravencrest,660,warrior,arms,18,7,11
Yuushi,doomhammer,656,warrior,arms,26,10,16
Punishers,ysondre,656,warrior,arms,156,54,102
Paaki,archimonde,655,warrior,arms,17,7,10
Mocka,veknilash,640,warrior,arms,16,7,9
Варбаул,soulflayer,639,warrior,arms,14,8,6
Мегаяйца,gordunni,639,warrior,arms,23,7,16
Xiny,blackrock,638,warrior,arms,17,7,10
Dasbiest,malorne,638,warrior,arms,17,7,10
Боевыещёчки,eversong,627,warrior,arms,22,11,11
Schmelzlord,thrall,624,warrior,arms,15,7,8
Knoxworth,kazzak,623,warrior,arms,11,7,4
Bloodeater,sylvanas,623,warrior,arms,15,7,8
Grunkor,eldrethalas,623,warrior,arms,17,7,10
Ätreides,sanguino,622,warrior,arms,17,7,10
Vaxillium,argent-dawn,621,warrior,arms,17,7,10
Ragingqawk,outland,608,warrior,arms,16,7,9
Kwesta,kazzak,607,warrior,arms,11,7,4
Matatorero,uldum,607,warrior,arms,16,7,9
Trundledaddy,silvermoon,607,warrior,arms,17,7,10
Ðowman,blackrock,607,warrior,arms,20,7,13
Cbahorde,outland,606,warrior,arms,14,7,7
Arashicage,emeriss,606,warrior,arms,14,7,7
Eragdagh,thrall,606,warrior,arms,20,7,13
Rhxy,burning-legion,605,warrior,arms,16,7,9
Kenzai,aegwynn,592,warrior,arms,13,7,6
Nebezpeka,silvermoon,592,warrior,arms,13,7,6
Olriksen,dentarg,590,warrior,arms,19,8,11
Bavet,sylvanas,589,warrior,arms,19,7,12
Dulex,draenor,576,warrior,arms,6,6,0
Watergate,ysondre,576,warrior,arms,6,6,0
Gidra,stormscale,576,warrior,arms,6,6,0
Lubcifer,emeriss,576,warrior,arms,6,6,0
Hornkesh,draenor,576,warrior,arms,6,6,0
Neoballâc,uldum,576,warrior,arms,12,6,6
Xqt,laughing-skull,576,warrior,arms,12,6,6
Nørst,draenor,576,warrior,arms,12,6,6
Kirmizikafa,twisting-nether,576,warrior,arms,12,6,6
Fonky,sylvanas,576,warrior,arms,12,6,6
Micromachìne,sanguino,576,warrior,arms,12,6,6
Belov,hyjal,576,warrior,arms,12,6,6
Deymio,defias-brotherhood,576,warrior,arms,12,6,6
Psychðtïc,archimonde,576,warrior,arms,12,6,6
Fookyoup,stormscale,576,warrior,arms,12,6,6
Brutarius,scarshield-legion,576,warrior,arms,12,6,6
Maheri,antonidas,576,warrior,arms,12,6,6
Синглдем,gordunni,576,warrior,arms,12,6,6
Brutalizar,draenor,576,warrior,arms,12,6,6
Mîleycyrûs,stormscale,576,warrior,arms,12,6,6
Moldamis,blackhand,576,warrior,arms,12,6,6
Lucywar,ravencrest,576,warrior,arms,12,6,6
Scràvity,blackhand,576,warrior,arms,12,6,6
Thanâtøs,kazzak,576,warrior,arms,12,6,6
Waranach,drakthul,576,warrior,arms,12,6,6
Oneoneseven,archimonde,576,warrior,arms,12,6,6
Dvigar,drakthul,576,warrior,arms,12,6,6
Finmajor,frostwhisper,576,warrior,arms,12,6,6
Wøokz,argent-dawn,576,warrior,arms,12,6,6
Bllué,ravencrest,576,warrior,arms,12,6,6
Qurujaa,kirin-tor,576,warrior,arms,12,6,6
Phalekxox,twisting-nether,576,warrior,arms,12,6,6
Радомель,gordunni,576,warrior,arms,12,6,6
Reshnak,die-todeskrallen,576,warrior,arms,12,6,6
Toqk,draenor,576,warrior,arms,12,6,6
Màgh,ravencrest,576,warrior,arms,12,6,6
Fankululu,kragjin,576,warrior,arms,12,6,6
Rageover,outland,576,warrior,arms,12,6,6
Vakios,confrérie-du-thorium,576,warrior,arms,12,6,6
Ðrews,kazzak,576,warrior,arms,12,6,6
Víoceptíon,blackrock,576,warrior,arms,12,6,6
Iuliaa,ravencrest,576,warrior,arms,12,6,6
Eyolf,thunderhorn,576,warrior,arms,12,6,6
Darkseid,burning-legion,576,warrior,arms,12,6,6
Earthshatter,emeriss,576,warrior,arms,12,6,6
Leetzorz,aszune,576,warrior,arms,12,6,6
Thegullet,draenor,576,warrior,arms,12,6,6
Intíkam,alleria,576,warrior,arms,12,6,6
Нерморрог,howling-fjord,576,warrior,arms,12,6,6
Kleckzz,blackmoore,576,warrior,arms,12,6,6
Krisusama,ravencrest,576,warrior,arms,12,6,6
Urmankey,kazzak,576,warrior,arms,12,6,6
Jayus,stormrage,576,warrior,arms,12,6,6
Shorane,varimathras,576,warrior,arms,12,6,6
Наомирассел,gordunni,576,warrior,arms,12,6,6
Chargekanta,antonidas,576,warrior,arms,12,6,6
Toscow,ravencrest,576,warrior,arms,12,6,6
Tùcky,ysondre,576,warrior,arms,12,6,6
Coolaa,kazzak,576,warrior,arms,12,6,6
Hycate,blackrock,576,warrior,arms,12,6,6
Skelash,blackhand,576,warrior,arms,12,6,6
Bourbimrgllr,hyjal,576,warrior,arms,12,6,6
Slám,burning-legion,576,warrior,arms,12,6,6
Whatabeast,blackmoore,576,warrior,arms,12,6,6
Rakhaldin,blackhand,576,warrior,arms,12,6,6
Freddio,tarren-mill,576,warrior,arms,12,6,6
Neverfear,aegwynn,576,warrior,arms,12,6,6
Torgath,kirin-tor,576,warrior,arms,12,6,6
Pryzinstyle,aegwynn,576,warrior,arms,12,6,6
Yuuta,ravencrest,576,warrior,arms,12,6,6
Долирия,gordunni,576,warrior,arms,12,6,6
Хедтакер,gordunni,576,warrior,arms,12,6,6
Rianhh,tarren-mill,576,warrior,arms,12,6,6
Tddyy,silvermoon,576,warrior,arms,12,6,6
Racore,aegwynn,576,warrior,arms,12,6,6
Wärlør,ravencrest,576,warrior,arms,12,6,6
Тягуч,howling-fjord,576,warrior,arms,12,6,6
Majestatix,doomhammer,576,warrior,arms,12,6,6
Lolpuîk,archimonde,576,warrior,arms,12,6,6
Hacci,ragnaros,576,warrior,arms,12,6,6
Ðjlækker,silvermoon,576,warrior,arms,12,6,6
Poyraz,blackrock,576,warrior,arms,12,6,6
Äsgeïr,archimonde,576,warrior,arms,12,6,6
Terisá,blackmoore,576,warrior,arms,12,6,6
Zabrona,turalyon,576,warrior,arms,12,6,6
Juggawumba,kazzak,576,warrior,arms,12,6,6
Teliese,argent-dawn,576,warrior,arms,12,6,6
Madswarr,tarren-mill,576,warrior,arms,12,6,6
Nakedwarrior,silvermoon,576,warrior,arms,12,6,6
Fidicenz,ysondre,576,warrior,arms,12,6,6
Tikej,silvermoon,576,warrior,arms,12,6,6
Дестингл,gordunni,576,warrior,arms,15,7,8
Chazeryu,stormreaver,576,warrior,arms,18,6,12
Реклэсс,blackscar,576,warrior,arms,18,6,12
Ezop,burning-blade,576,warrior,arms,18,6,12
Ermòr,ravencrest,576,warrior,arms,18,6,12
Kawaro,rajaxx,576,warrior,arms,18,6,12
Повстер,howling-fjord,576,warrior,arms,18,6,12
Ój,ravencrest,576,warrior,arms,18,6,12
Kneecleaver,darksorrow,576,warrior,arms,18,6,12
Foxxzorr,aszune,576,warrior,arms,18,6,12
Debiljov,ahnqiraj,576,warrior,arms,18,6,12
Kenet,tarren-mill,576,warrior,arms,18,6,12
Repó,twisting-nether,576,warrior,arms,18,6,12
Stillpetao,dun-modr,576,warrior,arms,18,6,12
Ragoar,blackmoore,576,warrior,arms,18,6,12
Duaig,pozzo-delleternità,576,warrior,arms,18,6,12
Jeriko,archimonde,576,warrior,arms,18,6,12
Shiikaa,hyjal,576,warrior,arms,18,6,12
Huor,tarren-mill,576,warrior,arms,18,6,12
Fracto,draenor,576,warrior,arms,18,6,12
Leroyluca,gilneas,576,warrior,arms,18,6,12
Gór,area-52,576,warrior,arms,18,6,12
Erayu,outland,576,warrior,arms,18,6,12
Cødi,antonidas,576,warrior,arms,18,6,12
Autumnfálls,kazzak,576,warrior,arms,18,6,12
Khagor,kazzak,576,warrior,arms,24,6,18
Steroidkidx,stormscale,576,warrior,arms,24,6,18
Luckysop,chants-éternels,576,warrior,arms,24,6,18
Topozugzug,tarren-mill,576,warrior,arms,24,6,18
Elsinner,ravencrest,576,warrior,arms,24,6,18
Crocodìle,magtheridon,575,warrior,arms,6,6,0
Pesroc,blackmoore,575,warrior,arms,9,7,2
Беспонятия,blackscar,575,warrior,arms,10,7,3
Arnnau,dun-modr,575,warrior,arms,12,6,6
Thorast,argent-dawn,575,warrior,arms,12,6,6
Wærriør,argent-dawn,575,warrior,arms,12,6,6
Empero,draenor,575,warrior,arms,12,6,6
Эсвексия,gordunni,575,warrior,arms,12,6,6
Soofies,madmortem,575,warrior,arms,12,6,6
Cyniczny,draenor,575,warrior,arms,12,6,6
Brávéheart,ravencrest,575,warrior,arms,12,6,6
Бэдбрэйнс,soulflayer,575,warrior,arms,12,6,6
Bzezita,hyjal,575,warrior,arms,12,6,6
Ràgnàmetàl,tarren-mill,575,warrior,arms,12,6,6
Valus,earthen-ring,575,warrior,arms,12,6,6
Demirkol,outland,575,warrior,arms,12,6,6
Акози,fordragon,575,warrior,arms,12,6,6
Cesaro,blackhand,575,warrior,arms,12,6,6
Scârath,eredar,575,warrior,arms,12,6,6
Thráll,aszune,575,warrior,arms,12,6,6
Ghostlord,dunemaul,575,warrior,arms,12,6,6
Bobleeragnar,ravencrest,575,warrior,arms,12,6,6
Djpuggerino,outland,575,warrior,arms,12,6,6
Cogne,illidan,575,warrior,arms,12,6,6
Zutto,conseil-des-ombres,575,warrior,arms,12,6,6
Mladris,outland,575,warrior,arms,12,6,6
Думрайт,gordunni,575,warrior,arms,12,6,6
Fótm,sylvanas,575,warrior,arms,12,6,6
Тханирох,howling-fjord,575,warrior,arms,12,6,6
Imafk,darksorrow,575,warrior,arms,12,6,6
Dexter,outland,575,warrior,arms,12,6,6
Lunath,stormscale,575,warrior,arms,12,6,6
Lupacha,exodar,575,warrior,arms,12,6,6
Uwazu,kazzak,575,warrior,arms,12,6,6
Rawi,antonidas,575,warrior,arms,12,6,6
Sombrenuit,kaelthas,575,warrior,arms,16,7,9
Отнулядоста,gordunni,575,warrior,arms,18,6,12
Кордупэль,gordunni,575,warrior,arms,18,6,12
Redcloak,outland,575,warrior,arms,18,6,12
Potatoslam,twisting-nether,575,warrior,arms,18,6,12
Critycall,drakthul,575,warrior,arms,18,6,12
Ruioz,draenor,575,warrior,arms,18,6,12
Sabøtage,aggra-português,575,warrior,arms,18,6,12
Vectus,zuljin,575,warrior,arms,18,6,12
Awares,blackmoore,575,warrior,arms,18,6,12
Pnizsz,draenor,575,warrior,arms,24,6,18
Kydecnick,kazzak,575,warrior,arms,24,6,18
Fugrim,draenor,574,warrior,arms,12,6,6
Solatika,alexstrasza,574,warrior,arms,12,6,6
Nostrawolf,sylvanas,574,warrior,arms,12,6,6
Greensmash,hyjal,574,warrior,arms,12,6,6
Rézinplin,archimonde,574,warrior,arms,12,6,6
Xaah,dun-modr,574,warrior,arms,18,6,12
Salom,illidan,574,warrior,arms,18,6,12
Maxeyn,kazzak,574,warrior,arms,27,7,20
Sztixi,silvermoon,574,warrior,arms,24,6,18
Kaerz,ysondre,573,warrior,arms,12,6,6
Prôtectore,hyjal,573,warrior,arms,12,6,6
Sallcon,khaz-modan,573,warrior,arms,12,6,6
Бачус,eversong,573,warrior,arms,18,6,12
Ttz,tarren-mill,573,warrior,arms,18,6,12
Haipaz,draenor,572,warrior,arms,12,6,6
Årxex,stormscale,572,warrior,arms,12,6,6
Oombac,lordaeron,572,warrior,arms,12,6,6
Raduriel,antonidas,571,warrior,arms,12,6,6
Ileei,kazzak,571,warrior,arms,18,6,12
Thoròk,antonidas,571,warrior,arms,18,6,12
Xavs,grim-batol,571,warrior,arms,18,6,12
Бланкк,deathweaver,570,warrior,arms,12,6,6
Dj,ragnaros,568,warrior,arms,12,6,6
Wulfgâr,dun-modr,566,warrior,arms,12,6,6
Gauklerbaron,blackmoore,566,warrior,arms,29,6,23
Wïnqlùlz,archimonde,564,warrior,arms,36,6,30
Rãgè,tarren-mill,559,warrior,arms,17,6,11
Wahney,thrall,543,warrior,arms,8,7,1
Randrion,blackrock,543,warrior,arms,11,6,5
Omaahton,magtheridon,543,warrior,arms,11,6,5
Krevó,ragnaros,543,warrior,arms,17,6,11
Fion,kult-der-verdammten,543,warrior,arms,20,7,13
Koruds,outland,528,warrior,arms,9,6,3
Kåñéthy,outland,528,warrior,arms,15,7,8
Warriotrix,tarren-mill,528,warrior,arms,15,6,9
Nukefun,blackrock,527,warrior,arms,11,6,5
Imabeatyoass,kazzak,527,warrior,arms,11,6,5
Манндалорец,gordunni,527,warrior,arms,15,6,9
Titanhaut,frostwolf,525,warrior,arms,11,6,5
Smaugman,nemesis,523,warrior,arms,23,6,17
Glut,drakthul,522,warrior,arms,18,7,11
Nuckii,antonidas,521,warrior,arms,21,7,14
Monifes,kazzak,520,warrior,arms,18,8,10
Эсканорд,gordunni,513,warrior,arms,26,7,19
Креспекс,gordunni,512,warrior,arms,16,6,10
Bujax,onyxia,512,warrior,arms,16,6,10
Dzamtule,ravencrest,511,warrior,arms,8,6,2
Hasira,xavius,511,warrior,arms,10,6,4
Sorô,antonidas,511,warrior,arms,16,6,10
Мембершримп,howling-fjord,511,warrior,arms,20,6,14
Myryna,exodar,510,warrior,arms,20,6,14
Блэйзерх,gordunni,496,warrior,arms,19,6,13
Serbia,blackrock,480,warrior,arms,6,5,1
Гневныйвиги,howling-fjord,480,warrior,arms,6,5,1
Murp,lightnings-blade,480,warrior,arms,6,5,1
Saitäma,burning-legion,480,warrior,arms,6,5,1
Karmaloop,stormscale,480,warrior,arms,6,5,1
Sufentaniili,frostwhisper,480,warrior,arms,6,5,1
Nalanis,stormreaver,480,warrior,arms,6,5,1
Zodiac,aggra-português,480,warrior,arms,6,5,1
Eysnwar,blackrock,480,warrior,arms,6,5,1
Mumbojumbo,uldum,480,warrior,arms,6,5,1
Chuck,ravencrest,480,warrior,arms,6,5,1
Hubq,burning-legion,480,warrior,arms,6,5,1
Himarsenko,silvermoon,480,warrior,arms,6,5,1
Remylacroix,blackrock,480,warrior,arms,6,5,1
Ocecute,tarren-mill,480,warrior,arms,6,5,1
Grímgor,aegwynn,480,warrior,arms,6,5,1
Angrytoddler,silvermoon,480,warrior,arms,6,5,1
Bashuk,grim-batol,480,warrior,arms,6,5,1
Tørrminator,stormscale,480,warrior,arms,6,5,1
Quateh,silvermoon,480,warrior,arms,6,5,1
Дядядмг,blackscar,480,warrior,arms,6,5,1
Chargelife,sylvanas,480,warrior,arms,6,5,1
Tekmali,archimonde,480,warrior,arms,6,5,1
Sezomih,outland,480,warrior,arms,6,5,1
Exether,auchindoun,480,warrior,arms,6,5,1
Cuzyxtwo,blackrock,480,warrior,arms,6,5,1
Asasius,ravencrest,480,warrior,arms,6,5,1
Rockygifll,sinstralis,480,warrior,arms,6,5,1
Chabonara,blackmoore,480,warrior,arms,6,5,1
Dagreenjo,tarren-mill,480,warrior,arms,6,5,1
Tørøg,eredar,480,warrior,arms,6,5,1
Хэрест,gordunni,480,warrior,arms,6,5,1
Slg,tarren-mill,480,warrior,arms,6,5,1
Synix,stormreaver,480,warrior,arms,6,5,1
Drragosh,tarren-mill,480,warrior,arms,6,5,1
Revoidnvm,blackmoore,480,warrior,arms,6,5,1
Hópbóp,magtheridon,480,warrior,arms,6,5,1
Lurion,malganis,480,warrior,arms,6,5,1
Tishues,kazzak,480,warrior,arms,8,5,3
Vitezandro,stormscale,480,warrior,arms,12,5,7
Balenciarmor,silvermoon,480,warrior,arms,12,5,7
Budwise,stormscale,480,warrior,arms,12,5,7
Снорре,soulflayer,480,warrior,arms,12,5,7
Тэратос,soulflayer,480,warrior,arms,12,5,7
Teramuhl,eredar,480,warrior,arms,12,5,7
Hodenhugo,thrall,480,warrior,arms,12,5,7
Xintha,frostwolf,480,warrior,arms,12,5,7
Боадрог,soulflayer,480,warrior,arms,12,5,7
Leelazero,argent-dawn,480,warrior,arms,12,5,7
Plzdontkite,blackrock,480,warrior,arms,12,5,7
Pourfendre,archimonde,480,warrior,arms,12,5,7
Threnewar,kazzak,480,warrior,arms,12,5,7
Gigantous,emerald-dream,480,warrior,arms,12,5,7
Nings,rashgarroth,480,warrior,arms,12,5,7
Drumsofwar,zuljin,480,warrior,arms,12,5,7
Gorkta,uldaman,480,warrior,arms,12,5,7
Khara,frostwolf,480,warrior,arms,12,5,7
Thirtynine,daggerspine,480,warrior,arms,12,5,7
Tyrag,eredar,480,warrior,arms,12,5,7
Ràgê,silvermoon,480,warrior,arms,12,5,7
Zeneve,auchindoun,480,warrior,arms,12,5,7
Buffury,twisting-nether,480,warrior,arms,12,5,7
Nomore,sylvanas,480,warrior,arms,12,5,7
Wardoz,archimonde,480,warrior,arms,12,5,7
Stepmomgodx,kazzak,480,warrior,arms,12,5,7
Шифик,soulflayer,480,warrior,arms,12,5,7
Tharokk,blackmoore,480,warrior,arms,12,5,7
Oplix,antonidas,480,warrior,arms,12,5,7
Zugzugsmash,thrall,480,warrior,arms,12,5,7
Zonïa,ysondre,480,warrior,arms,12,5,7
Câttiva,blackmoore,480,warrior,arms,12,5,7
Agres,zuluhed,480,warrior,arms,12,5,7
Бейлеор,gordunni,480,warrior,arms,12,5,7
Garradoom,stormscale,480,warrior,arms,12,5,7
Lïyah,eldrethalas,480,warrior,arms,12,5,7
Matiasek,burning-legion,480,warrior,arms,12,5,7
Horizonx,blackrock,480,warrior,arms,12,5,7
Whysobold,quelthalas,480,warrior,arms,12,5,7
Zuroq,antonidas,480,warrior,arms,12,5,7
Wãrby,ravencrest,480,warrior,arms,12,5,7
Zarrgash,blackhand,480,warrior,arms,12,5,7
Schlierkamp,aegwynn,480,warrior,arms,12,5,7
Steelian,kazzak,480,warrior,arms,12,5,7
Deathbleeder,argent-dawn,480,warrior,arms,12,5,7
Epicc,alleria,480,warrior,arms,12,5,7
Kirzan,silvermoon,480,warrior,arms,12,5,7
Klonyarikjr,ravencrest,480,warrior,arms,12,5,7
Steelstormz,ravencrest,480,warrior,arms,12,5,7
Zeryyo,blackrock,480,warrior,arms,12,5,7
Adamastos,ragnaros,480,warrior,arms,12,5,7
Matrixer,aegwynn,480,warrior,arms,12,5,7
Sergra,ysondre,480,warrior,arms,12,5,7
Møgwai,sanguino,480,warrior,arms,12,5,7
Zion,zenedar,480,warrior,arms,12,5,7
Loreven,silvermoon,480,warrior,arms,12,5,7
Keäghan,kazzak,480,warrior,arms,12,5,7
Warricious,outland,480,warrior,arms,12,5,7
Rohäc,drakthul,480,warrior,arms,12,5,7
Mokrakh,blackmoore,480,warrior,arms,12,5,7
Victôr,silvermoon,480,warrior,arms,12,5,7
Vulkân,aerie-peak,480,warrior,arms,12,5,7
Loliclapper,grim-batol,480,warrior,arms,12,5,7
Caltan,wildhammer,480,warrior,arms,12,5,7
Pattrock,blackmoore,480,warrior,arms,12,5,7
Ginjó,blackhand,480,warrior,arms,12,5,7
Сашарбгх,soulflayer,480,warrior,arms,12,5,7
Pablitø,silvermoon,480,warrior,arms,12,5,7
Warclodo,la-croisade-écarlate,480,warrior,arms,12,5,7
Zirriox,wildhammer,480,warrior,arms,12,5,7
Brasta,malganis,480,warrior,arms,12,5,7
Tryitmaxx,blackmoore,480,warrior,arms,12,5,7
Bladestormxx,blackmoore,480,warrior,arms,12,5,7
Lüund,ravencrest,480,warrior,arms,12,5,7
Ernexpóc,silvermoon,480,warrior,arms,12,5,7
Bigbanz,outland,480,warrior,arms,12,5,7
Arakhu,blackmoore,480,warrior,arms,12,5,7
Kalopsia,drakthul,480,warrior,arms,12,5,7
Coko,kirin-tor,480,warrior,arms,12,5,7
Бенчмаркпоу,gordunni,480,warrior,arms,12,5,7
Strengjahz,ragnaros,480,warrior,arms,12,5,7
Анжинерх,gordunni,480,warrior,arms,12,5,7
Okke,thunderhorn,480,warrior,arms,12,5,7
Baxyra,aegwynn,480,warrior,arms,12,5,7
Purjon,twilights-hammer,480,warrior,arms,12,5,7
Shanai,silvermoon,480,warrior,arms,12,5,7
Humanoç,dun-modr,480,warrior,arms,12,5,7
Huxies,draenor,480,warrior,arms,12,5,7
Asintended,draenor,480,warrior,arms,12,5,7
Thravaeg,draenor,480,warrior,arms,12,5,7
Kramix,thrall,480,warrior,arms,12,5,7
Mërkürÿ,draenor,480,warrior,arms,12,5,7
Ffz,hyjal,480,warrior,arms,12,5,7
Arsinal,destromath,480,warrior,arms,12,5,7
Sidekick,earthen-ring,480,warrior,arms,12,5,7
Oogaboogadps,silvermoon,480,warrior,arms,12,5,7
Ragingclue,draenor,480,warrior,arms,12,5,7
Síúkanto,blackrock,480,warrior,arms,12,5,7
Рэйердан,howling-fjord,480,warrior,arms,12,5,7
Dampbob,draenor,480,warrior,arms,12,5,7
ßzv,veklor,480,warrior,arms,12,5,7
Taskov,tarren-mill,480,warrior,arms,12,5,7
Elesharde,sanguino,480,warrior,arms,15,6,9
Vexxenn,outland,480,warrior,arms,16,6,10
Развалочка,howling-fjord,480,warrior,arms,16,6,10
Goldrage,archimonde,480,warrior,arms,16,5,11
Takagødx,archimonde,480,warrior,arms,18,5,13
Форгерон,howling-fjord,480,warrior,arms,18,5,13
Чевчелиос,deathweaver,480,warrior,arms,18,5,13
Heracles,jaedenar,480,warrior,arms,18,5,13
Spacemachine,kazzak,480,warrior,arms,18,5,13
Romic,guldan,480,warrior,arms,18,5,13
Rhaegon,laughing-skull,480,warrior,arms,18,5,13
Kundrakiz,kazzak,480,warrior,arms,18,5,13
Solgud,bloodfeather,480,warrior,arms,18,5,13
Æxcoast,ravencrest,480,warrior,arms,18,5,13
Курящийпро,blackscar,480,warrior,arms,18,5,13
Sheñ,antonidas,480,warrior,arms,18,5,13
Mellvorr,malganis,480,warrior,arms,23,5,18
Gnolimits,antonidas,480,warrior,arms,24,5,19
Jorund,archimonde,480,warrior,arms,24,5,19
Ludiboro,kazzak,480,warrior,arms,24,5,19
Vhy,antonidas,480,warrior,arms,25,5,20
Ceteris,eredar,479,warrior,arms,6,5,1
Saey,malorne,479,warrior,arms,6,5,1
Xtu,kazzak,479,warrior,arms,6,5,1
Dêrion,blackmoore,479,warrior,arms,10,6,4
Shpitzu,stormscale,479,warrior,arms,12,5,7
Meresin,madmortem,479,warrior,arms,12,5,7
Relüx,ragnaros,479,warrior,arms,12,5,7
Joesalamanca,ragnaros,479,warrior,arms,12,5,7
Tötø,archimonde,479,warrior,arms,12,5,7
Maxilanthis,eonar,479,warrior,arms,12,5,7
Grèèn,turalyon,479,warrior,arms,12,5,7
Lanïmal,eitrigg,479,warrior,arms,12,5,7
Caloomsa,hellfire,479,warrior,arms,12,5,7
Спарттанка,gordunni,479,warrior,arms,12,5,7
Fréyaá,blackrock,479,warrior,arms,12,5,7
Dúg,tarren-mill,479,warrior,arms,12,5,7
Svinks,sylvanas,479,warrior,arms,12,5,7
Swtparanoid,sylvanas,479,warrior,arms,12,5,7
Dragonforce,blackmoore,479,warrior,arms,12,5,7
Voodoowarr,rexxar,479,warrior,arms,12,5,7
Lezúziuszh,ragnaros,479,warrior,arms,17,7,10
Skarnir,blackhand,479,warrior,arms,18,5,13
Auggies,outland,479,warrior,arms,18,5,13
Ravedeath,tarren-mill,479,warrior,arms,18,5,13
Gids,silvermoon,479,warrior,arms,18,5,13
Tinull,silvermoon,479,warrior,arms,18,5,13
Hulkkis,outland,479,warrior,arms,24,5,19
Konstantin,grim-batol,479,warrior,arms,24,5,19
Nightmareb,magtheridon,478,warrior,arms,12,5,7
Ghorinchai,khazgoroth,478,warrior,arms,12,5,7
Aylîx,dun-modr,478,warrior,arms,12,5,7
Nodance,doomhammer,478,warrior,arms,12,5,7
Farxy,dun-modr,478,warrior,arms,12,5,7
Sahaminho,draenor,478,warrior,arms,18,5,13
Swordluw,argent-dawn,478,warrior,arms,18,5,13
Нириэла,howling-fjord,478,warrior,arms,18,5,13
Nierninwa,silvermoon,477,warrior,arms,12,5,7
Лидоний,gordunni,477,warrior,arms,12,5,7
Achsin,eredar,477,warrior,arms,15,6,9
Olagkhan,minahonda,476,warrior,arms,10,6,4
Àke,darksorrow,476,warrior,arms,18,5,13
Sheriff,dragonblight,475,warrior,arms,12,5,7
Короноварус,greymane,474,warrior,arms,12,5,7
Pillu,stormscale,448,warrior,arms,10,5,5
Duarel,blackmoore,448,warrior,arms,10,5,5
Takethisduck,stormscale,447,warrior,arms,11,5,6
Kviqr,auchindoun,447,warrior,arms,11,5,6
Чпонькмашина,soulflayer,447,warrior,arms,17,5,12
Kitano,garona,447,warrior,arms,23,5,18
Orkyu,stormrage,444,warrior,arms,11,5,6
Суицидгодх,howling-fjord,431,warrior,arms,11,5,6
Turdgurgler,executus,431,warrior,arms,11,5,6
Gramash,grim-batol,430,warrior,arms,17,5,12
Warriar,sylvanas,426,warrior,arms,17,7,10
Bismárck,nathrezim,426,warrior,arms,15,6,9
Knî,archimonde,426,warrior,arms,15,6,9
Leizey,stormscale,426,warrior,arms,15,6,9
Goreksson,aegwynn,426,warrior,arms,15,6,9
Rathis,arathor,426,warrior,arms,24,6,18
Prime,outland,416,warrior,arms,16,5,11
Ragnarr,ravencrest,416,warrior,arms,16,5,11
Kìrìtosan,pozzo-delleternità,415,warrior,arms,8,5,3
Kylian,aegwynn,415,warrior,arms,11,5,6
Suduri,drakthul,415,warrior,arms,14,5,9
Danx,culte-de-la-rive-noire,413,warrior,arms,16,5,11
Varkoz,sylvanas,400,warrior,arms,7,5,2
Жекабустер,borean-tundra,399,warrior,arms,7,5,2
Xtazen,draenor,384,warrior,arms,6,4,2
Howdoulose,dun-modr,384,warrior,arms,6,4,2
Thuder,sylvanas,384,warrior,arms,6,4,2
Voi,jaedenar,384,warrior,arms,6,4,2
Alaerion,magtheridon,384,warrior,arms,6,4,2
Delvirx,draenor,384,warrior,arms,6,4,2
Pappyza,hyjal,384,warrior,arms,6,4,2
Forsi,draenor,384,warrior,arms,6,4,2
Ddfxz,draenor,384,warrior,arms,6,4,2
Eseishard,hyjal,384,warrior,arms,6,4,2
Spiokra,hellscream,384,warrior,arms,6,4,2
Рандомвар,howling-fjord,384,warrior,arms,6,4,2
Gipsylove,twisting-nether,384,warrior,arms,6,4,2
Kayhw,stormscale,384,warrior,arms,6,4,2
Sucemabanner,hyjal,384,warrior,arms,6,4,2
Sveafy,ravencrest,384,warrior,arms,6,4,2
Rëvenge,burning-legion,384,warrior,arms,6,4,2
Baluste,culte-de-la-rive-noire,384,warrior,arms,6,4,2
Bìgre,la-croisade-écarlate,384,warrior,arms,6,4,2
Haikyuu,blackhand,384,warrior,arms,6,4,2
Mashooxd,archimonde,384,warrior,arms,6,4,2
Intrepid,dun-modr,384,warrior,arms,6,4,2
Cebystance,kazzak,384,warrior,arms,6,4,2
Thorbjør,silvermoon,384,warrior,arms,6,4,2
Chmg,kirin-tor,384,warrior,arms,6,4,2
Elsiâs,aegwynn,384,warrior,arms,6,4,2
Qvicfrito,ravencrest,384,warrior,arms,6,4,2
Fknslow,ravencrest,384,warrior,arms,6,4,2
Akión,zuljin,384,warrior,arms,6,4,2
Reckxpeep,twisting-nether,384,warrior,arms,6,4,2
Tirex,stormscale,384,warrior,arms,6,4,2
Kisoshi,tarren-mill,384,warrior,arms,6,4,2
Dallion,azjolnerub,384,warrior,arms,6,4,2
Wïn,silvermoon,384,warrior,arms,6,4,2
Выбьюглазик,gordunni,384,warrior,arms,6,4,2
Bandfør,archimonde,384,warrior,arms,6,4,2
Abrogatio,emeriss,384,warrior,arms,6,4,2
Ryuuzetsu,drakthul,384,warrior,arms,6,4,2
Olfik,drakthul,384,warrior,arms,6,4,2
Fleshwerk,silvermoon,384,warrior,arms,6,4,2
Goretterog,ysondre,384,warrior,arms,6,4,2
Mayback,pozzo-delleternità,384,warrior,arms,6,4,2
Fløxswarri,blackmoore,384,warrior,arms,6,4,2
Bjornn,azjolnerub,384,warrior,arms,6,4,2
Лагалиер,borean-tundra,384,warrior,arms,6,4,2
Måydåy,twisting-nether,384,warrior,arms,6,4,2
Lakri,chants-éternels,384,warrior,arms,6,4,2
Fîlzlaus,area-52,384,warrior,arms,6,4,2
Rastaj,defias-brotherhood,384,warrior,arms,6,4,2
Garad,frostmane,384,warrior,arms,6,4,2
Имяужезанято,gordunni,384,warrior,arms,6,4,2
Ricovega,kazzak,384,warrior,arms,6,4,2
Kielon,kazzak,384,warrior,arms,6,4,2
Swig,twisting-nether,384,warrior,arms,6,4,2
Ansàvage,kazzak,384,warrior,arms,6,4,2
Ðíñøðøng,ravencrest,384,warrior,arms,6,4,2
Гигасмэш,gordunni,384,warrior,arms,6,4,2
Ødräcîë,silvermoon,384,warrior,arms,6,4,2
Haîltøkîng,alakir,384,warrior,arms,6,4,2
Xladérz,ravencrest,384,warrior,arms,6,4,2
Galous,burning-blade,384,warrior,arms,6,4,2
Zeó,silvermoon,384,warrior,arms,6,4,2
Dimitrow,frostmane,384,warrior,arms,6,4,2
Susugar,ysondre,384,warrior,arms,6,4,2
Кринжеверт,howling-fjord,384,warrior,arms,6,4,2
Bindcry,ahnqiraj,384,warrior,arms,6,4,2
Роудс,soulflayer,384,warrior,arms,6,4,2
Kalym,malygos,384,warrior,arms,6,4,2
Боссберс,howling-fjord,384,warrior,arms,6,4,2
Фиббоначи,deathguard,384,warrior,arms,6,4,2
Braveorc,kazzak,384,warrior,arms,6,4,2
Màrv,ravencrest,384,warrior,arms,6,4,2
Bjornska,defias-brotherhood,384,warrior,arms,6,4,2
Swaàg,archimonde,384,warrior,arms,6,4,2
Тандеракс,soulflayer,384,warrior,arms,6,4,2
Achîlles,twisting-nether,384,warrior,arms,6,4,2
Dräparren,ragnaros,384,warrior,arms,6,4,2
Highbuffalo,kazzak,384,warrior,arms,6,4,2
Ярыйваряг,soulflayer,384,warrior,arms,6,4,2
Anubisra,alakir,384,warrior,arms,6,4,2
Ceen,alakir,384,warrior,arms,6,4,2
Warzër,archimonde,384,warrior,arms,6,4,2
Slante,darksorrow,384,warrior,arms,6,4,2
Kevlarsusan,the-maelstrom,384,warrior,arms,6,4,2
Beznacaj,outland,384,warrior,arms,6,4,2
Youstupide,drekthar,384,warrior,arms,6,4,2
Cmonbrah,ravencrest,384,warrior,arms,6,4,2
Aliyáhh,blackrock,384,warrior,arms,6,4,2
Abunai,thrall,384,warrior,arms,6,4,2
Ivâar,archimonde,384,warrior,arms,6,4,2
Rimvar,alleria,384,warrior,arms,6,4,2
Tejkopejko,kazzak,384,warrior,arms,6,4,2
Unchåined,burning-legion,384,warrior,arms,6,4,2
Ветросвист,gordunni,384,warrior,arms,6,4,2
Syjin,antonidas,384,warrior,arms,6,4,2
Besån,ragnaros,384,warrior,arms,7,4,3
Sinimfzugzug,eredar,384,warrior,arms,10,5,5
Tweener,azjolnerub,384,warrior,arms,8,4,4
Merkakis,argent-dawn,384,warrior,arms,15,5,10
Cøbe,arthas,384,warrior,arms,12,4,8
Executorä,stormscale,384,warrior,arms,12,4,8
Khvor,blackmoore,384,warrior,arms,12,4,8
Арристокррат,soulflayer,384,warrior,arms,12,4,8
Stuffed,blackrock,384,warrior,arms,12,4,8
Анусбрейкер,soulflayer,384,warrior,arms,12,4,8
Starkz,hellscream,384,warrior,arms,12,4,8
Nerfslam,stormscale,384,warrior,arms,12,4,8
Eýoe,ragnaros,384,warrior,arms,12,4,8
Evermoon,sanguino,384,warrior,arms,12,4,8
Gorok,culte-de-la-rive-noire,384,warrior,arms,12,4,8
Oesche,frostmourne,384,warrior,arms,12,4,8
Kussetrold,outland,384,warrior,arms,12,4,8
Rïven,los-errantes,384,warrior,arms,12,4,8
Deathrazór,stormscale,384,warrior,arms,12,4,8
Лайонхартед,soulflayer,384,warrior,arms,12,4,8
Farewe,lightbringer,384,warrior,arms,12,4,8
Linberg,ysondre,384,warrior,arms,12,4,8
Ellissari,tirion,384,warrior,arms,12,4,8
Gkhan,draenor,384,warrior,arms,12,4,8
Pillorrior,ambossar,384,warrior,arms,12,4,8
Iiam,kilrogg,384,warrior,arms,12,4,8
Фаллопиев,borean-tundra,384,warrior,arms,12,4,8
Zersei,los-errantes,384,warrior,arms,12,4,8
Cryos,destromath,384,warrior,arms,12,4,8
Wilko,twisting-nether,384,warrior,arms,12,4,8
Syel,sinstralis,384,warrior,arms,12,4,8
Azdrubal,outland,384,warrior,arms,12,4,8
Ambraxon,blackmoore,384,warrior,arms,12,4,8
Dataproffs,outland,384,warrior,arms,12,4,8
Péter,arathor,384,warrior,arms,12,4,8
Джанобу,soulflayer,384,warrior,arms,12,4,8
Skyrrskyr,blackrock,384,warrior,arms,12,4,8
Dwarfdruine,dun-modr,384,warrior,arms,12,4,8
Schjøtt,ravencrest,384,warrior,arms,12,4,8
Sinkiss,archimonde,384,warrior,arms,12,4,8
Brokenrage,twisting-nether,384,warrior,arms,12,4,8
Xavari,twisting-nether,384,warrior,arms,12,4,8
Pushh,dun-modr,384,warrior,arms,12,4,8
Arrhennius,kazzak,384,warrior,arms,12,4,8
Hubusan,blackmoore,384,warrior,arms,12,4,8
Ryuma,lordaeron,384,warrior,arms,12,4,8
Invictàs,hyjal,384,warrior,arms,12,4,8
Gregórry,eredar,384,warrior,arms,12,4,8
Sonyd,tarren-mill,384,warrior,arms,12,4,8
Tenramar,silvermoon,384,warrior,arms,12,4,8
Adorlyna,silvermoon,384,warrior,arms,12,4,8
Jesuisgaydsl,archimonde,384,warrior,arms,12,4,8
Woghard,drakthul,384,warrior,arms,12,4,8
Arxnamus,silvermoon,384,warrior,arms,12,4,8
Osteskanken,ravencrest,384,warrior,arms,12,4,8
Xállek,veknilash,384,warrior,arms,12,4,8
Rngcarrier,sylvanas,384,warrior,arms,12,4,8
Stragga,eredar,384,warrior,arms,12,4,8
Mickyrex,hyjal,384,warrior,arms,12,4,8
Nameless,malganis,384,warrior,arms,12,4,8
Borion,blackmoore,384,warrior,arms,12,4,8
Whyduck,silvermoon,384,warrior,arms,12,4,8
Слоз,gordunni,384,warrior,arms,12,4,8
Ðræberen,kazzak,384,warrior,arms,12,4,8
Ceojohnny,ravencrest,384,warrior,arms,12,4,8
Mórghúlís,aegwynn,384,warrior,arms,12,4,8
Mârcxb,antonidas,384,warrior,arms,12,4,8
Jeyay,defias-brotherhood,384,warrior,arms,12,4,8
Drazug,defias-brotherhood,384,warrior,arms,12,4,8
Kasperw,kazzak,384,warrior,arms,12,4,8
Testortv,twisting-nether,384,warrior,arms,12,4,8
Fzit,kazzak,384,warrior,arms,12,4,8
Heclatos,hyjal,384,warrior,arms,12,4,8
Minetaur,burning-legion,384,warrior,arms,12,4,8
Rastov,argent-dawn,384,warrior,arms,12,4,8
Qwaggie,draenor,384,warrior,arms,12,4,8
Stanislav,tarren-mill,384,warrior,arms,12,4,8
Flugan,vashj,384,warrior,arms,12,4,8
Фаталлес,galakrond,384,warrior,arms,12,4,8
Sebotagelol,twisting-nether,384,warrior,arms,12,4,8
Brrochacho,defias-brotherhood,384,warrior,arms,12,4,8
Вамвоосна,gordunni,384,warrior,arms,12,4,8
Sovax,ravencrest,384,warrior,arms,12,4,8
Blackzor,ragnaros,384,warrior,arms,12,4,8
Sveñor,the-maelstrom,384,warrior,arms,12,4,8
Oglisten,archimonde,384,warrior,arms,12,4,8
Apemonkeydk,kazzak,384,warrior,arms,12,4,8
Gromock,the-maelstrom,384,warrior,arms,12,4,8
Арбелоа,gordunni,384,warrior,arms,12,4,8
Cyrø,blackmoore,384,warrior,arms,12,4,8
Kgx,argent-dawn,384,warrior,arms,12,4,8
Blaackbeard,blackmoore,384,warrior,arms,12,4,8
Freutag,azshara,384,warrior,arms,12,4,8
Raynorwarr,tarren-mill,384,warrior,arms,12,4,8
Boomxi,burning-legion,384,warrior,arms,12,4,8
Schultze,kazzak,384,warrior,arms,12,4,8
Axero,drakthul,384,warrior,arms,12,4,8
Auguston,argent-dawn,384,warrior,arms,12,4,8
Hiraclès,archimonde,384,warrior,arms,12,4,8
Веоленс,gordunni,384,warrior,arms,12,4,8
Gigac,ragnaros,384,warrior,arms,12,4,8
Альмас,galakrond,384,warrior,arms,12,4,8
Дахирарг,fordragon,384,warrior,arms,12,4,8
Zeover,ragnaros,384,warrior,arms,12,4,8
Haldrium,malganis,384,warrior,arms,12,4,8
Karadayii,blackmoore,384,warrior,arms,12,4,8
Huihui,die-aldor,384,warrior,arms,12,4,8
Модныйклык,eversong,384,warrior,arms,12,4,8
Wildblow,ravencrest,384,warrior,arms,12,4,8
Rfgpwhfgjawr,ravencrest,384,warrior,arms,12,4,8
Ærion,die-aldor,384,warrior,arms,12,4,8
Сэмвариор,gordunni,384,warrior,arms,12,4,8
Kronner,blackmoore,384,warrior,arms,12,4,8
Guarn,archimonde,384,warrior,arms,12,4,8
Chrid,silvermoon,384,warrior,arms,12,4,8
Ouryuu,hyjal,384,warrior,arms,12,4,8
Chadgarrosh,tarren-mill,384,warrior,arms,12,4,8
Craftorar,defias-brotherhood,384,warrior,arms,12,4,8
Luciferkhan,twisting-nether,384,warrior,arms,12,4,8
Willadimore,ravencrest,384,warrior,arms,12,4,8
Phalek,ravencrest,384,warrior,arms,14,4,10
Omcat,dun-modr,384,warrior,arms,27,6,21
Erololi,sanguino,384,warrior,arms,18,4,14
Маллал,soulflayer,384,warrior,arms,18,4,14
Pantsupic,archimonde,384,warrior,arms,18,4,14
Ganaroth,tarren-mill,384,warrior,arms,18,4,14
Ceb,drakthul,384,warrior,arms,18,4,14
Xxenaa,drakthul,384,warrior,arms,18,4,14
Kaij,draenor,384,warrior,arms,18,4,14
Moosewood,draenor,384,warrior,arms,18,4,14
Wifioffline,silvermoon,384,warrior,arms,18,4,14
Vanaxd,blackrock,384,warrior,arms,20,4,16
Реф,gordunni,383,warrior,arms,6,4,2
Ironstep,silvermoon,383,warrior,arms,6,4,2
Adelphi,blackrock,383,warrior,arms,6,4,2
Asurian,runetotem,383,warrior,arms,6,4,2
Красаучик,razuvious,383,warrior,arms,6,4,2
Kãzzgot,burning-legion,383,warrior,arms,6,4,2
Димаджер,razuvious,383,warrior,arms,6,4,2
Angrytmyself,silvermoon,383,warrior,arms,6,4,2
Халиоссф,gordunni,383,warrior,arms,9,5,4
Mashamasha,twisting-nether,383,warrior,arms,9,5,4
Варинуб,soulflayer,383,warrior,arms,12,6,6
Shimy,pozzo-delleternità,383,warrior,arms,12,4,8
Meetto,argent-dawn,383,warrior,arms,12,4,8
Bassenheim,deathwing,383,warrior,arms,12,4,8
Brandox,defias-brotherhood,383,warrior,arms,12,4,8
Варзибейра,blackscar,383,warrior,arms,12,4,8
Familyguy,sylvanas,383,warrior,arms,12,4,8
Alhexander,dun-modr,383,warrior,arms,12,4,8
Алибастор,galakrond,383,warrior,arms,12,4,8
Dundee,sanguino,383,warrior,arms,12,4,8
Khaczer,thunderhorn,383,warrior,arms,18,4,14
Dracos,mannoroth,383,warrior,arms,18,4,14
Xonnico,ravencrest,383,warrior,arms,18,4,14
Maxai,outland,382,warrior,arms,6,4,2
Brindzema,doomhammer,382,warrior,arms,6,4,2
Aethwa,stormscale,382,warrior,arms,6,4,2
Fatbud,tarren-mill,382,warrior,arms,6,4,2
Nuxx,tarren-mill,382,warrior,arms,12,4,8
Epmeowpewpew,turalyon,382,warrior,arms,18,4,14
Аскольд,deathguard,379,warrior,arms,12,4,8
Асстероид,galakrond,379,warrior,arms,12,4,8
Oxascand,kazzak,367,warrior,arms,17,4,13
Отсекатель,howling-fjord,367,warrior,arms,17,4,13
Свинореззка,howling-fjord,352,warrior,arms,10,4,6
Mynoona,stormscale,351,warrior,arms,11,4,7
Shînta,hyjal,351,warrior,arms,11,4,7
Badroch,kazzak,351,warrior,arms,11,4,7
Upholder,xavius,351,warrior,arms,11,4,7
Лесковер,howling-fjord,351,warrior,arms,11,4,7
Kriegerlutz,blackmoore,335,warrior,arms,11,4,7
Steels,outland,331,warrior,arms,11,4,7
Bêlier,hyjal,329,warrior,arms,16,6,10
Dyingdog,kazzak,320,warrior,arms,10,4,6
Scarlettjo,outland,320,warrior,arms,10,4,6
Тоштайн,gordunni,319,warrior,arms,5,4,1
Babb,kazzak,319,warrior,arms,5,4,1
Kegslayer,darksorrow,319,warrior,arms,8,4,4
Savaski,thrall,304,warrior,arms,7,4,3
Lovehope,stormscale,304,warrior,arms,7,4,3
Warrez,azuremyst,304,warrior,arms,7,4,3
Dattebane,silvermoon,304,warrior,arms,13,4,9
Spearmisser,argent-dawn,288,warrior,arms,6,3,3
Klistertejp,argent-dawn,288,warrior,arms,6,3,3
Кроуфури,gordunni,288,warrior,arms,6,3,3
Klunkepumper,ravencrest,288,warrior,arms,6,3,3
Skullbash,outland,288,warrior,arms,6,3,3
Knubbz,ravencrest,288,warrior,arms,6,3,3
Srbooty,kazzak,288,warrior,arms,6,3,3
Imherhusband,ravencrest,288,warrior,arms,6,3,3
Grók,outland,288,warrior,arms,6,3,3
Goochi,turalyon,288,warrior,arms,6,3,3
Smásher,thrall,288,warrior,arms,6,3,3
Exy,kazzak,288,warrior,arms,6,3,3
Rîiper,ysondre,288,warrior,arms,6,3,3
Inflacija,grim-batol,288,warrior,arms,6,3,3
Robitusin,ragnaros,288,warrior,arms,6,3,3
Dðni,archimonde,288,warrior,arms,6,3,3
Indiannaa,draenor,288,warrior,arms,6,3,3
Moorgoth,ysondre,288,warrior,arms,6,3,3
Rådne,argent-dawn,288,warrior,arms,6,3,3
Ashkandur,antonidas,288,warrior,arms,6,3,3
Hemèra,hyjal,288,warrior,arms,6,3,3
Stãrscream,ysondre,288,warrior,arms,6,3,3
Blinkcharge,frostmane,288,warrior,arms,6,3,3
Suizix,blackrock,288,warrior,arms,6,3,3
Contdem,kazzak,288,warrior,arms,6,3,3
Afes,kazzak,288,warrior,arms,6,3,3
Zleyni,blackrock,288,warrior,arms,6,3,3
Instamerk,doomhammer,288,warrior,arms,6,3,3
Critwar,draenor,288,warrior,arms,6,3,3
Sentenzah,arakarahm,288,warrior,arms,6,3,3
Pouckette,hyjal,288,warrior,arms,6,3,3
Culwyn,frostmane,288,warrior,arms,6,3,3
Raïgã,hyjal,288,warrior,arms,6,3,3
Slayermaxx,kazzak,288,warrior,arms,6,3,3
Mòóds,malganis,288,warrior,arms,6,3,3
Féélmyfury,tarren-mill,288,warrior,arms,6,3,3
Xaidos,antonidas,288,warrior,arms,6,3,3
Pwncallxx,kazzak,288,warrior,arms,6,3,3
Elainax,eredar,288,warrior,arms,6,3,3
Neaka,archimonde,288,warrior,arms,6,3,3
Cptwheelchr,blackmoore,288,warrior,arms,6,3,3
Warriur,outland,288,warrior,arms,6,3,3
Pector,grim-batol,288,warrior,arms,6,3,3
Bundo,outland,288,warrior,arms,6,3,3
Issus,aggra-português,288,warrior,arms,6,3,3
Jammy,dentarg,288,warrior,arms,6,3,3
Irastah,frostmane,288,warrior,arms,6,3,3
Boig,ragnaros,288,warrior,arms,6,3,3
Noriela,archimonde,288,warrior,arms,6,3,3
Hatefull,onyxia,288,warrior,arms,6,3,3
Юргоз,howling-fjord,288,warrior,arms,6,3,3
Airethon,proudmoore,288,warrior,arms,6,3,3
Risara,outland,288,warrior,arms,6,3,3
Cerßêre,archimonde,288,warrior,arms,6,3,3
Dekzu,stormscale,288,warrior,arms,6,3,3
Topur,defias-brotherhood,288,warrior,arms,6,3,3
Miniwitts,ravencrest,288,warrior,arms,6,3,3
Thesituation,onyxia,288,warrior,arms,6,3,3
Evís,ragnaros,288,warrior,arms,6,3,3
Wárríor,ragnaros,288,warrior,arms,6,3,3
Stompare,tarren-mill,288,warrior,arms,6,3,3
Mightyrage,draenor,288,warrior,arms,6,3,3
Xiom,blackrock,288,warrior,arms,6,3,3
Exhumator,blackhand,288,warrior,arms,6,3,3
Ragnärey,voljin,288,warrior,arms,6,3,3
Суферна,howling-fjord,288,warrior,arms,6,3,3
Alaë,archimonde,288,warrior,arms,6,3,3
Vãnquish,archimonde,288,warrior,arms,6,3,3
Топлюзаорду,borean-tundra,288,warrior,arms,6,3,3
Alphyn,veknilash,288,warrior,arms,6,3,3
Стальнойорех,gordunni,288,warrior,arms,6,3,3
Lìcious,outland,288,warrior,arms,6,3,3
Nofêar,anubarak,288,warrior,arms,6,3,3
Kyraeth,defias-brotherhood,288,warrior,arms,6,3,3
Flürix,outland,288,warrior,arms,6,3,3
Hydracleave,ravencrest,288,warrior,arms,6,3,3
Неомх,howling-fjord,288,warrior,arms,6,3,3
Greatsword,turalyon,288,warrior,arms,6,3,3
Koffìe,tarren-mill,288,warrior,arms,6,3,3
Crimmwarr,aegwynn,288,warrior,arms,6,3,3
Mønzie,outland,288,warrior,arms,6,3,3
Gnarrwarr,eredar,288,warrior,arms,6,3,3
Xsasuke,ragnaros,288,warrior,arms,6,3,3
Tojaraa,kazzak,288,warrior,arms,6,3,3
Drengr,blackhand,288,warrior,arms,6,3,3
Изикол,blackscar,288,warrior,arms,6,3,3
Дзертуф,fordragon,288,warrior,arms,6,3,3
Møtomoto,defias-brotherhood,288,warrior,arms,6,3,3
Warwarsat,ysondre,288,warrior,arms,6,3,3
Hanibalbarca,tarren-mill,288,warrior,arms,6,3,3
Farnorn,kazzak,288,warrior,arms,6,3,3
Xiphiatwo,ravencrest,288,warrior,arms,6,3,3
Toleck,aegwynn,288,warrior,arms,6,3,3
Yotanwa,aegwynn,288,warrior,arms,6,3,3
Mauser,thrall,288,warrior,arms,6,3,3
Ragewin,kelthuzad,288,warrior,arms,6,3,3
Hietfield,twisting-nether,288,warrior,arms,6,3,3
Rasvamaksa,stormscale,288,warrior,arms,6,3,3
Venturez,stormscale,288,warrior,arms,6,3,3
Quáker,stormscale,288,warrior,arms,6,3,3
Tinydik,stormscale,288,warrior,arms,6,3,3
Somalisktjur,tarren-mill,288,warrior,arms,6,3,3
Экзекуторх,gordunni,288,warrior,arms,6,3,3
Shredded,stormscale,288,warrior,arms,6,3,3
Bleedmuch,silvermoon,288,warrior,arms,6,3,3
Mobyl,twisting-nether,288,warrior,arms,6,3,3
Soulmatee,aegwynn,288,warrior,arms,6,3,3
Baiganya,neptulon,288,warrior,arms,6,3,3
Ididntbindit,stormscale,288,warrior,arms,6,3,3
Nuhilug,tarren-mill,288,warrior,arms,6,3,3
Tumuerte,dun-modr,288,warrior,arms,6,3,3
Twelvearmsun,tarren-mill,288,warrior,arms,6,3,3
Raistwar,magtheridon,288,warrior,arms,6,3,3
Bânkai,aegwynn,288,warrior,arms,6,3,3
Kazzuk,dentarg,288,warrior,arms,6,3,3
Mukcho,sylvanas,288,warrior,arms,6,3,3
Tommytorres,stormscale,288,warrior,arms,6,3,3
Ranndall,blackrock,288,warrior,arms,6,3,3
Mogguh,tarren-mill,288,warrior,arms,6,3,3
Resttanis,arathor,288,warrior,arms,6,3,3
Fnoon,taerar,288,warrior,arms,6,3,3
Aestl,blackhand,288,warrior,arms,6,3,3
Barbatos,saurfang,288,warrior,arms,6,3,3
Sharn,emeriss,288,warrior,arms,6,3,3
Köftemecx,blackrock,288,warrior,arms,6,3,3
Karsul,shendralar,288,warrior,arms,6,3,3
Чтота,gordunni,288,warrior,arms,6,3,3
Sóuler,blackhand,288,warrior,arms,6,3,3
Stahlhund,silvermoon,288,warrior,arms,6,3,3
Béhrus,blackmoore,288,warrior,arms,6,3,3
Byrnjolf,zuljin,288,warrior,arms,6,3,3
Грассфеникс,gordunni,288,warrior,arms,6,3,3
Îgris,sanguino,288,warrior,arms,6,3,3
Flava,drakthul,288,warrior,arms,6,3,3
Venomflex,sanguino,288,warrior,arms,6,3,3
Fantawesome,ragnaros,288,warrior,arms,6,3,3
Eradya,ravencrest,288,warrior,arms,6,3,3
Waron,dalaran,288,warrior,arms,6,3,3
Madbert,drakthul,288,warrior,arms,6,3,3
Tankdepalo,sanguino,288,warrior,arms,6,3,3
Frenzyqt,zuljin,288,warrior,arms,6,3,3
Thebiggreen,twisting-nether,288,warrior,arms,6,3,3
Waescanor,ragnaros,288,warrior,arms,6,3,3
Luckyfelix,blackmoore,288,warrior,arms,6,3,3
Citrok,dun-modr,288,warrior,arms,6,3,3
Sïmstärxzy,hakkar,288,warrior,arms,6,3,3
Whiskes,silvermoon,288,warrior,arms,6,3,3
Инкула,gordunni,288,warrior,arms,6,3,3
Тотбывалый,soulflayer,288,warrior,arms,6,3,3
Enkö,twisting-nether,288,warrior,arms,6,3,3
Stiefbrudah,blackmoore,288,warrior,arms,6,3,3
Lawkh,sanguino,288,warrior,arms,6,3,3
Bolss,silvermoon,288,warrior,arms,6,3,3
Kampfrausch,blackmoore,288,warrior,arms,6,3,3
Khorgash,ravencrest,288,warrior,arms,6,3,3
Extrémex,stormscale,288,warrior,arms,6,3,3
Onoclus,sylvanas,288,warrior,arms,6,3,3
Kheiden,silvermoon,288,warrior,arms,6,3,3
Razza,ravencrest,288,warrior,arms,6,3,3
Xqty,ravencrest,288,warrior,arms,6,3,3
Alvis,nathrezim,288,warrior,arms,6,3,3
Gylfanders,the-maelstrom,288,warrior,arms,6,3,3
Фэймстар,soulflayer,288,warrior,arms,6,3,3
Vorri,ravencrest,288,warrior,arms,6,3,3
Mauricet,elune,288,warrior,arms,6,3,3
Доррин,deathguard,288,warrior,arms,6,3,3
Aedin,ravencrest,288,warrior,arms,6,3,3
Bigmalx,darkspear,288,warrior,arms,6,3,3
Fotmheróqtxd,ravencrest,288,warrior,arms,6,3,3
Lödbrök,dalaran,288,warrior,arms,6,3,3
Wellus,silvermoon,288,warrior,arms,6,3,3
Pioneer,blackhand,288,warrior,arms,6,3,3
Doghxnterx,ravencrest,288,warrior,arms,6,3,3
Träglik,thrall,288,warrior,arms,6,3,3
Retter,ravencrest,288,warrior,arms,6,3,3
Jimli,malygos,288,warrior,arms,6,3,3
Meywara,blackhand,288,warrior,arms,6,3,3
Nurfdw,ravencrest,288,warrior,arms,6,3,3
Zalameh,sylvanas,288,warrior,arms,6,3,3
Kindface,the-maelstrom,288,warrior,arms,6,3,3
Mightyzuv,the-maelstrom,288,warrior,arms,6,3,3
Deniosan,blackhand,288,warrior,arms,6,3,3
Lacos,drakthul,288,warrior,arms,6,3,3
Nahkampfnoob,blackmoore,288,warrior,arms,6,3,3
Virginity,sylvanas,288,warrior,arms,6,3,3
Morgendämeru,baelgun,288,warrior,arms,6,3,3
Goinhamx,blackhand,288,warrior,arms,6,3,3
Ахе,deathguard,288,warrior,arms,6,3,3
Ликано,greymane,288,warrior,arms,6,3,3
Дэйст,ashenvale,288,warrior,arms,6,3,3
Willywolxx,silvermoon,288,warrior,arms,6,3,3
Fargon,ravencrest,288,warrior,arms,6,3,3
Гениауч,eversong,288,warrior,arms,6,3,3
Arachnoyd,drakthul,288,warrior,arms,6,3,3
Ланат,ashenvale,288,warrior,arms,6,3,3
Sktnsilv,malfurion,288,warrior,arms,6,3,3
Suwarri,antonidas,288,warrior,arms,9,4,5
Ëlränger,dun-modr,288,warrior,arms,9,4,5
Monforte,silvermoon,288,warrior,arms,9,3,6
Elkatar,stormscale,288,warrior,arms,9,3,6
Kuchîoff,uldaman,288,warrior,arms,10,3,7
Balferenfgt,magtheridon,288,warrior,arms,15,4,11
Leonídás,blackhand,288,warrior,arms,15,4,11
Raithwall,stormreaver,288,warrior,arms,12,3,9
Ivailowar,ravencrest,288,warrior,arms,12,3,9
Warzaph,ravencrest,288,warrior,arms,12,3,9
Awewar,crushridge,288,warrior,arms,12,3,9
Aiwar,tarren-mill,288,warrior,arms,12,3,9
Refl,kazzak,288,warrior,arms,12,3,9
Burbidge,silvermoon,288,warrior,arms,12,3,9
Telrion,silvermoon,288,warrior,arms,12,3,9
Bozwa,silvermoon,288,warrior,arms,12,3,9
Goroth,vashj,288,warrior,arms,12,3,9
Smökey,silvermoon,288,warrior,arms,12,3,9
Héraclès,ravencrest,288,warrior,arms,12,3,9
Grodor,alakir,288,warrior,arms,12,3,9
Амбробенне,soulflayer,288,warrior,arms,12,3,9
Stoutsteel,kazzak,288,warrior,arms,12,3,9
Mistafleex,hyjal,288,warrior,arms,12,3,9
Willraxx,draenor,288,warrior,arms,12,3,9
Allmight,gorgonnash,288,warrior,arms,12,3,9
Pulx,dun-modr,288,warrior,arms,12,3,9
Executioner,ravencrest,288,warrior,arms,12,3,9
Gloindal,pozzo-delleternità,288,warrior,arms,12,3,9
Xtylu,cthun,288,warrior,arms,12,3,9
Lukkass,ravencrest,288,warrior,arms,12,3,9
Renix,auchindoun,288,warrior,arms,12,3,9
Algazarra,aggra-português,288,warrior,arms,12,3,9
Jivua,blackrock,288,warrior,arms,12,3,9
Acidumcremor,burning-legion,288,warrior,arms,12,3,9
Тирхо,gordunni,288,warrior,arms,12,3,9
Btkayy,tarren-mill,288,warrior,arms,12,3,9
Оверфлок,howling-fjord,288,warrior,arms,12,3,9
Брокксигарр,borean-tundra,288,warrior,arms,12,3,9
Gabbz,aggra-português,288,warrior,arms,12,3,9
Worcan,blackmoore,288,warrior,arms,12,3,9
Rychu,hellfire,288,warrior,arms,12,3,9
Nerdcorex,blackrock,288,warrior,arms,12,3,9
Poluneikos,turalyon,288,warrior,arms,12,3,9
Flexay,archimonde,288,warrior,arms,12,3,9
Вениамин,fordragon,288,warrior,arms,12,3,9
Варкрафтор,howling-fjord,288,warrior,arms,12,3,9
Gnomeð,blackrock,288,warrior,arms,12,3,9
Uthric,azuremyst,288,warrior,arms,12,3,9
Brooktar,sanguino,288,warrior,arms,12,3,9
Jimbock,eredar,288,warrior,arms,12,3,9
Conarconarik,zuluhed,288,warrior,arms,12,3,9
Simplyautism,silvermoon,288,warrior,arms,12,3,9
Ysmay,dun-morogh,288,warrior,arms,12,3,9
Danaüs,twisting-nether,288,warrior,arms,12,3,9
Buncljin,draenor,288,warrior,arms,12,3,9
Argean,argent-dawn,288,warrior,arms,12,3,9
Blxxwar,blackmoore,288,warrior,arms,12,3,9
Mino,theradras,288,warrior,arms,12,3,9
Nolavvii,ragnaros,288,warrior,arms,12,3,9
Zhodd,zuljin,288,warrior,arms,12,3,9
Tøytank,twisting-nether,288,warrior,arms,12,3,9
Роглум,blackscar,288,warrior,arms,12,3,9
Mercûry,stormscale,288,warrior,arms,12,3,9
Экзекутэр,soulflayer,288,warrior,arms,12,3,9
Турбобулка,gordunni,288,warrior,arms,12,3,9
Камрадшторм,borean-tundra,288,warrior,arms,12,3,9
Thorgaz,blackmoore,288,warrior,arms,12,3,9
Qdex,kazzak,288,warrior,arms,12,3,9
Gladiatoor,terenas,288,warrior,arms,12,3,9
Danrel,dalaran,288,warrior,arms,12,3,9
Sorryforwhat,stormscale,288,warrior,arms,12,3,9
Bolvarson,malganis,288,warrior,arms,12,3,9
Syruz,malganis,288,warrior,arms,12,3,9
Азизос,gordunni,288,warrior,arms,12,3,9
Armsstrong,blackhand,288,warrior,arms,12,3,9
Snissel,guldan,288,warrior,arms,12,3,9
Баам,fordragon,288,warrior,arms,12,3,9
Currarms,aegwynn,288,warrior,arms,13,3,10
Ervanw,sylvanas,288,warrior,arms,17,3,14
Старыйклоп,blackscar,288,warrior,arms,18,3,15
Rimstealer,tarren-mill,288,warrior,arms,18,3,15
Marax,spinebreaker,288,warrior,arms,18,3,15
Cassetibiat,rashgarroth,288,warrior,arms,18,3,15
Mercaderx,stormscale,287,warrior,arms,6,3,3
Всемкуяолд,gordunni,287,warrior,arms,6,3,3
Warrsong,dun-modr,287,warrior,arms,6,3,3
Blainebonk,arathor,287,warrior,arms,6,3,3
Ironkee,kazzak,287,warrior,arms,6,3,3
Kaazzuraa,hyjal,287,warrior,arms,6,3,3
Teñseî,archimonde,287,warrior,arms,6,3,3
Хелледрин,azuregos,287,warrior,arms,6,3,3
Falaliss,elune,287,warrior,arms,12,3,9
Ymïrjar,sanguino,287,warrior,arms,12,3,9
Freakzy,blackhand,287,warrior,arms,12,3,9
Akawan,ravencrest,287,warrior,arms,12,3,9
Ayatolah,kazzak,287,warrior,arms,12,3,9
Себаст,galakrond,286,warrior,arms,12,3,9
Пунишерс,howling-fjord,286,warrior,arms,12,3,9
Újorcharcos,ragnaros,286,warrior,arms,12,3,9
Thoon,teldrassil,284,warrior,arms,12,3,9
Galidras,nemesis,271,warrior,arms,11,3,8
Warbringér,ravencrest,271,warrior,arms,11,3,8
Evèllon,blackmoore,271,warrior,arms,11,3,8
Gwagonbrabus,twisting-nether,271,warrior,arms,17,3,14
Kanyequest,bloodhoof,266,warrior,arms,15,5,10
Brùtus,exodar,265,warrior,arms,14,5,9
Deci,bronzebeard,256,warrior,arms,10,3,7
Чикенсы,gordunni,256,warrior,arms,10,3,7
Jvpx,silvermoon,256,warrior,arms,10,3,7
Lokkara,blackrock,255,warrior,arms,8,4,4
Angrethar,tarren-mill,255,warrior,arms,8,4,4
Uki,kazzak,255,warrior,arms,11,3,8
Aleksandar,ravencrest,255,warrior,arms,11,3,8
Nurream,ravencrest,255,warrior,arms,11,3,8
Ânaxi,silvermoon,255,warrior,arms,11,3,8
Legharta,tarren-mill,240,warrior,arms,9,3,6
Ntouziera,silvermoon,239,warrior,arms,5,3,2
Sarma,trollbane,239,warrior,arms,5,3,2
Inselmo,grim-batol,239,warrior,arms,5,3,2
Keffboi,draenor,239,warrior,arms,5,3,2
Renji,proudmoore,239,warrior,arms,5,3,2
Dooguystyle,archimonde,239,warrior,arms,5,3,2
Sloody,ravencrest,239,warrior,arms,5,3,2
Bubidiblumxq,twisting-nether,239,warrior,arms,9,4,5
Porthios,azshara,239,warrior,arms,9,3,6
Xeonair,kazzak,234,warrior,arms,8,4,4
Tstrike,silvermoon,234,warrior,arms,9,4,5
Zyou,stormscale,234,warrior,arms,17,6,11
Myshu,ravencrest,234,warrior,arms,14,4,10
Bloodrâgê,silvermoon,224,warrior,arms,10,3,7
Artaas,drakthul,223,warrior,arms,8,3,5
Justah,silvermoon,208,warrior,arms,7,3,4
Brutariz,silvermoon,208,warrior,arms,7,3,4
Шрекинатор,soulflayer,208,warrior,arms,7,3,4
Rhw,tarren-mill,208,warrior,arms,13,3,10
Sargonas,burning-blade,192,warrior,arms,4,3,1
Toptier,drakthul,192,warrior,arms,4,3,1
Epimeno,tarren-mill,192,warrior,arms,4,3,1
Scootter,ravencrest,192,warrior,arms,9,3,6
Wowbert,frostwolf,192,warrior,arms,9,3,6
Iclickbutton,kazzak,192,warrior,arms,9,3,6
Connorzqt,ravencrest,192,warrior,arms,6,2,4
Aedanath,dragonblight,192,warrior,arms,6,2,4
Gergereja,argent-dawn,192,warrior,arms,6,2,4
Råzor,blackhand,192,warrior,arms,6,2,4
Dajnatarcze,burning-legion,192,warrior,arms,6,2,4
Highoverlord,aggra-português,192,warrior,arms,6,2,4
Tinker,crushridge,192,warrior,arms,6,2,4
Byedriver,kazzak,192,warrior,arms,6,2,4
Chargezon,drakthul,192,warrior,arms,6,2,4
Shieldstand,kazzak,192,warrior,arms,6,2,4
Chloade,burning-legion,192,warrior,arms,6,2,4
Kerando,tirion,192,warrior,arms,6,2,4
Кичисан,howling-fjord,192,warrior,arms,6,2,4
Sxng,deathwing,192,warrior,arms,6,2,4
Tigron,burning-legion,192,warrior,arms,6,2,4
Akkamagosh,argent-dawn,192,warrior,arms,6,2,4
Kíllguard,kazzak,192,warrior,arms,6,2,4
Còle,blackrock,192,warrior,arms,6,2,4
Бормормуш,gordunni,192,warrior,arms,6,2,4
Lâppön,blackmoore,192,warrior,arms,6,2,4
Artemiox,silvermoon,192,warrior,arms,6,2,4
Apolyptica,blackmoore,192,warrior,arms,6,2,4
Труска,ashenvale,192,warrior,arms,6,2,4
Wilæm,argent-dawn,192,warrior,arms,6,2,4
Кереешка,howling-fjord,192,warrior,arms,6,2,4
Pumse,silvermoon,192,warrior,arms,6,2,4
Jdcw,chamber-of-aspects,192,warrior,arms,6,2,4
Toporceanul,kazzak,192,warrior,arms,6,2,4
Darkbehemoth,kazzak,192,warrior,arms,6,2,4
Speiker,blackhand,192,warrior,arms,6,2,4
Апёхэндз,howling-fjord,192,warrior,arms,6,2,4
Bitethedust,darkspear,192,warrior,arms,6,2,4
Djarenn,defias-brotherhood,192,warrior,arms,6,2,4
Loutreboite,archimonde,192,warrior,arms,6,2,4
Rezn,kazzak,192,warrior,arms,6,2,4
Acour,elune,192,warrior,arms,6,2,4
Guttormur,dragonblight,192,warrior,arms,6,2,4
ßandit,ravencrest,192,warrior,arms,6,2,4
Lildiabeto,darkspear,192,warrior,arms,6,2,4
Neozz,ravencrest,192,warrior,arms,6,2,4
Touthi,archimonde,192,warrior,arms,6,2,4
Kogän,ragnaros,192,warrior,arms,6,2,4
Athrea,senjin,192,warrior,arms,6,2,4
Xatit,ravencrest,192,warrior,arms,6,2,4
Azurnok,argent-dawn,192,warrior,arms,6,2,4
Vexari,twisting-nether,192,warrior,arms,6,2,4
Spaiché,azshara,192,warrior,arms,6,2,4
Stonlocked,blackhand,192,warrior,arms,6,2,4
Shinychan,silvermoon,192,warrior,arms,6,2,4
Warriorussy,ravencrest,192,warrior,arms,6,2,4
Unehuitsept,eredar,192,warrior,arms,6,2,4
Манарет,gordunni,192,warrior,arms,6,2,4
Bulbasaur,twisting-nether,192,warrior,arms,6,2,4
Weren,blackmoore,192,warrior,arms,6,2,4
Очепенец,soulflayer,192,warrior,arms,6,2,4
Kirîto,dalaran,192,warrior,arms,6,2,4
Arthayl,eredar,192,warrior,arms,6,2,4
Gothgirlgg,argent-dawn,192,warrior,arms,6,2,4
Fastnfuryous,antonidas,192,warrior,arms,6,2,4
Nînes,tarren-mill,192,warrior,arms,6,2,4
Aeres,bladefist,192,warrior,arms,6,2,4
Yumahee,kult-der-verdammten,192,warrior,arms,6,2,4
Bromaz,blackmoore,192,warrior,arms,6,2,4
Sashafierce,tarren-mill,192,warrior,arms,6,2,4
Bennybryt,frostmane,192,warrior,arms,6,2,4
Faláfel,zuljin,192,warrior,arms,6,2,4
Baylis,kazzak,192,warrior,arms,6,2,4
Jaés,kazzak,192,warrior,arms,6,2,4
Ghorgutz,kazzak,192,warrior,arms,6,2,4
Poronga,sanguino,192,warrior,arms,6,2,4
Galenthor,ravencrest,192,warrior,arms,6,2,4
Aléxsandra,ravencrest,192,warrior,arms,6,2,4
Jares,argent-dawn,192,warrior,arms,6,2,4
Kladers,ravencrest,192,warrior,arms,6,2,4
Paralantius,kazzak,192,warrior,arms,6,2,4
Cromix,blackrock,192,warrior,arms,6,2,4
Greybâck,alleria,192,warrior,arms,6,2,4
Ивантуз,gordunni,192,warrior,arms,6,2,4
Gamedogo,silvermoon,192,warrior,arms,6,2,4
Sambaswiss,kazzak,192,warrior,arms,6,2,4
Gkavlaki,ravencrest,192,warrior,arms,6,2,4
Progresslol,tarren-mill,192,warrior,arms,6,2,4
Ratnìk,stormscale,192,warrior,arms,6,2,4
Røcksteady,festung-der-stürme,192,warrior,arms,6,2,4
Edurionw,kazzak,192,warrior,arms,6,2,4
Gymhan,the-shatar,192,warrior,arms,6,2,4
Sargul,ragnaros,192,warrior,arms,6,2,4
Discoklaus,blackmoore,192,warrior,arms,6,2,4
Vrii,eredar,192,warrior,arms,6,2,4
Bigpressure,blackhand,192,warrior,arms,6,2,4
Borntothis,zuljin,192,warrior,arms,6,2,4
Laakes,eredar,192,warrior,arms,6,2,4
Råkeff,tarren-mill,192,warrior,arms,6,2,4
Cjak,pozzo-delleternità,192,warrior,arms,6,2,4
Woximus,ravencrest,192,warrior,arms,6,2,4
Poliam,blackmoore,192,warrior,arms,6,2,4
Sibali,stormreaver,192,warrior,arms,6,2,4
Iordmatesp,drakthul,192,warrior,arms,6,2,4
Jatze,sanguino,192,warrior,arms,6,2,4
Retwarbtw,ragnaros,192,warrior,arms,6,2,4
Адамз,gordunni,192,warrior,arms,6,2,4
Chickengodx,archimonde,192,warrior,arms,6,2,4
Omgez,grim-batol,192,warrior,arms,6,2,4
Realz,malganis,192,warrior,arms,6,2,4
Boji,twisting-nether,192,warrior,arms,6,2,4
Enzylolz,sanguino,192,warrior,arms,6,2,4
Владикчардж,gordunni,192,warrior,arms,6,2,4
Steggee,argent-dawn,192,warrior,arms,6,2,4
Moolong,nozdormu,192,warrior,arms,6,2,4
Seghrim,drakthul,192,warrior,arms,6,2,4
Орвинг,soulflayer,192,warrior,arms,6,2,4
Aliáto,sanguino,192,warrior,arms,6,2,4
Guryn,sanguino,192,warrior,arms,6,2,4
Арестант,soulflayer,192,warrior,arms,6,2,4
Centuriôn,sanguino,192,warrior,arms,6,2,4
Jaeru,archimonde,192,warrior,arms,6,2,4
Watsabe,kazzak,192,warrior,arms,6,2,4
Bicepss,blackhand,192,warrior,arms,6,2,4
Tacco,ravencrest,192,warrior,arms,6,2,4
Fistawarrior,nemesis,192,warrior,arms,6,2,4
Athënã,archimonde,192,warrior,arms,6,2,4
Gucchy,nemesis,192,warrior,arms,6,2,4
Hittanebo,twisting-nether,192,warrior,arms,6,2,4
Amazòn,stormscale,192,warrior,arms,6,2,4
Ptp,argent-dawn,192,warrior,arms,6,2,4
Эгнораш,soulflayer,192,warrior,arms,6,2,4
Bloodparade,argent-dawn,192,warrior,arms,6,2,4
Warrlee,ravencrest,192,warrior,arms,6,2,4
Kharabik,silvermoon,192,warrior,arms,6,2,4
Svepscumata,twisting-nether,192,warrior,arms,6,2,4
Tekà,tarren-mill,192,warrior,arms,6,2,4
Bonkors,bronzebeard,192,warrior,arms,6,2,4
Pimagnum,stormscale,192,warrior,arms,6,2,4
Havkon,twisting-nether,192,warrior,arms,6,2,4
Amphie,silvermoon,192,warrior,arms,6,2,4
Skalì,archimonde,192,warrior,arms,6,2,4
Brutalizator,talnivarr,192,warrior,arms,6,2,4
Audelia,sunstrider,192,warrior,arms,6,2,4
Jaffacakes,kazzak,192,warrior,arms,6,2,4
Miotyz,ahnqiraj,192,warrior,arms,6,2,4
Scheroh,aegwynn,192,warrior,arms,6,2,4
Yoruíchi,sunstrider,192,warrior,arms,6,2,4
Syrebral,archimonde,192,warrior,arms,6,2,4
Bigestdamugr,stormscale,192,warrior,arms,6,2,4
Zenìa,argent-dawn,192,warrior,arms,6,2,4
Einhérjer,thrall,192,warrior,arms,6,2,4
Laßebluten,blackmoore,192,warrior,arms,6,2,4
Leaply,kazzak,192,warrior,arms,6,2,4
Longy,mazrigos,192,warrior,arms,6,2,4
Redencounter,stormscale,192,warrior,arms,6,2,4
Itchiiz,alonsus,192,warrior,arms,6,2,4
Truepassion,outland,192,warrior,arms,6,2,4
Diô,stormscale,192,warrior,arms,6,2,4
Noflameøfc,stormscale,192,warrior,arms,6,2,4
Gardom,doomhammer,192,warrior,arms,6,2,4
Pépêloup,archimonde,192,warrior,arms,6,2,4
Grimaced,tarren-mill,192,warrior,arms,6,2,4
Payßack,drakthul,192,warrior,arms,6,2,4
Meìlie,outland,192,warrior,arms,6,2,4
Yìnkxx,blackmoore,192,warrior,arms,6,2,4
Míngxuan,tarren-mill,192,warrior,arms,6,2,4
Angusbully,doomhammer,192,warrior,arms,6,2,4
Karkun,gilneas,192,warrior,arms,6,2,4
Leazin,outland,192,warrior,arms,6,2,4
Прикурил,gordunni,192,warrior,arms,6,2,4
Eifachöppis,blackhand,192,warrior,arms,6,2,4
Bukî,blackmoore,192,warrior,arms,6,2,4
Menelol,ysondre,192,warrior,arms,6,2,4
Octaniuz,silvermoon,192,warrior,arms,6,2,4
Escånør,archimonde,192,warrior,arms,6,2,4
Katypärry,outland,192,warrior,arms,6,2,4
Ismashu,anubarak,192,warrior,arms,6,2,4
Sancari,blackmoore,192,warrior,arms,6,2,4
Abibe,aggra-português,192,warrior,arms,6,2,4
Sxciestlsbin,stormscale,192,warrior,arms,6,2,4
Luderyo,outland,192,warrior,arms,6,2,4
Eleborn,tarren-mill,192,warrior,arms,6,2,4
Monkaslam,tarren-mill,192,warrior,arms,6,2,4
Raggnnar,blackrock,192,warrior,arms,6,2,4
Дахаэрис,gordunni,192,warrior,arms,6,2,4
Like,blackrock,192,warrior,arms,6,2,4
Grimilax,hellscream,192,warrior,arms,6,2,4
Thatsthepump,silvermoon,192,warrior,arms,6,2,4
Siberianstag,ravencrest,192,warrior,arms,6,2,4
Broley,blackhand,192,warrior,arms,6,2,4
Niffen,stormscale,192,warrior,arms,6,2,4
Ciuez,tarren-mill,192,warrior,arms,6,2,4
Auriwariah,silvermoon,192,warrior,arms,6,2,4
Mundigor,medivh,192,warrior,arms,6,2,4
Därlara,amanthul,192,warrior,arms,6,2,4
Æyra,durotan,192,warrior,arms,6,2,4
Гудмунт,borean-tundra,192,warrior,arms,6,2,4
Zaoclap,blackhand,192,warrior,arms,6,2,4
Киллиаф,howling-fjord,192,warrior,arms,6,2,4
Fitzer,ravencrest,192,warrior,arms,6,2,4
Берззлой,gordunni,192,warrior,arms,6,2,4
Granrubin,dun-modr,192,warrior,arms,6,2,4
Burkek,hyjal,192,warrior,arms,6,2,4
Hé,draenor,192,warrior,arms,6,2,4
Vulcán,aerie-peak,192,warrior,arms,6,2,4
Rastaboo,ravencrest,192,warrior,arms,6,2,4
Vearpayne,silvermoon,192,warrior,arms,6,2,4
Ratafya,hyjal,192,warrior,arms,6,2,4
Skeyzêr,dun-modr,192,warrior,arms,6,2,4
Snakééyés,kazzak,192,warrior,arms,6,2,4
Varix,burning-blade,192,warrior,arms,6,2,4
Ryonâgai,aegwynn,192,warrior,arms,6,2,4
Shakz,argent-dawn,192,warrior,arms,6,2,4
Spankyew,sylvanas,192,warrior,arms,6,2,4
Xáníes,draenor,192,warrior,arms,6,2,4
Hurricane,sylvanas,192,warrior,arms,6,2,4
Марфитус,borean-tundra,192,warrior,arms,6,2,4
Zigcc,draenor,192,warrior,arms,6,2,4
Zanzagg,draenor,192,warrior,arms,6,2,4
Vaaýzx,blackrock,192,warrior,arms,6,2,4
Bêllator,stormscale,192,warrior,arms,6,2,4
Gretathunb,twisting-nether,192,warrior,arms,6,2,4
Maeselance,dun-modr,192,warrior,arms,6,2,4
Mightywar,hyjal,192,warrior,arms,6,2,4
Demolize,sylvanas,192,warrior,arms,6,2,4
Xilthy,stormscale,192,warrior,arms,6,2,4
Jamoo,magtheridon,192,warrior,arms,6,2,4
Lepetitwar,hyjal,192,warrior,arms,6,2,4
Jurge,twisting-nether,192,warrior,arms,6,2,4
Cléveland,argent-dawn,192,warrior,arms,10,3,7
Eriqua,archimonde,192,warrior,arms,8,2,6
Sunzí,alakir,192,warrior,arms,8,2,6
Waréx,ravencrest,192,warrior,arms,11,2,9
Osrick,archimonde,192,warrior,arms,12,2,10
Blackmoor,argent-dawn,192,warrior,arms,12,2,10
Solidier,archimonde,192,warrior,arms,12,2,10
Phanatic,draenor,192,warrior,arms,12,2,10
Rokzor,anetheron,192,warrior,arms,12,2,10
Battousai,sanguino,192,warrior,arms,12,2,10
Gaav,burning-legion,192,warrior,arms,12,2,10
Xail,rexxar,192,warrior,arms,12,2,10
Actoni,sylvanas,192,warrior,arms,12,2,10
Unhingéd,stormscale,192,warrior,arms,12,2,10
Klm,stormscale,192,warrior,arms,12,2,10
Adoum,ysondre,192,warrior,arms,12,2,10
Antrøs,quelthalas,192,warrior,arms,12,2,10
Slayerxz,aegwynn,192,warrior,arms,12,2,10
Furybringer,silvermoon,192,warrior,arms,12,2,10
Pøpeyo,hyjal,192,warrior,arms,12,2,10
Aloia,stormscale,192,warrior,arms,12,2,10
Caíne,drakthul,192,warrior,arms,12,2,10
Tyranoth,defias-brotherhood,192,warrior,arms,12,2,10
Qforína,stormscale,192,warrior,arms,12,2,10
Хенминия,blackscar,192,warrior,arms,12,2,10
Eumellin,blackmoore,192,warrior,arms,12,2,10
Pwndrizle,blackmoore,192,warrior,arms,12,2,10
Wargød,eldrethalas,192,warrior,arms,12,2,10
Lzdmfckmeazy,blackmoore,192,warrior,arms,12,2,10
Bigflo,illidan,192,warrior,arms,12,2,10
Frozenevil,kazzak,192,warrior,arms,18,2,16
Бларк,goldrinn,192,warrior,arms,18,2,16
Hellis,frostmourne,191,warrior,arms,6,2,4
Savagsh,blackmoore,191,warrior,arms,6,2,4
Raufí,antonidas,191,warrior,arms,6,2,4
Laeràzh,archimonde,191,warrior,arms,6,2,4
Fitï,cthun,191,warrior,arms,6,2,4
Mangore,tyrande,191,warrior,arms,12,2,10
Касхо,gordunni,191,warrior,arms,12,2,10
Tronhaur,stormscale,191,warrior,arms,18,2,16
Waelkøh,hyjal,190,warrior,arms,7,3,4
Hofmanntv,alakir,186,warrior,arms,19,5,14
Eledryel,pozzo-delleternità,185,warrior,arms,15,4,11
Номер,eversong,160,warrior,arms,10,2,8
Broxugar,defias-brotherhood,159,warrior,arms,5,2,3
Lêksi,frostwolf,159,warrior,arms,5,2,3
Phenommenom,tarren-mill,159,warrior,arms,5,2,3
Газкон,ashenvale,159,warrior,arms,5,2,3
Празар,howling-fjord,159,warrior,arms,5,2,3
Deadwily,twisting-nether,159,warrior,arms,5,2,3
Pétin,kaelthas,159,warrior,arms,5,2,3
Kibb,sylvanas,159,warrior,arms,5,2,3
Bloodpyre,nemesis,159,warrior,arms,11,2,9
Amystad,ahnqiraj,144,warrior,arms,9,2,7
Gondyr,quelthalas,144,warrior,arms,15,2,13
Suue,stormscale,143,warrior,arms,3,3,0
Lilsib,outland,138,warrior,arms,7,3,4
Killinstinct,zuluhed,137,warrior,arms,13,3,10
Nacko,ravencrest,128,warrior,arms,4,2,2
Алол,gordunni,128,warrior,arms,4,2,2
Zhønya,aegwynn,128,warrior,arms,4,2,2
Vorns,silvermoon,128,warrior,arms,4,2,2
Ozymandyaz,hyjal,127,warrior,arms,8,2,6
Bleaja,tarren-mill,112,warrior,arms,7,2,5
Dreadoran,voljin,112,warrior,arms,7,2,5
Kyraxe,silvermoon,96,warrior,arms,3,2,1
Fridaax,lightbringer,96,warrior,arms,3,2,1
Nekwar,ravencrest,96,warrior,arms,3,2,1
Rdeniro,blackmoore,96,warrior,arms,3,2,1
Lasttfallen,hyjal,96,warrior,arms,3,2,1
Abhorrent,tarren-mill,96,warrior,arms,3,2,1
Durrüti,sanguino,96,warrior,arms,6,1,5
Squelch,blackrock,96,warrior,arms,6,1,5
Arnowz,stormscale,96,warrior,arms,6,1,5
Kalhmeras,twisting-nether,96,warrior,arms,6,1,5
Томмч,soulflayer,96,warrior,arms,6,1,5
Sebastian,ravencrest,96,warrior,arms,6,1,5
Wardam,terokkar,96,warrior,arms,6,1,5
Ytrox,twisting-nether,96,warrior,arms,6,1,5
Soley,neptulon,96,warrior,arms,6,1,5
Romppu,shattered-hand,96,warrior,arms,6,1,5
Nacindaz,thrall,96,warrior,arms,6,1,5
Headshot,zenedar,96,warrior,arms,6,1,5
Skullxy,talnivarr,96,warrior,arms,6,1,5
Hashyk,burning-legion,96,warrior,arms,6,1,5
Letha,twisting-nether,96,warrior,arms,6,1,5
Redjaw,twisting-nether,96,warrior,arms,6,1,5
Whydeadbro,twisting-nether,96,warrior,arms,6,1,5
Logmmar,sanguino,96,warrior,arms,6,1,5
Püp,thrall,96,warrior,arms,6,1,5
Gensur,skullcrusher,96,warrior,arms,6,1,5
Wigman,shattered-hand,96,warrior,arms,6,1,5
Bigk,burning-legion,96,warrior,arms,6,1,5
Halalmeat,minahonda,96,warrior,arms,6,1,5
Zaximos,twisting-nether,96,warrior,arms,6,1,5
Jigs,twisting-nether,96,warrior,arms,6,1,5
Naiph,blackmoore,96,warrior,arms,6,1,5
Yoshimang,twisting-nether,96,warrior,arms,6,1,5
Deauxa,twisting-nether,96,warrior,arms,6,1,5
Eléndrèn,blackrock,96,warrior,arms,6,1,5
Талейлан,gordunni,96,warrior,arms,6,1,5
Pepao,zuljin,96,warrior,arms,6,1,5
Nukêr,dun-modr,96,warrior,arms,6,1,5
Угхпах,soulflayer,96,warrior,arms,6,1,5
Рсдрпб,eversong,96,warrior,arms,6,1,5
Leryswarro,sanguino,96,warrior,arms,6,1,5
Дозикк,ashenvale,96,warrior,arms,6,1,5
Stretch,thrall,96,warrior,arms,6,1,5
Üzzy,dun-modr,96,warrior,arms,6,1,5
Вевеллер,ashenvale,96,warrior,arms,6,1,5
Jailbâit,baelgun,96,warrior,arms,6,1,5
Meadivh,auchindoun,96,warrior,arms,6,1,5
Guerrino,nemesis,96,warrior,arms,6,1,5
Laceyiee,anubarak,96,warrior,arms,6,1,5
Lincwar,stormscale,96,warrior,arms,6,1,5
Poppeyex,silvermoon,96,warrior,arms,6,1,5
Davidass,drakthul,96,warrior,arms,6,1,5
Càvalry,nemesis,96,warrior,arms,6,1,5
Truckfury,ravencrest,96,warrior,arms,6,1,5
Feltias,drakthul,96,warrior,arms,6,1,5
Keniny,drakthul,96,warrior,arms,6,1,5
Trickzît,silvermoon,96,warrior,arms,6,1,5
Acudam,stormscale,96,warrior,arms,6,1,5
Sànkà,pozzo-delleternità,96,warrior,arms,6,1,5
Sgtzmetek,drakthul,96,warrior,arms,6,1,5
Gilgarez,twisting-nether,96,warrior,arms,6,1,5
Winedru,bronzebeard,96,warrior,arms,6,1,5
Woosaah,ravencrest,96,warrior,arms,6,1,5
Beduin,twilights-hammer,96,warrior,arms,6,1,5
Васяжелезо,gordunni,96,warrior,arms,6,1,5
Gorroth,chamber-of-aspects,96,warrior,arms,6,1,5
Belgabad,rexxar,96,warrior,arms,6,1,5
Bjurkel,sylvanas,96,warrior,arms,6,1,5
Sharrok,blackmoore,96,warrior,arms,6,1,5
Âkbarrash,blackmoore,96,warrior,arms,6,1,5
Elëndïl,dun-modr,96,warrior,arms,6,1,5
Шапканауши,eversong,96,warrior,arms,6,1,5
Funkyfresh,ravencrest,96,warrior,arms,6,1,5
Rezail,silvermoon,96,warrior,arms,6,1,5
Vexecute,rexxar,96,warrior,arms,6,1,5
Brostorm,magtheridon,96,warrior,arms,6,1,5
Тревзор,gordunni,96,warrior,arms,6,1,5
Midvînter,silvermoon,96,warrior,arms,6,1,5
Schuy,silvermoon,96,warrior,arms,6,1,5
Spritekoppen,ravencrest,96,warrior,arms,6,1,5
Whitebeardx,tarren-mill,96,warrior,arms,6,1,5
Erosdulko,silvermoon,96,warrior,arms,6,1,5
Humanboi,ravencrest,96,warrior,arms,6,1,5
Wscieklosc,silvermoon,96,warrior,arms,6,1,5
Rägnât,dun-modr,96,warrior,arms,6,1,5
Siuzy,blackrock,96,warrior,arms,6,1,5
Pwnwarri,aegwynn,96,warrior,arms,6,1,5
Aemdall,chogall,96,warrior,arms,6,1,5
Prettyangel,aegwynn,96,warrior,arms,6,1,5
Kratosz,magtheridon,96,warrior,arms,6,1,5
Snuusu,blackmoore,96,warrior,arms,6,1,5
Ельмара,gordunni,96,warrior,arms,6,1,5
Dakotafred,ravencrest,96,warrior,arms,6,1,5
Darriuso,kazzak,96,warrior,arms,6,1,5
Zillrog,kazzak,96,warrior,arms,6,1,5
Evilez,ravencrest,96,warrior,arms,6,1,5
Konoplja,blackmoore,96,warrior,arms,6,1,5
Molløtov,sargeras,96,warrior,arms,6,1,5
Kysse,hyjal,96,warrior,arms,6,1,5
Chaohz,grim-batol,96,warrior,arms,6,1,5
Sarkan,ravencrest,96,warrior,arms,6,1,5
Wandore,grim-batol,96,warrior,arms,6,1,5
Mæuzl,draenor,96,warrior,arms,6,1,5
Kormazz,tarren-mill,96,warrior,arms,6,1,5
Juanvaco,tarren-mill,96,warrior,arms,6,1,5
Ragecrit,ragnaros,96,warrior,arms,6,1,5
Orthoss,archimonde,96,warrior,arms,6,1,5
Killávalon,kazzak,96,warrior,arms,6,1,5
Снакихснаки,gordunni,96,warrior,arms,6,1,5
Oksimbillah,blackrock,96,warrior,arms,6,1,5
Фьордал,howling-fjord,96,warrior,arms,6,1,5
Вульфычч,gordunni,96,warrior,arms,6,1,5
Tenicx,ravencrest,96,warrior,arms,6,1,5
Ifir,hyjal,96,warrior,arms,6,1,5
Armyne,kazzak,96,warrior,arms,6,1,5
Арленхейтлав,gordunni,96,warrior,arms,6,1,5
Luntee,ragnaros,96,warrior,arms,6,1,5
They,aggramar,96,warrior,arms,6,1,5
Murämasä,hyjal,96,warrior,arms,6,1,5
Kamelskum,draenor,96,warrior,arms,6,1,5
Furymeep,outland,96,warrior,arms,6,1,5
Molsah,draenor,96,warrior,arms,6,1,5
Warfield,draenor,96,warrior,arms,6,1,5
Замесик,blackscar,96,warrior,arms,6,1,5
Axelitee,draenor,96,warrior,arms,6,1,5
Rikkavikki,argent-dawn,96,warrior,arms,6,1,5
Deathsnarl,ragnaros,96,warrior,arms,6,1,5
Galatan,kazzak,96,warrior,arms,6,1,5
Brutannya,argent-dawn,96,warrior,arms,6,1,5
Ayasaki,argent-dawn,96,warrior,arms,6,1,5
Morshak,gorgonnash,96,warrior,arms,6,1,5
Lilsweép,draenor,96,warrior,arms,6,1,5
Bløødyshøcks,aggra-português,96,warrior,arms,6,1,5
Wârgâsm,argent-dawn,96,warrior,arms,6,1,5
Rinderliebe,thrall,96,warrior,arms,6,1,5
Урморн,gordunni,96,warrior,arms,6,1,5
Rhynot,argent-dawn,96,warrior,arms,6,1,5
Executê,kazzak,96,warrior,arms,6,1,5
Claymøre,khaz-modan,96,warrior,arms,6,1,5
Juicer,argent-dawn,96,warrior,arms,6,1,5
Macgull,ysondre,96,warrior,arms,6,1,5
Turbotrost,hyjal,96,warrior,arms,6,1,5
Osopeligroso,outland,96,warrior,arms,6,1,5
Greenbeanx,antonidas,96,warrior,arms,6,1,5
Haltwo,archimonde,96,warrior,arms,6,1,5
Taukkì,kazzak,96,warrior,arms,6,1,5
Cøbain,eredar,96,warrior,arms,6,1,5
Thekayizer,archimonde,96,warrior,arms,6,1,5
Осгаард,gordunni,96,warrior,arms,6,1,5
Tidùs,nethersturm,96,warrior,arms,6,1,5
Brøxx,garrosh,96,warrior,arms,6,1,5
Sláughter,forscherliga,96,warrior,arms,6,1,5
Onga,frostwolf,96,warrior,arms,6,1,5
Ezlive,blackrock,96,warrior,arms,6,1,5
Faereliah,argent-dawn,96,warrior,arms,6,1,5
Taroom,turalyon,96,warrior,arms,6,1,5
Karyoroo,eredar,96,warrior,arms,6,1,5
Rôtor,archimonde,96,warrior,arms,6,1,5
Суммрак,grom,96,warrior,arms,6,1,5
Abukrd,turalyon,96,warrior,arms,6,1,5
Darkmain,outland,96,warrior,arms,6,1,5
Booya,zirkel-des-cenarius,96,warrior,arms,6,1,5
Wlâdimir,eredar,96,warrior,arms,6,1,5
Worgenalpha,garona,96,warrior,arms,6,1,5
Bravestarrz,ungoro,96,warrior,arms,6,1,5
Bloodpath,stormrage,96,warrior,arms,6,1,5
Largeblade,kazzak,96,warrior,arms,6,1,5
Cromash,die-nachtwache,96,warrior,arms,6,1,5
Йошихироо,howling-fjord,96,warrior,arms,6,1,5
Zarkos,onyxia,96,warrior,arms,6,1,5
Bigpapapap,kazzak,96,warrior,arms,6,1,5
Ðeadyet,mugthol,96,warrior,arms,6,1,5
Psyph,onyxia,96,warrior,arms,6,1,5
Groullomus,archimonde,96,warrior,arms,6,1,5
Choûbab,archimonde,96,warrior,arms,6,1,5
Mirror,tarren-mill,96,warrior,arms,12,1,11
Jkarus,die-ewige-wacht,96,warrior,arms,12,1,11
Babæ,ravencrest,96,warrior,arms,12,1,11
Grimblade,kazzak,96,warrior,arms,12,1,11
Helmcleaver,tarren-mill,96,warrior,arms,12,1,11
Mikogød,ravencrest,96,warrior,arms,12,1,11
Moshpít,antonidas,96,warrior,arms,12,1,11
Отпустите,howling-fjord,96,warrior,arms,12,1,11
Шредс,howling-fjord,96,warrior,arms,12,1,11
Viana,sylvanas,96,warrior,arms,12,1,11
Benjarnee,draenor,96,warrior,arms,12,1,11
Aldébbarann,archimonde,96,warrior,arms,15,1,14
Shäshken,archimonde,96,warrior,arms,18,1,17
Baldemort,antonidas,96,warrior,arms,24,1,23
Enÿo,stormscale,84,warrior,arms,27,7,20
Kallum,ravencrest,79,warrior,arms,5,1,4
Agur,ysondre,79,warrior,arms,5,1,4
Koboone,tarren-mill,79,warrior,arms,5,1,4
Kimboslice,ragnaros,79,warrior,arms,11,2,9
Rimmedpigeon,alakir,64,warrior,arms,4,1,3
Hojalator,minahonda,64,warrior,arms,4,1,3
Roktdar,blackmoore,64,warrior,arms,4,1,3
Psychedx,ravencrest,64,warrior,arms,4,1,3
Bââgrâ,hyjal,64,warrior,arms,4,1,3
Rugal,dragonmaw,64,warrior,arms,5,1,4
Cowon,stormscale,63,warrior,arms,2,2,0
Rinos,silvermoon,63,warrior,arms,8,2,6
Lilchan,zuljin,63,warrior,arms,8,2,6
Carizona,twisting-nether,48,warrior,arms,3,1,2
Garaha,argent-dawn,48,warrior,arms,3,1,2
Elloo,tarren-mill,48,warrior,arms,3,1,2
Zannasbianca,doomhammer,48,warrior,arms,3,1,2
Zoljabu,eredar,42,warrior,arms,7,2,5
Laciater,burning-legion,42,warrior,arms,8,2,6
Артен,ashenvale,42,warrior,arms,10,2,8
Kurosawa,uldum,42,warrior,arms,10,2,8
Reyon,argent-dawn,41,warrior,arms,12,2,10
Закхорн,gordunni,31,warrior,arms,2,1,1
Tomby,argent-dawn,31,warrior,arms,2,1,1
Гангстарэпер,gordunni,31,warrior,arms,2,1,1
Skórn,burning-legion,31,warrior,arms,2,1,1
Eijnar,kazzak,31,warrior,arms,2,1,1
Ziñs,silvermoon,31,warrior,arms,2,1,1
Wincas,tarren-mill,31,warrior,arms,2,1,1
Clówny,garrosh,31,warrior,arms,8,1,7
Izmadfurax,archimonde,16,warrior,arms,1,1,0
Ugrlak,drakthul,16,warrior,arms,7,1,6
Sublexgg,blackrock,1868,warrior,protection,43,24,19
Swagenknecht,blackrock,1840,warrior,protection,66,31,35
Blaying,ravencrest,1540,warrior,protection,90,45,45
Doghxnterx,ravencrest,1261,warrior,protection,37,14,23
Narrative,kazzak,1091,warrior,protection,54,20,34
Tríbún,kult-der-verdammten,1015,warrior,protection,54,21,33
Фриегар,deathguard,1006,warrior,protection,56,22,34
Mandiso,norgannon,985,warrior,protection,52,27,25
Ferran,sanguino,949,warrior,protection,55,23,32
Carras,confrérie-du-thorium,937,warrior,protection,42,22,20
Grimurg,drakthul,921,warrior,protection,76,33,43
Флоуби,razuvious,806,warrior,protection,24,9,15
Naofumí,arthas,732,warrior,protection,18,8,10
Tokrika,die-aldor,384,warrior,protection,6,4,2
Bloodparade,argent-dawn,288,warrior,protection,6,3,3
Davetsiz,burning-legion,288,warrior,protection,12,3,9
Flinn,die-nachtwache,226,warrior,protection,20,4,16
Денеур,gordunni,192,warrior,protection,6,2,4
Маллал,soulflayer,192,warrior,protection,6,2,4
Asuvia,argent-dawn,127,warrior,protection,14,2,12
Warrqury,ravencrest,96,warrior,protection,6,1,5
Valem,suramar,96,warrior,protection,6,1,5
Leryswarro,sanguino,96,warrior,protection,6,1,5
Callipsa,argent-dawn,96,warrior,protection,12,1,11
Jøtas,dun-modr,96,warrior,protection,12,1,11
