name,realm,rating,cls,spec,play,win,lose
Phearbunny,bleeding-hollow,1523,deathknight,blood,60,31,29
Pagumon,moon-guard,1247,deathknight,blood,96,44,52
Bloodbukkaky,bleeding-hollow,1201,deathknight,blood,42,13,29
Tragül,sargeras,1012,deathknight,blood,36,16,20
Valind,eredar,854,deathknight,blood,18,9,9
Kult,azralon,841,deathknight,blood,12,9,3
Insonne,dalaran,837,deathknight,blood,18,9,9
Blasphemus,malganis,575,deathknight,blood,12,6,6
Kaîne,dalaran,480,deathknight,blood,12,5,7
Belfknightt,area-52,479,deathknight,blood,15,5,10
Tristam,area-52,384,deathknight,blood,6,4,2
Pride,ragnaros,384,deathknight,blood,12,4,8
ßläzë,baelgun,288,deathknight,blood,15,4,11
Kimbøslîce,area-52,288,deathknight,blood,12,3,9
Cerbeefquake,wyrmrest-accord,192,deathknight,blood,6,2,4
Unhølydøøm,misha,191,deathknight,blood,12,2,10
Determinate,deathwing,96,deathknight,blood,6,1,5
Gnargnarr,firetree,96,deathknight,blood,6,1,5
Cozzasad,barthilas,96,deathknight,blood,6,1,5
Wowattorney,tichondrius,96,deathknight,blood,6,1,5
Lunatick,darkspear,96,deathknight,blood,6,1,5
Nbayoungboy,kiljaeden,96,deathknight,blood,6,1,5
Zerhistran,proudmoore,64,deathknight,blood,4,1,3
Hulmorr,bleeding-hollow,64,deathknight,blood,4,1,3
Graphics,moon-guard,2125,deathknight,unholy,382,194,188
Pwaff,illidan,2125,deathknight,unholy,89,45,44
Neroxz,area-52,2105,deathknight,unholy,83,43,40
Spaidzz,malganis,2076,deathknight,unholy,193,97,96
Níngjìng,tichondrius,2041,deathknight,unholy,78,41,37
Qipara,zuljin,2039,deathknight,unholy,122,64,58
Juelzjerk,tichondrius,2010,deathknight,unholy,89,51,38
Flarkness,area-52,2010,deathknight,unholy,78,37,41
Partywaffles,illidan,1998,deathknight,unholy,193,97,96
Achílles,sargeras,1979,deathknight,unholy,175,85,90
Scriptløl,sargeras,1975,deathknight,unholy,138,66,72
Roidboy,illidan,1954,deathknight,unholy,115,57,58
Vineyard,area-52,1942,deathknight,unholy,287,143,144
Toxicwaste,malganis,1942,deathknight,unholy,82,39,43
Wøund,black-dragonflight,1938,deathknight,unholy,172,92,80
Mårlbørø,tichondrius,1915,deathknight,unholy,41,21,20
Darkdj,kelthuzad,1914,deathknight,unholy,73,34,39
Éternalnight,tichondrius,1913,deathknight,unholy,76,32,44
Zynyzter,malganis,1912,deathknight,unholy,72,41,31
Veilsidé,kelthuzad,1910,deathknight,unholy,250,125,125
Geomdae,tichondrius,1901,deathknight,unholy,71,31,40
Barelyviable,tichondrius,1898,deathknight,unholy,72,32,40
Bruceleedk,tichondrius,1896,deathknight,unholy,94,50,44
Milleh,bleeding-hollow,1895,deathknight,unholy,66,31,35
Starshopping,proudmoore,1891,deathknight,unholy,55,29,26
Daoniancc,tichondrius,1883,deathknight,unholy,169,95,74
Brutos,thrall,1878,deathknight,unholy,92,51,41
Ilceses,area-52,1870,deathknight,unholy,66,29,37
Catarïa,tichondrius,1869,deathknight,unholy,90,44,46
Iato,sargeras,1868,deathknight,unholy,60,39,21
Drauguss,azralon,1860,deathknight,unholy,106,53,53
Cavaliers,ragnaros,1860,deathknight,unholy,66,32,34
Lattè,area-52,1859,deathknight,unholy,55,30,25
Poesoul,tichondrius,1858,deathknight,unholy,204,104,100
Bloodbruh,blackrock,1854,deathknight,unholy,60,34,26
Plagueflavor,tichondrius,1851,deathknight,unholy,247,124,123
Bedstains,thunderlord,1849,deathknight,unholy,107,61,46
Morbiddesire,stormrage,1849,deathknight,unholy,87,49,38
Didri,quelthalas,1846,deathknight,unholy,72,34,38
Tokyotimxx,malganis,1842,deathknight,unholy,48,30,18
Sinell,kargath,1841,deathknight,unholy,109,63,46
Bicepsüal,zuljin,1840,deathknight,unholy,36,28,8
Riddles,maiev,1837,deathknight,unholy,119,64,55
Blackfyré,sargeras,1837,deathknight,unholy,62,32,30
Haldevarik,doomhammer,1834,deathknight,unholy,78,43,35
Kilohotel,stormrage,1832,deathknight,unholy,36,22,14
Orphanmakerx,area-52,1832,deathknight,unholy,123,60,63
Goonà,tichondrius,1831,deathknight,unholy,63,29,34
Aurious,lightnings-blade,1830,deathknight,unholy,84,47,37
Kortingert,nagrand,1830,deathknight,unholy,59,33,26
Anatøly,ragnaros,1827,deathknight,unholy,42,21,21
Sadboy,grizzly-hills,1822,deathknight,unholy,65,27,38
Serwestley,stormrage,1820,deathknight,unholy,59,31,28
Kciktep,tichondrius,1819,deathknight,unholy,36,19,17
Búddy,zuljin,1819,deathknight,unholy,58,28,30
Sagadk,hyjal,1819,deathknight,unholy,65,31,34
Skideroth,kelthuzad,1817,deathknight,unholy,60,28,32
Flizzycash,malganis,1816,deathknight,unholy,56,27,29
Õdin,area-52,1815,deathknight,unholy,203,103,100
Wowattorney,tichondrius,1815,deathknight,unholy,82,33,49
Ravindrannor,saurfang,1812,deathknight,unholy,65,32,33
Dahnga,frostmourne,1811,deathknight,unholy,54,32,22
Nixonxx,tichondrius,1810,deathknight,unholy,82,51,31
Warrcc,steamwheedle-cartel,1809,deathknight,unholy,48,24,24
Infectik,tichondrius,1807,deathknight,unholy,59,35,24
Chillbaynê,the-scryers,1807,deathknight,unholy,119,62,57
Fatzilla,tichondrius,1807,deathknight,unholy,60,23,37
Necrôtic,area-52,1806,deathknight,unholy,76,35,41
Twindleroot,aggramar,1804,deathknight,unholy,77,45,32
Mûs,tichondrius,1804,deathknight,unholy,66,36,30
Dkya,tichondrius,1803,deathknight,unholy,182,88,94
Kaeligh,ragnaros,1803,deathknight,unholy,66,29,37
Ziskon,illidan,1802,deathknight,unholy,100,53,47
Zìlêán,tichondrius,1800,deathknight,unholy,70,39,31
Harókz,azralon,1800,deathknight,unholy,65,31,34
Azre,tichondrius,1800,deathknight,unholy,160,74,86
Brandonsdk,tichondrius,1794,deathknight,unholy,107,53,54
Avengering,tichondrius,1793,deathknight,unholy,69,37,32
Pradas,area-52,1787,deathknight,unholy,41,24,17
Attack,grizzly-hills,1787,deathknight,unholy,60,28,32
Nabbiby,tichondrius,1784,deathknight,unholy,72,33,39
Áethros,malganis,1778,deathknight,unholy,96,44,52
Cesaroo,aegwynn,1777,deathknight,unholy,94,47,47
Thorediks,stormrage,1777,deathknight,unholy,54,27,27
Skippee,tichondrius,1775,deathknight,unholy,54,24,30
Grimiz,tichondrius,1774,deathknight,unholy,145,71,74
Demonboyjr,tichondrius,1766,deathknight,unholy,75,31,44
Jakeboyswag,shandris,1763,deathknight,unholy,105,52,53
Apøçálýpsé,firetree,1761,deathknight,unholy,67,35,32
Brocigar,tichondrius,1760,deathknight,unholy,48,25,23
Zìlêáns,tichondrius,1759,deathknight,unholy,60,39,21
Hrsb,tichondrius,1758,deathknight,unholy,112,60,52
Boneyards,bleeding-hollow,1758,deathknight,unholy,90,39,51
Dâki,blades-edge,1756,deathknight,unholy,60,39,21
Xiaodabaolol,tichondrius,1751,deathknight,unholy,48,26,22
Pooseunpoose,velen,1751,deathknight,unholy,60,32,28
Khaíne,wyrmrest-accord,1749,deathknight,unholy,145,79,66
Standalizer,gilneas,1745,deathknight,unholy,72,40,32
Ermanotruta,azralon,1744,deathknight,unholy,77,37,40
Carryme,quelthalas,1742,deathknight,unholy,92,45,47
Nh,malganis,1737,deathknight,unholy,54,28,26
Keomdae,tichondrius,1734,deathknight,unholy,53,26,27
Falkorn,korgath,1733,deathknight,unholy,63,32,31
Hwml,barthilas,1729,deathknight,unholy,81,45,36
Xebane,frostmourne,1728,deathknight,unholy,276,143,133
Arroyo,borean-tundra,1724,deathknight,unholy,54,29,25
Hatrèd,quelthalas,1724,deathknight,unholy,53,27,26
Nevmic,emerald-dream,1723,deathknight,unholy,86,41,45
Azhid,tichondrius,1719,deathknight,unholy,106,54,52
Lazarise,area-52,1713,deathknight,unholy,71,34,37
Tkyo,tichondrius,1712,deathknight,unholy,47,22,25
Tduggylolz,tichondrius,1712,deathknight,unholy,42,18,24
Huuzzha,tichondrius,1709,deathknight,unholy,112,63,49
Noik,azralon,1707,deathknight,unholy,75,36,39
Komplex,kelthuzad,1704,deathknight,unholy,54,31,23
Kurnoth,barthilas,1703,deathknight,unholy,80,40,40
Cardii,area-52,1703,deathknight,unholy,64,27,37
Justafkdk,gorefiend,1700,deathknight,unholy,84,43,41
Nevermore,hyjal,1699,deathknight,unholy,101,50,51
Kinkysgnome,tichondrius,1696,deathknight,unholy,131,61,70
Krätos,zuljin,1694,deathknight,unholy,36,23,13
Zerøimperial,quelthalas,1694,deathknight,unholy,167,85,82
Ðomìnus,moon-guard,1692,deathknight,unholy,84,51,33
Imadkloldie,frostmourne,1690,deathknight,unholy,84,44,40
Loongdk,kiljaeden,1685,deathknight,unholy,101,51,50
Søad,quelthalas,1683,deathknight,unholy,58,36,22
Aerd,sargeras,1682,deathknight,unholy,162,77,85
Yubell,barthilas,1681,deathknight,unholy,251,127,124
Wittlewanka,zuljin,1675,deathknight,unholy,40,18,22
Blacklabel,andorhal,1675,deathknight,unholy,72,31,41
Dialysis,emerald-dream,1673,deathknight,unholy,119,64,55
Altareon,ragnaros,1672,deathknight,unholy,108,53,55
Dunduner,tichondrius,1672,deathknight,unholy,90,44,46
Cloüd,wyrmrest-accord,1671,deathknight,unholy,47,21,26
Cantmove,area-52,1669,deathknight,unholy,50,22,28
Spacealien,malganis,1667,deathknight,unholy,54,29,25
Darktone,tichondrius,1665,deathknight,unholy,35,18,17
Slty,tichondrius,1664,deathknight,unholy,42,18,24
Soulhand,tichondrius,1662,deathknight,unholy,46,23,23
Lichtborne,illidan,1662,deathknight,unholy,73,33,40
Azynks,azralon,1660,deathknight,unholy,102,47,55
Ståtìc,tichondrius,1659,deathknight,unholy,60,31,29
Bellum,moon-guard,1658,deathknight,unholy,75,44,31
Nalz,drakkari,1658,deathknight,unholy,117,60,57
Ålastor,stormrage,1653,deathknight,unholy,52,27,25
Xhoul,sargeras,1649,deathknight,unholy,135,76,59
Trumps,stormrage,1649,deathknight,unholy,48,27,21
Ludgan,stormrage,1649,deathknight,unholy,180,86,94
Kwolve,proudmoore,1647,deathknight,unholy,201,101,100
Merados,quelthalas,1646,deathknight,unholy,79,30,49
Vexxan,thrall,1644,deathknight,unholy,41,23,18
Galarick,area-52,1643,deathknight,unholy,41,22,19
Tailm,ragnaros,1639,deathknight,unholy,36,20,16
Krargosh,quelthalas,1639,deathknight,unholy,150,78,72
Vynox,frostmourne,1637,deathknight,unholy,56,27,29
Grimmdreamer,stormrage,1634,deathknight,unholy,76,37,39
Muspellheim,azralon,1633,deathknight,unholy,42,21,21
Kakarotó,azralon,1629,deathknight,unholy,53,30,23
Arthez,frostmourne,1629,deathknight,unholy,48,22,26
Zerochillz,sargeras,1628,deathknight,unholy,30,17,13
Kenishii,kiljaeden,1627,deathknight,unholy,48,30,18
Landez,ragnaros,1627,deathknight,unholy,66,37,29
Wastethis,sargeras,1626,deathknight,unholy,71,40,31
Paratekdk,thrall,1625,deathknight,unholy,71,39,32
Megatroun,stormreaver,1625,deathknight,unholy,42,23,19
Deuter,quelthalas,1624,deathknight,unholy,164,85,79
Bladê,tichondrius,1624,deathknight,unholy,61,26,35
Jeremiahe,hyjal,1622,deathknight,unholy,84,45,39
Anhedonía,illidan,1622,deathknight,unholy,120,59,61
Xraduky,dawnbringer,1620,deathknight,unholy,38,26,12
Kjarnda,malganis,1620,deathknight,unholy,42,18,24
Gripyourhoe,tichondrius,1619,deathknight,unholy,42,26,16
Wheatasil,garona,1618,deathknight,unholy,64,33,31
Onefire,illidan,1616,deathknight,unholy,48,21,27
Ligmagooch,tichondrius,1614,deathknight,unholy,81,41,40
Boofcigars,sargeras,1612,deathknight,unholy,42,21,21
Rezøk,ragnaros,1612,deathknight,unholy,54,20,34
Ðogmá,vashj,1610,deathknight,unholy,35,22,13
Mikoaa,bladefist,1610,deathknight,unholy,30,17,13
Daethiel,demon-soul,1610,deathknight,unholy,53,25,28
Ousted,daggerspine,1608,deathknight,unholy,36,20,16
Bopalop,malganis,1607,deathknight,unholy,57,22,35
Takeurcheeks,tichondrius,1605,deathknight,unholy,101,49,52
Thotiannaqt,area-52,1605,deathknight,unholy,42,17,25
Boofcigars,kelthuzad,1604,deathknight,unholy,77,41,36
Mephostophel,sargeras,1604,deathknight,unholy,108,54,54
Unholykevin,sargeras,1604,deathknight,unholy,42,21,21
Dominos,tichondrius,1604,deathknight,unholy,42,20,22
Idodamn,tichondrius,1603,deathknight,unholy,84,45,39
Wednesdæ,moon-guard,1603,deathknight,unholy,54,28,26
Voncleaver,tichondrius,1603,deathknight,unholy,64,20,44
Drpepp,bleeding-hollow,1602,deathknight,unholy,107,59,48
Fasterjake,sargeras,1602,deathknight,unholy,98,52,46
Nofoamlattes,thrall,1602,deathknight,unholy,42,19,23
Puppykisses,perenolde,1602,deathknight,unholy,83,35,48
Properterps,bonechewer,1601,deathknight,unholy,116,62,54
Originalcimm,stormrage,1601,deathknight,unholy,54,22,32
Promotheseis,sargeras,1600,deathknight,unholy,66,41,25
Giznator,malganis,1598,deathknight,unholy,108,50,58
Ullísés,ragnaros,1597,deathknight,unholy,39,21,18
Xibbas,illidan,1594,deathknight,unholy,30,19,11
Demonnation,illidan,1592,deathknight,unholy,60,24,36
Telrenaur,proudmoore,1587,deathknight,unholy,42,22,20
Nøsfferatus,azralon,1579,deathknight,unholy,53,28,25
Rhaeisxalnym,sargeras,1579,deathknight,unholy,75,39,36
Zerhistran,proudmoore,1578,deathknight,unholy,218,109,109
Frostbite,the-venture-co,1577,deathknight,unholy,84,48,36
Auniel,gorefiend,1577,deathknight,unholy,42,19,23
Catena,blood-furnace,1575,deathknight,unholy,41,20,21
Asheravon,moon-guard,1575,deathknight,unholy,218,105,113
Lùcius,garrosh,1574,deathknight,unholy,92,48,44
Orkky,jubeithos,1573,deathknight,unholy,104,50,54
Kaaizer,azralon,1572,deathknight,unholy,120,68,52
Raps,frostmourne,1572,deathknight,unholy,50,19,31
Läskö,area-52,1569,deathknight,unholy,49,31,18
Muspel,sargeras,1568,deathknight,unholy,42,18,24
Onlyfunss,moon-guard,1564,deathknight,unholy,84,40,44
Gargoylepowa,nemesis,1563,deathknight,unholy,36,17,19
Kellydean,moon-guard,1561,deathknight,unholy,60,31,29
Exaar,tichondrius,1560,deathknight,unholy,45,17,28
Arcticc,area-52,1559,deathknight,unholy,42,19,23
Lichkong,dalaran,1557,deathknight,unholy,54,30,24
Naxn,tichondrius,1554,deathknight,unholy,36,18,18
Släke,azralon,1553,deathknight,unholy,142,72,70
Zzdk,thrall,1553,deathknight,unholy,36,18,18
Siphilusxo,dalaran,1551,deathknight,unholy,36,20,16
Toophus,sargeras,1551,deathknight,unholy,74,35,39
Kuwarerubana,proudmoore,1549,deathknight,unholy,74,41,33
Ulísés,ragnaros,1549,deathknight,unholy,52,17,35
Kalgor,illidan,1544,deathknight,unholy,114,58,56
Papalich,stormrage,1535,deathknight,unholy,96,44,52
Chachio,kiljaeden,1532,deathknight,unholy,30,16,14
Howdoulose,illidan,1532,deathknight,unholy,36,16,20
Arktoz,tichondrius,1531,deathknight,unholy,30,16,14
Aldebamuu,ragnaros,1529,deathknight,unholy,66,31,35
Kindaholy,malganis,1528,deathknight,unholy,23,17,6
Alistra,frostmourne,1528,deathknight,unholy,30,16,14
Obedient,firetree,1527,deathknight,unholy,102,60,42
Libitina,tichondrius,1526,deathknight,unholy,24,16,8
Biefeile,tichondrius,1526,deathknight,unholy,40,18,22
Dkdanim,tichondrius,1525,deathknight,unholy,65,35,30
Døømhøund,tichondrius,1524,deathknight,unholy,86,39,47
Tigs,proudmoore,1522,deathknight,unholy,126,65,61
Apocxo,lightnings-blade,1519,deathknight,unholy,113,56,57
Takeoverr,ragnaros,1518,deathknight,unholy,42,29,13
Hooterzqt,tichondrius,1518,deathknight,unholy,106,47,59
Evilduck,ragnaros,1516,deathknight,unholy,30,16,14
Mortarîon,moon-guard,1516,deathknight,unholy,114,56,58
Dóm,proudmoore,1516,deathknight,unholy,66,29,37
Brß,tichondrius,1515,deathknight,unholy,30,16,14
Zedsdead,mannoroth,1514,deathknight,unholy,24,16,8
Genjírou,frostwolf,1514,deathknight,unholy,148,74,74
Deathzpeckt,tichondrius,1513,deathknight,unholy,36,17,19
Burbash,moon-guard,1513,deathknight,unholy,48,22,26
Devillele,proudmoore,1509,deathknight,unholy,78,36,42
Evilbot,tichondrius,1507,deathknight,unholy,48,32,16
Elyxoxo,tichondrius,1507,deathknight,unholy,54,25,29
Fadedlight,zuljin,1506,deathknight,unholy,96,47,49
Dexarax,norgannon,1505,deathknight,unholy,87,49,38
Urieen,gorefiend,1505,deathknight,unholy,77,43,34
Arc,maiev,1504,deathknight,unholy,81,31,50
Zaxrree,malganis,1502,deathknight,unholy,54,34,20
Nokenoke,illidan,1502,deathknight,unholy,81,39,42
Unfórgíven,arthas,1501,deathknight,unholy,48,17,31
Cammy,frostmourne,1500,deathknight,unholy,29,16,13
Axeldrion,tichondrius,1499,deathknight,unholy,35,17,18
Gankstagrip,anvilmar,1498,deathknight,unholy,55,29,26
Abroham,arthas,1498,deathknight,unholy,59,30,29
Câpîrota,nemesis,1498,deathknight,unholy,46,23,23
Gottajuice,moonrunner,1494,deathknight,unholy,51,28,23
Drfauci,boulderfist,1494,deathknight,unholy,30,16,14
Starms,ragnaros,1492,deathknight,unholy,54,25,29
Ghoulslasher,bleeding-hollow,1490,deathknight,unholy,62,28,34
Halvôr,moon-guard,1489,deathknight,unholy,106,59,47
Kcorides,tichondrius,1488,deathknight,unholy,49,28,21
Thenin,crushridge,1487,deathknight,unholy,54,32,22
Jaxxftw,azralon,1485,deathknight,unholy,46,27,19
Deezwaz,draka,1485,deathknight,unholy,40,21,19
Typhøn,illidan,1484,deathknight,unholy,157,78,79
Saighast,illidan,1482,deathknight,unholy,72,39,33
Alexeous,wyrmrest-accord,1479,deathknight,unholy,148,79,69
Zaluster,malganis,1479,deathknight,unholy,143,72,71
Allianknight,windrunner,1479,deathknight,unholy,36,17,19
Brounlyii,drakkari,1478,deathknight,unholy,54,35,19
Nialich,kelthuzad,1476,deathknight,unholy,41,16,25
Zuly,moon-guard,1474,deathknight,unholy,101,52,49
Redbr,tichondrius,1474,deathknight,unholy,66,32,34
Aradorn,azralon,1470,deathknight,unholy,160,77,83
Stoicïsm,tichondrius,1469,deathknight,unholy,36,23,13
Grayfoxx,twisting-nether,1469,deathknight,unholy,41,18,23
Brisblade,shattered-hand,1468,deathknight,unholy,42,23,19
Buttrfingrz,cenarius,1465,deathknight,unholy,54,22,32
Tronnie,kelthuzad,1463,deathknight,unholy,72,37,35
Rk,blackhand,1457,deathknight,unholy,97,58,39
Tuicca,frostmane,1451,deathknight,unholy,54,18,36
Allhejluya,illidan,1449,deathknight,unholy,199,101,98
Balboskina,shattered-hand,1448,deathknight,unholy,70,36,34
Seiyokú,ragnaros,1447,deathknight,unholy,49,26,23
Volcolm,kelthuzad,1445,deathknight,unholy,48,26,22
Tracyminaj,tichondrius,1445,deathknight,unholy,60,27,33
Breadtruck,area-52,1445,deathknight,unholy,70,29,41
Knownkilla,hyjal,1444,deathknight,unholy,77,45,32
Nightskull,malganis,1444,deathknight,unholy,36,18,18
Barakhenaku,illidan,1439,deathknight,unholy,24,15,9
Corrpsse,tichondrius,1438,deathknight,unholy,157,81,76
Pettyk,tichondrius,1438,deathknight,unholy,36,15,21
Nymppho,kelthuzad,1436,deathknight,unholy,156,63,93
Emopalli,tichondrius,1435,deathknight,unholy,72,32,40
Ningjinglol,tichondrius,1434,deathknight,unholy,30,15,15
Exin,cenarion-circle,1432,deathknight,unholy,24,15,9
Moonjae,illidan,1432,deathknight,unholy,24,15,9
Wryu,malganis,1427,deathknight,unholy,29,18,11
Hhasaki,area-52,1427,deathknight,unholy,140,69,71
Blackary,emerald-dream,1426,deathknight,unholy,35,22,13
Coffeebagel,bleeding-hollow,1426,deathknight,unholy,107,44,63
Anexdk,korgath,1423,deathknight,unholy,24,15,9
Jarah,destromath,1422,deathknight,unholy,54,25,29
Seranta,wyrmrest-accord,1422,deathknight,unholy,42,16,26
Risottonero,kelthuzad,1421,deathknight,unholy,93,47,46
Sannistus,ysera,1420,deathknight,unholy,97,43,54
Pmpfrmdwntwn,stormrage,1420,deathknight,unholy,43,16,27
Hornpipe,borean-tundra,1418,deathknight,unholy,84,40,44
Fellenn,stormrage,1417,deathknight,unholy,144,78,66
Putrefactive,frostmourne,1415,deathknight,unholy,156,78,78
Fuzzknight,ravenholdt,1414,deathknight,unholy,30,15,15
Subparatbest,chogall,1414,deathknight,unholy,30,15,15
Regiknight,stormrage,1413,deathknight,unholy,111,63,48
Dûsk,thunderlord,1413,deathknight,unholy,52,21,31
Grimnuts,thrall,1412,deathknight,unholy,48,21,27
Plagueghoul,wyrmrest-accord,1411,deathknight,unholy,86,45,41
Reinhartlol,sargeras,1411,deathknight,unholy,81,38,43
Deathpool,shadowmoon,1409,deathknight,unholy,54,19,35
Fugs,ghostlands,1406,deathknight,unholy,56,30,26
Hatreon,sargeras,1401,deathknight,unholy,30,20,10
Sgtdead,thrall,1400,deathknight,unholy,36,21,15
Unholyfish,malganis,1398,deathknight,unholy,85,40,45
Vazarus,darrowmere,1397,deathknight,unholy,66,30,36
Dkzote,quelthalas,1393,deathknight,unholy,42,18,24
Deathofchaos,smolderthorn,1389,deathknight,unholy,53,18,35
Sammåel,malganis,1387,deathknight,unholy,36,18,18
Paíín,illidan,1387,deathknight,unholy,48,21,27
Laxatives,tichondrius,1385,deathknight,unholy,39,16,23
Unrealzrotz,tichondrius,1383,deathknight,unholy,60,39,21
Egirlgripper,area-52,1382,deathknight,unholy,30,15,15
Mèrc,ragnaros,1376,deathknight,unholy,89,38,51
Banjingquan,tichondrius,1375,deathknight,unholy,42,21,21
Sparklekitty,illidan,1374,deathknight,unholy,24,16,8
Greeasy,bleeding-hollow,1374,deathknight,unholy,41,23,18
Coolk,tichondrius,1368,deathknight,unholy,24,16,8
Darkunral,stormrage,1365,deathknight,unholy,80,33,47
Warstompgød,tichondrius,1364,deathknight,unholy,36,16,20
Waremoto,ragnaros,1361,deathknight,unholy,81,47,34
Bloodramen,dalaran,1360,deathknight,unholy,327,166,161
Shélly,ragnaros,1360,deathknight,unholy,59,29,30
Belegos,quelthalas,1357,deathknight,unholy,67,31,36
Deliriioh,ragnaros,1353,deathknight,unholy,99,54,45
Tenóry,nemesis,1353,deathknight,unholy,66,27,39
Beeftip,area-52,1352,deathknight,unholy,120,54,66
Darknessice,tichondrius,1350,deathknight,unholy,66,35,31
Bumbleton,blackrock,1349,deathknight,unholy,45,24,21
Dethcro,shandris,1343,deathknight,unholy,93,47,46
Tötenkaiser,quelthalas,1337,deathknight,unholy,30,14,16
Ântipaladin,arthas,1335,deathknight,unholy,46,19,27
Zeban,area-52,1334,deathknight,unholy,78,36,42
Bannedforevr,dalaran,1334,deathknight,unholy,36,14,22
Fiddleop,thrall,1333,deathknight,unholy,24,14,10
Negril,tichondrius,1332,deathknight,unholy,78,38,40
Vynkys,shadow-council,1325,deathknight,unholy,24,16,8
Rekbari,sargeras,1325,deathknight,unholy,24,15,9
Unknowndk,kul-tiras,1322,deathknight,unholy,30,14,16
Stangz,bonechewer,1322,deathknight,unholy,36,14,22
Earador,dalaran,1321,deathknight,unholy,30,15,15
Mords,area-52,1321,deathknight,unholy,30,14,16
Gilden,malfurion,1317,deathknight,unholy,80,34,46
Asylïthcc,sargeras,1316,deathknight,unholy,42,25,17
Midway,drakkari,1316,deathknight,unholy,30,16,14
Maligned,uldum,1312,deathknight,unholy,49,18,31
Frðst,executus,1310,deathknight,unholy,24,14,10
Ñovacaine,moon-guard,1309,deathknight,unholy,77,36,41
Gwiffhm,tichondrius,1304,deathknight,unholy,40,14,26
Daixks,proudmoore,1299,deathknight,unholy,30,18,12
Killerundead,area-52,1299,deathknight,unholy,39,17,22
Kallgìn,emerald-dream,1299,deathknight,unholy,36,15,21
Raíndrop,tichondrius,1297,deathknight,unholy,66,28,38
Wrothgarr,stormreaver,1292,deathknight,unholy,30,16,14
Ddibb,tichondrius,1291,deathknight,unholy,29,14,15
Wndypefrcorn,sargeras,1290,deathknight,unholy,25,16,9
Unholycube,zuljin,1290,deathknight,unholy,35,14,21
Mëgazørd,nemesis,1289,deathknight,unholy,42,22,20
Cripticknigt,spinebreaker,1289,deathknight,unholy,48,22,26
Shargan,tichondrius,1284,deathknight,unholy,78,41,37
Harlthas,ragnaros,1274,deathknight,unholy,30,17,13
Ometecuhtli,kelthuzad,1273,deathknight,unholy,60,35,25
Kromgarath,stormrage,1271,deathknight,unholy,60,28,32
Unleud,tichondrius,1260,deathknight,unholy,36,21,15
Nukydoe,azralon,1260,deathknight,unholy,42,19,23
Enjal,stormrage,1255,deathknight,unholy,53,23,30
Abruptdk,bonechewer,1254,deathknight,unholy,61,29,32
Ownaron,moon-guard,1249,deathknight,unholy,45,24,21
Resumen,steamwheedle-cartel,1249,deathknight,unholy,32,15,17
Clowngodx,illidan,1247,deathknight,unholy,24,13,11
Darktonelol,tichondrius,1247,deathknight,unholy,30,13,17
Lagmasterx,sargeras,1247,deathknight,unholy,30,13,17
Malhandir,azgalor,1247,deathknight,unholy,30,13,17
Buldrokastee,tichondrius,1247,deathknight,unholy,36,13,23
Lickblood,sargeras,1246,deathknight,unholy,24,13,11
Möchi,ragnaros,1246,deathknight,unholy,63,32,31
Bloodyloco,malganis,1246,deathknight,unholy,64,32,32
Sussybakadk,sargeras,1246,deathknight,unholy,28,14,14
Magipierrot,ragnaros,1245,deathknight,unholy,62,31,31
Koda,thrall,1243,deathknight,unholy,30,13,17
Lovedaddy,frostmourne,1242,deathknight,unholy,30,13,17
Teksurugi,korgath,1242,deathknight,unholy,30,13,17
Youngmoneyyd,illidan,1241,deathknight,unholy,18,13,5
Billieeilish,sargeras,1241,deathknight,unholy,24,13,11
Shezoe,drakkari,1238,deathknight,unholy,24,13,11
Flavorchops,kelthuzad,1238,deathknight,unholy,36,13,23
Lebrônjames,tichondrius,1236,deathknight,unholy,24,13,11
Neipum,stormrage,1234,deathknight,unholy,18,13,5
Madmaxxy,barthilas,1234,deathknight,unholy,69,30,39
Rarum,bleeding-hollow,1233,deathknight,unholy,24,13,11
Soulhuntress,doomhammer,1227,deathknight,unholy,114,58,56
Unhølydøøm,misha,1226,deathknight,unholy,78,39,39
Lorð,malganis,1225,deathknight,unholy,42,22,20
Nevarro,lightbringer,1224,deathknight,unholy,212,104,108
Necrósy,azralon,1222,deathknight,unholy,30,13,17
Potatobob,dalaran,1222,deathknight,unholy,30,13,17
Rixin,agamaggan,1216,deathknight,unholy,42,15,27
Unhøøly,nemesis,1214,deathknight,unholy,30,15,15
Mazey,moon-guard,1209,deathknight,unholy,199,98,101
Shadow,ragnaros,1201,deathknight,unholy,29,13,16
Golurun,tichondrius,1197,deathknight,unholy,25,15,10
Zeeroo,moon-guard,1191,deathknight,unholy,34,17,17
Gatrars,sargeras,1185,deathknight,unholy,72,32,40
Malsedius,kelthuzad,1181,deathknight,unholy,33,14,19
Sne,dragonmaw,1180,deathknight,unholy,30,17,13
Coffïnfeeder,dalaran,1178,deathknight,unholy,78,31,47
Drowhd,nemesis,1177,deathknight,unholy,60,27,33
Treikorh,quelthalas,1174,deathknight,unholy,130,55,75
Darktrinnity,nemesis,1173,deathknight,unholy,35,20,15
Mercysparx,thrall,1171,deathknight,unholy,60,30,30
Doombeast,area-52,1165,deathknight,unholy,31,15,16
Mmrhostage,kelthuzad,1165,deathknight,unholy,30,14,16
Omegaseven,gorgonnash,1154,deathknight,unholy,126,66,60
Oql,tichondrius,1152,deathknight,unholy,24,12,12
Diviniumx,bleeding-hollow,1152,deathknight,unholy,27,13,14
Divinium,bleeding-hollow,1152,deathknight,unholy,30,12,18
Goonaa,tichondrius,1151,deathknight,unholy,24,12,12
Bukum,zuljin,1151,deathknight,unholy,36,12,24
Kryptikkyt,blackrock,1150,deathknight,unholy,30,12,18
Vesel,tichondrius,1149,deathknight,unholy,36,12,24
Azgaroth,dathremar,1148,deathknight,unholy,38,20,18
Oldskul,sargeras,1146,deathknight,unholy,34,17,17
Chalamander,tichondrius,1146,deathknight,unholy,24,12,12
Iamthedanger,aerie-peak,1145,deathknight,unholy,24,12,12
Kehin,azralon,1144,deathknight,unholy,70,29,41
Tiansama,ragnaros,1143,deathknight,unholy,18,12,6
Dravix,azshara,1143,deathknight,unholy,18,12,6
Skeleton,lightnings-blade,1141,deathknight,unholy,33,13,20
Rognarash,emerald-dream,1139,deathknight,unholy,24,12,12
Fanggrief,proudmoore,1139,deathknight,unholy,30,12,18
Luckyson,tichondrius,1137,deathknight,unholy,24,12,12
Araris,stormrage,1135,deathknight,unholy,36,12,24
Fakiez,kelthuzad,1133,deathknight,unholy,32,13,19
Heärt,bleeding-hollow,1133,deathknight,unholy,50,19,31
Shinici,kelthuzad,1132,deathknight,unholy,24,12,12
Awzy,azralon,1127,deathknight,unholy,24,12,12
Vampirecarti,tichondrius,1122,deathknight,unholy,38,18,20
Toroandmoi,area-52,1121,deathknight,unholy,24,12,12
Carecaa,azralon,1119,deathknight,unholy,44,19,25
Sabotdk,tichondrius,1117,deathknight,unholy,24,12,12
Leviiathan,tichondrius,1117,deathknight,unholy,24,12,12
Frostcleave,emerald-dream,1115,deathknight,unholy,24,16,8
Joeyxdk,tichondrius,1114,deathknight,unholy,23,12,11
Druncker,blackrock,1114,deathknight,unholy,53,20,33
Mordeo,bleeding-hollow,1114,deathknight,unholy,34,12,22
Exequias,zuljin,1111,deathknight,unholy,30,17,13
Mandrágor,quelthalas,1111,deathknight,unholy,52,20,32
Alphabro,zuluhed,1108,deathknight,unholy,42,22,20
Polydeuces,queldorei,1091,deathknight,unholy,66,26,40
Anonymousix,kelthuzad,1090,deathknight,unholy,23,12,11
Rhaenyrà,tichondrius,1089,deathknight,unholy,27,15,12
Skellig,wyrmrest-accord,1086,deathknight,unholy,36,13,23
Beanboyx,tichondrius,1085,deathknight,unholy,22,12,10
Kanthrix,illidan,1084,deathknight,unholy,32,12,20
Plaguebreak,darrowmere,1083,deathknight,unholy,48,30,18
Fuzzyrump,eitrigg,1067,deathknight,unholy,18,13,5
Zaelize,sargeras,1065,deathknight,unholy,48,21,27
Ragsec,bleeding-hollow,1056,deathknight,unholy,18,11,7
Steamerboy,stormrage,1056,deathknight,unholy,18,11,7
Aidsbenedict,malganis,1056,deathknight,unholy,24,11,13
Gasani,bonechewer,1055,deathknight,unholy,18,11,7
Vleryan,ragnaros,1055,deathknight,unholy,18,11,7
Rongkhun,proudmoore,1054,deathknight,unholy,36,11,25
Bhyrnam,ragnaros,1054,deathknight,unholy,36,11,25
Sommeliergg,stormrage,1053,deathknight,unholy,18,11,7
Deathboost,stormrage,1053,deathknight,unholy,36,11,25
Happynaru,tichondrius,1052,deathknight,unholy,24,11,13
Polpop,zuljin,1051,deathknight,unholy,18,11,7
Any,the-venture-co,1050,deathknight,unholy,24,11,13
Acidirin,tichondrius,1049,deathknight,unholy,18,11,7
Draenor,shadowmoon,1049,deathknight,unholy,18,11,7
Fallen,nazjatar,1048,deathknight,unholy,18,11,7
Salahzar,stormrage,1048,deathknight,unholy,24,11,13
Agohnim,moon-guard,1046,deathknight,unholy,30,11,19
Bazzingaxd,hyjal,1044,deathknight,unholy,36,21,15
Lazta,azralon,1044,deathknight,unholy,40,17,23
Sniperlord,uldaman,1039,deathknight,unholy,18,11,7
Bubblesdk,whisperwind,1039,deathknight,unholy,30,11,19
Lieyanyanwan,tichondrius,1037,deathknight,unholy,30,11,19
Edhral,ragnaros,1033,deathknight,unholy,24,11,13
Deathcometh,tichondrius,1027,deathknight,unholy,30,11,19
Kayzark,tichondrius,1026,deathknight,unholy,36,20,16
Deathnorris,zuljin,1026,deathknight,unholy,80,38,42
Mordekaiseer,azralon,1016,deathknight,unholy,124,60,64
Jukpark,tichondrius,1004,deathknight,unholy,18,11,7
Azibar,moon-guard,990,deathknight,unholy,17,11,6
Honustustere,emerald-dream,986,deathknight,unholy,23,11,12
Vaseline,zangarmarsh,980,deathknight,unholy,24,11,13
Hansmclroy,trollbane,970,deathknight,unholy,24,14,10
Vaske,azjolnerub,963,deathknight,unholy,55,20,35
Vaizard,malganis,960,deathknight,unholy,18,10,8
Asukka,tichondrius,960,deathknight,unholy,18,10,8
Giveretms,azralon,960,deathknight,unholy,24,10,14
Ragrek,bleeding-hollow,960,deathknight,unholy,24,10,14
Einherjiar,tichondrius,960,deathknight,unholy,24,10,14
Rängi,caelestrasz,960,deathknight,unholy,78,26,52
Immadkx,area-52,960,deathknight,unholy,30,10,20
Rxzo,frostmourne,960,deathknight,unholy,30,10,20
Pookr,area-52,960,deathknight,unholy,30,10,20
Hotdk,thrall,960,deathknight,unholy,30,10,20
Orcsexual,azralon,959,deathknight,unholy,18,10,8
Mainxx,stormrage,959,deathknight,unholy,18,10,8
Awshuks,illidan,959,deathknight,unholy,18,10,8
Deathbloss,illidan,959,deathknight,unholy,20,11,9
Emarose,illidan,959,deathknight,unholy,24,10,14
Galaxyboom,tichondrius,958,deathknight,unholy,12,10,2
Reapsouls,stormrage,958,deathknight,unholy,13,10,3
Xlive,tichondrius,958,deathknight,unholy,24,10,14
Althamon,tanaris,958,deathknight,unholy,30,10,20
Iðûnn,barthilas,957,deathknight,unholy,18,10,8
Aldoraenna,illidan,957,deathknight,unholy,24,10,14
Yamanji,wyrmrest-accord,956,deathknight,unholy,18,10,8
Arthyius,kiljaeden,956,deathknight,unholy,30,10,20
Gobaiakun,proudmoore,955,deathknight,unholy,18,10,8
Mëlødy,quelthalas,955,deathknight,unholy,18,10,8
Ganancïa,nemesis,953,deathknight,unholy,21,11,10
Afterdeath,frostmourne,953,deathknight,unholy,24,10,14
Deathafter,tichondrius,948,deathknight,unholy,24,10,14
Thaylenaar,eredar,947,deathknight,unholy,18,10,8
Niennahh,sargeras,946,deathknight,unholy,24,10,14
Ghorzul,thrall,945,deathknight,unholy,24,10,14
Kel,stormreaver,942,deathknight,unholy,29,10,19
Hentaideath,kiljaeden,934,deathknight,unholy,24,10,14
Annerito,area-52,927,deathknight,unholy,23,10,13
Muffinstomp,eredar,927,deathknight,unholy,24,10,14
Bahtman,hakkar,925,deathknight,unholy,18,10,8
Jaydkx,tichondrius,906,deathknight,unholy,28,11,17
Rottenwiener,sargeras,900,deathknight,unholy,17,10,7
Cishei,quelthalas,897,deathknight,unholy,21,12,9
Càsshêrn,lightbringer,893,deathknight,unholy,14,10,4
Zareon,zuluhed,876,deathknight,unholy,24,12,12
Dandandor,muradin,876,deathknight,unholy,38,17,21
Deathstrikex,tichondrius,864,deathknight,unholy,12,9,3
Earthican,bleeding-hollow,864,deathknight,unholy,12,9,3
Nerfdklul,illidan,864,deathknight,unholy,12,9,3
Linyive,malganis,864,deathknight,unholy,18,9,9
Utthrity,ysera,864,deathknight,unholy,18,9,9
Methyldk,frostmourne,864,deathknight,unholy,21,10,11
Dill,madoran,864,deathknight,unholy,24,9,15
Datnai,barthilas,864,deathknight,unholy,24,9,15
Fortissax,area-52,864,deathknight,unholy,30,9,21
Twodkitty,kelthuzad,863,deathknight,unholy,12,9,3
Ãstaroth,stormrage,863,deathknight,unholy,18,9,9
Vynlerran,skullcrusher,862,deathknight,unholy,18,9,9
Umbranox,arthas,862,deathknight,unholy,18,9,9
Gerometal,ragnaros,862,deathknight,unholy,24,9,15
Sílthree,barthilas,862,deathknight,unholy,24,9,15
Runeswanson,area-52,861,deathknight,unholy,18,9,9
Cosanostrá,malganis,860,deathknight,unholy,12,9,3
Rinthosaka,ragnaros,860,deathknight,unholy,18,9,9
Aretos,dreadmaul,860,deathknight,unholy,18,9,9
Orphnoch,illidan,860,deathknight,unholy,24,9,15
Velyssiah,stormrage,860,deathknight,unholy,24,9,15
Sidbane,kalecgos,859,deathknight,unholy,19,9,10
Tugs,nathrezim,858,deathknight,unholy,18,9,9
Darkàn,lightnings-blade,858,deathknight,unholy,24,9,15
Kaórii,stormrage,858,deathknight,unholy,30,9,21
Tinytanx,aerie-peak,856,deathknight,unholy,30,9,21
Ulyssess,jubeithos,855,deathknight,unholy,34,15,19
Nicrack,malganis,853,deathknight,unholy,18,9,9
Zathog,lightbringer,853,deathknight,unholy,30,9,21
Ulerin,illidan,850,deathknight,unholy,18,9,9
Plaza,thorium-brotherhood,844,deathknight,unholy,18,9,9
Grimmtidings,dentarg,839,deathknight,unholy,42,17,25
Destruktion,uldaman,838,deathknight,unholy,12,9,3
Deadspellz,bleeding-hollow,832,deathknight,unholy,34,9,25
Fendos,turalyon,822,deathknight,unholy,18,9,9
Littlekims,emerald-dream,799,deathknight,unholy,16,9,7
Festers,burning-legion,794,deathknight,unholy,26,9,17
Balakk,tichondrius,790,deathknight,unholy,26,9,17
Liqùid,moon-guard,768,deathknight,unholy,12,8,4
Mesx,illidan,768,deathknight,unholy,12,8,4
Vitad,tichondrius,768,deathknight,unholy,12,8,4
Dicromick,illidan,768,deathknight,unholy,15,9,6
Puppykiss,perenolde,768,deathknight,unholy,18,8,10
Piratehookah,sargeras,768,deathknight,unholy,18,8,10
Gutterboy,malganis,768,deathknight,unholy,18,8,10
Böffa,dalaran,768,deathknight,unholy,18,8,10
Fydedk,stormrage,768,deathknight,unholy,18,8,10
Novädk,ragnaros,768,deathknight,unholy,18,8,10
Shadowsdk,tichondrius,768,deathknight,unholy,18,8,10
Loomoros,sargeras,768,deathknight,unholy,24,8,16
Deathsloot,sargeras,767,deathknight,unholy,12,8,4
Ørcrist,area-52,767,deathknight,unholy,12,8,4
Fluffymoo,frostmourne,767,deathknight,unholy,18,8,10
Hædës,area-52,767,deathknight,unholy,18,8,10
Traitre,onyxia,767,deathknight,unholy,18,8,10
Demona,ragnaros,767,deathknight,unholy,18,8,10
Ahrímán,illidan,767,deathknight,unholy,18,8,10
Rulord,wyrmrest-accord,767,deathknight,unholy,18,8,10
Mordumi,stormrage,767,deathknight,unholy,24,8,16
Paulpatine,tichondrius,767,deathknight,unholy,24,8,16
Ðerion,stormrage,766,deathknight,unholy,12,8,4
Redcancer,tichondrius,766,deathknight,unholy,12,8,4
Deathwardenn,ghostlands,766,deathknight,unholy,18,8,10
Olblueyes,hyjal,766,deathknight,unholy,18,8,10
Riparonii,illidan,766,deathknight,unholy,21,8,13
Shadowghast,saurfang,765,deathknight,unholy,12,8,4
Bloodydebt,malganis,765,deathknight,unholy,18,8,10
Dalrin,emerald-dream,765,deathknight,unholy,24,8,16
Leiry,darkspear,762,deathknight,unholy,12,8,4
Kowell,drakkari,762,deathknight,unholy,18,8,10
Dankbro,tichondrius,761,deathknight,unholy,24,10,14
Iamlrr,maelstrom,761,deathknight,unholy,24,8,16
Frozenkappa,hyjal,735,deathknight,unholy,17,8,9
Starset,burning-legion,728,deathknight,unholy,24,9,15
Volardan,trollbane,713,deathknight,unholy,15,9,6
Gêralt,darkspear,712,deathknight,unholy,18,9,9
Tonylin,tichondrius,703,deathknight,unholy,14,8,6
Somethingdum,sargeras,703,deathknight,unholy,16,8,8
Froznorbs,tichondrius,700,deathknight,unholy,14,8,6
Cgg,tichondrius,672,deathknight,unholy,12,7,5
Karthayne,area-52,672,deathknight,unholy,12,7,5
Donrhythmic,ysera,672,deathknight,unholy,12,7,5
Jbert,sargeras,672,deathknight,unholy,12,7,5
Gurnok,barthilas,672,deathknight,unholy,12,7,5
Plag,bleeding-hollow,672,deathknight,unholy,12,7,5
Eldavò,quelthalas,672,deathknight,unholy,12,7,5
Umbramane,tichondrius,672,deathknight,unholy,18,7,11
Kûri,runetotem,672,deathknight,unholy,18,7,11
Bellybuster,malganis,672,deathknight,unholy,18,7,11
Bryku,tichondrius,672,deathknight,unholy,18,7,11
Mmaximus,darkspear,672,deathknight,unholy,18,7,11
Ebolaxd,area-52,672,deathknight,unholy,18,7,11
Xenocrates,illidan,672,deathknight,unholy,24,7,17
Cptsäveähöe,tichondrius,672,deathknight,unholy,24,7,17
Darione,twisting-nether,672,deathknight,unholy,24,7,17
Ceedog,crushridge,672,deathknight,unholy,30,7,23
Fligdeath,llane,671,deathknight,unholy,12,7,5
Deathsatan,barthilas,671,deathknight,unholy,12,7,5
Deatheey,area-52,671,deathknight,unholy,12,7,5
Tiller,mannoroth,671,deathknight,unholy,12,7,5
Gâbriel,cairne,671,deathknight,unholy,12,7,5
Yadaddy,hydraxis,671,deathknight,unholy,12,7,5
Sevexi,moon-guard,671,deathknight,unholy,12,7,5
Kidek,proudmoore,671,deathknight,unholy,18,7,11
Biukanon,ragnaros,671,deathknight,unholy,18,7,11
Mfknight,archimonde,671,deathknight,unholy,18,7,11
Feorlar,dalaran,671,deathknight,unholy,18,7,11
Shhnitzle,stormrage,671,deathknight,unholy,18,7,11
Coldrhelx,quelthalas,671,deathknight,unholy,30,7,23
Emberwarden,stormrage,670,deathknight,unholy,18,7,11
Irokthefrost,frostmourne,669,deathknight,unholy,12,7,5
Zebastion,amanthul,668,deathknight,unholy,18,7,11
Terracundo,quelthalas,667,deathknight,unholy,18,9,9
Grtmisdirect,illidan,666,deathknight,unholy,21,8,13
Zëb,sargeras,665,deathknight,unholy,12,7,5
Zàkgor,moon-guard,665,deathknight,unholy,12,7,5
Argar,crushridge,664,deathknight,unholy,12,7,5
Heldwynd,bonechewer,664,deathknight,unholy,24,7,17
Garshna,ragnaros,658,deathknight,unholy,12,7,5
Dbg,frostmane,639,deathknight,unholy,11,7,4
Ams,moon-guard,639,deathknight,unholy,17,7,10
Killinois,tichondrius,623,deathknight,unholy,17,7,10
Bonalumë,azralon,620,deathknight,unholy,17,7,10
Soulkiti,blackwater-raiders,608,deathknight,unholy,16,7,9
Aundethell,moon-guard,608,deathknight,unholy,33,7,26
Bingoez,frostmourne,607,deathknight,unholy,11,7,4
Hadianton,stormrage,599,deathknight,unholy,11,7,4
Xtador,quelthalas,591,deathknight,unholy,11,7,4
Bernaldino,illidan,576,deathknight,unholy,6,6,0
Virulous,zuljin,576,deathknight,unholy,6,6,0
Arcänn,drenden,576,deathknight,unholy,6,6,0
Bøoth,area-52,576,deathknight,unholy,12,6,6
Lagérthâ,ragnaros,576,deathknight,unholy,12,6,6
Delwrath,proudmoore,576,deathknight,unholy,12,6,6
Ridesatenspd,caelestrasz,576,deathknight,unholy,12,6,6
Justtaki,zuljin,576,deathknight,unholy,12,6,6
Demonicrunes,windrunner,576,deathknight,unholy,12,6,6
Svlla,doomhammer,576,deathknight,unholy,12,6,6
Cali,bladefist,576,deathknight,unholy,12,6,6
Tragdore,thrall,576,deathknight,unholy,12,6,6
Desen,arthas,576,deathknight,unholy,12,6,6
Zifandel,bleeding-hollow,576,deathknight,unholy,12,6,6
Surkk,tichondrius,576,deathknight,unholy,12,6,6
Degrease,bonechewer,576,deathknight,unholy,12,6,6
Bébøp,malganis,576,deathknight,unholy,12,6,6
Tråuma,uther,576,deathknight,unholy,12,6,6
Meisterdeath,stormrage,576,deathknight,unholy,12,6,6
Raaizz,ragnaros,576,deathknight,unholy,12,6,6
Notorious,garrosh,576,deathknight,unholy,12,6,6
Hickish,tichondrius,576,deathknight,unholy,12,6,6
Lemuriön,nemesis,576,deathknight,unholy,12,6,6
Jonahdk,sargeras,576,deathknight,unholy,12,6,6
Mightyfails,frostmourne,576,deathknight,unholy,12,6,6
Friezen,illidan,576,deathknight,unholy,12,6,6
Volyant,frostmourne,576,deathknight,unholy,12,6,6
Garù,ragnaros,576,deathknight,unholy,12,6,6
Cirillan,bleeding-hollow,576,deathknight,unholy,18,6,12
Greenduck,malganis,576,deathknight,unholy,18,6,12
Lainmortal,ragnaros,576,deathknight,unholy,18,6,12
Joystickwrld,silvermoon,576,deathknight,unholy,18,6,12
Hydree,bleeding-hollow,576,deathknight,unholy,18,6,12
Maripaula,ragnaros,576,deathknight,unholy,18,6,12
Kterrorblade,sargeras,576,deathknight,unholy,18,6,12
Deephideblue,proudmoore,576,deathknight,unholy,19,6,13
Conquest,drenden,576,deathknight,unholy,24,6,18
Baldlord,tichondrius,576,deathknight,unholy,24,6,18
Åkatsukii,uther,575,deathknight,unholy,12,6,6
Vërmilliøn,ragnaros,575,deathknight,unholy,12,6,6
Agamoth,ragnaros,575,deathknight,unholy,12,6,6
Zevrynn,barthilas,575,deathknight,unholy,12,6,6
Pántera,darkspear,575,deathknight,unholy,12,6,6
Christophe,skullcrusher,575,deathknight,unholy,12,6,6
Corpsepetal,muradin,575,deathknight,unholy,18,6,12
Trüppen,area-52,574,deathknight,unholy,12,6,6
Fraänrisco,ragnaros,574,deathknight,unholy,18,6,12
Vapelounge,darkspear,574,deathknight,unholy,18,6,12
Darthblade,darkspear,573,deathknight,unholy,6,6,0
Tormentsoul,ragnaros,572,deathknight,unholy,12,6,6
Juggérnaút,bonechewer,572,deathknight,unholy,12,6,6
Deathsmog,quelthalas,571,deathknight,unholy,13,6,7
Lowan,stormrage,566,deathknight,unholy,12,6,6
Syzurp,barthilas,558,deathknight,unholy,13,7,6
Poonen,area-52,543,deathknight,unholy,11,6,5
Herstôry,kelthuzad,527,deathknight,unholy,11,6,5
Gkdm,tichondrius,522,deathknight,unholy,21,8,13
Chës,tichondrius,522,deathknight,unholy,22,7,15
Nekrosys,eitrigg,512,deathknight,unholy,16,6,10
Kalëndar,drakkari,503,deathknight,unholy,25,12,13
Bawlsauce,area-52,496,deathknight,unholy,13,6,7
Depthknight,barthilas,480,deathknight,unholy,6,5,1
Andariel,ragnaros,480,deathknight,unholy,6,5,1
Déká,tichondrius,480,deathknight,unholy,6,5,1
Xaldalas,kelthuzad,480,deathknight,unholy,6,5,1
Monstrosìty,bleeding-hollow,480,deathknight,unholy,6,5,1
Solø,proudmoore,480,deathknight,unholy,6,5,1
Bànished,moon-guard,480,deathknight,unholy,7,5,2
Frostyclaws,blackrock,480,deathknight,unholy,12,5,7
Initiative,moon-guard,480,deathknight,unholy,12,5,7
Xariuz,quelthalas,480,deathknight,unholy,12,5,7
Raull,ragnaros,480,deathknight,unholy,12,5,7
Gorillagrip,sargeras,480,deathknight,unholy,12,5,7
Deathpair,bleeding-hollow,480,deathknight,unholy,12,5,7
Morghulas,moon-guard,480,deathknight,unholy,12,5,7
Dkbunny,thaurissan,480,deathknight,unholy,12,5,7
Darkfög,sargeras,480,deathknight,unholy,12,5,7
Cosmicrune,turalyon,480,deathknight,unholy,12,5,7
Pathæs,bleeding-hollow,480,deathknight,unholy,12,5,7
Irreversible,zuljin,480,deathknight,unholy,12,5,7
Shinukishin,stormrage,480,deathknight,unholy,12,5,7
Darkwraith,illidan,480,deathknight,unholy,12,5,7
Andem,elune,480,deathknight,unholy,12,5,7
Swänsz,stormrage,480,deathknight,unholy,12,5,7
Yeahgood,frostmourne,480,deathknight,unholy,12,5,7
Römney,stormrage,480,deathknight,unholy,12,5,7
Akmy,illidan,480,deathknight,unholy,12,5,7
Defekaite,kiljaeden,480,deathknight,unholy,12,5,7
Defaultz,turalyon,480,deathknight,unholy,12,5,7
Tharegorn,azralon,480,deathknight,unholy,12,5,7
Akilol,tichondrius,480,deathknight,unholy,12,5,7
Skotch,lightninghoof,480,deathknight,unholy,12,5,7
Ghrat,bleeding-hollow,480,deathknight,unholy,12,5,7
Kasteny,frostmourne,480,deathknight,unholy,12,5,7
Zaratose,area-52,480,deathknight,unholy,12,5,7
Hardtoplaydk,chogall,480,deathknight,unholy,12,5,7
Noitrox,azralon,480,deathknight,unholy,12,5,7
Serathai,tichondrius,480,deathknight,unholy,12,5,7
Laboön,stormrage,480,deathknight,unholy,12,5,7
Abadena,illidan,480,deathknight,unholy,15,5,10
Nappão,azralon,480,deathknight,unholy,18,5,13
Sylèss,tichondrius,480,deathknight,unholy,18,5,13
Rytex,moon-guard,480,deathknight,unholy,18,5,13
Arkhän,ragnaros,480,deathknight,unholy,18,5,13
Dementrius,zuljin,480,deathknight,unholy,25,5,20
Ahwooh,kelthuzad,479,deathknight,unholy,6,5,1
Extremepvp,aegwynn,479,deathknight,unholy,6,5,1
Amaethyst,kelthuzad,479,deathknight,unholy,12,5,7
Caqw,akama,479,deathknight,unholy,12,5,7
Yosemithe,quelthalas,479,deathknight,unholy,12,5,7
Itired,tichondrius,479,deathknight,unholy,12,5,7
Jojomcdeath,senjin,479,deathknight,unholy,12,5,7
Deathfearsme,kiljaeden,479,deathknight,unholy,12,5,7
Azombie,burning-blade,479,deathknight,unholy,12,5,7
Primoverdino,azralon,479,deathknight,unholy,12,5,7
Moxtexd,drakkari,478,deathknight,unholy,6,5,1
Aborter,arthas,478,deathknight,unholy,12,5,7
Draxsos,quelthalas,475,deathknight,unholy,18,5,13
Dreekon,bleeding-hollow,468,deathknight,unholy,19,9,10
Megatrôn,malganis,463,deathknight,unholy,17,5,12
Faelmo,malganis,447,deathknight,unholy,11,5,6
Sorry,ysera,432,deathknight,unholy,9,6,3
Spôôn,aggramar,430,deathknight,unholy,11,5,6
Jhiv,tichondrius,426,deathknight,unholy,16,6,10
Dtrayn,tichondrius,416,deathknight,unholy,10,5,5
Reighart,kiljaeden,415,deathknight,unholy,8,5,3
Testifier,illidan,415,deathknight,unholy,8,5,3
Shiminy,chogall,415,deathknight,unholy,10,5,5
Wuhán,proudmoore,414,deathknight,unholy,20,5,15
Frostology,echo-isles,399,deathknight,unholy,5,5,0
Murphu,stormrage,384,deathknight,unholy,6,4,2
Ghouldruis,barthilas,384,deathknight,unholy,6,4,2
Tibocourtois,tichondrius,384,deathknight,unholy,6,4,2
Lîch,azralon,384,deathknight,unholy,6,4,2
Koltíra,azralon,384,deathknight,unholy,6,4,2
Whaleofwales,ysondre,384,deathknight,unholy,6,4,2
Raynorr,dawnbringer,384,deathknight,unholy,6,4,2
Darkswar,barthilas,384,deathknight,unholy,6,4,2
Futruth,khaz-modan,384,deathknight,unholy,6,4,2
Sephirott,boulderfist,384,deathknight,unholy,6,4,2
Deadsamurai,illidan,384,deathknight,unholy,6,4,2
Atrahazis,quelthalas,384,deathknight,unholy,6,4,2
Noahmelo,nemesis,384,deathknight,unholy,6,4,2
Vicentão,tichondrius,384,deathknight,unholy,6,4,2
Bigdollars,eredar,384,deathknight,unholy,6,4,2
Koreandk,tichondrius,384,deathknight,unholy,6,4,2
Chillbruh,garrosh,384,deathknight,unholy,6,4,2
Zakka,korgath,384,deathknight,unholy,6,4,2
Sleezyfbaby,sargeras,384,deathknight,unholy,6,4,2
Vampygeizt,zuljin,384,deathknight,unholy,6,4,2
Higeki,area-52,384,deathknight,unholy,6,4,2
Nøzawkolypse,area-52,384,deathknight,unholy,6,4,2
Logann,azralon,384,deathknight,unholy,6,4,2
Supblood,tichondrius,384,deathknight,unholy,6,4,2
Xhamstr,frostmourne,384,deathknight,unholy,6,4,2
Mistmoorex,stormscale,384,deathknight,unholy,6,4,2
Keator,tichondrius,384,deathknight,unholy,6,4,2
Claudio,tichondrius,384,deathknight,unholy,6,4,2
Zeathial,moon-guard,384,deathknight,unholy,6,4,2
Rompeimën,ragnaros,384,deathknight,unholy,6,4,2
Metinchaff,shadowmoon,384,deathknight,unholy,6,4,2
Vläad,ragnaros,384,deathknight,unholy,6,4,2
Deadwait,rivendare,384,deathknight,unholy,6,4,2
Pleasecakes,blood-furnace,384,deathknight,unholy,9,5,4
Bjorstad,moon-guard,384,deathknight,unholy,12,4,8
Maalevolent,thunderlord,384,deathknight,unholy,12,4,8
Raakaa,ghostlands,384,deathknight,unholy,12,4,8
Coronä,malfurion,384,deathknight,unholy,12,4,8
Cokedrip,bleeding-hollow,384,deathknight,unholy,12,4,8
Threehunned,frostmourne,384,deathknight,unholy,12,4,8
Clearlol,bleeding-hollow,384,deathknight,unholy,12,4,8
Nolderosdk,nemesis,384,deathknight,unholy,12,4,8
Testamentxx,thunderlord,384,deathknight,unholy,12,4,8
Bealzabub,sargeras,384,deathknight,unholy,12,4,8
Tinylich,arthas,384,deathknight,unholy,12,4,8
Hounura,dathremar,384,deathknight,unholy,12,4,8
Asana,illidan,384,deathknight,unholy,12,4,8
Noiksnow,azralon,384,deathknight,unholy,12,4,8
Silanvia,wyrmrest-accord,384,deathknight,unholy,12,4,8
Boltman,malganis,384,deathknight,unholy,12,4,8
Oomak,bonechewer,384,deathknight,unholy,12,4,8
Wúhan,moon-guard,384,deathknight,unholy,12,4,8
Çorn,sargeras,384,deathknight,unholy,12,4,8
Daellius,ragnaros,384,deathknight,unholy,12,4,8
Ambagrips,frostmourne,384,deathknight,unholy,12,4,8
Eightamdk,tichondrius,384,deathknight,unholy,12,4,8
Zoomoth,illidan,384,deathknight,unholy,12,4,8
Annuvyz,darkspear,384,deathknight,unholy,12,4,8
Bøngripx,tichondrius,384,deathknight,unholy,12,4,8
Tyrien,frostmane,384,deathknight,unholy,12,4,8
Avengis,bleeding-hollow,384,deathknight,unholy,18,4,14
Sahaile,moon-guard,384,deathknight,unholy,18,4,14
Lho,caelestrasz,384,deathknight,unholy,18,4,14
Keralius,stormrage,384,deathknight,unholy,18,4,14
Turbotoxic,illidan,383,deathknight,unholy,6,4,2
Croaker,gurubashi,383,deathknight,unholy,6,4,2
Flazzul,kiljaeden,383,deathknight,unholy,6,4,2
Hitsüyi,quelthalas,383,deathknight,unholy,11,6,5
Runíc,demon-soul,383,deathknight,unholy,12,4,8
Demher,ragnaros,383,deathknight,unholy,12,4,8
Optics,bleeding-hollow,383,deathknight,unholy,12,4,8
Plaguedoctor,moon-guard,383,deathknight,unholy,12,4,8
Mëllowhypë,sargeras,383,deathknight,unholy,12,4,8
Jinxtar,wyrmrest-accord,382,deathknight,unholy,6,4,2
Soulfarm,tichondrius,382,deathknight,unholy,6,4,2
Hobyrt,bleeding-hollow,382,deathknight,unholy,6,4,2
Gankhiss,emerald-dream,351,deathknight,unholy,11,4,7
Azupo,aerie-peak,351,deathknight,unholy,14,5,9
Ghostdeath,blackhand,336,deathknight,unholy,9,4,5
Zygon,thrall,336,deathknight,unholy,9,4,5
Ahirek,quelthalas,320,deathknight,unholy,10,4,6
Stankybreath,bleeding-hollow,320,deathknight,unholy,10,4,6
Ekaj,azuremyst,319,deathknight,unholy,5,4,1
Greizul,area-52,288,deathknight,unholy,6,3,3
Sherank,akama,288,deathknight,unholy,6,3,3
Malairia,area-52,288,deathknight,unholy,6,3,3
Marash,moon-guard,288,deathknight,unholy,6,3,3
Schreit,zuljin,288,deathknight,unholy,6,3,3
Jerkin,area-52,288,deathknight,unholy,6,3,3
Andeadx,tichondrius,288,deathknight,unholy,6,3,3
Monglord,arthas,288,deathknight,unholy,6,3,3
Laeroth,zuluhed,288,deathknight,unholy,6,3,3
Adavynn,darkspear,288,deathknight,unholy,6,3,3
Alivaron,lothar,288,deathknight,unholy,6,3,3
Handler,nemesis,288,deathknight,unholy,6,3,3
Birnolan,proudmoore,288,deathknight,unholy,6,3,3
Petkick,tichondrius,288,deathknight,unholy,6,3,3
Disritmia,stormrage,288,deathknight,unholy,6,3,3
Shookdnation,suramar,288,deathknight,unholy,6,3,3
Ventuss,bleeding-hollow,288,deathknight,unholy,6,3,3
Chrønnøz,nemesis,288,deathknight,unholy,6,3,3
Smokeyjoe,aegwynn,288,deathknight,unholy,6,3,3
Blitzcreig,sargeras,288,deathknight,unholy,6,3,3
Lafourche,sargeras,288,deathknight,unholy,6,3,3
Anderius,tichondrius,288,deathknight,unholy,6,3,3
Bosleigor,elune,288,deathknight,unholy,6,3,3
Válak,stormrage,288,deathknight,unholy,6,3,3
Rizzchimp,tichondrius,288,deathknight,unholy,6,3,3
Trant,tichondrius,288,deathknight,unholy,6,3,3
Remõrse,moon-guard,288,deathknight,unholy,6,3,3
Ödens,dalaran,288,deathknight,unholy,6,3,3
Mawvac,quelthalas,288,deathknight,unholy,6,3,3
Coldsleeps,saurfang,288,deathknight,unholy,6,3,3
Chibalaloca,quelthalas,288,deathknight,unholy,6,3,3
Grýmm,bonechewer,288,deathknight,unholy,6,3,3
Holsey,moon-guard,288,deathknight,unholy,6,3,3
Lepanda,skywall,288,deathknight,unholy,6,3,3
Xènia,exodar,288,deathknight,unholy,6,3,3
Redrox,tichondrius,288,deathknight,unholy,6,3,3
Sbplaysdk,akama,288,deathknight,unholy,6,3,3
Mýrrh,wyrmrest-accord,288,deathknight,unholy,6,3,3
Vinaroth,kiljaeden,288,deathknight,unholy,6,3,3
Lilwayne,archimonde,288,deathknight,unholy,6,3,3
Viscerus,stormrage,288,deathknight,unholy,6,3,3
Vigarst,azralon,288,deathknight,unholy,6,3,3
Indraz,jubeithos,288,deathknight,unholy,6,3,3
Nifftybear,tichondrius,288,deathknight,unholy,6,3,3
Mendoh,tichondrius,288,deathknight,unholy,6,3,3
Icefrost,ghostlands,288,deathknight,unholy,6,3,3
Supermane,jubeithos,288,deathknight,unholy,6,3,3
Frostdest,kiljaeden,288,deathknight,unholy,6,3,3
Jorich,ragnaros,288,deathknight,unholy,6,3,3
Drippedout,illidan,288,deathknight,unholy,6,3,3
Vexmaw,twisting-nether,288,deathknight,unholy,6,3,3
Yeetmaster,area-52,288,deathknight,unholy,6,3,3
Frenzza,frostmourne,288,deathknight,unholy,6,3,3
Grizzdk,blackrock,288,deathknight,unholy,6,3,3
Pepecoomer,frostmourne,288,deathknight,unholy,6,3,3
Fearfull,hyjal,288,deathknight,unholy,6,3,3
Kossero,thunderlord,288,deathknight,unholy,6,3,3
Ariacy,sargeras,288,deathknight,unholy,6,3,3
Renaming,area-52,288,deathknight,unholy,9,4,5
Oroborus,korgath,288,deathknight,unholy,8,3,5
Boomxic,shuhalo,288,deathknight,unholy,11,4,7
Mongomongo,malganis,288,deathknight,unholy,12,3,9
Wisdôm,frostmourne,288,deathknight,unholy,12,3,9
Angerforge,illidan,288,deathknight,unholy,12,3,9
Carmii,wyrmrest-accord,288,deathknight,unholy,12,3,9
Danlorinis,moon-guard,288,deathknight,unholy,12,3,9
Garonse,wyrmrest-accord,288,deathknight,unholy,12,3,9
Abømination,zuljin,288,deathknight,unholy,12,3,9
Torsophuk,stormrage,288,deathknight,unholy,12,3,9
Chosenrune,stormrage,288,deathknight,unholy,12,3,9
Fokit,barthilas,288,deathknight,unholy,12,3,9
Dkjs,anetheron,288,deathknight,unholy,12,3,9
Chosenhero,stormrage,288,deathknight,unholy,12,3,9
Coldmilk,wyrmrest-accord,288,deathknight,unholy,12,3,9
Gigabone,tichondrius,288,deathknight,unholy,12,3,9
Lolgriped,tichondrius,288,deathknight,unholy,12,3,9
Rottenqunt,tichondrius,288,deathknight,unholy,12,3,9
Techneeq,tichondrius,288,deathknight,unholy,12,3,9
Coffeemilk,kiljaeden,288,deathknight,unholy,13,3,10
Deathsent,malganis,288,deathknight,unholy,18,3,15
Jman,kaelthas,287,deathknight,unholy,6,3,3
Dàndàn,lightbringer,287,deathknight,unholy,6,3,3
Malovv,nemesis,287,deathknight,unholy,6,3,3
Chanskey,stormrage,287,deathknight,unholy,9,3,6
Zedknight,emerald-dream,287,deathknight,unholy,15,4,11
Morthul,tol-barad,287,deathknight,unholy,12,3,9
Orthason,moon-guard,286,deathknight,unholy,6,3,3
Papparoach,ysera,286,deathknight,unholy,6,3,3
Copy,suramar,271,deathknight,unholy,11,3,8
Milkdrugs,daggerspine,256,deathknight,unholy,10,3,7
Baskel,frostmane,255,deathknight,unholy,11,3,8
Deathrowe,blackhand,240,deathknight,unholy,9,3,6
Originalsin,tichondrius,239,deathknight,unholy,5,3,2
Dairboi,sargeras,239,deathknight,unholy,5,3,2
Mefistô,quelthalas,192,deathknight,unholy,4,3,1
Charabone,ragnaros,192,deathknight,unholy,4,3,1
Asterend,proudmoore,192,deathknight,unholy,4,3,1
Supfam,tichondrius,192,deathknight,unholy,6,2,4
Mesx,tichondrius,192,deathknight,unholy,6,2,4
Drzièglér,tichondrius,192,deathknight,unholy,6,2,4
Kranaz,barthilas,192,deathknight,unholy,6,2,4
Masochrist,baelgun,192,deathknight,unholy,6,2,4
Zerodk,kelthuzad,192,deathknight,unholy,6,2,4
Hanung,tichondrius,192,deathknight,unholy,6,2,4
Vlladimir,kelthuzad,192,deathknight,unholy,6,2,4
Gooré,ragnaros,192,deathknight,unholy,6,2,4
Cäin,dreadmaul,192,deathknight,unholy,6,2,4
Lìlith,dreadmaul,192,deathknight,unholy,6,2,4
Tbop,ragnaros,192,deathknight,unholy,6,2,4
Kookx,tichondrius,192,deathknight,unholy,6,2,4
Orcazmic,area-52,192,deathknight,unholy,6,2,4
Válhállá,ragnaros,192,deathknight,unholy,6,2,4
Poubelle,malganis,192,deathknight,unholy,6,2,4
Chandsformer,tichondrius,192,deathknight,unholy,6,2,4
Fizzease,illidan,192,deathknight,unholy,6,2,4
Båñglàdëshì,tichondrius,192,deathknight,unholy,6,2,4
Sieg,goldrinn,192,deathknight,unholy,6,2,4
Dxssxe,tichondrius,192,deathknight,unholy,6,2,4
Mistake,ragnaros,192,deathknight,unholy,6,2,4
Questíonable,arthas,192,deathknight,unholy,6,2,4
Gatitos,ragnaros,192,deathknight,unholy,6,2,4
Orbo,elune,192,deathknight,unholy,6,2,4
Nightdaddyy,laughing-skull,192,deathknight,unholy,6,2,4
Uncoachablex,illidan,192,deathknight,unholy,6,2,4
Ahmisu,tichondrius,192,deathknight,unholy,6,2,4
Afkftwok,illidan,192,deathknight,unholy,6,2,4
Twocolors,gilneas,192,deathknight,unholy,6,2,4
Ralphpootawn,illidan,192,deathknight,unholy,6,2,4
Spaxz,illidan,192,deathknight,unholy,6,2,4
Tristam,area-52,192,deathknight,unholy,6,2,4
Grimreminder,zuljin,192,deathknight,unholy,6,2,4
Jinus,earthen-ring,192,deathknight,unholy,6,2,4
Deathhimself,moonrunner,192,deathknight,unholy,6,2,4
Junepí,stormrage,192,deathknight,unholy,6,2,4
Blooddisease,frostmourne,192,deathknight,unholy,6,2,4
Moonkhink,stormrage,192,deathknight,unholy,6,2,4
Saraphdk,area-52,192,deathknight,unholy,6,2,4
Cimitiere,stormrage,192,deathknight,unholy,6,2,4
Nurglet,proudmoore,192,deathknight,unholy,6,2,4
Sokthr,proudmoore,192,deathknight,unholy,6,2,4
Eastcoast,azuremyst,192,deathknight,unholy,6,2,4
Mardrank,stormrage,192,deathknight,unholy,6,2,4
Kmardk,area-52,192,deathknight,unholy,6,2,4
Havasu,proudmoore,192,deathknight,unholy,6,2,4
Hastë,proudmoore,192,deathknight,unholy,6,2,4
Gusabio,drakkari,192,deathknight,unholy,6,2,4
Bealzabubb,sargeras,192,deathknight,unholy,6,2,4
Raahjx,sargeras,192,deathknight,unholy,6,2,4
Menalise,moon-guard,192,deathknight,unholy,6,2,4
Onsslaught,sargeras,192,deathknight,unholy,6,2,4
Teedk,drakthul,192,deathknight,unholy,6,2,4
Zilli,blackrock,192,deathknight,unholy,6,2,4
Mako,garithos,192,deathknight,unholy,6,2,4
Dustknight,sargeras,192,deathknight,unholy,6,2,4
Lunatick,darkspear,192,deathknight,unholy,6,2,4
Rockadeath,sargeras,192,deathknight,unholy,6,2,4
Tacofoxlol,tichondrius,192,deathknight,unholy,12,2,10
Chachea,kiljaeden,192,deathknight,unholy,12,2,10
Dravoc,kelthuzad,192,deathknight,unholy,12,2,10
Ðìvíne,illidan,192,deathknight,unholy,12,2,10
Ayooplaguez,guldan,192,deathknight,unholy,12,2,10
Ovulating,malganis,192,deathknight,unholy,12,2,10
Longlnus,malganis,192,deathknight,unholy,12,2,10
Maliceborn,stormrage,192,deathknight,unholy,12,2,10
Scythê,barthilas,192,deathknight,unholy,12,2,10
Fzero,frostmourne,192,deathknight,unholy,12,2,10
Rykard,hyjal,192,deathknight,unholy,12,2,10
Giraldus,stormrage,192,deathknight,unholy,12,2,10
Drdeathz,sargeras,191,deathknight,unholy,6,2,4
Vynjonc,drenden,191,deathknight,unholy,6,2,4
Larrisey,illidan,191,deathknight,unholy,6,2,4
Fishtouching,illidan,175,deathknight,unholy,11,2,9
Hooker,dragonmaw,138,deathknight,unholy,8,4,4
Glacíuss,ragnaros,138,deathknight,unholy,9,4,5
Hobdk,malganis,128,deathknight,unholy,9,2,7
Ðëthbringër,jubeithos,127,deathknight,unholy,8,2,6
Lunaxx,ragnaros,96,deathknight,unholy,6,1,5
Stormsick,ragnaros,96,deathknight,unholy,6,1,5
Azryull,perenolde,96,deathknight,unholy,6,1,5
Amö,emerald-dream,96,deathknight,unholy,6,1,5
Percy,thaurissan,96,deathknight,unholy,6,1,5
Moldremover,frostmourne,96,deathknight,unholy,6,1,5
Bein,frostmourne,96,deathknight,unholy,6,1,5
Requísition,barthilas,96,deathknight,unholy,6,1,5
Apeirøn,quelthalas,96,deathknight,unholy,6,1,5
Zenin,emerald-dream,96,deathknight,unholy,6,1,5
Report,dathremar,96,deathknight,unholy,6,1,5
Rgn,deathwing,96,deathknight,unholy,6,1,5
Tìtø,ragnaros,96,deathknight,unholy,6,1,5
Ishamaael,tichondrius,96,deathknight,unholy,6,1,5
Lichhbanne,doomhammer,96,deathknight,unholy,6,1,5
Dknightor,dalaran,96,deathknight,unholy,6,1,5
Alexanderz,quelthalas,96,deathknight,unholy,6,1,5
Gröxxigor,azralon,96,deathknight,unholy,6,1,5
Kìrìtó,malygos,96,deathknight,unholy,6,1,5
Sever,demon-soul,96,deathknight,unholy,6,1,5
Bealzabbub,sargeras,96,deathknight,unholy,6,1,5
Artyboy,icecrown,96,deathknight,unholy,6,1,5
Ellipsoro,onyxia,96,deathknight,unholy,6,1,5
Valandiel,jubeithos,96,deathknight,unholy,6,1,5
Hunwild,emerald-dream,96,deathknight,unholy,6,1,5
Iluvbooty,blackrock,96,deathknight,unholy,6,1,5
Alayssia,darkspear,96,deathknight,unholy,6,1,5
Sandolorian,area-52,96,deathknight,unholy,6,1,5
Grimorra,bleeding-hollow,96,deathknight,unholy,6,1,5
Worgenracist,tichondrius,96,deathknight,unholy,6,1,5
Vicesquad,tichondrius,96,deathknight,unholy,6,1,5
Dethklòk,area-52,96,deathknight,unholy,6,1,5
Krw,stormrage,96,deathknight,unholy,6,1,5
Heavic,skywall,96,deathknight,unholy,6,1,5
Almostdead,proudmoore,96,deathknight,unholy,6,1,5
Andivh,hydraxis,96,deathknight,unholy,6,1,5
Nachohands,laughing-skull,96,deathknight,unholy,6,1,5
Abake,illidan,96,deathknight,unholy,6,1,5
Gnargnarr,firetree,96,deathknight,unholy,6,1,5
Apocalypsis,uldum,96,deathknight,unholy,6,1,5
Terrethess,illidan,96,deathknight,unholy,6,1,5
Erodin,moon-guard,96,deathknight,unholy,6,1,5
Deathscyythe,illidan,96,deathknight,unholy,6,1,5
Dontbanmepls,zuljin,96,deathknight,unholy,6,1,5
Otarin,tichondrius,96,deathknight,unholy,6,1,5
Rotfang,elune,96,deathknight,unholy,6,1,5
Jessefur,undermine,96,deathknight,unholy,6,1,5
Maskofwintrs,zuljin,96,deathknight,unholy,6,1,5
Istery,thrall,96,deathknight,unholy,6,1,5
Tarone,zuljin,96,deathknight,unholy,6,1,5
Argy,zuljin,96,deathknight,unholy,6,1,5
Perculës,sargeras,96,deathknight,unholy,7,1,6
Aqs,sargeras,96,deathknight,unholy,9,1,8
Níce,tichondrius,96,deathknight,unholy,12,1,11
Skadattle,emerald-dream,96,deathknight,unholy,12,1,11
Darnkiller,kelthuzad,96,deathknight,unholy,18,1,17
Funerall,azralon,95,deathknight,unholy,12,1,11
Frostbytez,barthilas,79,deathknight,unholy,5,1,4
Deanz,stormrage,63,deathknight,unholy,2,2,0
Asfaq,frostmourne,63,deathknight,unholy,2,2,0
Spleem,stormrage,48,deathknight,unholy,3,1,2
Lördd,moon-guard,42,deathknight,unholy,11,3,8
Harrypottr,darrowmere,42,deathknight,unholy,8,2,6
Lazenca,malganis,31,deathknight,unholy,2,1,1
Pookr,area-52,2214,deathknight,frost,355,180,175
Yoinkzz,illidan,2167,deathknight,frost,113,58,55
Sylèss,tichondrius,1949,deathknight,frost,78,43,35
Thânätos,nemesis,1908,deathknight,frost,60,32,28
Raiekko,dalaran,1893,deathknight,frost,66,33,33
Duranteh,illidan,1881,deathknight,frost,60,32,28
Saco,malganis,1874,deathknight,frost,104,60,44
Venvicta,tichondrius,1850,deathknight,frost,44,31,13
Scareth,proudmoore,1823,deathknight,frost,46,27,19
Deaddubya,illidan,1815,deathknight,frost,63,40,23
Dkyeico,ragnaros,1762,deathknight,frost,90,44,46
Chillbaynê,the-scryers,1754,deathknight,frost,36,22,14
Ksmc,tichondrius,1740,deathknight,frost,54,27,27
Fastapi,tichondrius,1737,deathknight,frost,90,41,49
Sober,destromath,1712,deathknight,frost,95,48,47
Mikepinkdk,illidan,1700,deathknight,frost,75,40,35
Mikeycal,stormrage,1677,deathknight,frost,54,25,29
Frosthana,illidan,1654,deathknight,frost,72,33,39
Børeas,quelthalas,1645,deathknight,frost,96,43,53
Gkdm,tichondrius,1643,deathknight,frost,42,21,21
Tzepesci,hyjal,1626,deathknight,frost,58,26,32
Iccyhottie,stormrage,1621,deathknight,frost,82,42,40
Devcoil,sargeras,1617,deathknight,frost,36,17,19
Ebolaxd,area-52,1614,deathknight,frost,42,21,21
Rekktless,aerie-peak,1613,deathknight,frost,66,34,32
Worgenracist,tichondrius,1598,deathknight,frost,53,22,31
Fußuky,quelthalas,1594,deathknight,frost,76,39,37
Zemzil,tichondrius,1558,deathknight,frost,50,22,28
Vãl,sargeras,1556,deathknight,frost,36,18,18
Percy,thaurissan,1537,deathknight,frost,139,62,77
Axiomqt,tichondrius,1530,deathknight,frost,30,16,14
Grakth,quelthalas,1527,deathknight,frost,66,37,29
Lho,caelestrasz,1522,deathknight,frost,77,41,36
Uzgard,zuljin,1517,deathknight,frost,65,38,27
Report,dathremar,1494,deathknight,frost,75,38,37
Jimmyjohnson,illidan,1487,deathknight,frost,59,35,24
Emanuels,quelthalas,1480,deathknight,frost,30,16,14
Trødz,tichondrius,1464,deathknight,frost,42,19,23
Darkwraith,illidan,1461,deathknight,frost,36,17,19
Dekanok,korgath,1452,deathknight,frost,30,16,14
Jazh,tichondrius,1441,deathknight,frost,59,23,36
Umbramane,tichondrius,1438,deathknight,frost,39,19,20
Vuldy,blackhand,1396,deathknight,frost,30,17,13
Ellipsoro,onyxia,1393,deathknight,frost,72,33,39
Eldavò,quelthalas,1393,deathknight,frost,60,25,35
Khalid,azgalor,1376,deathknight,frost,54,23,31
Clongeus,tichondrius,1374,deathknight,frost,54,25,29
Tangarang,dalaran,1372,deathknight,frost,36,16,20
Abrahams,tichondrius,1369,deathknight,frost,40,18,22
Barrodir,tichondrius,1358,deathknight,frost,51,31,20
Gwab,stormrage,1354,deathknight,frost,48,20,28
Thetalis,moon-guard,1346,deathknight,frost,78,38,40
Kryptikkyt,blackrock,1341,deathknight,frost,18,14,4
Ðerion,stormrage,1339,deathknight,frost,116,52,64
Remanent,tichondrius,1336,deathknight,frost,24,14,10
Clapdat,malganis,1335,deathknight,frost,114,56,58
Dontbanmepls,zuljin,1318,deathknight,frost,30,14,16
Tekc,nemesis,1317,deathknight,frost,132,64,68
Nevermor,malganis,1301,deathknight,frost,72,35,37
Bridenbrad,quelthalas,1299,deathknight,frost,27,17,10
Sinyay,tichondrius,1291,deathknight,frost,48,29,19
Estali,kelthuzad,1286,deathknight,frost,99,46,53
Lichborn,azralon,1279,deathknight,frost,60,24,36
Abake,illidan,1267,deathknight,frost,62,30,32
Darkreígn,tichondrius,1265,deathknight,frost,35,18,17
Alexanderz,quelthalas,1264,deathknight,frost,36,15,21
Kruspy,area-52,1261,deathknight,frost,42,19,23
Iceice,emerald-dream,1259,deathknight,frost,78,34,44
Rylas,destromath,1250,deathknight,frost,57,25,32
Runtasticxz,tichondrius,1247,deathknight,frost,24,13,11
Sandooñ,tichondrius,1240,deathknight,frost,66,27,39
Alexeous,wyrmrest-accord,1240,deathknight,frost,91,36,55
Bâttalion,illidan,1237,deathknight,frost,30,13,17
Rayden,frostmourne,1235,deathknight,frost,24,13,11
Yödä,barthilas,1235,deathknight,frost,36,14,22
Darketvam,illidan,1230,deathknight,frost,38,23,15
Bossk,emerald-dream,1229,deathknight,frost,30,13,17
Spoon,sargeras,1223,deathknight,frost,70,33,37
Sécret,tichondrius,1212,deathknight,frost,24,13,11
Darfik,sargeras,1205,deathknight,frost,114,63,51
Jackofblades,veknilash,1204,deathknight,frost,66,32,34
Zefdk,illidan,1186,deathknight,frost,48,27,21
Eloton,daggerspine,1184,deathknight,frost,23,13,10
Flins,nemesis,1167,deathknight,frost,275,137,138
Tìtø,ragnaros,1151,deathknight,frost,24,12,12
Deadspellz,bleeding-hollow,1149,deathknight,frost,24,12,12
Tambaknight,nemesis,1146,deathknight,frost,44,15,29
Rembrandtdk,gorefiend,1143,deathknight,frost,24,12,12
Janco,runetotem,1141,deathknight,frost,24,12,12
Frostunholy,tichondrius,1140,deathknight,frost,24,12,12
Jordankg,tanaris,1137,deathknight,frost,30,12,18
Laumuelden,ragnaros,1135,deathknight,frost,42,14,28
Achilleo,quelthalas,1115,deathknight,frost,24,12,12
Dkptador,azralon,1115,deathknight,frost,89,41,48
Pembadk,tichondrius,1110,deathknight,frost,33,14,19
Soulfang,nemesis,1089,deathknight,frost,42,17,25
Moonnwater,frostmourne,1087,deathknight,frost,84,43,41
Sephirott,boulderfist,1086,deathknight,frost,35,19,16
Garryxz,quelthalas,1077,deathknight,frost,22,12,10
Darkdevilvii,tichondrius,1069,deathknight,frost,66,33,33
Mawvac,quelthalas,1069,deathknight,frost,72,33,39
Zephyx,lightbringer,1056,deathknight,frost,18,11,7
Grippygarý,illidan,1056,deathknight,frost,24,11,13
Toxismall,zuljin,1056,deathknight,frost,24,11,13
Puppykisses,perenolde,1055,deathknight,frost,24,11,13
Jhonnsnow,frostmourne,1051,deathknight,frost,24,11,13
Dregdar,emerald-dream,1049,deathknight,frost,18,11,7
Malovv,nemesis,1042,deathknight,frost,18,12,6
Vanyor,wyrmrest-accord,1025,deathknight,frost,44,14,30
Zarathraz,ragnaros,1004,deathknight,frost,23,11,12
Ciputra,blood-furnace,987,deathknight,frost,41,22,19
Icedmilk,zuluhed,982,deathknight,frost,25,14,11
Vorlakesh,boulderfist,979,deathknight,frost,22,11,11
Sinizster,kelthuzad,974,deathknight,frost,19,11,8
Skittsdk,thrall,966,deathknight,frost,24,12,12
Xhín,bleeding-hollow,959,deathknight,frost,18,10,8
Tokyotimxx,malganis,958,deathknight,frost,18,10,8
Iskandàr,ragnaros,958,deathknight,frost,18,10,8
Corrpsse,tichondrius,957,deathknight,frost,18,10,8
Toothstick,stormrage,957,deathknight,frost,18,10,8
Necrósy,azralon,955,deathknight,frost,18,10,8
Axylus,kelthuzad,953,deathknight,frost,18,10,8
Eliagianluca,caelestrasz,949,deathknight,frost,60,25,35
Úndead,barthilas,943,deathknight,frost,18,10,8
Kraige,tichondrius,933,deathknight,frost,30,10,20
Kallugrax,kelthuzad,919,deathknight,frost,30,12,18
Ârtas,uldum,913,deathknight,frost,30,10,20
Fokit,barthilas,897,deathknight,frost,58,28,30
Roarbane,muradin,896,deathknight,frost,18,10,8
Sandolorian,area-52,892,deathknight,frost,24,10,14
Larrisey,illidan,871,deathknight,frost,27,13,14
Lokitabeso,ragnaros,864,deathknight,frost,12,9,3
Vust,malganis,863,deathknight,frost,12,9,3
Lazenca,malganis,863,deathknight,frost,18,9,9
Zarakas,sargeras,863,deathknight,frost,24,9,15
Kekkijutsu,bleeding-hollow,862,deathknight,frost,12,9,3
Zivz,borean-tundra,862,deathknight,frost,12,9,3
Thesseo,quelthalas,862,deathknight,frost,18,9,9
Dkbunny,thaurissan,862,deathknight,frost,30,9,21
Chicnchsteak,tichondrius,862,deathknight,frost,30,9,21
Jasmíne,vashj,861,deathknight,frost,12,9,3
Dreekon,bleeding-hollow,861,deathknight,frost,12,9,3
Urieen,gorefiend,861,deathknight,frost,18,9,9
Sporkdk,illidan,859,deathknight,frost,29,9,20
Seeyoudiebr,gallywix,856,deathknight,frost,24,9,15
Metaphysicsx,amanthul,839,deathknight,frost,20,9,11
Uncfester,onyxia,823,deathknight,frost,18,9,9
Madorderog,stormrage,811,deathknight,frost,28,13,15
Loverianed,aerie-peak,807,deathknight,frost,48,13,35
Lokítabesos,ragnaros,768,deathknight,frost,12,8,4
Crink,sargeras,768,deathknight,frost,24,8,16
Incanis,moon-guard,767,deathknight,frost,18,8,10
Gypo,scilla,766,deathknight,frost,12,8,4
Artourias,wyrmrest-accord,766,deathknight,frost,12,8,4
Kerigann,moon-guard,766,deathknight,frost,12,8,4
Freemoney,wyrmrest-accord,766,deathknight,frost,12,8,4
Verhangnis,azjolnerub,765,deathknight,frost,12,8,4
Dhrogar,moon-guard,762,deathknight,frost,12,8,4
Dyingwolf,ragnaros,761,deathknight,frost,18,8,10
Jyantdeck,area-52,760,deathknight,frost,13,8,5
Nagaizao,nemesis,757,deathknight,frost,18,8,10
Hansmclroy,trollbane,738,deathknight,frost,24,8,16
Blooddisease,frostmourne,735,deathknight,frost,17,8,9
Monglord,arthas,733,deathknight,frost,27,9,18
Tarone,zuljin,688,deathknight,frost,21,10,11
Russkivolk,frostmourne,688,deathknight,frost,19,8,11
Griswold,windrunner,680,deathknight,frost,24,9,15
Insanity,boulderfist,672,deathknight,frost,12,7,5
Deathboost,stormrage,672,deathknight,frost,12,7,5
Dumbledore,deathwing,672,deathknight,frost,12,7,5
Anexdk,korgath,672,deathknight,frost,18,7,11
Chillpills,stormrage,672,deathknight,frost,18,7,11
Iriwa,tichondrius,672,deathknight,frost,24,7,17
Unholycube,zuljin,671,deathknight,frost,30,7,23
Carecaa,azralon,670,deathknight,frost,18,7,11
Elwoodblooz,stormrage,669,deathknight,frost,15,8,7
Cryptgore,moon-guard,665,deathknight,frost,18,7,11
Sakaarr,bleeding-hollow,664,deathknight,frost,18,7,11
Iiedown,stormrage,623,deathknight,frost,11,7,4
Plaw,kiljaeden,607,deathknight,frost,11,7,4
Riglros,tichondrius,576,deathknight,frost,12,6,6
Dreadlight,moon-guard,576,deathknight,frost,12,6,6
Rotfang,proudmoore,576,deathknight,frost,12,6,6
Vigasick,azralon,576,deathknight,frost,12,6,6
Darkxavros,stormrage,576,deathknight,frost,12,6,6
Gladiaturd,hellscream,576,deathknight,frost,12,6,6
Dementrius,zuljin,576,deathknight,frost,12,6,6
Wap,bloodhoof,576,deathknight,frost,12,6,6
Otarin,tichondrius,576,deathknight,frost,12,6,6
Rennoc,emerald-dream,576,deathknight,frost,12,6,6
Sparklekitty,illidan,576,deathknight,frost,12,6,6
Soulbone,wyrmrest-accord,576,deathknight,frost,12,6,6
Cozzasad,barthilas,576,deathknight,frost,12,6,6
Beliath,crushridge,576,deathknight,frost,17,6,11
Ariacy,sargeras,576,deathknight,frost,18,6,12
Dairboi,sargeras,576,deathknight,frost,18,6,12
Davenn,stormrage,575,deathknight,frost,12,6,6
Tooe,darrowmere,575,deathknight,frost,12,6,6
Winterstone,moon-guard,575,deathknight,frost,12,6,6
Friggintough,tichondrius,575,deathknight,frost,12,6,6
Ântipaladin,arthas,575,deathknight,frost,12,6,6
Nezareth,sargeras,574,deathknight,frost,12,6,6
Bloodbanne,darkspear,573,deathknight,frost,12,6,6
Ikaris,wildhammer,569,deathknight,frost,12,6,6
Werebuddy,lightnings-blade,528,deathknight,frost,15,6,9
Bellum,moon-guard,511,deathknight,frost,20,6,14
Lokitaßeso,ragnaros,480,deathknight,frost,6,5,1
Sathanazz,ragnaros,480,deathknight,frost,6,5,1
Vett,antonidas,480,deathknight,frost,6,5,1
Subparatbest,chogall,480,deathknight,frost,12,5,7
Martinnash,emerald-dream,480,deathknight,frost,12,5,7
Onsslaught,sargeras,480,deathknight,frost,12,5,7
Neaz,moon-guard,480,deathknight,frost,12,5,7
Deadbeards,zuluhed,480,deathknight,frost,12,5,7
Frozenhawk,lothar,480,deathknight,frost,12,5,7
Sllice,aegwynn,480,deathknight,frost,12,5,7
Algeross,dalaran,480,deathknight,frost,18,5,13
Saighast,illidan,480,deathknight,frost,18,5,13
Bëlzëbü,stormrage,479,deathknight,frost,6,5,1
Moovement,illidan,479,deathknight,frost,6,5,1
Caravante,azralon,479,deathknight,frost,12,5,7
Janzano,deathwing,479,deathknight,frost,14,5,9
Adjudicated,darkspear,477,deathknight,frost,12,5,7
Dèadpool,blackhand,474,deathknight,frost,12,5,7
Hiki,ragnaros,384,deathknight,frost,6,4,2
Tontan,cairne,384,deathknight,frost,6,4,2
Hunrune,emerald-dream,384,deathknight,frost,6,4,2
Bigdooks,area-52,384,deathknight,frost,6,4,2
Anatøly,ragnaros,384,deathknight,frost,6,4,2
Xelonith,sargeras,384,deathknight,frost,6,4,2
Orbo,elune,384,deathknight,frost,6,4,2
Icewalløw,darkspear,384,deathknight,frost,6,4,2
Lókhä,thrall,384,deathknight,frost,6,4,2
Tanjus,kelthuzad,384,deathknight,frost,6,4,2
Nabreus,ragnaros,384,deathknight,frost,6,4,2
Laxatives,tichondrius,384,deathknight,frost,6,4,2
Aldebamuu,ragnaros,384,deathknight,frost,6,4,2
Nefarion,nathrezim,384,deathknight,frost,12,4,8
Silanvia,wyrmrest-accord,384,deathknight,frost,12,4,8
Shmacmiller,stormrage,384,deathknight,frost,12,4,8
Deathrowe,blackhand,384,deathknight,frost,12,4,8
Lichhbanne,doomhammer,384,deathknight,frost,12,4,8
Xhoul,sargeras,384,deathknight,frost,12,4,8
Almostdead,proudmoore,384,deathknight,frost,12,4,8
Aradorn,azralon,384,deathknight,frost,12,4,8
Zenin,emerald-dream,384,deathknight,frost,12,4,8
Unintended,barthilas,384,deathknight,frost,12,4,8
Hooterzqt,tichondrius,384,deathknight,frost,12,4,8
Jykupajr,proudmoore,384,deathknight,frost,12,4,8
Shinici,kelthuzad,383,deathknight,frost,9,5,4
Vithael,stormrage,383,deathknight,frost,12,4,8
Getmad,anvilmar,383,deathknight,frost,12,4,8
Amauqsun,bleeding-hollow,383,deathknight,frost,12,4,8
Cailras,argent-dawn,382,deathknight,frost,6,4,2
Bullbanger,runetotem,382,deathknight,frost,6,4,2
Sindragos,stormrage,382,deathknight,frost,12,4,8
Deathvortex,nemesis,379,deathknight,frost,12,4,8
Greeasy,bleeding-hollow,351,deathknight,frost,11,4,7
Víní,azralon,288,deathknight,frost,6,3,3
Frostybones,guldan,288,deathknight,frost,6,3,3
Tofurious,barthilas,288,deathknight,frost,6,3,3
Brumaks,quelthalas,288,deathknight,frost,6,3,3
Saraphdk,area-52,288,deathknight,frost,6,3,3
Yungdooks,area-52,288,deathknight,frost,6,3,3
Plaugedone,lightbringer,288,deathknight,frost,6,3,3
Ghouldruis,barthilas,288,deathknight,frost,6,3,3
Mexe,ragnaros,288,deathknight,frost,6,3,3
Laboön,stormrage,288,deathknight,frost,6,3,3
Störmrünner,kelthuzad,288,deathknight,frost,6,3,3
Yamanji,wyrmrest-accord,288,deathknight,frost,6,3,3
Doomdk,azralon,288,deathknight,frost,6,3,3
Zügzug,chogall,288,deathknight,frost,6,3,3
Kalevesicant,nesingwary,288,deathknight,frost,6,3,3
Démise,malganis,288,deathknight,frost,6,3,3
Amarlana,mannoroth,288,deathknight,frost,6,3,3
Egirlgripper,area-52,288,deathknight,frost,6,3,3
Fåîrÿdûst,skullcrusher,288,deathknight,frost,6,3,3
Ruggair,proudmoore,288,deathknight,frost,6,3,3
Nalec,tichondrius,288,deathknight,frost,6,3,3
Zygon,thrall,288,deathknight,frost,6,3,3
Jughéad,thrall,288,deathknight,frost,6,3,3
Gorsz,tichondrius,288,deathknight,frost,6,3,3
Fearfull,hyjal,288,deathknight,frost,10,4,6
Freyjani,moon-guard,288,deathknight,frost,12,3,9
Paíín,illidan,288,deathknight,frost,12,3,9
Toxicant,zuljin,288,deathknight,frost,12,3,9
Bloodmourne,barthilas,288,deathknight,frost,12,3,9
Flarkness,area-52,288,deathknight,frost,12,3,9
Nenó,illidan,288,deathknight,frost,12,3,9
Janus,illidan,288,deathknight,frost,12,3,9
ßlazedkush,kelthuzad,287,deathknight,frost,6,3,3
Válhállá,ragnaros,287,deathknight,frost,12,3,9
Páthøgen,ravencrest,287,deathknight,frost,12,3,9
Ergoth,darkspear,287,deathknight,frost,18,3,15
Xslaught,maiev,286,deathknight,frost,6,3,3
Varrine,hyjal,286,deathknight,frost,6,3,3
Gnomey,area-52,255,deathknight,frost,8,4,4
Crukashongal,zuljin,240,deathknight,frost,9,4,5
Unwantedgrab,sargeras,239,deathknight,frost,5,3,2
Hamze,stormrage,239,deathknight,frost,5,3,2
Bbcobliterat,proudmoore,234,deathknight,frost,22,4,18
Surcäfauces,ragnaros,192,deathknight,frost,9,3,6
Crakdos,illidan,192,deathknight,frost,6,2,4
Fraýja,tichondrius,192,deathknight,frost,6,2,4
Envisage,kelthuzad,192,deathknight,frost,6,2,4
Rulord,wyrmrest-accord,192,deathknight,frost,6,2,4
Yourunigrip,tichondrius,192,deathknight,frost,6,2,4
Khørne,area-52,192,deathknight,frost,6,2,4
Frozenjuice,sargeras,192,deathknight,frost,6,2,4
Chilivibes,boulderfist,192,deathknight,frost,6,2,4
Zëb,sargeras,192,deathknight,frost,6,2,4
Lichkong,dalaran,192,deathknight,frost,6,2,4
Rotfang,elune,192,deathknight,frost,6,2,4
Aldrey,bonechewer,192,deathknight,frost,6,2,4
Piratehookah,sargeras,192,deathknight,frost,6,2,4
Sayâ,frostmane,192,deathknight,frost,6,2,4
Kreyun,bleeding-hollow,192,deathknight,frost,6,2,4
Dahaaka,malganis,192,deathknight,frost,6,2,4
Pofokut,bleeding-hollow,192,deathknight,frost,6,2,4
Bonusman,sargeras,192,deathknight,frost,6,2,4
Hunwild,emerald-dream,192,deathknight,frost,6,2,4
Nebuchadnezz,darkspear,192,deathknight,frost,6,2,4
Dego,tichondrius,192,deathknight,frost,6,2,4
Oreodeath,sargeras,192,deathknight,frost,6,2,4
Tarknok,moon-guard,192,deathknight,frost,6,2,4
Soutennizase,azralon,192,deathknight,frost,6,2,4
Bigdkk,thaurissan,192,deathknight,frost,6,2,4
Demise,stormrage,192,deathknight,frost,6,2,4
Alderollar,stormrage,192,deathknight,frost,6,2,4
Ryugetzu,drakkari,192,deathknight,frost,6,2,4
Lîch,azralon,192,deathknight,frost,6,2,4
Edek,frostmourne,192,deathknight,frost,6,2,4
Shadar,muradin,192,deathknight,frost,12,2,10
Melyrc,quelthalas,192,deathknight,frost,12,2,10
Neofrank,drakkari,192,deathknight,frost,12,2,10
Záiiko,quelthalas,192,deathknight,frost,12,2,10
Neowolf,azgalor,192,deathknight,frost,12,2,10
Lillylilly,bleeding-hollow,192,deathknight,frost,12,2,10
Evangelina,antonidas,192,deathknight,frost,12,2,10
Killa,maiev,191,deathknight,frost,6,2,4
Sübzerö,quelthalas,191,deathknight,frost,6,2,4
Deathmike,bonechewer,191,deathknight,frost,6,2,4
Rogoroth,stormrage,191,deathknight,frost,6,2,4
Edhral,ragnaros,191,deathknight,frost,6,2,4
Akmy,illidan,175,deathknight,frost,11,2,9
Nickolas,dalvengyr,159,deathknight,frost,5,2,3
Oilasslover,illidan,128,deathknight,frost,4,2,2
Xaldeth,moon-guard,127,deathknight,frost,8,2,6
Kookx,tichondrius,110,deathknight,frost,7,2,5
Telrenaur,proudmoore,96,deathknight,frost,3,2,1
Mako,garithos,96,deathknight,frost,6,1,5
Himanshu,emerald-dream,96,deathknight,frost,6,1,5
Grayfoxx,twisting-nether,96,deathknight,frost,6,1,5
Appledog,ragnaros,96,deathknight,frost,6,1,5
Denkot,stormrage,96,deathknight,frost,6,1,5
Raegywn,blood-furnace,96,deathknight,frost,6,1,5
Bingoez,frostmourne,96,deathknight,frost,6,1,5
Gooré,ragnaros,96,deathknight,frost,6,1,5
Kodokuna,bleeding-hollow,96,deathknight,frost,6,1,5
Grimorra,bleeding-hollow,96,deathknight,frost,6,1,5
Hadianton,stormrage,96,deathknight,frost,6,1,5
Skadattle,emerald-dream,96,deathknight,frost,6,1,5
Frostpanda,dalaran,96,deathknight,frost,6,1,5
Vrolock,quelthalas,96,deathknight,frost,6,1,5
Xakri,kelthuzad,96,deathknight,frost,6,1,5
Cellebrok,bleeding-hollow,96,deathknight,frost,6,1,5
Teksurugi,korgath,96,deathknight,frost,6,1,5
Siphilusxo,dalaran,96,deathknight,frost,6,1,5
Kakaih,azralon,96,deathknight,frost,6,1,5
Einherjiar,tichondrius,96,deathknight,frost,6,1,5
Mordekeiser,wyrmrest-accord,96,deathknight,frost,6,1,5
Thwap,sargeras,96,deathknight,frost,6,1,5
Bubblesdk,whisperwind,96,deathknight,frost,6,1,5
Fexon,queldorei,95,deathknight,frost,9,1,8
Xninjakiller,korgath,95,deathknight,frost,12,1,11
Dromidon,darkspear,79,deathknight,frost,5,1,4
Khaíne,wyrmrest-accord,64,deathknight,frost,4,1,3
Magipierrot,ragnaros,64,deathknight,frost,4,1,3
Agasuko,ghostlands,48,deathknight,frost,3,1,2
Villåin,hyjal,42,deathknight,frost,9,2,7
Twindleroot,aggramar,31,deathknight,frost,2,1,1
Sharnathos,stormrage,16,deathknight,frost,1,1,0
Jerric,skullcrusher,16,deathknight,frost,7,1,6
Demoncouch,malganis,2137,demonhunter,havoc,90,46,44
Seorae,tichondrius,2126,demonhunter,havoc,84,45,39
Ehtend,malganis,2126,demonhunter,havoc,155,78,77
Ehtend,sargeras,2106,demonhunter,havoc,78,42,36
Insomniaq,sargeras,2102,demonhunter,havoc,115,62,53
Nézuko,eldrethalas,2077,demonhunter,havoc,105,57,48
Taegos,tichondrius,2072,demonhunter,havoc,351,173,178
Xiaosu,tichondrius,2065,demonhunter,havoc,378,185,193
Fellhamer,malganis,2054,demonhunter,havoc,123,69,54
Dhcn,tichondrius,2002,demonhunter,havoc,53,30,23
Ordorll,area-52,1998,demonhunter,havoc,114,59,55
Lademon,tichondrius,1997,demonhunter,havoc,84,46,38
Zetara,malganis,1990,demonhunter,havoc,52,34,18
Nasadh,tichondrius,1980,demonhunter,havoc,78,43,35
Badhábits,sargeras,1979,demonhunter,havoc,54,31,23
Reps,hydraxis,1979,demonhunter,havoc,114,63,51
Ìke,quelthalas,1979,demonhunter,havoc,79,43,36
Terrorsong,tichondrius,1970,demonhunter,havoc,71,45,26
Felz,illidan,1964,demonhunter,havoc,95,48,47
Cyrøcryphä,quelthalas,1962,demonhunter,havoc,102,49,53
Lifting,illidan,1960,demonhunter,havoc,84,40,44
Boos,moon-guard,1949,demonhunter,havoc,112,56,56
Lighost,tichondrius,1944,demonhunter,havoc,288,140,148
Xch,aegwynn,1943,demonhunter,havoc,148,80,68
Xtickles,frostmourne,1937,demonhunter,havoc,148,74,74
Jøsem,ragnaros,1930,demonhunter,havoc,94,48,46
Mvpdh,area-52,1925,demonhunter,havoc,153,80,73
Kohî,sargeras,1924,demonhunter,havoc,53,27,26
Andthrx,area-52,1922,demonhunter,havoc,137,73,64
ßöb,aggramar,1920,demonhunter,havoc,66,34,32
Calpoot,stormscale,1918,demonhunter,havoc,47,28,19
Blode,tichondrius,1915,demonhunter,havoc,102,57,45
Dayvenie,area-52,1910,demonhunter,havoc,119,68,51
Cromega,malganis,1906,demonhunter,havoc,108,50,58
Lemilion,wyrmrest-accord,1903,demonhunter,havoc,53,27,26
Solit,illidan,1901,demonhunter,havoc,66,33,33
Winsforgold,area-52,1899,demonhunter,havoc,54,32,22
Ouru,area-52,1896,demonhunter,havoc,96,48,48
Medrathis,wyrmrest-accord,1891,demonhunter,havoc,42,26,16
Thânatøs,nemesis,1882,demonhunter,havoc,84,43,41
Stellitas,ragnaros,1881,demonhunter,havoc,72,38,34
Junma,tichondrius,1874,demonhunter,havoc,84,47,37
Mvqqdh,tichondrius,1872,demonhunter,havoc,42,20,22
Joshallen,malganis,1871,demonhunter,havoc,108,57,51
Leothero,area-52,1863,demonhunter,havoc,54,28,26
Asdazanis,nemesis,1859,demonhunter,havoc,62,32,30
Azrethec,wyrmrest-accord,1855,demonhunter,havoc,108,62,46
Nb,silvermoon,1853,demonhunter,havoc,59,32,27
Boonchu,frostmourne,1853,demonhunter,havoc,62,31,31
Bippy,durotan,1853,demonhunter,havoc,90,44,46
Dwilk,sargeras,1850,demonhunter,havoc,102,46,56
Mizaru,moon-guard,1849,demonhunter,havoc,35,24,11
Rosinanta,malygos,1849,demonhunter,havoc,98,53,45
Ystkz,tichondrius,1848,demonhunter,havoc,75,41,34
Càrnagex,tichondrius,1841,demonhunter,havoc,178,88,90
Airmax,tichondrius,1839,demonhunter,havoc,60,32,28
Doejah,stormrage,1838,demonhunter,havoc,50,28,22
Ökìtycoón,proudmoore,1833,demonhunter,havoc,78,45,33
Blasphemus,illidan,1832,demonhunter,havoc,35,20,15
Raiinier,sargeras,1830,demonhunter,havoc,72,45,27
Divide,tichondrius,1830,demonhunter,havoc,106,58,48
Maverzz,area-52,1828,demonhunter,havoc,35,20,15
Takagi,kirin-tor,1828,demonhunter,havoc,221,120,101
Migey,thrall,1825,demonhunter,havoc,112,65,47
Vanarion,area-52,1825,demonhunter,havoc,84,36,48
Beerdash,area-52,1825,demonhunter,havoc,66,28,38
Darkrai,area-52,1823,demonhunter,havoc,132,73,59
Potspoon,tichondrius,1823,demonhunter,havoc,132,68,64
Stellartv,tichondrius,1822,demonhunter,havoc,86,44,42
Mvqdh,illidan,1821,demonhunter,havoc,41,26,15
Gesture,malganis,1820,demonhunter,havoc,112,72,40
Karonisam,dalaran,1820,demonhunter,havoc,61,32,29
Dannyolo,hyjal,1820,demonhunter,havoc,78,32,46
Lamorty,tichondrius,1818,demonhunter,havoc,54,25,29
Cromosh,quelthalas,1818,demonhunter,havoc,78,35,43
Failtimeboat,terenas,1817,demonhunter,havoc,60,34,26
Yaboiswift,stormrage,1817,demonhunter,havoc,36,19,17
Garbage,illidan,1816,demonhunter,havoc,84,44,40
Helenquinn,kelthuzad,1815,demonhunter,havoc,66,43,23
Brotherz,tichondrius,1815,demonhunter,havoc,107,53,54
Brbpetmycat,zuljin,1815,demonhunter,havoc,63,30,33
Busting,tichondrius,1814,demonhunter,havoc,42,20,22
Zoenin,illidan,1814,demonhunter,havoc,78,37,41
Skyez,moon-guard,1814,demonhunter,havoc,115,54,61
Rufio,nesingwary,1813,demonhunter,havoc,54,25,29
Eldiablaso,malganis,1812,demonhunter,havoc,36,19,17
Tømåtøgøðx,sargeras,1812,demonhunter,havoc,156,78,78
Lucifèr,uther,1812,demonhunter,havoc,59,28,31
Vowz,sargeras,1811,demonhunter,havoc,66,34,32
Tyskeram,bleeding-hollow,1810,demonhunter,havoc,81,47,34
Griphunt,tichondrius,1810,demonhunter,havoc,136,71,65
Feldarath,sargeras,1807,demonhunter,havoc,133,76,57
Xcf,area-52,1807,demonhunter,havoc,48,22,26
Smqkepvrpp,zuljin,1806,demonhunter,havoc,52,35,17
Bitcoingodx,tichondrius,1804,demonhunter,havoc,78,47,31
Purplekuush,bleeding-hollow,1803,demonhunter,havoc,54,31,23
Fruitbatx,tichondrius,1803,demonhunter,havoc,102,50,52
Dhkyun,tichondrius,1801,demonhunter,havoc,54,29,25
Wompo,wyrmrest-accord,1801,demonhunter,havoc,36,19,17
Dewk,ghostlands,1801,demonhunter,havoc,57,29,28
Icecokelime,black-dragonflight,1800,demonhunter,havoc,38,20,18
Deathbladezx,tichondrius,1800,demonhunter,havoc,47,23,24
Mevadow,bleeding-hollow,1800,demonhunter,havoc,120,55,65
Donaldjr,area-52,1798,demonhunter,havoc,69,42,27
Bløødyrøse,illidan,1794,demonhunter,havoc,30,19,11
Zatharas,stormrage,1792,demonhunter,havoc,92,48,44
Nuktukdh,moon-guard,1791,demonhunter,havoc,68,30,38
Syrio,frostmourne,1784,demonhunter,havoc,168,94,74
Thundiir,area-52,1782,demonhunter,havoc,78,42,36
Oddblindguy,area-52,1777,demonhunter,havoc,30,22,8
Anihilum,zuljin,1772,demonhunter,havoc,78,49,29
Irisand,ragnaros,1768,demonhunter,havoc,65,33,32
Dyllen,tichondrius,1766,demonhunter,havoc,140,79,61
Monfel,dalaran,1765,demonhunter,havoc,90,55,35
Crittic,thrall,1764,demonhunter,havoc,54,25,29
Drachyn,darkspear,1762,demonhunter,havoc,65,29,36
Ahsref,stormrage,1757,demonhunter,havoc,60,30,30
Theprodigy,malganis,1756,demonhunter,havoc,54,28,26
Sadgirlx,area-52,1756,demonhunter,havoc,54,28,26
Kázeshini,frostmourne,1756,demonhunter,havoc,125,60,65
Sleepyjoeb,illidan,1752,demonhunter,havoc,48,27,21
Immortalsinz,dalaran,1747,demonhunter,havoc,112,48,64
Ubetterun,azralon,1746,demonhunter,havoc,117,62,55
Wherwelandin,zuljin,1746,demonhunter,havoc,45,22,23
Noobstaa,area-52,1745,demonhunter,havoc,48,34,14
Ðavid,firetree,1745,demonhunter,havoc,96,48,48
Lazydeamon,frostmourne,1740,demonhunter,havoc,60,26,34
Írís,blackrock,1739,demonhunter,havoc,66,43,23
Devotio,emerald-dream,1738,demonhunter,havoc,72,42,30
Furious,tichondrius,1737,demonhunter,havoc,48,23,25
Hoochee,lightnings-blade,1735,demonhunter,havoc,73,39,34
Firstsol,stormrage,1734,demonhunter,havoc,54,33,21
Harríson,tichondrius,1734,demonhunter,havoc,96,47,49
Axalark,nemesis,1733,demonhunter,havoc,54,26,28
Lilise,kiljaeden,1731,demonhunter,havoc,72,35,37
Hogmandh,illidan,1729,demonhunter,havoc,48,23,25
Bigbadmad,stormrage,1728,demonhunter,havoc,108,52,56
Dangerspud,frostmourne,1726,demonhunter,havoc,54,23,31
Bbteaa,frostmourne,1724,demonhunter,havoc,86,45,41
Dealer,frostmourne,1721,demonhunter,havoc,48,25,23
Croches,tichondrius,1721,demonhunter,havoc,36,18,18
Larandaa,sargeras,1720,demonhunter,havoc,60,33,27
Çhan,tichondrius,1717,demonhunter,havoc,153,79,74
Doeja,illidan,1713,demonhunter,havoc,30,18,12
Thehonor,tichondrius,1713,demonhunter,havoc,65,36,29
Ruffolina,azralon,1713,demonhunter,havoc,163,89,74
Aetheris,bleeding-hollow,1709,demonhunter,havoc,78,34,44
Obsidians,korgath,1708,demonhunter,havoc,49,31,18
Demabrak,azralon,1707,demonhunter,havoc,47,23,24
Soyboycuck,emerald-dream,1705,demonhunter,havoc,36,18,18
Rôsè,tichondrius,1704,demonhunter,havoc,70,40,30
Xeylin,sargeras,1703,demonhunter,havoc,54,34,20
Promitto,tichondrius,1703,demonhunter,havoc,35,21,14
Gamernation,area-52,1703,demonhunter,havoc,57,29,28
Wildh,stormrage,1702,demonhunter,havoc,66,35,31
Xanthalos,wyrmrest-accord,1702,demonhunter,havoc,138,68,70
Xøtourlife,malganis,1701,demonhunter,havoc,52,25,27
Nopohunter,burning-blade,1699,demonhunter,havoc,47,31,16
Junmà,tichondrius,1699,demonhunter,havoc,60,38,22
Raahjxz,sargeras,1696,demonhunter,havoc,54,33,21
Johnconnor,tichondrius,1696,demonhunter,havoc,53,20,33
Chiesa,sargeras,1695,demonhunter,havoc,34,27,7
Tendiës,tichondrius,1695,demonhunter,havoc,44,23,21
Imaginedmg,illidan,1695,demonhunter,havoc,54,26,28
Sacredtree,tichondrius,1694,demonhunter,havoc,56,30,26
Felswamp,zuljin,1694,demonhunter,havoc,42,20,22
Fenomeno,tichondrius,1693,demonhunter,havoc,46,25,21
Saaldh,zuljin,1693,demonhunter,havoc,47,20,27
Jcosta,tichondrius,1692,demonhunter,havoc,43,20,23
Munyanyô,moon-guard,1691,demonhunter,havoc,41,26,15
Tubaki,tichondrius,1691,demonhunter,havoc,35,19,16
Sarynrae,malganis,1691,demonhunter,havoc,46,24,22
Speedh,area-52,1691,demonhunter,havoc,36,18,18
Deaforalive,malganis,1690,demonhunter,havoc,96,54,42
Cöcainë,stormrage,1689,demonhunter,havoc,36,24,12
Flyudzhin,azgalor,1689,demonhunter,havoc,116,56,60
Kìed,kiljaeden,1687,demonhunter,havoc,48,24,24
Wickbeams,barthilas,1684,demonhunter,havoc,59,28,31
Dawgzo,thunderhorn,1682,demonhunter,havoc,60,34,26
Sikarnix,stormrage,1682,demonhunter,havoc,54,23,31
Sicknizzle,area-52,1679,demonhunter,havoc,60,32,28
Netherbane,azgalor,1679,demonhunter,havoc,66,32,34
Nips,lightnings-blade,1675,demonhunter,havoc,54,33,21
Dhwhat,stormrage,1675,demonhunter,havoc,53,32,21
Ironsightsdh,dalaran,1675,demonhunter,havoc,77,42,35
Buddyyguy,illidan,1675,demonhunter,havoc,102,45,57
Folkmagic,proudmoore,1673,demonhunter,havoc,30,18,12
Jaauk,ragnaros,1672,demonhunter,havoc,46,21,25
Tichóndrius,tichondrius,1671,demonhunter,havoc,89,51,38
Sypï,malganis,1669,demonhunter,havoc,42,20,22
Madepp,tichondrius,1669,demonhunter,havoc,42,20,22
Bloodhunter,exodar,1668,demonhunter,havoc,92,53,39
Boagz,area-52,1660,demonhunter,havoc,84,48,36
Kioka,khaz-modan,1659,demonhunter,havoc,34,20,14
Nolabb,tichondrius,1659,demonhunter,havoc,72,38,34
Nadlli,bleeding-hollow,1659,demonhunter,havoc,67,32,35
Ilìdarì,zuljin,1657,demonhunter,havoc,33,20,13
Scylus,tichondrius,1657,demonhunter,havoc,66,39,27
Ethhunter,proudmoore,1656,demonhunter,havoc,66,31,35
Azinoht,ragnaros,1656,demonhunter,havoc,122,57,65
Ninetalesx,sargeras,1655,demonhunter,havoc,29,19,10
Baalböski,tichondrius,1655,demonhunter,havoc,64,32,32
Sáìto,arthas,1654,demonhunter,havoc,30,19,11
Azexion,malganis,1653,demonhunter,havoc,70,34,36
Ðaredevil,azralon,1650,demonhunter,havoc,36,22,14
Needlepoint,illidan,1649,demonhunter,havoc,41,25,16
Chîsäki,quelthalas,1649,demonhunter,havoc,75,40,35
Tendies,tichondrius,1649,demonhunter,havoc,42,21,21
Askvivian,sargeras,1647,demonhunter,havoc,61,34,27
Vapegodxqt,aegwynn,1647,demonhunter,havoc,50,25,25
Asheng,cairne,1646,demonhunter,havoc,45,22,23
Vendeem,moonrunner,1645,demonhunter,havoc,68,36,32
Warlasher,zuljin,1644,demonhunter,havoc,132,70,62
Biognosis,ragnaros,1642,demonhunter,havoc,72,31,41
Vândel,kelthuzad,1639,demonhunter,havoc,47,22,25
Gôôseberry,malganis,1639,demonhunter,havoc,81,37,44
Remh,bleeding-hollow,1638,demonhunter,havoc,206,103,103
Pubelice,draenor,1636,demonhunter,havoc,36,25,11
Randomdh,zuljin,1636,demonhunter,havoc,43,23,20
Khaõs,tichondrius,1636,demonhunter,havoc,78,34,44
Synthwäve,area-52,1634,demonhunter,havoc,36,23,13
Joric,dalaran,1634,demonhunter,havoc,48,30,18
Balancedtoon,tichondrius,1632,demonhunter,havoc,36,22,14
Demoncastx,tichondrius,1632,demonhunter,havoc,83,47,36
Accidcleaves,sargeras,1632,demonhunter,havoc,48,26,22
Seraphïel,khaz-modan,1631,demonhunter,havoc,36,23,13
Deathlex,sargeras,1631,demonhunter,havoc,60,30,30
Cezkia,hyjal,1629,demonhunter,havoc,72,36,36
Stefdh,tichondrius,1627,demonhunter,havoc,51,23,28
Poogzzig,tichondrius,1626,demonhunter,havoc,54,27,27
Rekttx,area-52,1625,demonhunter,havoc,64,34,30
Cuper,tichondrius,1623,demonhunter,havoc,72,41,31
Perspirant,malganis,1623,demonhunter,havoc,41,23,18
Sivà,tichondrius,1622,demonhunter,havoc,69,35,34
Zeroheaven,stormrage,1621,demonhunter,havoc,48,19,29
Hehehaha,wyrmrest-accord,1620,demonhunter,havoc,30,20,10
Zachfortnite,emerald-dream,1616,demonhunter,havoc,30,19,11
Dingowango,illidan,1615,demonhunter,havoc,42,19,23
Glaivediggar,barthilas,1614,demonhunter,havoc,94,41,53
Taszyn,blackrock,1613,demonhunter,havoc,92,51,41
Karmakula,tichondrius,1613,demonhunter,havoc,77,39,38
Anathørn,ragnaros,1612,demonhunter,havoc,42,23,19
Jpdh,frostmourne,1612,demonhunter,havoc,56,30,26
Dammitbôbby,tichondrius,1610,demonhunter,havoc,109,61,48
Bitskii,kelthuzad,1610,demonhunter,havoc,47,21,26
Jk,dreadmaul,1609,demonhunter,havoc,70,40,30
Crixxus,zuljin,1609,demonhunter,havoc,48,20,28
Yiptaw,area-52,1608,demonhunter,havoc,55,29,26
Ferano,frostmourne,1606,demonhunter,havoc,108,50,58
Abigëil,quelthalas,1605,demonhunter,havoc,56,31,25
Mavrush,malganis,1604,demonhunter,havoc,54,31,23
Vynthar,wyrmrest-accord,1604,demonhunter,havoc,148,72,76
Dèmonhuntèr,tichondrius,1603,demonhunter,havoc,90,48,42
Sìlençe,illidan,1602,demonhunter,havoc,29,19,10
Ptsdh,bloodhoof,1602,demonhunter,havoc,44,25,19
Shale,gilneas,1602,demonhunter,havoc,70,35,35
Phaintx,tichondrius,1602,demonhunter,havoc,36,18,18
Ariodh,area-52,1602,demonhunter,havoc,36,17,19
Kaedri,burning-blade,1600,demonhunter,havoc,135,65,70
Gjoat,tichondrius,1600,demonhunter,havoc,42,19,23
Tenthslayer,frostmourne,1598,demonhunter,havoc,30,17,13
Killuaqt,frostmourne,1592,demonhunter,havoc,30,17,13
Reito,ragnaros,1589,demonhunter,havoc,53,29,24
Wsickformula,gilneas,1588,demonhunter,havoc,119,66,53
Progenji,azralon,1585,demonhunter,havoc,36,21,15
Oshinoko,area-52,1581,demonhunter,havoc,51,26,25
Supadupä,stormrage,1580,demonhunter,havoc,30,17,13
Kaelclaira,dalvengyr,1580,demonhunter,havoc,60,29,31
Jaybeezy,balnazzar,1580,demonhunter,havoc,42,18,24
Ossivil,ragnaros,1579,demonhunter,havoc,90,41,49
Mcspicyy,tichondrius,1578,demonhunter,havoc,42,22,20
Corngodx,sargeras,1578,demonhunter,havoc,96,47,49
Hoonjojjyana,tichondrius,1578,demonhunter,havoc,46,20,26
Demonfarter,tichondrius,1570,demonhunter,havoc,120,61,59
Gittgudd,area-52,1565,demonhunter,havoc,63,35,28
Kssmee,korgath,1565,demonhunter,havoc,42,23,19
Sheepone,tichondrius,1564,demonhunter,havoc,24,19,5
Xday,tichondrius,1563,demonhunter,havoc,195,98,97
Daymanhunter,bleeding-hollow,1563,demonhunter,havoc,83,41,42
Landorus,barthilas,1562,demonhunter,havoc,83,39,44
Darkrasta,ragnaros,1562,demonhunter,havoc,84,37,47
Wikkidd,thrall,1560,demonhunter,havoc,47,22,25
Eugenyackle,bleeding-hollow,1556,demonhunter,havoc,30,25,5
Gorillidan,kelthuzad,1553,demonhunter,havoc,30,18,12
Nándÿ,tichondrius,1553,demonhunter,havoc,49,26,23
Kaelthys,nordrassil,1552,demonhunter,havoc,33,21,12
Hisso,nordrassil,1549,demonhunter,havoc,30,18,12
Yqpro,tichondrius,1549,demonhunter,havoc,119,62,57
Pragma,thrall,1548,demonhunter,havoc,97,56,41
Macacøbrr,azralon,1548,demonhunter,havoc,70,36,34
Cäldo,tichondrius,1537,demonhunter,havoc,36,21,15
Scoplyn,malfurion,1535,demonhunter,havoc,60,30,30
Alli,bleeding-hollow,1533,demonhunter,havoc,63,37,26
Thêdràïñgáñg,jubeithos,1530,demonhunter,havoc,30,16,14
Feníxx,ragnaros,1529,demonhunter,havoc,61,29,32
Enfirok,duskwood,1527,demonhunter,havoc,191,99,92
Emopidgeon,dalaran,1525,demonhunter,havoc,30,16,14
Broneill,blood-furnace,1525,demonhunter,havoc,42,21,21
Mattdizzle,illidan,1524,demonhunter,havoc,24,17,7
Knuckifubuck,frostwolf,1521,demonhunter,havoc,76,41,35
Sineex,illidan,1520,demonhunter,havoc,30,18,12
Beastbringer,proudmoore,1518,demonhunter,havoc,105,62,43
Gaìjîn,barthilas,1517,demonhunter,havoc,78,45,33
Mazakein,tichondrius,1517,demonhunter,havoc,42,21,21
Dadoftheyear,destromath,1514,demonhunter,havoc,30,18,12
Deadpixellz,illidan,1511,demonhunter,havoc,76,39,37
Nomfries,malganis,1510,demonhunter,havoc,34,17,17
Dirtbag,tichondrius,1503,demonhunter,havoc,30,16,14
Ilydos,emerald-dream,1503,demonhunter,havoc,102,52,50
Crayoz,tichondrius,1501,demonhunter,havoc,95,54,41
Demodorn,frostmane,1499,demonhunter,havoc,30,19,11
Yåkuza,daggerspine,1496,demonhunter,havoc,128,63,65
Karmadh,malganis,1494,demonhunter,havoc,30,16,14
Træt,emerald-dream,1494,demonhunter,havoc,83,42,41
Noxon,stormrage,1490,demonhunter,havoc,80,44,36
Nuredmyy,illidan,1488,demonhunter,havoc,30,17,13
Jaysavage,eitrigg,1488,demonhunter,havoc,51,27,24
Dashxo,tichondrius,1487,demonhunter,havoc,36,17,19
Demontrue,tichondrius,1483,demonhunter,havoc,62,32,30
Kimjonguun,tichondrius,1481,demonhunter,havoc,32,22,10
Häruun,quelthalas,1480,demonhunter,havoc,41,23,18
Dhyzz,proudmoore,1479,demonhunter,havoc,36,18,18
Tychondrius,earthen-ring,1478,demonhunter,havoc,161,82,79
Wormli,moon-guard,1477,demonhunter,havoc,40,24,16
Shyisback,area-52,1477,demonhunter,havoc,78,41,37
Nooksuh,bleeding-hollow,1473,demonhunter,havoc,29,16,13
Gubydal,frostmourne,1473,demonhunter,havoc,29,16,13
Grizzop,sargeras,1473,demonhunter,havoc,72,37,35
Vlääd,ragnaros,1473,demonhunter,havoc,92,44,48
Falachio,tichondrius,1472,demonhunter,havoc,31,19,12
Kegu,stormrage,1469,demonhunter,havoc,54,20,34
Doxdevil,tichondrius,1467,demonhunter,havoc,46,16,30
Gomesdhunter,azralon,1466,demonhunter,havoc,88,47,41
Henry,tichondrius,1465,demonhunter,havoc,69,41,28
Zackfair,burning-legion,1465,demonhunter,havoc,105,53,52
Darknezzl,ragnaros,1463,demonhunter,havoc,78,35,43
Eery,tichondrius,1461,demonhunter,havoc,71,35,36
Demonicfish,malganis,1460,demonhunter,havoc,48,30,18
Yuppx,tichondrius,1460,demonhunter,havoc,30,17,13
Mamif,korgath,1460,demonhunter,havoc,68,31,37
Hellnkeller,tichondrius,1459,demonhunter,havoc,36,16,20
Somethingstu,sargeras,1458,demonhunter,havoc,28,18,10
Raenorion,kelthuzad,1458,demonhunter,havoc,26,16,10
Furiel,quelthalas,1458,demonhunter,havoc,38,22,16
Felseal,frostmourne,1456,demonhunter,havoc,53,34,19
Ralløszek,illidan,1456,demonhunter,havoc,30,17,13
Illusiondh,tichondrius,1455,demonhunter,havoc,71,46,25
Coohiyan,tichondrius,1455,demonhunter,havoc,30,18,12
Nekrosdaeva,zuljin,1455,demonhunter,havoc,73,40,33
Brútalgore,area-52,1455,demonhunter,havoc,92,46,46
Kuramou,area-52,1454,demonhunter,havoc,30,17,13
Aiapaec,wyrmrest-accord,1454,demonhunter,havoc,101,50,51
Sciatic,area-52,1454,demonhunter,havoc,68,33,35
Softkyll,area-52,1453,demonhunter,havoc,316,166,150
Eyecandyxo,grizzly-hills,1452,demonhunter,havoc,37,20,17
Órph,sargeras,1452,demonhunter,havoc,42,22,20
Gohamx,illidan,1452,demonhunter,havoc,104,51,53
Wangasaurus,emerald-dream,1452,demonhunter,havoc,54,26,28
Bucx,barthilas,1445,demonhunter,havoc,60,36,24
Nicodine,tichondrius,1445,demonhunter,havoc,63,34,29
Faphunter,illidan,1441,demonhunter,havoc,87,50,37
Mavèrick,thrall,1441,demonhunter,havoc,45,21,24
Mamazboy,area-52,1439,demonhunter,havoc,28,16,12
Velravyn,moon-guard,1438,demonhunter,havoc,35,17,18
Molchamp,kelthuzad,1438,demonhunter,havoc,60,27,33
Feelmybush,barthilas,1438,demonhunter,havoc,72,29,43
Anatema,illidan,1437,demonhunter,havoc,29,17,12
Lravanal,quelthalas,1435,demonhunter,havoc,24,17,7
Fametrap,tichondrius,1435,demonhunter,havoc,24,15,9
ßlurr,moon-guard,1435,demonhunter,havoc,114,63,51
Wowcoldcold,barthilas,1435,demonhunter,havoc,30,15,15
Dridri,quelthalas,1430,demonhunter,havoc,44,21,23
Mybus,tichondrius,1429,demonhunter,havoc,72,32,40
Iim,tichondrius,1428,demonhunter,havoc,87,35,52
Superlative,area-52,1423,demonhunter,havoc,24,15,9
Flirtyscythe,illidan,1422,demonhunter,havoc,30,15,15
Moylecrumbs,stormrage,1420,demonhunter,havoc,72,35,37
Talyethsam,shadowsong,1418,demonhunter,havoc,32,16,16
Valka,emerald-dream,1416,demonhunter,havoc,100,53,47
Ikilldemonz,thrall,1415,demonhunter,havoc,42,19,23
Bremdh,thrall,1413,demonhunter,havoc,30,15,15
Dragonÿx,ragnaros,1413,demonhunter,havoc,50,20,30
Oxyoxy,illidan,1410,demonhunter,havoc,37,23,14
Exequion,ragnaros,1410,demonhunter,havoc,69,40,29
Backtolumby,bleeding-hollow,1410,demonhunter,havoc,41,23,18
Genruis,area-52,1410,demonhunter,havoc,61,30,31
Derperhunter,kiljaeden,1403,demonhunter,havoc,54,26,28
Loreney,quelthalas,1402,demonhunter,havoc,120,55,65
Radamanthysi,azralon,1401,demonhunter,havoc,54,34,20
Yodiegang,nazgrel,1400,demonhunter,havoc,24,15,9
Nolights,area-52,1399,demonhunter,havoc,74,32,42
Varthalos,thrall,1398,demonhunter,havoc,72,41,31
Skace,jubeithos,1397,demonhunter,havoc,102,56,46
Torments,area-52,1397,demonhunter,havoc,30,15,15
Alganoth,malfurion,1394,demonhunter,havoc,67,36,31
Methany,saurfang,1393,demonhunter,havoc,81,37,44
Aryapudding,tichondrius,1389,demonhunter,havoc,29,15,14
Tharzadan,quelthalas,1387,demonhunter,havoc,51,26,25
Dejay,thunderhorn,1386,demonhunter,havoc,42,27,15
Sloôtybag,tichondrius,1385,demonhunter,havoc,24,15,9
Kúrama,tichondrius,1385,demonhunter,havoc,78,46,32
Ranir,doomhammer,1384,demonhunter,havoc,54,23,31
Lostsoulzz,tichondrius,1383,demonhunter,havoc,45,28,17
Chromatïc,jubeithos,1382,demonhunter,havoc,54,23,31
Creamboi,stormrage,1379,demonhunter,havoc,30,16,14
Ylydary,ragnaros,1378,demonhunter,havoc,30,16,14
Onewhoknox,mannoroth,1377,demonhunter,havoc,89,47,42
Violegrace,area-52,1376,demonhunter,havoc,100,48,52
Villumninati,tichondrius,1375,demonhunter,havoc,48,27,21
Kellox,ragnaros,1372,demonhunter,havoc,36,15,21
Xillidan,area-52,1371,demonhunter,havoc,88,55,33
Petty,moon-guard,1371,demonhunter,havoc,48,28,20
Kazdh,sargeras,1367,demonhunter,havoc,48,25,23
Thêpunisher,ragnaros,1367,demonhunter,havoc,118,60,58
Jellous,rivendare,1366,demonhunter,havoc,42,17,25
Loadedtruck,frostmourne,1362,demonhunter,havoc,24,16,8
Kakster,tichondrius,1362,demonhunter,havoc,66,35,31
Ronkasprince,thunderlord,1361,demonhunter,havoc,92,41,51
Mewmewkitty,tichondrius,1356,demonhunter,havoc,28,15,13
Raith,khazgoroth,1356,demonhunter,havoc,35,17,18
Inkubuz,sargeras,1355,demonhunter,havoc,133,68,65
Gwendanzig,zangarmarsh,1355,demonhunter,havoc,60,28,32
Hornedelf,frostmourne,1353,demonhunter,havoc,35,19,16
Rizzaarrdd,tichondrius,1353,demonhunter,havoc,110,58,52
Metagoblin,tichondrius,1352,demonhunter,havoc,30,15,15
Kitnix,proudmoore,1349,demonhunter,havoc,31,16,15
Krizo,frostmourne,1348,demonhunter,havoc,37,19,18
Vegan,magtheridon,1345,demonhunter,havoc,24,16,8
Rânkle,darkspear,1345,demonhunter,havoc,46,25,21
Exzyo,area-52,1344,demonhunter,havoc,18,14,4
Rem,stormrage,1344,demonhunter,havoc,69,37,32
Ergzydh,frostmourne,1344,demonhunter,havoc,72,30,42
Taylordem,tichondrius,1342,demonhunter,havoc,24,14,10
Theflurry,tichondrius,1342,demonhunter,havoc,36,14,22
Mèw,bleeding-hollow,1340,demonhunter,havoc,24,14,10
Deviljane,illidan,1340,demonhunter,havoc,24,14,10
Malviciouss,tichondrius,1339,demonhunter,havoc,42,19,23
Sillyslayadk,moon-guard,1336,demonhunter,havoc,118,67,51
Layli,azralon,1332,demonhunter,havoc,36,21,15
Billmcawsom,proudmoore,1332,demonhunter,havoc,30,14,16
Skyfly,stormscale,1331,demonhunter,havoc,36,14,22
Xein,khazgoroth,1327,demonhunter,havoc,66,30,36
Kalmor,barthilas,1327,demonhunter,havoc,45,20,25
Elevateztko,stormrage,1326,demonhunter,havoc,36,16,20
Fiziokratdh,ghostlands,1323,demonhunter,havoc,37,18,19
Refractx,illidan,1322,demonhunter,havoc,42,22,20
Hawkowicz,tichondrius,1322,demonhunter,havoc,175,88,87
Xiaochicken,tichondrius,1320,demonhunter,havoc,38,17,21
Gigavlad,area-52,1317,demonhunter,havoc,30,14,16
Ehrapist,kelthuzad,1316,demonhunter,havoc,24,14,10
Nepzz,stormrage,1315,demonhunter,havoc,36,18,18
Litzilla,thrall,1315,demonhunter,havoc,42,20,22
Ovèrrated,area-52,1315,demonhunter,havoc,70,32,38
Bjj,bonechewer,1314,demonhunter,havoc,52,29,23
Sicklyslick,frostmourne,1313,demonhunter,havoc,25,15,10
Absinith,jubeithos,1311,demonhunter,havoc,18,14,4
Kaelidan,kelthuzad,1311,demonhunter,havoc,107,56,51
Rytesx,moon-guard,1310,demonhunter,havoc,28,21,7
Yukisyn,proudmoore,1306,demonhunter,havoc,30,16,14
Aeonys,stormrage,1304,demonhunter,havoc,24,16,8
Powertaco,tichondrius,1304,demonhunter,havoc,67,31,36
Bllackclover,zuljin,1303,demonhunter,havoc,29,14,15
Duhan,tichondrius,1302,demonhunter,havoc,156,80,76
Miroir,silvermoon,1302,demonhunter,havoc,105,49,56
Felbreak,stormrage,1302,demonhunter,havoc,42,18,24
Scarshine,frostmourne,1301,demonhunter,havoc,54,23,31
Yønkou,stormrage,1300,demonhunter,havoc,102,50,52
Demonkratoz,ragnaros,1300,demonhunter,havoc,34,15,19
Telrindyl,moon-guard,1299,demonhunter,havoc,87,50,37
Silvs,illidan,1299,demonhunter,havoc,184,102,82
Belial,haomarush,1299,demonhunter,havoc,54,28,26
Zévron,area-52,1298,demonhunter,havoc,30,15,15
Halftruth,stormrage,1298,demonhunter,havoc,46,22,24
Snaped,tichondrius,1297,demonhunter,havoc,24,16,8
Thechaz,bleeding-hollow,1297,demonhunter,havoc,54,34,20
Revvup,tichondrius,1294,demonhunter,havoc,71,33,38
Alaron,wildhammer,1293,demonhunter,havoc,99,53,46
Naelaksa,tichondrius,1293,demonhunter,havoc,36,14,22
Swoffordsr,tichondrius,1291,demonhunter,havoc,48,23,25
Mustardtigër,bleeding-hollow,1290,demonhunter,havoc,23,14,9
Chungg,laughing-skull,1287,demonhunter,havoc,30,15,15
Draenkz,ragnaros,1287,demonhunter,havoc,46,15,31
Imwhack,frostmane,1281,demonhunter,havoc,31,15,16
Roughins,chogall,1278,demonhunter,havoc,51,28,23
Hròðvitnir,quelthalas,1277,demonhunter,havoc,26,16,10
Greent,stormrage,1270,demonhunter,havoc,30,17,13
Whataboutbob,korgath,1268,demonhunter,havoc,36,14,22
Mortiria,dalaran,1267,demonhunter,havoc,42,18,24
Kereses,bonechewer,1266,demonhunter,havoc,45,25,20
Tattedandfab,stormrage,1265,demonhunter,havoc,102,44,58
Diversityabc,bleeding-hollow,1263,demonhunter,havoc,72,30,42
Skilla,frostmourne,1262,demonhunter,havoc,85,42,43
Swarlee,kiljaeden,1259,demonhunter,havoc,59,30,29
Eullz,skullcrusher,1257,demonhunter,havoc,31,14,17
Xà,sargeras,1256,demonhunter,havoc,36,14,22
Durello,stormrage,1251,demonhunter,havoc,42,19,23
Onlypain,korgath,1251,demonhunter,havoc,38,16,22
Blinddh,bleeding-hollow,1249,demonhunter,havoc,32,14,18
Mårth,caelestrasz,1248,demonhunter,havoc,48,25,23
Stochastic,ragnaros,1248,demonhunter,havoc,31,14,17
Ilovenina,sargeras,1247,demonhunter,havoc,24,13,11
Giselah,malganis,1247,demonhunter,havoc,30,13,17
Gènji,tichondrius,1246,demonhunter,havoc,24,13,11
Niuzimeile,illidan,1246,demonhunter,havoc,42,13,29
Kalikanzar,sargeras,1245,demonhunter,havoc,24,13,11
Fingersdh,malganis,1245,demonhunter,havoc,30,13,17
Alizqt,ragnaros,1244,demonhunter,havoc,24,13,11
Deathsweep,tichondrius,1244,demonhunter,havoc,24,13,11
Baejuhyun,kiljaeden,1243,demonhunter,havoc,24,16,8
Nichousha,tichondrius,1243,demonhunter,havoc,24,13,11
Pythongodx,azralon,1243,demonhunter,havoc,24,13,11
Smilingbomb,tichondrius,1243,demonhunter,havoc,24,13,11
Ashtyr,emerald-dream,1241,demonhunter,havoc,22,14,8
Decoi,tichondrius,1241,demonhunter,havoc,24,13,11
Tydriedian,dalaran,1239,demonhunter,havoc,18,13,5
Harû,tichondrius,1239,demonhunter,havoc,30,13,17
Narandra,malganis,1239,demonhunter,havoc,36,13,23
Scriptyscrip,dark-iron,1238,demonhunter,havoc,42,13,29
Alast,emerald-dream,1237,demonhunter,havoc,30,13,17
Zétta,area-52,1236,demonhunter,havoc,24,13,11
Demonbane,moon-guard,1236,demonhunter,havoc,54,27,27
Redkin,moon-guard,1231,demonhunter,havoc,31,16,15
Sikäria,malganis,1229,demonhunter,havoc,24,13,11
Hasbeen,tichondrius,1229,demonhunter,havoc,27,14,13
Superbug,quelthalas,1229,demonhunter,havoc,42,20,22
Papaelf,thunderlord,1227,demonhunter,havoc,18,13,5
Cherlas,blood-furnace,1227,demonhunter,havoc,30,14,16
Revean,darkspear,1226,demonhunter,havoc,66,36,30
Tyredris,kelthuzad,1226,demonhunter,havoc,24,13,11
Zématador,azralon,1226,demonhunter,havoc,90,48,42
Darthmah,illidan,1222,demonhunter,havoc,18,13,5
Tezrian,earthen-ring,1221,demonhunter,havoc,24,13,11
Devwillhuntu,barthilas,1216,demonhunter,havoc,80,42,38
Pilyn,ragnaros,1216,demonhunter,havoc,80,39,41
Soulsteall,tichondrius,1213,demonhunter,havoc,24,14,10
Tekkamanevil,tichondrius,1212,demonhunter,havoc,144,67,77
Keelin,ragnaros,1212,demonhunter,havoc,28,13,15
Eraticdh,illidan,1211,demonhunter,havoc,30,13,17
Bzrp,stormrage,1210,demonhunter,havoc,40,23,17
Spicywings,arthas,1209,demonhunter,havoc,42,18,24
Dömönic,illidan,1208,demonhunter,havoc,24,13,11
Cursesoul,area-52,1206,demonhunter,havoc,54,28,26
Raradane,illidan,1203,demonhunter,havoc,18,13,5
Hellspawnn,malganis,1200,demonhunter,havoc,44,24,20
Etherëäl,stormrage,1194,demonhunter,havoc,53,32,21
Fellight,bonechewer,1193,demonhunter,havoc,42,27,15
Medusarri,frostmourne,1193,demonhunter,havoc,36,19,17
Asmoday,warsong,1192,demonhunter,havoc,87,50,37
Ixix,proudmoore,1192,demonhunter,havoc,62,30,32
Illidice,tichondrius,1189,demonhunter,havoc,30,13,17
Erazuz,stormrage,1188,demonhunter,havoc,30,13,17
Brunoqt,azralon,1185,demonhunter,havoc,29,13,16
Cyberpsycho,illidan,1184,demonhunter,havoc,30,14,16
Sleepyjobe,sargeras,1183,demonhunter,havoc,16,13,3
Churchpls,stormrage,1181,demonhunter,havoc,34,13,21
Tyrelara,durotan,1179,demonhunter,havoc,23,13,10
Glayve,emerald-dream,1178,demonhunter,havoc,85,41,44
Emeress,illidan,1174,demonhunter,havoc,29,13,16
Saelila,emerald-dream,1172,demonhunter,havoc,30,13,17
Dyingslow,stormrage,1172,demonhunter,havoc,66,24,42
Buzzmezaddy,bleeding-hollow,1170,demonhunter,havoc,63,28,35
Gouge,hakkar,1167,demonhunter,havoc,55,30,25
Daiks,proudmoore,1166,demonhunter,havoc,42,19,23
Blazed,thrall,1164,demonhunter,havoc,94,46,48
Zoruv,quelthalas,1160,demonhunter,havoc,27,14,13
Thedaz,frostmourne,1158,demonhunter,havoc,143,66,77
Ragiidh,tichondrius,1152,demonhunter,havoc,24,12,12
Xragii,kelthuzad,1152,demonhunter,havoc,24,12,12
Frostchaos,ragnaros,1151,demonhunter,havoc,18,12,6
Imjustbad,malganis,1151,demonhunter,havoc,42,26,16
Remuko,tichondrius,1151,demonhunter,havoc,24,12,12
Orgasmia,tichondrius,1151,demonhunter,havoc,46,13,33
Beyondjerky,malganis,1150,demonhunter,havoc,24,12,12
Kenmu,ragnaros,1150,demonhunter,havoc,24,12,12
Fasnk,tichondrius,1150,demonhunter,havoc,24,12,12
Qixoni,emerald-dream,1150,demonhunter,havoc,30,12,18
Nuggetx,lightnings-blade,1149,demonhunter,havoc,18,12,6
Xylëm,tichondrius,1149,demonhunter,havoc,36,12,24
Littlewolfie,illidan,1146,demonhunter,havoc,24,12,12
Viio,proudmoore,1146,demonhunter,havoc,24,12,12
Papazaraki,tichondrius,1145,demonhunter,havoc,18,12,6
Skinnrd,malganis,1142,demonhunter,havoc,24,12,12
Vandeste,tichondrius,1142,demonhunter,havoc,30,12,18
Kagraxxis,stormrage,1141,demonhunter,havoc,21,13,8
Spamsamich,stormscale,1140,demonhunter,havoc,53,31,22
Neecro,frostmourne,1140,demonhunter,havoc,30,14,16
Torophz,azralon,1139,demonhunter,havoc,30,12,18
Pupupoo,tichondrius,1138,demonhunter,havoc,18,12,6
Elidani,area-52,1138,demonhunter,havoc,30,12,18
Lory,eldrethalas,1136,demonhunter,havoc,43,23,20
Endyr,area-52,1136,demonhunter,havoc,25,12,13
Tayel,emerald-dream,1133,demonhunter,havoc,34,19,15
Dandreb,draenor,1130,demonhunter,havoc,29,15,14
Ozark,barthilas,1129,demonhunter,havoc,42,25,17
Siicknote,frostmourne,1127,demonhunter,havoc,23,12,11
Jennesis,tichondrius,1126,demonhunter,havoc,72,33,39
Ibeatrix,malorne,1124,demonhunter,havoc,24,18,6
Attritionx,sargeras,1118,demonhunter,havoc,23,13,10
Nrpx,stormrage,1118,demonhunter,havoc,22,12,10
Lilliåna,kiljaeden,1115,demonhunter,havoc,50,22,28
Jackk,nordrassil,1110,demonhunter,havoc,23,12,11
Sätän,malganis,1089,demonhunter,havoc,24,13,11
Adryr,eredar,1086,demonhunter,havoc,24,12,12
Ghostzface,sargeras,1084,demonhunter,havoc,48,26,22
Kelmar,stormreaver,1084,demonhunter,havoc,32,12,20
Moxí,ragnaros,1082,demonhunter,havoc,36,19,17
Telmordrin,azralon,1080,demonhunter,havoc,20,12,8
Bhuppz,frostmourne,1076,demonhunter,havoc,22,12,10
Rhaast,executus,1076,demonhunter,havoc,49,21,28
Misfortune,bloodscalp,1076,demonhunter,havoc,36,15,21
Dirtyvitus,gorefiend,1072,demonhunter,havoc,36,24,12
Esomet,stormrage,1070,demonhunter,havoc,27,15,12
Nixsa,area-52,1068,demonhunter,havoc,72,31,41
Faalleen,quelthalas,1059,demonhunter,havoc,18,12,6
Syrine,veknilash,1059,demonhunter,havoc,72,41,31
Illadra,fizzcrank,1058,demonhunter,havoc,23,12,11
Sucio,khaz-modan,1056,demonhunter,havoc,18,11,7
Thegoph,bleeding-hollow,1056,demonhunter,havoc,24,11,13
Fëlla,tanaris,1055,demonhunter,havoc,18,11,7
Çópê,sargeras,1055,demonhunter,havoc,18,11,7
Dãnishroll,illidan,1055,demonhunter,havoc,30,11,19
Dennfear,skullcrusher,1054,demonhunter,havoc,18,12,6
Diiecrux,bleeding-hollow,1054,demonhunter,havoc,18,11,7
Ariaxy,sargeras,1054,demonhunter,havoc,18,11,7
Narchis,malganis,1054,demonhunter,havoc,18,11,7
Thumôss,malganis,1054,demonhunter,havoc,18,11,7
Spicyblades,stormrage,1054,demonhunter,havoc,47,21,26
Xenore,emerald-dream,1054,demonhunter,havoc,30,11,19
Mudßutt,malganis,1054,demonhunter,havoc,30,11,19
Xavid,bleeding-hollow,1053,demonhunter,havoc,24,11,13
Messenoire,area-52,1051,demonhunter,havoc,26,11,15
Mood,stonemaul,1050,demonhunter,havoc,18,11,7
Ønsen,tichondrius,1049,demonhunter,havoc,29,11,18
Vuse,moon-guard,1048,demonhunter,havoc,24,11,13
Haades,proudmoore,1048,demonhunter,havoc,24,11,13
Covoth,bleeding-hollow,1048,demonhunter,havoc,27,12,15
Creamin,thrall,1047,demonhunter,havoc,18,11,7
Legäult,bleeding-hollow,1047,demonhunter,havoc,33,17,16
Callux,black-dragonflight,1047,demonhunter,havoc,30,11,19
Siksix,bleeding-hollow,1046,demonhunter,havoc,24,11,13
Kellytgt,perenolde,1045,demonhunter,havoc,18,11,7
Throniren,stormrage,1044,demonhunter,havoc,24,11,13
Demonslaier,dragonblight,1043,demonhunter,havoc,20,12,8
Xanthee,drakkari,1043,demonhunter,havoc,81,41,40
Metabeam,tichondrius,1042,demonhunter,havoc,18,11,7
Mursiless,drenden,1041,demonhunter,havoc,18,11,7
Rickinmorty,lightnings-blade,1041,demonhunter,havoc,19,11,8
Ënky,ragnaros,1035,demonhunter,havoc,30,11,19
Dameon,wildhammer,1032,demonhunter,havoc,54,27,27
Chinadh,tichondrius,1022,demonhunter,havoc,23,11,12
Jënesis,illidan,1022,demonhunter,havoc,68,29,39
Eikichi,bleeding-hollow,1009,demonhunter,havoc,54,26,28
Chirõn,moonrunner,1007,demonhunter,havoc,23,11,12
Demonhunter,kirin-tor,1005,demonhunter,havoc,23,12,11
Nocturnale,ragnaros,1005,demonhunter,havoc,23,11,12
Seamenhunter,garrosh,1004,demonhunter,havoc,24,12,12
Shawnchad,blood-furnace,999,demonhunter,havoc,133,68,65
Annabow,moon-guard,993,demonhunter,havoc,48,27,21
Xxann,tichondrius,991,demonhunter,havoc,26,11,15
Lüky,malganis,986,demonhunter,havoc,22,11,11
Sëlene,antonidas,984,demonhunter,havoc,29,12,17
Andarïel,bleeding-hollow,977,demonhunter,havoc,25,12,13
Chainsawz,zuljin,960,demonhunter,havoc,18,10,8
Cerebro,stormrage,960,demonhunter,havoc,18,10,8
Postodesaúde,azralon,960,demonhunter,havoc,18,10,8
Lancee,zuljin,960,demonhunter,havoc,24,10,14
Ntts,tichondrius,960,demonhunter,havoc,24,10,14
Gtåte,azjolnerub,960,demonhunter,havoc,30,10,20
Valerrias,area-52,959,demonhunter,havoc,18,10,8
Sourapple,barthilas,959,demonhunter,havoc,18,10,8
Apõz,tichondrius,959,demonhunter,havoc,18,10,8
Hoguriders,tichondrius,959,demonhunter,havoc,24,10,14
Cyånan,bleeding-hollow,958,demonhunter,havoc,23,14,9
Yaety,tichondrius,958,demonhunter,havoc,18,10,8
Planeinsky,malganis,958,demonhunter,havoc,18,10,8
Zunfooki,stormrage,957,demonhunter,havoc,18,10,8
Alwaysin,zuljin,957,demonhunter,havoc,18,10,8
Randôm,kelthuzad,957,demonhunter,havoc,21,11,10
Gilberte,stormrage,957,demonhunter,havoc,24,10,14
Valdiran,duskwood,956,demonhunter,havoc,24,10,14
Tangoh,burning-legion,955,demonhunter,havoc,18,10,8
Jagidan,area-52,955,demonhunter,havoc,24,10,14
Xibir,amanthul,953,demonhunter,havoc,24,10,14
Larnol,moon-guard,952,demonhunter,havoc,18,10,8
Allenqt,azralon,952,demonhunter,havoc,24,10,14
Salomesalvi,proudmoore,951,demonhunter,havoc,18,10,8
Mázoku,shuhalo,951,demonhunter,havoc,20,11,9
Omgshesocute,hyjal,951,demonhunter,havoc,24,10,14
Vizionz,emerald-dream,950,demonhunter,havoc,18,10,8
Sylenah,hyjal,950,demonhunter,havoc,24,10,14
Ghótam,quelthalas,950,demonhunter,havoc,24,10,14
Letzgobrandn,silvermoon,948,demonhunter,havoc,18,10,8
Vladdtepes,cairne,947,demonhunter,havoc,63,34,29
Kwoop,tichondrius,946,demonhunter,havoc,24,10,14
Demonizhe,thrall,944,demonhunter,havoc,43,22,21
Evros,tichondrius,933,demonhunter,havoc,21,11,10
Kslicedevil,dalaran,933,demonhunter,havoc,54,23,31
Deegsdh,sargeras,932,demonhunter,havoc,27,10,17
Gozer,korialstrasz,929,demonhunter,havoc,36,12,24
Lillidum,azralon,927,demonhunter,havoc,45,21,24
Rlycoolclass,zuljin,927,demonhunter,havoc,23,10,13
Keeblerself,tichondrius,925,demonhunter,havoc,24,11,13
Gravelot,quelthalas,915,demonhunter,havoc,30,10,20
Troigh,thunderlord,912,demonhunter,havoc,60,29,31
Cuint,barthilas,904,demonhunter,havoc,18,10,8
Malthazaan,stormrage,895,demonhunter,havoc,14,10,4
Rissélys,thrall,894,demonhunter,havoc,30,15,15
Røllnautløw,aegwynn,892,demonhunter,havoc,14,10,4
Ripchimmii,illidan,880,demonhunter,havoc,25,10,15
Blacktocki,barthilas,878,demonhunter,havoc,22,10,12
Blops,emerald-dream,877,demonhunter,havoc,24,11,13
Mikiller,thrall,874,demonhunter,havoc,67,33,34
Riicardo,ragnaros,870,demonhunter,havoc,28,12,16
Faarkyou,barthilas,868,demonhunter,havoc,26,10,16
Andyhunter,emerald-dream,867,demonhunter,havoc,50,24,26
Pennyx,barthilas,864,demonhunter,havoc,12,9,3
Ragiixoxo,tichondrius,864,demonhunter,havoc,12,9,3
Ravevê,area-52,864,demonhunter,havoc,12,9,3
Brackmagik,barthilas,864,demonhunter,havoc,12,9,3
Souliz,tichondrius,864,demonhunter,havoc,12,9,3
Bammski,tichondrius,864,demonhunter,havoc,18,9,9
Trillidan,mugthol,864,demonhunter,havoc,18,9,9
Diablitaa,sargeras,864,demonhunter,havoc,18,9,9
Unjusthunt,magtheridon,864,demonhunter,havoc,18,9,9
Tarro,whisperwind,864,demonhunter,havoc,18,9,9
Beerbreak,area-52,864,demonhunter,havoc,24,9,15
Mcgurty,illidan,864,demonhunter,havoc,24,9,15
Noobender,malganis,864,demonhunter,havoc,30,9,21
Ripidan,stormrage,864,demonhunter,havoc,30,9,21
Agsakim,tichondrius,863,demonhunter,havoc,12,9,3
Cybertrax,tichondrius,863,demonhunter,havoc,12,9,3
Rothdh,tichondrius,863,demonhunter,havoc,15,10,5
Subieshift,sargeras,863,demonhunter,havoc,15,10,5
Creãtuss,area-52,863,demonhunter,havoc,15,10,5
Orosz,bleeding-hollow,863,demonhunter,havoc,18,9,9
Missjotab,tichondrius,863,demonhunter,havoc,18,9,9
Checkmate,bleeding-hollow,863,demonhunter,havoc,24,9,15
Ídunno,kiljaeden,863,demonhunter,havoc,24,9,15
Dragynfíst,malganis,863,demonhunter,havoc,30,9,21
Colinn,illidan,862,demonhunter,havoc,12,9,3
Lucipur,thrall,862,demonhunter,havoc,18,9,9
Hugehogger,boulderfist,862,demonhunter,havoc,18,9,9
Vida,winterhoof,862,demonhunter,havoc,18,9,9
Moranah,tichondrius,862,demonhunter,havoc,18,9,9
Wut,nemesis,861,demonhunter,havoc,60,30,30
Foxdie,bonechewer,861,demonhunter,havoc,18,9,9
Felhunt,ragnaros,861,demonhunter,havoc,24,9,15
Hellboss,dalaran,860,demonhunter,havoc,12,9,3
Bodemön,stormrage,860,demonhunter,havoc,18,9,9
Rèlentless,moon-guard,860,demonhunter,havoc,18,9,9
Clorhídrico,quelthalas,860,demonhunter,havoc,60,25,35
Cleår,kelthuzad,859,demonhunter,havoc,18,9,9
Celestiel,cenarion-circle,859,demonhunter,havoc,18,9,9
Alphmega,malganis,859,demonhunter,havoc,18,9,9
Tickelfist,zuljin,859,demonhunter,havoc,24,9,15
Allukya,azralon,856,demonhunter,havoc,12,9,3
Flyingsky,tichondrius,855,demonhunter,havoc,12,9,3
Aflex,zuljin,855,demonhunter,havoc,18,9,9
Miltonpickle,tichondrius,855,demonhunter,havoc,24,9,15
Dartanyn,tichondrius,853,demonhunter,havoc,24,9,15
Drackista,stormrage,852,demonhunter,havoc,18,9,9
Aussiepleb,nagrand,846,demonhunter,havoc,87,37,50
Chronicsmoke,blood-furnace,842,demonhunter,havoc,18,9,9
Dalmandra,arthas,841,demonhunter,havoc,17,9,8
Howller,azralon,827,demonhunter,havoc,17,9,8
Wokeaf,malganis,814,demonhunter,havoc,17,9,8
Antistar,emerald-dream,799,demonhunter,havoc,26,9,17
Bukwheat,thunderhorn,793,demonhunter,havoc,48,19,29
Jellehx,frostmourne,784,demonhunter,havoc,13,9,4
Dzdh,stormrage,768,demonhunter,havoc,12,8,4
Humanitydh,sargeras,768,demonhunter,havoc,12,8,4
Danloesh,silver-hand,768,demonhunter,havoc,12,8,4
Behemod,thrall,768,demonhunter,havoc,12,8,4
Chulakels,tichondrius,768,demonhunter,havoc,12,8,4
Thickgary,illidan,768,demonhunter,havoc,12,8,4
Doomanone,sargeras,768,demonhunter,havoc,12,8,4
Surkkdh,tichondrius,768,demonhunter,havoc,12,8,4
Cegocruel,sargeras,768,demonhunter,havoc,13,8,5
Ohanadh,ragnaros,768,demonhunter,havoc,18,8,10
Icrazedcruxl,gnomeregan,768,demonhunter,havoc,18,8,10
Tomhenk,blackrock,768,demonhunter,havoc,18,8,10
Felontis,sargeras,768,demonhunter,havoc,18,8,10
Raylêy,tichondrius,768,demonhunter,havoc,18,8,10
Gogungho,tichondrius,768,demonhunter,havoc,18,8,10
Veilmaya,arthas,768,demonhunter,havoc,18,8,10
Mõemõeda,illidan,768,demonhunter,havoc,24,8,16
Doomantwo,sargeras,768,demonhunter,havoc,24,8,16
Xonu,sargeras,767,demonhunter,havoc,12,8,4
Catastrophis,tichondrius,767,demonhunter,havoc,12,8,4
Netherbird,malganis,767,demonhunter,havoc,12,8,4
Blackmvp,tichondrius,767,demonhunter,havoc,12,8,4
Fckyouscott,illidan,767,demonhunter,havoc,12,8,4
Ziyàl,vashj,767,demonhunter,havoc,12,8,4
Hellrazer,area-52,767,demonhunter,havoc,12,8,4
Badwurd,sargeras,767,demonhunter,havoc,12,8,4
Lethalblows,darkspear,767,demonhunter,havoc,15,9,6
Linedori,destromath,767,demonhunter,havoc,16,9,7
Hellrazer,azgalor,767,demonhunter,havoc,18,8,10
Xionas,moon-guard,767,demonhunter,havoc,18,8,10
Demonqt,blackrock,767,demonhunter,havoc,18,8,10
Oddlysimple,korgath,767,demonhunter,havoc,18,8,10
Wólff,azralon,766,demonhunter,havoc,12,8,4
Andein,dalaran,766,demonhunter,havoc,12,8,4
Aedice,gurubashi,766,demonhunter,havoc,18,8,10
Accipiter,ragnaros,766,demonhunter,havoc,24,8,16
Këÿz,earthen-ring,765,demonhunter,havoc,18,8,10
Lû,arthas,765,demonhunter,havoc,24,8,16
Felbòy,korgath,763,demonhunter,havoc,18,8,10
Kushidari,tichondrius,763,demonhunter,havoc,18,8,10
Syrena,mugthol,763,demonhunter,havoc,18,8,10
Sodiaksd,quelthalas,762,demonhunter,havoc,18,8,10
Illhuntya,bonechewer,758,demonhunter,havoc,18,8,10
Covidneitor,drakkari,752,demonhunter,havoc,18,8,10
Wuya,thrall,734,demonhunter,havoc,22,8,14
Catfood,icecrown,720,demonhunter,havoc,21,8,13
Hiresol,emerald-dream,719,demonhunter,havoc,11,8,3
Lrianna,senjin,706,demonhunter,havoc,17,8,9
Memoryleaky,proudmoore,696,demonhunter,havoc,11,8,3
Neshaan,stormreaver,688,demonhunter,havoc,38,20,18
Nephxz,tichondrius,672,demonhunter,havoc,12,7,5
Darthwhorë,frostmane,672,demonhunter,havoc,12,7,5
Nichidah,illidan,672,demonhunter,havoc,12,7,5
Evelynee,illidan,672,demonhunter,havoc,12,7,5
Mamadorx,azralon,672,demonhunter,havoc,12,7,5
Dabsfordayz,zuluhed,672,demonhunter,havoc,12,7,5
Surå,tichondrius,672,demonhunter,havoc,12,7,5
Verå,tichondrius,672,demonhunter,havoc,12,7,5
Warassassin,stormrage,672,demonhunter,havoc,12,7,5
Fiveiq,malganis,672,demonhunter,havoc,12,7,5
Reddh,bleeding-hollow,672,demonhunter,havoc,12,7,5
Dæl,quelthalas,672,demonhunter,havoc,12,7,5
Idontfaced,area-52,672,demonhunter,havoc,12,7,5
Juiced,thunderhorn,672,demonhunter,havoc,12,7,5
Demonthorne,illidan,672,demonhunter,havoc,12,7,5
Igotdc,tichondrius,672,demonhunter,havoc,13,7,6
Flamehunter,durotan,672,demonhunter,havoc,13,7,6
Faceurdemons,frostmourne,672,demonhunter,havoc,18,7,11
Hellmetal,quelthalas,672,demonhunter,havoc,18,7,11
Dumbledor,stonemaul,672,demonhunter,havoc,18,7,11
Getpoodon,sargeras,672,demonhunter,havoc,18,7,11
Moistybreeze,frostmourne,672,demonhunter,havoc,18,7,11
Yasuo,moon-guard,672,demonhunter,havoc,18,7,11
Babahorns,dalaran,672,demonhunter,havoc,18,7,11
Stormville,illidan,671,demonhunter,havoc,12,7,5
Nupx,frostmourne,671,demonhunter,havoc,12,7,5
Ivalerà,thrall,671,demonhunter,havoc,12,7,5
Rhadê,ragnaros,671,demonhunter,havoc,12,7,5
Unóhana,drakkari,671,demonhunter,havoc,12,7,5
Jolty,stormrage,671,demonhunter,havoc,12,7,5
Fiebzz,queldorei,671,demonhunter,havoc,12,7,5
Felraven,scarlet-crusade,671,demonhunter,havoc,12,7,5
Seabisciut,silvermoon,671,demonhunter,havoc,12,7,5
Taters,gorefiend,671,demonhunter,havoc,12,7,5
Wìtchblades,tichondrius,671,demonhunter,havoc,12,7,5
Cascadingeye,emerald-dream,671,demonhunter,havoc,12,7,5
Ogmon,tichondrius,671,demonhunter,havoc,12,7,5
Haax,azralon,671,demonhunter,havoc,18,7,11
Nicòrobin,dalaran,671,demonhunter,havoc,18,7,11
Hyphonìc,area-52,671,demonhunter,havoc,18,7,11
Veryaverage,kelthuzad,671,demonhunter,havoc,18,7,11
Weedeaterr,arthas,671,demonhunter,havoc,24,7,17
Ðarkone,ragnaros,671,demonhunter,havoc,24,7,17
Báléríón,area-52,670,demonhunter,havoc,12,7,5
Bijix,area-52,670,demonhunter,havoc,12,7,5
Renshear,cenarius,670,demonhunter,havoc,12,7,5
Vivas,tichondrius,670,demonhunter,havoc,18,7,11
Demonbanter,emerald-dream,668,demonhunter,havoc,15,8,7
Rahgoul,garrosh,666,demonhunter,havoc,18,7,11
Endoshiva,icecrown,666,demonhunter,havoc,18,7,11
Genifer,norgannon,665,demonhunter,havoc,12,7,5
Doomhead,burning-legion,658,demonhunter,havoc,12,7,5
Luzev,thrall,657,demonhunter,havoc,12,7,5
Ripperxx,zuljin,653,demonhunter,havoc,18,7,11
Purpsquirter,stormscale,653,demonhunter,havoc,21,8,13
Lëif,stormrage,652,demonhunter,havoc,18,7,11
Gwîlym,area-52,644,demonhunter,havoc,14,9,5
Pegásus,kiljaeden,639,demonhunter,havoc,10,7,3
Knshy,azralon,639,demonhunter,havoc,20,8,12
Bliqué,emerald-dream,633,demonhunter,havoc,17,7,10
Bofxo,sargeras,624,demonhunter,havoc,15,7,8
Bigtitiemilk,tichondrius,623,demonhunter,havoc,11,7,4
Gebblemon,aerie-peak,623,demonhunter,havoc,17,7,10
Thelada,illidan,621,demonhunter,havoc,15,7,8
Mqvdh,area-52,618,demonhunter,havoc,39,8,31
Galaxezz,bonechewer,612,demonhunter,havoc,15,8,7
Turecdh,illidan,607,demonhunter,havoc,14,7,7
Falaszun,aegwynn,606,demonhunter,havoc,14,7,7
Wualicho,ragnaros,603,demonhunter,havoc,24,8,16
Dogcleave,area-52,576,demonhunter,havoc,12,6,6
Whatdagoof,tichondrius,576,demonhunter,havoc,12,6,6
Manmilker,bleeding-hollow,576,demonhunter,havoc,12,6,6
Dgj,kelthuzad,576,demonhunter,havoc,12,6,6
Kolthis,tichondrius,576,demonhunter,havoc,12,6,6
Deathschosen,malganis,576,demonhunter,havoc,12,6,6
Thunderlor,malganis,576,demonhunter,havoc,12,6,6
Qualitycaulk,tichondrius,576,demonhunter,havoc,12,6,6
Bossdh,zuljin,576,demonhunter,havoc,12,6,6
Basdminority,bleeding-hollow,576,demonhunter,havoc,12,6,6
Solriel,malganis,576,demonhunter,havoc,12,6,6
Carlosjr,stormrage,576,demonhunter,havoc,12,6,6
Cðnstantine,barthilas,576,demonhunter,havoc,12,6,6
Pabloh,trollbane,576,demonhunter,havoc,12,6,6
Weskerz,illidan,576,demonhunter,havoc,12,6,6
Everdh,barthilas,576,demonhunter,havoc,12,6,6
Gommademon,illidan,576,demonhunter,havoc,12,6,6
Valeriya,frostmourne,576,demonhunter,havoc,12,6,6
Zyer,mannoroth,576,demonhunter,havoc,12,6,6
Kyuno,eitrigg,576,demonhunter,havoc,12,6,6
Majnun,moon-guard,576,demonhunter,havoc,12,6,6
Trenbolognie,illidan,576,demonhunter,havoc,12,6,6
Metakigai,ghostlands,576,demonhunter,havoc,12,6,6
Slapxy,illidan,576,demonhunter,havoc,12,6,6
Abadina,illidan,576,demonhunter,havoc,12,6,6
Beniesdh,frostmourne,576,demonhunter,havoc,12,6,6
Niteclawla,illidan,576,demonhunter,havoc,12,6,6
Soupwoup,moon-guard,576,demonhunter,havoc,12,6,6
Felraiser,stormrage,576,demonhunter,havoc,12,6,6
Stalkdemon,azralon,576,demonhunter,havoc,12,6,6
Audara,sargeras,576,demonhunter,havoc,12,6,6
Ahsoka,arygos,576,demonhunter,havoc,15,7,8
Zümanity,zangarmarsh,576,demonhunter,havoc,18,6,12
Zergedh,kiljaeden,576,demonhunter,havoc,18,6,12
Tresbotones,kelthuzad,576,demonhunter,havoc,18,6,12
Busta,dethecus,576,demonhunter,havoc,18,6,12
Vyrai,lightbringer,576,demonhunter,havoc,18,6,12
Kelan,borean-tundra,576,demonhunter,havoc,18,6,12
Khaito,illidan,576,demonhunter,havoc,18,6,12
Abscarnage,ragnaros,576,demonhunter,havoc,18,6,12
Chabashira,tichondrius,576,demonhunter,havoc,19,6,13
Lovekills,tichondrius,575,demonhunter,havoc,12,6,6
Smoothtaco,azshara,575,demonhunter,havoc,12,6,6
Tyindorin,gurubashi,575,demonhunter,havoc,12,6,6
Çummins,malganis,575,demonhunter,havoc,12,6,6
Diizy,illidan,575,demonhunter,havoc,12,6,6
Liquidblaze,elune,575,demonhunter,havoc,12,6,6
Veladoria,malorne,575,demonhunter,havoc,12,6,6
Nerco,bleeding-hollow,575,demonhunter,havoc,12,6,6
Cholula,korgath,575,demonhunter,havoc,12,6,6
Ralrdh,ragnaros,575,demonhunter,havoc,12,6,6
Elenamarth,kiljaeden,575,demonhunter,havoc,12,6,6
Hootyeahbou,shattered-hand,575,demonhunter,havoc,12,6,6
Lysol,darrowmere,575,demonhunter,havoc,12,6,6
Jalet,azralon,575,demonhunter,havoc,18,6,12
Salveya,stormrage,575,demonhunter,havoc,20,6,14
Ðruh,kelthuzad,574,demonhunter,havoc,18,6,12
Firesworn,zuljin,573,demonhunter,havoc,12,6,6
Slaytan,darkspear,573,demonhunter,havoc,18,6,12
Turbochadbro,spirestone,572,demonhunter,havoc,9,7,2
Lanistus,bloodhoof,570,demonhunter,havoc,18,6,12
Rampyr,terokkar,569,demonhunter,havoc,12,6,6
Kreel,ghostlands,568,demonhunter,havoc,12,6,6
Aleymar,tichondrius,568,demonhunter,havoc,12,6,6
Thjoannys,illidan,567,demonhunter,havoc,12,6,6
Grolschen,proudmoore,558,demonhunter,havoc,18,6,12
Kêydën,ragnaros,541,demonhunter,havoc,10,7,3
Shizune,boulderfist,525,demonhunter,havoc,11,6,5
Wickedlurker,sargeras,519,demonhunter,havoc,17,9,8
Soure,azralon,511,demonhunter,havoc,14,6,8
Isedelica,area-52,510,demonhunter,havoc,11,6,5
Ceried,moon-guard,491,demonhunter,havoc,13,6,7
Cynthadra,frostmourne,480,demonhunter,havoc,6,5,1
Khaodemus,kaelthas,480,demonhunter,havoc,6,5,1
Milfhuñter,sargeras,480,demonhunter,havoc,6,5,1
Lumh,quelthalas,480,demonhunter,havoc,6,5,1
Ryntx,moon-guard,480,demonhunter,havoc,6,5,1
Ottie,kelthuzad,480,demonhunter,havoc,6,5,1
Prazethesun,emerald-dream,480,demonhunter,havoc,6,5,1
Ljevilin,gilneas,480,demonhunter,havoc,6,5,1
Damador,malganis,480,demonhunter,havoc,6,5,1
Harahmbae,moon-guard,480,demonhunter,havoc,12,5,7
Køugami,azralon,480,demonhunter,havoc,12,5,7
Bátmañ,stormrage,480,demonhunter,havoc,12,5,7
Drathothian,moon-guard,480,demonhunter,havoc,12,5,7
Darkglaive,ragnaros,480,demonhunter,havoc,12,5,7
Besoween,tichondrius,480,demonhunter,havoc,12,5,7
Lachesix,tichondrius,480,demonhunter,havoc,12,5,7
Elchapotko,tichondrius,480,demonhunter,havoc,12,5,7
Hippygamer,frostmourne,480,demonhunter,havoc,12,5,7
Untouchèd,bleeding-hollow,480,demonhunter,havoc,12,5,7
Xiaodudh,tichondrius,480,demonhunter,havoc,12,5,7
Muffjuice,emerald-dream,480,demonhunter,havoc,12,5,7
Delaían,drakkari,480,demonhunter,havoc,12,5,7
Lìttlê,runetotem,480,demonhunter,havoc,12,5,7
Uneasydh,tichondrius,480,demonhunter,havoc,12,5,7
Chaosfienddh,bleeding-hollow,480,demonhunter,havoc,12,5,7
Domeemommy,moon-guard,480,demonhunter,havoc,12,5,7
Paypaldh,malganis,480,demonhunter,havoc,12,5,7
Faster,tichondrius,480,demonhunter,havoc,12,5,7
Maddummy,tichondrius,480,demonhunter,havoc,12,5,7
Onbloodfam,kelthuzad,480,demonhunter,havoc,12,5,7
Sailtheskies,tichondrius,480,demonhunter,havoc,12,5,7
Zlr,bleeding-hollow,480,demonhunter,havoc,12,5,7
Wwdh,stormrage,480,demonhunter,havoc,12,5,7
Chupillidan,tichondrius,480,demonhunter,havoc,12,5,7
Dontplanahea,tichondrius,480,demonhunter,havoc,12,5,7
Ahurock,ragnaros,480,demonhunter,havoc,12,5,7
Cococat,tichondrius,480,demonhunter,havoc,12,5,7
Obîtox,illidan,480,demonhunter,havoc,12,5,7
Bellysniffer,illidan,480,demonhunter,havoc,12,5,7
Anthvedroth,area-52,480,demonhunter,havoc,12,5,7
Hyptonique,queldorei,480,demonhunter,havoc,12,5,7
Finagel,destromath,480,demonhunter,havoc,12,5,7
Zuppashi,area-52,480,demonhunter,havoc,12,5,7
Demondurk,illidan,480,demonhunter,havoc,12,5,7
Roughcut,blackrock,480,demonhunter,havoc,12,5,7
Lonelydusk,zangarmarsh,480,demonhunter,havoc,12,5,7
Highpower,area-52,480,demonhunter,havoc,12,5,7
Dàrk,zuljin,480,demonhunter,havoc,23,7,16
Dracxus,sargeras,480,demonhunter,havoc,18,5,13
Barael,tichondrius,480,demonhunter,havoc,18,5,13
Soulrending,stormrage,480,demonhunter,havoc,18,5,13
Thedh,ragnaros,480,demonhunter,havoc,18,5,13
Breezoo,tichondrius,479,demonhunter,havoc,6,5,1
Pwnagextreme,area-52,479,demonhunter,havoc,6,5,1
Fliar,black-dragonflight,479,demonhunter,havoc,12,5,7
Bonebtwo,area-52,479,demonhunter,havoc,12,5,7
ßoobiemiles,area-52,479,demonhunter,havoc,12,5,7
Felvanora,amanthul,479,demonhunter,havoc,12,5,7
Hàuntress,saurfang,479,demonhunter,havoc,18,5,13
Kritik,goldrinn,478,demonhunter,havoc,12,5,7
Tdmturbo,zuluhed,478,demonhunter,havoc,12,5,7
Midnightlord,tichondrius,477,demonhunter,havoc,6,5,1
Devc,stormrage,477,demonhunter,havoc,12,5,7
Aliniron,illidan,477,demonhunter,havoc,12,5,7
Swansong,norgannon,476,demonhunter,havoc,12,5,7
Myname,aggramar,476,demonhunter,havoc,32,5,27
Mentoes,tichondrius,473,demonhunter,havoc,12,5,7
Leg,scilla,448,demonhunter,havoc,10,5,5
Fugabag,thrall,447,demonhunter,havoc,11,5,6
Raum,elune,443,demonhunter,havoc,8,6,2
Bogged,emerald-dream,432,demonhunter,havoc,9,5,4
Bituhvic,stormrage,431,demonhunter,havoc,11,5,6
Funky,draenor,420,demonhunter,havoc,22,8,14
Tygerion,emerald-dream,416,demonhunter,havoc,10,5,5
Wheredyougo,proudmoore,416,demonhunter,havoc,10,5,5
Bladezues,tichondrius,415,demonhunter,havoc,14,5,9
Blinddude,sargeras,415,demonhunter,havoc,14,5,9
Vessarin,madoran,415,demonhunter,havoc,14,5,9
Teenis,malygos,412,demonhunter,havoc,14,5,9
Akiirus,azralon,400,demonhunter,havoc,7,5,2
Darkrëaper,azralon,384,demonhunter,havoc,6,4,2
Omygaud,tichondrius,384,demonhunter,havoc,6,4,2
Kêrbydh,frostmourne,384,demonhunter,havoc,6,4,2
Spasmodiic,illidan,384,demonhunter,havoc,6,4,2
Blackblades,blackhand,384,demonhunter,havoc,6,4,2
Déörwine,quelthalas,384,demonhunter,havoc,6,4,2
Whudaz,tichondrius,384,demonhunter,havoc,6,4,2
Coa,nazjatar,384,demonhunter,havoc,6,4,2
Bigdingding,area-52,384,demonhunter,havoc,6,4,2
Florks,area-52,384,demonhunter,havoc,6,4,2
Deezhuntz,anvilmar,384,demonhunter,havoc,6,4,2
Cupernacus,tichondrius,384,demonhunter,havoc,6,4,2
Nihilist,kaelthas,384,demonhunter,havoc,6,4,2
Heygriffin,proudmoore,384,demonhunter,havoc,6,4,2
Uncleruckus,bloodscalp,384,demonhunter,havoc,6,4,2
Yågåmist,dalaran,384,demonhunter,havoc,6,4,2
Abakkio,kelthuzad,384,demonhunter,havoc,6,4,2
Cloudzzy,illidan,384,demonhunter,havoc,6,4,2
Tragedydh,sargeras,384,demonhunter,havoc,6,4,2
Intrusive,kelthuzad,384,demonhunter,havoc,6,4,2
Kasseater,stormrage,384,demonhunter,havoc,6,4,2
Slyblitz,bleeding-hollow,384,demonhunter,havoc,6,4,2
Tristanzx,sargeras,384,demonhunter,havoc,6,4,2
Hordesback,illidan,384,demonhunter,havoc,6,4,2
Doras,kelthuzad,384,demonhunter,havoc,6,4,2
Wogarg,sargeras,384,demonhunter,havoc,6,4,2
Dhworm,azralon,384,demonhunter,havoc,6,4,2
Jeeprcreeprs,sargeras,384,demonhunter,havoc,6,4,2
Bopersdh,drakkari,384,demonhunter,havoc,6,4,2
Hypetraindh,kelthuzad,384,demonhunter,havoc,6,4,2
Khaosx,ragnaros,384,demonhunter,havoc,6,4,2
Crankbaz,malganis,384,demonhunter,havoc,6,4,2
Verasu,kiljaeden,384,demonhunter,havoc,6,4,2
Ineptbb,frostmourne,384,demonhunter,havoc,6,4,2
Ãstoreth,quelthalas,384,demonhunter,havoc,6,4,2
Rizzle,malganis,384,demonhunter,havoc,6,4,2
Felshiv,azralon,384,demonhunter,havoc,6,4,2
Extínctíon,moon-guard,384,demonhunter,havoc,6,4,2
Diëgo,gallywix,384,demonhunter,havoc,6,4,2
Theownz,stormrage,384,demonhunter,havoc,6,4,2
Äòégämîñg,stormrage,384,demonhunter,havoc,6,4,2
Parabolicc,illidan,384,demonhunter,havoc,6,4,2
Nåxah,bleeding-hollow,384,demonhunter,havoc,8,4,4
Dkdakìng,thrall,384,demonhunter,havoc,12,4,8
Kruptikos,tichondrius,384,demonhunter,havoc,12,4,8
Zradda,zuljin,384,demonhunter,havoc,12,4,8
Vorlimornd,illidan,384,demonhunter,havoc,12,4,8
Misriah,sargeras,384,demonhunter,havoc,12,4,8
Fenthras,thrall,384,demonhunter,havoc,12,4,8
Dhibjorf,destromath,384,demonhunter,havoc,12,4,8
Zzatmikaze,area-52,384,demonhunter,havoc,12,4,8
Noliaclap,sargeras,384,demonhunter,havoc,12,4,8
Drîp,moon-guard,384,demonhunter,havoc,12,4,8
Contactfront,whisperwind,384,demonhunter,havoc,12,4,8
Allidox,tichondrius,384,demonhunter,havoc,12,4,8
Temporarý,bleeding-hollow,384,demonhunter,havoc,12,4,8
Separate,stormrage,384,demonhunter,havoc,12,4,8
Véñom,area-52,384,demonhunter,havoc,12,4,8
Namthar,quelthalas,384,demonhunter,havoc,12,4,8
Uchulu,quelthalas,384,demonhunter,havoc,12,4,8
Älönë,thrall,384,demonhunter,havoc,12,4,8
Reapersauce,illidan,384,demonhunter,havoc,12,4,8
Blackclóver,drakkari,384,demonhunter,havoc,12,4,8
Mikemyoffice,illidan,384,demonhunter,havoc,12,4,8
Heallscrean,drakkari,384,demonhunter,havoc,12,4,8
Mommafingers,illidan,384,demonhunter,havoc,12,4,8
Dhsoop,tichondrius,384,demonhunter,havoc,12,4,8
Croisoi,ragnaros,384,demonhunter,havoc,12,4,8
Maisus,illidan,384,demonhunter,havoc,12,4,8
Sathsong,tichondrius,384,demonhunter,havoc,12,4,8
Sektõr,dalaran,384,demonhunter,havoc,12,4,8
Zoomie,durotan,384,demonhunter,havoc,12,4,8
Rolecheck,tichondrius,384,demonhunter,havoc,12,4,8
Bättousai,kiljaeden,384,demonhunter,havoc,12,4,8
Fraxxured,proudmoore,384,demonhunter,havoc,12,4,8
Sinhful,darkspear,384,demonhunter,havoc,12,4,8
Alphatoo,area-52,384,demonhunter,havoc,15,4,11
Fuujiin,tol-barad,384,demonhunter,havoc,18,4,14
Roodblurz,zuljin,384,demonhunter,havoc,18,4,14
Mileze,area-52,384,demonhunter,havoc,24,4,20
Gretadumberg,area-52,383,demonhunter,havoc,6,4,2
Rarespawnjon,tichondrius,383,demonhunter,havoc,6,4,2
Severon,stormrage,383,demonhunter,havoc,6,4,2
Menadori,madoran,383,demonhunter,havoc,6,4,2
Demondrëad,lightbringer,383,demonhunter,havoc,9,5,4
Døffy,area-52,383,demonhunter,havoc,12,4,8
Themurderer,area-52,383,demonhunter,havoc,12,4,8
Vellinaris,zuljin,383,demonhunter,havoc,12,4,8
Darkweast,dalaran,383,demonhunter,havoc,12,4,8
Çherrii,moon-guard,382,demonhunter,havoc,6,4,2
Xiin,cenarion-circle,382,demonhunter,havoc,12,4,8
Saladuoduo,illidan,382,demonhunter,havoc,12,4,8
Anguloke,wyrmrest-accord,381,demonhunter,havoc,10,5,5
Bckzy,sargeras,381,demonhunter,havoc,12,4,8
Polunochnaya,area-52,352,demonhunter,havoc,16,4,12
Findoratoqc,darrowmere,351,demonhunter,havoc,11,4,7
Cassiedemonh,tichondrius,336,demonhunter,havoc,9,5,4
Xiruu,area-52,336,demonhunter,havoc,15,5,10
Deadlysin,dragonmaw,336,demonhunter,havoc,15,4,11
Fingerjamsx,area-52,335,demonhunter,havoc,11,4,7
Dearborn,frostmourne,330,demonhunter,havoc,16,5,11
Criyn,kelthuzad,330,demonhunter,havoc,17,5,12
Rivent,dethecus,319,demonhunter,havoc,14,4,10
Gibbz,wyrmrest-accord,304,demonhunter,havoc,11,5,6
Talsaris,drakthul,288,demonhunter,havoc,6,3,3
Eyesyk,bonechewer,288,demonhunter,havoc,6,3,3
Walluped,malganis,288,demonhunter,havoc,6,3,3
Thunderrbolt,illidan,288,demonhunter,havoc,6,3,3
Baikudyn,darkspear,288,demonhunter,havoc,6,3,3
Kunitsuna,thunderlord,288,demonhunter,havoc,6,3,3
Feldumper,illidan,288,demonhunter,havoc,6,3,3
Tink,kilrogg,288,demonhunter,havoc,6,3,3
Gnatman,skywall,288,demonhunter,havoc,6,3,3
Foodtruck,hellscream,288,demonhunter,havoc,6,3,3
Adycatt,illidan,288,demonhunter,havoc,6,3,3
Jibaiye,tichondrius,288,demonhunter,havoc,6,3,3
Kamakhasi,bleeding-hollow,288,demonhunter,havoc,6,3,3
Illipo,illidan,288,demonhunter,havoc,6,3,3
Tøwers,aegwynn,288,demonhunter,havoc,6,3,3
Pocahotnes,stormrage,288,demonhunter,havoc,6,3,3
Onií,bleeding-hollow,288,demonhunter,havoc,6,3,3
Zanaiahs,sargeras,288,demonhunter,havoc,6,3,3
Devirador,ragnaros,288,demonhunter,havoc,6,3,3
Sofedon,kargath,288,demonhunter,havoc,6,3,3
Smokahontas,eredar,288,demonhunter,havoc,6,3,3
Asukaxox,illidan,288,demonhunter,havoc,6,3,3
Fracxures,area-52,288,demonhunter,havoc,6,3,3
Bkeight,dalaran,288,demonhunter,havoc,6,3,3
Rauwèrs,azralon,288,demonhunter,havoc,6,3,3
Cassadega,sargeras,288,demonhunter,havoc,6,3,3
Demonfused,illidan,288,demonhunter,havoc,6,3,3
Zurg,wyrmrest-accord,288,demonhunter,havoc,6,3,3
Ziyutomioka,moon-guard,288,demonhunter,havoc,6,3,3
Shacco,bleeding-hollow,288,demonhunter,havoc,6,3,3
Zalenn,whisperwind,288,demonhunter,havoc,6,3,3
Cedicdh,illidan,288,demonhunter,havoc,6,3,3
Sxzure,frostmourne,288,demonhunter,havoc,6,3,3
Smallsuper,azralon,288,demonhunter,havoc,6,3,3
Xxsozin,skullcrusher,288,demonhunter,havoc,6,3,3
Touched,guldan,288,demonhunter,havoc,6,3,3
Vichopan,tichondrius,288,demonhunter,havoc,6,3,3
Felform,area-52,288,demonhunter,havoc,6,3,3
Treyydh,illidan,288,demonhunter,havoc,6,3,3
Mavrii,executus,288,demonhunter,havoc,6,3,3
Worldahmelee,illidan,288,demonhunter,havoc,6,3,3
Eyebeamtowin,stormrage,288,demonhunter,havoc,6,3,3
Gurthbrookz,tichondrius,288,demonhunter,havoc,6,3,3
Velerolas,area-52,288,demonhunter,havoc,6,3,3
Baka,grizzly-hills,288,demonhunter,havoc,6,3,3
Fleetop,tichondrius,288,demonhunter,havoc,6,3,3
Businessmaam,malganis,288,demonhunter,havoc,6,3,3
Cocomeld,tichondrius,288,demonhunter,havoc,6,3,3
Noóve,area-52,288,demonhunter,havoc,6,3,3
Rákdos,illidan,288,demonhunter,havoc,6,3,3
Kokushiibo,frostwolf,288,demonhunter,havoc,6,3,3
Totheglaive,sargeras,288,demonhunter,havoc,6,3,3
Wingsofhavoc,darkspear,288,demonhunter,havoc,6,3,3
Riodh,area-52,288,demonhunter,havoc,6,3,3
Dettlaff,sentinels,288,demonhunter,havoc,6,3,3
Ocão,azralon,288,demonhunter,havoc,6,3,3
Krendron,malganis,288,demonhunter,havoc,6,3,3
Darkstein,nathrezim,288,demonhunter,havoc,6,3,3
Rhynóe,illidan,288,demonhunter,havoc,6,3,3
Mèrlyn,sargeras,288,demonhunter,havoc,6,3,3
Feltini,whisperwind,288,demonhunter,havoc,6,3,3
Levail,wyrmrest-accord,288,demonhunter,havoc,6,3,3
Kylíejennêr,gilneas,288,demonhunter,havoc,6,3,3
Aslowbust,tichondrius,288,demonhunter,havoc,6,3,3
Ravack,stormrage,288,demonhunter,havoc,6,3,3
Demønical,dalaran,288,demonhunter,havoc,6,3,3
Khelt,dalaran,288,demonhunter,havoc,6,3,3
Dewkee,ghostlands,288,demonhunter,havoc,6,3,3
Goodrink,tichondrius,288,demonhunter,havoc,6,3,3
Arlequhin,ragnaros,288,demonhunter,havoc,6,3,3
Thelor,frostmourne,288,demonhunter,havoc,6,3,3
Celestez,kelthuzad,288,demonhunter,havoc,6,3,3
Slodeath,zuljin,288,demonhunter,havoc,6,3,3
Smokepurppx,zuljin,288,demonhunter,havoc,6,3,3
Bogdan,azjolnerub,288,demonhunter,havoc,6,3,3
Fellenkellar,stormrage,288,demonhunter,havoc,6,3,3
Namiisann,terenas,288,demonhunter,havoc,6,3,3
Blurblurblur,frostmourne,288,demonhunter,havoc,6,3,3
Fardyhole,illidan,288,demonhunter,havoc,6,3,3
Yedeme,tichondrius,288,demonhunter,havoc,6,3,3
Inva,stormrage,288,demonhunter,havoc,6,3,3
Orsova,area-52,288,demonhunter,havoc,6,3,3
Blingtrön,malganis,288,demonhunter,havoc,6,3,3
Darkterrôr,sargeras,288,demonhunter,havoc,9,4,5
Suyu,ragnaros,288,demonhunter,havoc,9,3,6
Dhuck,nemesis,288,demonhunter,havoc,15,4,11
Thrania,lothar,288,demonhunter,havoc,12,3,9
Kraky,nemesis,288,demonhunter,havoc,12,3,9
Çløûdïx,tichondrius,288,demonhunter,havoc,12,3,9
Zudo,amanthul,288,demonhunter,havoc,12,3,9
Trekt,blades-edge,288,demonhunter,havoc,12,3,9
Wotlkdh,area-52,288,demonhunter,havoc,12,3,9
Hemmerdainz,kelthuzad,288,demonhunter,havoc,12,3,9
Lawimmortal,tichondrius,288,demonhunter,havoc,12,3,9
Dirtyd,dragonmaw,288,demonhunter,havoc,12,3,9
Noztak,area-52,288,demonhunter,havoc,12,3,9
Roozi,tichondrius,288,demonhunter,havoc,12,3,9
Atriax,kelthuzad,288,demonhunter,havoc,12,3,9
Vwap,tichondrius,288,demonhunter,havoc,12,3,9
Dmfeetpics,dalaran,288,demonhunter,havoc,12,3,9
Mirante,illidan,288,demonhunter,havoc,12,3,9
Occula,moon-guard,288,demonhunter,havoc,12,3,9
Iluvboóty,blackrock,288,demonhunter,havoc,12,3,9
Elflerri,area-52,288,demonhunter,havoc,12,3,9
Denadiirx,area-52,288,demonhunter,havoc,12,3,9
Neverblurx,kirin-tor,288,demonhunter,havoc,12,3,9
Vellassa,stormscale,288,demonhunter,havoc,18,3,15
Lavantora,tichondrius,288,demonhunter,havoc,23,3,20
Magoroth,ragnaros,287,demonhunter,havoc,6,3,3
Haydet,stormrage,287,demonhunter,havoc,6,3,3
Eggandpotato,saurfang,287,demonhunter,havoc,6,3,3
Holescrewer,tichondrius,287,demonhunter,havoc,6,3,3
Devilina,khadgar,287,demonhunter,havoc,6,3,3
Slixxk,sargeras,287,demonhunter,havoc,9,4,5
Cheriste,malganis,287,demonhunter,havoc,14,4,10
Villoria,kul-tiras,287,demonhunter,havoc,12,3,9
Kellndore,emerald-dream,286,demonhunter,havoc,6,3,3
Syldaeya,silvermoon,285,demonhunter,havoc,10,5,5
Pekkora,illidan,284,demonhunter,havoc,12,3,9
Elrr,drakkari,255,demonhunter,havoc,11,3,8
Nikator,emerald-dream,255,demonhunter,havoc,11,3,8
Juantty,area-52,240,demonhunter,havoc,15,3,12
Vickyvette,illidan,239,demonhunter,havoc,5,3,2
Bushwacker,azralon,223,demonhunter,havoc,8,3,5
Onihunter,zangarmarsh,208,demonhunter,havoc,7,3,4
Cobra,quelthalas,208,demonhunter,havoc,7,3,4
Critxclutch,tichondrius,192,demonhunter,havoc,4,3,1
Syrendris,moon-guard,192,demonhunter,havoc,8,3,5
Cirillas,illidan,192,demonhunter,havoc,6,2,4
Badservice,frostwolf,192,demonhunter,havoc,6,2,4
Frino,steamwheedle-cartel,192,demonhunter,havoc,6,2,4
Xannaa,illidan,192,demonhunter,havoc,6,2,4
Arkynth,dalaran,192,demonhunter,havoc,6,2,4
Gyutaro,frostmourne,192,demonhunter,havoc,6,2,4
Dbljump,kiljaeden,192,demonhunter,havoc,6,2,4
Buhnana,stormscale,192,demonhunter,havoc,6,2,4
Sparklepunch,stormrage,192,demonhunter,havoc,6,2,4
Xanthrodril,illidan,192,demonhunter,havoc,6,2,4
Luana,stormscale,192,demonhunter,havoc,6,2,4
Rykko,borean-tundra,192,demonhunter,havoc,6,2,4
Metha,kiljaeden,192,demonhunter,havoc,6,2,4
Frøppy,illidan,192,demonhunter,havoc,6,2,4
Annmílls,quelthalas,192,demonhunter,havoc,6,2,4
Aleta,firetree,192,demonhunter,havoc,6,2,4
Demondubya,illidan,192,demonhunter,havoc,6,2,4
Sarithos,frostmourne,192,demonhunter,havoc,6,2,4
Pariah,saurfang,192,demonhunter,havoc,6,2,4
Yhell,darkspear,192,demonhunter,havoc,6,2,4
Falan,drakthul,192,demonhunter,havoc,6,2,4
Daso,the-forgotten-coast,192,demonhunter,havoc,6,2,4
Berquondh,tichondrius,192,demonhunter,havoc,6,2,4
Sodí,moon-guard,192,demonhunter,havoc,6,2,4
Azuki,lightbringer,192,demonhunter,havoc,6,2,4
Msbadass,demon-soul,192,demonhunter,havoc,6,2,4
Mäläk,zuluhed,192,demonhunter,havoc,6,2,4
Cocopapa,tichondrius,192,demonhunter,havoc,6,2,4
Denel,laughing-skull,192,demonhunter,havoc,6,2,4
Felmilk,demon-soul,192,demonhunter,havoc,6,2,4
Renoshan,wyrmrest-accord,192,demonhunter,havoc,6,2,4
Jadyne,frostmourne,192,demonhunter,havoc,6,2,4
Demonwaffle,draka,192,demonhunter,havoc,6,2,4
Pokoloko,twisting-nether,192,demonhunter,havoc,6,2,4
Margerie,bleeding-hollow,192,demonhunter,havoc,6,2,4
Blynx,destromath,192,demonhunter,havoc,6,2,4
Ratcnt,barthilas,192,demonhunter,havoc,6,2,4
Atsudadh,illidan,192,demonhunter,havoc,6,2,4
Ambitiòn,moon-guard,192,demonhunter,havoc,6,2,4
Billmurray,skullcrusher,192,demonhunter,havoc,6,2,4
Bleaster,malganis,192,demonhunter,havoc,6,2,4
Ausä,ragnaros,192,demonhunter,havoc,6,2,4
Gopump,area-52,192,demonhunter,havoc,6,2,4
Øxxy,azralon,192,demonhunter,havoc,6,2,4
Carlibeth,illidan,192,demonhunter,havoc,6,2,4
Renatha,ragnaros,192,demonhunter,havoc,6,2,4
Skol,andorhal,192,demonhunter,havoc,6,2,4
Freddiedread,bladefist,192,demonhunter,havoc,6,2,4
Daabsdh,thrall,192,demonhunter,havoc,6,2,4
Elaurenne,sargeras,192,demonhunter,havoc,6,2,4
Texts,norgannon,192,demonhunter,havoc,6,2,4
Daracu,aerie-peak,192,demonhunter,havoc,6,2,4
Swagidan,khaz-modan,192,demonhunter,havoc,6,2,4
Kraazi,thrall,192,demonhunter,havoc,6,2,4
Krador,wyrmrest-accord,192,demonhunter,havoc,6,2,4
Morgoph,burning-legion,192,demonhunter,havoc,6,2,4
Rorac,ragnaros,192,demonhunter,havoc,6,2,4
Hoagiedevil,moon-guard,192,demonhunter,havoc,6,2,4
Bastaghor,stormrage,192,demonhunter,havoc,6,2,4
Yukimes,frostmourne,192,demonhunter,havoc,6,2,4
Devilweef,whisperwind,192,demonhunter,havoc,6,2,4
Ossariss,moon-guard,192,demonhunter,havoc,6,2,4
Kayanson,azralon,192,demonhunter,havoc,6,2,4
Itachiix,sargeras,192,demonhunter,havoc,6,2,4
Rrochy,tichondrius,192,demonhunter,havoc,6,2,4
Ragath,bonechewer,192,demonhunter,havoc,6,2,4
Imagoon,sargeras,192,demonhunter,havoc,6,2,4
Lilyanie,stormrage,192,demonhunter,havoc,6,2,4
Lillidanss,the-forgotten-coast,192,demonhunter,havoc,6,2,4
Phoébé,drakkari,192,demonhunter,havoc,6,2,4
Cordianx,area-52,192,demonhunter,havoc,6,2,4
Zethh,drakkari,192,demonhunter,havoc,6,2,4
Wartornx,tichondrius,192,demonhunter,havoc,6,2,4
Wreckforce,blades-edge,192,demonhunter,havoc,6,2,4
Reflexin,tichondrius,192,demonhunter,havoc,6,2,4
Cryolite,sargeras,192,demonhunter,havoc,6,2,4
Dirtydone,area-52,192,demonhunter,havoc,6,2,4
Ivexia,blackrock,192,demonhunter,havoc,6,2,4
Slaymore,sargeras,192,demonhunter,havoc,6,2,4
Demonichoov,thrall,192,demonhunter,havoc,6,2,4
Illimare,tichondrius,192,demonhunter,havoc,6,2,4
Jozeez,emerald-dream,192,demonhunter,havoc,6,2,4
Lilvetis,thrall,192,demonhunter,havoc,6,2,4
Showaitie,thrall,192,demonhunter,havoc,6,2,4
Wowomg,tichondrius,192,demonhunter,havoc,6,2,4
Hávok,sargeras,192,demonhunter,havoc,7,2,5
Qlmm,stormrage,192,demonhunter,havoc,7,2,5
Tiristra,cenarion-circle,192,demonhunter,havoc,8,2,6
Proserpinâ,bleeding-hollow,192,demonhunter,havoc,12,2,10
Hollownight,area-52,192,demonhunter,havoc,12,2,10
Intensìve,illidan,192,demonhunter,havoc,12,2,10
Halaena,moon-guard,192,demonhunter,havoc,12,2,10
Beastforlife,sargeras,192,demonhunter,havoc,12,2,10
Daeth,skullcrusher,192,demonhunter,havoc,12,2,10
Âduka,illidan,192,demonhunter,havoc,12,2,10
Illidunk,tichondrius,192,demonhunter,havoc,12,2,10
Kushz,dalaran,192,demonhunter,havoc,12,2,10
Catastroz,ragnaros,192,demonhunter,havoc,12,2,10
Sadpepe,bleeding-hollow,192,demonhunter,havoc,12,2,10
Kyska,tichondrius,192,demonhunter,havoc,12,2,10
Asharian,wyrmrest-accord,192,demonhunter,havoc,12,2,10
Amdusias,darkspear,192,demonhunter,havoc,12,2,10
Rewyle,magtheridon,192,demonhunter,havoc,12,2,10
Spacéphoenix,stormrage,192,demonhunter,havoc,12,2,10
Hueylucifer,ravencrest,192,demonhunter,havoc,12,2,10
Dannaris,maelstrom,191,demonhunter,havoc,6,2,4
Abusedchild,dalaran,191,demonhunter,havoc,6,2,4
Psythe,undermine,191,demonhunter,havoc,6,2,4
Tarasam,burning-blade,191,demonhunter,havoc,12,2,10
Demonci,stormrage,190,demonhunter,havoc,4,3,1
Feilixx,moon-guard,190,demonhunter,havoc,12,2,10
Ryoga,malganis,159,demonhunter,havoc,5,2,3
Refused,nesingwary,138,demonhunter,havoc,11,4,7
Shanjara,sargeras,138,demonhunter,havoc,15,3,12
Xeil,zuljin,128,demonhunter,havoc,4,2,2
Kümï,quelthalas,96,demonhunter,havoc,3,2,1
Frenchtoast,bonechewer,96,demonhunter,havoc,6,1,5
Dhrongor,drakkari,96,demonhunter,havoc,6,1,5
Emodan,moon-guard,96,demonhunter,havoc,6,1,5
Thedhdream,frostmourne,96,demonhunter,havoc,6,1,5
Terpenese,chogall,96,demonhunter,havoc,6,1,5
Jhinskui,drakkari,96,demonhunter,havoc,6,1,5
Cidolem,area-52,96,demonhunter,havoc,6,1,5
Negraxo,ragnaros,96,demonhunter,havoc,6,1,5
Memslaw,tichondrius,96,demonhunter,havoc,6,1,5
Scarolol,malganis,96,demonhunter,havoc,6,1,5
Ellguindh,malganis,96,demonhunter,havoc,6,1,5
Roat,malganis,96,demonhunter,havoc,6,1,5
Bümb,moon-guard,96,demonhunter,havoc,6,1,5
Devî,ragnaros,96,demonhunter,havoc,6,1,5
Finnanutt,tichondrius,96,demonhunter,havoc,6,1,5
Treblig,nerzhul,96,demonhunter,havoc,6,1,5
Wubloadz,bleeding-hollow,96,demonhunter,havoc,6,1,5
Izruul,tichondrius,96,demonhunter,havoc,6,1,5
Deadopps,tichondrius,96,demonhunter,havoc,6,1,5
Safikins,tichondrius,96,demonhunter,havoc,6,1,5
Elillidan,emerald-dream,96,demonhunter,havoc,6,1,5
Skylinetime,sargeras,96,demonhunter,havoc,6,1,5
Ðemonhunterx,frostmourne,96,demonhunter,havoc,6,1,5
Constantwood,sargeras,96,demonhunter,havoc,6,1,5
Mazïkeen,uther,96,demonhunter,havoc,6,1,5
Lauriale,moon-guard,96,demonhunter,havoc,6,1,5
Pupariuh,illidan,96,demonhunter,havoc,6,1,5
Jerry,emerald-dream,96,demonhunter,havoc,6,1,5
Esøteric,area-52,96,demonhunter,havoc,6,1,5
Vëngêåncé,tichondrius,96,demonhunter,havoc,6,1,5
Denathrion,moon-guard,96,demonhunter,havoc,6,1,5
Demonleàf,area-52,96,demonhunter,havoc,6,1,5
Irìs,blood-furnace,96,demonhunter,havoc,6,1,5
Nightsatan,stormrage,96,demonhunter,havoc,6,1,5
Hausecat,aegwynn,96,demonhunter,havoc,6,1,5
Thêworld,azralon,96,demonhunter,havoc,6,1,5
Chris,nordrassil,96,demonhunter,havoc,6,1,5
Siegfridemon,ragnaros,96,demonhunter,havoc,6,1,5
Majindemon,dragonmaw,96,demonhunter,havoc,6,1,5
Icanmove,area-52,96,demonhunter,havoc,6,1,5
Painqtxo,area-52,96,demonhunter,havoc,6,1,5
Sternhunt,khadgar,96,demonhunter,havoc,6,1,5
Eibizoudh,sargeras,96,demonhunter,havoc,6,1,5
Chirøn,darkspear,96,demonhunter,havoc,6,1,5
Gil,moonrunner,96,demonhunter,havoc,6,1,5
Theysuffer,scilla,96,demonhunter,havoc,6,1,5
Boatsnhoze,tichondrius,96,demonhunter,havoc,6,1,5
Itsplague,tichondrius,96,demonhunter,havoc,6,1,5
Glaivee,dalaran,96,demonhunter,havoc,6,1,5
Demønvil,onyxia,96,demonhunter,havoc,6,1,5
Ðemonix,tichondrius,96,demonhunter,havoc,6,1,5
Mythundorn,burning-blade,96,demonhunter,havoc,6,1,5
Angelawhite,illidan,96,demonhunter,havoc,6,1,5
Cantreborn,destromath,96,demonhunter,havoc,6,1,5
Chad,anvilmar,96,demonhunter,havoc,6,1,5
Slycerr,illidan,96,demonhunter,havoc,6,1,5
Chakan,burning-legion,96,demonhunter,havoc,6,1,5
Sado,proudmoore,96,demonhunter,havoc,6,1,5
Carrîôn,tichondrius,96,demonhunter,havoc,6,1,5
Gosrend,durotan,96,demonhunter,havoc,7,1,6
Lantherin,sargeras,96,demonhunter,havoc,11,1,10
Moonsocks,proudmoore,96,demonhunter,havoc,12,1,11
Gnocchis,thrall,96,demonhunter,havoc,12,1,11
Vespherie,moon-guard,84,demonhunter,havoc,8,5,3
Miskiiv,malganis,79,demonhunter,havoc,5,1,4
Fellchapo,illidan,79,demonhunter,havoc,5,1,4
Zetsuwaffles,area-52,79,demonhunter,havoc,5,1,4
Demonbluntzz,tichondrius,79,demonhunter,havoc,11,1,10
Mcthiccyy,moon-guard,64,demonhunter,havoc,4,1,3
Hundredeye,malganis,64,demonhunter,havoc,4,1,3
Shadevon,wyrmrest-accord,64,demonhunter,havoc,4,1,3
Hiddenblade,coilfang,63,demonhunter,havoc,2,2,0
Quoates,dalaran,48,demonhunter,havoc,3,1,2
Raptorjèsus,azjolnerub,48,demonhunter,havoc,3,1,2
Unjust,darkspear,48,demonhunter,havoc,3,1,2
Aryía,stormrage,48,demonhunter,havoc,3,1,2
Xaryic,stormrage,42,demonhunter,havoc,16,5,11
Kryzthed,drakkari,42,demonhunter,havoc,7,2,5
Worcraf,ragnaros,42,demonhunter,havoc,8,2,6
Aríes,dreadmaul,31,demonhunter,havoc,2,1,1
Pooterjuice,shadowmoon,31,demonhunter,havoc,2,1,1
Mördredd,quelthalas,16,demonhunter,havoc,1,1,0
Lathazar,darkspear,16,demonhunter,havoc,1,1,0
Iwasright,stonemaul,1488,demonhunter,vengeance,72,35,37
Slippedinfel,tichondrius,1333,demonhunter,vengeance,41,19,22
Jersey,proudmoore,1091,demonhunter,vengeance,29,17,12
Agricornia,tichondrius,475,demonhunter,vengeance,12,5,7
Irisand,ragnaros,288,demonhunter,vengeance,6,3,3
Ferano,frostmourne,288,demonhunter,vengeance,6,3,3
Çherrii,moon-guard,286,demonhunter,vengeance,6,3,3
Tilltheend,illidan,239,demonhunter,vengeance,5,3,2
Asderel,zuljin,192,demonhunter,vengeance,6,2,4
Shiningvenus,stormrage,192,demonhunter,vengeance,12,2,10
Meliødaz,ragnaros,192,demonhunter,vengeance,12,2,10
Daymanhunter,bleeding-hollow,96,demonhunter,vengeance,6,1,5
Foodtruck,hellscream,96,demonhunter,vengeance,6,1,5
Aleymar,tichondrius,96,demonhunter,vengeance,6,1,5
Grovetenderx,tichondrius,2238,druid,restoration,86,53,33
Kobaishome,tichondrius,2148,druid,restoration,119,70,49
Flóp,dalaran,2141,druid,restoration,78,43,35
Linful,tichondrius,2141,druid,restoration,179,92,87
Omkin,tichondrius,2137,druid,restoration,120,62,58
Liangpibro,illidan,2123,druid,restoration,85,54,31
Renner,zuljin,2122,druid,restoration,103,51,52
Bestrun,tichondrius,2116,druid,restoration,108,58,50
Couragé,ragnaros,2108,druid,restoration,135,68,67
Andrwceo,stormrage,2104,druid,restoration,60,37,23
Angrygochux,tichondrius,2065,druid,restoration,131,67,64
Vers,dathremar,2037,druid,restoration,90,43,47
Shaylyne,moonrunner,2026,druid,restoration,69,41,28
Dannycarry,tichondrius,2025,druid,restoration,59,32,27
Racialmotive,illidan,2000,druid,restoration,123,70,53
Rorae,tichondrius,2000,druid,restoration,167,85,82
Hchls,tichondrius,1996,druid,restoration,140,71,69
Taiwanzz,tichondrius,1994,druid,restoration,79,40,39
Taaienberg,sargeras,1963,druid,restoration,60,32,28
Pornkkimi,tichondrius,1952,druid,restoration,48,29,19
Plorenz,zuljin,1952,druid,restoration,89,51,38
Mengniulol,tichondrius,1940,druid,restoration,132,75,57
Flowen,spinebreaker,1940,druid,restoration,78,39,39
Sanlunainiu,tichondrius,1935,druid,restoration,172,77,95
Tizzyy,eredar,1921,druid,restoration,78,43,35
Szwlol,tichondrius,1920,druid,restoration,274,144,130
Shiftýx,tichondrius,1905,druid,restoration,77,38,39
Brenden,area-52,1891,druid,restoration,138,68,70
Dancesdru,area-52,1888,druid,restoration,36,20,16
Davidqx,zuljin,1882,druid,restoration,42,30,12
Saxhouse,illidan,1881,druid,restoration,60,34,26
Nikdruidne,tichondrius,1881,druid,restoration,60,29,31
Darkenëd,dalaran,1880,druid,restoration,68,41,27
Oinkme,kiljaeden,1879,druid,restoration,66,33,33
Lenya,bleeding-hollow,1877,druid,restoration,69,38,31
Eddí,illidan,1872,druid,restoration,64,32,32
Xijinfing,tichondrius,1870,druid,restoration,42,25,17
Rindy,rexxar,1869,druid,restoration,72,37,35
Ksz,stormrage,1867,druid,restoration,42,25,17
Lotiononmyd,illidan,1860,druid,restoration,153,85,68
Guqingshuang,tichondrius,1855,druid,restoration,73,35,38
Bexdru,area-52,1850,druid,restoration,284,151,133
Psam,emerald-dream,1848,druid,restoration,53,29,24
Rèmix,bleeding-hollow,1847,druid,restoration,42,23,19
Qdeb,akama,1844,druid,restoration,48,27,21
Vesoween,tichondrius,1843,druid,restoration,55,37,18
Creamcow,tichondrius,1843,druid,restoration,52,28,24
Esque,stormrage,1842,druid,restoration,48,24,24
Tokesh,malganis,1840,druid,restoration,72,33,39
Mimidelol,tichondrius,1839,druid,restoration,66,36,30
Gluesmoka,icecrown,1836,druid,restoration,54,31,23
Gankstanerdz,tichondrius,1835,druid,restoration,113,55,58
Reehz,stormrage,1834,druid,restoration,53,25,28
Leafowl,tichondrius,1830,druid,restoration,42,25,17
Bodytwisting,tichondrius,1828,druid,restoration,48,29,19
Pvpgold,illidan,1827,druid,restoration,71,39,32
Rerolldr,firetree,1826,druid,restoration,42,24,18
Germlol,sargeras,1825,druid,restoration,51,30,21
Heymeow,tichondrius,1825,druid,restoration,60,24,36
Brendenjr,area-52,1819,druid,restoration,45,32,13
Jegara,auchindoun,1818,druid,restoration,149,81,68
Currants,lightbringer,1815,druid,restoration,132,61,71
Tunnaris,ragnaros,1811,druid,restoration,71,33,38
Kenái,nemesis,1810,druid,restoration,30,19,11
Hlchs,tichondrius,1810,druid,restoration,36,22,14
Corcovado,bleeding-hollow,1809,druid,restoration,66,31,35
Clameo,barthilas,1808,druid,restoration,84,38,46
Aljalladtv,bleeding-hollow,1805,druid,restoration,30,19,11
Yggdrasil,ravencrest,1805,druid,restoration,65,31,34
Kayorva,gurubashi,1804,druid,restoration,47,24,23
Playstyle,stormrage,1801,druid,restoration,49,25,24
Nayko,sargeras,1801,druid,restoration,72,30,42
Ivý,shadowsong,1800,druid,restoration,41,28,13
Mengyu,tichondrius,1800,druid,restoration,64,41,23
Héisénbérg,sargeras,1800,druid,restoration,81,44,37
Reizzy,sargeras,1793,druid,restoration,72,35,37
Holydruid,tichondrius,1780,druid,restoration,54,27,27
Ekr,tichondrius,1779,druid,restoration,54,29,25
Jdown,dalaran,1772,druid,restoration,76,43,33
Geddoff,stormrage,1770,druid,restoration,111,51,60
Kruisberg,sargeras,1769,druid,restoration,29,19,10
Maen,kelthuzad,1764,druid,restoration,58,26,32
Treenleaves,stormrage,1762,druid,restoration,418,216,202
Sùlyvahn,tichondrius,1761,druid,restoration,57,30,27
Tweeguy,malganis,1761,druid,restoration,60,24,36
Gsex,nemesis,1760,druid,restoration,40,22,18
Bashthecat,tichondrius,1749,druid,restoration,40,26,14
Facegotrake,stormrage,1748,druid,restoration,78,47,31
Sanitizer,tichondrius,1740,druid,restoration,48,27,21
Corbind,arthas,1739,druid,restoration,203,104,99
Surefacts,dathremar,1738,druid,restoration,40,21,19
Branchmanagr,dark-iron,1736,druid,restoration,54,23,31
Janzak,thrall,1735,druid,restoration,36,20,16
Airmeodaddy,barthilas,1730,druid,restoration,44,24,20
Fattdiabetic,tichondrius,1726,druid,restoration,42,24,18
Spiritot,tichondrius,1724,druid,restoration,42,22,20
Jbdontplay,sargeras,1722,druid,restoration,41,28,13
Thundercast,quelthalas,1722,druid,restoration,110,57,53
Dirtdog,uther,1719,druid,restoration,53,25,28
Ymy,tichondrius,1716,druid,restoration,36,21,15
Drjelly,tichondrius,1707,druid,restoration,76,32,44
Thasta,blackrock,1706,druid,restoration,104,56,48
Druuná,kiljaeden,1701,druid,restoration,45,19,26
Hideurkidz,tichondrius,1699,druid,restoration,39,23,16
Pizzatimex,zuluhed,1698,druid,restoration,72,38,34
Dmxx,kiljaeden,1696,druid,restoration,33,19,14
Remus,hydraxis,1696,druid,restoration,48,23,25
Badtree,tichondrius,1693,druid,restoration,68,40,28
Socialyst,area-52,1688,druid,restoration,35,21,14
Gotheels,illidan,1685,druid,restoration,29,18,11
Cienza,proudmoore,1678,druid,restoration,108,57,51
Dabloleu,illidan,1675,druid,restoration,24,19,5
Roen,tichondrius,1672,druid,restoration,40,21,19
Boonsogan,tichondrius,1672,druid,restoration,36,18,18
Meruemoo,tichondrius,1670,druid,restoration,285,150,135
Kwd,stormrage,1666,druid,restoration,53,35,18
Aryawilliams,area-52,1666,druid,restoration,35,18,17
Ellystarry,stormrage,1666,druid,restoration,48,24,24
Flowdruid,tichondrius,1664,druid,restoration,36,18,18
Legitonedge,zuljin,1662,druid,restoration,55,30,25
Moldragon,crushridge,1662,druid,restoration,42,19,23
Soreze,kelthuzad,1661,druid,restoration,38,25,13
Bramii,illidan,1657,druid,restoration,51,28,23
Anaps,frostmourne,1656,druid,restoration,42,25,17
Naturae,spirestone,1655,druid,restoration,106,57,49
Zoteqt,kelthuzad,1653,druid,restoration,36,21,15
Addiedru,zuljin,1650,druid,restoration,45,23,22
Druidstin,tichondrius,1649,druid,restoration,162,84,78
Defteras,illidan,1647,druid,restoration,42,21,21
Dkfm,thrall,1643,druid,restoration,319,172,147
Animalge,sargeras,1643,druid,restoration,60,25,35
Woshiyigede,frostmourne,1642,druid,restoration,66,29,37
Dendrix,area-52,1641,druid,restoration,90,46,44
Boomtastik,frostmourne,1639,druid,restoration,54,22,32
Images,kilrogg,1638,druid,restoration,54,37,17
Birdfromtree,dalaran,1636,druid,restoration,48,26,22
Pootyleaf,daggerspine,1636,druid,restoration,60,28,32
Relbedo,sargeras,1635,druid,restoration,132,72,60
Errane,eonar,1634,druid,restoration,147,85,62
Légz,area-52,1634,druid,restoration,94,49,45
Luckyslot,frostmourne,1631,druid,restoration,36,21,15
Dexlol,area-52,1629,druid,restoration,18,17,1
Pawsbutton,stormrage,1629,druid,restoration,30,20,10
Acdru,tichondrius,1624,druid,restoration,54,26,28
Wolfis,malganis,1622,druid,restoration,36,20,16
Lifeboomer,ragnaros,1621,druid,restoration,37,26,11
Notpodruida,tichondrius,1621,druid,restoration,36,21,15
Chevy,onyxia,1619,druid,restoration,66,23,43
Kaperij,sargeras,1617,druid,restoration,30,17,13
Asmitar,illidan,1616,druid,restoration,36,22,14
Muhu,frostmourne,1615,druid,restoration,60,35,25
Shinjis,tichondrius,1615,druid,restoration,36,18,18
Gødriç,tichondrius,1614,druid,restoration,221,112,109
Huaxià,tichondrius,1613,druid,restoration,89,50,39
Zyhsul,emerald-dream,1613,druid,restoration,56,28,28
Gulperberg,sargeras,1612,druid,restoration,30,25,5
Hxm,tichondrius,1611,druid,restoration,35,17,18
Møøncry,ragnaros,1611,druid,restoration,70,33,37
Hideurchickn,tichondrius,1609,druid,restoration,36,23,13
Fhiziod,kelthuzad,1606,druid,restoration,74,44,30
Cheddy,tichondrius,1606,druid,restoration,65,36,29
Druinin,archimonde,1606,druid,restoration,50,23,27
Tayriel,area-52,1606,druid,restoration,42,19,23
Jathy,area-52,1606,druid,restoration,51,21,30
Kurrious,frostmourne,1605,druid,restoration,40,18,22
Yavannita,quelthalas,1600,druid,restoration,57,36,21
Commercii,tichondrius,1600,druid,restoration,36,19,17
Lobsterdruid,area-52,1599,druid,restoration,30,20,10
Manycyclones,zuluhed,1598,druid,restoration,60,32,28
Gonimydear,proudmoore,1598,druid,restoration,138,70,68
Erral,malganis,1597,druid,restoration,57,26,31
Kaleaky,thrall,1595,druid,restoration,99,53,46
Tondrai,malganis,1593,druid,restoration,30,17,13
Sixthsex,tichondrius,1593,druid,restoration,83,43,40
Hdruid,tichondrius,1592,druid,restoration,55,31,24
Qidzerker,arathor,1589,druid,restoration,46,24,22
Poscow,tichondrius,1583,druid,restoration,45,25,20
Methyld,frostmourne,1574,druid,restoration,90,36,54
Nerfthedruid,blackrock,1569,druid,restoration,36,25,11
Rizzit,wyrmrest-accord,1568,druid,restoration,173,97,76
Ursiiday,sargeras,1568,druid,restoration,48,20,28
Duragx,bleeding-hollow,1567,druid,restoration,100,62,38
Douwantoplay,tichondrius,1567,druid,restoration,36,19,17
Arwëna,tichondrius,1566,druid,restoration,60,34,26
Breaksilence,tichondrius,1563,druid,restoration,29,18,11
Druxe,zuljin,1560,druid,restoration,45,19,26
Zyzzema,frostmourne,1559,druid,restoration,174,82,92
Sooey,wyrmrest-accord,1555,druid,restoration,42,23,19
Poscod,tichondrius,1552,druid,restoration,48,22,26
Hayase,tichondrius,1551,druid,restoration,42,25,17
Gunnymad,tichondrius,1549,druid,restoration,36,21,15
Aberdare,tichondrius,1546,druid,restoration,58,37,21
Psyqobloom,dalaran,1546,druid,restoration,58,33,25
Dbk,suramar,1545,druid,restoration,108,67,41
Silentbeer,frostmourne,1545,druid,restoration,144,72,72
Bedlam,zuljin,1544,druid,restoration,60,25,35
Moonyy,emerald-dream,1542,druid,restoration,42,20,22
Lubbeck,stormrage,1538,druid,restoration,98,53,45
Riiccflaiir,stormrage,1535,druid,restoration,51,29,22
Hravan,dentarg,1534,druid,restoration,49,26,23
Nikotser,dreadmaul,1531,druid,restoration,39,18,21
Shapedance,sargeras,1530,druid,restoration,60,27,33
Classydruid,spinebreaker,1527,druid,restoration,170,90,80
Terkpla,ragnaros,1525,druid,restoration,71,37,34
Mortqt,tichondrius,1524,druid,restoration,96,44,52
Lilbigcow,gnomeregan,1515,druid,restoration,176,77,99
Widescreen,burning-blade,1509,druid,restoration,209,109,100
Meniscus,arthas,1506,druid,restoration,53,19,34
Kimnim,tichondrius,1500,druid,restoration,106,57,49
Redpigo,tichondrius,1497,druid,restoration,36,18,18
Pëndulum,illidan,1497,druid,restoration,66,29,37
Soheezy,illidan,1496,druid,restoration,54,33,21
Morphiq,tichondrius,1493,druid,restoration,123,63,60
Akeven,illidan,1491,druid,restoration,68,31,37
Poliage,moon-guard,1489,druid,restoration,99,44,55
Sarrati,emerald-dream,1488,druid,restoration,158,81,77
Durintor,nemesis,1487,druid,restoration,48,22,26
Rowlex,moon-guard,1483,druid,restoration,22,17,5
Selling,moon-guard,1476,druid,restoration,60,27,33
Growl,jubeithos,1476,druid,restoration,48,19,29
Lutein,tichondrius,1474,druid,restoration,77,31,46
Sxlanderx,malganis,1468,druid,restoration,111,57,54
Cndistance,tichondrius,1467,druid,restoration,71,34,37
Bobx,kelthuzad,1467,druid,restoration,66,26,40
Unpeelable,stormrage,1460,druid,restoration,24,16,8
Drazibaz,thrall,1460,druid,restoration,36,23,13
Volktots,bleeding-hollow,1459,druid,restoration,60,34,26
Elliar,akama,1459,druid,restoration,72,35,37
Xhoz,tichondrius,1458,druid,restoration,172,94,78
Staraborn,stormrage,1458,druid,restoration,249,135,114
Faramar,sargeras,1456,druid,restoration,35,16,19
Berzz,frostmourne,1455,druid,restoration,217,105,112
Cutely,tichondrius,1452,druid,restoration,153,77,76
Verkara,stormrage,1452,druid,restoration,76,35,41
Meepø,mugthol,1451,druid,restoration,103,56,47
Busanmilk,tichondrius,1445,druid,restoration,60,29,31
Rikishi,executus,1441,druid,restoration,46,24,22
Rwi,tichondrius,1439,druid,restoration,90,46,44
Prevail,nazgrel,1438,druid,restoration,60,34,26
Lauramavra,azralon,1437,druid,restoration,222,118,104
Clubroot,sargeras,1437,druid,restoration,42,17,25
Drøgbä,tichondrius,1436,druid,restoration,24,15,9
Jonnygg,illidan,1433,druid,restoration,36,15,21
Vuru,azralon,1432,druid,restoration,72,33,39
Zrobloom,stormrage,1432,druid,restoration,36,15,21
Eviltwín,frostmourne,1431,druid,restoration,36,20,16
Swiftydel,frostmourne,1431,druid,restoration,46,24,22
Sakpase,area-52,1428,druid,restoration,30,15,15
Daku,moknathal,1427,druid,restoration,46,25,21
Strokingmyd,illidan,1427,druid,restoration,63,31,32
Hyne,emerald-dream,1425,druid,restoration,114,62,52
Horymory,darkspear,1423,druid,restoration,96,51,45
Approx,tichondrius,1419,druid,restoration,127,59,68
Lucked,tichondrius,1415,druid,restoration,24,15,9
Vakimumu,anubarak,1414,druid,restoration,66,30,36
Komaner,frostmourne,1414,druid,restoration,48,21,27
Kaerrort,sargeras,1412,druid,restoration,26,15,11
Shirô,bleeding-hollow,1412,druid,restoration,57,30,27
Seamandeman,sargeras,1403,druid,restoration,56,27,29
Grimo,illidan,1402,druid,restoration,24,15,9
Bruujz,moon-guard,1402,druid,restoration,36,22,14
Biggucci,stonemaul,1399,druid,restoration,30,18,12
Caipirinha,tichondrius,1399,druid,restoration,29,15,14
Cyclone,mugthol,1396,druid,restoration,24,19,5
Leleoceo,azralon,1396,druid,restoration,24,15,9
Haymade,sargeras,1396,druid,restoration,78,36,42
Seizuressld,stormrage,1395,druid,restoration,81,46,35
Greylyth,moon-guard,1392,druid,restoration,42,18,24
Evokade,dalaran,1390,druid,restoration,24,15,9
Venomgtz,laughing-skull,1389,druid,restoration,111,58,53
Kuwä,proudmoore,1385,druid,restoration,100,51,49
Nanniel,tichondrius,1383,druid,restoration,54,24,30
Icastsmells,tichondrius,1381,druid,restoration,57,36,21
Rlzdruid,tichondrius,1380,druid,restoration,36,15,21
Okiesmokied,proudmoore,1378,druid,restoration,30,17,13
Hehaw,kelthuzad,1376,druid,restoration,55,30,25
Maaui,sargeras,1374,druid,restoration,48,24,24
Farmageddon,thunderhorn,1372,druid,restoration,44,27,17
Yoshí,emerald-dream,1372,druid,restoration,45,22,23
Oobuck,kilrogg,1371,druid,restoration,75,41,34
Azshunara,moon-guard,1369,druid,restoration,84,43,41
Deamondruidz,kaelthas,1367,druid,restoration,78,31,47
Lorern,eldrethalas,1363,druid,restoration,42,20,22
Edraen,zuljin,1362,druid,restoration,137,67,70
Vondutch,tichondrius,1362,druid,restoration,60,24,36
Santiagowski,ragnaros,1359,druid,restoration,46,23,23
Shifftycent,trollbane,1359,druid,restoration,54,26,28
Amandi,magtheridon,1358,druid,restoration,36,20,16
Kergai,emerald-dream,1355,druid,restoration,102,53,49
Onblue,tichondrius,1347,druid,restoration,38,22,16
Jimjab,stormreaver,1346,druid,restoration,60,35,25
Melbian,tichondrius,1345,druid,restoration,118,69,49
Treelomilo,stormrage,1345,druid,restoration,61,34,27
Delody,tichondrius,1343,druid,restoration,38,23,15
Bemelerberg,sargeras,1343,druid,restoration,24,14,10
Rbavny,tichondrius,1342,druid,restoration,24,14,10
Groschats,area-52,1339,druid,restoration,42,14,28
Ripberg,chogall,1338,druid,restoration,30,14,16
Cznfik,area-52,1338,druid,restoration,78,32,46
Eraticdruid,illidan,1338,druid,restoration,42,16,26
Lusam,korialstrasz,1337,druid,restoration,28,15,13
Doglightning,illidan,1336,druid,restoration,25,15,10
Dsheeps,tichondrius,1336,druid,restoration,30,14,16
Klamediya,illidan,1336,druid,restoration,36,14,22
Binionsolboy,illidan,1333,druid,restoration,30,14,16
Nestaballo,illidan,1332,druid,restoration,111,58,53
Anchunlol,tichondrius,1332,druid,restoration,36,18,18
Mudpi,illidan,1332,druid,restoration,71,34,37
Kevarcen,dalaran,1331,druid,restoration,42,20,22
Izzabelle,deathwing,1330,druid,restoration,25,16,9
Girthture,tichondrius,1330,druid,restoration,130,63,67
Pilcosbie,stormrage,1327,druid,restoration,24,14,10
Hynz,barthilas,1327,druid,restoration,36,15,21
Joopsy,tichondrius,1321,druid,restoration,130,71,59
Youngteezy,barthilas,1319,druid,restoration,142,53,89
Petmydeadcow,illidan,1317,druid,restoration,115,56,59
Zelyvia,moon-guard,1313,druid,restoration,24,14,10
Freehealjob,lightnings-blade,1313,druid,restoration,30,14,16
Kzinti,zuluhed,1312,druid,restoration,30,14,16
Donnà,tichondrius,1310,druid,restoration,43,21,22
Arkenix,velen,1307,druid,restoration,30,14,16
Ghirox,stormrage,1306,druid,restoration,54,26,28
Skotty,hyjal,1306,druid,restoration,48,23,25
Gaawdx,illidan,1303,druid,restoration,54,25,29
Purpleleaves,stormrage,1299,druid,restoration,119,51,68
Airmíd,illidan,1299,druid,restoration,48,16,32
Aaughh,sargeras,1297,druid,restoration,70,33,37
Minokawa,kargath,1296,druid,restoration,29,15,14
Gladelf,sargeras,1295,druid,restoration,212,106,106
Badferal,blackhand,1295,druid,restoration,51,25,26
Plagiarist,stormrage,1295,druid,restoration,44,20,24
Nxghtfall,tichondrius,1294,druid,restoration,116,61,55
Caustìk,malganis,1291,druid,restoration,70,38,32
Aiyouyou,tichondrius,1291,druid,restoration,76,39,37
Haneulso,tichondrius,1290,druid,restoration,55,30,25
Standee,sargeras,1290,druid,restoration,48,18,30
Magicrock,moon-guard,1285,druid,restoration,42,23,19
Apoxi,arygos,1284,druid,restoration,42,24,18
Ananan,burning-blade,1282,druid,restoration,101,49,52
Rawbacon,blackrock,1281,druid,restoration,40,15,25
Lünaä,quelthalas,1280,druid,restoration,30,24,6
Nogàrd,arygos,1279,druid,restoration,23,14,9
Amatxu,ragnaros,1278,druid,restoration,102,52,50
Zambyr,azralon,1278,druid,restoration,66,28,38
Entydruid,khazgoroth,1276,druid,restoration,29,17,12
Morphios,barthilas,1274,druid,restoration,54,25,29
Silit,tichondrius,1273,druid,restoration,39,18,21
Thericebags,illidan,1272,druid,restoration,161,86,75
Utterhots,bleeding-hollow,1270,druid,restoration,49,24,25
Dimzim,lightbringer,1269,druid,restoration,60,31,29
Odcerberus,azralon,1267,druid,restoration,36,18,18
Tallenzz,lightninghoof,1265,druid,restoration,96,53,43
Slév,frostmourne,1263,druid,restoration,35,17,18
Ourse,frostmourne,1260,druid,restoration,23,14,9
Nanate,sargeras,1259,druid,restoration,47,24,23
Lindi,kelthuzad,1257,druid,restoration,78,42,36
Greenvibes,drakkari,1256,druid,restoration,47,28,19
Kerrzo,frostmourne,1256,druid,restoration,36,17,19
Afonso,frostmourne,1254,druid,restoration,38,19,19
Rockmeifucan,greymane,1253,druid,restoration,78,33,45
Katherine,moon-guard,1251,druid,restoration,132,62,70
Romcom,demon-soul,1250,druid,restoration,48,27,21
Jacknit,illidan,1250,druid,restoration,28,15,13
Phåtkid,darkspear,1250,druid,restoration,36,15,21
Druidnim,tichondrius,1249,druid,restoration,48,15,33
Haohomie,tichondrius,1248,druid,restoration,35,17,18
Ninzor,tichondrius,1247,druid,restoration,30,13,17
Ziegey,tichondrius,1246,druid,restoration,24,13,11
Jonculler,korgath,1246,druid,restoration,54,26,28
Torofarmeon,quelthalas,1243,druid,restoration,51,30,21
Goosebümps,stormrage,1242,druid,restoration,24,13,11
Healingcute,tichondrius,1239,druid,restoration,131,70,61
Kybecruz,stormrage,1239,druid,restoration,42,16,26
Feldstarx,stormrage,1238,druid,restoration,24,13,11
Shanê,proudmoore,1238,druid,restoration,55,27,28
Kyndel,kiljaeden,1237,druid,restoration,44,22,22
Travys,sargeras,1235,druid,restoration,36,16,20
Veganz,moon-guard,1233,druid,restoration,145,71,74
Anotherstar,frostmourne,1233,druid,restoration,48,18,30
Svarne,kiljaeden,1232,druid,restoration,59,29,30
Groõt,barthilas,1232,druid,restoration,99,42,57
Whispurrz,tichondrius,1231,druid,restoration,129,70,59
Shekelsnätch,area-52,1231,druid,restoration,42,21,21
Smilax,eonar,1231,druid,restoration,71,29,42
Slev,frostmourne,1229,druid,restoration,24,13,11
Imakitty,aerie-peak,1226,druid,restoration,121,62,59
Carneluna,area-52,1226,druid,restoration,66,31,35
Wildwhisper,moon-guard,1225,druid,restoration,96,50,46
Yellowstone,drakthul,1222,druid,restoration,42,23,19
Hotemz,dragonmaw,1222,druid,restoration,24,13,11
Speaks,moon-guard,1222,druid,restoration,71,29,42
Anothersalad,stormrage,1221,druid,restoration,66,32,34
Beladrexx,stormrage,1221,druid,restoration,54,21,33
Gorillagloo,area-52,1219,druid,restoration,61,30,31
Druidkingdk,stormrage,1218,druid,restoration,29,18,11
Dokasaurus,lightbringer,1218,druid,restoration,30,13,17
Ännä,moon-guard,1217,druid,restoration,30,13,17
Ulfaren,frostmourne,1209,druid,restoration,24,15,9
Gryel,area-52,1209,druid,restoration,197,103,94
Pyrogenics,whisperwind,1209,druid,restoration,42,20,22
Tìssuebox,malganis,1207,druid,restoration,75,32,43
Suye,tichondrius,1206,druid,restoration,60,26,34
Tuskdaddie,sargeras,1204,druid,restoration,30,17,13
Meôwmix,stormrage,1202,druid,restoration,24,13,11
Cuddles,moon-guard,1201,druid,restoration,137,67,70
Driftwood,bonechewer,1201,druid,restoration,64,27,37
Bikacat,kelthuzad,1200,druid,restoration,24,13,11
Longisland,quelthalas,1199,druid,restoration,78,38,40
Gokki,zuljin,1197,druid,restoration,22,14,8
Yakuho,proudmoore,1195,druid,restoration,26,16,10
Nugren,thrall,1195,druid,restoration,50,22,28
Dolanaar,stormrage,1193,druid,restoration,50,27,23
Dobidas,tichondrius,1192,druid,restoration,42,23,19
Sweetcorn,malganis,1192,druid,restoration,40,16,24
Gossìpgoat,frostmourne,1191,druid,restoration,80,38,42
Bäñgarang,tichondrius,1190,druid,restoration,36,20,16
Knowgo,tichondrius,1188,druid,restoration,54,28,26
Ahylen,quelthalas,1188,druid,restoration,48,22,26
Adarindre,aerie-peak,1185,druid,restoration,93,46,47
Pawpurrazzi,moon-guard,1183,druid,restoration,17,13,4
Valeñtine,dalaran,1179,druid,restoration,78,39,39
Tworax,frostmourne,1179,druid,restoration,30,13,17
Hruke,illidan,1173,druid,restoration,42,17,25
Dankcentral,frostwolf,1171,druid,restoration,76,41,35
Schlotzsky,skullcrusher,1171,druid,restoration,69,37,32
Mf,stormscale,1171,druid,restoration,30,14,16
Vantorsydmel,proudmoore,1167,druid,restoration,46,24,22
Matpd,norgannon,1165,druid,restoration,124,61,63
Elylaylalar,moon-guard,1164,druid,restoration,42,19,23
Kamisamalee,tichondrius,1163,druid,restoration,17,13,4
Lenori,vashj,1159,druid,restoration,48,24,24
Smhyle,frostmourne,1158,druid,restoration,41,21,20
Kasannaommi,sargeras,1157,druid,restoration,42,22,20
Sinseir,stormscale,1157,druid,restoration,70,28,42
Alphalemon,ragnaros,1156,druid,restoration,51,25,26
Darksteak,tichondrius,1156,druid,restoration,87,41,46
Toslick,kelthuzad,1156,druid,restoration,80,36,44
Ayadel,moon-guard,1155,druid,restoration,101,48,53
Doah,kelthuzad,1152,druid,restoration,24,12,12
Rekelberg,sargeras,1151,druid,restoration,18,12,6
Ayalia,saurfang,1151,druid,restoration,18,12,6
Beecammy,frostmourne,1151,druid,restoration,54,31,23
Floofi,kelthuzad,1151,druid,restoration,24,12,12
Kobrah,twisting-nether,1151,druid,restoration,24,12,12
Würzel,nemesis,1150,druid,restoration,78,39,39
Concordya,tichondrius,1149,druid,restoration,59,29,30
Enrÿu,nemesis,1149,druid,restoration,30,12,18
Mommymilkers,jubeithos,1149,druid,restoration,54,14,40
Æpex,lightnings-blade,1148,druid,restoration,30,16,14
Dchizzle,tichondrius,1147,druid,restoration,45,20,25
Skibbidy,boulderfist,1145,druid,restoration,33,14,19
Iambeefy,hyjal,1144,druid,restoration,159,75,84
Fatshift,chogall,1141,druid,restoration,102,51,51
Tyrs,aggramar,1140,druid,restoration,35,15,20
Jijunss,tichondrius,1137,druid,restoration,23,13,10
Junglefists,frostmourne,1137,druid,restoration,84,40,44
Samerax,vashj,1137,druid,restoration,89,41,48
Layala,sargeras,1137,druid,restoration,42,18,24
Miyeonly,dalaran,1137,druid,restoration,36,12,24
Joya,stormrage,1136,druid,restoration,18,12,6
Glenkair,lightnings-blade,1134,druid,restoration,36,17,19
Pumma,darkspear,1134,druid,restoration,28,13,15
Catlypso,tichondrius,1129,druid,restoration,66,40,26
Foxbear,garona,1127,druid,restoration,51,33,18
Cowtox,moon-guard,1127,druid,restoration,45,21,24
Sloptoucher,barthilas,1126,druid,restoration,24,12,12
Bigherbo,zuljin,1124,druid,restoration,41,18,23
Iheartpvp,tichondrius,1121,druid,restoration,48,21,27
Hotkage,tichondrius,1120,druid,restoration,18,12,6
Höneyfang,moon-guard,1120,druid,restoration,35,23,12
Hðthead,area-52,1118,druid,restoration,54,26,28
Rhatir,stormrage,1115,druid,restoration,65,25,40
Jruids,stormrage,1111,druid,restoration,36,12,24
Clawriander,barthilas,1110,druid,restoration,71,37,34
Dainehoof,area-52,1110,druid,restoration,39,14,25
Katdog,warsong,1109,druid,restoration,33,22,11
Löthnälar,ragnaros,1109,druid,restoration,48,24,24
Chowyunfats,proudmoore,1106,druid,restoration,301,155,146
Müfasä,azralon,1106,druid,restoration,54,25,29
Maddoxi,stormrage,1106,druid,restoration,30,12,18
Sharinna,andorhal,1106,druid,restoration,38,14,24
Furfu,illidan,1104,druid,restoration,74,33,41
Tensuen,boulderfist,1101,druid,restoration,36,13,23
Lizzelune,drakkari,1097,druid,restoration,24,12,12
Skymund,tichondrius,1095,druid,restoration,38,19,19
Jabina,detheroc,1093,druid,restoration,54,16,38
Mcriblet,illidan,1091,druid,restoration,24,12,12
Barugaf,drakkari,1090,druid,restoration,49,28,21
Carekoala,wyrmrest-accord,1090,druid,restoration,53,27,26
Kittne,hellscream,1089,druid,restoration,48,24,24
Cear,proudmoore,1087,druid,restoration,30,12,18
Volgoro,thrall,1078,druid,restoration,54,22,32
Vollzar,sargeras,1072,druid,restoration,38,14,24
Slleep,tichondrius,1069,druid,restoration,48,25,23
Baduret,dalaran,1067,druid,restoration,19,12,7
Gimborion,stormrage,1066,druid,restoration,48,23,25
Nöches,quelthalas,1065,druid,restoration,32,12,20
Macdonah,tichondrius,1064,druid,restoration,18,13,5
Buffalobillz,lethon,1062,druid,restoration,40,25,15
Creamjr,tichondrius,1056,druid,restoration,18,11,7
Bobd,proudmoore,1056,druid,restoration,18,11,7
Chinadruids,tichondrius,1056,druid,restoration,18,11,7
Bigtimers,illidan,1056,druid,restoration,24,11,13
Whhm,burning-blade,1056,druid,restoration,24,11,13
Udoyu,barthilas,1056,druid,restoration,24,11,13
Slurpi,barthilas,1056,druid,restoration,30,11,19
Vecuronium,tichondrius,1055,druid,restoration,18,11,7
Hoeba,tichondrius,1055,druid,restoration,18,11,7
Goodhealer,akama,1054,druid,restoration,42,26,16
Manzar,illidan,1054,druid,restoration,18,11,7
Lutzenberger,nemesis,1054,druid,restoration,47,20,27
Careless,destromath,1053,druid,restoration,66,27,39
Kitnip,proudmoore,1052,druid,restoration,24,16,8
Côunsyl,silvermoon,1052,druid,restoration,18,11,7
Áçxpërt,jubeithos,1052,druid,restoration,18,11,7
Israh,malygos,1052,druid,restoration,26,15,11
Yorch,stormrage,1052,druid,restoration,60,28,32
Undaunted,bloodhoof,1051,druid,restoration,24,11,13
Solisuu,frostmane,1051,druid,restoration,30,11,19
Cres,moon-guard,1051,druid,restoration,42,11,31
Agranock,nazgrel,1050,druid,restoration,52,26,26
Phxburn,illidan,1050,druid,restoration,30,11,19
Eredorn,darkspear,1049,druid,restoration,24,18,6
Quarantinia,arathor,1049,druid,restoration,36,20,16
Sodury,tichondrius,1049,druid,restoration,48,25,23
Aarandiel,borean-tundra,1048,druid,restoration,18,12,6
Dinglebops,stormrage,1047,druid,restoration,28,15,13
Cratose,runetotem,1047,druid,restoration,41,17,24
Yimii,stormrage,1046,druid,restoration,18,11,7
Diglit,malganis,1046,druid,restoration,28,12,16
Dorzaku,ragnaros,1045,druid,restoration,47,27,20
Zadayos,aerie-peak,1044,druid,restoration,30,16,14
Druilicious,ghostlands,1043,druid,restoration,55,27,28
Mielo,illidan,1042,druid,restoration,76,38,38
Feaveldin,moon-guard,1041,druid,restoration,18,11,7
Jimmycooks,tichondrius,1039,druid,restoration,18,11,7
Beefcurtâins,aggramar,1032,druid,restoration,18,11,7
Fionnbharr,ragnaros,1031,druid,restoration,76,35,41
Delicioso,wyrmrest-accord,1030,druid,restoration,33,21,12
Janaki,malygos,1024,druid,restoration,30,13,17
Imcop,tichondrius,1020,druid,restoration,18,11,7
Burdup,tichondrius,1020,druid,restoration,18,11,7
Troply,ragnaros,1020,druid,restoration,20,12,8
Funnydruid,frostmourne,1020,druid,restoration,42,20,22
Xarressian,moon-guard,1019,druid,restoration,24,11,13
Sonrius,proudmoore,1017,druid,restoration,52,25,27
Feanah,tichondrius,1017,druid,restoration,26,12,14
Nachopuppet,kelthuzad,1017,druid,restoration,45,20,25
Astharon,drakkari,1015,druid,restoration,50,29,21
Sunneater,azuremyst,1008,druid,restoration,36,17,19
Rivetrix,azralon,1007,druid,restoration,103,49,54
Duducows,tichondrius,1007,druid,restoration,35,12,23
Xzerhos,area-52,1004,druid,restoration,141,67,74
Keladria,bleeding-hollow,1002,druid,restoration,102,55,47
Guron,aegwynn,1001,druid,restoration,57,30,27
Pmsprone,tichondrius,1001,druid,restoration,66,30,36
Yeahhots,frostmourne,1000,druid,restoration,15,12,3
Mainera,sargeras,1000,druid,restoration,26,12,14
Bethemarble,sargeras,996,druid,restoration,29,16,13
Alfurr,tichondrius,994,druid,restoration,85,43,42
Canche,arthas,986,druid,restoration,34,19,15
Feralgød,tichondrius,985,druid,restoration,30,11,19
Treewik,emerald-dream,981,druid,restoration,85,48,37
Lawlz,aegwynn,976,druid,restoration,30,16,14
Santicow,ragnaros,975,druid,restoration,20,11,9
Duxz,tichondrius,968,druid,restoration,17,11,6
Boomshorts,blackrock,968,druid,restoration,29,14,15
Wiggle,stormscale,962,druid,restoration,44,21,23
Salzadruid,aggramar,960,druid,restoration,12,10,2
Baruc,illidan,960,druid,restoration,12,10,2
Jiywa,lightbringer,960,druid,restoration,18,10,8
Aphroditezs,tichondrius,960,druid,restoration,18,10,8
Smeekq,tichondrius,960,druid,restoration,24,10,14
Dolwizz,tichondrius,959,druid,restoration,18,10,8
Garbagebutt,burning-legion,959,druid,restoration,18,10,8
Hoonjojjyanx,tichondrius,959,druid,restoration,18,10,8
Oblackbetty,illidan,959,druid,restoration,39,18,21
Blueclàssxx,akama,958,druid,restoration,12,10,2
Lissette,thrall,958,druid,restoration,18,10,8
Uggadruid,malganis,958,druid,restoration,18,10,8
Magzally,stormrage,958,druid,restoration,24,10,14
Simina,kargath,957,druid,restoration,18,10,8
Chenxguang,tichondrius,957,druid,restoration,42,22,20
Lovenug,shadowsong,957,druid,restoration,24,10,14
Cranbérry,sargeras,956,druid,restoration,18,10,8
Ñoobdruid,tichondrius,956,druid,restoration,18,10,8
Vêzpêr,kelthuzad,956,druid,restoration,24,10,14
Lorca,stormrage,955,druid,restoration,12,10,2
Iheartmushu,mannoroth,955,druid,restoration,85,45,40
Chopleaf,khadgar,953,druid,restoration,114,56,58
Pronewb,frostmourne,952,druid,restoration,12,10,2
Trolbearpig,malganis,952,druid,restoration,18,10,8
Dietmilk,sargeras,952,druid,restoration,24,11,13
Bovindickus,tichondrius,952,druid,restoration,24,10,14
Barecow,tichondrius,952,druid,restoration,24,10,14
Däll,tichondrius,952,druid,restoration,24,10,14
Erisya,moon-guard,951,druid,restoration,18,10,8
Fortnitburgr,tichondrius,951,druid,restoration,18,10,8
Wintarz,sargeras,951,druid,restoration,30,10,20
Honeymead,wyrmrest-accord,950,druid,restoration,65,36,29
Hpcorrection,bleeding-hollow,946,druid,restoration,18,10,8
Yourka,uther,946,druid,restoration,29,15,14
Sneakysoren,kelthuzad,944,druid,restoration,24,10,14
Fatjoints,tichondrius,943,druid,restoration,60,21,39
Maxobviously,stormrage,942,druid,restoration,18,10,8
Devilsparda,frostmane,942,druid,restoration,24,10,14
Jethelium,illidan,941,druid,restoration,112,59,53
Kg,cenarion-circle,941,druid,restoration,28,13,15
Tyrantha,emerald-dream,941,druid,restoration,24,10,14
Shiftaholic,azgalor,940,druid,restoration,33,17,16
Drucaicer,quelthalas,939,druid,restoration,71,38,33
Seceru,proudmoore,938,druid,restoration,52,26,26
Bindudream,frostmane,938,druid,restoration,66,30,36
Kataless,sargeras,936,druid,restoration,71,37,34
Saltyzz,tichondrius,935,druid,restoration,24,10,14
Idoldeoz,quelthalas,933,druid,restoration,24,10,14
Killari,malganis,926,druid,restoration,24,12,12
Dhannar,proudmoore,924,druid,restoration,12,10,2
Cloudbreaker,duskwood,923,druid,restoration,18,10,8
Moolan,bleeding-hollow,919,druid,restoration,32,15,17
Lazypandas,silvermoon,914,druid,restoration,41,17,24
Kymopexy,sargeras,905,druid,restoration,35,12,23
Diaks,proudmoore,900,druid,restoration,24,12,12
Merawr,area-52,896,druid,restoration,22,10,12
Hentaiboom,kiljaeden,893,druid,restoration,36,16,20
Dwalk,moknathal,893,druid,restoration,42,15,27
Vengaul,amanthul,892,druid,restoration,24,10,14
Lâvazza,tichondrius,890,druid,restoration,28,10,18
Midníght,drakkari,880,druid,restoration,34,18,16
Wp,proudmoore,880,druid,restoration,22,10,12
Bunrÿl,thorium-brotherhood,874,druid,restoration,54,24,30
Augus,hyjal,870,druid,restoration,33,11,22
Theboy,dalaran,869,druid,restoration,48,15,33
Duo,demon-soul,864,druid,restoration,12,9,3
Spikeleaf,tichondrius,864,druid,restoration,12,9,3
Bopplejr,tichondrius,864,druid,restoration,12,9,3
Bridgerén,tichondrius,864,druid,restoration,12,9,3
Justforgame,sargeras,864,druid,restoration,12,9,3
Restokinaja,dreadmaul,864,druid,restoration,12,9,3
Hellshifterr,tichondrius,864,druid,restoration,18,9,9
Ppb,illidan,864,druid,restoration,18,9,9
Mmrborrower,icecrown,864,druid,restoration,18,9,9
Fruitberry,malganis,864,druid,restoration,30,9,21
Zhn,sargeras,863,druid,restoration,12,9,3
Ooh,stormreaver,863,druid,restoration,12,9,3
Naturenugget,tichondrius,863,druid,restoration,12,9,3
Rejuvenation,kaelthas,863,druid,restoration,12,9,3
Ilovejuli,illidan,863,druid,restoration,12,9,3
Canek,ghostlands,863,druid,restoration,18,9,9
Vernaar,laughing-skull,863,druid,restoration,18,9,9
Canitöuchit,tichondrius,863,druid,restoration,24,9,15
Guss,mannoroth,863,druid,restoration,24,9,15
Tugginudders,illidan,863,druid,restoration,30,9,21
Jentzull,tichondrius,862,druid,restoration,12,9,3
Shuffleqlol,stormrage,862,druid,restoration,12,9,3
Pawsh,tichondrius,862,druid,restoration,12,9,3
Chocoo,thaurissan,862,druid,restoration,18,9,9
Sorrinn,tichondrius,862,druid,restoration,18,9,9
Dummedruid,illidan,862,druid,restoration,24,9,15
Monkeyxo,kelthuzad,861,druid,restoration,18,9,9
Alindrä,moon-guard,861,druid,restoration,18,9,9
Stetile,azralon,859,druid,restoration,18,9,9
Sorio,area-52,858,druid,restoration,28,10,18
Judwen,grizzly-hills,857,druid,restoration,42,14,28
Malice,undermine,854,druid,restoration,24,9,15
Faroo,azralon,854,druid,restoration,24,9,15
Guerrillera,khadgar,849,druid,restoration,79,31,48
Drexldrood,cenarius,847,druid,restoration,12,9,3
Kanadae,thrall,846,druid,restoration,24,9,15
Uwupollo,ragnaros,846,druid,restoration,42,13,29
Katochi,area-52,844,druid,restoration,40,19,21
Draycø,tichondrius,841,druid,restoration,18,9,9
Fronkysilva,illidan,838,druid,restoration,48,19,29
Kittyz,wyrmrest-accord,817,druid,restoration,18,9,9
Worgbearpig,destromath,814,druid,restoration,17,9,8
Elauria,stormreaver,804,druid,restoration,42,17,25
Xxuan,tichondrius,803,druid,restoration,62,16,46
Gypsysoul,barthilas,798,druid,restoration,17,9,8
Mcy,nerzhul,798,druid,restoration,20,9,11
Cannabull,echo-isles,794,druid,restoration,21,10,11
Sweetgreen,blackrock,783,druid,restoration,11,9,2
Redharp,proudmoore,776,druid,restoration,43,17,26
Solbinn,nordrassil,771,druid,restoration,54,16,38
Chinadruides,tichondrius,768,druid,restoration,12,8,4
Hoebaz,tichondrius,768,druid,restoration,12,8,4
Ppbdru,tichondrius,768,druid,restoration,12,8,4
Albafic,illidan,768,druid,restoration,12,8,4
Ppm,illidan,768,druid,restoration,12,8,4
Bobxd,kelthuzad,768,druid,restoration,12,8,4
Quss,tichondrius,768,druid,restoration,12,8,4
Gotheelsx,illidan,768,druid,restoration,12,8,4
Restobaby,tichondrius,768,druid,restoration,18,8,10
Polyester,frostmourne,768,druid,restoration,18,8,10
Taledra,stormrage,768,druid,restoration,18,8,10
Înfamous,thrall,767,druid,restoration,12,8,4
Alend,alexstrasza,767,druid,restoration,12,8,4
Maeo,drenden,767,druid,restoration,12,8,4
Sarojna,malganis,767,druid,restoration,12,8,4
Mxlasthope,stormrage,767,druid,restoration,12,8,4
Thetakeout,tichondrius,767,druid,restoration,18,8,10
Waxedchest,emerald-dream,767,druid,restoration,18,8,10
Lifebloomlol,area-52,767,druid,restoration,18,8,10
Hughcockman,tichondrius,766,druid,restoration,12,8,4
Ohhshiift,tichondrius,766,druid,restoration,18,8,10
Wildsïde,tichondrius,766,druid,restoration,18,8,10
Hedwíg,ragnaros,766,druid,restoration,24,8,16
Louisvuittón,area-52,765,druid,restoration,12,8,4
Dmanrepus,sargeras,765,druid,restoration,12,8,4
Imnotinhuman,tichondrius,765,druid,restoration,12,8,4
Guybranch,illidan,765,druid,restoration,24,8,16
Slee,eredar,764,druid,restoration,12,8,4
Leatherpig,proudmoore,764,druid,restoration,18,8,10
Aurajin,spinebreaker,764,druid,restoration,24,8,16
Needabandaid,arthas,764,druid,restoration,24,8,16
Studioghibli,bleeding-hollow,762,druid,restoration,12,8,4
Panacaea,windrunner,762,druid,restoration,12,8,4
Atalìa,moon-guard,762,druid,restoration,18,8,10
Blitzÿ,lothar,761,druid,restoration,12,8,4
Markóla,stormrage,761,druid,restoration,18,8,10
Lunkz,tichondrius,760,druid,restoration,24,8,16
Rairven,stormrage,757,druid,restoration,42,8,34
Rhondarootsy,zuljin,756,druid,restoration,18,8,10
Marrana,altar-of-storms,754,druid,restoration,12,8,4
Friarpuck,nerzhul,747,druid,restoration,12,8,4
Dragondruid,dawnbringer,742,druid,restoration,35,9,26
Stamynn,kelthuzad,738,druid,restoration,85,25,60
Ekj,tichondrius,735,druid,restoration,14,9,5
Akanx,tichondrius,735,druid,restoration,16,9,7
Dypx,tichondrius,735,druid,restoration,22,8,14
Elvishchamp,mugthol,733,druid,restoration,17,9,8
Ojdidnt,bleeding-hollow,720,druid,restoration,15,9,6
Rdruidchump,the-forgotten-coast,719,druid,restoration,15,9,6
Xîstance,barthilas,717,druid,restoration,23,8,15
Felinedreams,sargeras,714,druid,restoration,14,9,5
Zoeyx,tichondrius,712,druid,restoration,13,9,4
Madsewerslvt,stormrage,707,druid,restoration,19,9,10
Whiskeyblues,ursin,706,druid,restoration,24,8,16
Zephiee,kelthuzad,692,druid,restoration,23,8,15
Sharkhotzlol,frostmourne,688,druid,restoration,19,8,11
Gromdruid,azralon,683,druid,restoration,54,26,28
Importedalc,zuljin,678,druid,restoration,36,8,28
Yungdoinkski,icecrown,672,druid,restoration,12,7,5
Cameltail,kelthuzad,672,druid,restoration,12,7,5
Redo,zuluhed,672,druid,restoration,12,7,5
Motate,malganis,672,druid,restoration,12,7,5
Skitzo,akama,672,druid,restoration,12,7,5
Treesh,kelthuzad,672,druid,restoration,12,7,5
Hmoobforshoz,wildhammer,672,druid,restoration,12,7,5
Puzzlebox,illidan,672,druid,restoration,12,7,5
Esqueue,stormrage,672,druid,restoration,12,7,5
Bigdockepoch,sargeras,672,druid,restoration,12,7,5
Ddi,frostmourne,672,druid,restoration,12,7,5
Toketree,sargeras,672,druid,restoration,12,7,5
Tmdogwater,sargeras,672,druid,restoration,12,7,5
Razberriesz,stormrage,672,druid,restoration,12,7,5
Treeofangels,nathrezim,672,druid,restoration,12,7,5
Spicyx,moon-guard,672,druid,restoration,12,7,5
Bigmoran,tichondrius,672,druid,restoration,12,7,5
Crusch,shattered-halls,672,druid,restoration,12,7,5
Dotsbots,barthilas,672,druid,restoration,18,7,11
Zblmystic,tichondrius,672,druid,restoration,18,7,11
Suekey,frostmourne,672,druid,restoration,18,7,11
Calimei,bladefist,672,druid,restoration,18,7,11
Rapttors,zuljin,672,druid,restoration,18,7,11
Wùúkìí,bleeding-hollow,672,druid,restoration,24,7,17
Feykurds,sargeras,671,druid,restoration,12,7,5
Tigranesia,proudmoore,671,druid,restoration,12,7,5
Hugharection,illidan,671,druid,restoration,12,7,5
Heniuhojia,tichondrius,671,druid,restoration,12,7,5
Chixao,tichondrius,671,druid,restoration,12,7,5
Iâmkyle,darkspear,671,druid,restoration,12,7,5
Zthatchx,shadowmoon,671,druid,restoration,12,7,5
Wildarumqt,tichondrius,671,druid,restoration,18,7,11
Boomchí,tichondrius,671,druid,restoration,18,7,11
Lexut,ragnaros,671,druid,restoration,18,7,11
Fryy,balnazzar,671,druid,restoration,18,7,11
Sêxcavator,thrall,671,druid,restoration,18,7,11
Lilgee,kelthuzad,671,druid,restoration,18,7,11
Tickman,altar-of-storms,671,druid,restoration,18,7,11
Hellahots,spinebreaker,670,druid,restoration,12,7,5
Erykk,dalaran,670,druid,restoration,12,7,5
Flexxfurion,thrall,670,druid,restoration,18,7,11
Wreckked,sargeras,670,druid,restoration,18,7,11
Frave,dentarg,670,druid,restoration,24,7,17
Hotpocketz,kiljaeden,670,druid,restoration,28,8,20
Dipset,khadgar,670,druid,restoration,30,7,23
Martymoo,bleeding-hollow,670,druid,restoration,30,7,23
Dylonomancer,tichondrius,669,druid,restoration,12,7,5
Nayelina,stormrage,669,druid,restoration,12,7,5
Battiatus,malganis,669,druid,restoration,18,7,11
Maggiee,arthas,669,druid,restoration,24,7,17
Shiftyy,nordrassil,668,druid,restoration,19,7,12
Esyiix,tichondrius,668,druid,restoration,24,7,17
Mïms,area-52,667,druid,restoration,12,7,5
Mydira,stormrage,666,druid,restoration,12,7,5
Gentlesoapp,blackrock,665,druid,restoration,18,7,11
Fovoss,dalaran,663,druid,restoration,12,7,5
Madambuku,thrall,663,druid,restoration,12,7,5
Tiufill,nemesis,659,druid,restoration,12,7,5
Hewozuoai,area-52,654,druid,restoration,17,7,10
Ikova,frostmourne,650,druid,restoration,18,7,11
Gotdruid,sargeras,639,druid,restoration,14,8,6
Riddickd,malfurion,639,druid,restoration,14,8,6
Kellogs,malganis,639,druid,restoration,17,7,10
Warmkitteh,kiljaeden,639,druid,restoration,17,7,10
Breathe,ysera,639,druid,restoration,28,7,21
Wolfelord,sargeras,624,druid,restoration,21,7,14
Rígo,frostmourne,622,druid,restoration,15,8,7
Puntcounder,sargeras,616,druid,restoration,12,8,4
Midoriiro,dentarg,612,druid,restoration,25,8,17
Milkz,zuljin,607,druid,restoration,26,7,19
Treesonn,kelthuzad,584,druid,restoration,11,7,4
Xiaoyi,tichondrius,576,druid,restoration,6,6,0
Overthink,daggerspine,576,druid,restoration,6,6,0
Ordono,emerald-dream,576,druid,restoration,6,6,0
Chinadruidss,tichondrius,576,druid,restoration,12,6,6
Tlanquility,tichondrius,576,druid,restoration,12,6,6
Krunks,frostmourne,576,druid,restoration,12,6,6
Xingyejingmi,tichondrius,576,druid,restoration,12,6,6
Torbock,zuljin,576,druid,restoration,12,6,6
Madowl,tichondrius,576,druid,restoration,12,6,6
Kurohîme,illidan,576,druid,restoration,12,6,6
Afkifuthrow,ysera,576,druid,restoration,12,6,6
Daddypompum,tichondrius,576,druid,restoration,12,6,6
Furrytorpedo,tichondrius,576,druid,restoration,12,6,6
Gemo,tichondrius,576,druid,restoration,12,6,6
Cheddastov,illidan,576,druid,restoration,12,6,6
Nomilk,illidan,576,druid,restoration,12,6,6
Sawajirii,tichondrius,576,druid,restoration,12,6,6
Smeekqtwo,tichondrius,576,druid,restoration,12,6,6
Moonpaws,frostmourne,576,druid,restoration,12,6,6
Disembles,illidan,576,druid,restoration,12,6,6
Dirtydrood,mugthol,576,druid,restoration,12,6,6
Nhin,ghostlands,576,druid,restoration,12,6,6
Asaphelps,stormrage,576,druid,restoration,12,6,6
Admoney,sargeras,576,druid,restoration,12,6,6
Larryjones,alleria,576,druid,restoration,12,6,6
Gìtgoodtrash,frostmourne,576,druid,restoration,12,6,6
Bobobear,proudmoore,576,druid,restoration,12,6,6
Acerolita,azralon,576,druid,restoration,12,6,6
Bearys,area-52,576,druid,restoration,12,6,6
Naturenugget,sargeras,576,druid,restoration,12,6,6
Forèst,sargeras,576,druid,restoration,12,6,6
Nodeathz,sargeras,576,druid,restoration,12,6,6
Kronik,jubeithos,576,druid,restoration,18,6,12
Kuaite,azralon,576,druid,restoration,18,6,12
Momorabbitd,tichondrius,576,druid,restoration,18,6,12
Opim,sargeras,576,druid,restoration,18,6,12
Hawtyforever,tichondrius,576,druid,restoration,18,6,12
Suublime,ragnaros,576,druid,restoration,18,6,12
Lolomas,proudmoore,576,druid,restoration,18,6,12
Nerglet,aerie-peak,576,druid,restoration,24,6,18
Hottietottie,laughing-skull,576,druid,restoration,24,6,18
Naturemagic,malganis,575,druid,restoration,6,6,0
Brandonxerox,tichondrius,575,druid,restoration,12,6,6
Jonoa,nagrand,575,druid,restoration,12,6,6
Clawandørder,tichondrius,575,druid,restoration,12,6,6
Feutrine,zuljin,575,druid,restoration,12,6,6
Flôkey,tichondrius,575,druid,restoration,12,6,6
Nrp,stormrage,575,druid,restoration,12,6,6
Wythrim,quelthalas,575,druid,restoration,12,6,6
Noonoo,frostwolf,575,druid,restoration,12,6,6
Weltherion,guldan,575,druid,restoration,12,6,6
Gosch,stormrage,575,druid,restoration,12,6,6
Kokushe,burning-legion,575,druid,restoration,12,6,6
Velauris,sargeras,575,druid,restoration,12,6,6
Lahsa,tichondrius,575,druid,restoration,12,6,6
Muatigorn,blackrock,575,druid,restoration,12,6,6
Cinderellax,illidan,575,druid,restoration,12,6,6
Nightnes,sargeras,575,druid,restoration,12,6,6
Skullchief,barthilas,575,druid,restoration,16,7,9
Aligantor,thrall,575,druid,restoration,18,6,12
Treynî,tichondrius,575,druid,restoration,18,6,12
Dýreðaguð,gurubashi,575,druid,restoration,18,6,12
Mithaelar,moon-guard,575,druid,restoration,18,6,12
Sleepypaws,silvermoon,575,druid,restoration,18,6,12
Poutyface,sargeras,575,druid,restoration,39,7,32
Elpako,ragnaros,574,druid,restoration,6,6,0
Astraelas,tichondrius,574,druid,restoration,12,6,6
Meonk,frostmourne,574,druid,restoration,12,6,6
Larc,frostwolf,574,druid,restoration,12,6,6
Carther,korgath,574,druid,restoration,12,6,6
Rockcow,tichondrius,574,druid,restoration,12,6,6
Aranuir,emerald-dream,574,druid,restoration,18,6,12
Brisketmre,dalaran,574,druid,restoration,36,6,30
Lonewolfdrd,illidan,573,druid,restoration,6,6,0
Persiancoco,area-52,572,druid,restoration,12,6,6
Nightshiver,bleeding-hollow,572,druid,restoration,12,6,6
Modification,eonar,572,druid,restoration,12,6,6
Dyfurion,stormrage,572,druid,restoration,12,6,6
Ahlekleklekk,azralon,572,druid,restoration,12,6,6
Hallowbranch,moon-guard,572,druid,restoration,18,6,12
Kupaloidzki,proudmoore,571,druid,restoration,12,6,6
Bonemaul,bonechewer,571,druid,restoration,12,6,6
Kellykapore,area-52,571,druid,restoration,36,6,30
Aokseer,azralon,570,druid,restoration,12,6,6
Vdubz,blackrock,570,druid,restoration,12,6,6
Nordway,alexstrasza,569,druid,restoration,12,6,6
Kawanishi,stormrage,567,druid,restoration,12,6,6
Aquesadilla,tichondrius,567,druid,restoration,30,6,24
Onyayo,barthilas,565,druid,restoration,12,6,6
Lililililil,stormrage,552,druid,restoration,36,6,30
Istishiã,tichondrius,543,druid,restoration,14,7,7
Movom,tichondrius,543,druid,restoration,17,6,11
Cudbacrakhed,tichondrius,541,druid,restoration,20,7,13
Arthemisgodx,azralon,520,druid,restoration,17,10,7
Pouncing,sargeras,511,druid,restoration,14,6,8
Wildartform,malganis,494,druid,restoration,11,7,4
Windù,azralon,488,druid,restoration,16,9,7
Nersepha,gurubashi,480,druid,restoration,6,5,1
Sevend,tichondrius,480,druid,restoration,6,5,1
Naakx,tichondrius,480,druid,restoration,6,5,1
Fanboy,magtheridon,480,druid,restoration,6,5,1
Dëmoníc,ragnaros,480,druid,restoration,6,5,1
Floray,tichondrius,480,druid,restoration,6,5,1
Brëed,tichondrius,480,druid,restoration,6,5,1
Kascatm,area-52,480,druid,restoration,6,5,1
Treehealage,sargeras,480,druid,restoration,6,5,1
Chaníng,frostmourne,480,druid,restoration,6,5,1
Ppbtw,illidan,480,druid,restoration,12,5,7
Imlordgumper,illidan,480,druid,restoration,12,5,7
Stormjammer,proudmoore,480,druid,restoration,12,5,7
Greeneguy,thrall,480,druid,restoration,12,5,7
Zemul,ragnaros,480,druid,restoration,12,5,7
Suekeys,frostmourne,480,druid,restoration,12,5,7
Shwayshift,bleeding-hollow,480,druid,restoration,12,5,7
Hotgoal,frostmourne,480,druid,restoration,12,5,7
Lukass,tichondrius,480,druid,restoration,12,5,7
Lookhowirun,emerald-dream,480,druid,restoration,12,5,7
Jaydog,emerald-dream,480,druid,restoration,12,5,7
Washedgodx,mugthol,480,druid,restoration,12,5,7
Milkmoneymeo,illidan,480,druid,restoration,12,5,7
Moonfannia,malganis,480,druid,restoration,12,5,7
Memoryleaks,proudmoore,480,druid,restoration,12,5,7
Hudada,emerald-dream,480,druid,restoration,12,5,7
Stamookee,area-52,480,druid,restoration,12,5,7
Noah,altar-of-storms,480,druid,restoration,12,5,7
Judar,barthilas,480,druid,restoration,12,5,7
Shartah,zuljin,480,druid,restoration,12,5,7
Spuncone,frostmourne,480,druid,restoration,12,5,7
Omelet,tichondrius,480,druid,restoration,12,5,7
Mâckdâddy,kul-tiras,480,druid,restoration,12,5,7
Twentyfour,laughing-skull,480,druid,restoration,12,5,7
Teslabeam,illidan,480,druid,restoration,12,5,7
Guavajuice,stormrage,480,druid,restoration,16,5,11
Hgoo,tichondrius,480,druid,restoration,18,5,13
Bumbleebee,azralon,480,druid,restoration,18,5,13
Djimbo,kelthuzad,480,druid,restoration,18,5,13
Qkskill,nemesis,480,druid,restoration,24,5,19
Krevy,nazgrel,480,druid,restoration,24,5,19
Spacaa,kelthuzad,480,druid,restoration,24,5,19
Queiq,malganis,479,druid,restoration,6,5,1
Sharialawl,stormreaver,479,druid,restoration,12,5,7
Murkkd,tichondrius,479,druid,restoration,12,5,7
Dunedaddy,silvermoon,479,druid,restoration,12,5,7
Sønèca,azralon,479,druid,restoration,12,5,7
Forest,frostmourne,479,druid,restoration,12,5,7
Jamona,cenarius,479,druid,restoration,12,5,7
Olegoatjames,darkspear,478,druid,restoration,13,6,7
Cadekey,illidan,478,druid,restoration,12,5,7
Fastafboy,stormrage,478,druid,restoration,12,5,7
Pachacamac,dragonmaw,478,druid,restoration,12,5,7
Natruid,sargeras,478,druid,restoration,12,5,7
Bloodyhoofs,malganis,478,druid,restoration,12,5,7
Chupaone,dalaran,478,druid,restoration,12,5,7
Rònaldò,drakthul,478,druid,restoration,12,5,7
Scheppke,bleeding-hollow,477,druid,restoration,12,5,7
Wraiven,elune,477,druid,restoration,18,5,13
Baha,azralon,477,druid,restoration,18,5,13
Swiftstrider,frostmourne,476,druid,restoration,10,6,4
Phlap,zuljin,476,druid,restoration,12,5,7
Kaldrago,detheroc,476,druid,restoration,12,5,7
Gôdôfwow,tichondrius,473,druid,restoration,25,9,16
Vuthryx,tichondrius,472,druid,restoration,18,5,13
Bobruid,nagrand,469,druid,restoration,19,9,10
Maerk,aerie-peak,469,druid,restoration,18,5,13
Atim,moon-guard,468,druid,restoration,36,5,31
Xiaoddi,tichondrius,463,druid,restoration,11,5,6
Metaldruid,tichondrius,463,druid,restoration,11,5,6
Semangarbage,tichondrius,457,druid,restoration,15,8,7
Fuzzie,icecrown,447,druid,restoration,16,5,11
Bigelbows,area-52,432,druid,restoration,15,6,9
Qij,eonar,431,druid,restoration,11,5,6
Asclepïus,tichondrius,431,druid,restoration,11,5,6
Gankstababy,tichondrius,426,druid,restoration,20,6,14
Indicahigh,moon-guard,424,druid,restoration,16,7,9
Oongadunga,tichondrius,415,druid,restoration,14,5,9
Nøbuchi,kelthuzad,384,druid,restoration,6,4,2
Zbh,tichondrius,384,druid,restoration,6,4,2
Fresh,earthen-ring,384,druid,restoration,6,4,2
Dzone,tichondrius,384,druid,restoration,6,4,2
Cuzzidr,tichondrius,384,druid,restoration,6,4,2
Bunrack,nerzhul,384,druid,restoration,6,4,2
Koan,proudmoore,384,druid,restoration,6,4,2
Kushkilla,malganis,384,druid,restoration,6,4,2
Èmax,barthilas,384,druid,restoration,6,4,2
Starshípx,tichondrius,384,druid,restoration,6,4,2
Yoona,kiljaeden,384,druid,restoration,6,4,2
Sanninx,barthilas,384,druid,restoration,6,4,2
Bearkîng,stormrage,384,druid,restoration,6,4,2
Metaindexqt,quelthalas,384,druid,restoration,6,4,2
Jillferal,proudmoore,384,druid,restoration,6,4,2
Druidlstrudl,moon-guard,384,druid,restoration,6,4,2
Erû,ragnaros,384,druid,restoration,6,4,2
Rasgabuxoh,azralon,384,druid,restoration,6,4,2
Outcastmango,thrall,384,druid,restoration,6,4,2
Queiq,kelthuzad,384,druid,restoration,6,4,2
Slambeezy,emerald-dream,384,druid,restoration,6,4,2
Shroomdealer,kelthuzad,384,druid,restoration,6,4,2
Someshta,sargeras,384,druid,restoration,6,4,2
Doomky,area-52,384,druid,restoration,6,4,2
Joeyshiftz,blackrock,384,druid,restoration,6,4,2
Nbendtner,tichondrius,384,druid,restoration,6,4,2
Lylek,azshara,384,druid,restoration,6,4,2
Peazoepico,tichondrius,384,druid,restoration,6,4,2
Êhurricane,dalaran,384,druid,restoration,6,4,2
Johnnybigg,frostmourne,384,druid,restoration,6,4,2
Thõrr,tichondrius,384,druid,restoration,6,4,2
Terokky,azralon,384,druid,restoration,6,4,2
Armorkits,area-52,384,druid,restoration,6,4,2
Tofumation,gorgonnash,384,druid,restoration,12,4,8
Ohioman,bleeding-hollow,384,druid,restoration,12,4,8
Shadru,bleeding-hollow,384,druid,restoration,12,4,8
Synthesïs,malganis,384,druid,restoration,12,4,8
Flyshles,frostmourne,384,druid,restoration,12,4,8
Bumbally,illidan,384,druid,restoration,12,4,8
Ganizote,ragnaros,384,druid,restoration,12,4,8
Thebutterboy,stormrage,384,druid,restoration,12,4,8
Greentoë,sargeras,384,druid,restoration,12,4,8
Nocup,illidan,384,druid,restoration,12,4,8
Kaboomy,moon-guard,384,druid,restoration,12,4,8
Brittanychan,sargeras,384,druid,restoration,12,4,8
Chickenwings,ragnaros,384,druid,restoration,12,4,8
Bwaccowi,sargeras,384,druid,restoration,12,4,8
Glenglooie,tichondrius,384,druid,restoration,12,4,8
Awguseon,proudmoore,384,druid,restoration,12,4,8
Malfurionis,tichondrius,384,druid,restoration,12,4,8
Bigshred,tichondrius,384,druid,restoration,12,4,8
Metaphysìcs,kelthuzad,384,druid,restoration,12,4,8
Flompstomper,skullcrusher,384,druid,restoration,12,4,8
Lillenan,illidan,384,druid,restoration,12,4,8
Feraldudu,illidan,384,druid,restoration,12,4,8
Mkat,illidan,384,druid,restoration,12,4,8
Mastabtw,illidan,384,druid,restoration,12,4,8
Weedmunchies,kelthuzad,384,druid,restoration,12,4,8
Hotrecki,kelthuzad,384,druid,restoration,12,4,8
Bopple,tichondrius,384,druid,restoration,12,4,8
Mastahskills,illidan,384,druid,restoration,12,4,8
Tarvosx,thrall,384,druid,restoration,18,4,14
Bryle,kiljaeden,383,druid,restoration,6,4,2
Theboyz,zuljin,383,druid,restoration,6,4,2
Calleguard,terenas,383,druid,restoration,6,4,2
Javoh,drakkari,383,druid,restoration,6,4,2
Zelara,kilrogg,383,druid,restoration,12,4,8
Hazbekbek,area-52,383,druid,restoration,12,4,8
Brazzar,kiljaeden,383,druid,restoration,12,4,8
Posmard,ragnaros,383,druid,restoration,12,4,8
Migdrail,nemesis,383,druid,restoration,12,4,8
Xay,runetotem,383,druid,restoration,12,4,8
Kvacco,kiljaeden,383,druid,restoration,12,4,8
Jonnyutaa,emerald-dream,383,druid,restoration,12,4,8
Pahrump,stormrage,383,druid,restoration,12,4,8
Ssuka,tichondrius,383,druid,restoration,12,4,8
Nightflow,emerald-dream,383,druid,restoration,12,4,8
Morphiius,archimonde,383,druid,restoration,18,4,14
Madmandan,moon-guard,383,druid,restoration,18,4,14
Rikey,thaurissan,383,druid,restoration,18,4,14
Beôrn,mugthol,382,druid,restoration,6,4,2
Puzzlè,thrall,382,druid,restoration,12,4,8
Guojue,tichondrius,382,druid,restoration,12,4,8
Maldrake,quelthalas,381,druid,restoration,12,4,8
Certzu,moon-guard,381,druid,restoration,18,4,14
Bigbadcow,sargeras,380,druid,restoration,12,4,8
Breakthemm,bonechewer,379,druid,restoration,12,4,8
Metamooseowl,crushridge,379,druid,restoration,12,4,8
Nüg,frostmourne,379,druid,restoration,14,4,10
Nerfmesoon,sargeras,367,druid,restoration,11,4,7
Reyvin,illidan,362,druid,restoration,20,6,14
Dashíng,proudmoore,348,druid,restoration,11,4,7
Gairen,the-venture-co,318,druid,restoration,8,4,4
Elendriss,quelthalas,304,druid,restoration,13,4,9
Koratan,frostmourne,288,druid,restoration,6,3,3
Azaran,bleeding-hollow,288,druid,restoration,6,3,3
Juicecarton,thrall,288,druid,restoration,6,3,3
Thenog,arthas,288,druid,restoration,6,3,3
Tziv,area-52,288,druid,restoration,6,3,3
Eryon,nemesis,288,druid,restoration,6,3,3
Pollished,kelthuzad,288,druid,restoration,6,3,3
Sonicphantom,kelthuzad,288,druid,restoration,6,3,3
Yllercia,quelthalas,288,druid,restoration,6,3,3
Lðhnar,malganis,288,druid,restoration,6,3,3
Tarlis,khazgoroth,288,druid,restoration,6,3,3
Mädnhairy,zuljin,288,druid,restoration,6,3,3
Seekamp,khazgoroth,288,druid,restoration,6,3,3
Ømí,quelthalas,288,druid,restoration,6,3,3
Ulfvur,nagrand,288,druid,restoration,6,3,3
Owaru,stormrage,288,druid,restoration,6,3,3
Xötic,stormrage,288,druid,restoration,6,3,3
Hashdxm,tichondrius,288,druid,restoration,6,3,3
Sensations,moon-guard,288,druid,restoration,6,3,3
Nokash,tichondrius,288,druid,restoration,6,3,3
Reptile,terenas,288,druid,restoration,6,3,3
Gloomster,tichondrius,288,druid,restoration,6,3,3
Unis,tichondrius,288,druid,restoration,6,3,3
Antonniel,azralon,288,druid,restoration,6,3,3
Ateoate,stormscale,288,druid,restoration,6,3,3
Hotmuztard,sargeras,288,druid,restoration,6,3,3
Mythicdruid,ragnaros,288,druid,restoration,6,3,3
Kcazz,thorium-brotherhood,288,druid,restoration,6,3,3
Geno,cenarius,288,druid,restoration,6,3,3
Panterarosa,ragnaros,288,druid,restoration,6,3,3
Rdruid,zuluhed,288,druid,restoration,6,3,3
Xgodhands,sargeras,288,druid,restoration,6,3,3
Vìdá,tichondrius,288,druid,restoration,6,3,3
Ðeepsixx,burning-legion,288,druid,restoration,6,3,3
Ayra,sargeras,288,druid,restoration,6,3,3
Cutefeetz,moon-guard,288,druid,restoration,6,3,3
Flatnose,agamaggan,288,druid,restoration,6,3,3
Càlthar,sargeras,288,druid,restoration,6,3,3
Gizho,dark-iron,288,druid,restoration,6,3,3
Wiskees,sargeras,288,druid,restoration,6,3,3
Naturetazer,sargeras,288,druid,restoration,6,3,3
Crapster,boulderfist,288,druid,restoration,6,3,3
Creamsoda,frostmane,288,druid,restoration,6,3,3
Kollective,sargeras,288,druid,restoration,6,3,3
Wâggles,moon-guard,288,druid,restoration,6,3,3
Hotwolf,tichondrius,288,druid,restoration,6,3,3
Spinach,moon-guard,288,druid,restoration,6,3,3
Pekingcuckoo,illidan,288,druid,restoration,6,3,3
Tricklein,tichondrius,288,druid,restoration,6,3,3
Vadroid,dalaran,288,druid,restoration,6,3,3
Buffjungle,tichondrius,288,druid,restoration,6,3,3
Demitassie,wyrmrest-accord,288,druid,restoration,8,3,5
Overgrowth,zuljin,288,druid,restoration,9,3,6
Quadrivium,stormrage,288,druid,restoration,12,3,9
Soloqmenace,malganis,288,druid,restoration,12,3,9
Theømega,stormrage,288,druid,restoration,12,3,9
Garrodan,aerie-peak,288,druid,restoration,12,3,9
Hoedrufroza,tichondrius,288,druid,restoration,12,3,9
Kitiano,thunderlord,288,druid,restoration,12,3,9
Arútam,ragnaros,288,druid,restoration,12,3,9
Wwkd,illidan,288,druid,restoration,12,3,9
Cybeé,sargeras,288,druid,restoration,12,3,9
Sbc,anvilmar,288,druid,restoration,12,3,9
Silasel,sargeras,288,druid,restoration,12,3,9
Nemoo,tichondrius,288,druid,restoration,12,3,9
Krispies,eredar,288,druid,restoration,12,3,9
Kanokoho,wyrmrest-accord,288,druid,restoration,12,3,9
Qdrui,tichondrius,288,druid,restoration,12,3,9
Deyz,ysera,288,druid,restoration,12,3,9
Bøo,frostmourne,288,druid,restoration,12,3,9
Monicaduan,frostmourne,288,druid,restoration,12,3,9
Nodab,tichondrius,288,druid,restoration,12,3,9
Mattiu,area-52,288,druid,restoration,12,3,9
Raptormotoo,lothar,288,druid,restoration,12,3,9
Azngødz,tichondrius,288,druid,restoration,12,3,9
Borbys,sargeras,288,druid,restoration,12,3,9
Blacksimba,area-52,288,druid,restoration,12,3,9
Biggié,bleeding-hollow,288,druid,restoration,12,3,9
Nuantar,nemesis,288,druid,restoration,12,3,9
Convokíng,kelthuzad,288,druid,restoration,18,3,15
Thundyrcat,tichondrius,288,druid,restoration,18,3,15
Giddeonv,draenor,288,druid,restoration,18,3,15
Sarangzzang,tichondrius,287,druid,restoration,6,3,3
Bullshifftt,kelthuzad,287,druid,restoration,6,3,3
Anakum,azshara,287,druid,restoration,6,3,3
Harderplease,emerald-dream,287,druid,restoration,6,3,3
Bringo,executus,287,druid,restoration,6,3,3
Udala,durotan,287,druid,restoration,6,3,3
Breakertime,illidan,287,druid,restoration,6,3,3
Budsmoke,stormrage,287,druid,restoration,6,3,3
Xkcc,perenolde,287,druid,restoration,6,3,3
Sefestria,senjin,287,druid,restoration,6,3,3
Ugress,whisperwind,287,druid,restoration,6,3,3
Iamanoob,sargeras,287,druid,restoration,10,4,6
Bankinbäbe,illidan,287,druid,restoration,8,3,5
Vulgär,kiljaeden,287,druid,restoration,12,3,9
Megara,dalaran,287,druid,restoration,12,3,9
Druishcat,dark-iron,287,druid,restoration,12,3,9
Atillah,stormscale,287,druid,restoration,12,3,9
Cieran,senjin,287,druid,restoration,18,3,15
Naachocheeze,tichondrius,286,druid,restoration,6,3,3
Bullshiftter,ursin,286,druid,restoration,6,3,3
Fortunecat,illidan,286,druid,restoration,12,3,9
Sabari,area-52,285,druid,restoration,18,3,15
Anastasyiar,illidan,256,druid,restoration,10,3,7
Gloomy,andorhal,256,druid,restoration,10,3,7
Cipozento,azralon,240,druid,restoration,9,3,6
Awkwarder,emerald-dream,239,druid,restoration,11,3,8
Opiumheals,sargeras,234,druid,restoration,8,4,4
Restyblazed,sargeras,234,druid,restoration,8,4,4
Donaldsr,area-52,234,druid,restoration,9,4,5
Stormwood,moonrunner,234,druid,restoration,21,4,17
Stèvén,tichondrius,233,druid,restoration,13,4,9
Gavdru,tichondrius,223,druid,restoration,8,3,5
Blackmoomba,kiljaeden,192,druid,restoration,4,3,1
Faentz,stormrage,192,druid,restoration,9,3,6
Megasteak,lightninghoof,192,druid,restoration,6,2,4
Zaddychulo,area-52,192,druid,restoration,6,2,4
Bigtonkatruk,tichondrius,192,druid,restoration,6,2,4
Cultnelf,illidan,192,druid,restoration,6,2,4
Bobochi,tichondrius,192,druid,restoration,6,2,4
Barkcheeks,area-52,192,druid,restoration,6,2,4
Lilcocoxoxo,shadowmoon,192,druid,restoration,6,2,4
Crazywoodowl,tichondrius,192,druid,restoration,6,2,4
Violyte,tichondrius,192,druid,restoration,6,2,4
Tadoo,tichondrius,192,druid,restoration,6,2,4
Ambassador,kelthuzad,192,druid,restoration,6,2,4
Freemac,tichondrius,192,druid,restoration,6,2,4
Chopotron,ragnaros,192,druid,restoration,6,2,4
Loveflowers,nemesis,192,druid,restoration,6,2,4
Akinetic,illidan,192,druid,restoration,6,2,4
Snugglin,kelthuzad,192,druid,restoration,6,2,4
Clonkzy,area-52,192,druid,restoration,6,2,4
Mcbeef,tichondrius,192,druid,restoration,6,2,4
Droody,earthen-ring,192,druid,restoration,6,2,4
Levincy,thrall,192,druid,restoration,6,2,4
Fixn,tichondrius,192,druid,restoration,6,2,4
Breezeys,tichondrius,192,druid,restoration,6,2,4
Krisdu,kelthuzad,192,druid,restoration,6,2,4
Whiplash,deathwing,192,druid,restoration,6,2,4
Acexten,tichondrius,192,druid,restoration,6,2,4
Tydruid,illidan,192,druid,restoration,6,2,4
Fracxx,area-52,192,druid,restoration,6,2,4
Nightwinter,area-52,192,druid,restoration,6,2,4
Cauroth,azralon,192,druid,restoration,6,2,4
Fastyhands,illidan,192,druid,restoration,6,2,4
Bomp,malganis,192,druid,restoration,6,2,4
Haful,emerald-dream,192,druid,restoration,6,2,4
Psycloned,magtheridon,192,druid,restoration,6,2,4
Bullbuddy,wyrmrest-accord,192,druid,restoration,6,2,4
Hawtzi,stormrage,192,druid,restoration,6,2,4
Py,stormscale,192,druid,restoration,6,2,4
Owlgz,barthilas,192,druid,restoration,6,2,4
Loved,stormrage,192,druid,restoration,6,2,4
Kaisuckslol,stormrage,192,druid,restoration,6,2,4
Gretatunberg,skywall,192,druid,restoration,6,2,4
Feeoria,lothar,192,druid,restoration,6,2,4
Nacur,bleeding-hollow,192,druid,restoration,6,2,4
Five,the-underbog,192,druid,restoration,6,2,4
Ghostti,stormrage,192,druid,restoration,6,2,4
Loganski,korialstrasz,192,druid,restoration,6,2,4
Firefireahh,sargeras,192,druid,restoration,6,2,4
Theblind,korgath,192,druid,restoration,6,2,4
Kroshape,stormrage,192,druid,restoration,6,2,4
Tropikana,burning-legion,192,druid,restoration,6,2,4
Tempesd,stormrage,192,druid,restoration,6,2,4
Hydruidponic,aegwynn,192,druid,restoration,6,2,4
Netflixnphil,sargeras,192,druid,restoration,6,2,4
Zils,bleeding-hollow,192,druid,restoration,6,2,4
Kagekuma,bleeding-hollow,192,druid,restoration,6,2,4
Bekroh,crushridge,192,druid,restoration,6,2,4
Krobz,bleeding-hollow,192,druid,restoration,6,2,4
Epicbehr,kiljaeden,192,druid,restoration,6,2,4
Zwind,nerzhul,192,druid,restoration,6,2,4
Mojoforweeks,bleeding-hollow,192,druid,restoration,6,2,4
Simperella,dalaran,192,druid,restoration,13,3,10
Hotsx,frostmourne,192,druid,restoration,9,2,7
Sleepyheals,tichondrius,192,druid,restoration,14,3,11
Moocka,ragnaros,192,druid,restoration,12,2,10
Naseebo,frostmourne,192,druid,restoration,12,2,10
Gradiluth,proudmoore,192,druid,restoration,12,2,10
Bboikha,quelthalas,192,druid,restoration,12,2,10
Kittysnuggle,emerald-dream,192,druid,restoration,12,2,10
Urhero,sargeras,192,druid,restoration,12,2,10
Grullandur,hakkar,192,druid,restoration,12,2,10
Wonderhood,quelthalas,192,druid,restoration,12,2,10
Daesdaddy,sargeras,192,druid,restoration,12,2,10
Elven,frostmourne,192,druid,restoration,12,2,10
Lunmoon,thrall,192,druid,restoration,12,2,10
Goorybud,tichondrius,192,druid,restoration,12,2,10
Duckyy,garithos,192,druid,restoration,12,2,10
Kymolyia,sargeras,192,druid,restoration,12,2,10
Cpksdru,tichondrius,192,druid,restoration,12,2,10
Killvious,kelthuzad,192,druid,restoration,12,2,10
Rootslayer,tichondrius,192,druid,restoration,12,2,10
Moonkay,tichondrius,192,druid,restoration,12,2,10
Aelena,whisperwind,192,druid,restoration,12,2,10
Crunchieroll,illidan,192,druid,restoration,12,2,10
Gahr,wyrmrest-accord,192,druid,restoration,12,2,10
Ddizz,cairne,192,druid,restoration,12,2,10
Fribbleog,korgath,192,druid,restoration,12,2,10
Trèè,frostmane,192,druid,restoration,12,2,10
Brutalhealz,aegwynn,192,druid,restoration,18,2,16
Clonemunster,frostmourne,192,druid,restoration,18,2,16
Irontree,dunemaul,192,druid,restoration,18,2,16
Devilzown,fenris,192,druid,restoration,18,2,16
Boofndergz,area-52,191,druid,restoration,6,2,4
Treeoleo,stormrage,191,druid,restoration,6,2,4
Äbÿss,tichondrius,191,druid,restoration,12,2,10
Calliecat,moon-guard,191,druid,restoration,12,2,10
Daweed,zuluhed,191,druid,restoration,12,2,10
Voodooshiftz,emerald-dream,191,druid,restoration,12,2,10
Garritass,moon-guard,189,druid,restoration,29,2,27
Dreamwalk,stormrage,175,druid,restoration,17,3,14
Brbcatsonfir,malganis,175,druid,restoration,22,3,19
Pvptactician,tichondrius,159,druid,restoration,11,4,7
Jeppcat,tichondrius,159,druid,restoration,14,3,11
Frenzymoon,zuljin,144,druid,restoration,3,3,0
Pokieoaks,zuljin,138,druid,restoration,10,3,7
Galind,rexxar,128,druid,restoration,4,2,2
Crunkk,thunderlord,127,druid,restoration,14,2,12
Nohkotana,illidan,96,druid,restoration,3,2,1
Rakroz,emerald-dream,96,druid,restoration,6,1,5
Moonfart,zuljin,96,druid,restoration,6,1,5
Arthridas,wyrmrest-accord,96,druid,restoration,6,1,5
Dedderita,bloodhoof,96,druid,restoration,6,1,5
Jayto,frostmourne,96,druid,restoration,6,1,5
Fartsicle,lightnings-blade,96,druid,restoration,6,1,5
Inblooms,blackhand,96,druid,restoration,6,1,5
Mollytonasty,demon-soul,96,druid,restoration,6,1,5
Nìck,the-scryers,96,druid,restoration,6,1,5
Macfluff,emerald-dream,96,druid,restoration,6,1,5
Lokobah,wyrmrest-accord,96,druid,restoration,6,1,5
Solá,skywall,96,druid,restoration,6,1,5
Fadingfast,frostmourne,96,druid,restoration,6,1,5
Sinistuhd,tichondrius,96,druid,restoration,6,1,5
Stephonxd,area-52,96,druid,restoration,6,1,5
Dotdmage,tichondrius,96,druid,restoration,6,1,5
Samully,area-52,96,druid,restoration,6,1,5
Tommyjimmy,andorhal,96,druid,restoration,6,1,5
Zeelán,emerald-dream,96,druid,restoration,6,1,5
Kzdubya,stormrage,96,druid,restoration,6,1,5
Ånxiety,skullcrusher,96,druid,restoration,6,1,5
Arienne,kelthuzad,96,druid,restoration,6,1,5
Chomperz,tichondrius,96,druid,restoration,6,1,5
Feralgo,tichondrius,96,druid,restoration,6,1,5
Mandingodam,auchindoun,96,druid,restoration,6,1,5
Carlosd,tichondrius,96,druid,restoration,6,1,5
Moocowbear,illidan,96,druid,restoration,6,1,5
Moonkingx,ragnaros,96,druid,restoration,6,1,5
Kurzul,area-52,96,druid,restoration,6,1,5
Rezl,sargeras,96,druid,restoration,6,1,5
Atagoo,tichondrius,96,druid,restoration,6,1,5
Hadoriss,kelthuzad,96,druid,restoration,6,1,5
Hille,sargeras,96,druid,restoration,6,1,5
Guap,bleeding-hollow,96,druid,restoration,6,1,5
Frydaze,tichondrius,96,druid,restoration,6,1,5
Afrogx,dalaran,96,druid,restoration,6,1,5
Wotermelon,moon-guard,96,druid,restoration,6,1,5
Djsummer,tichondrius,96,druid,restoration,6,1,5
Beldiin,khazgoroth,96,druid,restoration,6,1,5
Moonshocka,tichondrius,96,druid,restoration,6,1,5
Jammi,skywall,96,druid,restoration,6,1,5
Natürëblÿät,illidan,96,druid,restoration,6,1,5
Caminanube,quelthalas,96,druid,restoration,6,1,5
Ttaure,ragnaros,96,druid,restoration,6,1,5
Rastakant,malganis,96,druid,restoration,6,1,5
Suncintus,aggramar,96,druid,restoration,6,1,5
Ðjx,stormrage,96,druid,restoration,6,1,5
Nyanncat,frostmourne,96,druid,restoration,7,1,6
Lirilith,shadowsong,96,druid,restoration,16,2,14
Shebleeder,aegwynn,96,druid,restoration,11,1,10
Foracus,sargeras,96,druid,restoration,11,1,10
Kaeliah,stormrage,96,druid,restoration,12,1,11
Sinigang,duskwood,96,druid,restoration,12,1,11
Thorsèn,sargeras,96,druid,restoration,15,1,14
Grakzul,blood-furnace,95,druid,restoration,9,2,7
Wantto,moknathal,95,druid,restoration,6,1,5
Eliteshift,frostmourne,64,druid,restoration,4,1,3
Pownage,kelthuzad,64,druid,restoration,16,1,15
Bòmi,tichondrius,63,druid,restoration,2,2,0
Smorak,area-52,63,druid,restoration,2,2,0
Suwonhealer,tichondrius,31,druid,restoration,8,1,7
Neferpitou,fenris,16,druid,restoration,6,1,5
Landro,tichondrius,1545,druid,guardian,59,33,26
Haalls,gallywix,1107,druid,guardian,36,12,24
Crashägásm,proudmoore,1062,druid,guardian,30,15,15
Inxert,tichondrius,792,druid,guardian,16,9,7
Koan,proudmoore,671,druid,guardian,24,7,17
Multivar,burning-legion,669,druid,guardian,12,7,5
Mordu,rivendare,665,druid,guardian,18,7,11
Kesagake,feathermoon,664,druid,guardian,12,7,5
Agmukar,wyrmrest-accord,659,druid,guardian,12,7,5
Ishiftalot,bleeding-hollow,573,druid,guardian,15,7,8
Giddeonv,draenor,570,druid,guardian,12,6,6
Maraliss,shadowsong,566,druid,guardian,12,6,6
Chärmin,area-52,479,druid,guardian,12,5,7
Gifteddream,zuljin,474,druid,guardian,12,5,7
Balanah,quelthalas,472,druid,guardian,15,6,9
Wraithman,madoran,383,druid,guardian,6,4,2
Aìón,emerald-dream,382,druid,guardian,6,4,2
Tankbareass,aerie-peak,382,druid,guardian,18,4,14
Dalidielor,dalaran,288,druid,guardian,6,3,3
Manwool,illidan,288,druid,guardian,12,3,9
Read,boulderfist,288,druid,guardian,12,3,9
Woozydruid,anetheron,288,druid,guardian,12,3,9
Cayinna,altar-of-storms,288,druid,guardian,12,3,9
Deutschland,whisperwind,288,druid,guardian,12,3,9
Mavren,uldaman,286,druid,guardian,6,3,3
Classykitty,tichondrius,192,druid,guardian,4,3,1
Battlecát,stormscale,192,druid,guardian,6,2,4
Athious,moon-guard,192,druid,guardian,6,2,4
Mommyh,duskwood,192,druid,guardian,6,2,4
Skrimshaw,burning-legion,192,druid,guardian,6,2,4
Gornish,azralon,190,druid,guardian,12,2,10
Wintarz,sargeras,96,druid,guardian,6,1,5
Sixfeetunder,shattered-halls,96,druid,guardian,6,1,5
Kushtiger,ragnaros,96,druid,guardian,6,1,5
Drur,zuljin,96,druid,guardian,6,1,5
Vindecca,kelthuzad,96,druid,guardian,6,1,5
Aurno,queldorei,96,druid,guardian,6,1,5
Bigxworm,gurubashi,96,druid,guardian,6,1,5
Kylysea,dalaran,96,druid,guardian,12,1,11
Vineclaw,emerald-dream,96,druid,guardian,12,1,11
Lakroz,zuljin,95,druid,guardian,6,1,5
Marvin,stormreaver,2168,druid,feral,89,46,43
Nyç,sargeras,2139,druid,feral,216,116,100
Auntsusie,stormrage,2128,druid,feral,95,61,34
Iinkinbio,alleria,2124,druid,feral,84,50,34
Bawbe,lightbringer,2059,druid,feral,71,41,30
Angryalyu,tichondrius,2058,druid,feral,72,35,37
Crunchyroll,sargeras,2056,druid,feral,150,79,71
Jaguar,whisperwind,2041,druid,feral,66,39,27
Formrage,jubeithos,2027,druid,feral,176,92,84
Beomjun,tichondrius,2009,druid,feral,101,57,44
Loser,stormrage,1985,druid,feral,69,35,34
Abstractf,sargeras,1972,druid,feral,74,44,30
Boomboombom,tichondrius,1969,druid,feral,89,54,35
Babekisser,stormrage,1961,druid,feral,130,69,61
Pdfilewatch,stormrage,1943,druid,feral,42,30,12
Duhfective,proudmoore,1942,druid,feral,59,32,27
Feeg,sargeras,1937,druid,feral,65,33,32
Chowxx,tichondrius,1937,druid,feral,90,43,47
Fappywapple,kiljaeden,1932,druid,feral,88,46,42
Amellies,quelthalas,1921,druid,feral,160,84,76
Cliodhna,kelthuzad,1914,druid,feral,78,40,38
Trìckyz,tichondrius,1913,druid,feral,80,41,39
Alleae,stormrage,1908,druid,feral,54,32,22
Samuel,ravencrest,1897,druid,feral,60,33,27
Floorz,firetree,1895,druid,feral,42,23,19
Ripbot,sargeras,1894,druid,feral,59,31,28
Henikbite,zuljin,1893,druid,feral,66,34,32
Duzis,tichondrius,1887,druid,feral,48,28,20
Bassy,whisperwind,1885,druid,feral,70,31,39
Astrozxy,sargeras,1860,druid,feral,42,23,19
Vinjo,ragnaros,1858,druid,feral,54,25,29
Darmari,quelthalas,1852,druid,feral,60,27,33
Rwhatkr,tichondrius,1847,druid,feral,47,20,27
Sammy,scilla,1842,druid,feral,84,40,44
Tyxi,bleeding-hollow,1839,druid,feral,46,31,15
Yukjr,stormrage,1839,druid,feral,137,66,71
Yayue,tichondrius,1830,druid,feral,72,37,35
Bpdferal,stormrage,1828,druid,feral,180,99,81
Russiaguy,area-52,1826,druid,feral,271,141,130
Porkloafed,illidan,1824,druid,feral,94,53,41
Sappora,illidan,1824,druid,feral,178,92,86
Feignxd,emerald-dream,1823,druid,feral,60,43,17
Nuadris,azralon,1822,druid,feral,168,86,82
Chrye,tichondrius,1820,druid,feral,69,35,34
Hugecat,tichondrius,1812,druid,feral,60,26,34
Lucky,destromath,1811,druid,feral,126,65,61
Stellar,steamwheedle-cartel,1808,druid,feral,114,54,60
Skrambles,mugthol,1791,druid,feral,57,27,30
Porkonmyfork,frostmourne,1786,druid,feral,28,20,8
Notapn,tichondrius,1786,druid,feral,78,40,38
Icespicè,tichondrius,1772,druid,feral,84,38,46
Killuf,quelthalas,1767,druid,feral,95,35,60
Proudfurryxo,dragonmaw,1765,druid,feral,50,27,23
Kakaroot,tichondrius,1762,druid,feral,87,43,44
Kobez,bleeding-hollow,1748,druid,feral,84,46,38
Mhdd,tichondrius,1747,druid,feral,43,29,14
Lemön,frostmourne,1745,druid,feral,42,21,21
Vebee,frostmourne,1744,druid,feral,53,29,24
Extic,sargeras,1730,druid,feral,66,38,28
Blrr,sargeras,1730,druid,feral,60,28,32
Addymeow,drenden,1709,druid,feral,54,30,24
Thycamore,cenarius,1708,druid,feral,60,23,37
Bearoids,daggerspine,1706,druid,feral,42,29,13
Tyx,bleeding-hollow,1702,druid,feral,56,26,30
Yavà,tichondrius,1700,druid,feral,48,30,18
Dewfuss,tichondrius,1697,druid,feral,42,26,16
Turow,firetree,1690,druid,feral,53,25,28
Lesliewj,proudmoore,1688,druid,feral,41,22,19
Wildfire,nesingwary,1686,druid,feral,105,55,50
Nrp,stormrage,1684,druid,feral,108,44,64
Raincloud,mannoroth,1680,druid,feral,36,22,14
Nitetree,thrall,1679,druid,feral,60,31,29
Akanx,tichondrius,1677,druid,feral,36,21,15
Hriiya,tichondrius,1676,druid,feral,47,18,29
Tenavï,stormrage,1668,druid,feral,42,20,22
Kdrumania,tichondrius,1666,druid,feral,116,67,49
Fliip,barthilas,1662,druid,feral,47,24,23
Brewdock,boulderfist,1656,druid,feral,45,21,24
Fuqet,kelthuzad,1655,druid,feral,94,44,50
Jonio,tichondrius,1654,druid,feral,41,20,21
Mocfernando,sargeras,1652,druid,feral,36,21,15
Flowkie,illidan,1651,druid,feral,98,48,50
Chasertv,tichondrius,1650,druid,feral,36,19,17
Zlegacy,anvilmar,1650,druid,feral,54,21,33
Jpegcollectr,tichondrius,1649,druid,feral,66,23,43
Nicó,darkspear,1648,druid,feral,84,37,47
Kyoski,moon-guard,1645,druid,feral,34,19,15
Zirrie,stormrage,1640,druid,feral,44,25,19
Ferar,frostmourne,1638,druid,feral,47,22,25
Tompunch,tichondrius,1638,druid,feral,43,19,24
Bigbite,tichondrius,1637,druid,feral,48,27,21
Xyphor,bladefist,1637,druid,feral,40,22,18
Yavann,tichondrius,1636,druid,feral,66,38,28
Kolbie,emerald-dream,1636,druid,feral,96,51,45
Jaspurr,illidan,1634,druid,feral,42,26,16
Atrumn,emerald-dream,1631,druid,feral,78,33,45
Anxietyburns,stormrage,1630,druid,feral,60,36,24
Stêff,zuljin,1630,druid,feral,60,31,29
Fangry,queldorei,1623,druid,feral,88,44,44
Off,ravencrest,1622,druid,feral,172,86,86
Phøënîx,tichondrius,1622,druid,feral,36,17,19
Zyhsul,emerald-dream,1620,druid,feral,42,21,21
Durwyn,sargeras,1620,druid,feral,153,71,82
Sïmba,andorhal,1619,druid,feral,65,26,39
Enya,stormreaver,1618,druid,feral,66,31,35
Hiddenfur,ragnaros,1617,druid,feral,36,19,17
Poosnickety,kelthuzad,1617,druid,feral,49,21,28
Wøs,area-52,1615,druid,feral,92,47,45
Chococrispis,quelthalas,1606,druid,feral,48,21,27
Yüxy,sargeras,1602,druid,feral,42,19,23
Oldtomcat,moon-guard,1601,druid,feral,90,42,48
Zwaski,thrall,1601,druid,feral,68,31,37
Feralgo,tichondrius,1600,druid,feral,30,17,13
Akamu,nemesis,1600,druid,feral,48,17,31
Irontree,dunemaul,1598,druid,feral,48,23,25
Jurasico,ragnaros,1591,druid,feral,162,84,78
Rank,nerzhul,1588,druid,feral,126,59,67
Nobruh,sargeras,1588,druid,feral,77,36,41
Luvgames,area-52,1585,druid,feral,44,22,22
Oroskii,bleeding-hollow,1582,druid,feral,42,19,23
Gabdruid,kiljaeden,1578,druid,feral,42,20,22
Azrethyu,emerald-dream,1578,druid,feral,66,28,38
Dahmu,malygos,1572,druid,feral,150,79,71
Skyde,sargeras,1570,druid,feral,81,36,45
Franksuba,windrunner,1568,druid,feral,108,53,55
Csinii,bleeding-hollow,1566,druid,feral,48,18,30
Hellodan,proudmoore,1565,druid,feral,48,22,26
Idiotferal,tortheldrin,1564,druid,feral,30,19,11
Kibbens,area-52,1564,druid,feral,162,77,85
Ursarius,skullcrusher,1561,druid,feral,45,20,25
Rahxay,quelthalas,1556,druid,feral,54,24,30
Slanue,tichondrius,1556,druid,feral,64,26,38
Kwilli,tichondrius,1552,druid,feral,56,29,27
Darkombra,frostmourne,1548,druid,feral,54,27,27
Melez,kelthuzad,1547,druid,feral,139,71,68
Kaisuckslol,stormrage,1543,druid,feral,150,76,74
Fendiy,barthilas,1538,druid,feral,60,34,26
Mxdi,tichondrius,1535,druid,feral,36,19,17
Foxmeowz,blackwater-raiders,1534,druid,feral,30,16,14
Delorík,illidan,1534,druid,feral,66,32,34
Cawkaw,frostwolf,1528,druid,feral,122,62,60
Jizzie,tichondrius,1527,druid,feral,90,52,38
Plux,illidan,1522,druid,feral,126,65,61
Dustin,moon-guard,1522,druid,feral,88,43,45
Ulcera,nemesis,1520,druid,feral,48,30,18
Ikkarus,nemesis,1511,druid,feral,71,39,32
Conker,frostmourne,1509,druid,feral,49,22,27
Kushtiger,ragnaros,1508,druid,feral,102,52,50
Prowli,tichondrius,1505,druid,feral,128,69,59
Swolareclips,eitrigg,1498,druid,feral,150,72,78
Tree,lothar,1497,druid,feral,48,29,19
Ozex,crushridge,1484,druid,feral,42,17,25
Revcow,malganis,1477,druid,feral,42,21,21
Faelonk,frostmourne,1476,druid,feral,66,32,34
Bullcritzz,saurfang,1475,druid,feral,58,38,20
Eletto,stormrage,1466,druid,feral,48,25,23
Dillywadz,tichondrius,1463,druid,feral,158,72,86
Hoffhoff,area-52,1458,druid,feral,36,22,14
Blut,stormrage,1458,druid,feral,186,89,97
Luluid,tichondrius,1458,druid,feral,36,16,20
Badferal,blackhand,1455,druid,feral,78,38,40
Oreganic,barthilas,1454,druid,feral,81,42,39
Sheeyts,tichondrius,1453,druid,feral,54,28,26
Bossdru,sargeras,1447,druid,feral,47,28,19
Zivak,azshara,1445,druid,feral,48,22,26
Chomperz,tichondrius,1442,druid,feral,85,45,40
Prille,tichondrius,1438,druid,feral,33,16,17
Psychofeör,quelthalas,1433,druid,feral,36,18,18
Bênî,emerald-dream,1432,druid,feral,108,52,56
Käïïjü,tichondrius,1432,druid,feral,76,28,48
Feond,illidan,1431,druid,feral,70,37,33
Classydruid,spinebreaker,1431,druid,feral,84,39,45
Prêdator,ragnaros,1430,druid,feral,71,36,35
Wowgamer,sargeras,1427,druid,feral,24,15,9
Zenlonn,emerald-dream,1427,druid,feral,30,15,15
Hööper,illidan,1427,druid,feral,54,19,35
Weedsmuggler,burning-legion,1425,druid,feral,126,62,64
Oneinchclaw,malganis,1424,druid,feral,36,18,18
Xanybarz,stormrage,1422,druid,feral,60,23,37
Duckystryker,tichondrius,1421,druid,feral,48,17,31
Fugekî,zuljin,1420,druid,feral,41,24,17
Kaissara,nemesis,1420,druid,feral,32,17,15
Bobmarli,kiljaeden,1420,druid,feral,30,15,15
Senex,stormrage,1416,druid,feral,68,40,28
Treespec,stormrage,1414,druid,feral,29,18,11
Gairen,the-venture-co,1413,druid,feral,48,25,23
Clarice,shattered-halls,1409,druid,feral,24,15,9
Snowfaerie,moon-guard,1400,druid,feral,310,163,147
Gonjatusk,ravencrest,1397,druid,feral,54,30,24
Hoppus,icecrown,1396,druid,feral,57,20,37
Freinnar,kiljaeden,1393,druid,feral,36,15,21
Ytgamezoned,darkspear,1390,druid,feral,30,16,14
Swappy,korgath,1388,druid,feral,66,31,35
Treeweed,tichondrius,1386,druid,feral,81,42,39
Silvshifter,frostmourne,1382,druid,feral,29,22,7
Chitára,ragnaros,1379,druid,feral,106,55,51
Craak,tichondrius,1376,druid,feral,41,19,22
Bigthirty,area-52,1372,druid,feral,24,16,8
Fastcat,moon-guard,1369,druid,feral,54,25,29
Vaniedron,zuljin,1365,druid,feral,111,43,68
Gorim,area-52,1364,druid,feral,48,26,22
Sweetxtooth,area-52,1364,druid,feral,66,34,32
Erwelz,quelthalas,1363,druid,feral,29,15,14
Tardcakes,tichondrius,1362,druid,feral,62,31,31
Gnairda,sargeras,1357,druid,feral,174,90,84
Hjerim,quelthalas,1357,druid,feral,44,20,24
Kilohanno,alexstrasza,1356,druid,feral,42,19,23
Fugg,frostmourne,1350,druid,feral,84,34,50
Hadox,azralon,1348,druid,feral,83,41,42
Floorz,bleeding-hollow,1343,druid,feral,24,14,10
Kynvi,moon-guard,1343,druid,feral,30,14,16
Azoth,hyjal,1342,druid,feral,24,14,10
Senorcholo,malganis,1342,druid,feral,36,18,18
Catzetzan,tichondrius,1342,druid,feral,30,14,16
Darkdragoonz,barthilas,1340,druid,feral,37,17,20
Zuljor,sargeras,1339,druid,feral,18,14,4
Smeow,zuljin,1339,druid,feral,39,16,23
Bigmolii,quelthalas,1338,druid,feral,74,29,45
Brawleyx,tichondrius,1337,druid,feral,36,14,22
Riemannzeta,azgalor,1336,druid,feral,54,29,25
Dimsump,zuljin,1336,druid,feral,36,14,22
Malthen,quelthalas,1335,druid,feral,48,24,24
Cheshiire,moon-guard,1334,druid,feral,90,41,49
Khyzan,illidan,1329,druid,feral,78,41,37
Iamnature,dalaran,1325,druid,feral,43,17,26
Bullboy,frostmourne,1320,druid,feral,30,17,13
Panyot,kiljaeden,1318,druid,feral,60,31,29
Glockitty,tichondrius,1318,druid,feral,72,35,37
Kyrô,sargeras,1317,druid,feral,29,14,15
Nazdaq,stormrage,1313,druid,feral,62,33,29
Ninefeet,argent-dawn,1309,druid,feral,60,31,29
Suedle,kelthuzad,1309,druid,feral,29,14,15
Asteriel,stormrage,1305,druid,feral,52,25,27
Nyanncat,frostmourne,1302,druid,feral,30,14,16
Mbarakaja,malganis,1302,druid,feral,125,58,67
Nojiling,quelthalas,1301,druid,feral,55,24,31
Azuredreams,bleeding-hollow,1301,druid,feral,36,15,21
Raebies,dalaran,1297,druid,feral,93,50,43
Sahksi,lothar,1297,druid,feral,60,30,30
Frostelles,stormrage,1297,druid,feral,97,45,52
Anessan,silvermoon,1296,druid,feral,44,23,21
Ðreadfang,tichondrius,1295,druid,feral,47,28,19
Jasminonmars,zuluhed,1293,druid,feral,48,27,21
Awarz,drakkari,1291,druid,feral,36,14,22
Feanah,tichondrius,1284,druid,feral,48,22,26
Erahar,illidan,1281,druid,feral,46,24,22
Malu,muradin,1278,druid,feral,30,17,13
Percefhone,azralon,1272,druid,feral,80,34,46
Gotroadrash,azuremyst,1268,druid,feral,23,14,9
Dätto,thrall,1261,druid,feral,54,25,29
Evildooer,stormrage,1248,druid,feral,24,13,11
Zelyvia,moon-guard,1247,druid,feral,30,14,16
Sporadiclive,sargeras,1247,druid,feral,30,13,17
Waggs,illidan,1247,druid,feral,30,13,17
Mariko,area-52,1245,druid,feral,59,26,33
Enchiladacat,stormrage,1243,druid,feral,24,13,11
Shmayba,malganis,1241,druid,feral,24,13,11
Kellydacat,azuremyst,1241,druid,feral,24,13,11
Muwudred,stormrage,1240,druid,feral,24,13,11
Pfheral,area-52,1240,druid,feral,30,13,17
Theømega,stormrage,1237,druid,feral,24,13,11
Hektuk,barthilas,1235,druid,feral,34,19,15
Ourse,aegwynn,1234,druid,feral,77,46,31
Aahx,thrall,1232,druid,feral,99,54,45
Kleanxx,tichondrius,1232,druid,feral,223,111,112
Traxxo,tichondrius,1228,druid,feral,30,13,17
Matpd,norgannon,1228,druid,feral,66,28,38
Orthognathic,emerald-dream,1227,druid,feral,57,35,22
Bâgheera,sargeras,1225,druid,feral,61,25,36
Xanbàr,hyjal,1222,druid,feral,35,22,13
Yukcyducky,tichondrius,1222,druid,feral,42,15,27
Yobibit,terenas,1221,druid,feral,36,14,22
Zelazia,area-52,1219,druid,feral,30,16,14
Scruffywolf,tichondrius,1217,druid,feral,143,63,80
Xdkittyrawr,tichondrius,1216,druid,feral,76,39,37
Berd,whisperwind,1215,druid,feral,40,20,20
Midnitex,illidan,1214,druid,feral,37,16,21
Súse,sargeras,1212,druid,feral,53,24,29
Pusswhisperr,bleeding-hollow,1210,druid,feral,42,15,27
Kyrona,frostmourne,1207,druid,feral,30,21,9
Hermbott,proudmoore,1206,druid,feral,48,23,25
Spinach,moon-guard,1195,druid,feral,33,13,20
Beygatti,sargeras,1190,druid,feral,43,15,28
Khione,dreadmaul,1172,druid,feral,68,38,30
Haneulso,tichondrius,1171,druid,feral,33,14,19
Werebruin,bleeding-hollow,1169,druid,feral,55,29,26
Nomnomnomn,chogall,1168,druid,feral,22,13,9
Dehltax,stormrage,1168,druid,feral,48,26,22
Beargodx,stormrage,1163,druid,feral,42,20,22
Skufty,illidan,1158,druid,feral,60,22,38
Vintera,sargeras,1155,druid,feral,93,47,46
Floppa,whisperwind,1152,druid,feral,24,12,12
Milkmoneymeo,illidan,1151,druid,feral,24,12,12
Ryecoke,stormrage,1151,druid,feral,24,12,12
Boomboomboom,misha,1151,druid,feral,27,13,14
Lycanthrøpe,moon-guard,1151,druid,feral,30,12,18
Lakunahof,ragnaros,1149,druid,feral,27,13,14
Chambz,tichondrius,1148,druid,feral,60,24,36
Amishal,stormrage,1148,druid,feral,36,12,24
Erykk,dalaran,1147,druid,feral,36,12,24
Concordya,tichondrius,1146,druid,feral,30,13,17
Ishiftalot,bleeding-hollow,1145,druid,feral,51,20,31
Anastasyiar,illidan,1142,druid,feral,30,12,18
Shiftex,arthas,1140,druid,feral,30,12,18
Zazieraiel,moon-guard,1139,druid,feral,33,13,20
Styli,tichondrius,1130,druid,feral,18,12,6
Chëësëbürgër,illidan,1128,druid,feral,97,45,52
Yobolsun,sargeras,1123,druid,feral,36,16,20
Elunaya,illidan,1122,druid,feral,36,15,21
Tonoshapepai,azralon,1122,druid,feral,36,13,23
Borybuilder,azralon,1121,druid,feral,38,14,24
Shahahrazad,queldorei,1118,druid,feral,36,12,24
Eyzie,stormrage,1115,druid,feral,36,13,23
Daniin,azralon,1107,druid,feral,66,29,37
Ðementia,stormrage,1104,druid,feral,72,41,31
Surmise,tichondrius,1100,druid,feral,24,12,12
Azakana,sargeras,1094,druid,feral,23,12,11
Leight,whisperwind,1093,druid,feral,24,14,10
Strikinina,azralon,1091,druid,feral,61,26,35
Kotau,azralon,1089,druid,feral,24,16,8
Trevvor,thrall,1070,druid,feral,36,12,24
Fb,darkspear,1069,druid,feral,20,12,8
Druidsling,mugthol,1065,druid,feral,44,17,27
Pokémon,grizzly-hills,1064,druid,feral,33,15,18
Twigz,illidan,1059,druid,feral,42,21,21
Birdy,proudmoore,1056,druid,feral,18,11,7
Glenn,norgannon,1056,druid,feral,18,11,7
Switchform,kiljaeden,1056,druid,feral,18,11,7
Fyrkax,sargeras,1056,druid,feral,18,11,7
Lelobull,ragnaros,1056,druid,feral,48,19,29
Dangersweg,frostmourne,1056,druid,feral,30,11,19
Bhen,tichondrius,1055,druid,feral,18,11,7
Orekinya,area-52,1055,druid,feral,24,11,13
Tabbsy,frostmourne,1055,druid,feral,36,11,25
Kellydabear,azuremyst,1054,druid,feral,24,11,13
Goldferal,illidan,1053,druid,feral,12,11,1
Naturestouch,tichondrius,1053,druid,feral,24,11,13
Myeow,illidan,1052,druid,feral,24,11,13
Corv,drenden,1051,druid,feral,16,12,4
Swindlestan,zuljin,1051,druid,feral,24,11,13
Unfriendly,bleeding-hollow,1050,druid,feral,24,11,13
Kongquest,emerald-dream,1049,druid,feral,36,11,25
Vykarux,suramar,1048,druid,feral,24,11,13
Yám,tichondrius,1048,druid,feral,30,11,19
Bleedz,mugthol,1040,druid,feral,24,11,13
Dkkng,dalaran,1039,druid,feral,18,11,7
Buhooki,tichondrius,1035,druid,feral,77,37,40
Anarad,dalaran,1032,druid,feral,30,15,15
Seraphim,lightnings-blade,1029,druid,feral,60,30,30
Bloodriot,wyrmrest-accord,1026,druid,feral,36,11,25
Screwdrivers,moon-guard,1022,druid,feral,29,11,18
Fennel,korgath,1017,druid,feral,23,11,12
Lyndonww,frostmourne,1006,druid,feral,26,12,14
Ursuur,drakkari,1004,druid,feral,29,11,18
Afrogx,dalaran,1001,druid,feral,24,11,13
Ruzkit,illidan,996,druid,feral,30,14,16
Sisilo,bonechewer,971,druid,feral,60,23,37
Semveta,alleria,960,druid,feral,12,10,2
Hypérion,dalaran,960,druid,feral,24,10,14
Buffjungle,tichondrius,960,druid,feral,26,10,16
Meanbear,stormrage,959,druid,feral,18,10,8
Juiceonlips,sargeras,959,druid,feral,18,10,8
Kuzigothigh,thunderhorn,959,druid,feral,48,25,23
Kekepöp,illidan,959,druid,feral,24,10,14
Yaboidakota,stormrage,959,druid,feral,24,10,14
Tysandra,sargeras,959,druid,feral,30,10,20
Beastbaby,eldrethalas,959,druid,feral,30,10,20
Nearkoo,tichondrius,958,druid,feral,24,10,14
Rekrasaur,emerald-dream,958,druid,feral,30,10,20
Doubledówn,sargeras,957,druid,feral,72,33,39
Hoofin,blackwing-lair,957,druid,feral,24,10,14
Pavel,aerie-peak,957,druid,feral,59,18,41
Swornenemy,mugthol,956,druid,feral,18,10,8
Shiftingdean,sargeras,956,druid,feral,30,10,20
Grizzlepaw,tichondrius,955,druid,feral,24,10,14
Kaya,hyjal,955,druid,feral,24,10,14
Moonbow,frostmourne,954,druid,feral,18,10,8
Dorio,quelthalas,952,druid,feral,18,10,8
Barbary,tichondrius,952,druid,feral,24,10,14
Duckieheit,sargeras,952,druid,feral,24,10,14
Datkittydoe,kiljaeden,952,druid,feral,24,10,14
Hobbles,emerald-dream,949,druid,feral,24,10,14
Drdanknugs,laughing-skull,939,druid,feral,36,10,26
Feraluwu,illidan,938,druid,feral,18,10,8
Téddybéar,smolderthorn,929,druid,feral,12,10,2
Greasemonkey,trollbane,919,druid,feral,22,12,10
Sjana,bleeding-hollow,918,druid,feral,18,11,7
Skrillin,thrall,914,druid,feral,23,11,12
Superwrath,khaz-modan,908,druid,feral,17,10,7
Àspên,moon-guard,908,druid,feral,42,20,22
Wildbeasts,proudmoore,908,druid,feral,75,33,42
Lusk,blades-edge,908,druid,feral,53,22,31
Blêêd,stormscale,904,druid,feral,13,12,1
Threeo,burning-blade,889,druid,feral,16,10,6
Taurenaught,aegwynn,881,druid,feral,37,17,20
Eglania,stormrage,866,druid,feral,24,11,13
Retzerbil,sargeras,864,druid,feral,12,9,3
Hatergodx,ravencrest,864,druid,feral,18,9,9
Feorb,azuremyst,864,druid,feral,24,9,15
Féèd,stormrage,863,druid,feral,18,9,9
Tt,akama,863,druid,feral,18,9,9
Jazzxs,proudmoore,863,druid,feral,18,9,9
Gz,icecrown,863,druid,feral,18,9,9
Ërebüs,emerald-dream,863,druid,feral,25,10,15
Thaherb,korgath,863,druid,feral,24,9,15
Malfurionsto,moon-guard,863,druid,feral,30,9,21
Wabbehkus,barthilas,862,druid,feral,36,9,27
Catten,barthilas,860,druid,feral,12,9,3
Roots,anubarak,860,druid,feral,18,9,9
Tommyjimmy,andorhal,860,druid,feral,18,9,9
Boofings,sargeras,860,druid,feral,18,9,9
Behrhart,stormrage,859,druid,feral,12,9,3
Jonoa,nagrand,858,druid,feral,24,9,15
Rum,the-venture-co,857,druid,feral,36,14,22
Tolldruid,chogall,852,druid,feral,24,10,14
Koag,dalaran,851,druid,feral,23,11,12
Wuarlo,moon-guard,846,druid,feral,73,34,39
Predatõr,malorne,841,druid,feral,24,10,14
Sosd,kelthuzad,837,druid,feral,17,9,8
Fogboom,area-52,830,druid,feral,20,10,10
Mavren,uldaman,828,druid,feral,25,9,16
Fanaror,frostmourne,822,druid,feral,18,9,9
Shartasm,anetheron,822,druid,feral,30,12,18
Tatiannaa,stormreaver,815,druid,feral,15,10,5
Gapingloli,tichondrius,813,druid,feral,15,9,6
Feorelm,proudmoore,810,druid,feral,17,9,8
Nephdruid,stormrage,804,druid,feral,30,9,21
Kattles,frostmourne,768,druid,feral,12,8,4
Cätwälk,gnomeregan,768,druid,feral,12,8,4
Notinsanity,proudmoore,768,druid,feral,12,8,4
Jason,vashj,768,druid,feral,12,8,4
Gregondor,skullcrusher,768,druid,feral,12,8,4
Anìmorph,sargeras,768,druid,feral,12,8,4
Cjæ,bleeding-hollow,768,druid,feral,15,9,6
Mooncatbear,malganis,768,druid,feral,18,8,10
Férállgødx,area-52,768,druid,feral,18,8,10
Sylvaster,stormrage,768,druid,feral,24,8,16
Saltydru,illidan,768,druid,feral,24,8,16
Nahelae,tichondrius,767,druid,feral,12,8,4
Pokeyouryolk,sargeras,767,druid,feral,12,8,4
Jentzull,tichondrius,767,druid,feral,12,8,4
Pergutory,frostmourne,767,druid,feral,18,8,10
Koducck,tichondrius,767,druid,feral,18,8,10
Kìttykat,stormrage,767,druid,feral,18,8,10
Udderchaos,dark-iron,767,druid,feral,18,8,10
Fullmoon,greymane,767,druid,feral,22,9,13
Angulus,darkspear,766,druid,feral,18,8,10
Herbx,sargeras,765,druid,feral,18,8,10
Dròódles,barthilas,764,druid,feral,12,8,4
Zimah,illidan,764,druid,feral,18,8,10
Raknary,kelthuzad,764,druid,feral,30,8,22
Freddiemerk,moon-guard,763,druid,feral,18,8,10
Framko,quelthalas,763,druid,feral,36,8,28
Gamble,the-underbog,760,druid,feral,24,8,16
Pawprika,tichondrius,758,druid,feral,30,9,21
Mychi,ragnaros,748,druid,feral,20,9,11
Reallysauce,zuljin,748,druid,feral,18,8,10
Nodraent,quelthalas,741,druid,feral,18,8,10
Amdruid,bloodhoof,735,druid,feral,14,9,5
Ashmila,ragnaros,716,druid,feral,17,8,9
Mazoak,sargeras,703,druid,feral,28,8,20
Zderhs,blackrock,702,druid,feral,14,8,6
Byson,bleeding-hollow,702,druid,feral,17,8,9
Shakedru,stormrage,684,druid,feral,19,8,11
Cracked,vashj,672,druid,feral,12,7,5
Primalxd,area-52,672,druid,feral,12,7,5
Susruth,area-52,672,druid,feral,12,7,5
Zðzð,zuljin,672,druid,feral,12,7,5
Tnvï,stormrage,672,druid,feral,12,7,5
Dailydruid,illidan,672,druid,feral,12,7,5
Elyveen,proudmoore,672,druid,feral,12,7,5
Krobz,bleeding-hollow,672,druid,feral,12,7,5
Kiwidru,frostmourne,672,druid,feral,12,7,5
Boll,akama,672,druid,feral,12,7,5
Scuffedx,tichondrius,672,druid,feral,12,7,5
Shiftage,frostmane,672,druid,feral,18,7,11
Flowke,illidan,672,druid,feral,18,7,11
Meowny,area-52,672,druid,feral,18,7,11
Selendis,tichondrius,672,druid,feral,18,7,11
Faithxo,stormrage,672,druid,feral,18,7,11
Hroney,area-52,672,druid,feral,18,7,11
Lunacore,illidan,672,druid,feral,18,7,11
Muffbfloppn,zuljin,672,druid,feral,18,7,11
Bearlyviable,stormrage,672,druid,feral,21,8,13
Bobochan,tichondrius,672,druid,feral,24,7,17
Happyhotter,proudmoore,671,druid,feral,12,7,5
Ännä,moon-guard,671,druid,feral,18,7,11
Druidydruid,blackrock,671,druid,feral,18,7,11
Bananawaffle,proudmoore,671,druid,feral,18,7,11
Bearmuda,trollbane,671,druid,feral,18,7,11
Samirgodx,tichondrius,671,druid,feral,18,7,11
Momoxchan,quelthalas,671,druid,feral,18,7,11
Ruckiz,stormrage,671,druid,feral,18,7,11
Thegrefgx,ragnaros,670,druid,feral,12,7,5
Aligantor,thrall,670,druid,feral,12,7,5
Servax,illidan,670,druid,feral,18,7,11
Curainfeliz,nemesis,669,druid,feral,12,7,5
Bullshiftin,area-52,669,druid,feral,12,7,5
Redness,daggerspine,669,druid,feral,18,7,11
Yokimo,amanthul,668,druid,feral,18,7,11
Jordiët,dalaran,667,druid,feral,12,7,5
Oxvxo,senjin,648,druid,feral,18,7,11
Hyperlite,bonechewer,643,druid,feral,18,7,11
Injail,tichondrius,640,druid,feral,16,7,9
Arntu,malganis,639,druid,feral,11,7,4
Chadwickx,illidan,639,druid,feral,11,7,4
Ekkoh,sargeras,638,druid,feral,17,7,10
Jeanz,bonechewer,632,druid,feral,19,9,10
Meowzetzan,tichondrius,623,druid,feral,11,7,4
Slapymilf,dentarg,623,druid,feral,11,7,4
Ruhgen,deathwing,622,druid,feral,17,7,10
Puzzykat,uldum,621,druid,feral,27,7,20
Gutzzu,area-52,619,druid,feral,15,7,8
Weedleaf,wyrmrest-accord,610,druid,feral,20,8,12
Beaker,uldum,605,druid,feral,11,7,4
Earlgrayl,kelthuzad,591,druid,feral,13,7,6
Bigherbo,zuljin,585,druid,feral,20,8,12
Duuj,illidan,576,druid,feral,6,6,0
Lïberty,ragnaros,576,druid,feral,6,6,0
Meldzetzan,tichondrius,576,druid,feral,6,6,0
Hybridxo,kelthuzad,576,druid,feral,6,6,0
Cíphenz,illidan,576,druid,feral,12,6,6
Shiftalk,nerzhul,576,druid,feral,12,6,6
Nelfwaifú,area-52,576,druid,feral,12,6,6
Bloodynine,cairne,576,druid,feral,12,6,6
Wilddeity,tichondrius,576,druid,feral,12,6,6
Hashmall,ragnaros,576,druid,feral,12,6,6
Bables,tichondrius,576,druid,feral,12,6,6
Sooey,wyrmrest-accord,576,druid,feral,12,6,6
Funkattack,tichondrius,576,druid,feral,12,6,6
Spaléxgu,azralon,576,druid,feral,12,6,6
Whitetigeris,tichondrius,576,druid,feral,12,6,6
Daniverse,sargeras,576,druid,feral,12,6,6
Thontt,sargeras,576,druid,feral,12,6,6
Kittysnuggle,emerald-dream,576,druid,feral,15,7,8
Welshblack,tichondrius,576,druid,feral,16,7,9
Jinhova,stormrage,576,druid,feral,15,6,9
Calikonger,spirestone,576,druid,feral,18,6,12
Rebrrth,antonidas,576,druid,feral,18,6,12
Kittendev,tichondrius,576,druid,feral,18,6,12
Sugarbawls,area-52,576,druid,feral,24,6,18
Wulfjack,emerald-dream,575,druid,feral,12,6,6
Amoru,moon-guard,575,druid,feral,12,6,6
Fireeloot,tichondrius,575,druid,feral,12,6,6
Omnilul,zuljin,575,druid,feral,12,6,6
Stríðsmaður,area-52,575,druid,feral,12,6,6
Allenjunior,ragnaros,575,druid,feral,12,6,6
Davinchii,drakkari,575,druid,feral,12,6,6
Austîn,moon-guard,575,druid,feral,12,6,6
Beelzehog,whisperwind,574,druid,feral,12,6,6
Dinnerbone,echo-isles,573,druid,feral,12,6,6
Hupod,proudmoore,573,druid,feral,18,6,12
Nikozho,sargeras,573,druid,feral,18,6,12
Kragma,zuluhed,572,druid,feral,12,6,6
Soldadito,zuljin,572,druid,feral,15,7,8
Udala,durotan,572,druid,feral,14,6,8
Snowlion,the-forgotten-coast,570,druid,feral,12,6,6
Expells,nemesis,569,druid,feral,18,6,12
Bigdeeza,frostmourne,566,druid,feral,12,6,6
Odesellena,moon-guard,563,druid,feral,18,6,12
Druidcyber,stormrage,543,druid,feral,16,6,10
Dreamfyre,kiljaeden,543,druid,feral,17,6,11
Lacrarola,nemesis,542,druid,feral,11,6,5
Lémons,tichondrius,542,druid,feral,17,6,11
Wtfimacat,area-52,527,druid,feral,11,6,5
Ðjangø,goldrinn,525,druid,feral,11,6,5
Drulicious,tichondrius,522,druid,feral,14,7,7
Shadalor,frostmourne,512,druid,feral,16,6,10
Kilbys,nemesis,510,druid,feral,8,6,2
Iamatomic,illidan,509,druid,feral,20,6,14
Druski,lightbringer,508,druid,feral,11,6,5
Bearjoo,kelthuzad,495,druid,feral,18,6,12
Flompstomper,skullcrusher,480,druid,feral,6,5,1
Exxh,tichondrius,480,druid,feral,6,5,1
Nbnbnb,proudmoore,480,druid,feral,6,5,1
Sweetnippies,elune,480,druid,feral,6,5,1
Féralis,sargeras,480,druid,feral,6,5,1
Sweetpurple,elune,480,druid,feral,6,5,1
Gloomcat,illidan,480,druid,feral,6,5,1
Idiotdruid,ragnaros,480,druid,feral,6,5,1
Carboz,jubeithos,480,druid,feral,6,5,1
Linkinbiox,alleria,480,druid,feral,12,5,7
Gunnymad,tichondrius,480,druid,feral,12,5,7
Choolah,area-52,480,druid,feral,12,5,7
Softshirtxo,ragnaros,480,druid,feral,12,5,7
Topangâ,lightninghoof,480,druid,feral,12,5,7
Bloodyugly,area-52,480,druid,feral,12,5,7
Noet,ragnaros,480,druid,feral,12,5,7
Karizikat,tichondrius,480,druid,feral,12,5,7
Lunarboy,tichondrius,480,druid,feral,12,5,7
Feralhearted,kelthuzad,480,druid,feral,12,5,7
Mythienair,stormrage,480,druid,feral,12,5,7
Loamie,proudmoore,480,druid,feral,12,5,7
Frenzyirl,darkspear,480,druid,feral,12,5,7
Neetform,zuljin,480,druid,feral,12,5,7
Ninelivez,gorgonnash,480,druid,feral,12,5,7
Yizhiyuren,aegwynn,480,druid,feral,12,5,7
Zeratull,cenarius,480,druid,feral,12,5,7
Lurky,dalvengyr,480,druid,feral,12,5,7
Honeybeam,moon-guard,480,druid,feral,12,5,7
Scorn,spirestone,480,druid,feral,13,5,8
Fredolay,tichondrius,480,druid,feral,13,5,8
Oneninesix,frostmourne,480,druid,feral,18,5,13
Bere,kul-tiras,480,druid,feral,18,5,13
Caelüm,area-52,480,druid,feral,18,5,13
Kobebeef,malganis,480,druid,feral,18,5,13
Gouzz,frostmourne,480,druid,feral,18,5,13
Doblun,nemesis,480,druid,feral,18,5,13
Purrcat,tichondrius,480,druid,feral,18,5,13
Goorybud,tichondrius,479,druid,feral,6,5,1
Cooln,bleeding-hollow,479,druid,feral,6,5,1
Aeonás,tichondrius,479,druid,feral,12,5,7
Snugglin,kelthuzad,479,druid,feral,12,5,7
Animalcade,area-52,479,druid,feral,12,5,7
Balthøs,moon-guard,479,druid,feral,12,5,7
Calani,lightnings-blade,479,druid,feral,12,5,7
Ysemia,drakkari,479,druid,feral,14,5,9
Zauska,cenarion-circle,479,druid,feral,18,5,13
Drewiid,stormrage,478,druid,feral,12,5,7
Nokther,muradin,478,druid,feral,24,5,19
Ediiann,cenarius,477,druid,feral,12,5,7
Wokoom,windrunner,474,druid,feral,24,5,19
Moonrg,stormrage,431,druid,feral,11,5,6
Maplesyrup,moonrunner,431,druid,feral,11,5,6
Yunekai,stormrage,415,druid,feral,11,5,6
Vaelthunis,sargeras,400,druid,feral,13,5,8
Nâturê,dalaran,384,druid,feral,6,4,2
Orizane,moon-guard,384,druid,feral,6,4,2
Soaring,moon-guard,384,druid,feral,6,4,2
Bearcathawk,sargeras,384,druid,feral,6,4,2
Oobuck,kilrogg,384,druid,feral,6,4,2
Kittycudi,hyjal,384,druid,feral,6,4,2
Niwßor,azralon,384,druid,feral,6,4,2
Curet,lightbringer,384,druid,feral,6,4,2
Kistormx,tichondrius,384,druid,feral,6,4,2
Cfab,tichondrius,384,druid,feral,6,4,2
Pressuretd,frostmourne,384,druid,feral,6,4,2
Menapäws,area-52,384,druid,feral,6,4,2
Jaegerbombx,sargeras,384,druid,feral,6,4,2
Drywatter,tichondrius,384,druid,feral,6,4,2
Vecuronium,tichondrius,384,druid,feral,6,4,2
Miviaris,alleria,384,druid,feral,6,4,2
Olhosdlua,azralon,384,druid,feral,6,4,2
Aldr,tichondrius,384,druid,feral,6,4,2
Zzkitty,stormreaver,384,druid,feral,6,4,2
Robomexi,tichondrius,384,druid,feral,6,4,2
Mameseph,lightnings-blade,384,druid,feral,6,4,2
Hótlife,fizzcrank,384,druid,feral,6,4,2
Eliteshift,frostmourne,384,druid,feral,6,4,2
Unfunnyferal,kelthuzad,384,druid,feral,6,4,2
Srwow,elune,384,druid,feral,6,4,2
Toiiz,malganis,384,druid,feral,9,4,5
Genuine,guldan,384,druid,feral,11,4,7
Gernichora,barthilas,384,druid,feral,12,4,8
Iamfynch,sargeras,384,druid,feral,12,4,8
Moohok,bleeding-hollow,384,druid,feral,12,4,8
Gatona,stormrage,384,druid,feral,12,4,8
Carnumoose,zuljin,384,druid,feral,12,4,8
Teddybear,medivh,384,druid,feral,12,4,8
Feralgød,tichondrius,384,druid,feral,12,4,8
Freshzk,azralon,384,druid,feral,12,4,8
Alaillais,moon-guard,384,druid,feral,12,4,8
Pollykush,sargeras,384,druid,feral,12,4,8
Lycanjungle,azralon,384,druid,feral,12,4,8
Auxl,tichondrius,384,druid,feral,12,4,8
Weeñor,tichondrius,384,druid,feral,12,4,8
Quiziato,burning-legion,384,druid,feral,12,4,8
Kajla,sargeras,384,druid,feral,12,4,8
Sellîas,senjin,384,druid,feral,12,4,8
Carlosd,tichondrius,384,druid,feral,12,4,8
Ewok,vashj,384,druid,feral,12,4,8
Toetoetoete,darrowmere,384,druid,feral,12,4,8
Pretzle,kelthuzad,384,druid,feral,12,4,8
Bearlylegalz,kelthuzad,384,druid,feral,12,4,8
Pereréka,azralon,384,druid,feral,14,4,10
Ráhilk,quelthalas,384,druid,feral,18,4,14
Houseboat,hellscream,384,druid,feral,18,4,14
Startalons,area-52,384,druid,feral,18,4,14
Berall,bleeding-hollow,383,druid,feral,6,4,2
Jamesbailey,sargeras,383,druid,feral,12,4,8
Bramth,quelthalas,383,druid,feral,12,4,8
Porrosman,quelthalas,383,druid,feral,12,4,8
Shoboski,quelthalas,383,druid,feral,12,4,8
Topguncarl,illidan,383,druid,feral,12,4,8
Sansao,sargeras,383,druid,feral,12,4,8
Mfgs,kelthuzad,383,druid,feral,12,4,8
Mogli,perenolde,383,druid,feral,30,4,26
Jabiso,smolderthorn,382,druid,feral,12,4,8
Ssimbaa,area-52,382,druid,feral,12,4,8
Dalinaìr,moon-guard,382,druid,feral,12,4,8
Eightyhd,ravencrest,351,druid,feral,11,4,7
Defku,quelthalas,330,druid,feral,28,6,22
Ogversaucey,skullcrusher,288,druid,feral,6,3,3
Dairycream,skullcrusher,288,druid,feral,6,3,3
Ysero,area-52,288,druid,feral,6,3,3
Yseraspawn,kelthuzad,288,druid,feral,6,3,3
Purrfact,frostmourne,288,druid,feral,6,3,3
Kurokyy,frostmourne,288,druid,feral,6,3,3
Uag,emerald-dream,288,druid,feral,6,3,3
Bubbleshiftz,area-52,288,druid,feral,6,3,3
Shalaz,magtheridon,288,druid,feral,6,3,3
Owlcapwn,stormreaver,288,druid,feral,6,3,3
Bootayclappa,sargeras,288,druid,feral,6,3,3
Arienne,kelthuzad,288,druid,feral,6,3,3
Griefs,emerald-dream,288,druid,feral,6,3,3
Pabag,chogall,288,druid,feral,6,3,3
Thecolortwoo,tichondrius,288,druid,feral,6,3,3
Celetra,kiljaeden,288,druid,feral,6,3,3
Worgbearpig,destromath,288,druid,feral,6,3,3
Ripx,khadgar,288,druid,feral,6,3,3
Neksir,ragnaros,288,druid,feral,6,3,3
Deadlykept,ragnaros,288,druid,feral,6,3,3
Posmard,ragnaros,288,druid,feral,6,3,3
Deaddpool,ragnaros,288,druid,feral,6,3,3
Katatafish,azralon,288,druid,feral,6,3,3
Øvernight,azralon,288,druid,feral,6,3,3
Yesqt,dalaran,288,druid,feral,6,3,3
Destrez,ragnaros,288,druid,feral,6,3,3
Riverthorne,moon-guard,288,druid,feral,6,3,3
Rígél,ragnaros,288,druid,feral,6,3,3
Meowzedon,sargeras,288,druid,feral,6,3,3
Zadayos,aerie-peak,288,druid,feral,6,3,3
Espoir,azuremyst,288,druid,feral,6,3,3
Nichodameus,firetree,288,druid,feral,6,3,3
Hitchslaps,tichondrius,288,druid,feral,6,3,3
Parallax,shadowsong,288,druid,feral,6,3,3
Rotclaws,stormrage,288,druid,feral,6,3,3
Datlogan,tichondrius,288,druid,feral,6,3,3
Steakjr,senjin,288,druid,feral,6,3,3
Jeperty,tichondrius,288,druid,feral,6,3,3
Rairven,stormrage,288,druid,feral,6,3,3
Frrest,proudmoore,288,druid,feral,6,3,3
Chopleaf,khadgar,288,druid,feral,6,3,3
Ahhpalu,tichondrius,288,druid,feral,6,3,3
Opconvoke,illidan,288,druid,feral,6,3,3
Nofeets,azshara,288,druid,feral,6,3,3
Plantdaddy,bladefist,288,druid,feral,6,3,3
Elythria,hellscream,288,druid,feral,6,3,3
Tasselhoof,hyjal,288,druid,feral,6,3,3
Hyldru,stormrage,288,druid,feral,6,3,3
Bigskeeve,sargeras,288,druid,feral,6,3,3
Riddickd,malfurion,288,druid,feral,6,3,3
Lilrichdmg,sargeras,288,druid,feral,6,3,3
Zalmo,area-52,288,druid,feral,9,4,5
Lovemakitty,sargeras,288,druid,feral,12,3,9
Tchallå,tichondrius,288,druid,feral,12,3,9
Tenedoors,ragnaros,288,druid,feral,12,3,9
Hídde,quelthalas,288,druid,feral,12,3,9
Rivetrix,azralon,288,druid,feral,12,3,9
Peppapig,mugthol,288,druid,feral,12,3,9
Oo,grizzly-hills,288,druid,feral,12,3,9
Maplêleaf,moon-guard,288,druid,feral,12,3,9
Vorare,tichondrius,288,druid,feral,12,3,9
Flayx,frostmourne,288,druid,feral,12,3,9
Drailyo,ravenholdt,288,druid,feral,12,3,9
Näna,dalaran,288,druid,feral,12,3,9
Lilnippy,stormscale,288,druid,feral,12,3,9
Uniquex,zuljin,288,druid,feral,12,3,9
Garuharken,skullcrusher,288,druid,feral,12,3,9
Solstice,frostmourne,288,druid,feral,12,3,9
Flushi,nagrand,288,druid,feral,12,3,9
Catorcow,aegwynn,288,druid,feral,13,3,10
Iamthewambo,bloodhoof,288,druid,feral,30,3,27
Extremeshift,dalaran,287,druid,feral,8,4,4
Rawrii,nemesis,287,druid,feral,6,3,3
Kurodash,tichondrius,287,druid,feral,6,3,3
Slymar,darkspear,287,druid,feral,6,3,3
Absoles,agamaggan,287,druid,feral,12,3,9
Schwiftea,skullcrusher,287,druid,feral,12,3,9
Psychosis,kul-tiras,285,druid,feral,12,3,9
Punderful,stormrage,254,druid,feral,10,4,6
Trippykitty,tichondrius,240,druid,feral,9,3,6
Yámï,stormrage,239,druid,feral,5,3,2
Worldly,medivh,223,druid,feral,14,3,11
Rosalba,zuljin,221,druid,feral,29,8,21
Ebrìthil,hyjal,208,druid,feral,7,3,4
Puiltraxs,ragnaros,192,druid,feral,4,3,1
Feraldudu,illidan,192,druid,feral,4,3,1
Shiftdeznutz,tichondrius,192,druid,feral,6,2,4
Unclebolty,frostmourne,192,druid,feral,6,2,4
Klawzy,thrall,192,druid,feral,6,2,4
Yakir,kiljaeden,192,druid,feral,6,2,4
Aethorax,hyjal,192,druid,feral,6,2,4
Samsaralol,tichondrius,192,druid,feral,6,2,4
Augus,hyjal,192,druid,feral,6,2,4
Ikova,frostmourne,192,druid,feral,6,2,4
Geno,cenarius,192,druid,feral,6,2,4
Kanadae,thrall,192,druid,feral,6,2,4
Illr,laughing-skull,192,druid,feral,6,2,4
Dawsonxo,proudmoore,192,druid,feral,6,2,4
Manwool,illidan,192,druid,feral,6,2,4
Shiftwork,korgath,192,druid,feral,6,2,4
Asmondruud,tichondrius,192,druid,feral,6,2,4
Stolenrims,tichondrius,192,druid,feral,6,2,4
Zascat,malganis,192,druid,feral,6,2,4
Metaldruid,tichondrius,192,druid,feral,6,2,4
Kurakai,runetotem,192,druid,feral,6,2,4
Loserceo,stormrage,192,druid,feral,6,2,4
Onewitnature,nordrassil,192,druid,feral,6,2,4
Aurajin,spinebreaker,192,druid,feral,6,2,4
Bullbuddy,wyrmrest-accord,192,druid,feral,6,2,4
Bernoboy,kelthuzad,192,druid,feral,6,2,4
Imass,draka,192,druid,feral,6,2,4
Karpin,area-52,192,druid,feral,6,2,4
Catmóm,tichondrius,192,druid,feral,6,2,4
Taztoc,stormrage,192,druid,feral,6,2,4
Prosperz,dalaran,192,druid,feral,6,2,4
Tootiebootie,bleeding-hollow,192,druid,feral,6,2,4
Hännibal,hydraxis,192,druid,feral,6,2,4
Dankbite,doomhammer,192,druid,feral,6,2,4
Barrah,barthilas,192,druid,feral,6,2,4
Haegur,tichondrius,192,druid,feral,6,2,4
Bronaarr,nordrassil,192,druid,feral,6,2,4
Numbkin,stormrage,192,druid,feral,6,2,4
Atreis,malganis,192,druid,feral,6,2,4
Eliaris,rivendare,192,druid,feral,6,2,4
Strixferal,zuljin,192,druid,feral,6,2,4
Kikothecat,burning-blade,192,druid,feral,6,2,4
Madador,bleeding-hollow,192,druid,feral,6,2,4
Taiga,moon-guard,192,druid,feral,6,2,4
Qouro,area-52,192,druid,feral,6,2,4
Dreadonly,tichondrius,192,druid,feral,6,2,4
Snupy,area-52,192,druid,feral,6,2,4
Vivinara,moon-guard,192,druid,feral,6,2,4
Omgapuddycat,stormrage,192,druid,feral,6,2,4
Owd,tichondrius,192,druid,feral,6,2,4
Milezy,area-52,192,druid,feral,6,2,4
Athious,moon-guard,192,druid,feral,6,2,4
Binjuicex,frostmourne,192,druid,feral,6,2,4
Sosorry,blackhand,192,druid,feral,6,2,4
Corym,frostmourne,192,druid,feral,6,2,4
Bdsurges,illidan,192,druid,feral,6,2,4
Uphine,area-52,192,druid,feral,6,2,4
Theliono,lightnings-blade,192,druid,feral,6,2,4
Nabious,malganis,192,druid,feral,6,2,4
Varietypack,antonidas,192,druid,feral,6,2,4
Handolar,quelthalas,192,druid,feral,6,2,4
Veryhighrn,area-52,192,druid,feral,6,2,4
Lavanca,azralon,192,druid,feral,6,2,4
Fieryferal,kargath,192,druid,feral,6,2,4
Apothe,emerald-dream,192,druid,feral,6,2,4
Pawblems,sargeras,192,druid,feral,6,2,4
Wreckked,sargeras,192,druid,feral,6,2,4
Evolute,sargeras,192,druid,feral,6,2,4
Katskratch,sargeras,192,druid,feral,6,2,4
Happyc,bleeding-hollow,192,druid,feral,12,2,10
Faroo,azralon,192,druid,feral,12,2,10
Seyala,moon-guard,192,druid,feral,12,2,10
Codieneme,blades-edge,192,druid,feral,12,2,10
Nerfdemo,kiljaeden,192,druid,feral,12,2,10
Pawz,windrunner,192,druid,feral,12,2,10
Envasions,emerald-dream,192,druid,feral,12,2,10
Drabo,boulderfist,192,druid,feral,12,2,10
Shiftyounot,shattered-hand,192,druid,feral,12,2,10
Ymirgore,zuljin,192,druid,feral,12,2,10
Meudayr,crushridge,192,druid,feral,12,2,10
Shadedmika,zuljin,192,druid,feral,12,2,10
Igneël,ragnaros,192,druid,feral,12,2,10
Àcid,stormreaver,192,druid,feral,12,2,10
Boomanon,illidan,191,druid,feral,6,2,4
Liightbite,illidan,191,druid,feral,12,2,10
Feralhearted,tichondrius,175,druid,feral,11,2,9
Dullbozer,thrall,159,druid,feral,5,2,3
Jdoozie,bleeding-hollow,159,druid,feral,5,2,3
Bowbaggins,bleeding-hollow,159,druid,feral,5,2,3
Jihadibleeds,stormrage,138,druid,feral,7,3,4
Kipsmiffly,darkspear,128,druid,feral,4,2,2
Mawnster,drenden,96,druid,feral,3,2,1
Acórn,frostmourne,96,druid,feral,6,1,5
Ärianagrande,stormrage,96,druid,feral,6,1,5
Polyproof,emerald-dream,96,druid,feral,6,1,5
Poppynoff,barthilas,96,druid,feral,6,1,5
Asaptom,frostmourne,96,druid,feral,6,1,5
Ilikedôggy,saurfang,96,druid,feral,6,1,5
Kî,thunderlord,96,druid,feral,6,1,5
Valdr,stormrage,96,druid,feral,6,1,5
Swippy,blackhand,96,druid,feral,6,1,5
Importedalc,zuljin,96,druid,feral,6,1,5
Jawsbee,emerald-dream,96,druid,feral,6,1,5
Krawnk,zuljin,96,druid,feral,6,1,5
Lakroz,zuljin,96,druid,feral,6,1,5
Dééz,illidan,96,druid,feral,6,1,5
Ghostboy,zuljin,96,druid,feral,6,1,5
Wreckingcrew,emerald-dream,96,druid,feral,6,1,5
Fortunecat,illidan,96,druid,feral,6,1,5
Hynz,barthilas,96,druid,feral,6,1,5
Aigo,azralon,96,druid,feral,6,1,5
Naztekk,dalaran,96,druid,feral,6,1,5
Raigor,azralon,96,druid,feral,6,1,5
Thebigcat,deathwing,96,druid,feral,6,1,5
Frëýá,bleeding-hollow,96,druid,feral,6,1,5
Purpyo,bleeding-hollow,96,druid,feral,6,1,5
Ban,chogall,96,druid,feral,6,1,5
Whiplash,deathwing,96,druid,feral,6,1,5
Vernaar,laughing-skull,96,druid,feral,6,1,5
Furrycon,ysera,96,druid,feral,6,1,5
Glorp,blackwater-raiders,96,druid,feral,6,1,5
Tuskdaddie,sargeras,96,druid,feral,6,1,5
Édzar,area-52,96,druid,feral,6,1,5
Crazypaddy,dark-iron,96,druid,feral,6,1,5
Barnabie,black-dragonflight,96,druid,feral,6,1,5
Ausbie,garona,96,druid,feral,6,1,5
Bootzs,kelthuzad,96,druid,feral,6,1,5
Aquahektik,malganis,96,druid,feral,6,1,5
Chumdrumrum,malganis,96,druid,feral,6,1,5
Feralhefty,stormrage,96,druid,feral,6,1,5
Ashmíla,ragnaros,96,druid,feral,6,1,5
Ticømia,stormrage,96,druid,feral,6,1,5
Droody,earthen-ring,96,druid,feral,6,1,5
Cattdog,tichondrius,96,druid,feral,6,1,5
Healthy,auchindoun,96,druid,feral,6,1,5
Nezrael,frostwolf,96,druid,feral,6,1,5
Shlümp,tichondrius,96,druid,feral,6,1,5
Crowaar,moon-guard,96,druid,feral,6,1,5
Yungle,tichondrius,96,druid,feral,6,1,5
Ojira,moon-guard,96,druid,feral,6,1,5
Terminated,tichondrius,96,druid,feral,6,1,5
Makonis,tichondrius,96,druid,feral,6,1,5
Captclaws,tichondrius,96,druid,feral,6,1,5
Pibily,sargeras,96,druid,feral,6,1,5
Samedo,sargeras,96,druid,feral,6,1,5
Morizo,proudmoore,96,druid,feral,6,1,5
Alope,blades-edge,96,druid,feral,6,1,5
Capson,darkspear,96,druid,feral,6,1,5
Kollective,sargeras,96,druid,feral,6,1,5
Gretatunberg,skywall,96,druid,feral,6,1,5
Deelark,skywall,96,druid,feral,6,1,5
Dotsgallore,garrosh,96,druid,feral,6,1,5
Garcia,feathermoon,96,druid,feral,6,1,5
Byefren,darkspear,96,druid,feral,7,1,6
Habras,alterac-mountains,96,druid,feral,12,1,11
Funfunfrank,aegwynn,96,druid,feral,12,1,11
Grovestalker,nemesis,96,druid,feral,12,1,11
Owlcapwn,tichondrius,96,druid,feral,12,1,11
Weezydende,area-52,96,druid,feral,12,1,11
Ballsnack,zuljin,96,druid,feral,12,1,11
Lonewolfdrd,illidan,96,druid,feral,12,1,11
Versipex,emerald-dream,96,druid,feral,12,1,11
Rorhenn,moon-guard,96,druid,feral,12,1,11
Furiøsä,quelthalas,95,druid,feral,6,1,5
Zyila,garithos,79,druid,feral,5,1,4
Gitsnshigles,frostmourne,79,druid,feral,5,1,4
Pixyls,bleeding-hollow,48,druid,feral,3,1,2
Chubakea,kiljaeden,48,druid,feral,3,1,2
Wierdosaur,azralon,48,druid,feral,3,1,2
Enderhero,illidan,42,druid,feral,14,2,12
Ânhur,tichondrius,42,druid,feral,17,2,15
Psynix,zuljin,16,druid,feral,1,1,0
Laryfsherman,tichondrius,2324,druid,balance,83,54,29
Fredagn,illidan,2306,druid,balance,90,55,35
Legionsucks,tanaris,2300,druid,balance,132,76,56
Jbz,balnazzar,2269,druid,balance,189,121,68
Owl,shadowsong,2261,druid,balance,120,69,51
Supatease,tichondrius,2253,druid,balance,117,67,50
Cti,tichondrius,2204,druid,balance,59,42,17
Tanerno,illidan,2201,druid,balance,108,65,43
Theforeigner,arathor,2194,druid,balance,59,46,13
Notes,farstriders,2187,druid,balance,104,54,50
Flowerboï,azralon,2180,druid,balance,96,69,27
Bkqtpie,tichondrius,2176,druid,balance,106,59,47
Flapz,illidan,2164,druid,balance,66,38,28
Sonicphantom,kelthuzad,2149,druid,balance,66,48,18
Pushpop,frostmourne,2140,druid,balance,78,50,28
Impëria,quelthalas,2137,druid,balance,89,58,31
Mewfasa,duskwood,2135,druid,balance,147,94,53
Houli,tichondrius,2134,druid,balance,96,50,46
Peterßigßeam,malganis,2131,druid,balance,88,47,41
Nbadizzyboy,illidan,2130,druid,balance,53,43,10
Kidcudi,dentarg,2128,druid,balance,192,99,93
Xijînping,tichondrius,2125,druid,balance,69,41,28
Dízzen,bleeding-hollow,2120,druid,balance,90,57,33
Tranquilo,stormrage,2118,druid,balance,114,69,45
Brose,malganis,2115,druid,balance,66,43,23
Hayase,tichondrius,2113,druid,balance,96,60,36
Altoberano,azralon,2111,druid,balance,89,49,40
Fergh,tichondrius,2109,druid,balance,83,45,38
Gritzxv,stormrage,2105,druid,balance,83,48,35
Sqwippyd,tichondrius,2102,druid,balance,78,49,29
Trusyrusty,stormrage,2096,druid,balance,133,74,59
Gspx,dalaran,2089,druid,balance,60,33,27
Smëagol,zuljin,2078,druid,balance,66,38,28
Boomçhicken,tichondrius,2078,druid,balance,70,39,31
Soggykfc,illidan,2078,druid,balance,140,76,64
Gugukuaipao,tichondrius,2078,druid,balance,137,71,66
Lavlol,frostmourne,2059,druid,balance,251,135,116
Nokomanida,zuljin,2053,druid,balance,75,48,27
Ertuzi,tichondrius,2052,druid,balance,114,68,46
Balancex,tichondrius,2049,druid,balance,120,58,62
Solareclipse,tichondrius,2041,druid,balance,66,39,27
Bigdiablo,frostmourne,2040,druid,balance,159,87,72
Fhormations,area-52,2038,druid,balance,102,61,41
Flatass,cairne,2029,druid,balance,116,71,45
Houlix,stormrage,2029,druid,balance,140,68,72
Lgpepperoni,tichondrius,2020,druid,balance,54,47,7
Biophilic,moon-guard,2020,druid,balance,94,48,46
Omends,thrall,2017,druid,balance,122,66,56
Compléx,tichondrius,2016,druid,balance,78,41,37
Soulz,quelthalas,2012,druid,balance,72,43,29
Astraldank,tichondrius,2008,druid,balance,118,71,47
Murkeÿ,frostmourne,2004,druid,balance,108,50,58
Lazygaga,zuljin,2002,druid,balance,99,54,45
Snöwghost,aerie-peak,2000,druid,balance,227,118,109
Lazershartz,cenarion-circle,1992,druid,balance,72,36,36
Zneb,darkspear,1987,druid,balance,36,29,7
Dogwáter,tichondrius,1984,druid,balance,40,29,11
Tòmathy,tichondrius,1982,druid,balance,65,38,27
Fracxx,area-52,1981,druid,balance,30,21,9
Murruk,darkspear,1972,druid,balance,153,84,69
Riskies,tichondrius,1971,druid,balance,204,104,100
Wnxmomthicc,tichondrius,1970,druid,balance,42,29,13
Jimmypop,malganis,1970,druid,balance,115,71,44
Babekisser,stormrage,1966,druid,balance,101,65,36
Treirus,sargeras,1965,druid,balance,82,64,18
Pisces,emerald-dream,1961,druid,balance,68,40,28
Pønchø,quelthalas,1960,druid,balance,56,33,23
Daspdruid,nagrand,1957,druid,balance,212,109,103
Vertderferk,tichondrius,1954,druid,balance,68,40,28
Ezgamed,tichondrius,1950,druid,balance,69,46,23
Enøsh,tichondrius,1949,druid,balance,72,42,30
Spamclonewin,tichondrius,1942,druid,balance,111,67,44
Basedcatx,tichondrius,1940,druid,balance,82,52,30
Thugrose,blackrock,1938,druid,balance,48,25,23
Sebastian,tichondrius,1937,druid,balance,59,36,23
Toughshift,zuljin,1936,druid,balance,66,28,38
John,azralon,1930,druid,balance,120,56,64
Cultnelf,illidan,1929,druid,balance,107,56,51
Psychotycxd,tichondrius,1928,druid,balance,114,65,49
Jakob,arygos,1925,druid,balance,144,83,61
Lovemakitty,sargeras,1922,druid,balance,78,46,32
Komacine,emerald-dream,1919,druid,balance,361,199,162
Starfail,illidan,1917,druid,balance,54,27,27
Bubalolz,quelthalas,1914,druid,balance,191,101,90
Herpadruid,illidan,1912,druid,balance,102,48,54
Acdru,tichondrius,1911,druid,balance,67,37,30
Ztraws,tichondrius,1908,druid,balance,70,46,24
Dilondru,area-52,1906,druid,balance,117,70,47
Beefnudlsoup,tichondrius,1906,druid,balance,66,39,27
Vengex,sargeras,1904,druid,balance,48,30,18
Hxzard,dalaran,1904,druid,balance,116,66,50
Hessenmèow,tichondrius,1901,druid,balance,66,33,33
Jayelljaÿ,thrall,1899,druid,balance,129,78,51
Knotgiver,moon-guard,1899,druid,balance,52,31,21
Vernaar,laughing-skull,1888,druid,balance,84,47,37
Oakwalker,moon-guard,1888,druid,balance,96,52,44
Druidstin,tichondrius,1883,druid,balance,66,33,33
Hefkerd,tichondrius,1881,druid,balance,30,20,10
Lazersnewch,kelthuzad,1877,druid,balance,60,35,25
Boomkek,wyrmrest-accord,1873,druid,balance,42,30,12
Möshinòõb,proudmoore,1865,druid,balance,58,40,18
Sarvi,zuljin,1864,druid,balance,33,24,9
Elythria,hellscream,1863,druid,balance,30,26,4
Petruccius,nordrassil,1863,druid,balance,178,94,84
Vuru,azralon,1860,druid,balance,41,29,12
Wereocelot,firetree,1857,druid,balance,96,58,38
Lilbeam,sargeras,1855,druid,balance,42,27,15
Foekinghobo,sargeras,1855,druid,balance,126,69,57
Thundoon,tichondrius,1854,druid,balance,36,23,13
Hogd,illidan,1854,druid,balance,60,35,25
Rizzit,wyrmrest-accord,1852,druid,balance,58,32,26
Johnieboy,azralon,1850,druid,balance,45,32,13
Pennytrate,barthilas,1847,druid,balance,66,44,22
Swaggu,kelthuzad,1847,druid,balance,72,44,28
Geezbutt,tichondrius,1846,druid,balance,139,70,69
Laser,bonechewer,1844,druid,balance,42,27,15
Bentøbøx,barthilas,1841,druid,balance,47,27,20
Gèb,dalaran,1835,druid,balance,116,71,45
Elunegoddess,tichondrius,1834,druid,balance,46,27,19
Moonflora,stormrage,1833,druid,balance,129,73,56
Sawsaw,bleeding-hollow,1832,druid,balance,74,42,32
Ilovediegoxo,kelthuzad,1830,druid,balance,48,32,16
Hydrahl,thrall,1830,druid,balance,42,28,14
Deloria,nemesis,1829,druid,balance,42,25,17
Dontnerfmore,queldorei,1829,druid,balance,66,31,35
Moozzash,azralon,1828,druid,balance,54,32,22
Chernovax,kelthuzad,1828,druid,balance,87,47,40
Equinøxx,malganis,1827,druid,balance,47,30,17
Dorlingus,tichondrius,1825,druid,balance,42,28,14
Ericzzdd,tichondrius,1823,druid,balance,54,40,14
Poliage,moon-guard,1823,druid,balance,125,73,52
Clonemunster,frostmourne,1821,druid,balance,66,38,28
Lunalai,bloodhoof,1820,druid,balance,96,55,41
Sueycide,tichondrius,1819,druid,balance,71,34,37
Dipii,proudmoore,1818,druid,balance,30,22,8
Resorange,malganis,1818,druid,balance,48,29,19
Rìniroo,area-52,1816,druid,balance,48,30,18
Xenny,chogall,1815,druid,balance,48,34,14
Raïsin,moon-guard,1814,druid,balance,45,26,19
Jacusias,stormrage,1814,druid,balance,188,102,86
Animatronixz,area-52,1813,druid,balance,66,34,32
Keylae,sargeras,1812,druid,balance,86,46,40
Drugdoer,tichondrius,1811,druid,balance,106,64,42
Thottiie,hyjal,1811,druid,balance,60,36,24
Boyoboy,thrall,1810,druid,balance,24,19,5
Moonkay,tichondrius,1810,druid,balance,42,26,16
Spacedruidx,illidan,1810,druid,balance,78,45,33
Instar,tichondrius,1810,druid,balance,36,19,17
Bables,tichondrius,1809,druid,balance,54,35,19
Drcuy,ragnaros,1809,druid,balance,98,56,42
Cocainebeär,tichondrius,1808,druid,balance,54,30,24
Dustydrx,area-52,1806,druid,balance,56,34,22
Zeromoon,frostmourne,1806,druid,balance,59,29,30
Harukai,azralon,1805,druid,balance,114,67,47
Formhub,malganis,1805,druid,balance,78,38,40
Starbränd,azralon,1803,druid,balance,60,38,22
Halenson,illidan,1803,druid,balance,46,29,17
Youngtree,tichondrius,1803,druid,balance,33,20,13
Itachi,dragonmaw,1803,druid,balance,65,38,27
Vengexd,sargeras,1802,druid,balance,24,19,5
Mythleaf,ragnaros,1802,druid,balance,120,70,50
Jaxer,illidan,1801,druid,balance,99,64,35
Buffjungle,tichondrius,1801,druid,balance,36,20,16
Treeheehee,frostmourne,1798,druid,balance,57,44,13
Cousa,zuljin,1797,druid,balance,64,39,25
Metroboomy,magtheridon,1795,druid,balance,68,40,28
Lekick,tichondrius,1795,druid,balance,66,36,30
Suen,tichondrius,1793,druid,balance,42,29,13
Chal,illidan,1791,druid,balance,53,32,21
Etherêal,stormrage,1791,druid,balance,84,46,38
Alpine,eldrethalas,1790,druid,balance,54,35,19
Hypefull,tichondrius,1790,druid,balance,48,23,25
Yepz,tichondrius,1786,druid,balance,51,27,24
Dànkness,frostwolf,1784,druid,balance,36,23,13
Weckxa,sargeras,1784,druid,balance,48,28,20
Destromz,zuljin,1780,druid,balance,36,24,12
Ataraxie,illidan,1780,druid,balance,78,47,31
Swayjizz,tichondrius,1779,druid,balance,102,59,43
Glazinator,sargeras,1779,druid,balance,154,77,77
Dorizio,illidan,1775,druid,balance,30,19,11
Orollå,tichondrius,1771,druid,balance,50,29,21
Oungan,illidan,1771,druid,balance,98,56,42
Çørrúptíøñzx,tichondrius,1770,druid,balance,36,25,11
Sadboy,moon-guard,1769,druid,balance,119,63,56
Boomybro,thrall,1768,druid,balance,140,84,56
Zoteqt,kelthuzad,1767,druid,balance,115,62,53
Dôcteurowl,zuljin,1767,druid,balance,47,25,22
Olongjonsson,wyrmrest-accord,1766,druid,balance,36,19,17
Lilkitty,tichondrius,1764,druid,balance,148,81,67
Ailari,moon-guard,1763,druid,balance,79,46,33
Maligoz,nemesis,1759,druid,balance,89,48,41
Jojo,ysera,1759,druid,balance,89,47,42
Sommerrays,kelthuzad,1753,druid,balance,54,27,27
Dextructive,tichondrius,1753,druid,balance,106,52,54
Byk,tichondrius,1751,druid,balance,72,37,35
Deviperdruid,frostmourne,1748,druid,balance,51,35,16
Droodaphobé,sargeras,1745,druid,balance,53,32,21
Fleasy,wyrmrest-accord,1744,druid,balance,68,41,27
Owlyfans,frostmourne,1741,druid,balance,42,25,17
Readt,malganis,1738,druid,balance,198,108,90
Ebrìthil,hyjal,1737,druid,balance,54,27,27
Nxf,sargeras,1734,druid,balance,35,21,14
Druidwhat,stormrage,1734,druid,balance,153,81,72
Form,bleeding-hollow,1732,druid,balance,72,42,30
Daddyshift,proudmoore,1731,druid,balance,62,35,27
Exxh,tichondrius,1729,druid,balance,34,26,8
Nyloke,kelthuzad,1729,druid,balance,66,44,22
Scene,frostmourne,1729,druid,balance,71,40,31
Druidk,tichondrius,1728,druid,balance,60,28,32
Cobal,goldrinn,1727,druid,balance,419,216,203
Trapdoorboom,illidan,1726,druid,balance,96,51,45
Bunnykiss,tichondrius,1726,druid,balance,64,30,34
Faerie,kaelthas,1724,druid,balance,64,36,28
Naakx,tichondrius,1722,druid,balance,52,30,22
Megadruidx,stormrage,1721,druid,balance,39,25,14
Wecksox,area-52,1721,druid,balance,246,119,127
Xantastic,area-52,1719,druid,balance,42,24,18
Bobthehefty,area-52,1718,druid,balance,36,24,12
Swiftydel,frostmourne,1718,druid,balance,42,27,15
Starsucceed,illidan,1718,druid,balance,42,21,21
Jaseyxxl,area-52,1715,druid,balance,28,23,5
Convokeopp,tichondrius,1713,druid,balance,24,21,3
Cjæ,bleeding-hollow,1713,druid,balance,24,18,6
Líu,area-52,1705,druid,balance,90,55,35
Kyura,sargeras,1705,druid,balance,130,62,68
Starcastic,tichondrius,1704,druid,balance,66,41,25
Melloj,kelthuzad,1704,druid,balance,54,31,23
Catpoop,frostmourne,1703,druid,balance,36,26,10
Trapkin,tichondrius,1703,druid,balance,137,89,48
Mädnhairy,zuljin,1703,druid,balance,45,28,17
Showmanship,tichondrius,1703,druid,balance,75,45,30
Beamed,thrall,1702,druid,balance,24,18,6
Davione,tichondrius,1702,druid,balance,46,28,18
Rerob,aerie-peak,1702,druid,balance,50,26,24
Souress,shadowsong,1700,druid,balance,36,23,13
Staystrongox,tichondrius,1700,druid,balance,58,35,23
Kletys,azralon,1700,druid,balance,59,34,25
Kamero,tichondrius,1697,druid,balance,45,26,19
Tunaren,wyrmrest-accord,1696,druid,balance,42,21,21
Angryjo,tichondrius,1695,druid,balance,40,24,16
Bathrobe,bloodscalp,1695,druid,balance,42,23,19
Raquelitá,ragnaros,1694,druid,balance,28,19,9
Cynhawts,emerald-dream,1692,druid,balance,36,20,16
Sibby,barthilas,1691,druid,balance,90,48,42
Ilovediego,stormrage,1689,druid,balance,30,18,12
Giantpanther,tichondrius,1689,druid,balance,42,24,18
Bloomqt,tichondrius,1688,druid,balance,90,54,36
Pipiwiwi,stormrage,1688,druid,balance,87,48,39
Meowkit,blackrock,1687,druid,balance,30,22,8
Fifty,ragnaros,1687,druid,balance,36,23,13
Aule,frostmourne,1687,druid,balance,36,18,18
Nophysique,zuljin,1686,druid,balance,76,43,33
Spinach,moon-guard,1686,druid,balance,104,53,51
Mortqt,tichondrius,1685,druid,balance,42,23,19
Chickenwings,ragnaros,1683,druid,balance,42,27,15
Ghaal,tichondrius,1682,druid,balance,78,50,28
Fìlø,bleeding-hollow,1682,druid,balance,146,89,57
Gordzak,illidan,1682,druid,balance,78,42,36
Roofty,illidan,1681,druid,balance,34,22,12
Buckwhêât,illidan,1680,druid,balance,41,20,21
Justsidious,sargeras,1679,druid,balance,30,23,7
Kzinti,zuluhed,1679,druid,balance,85,41,44
Cattdog,tichondrius,1678,druid,balance,49,34,15
Ruthlessbro,sargeras,1677,druid,balance,85,45,40
Pizzaparties,tichondrius,1676,druid,balance,35,28,7
Haneulso,tichondrius,1676,druid,balance,152,90,62
Ànìmàl,stormrage,1674,druid,balance,36,27,9
Jemima,auchindoun,1673,druid,balance,106,63,43
Cirranis,moon-guard,1671,druid,balance,63,41,22
Halensen,illidan,1668,druid,balance,47,23,24
Choosegoose,area-52,1667,druid,balance,26,19,7
Wallower,malganis,1667,druid,balance,54,24,30
Yipëë,moon-guard,1666,druid,balance,64,34,30
Nickyü,ragnaros,1665,druid,balance,54,23,31
Partybeast,malganis,1664,druid,balance,74,55,19
Meatbender,frostmourne,1663,druid,balance,54,26,28
Gumbawl,sargeras,1662,druid,balance,36,22,14
Seilah,lightbringer,1660,druid,balance,36,20,16
Locose,black-dragonflight,1658,druid,balance,30,19,11
Foafoa,illidan,1657,druid,balance,31,19,12
Bukkwild,stormrage,1656,druid,balance,33,28,5
Pannaxx,tichondrius,1653,druid,balance,30,21,9
Aull,kelthuzad,1653,druid,balance,36,19,17
Roar,moon-guard,1652,druid,balance,45,31,14
Renithen,trollbane,1652,druid,balance,42,28,14
Înfamous,thrall,1652,druid,balance,36,24,12
Starlyxo,malganis,1652,druid,balance,59,37,22
Seyala,moon-guard,1652,druid,balance,142,77,65
Druentia,tichondrius,1650,druid,balance,30,20,10
Frames,area-52,1646,druid,balance,65,31,34
Panansy,stormrage,1644,druid,balance,251,122,129
Josepha,tichondrius,1643,druid,balance,30,20,10
Wizdùm,frostmourne,1643,druid,balance,53,34,19
Convokeula,tichondrius,1643,druid,balance,90,55,35
Pils,nemesis,1643,druid,balance,112,66,46
Pankecito,ragnaros,1643,druid,balance,52,30,22
Partylord,malganis,1641,druid,balance,96,51,45
Oppose,akama,1640,druid,balance,49,30,19
Grapeful,frostmourne,1640,druid,balance,66,37,29
Sweatypapa,tichondrius,1639,druid,balance,72,49,23
Chøpstixs,bleeding-hollow,1639,druid,balance,48,28,20
Snugglin,kelthuzad,1639,druid,balance,60,31,29
Goochies,aerie-peak,1638,druid,balance,29,18,11
Jillferal,proudmoore,1638,druid,balance,78,47,31
Phurr,area-52,1638,druid,balance,42,22,20
Killiamp,tichondrius,1636,druid,balance,41,27,14
Brokenomega,area-52,1636,druid,balance,100,61,39
Thamoonsbak,aggramar,1635,druid,balance,35,18,17
Wasabilol,tichondrius,1634,druid,balance,61,37,24
Blitzkreigtv,area-52,1633,druid,balance,36,23,13
Moonrg,stormrage,1632,druid,balance,42,21,21
Midnitetoker,hyjal,1631,druid,balance,48,25,23
Lostnsauce,tichondrius,1630,druid,balance,48,36,12
Kekepöp,illidan,1628,druid,balance,36,25,11
Bearyhallsjr,sargeras,1627,druid,balance,24,17,7
Dreamwalker,bleeding-hollow,1626,druid,balance,24,17,7
Ablackdruid,moon-guard,1624,druid,balance,35,21,14
Flappyjacks,elune,1624,druid,balance,42,22,20
Khryllx,tichondrius,1623,druid,balance,30,20,10
Moonra,malganis,1623,druid,balance,66,38,28
Soonntkgo,ragnaros,1623,druid,balance,56,29,27
Eseldra,area-52,1622,druid,balance,58,34,24
Harryhotter,blackrock,1622,druid,balance,109,54,55
Reàsons,stormrage,1622,druid,balance,60,27,33
Jeanz,bonechewer,1621,druid,balance,30,21,9
Realmehji,wyrmrest-accord,1619,druid,balance,30,23,7
Mûû,tichondrius,1619,druid,balance,80,46,34
Gatø,area-52,1619,druid,balance,90,42,48
Bolthor,wyrmrest-accord,1618,druid,balance,43,22,21
Cyclone,darkspear,1618,druid,balance,36,17,19
Wildslash,proudmoore,1617,druid,balance,75,37,38
Yazmawma,tichondrius,1616,druid,balance,30,18,12
Mastabtw,illidan,1616,druid,balance,30,17,13
Treeshift,tichondrius,1615,druid,balance,53,32,21
Scurse,tichondrius,1615,druid,balance,42,24,18
Nasuu,bleeding-hollow,1613,druid,balance,54,35,19
Auras,kelthuzad,1612,druid,balance,120,73,47
Duglas,illidan,1612,druid,balance,91,55,36
Ellguin,malganis,1611,druid,balance,60,44,16
Skeevz,darkspear,1611,druid,balance,32,20,12
Gwiffurry,tichondrius,1611,druid,balance,42,24,18
Burninmoon,tichondrius,1611,druid,balance,30,17,13
Judar,barthilas,1610,druid,balance,48,21,27
Pänzerkin,sargeras,1609,druid,balance,30,21,9
Alaillais,moon-guard,1609,druid,balance,48,28,20
Canek,ghostlands,1609,druid,balance,107,62,45
Boys,bleeding-hollow,1606,druid,balance,42,24,18
Braviel,stormrage,1605,druid,balance,54,32,22
Djsummer,tichondrius,1605,druid,balance,107,56,51
Wòót,stormreaver,1604,druid,balance,60,42,18
Lyshani,thrall,1604,druid,balance,46,27,19
Softkiller,chogall,1603,druid,balance,36,23,13
Anchunlol,tichondrius,1603,druid,balance,36,19,17
Ehleven,tichondrius,1602,druid,balance,36,23,13
Krispz,area-52,1602,druid,balance,35,18,17
Haohomie,tichondrius,1601,druid,balance,30,21,9
Coldkill,burning-legion,1600,druid,balance,30,17,13
Brodda,sargeras,1600,druid,balance,194,101,93
Doomdawn,sargeras,1600,druid,balance,83,41,42
Boomchickens,area-52,1598,druid,balance,54,28,26
Stellar,steamwheedle-cartel,1597,druid,balance,24,19,5
Catworm,sargeras,1596,druid,balance,30,19,11
Odirtytshirt,malganis,1595,druid,balance,55,27,28
Skurts,tichondrius,1594,druid,balance,39,25,14
Soupbeandru,zuljin,1593,druid,balance,48,28,20
Kittycleave,tichondrius,1591,druid,balance,24,17,7
Sodapooping,azjolnerub,1588,druid,balance,90,55,35
Niroxic,frostmourne,1588,druid,balance,36,22,14
Lewïs,stormrage,1588,druid,balance,54,29,25
Davo,tichondrius,1587,druid,balance,42,27,15
Aethisra,moon-guard,1587,druid,balance,101,58,43
Beamrooster,silvermoon,1586,druid,balance,36,23,13
Seyedo,sargeras,1586,druid,balance,47,29,18
Korbö,zuljin,1585,druid,balance,30,18,12
Thespían,tichondrius,1584,druid,balance,321,170,151
Verbz,arthas,1584,druid,balance,48,21,27
Yoglosmas,tichondrius,1582,druid,balance,24,19,5
Chedisdru,mugthol,1582,druid,balance,30,20,10
Glickbear,illidan,1582,druid,balance,36,18,18
Shîfty,ysondre,1580,druid,balance,65,35,30
Krahz,lightnings-blade,1580,druid,balance,265,136,129
Animlcracker,emerald-dream,1579,druid,balance,30,21,9
Druiddruid,daggerspine,1577,druid,balance,59,36,23
Pawpurrazzi,darkspear,1574,druid,balance,30,19,11
Sombrien,stormrage,1573,druid,balance,90,46,44
Mõoõoõoõoõoõ,tichondrius,1573,druid,balance,36,18,18
Surfingbird,tichondrius,1572,druid,balance,99,65,34
Beretta,rexxar,1571,druid,balance,84,48,36
Saltydru,illidan,1570,druid,balance,44,25,19
Starsurgê,tichondrius,1569,druid,balance,66,42,24
Venkin,gnomeregan,1566,druid,balance,96,47,49
Ðøomkinz,azjolnerub,1565,druid,balance,36,23,13
Atagoo,tichondrius,1565,druid,balance,174,91,83
Inuyasha,sargeras,1564,druid,balance,41,24,17
Swoopy,stormrage,1563,druid,balance,79,44,35
Xiaoshuaigê,illidan,1562,druid,balance,30,18,12
Jimrobloxttv,emerald-dream,1559,druid,balance,30,19,11
Animaldoctor,illidan,1558,druid,balance,39,27,12
Boõsty,bleeding-hollow,1558,druid,balance,30,17,13
Polánd,area-52,1558,druid,balance,69,38,31
Fancynut,kiljaeden,1558,druid,balance,42,19,23
Cottonpaw,sargeras,1557,druid,balance,151,89,62
Elyveen,proudmoore,1556,druid,balance,51,38,13
Zesto,nazjatar,1555,druid,balance,24,17,7
Furryswipe,proudmoore,1555,druid,balance,50,28,22
Targareyen,sargeras,1555,druid,balance,47,20,27
Syclonez,stormrage,1554,druid,balance,42,21,21
Torrox,tichondrius,1553,druid,balance,105,59,46
Drdrulittle,darkspear,1553,druid,balance,78,40,38
Yehaw,bloodhoof,1552,druid,balance,36,24,12
Darkombra,frostmourne,1552,druid,balance,60,28,32
Nodadpullout,tichondrius,1550,druid,balance,30,17,13
Lowkie,llane,1548,druid,balance,33,19,14
Boome,blackrock,1544,druid,balance,60,33,27
Clarice,shattered-halls,1544,druid,balance,87,44,43
Còyot,stormrage,1544,druid,balance,44,20,24
Hayop,illidan,1543,druid,balance,60,28,32
Kg,cenarion-circle,1541,druid,balance,149,87,62
Ihavehothots,kiljaeden,1540,druid,balance,38,26,12
Zettka,tichondrius,1539,druid,balance,49,29,20
Offthezaza,tichondrius,1538,druid,balance,70,37,33
Montrá,stormrage,1537,druid,balance,84,38,46
Hikoro,sargeras,1536,druid,balance,126,74,52
Starsurgeon,thrall,1536,druid,balance,90,49,41
Midoo,proudmoore,1535,druid,balance,44,22,22
Umadornahh,malganis,1534,druid,balance,36,21,15
Fironous,nerzhul,1532,druid,balance,36,20,16
Gokki,zuljin,1531,druid,balance,47,33,14
Hasteley,khadgar,1531,druid,balance,53,24,29
November,wyrmrest-accord,1530,druid,balance,92,52,40
Komaner,frostmourne,1529,druid,balance,36,16,20
Brockolini,tichondrius,1528,druid,balance,82,44,38
Lavanis,stormrage,1528,druid,balance,185,98,87
Cauroth,azralon,1527,druid,balance,133,72,61
Indicamicah,tichondrius,1526,druid,balance,36,20,16
Cyeq,blackrock,1526,druid,balance,243,127,116
Contrololol,hyjal,1525,druid,balance,36,17,19
Bcup,sargeras,1524,druid,balance,30,16,14
Âzn,tichondrius,1523,druid,balance,54,39,15
Sweatydruidx,tichondrius,1523,druid,balance,24,16,8
Smeepy,bleeding-hollow,1523,druid,balance,30,16,14
Rayzer,bleeding-hollow,1523,druid,balance,96,50,46
Aralix,zuljin,1520,druid,balance,45,25,20
Raddosaurus,area-52,1520,druid,balance,65,33,32
Druidlolwtf,area-52,1520,druid,balance,108,52,56
Myeow,illidan,1520,druid,balance,74,35,39
Milksquirts,thrall,1519,druid,balance,81,47,34
Swooped,emerald-dream,1519,druid,balance,53,29,24
Musha,tichondrius,1517,druid,balance,57,30,27
Hagatta,stormrage,1517,druid,balance,151,77,74
Skyde,sargeras,1517,druid,balance,36,17,19
Faruu,tichondrius,1516,druid,balance,24,16,8
Ghostowl,thrall,1516,druid,balance,66,42,24
Pirira,quelthalas,1516,druid,balance,36,21,15
Groovyroom,tichondrius,1516,druid,balance,42,23,19
Lãzy,tichondrius,1512,druid,balance,78,46,32
Blazeikin,tichondrius,1512,druid,balance,36,16,20
Skum,bloodscalp,1512,druid,balance,57,23,34
Mk,caelestrasz,1511,druid,balance,30,17,13
Pëps,emerald-dream,1509,druid,balance,31,18,13
Maviç,hyjal,1509,druid,balance,84,43,41
Tyapet,area-52,1509,druid,balance,61,31,30
Zorn,lightnings-blade,1508,druid,balance,48,26,22
Drmf,frostmourne,1507,druid,balance,24,16,8
Neytîrî,tichondrius,1506,druid,balance,65,35,30
Clense,tichondrius,1505,druid,balance,55,34,21
Sadsex,illidan,1505,druid,balance,71,42,29
Woog,moon-guard,1504,druid,balance,60,34,26
Awkwarder,emerald-dream,1504,druid,balance,84,43,41
Daddymaple,tichondrius,1503,druid,balance,42,23,19
Hoagiecannon,moon-guard,1503,druid,balance,143,75,68
Jxrx,malganis,1501,druid,balance,24,16,8
Maplêleaf,moon-guard,1501,druid,balance,84,41,43
Nuubmurph,stormrage,1499,druid,balance,33,20,13
Delorík,illidan,1499,druid,balance,54,27,27
Vergota,emerald-dream,1498,druid,balance,49,33,16
Thatscute,moon-guard,1497,druid,balance,282,147,135
Tak,garrosh,1496,druid,balance,36,17,19
Yoloboomkin,tichondrius,1494,druid,balance,46,23,23
Rashmi,kiljaeden,1494,druid,balance,36,18,18
Myex,illidan,1491,druid,balance,24,16,8
Quaras,frostmourne,1489,druid,balance,205,107,98
Cabek,malganis,1488,druid,balance,60,32,28
Kittiepurry,blackrock,1488,druid,balance,83,44,39
Boxtops,bleeding-hollow,1486,druid,balance,36,23,13
Stepbro,malorne,1484,druid,balance,95,53,42
Dreamkin,tichondrius,1484,druid,balance,48,25,23
Byte,ragnaros,1482,druid,balance,29,16,13
Donresantis,stormreaver,1482,druid,balance,78,38,40
Syntheris,kaelthas,1481,druid,balance,81,49,32
Blackjésüs,kelthuzad,1481,druid,balance,117,64,53
Wildsïde,tichondrius,1480,druid,balance,30,19,11
Ayla,gorefiend,1478,druid,balance,23,19,4
Druuyid,jubeithos,1478,druid,balance,84,48,36
Fahnir,ragnaros,1477,druid,balance,66,37,29
Charnlok,thunderlord,1475,druid,balance,30,23,7
Loudpax,zuljin,1475,druid,balance,23,16,7
Kuwä,proudmoore,1474,druid,balance,72,36,36
Gummoo,tichondrius,1472,druid,balance,42,30,12
Kallabaluwa,azralon,1471,druid,balance,35,17,18
Rootchan,azralon,1470,druid,balance,52,34,18
Suncintus,aggramar,1468,druid,balance,54,24,30
Bigherbo,zuljin,1466,druid,balance,30,16,14
Sofereir,frostmourne,1466,druid,balance,149,76,73
Kawshuhn,bleeding-hollow,1463,druid,balance,78,47,31
Unclenya,barthilas,1463,druid,balance,72,32,40
Nephdruid,stormrage,1462,druid,balance,75,44,31
Rakex,tichondrius,1461,druid,balance,38,17,21
Huggerino,stormrage,1460,druid,balance,46,25,21
Zhinger,tichondrius,1460,druid,balance,73,36,37
Bruddahderpp,tichondrius,1459,druid,balance,36,25,11
Nightstalkr,kelthuzad,1459,druid,balance,187,101,86
Seyon,tichondrius,1459,druid,balance,33,17,16
Astrals,runetotem,1457,druid,balance,29,16,13
Yaboidakota,stormrage,1456,druid,balance,160,84,76
Haymade,sargeras,1455,druid,balance,42,24,18
Cowody,moon-guard,1454,druid,balance,29,22,7
Aranuir,emerald-dream,1452,druid,balance,35,20,15
Dudur,zuljin,1452,druid,balance,36,17,19
Rezlur,tichondrius,1452,druid,balance,35,16,19
Thunderhox,tichondrius,1451,druid,balance,67,36,31
Repanda,proudmoore,1451,druid,balance,71,37,34
Paddywhacked,tichondrius,1449,druid,balance,36,22,14
Padavore,wyrmrest-accord,1449,druid,balance,59,35,24
Jruids,stormrage,1449,druid,balance,54,32,22
Groggs,frostwolf,1447,druid,balance,27,16,11
Instanodle,proudmoore,1447,druid,balance,36,20,16
Rdruidchump,the-forgotten-coast,1445,druid,balance,32,19,13
Bighomïe,emerald-dream,1445,druid,balance,48,27,21
Formmaster,malganis,1441,druid,balance,76,38,38
Thatboiscrew,tichondrius,1439,druid,balance,35,26,9
Nicotinefien,sargeras,1439,druid,balance,24,15,9
Ripdimebag,frostmourne,1438,druid,balance,34,18,16
Lunarbalance,veknilash,1438,druid,balance,99,44,55
Elvishrage,zuljin,1437,druid,balance,18,15,3
Thorothir,ragnaros,1437,druid,balance,72,40,32
Envoy,sargeras,1435,druid,balance,60,33,27
Falkond,tichondrius,1433,druid,balance,35,18,17
Arealdruid,moon-guard,1433,druid,balance,42,18,24
Juicywap,proudmoore,1432,druid,balance,41,23,18
Evsn,tichondrius,1431,druid,balance,18,15,3
Djayolo,illidan,1431,druid,balance,18,15,3
Shapedance,sargeras,1431,druid,balance,35,16,19
Mcv,tichondrius,1430,druid,balance,30,15,15
Nokash,tichondrius,1425,druid,balance,43,17,26
Squidrific,tichondrius,1424,druid,balance,71,47,24
Nebulose,moon-guard,1424,druid,balance,59,26,33
Gaawdx,illidan,1424,druid,balance,90,39,51
Mèowcenaary,chogall,1423,druid,balance,60,35,25
Çoach,tichondrius,1423,druid,balance,36,15,21
Relaeh,andorhal,1420,druid,balance,30,15,15
Maimz,tichondrius,1419,druid,balance,54,33,21
Dontfloodit,tichondrius,1419,druid,balance,57,25,32
Maxspeed,tichondrius,1417,druid,balance,24,15,9
Alliess,aerie-peak,1417,druid,balance,99,50,49
Raximus,moon-guard,1417,druid,balance,84,42,42
Jentlegiant,tichondrius,1416,druid,balance,24,15,9
Faroo,azralon,1416,druid,balance,40,24,16
Crocface,tichondrius,1415,druid,balance,66,38,28
Axiomisop,tichondrius,1414,druid,balance,53,32,21
Leonardsby,tichondrius,1414,druid,balance,54,28,26
Fätål,ysera,1412,druid,balance,24,15,9
Gullmock,quelthalas,1412,druid,balance,78,35,43
Driftwood,bonechewer,1411,druid,balance,47,28,19
Wiiee,darkspear,1410,druid,balance,80,48,32
Snailbeam,shattered-hand,1410,druid,balance,48,20,28
Feroz,frostmourne,1409,druid,balance,24,15,9
Côheed,bleeding-hollow,1407,druid,balance,30,15,15
Chonkykitty,frostmourne,1405,druid,balance,30,19,11
Imnotinhuman,tichondrius,1405,druid,balance,35,22,13
Slyfoxx,stonemaul,1403,druid,balance,92,53,39
Trickatreyy,kelthuzad,1401,druid,balance,24,15,9
Quelarre,velen,1400,druid,balance,54,29,25
Jainzar,dreadmaul,1400,druid,balance,48,22,26
Cudbacrakhed,tichondrius,1399,druid,balance,48,27,21
Zuice,thrall,1398,druid,balance,69,32,37
Deathkahn,lightninghoof,1397,druid,balance,60,31,29
Tahunne,tichondrius,1396,druid,balance,66,41,25
Drunknoodles,stormrage,1396,druid,balance,29,16,13
Ulcera,nemesis,1396,druid,balance,33,17,16
Tinkeress,stormrage,1396,druid,balance,84,43,41
Justinheras,area-52,1394,druid,balance,52,30,22
Seneshy,azralon,1387,druid,balance,30,22,8
Indoee,mannoroth,1385,druid,balance,70,33,37
Envasions,emerald-dream,1380,druid,balance,24,15,9
Drufasa,tichondrius,1378,druid,balance,29,15,14
Nanashi,tichondrius,1378,druid,balance,30,15,15
Metal,jaedenar,1378,druid,balance,50,21,29
Huskars,tichondrius,1375,druid,balance,48,26,22
Illilydan,tichondrius,1375,druid,balance,30,16,14
Shemeus,malganis,1374,druid,balance,54,27,27
Starsaber,dalaran,1372,druid,balance,42,24,18
Cerest,kaelthas,1370,druid,balance,28,17,11
Saeval,korgath,1370,druid,balance,87,46,41
Jaduss,thrall,1370,druid,balance,32,16,16
Asteriel,stormrage,1367,druid,balance,54,24,30
Binnchook,barthilas,1366,druid,balance,31,19,12
Barrahjr,frostmourne,1366,druid,balance,51,28,23
Throatjelly,blackrock,1363,druid,balance,42,23,19
Twinscroll,tichondrius,1360,druid,balance,30,21,9
Druiddreams,frostmourne,1358,druid,balance,24,17,7
Gitsnshigles,frostmourne,1352,druid,balance,43,23,20
Theirs,tichondrius,1351,druid,balance,121,71,50
Tahnu,deathwing,1350,druid,balance,23,15,8
Mythelian,icecrown,1348,druid,balance,60,34,26
Skagakr,moon-guard,1347,druid,balance,107,52,55
Bugbugz,tichondrius,1342,druid,balance,24,14,10
Solarcannon,shuhalo,1342,druid,balance,130,70,60
Odweaven,thunderlord,1342,druid,balance,41,20,21
Starboy,garona,1340,druid,balance,24,14,10
Ernest,goldrinn,1340,druid,balance,63,31,32
Boomfold,tichondrius,1339,druid,balance,30,14,16
Eldenis,drakkari,1338,druid,balance,53,29,24
Xevão,nemesis,1338,druid,balance,32,15,17
Boomchí,tichondrius,1337,druid,balance,18,14,4
Boomsquanch,emerald-dream,1337,druid,balance,24,14,10
Frostig,tichondrius,1337,druid,balance,24,14,10
Boattastic,terenas,1337,druid,balance,24,14,10
Druizzy,illidan,1336,druid,balance,36,14,22
Skrimshaw,burning-legion,1335,druid,balance,30,15,15
Monsin,illidan,1335,druid,balance,102,49,53
Brawndiboom,stormrage,1335,druid,balance,71,33,38
Bigboðm,tichondrius,1334,druid,balance,30,18,12
Droody,earthen-ring,1333,druid,balance,40,20,20
Breynna,draenor,1333,druid,balance,41,20,21
Yungterp,zuljin,1332,druid,balance,18,14,4
Bâzinga,bleeding-hollow,1331,druid,balance,47,24,23
Xvenusaur,bleeding-hollow,1329,druid,balance,21,15,6
Drubuzz,tichondrius,1328,druid,balance,72,37,35
Noteff,illidan,1327,druid,balance,30,19,11
Yaboydave,stonemaul,1327,druid,balance,24,14,10
Thorsèn,sargeras,1327,druid,balance,47,25,22
Limikeen,bleeding-hollow,1325,druid,balance,30,15,15
Fondra,sargeras,1322,druid,balance,24,14,10
Moohok,bleeding-hollow,1321,druid,balance,30,14,16
Thickmoo,tichondrius,1319,druid,balance,81,38,43
Winekoolers,malganis,1317,druid,balance,42,21,21
Muscelmilk,tichondrius,1316,druid,balance,39,21,18
Jonoa,nagrand,1315,druid,balance,73,42,31
Qs,rivendare,1315,druid,balance,42,14,28
Shuxz,sargeras,1313,druid,balance,30,20,10
Pavati,bleeding-hollow,1313,druid,balance,26,14,12
Réko,sargeras,1311,druid,balance,40,23,17
Evilakali,tichondrius,1311,druid,balance,49,27,22
Flôkey,tichondrius,1311,druid,balance,42,21,21
Bigbeugs,frostmourne,1310,druid,balance,24,14,10
Katobe,tichondrius,1310,druid,balance,30,15,15
Audacities,bloodhoof,1309,druid,balance,46,23,23
Squidwonk,sargeras,1309,druid,balance,30,14,16
Stepdru,sargeras,1308,druid,balance,24,14,10
Annef,tichondrius,1307,druid,balance,42,21,21
Ðjx,stormrage,1306,druid,balance,19,15,4
Duakx,malganis,1305,druid,balance,30,14,16
Imshiftastic,area-52,1304,druid,balance,40,21,19
Doomkiñ,darkspear,1303,druid,balance,29,14,15
Treemendous,nemesis,1303,druid,balance,30,14,16
Sergat,stormreaver,1302,druid,balance,54,28,26
Floote,thrall,1302,druid,balance,50,23,27
Sochin,nemesis,1296,druid,balance,72,41,31
Lightconvoke,norgannon,1296,druid,balance,32,15,17
Soar,destromath,1295,druid,balance,30,14,16
Slumpxaddy,illidan,1289,druid,balance,23,14,9
Restorationz,tichondrius,1286,druid,balance,26,15,11
Stupidranga,barthilas,1286,druid,balance,54,29,25
Minusdruid,dalaran,1286,druid,balance,117,57,60
Lokdu,area-52,1284,druid,balance,30,15,15
Redbbull,tichondrius,1282,druid,balance,48,30,18
Xodz,sargeras,1282,druid,balance,42,21,21
Treezús,thrall,1281,druid,balance,60,29,31
Barrah,barthilas,1280,druid,balance,70,34,36
Nimfaa,nemesis,1279,druid,balance,36,21,15
Barekat,emerald-dream,1279,druid,balance,28,16,12
Deez,korgath,1277,druid,balance,50,19,31
Morphkow,sargeras,1272,druid,balance,45,26,19
Softshirtxo,ragnaros,1271,druid,balance,24,14,10
Mercz,illidan,1268,druid,balance,30,20,10
Sileda,nemesis,1266,druid,balance,20,14,6
Lønewolf,sargeras,1263,druid,balance,65,32,33
Shivlary,stormrage,1262,druid,balance,30,20,10
Knoxella,moon-guard,1257,druid,balance,86,42,44
Dkat,malganis,1254,druid,balance,40,21,19
Furu,bonechewer,1254,druid,balance,78,36,42
Xenöchrist,ragnaros,1252,druid,balance,32,16,16
Styless,azjolnerub,1251,druid,balance,28,16,12
Lavenderowl,arthas,1250,druid,balance,52,27,25
Slowreverb,silver-hand,1248,druid,balance,18,13,5
Mayanardz,bleeding-hollow,1248,druid,balance,18,13,5
Gatorskin,sargeras,1247,druid,balance,15,14,1
Irl,frostmane,1246,druid,balance,18,13,5
Galeshift,stormrage,1246,druid,balance,18,13,5
Lawlz,aegwynn,1246,druid,balance,51,28,23
Dirtdog,uther,1246,druid,balance,24,13,11
Mntra,emerald-dream,1245,druid,balance,18,13,5
Antiherø,sargeras,1245,druid,balance,18,13,5
Nehrudruid,area-52,1243,druid,balance,18,13,5
Sahksi,lothar,1243,druid,balance,24,13,11
Kydralola,ragnaros,1243,druid,balance,24,13,11
Ripkinztko,stormrage,1241,druid,balance,18,13,5
Kyabe,ragnaros,1241,druid,balance,67,26,41
Tummycummy,thrall,1240,druid,balance,18,13,5
Trippyshift,hyjal,1240,druid,balance,24,13,11
Héisénbérg,sargeras,1239,druid,balance,24,13,11
Gwub,illidan,1238,druid,balance,18,13,5
Guojue,tichondrius,1237,druid,balance,46,25,21
Hawkk,azralon,1237,druid,balance,56,26,30
Roundtummy,area-52,1234,druid,balance,24,13,11
Astrixx,frostmourne,1233,druid,balance,18,13,5
Édzar,area-52,1230,druid,balance,70,35,35
Vicorin,illidan,1226,druid,balance,24,13,11
Shiftyn,proudmoore,1225,druid,balance,18,13,5
Vorare,tichondrius,1225,druid,balance,26,14,12
Zentabra,proudmoore,1225,druid,balance,42,18,24
Kuroshizen,tichondrius,1224,druid,balance,94,39,55
Beal,azgalor,1224,druid,balance,54,21,33
Sunboy,tichondrius,1221,druid,balance,73,36,37
Deths,frostmourne,1219,druid,balance,18,13,5
Acidmoon,tichondrius,1219,druid,balance,52,22,30
Pokémon,grizzly-hills,1218,druid,balance,24,13,11
Strallà,illidan,1217,druid,balance,96,49,47
Flatnose,agamaggan,1216,druid,balance,30,13,17
Vuginas,bleeding-hollow,1215,druid,balance,62,33,29
Meowmixx,frostmane,1215,druid,balance,41,19,22
Lindzy,moon-guard,1210,druid,balance,78,43,35
Elpako,ragnaros,1208,druid,balance,54,23,31
Mooing,azralon,1205,druid,balance,24,16,8
Møønscar,tichondrius,1204,druid,balance,48,22,26
Tankbareass,aerie-peak,1203,druid,balance,42,16,26
Trollsmind,tichondrius,1202,druid,balance,28,14,14
Pleasepime,stormrage,1202,druid,balance,84,35,49
Thehooligan,stormrage,1200,druid,balance,75,41,34
Chillcat,illidan,1194,druid,balance,18,14,4
Nolifer,sargeras,1192,druid,balance,30,17,13
Dumdumdugan,korgath,1191,druid,balance,83,41,42
Chernlyssayo,stormrage,1188,druid,balance,26,16,10
Dampnr,tichondrius,1186,druid,balance,30,14,16
Maxable,alleria,1184,druid,balance,27,14,13
Quincunx,tichondrius,1181,druid,balance,70,39,31
Drßoom,stormrage,1181,druid,balance,81,35,46
Kïx,illidan,1180,druid,balance,20,13,7
Jokerdks,tichondrius,1174,druid,balance,26,14,12
Mufaasa,boulderfist,1173,druid,balance,42,22,20
Aberdare,tichondrius,1169,druid,balance,29,13,16
Kattel,blackrock,1168,druid,balance,48,24,24
Blackmoons,thunderlord,1166,druid,balance,42,15,27
Baboongodx,frostmourne,1164,druid,balance,23,13,10
Trythis,tichondrius,1161,druid,balance,24,13,11
Goofyfoot,wyrmrest-accord,1161,druid,balance,32,15,17
Draide,dragonblight,1159,druid,balance,31,13,18
Mihnt,sargeras,1158,druid,balance,40,14,26
Levincy,thrall,1156,druid,balance,60,33,27
Crazystorm,ragnaros,1154,druid,balance,48,26,22
Dojacow,mannoroth,1154,druid,balance,34,16,18
Katbriel,zuljin,1151,druid,balance,18,12,6
Doomty,tichondrius,1151,druid,balance,18,12,6
Comidru,tichondrius,1150,druid,balance,24,12,12
Borrdru,arthas,1150,druid,balance,24,12,12
Hefe,terenas,1149,druid,balance,18,12,6
Yoona,kiljaeden,1148,druid,balance,24,12,12
Dbanned,nemesis,1144,druid,balance,24,12,12
Roots,boulderfist,1144,druid,balance,30,13,17
Gravshift,zuljin,1143,druid,balance,18,12,6
Queiq,kelthuzad,1142,druid,balance,24,12,12
Hitchslaps,tichondrius,1140,druid,balance,24,12,12
Crashägásm,proudmoore,1140,druid,balance,49,19,30
Ularda,bleeding-hollow,1139,druid,balance,18,12,6
Saturday,frostmourne,1137,druid,balance,18,12,6
Aozeh,kiljaeden,1136,druid,balance,18,12,6
Chaossdruid,bleeding-hollow,1136,druid,balance,24,12,12
Alphakatt,area-52,1136,druid,balance,54,22,32
Ðementia,stormrage,1131,druid,balance,30,12,18
Ûñø,frostmourne,1130,druid,balance,30,19,11
Prismo,ravencrest,1129,druid,balance,24,12,12
Treeteej,kelthuzad,1128,druid,balance,36,16,20
Gepardéx,ragnaros,1127,druid,balance,64,26,38
Kuthian,moon-guard,1126,druid,balance,39,17,22
Kudro,garithos,1122,druid,balance,30,12,18
Basilix,moon-guard,1121,druid,balance,33,16,17
Burninmôön,tichondrius,1118,druid,balance,35,12,23
Bethemarble,sargeras,1115,druid,balance,51,20,31
Dirtydot,ragnaros,1114,druid,balance,18,12,6
Dodid,laughing-skull,1111,druid,balance,42,20,22
Ilgalsard,frostmourne,1109,druid,balance,36,16,20
Judgedruid,scilla,1107,druid,balance,18,12,6
Mambuz,tichondrius,1100,druid,balance,60,30,30
Floridajoe,blackrock,1094,druid,balance,24,15,9
Alucardxd,ragnaros,1094,druid,balance,29,12,17
Krazykritz,illidan,1090,druid,balance,27,13,14
Qelthalas,sargeras,1090,druid,balance,115,52,63
Coppersnout,moon-guard,1089,druid,balance,54,29,25
Gorgoncity,illidan,1088,druid,balance,22,12,10
Moistcream,tichondrius,1087,druid,balance,21,12,9
Meekgrylls,frostmourne,1087,druid,balance,28,12,16
Zeromeme,frostmourne,1086,druid,balance,20,12,8
Jâykeup,lightbringer,1085,druid,balance,32,13,19
Råstafart,tichondrius,1080,druid,balance,30,12,18
Thecovid,illidan,1073,druid,balance,71,29,42
Lakermagik,moknathal,1071,druid,balance,19,12,7
Moonfart,zuljin,1071,druid,balance,29,13,16
Alagoano,azralon,1065,druid,balance,24,16,8
Drdoomerkin,area-52,1056,druid,balance,12,11,1
Slickitty,kelthuzad,1056,druid,balance,18,11,7
Roccko,illidan,1056,druid,balance,18,11,7
Chanimal,tichondrius,1055,druid,balance,12,11,1
Purkins,barthilas,1055,druid,balance,18,11,7
Likorit,azralon,1055,druid,balance,18,11,7
Kydro,sargeras,1055,druid,balance,18,11,7
Feralgo,tichondrius,1055,druid,balance,18,11,7
Mastahskills,illidan,1055,druid,balance,18,11,7
Docleave,tichondrius,1055,druid,balance,18,11,7
Mooseknukel,zuljin,1055,druid,balance,18,11,7
Shibbith,nordrassil,1054,druid,balance,18,11,7
Buffclyde,blackrock,1054,druid,balance,18,11,7
Erealana,tichondrius,1054,druid,balance,18,11,7
Ryannshiftz,proudmoore,1054,druid,balance,18,11,7
Abomasnow,turalyon,1054,druid,balance,18,11,7
Theboomkin,kelthuzad,1054,druid,balance,18,11,7
Quefemme,kelthuzad,1053,druid,balance,18,11,7
Yggdrasil,ravencrest,1053,druid,balance,24,11,13
Kittygoboom,kiljaeden,1053,druid,balance,24,11,13
Awguseon,proudmoore,1051,druid,balance,18,11,7
Milkshift,demon-soul,1051,druid,balance,24,11,13
Fjblol,sargeras,1051,druid,balance,24,11,13
Boostgu,illidan,1050,druid,balance,18,11,7
Wildbloom,draenor,1050,druid,balance,18,11,7
Nozgöth,quelthalas,1050,druid,balance,45,23,22
Samsshifter,tichondrius,1050,druid,balance,24,11,13
Spicydurid,tichondrius,1050,druid,balance,24,11,13
Balverixqt,tichondrius,1048,druid,balance,24,11,13
Shavedtaco,azshara,1047,druid,balance,12,11,1
Chikenflu,tichondrius,1047,druid,balance,22,11,11
Shebleeder,aegwynn,1047,druid,balance,24,11,13
Catrene,mannoroth,1045,druid,balance,45,28,17
Maulinyou,whisperwind,1045,druid,balance,18,11,7
Jinglebells,kiljaeden,1038,druid,balance,18,11,7
Miggzii,draka,1030,druid,balance,40,17,23
Muhana,runetotem,1028,druid,balance,24,11,13
Thèbearjèw,tichondrius,1024,druid,balance,55,23,32
Hosehead,malganis,1023,druid,balance,24,14,10
Malamew,antonidas,1016,druid,balance,18,12,6
Lumipawz,frostmourne,1014,druid,balance,19,12,7
Caminanube,quelthalas,1012,druid,balance,24,12,12
Riprip,tichondrius,1012,druid,balance,27,12,15
Bloomsong,emerald-dream,1012,druid,balance,30,13,17
Araminka,drakkari,1011,druid,balance,12,11,1
Rslm,tichondrius,1001,druid,balance,21,12,9
Genghisz,area-52,1001,druid,balance,23,11,12
Dustin,moon-guard,1000,druid,balance,22,12,10
Finntröll,area-52,993,druid,balance,29,11,18
Boomybalboa,stormrage,990,druid,balance,17,11,6
Velaana,tichondrius,989,druid,balance,26,11,15
Vapeculture,lightbringer,981,druid,balance,48,27,21
Indy,rivendare,980,druid,balance,22,11,11
Smashthatbox,illidan,977,druid,balance,32,12,20
Salvattor,stormrage,970,druid,balance,14,11,3
Cowel,tichondrius,969,druid,balance,25,11,14
Bäñgarang,tichondrius,966,druid,balance,31,11,20
Jubi,bleeding-hollow,960,druid,balance,12,10,2
Roben,tichondrius,960,druid,balance,18,10,8
Omnigrind,frostmourne,960,druid,balance,18,10,8
Hugodruid,frostmourne,960,druid,balance,18,10,8
Mcy,nerzhul,960,druid,balance,18,10,8
Sÿndru,illidan,960,druid,balance,18,10,8
Jshwills,sargeras,959,druid,balance,12,10,2
Renamebdsm,cenarius,959,druid,balance,18,10,8
Kohru,moon-guard,959,druid,balance,18,10,8
Biggieclawz,tichondrius,958,druid,balance,12,10,2
Shumarina,mannoroth,958,druid,balance,18,10,8
Meatcat,sargeras,958,druid,balance,18,10,8
Piping,thunderlord,958,druid,balance,18,10,8
Kushidabs,tichondrius,958,druid,balance,34,11,23
Messyboom,illidan,957,druid,balance,12,10,2
Nøzopium,kelthuzad,956,druid,balance,18,10,8
Airinsurgent,stormrage,956,druid,balance,24,10,14
Drewpg,zuljin,955,druid,balance,18,10,8
Tanguanota,quelthalas,955,druid,balance,24,10,14
Pneumashift,tichondrius,954,druid,balance,12,10,2
Jal,khazgoroth,953,druid,balance,18,10,8
Moonowl,crushridge,953,druid,balance,18,10,8
Santogrial,blood-furnace,953,druid,balance,46,25,21
Bouffecul,zuljin,952,druid,balance,18,10,8
Veraciouss,sargeras,952,druid,balance,18,10,8
Crunkk,thunderlord,952,druid,balance,18,10,8
Ðarkscar,laughing-skull,943,druid,balance,50,18,32
Skiouros,emerald-dream,943,druid,balance,30,10,20
Lacroix,wildhammer,938,druid,balance,12,10,2
Rahkaaga,kiljaeden,936,druid,balance,18,10,8
Rokk,baelgun,922,druid,balance,17,10,7
Rakelan,tichondrius,912,druid,balance,134,68,66
Krustyora,khazgoroth,911,druid,balance,17,10,7
Athious,moon-guard,909,druid,balance,29,13,16
Bellä,nazjatar,900,druid,balance,37,11,26
Skirts,area-52,879,druid,balance,13,10,3
Nalarin,kaelthas,878,druid,balance,72,35,37
Ryügähidëki,tichondrius,875,druid,balance,25,10,15
Gerrt,bleeding-hollow,864,druid,balance,12,9,3
Ràjeesh,frostmourne,864,druid,balance,12,9,3
Napes,tichondrius,864,druid,balance,12,9,3
Zebyn,tichondrius,864,druid,balance,12,9,3
Tôpdadwôrld,sargeras,864,druid,balance,18,9,9
Mvpps,thrall,864,druid,balance,18,9,9
Jssy,tichondrius,864,druid,balance,18,9,9
Aqulaíssaela,sargeras,864,druid,balance,18,9,9
Kûramä,dalaran,864,druid,balance,18,9,9
Rikishi,executus,864,druid,balance,18,9,9
Cthulhuqt,kelthuzad,863,druid,balance,12,9,3
Zmk,barthilas,863,druid,balance,12,9,3
Cdroo,burning-blade,863,druid,balance,12,9,3
Verelyris,nordrassil,863,druid,balance,12,9,3
Cheezaygx,arthas,863,druid,balance,18,9,9
Starkraven,firetree,863,druid,balance,18,9,9
Columpio,area-52,863,druid,balance,18,9,9
Môônkîn,chogall,863,druid,balance,18,9,9
Doots,aegwynn,863,druid,balance,18,9,9
Amookelia,tichondrius,863,druid,balance,18,9,9
Miviaris,alleria,863,druid,balance,18,9,9
Sym,zuljin,863,druid,balance,18,9,9
Dolwizz,tichondrius,863,druid,balance,24,9,15
Kelagoat,kiljaeden,863,druid,balance,24,9,15
Faelonk,frostmourne,862,druid,balance,12,9,3
Oreoshift,illidan,862,druid,balance,12,9,3
Rootslayer,tichondrius,862,druid,balance,12,9,3
Zugdruid,tichondrius,862,druid,balance,13,9,4
Felløwship,nemesis,862,druid,balance,18,9,9
Furrmissile,area-52,862,druid,balance,18,9,9
Muagor,tichondrius,862,druid,balance,18,9,9
Swappy,korgath,862,druid,balance,18,9,9
Tinkker,zuljin,861,druid,balance,12,9,3
Pooöòôp,kiljaeden,861,druid,balance,12,9,3
Blizdontcuur,area-52,860,druid,balance,12,9,3
Sanleba,tichondrius,860,druid,balance,18,9,9
Itchyrat,moon-guard,859,druid,balance,18,9,9
Ascension,emerald-dream,858,druid,balance,18,9,9
Amandi,magtheridon,858,druid,balance,24,9,15
Epicworld,stormrage,857,druid,balance,18,9,9
Kamionero,drakkari,856,druid,balance,12,9,3
Elatheris,stormrage,855,druid,balance,18,9,9
Slingin,illidan,855,druid,balance,30,9,21
Firefirelol,proudmoore,847,druid,balance,23,9,14
Jokey,quelthalas,845,druid,balance,12,9,3
Dèmønblâckev,malganis,842,druid,balance,24,11,13
Amigomel,emerald-dream,836,druid,balance,17,9,8
Irooftrellen,chogall,815,druid,balance,17,9,8
Ssïp,tichondrius,814,druid,balance,21,9,12
Shifterx,illidan,810,druid,balance,22,13,9
Taurenosorus,illidan,809,druid,balance,46,20,26
Leeteracola,malganis,798,druid,balance,20,9,11
Grgcostanza,bleeding-hollow,793,druid,balance,14,9,5
Meliódás,area-52,785,druid,balance,174,70,104
Koratan,frostmourne,784,druid,balance,13,9,4
Astroshift,emerald-dream,784,druid,balance,20,9,11
Spazz,firetree,783,druid,balance,11,9,2
Thallid,hydraxis,768,druid,balance,12,8,4
Guuh,tichondrius,768,druid,balance,12,8,4
Nyzear,bleeding-hollow,768,druid,balance,12,8,4
Laserxo,tichondrius,768,druid,balance,12,8,4
Ligerbomb,bleeding-hollow,768,druid,balance,12,8,4
Shaney,zuljin,768,druid,balance,12,8,4
Shiftytom,spirestone,768,druid,balance,12,8,4
Hootforce,spirestone,768,druid,balance,12,8,4
Chococrispis,quelthalas,768,druid,balance,12,8,4
Catmoomoo,tichondrius,768,druid,balance,12,8,4
Chayten,bleeding-hollow,768,druid,balance,12,8,4
Ryanspeed,mugthol,768,druid,balance,12,8,4
Furor,eonar,768,druid,balance,12,8,4
Ralphrawr,barthilas,768,druid,balance,12,8,4
Mikelovin,nemesis,768,druid,balance,12,8,4
Argento,frostmourne,768,druid,balance,12,8,4
Johnnybigg,frostmourne,768,druid,balance,12,8,4
Sñìp,zuljin,768,druid,balance,12,8,4
Azakai,sargeras,768,druid,balance,12,8,4
Elyiaida,emerald-dream,768,druid,balance,12,8,4
Supafat,thrall,768,druid,balance,12,8,4
Yøpìèrre,zuljin,768,druid,balance,12,8,4
Onsen,tichondrius,768,druid,balance,18,8,10
Zils,bleeding-hollow,768,druid,balance,18,8,10
Arntu,malganis,767,druid,balance,12,8,4
Adaptivv,sargeras,767,druid,balance,12,8,4
Foxhoundlol,tichondrius,767,druid,balance,12,8,4
Xornhxb,tichondrius,767,druid,balance,12,8,4
Entakkt,cenarius,767,druid,balance,12,8,4
Smokeheaters,dalaran,767,druid,balance,12,8,4
Starbender,arygos,767,druid,balance,12,8,4
Harddeenball,area-52,767,druid,balance,15,9,6
Jiya,zuljin,767,druid,balance,18,8,10
Ebonclaw,malganis,767,druid,balance,18,8,10
Ruckiz,stormrage,767,druid,balance,18,8,10
Ïny,emerald-dream,767,druid,balance,18,8,10
Dárách,malganis,767,druid,balance,18,8,10
Catastrophic,whisperwind,767,druid,balance,18,8,10
Maldobear,stormrage,767,druid,balance,18,8,10
Vyrrath,stormrage,767,druid,balance,18,8,10
Narthurs,ragnaros,767,druid,balance,24,8,16
Khristine,spinebreaker,767,druid,balance,24,8,16
Aolus,kaelthas,766,druid,balance,12,8,4
Mornis,zuljin,766,druid,balance,12,8,4
Onidudu,frostmourne,766,druid,balance,12,8,4
Nxghtfall,tichondrius,766,druid,balance,18,8,10
Serega,skywall,766,druid,balance,18,8,10
Lunapuma,stonemaul,765,druid,balance,12,8,4
Jashrus,korgath,765,druid,balance,12,8,4
Whitekongg,blackhand,765,druid,balance,15,9,6
Lavanca,azralon,765,druid,balance,18,8,10
Worldbullguy,area-52,765,druid,balance,18,8,10
Sefestria,senjin,765,druid,balance,18,8,10
Lazerckn,tichondrius,765,druid,balance,18,8,10
Aton,frostwolf,764,druid,balance,12,8,4
Crépes,bleeding-hollow,764,druid,balance,18,8,10
Hootie,arygos,764,druid,balance,24,8,16
Wabbehkus,barthilas,764,druid,balance,26,8,18
Psnárf,area-52,763,druid,balance,12,8,4
Naturlig,area-52,762,druid,balance,12,8,4
Sleek,illidan,762,druid,balance,18,8,10
Astromyles,tichondrius,762,druid,balance,25,8,17
Dennyyd,illidan,759,druid,balance,12,8,4
Jtogethendr,area-52,759,druid,balance,12,8,4
Boneheir,proudmoore,757,druid,balance,21,9,12
Volddy,tichondrius,755,druid,balance,18,8,10
Reeiyna,gallywix,749,druid,balance,12,8,4
Nokther,muradin,735,druid,balance,22,8,14
Outclone,tichondrius,734,druid,balance,10,9,1
Beleraine,moon-guard,732,druid,balance,17,8,9
Buyadoge,area-52,703,druid,balance,16,8,8
Dankasauras,tichondrius,703,druid,balance,26,9,17
Gibbo,illidan,696,druid,balance,16,8,8
Shiftness,nordrassil,679,druid,balance,11,8,3
Psilo,kelthuzad,672,druid,balance,12,7,5
Xioqt,chogall,672,druid,balance,12,7,5
Sàbrè,darkspear,672,druid,balance,12,7,5
Floofi,kelthuzad,672,druid,balance,12,7,5
Nbnbnb,proudmoore,672,druid,balance,12,7,5
Donaldsr,area-52,672,druid,balance,12,7,5
Omegablasted,tichondrius,672,druid,balance,12,7,5
Suedou,moon-guard,672,druid,balance,12,7,5
Slickthick,sargeras,672,druid,balance,12,7,5
Tensuen,boulderfist,672,druid,balance,12,7,5
Pecopeco,sargeras,672,druid,balance,12,7,5
Bippygucci,tichondrius,672,druid,balance,12,7,5
Ottovonbird,tichondrius,672,druid,balance,12,7,5
Junaleska,lightbringer,672,druid,balance,12,7,5
Riptin,kelthuzad,672,druid,balance,12,7,5
Notsofat,deathwing,672,druid,balance,12,7,5
Fastlife,drakkari,672,druid,balance,12,7,5
Seannybhoy,emerald-dream,672,druid,balance,12,7,5
Uhnoheals,tichondrius,672,druid,balance,12,7,5
Flapping,illidan,672,druid,balance,12,7,5
Redscyclone,dalaran,672,druid,balance,12,7,5
Kittycatman,tichondrius,672,druid,balance,12,7,5
Themustafa,tichondrius,672,druid,balance,12,7,5
Martians,laughing-skull,672,druid,balance,12,7,5
Elithyra,area-52,672,druid,balance,12,7,5
Starz,arthas,672,druid,balance,12,7,5
Boomypower,dalaran,672,druid,balance,12,7,5
Muunragery,illidan,672,druid,balance,12,7,5
Cfp,tichondrius,672,druid,balance,12,7,5
Kitinglol,alexstrasza,672,druid,balance,12,7,5
Covidcarrier,thrall,672,druid,balance,12,7,5
Straitbeast,tichondrius,672,druid,balance,12,7,5
Espoir,azuremyst,672,druid,balance,12,7,5
Lalalu,frostmourne,672,druid,balance,15,8,7
Trashytrash,bleeding-hollow,672,druid,balance,18,7,11
Dreveron,bleeding-hollow,672,druid,balance,18,7,11
Dupaface,stormrage,672,druid,balance,18,7,11
Dooruid,tichondrius,672,druid,balance,18,7,11
Antagonist,burning-blade,671,druid,balance,12,7,5
Catahoula,lothar,671,druid,balance,12,7,5
Dgas,tichondrius,671,druid,balance,12,7,5
Jeezelouise,kelthuzad,671,druid,balance,12,7,5
Coochi,sargeras,671,druid,balance,12,7,5
Ripx,khadgar,671,druid,balance,12,7,5
Jubeam,area-52,671,druid,balance,12,7,5
Dobidas,tichondrius,671,druid,balance,12,7,5
Eyzie,stormrage,671,druid,balance,15,8,7
Barkcheeks,area-52,671,druid,balance,18,7,11
Galind,rexxar,671,druid,balance,18,7,11
Wyldthangz,stormrage,671,druid,balance,18,7,11
Rabbismang,area-52,671,druid,balance,18,7,11
Chakrabeam,kelthuzad,671,druid,balance,18,7,11
Starsurged,moon-guard,671,druid,balance,18,7,11
Dashio,lightnings-blade,671,druid,balance,18,7,11
Oâk,farstriders,670,druid,balance,12,7,5
Shiffterzz,tichondrius,670,druid,balance,12,7,5
Andrés,azralon,670,druid,balance,12,7,5
Chukksz,nerzhul,670,druid,balance,12,7,5
Hootyhoot,illidan,670,druid,balance,12,7,5
Runhe,zuljin,670,druid,balance,12,7,5
Traxxo,tichondrius,670,druid,balance,12,7,5
Circadion,illidan,670,druid,balance,18,7,11
Dizzyshiftz,dalaran,670,druid,balance,24,7,17
Vicvc,tichondrius,669,druid,balance,12,7,5
Aviendiana,thrall,669,druid,balance,12,7,5
Eurotrance,frostmourne,669,druid,balance,12,7,5
Exillïs,frostmourne,669,druid,balance,17,8,9
Onecalf,tichondrius,668,druid,balance,12,7,5
Wresty,frostmourne,667,druid,balance,12,7,5
Boatox,jubeithos,666,druid,balance,24,7,17
Coqeh,frostwolf,664,druid,balance,12,7,5
Beammz,stormrage,664,druid,balance,15,8,7
Pao,nordrassil,664,druid,balance,18,7,11
Kångåwalafox,sargeras,663,druid,balance,12,7,5
Azevedoo,nemesis,660,druid,balance,31,7,24
Meiling,spirestone,659,druid,balance,12,7,5
Abzuri,kiljaeden,655,druid,balance,15,8,7
Vallk,area-52,639,druid,balance,14,8,6
Spacéchicken,stormrage,638,druid,balance,10,8,2
Vaalser,frostmourne,636,druid,balance,23,7,16
Tumblr,terenas,624,druid,balance,9,7,2
Desiration,area-52,624,druid,balance,15,7,8
Arescarriess,shuhalo,622,druid,balance,17,7,10
Chankletta,quelthalas,618,druid,balance,18,8,10
Warberton,moon-guard,616,druid,balance,15,7,8
Zalothianx,thrall,608,druid,balance,16,7,9
Lawnkin,dalaran,608,druid,balance,16,7,9
Feldstarx,stormrage,607,druid,balance,14,7,7
Neurotoxins,tichondrius,576,druid,balance,6,6,0
Nardwaur,tichondrius,576,druid,balance,6,6,0
Starship,frostmourne,576,druid,balance,6,6,0
Ory,illidan,576,druid,balance,6,6,0
Prev,arathor,576,druid,balance,6,6,0
Drop,shadow-council,576,druid,balance,6,6,0
Gâlaxy,sargeras,576,druid,balance,12,6,6
Gigathicc,malganis,576,druid,balance,12,6,6
Beomjun,tichondrius,576,druid,balance,12,6,6
Skydín,stormrage,576,druid,balance,12,6,6
Nerfdemo,kiljaeden,576,druid,balance,12,6,6
Kitem,tichondrius,576,druid,balance,12,6,6
Celetra,kiljaeden,576,druid,balance,12,6,6
Jamuestus,illidan,576,druid,balance,12,6,6
Dalaverrunis,tichondrius,576,druid,balance,12,6,6
Slaÿr,malganis,576,druid,balance,12,6,6
Jacknit,illidan,576,druid,balance,12,6,6
Ssantirap,quelthalas,576,druid,balance,12,6,6
Bar,stormrage,576,druid,balance,12,6,6
Wondercat,illidan,576,druid,balance,12,6,6
Msparker,illidan,576,druid,balance,12,6,6
Joux,barthilas,576,druid,balance,12,6,6
Afpak,sargeras,576,druid,balance,12,6,6
Scykin,stormrage,576,druid,balance,12,6,6
Ggae,tichondrius,576,druid,balance,12,6,6
Ephwürd,malganis,576,druid,balance,12,6,6
Treehard,malganis,576,druid,balance,12,6,6
Jawsbar,tichondrius,576,druid,balance,12,6,6
Peteybears,stormrage,576,druid,balance,12,6,6
Versena,moon-guard,576,druid,balance,12,6,6
Runforest,tichondrius,576,druid,balance,12,6,6
Zgg,ragnaros,576,druid,balance,12,6,6
Lunartiç,kelthuzad,576,druid,balance,12,6,6
Gallianö,frostmourne,576,druid,balance,12,6,6
Nýla,stormrage,576,druid,balance,12,6,6
Bamfferal,tichondrius,576,druid,balance,12,6,6
Medibull,tichondrius,576,druid,balance,12,6,6
Skaie,ragnaros,576,druid,balance,12,6,6
Fixn,tichondrius,576,druid,balance,12,6,6
Jmackd,frostmourne,576,druid,balance,12,6,6
Notpodruida,tichondrius,576,druid,balance,13,6,7
Yorch,stormrage,576,druid,balance,18,6,12
Doomky,area-52,576,druid,balance,18,6,12
Longnus,stormrage,576,druid,balance,18,6,12
Droodad,mannoroth,576,druid,balance,18,6,12
Faletra,eitrigg,576,druid,balance,18,6,12
Drphilsmith,moon-guard,576,druid,balance,18,6,12
Jherrak,area-52,575,druid,balance,6,6,0
Zetii,emerald-dream,575,druid,balance,12,6,6
Tariksha,sargeras,575,druid,balance,12,6,6
Razzldazzle,thrall,575,druid,balance,12,6,6
Rígél,ragnaros,575,druid,balance,12,6,6
Zeanasfaratu,spinebreaker,575,druid,balance,12,6,6
Hpcorrection,bleeding-hollow,575,druid,balance,12,6,6
Runarok,ragnaros,575,druid,balance,12,6,6
Guybranch,illidan,575,druid,balance,12,6,6
Chodkiewicz,echo-isles,575,druid,balance,12,6,6
Jynxy,sargeras,575,druid,balance,18,6,12
Samelthios,proudmoore,575,druid,balance,20,6,14
Uuli,area-52,574,druid,balance,12,6,6
Feralchild,emerald-dream,574,druid,balance,12,6,6
Outandy,quelthalas,574,druid,balance,12,6,6
Quagsire,moon-guard,574,druid,balance,18,6,12
Tinyypuppyy,sargeras,573,druid,balance,12,6,6
Mctree,cenarius,572,druid,balance,12,6,6
Wantto,moknathal,566,druid,balance,12,6,6
Proñgs,tichondrius,566,druid,balance,12,6,6
Orkinetvx,frostmourne,555,druid,balance,13,7,6
Suist,moonrunner,544,druid,balance,10,6,4
Casaran,anetheron,543,druid,balance,11,6,5
Matock,malganis,543,druid,balance,11,6,5
Liñk,sargeras,543,druid,balance,17,8,9
Bearyhalls,frostmourne,528,druid,balance,9,6,3
Boufa,dentarg,527,druid,balance,9,7,2
Velais,exodar,512,druid,balance,22,6,16
Gemineye,stormrage,511,druid,balance,11,6,5
Istayfrawsty,darkspear,511,druid,balance,14,6,8
Rank,nerzhul,496,druid,balance,13,6,7
Oo,grizzly-hills,480,druid,balance,6,5,1
Daroot,spinebreaker,480,druid,balance,6,5,1
Yokux,thunderlord,480,druid,balance,6,5,1
Toastsdruid,tichondrius,480,druid,balance,6,5,1
Løk,sargeras,480,druid,balance,6,5,1
Canuatemyrat,tichondrius,480,druid,balance,6,5,1
Alindrä,moon-guard,480,druid,balance,6,5,1
Eskimocowboy,sargeras,480,druid,balance,6,5,1
Megåtron,kelthuzad,480,druid,balance,6,5,1
Dojacat,tichondrius,480,druid,balance,6,5,1
Bearyhalls,sargeras,480,druid,balance,6,5,1
Aoewynn,nerzhul,480,druid,balance,6,5,1
Simperella,dalaran,480,druid,balance,6,5,1
Crazystarz,frostmourne,480,druid,balance,6,5,1
Hàchi,malganis,480,druid,balance,6,5,1
Ragiix,tichondrius,480,druid,balance,6,5,1
Bumbleebee,azralon,480,druid,balance,6,5,1
Nephsis,kelthuzad,480,druid,balance,6,5,1
Ichangeabull,bleeding-hollow,480,druid,balance,6,5,1
Marutot,tichondrius,480,druid,balance,6,5,1
Ratspot,stormrage,480,druid,balance,6,5,1
Prøspect,moon-guard,480,druid,balance,6,5,1
Duckdie,moon-guard,480,druid,balance,6,5,1
Dtefy,ragnaros,480,druid,balance,6,5,1
ßælot,quelthalas,480,druid,balance,6,5,1
Miçangak,azralon,480,druid,balance,6,5,1
Immortalowl,illidan,480,druid,balance,6,5,1
Arwëna,tichondrius,480,druid,balance,6,5,1
Numbkin,stormrage,480,druid,balance,6,5,1
Bayaba,tichondrius,480,druid,balance,6,5,1
Rastakant,malganis,480,druid,balance,6,5,1
Volgoro,thrall,480,druid,balance,6,5,1
Mithroi,tichondrius,480,druid,balance,6,5,1
Hännibal,hydraxis,480,druid,balance,6,5,1
Rowdie,area-52,480,druid,balance,6,5,1
Fakechower,stormreaver,480,druid,balance,6,5,1
Zieda,sisters-of-elune,480,druid,balance,6,5,1
Stacker,malganis,480,druid,balance,6,5,1
Nuppxx,frostmourne,480,druid,balance,6,5,1
Dahts,destromath,480,druid,balance,6,5,1
Hooffy,emerald-dream,480,druid,balance,6,5,1
Fattdiabetic,tichondrius,480,druid,balance,6,5,1
Druidlow,azralon,480,druid,balance,7,5,2
Bullquenepas,dalaran,480,druid,balance,12,5,7
Xoth,executus,480,druid,balance,12,5,7
Arnlu,malganis,480,druid,balance,12,5,7
Ragerag,trollbane,480,druid,balance,12,5,7
Nöches,quelthalas,480,druid,balance,12,5,7
Fluff,gurubashi,480,druid,balance,12,5,7
Zuga,the-venture-co,480,druid,balance,12,5,7
Zimah,illidan,480,druid,balance,12,5,7
Wrathmighty,frostmourne,480,druid,balance,12,5,7
Cynderellaa,proudmoore,480,druid,balance,12,5,7
Havócdh,tichondrius,480,druid,balance,12,5,7
Dotdmage,tichondrius,480,druid,balance,12,5,7
Livilla,sargeras,480,druid,balance,12,5,7
Cloninglol,darkspear,480,druid,balance,12,5,7
Veganmom,zuluhed,480,druid,balance,12,5,7
Milkmoneymeo,illidan,480,druid,balance,12,5,7
Voelcan,tichondrius,480,druid,balance,12,5,7
Spudpatikins,barthilas,480,druid,balance,12,5,7
Ripter,moon-guard,480,druid,balance,12,5,7
Bigtammy,moon-guard,480,druid,balance,12,5,7
Sharkfighter,sargeras,480,druid,balance,12,5,7
Bearwithit,sargeras,480,druid,balance,12,5,7
Sodacream,illidan,480,druid,balance,12,5,7
Bigdaddyferg,illidan,480,druid,balance,12,5,7
Lickmypaws,sargeras,480,druid,balance,12,5,7
Paintlicker,emerald-dream,480,druid,balance,12,5,7
Ghoouul,tichondrius,480,druid,balance,18,5,13
Tuppyboom,barthilas,480,druid,balance,24,5,19
Durdern,barthilas,479,druid,balance,6,5,1
Wtfiisthis,tichondrius,479,druid,balance,6,5,1
Fourthkind,illidan,479,druid,balance,12,5,7
Damallis,anubarak,479,druid,balance,12,5,7
Smhyle,frostmourne,479,druid,balance,12,5,7
Palermo,aerie-peak,479,druid,balance,12,5,7
Raknary,kelthuzad,479,druid,balance,12,5,7
Baaksau,illidan,479,druid,balance,12,5,7
Morphntime,blackrock,479,druid,balance,18,5,13
Mantis,the-underbog,478,druid,balance,12,5,7
Abzyplasm,sargeras,478,druid,balance,12,5,7
Convoken,tichondrius,447,druid,balance,11,5,6
Bearcathawk,sargeras,447,druid,balance,11,5,6
Charmandxr,hyjal,447,druid,balance,14,6,8
Féralis,sargeras,431,druid,balance,11,5,6
Gigajuiced,proudmoore,400,druid,balance,7,5,2
Eintier,tichondrius,384,druid,balance,6,4,2
Anamoorphicc,kelthuzad,384,druid,balance,6,4,2
Daddyfresh,ursin,384,druid,balance,6,4,2
Brettdadad,shandris,384,druid,balance,6,4,2
Flamejacker,tichondrius,384,druid,balance,6,4,2
Oldcreg,emerald-dream,384,druid,balance,6,4,2
Abelladañger,area-52,384,druid,balance,6,4,2
Hadoriss,kelthuzad,384,druid,balance,6,4,2
Somarythe,moon-guard,384,druid,balance,6,4,2
Ahruan,stormrage,384,druid,balance,6,4,2
Feathergun,ragnaros,384,druid,balance,6,4,2
Kiwidru,frostmourne,384,druid,balance,6,4,2
Notadopted,sargeras,384,druid,balance,6,4,2
Selfplay,barthilas,384,druid,balance,6,4,2
Drmnheal,frostmourne,384,druid,balance,6,4,2
Stärfäll,frostmourne,384,druid,balance,6,4,2
Nevershiftx,kirin-tor,384,druid,balance,6,4,2
Qyuka,area-52,384,druid,balance,6,4,2
Rennar,stormrage,384,druid,balance,6,4,2
Girthybeam,sargeras,384,druid,balance,6,4,2
Sharialawl,stormreaver,384,druid,balance,6,4,2
Yevenbother,tichondrius,384,druid,balance,6,4,2
Matinee,tichondrius,384,druid,balance,6,4,2
Nicklul,llane,384,druid,balance,6,4,2
Beastsworn,alexstrasza,384,druid,balance,6,4,2
Tinishaker,ragnaros,384,druid,balance,6,4,2
Söökie,tichondrius,384,druid,balance,6,4,2
Withwind,dalaran,384,druid,balance,6,4,2
Armorkits,area-52,384,druid,balance,6,4,2
Bearlylegál,sargeras,384,druid,balance,6,4,2
Bäldir,dalaran,384,druid,balance,6,4,2
Harlisu,stormrage,384,druid,balance,6,4,2
Twostars,thrall,384,druid,balance,6,4,2
Cashgame,malganis,384,druid,balance,6,4,2
Beamerboy,bleeding-hollow,384,druid,balance,6,4,2
Pincho,hyjal,384,druid,balance,6,4,2
Hëllchaos,sargeras,384,druid,balance,6,4,2
Bubblybear,winterhoof,384,druid,balance,6,4,2
Duo,demon-soul,384,druid,balance,6,4,2
Joiczar,maelstrom,384,druid,balance,6,4,2
Shinazugawa,maiev,384,druid,balance,6,4,2
Melizaa,stormrage,384,druid,balance,6,4,2
Luvgames,area-52,384,druid,balance,6,4,2
Critkatbear,detheroc,384,druid,balance,6,4,2
Druz,spirestone,384,druid,balance,6,4,2
Dokasaurus,lightbringer,384,druid,balance,6,4,2
Watchugonndo,tichondrius,384,druid,balance,6,4,2
Gloomcat,illidan,384,druid,balance,6,4,2
Korlstone,zuljin,384,druid,balance,6,4,2
Lukass,tichondrius,384,druid,balance,6,4,2
Elonmuskirl,illidan,384,druid,balance,6,4,2
Zxve,stormrage,384,druid,balance,6,4,2
Seekamp,khazgoroth,384,druid,balance,6,4,2
Balancz,thrall,384,druid,balance,10,5,5
Scraww,tichondrius,384,druid,balance,17,6,11
Astraelas,tichondrius,384,druid,balance,12,4,8
Tegrizelle,cenarion-circle,384,druid,balance,12,4,8
Jakermans,area-52,384,druid,balance,12,4,8
Blipshift,tichondrius,384,druid,balance,12,4,8
Sinistuhd,tichondrius,384,druid,balance,12,4,8
Datdruidrod,illidan,384,druid,balance,12,4,8
Sorh,stormrage,384,druid,balance,12,4,8
Veyrønn,stormrage,384,druid,balance,12,4,8
Lutein,tichondrius,384,druid,balance,12,4,8
Ethan,the-venture-co,384,druid,balance,12,4,8
Altius,drakkari,384,druid,balance,12,4,8
Einraedon,dalaran,384,druid,balance,12,4,8
Omnipaw,kelthuzad,384,druid,balance,12,4,8
Zenowl,turalyon,384,druid,balance,12,4,8
Tasselhoof,hyjal,384,druid,balance,12,4,8
Bignosecow,illidan,384,druid,balance,12,4,8
Madisonivyx,area-52,384,druid,balance,12,4,8
Simo,kaelthas,384,druid,balance,12,4,8
Halrath,sargeras,384,druid,balance,12,4,8
Vashida,stormrage,384,druid,balance,12,4,8
Immortalwild,tichondrius,384,druid,balance,12,4,8
Stormclaw,elune,384,druid,balance,12,4,8
Wintarz,sargeras,384,druid,balance,12,4,8
Velaar,arthas,384,druid,balance,12,4,8
Guitarsolos,nagrand,384,druid,balance,12,4,8
Katdog,warsong,384,druid,balance,18,4,14
Krunge,frostwolf,383,druid,balance,6,4,2
Bulldog,runetotem,383,druid,balance,6,4,2
Huoxiaoying,tichondrius,383,druid,balance,6,4,2
Aessinawisp,frostmourne,383,druid,balance,6,4,2
Herbirove,frostmourne,383,druid,balance,6,4,2
Xisloko,azralon,383,druid,balance,6,4,2
Papitank,drakkari,383,druid,balance,6,4,2
Balthøs,moon-guard,383,druid,balance,6,4,2
Scienttific,malganis,383,druid,balance,12,4,8
Balantina,tichondrius,383,druid,balance,12,4,8
Nobullshift,icecrown,383,druid,balance,12,4,8
Tïcks,illidan,383,druid,balance,12,4,8
Nukaboom,elune,382,druid,balance,6,4,2
Boomanon,illidan,382,druid,balance,6,4,2
Sever,ysera,382,druid,balance,12,4,8
Meowfacebby,stormrage,367,druid,balance,11,4,7
Seytu,sargeras,351,druid,balance,8,5,3
Gutanamo,stormrage,334,druid,balance,8,5,3
Rahdek,azgalor,330,druid,balance,7,5,2
Kimnim,tichondrius,330,druid,balance,9,6,3
Ihjx,sargeras,330,druid,balance,11,6,5
Yangrou,tichondrius,330,druid,balance,11,5,6
Wiredxd,illidan,288,druid,balance,6,3,3
Taztoc,stormrage,288,druid,balance,6,3,3
Jabawockdeez,area-52,288,druid,balance,6,3,3
Schmeatbawls,illidan,288,druid,balance,6,3,3
Slottpocket,malganis,288,druid,balance,6,3,3
Jxred,illidan,288,druid,balance,6,3,3
Haaha,area-52,288,druid,balance,6,3,3
Nidalie,zuljin,288,druid,balance,6,3,3
Spooser,proudmoore,288,druid,balance,6,3,3
Starfallgg,sargeras,288,druid,balance,6,3,3
Pepperpawz,emerald-dream,288,druid,balance,6,3,3
Polyproof,emerald-dream,288,druid,balance,6,3,3
Loren,gorefiend,288,druid,balance,6,3,3
Alcorria,area-52,288,druid,balance,6,3,3
Guidoanchovz,thrall,288,druid,balance,6,3,3
Kî,thunderlord,288,druid,balance,6,3,3
Painsbrook,thrall,288,druid,balance,6,3,3
Malfuria,tichondrius,288,druid,balance,6,3,3
Aconcat,bleeding-hollow,288,druid,balance,6,3,3
Icastsmells,tichondrius,288,druid,balance,6,3,3
Budtender,moon-guard,288,druid,balance,6,3,3
Boiledfrogs,zuljin,288,druid,balance,6,3,3
Cimanin,malganis,288,druid,balance,6,3,3
Swampduck,saurfang,288,druid,balance,6,3,3
Goldentaint,tichondrius,288,druid,balance,6,3,3
Luuxia,tichondrius,288,druid,balance,6,3,3
Sawachicky,frostmourne,288,druid,balance,6,3,3
Silynce,tichondrius,288,druid,balance,6,3,3
Waiv,area-52,288,druid,balance,6,3,3
Voodoopipe,tichondrius,288,druid,balance,6,3,3
Fengfeidruid,illidan,288,druid,balance,6,3,3
Azoth,hyjal,288,druid,balance,6,3,3
Hootiepie,hyjal,288,druid,balance,6,3,3
Coompie,frostmourne,288,druid,balance,6,3,3
Iploopedyogf,bleeding-hollow,288,druid,balance,6,3,3
Akiza,sargeras,288,druid,balance,6,3,3
Silkyroad,tichondrius,288,druid,balance,6,3,3
Stretchhxd,tichondrius,288,druid,balance,6,3,3
Vykarux,suramar,288,druid,balance,6,3,3
Kaldelar,emerald-dream,288,druid,balance,6,3,3
Kalalana,illidan,288,druid,balance,6,3,3
Icefang,tichondrius,288,druid,balance,6,3,3
Bearys,area-52,288,druid,balance,6,3,3
Cien,thrall,288,druid,balance,6,3,3
Ohsnapz,silvermoon,288,druid,balance,6,3,3
Papacard,stormrage,288,druid,balance,6,3,3
Sodah,tichondrius,288,druid,balance,6,3,3
Däll,tichondrius,288,druid,balance,6,3,3
Ðeepsixx,burning-legion,288,druid,balance,6,3,3
Jpylm,ysera,288,druid,balance,6,3,3
Eøle,stormrage,288,druid,balance,6,3,3
Mådge,frostmourne,288,druid,balance,6,3,3
Shaftomatic,tichondrius,288,druid,balance,6,3,3
Snartx,illidan,288,druid,balance,6,3,3
Cbark,ravencrest,288,druid,balance,6,3,3
Winmax,tichondrius,288,druid,balance,6,3,3
Targeted,sargeras,288,druid,balance,6,3,3
Bhíkkhu,stormrage,288,druid,balance,6,3,3
Thumpb,bronzebeard,288,druid,balance,6,3,3
Celestialife,frostmourne,288,druid,balance,6,3,3
Sypìí,stormrage,288,druid,balance,6,3,3
Pergutory,frostmourne,288,druid,balance,6,3,3
Jgb,dalaran,288,druid,balance,6,3,3
Galadriowl,dalaran,288,druid,balance,6,3,3
Jayroneowo,frostmourne,288,druid,balance,6,3,3
Shalaz,magtheridon,288,druid,balance,6,3,3
Swiftboom,stormrage,288,druid,balance,6,3,3
Çãñçèr,frostmourne,288,druid,balance,6,3,3
Pigmanbear,kelthuzad,288,druid,balance,6,3,3
Rhorr,frostmourne,288,druid,balance,6,3,3
Ornaaga,blackrock,288,druid,balance,6,3,3
Hchhi,ragnaros,288,druid,balance,6,3,3
Bigswaag,malganis,288,druid,balance,7,3,4
Xail,hyjal,288,druid,balance,8,3,5
Wreckingcrew,emerald-dream,288,druid,balance,8,3,5
Retsarehard,illidan,288,druid,balance,8,3,5
Scythé,stormrage,288,druid,balance,12,3,9
Feyrien,dalaran,288,druid,balance,12,3,9
Mulgorer,tichondrius,288,druid,balance,12,3,9
Monicaduan,frostmourne,288,druid,balance,12,3,9
Plye,korgath,288,druid,balance,12,3,9
Koan,proudmoore,288,druid,balance,12,3,9
Uezzon,tol-barad,288,druid,balance,12,3,9
Davelombardo,tichondrius,288,druid,balance,12,3,9
Jalapenoz,wyrmrest-accord,288,druid,balance,12,3,9
Furrycringe,stormrage,288,druid,balance,12,3,9
Mørphea,darkspear,288,druid,balance,12,3,9
Machinex,illidan,288,druid,balance,12,3,9
Proudmom,barthilas,288,druid,balance,12,3,9
Gilgorash,kiljaeden,288,druid,balance,12,3,9
Xalstarrot,sargeras,288,druid,balance,12,3,9
Cêania,moon-guard,288,druid,balance,12,3,9
Hottiecake,bronzebeard,288,druid,balance,12,3,9
Loathe,korialstrasz,288,druid,balance,12,3,9
Teyollocuani,sargeras,288,druid,balance,12,3,9
Evarene,vashj,288,druid,balance,12,3,9
Wweegyy,tichondrius,287,druid,balance,6,3,3
Guston,lightbringer,287,druid,balance,6,3,3
Seethert,quelthalas,286,druid,balance,6,3,3
Wiseoldman,jubeithos,286,druid,balance,6,3,3
Elydaria,destromath,286,druid,balance,6,3,3
Formgodx,malganis,256,druid,balance,10,3,7
Vollzar,sargeras,255,druid,balance,11,3,8
Amanara,echo-isles,255,druid,balance,11,3,8
Oddclaw,stormrage,239,druid,balance,5,3,2
Bigtoeess,tichondrius,239,druid,balance,5,3,2
Tanawak,tichondrius,239,druid,balance,5,3,2
Ranokaliki,area-52,239,druid,balance,5,3,2
Clawandørder,tichondrius,223,druid,balance,8,3,5
Jazzman,jubeithos,223,druid,balance,14,3,11
Nodeathz,sargeras,192,druid,balance,4,3,1
Flummoz,frostmourne,192,druid,balance,4,3,1
Niwßor,azralon,192,druid,balance,10,4,6
Hellabanx,tichondrius,192,druid,balance,6,2,4
Isunami,emerald-dream,192,druid,balance,6,2,4
Bobobear,proudmoore,192,druid,balance,6,2,4
Lilherb,azralon,192,druid,balance,6,2,4
Hagenws,azralon,192,druid,balance,6,2,4
Edinhalfhorn,bonechewer,192,druid,balance,6,2,4
Dazedru,stormrage,192,druid,balance,6,2,4
Potus,illidan,192,druid,balance,6,2,4
Smallrichard,bleeding-hollow,192,druid,balance,6,2,4
Bubblebraìn,area-52,192,druid,balance,6,2,4
Cbreezyy,tichondrius,192,druid,balance,6,2,4
Spicyorange,dalaran,192,druid,balance,6,2,4
Injeckx,tichondrius,192,druid,balance,6,2,4
Ginunaga,tichondrius,192,druid,balance,6,2,4
Moistism,tichondrius,192,druid,balance,6,2,4
Adonalsium,area-52,192,druid,balance,6,2,4
Credd,zuljin,192,druid,balance,6,2,4
Yosuzume,thrall,192,druid,balance,6,2,4
Bullwïnkle,uther,192,druid,balance,6,2,4
Trippykitty,tichondrius,192,druid,balance,6,2,4
Simeron,silvermoon,192,druid,balance,6,2,4
Gazwazluz,lothar,192,druid,balance,6,2,4
Pawswap,tichondrius,192,druid,balance,6,2,4
Tp,dragonblight,192,druid,balance,6,2,4
Tansdruid,area-52,192,druid,balance,6,2,4
Azshunara,moon-guard,192,druid,balance,6,2,4
Absentteeth,stormrage,192,druid,balance,6,2,4
Speaks,moon-guard,192,druid,balance,6,2,4
Crycloné,stormrage,192,druid,balance,6,2,4
Dweralin,nemesis,192,druid,balance,6,2,4
Starsfall,tichondrius,192,druid,balance,6,2,4
Hoptimus,zuljin,192,druid,balance,6,2,4
Zigh,azralon,192,druid,balance,6,2,4
Ridicules,cenarius,192,druid,balance,6,2,4
Katherine,moon-guard,192,druid,balance,6,2,4
Markóla,stormrage,192,druid,balance,6,2,4
Laymonath,elune,192,druid,balance,6,2,4
Totorostard,tichondrius,192,druid,balance,6,2,4
Hream,echo-isles,192,druid,balance,6,2,4
Moonhorn,kelthuzad,192,druid,balance,6,2,4
Mäûled,fizzcrank,192,druid,balance,6,2,4
Octacer,malfurion,192,druid,balance,6,2,4
Ohzú,ragnaros,192,druid,balance,6,2,4
Hornny,shattered-hand,192,druid,balance,6,2,4
Rakuath,zuljin,192,druid,balance,6,2,4
Boomtastik,frostmourne,192,druid,balance,6,2,4
Mythicdruid,ragnaros,192,druid,balance,6,2,4
Trìckyz,tichondrius,192,druid,balance,6,2,4
Bestik,quelthalas,192,druid,balance,6,2,4
Gidam,moon-guard,192,druid,balance,6,2,4
Chèétøhz,moon-guard,192,druid,balance,6,2,4
Srbestias,quelthalas,192,druid,balance,6,2,4
Wtfhommie,madoran,192,druid,balance,6,2,4
Mòónwhisper,moon-guard,192,druid,balance,6,2,4
Variandruid,kelthuzad,192,druid,balance,6,2,4
Arienne,kelthuzad,192,druid,balance,6,2,4
Guap,bleeding-hollow,192,druid,balance,6,2,4
Skke,barthilas,192,druid,balance,6,2,4
Hawgs,bleeding-hollow,192,druid,balance,6,2,4
Loodichriss,area-52,192,druid,balance,6,2,4
Maidah,malganis,192,druid,balance,6,2,4
Nightnes,sargeras,192,druid,balance,6,2,4
Zukru,malganis,192,druid,balance,6,2,4
Hancalimon,nemesis,192,druid,balance,6,2,4
Nokitty,tichondrius,192,druid,balance,6,2,4
Flarkage,area-52,192,druid,balance,6,2,4
Enlil,the-underbog,192,druid,balance,6,2,4
Explicít,sargeras,192,druid,balance,6,2,4
Treezyn,sargeras,192,druid,balance,6,2,4
Empriona,wildhammer,192,druid,balance,6,2,4
Sloppysheila,sargeras,192,druid,balance,6,2,4
Visûcius,moon-guard,192,druid,balance,12,2,10
Loggoruk,illidan,192,druid,balance,12,2,10
Everglim,azralon,192,druid,balance,12,2,10
Daydaygo,illidan,192,druid,balance,12,2,10
Thundyrcat,tichondrius,192,druid,balance,12,2,10
Solaress,moon-guard,192,druid,balance,12,2,10
Thicchicken,emerald-dream,191,druid,balance,12,2,10
Moonkingx,ragnaros,159,druid,balance,5,2,3
Nightsanta,emerald-dream,159,druid,balance,5,2,3
Stealthhero,lightbringer,159,druid,balance,5,2,3
Irontree,dunemaul,159,druid,balance,5,2,3
Formality,kalecgos,159,druid,balance,5,2,3
Xylemcow,malganis,159,druid,balance,5,2,3
Theriomorph,barthilas,138,druid,balance,10,3,7
Appitrap,emerald-dream,137,druid,balance,19,3,16
Aeo,frostmourne,112,druid,balance,7,2,5
Alistar,scilla,96,druid,balance,3,2,1
Vawdka,proudmoore,96,druid,balance,3,2,1
Yøpièrre,bleeding-hollow,96,druid,balance,3,2,1
Scoobyshiftz,frostmourne,96,druid,balance,8,2,6
Omegabeast,frostmourne,96,druid,balance,6,1,5
Aelena,whisperwind,96,druid,balance,6,1,5
Kirrel,frostmourne,96,druid,balance,6,1,5
Brucey,khadgar,96,druid,balance,6,1,5
Travys,sargeras,96,druid,balance,6,1,5
Dèrpin,thrall,96,druid,balance,6,1,5
Chalupà,illidan,96,druid,balance,6,1,5
Schlaankeyy,stormrage,96,druid,balance,6,1,5
Zazinium,illidan,96,druid,balance,6,1,5
Cloyer,stormrage,96,druid,balance,6,1,5
Caponetonejr,steamwheedle-cartel,96,druid,balance,6,1,5
Chickenaeg,stormrage,96,druid,balance,6,1,5
Elivacheth,zuljin,96,druid,balance,6,1,5
Iamatomic,illidan,96,druid,balance,6,1,5
Salanzô,bleeding-hollow,96,druid,balance,6,1,5
Tsaß,bleeding-hollow,96,druid,balance,6,1,5
Fancyprance,dalaran,96,druid,balance,6,1,5
Thissaene,sargeras,96,druid,balance,6,1,5
Breedable,elune,96,druid,balance,6,1,5
Grimmb,emerald-dream,96,druid,balance,6,1,5
Sunmoonkong,area-52,96,druid,balance,6,1,5
Stalfrus,area-52,96,druid,balance,6,1,5
Shmooglite,emerald-dream,96,druid,balance,6,1,5
Barecowbear,bleeding-hollow,96,druid,balance,6,1,5
Sinapticc,proudmoore,96,druid,balance,6,1,5
Papaland,tichondrius,96,druid,balance,6,1,5
Torpina,malganis,96,druid,balance,6,1,5
Stinkycrotch,malganis,96,druid,balance,6,1,5
Ultracatx,tichondrius,96,druid,balance,6,1,5
Dendríta,ragnaros,96,druid,balance,6,1,5
Oatmeals,fizzcrank,96,druid,balance,6,1,5
Walkdown,turalyon,96,druid,balance,6,1,5
Whodoüvoodoo,tichondrius,96,druid,balance,6,1,5
Furryluvr,tichondrius,96,druid,balance,6,1,5
Goodhealer,akama,96,druid,balance,6,1,5
Rennan,cenarius,96,druid,balance,6,1,5
Ggumy,tichondrius,96,druid,balance,6,1,5
Klint,darkspear,96,druid,balance,6,1,5
Scatpanties,moon-guard,96,druid,balance,6,1,5
Dobrman,sargeras,96,druid,balance,6,1,5
Youlived,aegwynn,96,druid,balance,6,1,5
Idontknowbro,bonechewer,96,druid,balance,6,1,5
Simbaa,blades-edge,96,druid,balance,10,1,9
Kängawalafox,frostmourne,96,druid,balance,12,1,11
Kodrän,stormrage,96,druid,balance,12,1,11
Drewcarriesu,arthas,79,druid,balance,5,2,3
Zephiee,kelthuzad,79,druid,balance,5,1,4
Manalune,firetree,79,druid,balance,5,1,4
Foggie,spirestone,79,druid,balance,5,1,4
Raahmirtah,illidan,79,druid,balance,5,1,4
Lutzenberger,nemesis,79,druid,balance,5,1,4
Hughhefferr,illidan,63,druid,balance,2,2,0
Guron,aegwynn,48,druid,balance,3,1,2
Joshepwrith,azralon,42,druid,balance,7,2,5
Policë,skullcrusher,42,druid,balance,8,2,6
Nåpes,frostmourne,31,druid,balance,2,1,1
Thullian,stormrage,31,druid,balance,2,1,1
Äbÿss,tichondrius,16,druid,balance,1,1,0
Highs,sargeras,16,druid,balance,1,1,0
Garbagevoker,scilla,2242,evoker,preservation,192,99,93
Meraxes,moonrunner,2167,evoker,preservation,77,42,35
Dracob,sargeras,2131,evoker,preservation,164,88,76
Sleepiihead,stormrage,2130,evoker,preservation,96,50,46
Jakedrake,stormrage,2128,evoker,preservation,97,49,48
Dragocula,tichondrius,2106,evoker,preservation,109,55,54
Jdbthyr,malganis,2025,evoker,preservation,156,73,83
Sleepiiheadx,stormrage,2021,evoker,preservation,60,35,25
Idk,proudmoore,2004,evoker,preservation,66,34,32
Kiry,emerald-dream,1994,evoker,preservation,84,40,44
Eskrizzle,thrall,1991,evoker,preservation,78,38,40
Didy,tichondrius,1986,evoker,preservation,135,69,66
Storeypagoda,tichondrius,1984,evoker,preservation,74,42,32
Kallie,whisperwind,1971,evoker,preservation,503,250,253
Idrinkurine,tichondrius,1918,evoker,preservation,88,45,43
Ellafortnite,emerald-dream,1915,evoker,preservation,55,31,24
Sloane,dunemaul,1899,evoker,preservation,51,32,19
Mngxaltx,ragnaros,1885,evoker,preservation,78,37,41
Philmcracken,proudmoore,1883,evoker,preservation,34,24,10
Benym,tichondrius,1873,evoker,preservation,60,32,28
Lieferant,area-52,1867,evoker,preservation,48,25,23
Bimbus,illidan,1865,evoker,preservation,148,81,67
Walf,stormrage,1864,evoker,preservation,311,156,155
Eyjes,stormrage,1847,evoker,preservation,90,48,42
Thnake,zuljin,1839,evoker,preservation,72,38,34
Selkisaurus,area-52,1834,evoker,preservation,60,29,31
Ancalagøn,ragnaros,1833,evoker,preservation,70,35,35
Ojigi,sargeras,1833,evoker,preservation,69,28,41
Driceses,area-52,1831,evoker,preservation,72,44,28
Stønemonkey,sargeras,1831,evoker,preservation,123,66,57
Iba,tichondrius,1828,evoker,preservation,96,54,42
Ravebae,frostmourne,1828,evoker,preservation,45,25,20
Neskor,moon-guard,1827,evoker,preservation,101,58,43
Drupy,tichondrius,1816,evoker,preservation,54,28,26
Dragongunz,illidan,1815,evoker,preservation,42,19,23
Lucardeht,illidan,1813,evoker,preservation,44,23,21
Dragonkok,stormrage,1810,evoker,preservation,42,26,16
Hlaargh,illidan,1809,evoker,preservation,60,31,29
Furegos,zuljin,1807,evoker,preservation,48,23,25
Lodekiim,malganis,1806,evoker,preservation,66,30,36
Obama,dragonmaw,1801,evoker,preservation,78,33,45
Novustrasza,lightbringer,1800,evoker,preservation,66,43,23
Petezra,ragnaros,1800,evoker,preservation,70,33,37
Livesey,thunderhorn,1791,evoker,preservation,96,56,40
Drerick,illidan,1772,evoker,preservation,104,53,51
Dragontrees,illidan,1765,evoker,preservation,54,28,26
Neocellx,frostwolf,1756,evoker,preservation,49,28,21
Ugg,stormrage,1756,evoker,preservation,171,76,95
Berquone,tichondrius,1747,evoker,preservation,72,31,41
Cerevok,area-52,1745,evoker,preservation,60,37,23
Phooby,sargeras,1736,evoker,preservation,72,37,35
Dunkinonem,black-dragonflight,1734,evoker,preservation,562,281,281
Rosestrasza,silvermoon,1734,evoker,preservation,132,63,69
Dirtydragon,uther,1724,evoker,preservation,54,22,32
Dracthyrfang,elune,1718,evoker,preservation,48,22,26
Révoked,magtheridon,1715,evoker,preservation,305,166,139
Courtvoke,turalyon,1715,evoker,preservation,153,82,71
Basherm,moon-guard,1711,evoker,preservation,96,47,49
Lodedragon,tichondrius,1695,evoker,preservation,102,44,58
Elimi,tichondrius,1687,evoker,preservation,30,18,12
Redseal,tichondrius,1685,evoker,preservation,66,31,35
Evokethisdik,tichondrius,1684,evoker,preservation,37,20,17
Schmitty,hellscream,1684,evoker,preservation,94,45,49
Mirandaxo,tichondrius,1684,evoker,preservation,161,73,88
Dragonclause,stormrage,1684,evoker,preservation,54,24,30
Whethersmell,tichondrius,1674,evoker,preservation,92,43,49
Judra,barthilas,1665,evoker,preservation,74,38,36
Velstrasza,stormrage,1664,evoker,preservation,36,20,16
Dupastrasza,illidan,1664,evoker,preservation,60,25,35
Vulkerr,stormrage,1663,evoker,preservation,90,51,39
Usedbandage,sargeras,1660,evoker,preservation,72,39,33
Daegonz,lightbringer,1657,evoker,preservation,116,57,59
Junkstam,malganis,1648,evoker,preservation,63,30,33
Dragboy,stormrage,1645,evoker,preservation,116,64,52
Domavem,tichondrius,1642,evoker,preservation,66,28,38
Flamedramon,bleeding-hollow,1641,evoker,preservation,223,103,120
Kainalaz,moon-guard,1637,evoker,preservation,49,23,26
Trákanon,mugthol,1634,evoker,preservation,67,37,30
Ðrac,bleeding-hollow,1633,evoker,preservation,53,30,23
Modenzu,malganis,1629,evoker,preservation,66,33,33
Purrlynn,tichondrius,1627,evoker,preservation,48,31,17
Dripdrop,stormscale,1627,evoker,preservation,94,49,45
Wingsoflyfe,frostmourne,1625,evoker,preservation,48,20,28
Dragondikz,tichondrius,1622,evoker,preservation,48,25,23
Chessyk,ragnaros,1615,evoker,preservation,35,25,10
Grunkthyr,moon-guard,1614,evoker,preservation,47,25,22
Leonilxd,tichondrius,1610,evoker,preservation,97,51,46
Bigdwagon,stormrage,1608,evoker,preservation,36,17,19
Triarcs,sargeras,1606,evoker,preservation,40,21,19
Twizzthyr,bleeding-hollow,1604,evoker,preservation,90,42,48
Deadlybx,bleeding-hollow,1603,evoker,preservation,70,32,38
Layugos,azralon,1601,evoker,preservation,35,20,15
Gharkul,frostmourne,1601,evoker,preservation,42,20,22
Provokker,drakkari,1600,evoker,preservation,30,21,9
Jlucks,wyrmrest-accord,1600,evoker,preservation,166,94,72
Veraxsys,wyrmrest-accord,1600,evoker,preservation,52,20,32
Emperör,quelthalas,1598,evoker,preservation,79,43,36
Grousegamer,barthilas,1591,evoker,preservation,50,21,29
Stinkler,stormscale,1586,evoker,preservation,78,36,42
Adragon,garithos,1585,evoker,preservation,77,30,47
Thinprivlege,area-52,1583,evoker,preservation,60,26,34
Evokesyn,stormrage,1582,evoker,preservation,69,37,32
Cyndragosa,dalvengyr,1565,evoker,preservation,59,27,32
Buttcrease,emerald-dream,1562,evoker,preservation,42,22,20
Møritz,stormrage,1562,evoker,preservation,86,40,46
Deathdrake,jubeithos,1559,evoker,preservation,114,51,63
Slimez,malganis,1556,evoker,preservation,48,21,27
Dragonkink,sargeras,1550,evoker,preservation,54,28,26
Dracore,firetree,1549,evoker,preservation,215,112,103
Ffaarrvv,illidan,1540,evoker,preservation,97,58,39
Tonysaur,lethon,1537,evoker,preservation,30,19,11
Kwitty,illidan,1535,evoker,preservation,48,27,21
Fláppÿbírd,bleeding-hollow,1533,evoker,preservation,24,16,8
Runawayslave,frostmane,1530,evoker,preservation,204,99,105
Cokobra,haomarush,1529,evoker,preservation,24,16,8
Velocîraptor,bleeding-hollow,1524,evoker,preservation,92,53,39
Bigbaojian,tichondrius,1522,evoker,preservation,24,16,8
Trembulos,malganis,1522,evoker,preservation,36,18,18
Eyolker,kelthuzad,1521,evoker,preservation,59,31,28
Gobananas,sargeras,1520,evoker,preservation,29,17,12
Quickshootin,tichondrius,1519,evoker,preservation,132,59,73
Ponnukii,tichondrius,1517,evoker,preservation,172,89,83
Mfka,dalaran,1515,evoker,preservation,53,24,29
Drepz,dalaran,1514,evoker,preservation,57,40,17
Thevochr,area-52,1514,evoker,preservation,42,27,15
Dragonsteppz,aegwynn,1512,evoker,preservation,30,16,14
Earthshatter,lightbringer,1510,evoker,preservation,166,91,75
Ycnpass,tichondrius,1509,evoker,preservation,134,79,55
Dragoncods,velen,1509,evoker,preservation,42,24,18
Madegood,tichondrius,1508,evoker,preservation,54,26,28
Jacm,fizzcrank,1502,evoker,preservation,48,23,25
Youngyongdie,tichondrius,1499,evoker,preservation,52,25,27
Corncrake,sargeras,1495,evoker,preservation,44,19,25
Vhaegart,area-52,1491,evoker,preservation,90,38,52
Emoker,magtheridon,1490,evoker,preservation,84,46,38
Zenot,malganis,1488,evoker,preservation,34,25,9
Macismighty,emerald-dream,1488,evoker,preservation,48,31,17
Hepzibah,kelthuzad,1488,evoker,preservation,53,23,30
Virtualcrush,sisters-of-elune,1486,evoker,preservation,94,49,45
Nikholatrus,malganis,1483,evoker,preservation,106,52,54
Splendadaddy,kiljaeden,1482,evoker,preservation,30,16,14
Sineexe,illidan,1476,evoker,preservation,80,47,33
Buttfinger,bladefist,1476,evoker,preservation,74,33,41
Ralzital,auchindoun,1476,evoker,preservation,68,29,39
Yotus,illidan,1474,evoker,preservation,60,35,25
Necrathma,tichondrius,1473,evoker,preservation,62,31,31
Nazatra,wyrmrest-accord,1473,evoker,preservation,71,34,37
Suffler,warsong,1472,evoker,preservation,72,39,33
Qiblii,moon-guard,1470,evoker,preservation,48,24,24
Monavoker,bleeding-hollow,1466,evoker,preservation,36,20,16
Weagle,zuljin,1465,evoker,preservation,45,18,27
Garchamp,area-52,1462,evoker,preservation,42,19,23
Enazen,kiljaeden,1460,evoker,preservation,83,45,38
Delivv,hyjal,1455,evoker,preservation,54,30,24
Cringilisk,kelthuzad,1454,evoker,preservation,126,82,44
Thicscales,tichondrius,1454,evoker,preservation,58,29,29
Lalargata,azralon,1450,evoker,preservation,59,28,31
Pauly,suramar,1449,evoker,preservation,54,27,27
Vormontis,azralon,1449,evoker,preservation,76,34,42
Suedeshoes,bleeding-hollow,1448,evoker,preservation,162,88,74
Egglayer,tichondrius,1448,evoker,preservation,114,42,72
Nyxtari,ragnaros,1447,evoker,preservation,108,57,51
Spyrox,zuluhed,1445,evoker,preservation,30,16,14
Gogmagog,korgath,1442,evoker,preservation,84,40,44
Dragisha,gnomeregan,1441,evoker,preservation,48,28,20
Ráigon,ragnaros,1439,evoker,preservation,118,54,64
Derazar,malganis,1438,evoker,preservation,249,111,138
Squarter,kiljaeden,1437,evoker,preservation,48,28,20
Bucket,wyrmrest-accord,1437,evoker,preservation,38,16,22
Dragonmyass,tichondrius,1434,evoker,preservation,43,17,26
Sovietønion,tichondrius,1433,evoker,preservation,71,32,39
Fusrodude,shuhalo,1428,evoker,preservation,86,48,38
Zakaraki,bloodscalp,1427,evoker,preservation,60,35,25
Handeezol,malganis,1426,evoker,preservation,48,27,21
Kjerne,stormrage,1424,evoker,preservation,64,34,30
Elcigala,ragnaros,1423,evoker,preservation,210,103,107
Spyrodadrago,malganis,1423,evoker,preservation,113,50,63
Nyzara,emerald-dream,1419,evoker,preservation,36,16,20
Xurota,proudmoore,1418,evoker,preservation,80,34,46
Xerroh,area-52,1417,evoker,preservation,71,38,33
Kephii,eonar,1415,evoker,preservation,42,22,20
Vyndormu,moon-guard,1410,evoker,preservation,46,22,24
Zka,nemesis,1408,evoker,preservation,43,21,22
Meiron,azralon,1407,evoker,preservation,66,33,33
Kigglypuff,illidan,1406,evoker,preservation,36,15,21
Cyntheticdr,malganis,1404,evoker,preservation,54,30,24
Roogye,illidan,1403,evoker,preservation,96,49,47
Dylôn,tichondrius,1398,evoker,preservation,58,27,31
Kikokosta,tichondrius,1389,evoker,preservation,106,57,49
Jmir,tichondrius,1389,evoker,preservation,59,24,35
Miliolievo,azralon,1385,evoker,preservation,235,115,120
Otsira,frostmourne,1383,evoker,preservation,48,32,16
Masquemeto,illidan,1382,evoker,preservation,43,21,22
Mythsvoker,barthilas,1377,evoker,preservation,44,25,19
Tazarke,dawnbringer,1375,evoker,preservation,60,35,25
Fuoco,kiljaeden,1374,evoker,preservation,50,28,22
Healmeta,sargeras,1369,evoker,preservation,308,154,154
Pootylizard,daggerspine,1367,evoker,preservation,44,16,28
Friedwings,wyrmrest-accord,1359,evoker,preservation,27,16,11
Giratina,area-52,1357,evoker,preservation,72,37,35
Thepplschamp,bloodhoof,1354,evoker,preservation,48,23,25
Lifewing,bleeding-hollow,1352,evoker,preservation,67,25,42
Darthjarjar,bloodscalp,1351,evoker,preservation,170,84,86
Bomber,frostwolf,1351,evoker,preservation,34,16,18
Quesodillas,stormreaver,1350,evoker,preservation,48,18,30
Sía,drakkari,1349,evoker,preservation,48,28,20
Cronós,tichondrius,1347,evoker,preservation,60,26,34
Neffiie,dalaran,1345,evoker,preservation,96,45,51
Misico,illidan,1343,evoker,preservation,48,30,18
Kîñggïgàçhäð,stormrage,1343,evoker,preservation,24,14,10
Feijiwang,aegwynn,1342,evoker,preservation,69,41,28
Patzdormu,area-52,1342,evoker,preservation,30,14,16
Dracadukez,illidan,1342,evoker,preservation,42,14,28
Voithyr,moon-guard,1340,evoker,preservation,183,84,99
Primshin,illidan,1339,evoker,preservation,69,34,35
Gotbreath,dalaran,1338,evoker,preservation,57,32,25
Enalen,azjolnerub,1338,evoker,preservation,62,29,33
Actïoncat,emerald-dream,1338,evoker,preservation,69,26,43
Paladinex,tichondrius,1337,evoker,preservation,35,23,12
Moralies,area-52,1336,evoker,preservation,30,14,16
Naykir,khazgoroth,1335,evoker,preservation,24,16,8
Sanninv,barthilas,1334,evoker,preservation,30,14,16
Forsakentime,sargeras,1333,evoker,preservation,60,32,28
Chunkè,moon-guard,1331,evoker,preservation,63,26,37
Kalsit,emerald-dream,1330,evoker,preservation,58,26,32
Gumbåll,bleeding-hollow,1330,evoker,preservation,70,31,39
Growthyy,malganis,1328,evoker,preservation,23,16,7
Mäverick,kelthuzad,1327,evoker,preservation,35,23,12
Bigdrag,blackhand,1325,evoker,preservation,97,51,46
Linguistic,tichondrius,1325,evoker,preservation,30,14,16
Chambea,kelthuzad,1324,evoker,preservation,53,26,27
Tinine,frostmourne,1324,evoker,preservation,36,14,22
Caphe,nerzhul,1323,evoker,preservation,54,24,30
Vodkasauce,tichondrius,1321,evoker,preservation,24,14,10
Dendywings,zuljin,1321,evoker,preservation,30,14,16
Dracniel,illidan,1319,evoker,preservation,59,33,26
Verk,deathwing,1318,evoker,preservation,132,72,60
Hydrrax,dalaran,1316,evoker,preservation,178,90,88
Annum,moon-guard,1312,evoker,preservation,42,14,28
Nitalzith,area-52,1311,evoker,preservation,48,23,25
Solong,sargeras,1310,evoker,preservation,67,38,29
Jazzdragon,tichondrius,1310,evoker,preservation,51,24,27
Zippityzoom,barthilas,1306,evoker,preservation,35,21,14
Glizzurd,proudmoore,1306,evoker,preservation,273,133,140
Zindrozarath,area-52,1306,evoker,preservation,109,53,56
Dawitchvoker,illidan,1304,evoker,preservation,145,78,67
Bryagh,executus,1304,evoker,preservation,36,18,18
Kalikani,moon-guard,1303,evoker,preservation,93,41,52
Wangasaur,emerald-dream,1302,evoker,preservation,55,26,29
Aoibae,frostmourne,1300,evoker,preservation,60,27,33
Cynderrellaa,proudmoore,1299,evoker,preservation,152,73,79
Feelzz,illidan,1295,evoker,preservation,31,17,14
Radragão,azralon,1291,evoker,preservation,42,24,18
Nitalash,moon-guard,1286,evoker,preservation,29,14,15
Selfhealzer,korgath,1285,evoker,preservation,62,29,33
Xazxander,tichondrius,1284,evoker,preservation,42,20,22
Thereptile,frostmourne,1284,evoker,preservation,90,41,49
Crowqt,frostmourne,1282,evoker,preservation,78,29,49
Ultis,tichondrius,1281,evoker,preservation,257,133,124
Mëleys,ragnaros,1280,evoker,preservation,41,20,21
Dragûn,stormrage,1279,evoker,preservation,30,16,14
Shellessturt,kelthuzad,1278,evoker,preservation,27,14,13
Lickndragons,sargeras,1265,evoker,preservation,36,14,22
Xhamon,quelthalas,1264,evoker,preservation,56,29,27
Lizzardload,stormreaver,1264,evoker,preservation,76,32,44
Nêwt,darkspear,1256,evoker,preservation,154,77,77
Skailyx,zuljin,1254,evoker,preservation,30,14,16
Lilacstrasza,moon-guard,1254,evoker,preservation,71,33,38
Sylf,kiljaeden,1253,evoker,preservation,75,42,33
Brantley,stormscale,1253,evoker,preservation,86,41,45
Vgt,nemesis,1253,evoker,preservation,84,35,49
Lamentation,area-52,1252,evoker,preservation,42,23,19
Bayvoker,area-52,1252,evoker,preservation,53,28,25
Agony,emerald-dream,1252,evoker,preservation,249,121,128
Döublepenn,tichondrius,1248,evoker,preservation,63,35,28
Shudo,moon-guard,1248,evoker,preservation,71,35,36
Mikoriivoker,tichondrius,1247,evoker,preservation,30,13,17
Garboker,area-52,1246,evoker,preservation,80,34,46
Stableboy,bleeding-hollow,1244,evoker,preservation,18,13,5
Gloamdream,cenarius,1243,evoker,preservation,97,50,47
Valarakuu,illidan,1242,evoker,preservation,24,13,11
Allaston,tichondrius,1240,evoker,preservation,45,28,17
Zandragosa,dalaran,1240,evoker,preservation,24,13,11
Drakjar,nemesis,1238,evoker,preservation,30,13,17
Dkvastate,tichondrius,1236,evoker,preservation,112,56,56
Zerath,frostmane,1236,evoker,preservation,30,13,17
Lavagurl,stormscale,1235,evoker,preservation,30,13,17
Shenlong,malganis,1232,evoker,preservation,71,38,33
Astoragosa,moon-guard,1231,evoker,preservation,61,38,23
Verosria,area-52,1230,evoker,preservation,24,13,11
Evokas,tichondrius,1230,evoker,preservation,198,103,95
Onornun,magtheridon,1229,evoker,preservation,66,32,34
Kycaka,area-52,1228,evoker,preservation,46,14,32
Bendover,proudmoore,1227,evoker,preservation,24,13,11
Lilithlittle,daggerspine,1227,evoker,preservation,112,52,60
Lebronjmz,kiljaeden,1224,evoker,preservation,127,58,69
Mungwings,area-52,1221,evoker,preservation,43,22,21
Riz,blackhand,1221,evoker,preservation,71,35,36
Mãttyy,malganis,1220,evoker,preservation,36,19,17
Milfwizard,tichondrius,1219,evoker,preservation,24,13,11
Nulldd,tichondrius,1219,evoker,preservation,41,13,28
Dunkelzahn,gorgonnash,1214,evoker,preservation,30,15,15
Zmaj,jubeithos,1213,evoker,preservation,18,13,5
Greenscales,frostmourne,1213,evoker,preservation,93,37,56
Amniotic,hyjal,1212,evoker,preservation,54,31,23
Ysondrius,durotan,1212,evoker,preservation,48,26,22
Lévocatrice,hakkar,1208,evoker,preservation,46,20,26
Frozanat,kelthuzad,1205,evoker,preservation,75,34,41
Sanaz,stormreaver,1204,evoker,preservation,48,25,23
Allaker,kargath,1204,evoker,preservation,39,16,23
Doogiehowser,azshara,1202,evoker,preservation,162,78,84
Hamanv,tichondrius,1202,evoker,preservation,30,13,17
Partysnaxx,thrall,1199,evoker,preservation,72,35,37
Çhara,illidan,1198,evoker,preservation,126,65,61
Shênlong,sargeras,1193,evoker,preservation,54,22,32
Goonwing,frostmourne,1188,evoker,preservation,24,13,11
Bahamut,magtheridon,1186,evoker,preservation,60,25,35
Draconian,frostmourne,1182,evoker,preservation,34,13,21
Wyldefire,senjin,1180,evoker,preservation,48,22,26
Deralan,khaz-modan,1179,evoker,preservation,108,40,68
Slither,terenas,1178,evoker,preservation,27,13,14
Xblood,tichondrius,1172,evoker,preservation,42,25,17
Héllfire,ghostlands,1171,evoker,preservation,36,17,19
Kaguax,tichondrius,1167,evoker,preservation,84,32,52
Worldx,illidan,1166,evoker,preservation,24,13,11
Lyingdragon,tichondrius,1166,evoker,preservation,60,26,34
Mazalagon,trollbane,1165,evoker,preservation,29,15,14
Brôcôlînî,zuljin,1164,evoker,preservation,24,18,6
Dandera,stormrage,1164,evoker,preservation,88,40,48
Draginnuts,illidan,1162,evoker,preservation,53,25,28
Djdavi,azralon,1157,evoker,preservation,96,60,36
Vermitor,sargeras,1155,evoker,preservation,24,13,11
Fatsu,executus,1152,evoker,preservation,30,12,18
Mikoribreath,moknathal,1151,evoker,preservation,18,12,6
Biggestbroie,frostmourne,1151,evoker,preservation,18,12,6
Raundur,ragnaros,1150,evoker,preservation,24,12,12
Mysticenergy,tichondrius,1150,evoker,preservation,60,28,32
Emozoomer,malganis,1148,evoker,preservation,66,25,41
Alitasbbq,malganis,1147,evoker,preservation,30,12,18
Kaldobar,stormrage,1144,evoker,preservation,18,12,6
Unknowndrago,kul-tiras,1143,evoker,preservation,24,12,12
Detreshan,stormreaver,1142,evoker,preservation,104,57,47
Hakuroyime,ragnaros,1141,evoker,preservation,24,15,9
Zackxo,moon-guard,1137,evoker,preservation,29,19,10
Vermax,akama,1133,evoker,preservation,45,17,28
Buttstough,aerie-peak,1132,evoker,preservation,23,13,10
Distortion,drakthul,1130,evoker,preservation,81,43,38
Treadcinder,tichondrius,1130,evoker,preservation,30,14,16
Blay,elune,1130,evoker,preservation,36,15,21
Derkscale,stormrage,1125,evoker,preservation,24,13,11
Endroz,tichondrius,1119,evoker,preservation,24,12,12
Drathron,tichondrius,1118,evoker,preservation,28,13,15
Dragonwench,sargeras,1101,evoker,preservation,22,13,9
Geico,spinebreaker,1100,evoker,preservation,15,13,2
Ilithiphobia,ghostlands,1100,evoker,preservation,38,16,22
Wethotgarbee,tichondrius,1099,evoker,preservation,20,13,7
Thegrinchh,malganis,1097,evoker,preservation,81,39,42
Krossbones,cenarion-circle,1096,evoker,preservation,80,47,33
Dragdezenutz,bleeding-hollow,1091,evoker,preservation,41,13,28
Dragonknght,tichondrius,1085,evoker,preservation,24,14,10
Shook,baelgun,1085,evoker,preservation,50,21,29
Thendroz,aerie-peak,1084,evoker,preservation,34,19,15
Emyhr,sargeras,1084,evoker,preservation,24,13,11
Draisin,zuljin,1083,evoker,preservation,24,13,11
Tryhard,wyrmrest-accord,1083,evoker,preservation,78,33,45
Solryp,terokkar,1081,evoker,preservation,83,42,41
Setash,hyjal,1081,evoker,preservation,24,12,12
Clubmetro,boulderfist,1081,evoker,preservation,39,18,21
Lahfly,tichondrius,1079,evoker,preservation,54,33,21
Qiuhan,tichondrius,1076,evoker,preservation,48,23,25
Lilithà,kelthuzad,1075,evoker,preservation,30,20,10
Bumbledragn,moon-guard,1071,evoker,preservation,37,23,14
Maxyz,khadgar,1071,evoker,preservation,42,13,29
Balmoze,tichondrius,1070,evoker,preservation,60,31,29
Careflight,barthilas,1066,evoker,preservation,42,22,20
Draganoche,zuljin,1066,evoker,preservation,30,14,16
Daikis,proudmoore,1066,evoker,preservation,36,16,20
Aspecto,area-52,1066,evoker,preservation,34,13,21
Ashandshadow,area-52,1065,evoker,preservation,37,13,24
Balèrion,illidan,1064,evoker,preservation,24,12,12
Yozhz,ragnaros,1059,evoker,preservation,29,13,16
Versezz,tichondrius,1056,evoker,preservation,18,11,7
Binidragon,tichondrius,1055,evoker,preservation,12,11,1
Tallcanman,kelthuzad,1055,evoker,preservation,24,11,13
Ajiz,mannoroth,1053,evoker,preservation,18,11,7
Imugee,sargeras,1051,evoker,preservation,24,11,13
Mordrakhuul,chogall,1051,evoker,preservation,24,11,13
Puraimaru,sargeras,1049,evoker,preservation,30,11,19
Sacrementus,tichondrius,1049,evoker,preservation,48,14,34
Drittles,illidan,1043,evoker,preservation,62,28,34
Rubellite,azralon,1042,evoker,preservation,39,18,21
Uniqqe,tichondrius,1041,evoker,preservation,18,11,7
Amnemís,tichondrius,1040,evoker,preservation,20,12,8
Rynntynn,blood-furnace,1039,evoker,preservation,24,11,13
Charadrius,zuljin,1038,evoker,preservation,41,23,18
Myxter,tichondrius,1035,evoker,preservation,49,25,24
Carloxd,tichondrius,1035,evoker,preservation,34,12,22
Abigaile,illidan,1034,evoker,preservation,18,13,5
Blankebr,gallywix,1032,evoker,preservation,36,24,12
Droggerdrago,stormreaver,1031,evoker,preservation,18,11,7
Evoke,boulderfist,1025,evoker,preservation,28,12,16
Karmakulax,wildhammer,1024,evoker,preservation,31,12,19
Vandinus,stormrage,1023,evoker,preservation,38,17,21
Ownlyfans,silvermoon,1018,evoker,preservation,24,12,12
Adessa,lothar,1012,evoker,preservation,24,11,13
Mightywings,skywall,1011,evoker,preservation,138,70,68
Richviewrd,illidan,1007,evoker,preservation,30,15,15
Lightbeing,nazjatar,1001,evoker,preservation,42,26,16
Azuril,wyrmrest-accord,1001,evoker,preservation,84,29,55
Fibonac,frostmourne,1000,evoker,preservation,24,13,11
Brahown,altar-of-storms,998,evoker,preservation,36,11,25
Gemis,anvilmar,991,evoker,preservation,55,25,30
Hover,vashj,989,evoker,preservation,27,13,14
Items,frostmourne,987,evoker,preservation,22,11,11
Vyreth,sargeras,987,evoker,preservation,81,38,43
Echoker,destromath,986,evoker,preservation,37,17,20
Arazerazer,thrall,984,evoker,preservation,66,23,43
Gidury,tichondrius,982,evoker,preservation,84,39,45
Sïgrìd,tichondrius,979,evoker,preservation,27,19,8
Mesamune,bonechewer,969,evoker,preservation,61,23,38
Sophdrac,illidan,966,evoker,preservation,24,12,12
Milkspurt,tichondrius,962,evoker,preservation,52,23,29
Syraxiez,sargeras,960,evoker,preservation,18,10,8
Rubyzz,illidan,960,evoker,preservation,18,10,8
Uncleìroh,tichondrius,960,evoker,preservation,24,10,14
Jnitoscaly,tichondrius,959,evoker,preservation,18,10,8
Cripcuhz,tichondrius,959,evoker,preservation,48,21,27
Joc,khazgoroth,959,evoker,preservation,24,10,14
Truffleßutta,tichondrius,958,evoker,preservation,18,10,8
Puffthemagic,lightnings-blade,958,evoker,preservation,18,10,8
Yaaj,black-dragonflight,958,evoker,preservation,20,10,10
Dragonsand,area-52,958,evoker,preservation,62,30,32
Drakthussey,illidan,957,evoker,preservation,18,10,8
Dokthyr,lightbringer,956,evoker,preservation,12,10,2
Goonguy,gnomeregan,955,evoker,preservation,12,10,2
Holdherhorn,area-52,955,evoker,preservation,18,10,8
Dragy,bonechewer,954,evoker,preservation,24,10,14
Hoverharder,stormrage,953,evoker,preservation,18,10,8
Soziin,skullcrusher,953,evoker,preservation,18,10,8
Proevoker,illidan,951,evoker,preservation,18,10,8
Barneydragon,stormrage,949,evoker,preservation,18,10,8
Wheyvern,malganis,949,evoker,preservation,57,19,38
Ayavi,illidan,942,evoker,preservation,18,10,8
Zitasanazen,tichondrius,935,evoker,preservation,134,63,71
Saintetoile,tichondrius,934,evoker,preservation,24,13,11
Faethana,thrall,929,evoker,preservation,23,11,12
Raptormoto,lothar,926,evoker,preservation,26,11,15
Dragonbro,spirestone,923,evoker,preservation,18,10,8
Justbreathe,sargeras,911,evoker,preservation,17,10,7
Dmuzh,drakkari,904,evoker,preservation,198,99,99
Badvoker,area-52,902,evoker,preservation,71,26,45
Cransvoker,illidan,902,evoker,preservation,30,10,20
Kerlaan,illidan,895,evoker,preservation,18,10,8
Eldenkingy,sargeras,892,evoker,preservation,34,10,24
Kivoke,proudmoore,888,evoker,preservation,24,10,14
Mugenyan,ragnaros,879,evoker,preservation,41,21,20
Draczod,proudmoore,878,evoker,preservation,41,10,31
Dragginhealz,stormrage,876,evoker,preservation,36,17,19
Ayoitspav,malganis,872,evoker,preservation,19,10,9
Moxa,doomhammer,868,evoker,preservation,59,30,29
Willowflight,illidan,867,evoker,preservation,50,23,27
Mikorivoker,illidan,864,evoker,preservation,12,9,3
Calvoker,moon-guard,864,evoker,preservation,18,9,9
Wonderk,frostmourne,863,evoker,preservation,18,9,9
Tonymanitoba,whisperwind,863,evoker,preservation,18,9,9
Nuubvoker,stormrage,863,evoker,preservation,18,9,9
Sandragon,ragnaros,863,evoker,preservation,27,10,17
Velocivraull,malganis,862,evoker,preservation,12,9,3
Dragocser,drakkari,862,evoker,preservation,24,9,15
Kakanjutan,azralon,861,evoker,preservation,16,10,6
Macdrag,malganis,861,evoker,preservation,18,9,9
Jesstrasza,quelthalas,861,evoker,preservation,42,18,24
Tigdragon,proudmoore,861,evoker,preservation,24,9,15
Gravityblast,tichondrius,861,evoker,preservation,24,9,15
Binxyboy,garrosh,860,evoker,preservation,16,10,6
Arûmat,tichondrius,859,evoker,preservation,30,9,21
Kaeszandrus,azralon,855,evoker,preservation,18,9,9
Bjason,tichondrius,855,evoker,preservation,18,9,9
Bizzstrasza,tichondrius,851,evoker,preservation,46,20,26
Moiraine,kargath,850,evoker,preservation,24,9,15
Hentaizilla,kiljaeden,850,evoker,preservation,55,19,36
Lechonlechon,tichondrius,847,evoker,preservation,12,9,3
Orïon,azralon,845,evoker,preservation,24,9,15
Nazzadormu,tichondrius,830,evoker,preservation,17,9,8
Venlormi,moon-guard,828,evoker,preservation,36,12,24
Dragndeez,garrosh,824,evoker,preservation,40,9,31
Sandrozeria,wyrmrest-accord,822,evoker,preservation,14,10,4
Azuragon,illidan,822,evoker,preservation,48,15,33
Drakthuul,icecrown,819,evoker,preservation,24,11,13
Saintpablox,illidan,810,evoker,preservation,34,10,24
Bandel,tichondrius,805,evoker,preservation,16,11,5
Shenrøn,altar-of-storms,805,evoker,preservation,26,13,13
Darkspyro,area-52,799,evoker,preservation,11,9,2
Drackaras,stormrage,790,evoker,preservation,18,9,9
Æsshayád,area-52,768,evoker,preservation,12,8,4
Ninereeds,malganis,768,evoker,preservation,12,8,4
Kaddyragon,mannoroth,768,evoker,preservation,12,8,4
Hasstle,tichondrius,768,evoker,preservation,12,8,4
Rvrbzv,stormrage,768,evoker,preservation,12,8,4
Airschlong,tichondrius,768,evoker,preservation,18,8,10
Chañïng,frostmourne,768,evoker,preservation,18,8,10
Sheepdoll,icecrown,768,evoker,preservation,18,8,10
Messyvok,illidan,768,evoker,preservation,18,8,10
Walloper,malganis,767,evoker,preservation,12,8,4
Cadwaladr,frostmourne,767,evoker,preservation,12,8,4
Djvoker,zuljin,767,evoker,preservation,12,8,4
Slèv,frostmourne,767,evoker,preservation,18,8,10
Innervoker,tichondrius,767,evoker,preservation,18,8,10
Vokr,area-52,767,evoker,preservation,18,8,10
Nfts,darkspear,767,evoker,preservation,24,8,16
Azarke,rivendare,767,evoker,preservation,24,8,16
Chue,quelthalas,766,evoker,preservation,18,8,10
Drgndeeznüts,tichondrius,766,evoker,preservation,28,10,18
Skithyrix,bleeding-hollow,765,evoker,preservation,12,8,4
Kathendrov,sargeras,764,evoker,preservation,12,8,4
Everglow,the-forgotten-coast,763,evoker,preservation,12,8,4
Spitdafire,tichondrius,763,evoker,preservation,18,8,10
Nutsdragon,tichondrius,763,evoker,preservation,18,8,10
Wrathiøn,sargeras,763,evoker,preservation,24,8,16
Rorie,farstriders,762,evoker,preservation,12,8,4
Matsutake,kelthuzad,762,evoker,preservation,18,8,10
Draehgor,hyjal,758,evoker,preservation,18,8,10
Crumbflaps,kelthuzad,758,evoker,preservation,24,8,16
Lervish,durotan,755,evoker,preservation,12,8,4
Criteria,burning-legion,748,evoker,preservation,18,8,10
Durtyvoker,illidan,735,evoker,preservation,22,8,14
Butta,darkspear,734,evoker,preservation,17,8,9
Enuzan,dalaran,734,evoker,preservation,32,8,24
Whinks,zangarmarsh,732,evoker,preservation,17,8,9
Polland,area-52,731,evoker,preservation,17,8,9
Icthelestron,black-dragonflight,729,evoker,preservation,14,9,5
Geicovoker,tichondrius,714,evoker,preservation,28,9,19
Shardsnorta,chogall,708,evoker,preservation,17,8,9
Velaryonhero,arthas,700,evoker,preservation,20,8,12
Wilbog,moon-guard,700,evoker,preservation,44,10,34
Letharrian,sargeras,698,evoker,preservation,12,10,2
Iantern,dalaran,672,evoker,preservation,12,7,5
Vrondiss,trollbane,672,evoker,preservation,12,7,5
Goursaud,malganis,672,evoker,preservation,12,7,5
Prettycooll,dathremar,672,evoker,preservation,12,7,5
Cycircle,tichondrius,672,evoker,preservation,12,7,5
Skrimbles,tichondrius,672,evoker,preservation,12,7,5
Vroomby,area-52,672,evoker,preservation,12,7,5
Beatxqt,area-52,672,evoker,preservation,12,7,5
Whelp,shadow-council,672,evoker,preservation,12,7,5
Briggsybear,malganis,672,evoker,preservation,18,7,11
Iamg,stormscale,672,evoker,preservation,18,7,11
Draikia,zuljin,672,evoker,preservation,18,7,11
Orncen,emerald-dream,672,evoker,preservation,18,7,11
Darchomp,illidan,672,evoker,preservation,18,7,11
Kwebab,tichondrius,672,evoker,preservation,18,7,11
Hamine,tichondrius,672,evoker,preservation,18,7,11
Gaslightqt,tichondrius,672,evoker,preservation,19,7,12
Spyrotime,tichondrius,672,evoker,preservation,21,7,14
Advancedonly,tichondrius,672,evoker,preservation,24,7,17
Spicypnuts,zuljin,671,evoker,preservation,12,7,5
Flapthewap,illidan,671,evoker,preservation,12,7,5
Reskue,burning-legion,671,evoker,preservation,12,7,5
Kymoxien,sargeras,671,evoker,preservation,12,7,5
Matchamjölk,tichondrius,671,evoker,preservation,12,7,5
Boomlvx,frostmourne,671,evoker,preservation,12,7,5
Forlornomens,area-52,671,evoker,preservation,12,7,5
Vertorgon,proudmoore,671,evoker,preservation,12,7,5
Longxx,dalaran,671,evoker,preservation,18,7,11
Bookkoo,burning-legion,671,evoker,preservation,24,7,17
Rayvoker,elune,670,evoker,preservation,12,7,5
Mad,aerie-peak,670,evoker,preservation,19,9,10
Woozul,malganis,670,evoker,preservation,30,7,23
Deezyroller,sargeras,669,evoker,preservation,12,7,5
Retcondragon,sargeras,669,evoker,preservation,18,7,11
Dragonballer,trollbane,669,evoker,preservation,18,7,11
Rilex,kelthuzad,666,evoker,preservation,12,7,5
Azulnova,tichondrius,665,evoker,preservation,18,7,11
Pypokay,nemesis,665,evoker,preservation,18,7,11
Acidbreath,tichondrius,661,evoker,preservation,18,7,11
Itsac,daggerspine,656,evoker,preservation,12,7,5
Yiptondabs,emerald-dream,650,evoker,preservation,29,7,22
Thenasath,sargeras,640,evoker,preservation,17,7,10
Mokkdala,blackrock,637,evoker,preservation,17,7,10
Elderdragon,nerzhul,629,evoker,preservation,16,8,8
Kixxely,sargeras,623,evoker,preservation,12,8,4
Terpsy,area-52,620,evoker,preservation,11,7,4
Kilawatt,barthilas,620,evoker,preservation,11,7,4
Tsuruda,illidan,618,evoker,preservation,21,8,13
Gdragons,tichondrius,607,evoker,preservation,11,7,4
Saxthyr,stormreaver,592,evoker,preservation,13,7,6
Ambadragon,frostmourne,591,evoker,preservation,11,7,4
Hwansu,tichondrius,576,evoker,preservation,6,6,0
Cheesedragon,tichondrius,576,evoker,preservation,6,6,0
Tatsurai,tichondrius,576,evoker,preservation,10,7,3
Whitesnow,korgath,576,evoker,preservation,12,6,6
Oldgeorge,tichondrius,576,evoker,preservation,12,6,6
Dgevoker,tichondrius,576,evoker,preservation,12,6,6
Wtfhappen,tichondrius,576,evoker,preservation,12,6,6
Ozvoker,area-52,576,evoker,preservation,12,6,6
Theyevokbuda,kelthuzad,576,evoker,preservation,12,6,6
Talzindera,sargeras,576,evoker,preservation,12,6,6
Teëst,malganis,576,evoker,preservation,12,6,6
Diregon,kelthuzad,576,evoker,preservation,12,6,6
Flybro,malganis,576,evoker,preservation,12,6,6
Daylenx,thrall,576,evoker,preservation,12,6,6
Xiaolongmei,frostmourne,576,evoker,preservation,12,6,6
Ccguzzlerx,tichondrius,576,evoker,preservation,12,6,6
Thegoone,bleeding-hollow,576,evoker,preservation,12,6,6
Localfemboy,area-52,576,evoker,preservation,12,6,6
Bookwyrm,khadgar,576,evoker,preservation,12,6,6
Datinysmaug,stormrage,576,evoker,preservation,12,6,6
Teddydarg,tichondrius,576,evoker,preservation,14,6,8
Dragonk,dragonblight,576,evoker,preservation,18,6,12
Murphymonsta,stormscale,576,evoker,preservation,18,6,12
Toodllesz,stormrage,575,evoker,preservation,6,6,0
Tokeandvoke,haomarush,575,evoker,preservation,12,6,6
Magnito,thorium-brotherhood,575,evoker,preservation,12,6,6
Valadrakth,tichondrius,575,evoker,preservation,12,6,6
Shinryuu,warsong,575,evoker,preservation,12,6,6
Madzul,emerald-dream,575,evoker,preservation,12,6,6
Flameschosen,malganis,575,evoker,preservation,12,6,6
Bhfflove,area-52,575,evoker,preservation,12,6,6
Naùghtygames,area-52,575,evoker,preservation,18,6,12
Kyloflight,thrall,575,evoker,preservation,24,6,18
Toothless,garithos,574,evoker,preservation,6,6,0
Amun,frostwolf,574,evoker,preservation,12,6,6
Fránky,ragnaros,574,evoker,preservation,12,6,6
Cinderazerat,moon-guard,574,evoker,preservation,18,6,12
Azalana,thrall,574,evoker,preservation,24,6,18
Rzdrag,nemesis,574,evoker,preservation,36,6,30
Moraise,bonechewer,573,evoker,preservation,12,6,6
Rhaeynes,moon-guard,568,evoker,preservation,12,6,6
Kratheu,azralon,559,evoker,preservation,17,6,11
Dragussy,illidan,548,evoker,preservation,28,10,18
Spliffdragon,sargeras,528,evoker,preservation,17,6,11
Imperialist,proudmoore,522,evoker,preservation,29,7,22
Shenlòng,drakkari,521,evoker,preservation,15,7,8
Akavoker,sargeras,521,evoker,preservation,20,7,13
Supernovax,illidan,512,evoker,preservation,16,6,10
Imaginedrgn,tichondrius,511,evoker,preservation,11,6,5
Errier,tichondrius,511,evoker,preservation,14,6,8
Nwo,shattered-hand,494,evoker,preservation,11,6,5
Brindletail,proudmoore,494,evoker,preservation,19,6,13
Finnahorns,sargeras,480,evoker,preservation,6,5,1
Evvookkeerr,tichondrius,480,evoker,preservation,6,5,1
Chinadragon,balnazzar,480,evoker,preservation,6,5,1
Whelpling,cenarion-circle,480,evoker,preservation,6,5,1
Draggin,barthilas,480,evoker,preservation,12,5,7
Shazdrag,stormrage,480,evoker,preservation,12,5,7
Evizzar,zuljin,480,evoker,preservation,12,5,7
Neewhad,malganis,480,evoker,preservation,12,5,7
Cutewing,tichondrius,480,evoker,preservation,12,5,7
Hageiz,tichondrius,480,evoker,preservation,12,5,7
Ryloun,sargeras,480,evoker,preservation,12,5,7
Cirroaltos,aerie-peak,480,evoker,preservation,12,5,7
Chronocolter,thunderhorn,480,evoker,preservation,12,5,7
Draktharl,tichondrius,480,evoker,preservation,12,5,7
Roastdrake,tichondrius,480,evoker,preservation,12,5,7
Oldmandrake,mannoroth,480,evoker,preservation,12,5,7
Imwoker,illidan,480,evoker,preservation,12,5,7
Salusx,proudmoore,480,evoker,preservation,12,5,7
Dracndanuts,draenor,480,evoker,preservation,14,5,9
Seeyn,tichondrius,480,evoker,preservation,18,5,13
Cruv,boulderfist,480,evoker,preservation,18,5,13
Yaaty,tichondrius,480,evoker,preservation,18,5,13
Bronyflexy,sargeras,480,evoker,preservation,24,5,19
Mcdonovan,stormrage,480,evoker,preservation,24,5,19
Prevoker,kirin-tor,479,evoker,preservation,6,5,1
Bvo,stormrage,479,evoker,preservation,6,5,1
Dracdeez,dreadmaul,479,evoker,preservation,12,5,7
Drizzydrag,jubeithos,479,evoker,preservation,12,5,7
Álln,sargeras,479,evoker,preservation,12,5,7
Kratostrasz,moon-guard,479,evoker,preservation,12,5,7
Cootietooter,icecrown,479,evoker,preservation,12,5,7
Drektar,the-scryers,479,evoker,preservation,12,5,7
Selden,boulderfist,479,evoker,preservation,12,5,7
Rhaènyra,sargeras,479,evoker,preservation,12,5,7
Lickyertits,tichondrius,479,evoker,preservation,12,5,7
Cindermint,mugthol,479,evoker,preservation,14,5,9
Bitkoinz,tichondrius,479,evoker,preservation,18,5,13
Dragown,sargeras,478,evoker,preservation,12,5,7
Scaryðragon,akama,477,evoker,preservation,12,5,7
Dracoly,medivh,476,evoker,preservation,12,5,7
Interracial,stormscale,475,evoker,preservation,10,6,4
Lisatallie,moon-guard,475,evoker,preservation,12,5,7
Falsedaze,sargeras,475,evoker,preservation,12,5,7
Trillis,eldrethalas,474,evoker,preservation,12,5,7
Kaelestian,ragnaros,473,evoker,preservation,12,5,7
Amoraz,tichondrius,460,evoker,preservation,23,5,18
Jcii,tichondrius,447,evoker,preservation,11,5,6
Bootymágic,tichondrius,431,evoker,preservation,9,6,3
Gaserick,quelthalas,426,evoker,preservation,17,6,11
Soukizilla,sargeras,416,evoker,preservation,10,5,5
Monzydrake,emerald-dream,408,evoker,preservation,20,5,15
Taegon,area-52,384,evoker,preservation,6,4,2
Syneestra,nemesis,384,evoker,preservation,6,4,2
Ygnizem,ysera,384,evoker,preservation,6,4,2
Dreamfuego,tichondrius,384,evoker,preservation,6,4,2
Fluffelss,moon-guard,384,evoker,preservation,6,4,2
Azurgos,proudmoore,384,evoker,preservation,6,4,2
Venitsu,malganis,384,evoker,preservation,6,4,2
Tygor,arthas,384,evoker,preservation,6,4,2
Atraxian,tichondrius,384,evoker,preservation,6,4,2
Dragoontekka,tichondrius,384,evoker,preservation,6,4,2
Ancalagðn,quelthalas,384,evoker,preservation,6,4,2
Abevv,bonechewer,384,evoker,preservation,6,4,2
Spaceox,tichondrius,384,evoker,preservation,6,4,2
Babylons,area-52,384,evoker,preservation,6,4,2
Linabeauty,ragnaros,384,evoker,preservation,6,4,2
Exrtj,stormrage,384,evoker,preservation,6,4,2
Docevoker,tichondrius,384,evoker,preservation,6,4,2
Mtndewboy,illidan,384,evoker,preservation,6,4,2
Murloc,shadowsong,384,evoker,preservation,6,4,2
Darksmoke,spirestone,384,evoker,preservation,6,4,2
Treysongz,area-52,384,evoker,preservation,6,4,2
Jëthrø,illidan,384,evoker,preservation,6,4,2
Gavstarz,frostmourne,384,evoker,preservation,6,4,2
Baradad,frostmourne,384,evoker,preservation,6,4,2
Bassblasterr,dalaran,384,evoker,preservation,6,4,2
Tëssarion,quelthalas,384,evoker,preservation,9,5,4
Zaedor,stormrage,384,evoker,preservation,10,5,5
Longaot,tichondrius,384,evoker,preservation,10,4,6
Olindoe,tichondrius,384,evoker,preservation,12,4,8
Xaxas,boulderfist,384,evoker,preservation,12,4,8
Galrend,firetree,384,evoker,preservation,12,4,8
Oldui,frostmourne,384,evoker,preservation,12,4,8
Yujirohanma,frostmourne,384,evoker,preservation,12,4,8
Mignificent,sargeras,384,evoker,preservation,12,4,8
Crumbsock,thrall,384,evoker,preservation,12,4,8
Satratren,moon-guard,384,evoker,preservation,12,4,8
Shoestrings,tichondrius,384,evoker,preservation,12,4,8
Soyum,sargeras,384,evoker,preservation,12,4,8
Donresantis,tichondrius,384,evoker,preservation,12,4,8
Raphdragon,stormrage,384,evoker,preservation,12,4,8
Williamjong,tichondrius,384,evoker,preservation,12,4,8
Pensini,illidan,384,evoker,preservation,12,4,8
Bryágh,wyrmrest-accord,384,evoker,preservation,12,4,8
Upsdriver,dentarg,384,evoker,preservation,18,4,14
Aceu,bloodhoof,383,evoker,preservation,6,4,2
Shintrax,ragnaros,383,evoker,preservation,10,4,6
Quesovoke,eldrethalas,383,evoker,preservation,12,4,8
Dombi,moon-guard,383,evoker,preservation,12,4,8
Xdragon,lightbringer,383,evoker,preservation,12,4,8
Tihkal,spinebreaker,383,evoker,preservation,12,4,8
Flymuch,illidan,383,evoker,preservation,12,4,8
Bigtoots,illidan,382,evoker,preservation,12,4,8
Danatreseth,moon-guard,380,evoker,preservation,12,4,8
Nyxstrasza,moknathal,366,evoker,preservation,11,4,7
Dreamvisage,silvermoon,351,evoker,preservation,8,5,3
Annazara,stormrage,336,evoker,preservation,9,4,5
Zathasar,tichondrius,333,evoker,preservation,28,4,24
Corlys,thunderhorn,330,evoker,preservation,17,5,12
Tealik,frostmourne,320,evoker,preservation,10,4,6
Jolynne,illidan,320,evoker,preservation,14,4,10
Lantur,perenolde,319,evoker,preservation,16,4,12
Polyrhythmic,ysera,304,evoker,preservation,7,4,3
Vaeghar,anvilmar,288,evoker,preservation,6,3,3
Gvoker,nemesis,288,evoker,preservation,6,3,3
Bigtitsdrag,illidan,288,evoker,preservation,6,3,3
Æg,zuljin,288,evoker,preservation,6,3,3
Jakburnon,stormrage,288,evoker,preservation,6,3,3
Vokefuu,illidan,288,evoker,preservation,6,3,3
Dragonblazer,illidan,288,evoker,preservation,6,3,3
Thendetra,mannoroth,288,evoker,preservation,6,3,3
Dimpulse,zuljin,288,evoker,preservation,6,3,3
Icallthecops,tichondrius,288,evoker,preservation,6,3,3
Ruffee,frostmourne,288,evoker,preservation,6,3,3
Cônflicted,emerald-dream,288,evoker,preservation,6,3,3
Crsevencr,tichondrius,288,evoker,preservation,6,3,3
Chawp,tichondrius,288,evoker,preservation,6,3,3
Heidibibe,tichondrius,288,evoker,preservation,6,3,3
Lilrandal,emerald-dream,288,evoker,preservation,6,3,3
Swagdriver,moon-guard,288,evoker,preservation,6,3,3
Dragonsama,area-52,288,evoker,preservation,6,3,3
Paradïsso,tichondrius,288,evoker,preservation,6,3,3
Toastsevoker,tichondrius,288,evoker,preservation,6,3,3
Evoketage,malganis,288,evoker,preservation,6,3,3
Setren,antonidas,288,evoker,preservation,6,3,3
Halcyonxz,tichondrius,288,evoker,preservation,6,3,3
Jokko,moon-guard,288,evoker,preservation,6,3,3
Flexlong,tichondrius,288,evoker,preservation,6,3,3
Kreutzhauser,tichondrius,288,evoker,preservation,6,3,3
Knowragretz,tichondrius,288,evoker,preservation,6,3,3
Ðçßñÿåæéîùøð,tichondrius,288,evoker,preservation,6,3,3
Rangä,caelestrasz,288,evoker,preservation,6,3,3
Golden,area-52,288,evoker,preservation,6,3,3
Dracoon,madoran,288,evoker,preservation,6,3,3
Hlf,tichondrius,288,evoker,preservation,6,3,3
Visserion,sargeras,288,evoker,preservation,6,3,3
Draseew,drakkari,288,evoker,preservation,6,3,3
Vygrax,nerzhul,288,evoker,preservation,6,3,3
Jamörant,tichondrius,288,evoker,preservation,6,3,3
Drakistraz,draenor,288,evoker,preservation,6,3,3
Dragonleaves,sargeras,288,evoker,preservation,6,3,3
Flyingmooie,frostmourne,288,evoker,preservation,6,3,3
Garrgle,sargeras,288,evoker,preservation,6,3,3
Dracritzzx,ragnaros,288,evoker,preservation,6,3,3
Bad,nerzhul,288,evoker,preservation,6,3,3
Meepslol,kiljaeden,288,evoker,preservation,6,3,3
Redhorn,frostmourne,288,evoker,preservation,6,3,3
Dansauce,sargeras,288,evoker,preservation,6,3,3
Raxdragon,sargeras,288,evoker,preservation,6,3,3
Jumpmaster,black-dragonflight,288,evoker,preservation,12,3,9
Vxfire,sargeras,288,evoker,preservation,12,3,9
Jammstraza,skywall,288,evoker,preservation,12,3,9
Simmnyxia,area-52,288,evoker,preservation,12,3,9
Dwacawys,zuljin,288,evoker,preservation,12,3,9
Explosives,blades-edge,288,evoker,preservation,12,3,9
Snáckbóx,alexstrasza,288,evoker,preservation,12,3,9
Zumanitÿ,zangarmarsh,288,evoker,preservation,12,3,9
Hel,stormrage,288,evoker,preservation,12,3,9
Discussion,area-52,288,evoker,preservation,12,3,9
Drakkar,elune,288,evoker,preservation,12,3,9
Ahahaa,frostmourne,288,evoker,preservation,12,3,9
Dragonbabu,area-52,288,evoker,preservation,12,3,9
Galfiore,malganis,288,evoker,preservation,12,3,9
Stormdagger,proudmoore,288,evoker,preservation,12,3,9
Teldormu,drenden,288,evoker,preservation,12,3,9
Fugginuhh,proudmoore,288,evoker,preservation,12,3,9
Reflexd,malganis,288,evoker,preservation,12,3,9
Cøømbuya,sargeras,288,evoker,preservation,12,3,9
Mouthgorawr,tichondrius,288,evoker,preservation,13,3,10
Yop,proudmoore,288,evoker,preservation,18,3,15
Rogir,zuljin,288,evoker,preservation,18,3,15
Wapowthion,blades-edge,288,evoker,preservation,18,3,15
Killerdragon,darkspear,287,evoker,preservation,6,3,3
Supereragon,area-52,287,evoker,preservation,6,3,3
Saphfire,burning-legion,287,evoker,preservation,6,3,3
Retroo,dark-iron,287,evoker,preservation,6,3,3
Dragoreo,illidan,287,evoker,preservation,12,3,9
Tazen,bleeding-hollow,287,evoker,preservation,12,3,9
Chenrong,sargeras,287,evoker,preservation,12,3,9
Toothlesz,draka,287,evoker,preservation,18,3,15
Kalistro,quelthalas,286,evoker,preservation,6,3,3
Straightman,stormrage,286,evoker,preservation,12,3,9
Arazarion,mugthol,285,evoker,preservation,12,3,9
Drakonyx,mugthol,285,evoker,preservation,12,3,9
Ragendragon,hellscream,285,evoker,preservation,12,3,9
Uskrait,tichondrius,255,evoker,preservation,14,4,10
Stíckyj,tichondrius,255,evoker,preservation,11,3,8
Decyrion,bleeding-hollow,255,evoker,preservation,17,3,14
Tailia,sargeras,239,evoker,preservation,11,3,8
Rápturé,tichondrius,234,evoker,preservation,10,6,4
Daddyrp,tichondrius,234,evoker,preservation,15,5,10
Tugmapvpean,kelthuzad,208,evoker,preservation,7,3,4
Boseijwho,emerald-dream,208,evoker,preservation,7,3,4
Carrnedge,area-52,192,evoker,preservation,6,2,4
Aetherz,illidan,192,evoker,preservation,6,2,4
Saviorkai,barthilas,192,evoker,preservation,6,2,4
Dscim,zuljin,192,evoker,preservation,6,2,4
Ignicion,quelthalas,192,evoker,preservation,6,2,4
Nil,malganis,192,evoker,preservation,6,2,4
Sekidrac,ragnaros,192,evoker,preservation,6,2,4
Surasi,frostmourne,192,evoker,preservation,6,2,4
Racovoker,zuljin,192,evoker,preservation,6,2,4
Conorvokes,tichondrius,192,evoker,preservation,6,2,4
Hochelaga,arthas,192,evoker,preservation,6,2,4
Syfen,burning-blade,192,evoker,preservation,6,2,4
Drakhaz,azralon,192,evoker,preservation,6,2,4
Scyyterr,azralon,192,evoker,preservation,6,2,4
Lëåf,area-52,192,evoker,preservation,6,2,4
Flappyboy,bleeding-hollow,192,evoker,preservation,6,2,4
Alexevoker,tichondrius,192,evoker,preservation,6,2,4
Koopa,malygos,192,evoker,preservation,6,2,4
Nunez,frostmourne,192,evoker,preservation,6,2,4
Invdkill,azralon,192,evoker,preservation,6,2,4
Lexazule,bleeding-hollow,192,evoker,preservation,6,2,4
Tagritash,kelthuzad,192,evoker,preservation,6,2,4
Inkdsy,detheroc,192,evoker,preservation,6,2,4
Dragonpel,azralon,192,evoker,preservation,6,2,4
Xerithious,bleeding-hollow,192,evoker,preservation,6,2,4
Dwagonwage,zuljin,192,evoker,preservation,6,2,4
Froky,stormrage,192,evoker,preservation,6,2,4
Slaymedaddy,proudmoore,192,evoker,preservation,6,2,4
Drugdoer,illidan,192,evoker,preservation,6,2,4
Wse,illidan,192,evoker,preservation,6,2,4
Daemon,terokkar,192,evoker,preservation,6,2,4
Preserveluke,moon-guard,192,evoker,preservation,6,2,4
Kalrid,sargeras,192,evoker,preservation,6,2,4
Smurgma,frostmane,192,evoker,preservation,6,2,4
Stickvoker,sargeras,192,evoker,preservation,6,2,4
Ndr,proudmoore,192,evoker,preservation,6,2,4
Nite,lothar,192,evoker,preservation,6,2,4
Sketchybum,tichondrius,192,evoker,preservation,6,2,4
Olesmokey,tichondrius,192,evoker,preservation,12,2,10
Draghyon,tichondrius,192,evoker,preservation,12,2,10
Prahvlord,shuhalo,192,evoker,preservation,12,2,10
Hotblower,tichondrius,192,evoker,preservation,12,2,10
Timecøp,zuljin,192,evoker,preservation,12,2,10
Luxxa,bloodhoof,192,evoker,preservation,12,2,10
Takasaki,dalaran,192,evoker,preservation,12,2,10
Djornmustman,sargeras,192,evoker,preservation,12,2,10
Ceraxxes,tichondrius,192,evoker,preservation,12,2,10
Arkaan,malganis,192,evoker,preservation,12,2,10
Tightp,malganis,192,evoker,preservation,12,2,10
Drakthyrmonk,hyjal,192,evoker,preservation,12,2,10
Lampizard,bonechewer,192,evoker,preservation,12,2,10
Draxitar,blackrock,191,evoker,preservation,6,2,4
Dracalis,thrall,191,evoker,preservation,6,2,4
Lacost,area-52,191,evoker,preservation,6,2,4
Valethal,ragnaros,191,evoker,preservation,6,2,4
Frozonic,tichondrius,191,evoker,preservation,6,2,4
Spyrð,emerald-dream,191,evoker,preservation,6,2,4
Shadowyasuke,area-52,191,evoker,preservation,12,2,10
Sodre,illidan,191,evoker,preservation,12,2,10
Evooern,frostmourne,175,evoker,preservation,11,2,9
Devokerkofwa,tichondrius,159,evoker,preservation,5,2,3
Hexavalent,tichondrius,159,evoker,preservation,5,2,3
Jetthryx,emerald-dream,159,evoker,preservation,11,2,9
Temporal,mannoroth,144,evoker,preservation,3,3,0
Dragonbush,sargeras,138,evoker,preservation,10,3,7
Shíkyo,stormrage,138,evoker,preservation,20,3,17
Lendren,sargeras,128,evoker,preservation,10,2,8
Hutterbut,malganis,96,evoker,preservation,3,2,1
Xampusaurio,ragnaros,96,evoker,preservation,6,1,5
Tasdarallar,frostmourne,96,evoker,preservation,6,1,5
Hardstuckirl,tichondrius,96,evoker,preservation,6,1,5
Simarity,thrall,96,evoker,preservation,6,1,5
Fkndragon,proudmoore,96,evoker,preservation,6,1,5
Spyroh,crushridge,96,evoker,preservation,6,1,5
Nowon,tichondrius,96,evoker,preservation,6,1,5
Rdrako,emerald-dream,96,evoker,preservation,6,1,5
Ðräco,quelthalas,96,evoker,preservation,6,1,5
Ripdumpster,bonechewer,96,evoker,preservation,6,1,5
Omars,sargeras,96,evoker,preservation,6,1,5
Trrxx,tichondrius,96,evoker,preservation,6,1,5
Vvhip,tichondrius,96,evoker,preservation,6,1,5
Myjewelshurt,stormrage,96,evoker,preservation,6,1,5
Keedrori,thrall,96,evoker,preservation,6,1,5
Caelïn,malganis,96,evoker,preservation,6,1,5
Ohmylanta,stormrage,96,evoker,preservation,6,1,5
Daraz,tichondrius,96,evoker,preservation,6,1,5
Uwuspit,tichondrius,96,evoker,preservation,6,1,5
Iamthêt,sargeras,96,evoker,preservation,6,1,5
Atreign,blackwing-lair,96,evoker,preservation,6,1,5
Boppled,tichondrius,96,evoker,preservation,6,1,5
Yoyke,tichondrius,96,evoker,preservation,6,1,5
Patrdorasz,zuljin,96,evoker,preservation,6,1,5
Freeblaze,blackhand,96,evoker,preservation,6,1,5
Vermax,spirestone,96,evoker,preservation,6,1,5
Dragondoh,frostmourne,96,evoker,preservation,6,1,5
Liltj,tichondrius,96,evoker,preservation,6,1,5
Frëëbîë,area-52,96,evoker,preservation,6,1,5
Shockragosa,chogall,96,evoker,preservation,6,1,5
Deviantart,emerald-dream,96,evoker,preservation,6,1,5
Charbothyr,gorgonnash,96,evoker,preservation,6,1,5
Gamerwords,barthilas,96,evoker,preservation,6,1,5
Mookthyr,area-52,96,evoker,preservation,6,1,5
Dracomedicus,frostmourne,96,evoker,preservation,10,1,9
Shimshine,destromath,96,evoker,preservation,12,1,11
Khorvin,proudmoore,96,evoker,preservation,12,1,11
Morkite,moon-guard,96,evoker,preservation,12,1,11
Eragon,feathermoon,96,evoker,preservation,12,1,11
Dracarus,crushridge,96,evoker,preservation,12,1,11
Bobstrasz,tichondrius,96,evoker,preservation,12,1,11
Diavai,area-52,96,evoker,preservation,12,1,11
Derath,maelstrom,96,evoker,preservation,12,1,11
Dakotakek,illidan,96,evoker,preservation,12,1,11
Tidehunter,chogall,96,evoker,preservation,12,1,11
Jsb,moon-guard,96,evoker,preservation,18,1,17
Blowmiê,area-52,79,evoker,preservation,5,1,4
Wtsgoldpst,tichondrius,31,evoker,preservation,2,1,1
Thiqc,zuluhed,9,evoker,preservation,9,3,6
Nikthevoker,tichondrius,2153,evoker,devastation,150,81,69
Whilefalse,stormrage,2125,evoker,devastation,95,48,47
Lizzimcguire,zuljin,2118,evoker,devastation,90,60,30
Shamblewing,arthas,2113,evoker,devastation,65,35,30
Ocdgamer,malganis,2107,evoker,devastation,103,51,52
Dametra,proudmoore,2100,evoker,devastation,102,59,43
Caedalade,proudmoore,2076,evoker,devastation,220,113,107
Breathalizer,sargeras,2029,evoker,devastation,90,51,39
Evokemedaddy,bleeding-hollow,2024,evoker,devastation,132,70,62
Rothvoker,tichondrius,2020,evoker,devastation,104,61,43
Somyr,area-52,2003,evoker,devastation,78,43,35
Koalaman,area-52,1972,evoker,devastation,180,96,84
Nikthevoker,area-52,1963,evoker,devastation,135,64,71
Quadude,illidan,1947,evoker,devastation,197,99,98
Wazgon,emerald-dream,1940,evoker,devastation,194,94,100
Hutaothighs,illidan,1937,evoker,devastation,124,64,60
Arzaria,stormrage,1906,evoker,devastation,158,88,70
Ethalem,thrall,1901,evoker,devastation,168,99,69
Juicyjom,staghelm,1900,evoker,devastation,60,30,30
Bigdrag,blackhand,1898,evoker,devastation,138,74,64
Ayavi,illidan,1890,evoker,devastation,96,61,35
Trogdør,illidan,1887,evoker,devastation,153,76,77
Dzrn,moon-guard,1887,evoker,devastation,114,56,58
Seldantria,dalaran,1875,evoker,devastation,71,36,35
Draxarys,area-52,1865,evoker,devastation,197,102,95
Eastwubz,norgannon,1862,evoker,devastation,90,44,46
Saryuja,thunderhorn,1860,evoker,devastation,46,31,15
Thrawn,arygos,1855,evoker,devastation,59,37,22
Bugberry,illidan,1854,evoker,devastation,96,51,45
Azazél,borean-tundra,1852,evoker,devastation,107,61,46
Royquaza,illidan,1850,evoker,devastation,60,33,27
Wheezee,emerald-dream,1850,evoker,devastation,46,25,21
Rescued,wyrmrest-accord,1848,evoker,devastation,54,31,23
Xxkimura,tichondrius,1848,evoker,devastation,174,94,80
Tatsurai,tichondrius,1845,evoker,devastation,43,24,19
Fores,tichondrius,1845,evoker,devastation,127,65,62
Eshen,ragnaros,1843,evoker,devastation,298,158,140
Plep,wyrmrest-accord,1836,evoker,devastation,51,30,21
Laneva,moon-guard,1835,evoker,devastation,128,86,42
Venarys,dalaran,1826,evoker,devastation,42,30,12
Raxdragon,sargeras,1826,evoker,devastation,36,22,14
Anachronormu,mannoroth,1826,evoker,devastation,71,40,31
Airgordan,area-52,1821,evoker,devastation,77,37,40
Komodolong,tichondrius,1819,evoker,devastation,53,26,27
Evokes,moon-guard,1818,evoker,devastation,80,41,39
Kyloflight,thrall,1817,evoker,devastation,50,33,17
Puf,magtheridon,1817,evoker,devastation,177,101,76
Drakori,azralon,1812,evoker,devastation,80,49,31
Drogu,kelthuzad,1810,evoker,devastation,30,19,11
Gojirastraza,stormrage,1810,evoker,devastation,53,32,21
Pykan,skullcrusher,1809,evoker,devastation,47,24,23
Ragedizzle,twisting-nether,1808,evoker,devastation,91,49,42
Geicovoker,tichondrius,1806,evoker,devastation,52,30,22
Tazriak,tichondrius,1803,evoker,devastation,83,52,31
Thordak,drakkari,1801,evoker,devastation,72,40,32
Fractalz,alterac-mountains,1800,evoker,devastation,169,92,77
Azradormu,zuljin,1798,evoker,devastation,103,45,58
Meltharian,frostmourne,1797,evoker,devastation,80,42,38
Srb,chogall,1783,evoker,devastation,84,47,37
Yrue,moon-guard,1779,evoker,devastation,36,19,17
Nørbert,frostmourne,1769,evoker,devastation,48,29,19
Dooklord,shuhalo,1763,evoker,devastation,54,24,30
Juicylizard,stormrage,1755,evoker,devastation,155,81,74
Oldxdrake,sargeras,1747,evoker,devastation,138,70,68
Emiriss,thrall,1744,evoker,devastation,88,45,43
Rizzanomics,zuljin,1741,evoker,devastation,64,30,34
Stickvoker,sargeras,1732,evoker,devastation,48,31,17
Rá,drenden,1728,evoker,devastation,78,34,44
Blowmiê,area-52,1727,evoker,devastation,66,38,28
Nunez,frostmourne,1713,evoker,devastation,41,22,19
Psynister,illidan,1711,evoker,devastation,108,48,60
Strepo,proudmoore,1710,evoker,devastation,48,25,23
Gwaelii,tichondrius,1708,evoker,devastation,60,36,24
Rðsè,tichondrius,1697,evoker,devastation,114,56,58
Ðeepßreath,sargeras,1692,evoker,devastation,60,32,28
Jase,gilneas,1691,evoker,devastation,74,45,29
Scaleychad,zuljin,1688,evoker,devastation,53,27,26
Krúnsh,ragnaros,1687,evoker,devastation,125,66,59
Darkwingz,icecrown,1680,evoker,devastation,44,25,19
Vhagarius,tichondrius,1680,evoker,devastation,45,21,24
Eszel,thunderlord,1679,evoker,devastation,184,98,86
Betasoldier,kelthuzad,1678,evoker,devastation,71,43,28
Catvoker,area-52,1678,evoker,devastation,114,58,56
Draxarys,tichondrius,1677,evoker,devastation,232,108,124
Shoestrings,tichondrius,1675,evoker,devastation,108,51,57
Dwagonwage,zuljin,1672,evoker,devastation,54,25,29
Theredmenace,barthilas,1671,evoker,devastation,35,23,12
Garlicbreth,stormrage,1671,evoker,devastation,76,40,36
Shalander,proudmoore,1670,evoker,devastation,126,71,55
Fizzlevoker,malganis,1670,evoker,devastation,48,23,25
Evokez,barthilas,1661,evoker,devastation,36,27,9
Izzythelizzy,tichondrius,1657,evoker,devastation,108,59,49
Arkeryte,moon-guard,1657,evoker,devastation,108,56,52
Beatdownbill,sargeras,1657,evoker,devastation,99,48,51
Balrôg,malganis,1656,evoker,devastation,63,29,34
Dovàhkin,moon-guard,1655,evoker,devastation,60,32,28
Mindme,tichondrius,1652,evoker,devastation,53,30,23
Dragonkings,tichondrius,1651,evoker,devastation,51,23,28
Wingdeadly,tichondrius,1650,evoker,devastation,66,35,31
Nazaral,mannoroth,1647,evoker,devastation,60,32,28
Deralan,khaz-modan,1645,evoker,devastation,36,20,16
Blackdragôn,stormrage,1641,evoker,devastation,43,22,21
Rengöku,skullcrusher,1637,evoker,devastation,36,20,16
Epollyon,sargeras,1633,evoker,devastation,30,19,11
Xhamon,quelthalas,1630,evoker,devastation,52,23,29
Zenithria,thrall,1627,evoker,devastation,94,49,45
Nishalethen,moon-guard,1626,evoker,devastation,29,18,11
Zona,moon-guard,1625,evoker,devastation,48,24,24
Galakrønd,illidan,1624,evoker,devastation,116,63,53
Bombs,shattered-hand,1621,evoker,devastation,132,70,62
Æthyr,anubarak,1616,evoker,devastation,30,21,9
Mayhemvoker,rexxar,1616,evoker,devastation,42,27,15
Alekoslol,area-52,1615,evoker,devastation,40,23,17
Spyrodadrago,malganis,1615,evoker,devastation,54,29,25
Burnyxia,zuljin,1613,evoker,devastation,42,22,20
Endoveire,tichondrius,1613,evoker,devastation,54,23,31
Evòker,tichondrius,1610,evoker,devastation,48,25,23
Bréáth,tichondrius,1608,evoker,devastation,48,33,15
Akajills,tichondrius,1607,evoker,devastation,124,70,54
Mushugon,wyrmrest-accord,1605,evoker,devastation,24,17,7
Eshaybruh,barthilas,1605,evoker,devastation,34,20,14
Flysokan,tichondrius,1604,evoker,devastation,48,25,23
Dubskis,area-52,1603,evoker,devastation,122,63,59
Jereico,stonemaul,1603,evoker,devastation,78,39,39
Bently,bloodhoof,1603,evoker,devastation,48,21,27
Marccuss,bleeding-hollow,1601,evoker,devastation,24,17,7
Ryuback,sargeras,1601,evoker,devastation,42,26,16
Xhaal,tichondrius,1601,evoker,devastation,168,83,85
Mfquietus,illidan,1598,evoker,devastation,48,25,23
Imugee,sargeras,1598,evoker,devastation,54,27,27
Haramcad,tichondrius,1595,evoker,devastation,159,84,75
Ackreshanaz,nagrand,1594,evoker,devastation,36,17,19
Batwig,tichondrius,1590,evoker,devastation,71,39,32
Djvoker,zuljin,1590,evoker,devastation,39,21,18
Chànge,lothar,1587,evoker,devastation,41,23,18
Lorb,icecrown,1584,evoker,devastation,153,84,69
Juooun,tichondrius,1583,evoker,devastation,71,31,40
Algonir,wyrmrest-accord,1581,evoker,devastation,30,17,13
Zeranthal,moon-guard,1580,evoker,devastation,26,17,9
Curtis,shadowmoon,1572,evoker,devastation,52,35,17
Envisioned,kelthuzad,1572,evoker,devastation,36,19,17
Aarax,tichondrius,1570,evoker,devastation,89,45,44
Ævoker,tichondrius,1569,evoker,devastation,111,54,57
Mmrglmrglmr,stormrage,1565,evoker,devastation,47,26,21
Linguistic,tichondrius,1557,evoker,devastation,48,25,23
Rinstraza,thrall,1554,evoker,devastation,120,59,61
Sintholo,sargeras,1544,evoker,devastation,98,49,49
Agheel,firetree,1543,evoker,devastation,44,23,21
Caelïn,malganis,1542,evoker,devastation,132,67,65
Jiminsgf,tichondrius,1539,evoker,devastation,54,36,18
Dragnmÿballs,blackrock,1536,evoker,devastation,34,20,14
Hydrogenbomb,sargeras,1530,evoker,devastation,86,47,39
Voithyr,moon-guard,1526,evoker,devastation,42,24,18
Hotdragon,zuljin,1526,evoker,devastation,78,43,35
Drgua,tichondrius,1522,evoker,devastation,30,16,14
Valthenax,frostmourne,1519,evoker,devastation,60,25,35
Bryágh,wyrmrest-accord,1517,evoker,devastation,147,76,71
Bumbaclot,illidan,1516,evoker,devastation,30,16,14
Olesmokey,tichondrius,1513,evoker,devastation,86,45,41
Galrend,firetree,1511,evoker,devastation,78,41,37
Polyrhythmic,ysera,1510,evoker,devastation,79,38,41
Qfyre,frostmourne,1508,evoker,devastation,51,32,19
Gôdzevoker,area-52,1507,evoker,devastation,30,16,14
Xplode,area-52,1504,evoker,devastation,176,89,87
Tinine,frostmourne,1503,evoker,devastation,60,33,27
Tezzyl,kiljaeden,1498,evoker,devastation,30,16,14
Tealetaz,area-52,1495,evoker,devastation,49,32,17
Hochenblume,proudmoore,1494,evoker,devastation,36,17,19
Ùwüdragon,tichondrius,1490,evoker,devastation,118,71,47
Zenasatral,sargeras,1483,evoker,devastation,23,16,7
Eternabeam,gilneas,1478,evoker,devastation,35,16,19
Dragonvore,moon-guard,1475,evoker,devastation,23,17,6
Elurb,illidan,1475,evoker,devastation,44,27,17
Prevocker,sargeras,1470,evoker,devastation,37,18,19
Quadarius,tichondrius,1466,evoker,devastation,105,55,50
Monkeydrake,tichondrius,1466,evoker,devastation,66,29,37
Karox,moon-guard,1464,evoker,devastation,53,23,30
Dekux,elune,1459,evoker,devastation,36,16,20
Tagzy,tichondrius,1454,evoker,devastation,36,20,16
Dragontrees,illidan,1450,evoker,devastation,36,19,17
Bellerion,proudmoore,1450,evoker,devastation,48,22,26
Amlug,illidan,1450,evoker,devastation,88,38,50
Xaeradroz,area-52,1448,evoker,devastation,48,25,23
Brounno,area-52,1446,evoker,devastation,64,43,21
Emoker,magtheridon,1446,evoker,devastation,31,18,13
Midi,boulderfist,1446,evoker,devastation,42,21,21
Lilfootmommy,emerald-dream,1446,evoker,devastation,36,16,20
Rhÿu,quelthalas,1444,evoker,devastation,29,16,13
Chinesedragn,tichondrius,1443,evoker,devastation,54,28,26
Peef,tichondrius,1439,evoker,devastation,24,15,9
Mcglizzy,stormrage,1437,evoker,devastation,54,22,32
Zalzin,agamaggan,1435,evoker,devastation,92,48,44
Devonstation,zuljin,1429,evoker,devastation,42,24,18
Malygoz,frostmourne,1426,evoker,devastation,48,20,28
Dragonbic,illidan,1423,evoker,devastation,36,16,20
Evoqz,stormrage,1422,evoker,devastation,30,18,12
Grapthar,korgath,1418,evoker,devastation,78,41,37
Trenash,illidan,1418,evoker,devastation,76,32,44
You,deathwing,1413,evoker,devastation,30,16,14
Toastragosa,cenarius,1406,evoker,devastation,149,66,83
Kjerne,stormrage,1404,evoker,devastation,30,20,10
Thechadwasgr,bleeding-hollow,1403,evoker,devastation,62,31,31
Drussyboy,illidan,1402,evoker,devastation,30,15,15
Firkrag,bleeding-hollow,1402,evoker,devastation,60,28,32
Favoredson,area-52,1400,evoker,devastation,48,25,23
Devdjinn,tichondrius,1400,evoker,devastation,132,67,65
Valkalas,moon-guard,1400,evoker,devastation,63,30,33
Børedom,burning-legion,1399,evoker,devastation,24,15,9
Zartolas,moon-guard,1399,evoker,devastation,84,36,48
Dillss,tichondrius,1397,evoker,devastation,66,31,35
Veserion,azralon,1396,evoker,devastation,90,50,40
Erling,duskwood,1396,evoker,devastation,54,28,26
Rodgoesinya,blackrock,1392,evoker,devastation,54,30,24
Blittlle,bleeding-hollow,1391,evoker,devastation,66,39,27
Frequevoker,tichondrius,1390,evoker,devastation,35,15,20
Narissian,wyrmrest-accord,1388,evoker,devastation,80,44,36
Howtew,jubeithos,1384,evoker,devastation,30,18,12
Tyrvin,kiljaeden,1382,evoker,devastation,145,72,73
Puffthemagiq,mugthol,1373,evoker,devastation,30,16,14
Dragneel,wyrmrest-accord,1367,evoker,devastation,39,17,22
Drakoris,malganis,1365,evoker,devastation,93,50,43
Dailon,stormreaver,1365,evoker,devastation,39,17,22
Bvo,stormrage,1364,evoker,devastation,77,41,36
Navaji,tichondrius,1362,evoker,devastation,55,30,25
Jurokiel,sargeras,1361,evoker,devastation,123,64,59
Evokedx,area-52,1361,evoker,devastation,42,21,21
Zeetash,illidan,1361,evoker,devastation,42,15,27
Zayllaerth,illidan,1360,evoker,devastation,82,42,40
Ezarke,madoran,1359,evoker,devastation,35,17,18
Aoxila,proudmoore,1359,evoker,devastation,129,58,71
Thendroz,moon-guard,1357,evoker,devastation,30,18,12
Grendalevo,tichondrius,1357,evoker,devastation,57,28,29
Drogan,demon-soul,1356,evoker,devastation,92,55,37
Kêristrasza,wyrmrest-accord,1352,evoker,devastation,54,27,27
Bumbledragn,moon-guard,1344,evoker,devastation,95,46,49
Sylnathaire,wyrmrest-accord,1343,evoker,devastation,84,41,43
Aydetal,eonar,1343,evoker,devastation,42,20,22
Monyz,emerald-dream,1342,evoker,devastation,34,26,8
Tekath,altar-of-storms,1340,evoker,devastation,49,23,26
Coltist,elune,1338,evoker,devastation,18,14,4
Yuukee,thrall,1338,evoker,devastation,43,23,20
Valyrik,illidan,1326,evoker,devastation,98,47,51
Serthius,darkspear,1323,evoker,devastation,18,14,4
Talanoth,skullcrusher,1323,evoker,devastation,45,25,20
Dovå,moon-guard,1322,evoker,devastation,32,16,16
Drachenatem,skywall,1319,evoker,devastation,24,14,10
Emikothyr,thrall,1319,evoker,devastation,74,41,33
Nazanazar,wyrmrest-accord,1317,evoker,devastation,73,37,36
Jabbawockeëz,drakkari,1315,evoker,devastation,94,50,44
Itwasntthis,tichondrius,1306,evoker,devastation,99,51,48
Skykeeper,quelthalas,1300,evoker,devastation,112,58,54
Setash,kiljaeden,1296,evoker,devastation,24,14,10
Zlandicaar,area-52,1296,evoker,devastation,30,14,16
Vahaerys,stormrage,1296,evoker,devastation,48,21,27
Sidrasza,norgannon,1292,evoker,devastation,43,22,21
Valentis,bleeding-hollow,1286,evoker,devastation,42,20,22
Vokeero,ysera,1284,evoker,devastation,72,36,36
Draconicus,bonechewer,1279,evoker,devastation,80,41,39
Mønster,zuljin,1279,evoker,devastation,91,43,48
Sylverion,thrall,1277,evoker,devastation,70,35,35
Zendrov,skywall,1276,evoker,devastation,30,14,16
Golden,area-52,1274,evoker,devastation,28,14,14
Wrecketz,tichondrius,1266,evoker,devastation,47,26,21
Evokjoe,tortheldrin,1262,evoker,devastation,58,29,29
Zlolykcir,malganis,1258,evoker,devastation,64,34,30
Crogosa,quelthalas,1251,evoker,devastation,36,14,22
Ezgamedeez,tichondrius,1247,evoker,devastation,24,13,11
Dracomalfoyy,caelestrasz,1246,evoker,devastation,21,14,7
Marknormand,area-52,1246,evoker,devastation,24,13,11
Shanegillis,emerald-dream,1244,evoker,devastation,18,13,5
Hmong,proudmoore,1244,evoker,devastation,36,13,23
Rotscale,proudmoore,1243,evoker,devastation,24,13,11
Lexgrossman,kelthuzad,1242,evoker,devastation,49,21,28
Jarzilla,illidan,1240,evoker,devastation,18,13,5
Dracfire,saurfang,1239,evoker,devastation,24,13,11
Longxx,dalaran,1235,evoker,devastation,24,13,11
Galakraas,proudmoore,1235,evoker,devastation,75,34,41
Xm,emerald-dream,1235,evoker,devastation,31,14,17
Bigbadfred,tichondrius,1234,evoker,devastation,24,13,11
Atreign,blackwing-lair,1234,evoker,devastation,43,13,30
Raghnard,illidan,1231,evoker,devastation,64,31,33
Sindraxx,stormrage,1228,evoker,devastation,48,25,23
Phlegython,eredar,1226,evoker,devastation,30,13,17
Valakaztower,area-52,1225,evoker,devastation,36,19,17
Nathx,drakkari,1222,evoker,devastation,24,18,6
Cheaterz,area-52,1222,evoker,devastation,36,22,14
Dingermun,bleeding-hollow,1221,evoker,devastation,19,14,5
Azorian,vashj,1208,evoker,devastation,30,17,13
Dîego,azralon,1206,evoker,devastation,22,14,8
Midnights,scarlet-crusade,1206,evoker,devastation,56,33,23
Trenot,draenor,1202,evoker,devastation,42,21,21
Layothyr,stormrage,1201,evoker,devastation,24,14,10
Drakonyx,mugthol,1195,evoker,devastation,42,18,24
Yiserion,sargeras,1194,evoker,devastation,54,29,25
Enuzan,dalaran,1191,evoker,devastation,35,17,18
Dragoceleste,ragnaros,1190,evoker,devastation,36,19,17
Dragkon,azuremyst,1190,evoker,devastation,54,22,32
Paean,moon-guard,1183,evoker,devastation,32,18,14
Evooern,frostmourne,1181,evoker,devastation,84,39,45
Vizora,moon-guard,1180,evoker,devastation,20,13,7
Kaikisen,malganis,1178,evoker,devastation,41,19,22
Climax,stormrage,1177,evoker,devastation,28,13,15
Bhalaria,ragnaros,1170,evoker,devastation,57,21,36
Teritwo,stormrage,1166,evoker,devastation,28,13,15
Drakhaz,azralon,1156,evoker,devastation,22,13,9
Crappysmellz,tichondrius,1152,evoker,devastation,18,12,6
Asham,azralon,1152,evoker,devastation,63,36,27
Devokerx,emerald-dream,1151,evoker,devastation,18,12,6
Tërminus,quelthalas,1151,evoker,devastation,18,12,6
Shwaydbz,zuljin,1151,evoker,devastation,24,12,12
Klownfiesta,thrall,1148,evoker,devastation,30,15,15
Mythsvoker,barthilas,1147,evoker,devastation,19,12,7
Aentharion,argent-dawn,1147,evoker,devastation,24,12,12
Zervis,arthas,1147,evoker,devastation,30,12,18
Drozul,stormrage,1145,evoker,devastation,30,12,18
Unseenzblack,tichondrius,1141,evoker,devastation,18,12,6
Zippityzoom,barthilas,1139,evoker,devastation,36,15,21
Dinnkyion,dalaran,1138,evoker,devastation,24,12,12
Midyr,nemesis,1137,evoker,devastation,24,15,9
Dragonbranch,area-52,1133,evoker,devastation,24,12,12
Lorathyr,lothar,1128,evoker,devastation,24,12,12
Loginplease,frostmourne,1124,evoker,devastation,56,23,33
Paycussy,sargeras,1110,evoker,devastation,18,12,6
Zitasanazen,tichondrius,1107,evoker,devastation,64,25,39
Cowboyydann,malganis,1102,evoker,devastation,17,12,5
Crymor,lethon,1099,evoker,devastation,30,16,14
Madelines,tichondrius,1097,evoker,devastation,24,13,11
Ðarkwyrm,laughing-skull,1092,evoker,devastation,36,20,16
Byäkuyá,azralon,1091,evoker,devastation,53,27,26
Trazana,wyrmrest-accord,1089,evoker,devastation,23,12,11
Zhannecgos,moon-guard,1087,evoker,devastation,28,12,16
Erizcdraa,tichondrius,1069,evoker,devastation,19,12,7
Durijus,tichondrius,1069,evoker,devastation,35,14,21
Aktas,illidan,1063,evoker,devastation,28,12,16
Warhammerxx,tichondrius,1058,evoker,devastation,66,25,41
Devokèr,tichondrius,1056,evoker,devastation,24,11,13
Mtndewboy,illidan,1055,evoker,devastation,18,11,7
Hydroponicsz,bloodscalp,1055,evoker,devastation,24,11,13
Obsidianimp,sargeras,1055,evoker,devastation,24,11,13
Kiry,emerald-dream,1055,evoker,devastation,24,11,13
Kubus,emerald-dream,1054,evoker,devastation,18,11,7
Yousurper,thunderlord,1054,evoker,devastation,27,14,13
Kinto,stormrage,1054,evoker,devastation,30,11,19
Eìdolon,sargeras,1049,evoker,devastation,18,11,7
Sübjugador,azralon,1042,evoker,devastation,30,20,10
Wackthyr,frostmourne,1042,evoker,devastation,24,11,13
Visron,stormrage,1039,evoker,devastation,41,25,16
Drögón,stormrage,1038,evoker,devastation,24,16,8
Tïtäm,area-52,1032,evoker,devastation,21,12,9
Tireoz,frostmourne,1026,evoker,devastation,38,11,27
Abaddragon,dalaran,1020,evoker,devastation,29,11,18
Culture,khazgoroth,1006,evoker,devastation,15,11,4
Alnuin,stormrage,1004,evoker,devastation,102,42,60
Stolesom,emerald-dream,992,evoker,devastation,59,29,30
Daydrac,thrall,987,evoker,devastation,26,11,15
Neofarian,lightbringer,986,evoker,devastation,20,11,9
Dragongrim,silvermoon,986,evoker,devastation,30,14,16
Chun,malganis,960,evoker,devastation,18,10,8
Iantern,dalaran,960,evoker,devastation,18,10,8
Kazrekan,moon-guard,960,evoker,devastation,18,10,8
Cmiygl,proudmoore,959,evoker,devastation,12,10,2
Cløud,hellscream,959,evoker,devastation,12,10,2
Nasdanot,zuljin,959,evoker,devastation,18,10,8
Xeerus,stormreaver,959,evoker,devastation,18,10,8
Chime,dalaran,959,evoker,devastation,18,10,8
Spicyrooster,area-52,959,evoker,devastation,18,10,8
Milkymike,uldum,959,evoker,devastation,18,10,8
Runescape,altar-of-storms,959,evoker,devastation,24,10,14
Flapples,stormrage,958,evoker,devastation,24,10,14
Vokezuì,sargeras,958,evoker,devastation,30,10,20
Jormungandre,wyrmrest-accord,957,evoker,devastation,18,10,8
Youdig,nazjatar,957,evoker,devastation,18,10,8
Dragocser,drakkari,957,evoker,devastation,18,10,8
Pewpowdragon,malganis,957,evoker,devastation,18,10,8
Jgdragon,sargeras,957,evoker,devastation,18,10,8
Herikas,tichondrius,956,evoker,devastation,72,35,37
Embarasi,moon-guard,956,evoker,devastation,24,10,14
Kheeleesi,illidan,956,evoker,devastation,24,10,14
Oatmealneil,bleeding-hollow,955,evoker,devastation,24,10,14
Kozukimomo,area-52,955,evoker,devastation,33,11,22
Sinepbreath,bleeding-hollow,954,evoker,devastation,18,10,8
Wizadsa,amanthul,951,evoker,devastation,12,10,2
Loganvkr,illidan,950,evoker,devastation,18,10,8
Fìg,wyrmrest-accord,948,evoker,devastation,18,10,8
Jorlozthyr,ragnaros,948,evoker,devastation,24,10,14
Prolyfe,blood-furnace,942,evoker,devastation,15,11,4
Escanorr,ghostlands,936,evoker,devastation,20,11,9
Stylez,anetheron,932,evoker,devastation,24,14,10
Salakhar,drakkari,924,evoker,devastation,14,11,3
Gridskully,quelthalas,912,evoker,devastation,21,11,10
Drahconne,illidan,912,evoker,devastation,23,10,13
Zyzzy,icecrown,910,evoker,devastation,15,10,5
Ciana,black-dragonflight,902,evoker,devastation,38,19,19
Mustardtiger,malorne,893,evoker,devastation,14,10,4
Áspect,aegwynn,864,evoker,devastation,12,9,3
Kiserys,suramar,864,evoker,devastation,12,9,3
Oracle,duskwood,864,evoker,devastation,12,9,3
Gobananas,sargeras,864,evoker,devastation,12,9,3
Orncen,emerald-dream,864,evoker,devastation,16,10,6
Todorøki,hyjal,864,evoker,devastation,18,9,9
Dracaryz,blackhand,864,evoker,devastation,18,9,9
Puffthemagic,lightnings-blade,864,evoker,devastation,18,9,9
Dragonsteppz,aegwynn,863,evoker,devastation,18,9,9
Nxnevo,tichondrius,863,evoker,devastation,18,9,9
Siatrend,moon-guard,863,evoker,devastation,18,9,9
Misik,frostwolf,863,evoker,devastation,18,9,9
Missjenny,korgath,863,evoker,devastation,18,9,9
Thyatera,ragnaros,863,evoker,devastation,18,9,9
Mil,lightnings-blade,863,evoker,devastation,21,10,11
Gharscales,tichondrius,863,evoker,devastation,24,9,15
Terraxkhan,quelthalas,863,evoker,devastation,24,9,15
Demidas,emerald-dream,862,evoker,devastation,13,9,4
Arath,zangarmarsh,862,evoker,devastation,30,14,16
Sía,drakkari,861,evoker,devastation,12,9,3
Vaayu,moon-guard,861,evoker,devastation,12,9,3
Nasath,arthas,861,evoker,devastation,18,9,9
Teanie,tichondrius,861,evoker,devastation,18,9,9
Karaxes,gorefiend,861,evoker,devastation,24,9,15
Zorashal,kiljaeden,860,evoker,devastation,12,9,3
Krokuzan,ragnaros,860,evoker,devastation,18,9,9
Doombreath,ragnaros,859,evoker,devastation,18,9,9
Keedrori,thrall,859,evoker,devastation,19,9,10
Aelvina,moon-guard,857,evoker,devastation,24,9,15
Nathenezital,frostmourne,856,evoker,devastation,18,9,9
Azuria,lothar,855,evoker,devastation,12,9,3
Furyíon,stormrage,855,evoker,devastation,12,9,3
Acnølogia,stormrage,855,evoker,devastation,18,9,9
Dragonpete,whisperwind,854,evoker,devastation,18,9,9
Neith,aerie-peak,846,evoker,devastation,23,9,14
Rasec,moon-guard,843,evoker,devastation,20,9,11
Acnøløgia,azralon,840,evoker,devastation,30,9,21
Rikfreedom,ragnaros,815,evoker,devastation,30,12,18
Zandrov,greymane,814,evoker,devastation,15,9,6
Dvrk,frostmourne,812,evoker,devastation,17,9,8
Nyranblood,zuljin,795,evoker,devastation,18,9,9
Gutterskank,illidan,793,evoker,devastation,17,9,8
Dragonfarts,frostmourne,768,evoker,devastation,12,8,4
Shortdargon,zuljin,768,evoker,devastation,12,8,4
Cròk,quelthalas,768,evoker,devastation,12,8,4
Taeloc,frostmourne,768,evoker,devastation,18,8,10
Drsgme,dentarg,768,evoker,devastation,18,8,10
Crosis,azralon,768,evoker,devastation,18,8,10
Growthyy,malganis,767,evoker,devastation,12,8,4
Dragontales,stormrage,767,evoker,devastation,12,8,4
Vermax,akama,767,evoker,devastation,18,8,10
Kozara,trollbane,767,evoker,devastation,18,8,10
Satanasx,illidan,767,evoker,devastation,18,8,10
Rïvé,tichondrius,767,evoker,devastation,24,8,16
Dawitchvoker,illidan,766,evoker,devastation,18,8,10
Aaztra,whisperwind,765,evoker,devastation,12,8,4
Tinà,tichondrius,765,evoker,devastation,18,8,10
Skrillerv,frostmourne,765,evoker,devastation,18,8,10
Archion,azgalor,764,evoker,devastation,24,8,16
Redeyés,area-52,761,evoker,devastation,12,8,4
Seletgos,quelthalas,761,evoker,devastation,24,8,16
Detraa,illidan,754,evoker,devastation,12,8,4
Drapybaras,bleeding-hollow,745,evoker,devastation,24,8,16
Pouncer,proudmoore,729,evoker,devastation,20,8,12
Onornun,magtheridon,718,evoker,devastation,17,8,9
Kalisee,skullcrusher,703,evoker,devastation,11,8,3
Raygos,nemesis,700,evoker,devastation,26,8,18
Zhyrouvion,stormrage,699,evoker,devastation,17,8,9
Torakk,ravencrest,687,evoker,devastation,13,8,5
Lacadabeef,tichondrius,672,evoker,devastation,12,7,5
Koralia,wyrmrest-accord,672,evoker,devastation,12,7,5
Vokr,area-52,672,evoker,devastation,12,7,5
Axiomoixa,tichondrius,672,evoker,devastation,12,7,5
Nysian,wyrmrest-accord,672,evoker,devastation,12,7,5
Spikeyboi,eonar,672,evoker,devastation,12,7,5
Bryiona,proudmoore,672,evoker,devastation,12,7,5
Dudeofdragon,illidan,672,evoker,devastation,12,7,5
Serathrine,smolderthorn,672,evoker,devastation,12,7,5
Dragonherb,zuljin,672,evoker,devastation,12,7,5
Chewbigred,vashj,672,evoker,devastation,12,7,5
Écaille,dalaran,672,evoker,devastation,15,8,7
Dragonstonks,moon-guard,672,evoker,devastation,18,7,11
Razistzegrlz,illidan,672,evoker,devastation,24,7,17
Jwoker,malganis,672,evoker,devastation,24,7,17
Whiegrath,azralon,671,evoker,devastation,12,7,5
Xeretas,bleeding-hollow,671,evoker,devastation,12,7,5
Glaurungr,ragnaros,671,evoker,devastation,12,7,5
Vexosza,moon-guard,671,evoker,devastation,12,7,5
Gôdswrath,tichondrius,671,evoker,devastation,12,7,5
Ggcthulhu,area-52,671,evoker,devastation,12,7,5
Boseijwho,emerald-dream,671,evoker,devastation,12,7,5
Hemipenes,tichondrius,671,evoker,devastation,18,7,11
Phatë,nerzhul,671,evoker,devastation,18,7,11
Setchagos,emerald-dream,670,evoker,devastation,12,7,5
Beastlysoul,tichondrius,670,evoker,devastation,12,7,5
Gulvoke,shattered-hand,670,evoker,devastation,12,7,5
Nikeze,kiljaeden,670,evoker,devastation,18,7,11
Takhysis,frostmourne,670,evoker,devastation,18,7,11
Lamperr,illidan,670,evoker,devastation,54,10,44
Pyrepapi,thrall,669,evoker,devastation,20,8,12
Lostplanet,drakkari,669,evoker,devastation,24,7,17
Mmanigoldo,quelthalas,667,evoker,devastation,18,7,11
Sleepeasy,blackrock,667,evoker,devastation,18,7,11
Evilsquirel,area-52,666,evoker,devastation,12,7,5
Popgoesurmom,tichondrius,662,evoker,devastation,12,7,5
Littleripper,tichondrius,658,evoker,devastation,12,7,5
Stormstryke,queldorei,641,evoker,devastation,35,7,28
Krefugee,tichondrius,637,evoker,devastation,17,7,10
Drahkoo,azralon,623,evoker,devastation,15,7,8
Zérai,quelthalas,576,evoker,devastation,6,6,0
Yellowker,thrall,576,evoker,devastation,6,6,0
Ilovepolpot,tichondrius,576,evoker,devastation,6,6,0
Zlyrax,moon-guard,576,evoker,devastation,6,6,0
Fuecoco,proudmoore,576,evoker,devastation,6,6,0
Dragønbørne,blackrock,576,evoker,devastation,12,6,6
Brakkarion,wyrmrest-accord,576,evoker,devastation,12,6,6
Uncleìroh,tichondrius,576,evoker,devastation,12,6,6
Sathregos,emerald-dream,576,evoker,devastation,12,6,6
Glizard,firetree,576,evoker,devastation,12,6,6
Müshü,icecrown,576,evoker,devastation,12,6,6
Iamtrash,daggerspine,576,evoker,devastation,12,6,6
Comepancito,quelthalas,576,evoker,devastation,12,6,6
Dracthyrius,thunderlord,576,evoker,devastation,12,6,6
Zoomi,whisperwind,576,evoker,devastation,12,6,6
Lardicønn,thrall,576,evoker,devastation,12,6,6
Dafiya,thrall,576,evoker,devastation,12,6,6
Dimatis,ragnaros,576,evoker,devastation,12,6,6
Dukä,dalaran,576,evoker,devastation,15,7,8
Krashbandico,zangarmarsh,576,evoker,devastation,18,6,12
Bhanethyr,illidan,576,evoker,devastation,18,6,12
Saxthyr,stormreaver,576,evoker,devastation,24,6,18
Avithori,borean-tundra,575,evoker,devastation,12,6,6
Amaryliss,kelthuzad,575,evoker,devastation,12,6,6
Lòrdope,illidan,575,evoker,devastation,12,6,6
Avastri,moon-guard,575,evoker,devastation,12,6,6
Rykuvokr,azuremyst,575,evoker,devastation,12,6,6
Spicy,mannoroth,575,evoker,devastation,12,6,6
Altri,lightnings-blade,575,evoker,devastation,12,6,6
Tylexstranza,malganis,575,evoker,devastation,12,6,6
Liekki,illidan,575,evoker,devastation,12,6,6
Dragonair,spinebreaker,575,evoker,devastation,15,6,9
Slitherin,dalaran,575,evoker,devastation,18,6,12
Bazelgos,moon-guard,575,evoker,devastation,24,6,18
Snowdragon,azralon,574,evoker,devastation,12,6,6
Vermáx,caelestrasz,574,evoker,devastation,12,6,6
Aegontargary,azralon,574,evoker,devastation,15,7,8
Carloxd,tichondrius,574,evoker,devastation,24,6,18
Syndue,malganis,573,evoker,devastation,12,6,6
Noodleslut,stormrage,573,evoker,devastation,12,6,6
Azuril,wyrmrest-accord,572,evoker,devastation,12,6,6
Ezdrake,drakkari,572,evoker,devastation,24,6,18
Aratre,daggerspine,560,evoker,devastation,30,6,24
Toephotos,tichondrius,558,evoker,devastation,17,6,11
Lightaurae,thunderlord,556,evoker,devastation,30,6,24
Pzyko,ragnaros,551,evoker,devastation,17,6,11
Zindrozarath,area-52,544,evoker,devastation,10,6,4
Blazor,sisters-of-elune,542,evoker,devastation,11,6,5
Dragonbreaf,emerald-dream,527,evoker,devastation,11,6,5
Derite,bonechewer,511,evoker,devastation,10,6,4
Gangbânk,tichondrius,480,evoker,devastation,6,5,1
Vaelikai,korgath,480,evoker,devastation,6,5,1
Kharibdis,kul-tiras,480,evoker,devastation,6,5,1
Khalt,quelthalas,480,evoker,devastation,6,5,1
Drakedrift,malganis,480,evoker,devastation,6,5,1
Raller,malganis,480,evoker,devastation,6,5,1
Toastsevoker,tichondrius,480,evoker,devastation,9,6,3
Dhcb,tichondrius,480,evoker,devastation,12,5,7
Nardleberry,wyrmrest-accord,480,evoker,devastation,12,5,7
Rebuk,area-52,480,evoker,devastation,12,5,7
Ackresh,executus,480,evoker,devastation,12,5,7
Purplerocket,illidan,480,evoker,devastation,12,5,7
Moltqt,tichondrius,480,evoker,devastation,12,5,7
Deezdragon,stormrage,480,evoker,devastation,12,5,7
Darkscale,haomarush,480,evoker,devastation,12,5,7
Ryhu,sargeras,480,evoker,devastation,12,5,7
Nuttutted,emerald-dream,480,evoker,devastation,12,5,7
Nelthendros,moon-guard,480,evoker,devastation,12,5,7
Faahrad,azralon,480,evoker,devastation,12,5,7
Vikings,madoran,480,evoker,devastation,12,5,7
Meleyx,saurfang,480,evoker,devastation,12,5,7
Stælthßømbèr,baelgun,480,evoker,devastation,12,5,7
Draehgor,hyjal,480,evoker,devastation,12,5,7
Trillvoker,illidan,480,evoker,devastation,12,5,7
Asatrat,greymane,480,evoker,devastation,12,5,7
Kinndyvoker,sargeras,480,evoker,devastation,12,5,7
Bucket,wyrmrest-accord,480,evoker,devastation,12,5,7
Nethenezoth,auchindoun,480,evoker,devastation,12,5,7
Glideoure,stonemaul,480,evoker,devastation,18,5,13
Jugzxs,frostmourne,480,evoker,devastation,18,5,13
Emsli,moon-guard,479,evoker,devastation,6,5,1
Targaryenz,malganis,479,evoker,devastation,12,5,7
Scalesun,azralon,479,evoker,devastation,12,5,7
Dedderion,zuljin,479,evoker,devastation,12,5,7
Historius,proudmoore,479,evoker,devastation,12,5,7
Granolajin,ragnaros,479,evoker,devastation,12,5,7
Niratrenn,area-52,478,evoker,devastation,12,5,7
Nathrach,wyrmrest-accord,477,evoker,devastation,6,5,1
Sandrov,kaelthas,477,evoker,devastation,12,5,7
Daigrefn,echo-isles,476,evoker,devastation,12,5,7
Zzae,tichondrius,432,evoker,devastation,15,5,10
Lifcleal,moon-guard,415,evoker,devastation,14,5,9
Kosstro,thunderlord,398,evoker,devastation,10,5,5
Docevoker,tichondrius,384,evoker,devastation,6,4,2
Zorlstisza,moon-guard,384,evoker,devastation,6,4,2
Opsmybad,ragnaros,384,evoker,devastation,6,4,2
Atraxian,tichondrius,384,evoker,devastation,6,4,2
Whinks,zangarmarsh,384,evoker,devastation,6,4,2
Deathraux,tichondrius,384,evoker,devastation,6,4,2
Dragonsbgay,stormrage,384,evoker,devastation,6,4,2
Potfase,tichondrius,384,evoker,devastation,6,4,2
Kaidoxuchihv,ragnaros,384,evoker,devastation,6,4,2
Shenròn,kelthuzad,384,evoker,devastation,6,4,2
Drøgon,sargeras,384,evoker,devastation,6,4,2
Draisin,zuljin,384,evoker,devastation,6,4,2
Machaflux,winterhoof,384,evoker,devastation,6,4,2
Testzvoker,dalaran,384,evoker,devastation,6,4,2
Bmbo,illidan,384,evoker,devastation,6,4,2
Jammstraza,skywall,384,evoker,devastation,6,4,2
Dylawn,illidan,384,evoker,devastation,6,4,2
Bodytypetwo,area-52,384,evoker,devastation,6,4,2
Raikori,ragnaros,384,evoker,devastation,6,4,2
Daemon,detheroc,384,evoker,devastation,6,4,2
Mushú,archimonde,384,evoker,devastation,6,4,2
Lizardgodtko,tichondrius,384,evoker,devastation,6,4,2
Seaserpent,kelthuzad,384,evoker,devastation,6,4,2
Skylizard,illidan,384,evoker,devastation,6,4,2
Kcwt,illidan,384,evoker,devastation,6,4,2
Mcflý,sargeras,384,evoker,devastation,6,4,2
Swagondragon,illidan,384,evoker,devastation,6,4,2
Biscotti,illidan,384,evoker,devastation,6,4,2
Jenovi,tichondrius,384,evoker,devastation,6,4,2
Vuldon,area-52,384,evoker,devastation,6,4,2
Saìntgeorge,sargeras,384,evoker,devastation,6,4,2
Blay,elune,384,evoker,devastation,12,4,8
Dragostephen,nazjatar,384,evoker,devastation,12,4,8
Nitalzith,area-52,384,evoker,devastation,12,4,8
Lindrak,azralon,384,evoker,devastation,12,4,8
Rizzlordx,bleeding-hollow,384,evoker,devastation,12,4,8
Zirath,emerald-dream,384,evoker,devastation,12,4,8
Baddrakthyr,moon-guard,384,evoker,devastation,12,4,8
Butta,darkspear,384,evoker,devastation,12,4,8
Kendrac,wyrmrest-accord,384,evoker,devastation,12,4,8
Smacktoch,sargeras,384,evoker,devastation,12,4,8
Dragonballer,trollbane,384,evoker,devastation,12,4,8
Alragos,ragnaros,384,evoker,devastation,12,4,8
Alligatorz,sargeras,384,evoker,devastation,12,4,8
Idiotlizard,stormrage,384,evoker,devastation,12,4,8
Thnake,zuljin,384,evoker,devastation,12,4,8
Smackthyr,thrall,384,evoker,devastation,12,4,8
Pewnee,eonar,384,evoker,devastation,12,4,8
Cuarta,drakkari,384,evoker,devastation,12,4,8
Lukamagik,boulderfist,384,evoker,devastation,12,4,8
Syvernius,khazgoroth,384,evoker,devastation,12,4,8
Muppetgronk,frostmourne,384,evoker,devastation,12,4,8
Devåståtion,tichondrius,384,evoker,devastation,12,4,8
Taylordra,tichondrius,384,evoker,devastation,12,4,8
Munichho,spirestone,384,evoker,devastation,18,4,14
Dinossauro,stormrage,383,evoker,devastation,6,4,2
Rysonda,tichondrius,383,evoker,devastation,6,4,2
Pläid,azuremyst,383,evoker,devastation,6,4,2
Stretonaught,dalaran,383,evoker,devastation,9,4,5
Jabberwockie,zuljin,383,evoker,devastation,12,4,8
Ezath,zuljin,383,evoker,devastation,12,4,8
Bagelsaurus,tichondrius,383,evoker,devastation,12,4,8
Fukhur,ragnaros,381,evoker,devastation,12,4,8
Vermicri,zuljin,351,evoker,devastation,11,4,7
Serazenoth,area-52,336,evoker,devastation,9,4,5
Acindor,stormrage,335,evoker,devastation,11,4,7
Carrnedge,area-52,319,evoker,devastation,5,4,1
Kettor,kelthuzad,288,evoker,devastation,6,3,3
Dragoom,saurfang,288,evoker,devastation,6,3,3
Kulrainor,drakkari,288,evoker,devastation,6,3,3
Inferna,ysera,288,evoker,devastation,6,3,3
Skeye,malganis,288,evoker,devastation,6,3,3
Spyro,nazgrel,288,evoker,devastation,6,3,3
Ripdumpster,bonechewer,288,evoker,devastation,6,3,3
Saintpablox,illidan,288,evoker,devastation,6,3,3
Straykitty,moon-guard,288,evoker,devastation,6,3,3
Deathwingtwo,sargeras,288,evoker,devastation,6,3,3
Jakarn,moon-guard,288,evoker,devastation,6,3,3
Yousmokemids,frostwolf,288,evoker,devastation,6,3,3
Ráigon,ragnaros,288,evoker,devastation,6,3,3
Hausebat,aegwynn,288,evoker,devastation,6,3,3
Dreamfyrexi,thrall,288,evoker,devastation,6,3,3
Ironscale,dalaran,288,evoker,devastation,6,3,3
Ceraxes,stormscale,288,evoker,devastation,6,3,3
Madjeckyl,dalaran,288,evoker,devastation,6,3,3
Deshalth,dalaran,288,evoker,devastation,6,3,3
Zindraco,thrall,288,evoker,devastation,6,3,3
Shenronda,moon-guard,288,evoker,devastation,6,3,3
Lïzzy,tichondrius,288,evoker,devastation,6,3,3
Scyyterr,azralon,288,evoker,devastation,6,3,3
Xampusaurio,ragnaros,288,evoker,devastation,6,3,3
Aomend,stormrage,288,evoker,devastation,6,3,3
Platypus,tichondrius,288,evoker,devastation,6,3,3
Ecoera,tichondrius,288,evoker,devastation,6,3,3
Avasd,area-52,288,evoker,devastation,6,3,3
Magicev,tichondrius,288,evoker,devastation,6,3,3
Baddrake,moon-guard,288,evoker,devastation,6,3,3
Êsh,lightbringer,288,evoker,devastation,6,3,3
Lëåf,area-52,288,evoker,devastation,6,3,3
Yeda,barthilas,288,evoker,devastation,6,3,3
Cøømbuya,sargeras,288,evoker,devastation,6,3,3
Brokenscales,nerzhul,288,evoker,devastation,6,3,3
Drakthaer,tichondrius,288,evoker,devastation,6,3,3
Cerisoromis,stormrage,288,evoker,devastation,6,3,3
Bigsquirt,proudmoore,288,evoker,devastation,6,3,3
Shennron,darkspear,288,evoker,devastation,6,3,3
Lamdyn,wyrmrest-accord,288,evoker,devastation,6,3,3
Dragbod,korgath,288,evoker,devastation,6,3,3
Varandir,frostmane,288,evoker,devastation,6,3,3
Galakrond,black-dragonflight,288,evoker,devastation,6,3,3
Vallath,zuljin,288,evoker,devastation,6,3,3
Deewey,sargeras,288,evoker,devastation,6,3,3
Viverion,dalaran,288,evoker,devastation,10,4,6
Taegon,area-52,288,evoker,devastation,10,4,6
Nyldra,area-52,288,evoker,devastation,8,3,5
Vandinus,stormrage,288,evoker,devastation,8,3,5
Freddragon,illidan,288,evoker,devastation,12,3,9
Enserio,stormrage,288,evoker,devastation,12,3,9
Nazervis,silver-hand,288,evoker,devastation,12,3,9
Healmeta,sargeras,288,evoker,devastation,12,3,9
Ashenoth,antonidas,288,evoker,devastation,12,3,9
Talonsong,wyrmrest-accord,288,evoker,devastation,12,3,9
Velahesa,sargeras,288,evoker,devastation,12,3,9
Althenot,emerald-dream,287,evoker,devastation,6,3,3
Fortwonty,thrall,287,evoker,devastation,6,3,3
Zeralzin,aerie-peak,287,evoker,devastation,6,3,3
Myvrth,windrunner,287,evoker,devastation,12,3,9
Kilnarx,uldaman,286,evoker,devastation,6,3,3
Ghorin,akama,240,evoker,devastation,9,3,6
Panicnodisco,zuljin,239,evoker,devastation,5,3,2
Reombarth,nemesis,234,evoker,devastation,12,6,6
Trrxx,tichondrius,224,evoker,devastation,10,3,7
Joesount,frostmourne,192,evoker,devastation,6,2,4
Garchamp,area-52,192,evoker,devastation,6,2,4
Noxidian,moon-guard,192,evoker,devastation,6,2,4
Ralzital,auchindoun,192,evoker,devastation,6,2,4
Draketyr,area-52,192,evoker,devastation,6,2,4
Rõÿ,area-52,192,evoker,devastation,6,2,4
Goreriders,area-52,192,evoker,devastation,6,2,4
Racovoker,zuljin,192,evoker,devastation,6,2,4
Broconian,zuljin,192,evoker,devastation,6,2,4
Dragonsand,area-52,192,evoker,devastation,6,2,4
Ilithiphobia,ghostlands,192,evoker,devastation,6,2,4
Dunkinonem,black-dragonflight,192,evoker,devastation,6,2,4
Selocky,bleeding-hollow,192,evoker,devastation,6,2,4
Pocketgiga,stormrage,192,evoker,devastation,6,2,4
Frozanat,kelthuzad,192,evoker,devastation,6,2,4
Parachutes,kelthuzad,192,evoker,devastation,6,2,4
Puffed,frostmourne,192,evoker,devastation,6,2,4
Theyevokbuda,kelthuzad,192,evoker,devastation,6,2,4
Analogies,stormrage,192,evoker,devastation,6,2,4
Lightbeing,nazjatar,192,evoker,devastation,6,2,4
Slydawg,amanthul,192,evoker,devastation,6,2,4
Siatren,shadowmoon,192,evoker,devastation,6,2,4
Daemon,terokkar,192,evoker,devastation,6,2,4
Wse,illidan,192,evoker,devastation,6,2,4
Grawlix,stormreaver,192,evoker,devastation,6,2,4
Vermithõr,ragnaros,192,evoker,devastation,6,2,4
Usulamili,stormrage,192,evoker,devastation,6,2,4
Paindragon,tol-barad,192,evoker,devastation,6,2,4
Yalena,illidan,192,evoker,devastation,6,2,4
Daebruk,ragnaros,192,evoker,devastation,6,2,4
Mâne,ragnaros,192,evoker,devastation,6,2,4
Dixb,illidan,192,evoker,devastation,6,2,4
Mattykanish,illidan,192,evoker,devastation,6,2,4
Ýüp,tichondrius,192,evoker,devastation,6,2,4
Guavomango,moon-guard,192,evoker,devastation,6,2,4
Acade,tichondrius,192,evoker,devastation,6,2,4
Aralzit,tichondrius,192,evoker,devastation,6,2,4
Nitalash,moon-guard,192,evoker,devastation,6,2,4
Doldorrii,terenas,192,evoker,devastation,6,2,4
Daraz,tichondrius,192,evoker,devastation,6,2,4
Darazen,scarlet-crusade,192,evoker,devastation,6,2,4
Xazxander,tichondrius,192,evoker,devastation,6,2,4
Magnito,thorium-brotherhood,192,evoker,devastation,6,2,4
Chriszilla,tichondrius,192,evoker,devastation,6,2,4
Wydbro,kiljaeden,192,evoker,devastation,6,2,4
Kímbah,emerald-dream,192,evoker,devastation,6,2,4
Swamper,emerald-dream,192,evoker,devastation,6,2,4
Zuberion,wyrmrest-accord,192,evoker,devastation,6,2,4
Dokthyr,lightbringer,192,evoker,devastation,6,2,4
Genderboy,tichondrius,192,evoker,devastation,6,2,4
Nyaraoorun,uther,192,evoker,devastation,6,2,4
Actïoncat,emerald-dream,192,evoker,devastation,6,2,4
Kazervish,wyrmrest-accord,192,evoker,devastation,6,2,4
Tasdaral,tichondrius,192,evoker,devastation,6,2,4
Desdinova,tortheldrin,192,evoker,devastation,6,2,4
Ytq,tichondrius,192,evoker,devastation,6,2,4
Hellasketchy,sargeras,192,evoker,devastation,6,2,4
Xfemboyqt,area-52,192,evoker,devastation,11,3,8
Cyromancerr,illidan,192,evoker,devastation,8,2,6
Arokh,frostmourne,192,evoker,devastation,12,2,10
Gamerwords,barthilas,192,evoker,devastation,12,2,10
Blueblack,proudmoore,192,evoker,devastation,12,2,10
Sørrøw,blades-edge,192,evoker,devastation,18,2,16
Dracalis,thrall,191,evoker,devastation,6,2,4
Fearmybreath,stormrage,179,evoker,devastation,16,5,11
Goongdi,tichondrius,159,evoker,devastation,5,2,3
Tevvez,moon-guard,159,evoker,devastation,5,2,3
Deathflamee,emerald-dream,138,evoker,devastation,12,3,9
Eleechee,magtheridon,128,evoker,devastation,4,2,2
Shunkagosa,frostmourne,128,evoker,devastation,4,2,2
Vïtmercon,frostmourne,128,evoker,devastation,4,2,2
Booniejimbob,illidan,128,evoker,devastation,4,2,2
Vormontis,azralon,112,evoker,devastation,7,2,5
Grafixx,sargeras,96,evoker,devastation,3,2,1
Tugmapvpean,kelthuzad,96,evoker,devastation,3,2,1
Gavstarz,frostmourne,96,evoker,devastation,3,2,1
Demobreath,sargeras,96,evoker,devastation,6,1,5
Asui,senjin,96,evoker,devastation,6,1,5
Ojigi,sargeras,96,evoker,devastation,6,1,5
Zinderaz,runetotem,96,evoker,devastation,6,1,5
Aoibae,frostmourne,96,evoker,devastation,6,1,5
Ackonstraza,frostmourne,96,evoker,devastation,6,1,5
Ðrac,bleeding-hollow,96,evoker,devastation,6,1,5
Eyedxl,magtheridon,96,evoker,devastation,6,1,5
Kazadon,icecrown,96,evoker,devastation,6,1,5
Handb,tichondrius,96,evoker,devastation,6,1,5
Koopa,malygos,96,evoker,devastation,6,1,5
Myjewelshurt,stormrage,96,evoker,devastation,6,1,5
Bløssom,malganis,96,evoker,devastation,6,1,5
Warchad,stormrage,96,evoker,devastation,6,1,5
Yongyang,tichondrius,96,evoker,devastation,6,1,5
Pisslizard,stormrage,96,evoker,devastation,6,1,5
Modenzu,malganis,96,evoker,devastation,6,1,5
Fígment,tichondrius,96,evoker,devastation,6,1,5
Chillistraza,tichondrius,96,evoker,devastation,6,1,5
Zealagon,ragnaros,96,evoker,devastation,6,1,5
Lucià,thrall,96,evoker,devastation,6,1,5
Charrio,illidan,96,evoker,devastation,6,1,5
Batterypowa,frostmourne,96,evoker,devastation,6,1,5
Dracoi,illidan,96,evoker,devastation,6,1,5
Erathiss,wyrmrest-accord,96,evoker,devastation,6,1,5
Shintrax,ragnaros,96,evoker,devastation,6,1,5
Colloc,tichondrius,96,evoker,devastation,6,1,5
Dadydafather,sargeras,96,evoker,devastation,12,1,11
Ysondrius,durotan,96,evoker,devastation,12,1,11
Carnosaur,lightbringer,96,evoker,devastation,12,1,11
Embeka,illidan,95,evoker,devastation,6,1,5
Bàkèd,illidan,79,evoker,devastation,5,1,4
Nwo,shattered-hand,64,evoker,devastation,4,1,3
Cerevok,area-52,64,evoker,devastation,4,1,3
Charlestrasz,hyjal,42,evoker,devastation,11,3,8
Remisha,emerald-dream,2136,hunter,marksmanship,82,44,38
Darkshady,tichondrius,2050,hunter,marksmanship,78,40,38
Abolick,area-52,1990,hunter,marksmanship,118,61,57
Dobarantu,tichondrius,1972,hunter,marksmanship,98,49,49
Imvalence,area-52,1947,hunter,marksmanship,82,36,46
Rendel,drakkari,1932,hunter,marksmanship,89,42,47
Fuknhunter,kiljaeden,1905,hunter,marksmanship,110,56,54
Rakan,spinebreaker,1884,hunter,marksmanship,54,33,21
Bøl,ragnaros,1882,hunter,marksmanship,30,20,10
Hokutox,tichondrius,1870,hunter,marksmanship,68,31,37
Blackjesu,blackrock,1868,hunter,marksmanship,72,33,39
Renaître,tichondrius,1866,hunter,marksmanship,120,57,63
Squawkers,sargeras,1848,hunter,marksmanship,78,43,35
Iconvoked,sargeras,1842,hunter,marksmanship,142,75,67
Hâwkêyê,thrall,1827,hunter,marksmanship,48,22,26
Lely,tichondrius,1823,hunter,marksmanship,54,30,24
Hrafn,illidan,1813,hunter,marksmanship,54,28,26
Colada,malganis,1813,hunter,marksmanship,72,34,38
Bosshunter,tichondrius,1810,hunter,marksmanship,86,43,43
Nishinos,tichondrius,1808,hunter,marksmanship,183,88,95
Deutêr,quelthalas,1801,hunter,marksmanship,66,35,31
Kensho,illidan,1789,hunter,marksmanship,48,28,20
Drasen,deathwing,1778,hunter,marksmanship,48,27,21
Hagadinn,frostmourne,1765,hunter,marksmanship,48,21,27
Boquiinha,stormrage,1759,hunter,marksmanship,90,46,44
Globalcake,illidan,1757,hunter,marksmanship,121,59,62
Dynith,sargeras,1756,hunter,marksmanship,39,21,18
Ladderpolice,tichondrius,1749,hunter,marksmanship,61,35,26
Undeadroach,tichondrius,1747,hunter,marksmanship,119,55,64
Notnick,tichondrius,1747,hunter,marksmanship,84,37,47
Preze,moon-guard,1739,hunter,marksmanship,51,29,22
Chadsmanship,kelthuzad,1737,hunter,marksmanship,48,22,26
Kristemis,thrall,1727,hunter,marksmanship,42,23,19
Kkoduckk,tichondrius,1715,hunter,marksmanship,30,19,11
Blungo,azralon,1713,hunter,marksmanship,60,31,29
Dolcece,tichondrius,1713,hunter,marksmanship,48,24,24
Overgnome,ragnaros,1710,hunter,marksmanship,54,26,28
Surprisemfkr,emerald-dream,1693,hunter,marksmanship,54,29,25
Tropic,proudmoore,1688,hunter,marksmanship,68,28,40
Killatrap,malganis,1677,hunter,marksmanship,42,23,19
Ingrutamig,tichondrius,1672,hunter,marksmanship,48,23,25
Heädshöt,malorne,1672,hunter,marksmanship,66,31,35
Onemoreshot,bleeding-hollow,1670,hunter,marksmanship,116,55,61
Petattack,barthilas,1668,hunter,marksmanship,42,20,22
Tassili,illidan,1666,hunter,marksmanship,60,23,37
Somethinggo,tichondrius,1658,hunter,marksmanship,95,51,44
Shawtytraps,tichondrius,1652,hunter,marksmanship,131,53,78
Gotchã,area-52,1650,hunter,marksmanship,42,27,15
Quickitty,proudmoore,1648,hunter,marksmanship,54,25,29
Czeroenjoyer,malganis,1647,hunter,marksmanship,36,22,14
Aymas,sargeras,1645,hunter,marksmanship,119,62,57
Zumago,tichondrius,1633,hunter,marksmanship,42,19,23
Hmh,burning-legion,1631,hunter,marksmanship,155,79,76
Bigpie,daggerspine,1628,hunter,marksmanship,59,37,22
Taylormadae,frostmourne,1627,hunter,marksmanship,66,37,29
Arjunå,sargeras,1621,hunter,marksmanship,101,56,45
Easynightjr,bleeding-hollow,1620,hunter,marksmanship,225,117,108
Xcw,stormrage,1619,hunter,marksmanship,60,28,32
Supersaiyan,antonidas,1618,hunter,marksmanship,36,17,19
Alansho,tichondrius,1618,hunter,marksmanship,53,20,33
Tânsøxøxø,tichondrius,1617,hunter,marksmanship,30,17,13
Latesummer,tichondrius,1616,hunter,marksmanship,48,25,23
Johaylon,sargeras,1616,hunter,marksmanship,42,19,23
Jubiscleudo,azralon,1615,hunter,marksmanship,85,39,46
Dezertpower,sargeras,1613,hunter,marksmanship,36,20,16
Snìpershot,sargeras,1612,hunter,marksmanship,61,33,28
Shotashot,area-52,1612,hunter,marksmanship,36,17,19
Wildder,area-52,1609,hunter,marksmanship,56,31,25
Simbagrove,dalaran,1605,hunter,marksmanship,42,19,23
Evaelfi,illidan,1605,hunter,marksmanship,40,17,23
Dienasty,zuljin,1601,hunter,marksmanship,30,21,9
Vitekz,illidan,1593,hunter,marksmanship,24,17,7
Mambothehunt,stormrage,1579,hunter,marksmanship,60,33,27
Drivebymac,tichondrius,1578,hunter,marksmanship,42,21,21
Dummorogh,stormrage,1578,hunter,marksmanship,96,45,51
Wìkkihx,emerald-dream,1568,hunter,marksmanship,48,25,23
Papiskrill,staghelm,1568,hunter,marksmanship,91,42,49
Swagprince,skullcrusher,1563,hunter,marksmanship,52,32,20
Stimpblimp,jubeithos,1563,hunter,marksmanship,48,19,29
Onemøreshot,bleeding-hollow,1561,hunter,marksmanship,108,54,54
Amyrkvothe,ragnaros,1561,hunter,marksmanship,42,19,23
Saloran,akama,1560,hunter,marksmanship,54,33,21
Gnomorecum,kiljaeden,1558,hunter,marksmanship,87,54,33
Shotsphodays,sargeras,1558,hunter,marksmanship,72,37,35
Crounzz,sargeras,1558,hunter,marksmanship,51,23,28
Rampagez,tichondrius,1555,hunter,marksmanship,36,19,17
Luchadoris,malganis,1552,hunter,marksmanship,60,30,30
Alyywn,tichondrius,1551,hunter,marksmanship,101,44,57
Hötdôg,kiljaeden,1548,hunter,marksmanship,36,20,16
Hämhunter,stormrage,1539,hunter,marksmanship,48,31,17
Arrowslol,stormrage,1537,hunter,marksmanship,48,23,25
Huntncheekz,kelthuzad,1534,hunter,marksmanship,76,38,38
Metalgear,icecrown,1533,hunter,marksmanship,66,34,32
Adive,drakkari,1533,hunter,marksmanship,66,32,34
Hitts,barthilas,1531,hunter,marksmanship,53,27,26
Bowflexen,illidan,1531,hunter,marksmanship,36,17,19
Zugbrained,illidan,1529,hunter,marksmanship,48,26,22
Lilbang,thrall,1529,hunter,marksmanship,42,19,23
Kekkww,hyjal,1526,hunter,marksmanship,48,25,23
Acelol,proudmoore,1524,hunter,marksmanship,142,80,62
Joshmckin,area-52,1524,hunter,marksmanship,86,42,44
Guacmec,tichondrius,1521,hunter,marksmanship,48,28,20
Elfymcelf,arthas,1520,hunter,marksmanship,84,39,45
Gretress,azralon,1520,hunter,marksmanship,66,28,38
Grands,tortheldrin,1519,hunter,marksmanship,48,23,25
Lsily,tichondrius,1519,hunter,marksmanship,36,16,20
Vibøra,stormrage,1518,hunter,marksmanship,85,39,46
Realskinhead,terenas,1516,hunter,marksmanship,46,24,22
Odin,goldrinn,1516,hunter,marksmanship,101,46,55
Insanedabz,tichondrius,1515,hunter,marksmanship,72,35,37
Undien,area-52,1509,hunter,marksmanship,30,16,14
Cyrsmen,ragnaros,1509,hunter,marksmanship,63,30,33
Kimghak,tichondrius,1506,hunter,marksmanship,49,20,29
Lostfaith,tichondrius,1504,hunter,marksmanship,66,36,30
Rïve,tichondrius,1504,hunter,marksmanship,36,17,19
Marshen,zuljin,1503,hunter,marksmanship,36,17,19
Huntkiller,tichondrius,1502,hunter,marksmanship,28,18,10
Baixiaochu,area-52,1502,hunter,marksmanship,75,35,40
Richmond,lightnings-blade,1500,hunter,marksmanship,48,20,28
Lixniqua,tichondrius,1498,hunter,marksmanship,75,38,37
Bertimus,sargeras,1498,hunter,marksmanship,42,17,25
Papacohen,stormrage,1495,hunter,marksmanship,45,22,23
Lildex,demon-soul,1494,hunter,marksmanship,30,18,12
Jotosalsa,blackrock,1494,hunter,marksmanship,48,26,22
Killshøtß,tichondrius,1494,hunter,marksmanship,48,23,25
Dracõ,proudmoore,1491,hunter,marksmanship,42,18,24
Esler,quelthalas,1490,hunter,marksmanship,54,28,26
Xcisiion,nagrand,1487,hunter,marksmanship,97,51,46
Pâl,quelthalas,1481,hunter,marksmanship,42,21,21
Windrein,ysondre,1475,hunter,marksmanship,48,20,28
Barrohunt,tichondrius,1473,hunter,marksmanship,49,31,18
Scourgesurge,kiljaeden,1470,hunter,marksmanship,42,21,21
Sagadegêmeos,stormrage,1465,hunter,marksmanship,48,16,32
Lowlore,moon-guard,1463,hunter,marksmanship,96,52,44
Tóri,emerald-dream,1445,hunter,marksmanship,47,25,22
Chï,zuljin,1442,hunter,marksmanship,97,49,48
Hemathios,drakkari,1442,hunter,marksmanship,50,21,29
Ssdslol,bleeding-hollow,1437,hunter,marksmanship,79,48,31
Shatterwax,area-52,1435,hunter,marksmanship,30,15,15
Pokcmvmxckm,senjin,1433,hunter,marksmanship,66,35,31
Crazyeasy,azshara,1431,hunter,marksmanship,30,15,15
Lewanker,zuljin,1429,hunter,marksmanship,36,20,16
Nelosi,shadowmoon,1427,hunter,marksmanship,42,18,24
Lokuhzmarcus,goldrinn,1423,hunter,marksmanship,54,30,24
Leucis,cenarius,1420,hunter,marksmanship,18,15,3
Lederniertra,gorefiend,1416,hunter,marksmanship,71,35,36
Boombob,sargeras,1415,hunter,marksmanship,53,24,29
Cashhapp,zuljin,1413,hunter,marksmanship,111,58,53
Zasnar,malganis,1413,hunter,marksmanship,30,15,15
Aimz,zuluhed,1411,hunter,marksmanship,67,26,41
Vergillx,ragnaros,1409,hunter,marksmanship,74,45,29
Klannis,quelthalas,1409,hunter,marksmanship,42,19,23
Malebolick,ragnaros,1409,hunter,marksmanship,59,25,34
Ryukuzen,tichondrius,1409,hunter,marksmanship,36,15,21
Pwnagraphic,barthilas,1407,hunter,marksmanship,64,25,39
Banshee,frostmourne,1404,hunter,marksmanship,22,16,6
Voidmarksman,whisperwind,1404,hunter,marksmanship,49,30,19
Automatic,illidan,1402,hunter,marksmanship,42,19,23
Kronicbeast,bleeding-hollow,1399,hunter,marksmanship,90,40,50
Boggartt,ragnaros,1398,hunter,marksmanship,36,15,21
Ashx,khazgoroth,1392,hunter,marksmanship,30,15,15
Braxigarr,area-52,1392,hunter,marksmanship,196,95,101
Insulin,moonrunner,1390,hunter,marksmanship,36,17,19
Rockenrique,nemesis,1390,hunter,marksmanship,36,16,20
Mèseeks,bleeding-hollow,1388,hunter,marksmanship,24,15,9
ßeãst,bladefist,1387,hunter,marksmanship,24,16,8
Maia,frostwolf,1387,hunter,marksmanship,36,15,21
Trapshawty,darkspear,1382,hunter,marksmanship,36,15,21
Deliond,moon-guard,1380,hunter,marksmanship,30,15,15
Idiiot,sargeras,1376,hunter,marksmanship,44,22,22
Húntingarrow,area-52,1373,hunter,marksmanship,72,36,36
Leshwi,ragnaros,1370,hunter,marksmanship,47,23,24
Ripmytoast,chogall,1368,hunter,marksmanship,121,71,50
Lukhas,moon-guard,1367,hunter,marksmanship,60,24,36
Blackhuntr,garona,1364,hunter,marksmanship,107,57,50
Chokemescara,stormrage,1364,hunter,marksmanship,36,16,20
Staticarrow,norgannon,1363,hunter,marksmanship,42,17,25
Jumaanji,gurubashi,1362,hunter,marksmanship,70,36,34
Bowinc,greymane,1357,hunter,marksmanship,24,15,9
Benme,illidan,1357,hunter,marksmanship,162,73,89
Pleyadez,drakkari,1356,hunter,marksmanship,42,24,18
Dnicee,stormrage,1351,hunter,marksmanship,30,23,7
Watchmanjoe,grizzly-hills,1350,hunter,marksmanship,54,30,24
Uwuessy,illidan,1348,hunter,marksmanship,66,30,36
Kyukon,illidan,1345,hunter,marksmanship,36,18,18
Diisdik,tichondrius,1344,hunter,marksmanship,51,23,28
Gorîlla,sargeras,1344,hunter,marksmanship,48,21,27
Mariaassjx,ragnaros,1344,hunter,marksmanship,54,20,34
Tren,blackrock,1342,hunter,marksmanship,24,14,10
Takeiya,zuljin,1342,hunter,marksmanship,24,14,10
Hurstt,kelthuzad,1341,hunter,marksmanship,56,27,29
Glediator,tichondrius,1339,hunter,marksmanship,100,47,53
Toniic,moon-guard,1337,hunter,marksmanship,54,33,21
Orgpopeyes,illidan,1336,hunter,marksmanship,24,14,10
Dvei,silvermoon,1336,hunter,marksmanship,57,25,32
Legeye,malganis,1332,hunter,marksmanship,30,14,16
Azaz,khaz-modan,1332,hunter,marksmanship,54,25,29
Thebweh,ragnaros,1331,hunter,marksmanship,30,14,16
Hukkx,kalecgos,1325,hunter,marksmanship,44,19,25
Dathunterr,azralon,1325,hunter,marksmanship,65,28,37
Softhunter,tichondrius,1324,hunter,marksmanship,36,14,22
Tonnyfab,ragnaros,1323,hunter,marksmanship,23,16,7
Tristiae,stormrage,1319,hunter,marksmanship,65,35,30
Péppérmínt,korgath,1318,hunter,marksmanship,22,15,7
Dogezandalar,illidan,1317,hunter,marksmanship,40,18,22
Explosief,area-52,1315,hunter,marksmanship,60,30,30
Cholohippie,blackrock,1315,hunter,marksmanship,37,17,20
Ricas,malganis,1315,hunter,marksmanship,98,44,54
Condorexe,illidan,1307,hunter,marksmanship,72,28,44
Rekshot,amanthul,1306,hunter,marksmanship,150,73,77
Snewboy,malganis,1299,hunter,marksmanship,24,14,10
Celph,moon-guard,1299,hunter,marksmanship,48,20,28
Gunther,korgath,1296,hunter,marksmanship,30,14,16
Markymarc,tichondrius,1294,hunter,marksmanship,35,14,21
Krattøs,bleeding-hollow,1293,hunter,marksmanship,34,16,18
Swolfp,tichondrius,1291,hunter,marksmanship,40,16,24
Gor,hyjal,1291,hunter,marksmanship,35,14,21
Renzô,sargeras,1289,hunter,marksmanship,27,16,11
Gstring,kelthuzad,1289,hunter,marksmanship,72,30,42
Albe,azralon,1288,hunter,marksmanship,65,31,34
Shadowhokage,zuljin,1286,hunter,marksmanship,30,14,16
Kalibah,azralon,1285,hunter,marksmanship,81,30,51
Hoboh,illidan,1284,hunter,marksmanship,77,34,43
Toowizeë,barthilas,1284,hunter,marksmanship,35,14,21
Seenobody,stormrage,1283,hunter,marksmanship,83,44,39
Smokabombom,eredar,1281,hunter,marksmanship,28,15,13
Gromtheponch,area-52,1280,hunter,marksmanship,41,21,20
Xephert,ragnaros,1280,hunter,marksmanship,36,17,19
Rawrzy,sargeras,1278,hunter,marksmanship,29,14,15
Bojob,azgalor,1275,hunter,marksmanship,51,26,25
Sniperarmy,dalaran,1274,hunter,marksmanship,103,52,51
Darylovejr,destromath,1274,hunter,marksmanship,38,16,22
Spyhunter,malganis,1266,hunter,marksmanship,67,28,39
Ëzy,frostmourne,1263,hunter,marksmanship,36,22,14
Smoothbrain,khadgar,1261,hunter,marksmanship,46,16,30
Ilovehippos,laughing-skull,1259,hunter,marksmanship,139,67,72
Cloudbuck,aegwynn,1258,hunter,marksmanship,52,18,34
Urtthel,stormrage,1257,hunter,marksmanship,25,15,10
Lightweight,kelthuzad,1257,hunter,marksmanship,47,22,25
Ahegoface,frostmourne,1256,hunter,marksmanship,42,14,28
Jerybery,gundrak,1253,hunter,marksmanship,29,18,11
Ärtémisa,quelthalas,1251,hunter,marksmanship,24,14,10
Tánsøxøxø,tichondrius,1246,hunter,marksmanship,30,13,17
Duruainn,zuljin,1245,hunter,marksmanship,73,33,40
Hoeswannafuk,stormrage,1243,hunter,marksmanship,24,13,11
Vipermaster,azralon,1243,hunter,marksmanship,46,24,22
Oattes,daggerspine,1243,hunter,marksmanship,30,13,17
Hogshanks,moon-guard,1242,hunter,marksmanship,24,13,11
Mizhu,ragnaros,1242,hunter,marksmanship,36,17,19
Artemyzz,tichondrius,1241,hunter,marksmanship,24,13,11
Mensrea,illidan,1240,hunter,marksmanship,35,22,13
Rudekeef,illidan,1240,hunter,marksmanship,24,13,11
Lafleche,kiljaeden,1239,hunter,marksmanship,29,15,14
Hunimi,elune,1237,hunter,marksmanship,32,14,18
Valimhir,tichondrius,1237,hunter,marksmanship,30,13,17
Birgite,stormrage,1237,hunter,marksmanship,48,17,31
Sootgarbage,sargeras,1235,hunter,marksmanship,18,13,5
Pokeyourbutt,hydraxis,1235,hunter,marksmanship,24,13,11
Killz,skullcrusher,1234,hunter,marksmanship,44,21,23
Wìllòw,khazgoroth,1234,hunter,marksmanship,30,13,17
Chikkynuggy,destromath,1228,hunter,marksmanship,33,14,19
Fuzzypjs,stormrage,1226,hunter,marksmanship,33,14,19
Mezmore,thrall,1223,hunter,marksmanship,48,23,25
Raneldar,proudmoore,1223,hunter,marksmanship,42,14,28
Targetreaper,proudmoore,1215,hunter,marksmanship,24,13,11
Sukr,korgath,1215,hunter,marksmanship,98,37,61
Give,draktharon,1214,hunter,marksmanship,33,14,19
Puresport,hyjal,1212,hunter,marksmanship,24,13,11
Kritsu,tichondrius,1209,hunter,marksmanship,41,20,21
Augus,eredar,1207,hunter,marksmanship,30,13,17
Cocobread,stormreaver,1207,hunter,marksmanship,42,16,26
Apaweclover,stormrage,1206,hunter,marksmanship,155,74,81
Vinranya,sargeras,1194,hunter,marksmanship,75,34,41
Chaðs,amanthul,1190,hunter,marksmanship,39,21,18
Kayzia,lightninghoof,1190,hunter,marksmanship,29,13,16
Bluecoral,frostmourne,1189,hunter,marksmanship,51,21,30
Valieev,black-dragonflight,1188,hunter,marksmanship,36,22,14
Forthethrill,area-52,1187,hunter,marksmanship,45,24,21
Oopsurtrappd,darkspear,1186,hunter,marksmanship,29,16,13
Zock,lothar,1184,hunter,marksmanship,80,38,42
Fova,wyrmrest-accord,1179,hunter,marksmanship,19,14,5
Chïnchïlla,zuljin,1176,hunter,marksmanship,21,14,7
Floozyfairy,daggerspine,1176,hunter,marksmanship,35,18,17
Huntonthic,korgath,1176,hunter,marksmanship,32,14,18
Rocroc,gurubashi,1175,hunter,marksmanship,66,29,37
Silverweaver,illidan,1174,hunter,marksmanship,30,15,15
Elendïr,tichondrius,1174,hunter,marksmanship,30,13,17
Aftërlyfe,tichondrius,1170,hunter,marksmanship,29,14,15
Calî,stormscale,1167,hunter,marksmanship,24,13,11
Ackzar,ragnaros,1166,hunter,marksmanship,51,27,24
Moüserat,moon-guard,1162,hunter,marksmanship,114,55,59
Primalus,tichondrius,1152,hunter,marksmanship,18,12,6
Negãn,tichondrius,1151,hunter,marksmanship,24,12,12
Hunterlist,frostmourne,1151,hunter,marksmanship,24,12,12
Spiketurtle,queldorei,1148,hunter,marksmanship,30,13,17
Ocromiun,illidan,1146,hunter,marksmanship,39,13,26
Rubinaldo,azralon,1145,hunter,marksmanship,24,12,12
Yadír,quelthalas,1145,hunter,marksmanship,48,22,26
Plopslopper,frostmourne,1142,hunter,marksmanship,24,12,12
Inability,emerald-dream,1142,hunter,marksmanship,30,12,18
Sugarboyy,darkspear,1141,hunter,marksmanship,30,14,16
Alindra,zuluhed,1141,hunter,marksmanship,60,25,35
Tenlbbow,illidan,1137,hunter,marksmanship,24,12,12
Ghudi,moon-guard,1135,hunter,marksmanship,20,12,8
Cßo,tichondrius,1135,hunter,marksmanship,60,27,33
Vhan,azralon,1133,hunter,marksmanship,44,19,25
Shooterzz,illidan,1132,hunter,marksmanship,18,12,6
Caylix,sargeras,1132,hunter,marksmanship,30,12,18
Jarloo,madoran,1129,hunter,marksmanship,35,19,16
Bigolhippy,frostmourne,1129,hunter,marksmanship,24,12,12
Táká,quelthalas,1129,hunter,marksmanship,30,13,17
Malkuri,medivh,1127,hunter,marksmanship,29,12,17
Kánnah,ragnaros,1126,hunter,marksmanship,120,63,57
Clockwörk,sargeras,1125,hunter,marksmanship,21,13,8
Tiofil,goldrinn,1124,hunter,marksmanship,24,14,10
Oqqo,tichondrius,1123,hunter,marksmanship,45,18,27
Bowdown,moon-guard,1119,hunter,marksmanship,36,18,18
Linedalina,wyrmrest-accord,1119,hunter,marksmanship,30,14,16
Wixyy,aegwynn,1114,hunter,marksmanship,58,23,35
Killincrew,scilla,1112,hunter,marksmanship,26,13,13
Grimbleneep,emerald-dream,1111,hunter,marksmanship,40,16,24
Repotro,drakkari,1108,hunter,marksmanship,42,14,28
Halibut,quelthalas,1106,hunter,marksmanship,47,25,22
Bemaa,frostmourne,1106,hunter,marksmanship,42,21,21
Rykár,kiljaeden,1106,hunter,marksmanship,24,12,12
Týrak,illidan,1100,hunter,marksmanship,24,12,12
Critaclyzm,moon-guard,1100,hunter,marksmanship,30,12,18
Bentrick,altar-of-storms,1097,hunter,marksmanship,33,18,15
Grànd,tortheldrin,1096,hunter,marksmanship,23,12,11
Udietofast,illidan,1092,hunter,marksmanship,77,31,46
Veranir,nemesis,1091,hunter,marksmanship,98,49,49
Malo,dragonmaw,1090,hunter,marksmanship,30,16,14
Angelacross,azralon,1087,hunter,marksmanship,54,26,28
Maxwel,sargeras,1082,hunter,marksmanship,175,86,89
Lezzbow,tichondrius,1081,hunter,marksmanship,61,32,29
Foxhe,hyjal,1081,hunter,marksmanship,30,14,16
Katebishop,nemesis,1071,hunter,marksmanship,22,12,10
Thoopered,korgath,1062,hunter,marksmanship,65,33,32
Piloks,gallywix,1058,hunter,marksmanship,36,17,19
Imperatrix,emerald-dream,1058,hunter,marksmanship,72,25,47
Gvjellybeans,tichondrius,1056,hunter,marksmanship,18,11,7
Ryutiz,fizzcrank,1056,hunter,marksmanship,30,11,19
Redzic,tichondrius,1054,hunter,marksmanship,18,11,7
Landon,lightnings-blade,1054,hunter,marksmanship,24,11,13
Aoolfs,stormrage,1054,hunter,marksmanship,30,12,18
Inktray,durotan,1054,hunter,marksmanship,30,11,19
Wockqt,kiljaeden,1053,hunter,marksmanship,24,11,13
Nelandris,tichondrius,1053,hunter,marksmanship,54,24,30
Longshánks,stormrage,1052,hunter,marksmanship,24,11,13
Mathund,gurubashi,1052,hunter,marksmanship,89,37,52
Shootipie,hyjal,1051,hunter,marksmanship,18,11,7
Blimpbooty,stormrage,1050,hunter,marksmanship,24,11,13
Kalinor,cenarius,1049,hunter,marksmanship,36,17,19
Balun,sargeras,1049,hunter,marksmanship,24,11,13
Vansatih,azralon,1047,hunter,marksmanship,66,27,39
Amanazàra,tichondrius,1046,hunter,marksmanship,18,11,7
Fëanora,quelthalas,1044,hunter,marksmanship,24,11,13
Chainmaster,misha,1041,hunter,marksmanship,80,37,43
Corruptid,moon-guard,1039,hunter,marksmanship,18,11,7
Tazent,moon-guard,1039,hunter,marksmanship,24,11,13
Deadalot,dalaran,1038,hunter,marksmanship,18,11,7
Porkerr,black-dragonflight,1038,hunter,marksmanship,42,22,20
Yoimiya,thunderlord,1036,hunter,marksmanship,41,18,23
Baldor,stormrage,1036,hunter,marksmanship,66,27,39
Sartros,drakkari,1034,hunter,marksmanship,19,13,6
Huntnfizzle,dethecus,1031,hunter,marksmanship,18,11,7
Clemenlemon,illidan,1029,hunter,marksmanship,18,11,7
Vendortrash,aggramar,1029,hunter,marksmanship,24,12,12
Silenciozzo,azralon,1026,hunter,marksmanship,42,17,25
Balgair,hakkar,1019,hunter,marksmanship,40,22,18
Flacidhunter,kelthuzad,1017,hunter,marksmanship,30,12,18
Shukucingjr,illidan,1015,hunter,marksmanship,39,23,16
Madogite,azralon,1014,hunter,marksmanship,60,34,26
Secure,doomhammer,1014,hunter,marksmanship,30,12,18
Kødran,stormrage,1013,hunter,marksmanship,48,23,25
Jzander,ragnaros,1010,hunter,marksmanship,20,13,7
Thyraza,proudmoore,1010,hunter,marksmanship,24,11,13
Triggaplease,jubeithos,1008,hunter,marksmanship,67,37,30
Killerxzxz,stormrage,1007,hunter,marksmanship,24,13,11
Aïmïng,tichondrius,1006,hunter,marksmanship,24,11,13
Brenri,boulderfist,1003,hunter,marksmanship,30,15,15
Torturekilla,bleeding-hollow,1003,hunter,marksmanship,54,26,28
Koonorc,dalaran,998,hunter,marksmanship,46,22,24
Iililillilii,tichondrius,998,hunter,marksmanship,26,12,14
Xaveco,gallywix,995,hunter,marksmanship,40,16,24
Scottcrume,area-52,990,hunter,marksmanship,60,27,33
Nelay,ragnaros,988,hunter,marksmanship,23,11,12
Ritler,frostmourne,987,hunter,marksmanship,21,11,10
Àbyss,shandris,982,hunter,marksmanship,42,15,27
Fourkayiv,azgalor,971,hunter,marksmanship,29,16,13
Tiidkloul,illidan,968,hunter,marksmanship,18,12,6
Ontarget,cairne,968,hunter,marksmanship,52,24,28
Reanivan,kiljaeden,968,hunter,marksmanship,66,24,42
Drjingajanga,zuluhed,961,hunter,marksmanship,33,13,20
Hanabanana,wyrmrest-accord,960,hunter,marksmanship,12,10,2
Nainit,sargeras,960,hunter,marksmanship,18,10,8
Zota,frostmourne,960,hunter,marksmanship,18,10,8
Goonsh,tichondrius,960,hunter,marksmanship,18,10,8
Dudemanyeah,skullcrusher,960,hunter,marksmanship,24,10,14
Taumelz,sargeras,960,hunter,marksmanship,24,10,14
Sylvaa,tichondrius,960,hunter,marksmanship,30,10,20
Ñðñdêsçrípt,frostmourne,959,hunter,marksmanship,30,10,20
Austelos,moon-guard,958,hunter,marksmanship,18,10,8
Lilnatty,area-52,958,hunter,marksmanship,27,11,16
Maximos,lightnings-blade,958,hunter,marksmanship,30,10,20
Zeenuts,sargeras,957,hunter,marksmanship,18,10,8
Tup,guldan,956,hunter,marksmanship,18,10,8
Dartháne,moon-guard,956,hunter,marksmanship,29,11,18
Grimcask,ragnaros,955,hunter,marksmanship,24,10,14
Hawkeyë,ragnaros,954,hunter,marksmanship,18,10,8
Zettl,eredar,954,hunter,marksmanship,45,19,26
Daymanaahh,malfurion,954,hunter,marksmanship,24,10,14
Salsa,hakkar,954,hunter,marksmanship,54,12,42
Twist,burning-legion,953,hunter,marksmanship,12,10,2
Skelyeelegno,perenolde,953,hunter,marksmanship,18,10,8
Damadar,tichondrius,953,hunter,marksmanship,24,10,14
Verdao,stormrage,952,hunter,marksmanship,30,10,20
Xhartanis,magtheridon,950,hunter,marksmanship,24,10,14
Sumom,darrowmere,950,hunter,marksmanship,66,26,40
Wwing,frostwolf,949,hunter,marksmanship,192,92,100
Moonet,amanthul,948,hunter,marksmanship,18,10,8
Vanhe,quelthalas,947,hunter,marksmanship,18,10,8
Milktoker,tichondrius,947,hunter,marksmanship,24,10,14
Globlauncher,tichondrius,946,hunter,marksmanship,18,10,8
Yamanashi,black-dragonflight,945,hunter,marksmanship,102,51,51
Lauannÿ,gallywix,944,hunter,marksmanship,106,49,57
Lazygnome,azshara,934,hunter,marksmanship,17,11,6
Zarely,frostmourne,932,hunter,marksmanship,24,10,14
Jamzlol,frostmourne,930,hunter,marksmanship,23,14,9
Katnie,azralon,928,hunter,marksmanship,40,18,22
Thundershots,tichondrius,927,hunter,marksmanship,62,23,39
Silhouettes,barthilas,923,hunter,marksmanship,27,13,14
Wael,perenolde,920,hunter,marksmanship,29,10,19
Onehitrip,illidan,918,hunter,marksmanship,84,36,48
Adbéélitø,ragnaros,913,hunter,marksmanship,18,10,8
Zievieda,hellscream,910,hunter,marksmanship,24,12,12
Sunnimuffens,deathwing,906,hunter,marksmanship,23,10,13
Nachtcloverr,stormrage,906,hunter,marksmanship,57,23,34
Blaws,tichondrius,906,hunter,marksmanship,27,10,17
Flechá,illidan,900,hunter,marksmanship,17,10,7
Desolateone,nazgrel,900,hunter,marksmanship,42,21,21
Déadlyshot,tichondrius,900,hunter,marksmanship,77,36,41
Huntercotoco,azralon,894,hunter,marksmanship,47,24,23
Brenogam,azralon,884,hunter,marksmanship,33,16,17
Alleessa,goldrinn,883,hunter,marksmanship,54,21,33
Jetlinx,thrall,881,hunter,marksmanship,21,12,9
Nightwatch,kelthuzad,877,hunter,marksmanship,18,10,8
Rödrigö,azralon,876,hunter,marksmanship,30,14,16
Galaxxis,bonechewer,868,hunter,marksmanship,46,22,24
Karazuba,ragnaros,865,hunter,marksmanship,89,33,56
Comebacks,ragnaros,864,hunter,marksmanship,18,9,9
Bootywhop,dalaran,864,hunter,marksmanship,18,9,9
Eratichunt,illidan,864,hunter,marksmanship,18,9,9
Hunghang,frostmourne,864,hunter,marksmanship,24,9,15
Keenz,frostmourne,864,hunter,marksmanship,24,9,15
Drãgenox,quelthalas,864,hunter,marksmanship,24,9,15
Topshotx,tichondrius,863,hunter,marksmanship,12,9,3
Rambot,bleeding-hollow,863,hunter,marksmanship,12,9,3
Photos,moon-guard,863,hunter,marksmanship,14,9,5
Pkn,chogall,863,hunter,marksmanship,18,9,9
Mehontar,area-52,863,hunter,marksmanship,18,9,9
Torrthack,area-52,863,hunter,marksmanship,18,9,9
Ultrasj,malfurion,863,hunter,marksmanship,18,9,9
Telånnas,illidan,863,hunter,marksmanship,18,9,9
Dayanier,ragnaros,863,hunter,marksmanship,18,9,9
Dôntlosmebro,stormrage,863,hunter,marksmanship,18,9,9
Nosmoke,kargath,863,hunter,marksmanship,24,9,15
Junglejam,elune,863,hunter,marksmanship,24,9,15
Fangs,arthas,862,hunter,marksmanship,12,9,3
Airpodpro,emerald-dream,862,hunter,marksmanship,12,9,3
Audioannie,thrall,862,hunter,marksmanship,18,9,9
Syrach,area-52,862,hunter,marksmanship,18,9,9
Mídnîght,azralon,862,hunter,marksmanship,18,9,9
Varrinda,wyrmrest-accord,862,hunter,marksmanship,24,9,15
Insgesicht,proudmoore,862,hunter,marksmanship,24,9,15
Thirià,garona,861,hunter,marksmanship,12,9,3
Snipastyle,twisting-nether,861,hunter,marksmanship,30,9,21
Twistedtawl,area-52,860,hunter,marksmanship,18,9,9
Junka,bleeding-hollow,860,hunter,marksmanship,18,9,9
Bomomatic,zuljin,860,hunter,marksmanship,18,9,9
Loyalrely,tichondrius,859,hunter,marksmanship,18,9,9
Arzant,quelthalas,858,hunter,marksmanship,12,9,3
Coldhunger,uldum,857,hunter,marksmanship,12,9,3
Trikshot,magtheridon,855,hunter,marksmanship,18,10,8
Azx,tichondrius,851,hunter,marksmanship,18,9,9
Avindal,greymane,850,hunter,marksmanship,18,9,9
Trìggered,dark-iron,849,hunter,marksmanship,18,9,9
Ganeva,sargeras,846,hunter,marksmanship,18,10,8
Kazzanval,sargeras,843,hunter,marksmanship,18,9,9
Apochuntz,greymane,839,hunter,marksmanship,24,11,13
Zelanst,illidan,838,hunter,marksmanship,18,9,9
Muggzzy,malygos,824,hunter,marksmanship,18,9,9
Kuramax,senjin,810,hunter,marksmanship,59,23,36
Iamtotoro,area-52,809,hunter,marksmanship,28,9,19
Babyhydra,frostmourne,799,hunter,marksmanship,17,9,8
Myrfes,ragnaros,797,hunter,marksmanship,22,9,13
Fian,lightnings-blade,797,hunter,marksmanship,22,9,13
Cu,frostmourne,783,hunter,marksmanship,13,9,4
Thaendra,moon-guard,781,hunter,marksmanship,17,9,8
Skyloss,illidan,775,hunter,marksmanship,42,12,30
Ragshunt,stormrage,768,hunter,marksmanship,12,8,4
Doves,wyrmrest-accord,768,hunter,marksmanship,12,8,4
Ashx,nemesis,768,hunter,marksmanship,12,8,4
Headshoot,tichondrius,768,hunter,marksmanship,12,8,4
Achillez,bleeding-hollow,768,hunter,marksmanship,18,8,10
Tyrmaakk,emerald-dream,768,hunter,marksmanship,18,8,10
Astolenis,quelthalas,768,hunter,marksmanship,22,8,14
Soul,sargeras,768,hunter,marksmanship,24,8,16
Civvo,dalaran,768,hunter,marksmanship,24,8,16
Woeisyou,stormrage,768,hunter,marksmanship,24,8,16
Cimotsw,stormrage,767,hunter,marksmanship,12,8,4
Suyesh,tichondrius,767,hunter,marksmanship,12,8,4
Huntnmaster,thrall,767,hunter,marksmanship,12,8,4
Booyakah,hyjal,767,hunter,marksmanship,12,8,4
Yory,tol-barad,767,hunter,marksmanship,18,8,10
Mensita,quelthalas,767,hunter,marksmanship,18,8,10
Ravanskull,burning-blade,767,hunter,marksmanship,18,8,10
Vileplumè,stormrage,767,hunter,marksmanship,18,8,10
Cufless,proudmoore,767,hunter,marksmanship,18,8,10
Xtina,drakkari,767,hunter,marksmanship,18,8,10
Saltz,tichondrius,766,hunter,marksmanship,12,8,4
Juicyjams,moon-guard,766,hunter,marksmanship,12,8,4
Ladright,altar-of-storms,766,hunter,marksmanship,18,8,10
Zèd,azralon,766,hunter,marksmanship,18,8,10
Trochillidae,dragonmaw,766,hunter,marksmanship,18,8,10
Deathspot,thrall,766,hunter,marksmanship,18,8,10
Raiku,aggramar,766,hunter,marksmanship,18,8,10
Stupidgodx,tichondrius,766,hunter,marksmanship,18,8,10
Picaubica,kiljaeden,766,hunter,marksmanship,24,8,16
Daahm,malganis,765,hunter,marksmanship,25,8,17
Taynen,azralon,764,hunter,marksmanship,18,8,10
Myciri,proudmoore,764,hunter,marksmanship,18,8,10
Drillklinton,tichondrius,764,hunter,marksmanship,22,9,13
Herroo,thrall,764,hunter,marksmanship,24,8,16
Rattrap,proudmoore,763,hunter,marksmanship,24,8,16
Kluako,stormreaver,762,hunter,marksmanship,12,8,4
Thisguÿ,arthas,762,hunter,marksmanship,18,8,10
Buckethole,doomhammer,762,hunter,marksmanship,18,8,10
Sorid,medivh,761,hunter,marksmanship,12,8,4
Enonoa,thunderlord,760,hunter,marksmanship,12,8,4
Heapstack,stormrage,753,hunter,marksmanship,18,8,10
Huntercry,ragnaros,751,hunter,marksmanship,12,8,4
Niceshotboi,azgalor,751,hunter,marksmanship,24,8,16
Arshuntica,blackrock,750,hunter,marksmanship,18,8,10
Lynnì,khadgar,750,hunter,marksmanship,18,8,10
Xshadowdemon,korgath,749,hunter,marksmanship,12,8,4
Aksalaz,area-52,749,hunter,marksmanship,17,8,9
Belieli,ragnaros,740,hunter,marksmanship,22,8,14
Mackin,maelstrom,740,hunter,marksmanship,24,8,16
Volga,haomarush,733,hunter,marksmanship,16,8,8
Netorip,azralon,718,hunter,marksmanship,15,8,7
Mikeangel,hydraxis,718,hunter,marksmanship,21,8,13
Lookøut,moon-guard,713,hunter,marksmanship,32,10,22
Jvmr,azralon,704,hunter,marksmanship,20,9,11
Andalora,malganis,703,hunter,marksmanship,11,8,3
Llachiip,zuljin,702,hunter,marksmanship,17,9,8
Fizzleshot,malganis,699,hunter,marksmanship,17,8,9
Delukzin,azralon,695,hunter,marksmanship,26,8,18
Felkrozzul,kalecgos,672,hunter,marksmanship,9,8,1
Hyrus,shadowmoon,672,hunter,marksmanship,12,7,5
Kookh,area-52,672,hunter,marksmanship,12,7,5
Mörgoth,quelthalas,672,hunter,marksmanship,12,7,5
Enty,khazgoroth,672,hunter,marksmanship,12,7,5
Drupert,tichondrius,672,hunter,marksmanship,12,7,5
Ehnub,stormrage,672,hunter,marksmanship,12,7,5
Mms,frostmourne,672,hunter,marksmanship,12,7,5
Shotmaster,tichondrius,672,hunter,marksmanship,12,7,5
Timmee,bleeding-hollow,672,hunter,marksmanship,12,7,5
Kaznik,ragnaros,672,hunter,marksmanship,12,7,5
Keboks,alleria,672,hunter,marksmanship,12,7,5
Kagaramar,hellscream,672,hunter,marksmanship,15,8,7
Mochaxd,stormrage,672,hunter,marksmanship,14,7,7
Focusfire,khazgoroth,672,hunter,marksmanship,18,7,11
Vonkrieg,tichondrius,672,hunter,marksmanship,18,7,11
Bigzane,darkspear,672,hunter,marksmanship,24,7,17
Datbigbowdoe,illidan,672,hunter,marksmanship,24,7,17
Neoxbow,wyrmrest-accord,671,hunter,marksmanship,12,7,5
Hannover,ragnaros,671,hunter,marksmanship,12,7,5
Dest,azralon,671,hunter,marksmanship,12,7,5
Illt,blackrock,671,hunter,marksmanship,12,7,5
Getnukedbud,emerald-dream,671,hunter,marksmanship,12,7,5
Geraldson,proudmoore,671,hunter,marksmanship,12,7,5
Sunyourmom,proudmoore,671,hunter,marksmanship,12,7,5
Xhare,stormrage,671,hunter,marksmanship,12,7,5
Ethne,garithos,671,hunter,marksmanship,12,7,5
Larree,kelthuzad,671,hunter,marksmanship,12,7,5
Ocui,ragnaros,671,hunter,marksmanship,12,7,5
Vatits,dalaran,671,hunter,marksmanship,12,7,5
Texploto,area-52,671,hunter,marksmanship,12,7,5
Zhions,ragnaros,671,hunter,marksmanship,12,7,5
Solomine,jubeithos,671,hunter,marksmanship,18,7,11
Schbaltz,tichondrius,671,hunter,marksmanship,18,7,11
Såvagehunter,malganis,671,hunter,marksmanship,18,7,11
Sï,anubarak,671,hunter,marksmanship,18,7,11
Kaeuljua,tichondrius,671,hunter,marksmanship,18,7,11
Glittergun,sargeras,671,hunter,marksmanship,18,7,11
Jackrandall,frostmourne,671,hunter,marksmanship,18,7,11
Löbo,quelthalas,671,hunter,marksmanship,18,7,11
Chuvug,quelthalas,671,hunter,marksmanship,18,7,11
Toesgoes,thrall,671,hunter,marksmanship,18,7,11
Kalizra,quelthalas,671,hunter,marksmanship,18,7,11
Navagee,tichondrius,671,hunter,marksmanship,18,7,11
Lyricly,lightbringer,671,hunter,marksmanship,18,7,11
Sáns,sargeras,671,hunter,marksmanship,18,7,11
Cullowhee,proudmoore,671,hunter,marksmanship,23,7,16
Temara,icecrown,671,hunter,marksmanship,24,7,17
Joogeenda,kaelthas,670,hunter,marksmanship,12,7,5
Wolfyyxx,stormrage,670,hunter,marksmanship,18,7,11
Gagau,stormrage,670,hunter,marksmanship,18,7,11
Westbrooke,illidan,669,hunter,marksmanship,18,7,11
Lilzoomer,barthilas,668,hunter,marksmanship,12,7,5
Minzuki,drakkari,668,hunter,marksmanship,18,7,11
Emeri,winterhoof,667,hunter,marksmanship,12,7,5
Mahty,stormrage,665,hunter,marksmanship,12,7,5
Konar,nemesis,656,hunter,marksmanship,30,7,23
Righthole,area-52,640,hunter,marksmanship,22,7,15
Mawlotov,barthilas,639,hunter,marksmanship,23,7,16
Pikochon,illidan,637,hunter,marksmanship,23,7,16
Muerteaterry,ragnaros,618,hunter,marksmanship,18,8,10
Mesiauzx,stormrage,618,hunter,marksmanship,22,9,13
Butimbutters,bleeding-hollow,617,hunter,marksmanship,22,8,14
Typh,saurfang,607,hunter,marksmanship,11,7,4
Hokutoxx,tichondrius,607,hunter,marksmanship,20,7,13
Kushminion,zuljin,592,hunter,marksmanship,13,8,5
Krossx,thrall,591,hunter,marksmanship,12,7,5
Summerrain,illidan,576,hunter,marksmanship,6,6,0
Rizzbow,dalvengyr,576,hunter,marksmanship,12,6,6
Spanerd,moon-guard,576,hunter,marksmanship,12,6,6
Rangêr,frostmourne,576,hunter,marksmanship,12,6,6
Gugubird,proudmoore,576,hunter,marksmanship,12,6,6
Gq,garona,576,hunter,marksmanship,12,6,6
Elmozz,thrall,576,hunter,marksmanship,12,6,6
Booffmeister,area-52,576,hunter,marksmanship,12,6,6
Blaðe,kelthuzad,576,hunter,marksmanship,12,6,6
Kyudo,moon-guard,576,hunter,marksmanship,12,6,6
Islachan,ragnaros,576,hunter,marksmanship,12,6,6
Mochigelato,kelthuzad,576,hunter,marksmanship,12,6,6
Groomme,area-52,576,hunter,marksmanship,12,6,6
Mhd,stormrage,576,hunter,marksmanship,12,6,6
Êlautismo,wyrmrest-accord,576,hunter,marksmanship,12,6,6
Vicecheney,illidan,576,hunter,marksmanship,12,6,6
Throre,bleeding-hollow,576,hunter,marksmanship,12,6,6
Juwannaaim,lethon,576,hunter,marksmanship,12,6,6
Jeezyxxii,shadowmoon,576,hunter,marksmanship,12,6,6
Kimbaa,tichondrius,576,hunter,marksmanship,12,6,6
Pulso,illidan,576,hunter,marksmanship,12,6,6
Zaamsa,ragnaros,576,hunter,marksmanship,12,6,6
Gritzix,frostmourne,576,hunter,marksmanship,12,6,6
Flämma,azralon,576,hunter,marksmanship,12,6,6
Ssds,sargeras,576,hunter,marksmanship,12,6,6
Birbwatcher,moon-guard,576,hunter,marksmanship,12,6,6
Laurenx,illidan,576,hunter,marksmanship,12,6,6
Aoti,nerzhul,576,hunter,marksmanship,12,6,6
Murderone,undermine,576,hunter,marksmanship,12,6,6
Tokez,moon-guard,576,hunter,marksmanship,14,6,8
Boomphaque,ravencrest,576,hunter,marksmanship,18,6,12
Gnometoprace,illidan,576,hunter,marksmanship,18,6,12
Tandope,sargeras,576,hunter,marksmanship,18,6,12
Aaggros,sargeras,576,hunter,marksmanship,18,6,12
Qúin,frostmourne,576,hunter,marksmanship,18,6,12
Jônathan,tichondrius,576,hunter,marksmanship,24,6,18
Dirtbagchaz,illidan,575,hunter,marksmanship,12,6,6
Littlespike,queldorei,575,hunter,marksmanship,12,6,6
Brosk,drakthul,575,hunter,marksmanship,12,6,6
Sylvaethas,lightninghoof,575,hunter,marksmanship,12,6,6
Hobbës,kelthuzad,575,hunter,marksmanship,12,6,6
Silentzkill,tichondrius,575,hunter,marksmanship,12,6,6
Onlyfeìgns,frostmourne,575,hunter,marksmanship,12,6,6
Cobrag,tichondrius,575,hunter,marksmanship,12,6,6
Lagginwaggin,azgalor,575,hunter,marksmanship,12,6,6
Aragörnn,azralon,575,hunter,marksmanship,12,6,6
Chipsncheese,korgath,575,hunter,marksmanship,12,6,6
Taphh,moon-guard,575,hunter,marksmanship,12,6,6
Projectilez,sargeras,575,hunter,marksmanship,12,6,6
Lahyanhou,azjolnerub,575,hunter,marksmanship,18,6,12
Tazmaniak,gorefiend,575,hunter,marksmanship,18,6,12
Wolverhino,thrall,575,hunter,marksmanship,18,6,12
Marcusrarnis,zuljin,574,hunter,marksmanship,12,6,6
Hildihunt,stormrage,574,hunter,marksmanship,12,6,6
Zeddunn,stormrage,574,hunter,marksmanship,12,6,6
Blåckhat,frostmourne,573,hunter,marksmanship,30,6,24
Recebaa,barthilas,572,hunter,marksmanship,12,6,6
Returners,emerald-dream,571,hunter,marksmanship,12,6,6
Jogoran,thunderlord,571,hunter,marksmanship,12,6,6
Tungles,tichondrius,570,hunter,marksmanship,24,6,18
Lennfear,frostmourne,568,hunter,marksmanship,18,6,12
Vaelanor,destromath,566,hunter,marksmanship,12,6,6
Beastmodeqt,blood-furnace,566,hunter,marksmanship,18,6,12
Neef,mannoroth,564,hunter,marksmanship,24,6,18
Ratspit,chogall,557,hunter,marksmanship,11,6,5
Wij,turalyon,557,hunter,marksmanship,18,6,12
Gymli,destromath,543,hunter,marksmanship,11,6,5
Jaydemo,thunderhorn,527,hunter,marksmanship,17,6,11
Remixjy,burning-blade,522,hunter,marksmanship,16,7,9
Cns,tichondrius,521,hunter,marksmanship,20,7,13
Jonsnow,lightnings-blade,519,hunter,marksmanship,15,6,9
Dainsleif,perenolde,512,hunter,marksmanship,10,6,4
Tracershot,malganis,511,hunter,marksmanship,14,6,8
Cplski,kelthuzad,511,hunter,marksmanship,16,6,10
Stepbroski,moon-guard,510,hunter,marksmanship,14,6,8
Brainzz,emerald-dream,509,hunter,marksmanship,16,7,9
Chasseür,quelthalas,480,hunter,marksmanship,6,5,1
Moktarg,archimonde,480,hunter,marksmanship,6,5,1
Bendotexe,stormrage,480,hunter,marksmanship,6,5,1
Qthunterr,dalaran,480,hunter,marksmanship,6,5,1
Toxarch,aggramar,480,hunter,marksmanship,6,5,1
Knerf,silvermoon,480,hunter,marksmanship,6,5,1
Taije,arthas,480,hunter,marksmanship,6,5,1
Thrandrial,smolderthorn,480,hunter,marksmanship,6,5,1
Chickenzzack,tichondrius,480,hunter,marksmanship,6,5,1
Kimchishotxo,tichondrius,480,hunter,marksmanship,6,5,1
Shootandloot,zuljin,480,hunter,marksmanship,6,5,1
Idtrapthat,nordrassil,480,hunter,marksmanship,9,5,4
Déadshot,thaurissan,480,hunter,marksmanship,12,5,7
Infamousorc,chogall,480,hunter,marksmanship,12,5,7
Arraza,ragnaros,480,hunter,marksmanship,12,5,7
Josyv,quelthalas,480,hunter,marksmanship,12,5,7
Fjdominador,azralon,480,hunter,marksmanship,12,5,7
Boomheadshot,blood-furnace,480,hunter,marksmanship,12,5,7
Slobon,tichondrius,480,hunter,marksmanship,12,5,7
Kyujin,ragnaros,480,hunter,marksmanship,12,5,7
Lagshots,kelthuzad,480,hunter,marksmanship,12,5,7
Kattarry,moon-guard,480,hunter,marksmanship,12,5,7
Bullzeyê,kelthuzad,480,hunter,marksmanship,12,5,7
Kaelhim,warsong,480,hunter,marksmanship,12,5,7
Xísa,proudmoore,480,hunter,marksmanship,12,5,7
Teaks,aggramar,480,hunter,marksmanship,12,5,7
Jaywuz,tichondrius,480,hunter,marksmanship,12,5,7
Omniquiver,sargeras,480,hunter,marksmanship,12,5,7
Lianm,stormrage,480,hunter,marksmanship,12,5,7
Thewïld,tichondrius,480,hunter,marksmanship,12,5,7
Connora,stormrage,480,hunter,marksmanship,12,5,7
Valro,hyjal,480,hunter,marksmanship,12,5,7
Thejessiah,tichondrius,480,hunter,marksmanship,12,5,7
Snoplow,illidan,480,hunter,marksmanship,12,5,7
Aloa,nagrand,480,hunter,marksmanship,12,5,7
Duckpow,frostmourne,480,hunter,marksmanship,12,5,7
Hunt,the-underbog,480,hunter,marksmanship,12,5,7
Ownshot,kiljaeden,480,hunter,marksmanship,12,5,7
Regretful,kelthuzad,480,hunter,marksmanship,13,5,8
Aueria,kiljaeden,480,hunter,marksmanship,18,5,13
Absinther,emerald-dream,480,hunter,marksmanship,18,5,13
Tarah,lightbringer,480,hunter,marksmanship,18,5,13
Ikiteforfood,zuljin,480,hunter,marksmanship,18,5,13
Blickys,area-52,480,hunter,marksmanship,18,5,13
Eurekasl,ragnaros,480,hunter,marksmanship,18,5,13
Ownyoufast,darkspear,480,hunter,marksmanship,24,5,19
Hishamo,aggramar,479,hunter,marksmanship,6,5,1
Runimurder,zuljin,479,hunter,marksmanship,6,5,1
Globalhunter,emerald-dream,479,hunter,marksmanship,12,5,7
Akomata,emerald-dream,479,hunter,marksmanship,12,5,7
Ëz,ragnaros,479,hunter,marksmanship,12,5,7
Blurrí,area-52,479,hunter,marksmanship,12,5,7
Peitowyn,illidan,479,hunter,marksmanship,12,5,7
Doubletappz,stormrage,479,hunter,marksmanship,12,5,7
Rykbad,area-52,479,hunter,marksmanship,12,5,7
Pathius,uldaman,479,hunter,marksmanship,12,5,7
Papiquezo,nagrand,479,hunter,marksmanship,12,5,7
Ohhsnaapp,blood-furnace,479,hunter,marksmanship,12,5,7
Patmypet,terenas,479,hunter,marksmanship,12,5,7
Diur,ragnaros,479,hunter,marksmanship,15,5,10
Johar,nerzhul,479,hunter,marksmanship,18,5,13
Enzym,archimonde,479,hunter,marksmanship,18,5,13
Seyd,barthilas,479,hunter,marksmanship,18,5,13
Ashaelyn,wyrmrest-accord,479,hunter,marksmanship,18,5,13
Cócaine,tichondrius,478,hunter,marksmanship,13,6,7
Lyssavirhus,azralon,478,hunter,marksmanship,12,5,7
Ozzoty,tol-barad,478,hunter,marksmanship,12,5,7
Damnnicebutt,borean-tundra,478,hunter,marksmanship,20,7,13
Tularac,sentinels,477,hunter,marksmanship,12,5,7
Survival,dentarg,477,hunter,marksmanship,12,5,7
Darkmaximus,echo-isles,477,hunter,marksmanship,18,5,13
Àrsha,gallywix,475,hunter,marksmanship,12,5,7
Oorudun,hellscream,472,hunter,marksmanship,12,5,7
Erudraugdin,quelthalas,468,hunter,marksmanship,18,5,13
Raun,anvilmar,453,hunter,marksmanship,17,5,12
Diavál,area-52,447,hunter,marksmanship,11,5,6
Mukeru,stormrage,432,hunter,marksmanship,9,5,4
Wook,hyjal,431,hunter,marksmanship,11,5,6
Noriee,destromath,431,hunter,marksmanship,15,5,10
Ellishunter,frostmourne,426,hunter,marksmanship,22,6,16
Yaboismokey,aerie-peak,425,hunter,marksmanship,17,7,10
Nirika,moon-guard,416,hunter,marksmanship,10,5,5
Póra,stormrage,396,hunter,marksmanship,13,5,8
Infatuatedx,moon-guard,384,hunter,marksmanship,6,4,2
Rektarrow,area-52,384,hunter,marksmanship,6,4,2
Wellerman,firetree,384,hunter,marksmanship,6,4,2
Gogey,area-52,384,hunter,marksmanship,6,4,2
Sylos,moon-guard,384,hunter,marksmanship,6,4,2
Coolwhip,demon-soul,384,hunter,marksmanship,6,4,2
Thehunturd,dalaran,384,hunter,marksmanship,6,4,2
Moyria,quelthalas,384,hunter,marksmanship,6,4,2
Subdue,tichondrius,384,hunter,marksmanship,6,4,2
Hyyz,proudmoore,384,hunter,marksmanship,6,4,2
Balaria,tichondrius,384,hunter,marksmanship,6,4,2
Zendarae,tichondrius,384,hunter,marksmanship,6,4,2
Jimryl,illidan,384,hunter,marksmanship,6,4,2
Oromís,dalaran,384,hunter,marksmanship,6,4,2
Emilysamuels,tichondrius,384,hunter,marksmanship,6,4,2
Anecko,zuljin,384,hunter,marksmanship,6,4,2
Shootbert,malganis,384,hunter,marksmanship,6,4,2
Winotah,frostmourne,384,hunter,marksmanship,6,4,2
Huataran,stormrage,384,hunter,marksmanship,6,4,2
Cashisabeast,zuljin,384,hunter,marksmanship,6,4,2
Aimbôt,frostmourne,384,hunter,marksmanship,6,4,2
Revo,darkspear,384,hunter,marksmanship,6,4,2
Llhopital,ragnaros,384,hunter,marksmanship,6,4,2
Obsol,hyjal,384,hunter,marksmanship,6,4,2
Arteene,illidan,384,hunter,marksmanship,6,4,2
Venj,proudmoore,384,hunter,marksmanship,6,4,2
Swoljashotxp,area-52,384,hunter,marksmanship,6,4,2
Swish,burning-legion,384,hunter,marksmanship,6,4,2
Goosejuicer,emerald-dream,384,hunter,marksmanship,6,4,2
Stfd,illidan,384,hunter,marksmanship,6,4,2
Relapse,dreadmaul,384,hunter,marksmanship,6,4,2
Côckblocked,tichondrius,384,hunter,marksmanship,6,4,2
Malcab,tichondrius,384,hunter,marksmanship,6,4,2
Blamethenaga,sargeras,384,hunter,marksmanship,6,4,2
Huumpoutine,burning-blade,384,hunter,marksmanship,6,4,2
Archetype,bladefist,384,hunter,marksmanship,6,4,2
Raevon,kelthuzad,384,hunter,marksmanship,6,4,2
Junmuxiao,ragnaros,384,hunter,marksmanship,6,4,2
Silvertokay,ragnaros,384,hunter,marksmanship,6,4,2
Déwi,tichondrius,384,hunter,marksmanship,6,4,2
Clutchxx,tichondrius,384,hunter,marksmanship,6,4,2
Frîck,bleeding-hollow,384,hunter,marksmanship,6,4,2
Maidán,azralon,384,hunter,marksmanship,6,4,2
Malthiz,antonidas,384,hunter,marksmanship,8,4,4
Msghunter,sargeras,384,hunter,marksmanship,12,4,8
Dmasterbiter,zuljin,384,hunter,marksmanship,12,4,8
Percision,bonechewer,384,hunter,marksmanship,12,4,8
Trippyhunter,akama,384,hunter,marksmanship,12,4,8
Dropflag,stormrage,384,hunter,marksmanship,12,4,8
Artemisagro,greymane,384,hunter,marksmanship,12,4,8
Hywhan,stormrage,384,hunter,marksmanship,12,4,8
Ojmo,arthas,384,hunter,marksmanship,12,4,8
Soljer,kiljaeden,384,hunter,marksmanship,12,4,8
Patroclo,azralon,384,hunter,marksmanship,12,4,8
Braindeadorc,illidan,384,hunter,marksmanship,12,4,8
Revö,area-52,384,hunter,marksmanship,12,4,8
Saralli,thrall,384,hunter,marksmanship,12,4,8
Zipzyup,tichondrius,384,hunter,marksmanship,12,4,8
Ningiiwose,garona,384,hunter,marksmanship,12,4,8
Skillvanas,stormrage,384,hunter,marksmanship,12,4,8
Shotfromhell,sargeras,384,hunter,marksmanship,12,4,8
Abloodelf,zuljin,384,hunter,marksmanship,12,4,8
Taurenseason,sargeras,384,hunter,marksmanship,12,4,8
Bleedwolf,tichondrius,384,hunter,marksmanship,12,4,8
Robobop,stormrage,384,hunter,marksmanship,12,4,8
Vion,mannoroth,384,hunter,marksmanship,12,4,8
Samsin,sargeras,384,hunter,marksmanship,12,4,8
Karev,area-52,384,hunter,marksmanship,12,4,8
Grukar,tichondrius,384,hunter,marksmanship,12,4,8
Kumari,lothar,384,hunter,marksmanship,12,4,8
Bombanodos,kelthuzad,384,hunter,marksmanship,12,4,8
Ganzilla,aerie-peak,384,hunter,marksmanship,12,4,8
Vélos,illidan,384,hunter,marksmanship,12,4,8
Emérr,drakkari,384,hunter,marksmanship,12,4,8
Cloudzbow,moon-guard,384,hunter,marksmanship,12,4,8
Crackshotzz,illidan,384,hunter,marksmanship,12,4,8
Joton,tichondrius,384,hunter,marksmanship,12,4,8
Xeriife,stormrage,384,hunter,marksmanship,12,4,8
Ðïanä,azralon,384,hunter,marksmanship,12,4,8
Sylvanâs,bleeding-hollow,384,hunter,marksmanship,12,4,8
Bowtech,kelthuzad,384,hunter,marksmanship,12,4,8
Junglar,eitrigg,384,hunter,marksmanship,12,4,8
Whatalexa,tichondrius,384,hunter,marksmanship,12,4,8
Spunky,zuluhed,384,hunter,marksmanship,12,4,8
Kä,blackhand,384,hunter,marksmanship,12,4,8
Enchantras,jaedenar,384,hunter,marksmanship,12,4,8
Ididntdoit,blackhand,384,hunter,marksmanship,12,4,8
Sabo,nemesis,384,hunter,marksmanship,12,4,8
Shottz,blackhand,384,hunter,marksmanship,12,4,8
Limpnoodle,nerzhul,384,hunter,marksmanship,12,4,8
Crimsonmm,ragnaros,384,hunter,marksmanship,12,4,8
Aewyn,malganis,384,hunter,marksmanship,12,4,8
Deadshöt,bleeding-hollow,384,hunter,marksmanship,18,4,14
Kiteftw,tichondrius,384,hunter,marksmanship,18,4,14
Angelickon,tichondrius,384,hunter,marksmanship,18,4,14
Peashooter,sargeras,384,hunter,marksmanship,19,4,15
Meriah,bleeding-hollow,383,hunter,marksmanship,6,4,2
Snäpträp,stormrage,383,hunter,marksmanship,6,4,2
Soulbutter,malganis,383,hunter,marksmanship,6,4,2
Essya,frostmourne,383,hunter,marksmanship,6,4,2
Euphylesz,garrosh,383,hunter,marksmanship,10,4,6
Zérõ,area-52,383,hunter,marksmanship,12,4,8
Rottinghood,hyjal,383,hunter,marksmanship,12,4,8
Minibrö,tichondrius,383,hunter,marksmanship,12,4,8
Brody,eitrigg,383,hunter,marksmanship,12,4,8
Shootingjaem,tichondrius,383,hunter,marksmanship,12,4,8
Diacachimbaa,ragnaros,383,hunter,marksmanship,12,4,8
Aridan,area-52,383,hunter,marksmanship,12,4,8
Juanita,laughing-skull,383,hunter,marksmanship,12,4,8
Amsalja,tichondrius,383,hunter,marksmanship,12,4,8
Chetta,ragnaros,383,hunter,marksmanship,22,5,17
Nevon,azralon,383,hunter,marksmanship,18,4,14
Oohuntsoo,emerald-dream,382,hunter,marksmanship,6,4,2
Föcker,emerald-dream,382,hunter,marksmanship,10,6,4
Eaudelune,vashj,382,hunter,marksmanship,12,4,8
Skatenos,tortheldrin,381,hunter,marksmanship,12,4,8
Twofeathers,wyrmrest-accord,381,hunter,marksmanship,12,4,8
Äzrael,elune,379,hunter,marksmanship,12,4,8
Venessie,moon-guard,379,hunter,marksmanship,12,4,8
Arighthunt,frostmourne,367,hunter,marksmanship,17,4,13
Hyesik,tichondrius,362,hunter,marksmanship,21,7,14
Bloodarrow,tichondrius,351,hunter,marksmanship,11,4,7
Trappxy,sargeras,336,hunter,marksmanship,9,4,5
Zucarita,tichondrius,330,hunter,marksmanship,9,5,4
Dsizzle,tichondrius,330,hunter,marksmanship,20,5,15
Nubcaks,nerzhul,330,hunter,marksmanship,21,5,16
Pérséús,ragnaros,320,hunter,marksmanship,10,4,6
Stupïd,tichondrius,319,hunter,marksmanship,5,4,1
Aimian,frostmourne,319,hunter,marksmanship,8,4,4
Kazug,destromath,319,hunter,marksmanship,12,5,7
Berkhof,tichondrius,319,hunter,marksmanship,14,4,10
Dagre,the-forgotten-coast,304,hunter,marksmanship,13,4,9
Mikey,exodar,288,hunter,marksmanship,6,3,3
Physical,destromath,288,hunter,marksmanship,6,3,3
Uc,khadgar,288,hunter,marksmanship,6,3,3
Madsniper,thunderlord,288,hunter,marksmanship,6,3,3
Racoon,spinebreaker,288,hunter,marksmanship,6,3,3
Eatmybow,nemesis,288,hunter,marksmanship,6,3,3
Pvrisxoxo,frostmourne,288,hunter,marksmanship,6,3,3
Cù,frostmourne,288,hunter,marksmanship,6,3,3
Internade,frostmourne,288,hunter,marksmanship,6,3,3
Azairxd,tichondrius,288,hunter,marksmanship,6,3,3
Stupedhunter,tichondrius,288,hunter,marksmanship,6,3,3
Casadora,dark-iron,288,hunter,marksmanship,6,3,3
Trænquility,tichondrius,288,hunter,marksmanship,6,3,3
Javoj,drakkari,288,hunter,marksmanship,6,3,3
Goatshots,lightninghoof,288,hunter,marksmanship,6,3,3
Bloodyman,korgath,288,hunter,marksmanship,6,3,3
Eforas,ragnaros,288,hunter,marksmanship,6,3,3
Wasteyou,tichondrius,288,hunter,marksmanship,6,3,3
Fruitenveg,frostmourne,288,hunter,marksmanship,6,3,3
Muffhuntér,blackrock,288,hunter,marksmanship,6,3,3
Vashra,stormrage,288,hunter,marksmanship,6,3,3
Wannakill,stormrage,288,hunter,marksmanship,6,3,3
Rivs,detheroc,288,hunter,marksmanship,6,3,3
Kallindo,sargeras,288,hunter,marksmanship,6,3,3
Tìnker,stormrage,288,hunter,marksmanship,6,3,3
Khasu,ragnaros,288,hunter,marksmanship,6,3,3
Bamfhunt,darkspear,288,hunter,marksmanship,6,3,3
Candîce,moon-guard,288,hunter,marksmanship,6,3,3
Vivaswan,tichondrius,288,hunter,marksmanship,6,3,3
Ÿöskë,tichondrius,288,hunter,marksmanship,6,3,3
Kansolly,tichondrius,288,hunter,marksmanship,6,3,3
Triggamikê,tichondrius,288,hunter,marksmanship,6,3,3
Aaron,jubeithos,288,hunter,marksmanship,6,3,3
Auset,aegwynn,288,hunter,marksmanship,6,3,3
Folgadoo,azralon,288,hunter,marksmanship,6,3,3
Blakespace,area-52,288,hunter,marksmanship,6,3,3
Baehydra,frostmourne,288,hunter,marksmanship,6,3,3
Mabaku,tichondrius,288,hunter,marksmanship,6,3,3
Zeonas,tichondrius,288,hunter,marksmanship,6,3,3
Zym,the-forgotten-coast,288,hunter,marksmanship,6,3,3
Grimdrakk,zuljin,288,hunter,marksmanship,6,3,3
Buzzkiller,sargeras,288,hunter,marksmanship,6,3,3
Wolftracer,sargeras,288,hunter,marksmanship,6,3,3
Gorhound,tichondrius,288,hunter,marksmanship,6,3,3
Daggétt,zuljin,288,hunter,marksmanship,6,3,3
Diertz,area-52,288,hunter,marksmanship,6,3,3
Innerhunt,aegwynn,288,hunter,marksmanship,6,3,3
Carot,dalaran,288,hunter,marksmanship,6,3,3
Kneecrippler,proudmoore,288,hunter,marksmanship,6,3,3
Halosucks,sargeras,288,hunter,marksmanship,6,3,3
Zengrin,quelthalas,288,hunter,marksmanship,6,3,3
Humiliation,mugthol,288,hunter,marksmanship,6,3,3
Neverhunter,azralon,288,hunter,marksmanship,6,3,3
Sindain,bloodscalp,288,hunter,marksmanship,6,3,3
Lilbic,bleeding-hollow,288,hunter,marksmanship,6,3,3
Xtremesnipez,frostmourne,288,hunter,marksmanship,6,3,3
Arithrawn,area-52,288,hunter,marksmanship,6,3,3
Ropivacaine,illidan,288,hunter,marksmanship,6,3,3
Thugbeast,tichondrius,288,hunter,marksmanship,6,3,3
Kynigi,bleeding-hollow,288,hunter,marksmanship,6,3,3
Wolfmilkers,illidan,288,hunter,marksmanship,6,3,3
Weegnomie,wyrmrest-accord,288,hunter,marksmanship,6,3,3
Sereom,frostmourne,288,hunter,marksmanship,6,3,3
Mtuanwm,tichondrius,288,hunter,marksmanship,6,3,3
Zzackchicken,tichondrius,288,hunter,marksmanship,6,3,3
Kormas,illidan,288,hunter,marksmanship,6,3,3
Tugh,maiev,288,hunter,marksmanship,6,3,3
Exabyssus,bleeding-hollow,288,hunter,marksmanship,6,3,3
Luckynoodlle,frostmourne,288,hunter,marksmanship,6,3,3
Playnogames,moon-guard,288,hunter,marksmanship,6,3,3
Chootembro,thunderlord,288,hunter,marksmanship,6,3,3
Madjango,illidan,288,hunter,marksmanship,6,3,3
Bernelli,kelthuzad,288,hunter,marksmanship,6,3,3
Ligmubhole,queldorei,288,hunter,marksmanship,6,3,3
Quondo,boulderfist,288,hunter,marksmanship,6,3,3
Untermench,tichondrius,288,hunter,marksmanship,6,3,3
Cloakedninja,illidan,288,hunter,marksmanship,6,3,3
Sosaho,sargeras,288,hunter,marksmanship,6,3,3
Keliara,dunemaul,288,hunter,marksmanship,6,3,3
Kong,tichondrius,288,hunter,marksmanship,6,3,3
Vinksy,sargeras,288,hunter,marksmanship,6,3,3
Antily,kelthuzad,288,hunter,marksmanship,6,3,3
Deepbowjob,sargeras,288,hunter,marksmanship,6,3,3
Ekzoo,tichondrius,288,hunter,marksmanship,6,3,3
Krelas,eldrethalas,288,hunter,marksmanship,6,3,3
Waqz,tichondrius,288,hunter,marksmanship,6,3,3
Miscreant,kelthuzad,288,hunter,marksmanship,6,3,3
Starsabov,emerald-dream,288,hunter,marksmanship,6,3,3
Eldotbrod,quelthalas,288,hunter,marksmanship,6,3,3
Silvershot,emerald-dream,288,hunter,marksmanship,6,3,3
Ud,eldrethalas,288,hunter,marksmanship,6,3,3
Iannieht,illidan,288,hunter,marksmanship,6,3,3
Zindula,malganis,288,hunter,marksmanship,7,3,4
Amonerhunter,bleeding-hollow,288,hunter,marksmanship,10,4,6
Mojopojo,tichondrius,288,hunter,marksmanship,12,4,8
Prpl,sargeras,288,hunter,marksmanship,15,4,11
Exiun,sargeras,288,hunter,marksmanship,12,3,9
Mulnaaj,zuljin,288,hunter,marksmanship,12,3,9
Princssdaizy,zuljin,288,hunter,marksmanship,12,3,9
Alyzza,sargeras,288,hunter,marksmanship,12,3,9
Peña,trollbane,288,hunter,marksmanship,12,3,9
Oua,queldorei,288,hunter,marksmanship,12,3,9
Bwaa,illidan,288,hunter,marksmanship,12,3,9
Fatehunter,bleeding-hollow,288,hunter,marksmanship,12,3,9
Zeedii,dalaran,288,hunter,marksmanship,12,3,9
Sliperysaly,tichondrius,288,hunter,marksmanship,12,3,9
Blarck,shattered-halls,288,hunter,marksmanship,12,3,9
Gustavitch,executus,288,hunter,marksmanship,12,3,9
Kòng,quelthalas,288,hunter,marksmanship,12,3,9
Arbclimbs,frostmane,288,hunter,marksmanship,12,3,9
Hatara,quelthalas,288,hunter,marksmanship,12,3,9
Zøkøtrøkø,ragnaros,288,hunter,marksmanship,12,3,9
Shootybootìe,tichondrius,288,hunter,marksmanship,12,3,9
Wadadly,malganis,288,hunter,marksmanship,12,3,9
Lumbygoblin,illidan,288,hunter,marksmanship,13,3,10
Guntrïx,stormrage,288,hunter,marksmanship,18,3,15
Multicereal,quelthalas,287,hunter,marksmanship,6,3,3
Ghazzghkuull,ragnaros,287,hunter,marksmanship,6,3,3
Puttry,stormrage,287,hunter,marksmanship,6,3,3
Drâgônâr,stormrage,287,hunter,marksmanship,6,3,3
Lapelada,ragnaros,287,hunter,marksmanship,6,3,3
Scoundrella,sargeras,287,hunter,marksmanship,6,3,3
Towness,kelthuzad,287,hunter,marksmanship,6,3,3
Downtimes,illidan,287,hunter,marksmanship,6,3,3
Slayemz,barthilas,287,hunter,marksmanship,6,3,3
Darthwillie,cenarius,287,hunter,marksmanship,12,3,9
Lulaladraun,azralon,287,hunter,marksmanship,12,3,9
Tarbabies,mannoroth,287,hunter,marksmanship,12,3,9
Bumbow,tichondrius,287,hunter,marksmanship,12,3,9
Lorelåii,tichondrius,286,hunter,marksmanship,6,3,3
Irishnia,bleeding-hollow,286,hunter,marksmanship,6,3,3
Aeclpysis,dark-iron,281,hunter,marksmanship,12,5,7
Zuuvuya,nemesis,255,hunter,marksmanship,14,4,10
Setepalms,azralon,239,hunter,marksmanship,5,3,2
Brorc,kul-tiras,239,hunter,marksmanship,5,3,2
Knowtraps,area-52,234,hunter,marksmanship,7,4,3
Druskritag,moon-guard,234,hunter,marksmanship,10,4,6
Richihunt,ragnaros,234,hunter,marksmanship,14,4,10
Demongirl,arathor,231,hunter,marksmanship,25,4,21
Rnger,aerie-peak,223,hunter,marksmanship,8,3,5
Andrømeda,frostmourne,208,hunter,marksmanship,7,3,4
Lamb,undermine,202,hunter,marksmanship,11,4,7
Traitorously,daggerspine,192,hunter,marksmanship,9,3,6
Yortrox,ragnaros,192,hunter,marksmanship,6,2,4
Muscletooth,moon-guard,192,hunter,marksmanship,6,2,4
Latherel,bleeding-hollow,192,hunter,marksmanship,6,2,4
Ilîiìîìiilil,bleeding-hollow,192,hunter,marksmanship,6,2,4
Firskin,frostmourne,192,hunter,marksmanship,6,2,4
Inurah,malganis,192,hunter,marksmanship,6,2,4
Erebor,malganis,192,hunter,marksmanship,6,2,4
Kanta,bleeding-hollow,192,hunter,marksmanship,6,2,4
Alluminant,gilneas,192,hunter,marksmanship,6,2,4
Leeshaarrow,moon-guard,192,hunter,marksmanship,6,2,4
Àngèl,malganis,192,hunter,marksmanship,6,2,4
Desdee,icecrown,192,hunter,marksmanship,6,2,4
Ramchi,burning-blade,192,hunter,marksmanship,6,2,4
Sevitham,dalaran,192,hunter,marksmanship,6,2,4
Kahtniss,quelthalas,192,hunter,marksmanship,6,2,4
Cornbreadfed,gorgonnash,192,hunter,marksmanship,6,2,4
Dreezzy,bleeding-hollow,192,hunter,marksmanship,6,2,4
Cazaaires,quelthalas,192,hunter,marksmanship,6,2,4
Cefla,illidan,192,hunter,marksmanship,6,2,4
Jebote,frostmourne,192,hunter,marksmanship,6,2,4
Lorgor,eonar,192,hunter,marksmanship,6,2,4
Haki,gallywix,192,hunter,marksmanship,6,2,4
Tyraelias,kaelthas,192,hunter,marksmanship,6,2,4
Cuchulláin,area-52,192,hunter,marksmanship,6,2,4
Crownchild,illidan,192,hunter,marksmanship,6,2,4
Sogeki,kelthuzad,192,hunter,marksmanship,6,2,4
Orber,stormrage,192,hunter,marksmanship,6,2,4
Wartoz,dragonblight,192,hunter,marksmanship,6,2,4
Zaghoward,fenris,192,hunter,marksmanship,6,2,4
Geeshot,area-52,192,hunter,marksmanship,6,2,4
Huntkillerx,illidan,192,hunter,marksmanship,6,2,4
Pumpydumpy,malganis,192,hunter,marksmanship,6,2,4
Huntugz,frostmourne,192,hunter,marksmanship,6,2,4
Mtq,thrall,192,hunter,marksmanship,6,2,4
Ragnarlobkk,ragnaros,192,hunter,marksmanship,6,2,4
Lulafourdedo,stormrage,192,hunter,marksmanship,6,2,4
Mayhunter,ragnaros,192,hunter,marksmanship,6,2,4
Percival,firetree,192,hunter,marksmanship,6,2,4
Xpyroshot,area-52,192,hunter,marksmanship,6,2,4
Knator,area-52,192,hunter,marksmanship,6,2,4
Áppóló,spinebreaker,192,hunter,marksmanship,6,2,4
Xxunderoath,frostwolf,192,hunter,marksmanship,6,2,4
Doug,illidan,192,hunter,marksmanship,6,2,4
Hfn,stormrage,192,hunter,marksmanship,6,2,4
Ðevil,ragnaros,192,hunter,marksmanship,6,2,4
Symz,ragnaros,192,hunter,marksmanship,6,2,4
Rëxx,moon-guard,192,hunter,marksmanship,6,2,4
Stingyshot,thrall,192,hunter,marksmanship,6,2,4
Commonbuck,area-52,192,hunter,marksmanship,6,2,4
Léfty,nagrand,192,hunter,marksmanship,6,2,4
Gadorim,kelthuzad,192,hunter,marksmanship,6,2,4
Yonzo,area-52,192,hunter,marksmanship,6,2,4
Benryats,area-52,192,hunter,marksmanship,6,2,4
Arantir,drakkari,192,hunter,marksmanship,6,2,4
Najmoira,area-52,192,hunter,marksmanship,6,2,4
Huntgar,earthen-ring,192,hunter,marksmanship,6,2,4
Otirrub,deathwing,192,hunter,marksmanship,6,2,4
Doopers,kiljaeden,192,hunter,marksmanship,6,2,4
Huntingyou,destromath,192,hunter,marksmanship,6,2,4
Vitae,shattered-halls,192,hunter,marksmanship,6,2,4
Whitemàne,dalaran,192,hunter,marksmanship,6,2,4
Angrypepe,bleeding-hollow,192,hunter,marksmanship,6,2,4
Bôdon,illidan,192,hunter,marksmanship,6,2,4
Voodoohunter,blood-furnace,192,hunter,marksmanship,6,2,4
Ctrlaltdel,gundrak,192,hunter,marksmanship,6,2,4
Regerts,sargeras,192,hunter,marksmanship,6,2,4
Gangstashot,burning-legion,192,hunter,marksmanship,6,2,4
Yembohi,queldorei,192,hunter,marksmanship,6,2,4
Magvez,tichondrius,192,hunter,marksmanship,6,2,4
Logonman,rexxar,192,hunter,marksmanship,6,2,4
Fermra,dunemaul,192,hunter,marksmanship,6,2,4
Warsh,anubarak,192,hunter,marksmanship,6,2,4
Zeaks,emerald-dream,192,hunter,marksmanship,6,2,4
Nes,azuremyst,192,hunter,marksmanship,6,2,4
Bionix,sargeras,192,hunter,marksmanship,6,2,4
Momomomo,draka,192,hunter,marksmanship,6,2,4
Zhona,moon-guard,192,hunter,marksmanship,6,2,4
Hunchback,emerald-dream,192,hunter,marksmanship,6,2,4
Penelòpe,wyrmrest-accord,192,hunter,marksmanship,6,2,4
Sinsix,akama,192,hunter,marksmanship,6,2,4
Jgodsslayer,tichondrius,192,hunter,marksmanship,6,2,4
Petmydog,aegwynn,192,hunter,marksmanship,6,2,4
Zaheerz,sargeras,192,hunter,marksmanship,6,2,4
Sobala,azralon,192,hunter,marksmanship,6,2,4
Bowzørx,tichondrius,192,hunter,marksmanship,6,2,4
Fleshfeast,tichondrius,192,hunter,marksmanship,6,2,4
Dikbender,tichondrius,192,hunter,marksmanship,6,2,4
Alssong,tichondrius,192,hunter,marksmanship,6,2,4
Drysst,tichondrius,192,hunter,marksmanship,6,2,4
Bloodrainia,ravencrest,192,hunter,marksmanship,6,2,4
Lemmiewînkzz,sargeras,192,hunter,marksmanship,6,2,4
Ragar,korialstrasz,192,hunter,marksmanship,6,2,4
Lolknocked,alexstrasza,192,hunter,marksmanship,6,2,4
Anilora,wyrmrest-accord,192,hunter,marksmanship,6,2,4
Geldyn,stormreaver,192,hunter,marksmanship,6,2,4
Amptx,tichondrius,192,hunter,marksmanship,6,2,4
Rumnaheim,nemesis,192,hunter,marksmanship,6,2,4
Bendoon,sargeras,192,hunter,marksmanship,6,2,4
Kïwwï,tichondrius,192,hunter,marksmanship,6,2,4
Kreaytion,sargeras,192,hunter,marksmanship,6,2,4
Namøscä,nemesis,192,hunter,marksmanship,6,2,4
Córnell,tichondrius,192,hunter,marksmanship,6,2,4
Ayrana,tichondrius,192,hunter,marksmanship,6,2,4
Ðecarlis,azralon,192,hunter,marksmanship,6,2,4
Skolzero,azralon,192,hunter,marksmanship,6,2,4
Blury,tichondrius,192,hunter,marksmanship,6,2,4
Tus,tichondrius,192,hunter,marksmanship,6,2,4
Xuxoo,nemesis,192,hunter,marksmanship,6,2,4
Kìkìjiki,emerald-dream,192,hunter,marksmanship,6,2,4
Thugio,sargeras,192,hunter,marksmanship,6,2,4
Huntdawgg,illidan,192,hunter,marksmanship,12,2,10
Dojaqat,frostmourne,192,hunter,marksmanship,12,2,10
Hunterish,area-52,192,hunter,marksmanship,12,2,10
Shafttrapper,queldorei,192,hunter,marksmanship,12,2,10
Littleagu,proudmoore,192,hunter,marksmanship,12,2,10
Seekem,destromath,192,hunter,marksmanship,12,2,10
Zarknoth,cenarius,192,hunter,marksmanship,12,2,10
Killdred,bonechewer,192,hunter,marksmanship,12,2,10
Warpedshots,malganis,192,hunter,marksmanship,12,2,10
Larts,fenris,192,hunter,marksmanship,12,2,10
Findbind,altar-of-storms,192,hunter,marksmanship,12,2,10
Stïinck,azralon,192,hunter,marksmanship,12,2,10
Warrioress,illidan,192,hunter,marksmanship,12,2,10
Mayohater,sargeras,192,hunter,marksmanship,12,2,10
Josthar,thrall,192,hunter,marksmanship,12,2,10
Àlëxx,aegwynn,192,hunter,marksmanship,12,2,10
Thunderox,tichondrius,192,hunter,marksmanship,12,2,10
Eaglesx,skullcrusher,192,hunter,marksmanship,12,2,10
Sharpzy,jubeithos,192,hunter,marksmanship,12,2,10
Shootybooty,arygos,192,hunter,marksmanship,12,2,10
Roboputa,quelthalas,192,hunter,marksmanship,12,2,10
Xulag,tichondrius,192,hunter,marksmanship,12,2,10
Demolitions,kelthuzad,192,hunter,marksmanship,12,2,10
Chinchompas,bleeding-hollow,192,hunter,marksmanship,18,2,16
Tamsynn,stormrage,192,hunter,marksmanship,18,2,16
Sylviannas,frostmourne,191,hunter,marksmanship,6,2,4
Wörg,elune,191,hunter,marksmanship,6,2,4
Lanney,firetree,191,hunter,marksmanship,6,2,4
ßonßon,stormrage,160,hunter,marksmanship,10,2,8
Clintbartun,shadowsong,159,hunter,marksmanship,5,2,3
Hunntard,veknilash,159,hunter,marksmanship,5,2,3
Thesloott,azshara,159,hunter,marksmanship,5,2,3
Ryonel,moon-guard,159,hunter,marksmanship,11,2,9
Dusle,azralon,138,hunter,marksmanship,8,3,5
Darthski,drenden,138,hunter,marksmanship,12,4,8
Ünknown,sargeras,138,hunter,marksmanship,10,3,7
Plsnobanmee,frostmourne,137,hunter,marksmanship,9,5,4
Almighty,trollbane,134,hunter,marksmanship,16,3,13
Ggtooeasy,thrall,128,hunter,marksmanship,4,2,2
Fartingshot,proudmoore,128,hunter,marksmanship,4,2,2
Lúthiel,azralon,127,hunter,marksmanship,8,2,6
Ïmprîsôñ,dalaran,96,hunter,marksmanship,3,2,1
Shootr,darkspear,96,hunter,marksmanship,3,2,1
Razer,anvilmar,96,hunter,marksmanship,3,2,1
Terezhunt,tichondrius,96,hunter,marksmanship,6,1,5
Puppyghoul,malganis,96,hunter,marksmanship,6,1,5
Zünma,tichondrius,96,hunter,marksmanship,6,1,5
Insönnia,azralon,96,hunter,marksmanship,6,1,5
Blaptz,wyrmrest-accord,96,hunter,marksmanship,6,1,5
Siimmplicitz,area-52,96,hunter,marksmanship,6,1,5
Zral,dragonmaw,96,hunter,marksmanship,6,1,5
Rämbow,frostmourne,96,hunter,marksmanship,6,1,5
Bacchantress,tichondrius,96,hunter,marksmanship,6,1,5
Sarutovy,kelthuzad,96,hunter,marksmanship,6,1,5
Biehuixin,tichondrius,96,hunter,marksmanship,6,1,5
Hopsmatei,azralon,96,hunter,marksmanship,6,1,5
Pogcheddar,tichondrius,96,hunter,marksmanship,6,1,5
Jaidev,nemesis,96,hunter,marksmanship,6,1,5
Solderboi,tichondrius,96,hunter,marksmanship,6,1,5
Clacktar,wyrmrest-accord,96,hunter,marksmanship,6,1,5
Gabitoqt,gallywix,96,hunter,marksmanship,6,1,5
Seizedhunt,frostmourne,96,hunter,marksmanship,6,1,5
Jumeog,stormscale,96,hunter,marksmanship,6,1,5
Arawnz,emerald-dream,96,hunter,marksmanship,6,1,5
Keelif,arthas,96,hunter,marksmanship,6,1,5
Hyena,kelthuzad,96,hunter,marksmanship,6,1,5
Shootermgavn,frostmourne,96,hunter,marksmanship,6,1,5
Longshott,azralon,96,hunter,marksmanship,6,1,5
Maquire,tichondrius,96,hunter,marksmanship,6,1,5
Zenwrath,illidan,96,hunter,marksmanship,6,1,5
Zirstorm,altar-of-storms,96,hunter,marksmanship,6,1,5
Laudion,quelthalas,96,hunter,marksmanship,6,1,5
Artilleria,quelthalas,96,hunter,marksmanship,6,1,5
Coppersnout,wyrmrest-accord,96,hunter,marksmanship,6,1,5
Deadlyattack,barthilas,96,hunter,marksmanship,6,1,5
Samanta,blood-furnace,96,hunter,marksmanship,6,1,5
Elknut,sargeras,96,hunter,marksmanship,6,1,5
Vilguz,illidan,96,hunter,marksmanship,6,1,5
Fingamyquill,tichondrius,96,hunter,marksmanship,6,1,5
Ashner,illidan,96,hunter,marksmanship,6,1,5
Rockehm,frostmourne,96,hunter,marksmanship,6,1,5
Anndaria,tichondrius,96,hunter,marksmanship,6,1,5
Hovahdo,proudmoore,96,hunter,marksmanship,6,1,5
Panchovill,ragnaros,96,hunter,marksmanship,6,1,5
Boongtokes,illidan,96,hunter,marksmanship,6,1,5
Narukín,tichondrius,96,hunter,marksmanship,6,1,5
Fawn,moon-guard,96,hunter,marksmanship,6,1,5
Kiatus,nesingwary,96,hunter,marksmanship,6,1,5
Hellcry,khadgar,96,hunter,marksmanship,6,1,5
Gunwalk,azjolnerub,96,hunter,marksmanship,6,1,5
Shablagoosh,zuljin,96,hunter,marksmanship,6,1,5
Ikiteforgold,zuljin,96,hunter,marksmanship,6,1,5
Wolfmastera,zuljin,96,hunter,marksmanship,6,1,5
Ruhak,windrunner,96,hunter,marksmanship,6,1,5
Crazyshot,drakkari,96,hunter,marksmanship,6,1,5
Aerefix,frostmourne,96,hunter,marksmanship,6,1,5
Htcrazykofwa,tichondrius,96,hunter,marksmanship,6,1,5
Cocobage,destromath,96,hunter,marksmanship,6,1,5
Arin,suramar,96,hunter,marksmanship,6,1,5
Cowboytroy,exodar,96,hunter,marksmanship,6,1,5
Brutalhit,bonechewer,96,hunter,marksmanship,6,1,5
Smackadoodlé,illidan,96,hunter,marksmanship,6,1,5
Evemae,sargeras,96,hunter,marksmanship,6,1,5
Dreygar,dawnbringer,96,hunter,marksmanship,6,1,5
Dogtagluke,stormrage,96,hunter,marksmanship,6,1,5
Darkarcher,hyjal,96,hunter,marksmanship,6,1,5
Exitwoundz,hyjal,96,hunter,marksmanship,6,1,5
Necroshotz,kul-tiras,96,hunter,marksmanship,6,1,5
Desarus,archimonde,96,hunter,marksmanship,6,1,5
Faceshots,tichondrius,96,hunter,marksmanship,6,1,5
Kofan,darkspear,96,hunter,marksmanship,12,1,11
Hawneyduo,skullcrusher,96,hunter,marksmanship,12,1,11
Tarapandas,kilrogg,96,hunter,marksmanship,12,1,11
Jacobsladder,illidan,96,hunter,marksmanship,12,1,11
Xalmoinmybow,illidan,96,hunter,marksmanship,12,1,11
Cerébro,illidan,96,hunter,marksmanship,12,1,11
Bophadeaz,sargeras,96,hunter,marksmanship,12,1,11
Elanor,feathermoon,96,hunter,marksmanship,18,1,17
Strixis,blood-furnace,95,hunter,marksmanship,6,1,5
Setbackhunt,illidan,79,hunter,marksmanship,5,1,4
Raymose,tichondrius,64,hunter,marksmanship,4,1,3
Huntsmate,tichondrius,64,hunter,marksmanship,4,1,3
Nyloc,dalvengyr,64,hunter,marksmanship,4,1,3
Maveraxx,executus,48,hunter,marksmanship,3,1,2
Ahncheolsoo,tichondrius,42,hunter,marksmanship,11,2,9
Dapoosyx,tichondrius,31,hunter,marksmanship,2,1,1
Downworlder,darkspear,31,hunter,marksmanship,2,1,1
Suntail,dalaran,2208,hunter,survival,111,58,53
Saiiph,bleeding-hollow,2169,hunter,survival,144,74,70
Cëb,stormrage,2157,hunter,survival,168,84,84
Disciple,darkspear,2152,hunter,survival,74,43,31
Cadencex,stormrage,2131,hunter,survival,135,69,66
Hotmuscleman,tichondrius,2127,hunter,survival,74,45,29
Malukaca,azralon,2121,hunter,survival,137,69,68
Capncams,emerald-dream,2120,hunter,survival,130,68,62
Buffmm,kelthuzad,2095,hunter,survival,72,40,32
Dijhoni,moon-guard,2077,hunter,survival,96,55,41
Aimbotmir,zuljin,2065,hunter,survival,74,35,39
Pridefulz,stormrage,2062,hunter,survival,170,85,85
Noimnotokay,tichondrius,2051,hunter,survival,107,56,51
Legoelass,emerald-dream,2045,hunter,survival,137,78,59
Kansolly,tichondrius,2040,hunter,survival,105,54,51
Djtraphouse,stormrage,2013,hunter,survival,132,67,65
Hamslapper,shattered-hand,2004,hunter,survival,129,64,65
Ungrella,malganis,2001,hunter,survival,81,44,37
Maxiam,frostmourne,1989,hunter,survival,71,37,34
Nearly,wyrmrest-accord,1987,hunter,survival,79,40,39
Koupon,tichondrius,1987,hunter,survival,95,48,47
Veyronnx,stormrage,1982,hunter,survival,96,56,40
Foxyhood,ragnaros,1980,hunter,survival,120,66,54
Bicmex,sargeras,1970,hunter,survival,42,29,13
Pokìmane,tichondrius,1961,hunter,survival,98,62,36
Galavant,frostmourne,1960,hunter,survival,98,52,46
Lèkïnhø,azralon,1953,hunter,survival,72,36,36
Effyh,emerald-dream,1942,hunter,survival,134,72,62
Coggenda,sargeras,1932,hunter,survival,102,63,39
Runecrossbow,barthilas,1930,hunter,survival,102,52,50
Finito,bladefist,1926,hunter,survival,127,66,61
Gloomy,dark-iron,1925,hunter,survival,36,29,7
Aurelx,tichondrius,1920,hunter,survival,42,30,12
Dwx,bleeding-hollow,1911,hunter,survival,66,35,31
Sikhunt,frostmourne,1908,hunter,survival,54,33,21
Leonilc,tichondrius,1907,hunter,survival,78,36,42
Drasen,deathwing,1874,hunter,survival,54,30,24
Bergy,thrall,1873,hunter,survival,54,30,24
Jalinhabbei,azralon,1862,hunter,survival,53,28,25
Hwslol,tichondrius,1861,hunter,survival,130,68,62
Ferex,tichondrius,1858,hunter,survival,45,31,14
Covlol,illidan,1857,hunter,survival,42,21,21
Destrumz,zuljin,1855,hunter,survival,66,31,35
Briggsx,sargeras,1854,hunter,survival,42,24,18
Kelarcia,moon-guard,1846,hunter,survival,65,29,36
Pylorih,area-52,1842,hunter,survival,51,35,16
Sartel,tichondrius,1837,hunter,survival,178,92,86
Ssds,sargeras,1834,hunter,survival,42,26,16
Endsnear,stormrage,1830,hunter,survival,66,31,35
Gvoo,tichondrius,1829,hunter,survival,30,24,6
Exhausted,blackrock,1828,hunter,survival,72,29,43
Fizzleegear,area-52,1827,hunter,survival,153,74,79
Mlemily,stormrage,1826,hunter,survival,47,31,16
Otii,tichondrius,1826,hunter,survival,126,57,69
Dyucol,tichondrius,1824,hunter,survival,89,51,38
Queríde,emerald-dream,1822,hunter,survival,54,36,18
Angrybow,ragnaros,1821,hunter,survival,36,25,11
Thoromel,wyrmrest-accord,1820,hunter,survival,66,33,33
Ynoit,sargeras,1818,hunter,survival,40,23,17
Notnunca,tichondrius,1816,hunter,survival,54,31,23
Kisuke,khaz-modan,1815,hunter,survival,54,34,20
Trapula,tichondrius,1814,hunter,survival,84,46,38
Kubu,emerald-dream,1810,hunter,survival,63,41,22
Joón,moon-guard,1808,hunter,survival,43,26,17
Jagaerz,emerald-dream,1808,hunter,survival,42,23,19
Raef,azralon,1804,hunter,survival,60,32,28
Wmsgs,tichondrius,1802,hunter,survival,58,29,29
Kzmo,gnomeregan,1801,hunter,survival,24,19,5
Ratonh,ragnaros,1801,hunter,survival,156,88,68
Huntmon,nemesis,1800,hunter,survival,48,31,17
Neonjz,ragnaros,1800,hunter,survival,60,28,32
Jîñßæçhïñæ,sargeras,1800,hunter,survival,66,29,37
Carnidon,area-52,1796,hunter,survival,193,97,96
Snzzl,bleeding-hollow,1789,hunter,survival,42,25,17
Gabiña,tichondrius,1780,hunter,survival,183,89,94
Sobit,tichondrius,1776,hunter,survival,30,19,11
Percival,firetree,1770,hunter,survival,36,19,17
Nishinos,tichondrius,1766,hunter,survival,83,42,41
Pathed,azralon,1761,hunter,survival,54,31,23
Woriath,quelthalas,1761,hunter,survival,96,50,46
Krømatik,tichondrius,1756,hunter,survival,30,20,10
Vlf,tichondrius,1753,hunter,survival,60,30,30
Queride,area-52,1753,hunter,survival,48,23,25
Shootin,frostmourne,1749,hunter,survival,42,22,20
Leaku,illidan,1744,hunter,survival,36,25,11
Concur,frostmourne,1744,hunter,survival,60,30,30
Róckzero,quelthalas,1739,hunter,survival,151,76,75
Acres,emerald-dream,1737,hunter,survival,48,22,26
Caiodluffy,malganis,1729,hunter,survival,60,30,30
Hibyexo,illidan,1728,hunter,survival,36,22,14
Peppancini,wyrmrest-accord,1725,hunter,survival,53,34,19
Xyzv,tichondrius,1723,hunter,survival,30,18,12
Pathofsexile,tichondrius,1714,hunter,survival,51,25,26
Fictìon,kelthuzad,1712,hunter,survival,35,21,14
Stevemonday,stormrage,1711,hunter,survival,96,53,43
Knewbee,emerald-dream,1709,hunter,survival,51,29,22
Blåker,bleeding-hollow,1709,hunter,survival,72,38,34
Sylvanne,sargeras,1706,hunter,survival,30,18,12
Názzul,area-52,1705,hunter,survival,30,18,12
Partz,darkspear,1700,hunter,survival,50,33,17
Samcro,rivendare,1700,hunter,survival,65,33,32
Yip,moon-guard,1698,hunter,survival,39,20,19
Kyujin,ragnaros,1697,hunter,survival,78,44,34
Gnarwallz,stormrage,1691,hunter,survival,60,32,28
Henhøuse,illidan,1691,hunter,survival,48,24,24
Noxtis,kiljaeden,1689,hunter,survival,36,18,18
Arrów,duskwood,1688,hunter,survival,36,18,18
Bjornwald,thrall,1684,hunter,survival,220,114,106
Anisphia,tichondrius,1683,hunter,survival,79,40,39
Budgetben,stormrage,1682,hunter,survival,33,19,14
Truckrsaurus,tichondrius,1681,hunter,survival,87,45,42
Shablagoosh,zuljin,1672,hunter,survival,45,23,22
Réxon,quelthalas,1672,hunter,survival,105,51,54
Skàdii,tichondrius,1670,hunter,survival,79,41,38
Arsk,ragnaros,1670,hunter,survival,45,19,26
Ingridaniela,aegwynn,1668,hunter,survival,30,20,10
Crypy,illidan,1664,hunter,survival,48,24,24
Chimeralol,area-52,1660,hunter,survival,72,44,28
Swordshot,moon-guard,1660,hunter,survival,72,37,35
Fleche,aggramar,1658,hunter,survival,30,20,10
Ganemdar,sargeras,1653,hunter,survival,57,22,35
Ajacs,zuljin,1647,hunter,survival,35,24,11
Undien,area-52,1647,hunter,survival,60,35,25
Liekis,darkspear,1645,hunter,survival,54,24,30
Ryukotsu,tichondrius,1641,hunter,survival,49,24,25
Bendotexe,stormrage,1638,hunter,survival,36,21,15
Killshøtß,tichondrius,1634,hunter,survival,84,43,41
Nimeer,tichondrius,1632,hunter,survival,76,42,34
Dju,stormrage,1628,hunter,survival,48,23,25
Warhog,wyrmrest-accord,1626,hunter,survival,61,34,27
Bigbillx,tichondrius,1623,hunter,survival,30,17,13
Saltstream,tichondrius,1623,hunter,survival,36,17,19
Viòlenc,tichondrius,1621,hunter,survival,41,24,17
Skyland,tichondrius,1621,hunter,survival,54,29,25
Mxabyycc,tichondrius,1619,hunter,survival,54,30,24
Bbaronsamedi,darkspear,1615,hunter,survival,39,22,17
Cuddlestomp,magtheridon,1614,hunter,survival,46,24,22
Vhelkan,senjin,1613,hunter,survival,30,21,9
Voidarrows,area-52,1612,hunter,survival,35,21,14
Nandorius,proudmoore,1606,hunter,survival,60,29,31
Vigon,stormrage,1605,hunter,survival,69,36,33
Tøkÿöghøül,agamaggan,1603,hunter,survival,30,19,11
Arazian,stormrage,1601,hunter,survival,29,19,10
Töxic,dalaran,1601,hunter,survival,31,20,11
Limpingspoon,kelthuzad,1600,hunter,survival,114,64,50
Imapacifist,barthilas,1600,hunter,survival,69,37,32
Noxickk,sargeras,1587,hunter,survival,30,19,11
Exh,tichondrius,1586,hunter,survival,101,51,50
Táká,quelthalas,1577,hunter,survival,36,22,14
Xtina,drakkari,1577,hunter,survival,71,40,31
Bigiesmalls,moon-guard,1572,hunter,survival,54,28,26
Xebbec,sargeras,1571,hunter,survival,80,43,37
Drifting,bleeding-hollow,1569,hunter,survival,60,34,26
Lenacraft,frostmourne,1568,hunter,survival,36,18,18
Køjo,emerald-dream,1564,hunter,survival,38,23,15
Fabfilter,tichondrius,1564,hunter,survival,40,21,19
Ripsurvival,area-52,1561,hunter,survival,28,18,10
Mckennagrace,tichondrius,1558,hunter,survival,54,29,25
Shooting,sargeras,1555,hunter,survival,64,35,29
Interleukin,frostwolf,1554,hunter,survival,90,50,40
Equilibrium,tol-barad,1554,hunter,survival,74,40,34
Berenal,moon-guard,1554,hunter,survival,144,69,75
Trap,vashj,1553,hunter,survival,30,19,11
Kukulkan,haomarush,1553,hunter,survival,99,53,46
Huntasaurus,saurfang,1553,hunter,survival,66,32,34
Nicochan,senjin,1551,hunter,survival,66,28,38
Legalt,tichondrius,1550,hunter,survival,42,24,18
Asarden,jubeithos,1550,hunter,survival,42,23,19
Viólenc,tichondrius,1548,hunter,survival,36,18,18
Kurnos,hyjal,1547,hunter,survival,24,18,6
Krouno,ragnaros,1543,hunter,survival,36,18,18
Xenonviper,bleeding-hollow,1535,hunter,survival,60,29,31
Garfieldbb,tichondrius,1531,hunter,survival,36,16,20
Pfizershot,tichondrius,1526,hunter,survival,42,23,19
Sativ,moknathal,1524,hunter,survival,54,27,27
Fâmôûs,tichondrius,1522,hunter,survival,30,17,13
Pivott,wyrmrest-accord,1521,hunter,survival,136,71,65
Dorkins,azralon,1521,hunter,survival,75,35,40
Meowtard,kaelthas,1520,hunter,survival,66,31,35
Ronnïn,proudmoore,1517,hunter,survival,42,21,21
Hildebald,moon-guard,1514,hunter,survival,42,25,17
Lyler,tichondrius,1514,hunter,survival,40,23,17
Ceejaee,tichondrius,1511,hunter,survival,66,31,35
Hunterdemond,ragnaros,1509,hunter,survival,65,35,30
Fkurrules,frostmourne,1505,hunter,survival,75,39,36
Jubulba,frostwolf,1502,hunter,survival,24,16,8
Helïos,drakkari,1495,hunter,survival,30,16,14
Tharoks,tichondrius,1494,hunter,survival,42,21,21
Uhm,laughing-skull,1490,hunter,survival,52,28,24
Vinnieone,kiljaeden,1487,hunter,survival,24,16,8
Rúdrá,area-52,1487,hunter,survival,81,43,38
Rooman,ragnaros,1477,hunter,survival,48,24,24
Altarare,ragnaros,1475,hunter,survival,221,106,115
Nussyo,tichondrius,1474,hunter,survival,30,17,13
Eliandriss,quelthalas,1468,hunter,survival,70,33,37
Gadorim,kelthuzad,1465,hunter,survival,115,54,61
Met,dentarg,1462,hunter,survival,30,16,14
Hrywnn,azralon,1461,hunter,survival,165,86,79
Alby,deathwing,1459,hunter,survival,67,33,34
Tuohnosaj,sargeras,1454,hunter,survival,72,33,39
Dversive,nagrand,1452,hunter,survival,33,18,15
Kimbaa,tichondrius,1449,hunter,survival,37,16,21
Dephobius,azralon,1447,hunter,survival,42,19,23
Shtealo,ragnaros,1443,hunter,survival,60,31,29
Gildthorn,frostmourne,1441,hunter,survival,36,20,16
Seanpennis,barthilas,1437,hunter,survival,24,15,9
Darkèlfo,azralon,1437,hunter,survival,54,32,22
Dirtysoap,sargeras,1437,hunter,survival,36,15,21
Krimzus,hyjal,1436,hunter,survival,42,21,21
Jarhar,nesingwary,1432,hunter,survival,96,44,52
Kensho,illidan,1432,hunter,survival,36,15,21
Sensator,barthilas,1430,hunter,survival,24,15,9
Scytsbow,illidan,1430,hunter,survival,24,15,9
Titanaxis,tichondrius,1428,hunter,survival,101,46,55
Volkr,bleeding-hollow,1427,hunter,survival,90,44,46
Moartraps,zuljin,1425,hunter,survival,24,15,9
Evilfury,tichondrius,1425,hunter,survival,134,65,69
Kula,haomarush,1424,hunter,survival,52,24,28
Dooper,malfurion,1424,hunter,survival,57,22,35
Shadeckz,stormrage,1423,hunter,survival,74,32,42
Pdg,ragnaros,1422,hunter,survival,54,31,23
Axezul,tichondrius,1422,hunter,survival,30,15,15
Grizzlydeath,stormrage,1421,hunter,survival,48,30,18
Soulwarden,haomarush,1417,hunter,survival,36,17,19
Exxonerous,sargeras,1414,hunter,survival,72,37,35
Mayamia,ragnaros,1413,hunter,survival,54,24,30
Ivansotes,quelthalas,1409,hunter,survival,39,18,21
Weedhoof,barthilas,1406,hunter,survival,54,30,24
Dudemanyeah,black-dragonflight,1406,hunter,survival,100,47,53
Snowynightt,proudmoore,1406,hunter,survival,84,31,53
Schurk,illidan,1405,hunter,survival,72,33,39
Triplethreat,bleeding-hollow,1403,hunter,survival,42,18,24
Dazarrow,burning-blade,1398,hunter,survival,35,15,20
Apokryph,stormrage,1394,hunter,survival,48,35,13
Zänich,tichondrius,1387,hunter,survival,36,18,18
Fallacies,moon-guard,1387,hunter,survival,72,35,37
Toross,stormscale,1379,hunter,survival,73,29,44
Zorht,ragnaros,1378,hunter,survival,146,76,70
Rirand,dalaran,1376,hunter,survival,53,26,27
Luckboy,tichondrius,1371,hunter,survival,108,54,54
Killconfirm,sargeras,1369,hunter,survival,59,24,35
Fìebs,queldorei,1368,hunter,survival,53,25,28
Navagee,tichondrius,1364,hunter,survival,47,25,22
Thalrae,quelthalas,1363,hunter,survival,30,16,14
Rayuwa,azralon,1358,hunter,survival,46,21,25
Wetpeach,frostmourne,1352,hunter,survival,46,23,23
Gunka,illidan,1349,hunter,survival,35,17,18
Lfg,bleeding-hollow,1345,hunter,survival,23,15,8
Lamerpvp,tichondrius,1343,hunter,survival,18,14,4
Ikiteforfood,zuljin,1343,hunter,survival,24,14,10
Cocobread,stormreaver,1343,hunter,survival,96,41,55
Tumerok,barthilas,1342,hunter,survival,24,14,10
Soyos,sargeras,1342,hunter,survival,41,16,25
Ryonel,moon-guard,1341,hunter,survival,161,79,82
Wingclippin,stormrage,1338,hunter,survival,24,16,8
Jollycraze,spirestone,1337,hunter,survival,18,14,4
Sniffler,barthilas,1337,hunter,survival,36,14,22
Blackdevil,magtheridon,1333,hunter,survival,30,14,16
Pedropete,barthilas,1331,hunter,survival,36,14,22
Audiofly,tichondrius,1329,hunter,survival,42,22,20
Bigsexi,kiljaeden,1329,hunter,survival,62,27,35
Viró,sargeras,1325,hunter,survival,27,15,12
Taiberianrex,khazgoroth,1317,hunter,survival,48,28,20
Buggyhuntz,stormrage,1317,hunter,survival,42,16,26
Core,gorefiend,1315,hunter,survival,30,14,16
Chiad,kargath,1313,hunter,survival,36,22,14
Henesis,sargeras,1312,hunter,survival,42,18,24
Dirtysoap,tichondrius,1310,hunter,survival,28,14,14
Gichiwalrus,emerald-dream,1306,hunter,survival,54,29,25
Draban,stormrage,1305,hunter,survival,30,14,16
Duckpow,frostmourne,1305,hunter,survival,54,23,31
Kyoü,drakkari,1303,hunter,survival,24,16,8
Darkarrow,hyjal,1302,hunter,survival,31,16,15
Dreebizz,gorefiend,1294,hunter,survival,62,25,37
Félíx,ragnaros,1292,hunter,survival,36,15,21
Hovahdo,proudmoore,1287,hunter,survival,29,14,15
Hawkethorn,moon-guard,1286,hunter,survival,72,28,44
Rogaldornn,thrall,1280,hunter,survival,47,23,24
Lashga,wyrmrest-accord,1279,hunter,survival,45,17,28
Orgpopeyes,illidan,1275,hunter,survival,37,15,22
Civvo,dalaran,1272,hunter,survival,33,15,18
Vongard,wyrmrest-accord,1272,hunter,survival,40,18,22
Firesail,kelthuzad,1268,hunter,survival,42,20,22
Gxswow,tichondrius,1268,hunter,survival,66,30,36
Ghuntcassh,quelthalas,1262,hunter,survival,30,18,12
Budika,ragnaros,1247,hunter,survival,18,13,5
Fancyox,frostmourne,1247,hunter,survival,18,13,5
Hawkem,illidan,1246,hunter,survival,24,13,11
Svhunt,frostmourne,1243,hunter,survival,26,13,13
Ariädne,sargeras,1239,hunter,survival,72,27,45
Kenjipoo,tichondrius,1238,hunter,survival,24,13,11
Offensive,dragonmaw,1222,hunter,survival,31,14,17
Rojpube,frostmourne,1215,hunter,survival,29,13,16
Arkeryn,azralon,1203,hunter,survival,18,13,5
Mypeach,frostmourne,1200,hunter,survival,30,13,17
Rykbad,area-52,1195,hunter,survival,24,13,11
Wartoz,dragonblight,1190,hunter,survival,59,40,19
Rairin,tichondrius,1190,hunter,survival,47,20,27
Vhan,azralon,1187,hunter,survival,42,21,21
Bangerzx,stormrage,1185,hunter,survival,24,13,11
Nigthunt,quelthalas,1176,hunter,survival,27,13,14
Gruì,malganis,1168,hunter,survival,26,13,13
Gigabigly,wyrmrest-accord,1152,hunter,survival,18,12,6
Moroally,sargeras,1152,hunter,survival,24,12,12
Åpe,illidan,1150,hunter,survival,18,12,6
Laralodge,stormrage,1150,hunter,survival,72,29,43
Barnbougle,sargeras,1149,hunter,survival,18,12,6
Crimsoncoast,tichondrius,1149,hunter,survival,18,12,6
Bolognã,tichondrius,1149,hunter,survival,24,12,12
Giraffetrap,zuljin,1147,hunter,survival,18,12,6
Freebeë,area-52,1147,hunter,survival,24,12,12
Rhyzen,drenden,1146,hunter,survival,18,12,6
Kekkww,hyjal,1146,hunter,survival,24,12,12
Sukr,korgath,1143,hunter,survival,27,13,14
Arcos,emerald-dream,1138,hunter,survival,18,12,6
Vansatih,azralon,1138,hunter,survival,64,38,26
Xitara,stormrage,1137,hunter,survival,24,12,12
Chopsley,feathermoon,1136,hunter,survival,71,30,41
Huntardadoo,nemesis,1135,hunter,survival,23,12,11
Eastera,tichondrius,1119,hunter,survival,68,30,38
Poston,ragnaros,1116,hunter,survival,29,12,17
Allahakbar,ragnaros,1110,hunter,survival,24,12,12
Nanotorque,moon-guard,1104,hunter,survival,55,23,32
Lesseneth,aegwynn,1072,hunter,survival,42,17,25
Scythedom,tichondrius,1056,hunter,survival,18,11,7
Plsbepatient,wyrmrest-accord,1054,hunter,survival,18,11,7
Expskippy,darkspear,1054,hunter,survival,30,18,12
Jaw,hakkar,1053,hunter,survival,18,11,7
Reignwolf,nemesis,1053,hunter,survival,18,11,7
Bowzørx,tichondrius,1053,hunter,survival,24,11,13
Kukulkán,muradin,1048,hunter,survival,24,11,13
Zhafiro,drakkari,1037,hunter,survival,24,14,10
Panm,runetotem,1034,hunter,survival,27,12,15
Gairkill,area-52,1026,hunter,survival,89,48,41
Aniraza,ragnaros,999,hunter,survival,21,11,10
Lucarcher,stormrage,988,hunter,survival,17,11,6
Kaïmsael,kelthuzad,985,hunter,survival,30,18,12
Thrandrial,smolderthorn,985,hunter,survival,20,11,9
Hellrayserr,azralon,970,hunter,survival,24,11,13
Vanthel,ragnaros,966,hunter,survival,27,12,15
Boogiemas,akama,960,hunter,survival,12,10,2
Virindi,barthilas,960,hunter,survival,12,10,2
Ickstab,illidan,960,hunter,survival,12,10,2
Corpo,area-52,960,hunter,survival,24,10,14
Covlolzz,illidan,960,hunter,survival,24,10,14
Zipzyo,tichondrius,960,hunter,survival,24,10,14
Snipin,ragnaros,960,hunter,survival,30,10,20
Kêdokî,sargeras,959,hunter,survival,12,10,2
Piñg,tichondrius,959,hunter,survival,18,10,8
Anêmos,ragnaros,959,hunter,survival,18,10,8
Plainrain,tichondrius,959,hunter,survival,18,10,8
Tyleraq,area-52,959,hunter,survival,18,10,8
Ifoxs,bleeding-hollow,959,hunter,survival,18,10,8
Venoc,bleeding-hollow,959,hunter,survival,24,10,14
Haemøphilus,area-52,958,hunter,survival,18,10,8
Fangtreason,sargeras,958,hunter,survival,18,10,8
Downer,antonidas,958,hunter,survival,24,10,14
Randël,nemesis,957,hunter,survival,18,10,8
Daréz,blackrock,956,hunter,survival,16,11,5
Mmx,whisperwind,956,hunter,survival,18,10,8
Shytshot,dalaran,954,hunter,survival,24,10,14
Syvarris,medivh,943,hunter,survival,17,10,7
Demtings,dark-iron,925,hunter,survival,32,11,21
Lavo,borean-tundra,923,hunter,survival,25,10,15
Tempistworg,greymane,919,hunter,survival,28,12,16
Survïvalïst,bleeding-hollow,911,hunter,survival,17,10,7
Liñcoln,sargeras,895,hunter,survival,16,10,6
Khaoskills,thunderlord,884,hunter,survival,24,11,13
Puffcopeak,illidan,864,hunter,survival,12,9,3
Tigglyjits,tichondrius,864,hunter,survival,12,9,3
Jaywaz,tichondrius,864,hunter,survival,12,9,3
Weedzy,tichondrius,864,hunter,survival,12,9,3
Hunterguyy,tichondrius,864,hunter,survival,12,9,3
Desari,thunderhorn,864,hunter,survival,18,9,9
Broskina,stormrage,864,hunter,survival,18,9,9
Drunknachos,bleeding-hollow,864,hunter,survival,18,9,9
Scottmeyers,proudmoore,864,hunter,survival,24,9,15
Sarvaxagar,tichondrius,863,hunter,survival,18,9,9
Grandpopjim,illidan,863,hunter,survival,18,9,9
Landscape,kiljaeden,863,hunter,survival,24,9,15
Vulkru,azralon,862,hunter,survival,18,9,9
Inheart,khazgoroth,862,hunter,survival,18,9,9
Htniss,tichondrius,862,hunter,survival,18,9,9
Packlead,sargeras,861,hunter,survival,18,9,9
Zotahunterx,ragnaros,859,hunter,survival,24,9,15
Obsididan,aerie-peak,855,hunter,survival,24,9,15
Prettysure,nesingwary,851,hunter,survival,25,12,13
Shukucingjr,illidan,842,hunter,survival,18,9,9
Blaymorrd,senjin,839,hunter,survival,18,9,9
Trapgodxo,moon-guard,816,hunter,survival,15,10,5
Kimchishotxo,tichondrius,815,hunter,survival,17,9,8
Tyjes,stormrage,768,hunter,survival,12,8,4
Toozz,frostmourne,768,hunter,survival,12,8,4
Hazzeth,thrall,768,hunter,survival,12,8,4
Viiu,sargeras,768,hunter,survival,12,8,4
Árröw,arygos,768,hunter,survival,12,8,4
Iizerd,illidan,768,hunter,survival,12,8,4
Fineye,illidan,768,hunter,survival,14,8,6
Diddycombe,stormrage,768,hunter,survival,18,8,10
Kimssis,tichondrius,768,hunter,survival,18,8,10
Buttercocoa,kelthuzad,768,hunter,survival,18,8,10
Maxlol,stormrage,768,hunter,survival,18,8,10
Eref,sargeras,768,hunter,survival,24,8,16
Bicflop,azralon,767,hunter,survival,12,8,4
Korasaya,area-52,767,hunter,survival,18,8,10
Raiku,aggramar,767,hunter,survival,18,8,10
Wakkå,mugthol,767,hunter,survival,21,9,12
Mmchode,zuljin,767,hunter,survival,24,8,16
Chokemescara,stormrage,767,hunter,survival,30,8,22
Greyh,madoran,766,hunter,survival,12,8,4
Hunfor,anubarak,766,hunter,survival,18,8,10
Chicall,kalecgos,765,hunter,survival,18,8,10
Lohse,emerald-dream,765,hunter,survival,18,8,10
Loochlin,sargeras,765,hunter,survival,21,8,13
Akigga,arthas,764,hunter,survival,12,8,4
Sterge,maiev,764,hunter,survival,18,8,10
Eithelleta,frostmourne,764,hunter,survival,18,8,10
Haumer,wyrmrest-accord,763,hunter,survival,12,8,4
Thoriden,amanthul,762,hunter,survival,36,8,28
Iraxium,illidan,735,hunter,survival,14,9,5
Dirtypolee,bleeding-hollow,719,hunter,survival,17,8,9
Thrakgor,wyrmrest-accord,713,hunter,survival,23,10,13
Ropivacaine,illidan,672,hunter,survival,12,7,5
Mattyhuntz,tichondrius,672,hunter,survival,12,7,5
Magvez,tichondrius,672,hunter,survival,12,7,5
Arcobaleno,tichondrius,672,hunter,survival,12,7,5
Seratoninx,malganis,672,hunter,survival,12,7,5
Pfheign,area-52,672,hunter,survival,12,7,5
Shinhyez,tichondrius,672,hunter,survival,12,7,5
Joree,medivh,672,hunter,survival,12,7,5
Jamesön,sargeras,672,hunter,survival,12,7,5
Rickybobby,warsong,672,hunter,survival,12,7,5
Oronir,frostmourne,672,hunter,survival,12,7,5
Fannypacks,dragonmaw,672,hunter,survival,12,7,5
Lovevv,frostmourne,672,hunter,survival,12,7,5
Twodoobies,ghostlands,672,hunter,survival,12,7,5
Vânillaice,stormrage,672,hunter,survival,12,7,5
Egurl,firetree,672,hunter,survival,12,7,5
Ozzsimp,stormrage,672,hunter,survival,12,7,5
Awârz,drakkari,672,hunter,survival,12,7,5
Arraza,ragnaros,672,hunter,survival,12,7,5
Onécare,bleeding-hollow,672,hunter,survival,12,7,5
Meowimadog,spinebreaker,672,hunter,survival,18,7,11
Snoopinator,malganis,672,hunter,survival,18,7,11
Porrainga,auchindoun,672,hunter,survival,18,7,11
Trumpmerica,illidan,672,hunter,survival,18,7,11
Bombbot,zuljin,672,hunter,survival,18,7,11
Ajira,stormrage,671,hunter,survival,12,7,5
Genocell,thunderlord,671,hunter,survival,12,7,5
Sarqis,lightbringer,671,hunter,survival,12,7,5
Ziaxel,bleeding-hollow,671,hunter,survival,12,7,5
Turquesaa,wyrmrest-accord,670,hunter,survival,12,7,5
Nowê,azralon,670,hunter,survival,18,7,11
Catboikilla,ravencrest,639,hunter,survival,17,7,10
Rotthem,ragnaros,638,hunter,survival,20,8,12
Trappin,malganis,623,hunter,survival,11,7,4
Éshen,illidan,623,hunter,survival,11,7,4
Lartrius,bleeding-hollow,621,hunter,survival,15,8,7
Arrebol,tichondrius,608,hunter,survival,16,7,9
Odynshowl,stormrage,605,hunter,survival,11,7,4
Ðevil,ragnaros,576,hunter,survival,6,6,0
Ÿöskë,tichondrius,576,hunter,survival,6,6,0
Ivanjackenov,illidan,576,hunter,survival,10,7,3
Brewster,burning-legion,576,hunter,survival,12,6,6
Wezkerh,ragnaros,576,hunter,survival,12,6,6
Drupert,tichondrius,576,hunter,survival,12,6,6
Turkshot,area-52,576,hunter,survival,12,6,6
Traponomics,stormrage,576,hunter,survival,12,6,6
Frêäkk,ragnaros,576,hunter,survival,12,6,6
Woeisyou,stormrage,576,hunter,survival,12,6,6
Jésús,dalaran,576,hunter,survival,12,6,6
Kelx,azralon,576,hunter,survival,12,6,6
Pilesofpoop,sargeras,576,hunter,survival,12,6,6
Tazsic,mannoroth,576,hunter,survival,12,6,6
Zerark,kelthuzad,576,hunter,survival,13,6,7
Kimchimaster,tichondrius,576,hunter,survival,18,6,12
Emart,bloodhoof,576,hunter,survival,18,6,12
Xfo,bleeding-hollow,575,hunter,survival,12,6,6
Týrak,illidan,575,hunter,survival,12,6,6
Animityx,illidan,575,hunter,survival,12,6,6
Xeiana,proudmoore,575,hunter,survival,12,6,6
Vortann,proudmoore,575,hunter,survival,18,6,12
Bushytails,illidan,573,hunter,survival,18,6,12
Opsi,ragnaros,559,hunter,survival,11,6,5
Tyrokk,barthilas,543,hunter,survival,18,6,12
Dräkö,tichondrius,527,hunter,survival,15,7,8
Hediilyan,azralon,522,hunter,survival,16,7,9
Pxry,drenden,511,hunter,survival,11,6,5
Jäger,zuljin,480,hunter,survival,6,5,1
Lawyerpbj,tichondrius,480,hunter,survival,6,5,1
Narukín,tichondrius,480,hunter,survival,6,5,1
Selenis,khadgar,480,hunter,survival,6,5,1
Tmzsteezy,tichondrius,480,hunter,survival,6,5,1
Gufanyaun,tichondrius,480,hunter,survival,6,5,1
Keenai,moon-guard,480,hunter,survival,6,5,1
Jonah,sargeras,480,hunter,survival,6,5,1
Kanta,bleeding-hollow,480,hunter,survival,6,5,1
Neverturtlex,tichondrius,480,hunter,survival,6,5,1
Casadega,sargeras,480,hunter,survival,10,6,4
Lorethor,kaelthas,480,hunter,survival,12,5,7
Shakeasaurus,sargeras,480,hunter,survival,12,5,7
Alansho,tichondrius,480,hunter,survival,12,5,7
Firskin,frostmourne,480,hunter,survival,12,5,7
Downrange,stonemaul,480,hunter,survival,12,5,7
Minxed,sargeras,480,hunter,survival,12,5,7
Goromi,tichondrius,480,hunter,survival,12,5,7
Mìtáng,moon-guard,480,hunter,survival,12,5,7
Mambothehunt,stormrage,480,hunter,survival,12,5,7
Shootnoscore,vashj,480,hunter,survival,15,6,9
Cufless,proudmoore,480,hunter,survival,18,5,13
Querosushi,ragnaros,479,hunter,survival,12,5,7
Belvhar,skullcrusher,479,hunter,survival,12,5,7
Sealteamrick,frostmourne,479,hunter,survival,12,5,7
Emiri,dalaran,479,hunter,survival,18,5,13
Crumpit,moon-guard,426,hunter,survival,22,6,16
Cinnybunz,malganis,415,hunter,survival,16,6,10
Rinehart,dalaran,415,hunter,survival,14,5,9
Jawbreakër,tichondrius,400,hunter,survival,13,5,8
Nastoid,area-52,384,hunter,survival,6,4,2
Huntardxo,moon-guard,384,hunter,survival,6,4,2
Chasseür,quelthalas,384,hunter,survival,6,4,2
Bigpets,azralon,384,hunter,survival,6,4,2
Lovoo,sargeras,384,hunter,survival,6,4,2
Hunterlolxd,altar-of-storms,384,hunter,survival,6,4,2
Thalyxion,moon-guard,384,hunter,survival,6,4,2
Æßç,ragnaros,384,hunter,survival,6,4,2
Lasagnadaddy,maiev,384,hunter,survival,6,4,2
Petstun,moon-guard,384,hunter,survival,6,4,2
Drachl,moon-guard,384,hunter,survival,6,4,2
Zouzu,area-52,384,hunter,survival,6,4,2
Equalizér,sargeras,384,hunter,survival,6,4,2
Negligent,sargeras,384,hunter,survival,6,4,2
Pokeahuntasz,frostmourne,384,hunter,survival,6,4,2
Spinze,stormrage,384,hunter,survival,6,4,2
Rankonee,area-52,384,hunter,survival,6,4,2
Alfaan,moon-guard,384,hunter,survival,6,4,2
Bendoon,sargeras,384,hunter,survival,6,4,2
Litchi,illidan,384,hunter,survival,6,4,2
Spitballa,emerald-dream,384,hunter,survival,6,4,2
Swagprince,skullcrusher,384,hunter,survival,6,4,2
Ehhee,twisting-nether,384,hunter,survival,6,4,2
Yiyixx,tichondrius,384,hunter,survival,6,4,2
Ðfac,moon-guard,384,hunter,survival,6,4,2
Arrowmatic,frostmourne,384,hunter,survival,6,4,2
Terapista,area-52,384,hunter,survival,6,4,2
Mokuraak,emerald-dream,384,hunter,survival,6,4,2
Ratherbully,tichondrius,384,hunter,survival,6,4,2
Trapdaddyx,thrall,384,hunter,survival,6,4,2
Ikitefordmt,zuljin,384,hunter,survival,6,4,2
Thefanbus,tichondrius,384,hunter,survival,6,4,2
Boomseed,nagrand,384,hunter,survival,6,4,2
Mameikilled,saurfang,384,hunter,survival,6,4,2
Glediator,tichondrius,384,hunter,survival,6,4,2
Prêd,malganis,384,hunter,survival,6,4,2
Ruskö,tichondrius,384,hunter,survival,7,4,3
Hyena,kelthuzad,384,hunter,survival,9,5,4
Leftty,illidan,384,hunter,survival,12,4,8
Gunicks,illidan,384,hunter,survival,12,4,8
Violénc,tichondrius,384,hunter,survival,12,4,8
Skriill,tichondrius,384,hunter,survival,12,4,8
Camfeed,illidan,384,hunter,survival,12,4,8
Oatmeallover,stormrage,384,hunter,survival,12,4,8
Stupidgodx,tichondrius,384,hunter,survival,12,4,8
Gaezangsu,tichondrius,384,hunter,survival,12,4,8
Ariran,illidan,384,hunter,survival,12,4,8
Michaeljfox,area-52,384,hunter,survival,12,4,8
Sharkzooka,illidan,384,hunter,survival,12,4,8
Fâpple,stormrage,384,hunter,survival,12,4,8
Eforas,ragnaros,384,hunter,survival,12,4,8
Braindeadorc,illidan,384,hunter,survival,12,4,8
Aaggros,sargeras,384,hunter,survival,12,4,8
Banai,the-underbog,384,hunter,survival,12,4,8
Wolfsok,norgannon,384,hunter,survival,12,4,8
Éygon,sargeras,384,hunter,survival,12,4,8
Wkx,tichondrius,384,hunter,survival,12,4,8
Lahinch,darkspear,384,hunter,survival,12,4,8
Alphaqt,dethecus,384,hunter,survival,12,4,8
Keenz,frostmourne,384,hunter,survival,12,4,8
Cakeislife,kelthuzad,384,hunter,survival,18,4,14
Tydee,nagrand,383,hunter,survival,18,4,14
Platonium,stormrage,351,hunter,survival,8,5,3
Acidhunt,tichondrius,320,hunter,survival,16,4,12
Adamariss,stormrage,319,hunter,survival,16,4,12
Mistrj,frostmourne,288,hunter,survival,6,3,3
Slowhunterr,tichondrius,288,hunter,survival,6,3,3
Yøske,tichondrius,288,hunter,survival,6,3,3
Trenbolone,frostmourne,288,hunter,survival,6,3,3
Moistbooger,emerald-dream,288,hunter,survival,6,3,3
Petkd,frostmourne,288,hunter,survival,6,3,3
Whitemàne,dalaran,288,hunter,survival,6,3,3
Chiline,frostmourne,288,hunter,survival,6,3,3
Walterwhite,trollbane,288,hunter,survival,6,3,3
Dirtymongrel,barthilas,288,hunter,survival,6,3,3
Makeastinky,malfurion,288,hunter,survival,6,3,3
Cantantie,tichondrius,288,hunter,survival,6,3,3
Twom,area-52,288,hunter,survival,6,3,3
Badseedz,kargath,288,hunter,survival,6,3,3
Soukken,ragnaros,288,hunter,survival,6,3,3
Pridefulzjr,stormrage,288,hunter,survival,6,3,3
Trapmasterx,tichondrius,288,hunter,survival,6,3,3
Hazzersk,ragnaros,288,hunter,survival,6,3,3
Pistolon,quelthalas,288,hunter,survival,6,3,3
Gaahl,aggramar,288,hunter,survival,6,3,3
Spårrow,alleria,288,hunter,survival,6,3,3
Zà,sargeras,288,hunter,survival,6,3,3
Glockin,zuljin,288,hunter,survival,6,3,3
Gorgrokk,area-52,288,hunter,survival,6,3,3
Soul,sargeras,288,hunter,survival,6,3,3
Embaçado,bleeding-hollow,288,hunter,survival,6,3,3
Loogan,sargeras,288,hunter,survival,6,3,3
Wooftoof,frostmourne,288,hunter,survival,6,3,3
Thesniperx,sargeras,288,hunter,survival,6,3,3
Ünitedi,nemesis,288,hunter,survival,6,3,3
Furipoon,stormrage,288,hunter,survival,6,3,3
Fälke,stormrage,288,hunter,survival,6,3,3
Calidian,moon-guard,288,hunter,survival,6,3,3
Rûff,azralon,288,hunter,survival,6,3,3
Mythfive,stormrage,288,hunter,survival,6,3,3
Lowlore,moon-guard,288,hunter,survival,6,3,3
Fearna,destromath,288,hunter,survival,6,3,3
Kharñe,tichondrius,288,hunter,survival,12,3,9
Cndavyjones,akama,288,hunter,survival,12,3,9
Lixniqua,tichondrius,288,hunter,survival,12,3,9
Huntranger,malganis,288,hunter,survival,12,3,9
Daxar,ragnaros,288,hunter,survival,12,3,9
Gutshott,tichondrius,288,hunter,survival,12,3,9
Kalibah,azralon,288,hunter,survival,12,3,9
Calvarîam,korgath,288,hunter,survival,12,3,9
Aiyanafox,moon-guard,288,hunter,survival,12,3,9
Iol,blades-edge,288,hunter,survival,12,3,9
Vizkha,azralon,287,hunter,survival,6,3,3
Drunkbunny,tichondrius,271,hunter,survival,11,3,8
Mokaonly,wildhammer,256,hunter,survival,8,4,4
Crèpes,bleeding-hollow,239,hunter,survival,5,3,2
Yogurtti,zuljin,239,hunter,survival,5,3,2
Raeshots,area-52,233,hunter,survival,15,5,10
Moscato,cenarion-circle,232,hunter,survival,14,4,10
Rifomen,illidan,192,hunter,survival,9,3,6
Sebastian,blackhand,192,hunter,survival,6,2,4
Sunchea,arygos,192,hunter,survival,6,2,4
Xoxono,frostmourne,192,hunter,survival,6,2,4
Gunudown,haomarush,192,hunter,survival,6,2,4
Lenyuecf,proudmoore,192,hunter,survival,6,2,4
Blackjesu,blackrock,192,hunter,survival,6,2,4
Mckim,tichondrius,192,hunter,survival,6,2,4
Trígger,azshara,192,hunter,survival,6,2,4
Nahzah,stormrage,192,hunter,survival,6,2,4
Zellor,wyrmrest-accord,192,hunter,survival,6,2,4
Bboo,bonechewer,192,hunter,survival,6,2,4
Cosmodome,daggerspine,192,hunter,survival,6,2,4
Zèd,azralon,192,hunter,survival,6,2,4
Eclipsie,aerie-peak,192,hunter,survival,6,2,4
Toruhagakure,tichondrius,192,hunter,survival,6,2,4
Achilles,twisting-nether,192,hunter,survival,6,2,4
Gaim,dalaran,192,hunter,survival,6,2,4
Dobuu,tichondrius,192,hunter,survival,6,2,4
Oattes,daggerspine,192,hunter,survival,6,2,4
Cio,fizzcrank,192,hunter,survival,6,2,4
Gomrog,gurubashi,192,hunter,survival,6,2,4
Rainzs,stormrage,192,hunter,survival,6,2,4
Kravern,ragnaros,192,hunter,survival,6,2,4
Zackèse,area-52,192,hunter,survival,6,2,4
Araghrn,draktharon,192,hunter,survival,6,2,4
Vietnrg,doomhammer,192,hunter,survival,6,2,4
Woobinman,tichondrius,192,hunter,survival,6,2,4
Côckblocked,tichondrius,192,hunter,survival,6,2,4
Mirdous,moon-guard,192,hunter,survival,6,2,4
Zakorai,thrall,192,hunter,survival,6,2,4
Dfnhdft,stormrage,192,hunter,survival,6,2,4
Pedropete,frostmourne,192,hunter,survival,6,2,4
Comebacks,ragnaros,192,hunter,survival,6,2,4
Henroyer,quelthalas,192,hunter,survival,6,2,4
Slipox,sargeras,192,hunter,survival,6,2,4
Harposmash,trollbane,192,hunter,survival,6,2,4
Shaftgravy,area-52,192,hunter,survival,6,2,4
Stylebende,tichondrius,192,hunter,survival,6,2,4
Gswag,malganis,192,hunter,survival,6,2,4
Imraghorn,sargeras,192,hunter,survival,6,2,4
Splewsh,area-52,192,hunter,survival,6,2,4
Gobygobbs,magtheridon,192,hunter,survival,6,2,4
Nelandris,tichondrius,192,hunter,survival,6,2,4
Sharpster,zuljin,192,hunter,survival,6,2,4
Rimbar,ysera,192,hunter,survival,6,2,4
Clampula,sargeras,192,hunter,survival,6,2,4
Kaldrool,frostmourne,192,hunter,survival,12,2,10
Skrìms,tichondrius,192,hunter,survival,12,2,10
Linova,stormrage,192,hunter,survival,12,2,10
Zhona,moon-guard,192,hunter,survival,12,2,10
Lawafla,area-52,138,hunter,survival,8,3,5
Xradû,dawnbringer,138,hunter,survival,9,3,6
Morganson,moon-guard,138,hunter,survival,22,4,18
Bránn,quelthalas,128,hunter,survival,4,2,2
Narakara,stormreaver,128,hunter,survival,5,2,3
Fenrock,cenarius,96,hunter,survival,3,2,1
Whitecake,area-52,96,hunter,survival,3,2,1
Kölhberg,azralon,96,hunter,survival,6,1,5
Jumpkick,azralon,96,hunter,survival,6,1,5
Huntingjutsu,kelthuzad,96,hunter,survival,6,1,5
Wildhùnt,tichondrius,96,hunter,survival,6,1,5
Waylòn,moon-guard,96,hunter,survival,6,1,5
Lammy,bleeding-hollow,96,hunter,survival,6,1,5
Sobala,azralon,96,hunter,survival,6,1,5
Dusle,azralon,96,hunter,survival,6,1,5
Esser,mannoroth,96,hunter,survival,6,1,5
Nucleosome,stormrage,96,hunter,survival,6,1,5
Feorbxl,proudmoore,96,hunter,survival,6,1,5
Jîlt,aerie-peak,96,hunter,survival,6,1,5
Weegnomie,wyrmrest-accord,96,hunter,survival,6,1,5
Nevertraps,tichondrius,96,hunter,survival,6,1,5
Tejodite,thrall,96,hunter,survival,6,1,5
Survbot,malganis,96,hunter,survival,6,1,5
Fearlesarrow,suramar,96,hunter,survival,6,1,5
Taofang,emerald-dream,96,hunter,survival,6,1,5
Bloodarrow,tichondrius,96,hunter,survival,6,1,5
Lance,darrowmere,96,hunter,survival,6,1,5
Legosshi,darrowmere,96,hunter,survival,6,1,5
Montakka,illidan,79,hunter,survival,5,1,4
Luangg,tichondrius,31,hunter,survival,2,1,1
Therealpafo,tichondrius,31,hunter,survival,8,1,7
Saiiph,bleeding-hollow,2274,hunter,beastmastery,136,76,60
Sphericsnow,shuhalo,2210,hunter,beastmastery,95,51,44
Missedmytrap,agamaggan,2149,hunter,beastmastery,80,46,34
Eref,sargeras,2116,hunter,beastmastery,78,42,36
Wmsgs,tichondrius,2091,hunter,beastmastery,123,61,62
Maiyev,quelthalas,2074,hunter,beastmastery,95,52,43
Fish,darkspear,2070,hunter,beastmastery,90,45,45
Hfn,stormrage,2058,hunter,beastmastery,70,37,33
Warpath,ursin,2057,hunter,beastmastery,102,56,46
Pãrzival,tichondrius,2042,hunter,beastmastery,60,30,30
Manyu,tichondrius,2035,hunter,beastmastery,69,34,35
Zujo,emerald-dream,2030,hunter,beastmastery,149,74,75
Hazzersk,ragnaros,2023,hunter,beastmastery,155,75,80
Axlee,tichondrius,2011,hunter,beastmastery,144,72,72
Kensho,illidan,2007,hunter,beastmastery,118,62,56
Cannondale,tichondrius,1993,hunter,beastmastery,36,21,15
Beastmunster,frostmourne,1984,hunter,beastmastery,72,34,38
Pokìmane,tichondrius,1980,hunter,beastmastery,74,44,30
Antø,tichondrius,1978,hunter,beastmastery,117,56,61
Outz,anvilmar,1952,hunter,beastmastery,222,111,111
Arcobaleno,tichondrius,1952,hunter,beastmastery,89,44,45
Nutellacrepe,kelthuzad,1949,hunter,beastmastery,152,80,72
Øverdose,ragnaros,1935,hunter,beastmastery,54,28,26
Arsk,ragnaros,1934,hunter,beastmastery,136,70,66
Zugbrained,illidan,1925,hunter,beastmastery,142,78,64
Blackathena,tichondrius,1922,hunter,beastmastery,126,65,61
Wodhunterxdd,sargeras,1915,hunter,beastmastery,70,34,36
Orber,stormrage,1914,hunter,beastmastery,254,131,123
Headshotzplz,tichondrius,1912,hunter,beastmastery,62,34,28
Ashenga,cairne,1910,hunter,beastmastery,114,64,50
Nollzey,frostmourne,1903,hunter,beastmastery,39,21,18
Nyxus,tichondrius,1887,hunter,beastmastery,125,63,62
Lamerpvp,tichondrius,1885,hunter,beastmastery,50,31,19
Edarkness,gurubashi,1884,hunter,beastmastery,103,51,52
Perawantua,frostmourne,1878,hunter,beastmastery,61,35,26
Ñotorious,frostmane,1878,hunter,beastmastery,42,24,18
Mugiwara,frostwolf,1877,hunter,beastmastery,42,25,17
Trapful,illidan,1872,hunter,beastmastery,54,30,24
Argryta,azralon,1872,hunter,beastmastery,47,22,25
Graar,tichondrius,1871,hunter,beastmastery,48,25,23
Illweedx,kiljaeden,1870,hunter,beastmastery,71,36,35
Lilstinstin,tichondrius,1867,hunter,beastmastery,42,23,19
Hogx,sargeras,1862,hunter,beastmastery,72,32,40
Lkw,tichondrius,1859,hunter,beastmastery,50,23,27
Nelay,ragnaros,1857,hunter,beastmastery,106,59,47
Zeddead,magtheridon,1854,hunter,beastmastery,130,67,63
Koridelse,nemesis,1854,hunter,beastmastery,126,62,64
Faniquitinha,stormrage,1854,hunter,beastmastery,54,25,29
Trappxy,sargeras,1851,hunter,beastmastery,48,27,21
Bolanite,illidan,1846,hunter,beastmastery,48,27,21
Inktray,durotan,1844,hunter,beastmastery,37,22,15
Ðeatheater,tichondrius,1843,hunter,beastmastery,41,21,20
Ucl,tichondrius,1843,hunter,beastmastery,54,27,27
Aqq,moon-guard,1842,hunter,beastmastery,98,58,40
Monffbe,tichondrius,1842,hunter,beastmastery,60,28,32
Taterballs,illidan,1838,hunter,beastmastery,54,29,25
Auwstin,tichondrius,1837,hunter,beastmastery,55,31,24
Traptations,sargeras,1836,hunter,beastmastery,42,23,19
Bowrockobama,illidan,1836,hunter,beastmastery,69,37,32
Mørodox,sargeras,1834,hunter,beastmastery,54,24,30
Hollymarie,nazjatar,1832,hunter,beastmastery,48,31,17
Absinther,emerald-dream,1829,hunter,beastmastery,66,41,25
Nerfthepet,blackrock,1828,hunter,beastmastery,66,42,24
Sobewan,staghelm,1828,hunter,beastmastery,80,37,43
Negãn,tichondrius,1826,hunter,beastmastery,80,41,39
Sosaho,sargeras,1825,hunter,beastmastery,41,21,20
Phatshiet,anvilmar,1823,hunter,beastmastery,50,31,19
Jeffersan,illidan,1823,hunter,beastmastery,149,72,77
Tytonic,bleeding-hollow,1822,hunter,beastmastery,48,27,21
Zefbaby,quelthalas,1822,hunter,beastmastery,66,31,35
Tyreu,tichondrius,1820,hunter,beastmastery,59,30,29
Zumago,tichondrius,1820,hunter,beastmastery,106,48,58
Torolol,tichondrius,1819,hunter,beastmastery,126,73,53
Bogen,nemesis,1819,hunter,beastmastery,64,34,30
Grimrokk,malganis,1819,hunter,beastmastery,78,40,38
Scuffedshots,tichondrius,1817,hunter,beastmastery,74,43,31
Flitt,zuljin,1815,hunter,beastmastery,36,19,17
Audeline,tichondrius,1815,hunter,beastmastery,69,33,36
Goonsh,tichondrius,1813,hunter,beastmastery,40,25,15
Songhammer,tichondrius,1813,hunter,beastmastery,77,44,33
Asukaw,barthilas,1813,hunter,beastmastery,57,28,29
Mythxplosive,ragnaros,1813,hunter,beastmastery,73,32,41
Logjohn,frostmourne,1811,hunter,beastmastery,40,20,20
Kybelís,dalaran,1810,hunter,beastmastery,110,61,49
Hogd,sargeras,1810,hunter,beastmastery,54,26,28
Easonl,tichondrius,1809,hunter,beastmastery,84,34,50
Mckim,tichondrius,1805,hunter,beastmastery,36,22,14
Swang,kiljaeden,1805,hunter,beastmastery,49,24,25
Hunterphil,hyjal,1804,hunter,beastmastery,54,34,20
Phayzd,sargeras,1804,hunter,beastmastery,48,28,20
Sarutobi,black-dragonflight,1804,hunter,beastmastery,66,29,37
Lenalena,tichondrius,1803,hunter,beastmastery,59,33,26
Kabalaku,moon-guard,1802,hunter,beastmastery,130,72,58
Warcher,azralon,1802,hunter,beastmastery,60,32,28
Veevx,proudmoore,1801,hunter,beastmastery,53,35,18
Hg,illidan,1800,hunter,beastmastery,38,25,13
Shafttrapper,queldorei,1800,hunter,beastmastery,119,64,55
Fernn,illidan,1799,hunter,beastmastery,88,45,43
Funkyjunk,arthas,1799,hunter,beastmastery,66,32,34
Robinhooz,illidan,1798,hunter,beastmastery,175,96,79
Kytan,shadowmoon,1793,hunter,beastmastery,162,79,83
Pathofsexile,tichondrius,1783,hunter,beastmastery,93,43,50
Vëëv,proudmoore,1783,hunter,beastmastery,65,29,36
Xgoh,sargeras,1782,hunter,beastmastery,42,22,20
Liarael,illidan,1779,hunter,beastmastery,95,46,49
Skywvlker,illidan,1777,hunter,beastmastery,53,26,27
Kyló,sargeras,1774,hunter,beastmastery,54,26,28
Zå,dalaran,1772,hunter,beastmastery,63,33,30
Quietqt,ragnaros,1770,hunter,beastmastery,106,54,52
Sxra,area-52,1762,hunter,beastmastery,46,23,23
Sniperælite,korgath,1761,hunter,beastmastery,49,28,21
Yucca,drenden,1760,hunter,beastmastery,36,20,16
Spizsnipes,malganis,1756,hunter,beastmastery,48,24,24
Drektorath,bleeding-hollow,1756,hunter,beastmastery,60,29,31
Tracershot,malganis,1754,hunter,beastmastery,83,49,34
Rëxx,moon-guard,1753,hunter,beastmastery,60,37,23
Datbigbowdoe,illidan,1752,hunter,beastmastery,36,23,13
Sbplayshunt,akama,1750,hunter,beastmastery,42,19,23
Fockewulf,dragonmaw,1750,hunter,beastmastery,90,40,50
Airpodpro,emerald-dream,1747,hunter,beastmastery,36,21,15
Mhter,tichondrius,1745,hunter,beastmastery,41,21,20
Kangarookyle,illidan,1741,hunter,beastmastery,84,50,34
Madbéê,tichondrius,1741,hunter,beastmastery,41,19,22
Mauklindaufe,fenris,1737,hunter,beastmastery,69,38,31
Livelovelaff,tichondrius,1736,hunter,beastmastery,48,26,22
Horcnbeans,bleeding-hollow,1736,hunter,beastmastery,78,42,36
Shablagoosh,zuljin,1733,hunter,beastmastery,31,23,8
Pineapplees,tichondrius,1733,hunter,beastmastery,54,29,25
Dahmer,greymane,1732,hunter,beastmastery,62,29,33
Melov,frostmourne,1730,hunter,beastmastery,64,30,34
Comebacks,ragnaros,1726,hunter,beastmastery,54,29,25
Krunkz,frostmourne,1724,hunter,beastmastery,53,33,20
Turtlegirl,tichondrius,1724,hunter,beastmastery,41,20,21
Reparcero,quelthalas,1723,hunter,beastmastery,42,20,22
Bootydoo,illidan,1721,hunter,beastmastery,124,64,60
Kushaddict,lightnings-blade,1718,hunter,beastmastery,108,49,59
Twixzorz,boulderfist,1716,hunter,beastmastery,60,28,32
Acres,emerald-dream,1714,hunter,beastmastery,27,19,8
Tembaktytyd,barthilas,1714,hunter,beastmastery,43,22,21
Edelyysa,arthas,1711,hunter,beastmastery,180,89,91
Raymose,tichondrius,1709,hunter,beastmastery,40,20,20
Lenacraft,frostmourne,1708,hunter,beastmastery,24,18,6
Cuchulláin,area-52,1707,hunter,beastmastery,108,55,53
Notvn,illidan,1707,hunter,beastmastery,41,20,21
Shadowfangs,tichondrius,1703,hunter,beastmastery,48,24,24
Hyjax,darkspear,1701,hunter,beastmastery,43,26,17
Killshøtß,tichondrius,1701,hunter,beastmastery,65,30,35
Facerolled,area-52,1699,hunter,beastmastery,63,40,23
Jfkd,sargeras,1694,hunter,beastmastery,52,21,31
Sindragostra,tichondrius,1693,hunter,beastmastery,120,62,58
Dju,stormrage,1693,hunter,beastmastery,65,31,34
Infinit,onyxia,1693,hunter,beastmastery,48,21,27
Wodunaz,stormrage,1689,hunter,beastmastery,60,39,21
Studiosx,tichondrius,1688,hunter,beastmastery,41,24,17
Cresselia,drakkari,1686,hunter,beastmastery,53,29,24
Biehuixin,tichondrius,1685,hunter,beastmastery,50,27,23
Sniper,area-52,1683,hunter,beastmastery,94,45,49
Lilskill,lightnings-blade,1682,hunter,beastmastery,30,18,12
Lucki,blades-edge,1682,hunter,beastmastery,54,30,24
Genom,tichondrius,1682,hunter,beastmastery,279,132,147
Silverbite,garona,1678,hunter,beastmastery,92,51,41
Coopshot,darkspear,1675,hunter,beastmastery,69,40,29
Parnicyon,frostmourne,1675,hunter,beastmastery,124,69,55
Saiiphz,bleeding-hollow,1675,hunter,beastmastery,40,22,18
Tuân,azgalor,1674,hunter,beastmastery,36,23,13
Alaurys,moon-guard,1674,hunter,beastmastery,35,18,17
Koalahunter,area-52,1667,hunter,beastmastery,76,31,45
Hokutoxx,tichondrius,1663,hunter,beastmastery,61,25,36
Dpdóugh,illidan,1655,hunter,beastmastery,100,53,47
Gufanyaun,tichondrius,1654,hunter,beastmastery,34,18,16
Rndx,sargeras,1653,hunter,beastmastery,46,20,26
Kwinoah,zuljin,1652,hunter,beastmastery,174,84,90
Ipickmynose,tichondrius,1645,hunter,beastmastery,45,27,18
Mlemily,stormrage,1643,hunter,beastmastery,63,36,27
Cachín,ragnaros,1642,hunter,beastmastery,54,26,28
Montakka,illidan,1638,hunter,beastmastery,48,26,22
Publicpooper,tichondrius,1637,hunter,beastmastery,36,21,15
Sissleto,tichondrius,1637,hunter,beastmastery,184,89,95
Mcclintock,executus,1636,hunter,beastmastery,41,21,20
Drakarth,khazgoroth,1635,hunter,beastmastery,47,22,25
Apøllö,kilrogg,1635,hunter,beastmastery,208,96,112
Kahll,azralon,1634,hunter,beastmastery,54,24,30
Nobito,quelthalas,1632,hunter,beastmastery,97,52,45
Kniightjayyx,kelthuzad,1631,hunter,beastmastery,42,19,23
Asurvivor,suramar,1630,hunter,beastmastery,90,48,42
Cocoapuffs,cenarius,1627,hunter,beastmastery,36,17,19
Vox,tichondrius,1626,hunter,beastmastery,30,20,10
Gumbro,malganis,1626,hunter,beastmastery,48,30,18
Onemoreshot,bleeding-hollow,1626,hunter,beastmastery,84,44,40
Layloww,thrall,1626,hunter,beastmastery,36,18,18
Ryûkø,quelthalas,1626,hunter,beastmastery,48,23,25
Energiser,stormrage,1625,hunter,beastmastery,52,26,26
Whitecake,area-52,1623,hunter,beastmastery,40,25,15
Svsnipe,tichondrius,1623,hunter,beastmastery,58,33,25
Mojopotato,stormrage,1623,hunter,beastmastery,53,24,29
Shootsb,tichondrius,1623,hunter,beastmastery,58,24,34
Junglefever,skywall,1622,hunter,beastmastery,28,18,10
Realskinhead,terenas,1622,hunter,beastmastery,54,29,25
Eastwood,tichondrius,1621,hunter,beastmastery,86,37,49
Consanguin,sargeras,1618,hunter,beastmastery,36,22,14
Austelos,moon-guard,1617,hunter,beastmastery,42,22,20
Sambucca,daggerspine,1617,hunter,beastmastery,42,21,21
Andalora,malganis,1617,hunter,beastmastery,49,23,26
Oblivîon,illidan,1616,hunter,beastmastery,59,38,21
Terpa,nemesis,1616,hunter,beastmastery,161,83,78
Telånnas,illidan,1616,hunter,beastmastery,42,21,21
Skytrooper,boulderfist,1616,hunter,beastmastery,59,26,33
Wøden,draka,1614,hunter,beastmastery,72,38,34
Xionos,wyrmrest-accord,1612,hunter,beastmastery,54,28,26
Huntinpuss,tichondrius,1611,hunter,beastmastery,30,17,13
Casperonni,illidan,1611,hunter,beastmastery,48,27,21
Revalay,emerald-dream,1611,hunter,beastmastery,42,23,19
Mambothehunt,stormrage,1610,hunter,beastmastery,59,27,32
Razor,destromath,1610,hunter,beastmastery,54,24,30
Yughii,stormrage,1609,hunter,beastmastery,36,17,19
Cobrakhan,tichondrius,1608,hunter,beastmastery,66,42,24
Elad,tichondrius,1608,hunter,beastmastery,54,31,23
Bertimus,sargeras,1608,hunter,beastmastery,132,61,71
Skysmile,tichondrius,1607,hunter,beastmastery,30,17,13
Focusfire,khazgoroth,1607,hunter,beastmastery,66,32,34
Lexandr,tichondrius,1606,hunter,beastmastery,84,47,37
Shootnoscore,vashj,1606,hunter,beastmastery,83,46,37
Legacyhunter,nazgrel,1605,hunter,beastmastery,30,17,13
Ðfac,moon-guard,1604,hunter,beastmastery,60,26,34
Diegoshotz,zuljin,1603,hunter,beastmastery,40,19,21
Aazua,frostmourne,1601,hunter,beastmastery,45,22,23
Dreygar,dawnbringer,1599,hunter,beastmastery,81,41,40
Airhunt,thrall,1599,hunter,beastmastery,36,17,19
Sñïpêr,tichondrius,1595,hunter,beastmastery,36,19,17
Spídër,maiev,1591,hunter,beastmastery,38,20,18
Killwill,illidan,1586,hunter,beastmastery,48,25,23
Sashagreen,frostmourne,1585,hunter,beastmastery,83,43,40
Toxarch,aggramar,1585,hunter,beastmastery,78,39,39
Mournebow,tichondrius,1583,hunter,beastmastery,219,119,100
Teneightt,tichondrius,1578,hunter,beastmastery,62,30,32
Wilmaßallfit,malganis,1578,hunter,beastmastery,42,18,24
Fkkroglash,barthilas,1573,hunter,beastmastery,36,23,13
Zennifi,bleeding-hollow,1573,hunter,beastmastery,73,36,37
Kopula,illidan,1569,hunter,beastmastery,55,30,25
Illsugoi,frostwolf,1565,hunter,beastmastery,81,36,45
Velhokoira,illidan,1563,hunter,beastmastery,42,27,15
Zakalla,malganis,1563,hunter,beastmastery,56,28,28
Icecaffemoca,tichondrius,1562,hunter,beastmastery,45,19,26
Trickshotss,illidan,1561,hunter,beastmastery,70,43,27
Assbow,kiljaeden,1561,hunter,beastmastery,36,18,18
Camhaanes,area-52,1560,hunter,beastmastery,74,42,32
Lasix,burning-blade,1559,hunter,beastmastery,107,52,55
Vanero,eonar,1557,hunter,beastmastery,42,19,23
Urzoth,tichondrius,1556,hunter,beastmastery,42,26,16
Keboks,alleria,1551,hunter,beastmastery,33,18,15
Reay,frostmourne,1551,hunter,beastmastery,36,19,17
Venrod,ragnaros,1551,hunter,beastmastery,48,21,27
Bamfhunt,darkspear,1547,hunter,beastmastery,40,20,20
Gernon,frostmourne,1546,hunter,beastmastery,39,20,19
Sungoro,tichondrius,1546,hunter,beastmastery,60,30,30
Snewfly,tichondrius,1544,hunter,beastmastery,36,25,11
Mortalz,barthilas,1544,hunter,beastmastery,125,62,63
Despairius,moon-guard,1543,hunter,beastmastery,44,25,19
Limcross,drakkari,1543,hunter,beastmastery,48,26,22
Ungoliánt,cairne,1541,hunter,beastmastery,54,28,26
Rektarrow,area-52,1541,hunter,beastmastery,41,19,22
Varka,area-52,1539,hunter,beastmastery,36,20,16
Petkd,frostmourne,1538,hunter,beastmastery,42,23,19
Punjisticks,tichondrius,1538,hunter,beastmastery,48,24,24
Cerébro,illidan,1538,hunter,beastmastery,78,31,47
Laurenx,illidan,1537,hunter,beastmastery,33,20,13
Kaizong,hyjal,1537,hunter,beastmastery,29,17,12
Axis,mugthol,1537,hunter,beastmastery,76,38,38
Diavál,area-52,1533,hunter,beastmastery,36,22,14
Freebeë,area-52,1531,hunter,beastmastery,85,49,36
Pankyrangs,kelthuzad,1531,hunter,beastmastery,42,22,20
Fatalshots,bonechewer,1529,hunter,beastmastery,30,16,14
Flanzo,illidan,1528,hunter,beastmastery,36,16,20
Teaks,aggramar,1527,hunter,beastmastery,30,16,14
Shadowtensai,stormrage,1527,hunter,beastmastery,78,34,44
Robnhunt,tichondrius,1526,hunter,beastmastery,30,16,14
Szone,tichondrius,1526,hunter,beastmastery,71,36,35
Phindo,agamaggan,1525,hunter,beastmastery,30,17,13
Uzpak,tichondrius,1524,hunter,beastmastery,59,34,25
Hazzeth,thrall,1516,hunter,beastmastery,30,21,9
Grimbrew,garona,1514,hunter,beastmastery,29,17,12
Readtitle,malganis,1513,hunter,beastmastery,36,22,14
Liadrelle,proudmoore,1513,hunter,beastmastery,39,17,22
Kript,dragonmaw,1512,hunter,beastmastery,283,134,149
Gamestopceo,tichondrius,1511,hunter,beastmastery,84,41,43
Selhort,quelthalas,1511,hunter,beastmastery,72,31,41
Sonichunterr,illidan,1509,hunter,beastmastery,46,27,19
Internade,frostmourne,1509,hunter,beastmastery,54,25,29
Cyrsmen,ragnaros,1508,hunter,beastmastery,132,65,67
Daarrk,thrall,1506,hunter,beastmastery,58,29,29
Legoflaiz,drakkari,1506,hunter,beastmastery,36,16,20
Volbz,barthilas,1505,hunter,beastmastery,36,16,20
Shockwave,velen,1504,hunter,beastmastery,182,93,89
Emilysamuels,tichondrius,1503,hunter,beastmastery,24,16,8
Stalkstride,destromath,1503,hunter,beastmastery,72,35,37
Outfazed,tichondrius,1502,hunter,beastmastery,58,32,26
Irøneye,sargeras,1499,hunter,beastmastery,55,20,35
Yaisk,tichondrius,1498,hunter,beastmastery,56,32,24
Skarasha,tichondrius,1497,hunter,beastmastery,30,16,14
Ramchi,burning-blade,1494,hunter,beastmastery,61,33,28
Reloadz,shattered-hand,1494,hunter,beastmastery,34,18,16
Chrest,sargeras,1491,hunter,beastmastery,36,19,17
Scirfreez,ragnaros,1491,hunter,beastmastery,42,18,24
Danncer,alexstrasza,1490,hunter,beastmastery,72,42,30
Sereom,frostmourne,1490,hunter,beastmastery,95,55,40
Chizhi,tichondrius,1489,hunter,beastmastery,72,36,36
Wredd,nemesis,1488,hunter,beastmastery,35,20,15
Brokiînn,aegwynn,1485,hunter,beastmastery,42,20,22
Laras,blades-edge,1484,hunter,beastmastery,36,22,14
Morganson,moon-guard,1484,hunter,beastmastery,126,61,65
Jjack,muradin,1482,hunter,beastmastery,54,29,25
Chowyunfatss,proudmoore,1481,hunter,beastmastery,112,53,59
Grànd,tortheldrin,1480,hunter,beastmastery,66,33,33
Scourgesurge,kiljaeden,1478,hunter,beastmastery,145,71,74
Garzb,area-52,1476,hunter,beastmastery,42,22,20
Montano,area-52,1471,hunter,beastmastery,26,17,9
Aguntur,ragnaros,1471,hunter,beastmastery,93,56,37
Breezekeeper,area-52,1470,hunter,beastmastery,72,35,37
Virolac,tichondrius,1469,hunter,beastmastery,32,16,16
Unrealpewpew,lightbringer,1469,hunter,beastmastery,42,18,24
Paganfinn,tichondrius,1467,hunter,beastmastery,42,19,23
Sootgarbage,sargeras,1464,hunter,beastmastery,72,42,30
Dlabio,emerald-dream,1461,hunter,beastmastery,90,46,44
Häm,dalaran,1458,hunter,beastmastery,54,27,27
Zaetor,ragnaros,1457,hunter,beastmastery,36,21,15
Ñðñdêsçrípt,frostmourne,1450,hunter,beastmastery,39,18,21
Dontmissz,tichondrius,1449,hunter,beastmastery,42,24,18
Chaw,nathrezim,1449,hunter,beastmastery,68,34,34
Limpnoodle,nerzhul,1445,hunter,beastmastery,93,45,48
Kouandjio,area-52,1444,hunter,beastmastery,36,18,18
Recha,emerald-dream,1442,hunter,beastmastery,30,17,13
Lashga,wyrmrest-accord,1439,hunter,beastmastery,47,22,25
Cyboreg,stormrage,1436,hunter,beastmastery,35,21,14
Aristæos,kelthuzad,1436,hunter,beastmastery,77,40,37
Tacos,kelthuzad,1432,hunter,beastmastery,30,18,12
Seatback,arathor,1432,hunter,beastmastery,76,33,43
Kkoner,illidan,1431,hunter,beastmastery,24,15,9
Fames,shuhalo,1431,hunter,beastmastery,49,22,27
Bonnèy,zuljin,1430,hunter,beastmastery,36,22,14
Dôntlosmebro,stormrage,1427,hunter,beastmastery,48,24,24
Jungleboy,gorgonnash,1427,hunter,beastmastery,59,25,34
Iyne,stormrage,1427,hunter,beastmastery,36,15,21
Munyshotz,tichondrius,1426,hunter,beastmastery,86,50,36
Syldris,proudmoore,1423,hunter,beastmastery,24,15,9
Mukeru,stormrage,1418,hunter,beastmastery,24,15,9
Araghrn,draktharon,1417,hunter,beastmastery,105,51,54
Eldlichi,proudmoore,1416,hunter,beastmastery,48,20,28
Terminatôr,malganis,1415,hunter,beastmastery,36,15,21
Drunkhunter,malygos,1414,hunter,beastmastery,24,15,9
Spèedbump,stormrage,1414,hunter,beastmastery,47,24,23
Partz,darkspear,1413,hunter,beastmastery,24,15,9
Tinyted,nathrezim,1412,hunter,beastmastery,30,15,15
Drig,korgath,1409,hunter,beastmastery,47,19,28
Cigâro,thrall,1404,hunter,beastmastery,93,46,47
Cashisabeast,zuljin,1403,hunter,beastmastery,28,15,13
Sioul,bleeding-hollow,1403,hunter,beastmastery,30,15,15
Darthski,drenden,1402,hunter,beastmastery,51,24,27
Thezeus,barthilas,1402,hunter,beastmastery,41,15,26
Lilpoots,warsong,1401,hunter,beastmastery,59,28,31
Orcanjo,azralon,1400,hunter,beastmastery,42,19,23
Rcman,tichondrius,1399,hunter,beastmastery,24,17,7
Jyttrg,tichondrius,1396,hunter,beastmastery,59,31,28
Timmee,bleeding-hollow,1392,hunter,beastmastery,36,15,21
Liillilliil,tichondrius,1391,hunter,beastmastery,31,16,15
Omegalulzxd,kelthuzad,1390,hunter,beastmastery,72,35,37
Sülivan,zuljin,1389,hunter,beastmastery,43,23,20
Taelen,aegwynn,1386,hunter,beastmastery,41,20,21
Tentoontrey,emerald-dream,1382,hunter,beastmastery,36,17,19
Viperstng,area-52,1380,hunter,beastmastery,70,40,30
Yandralen,kiljaeden,1379,hunter,beastmastery,30,15,15
Oceandoom,tichondrius,1374,hunter,beastmastery,54,29,25
Fruitenveg,frostmourne,1374,hunter,beastmastery,36,18,18
Alitharia,nerzhul,1374,hunter,beastmastery,105,45,60
Boward,illidan,1371,hunter,beastmastery,43,24,19
Phaction,tichondrius,1369,hunter,beastmastery,60,26,34
Jangle,mannoroth,1368,hunter,beastmastery,34,19,15
Revbubs,darkspear,1360,hunter,beastmastery,54,26,28
Ryukuzen,tichondrius,1359,hunter,beastmastery,35,15,20
Femonemos,nemesis,1358,hunter,beastmastery,30,17,13
Shlandy,frostmourne,1356,hunter,beastmastery,32,18,14
Sliturthroat,barthilas,1354,hunter,beastmastery,44,17,27
Fleetfox,tichondrius,1349,hunter,beastmastery,48,22,26
Euclase,bleeding-hollow,1344,hunter,beastmastery,40,21,19
Borudin,stormrage,1344,hunter,beastmastery,161,71,90
Trapandclap,tichondrius,1343,hunter,beastmastery,24,14,10
Lilien,khazgoroth,1341,hunter,beastmastery,30,18,12
Bro,malorne,1341,hunter,beastmastery,72,34,38
Tergls,illidan,1341,hunter,beastmastery,73,33,40
Kârân,tichondrius,1341,hunter,beastmastery,60,27,33
Deathtomyfoe,sargeras,1340,hunter,beastmastery,36,14,22
Mitulla,wyrmrest-accord,1339,hunter,beastmastery,44,22,22
Oatmeallover,stormrage,1339,hunter,beastmastery,30,14,16
Peterming,tichondrius,1339,hunter,beastmastery,108,49,59
Aiollus,stormreaver,1338,hunter,beastmastery,30,14,16
Wolfarms,area-52,1338,hunter,beastmastery,39,16,23
Kapukapu,illidan,1337,hunter,beastmastery,24,14,10
Cw,gorefiend,1336,hunter,beastmastery,24,14,10
Crownchild,illidan,1336,hunter,beastmastery,24,14,10
Skulgor,zuljin,1336,hunter,beastmastery,66,34,32
Psychiatry,bonechewer,1336,hunter,beastmastery,70,35,35
Azx,tichondrius,1336,hunter,beastmastery,42,19,23
Rnger,aerie-peak,1335,hunter,beastmastery,40,20,20
Shootiepie,hyjal,1333,hunter,beastmastery,24,14,10
Dirtymongrel,barthilas,1331,hunter,beastmastery,30,14,16
Keknine,gnomeregan,1331,hunter,beastmastery,48,19,29
Daken,ysera,1330,hunter,beastmastery,24,14,10
Khaydarin,sargeras,1329,hunter,beastmastery,30,14,16
Luprikus,maelstrom,1328,hunter,beastmastery,29,14,15
Belime,korgath,1327,hunter,beastmastery,84,45,39
Frostyarrow,moon-guard,1325,hunter,beastmastery,55,28,27
Lastanar,amanthul,1322,hunter,beastmastery,60,32,28
Tokendaily,sargeras,1321,hunter,beastmastery,60,33,27
Vruul,sargeras,1321,hunter,beastmastery,52,23,29
Jesticles,zuljin,1320,hunter,beastmastery,60,30,30
Bowna,stormscale,1320,hunter,beastmastery,48,17,31
Petmayo,tichondrius,1318,hunter,beastmastery,18,14,4
Doug,illidan,1317,hunter,beastmastery,30,14,16
Bepee,auchindoun,1313,hunter,beastmastery,83,46,37
Narus,whisperwind,1310,hunter,beastmastery,48,26,22
Ascer,gurubashi,1310,hunter,beastmastery,82,42,40
Hoboh,illidan,1310,hunter,beastmastery,66,32,34
Jetzy,illidan,1310,hunter,beastmastery,43,19,24
Lizymcguire,malganis,1308,hunter,beastmastery,42,23,19
Javoz,drakkari,1302,hunter,beastmastery,36,14,22
Bacatran,darkspear,1301,hunter,beastmastery,58,32,26
Wulfgeng,azgalor,1301,hunter,beastmastery,74,36,38
Bluebow,tichondrius,1301,hunter,beastmastery,72,34,38
Fallenfates,stormrage,1300,hunter,beastmastery,72,34,38
Sunchea,arygos,1300,hunter,beastmastery,30,14,16
Zzsocrateszz,dragonmaw,1298,hunter,beastmastery,104,52,52
Rengarok,emerald-dream,1295,hunter,beastmastery,30,14,16
Jacobsladder,illidan,1293,hunter,beastmastery,113,51,62
Perffect,sargeras,1288,hunter,beastmastery,39,15,24
Voodoohunter,blood-furnace,1286,hunter,beastmastery,30,15,15
Vaettai,barthilas,1286,hunter,beastmastery,72,32,40
Showmakerc,proudmoore,1284,hunter,beastmastery,35,15,20
Glediator,tichondrius,1283,hunter,beastmastery,33,16,17
Airtight,area-52,1281,hunter,beastmastery,53,24,29
Vesity,tichondrius,1277,hunter,beastmastery,44,21,23
Huukend,azjolnerub,1277,hunter,beastmastery,42,20,22
Iar,tichondrius,1270,hunter,beastmastery,30,18,12
Bulleitrye,illidan,1270,hunter,beastmastery,36,16,20
Pingaamarela,nemesis,1266,hunter,beastmastery,96,47,49
Caetomon,kiljaeden,1263,hunter,beastmastery,22,14,8
Hairyhype,malganis,1263,hunter,beastmastery,36,18,18
Shmurda,duskwood,1263,hunter,beastmastery,36,15,21
Trailbreaker,trollbane,1255,hunter,beastmastery,51,33,18
Trapz,hellscream,1251,hunter,beastmastery,90,44,46
Sarahbeara,moonrunner,1247,hunter,beastmastery,18,13,5
Broydiesnipe,illidan,1247,hunter,beastmastery,18,13,5
Alexxspewpew,ragnaros,1247,hunter,beastmastery,23,13,10
Kenshaunter,azralon,1247,hunter,beastmastery,24,13,11
Wastdpenguin,area-52,1247,hunter,beastmastery,30,13,17
Frankabingle,area-52,1247,hunter,beastmastery,30,13,17
Slowhunterr,tichondrius,1247,hunter,beastmastery,36,13,23
Shootnskoot,icecrown,1246,hunter,beastmastery,18,13,5
Twopumphunt,tichondrius,1246,hunter,beastmastery,24,13,11
Gabulmenina,nemesis,1245,hunter,beastmastery,24,13,11
Reeload,tichondrius,1244,hunter,beastmastery,24,13,11
Shotmieye,thunderhorn,1244,hunter,beastmastery,60,30,30
Maquire,tichondrius,1244,hunter,beastmastery,36,17,19
Jillypoo,azralon,1243,hunter,beastmastery,18,13,5
Dj,arygos,1243,hunter,beastmastery,24,13,11
Craftarrow,tichondrius,1243,hunter,beastmastery,41,21,20
Wickyz,malganis,1243,hunter,beastmastery,30,13,17
Hurak,elune,1243,hunter,beastmastery,30,13,17
Sanchode,tichondrius,1240,hunter,beastmastery,30,13,17
Wadadly,malganis,1239,hunter,beastmastery,138,66,72
Ioioi,tichondrius,1238,hunter,beastmastery,34,16,18
Chetta,ragnaros,1236,hunter,beastmastery,48,22,26
Timogen,illidan,1236,hunter,beastmastery,36,16,20
Nogaro,nemesis,1235,hunter,beastmastery,42,20,22
Overshot,barthilas,1234,hunter,beastmastery,18,13,5
Bubbz,bloodscalp,1233,hunter,beastmastery,42,20,22
Hynathios,azralon,1233,hunter,beastmastery,30,13,17
Honeygold,tichondrius,1233,hunter,beastmastery,51,19,32
Rbtz,illidan,1231,hunter,beastmastery,17,13,4
Xtop,draktharon,1231,hunter,beastmastery,23,15,8
Luoca,shuhalo,1227,hunter,beastmastery,24,13,11
Angdre,tichondrius,1227,hunter,beastmastery,30,13,17
Shneedle,illidan,1226,hunter,beastmastery,30,14,16
Hughneutron,kirin-tor,1224,hunter,beastmastery,147,76,71
Urimiel,daggerspine,1223,hunter,beastmastery,36,16,20
Varthurg,ragnaros,1222,hunter,beastmastery,24,13,11
Bromance,kaelthas,1221,hunter,beastmastery,36,18,18
Grands,tortheldrin,1219,hunter,beastmastery,29,14,15
Havymetal,andorhal,1219,hunter,beastmastery,48,20,28
Aggargh,baelgun,1214,hunter,beastmastery,27,14,13
Nebulahaze,stormrage,1214,hunter,beastmastery,30,15,15
Alaranel,kiljaeden,1208,hunter,beastmastery,36,15,21
Fusionrpg,quelthalas,1207,hunter,beastmastery,24,13,11
Artilleria,quelthalas,1207,hunter,beastmastery,42,18,24
Desydn,draenor,1206,hunter,beastmastery,143,72,71
Ydaine,alexstrasza,1206,hunter,beastmastery,75,33,42
Gejagt,sargeras,1201,hunter,beastmastery,25,14,11
Winchestyr,lightbringer,1201,hunter,beastmastery,30,14,16
Brokenstars,illidan,1200,hunter,beastmastery,97,48,49
Mithrandiel,blood-furnace,1197,hunter,beastmastery,46,23,23
Rypunzul,proudmoore,1196,hunter,beastmastery,24,13,11
Mordriva,azjolnerub,1193,hunter,beastmastery,29,13,16
Ownyoufast,darkspear,1193,hunter,beastmastery,30,13,17
Shootaids,illidan,1192,hunter,beastmastery,44,22,22
Kleankilla,malganis,1189,hunter,beastmastery,20,13,7
Gaktog,area-52,1189,hunter,beastmastery,27,13,14
Wodhunterxdd,tichondrius,1182,hunter,beastmastery,20,13,7
Genx,frostmane,1182,hunter,beastmastery,35,15,20
Thetrickyone,area-52,1180,hunter,beastmastery,52,20,32
Aztrappin,illidan,1177,hunter,beastmastery,63,24,39
Kathoey,wyrmrest-accord,1175,hunter,beastmastery,36,14,22
Eightbeers,bleeding-hollow,1173,hunter,beastmastery,30,13,17
Taedulos,azralon,1169,hunter,beastmastery,36,19,17
Frenzyfire,whisperwind,1162,hunter,beastmastery,39,16,23
Iffy,dentarg,1161,hunter,beastmastery,24,14,10
Pvrisxoxo,frostmourne,1161,hunter,beastmastery,25,13,12
Arucedd,frostmourne,1156,hunter,beastmastery,53,22,31
Chrønic,khadgar,1155,hunter,beastmastery,24,13,11
Lustblitz,illidan,1152,hunter,beastmastery,18,12,6
Malvnfresh,tichondrius,1152,hunter,beastmastery,24,12,12
Tus,tichondrius,1151,hunter,beastmastery,30,12,18
Smullik,wyrmrest-accord,1150,hunter,beastmastery,30,12,18
Kroozeh,illidan,1149,hunter,beastmastery,24,12,12
Mvpwonder,frostmourne,1149,hunter,beastmastery,36,12,24
Squishasf,tichondrius,1148,hunter,beastmastery,18,12,6
Sax,stormreaver,1147,hunter,beastmastery,24,12,12
Puffcopeak,illidan,1147,hunter,beastmastery,24,12,12
Yembohi,queldorei,1145,hunter,beastmastery,18,12,6
Cuteorcgirl,sargeras,1145,hunter,beastmastery,38,15,23
Riivali,quelthalas,1144,hunter,beastmastery,42,17,25
Chrise,darkspear,1142,hunter,beastmastery,12,12,0
Dyz,ragnaros,1137,hunter,beastmastery,28,13,15
Karev,area-52,1134,hunter,beastmastery,24,12,12
Blimpbooty,stormrage,1130,hunter,beastmastery,41,20,21
Juicedhunter,tichondrius,1128,hunter,beastmastery,24,12,12
Camperbill,borean-tundra,1127,hunter,beastmastery,25,14,11
Huñté,stormrage,1127,hunter,beastmastery,24,12,12
Kälec,quelthalas,1127,hunter,beastmastery,66,32,34
Legolasbow,tichondrius,1127,hunter,beastmastery,30,12,18
Faldran,earthen-ring,1123,hunter,beastmastery,70,30,40
Qpoc,tichondrius,1120,hunter,beastmastery,44,20,24
Mvpbunny,tichondrius,1117,hunter,beastmastery,46,21,25
Argent,altar-of-storms,1113,hunter,beastmastery,24,12,12
Merkidy,illidan,1099,hunter,beastmastery,17,12,5
Ehnó,illidan,1098,hunter,beastmastery,21,12,9
Ukamau,ragnaros,1097,hunter,beastmastery,24,14,10
Setepalms,azralon,1097,hunter,beastmastery,21,12,9
Topshunter,sargeras,1095,hunter,beastmastery,58,31,27
Funwell,dalaran,1090,hunter,beastmastery,29,14,15
Tmac,winterhoof,1087,hunter,beastmastery,41,18,23
Zalyssavara,aerie-peak,1085,hunter,beastmastery,27,12,15
Fixnoone,moon-guard,1083,hunter,beastmastery,26,13,13
Ragnarlobkk,ragnaros,1082,hunter,beastmastery,124,56,68
Eithelleta,frostmourne,1078,hunter,beastmastery,48,18,30
Quigfoot,area-52,1077,hunter,beastmastery,30,12,18
Buyaga,stormreaver,1073,hunter,beastmastery,72,37,35
Dracð,malganis,1071,hunter,beastmastery,30,14,16
Rotokrim,emerald-dream,1059,hunter,beastmastery,142,72,70
Hog,darkspear,1056,hunter,beastmastery,18,11,7
Playnogames,moon-guard,1056,hunter,beastmastery,24,11,13
Jawnhunter,tichondrius,1056,hunter,beastmastery,24,11,13
Unicom,malganis,1056,hunter,beastmastery,30,11,19
Ryutiz,fizzcrank,1055,hunter,beastmastery,18,11,7
Tashio,aerie-peak,1055,hunter,beastmastery,24,11,13
Datadyne,stormrage,1054,hunter,beastmastery,12,11,1
Ispamtraps,emerald-dream,1054,hunter,beastmastery,18,11,7
Selljzs,zuljin,1054,hunter,beastmastery,18,11,7
Crounzz,sargeras,1054,hunter,beastmastery,42,11,31
Bigolekack,tichondrius,1053,hunter,beastmastery,24,11,13
Anastasia,gorgonnash,1052,hunter,beastmastery,18,11,7
Phiyuh,stormrage,1051,hunter,beastmastery,18,11,7
Cummis,skullcrusher,1051,hunter,beastmastery,18,11,7
Lunarlunar,khadgar,1051,hunter,beastmastery,30,11,19
Luckshot,destromath,1050,hunter,beastmastery,24,11,13
Zünma,tichondrius,1050,hunter,beastmastery,24,11,13
Reallybroke,stormrage,1050,hunter,beastmastery,24,11,13
Gannidema,illidan,1049,hunter,beastmastery,18,11,7
Gølin,aerie-peak,1049,hunter,beastmastery,30,11,19
Freeside,emerald-dream,1048,hunter,beastmastery,18,11,7
Wingclipped,kelthuzad,1048,hunter,beastmastery,18,11,7
ßaelon,malganis,1047,hunter,beastmastery,12,11,1
Kynagidas,korgath,1047,hunter,beastmastery,24,11,13
Vord,frostmourne,1046,hunter,beastmastery,24,11,13
Cilnolm,moon-guard,1045,hunter,beastmastery,24,11,13
Wogolas,barthilas,1044,hunter,beastmastery,18,11,7
Youngteflon,bonechewer,1043,hunter,beastmastery,24,11,13
Ketulirantle,azralon,1041,hunter,beastmastery,42,11,31
Zooker,tichondrius,1039,hunter,beastmastery,29,11,18
Kamikazey,tichondrius,1037,hunter,beastmastery,24,11,13
Neverhunter,azralon,1036,hunter,beastmastery,24,12,12
Bobbysmurica,cenarion-circle,1032,hunter,beastmastery,30,11,19
Caytano,quelthalas,1031,hunter,beastmastery,24,15,9
Robingear,baelgun,1029,hunter,beastmastery,93,43,50
Huntercry,ragnaros,1026,hunter,beastmastery,18,11,7
Hetaya,haomarush,1024,hunter,beastmastery,80,31,49
Vegamax,illidan,1020,hunter,beastmastery,18,11,7
Bolbathefett,shadowsong,1020,hunter,beastmastery,30,11,19
Sumom,darrowmere,1019,hunter,beastmastery,38,17,21
Brendie,thrall,1019,hunter,beastmastery,118,52,66
Fifie,azgalor,1011,hunter,beastmastery,31,12,19
Londen,tichondrius,1006,hunter,beastmastery,20,12,8
Rairin,tichondrius,1004,hunter,beastmastery,65,33,32
Antihero,norgannon,1001,hunter,beastmastery,20,12,8
Eddyholiday,tichondrius,1001,hunter,beastmastery,26,13,13
Falesta,sargeras,999,hunter,beastmastery,28,12,16
Flexxbow,thrall,994,hunter,beastmastery,23,13,10
Warsh,anubarak,990,hunter,beastmastery,22,11,11
Dadhatesme,stormrage,989,hunter,beastmastery,22,11,11
Onihanzo,thrall,987,hunter,beastmastery,25,12,13
Zullypewpew,stormrage,982,hunter,beastmastery,17,11,6
Boomseed,nagrand,982,hunter,beastmastery,28,11,17
Erik,nemesis,980,hunter,beastmastery,47,19,28
Dayneryz,quelthalas,971,hunter,beastmastery,32,11,21
Håwkeye,hyjal,970,hunter,beastmastery,93,44,49
Erovianoria,silver-hand,968,hunter,beastmastery,57,29,28
Puhpsy,azralon,966,hunter,beastmastery,36,19,17
Ahhpash,tichondrius,960,hunter,beastmastery,16,11,5
Survenant,zuljin,960,hunter,beastmastery,18,10,8
Worsthunt,tichondrius,960,hunter,beastmastery,18,10,8
Pumplum,kiljaeden,960,hunter,beastmastery,18,10,8
Gööber,hyjal,960,hunter,beastmastery,18,10,8
Yná,azralon,960,hunter,beastmastery,18,10,8
Bustyredhead,kelthuzad,960,hunter,beastmastery,18,10,8
Emmihunt,tichondrius,960,hunter,beastmastery,18,10,8
Sniperfx,lightbringer,960,hunter,beastmastery,18,10,8
Shinhyez,tichondrius,960,hunter,beastmastery,18,10,8
Wovow,tichondrius,960,hunter,beastmastery,18,10,8
Savagerko,illidan,960,hunter,beastmastery,21,11,10
Prêd,malganis,960,hunter,beastmastery,21,11,10
Focús,laughing-skull,960,hunter,beastmastery,24,10,14
Willdey,frostmourne,960,hunter,beastmastery,24,10,14
Rosebullets,bleeding-hollow,959,hunter,beastmastery,18,10,8
Mmeep,illidan,959,hunter,beastmastery,18,10,8
Exitwoundz,hyjal,959,hunter,beastmastery,18,10,8
Tmnarcanttv,tichondrius,959,hunter,beastmastery,18,10,8
Huntfaceguy,agamaggan,959,hunter,beastmastery,24,10,14
Stonehard,mugthol,959,hunter,beastmastery,24,10,14
Orgpopeyes,illidan,959,hunter,beastmastery,24,10,14
Sagadegêmeos,stormrage,959,hunter,beastmastery,24,10,14
Vigon,stormrage,959,hunter,beastmastery,24,10,14
Leyliann,quelthalas,959,hunter,beastmastery,27,11,16
Kimbaa,tichondrius,959,hunter,beastmastery,30,10,20
Yager,kalecgos,958,hunter,beastmastery,18,10,8
Aquabat,wildhammer,958,hunter,beastmastery,18,10,8
Quickfyre,stormrage,958,hunter,beastmastery,18,10,8
Celarla,tichondrius,958,hunter,beastmastery,21,11,10
Pafäcïle,tichondrius,958,hunter,beastmastery,24,10,14
Alwaysblazed,hyjal,957,hunter,beastmastery,18,10,8
Mikly,ragnaros,957,hunter,beastmastery,24,10,14
Hyena,kelthuzad,955,hunter,beastmastery,24,10,14
Rocchettâ,kirin-tor,954,hunter,beastmastery,18,10,8
Anaiset,hyjal,954,hunter,beastmastery,18,10,8
Trim,tichondrius,954,hunter,beastmastery,18,10,8
Murdaugh,icecrown,954,hunter,beastmastery,18,10,8
Deepcarver,tichondrius,954,hunter,beastmastery,24,10,14
Gïzmo,malganis,953,hunter,beastmastery,18,10,8
Rezkiin,tichondrius,953,hunter,beastmastery,18,10,8
Jijiyoyo,tichondrius,953,hunter,beastmastery,35,12,23
Raikuu,skullcrusher,951,hunter,beastmastery,36,18,18
Steelaeon,moon-guard,951,hunter,beastmastery,24,10,14
Flacidhunter,kelthuzad,948,hunter,beastmastery,24,10,14
Böuntyhuntêr,area-52,948,hunter,beastmastery,24,10,14
ßaeløn,malganis,947,hunter,beastmastery,15,11,4
Glizzys,cairne,943,hunter,beastmastery,24,11,13
Arrowae,sargeras,941,hunter,beastmastery,26,12,14
Shootyurshot,stormrage,927,hunter,beastmastery,20,11,9
Finol,azralon,926,hunter,beastmastery,14,11,3
Entrapment,emerald-dream,924,hunter,beastmastery,23,10,13
Dekestei,bleeding-hollow,911,hunter,beastmastery,29,10,19
Çhexmix,kiljaeden,910,hunter,beastmastery,15,10,5
Coyner,tichondrius,907,hunter,beastmastery,21,10,11
Wael,perenolde,905,hunter,beastmastery,17,10,7
Saltz,tichondrius,901,hunter,beastmastery,21,11,10
Hillside,frostmourne,895,hunter,beastmastery,11,10,1
Gandson,fizzcrank,892,hunter,beastmastery,24,10,14
Foh,kelthuzad,888,hunter,beastmastery,17,10,7
Leaii,thrall,880,hunter,beastmastery,33,16,17
Petattack,barthilas,864,hunter,beastmastery,12,9,3
Huntations,sargeras,864,hunter,beastmastery,12,9,3
Jaysuper,zuljin,864,hunter,beastmastery,12,9,3
Bmhuntlol,illidan,864,hunter,beastmastery,12,9,3
Survivalists,kelthuzad,864,hunter,beastmastery,12,9,3
Slipox,sargeras,864,hunter,beastmastery,12,9,3
Lubze,bleeding-hollow,864,hunter,beastmastery,12,9,3
Déwi,tichondrius,864,hunter,beastmastery,18,9,9
Esstark,bleeding-hollow,864,hunter,beastmastery,18,9,9
Wildlifezoo,tichondrius,864,hunter,beastmastery,18,9,9
Lilsynchfyb,sargeras,864,hunter,beastmastery,18,9,9
Deutêr,quelthalas,864,hunter,beastmastery,18,9,9
Hagadinn,frostmourne,864,hunter,beastmastery,18,9,9
Xbloody,tichondrius,864,hunter,beastmastery,18,9,9
Heparinqt,area-52,864,hunter,beastmastery,24,9,15
Balrröt,malganis,864,hunter,beastmastery,24,9,15
Dirtyytroll,area-52,864,hunter,beastmastery,24,9,15
Arteene,illidan,864,hunter,beastmastery,24,9,15
Twoshotzz,darkspear,863,hunter,beastmastery,15,10,5
Nikronos,quelthalas,863,hunter,beastmastery,18,9,9
Akoshi,illidan,863,hunter,beastmastery,18,9,9
Snowjin,stormrage,863,hunter,beastmastery,18,9,9
Drivebyjuju,dentarg,863,hunter,beastmastery,18,9,9
Xernen,thrall,863,hunter,beastmastery,18,9,9
Jamzlol,frostmourne,863,hunter,beastmastery,18,9,9
Çute,moon-guard,863,hunter,beastmastery,18,9,9
Nubberton,sargeras,863,hunter,beastmastery,24,9,15
Myladyy,zuljin,863,hunter,beastmastery,30,9,21
Bleedwish,tichondrius,863,hunter,beastmastery,31,9,22
Seáhawk,kiljaeden,862,hunter,beastmastery,12,9,3
Loriandel,proudmoore,862,hunter,beastmastery,14,9,5
Qúin,frostmourne,862,hunter,beastmastery,18,9,9
Hawkeye,boulderfist,862,hunter,beastmastery,18,9,9
Pokérap,dalaran,862,hunter,beastmastery,18,9,9
Kinete,proudmoore,862,hunter,beastmastery,18,9,9
Toross,stormscale,862,hunter,beastmastery,18,9,9
Bootylickin,tichondrius,862,hunter,beastmastery,18,9,9
Korasaurus,tichondrius,861,hunter,beastmastery,12,9,3
Exotichunter,the-underbog,861,hunter,beastmastery,24,9,15
Cottonshots,dalaran,861,hunter,beastmastery,24,9,15
Trápngap,barthilas,861,hunter,beastmastery,24,9,15
Thiccit,illidan,858,hunter,beastmastery,18,9,9
Xeriife,stormrage,858,hunter,beastmastery,19,9,10
More,khadgar,858,hunter,beastmastery,24,9,15
Chuphunts,tichondrius,857,hunter,beastmastery,12,9,3
Vexxør,bleeding-hollow,856,hunter,beastmastery,18,9,9
Galerius,illidan,855,hunter,beastmastery,30,9,21
Shiztec,malganis,854,hunter,beastmastery,24,9,15
Hunterdps,gurubashi,851,hunter,beastmastery,18,9,9
Survival,dentarg,851,hunter,beastmastery,24,9,15
Hovahdo,proudmoore,847,hunter,beastmastery,17,9,8
Eggsquatch,emerald-dream,844,hunter,beastmastery,12,9,3
Noahxkhalel,azralon,832,hunter,beastmastery,29,9,20
Vastiks,dalaran,829,hunter,beastmastery,26,9,17
Coletrickle,chogall,822,hunter,beastmastery,32,10,22
Monatre,fizzcrank,816,hunter,beastmastery,21,9,12
Sharpster,zuljin,815,hunter,beastmastery,15,9,6
Rawspits,kiljaeden,814,hunter,beastmastery,29,9,20
Vyalaris,emerald-dream,813,hunter,beastmastery,21,9,12
Anya,proudmoore,801,hunter,beastmastery,30,12,18
Jsrhuntz,sargeras,768,hunter,beastmastery,12,8,4
Chippendales,illidan,768,hunter,beastmastery,12,8,4
Puns,stormreaver,768,hunter,beastmastery,12,8,4
Bowzørx,tichondrius,768,hunter,beastmastery,12,8,4
Clydebarro,sargeras,768,hunter,beastmastery,12,8,4
Seljzs,zuljin,768,hunter,beastmastery,12,8,4
Ogstrutt,zuljin,768,hunter,beastmastery,12,8,4
Yonzo,area-52,768,hunter,beastmastery,18,8,10
Bicas,emerald-dream,768,hunter,beastmastery,18,8,10
Getrekt,azralon,768,hunter,beastmastery,18,8,10
Ddukgue,tichondrius,768,hunter,beastmastery,18,8,10
Seongnam,tichondrius,768,hunter,beastmastery,18,8,10
Oblitus,zuljin,768,hunter,beastmastery,18,8,10
Axxll,tichondrius,768,hunter,beastmastery,18,8,10
Tigglyjits,tichondrius,768,hunter,beastmastery,18,8,10
Kellsier,nordrassil,768,hunter,beastmastery,18,8,10
Heädshöt,malorne,768,hunter,beastmastery,18,8,10
Katherìnelol,tichondrius,768,hunter,beastmastery,21,9,12
Skeetslinger,illidan,768,hunter,beastmastery,24,8,16
Remièl,frostmourne,767,hunter,beastmastery,12,8,4
Flacidpasta,sargeras,767,hunter,beastmastery,12,8,4
Cxnt,saurfang,767,hunter,beastmastery,15,9,6
Gorgoon,sargeras,767,hunter,beastmastery,16,9,7
Morbow,proudmoore,767,hunter,beastmastery,18,8,10
Zephanno,sargeras,767,hunter,beastmastery,18,8,10
Jesselos,stormrage,767,hunter,beastmastery,18,8,10
Dooper,malfurion,767,hunter,beastmastery,18,8,10
Raphgun,stormrage,767,hunter,beastmastery,18,8,10
Bowjingles,blackrock,767,hunter,beastmastery,18,8,10
Thehunturd,dalaran,767,hunter,beastmastery,18,8,10
Picapaul,stormrage,767,hunter,beastmastery,18,8,10
Flîp,daggerspine,767,hunter,beastmastery,18,8,10
Suetyic,tichondrius,767,hunter,beastmastery,18,8,10
Jímmycorn,sargeras,767,hunter,beastmastery,18,8,10
Computer,darkspear,767,hunter,beastmastery,18,8,10
Lûrtz,aegwynn,767,hunter,beastmastery,21,8,13
Laudion,quelthalas,766,hunter,beastmastery,12,8,4
Satours,quelthalas,766,hunter,beastmastery,18,8,10
Thirtyeight,blades-edge,766,hunter,beastmastery,18,8,10
Traps,deathwing,766,hunter,beastmastery,18,8,10
Josyv,quelthalas,766,hunter,beastmastery,18,8,10
Frenzygirl,azralon,765,hunter,beastmastery,12,8,4
Ivix,sargeras,765,hunter,beastmastery,12,8,4
Handicrap,tichondrius,765,hunter,beastmastery,16,9,7
Hunt,akama,765,hunter,beastmastery,24,8,16
Grøøves,dalaran,763,hunter,beastmastery,18,8,10
Halberick,quelthalas,762,hunter,beastmastery,12,8,4
Shamtus,bladefist,762,hunter,beastmastery,12,8,4
Blury,tichondrius,762,hunter,beastmastery,18,8,10
Ophiela,shuhalo,759,hunter,beastmastery,36,8,28
Massivattack,skullcrusher,758,hunter,beastmastery,24,8,16
Blankshot,doomhammer,757,hunter,beastmastery,18,8,10
Androki,stormrage,752,hunter,beastmastery,12,8,4
Raevenah,dalaran,747,hunter,beastmastery,12,8,4
Vendortrash,aggramar,733,hunter,beastmastery,17,8,9
Timberex,drenden,715,hunter,beastmastery,15,8,7
Kysii,burning-blade,714,hunter,beastmastery,21,8,13
Cloxygen,moon-guard,713,hunter,beastmastery,22,9,13
Petpenguin,kelthuzad,703,hunter,beastmastery,11,8,3
Yozomoto,nordrassil,703,hunter,beastmastery,14,8,6
Jinchuriki,shadow-council,703,hunter,beastmastery,28,8,20
Imthaböss,nazjatar,672,hunter,beastmastery,12,7,5
Starkhaven,firetree,672,hunter,beastmastery,12,7,5
Pmø,sargeras,672,hunter,beastmastery,12,7,5
Jsr,tichondrius,672,hunter,beastmastery,12,7,5
Barainto,tichondrius,672,hunter,beastmastery,12,7,5
Alfentanil,thrall,672,hunter,beastmastery,12,7,5
Downor,malganis,672,hunter,beastmastery,12,7,5
Skippyh,zuluhed,672,hunter,beastmastery,12,7,5
Flamenco,arthas,672,hunter,beastmastery,12,7,5
Wellerman,firetree,672,hunter,beastmastery,12,7,5
Gunbladez,burning-blade,672,hunter,beastmastery,12,7,5
Gotrap,saurfang,672,hunter,beastmastery,12,7,5
Crimsoncoast,tichondrius,672,hunter,beastmastery,12,7,5
Litchi,illidan,672,hunter,beastmastery,12,7,5
Grannygatya,tichondrius,672,hunter,beastmastery,12,7,5
Shrian,illidan,672,hunter,beastmastery,12,7,5
Gentledream,dalaran,672,hunter,beastmastery,12,7,5
Buzzkilla,mannoroth,672,hunter,beastmastery,12,7,5
Tusxx,tichondrius,672,hunter,beastmastery,12,7,5
Mauiies,sargeras,672,hunter,beastmastery,12,7,5
Airlol,tichondrius,672,hunter,beastmastery,12,7,5
Machiko,gorefiend,672,hunter,beastmastery,12,7,5
Teammatescba,tichondrius,672,hunter,beastmastery,12,7,5
Handmemygun,aggramar,672,hunter,beastmastery,12,7,5
Yolotraps,thrall,672,hunter,beastmastery,12,7,5
Sakedji,area-52,672,hunter,beastmastery,12,7,5
Xerosa,emerald-dream,672,hunter,beastmastery,12,7,5
Cinnybunz,malganis,672,hunter,beastmastery,12,7,5
Csantana,sargeras,672,hunter,beastmastery,12,7,5
Mehontar,area-52,672,hunter,beastmastery,12,7,5
Jawnhunterii,tichondrius,672,hunter,beastmastery,12,7,5
Mylaqt,malganis,672,hunter,beastmastery,12,7,5
Hollowhunt,sentinels,672,hunter,beastmastery,12,7,5
Åspect,aegwynn,672,hunter,beastmastery,12,7,5
Booffmeister,area-52,672,hunter,beastmastery,12,7,5
Zemphoths,eredar,672,hunter,beastmastery,15,7,8
Xxo,frostmourne,672,hunter,beastmastery,17,7,10
Dreagneal,ragnaros,672,hunter,beastmastery,18,7,11
Antares,dalaran,672,hunter,beastmastery,18,7,11
Hrodvitnir,quelthalas,672,hunter,beastmastery,18,7,11
Memënto,barthilas,672,hunter,beastmastery,18,7,11
Geeshot,area-52,672,hunter,beastmastery,18,7,11
Cantcatchtin,tichondrius,672,hunter,beastmastery,18,7,11
Sylpheous,bleeding-hollow,672,hunter,beastmastery,18,7,11
Joerogan,hydraxis,672,hunter,beastmastery,18,7,11
Clowntown,illidan,672,hunter,beastmastery,18,7,11
Ðevil,ragnaros,672,hunter,beastmastery,18,7,11
Titanaxis,tichondrius,672,hunter,beastmastery,24,7,17
Darksector,nemesis,672,hunter,beastmastery,24,7,17
Scrubmastery,emerald-dream,671,hunter,beastmastery,12,7,5
Hunterjim,tichondrius,671,hunter,beastmastery,12,7,5
Exploits,stormrage,671,hunter,beastmastery,12,7,5
Deadlyarrows,ragnaros,671,hunter,beastmastery,12,7,5
Jendell,area-52,671,hunter,beastmastery,12,7,5
Mannypew,kelthuzad,671,hunter,beastmastery,12,7,5
Melinda,kilrogg,671,hunter,beastmastery,12,7,5
Lavo,borean-tundra,671,hunter,beastmastery,12,7,5
Wook,hyjal,671,hunter,beastmastery,12,7,5
Anniefuchsia,stormrage,671,hunter,beastmastery,12,7,5
Valintine,the-scryers,671,hunter,beastmastery,12,7,5
Spunkked,tichondrius,671,hunter,beastmastery,12,7,5
Nightfal,emerald-dream,671,hunter,beastmastery,18,7,11
Mooséhunt,wyrmrest-accord,671,hunter,beastmastery,18,7,11
Shdwhntrclub,wyrmrest-accord,671,hunter,beastmastery,18,7,11
Peiching,proudmoore,671,hunter,beastmastery,18,7,11
Cotó,stormrage,671,hunter,beastmastery,18,7,11
Amortiz,illidan,671,hunter,beastmastery,18,7,11
Threethirty,thrall,671,hunter,beastmastery,18,7,11
Genowin,sargeras,671,hunter,beastmastery,18,7,11
Ratfood,tichondrius,671,hunter,beastmastery,23,7,16
Ddänz,kiljaeden,671,hunter,beastmastery,27,8,19
Yanzz,spinebreaker,670,hunter,beastmastery,12,7,5
Easypoacher,tichondrius,670,hunter,beastmastery,12,7,5
Fawn,moon-guard,670,hunter,beastmastery,18,7,11
Spaeth,borean-tundra,670,hunter,beastmastery,24,7,17
Neurosurgery,azralon,669,hunter,beastmastery,18,7,11
Morenarösa,nemesis,669,hunter,beastmastery,24,7,17
Strafenshoot,darkspear,666,hunter,beastmastery,12,7,5
Elisen,frostmourne,665,hunter,beastmastery,30,7,23
Eastera,tichondrius,663,hunter,beastmastery,27,8,19
Theprovider,burning-blade,659,hunter,beastmastery,12,7,5
Benryats,area-52,657,hunter,beastmastery,21,8,13
Lyduc,barthilas,655,hunter,beastmastery,17,7,10
Boomsprocket,khazgoroth,639,hunter,beastmastery,8,8,0
Hawkkeye,thunderlord,639,hunter,beastmastery,17,7,10
Hikkupz,tichondrius,639,hunter,beastmastery,17,7,10
Scaredcrow,azshara,639,hunter,beastmastery,28,7,21
Hunbatz,dalaran,634,hunter,beastmastery,19,9,10
Árescarries,shuhalo,623,hunter,beastmastery,15,7,8
Ashx,nemesis,623,hunter,beastmastery,17,7,10
Loktarnum,illidan,607,hunter,beastmastery,14,7,7
Supdawg,aggramar,607,hunter,beastmastery,17,7,10
Shanghunt,cenarius,604,hunter,beastmastery,14,7,7
Oshosiwar,ragnaros,588,hunter,beastmastery,21,7,14
Rekkis,area-52,576,hunter,beastmastery,6,6,0
Píps,maelstrom,576,hunter,beastmastery,6,6,0
Gassmask,area-52,576,hunter,beastmastery,6,6,0
Igotapvpness,tichondrius,576,hunter,beastmastery,6,6,0
Jjaro,area-52,576,hunter,beastmastery,6,6,0
Evolushun,kiljaeden,576,hunter,beastmastery,9,7,2
Marexx,tichondrius,576,hunter,beastmastery,12,6,6
Zeedii,dalaran,576,hunter,beastmastery,12,6,6
Dbrickashaw,proudmoore,576,hunter,beastmastery,12,6,6
Darkoshuntar,tichondrius,576,hunter,beastmastery,12,6,6
Vindication,ysera,576,hunter,beastmastery,12,6,6
Squírtle,ragnaros,576,hunter,beastmastery,12,6,6
Conizle,sargeras,576,hunter,beastmastery,12,6,6
Geregaux,sargeras,576,hunter,beastmastery,12,6,6
Hxnry,barthilas,576,hunter,beastmastery,12,6,6
Wongy,tichondrius,576,hunter,beastmastery,12,6,6
Retaâáàäãart,tichondrius,576,hunter,beastmastery,12,6,6
Jonah,sargeras,576,hunter,beastmastery,12,6,6
Elyssandrá,thrall,576,hunter,beastmastery,12,6,6
Huntard,stormrage,576,hunter,beastmastery,12,6,6
Kånade,ragnaros,576,hunter,beastmastery,12,6,6
Skyfel,aggramar,576,hunter,beastmastery,12,6,6
Spottedoger,burning-legion,576,hunter,beastmastery,12,6,6
Toniic,moon-guard,576,hunter,beastmastery,12,6,6
Tyrokk,barthilas,576,hunter,beastmastery,12,6,6
Raadun,terokkar,576,hunter,beastmastery,12,6,6
Runforthehil,barthilas,576,hunter,beastmastery,12,6,6
Zizilio,kelthuzad,576,hunter,beastmastery,12,6,6
Digitizoid,tichondrius,576,hunter,beastmastery,12,6,6
Thoridhal,quelthalas,576,hunter,beastmastery,12,6,6
Khanittus,area-52,576,hunter,beastmastery,12,6,6
Ecl,azralon,576,hunter,beastmastery,12,6,6
Jwzz,tichondrius,576,hunter,beastmastery,12,6,6
Wrècked,kiljaeden,576,hunter,beastmastery,12,6,6
Shøz,wyrmrest-accord,576,hunter,beastmastery,12,6,6
Undeadroach,tichondrius,576,hunter,beastmastery,12,6,6
Evilblammo,thorium-brotherhood,576,hunter,beastmastery,12,6,6
Hunterpk,lightbringer,576,hunter,beastmastery,12,6,6
Alochol,vashj,576,hunter,beastmastery,12,6,6
Zookeepah,tichondrius,576,hunter,beastmastery,12,6,6
Zertkal,undermine,576,hunter,beastmastery,12,6,6
Pikabow,tichondrius,576,hunter,beastmastery,12,6,6
Raerdun,bonechewer,576,hunter,beastmastery,12,6,6
Nytefell,skullcrusher,576,hunter,beastmastery,12,6,6
Kyoü,drakkari,576,hunter,beastmastery,12,6,6
Ahncheolsoo,tichondrius,576,hunter,beastmastery,12,6,6
Scurvypete,perenolde,576,hunter,beastmastery,12,6,6
Balboa,tortheldrin,576,hunter,beastmastery,12,6,6
Somethinglit,sargeras,576,hunter,beastmastery,12,6,6
Jalinhabbei,azralon,576,hunter,beastmastery,12,6,6
Jboogie,malganis,576,hunter,beastmastery,12,6,6
Fma,stormrage,576,hunter,beastmastery,12,6,6
Shyck,ragnaros,576,hunter,beastmastery,12,6,6
Daylilycoast,emerald-dream,576,hunter,beastmastery,12,6,6
Bloodymalik,tichondrius,576,hunter,beastmastery,12,6,6
Tethro,zuljin,576,hunter,beastmastery,12,6,6
Peregrin,burning-legion,576,hunter,beastmastery,12,6,6
Fanikita,azralon,576,hunter,beastmastery,12,6,6
Despise,frostmourne,576,hunter,beastmastery,12,6,6
Gravshot,zuljin,576,hunter,beastmastery,12,6,6
Gennaro,ragnaros,576,hunter,beastmastery,12,6,6
Virgim,kelthuzad,576,hunter,beastmastery,12,6,6
Nitroxl,illidan,576,hunter,beastmastery,12,6,6
Puppe,sargeras,576,hunter,beastmastery,15,7,8
Misakilr,illidan,576,hunter,beastmastery,13,6,7
Arraza,ragnaros,576,hunter,beastmastery,16,7,9
Justforfunxx,tichondrius,576,hunter,beastmastery,18,6,12
Bowreckage,malganis,576,hunter,beastmastery,18,6,12
Snipin,ragnaros,576,hunter,beastmastery,18,6,12
Kanta,bleeding-hollow,576,hunter,beastmastery,18,6,12
Nishinos,tichondrius,576,hunter,beastmastery,18,6,12
Crumpit,moon-guard,576,hunter,beastmastery,21,6,15
Yolloswag,tichondrius,576,hunter,beastmastery,24,6,18
Sniffler,barthilas,576,hunter,beastmastery,24,6,18
Beastbaal,sargeras,576,hunter,beastmastery,24,6,18
Lulafourdedo,stormrage,575,hunter,beastmastery,7,6,1
Noitrag,azralon,575,hunter,beastmastery,11,6,5
Míbu,lightbringer,575,hunter,beastmastery,12,6,6
Recoyl,proudmoore,575,hunter,beastmastery,12,6,6
Gammaraven,dalaran,575,hunter,beastmastery,12,6,6
Yobby,area-52,575,hunter,beastmastery,12,6,6
Ovî,area-52,575,hunter,beastmastery,12,6,6
Gwarnar,stormrage,575,hunter,beastmastery,12,6,6
Eastwake,stormrage,575,hunter,beastmastery,12,6,6
Asuryakha,darkspear,575,hunter,beastmastery,12,6,6
Fireshots,tichondrius,575,hunter,beastmastery,12,6,6
Tozier,destromath,575,hunter,beastmastery,18,6,12
Revö,area-52,575,hunter,beastmastery,18,6,12
Camorcaist,stormrage,575,hunter,beastmastery,18,6,12
Balsagoth,azralon,575,hunter,beastmastery,18,6,12
Aliciaomg,andorhal,575,hunter,beastmastery,18,6,12
Arcticuz,aegwynn,574,hunter,beastmastery,12,6,6
Nekrongar,agamaggan,574,hunter,beastmastery,12,6,6
Shikago,wyrmrest-accord,574,hunter,beastmastery,18,6,12
Kalibah,azralon,574,hunter,beastmastery,18,6,12
Sapphie,frostmourne,574,hunter,beastmastery,24,6,18
Rikitiki,bleeding-hollow,573,hunter,beastmastery,12,6,6
Foffy,darkspear,573,hunter,beastmastery,12,6,6
Dakirell,drakkari,573,hunter,beastmastery,18,6,12
Pewpew,gallywix,573,hunter,beastmastery,18,6,12
Pewpewd,tichondrius,572,hunter,beastmastery,12,6,6
Dethh,dunemaul,572,hunter,beastmastery,12,6,6
Kargathx,ragnaros,569,hunter,beastmastery,20,8,12
Bluehead,emerald-dream,566,hunter,beastmastery,12,6,6
Wkg,azgalor,566,hunter,beastmastery,12,6,6
Squeeb,frostmourne,543,hunter,beastmastery,14,7,7
Viserysll,azralon,542,hunter,beastmastery,11,6,5
Socrato,tichondrius,526,hunter,beastmastery,11,6,5
Ataxyus,area-52,512,hunter,beastmastery,10,6,4
Aluminumfoil,kelthuzad,510,hunter,beastmastery,11,6,5
Bagodonuts,malganis,510,hunter,beastmastery,17,7,10
Malthiz,antonidas,507,hunter,beastmastery,22,8,14
Jackcoügh,frostmourne,496,hunter,beastmastery,13,6,7
Unloaded,illidan,480,hunter,beastmastery,6,5,1
Oeoeoeoeoeoe,alterac-mountains,480,hunter,beastmastery,6,5,1
Arrebol,tichondrius,480,hunter,beastmastery,6,5,1
Yajr,black-dragonflight,480,hunter,beastmastery,6,5,1
Slêv,frostmourne,480,hunter,beastmastery,6,5,1
Cojáx,dalaran,480,hunter,beastmastery,6,5,1
Dankshunt,arthas,480,hunter,beastmastery,6,5,1
Kkoduckk,tichondrius,480,hunter,beastmastery,6,5,1
Wopper,moon-guard,480,hunter,beastmastery,6,5,1
Brokensnipez,area-52,480,hunter,beastmastery,6,5,1
Beasting,moon-guard,480,hunter,beastmastery,6,5,1
Traptrinket,sargeras,480,hunter,beastmastery,6,5,1
Berkhof,tichondrius,480,hunter,beastmastery,6,5,1
Zansnipes,dalaran,480,hunter,beastmastery,6,5,1
Bluez,tichondrius,480,hunter,beastmastery,6,5,1
Megahuntard,bleeding-hollow,480,hunter,beastmastery,6,5,1
Plsnobanmee,frostmourne,480,hunter,beastmastery,6,5,1
Hitx,tichondrius,480,hunter,beastmastery,6,5,1
Laoai,tichondrius,480,hunter,beastmastery,6,5,1
Chimeralol,area-52,480,hunter,beastmastery,6,5,1
Nsjp,darkspear,480,hunter,beastmastery,6,5,1
Linkolnn,sargeras,480,hunter,beastmastery,6,5,1
Nokda,tichondrius,480,hunter,beastmastery,6,5,1
Tèrrabite,sargeras,480,hunter,beastmastery,6,5,1
Tukki,quelthalas,480,hunter,beastmastery,6,5,1
Hediilyan,azralon,480,hunter,beastmastery,7,5,2
Angrypepe,bleeding-hollow,480,hunter,beastmastery,12,5,7
Køk,agamaggan,480,hunter,beastmastery,12,5,7
Àthenaa,malygos,480,hunter,beastmastery,12,5,7
Lrnb,tichondrius,480,hunter,beastmastery,12,5,7
Imperatrix,emerald-dream,480,hunter,beastmastery,12,5,7
Ariais,zangarmarsh,480,hunter,beastmastery,12,5,7
Wønky,stormrage,480,hunter,beastmastery,12,5,7
Snoozee,emerald-dream,480,hunter,beastmastery,12,5,7
Nj,kiljaeden,480,hunter,beastmastery,12,5,7
Drakku,zuljin,480,hunter,beastmastery,12,5,7
Ferex,tichondrius,480,hunter,beastmastery,12,5,7
Lissavi,tichondrius,480,hunter,beastmastery,12,5,7
Nflmaster,malganis,480,hunter,beastmastery,12,5,7
Sunflwerdawn,emerald-dream,480,hunter,beastmastery,12,5,7
Rürü,illidan,480,hunter,beastmastery,12,5,7
Xuorias,area-52,480,hunter,beastmastery,12,5,7
Powdersoak,area-52,480,hunter,beastmastery,12,5,7
Michaeljfox,area-52,480,hunter,beastmastery,12,5,7
Viral,grizzly-hills,480,hunter,beastmastery,12,5,7
Valeous,azjolnerub,480,hunter,beastmastery,12,5,7
Sinvat,tichondrius,480,hunter,beastmastery,12,5,7
Skillvanas,stormrage,480,hunter,beastmastery,12,5,7
Zyzzmirin,illidan,480,hunter,beastmastery,12,5,7
Kurmojo,hyjal,480,hunter,beastmastery,12,5,7
Yatyegatchun,illidan,480,hunter,beastmastery,12,5,7
Smexyhunter,moon-guard,480,hunter,beastmastery,12,5,7
Taphh,moon-guard,480,hunter,beastmastery,12,5,7
Mojopojo,tichondrius,480,hunter,beastmastery,12,5,7
Twoshotz,stormrage,480,hunter,beastmastery,12,5,7
Kolosaltraps,tichondrius,480,hunter,beastmastery,12,5,7
Fallacies,moon-guard,480,hunter,beastmastery,12,5,7
Mostmanly,tichondrius,480,hunter,beastmastery,12,5,7
Yesterday,draka,480,hunter,beastmastery,12,5,7
Fabbs,frostmourne,480,hunter,beastmastery,12,5,7
Mav,dragonmaw,480,hunter,beastmastery,14,5,9
Bøl,ragnaros,480,hunter,beastmastery,16,5,11
Motegi,illidan,480,hunter,beastmastery,18,5,13
Blockbusters,sargeras,480,hunter,beastmastery,18,5,13
Amoreiene,stormrage,480,hunter,beastmastery,18,5,13
Gratmuk,ragnaros,480,hunter,beastmastery,18,5,13
Tazer,area-52,480,hunter,beastmastery,18,5,13
Chetxs,bleeding-hollow,480,hunter,beastmastery,18,5,13
Trycaza,ragnaros,480,hunter,beastmastery,18,5,13
Clinteastwoo,ragnaros,480,hunter,beastmastery,18,5,13
Cophunter,tichondrius,480,hunter,beastmastery,18,5,13
Snoogen,illidan,480,hunter,beastmastery,18,5,13
Bighuntz,bleeding-hollow,480,hunter,beastmastery,18,5,13
Grindal,drakkari,480,hunter,beastmastery,18,5,13
Zpax,area-52,479,hunter,beastmastery,6,5,1
Mafghine,malganis,479,hunter,beastmastery,6,5,1
Smallsouljah,demon-soul,479,hunter,beastmastery,12,5,7
Shoya,nerzhul,479,hunter,beastmastery,12,5,7
Oblíviion,stormrage,479,hunter,beastmastery,12,5,7
Zhanzu,quelthalas,479,hunter,beastmastery,12,5,7
Mecatrón,quelthalas,479,hunter,beastmastery,12,5,7
Kairoke,azralon,479,hunter,beastmastery,12,5,7
Trianthel,azralon,479,hunter,beastmastery,12,5,7
Deadlyattack,barthilas,479,hunter,beastmastery,12,5,7
Equipmunk,arthas,479,hunter,beastmastery,12,5,7
Namikawa,stormrage,479,hunter,beastmastery,12,5,7
Trushôtz,tichondrius,479,hunter,beastmastery,17,5,12
Smider,magtheridon,479,hunter,beastmastery,18,5,13
Tiraa,kelthuzad,479,hunter,beastmastery,18,5,13
Zarrockk,emerald-dream,478,hunter,beastmastery,12,5,7
Fiznits,nerzhul,478,hunter,beastmastery,18,5,13
Feralhuntard,muradin,477,hunter,beastmastery,12,5,7
Jîa,tichondrius,448,hunter,beastmastery,10,5,5
Travisshot,tichondrius,447,hunter,beastmastery,11,5,6
Gunther,korgath,447,hunter,beastmastery,11,5,6
Spunky,zuluhed,447,hunter,beastmastery,11,5,6
Verzatyle,frostwolf,447,hunter,beastmastery,11,5,6
Vuur,korialstrasz,447,hunter,beastmastery,19,6,13
Rástakhan,ragnaros,431,hunter,beastmastery,11,5,6
Hazzlôk,cairne,426,hunter,beastmastery,20,7,13
Malgar,zuljin,415,hunter,beastmastery,11,5,6
Actioh,stormrage,384,hunter,beastmastery,6,4,2
Ithanna,quelthalas,384,hunter,beastmastery,6,4,2
Markymarc,tichondrius,384,hunter,beastmastery,6,4,2
Jerso,zuljin,384,hunter,beastmastery,6,4,2
Reilerhunt,stormrage,384,hunter,beastmastery,6,4,2
Probo,aegwynn,384,hunter,beastmastery,6,4,2
Strongene,aegwynn,384,hunter,beastmastery,6,4,2
Dexh,frostmourne,384,hunter,beastmastery,6,4,2
Kong,tichondrius,384,hunter,beastmastery,6,4,2
Coppersnout,wyrmrest-accord,384,hunter,beastmastery,6,4,2
Redzic,tichondrius,384,hunter,beastmastery,6,4,2
Silvershot,emerald-dream,384,hunter,beastmastery,6,4,2
Mhters,tichondrius,384,hunter,beastmastery,6,4,2
Chichi,korgath,384,hunter,beastmastery,6,4,2
Sindshai,onyxia,384,hunter,beastmastery,6,4,2
Funnk,tichondrius,384,hunter,beastmastery,6,4,2
Dcousins,tichondrius,384,hunter,beastmastery,6,4,2
Naxhunter,stormrage,384,hunter,beastmastery,6,4,2
Gorillafart,spirestone,384,hunter,beastmastery,6,4,2
Yeaheh,area-52,384,hunter,beastmastery,6,4,2
Heylenny,area-52,384,hunter,beastmastery,6,4,2
Tangoda,tichondrius,384,hunter,beastmastery,6,4,2
Ragerab,trollbane,384,hunter,beastmastery,6,4,2
Chikkynuggy,destromath,384,hunter,beastmastery,6,4,2
Houdan,frostmourne,384,hunter,beastmastery,6,4,2
Zarnick,frostwolf,384,hunter,beastmastery,6,4,2
Bodangel,galakrond,384,hunter,beastmastery,6,4,2
Sôuleater,moon-guard,384,hunter,beastmastery,6,4,2
Pillarington,tichondrius,384,hunter,beastmastery,6,4,2
Nodougaelark,dalaran,384,hunter,beastmastery,6,4,2
Chokemescara,stormrage,384,hunter,beastmastery,6,4,2
Malcab,tichondrius,384,hunter,beastmastery,6,4,2
Fizzpow,blackrock,384,hunter,beastmastery,6,4,2
Naestrá,bleeding-hollow,384,hunter,beastmastery,6,4,2
Jagare,tichondrius,384,hunter,beastmastery,6,4,2
Khels,stormreaver,384,hunter,beastmastery,6,4,2
Zubo,tichondrius,384,hunter,beastmastery,6,4,2
Bittitan,frostmourne,384,hunter,beastmastery,6,4,2
Hitcompleted,moon-guard,384,hunter,beastmastery,6,4,2
Skytah,darkspear,384,hunter,beastmastery,6,4,2
Bufluu,bleeding-hollow,384,hunter,beastmastery,6,4,2
Mexishots,tichondrius,384,hunter,beastmastery,6,4,2
Shiki,icecrown,384,hunter,beastmastery,6,4,2
Snipingmilfs,zuluhed,384,hunter,beastmastery,6,4,2
Tyleraq,area-52,384,hunter,beastmastery,6,4,2
Ziêg,eonar,384,hunter,beastmastery,6,4,2
Shedowhunter,azralon,384,hunter,beastmastery,6,4,2
Recklaw,frostmourne,384,hunter,beastmastery,6,4,2
Xarmozao,nemesis,384,hunter,beastmastery,6,4,2
Lowlore,moon-guard,384,hunter,beastmastery,6,4,2
Infatuatedx,moon-guard,384,hunter,beastmastery,6,4,2
Moash,spinebreaker,384,hunter,beastmastery,6,4,2
Tezcâtlipocâ,sargeras,384,hunter,beastmastery,6,4,2
Byrdh,zuljin,384,hunter,beastmastery,9,5,4
Nakyash,ragnaros,384,hunter,beastmastery,9,5,4
Jeonghun,tichondrius,384,hunter,beastmastery,9,5,4
Anteróz,tichondrius,384,hunter,beastmastery,9,4,5
Rycksanches,quelthalas,384,hunter,beastmastery,10,4,6
Shaevie,lothar,384,hunter,beastmastery,12,4,8
Calypso,chromaggus,384,hunter,beastmastery,12,4,8
Moùrningwood,stormrage,384,hunter,beastmastery,12,4,8
Inetpub,stormrage,384,hunter,beastmastery,12,4,8
Kaliaraan,bleeding-hollow,384,hunter,beastmastery,12,4,8
Skycaptaín,lightbringer,384,hunter,beastmastery,12,4,8
Bangerzx,stormrage,384,hunter,beastmastery,12,4,8
Oztroza,grizzly-hills,384,hunter,beastmastery,12,4,8
Artemisa,warsong,384,hunter,beastmastery,12,4,8
Bówjòb,nordrassil,384,hunter,beastmastery,12,4,8
Elywen,alexstrasza,384,hunter,beastmastery,12,4,8
Shatterwax,area-52,384,hunter,beastmastery,12,4,8
Macabre,scilla,384,hunter,beastmastery,12,4,8
Bowsauce,khadgar,384,hunter,beastmastery,12,4,8
Cndavyjones,akama,384,hunter,beastmastery,12,4,8
Odb,kelthuzad,384,hunter,beastmastery,12,4,8
Mingsomnia,kiljaeden,384,hunter,beastmastery,12,4,8
Iililillilii,tichondrius,384,hunter,beastmastery,12,4,8
Alkynabm,kelthuzad,384,hunter,beastmastery,12,4,8
Bazanguita,tichondrius,384,hunter,beastmastery,12,4,8
Throwadox,malganis,384,hunter,beastmastery,12,4,8
Killatrap,malganis,384,hunter,beastmastery,12,4,8
Devastavi,proudmoore,384,hunter,beastmastery,12,4,8
Arcuz,quelthalas,384,hunter,beastmastery,12,4,8
Grumaku,area-52,384,hunter,beastmastery,12,4,8
Seanpaì,tichondrius,384,hunter,beastmastery,12,4,8
Bingdat,area-52,384,hunter,beastmastery,12,4,8
Twopawshunta,tichondrius,384,hunter,beastmastery,12,4,8
Grimshot,boulderfist,384,hunter,beastmastery,12,4,8
Päinal,area-52,384,hunter,beastmastery,12,4,8
Kok,andorhal,384,hunter,beastmastery,12,4,8
Xcisiion,nagrand,384,hunter,beastmastery,12,4,8
Teddybowschi,sargeras,384,hunter,beastmastery,12,4,8
Atheranni,azralon,384,hunter,beastmastery,12,4,8
Noxura,illidan,384,hunter,beastmastery,12,4,8
Kidao,emerald-dream,384,hunter,beastmastery,12,4,8
Saharä,illidan,384,hunter,beastmastery,12,4,8
Rogshunt,sargeras,384,hunter,beastmastery,12,4,8
Sèasons,tichondrius,384,hunter,beastmastery,15,4,11
Atheos,gallywix,384,hunter,beastmastery,18,4,14
Boomup,tichondrius,384,hunter,beastmastery,18,4,14
Ruffini,tichondrius,384,hunter,beastmastery,18,4,14
Katiepie,frostmourne,384,hunter,beastmastery,18,4,14
Löö,arthas,384,hunter,beastmastery,23,4,19
Jônathan,tichondrius,383,hunter,beastmastery,6,4,2
Gichiwalrus,emerald-dream,383,hunter,beastmastery,6,4,2
Eeremm,drakkari,383,hunter,beastmastery,6,4,2
Bboo,bonechewer,383,hunter,beastmastery,6,4,2
Gigawrench,darkspear,383,hunter,beastmastery,6,4,2
Paulayork,drakthul,383,hunter,beastmastery,12,4,8
Böwjøb,illidan,383,hunter,beastmastery,12,4,8
Lazygnome,azshara,383,hunter,beastmastery,12,4,8
Lamper,emerald-dream,383,hunter,beastmastery,12,4,8
Beatnyou,tichondrius,383,hunter,beastmastery,12,4,8
Àléç,mannoroth,383,hunter,beastmastery,12,4,8
Terusa,ragnaros,383,hunter,beastmastery,18,4,14
Fiury,hyjal,382,hunter,beastmastery,6,4,2
Etb,bleeding-hollow,382,hunter,beastmastery,12,4,8
Wuzi,echo-isles,380,hunter,beastmastery,12,4,8
Vicluvv,stormrage,367,hunter,beastmastery,11,4,7
Sylaris,arathor,366,hunter,beastmastery,11,4,7
Linszsz,nemesis,361,hunter,beastmastery,17,6,11
Stimpblimp,jubeithos,352,hunter,beastmastery,10,4,6
Clinkz,chogall,351,hunter,beastmastery,11,4,7
Vínçent,blood-furnace,351,hunter,beastmastery,17,4,13
Sadarrow,frostmourne,334,hunter,beastmastery,11,4,7
Bugsßunny,sargeras,330,hunter,beastmastery,16,5,11
Somethinggo,tichondrius,330,hunter,beastmastery,22,6,16
Sylviai,hyjal,319,hunter,beastmastery,8,4,4
Resonators,tichondrius,304,hunter,beastmastery,7,4,3
Ironova,illidan,288,hunter,beastmastery,6,3,3
Venj,proudmoore,288,hunter,beastmastery,6,3,3
Gudlukk,stormrage,288,hunter,beastmastery,6,3,3
Tibineids,stormrage,288,hunter,beastmastery,6,3,3
Onahai,tichondrius,288,hunter,beastmastery,6,3,3
Therealgam,the-underbog,288,hunter,beastmastery,6,3,3
Barrohunt,tichondrius,288,hunter,beastmastery,6,3,3
Wannakill,stormrage,288,hunter,beastmastery,6,3,3
Enonoa,thunderlord,288,hunter,beastmastery,6,3,3
Grayføxx,twisting-nether,288,hunter,beastmastery,6,3,3
Britannian,moon-guard,288,hunter,beastmastery,6,3,3
Oddangel,azuremyst,288,hunter,beastmastery,6,3,3
Thiccphat,sargeras,288,hunter,beastmastery,6,3,3
Lyler,tichondrius,288,hunter,beastmastery,6,3,3
Fakerz,stormrage,288,hunter,beastmastery,6,3,3
Hannes,boulderfist,288,hunter,beastmastery,6,3,3
Parâsite,kelthuzad,288,hunter,beastmastery,6,3,3
Billcsbyswtr,sargeras,288,hunter,beastmastery,6,3,3
Makeastinky,malfurion,288,hunter,beastmastery,6,3,3
Nyloc,dalvengyr,288,hunter,beastmastery,6,3,3
Rachetbutt,tichondrius,288,hunter,beastmastery,6,3,3
Mastasnipa,illidan,288,hunter,beastmastery,6,3,3
Hobbléfoot,proudmoore,288,hunter,beastmastery,6,3,3
Adapted,proudmoore,288,hunter,beastmastery,6,3,3
Sabanna,proudmoore,288,hunter,beastmastery,6,3,3
Saynice,warsong,288,hunter,beastmastery,6,3,3
Norgalys,proudmoore,288,hunter,beastmastery,6,3,3
Harmfulwang,emerald-dream,288,hunter,beastmastery,6,3,3
Stel,tichondrius,288,hunter,beastmastery,6,3,3
Bountybud,kiljaeden,288,hunter,beastmastery,6,3,3
Chouklak,zuljin,288,hunter,beastmastery,6,3,3
Skarioth,azralon,288,hunter,beastmastery,6,3,3
Realzanderr,antonidas,288,hunter,beastmastery,6,3,3
Vikshen,illidan,288,hunter,beastmastery,6,3,3
Tetzuo,illidan,288,hunter,beastmastery,6,3,3
Warrccjr,steamwheedle-cartel,288,hunter,beastmastery,6,3,3
Backa,jubeithos,288,hunter,beastmastery,6,3,3
Cefla,illidan,288,hunter,beastmastery,6,3,3
Relaxnerd,antonidas,288,hunter,beastmastery,6,3,3
Bmsurvmm,tichondrius,288,hunter,beastmastery,6,3,3
Vicarnam,uldum,288,hunter,beastmastery,6,3,3
Herroo,thrall,288,hunter,beastmastery,6,3,3
Longshott,azralon,288,hunter,beastmastery,6,3,3
Airoh,gorefiend,288,hunter,beastmastery,6,3,3
Cluhaywood,zuljin,288,hunter,beastmastery,6,3,3
Deahtgab,ragnaros,288,hunter,beastmastery,6,3,3
Redthedeer,warsong,288,hunter,beastmastery,6,3,3
Guacmec,tichondrius,288,hunter,beastmastery,6,3,3
Jellyleg,bleeding-hollow,288,hunter,beastmastery,6,3,3
Exabyssus,bleeding-hollow,288,hunter,beastmastery,6,3,3
Oblio,silvermoon,288,hunter,beastmastery,6,3,3
Soberish,bleeding-hollow,288,hunter,beastmastery,6,3,3
Wanshöt,tichondrius,288,hunter,beastmastery,6,3,3
Mynds,stormrage,288,hunter,beastmastery,6,3,3
Raainha,stormrage,288,hunter,beastmastery,6,3,3
Thejw,firetree,288,hunter,beastmastery,6,3,3
Scolhunter,scarlet-crusade,288,hunter,beastmastery,6,3,3
Braxigarr,area-52,288,hunter,beastmastery,6,3,3
Ljai,gilneas,288,hunter,beastmastery,6,3,3
Archetype,bladefist,288,hunter,beastmastery,6,3,3
Viavii,barthilas,288,hunter,beastmastery,6,3,3
Urukah,gallywix,288,hunter,beastmastery,6,3,3
Mogradme,shadowsong,288,hunter,beastmastery,6,3,3
Pewpewbang,muradin,288,hunter,beastmastery,6,3,3
Aldurion,wyrmrest-accord,288,hunter,beastmastery,6,3,3
Bagofsnit,frostmourne,288,hunter,beastmastery,6,3,3
Beastmodex,quelthalas,288,hunter,beastmastery,6,3,3
Chrisp,bloodhoof,288,hunter,beastmastery,6,3,3
Moyria,quelthalas,288,hunter,beastmastery,6,3,3
Trailed,dalaran,288,hunter,beastmastery,6,3,3
Emart,bloodhoof,288,hunter,beastmastery,6,3,3
Blastinnagas,tichondrius,288,hunter,beastmastery,6,3,3
Enigmer,area-52,288,hunter,beastmastery,6,3,3
Latrampoza,quelthalas,288,hunter,beastmastery,6,3,3
Goraku,dalaran,288,hunter,beastmastery,6,3,3
Orqism,tichondrius,288,hunter,beastmastery,6,3,3
Dualp,tichondrius,288,hunter,beastmastery,6,3,3
Brorc,kul-tiras,288,hunter,beastmastery,6,3,3
Nalsa,tichondrius,288,hunter,beastmastery,6,3,3
Leadblaster,gorefiend,288,hunter,beastmastery,6,3,3
Díllý,area-52,288,hunter,beastmastery,6,3,3
Zeroday,emerald-dream,288,hunter,beastmastery,6,3,3
Teaa,dalaran,288,hunter,beastmastery,6,3,3
Siimmplicitz,area-52,288,hunter,beastmastery,6,3,3
Kalekros,tichondrius,288,hunter,beastmastery,6,3,3
Perfectcrit,area-52,288,hunter,beastmastery,6,3,3
Vinksy,sargeras,288,hunter,beastmastery,6,3,3
Akirarika,wyrmrest-accord,288,hunter,beastmastery,6,3,3
Ballistik,area-52,288,hunter,beastmastery,6,3,3
Shallwe,frostmourne,288,hunter,beastmastery,6,3,3
Wiittig,hyjal,288,hunter,beastmastery,6,3,3
Yoyoletsgo,malganis,288,hunter,beastmastery,6,3,3
Nexxa,muradin,288,hunter,beastmastery,6,3,3
Burguir,ragnaros,288,hunter,beastmastery,6,3,3
Mcfibers,malganis,288,hunter,beastmastery,6,3,3
Firskin,frostmourne,288,hunter,beastmastery,6,3,3
Gugubird,proudmoore,288,hunter,beastmastery,6,3,3
Jungling,kelthuzad,288,hunter,beastmastery,6,3,3
Georgigeo,turalyon,288,hunter,beastmastery,6,3,3
Harosh,azralon,288,hunter,beastmastery,6,3,3
Autismo,garithos,288,hunter,beastmastery,6,3,3
Trixex,darkspear,288,hunter,beastmastery,6,3,3
Popshotz,khazgoroth,288,hunter,beastmastery,6,3,3
Llachiip,zuljin,288,hunter,beastmastery,10,4,6
Aybeara,area-52,288,hunter,beastmastery,12,3,9
Grlzzlyadams,norgannon,288,hunter,beastmastery,12,3,9
Zhona,moon-guard,288,hunter,beastmastery,12,3,9
Wargodthor,blades-edge,288,hunter,beastmastery,12,3,9
Brewster,burning-legion,288,hunter,beastmastery,12,3,9
Harÿn,nemesis,288,hunter,beastmastery,12,3,9
Aamoody,bloodhoof,288,hunter,beastmastery,12,3,9
Rinasonline,sargeras,288,hunter,beastmastery,12,3,9
Natnat,sargeras,288,hunter,beastmastery,12,3,9
Punkrockguy,illidan,288,hunter,beastmastery,12,3,9
Dieplox,thunderhorn,288,hunter,beastmastery,12,3,9
Terrygross,sargeras,288,hunter,beastmastery,12,3,9
Elfinballz,khadgar,288,hunter,beastmastery,12,3,9
Thiande,zuljin,288,hunter,beastmastery,12,3,9
Hohohohahah,gallywix,288,hunter,beastmastery,12,3,9
Fistbèk,bleeding-hollow,288,hunter,beastmastery,12,3,9
Dunkam,quelthalas,288,hunter,beastmastery,12,3,9
Bowflëx,zuljin,288,hunter,beastmastery,12,3,9
Ryanderanged,wyrmrest-accord,288,hunter,beastmastery,12,3,9
Dodirty,laughing-skull,288,hunter,beastmastery,12,3,9
Leggodex,caelestrasz,288,hunter,beastmastery,12,3,9
Jgalth,chogall,288,hunter,beastmastery,12,3,9
Nikå,ragnaros,288,hunter,beastmastery,12,3,9
Gunwalk,azjolnerub,288,hunter,beastmastery,12,3,9
Rooman,ragnaros,288,hunter,beastmastery,12,3,9
Kharthorin,moon-guard,288,hunter,beastmastery,12,3,9
Tarah,lightbringer,288,hunter,beastmastery,12,3,9
Scythedom,tichondrius,288,hunter,beastmastery,12,3,9
Digsites,emerald-dream,288,hunter,beastmastery,12,3,9
Prowd,staghelm,288,hunter,beastmastery,12,3,9
Delanooch,rexxar,288,hunter,beastmastery,12,3,9
ßloodmain,tichondrius,288,hunter,beastmastery,12,3,9
Tanrith,dark-iron,288,hunter,beastmastery,12,3,9
Neríne,drakkari,288,hunter,beastmastery,12,3,9
Toozz,frostmourne,288,hunter,beastmastery,12,3,9
Rice,veknilash,288,hunter,beastmastery,12,3,9
Jezoo,frostmourne,288,hunter,beastmastery,18,3,15
Blanar,quelthalas,288,hunter,beastmastery,18,3,15
Kango,azgalor,288,hunter,beastmastery,18,3,15
Yiyixx,tichondrius,288,hunter,beastmastery,18,3,15
Drpenatrator,barthilas,287,hunter,beastmastery,6,3,3
Pureguava,gorefiend,287,hunter,beastmastery,6,3,3
Luzyfer,quelthalas,287,hunter,beastmastery,6,3,3
Euroniimus,ragnaros,287,hunter,beastmastery,6,3,3
Wolftracer,sargeras,287,hunter,beastmastery,6,3,3
Ledan,lightnings-blade,287,hunter,beastmastery,6,3,3
Maveraxx,executus,287,hunter,beastmastery,12,3,9
Arin,suramar,287,hunter,beastmastery,12,3,9
Acotas,blades-edge,286,hunter,beastmastery,6,3,3
Mehtcurious,ragnaros,286,hunter,beastmastery,12,3,9
Darkally,blades-edge,285,hunter,beastmastery,12,3,9
Twatshót,burning-legion,281,hunter,beastmastery,15,5,10
Salurian,destromath,271,hunter,beastmastery,11,3,8
Bulszeye,azgalor,255,hunter,beastmastery,8,4,4
Tearsofnoobs,tichondrius,255,hunter,beastmastery,9,4,5
Pokeyourbutt,hydraxis,240,hunter,beastmastery,15,3,12
Metrallon,black-dragonflight,239,hunter,beastmastery,5,3,2
Diisdik,tichondrius,239,hunter,beastmastery,5,3,2
Trycen,bleeding-hollow,239,hunter,beastmastery,5,3,2
Vicecheney,illidan,239,hunter,beastmastery,5,3,2
Léfty,nagrand,239,hunter,beastmastery,11,3,8
Djcummyfeet,stormrage,234,hunter,beastmastery,17,6,11
Feralcat,nazjatar,208,hunter,beastmastery,13,3,10
Kansolly,tichondrius,192,hunter,beastmastery,6,2,4
Shootermgavn,frostmourne,192,hunter,beastmastery,6,2,4
Solderboi,tichondrius,192,hunter,beastmastery,6,2,4
Pfheign,area-52,192,hunter,beastmastery,6,2,4
Ussy,area-52,192,hunter,beastmastery,6,2,4
Zoopdapoop,dalaran,192,hunter,beastmastery,6,2,4
Blakespace,area-52,192,hunter,beastmastery,6,2,4
Thunderbúll,tichondrius,192,hunter,beastmastery,6,2,4
Drimhuzzah,velen,192,hunter,beastmastery,6,2,4
Hollee,turalyon,192,hunter,beastmastery,6,2,4
Varianhunter,kelthuzad,192,hunter,beastmastery,6,2,4
Gruì,malganis,192,hunter,beastmastery,6,2,4
Gohan,jubeithos,192,hunter,beastmastery,6,2,4
Powerful,aerie-peak,192,hunter,beastmastery,6,2,4
Etarie,malganis,192,hunter,beastmastery,6,2,4
Mojito,frostmourne,192,hunter,beastmastery,6,2,4
Habanero,anetheron,192,hunter,beastmastery,6,2,4
Munrrack,ragnaros,192,hunter,beastmastery,6,2,4
Diacachimbaa,ragnaros,192,hunter,beastmastery,6,2,4
Juicyfruit,bleeding-hollow,192,hunter,beastmastery,6,2,4
Survbot,malganis,192,hunter,beastmastery,6,2,4
Alikay,ragnaros,192,hunter,beastmastery,6,2,4
Impërïum,zuljin,192,hunter,beastmastery,6,2,4
Åî,tichondrius,192,hunter,beastmastery,6,2,4
Hüh,area-52,192,hunter,beastmastery,6,2,4
Verzoz,illidan,192,hunter,beastmastery,6,2,4
Revengexyz,zuljin,192,hunter,beastmastery,6,2,4
Plastera,zuljin,192,hunter,beastmastery,6,2,4
Caligar,tichondrius,192,hunter,beastmastery,6,2,4
Xavííer,tichondrius,192,hunter,beastmastery,6,2,4
Ikiteforfood,zuljin,192,hunter,beastmastery,6,2,4
Warplaquee,zuljin,192,hunter,beastmastery,6,2,4
Dreadrahl,deathwing,192,hunter,beastmastery,6,2,4
Rämbow,frostmourne,192,hunter,beastmastery,6,2,4
Monffbc,tichondrius,192,hunter,beastmastery,6,2,4
Snaken,the-forgotten-coast,192,hunter,beastmastery,6,2,4
Barrelsofrum,illidan,192,hunter,beastmastery,6,2,4
Vanpeltz,illidan,192,hunter,beastmastery,6,2,4
Autoshotxprt,frostmourne,192,hunter,beastmastery,6,2,4
Singer,lothar,192,hunter,beastmastery,6,2,4
Frìtz,barthilas,192,hunter,beastmastery,6,2,4
Totolol,trollbane,192,hunter,beastmastery,6,2,4
Shådé,stormrage,192,hunter,beastmastery,6,2,4
Viracha,stormrage,192,hunter,beastmastery,6,2,4
Wooftoof,frostmourne,192,hunter,beastmastery,6,2,4
Greasyboi,tichondrius,192,hunter,beastmastery,6,2,4
Seenobody,stormrage,192,hunter,beastmastery,6,2,4
Dnicee,stormrage,192,hunter,beastmastery,6,2,4
Kudzue,illidan,192,hunter,beastmastery,6,2,4
Purpreynolds,tichondrius,192,hunter,beastmastery,6,2,4
Presleyjane,tichondrius,192,hunter,beastmastery,6,2,4
Nahzah,stormrage,192,hunter,beastmastery,6,2,4
Yangthekhunt,tichondrius,192,hunter,beastmastery,6,2,4
Harrowin,area-52,192,hunter,beastmastery,6,2,4
Nevon,azralon,192,hunter,beastmastery,6,2,4
Bluntcrushed,area-52,192,hunter,beastmastery,6,2,4
Fjdominador,azralon,192,hunter,beastmastery,6,2,4
Madsniper,thunderlord,192,hunter,beastmastery,6,2,4
Rúdrá,area-52,192,hunter,beastmastery,6,2,4
Neverwipes,frostmourne,192,hunter,beastmastery,6,2,4
Skillhunter,tichondrius,192,hunter,beastmastery,6,2,4
Urukkz,goldrinn,192,hunter,beastmastery,6,2,4
Defacecilth,dalaran,192,hunter,beastmastery,6,2,4
Camfeed,illidan,192,hunter,beastmastery,6,2,4
Ivanjackenov,illidan,192,hunter,beastmastery,6,2,4
Bloodstark,dreadmaul,192,hunter,beastmastery,6,2,4
Csadark,nemesis,192,hunter,beastmastery,6,2,4
Chaseurnoir,exodar,192,hunter,beastmastery,6,2,4
Rostter,azralon,192,hunter,beastmastery,6,2,4
Magvez,tichondrius,192,hunter,beastmastery,6,2,4
Yugno,wildhammer,192,hunter,beastmastery,6,2,4
Softhunter,tichondrius,192,hunter,beastmastery,6,2,4
Smokiiganja,proudmoore,192,hunter,beastmastery,6,2,4
Aaggros,sargeras,192,hunter,beastmastery,6,2,4
Critaclyzm,moon-guard,192,hunter,beastmastery,6,2,4
Jumeog,stormscale,192,hunter,beastmastery,6,2,4
Fova,wyrmrest-accord,192,hunter,beastmastery,6,2,4
Zarknoth,cenarius,192,hunter,beastmastery,6,2,4
Sukr,korgath,192,hunter,beastmastery,6,2,4
Pressbro,tichondrius,192,hunter,beastmastery,6,2,4
Zellor,wyrmrest-accord,192,hunter,beastmastery,6,2,4
Sativ,moknathal,192,hunter,beastmastery,6,2,4
Capnjack,hyjal,192,hunter,beastmastery,6,2,4
Twocranes,tichondrius,192,hunter,beastmastery,6,2,4
Chømp,tichondrius,192,hunter,beastmastery,6,2,4
Nubcaks,nerzhul,192,hunter,beastmastery,6,2,4
Skolzero,azralon,192,hunter,beastmastery,6,2,4
Nanotorque,moon-guard,192,hunter,beastmastery,6,2,4
Flor,boulderfist,192,hunter,beastmastery,6,2,4
Garble,darkspear,192,hunter,beastmastery,6,2,4
Doves,wyrmrest-accord,192,hunter,beastmastery,6,2,4
Notoffended,sargeras,192,hunter,beastmastery,6,2,4
Pickshot,boulderfist,192,hunter,beastmastery,6,2,4
Mídnîght,azralon,192,hunter,beastmastery,6,2,4
Dynith,sargeras,192,hunter,beastmastery,6,2,4
Thugio,sargeras,192,hunter,beastmastery,6,2,4
Zaydenm,sargeras,192,hunter,beastmastery,6,2,4
Blickymon,wyrmrest-accord,192,hunter,beastmastery,6,2,4
Equalizér,sargeras,192,hunter,beastmastery,6,2,4
Expskippy,darkspear,192,hunter,beastmastery,6,2,4
Jbahh,hyjal,192,hunter,beastmastery,6,2,4
Cufless,proudmoore,192,hunter,beastmastery,6,2,4
Ganderion,sargeras,192,hunter,beastmastery,6,2,4
Illrannevian,garrosh,192,hunter,beastmastery,6,2,4
Ratbasterrd,darkspear,192,hunter,beastmastery,6,2,4
Nfo,lightbringer,192,hunter,beastmastery,6,2,4
Rhyzen,drenden,192,hunter,beastmastery,6,2,4
Budget,emerald-dream,192,hunter,beastmastery,6,2,4
Graatata,shandris,192,hunter,beastmastery,6,2,4
Jämmëdclïp,emerald-dream,192,hunter,beastmastery,6,2,4
Shootr,darkspear,192,hunter,beastmastery,6,2,4
Clütch,darkspear,192,hunter,beastmastery,6,2,4
Hötdôg,kiljaeden,192,hunter,beastmastery,6,2,4
Hìrcine,nesingwary,192,hunter,beastmastery,6,2,4
Seratoninx,malganis,192,hunter,beastmastery,9,2,7
Aeriladin,moon-guard,192,hunter,beastmastery,12,2,10
Gilonate,tichondrius,192,hunter,beastmastery,12,2,10
Thyladaern,kiljaeden,192,hunter,beastmastery,12,2,10
Tânsøxøxø,tichondrius,192,hunter,beastmastery,12,2,10
Lhax,stormrage,192,hunter,beastmastery,12,2,10
Arrowzpeckt,tichondrius,192,hunter,beastmastery,12,2,10
Meetdmonster,illidan,192,hunter,beastmastery,12,2,10
Tánsøxøxø,tichondrius,192,hunter,beastmastery,12,2,10
Bjj,eonar,192,hunter,beastmastery,12,2,10
Khabul,area-52,192,hunter,beastmastery,12,2,10
Carloslaun,drakkari,192,hunter,beastmastery,12,2,10
Ullr,gurubashi,192,hunter,beastmastery,12,2,10
Ijii,tichondrius,192,hunter,beastmastery,12,2,10
Sojun,jaedenar,192,hunter,beastmastery,14,2,12
Aiilton,gallywix,191,hunter,beastmastery,6,2,4
Tuvasa,blood-furnace,191,hunter,beastmastery,6,2,4
Kolarius,emerald-dream,191,hunter,beastmastery,6,2,4
Stoneforged,ragnaros,191,hunter,beastmastery,6,2,4
Recebaa,barthilas,191,hunter,beastmastery,6,2,4
Moapax,azralon,191,hunter,beastmastery,6,2,4
Enrage,queldorei,191,hunter,beastmastery,12,2,10
Drakarÿs,drakkari,191,hunter,beastmastery,12,2,10
Sagittarion,malfurion,190,hunter,beastmastery,7,3,4
Zock,lothar,160,hunter,beastmastery,10,2,8
Sleepywrld,area-52,159,hunter,beastmastery,5,2,3
Stèlla,frostmourne,159,hunter,beastmastery,5,2,3
Helikaon,deathwing,159,hunter,beastmastery,5,2,3
Tezlekhan,haomarush,159,hunter,beastmastery,5,2,3
Skrìms,tichondrius,159,hunter,beastmastery,5,2,3
Maximum,tichondrius,159,hunter,beastmastery,5,2,3
Lele,stormrage,138,hunter,beastmastery,8,4,4
Daréz,blackrock,138,hunter,beastmastery,8,3,5
Piñg,tichondrius,128,hunter,beastmastery,4,2,2
Beastmastr,garrosh,128,hunter,beastmastery,4,2,2
Popster,cenarius,128,hunter,beastmastery,4,2,2
Laviè,tichondrius,112,hunter,beastmastery,4,3,1
Opsi,ragnaros,96,hunter,beastmastery,6,1,5
Poonbaddy,kiljaeden,96,hunter,beastmastery,6,1,5
Panm,runetotem,96,hunter,beastmastery,6,1,5
Taurenseason,sargeras,96,hunter,beastmastery,6,1,5
Sõulhunter,frostmourne,96,hunter,beastmastery,6,1,5
Bithiáh,quelthalas,96,hunter,beastmastery,6,1,5
Wârhunt,frostmourne,96,hunter,beastmastery,6,1,5
Frenchhtoast,sargeras,96,hunter,beastmastery,6,1,5
Taumelz,sargeras,96,hunter,beastmastery,6,1,5
Muckenfoose,frostmourne,96,hunter,beastmastery,6,1,5
Warpedshots,malganis,96,hunter,beastmastery,6,1,5
Penelòpe,wyrmrest-accord,96,hunter,beastmastery,6,1,5
Dampteeth,sargeras,96,hunter,beastmastery,6,1,5
Xclaw,llane,96,hunter,beastmastery,6,1,5
Bigpie,daggerspine,96,hunter,beastmastery,6,1,5
Spitballa,emerald-dream,96,hunter,beastmastery,6,1,5
Baehydra,frostmourne,96,hunter,beastmastery,6,1,5
Auset,aegwynn,96,hunter,beastmastery,6,1,5
Marksmanpain,malganis,96,hunter,beastmastery,6,1,5
Wixyy,aegwynn,96,hunter,beastmastery,6,1,5
Speirs,tichondrius,96,hunter,beastmastery,6,1,5
Pampas,darkspear,96,hunter,beastmastery,6,1,5
Allgasnocap,kelthuzad,96,hunter,beastmastery,6,1,5
Appä,lightnings-blade,96,hunter,beastmastery,6,1,5
Slimetime,tichondrius,96,hunter,beastmastery,6,1,5
Varag,amanthul,96,hunter,beastmastery,6,1,5
Fadingtrapz,jubeithos,96,hunter,beastmastery,6,1,5
Sóggybóxers,tichondrius,96,hunter,beastmastery,6,1,5
Båttousai,kiljaeden,96,hunter,beastmastery,6,1,5
Rexxiga,kiljaeden,96,hunter,beastmastery,6,1,5
Carot,dalaran,96,hunter,beastmastery,6,1,5
Nearsightedd,area-52,96,hunter,beastmastery,6,1,5
Jootuber,barthilas,96,hunter,beastmastery,6,1,5
Globlauncher,tichondrius,96,hunter,beastmastery,6,1,5
Vencc,tichondrius,96,hunter,beastmastery,6,1,5
Henhøuse,illidan,96,hunter,beastmastery,6,1,5
Ilîiìîìiilil,bleeding-hollow,96,hunter,beastmastery,6,1,5
Jabbar,bleeding-hollow,96,hunter,beastmastery,6,1,5
Wamion,zuljin,96,hunter,beastmastery,6,1,5
Percival,firetree,96,hunter,beastmastery,6,1,5
Nimbioth,proudmoore,96,hunter,beastmastery,6,1,5
Bertiebott,zuljin,96,hunter,beastmastery,6,1,5
Murk,spirestone,96,hunter,beastmastery,6,1,5
Ghostone,sargeras,96,hunter,beastmastery,6,1,5
Foakus,zuljin,96,hunter,beastmastery,6,1,5
Birggitte,the-venture-co,96,hunter,beastmastery,6,1,5
Cynasia,maelstrom,96,hunter,beastmastery,6,1,5
Huntardness,moon-guard,96,hunter,beastmastery,6,1,5
Boido,ghostlands,96,hunter,beastmastery,6,1,5
Dusle,azralon,96,hunter,beastmastery,6,1,5
Sobala,azralon,96,hunter,beastmastery,6,1,5
Mtuanwm,tichondrius,96,hunter,beastmastery,6,1,5
Nachtcloverr,stormrage,96,hunter,beastmastery,6,1,5
Tybierious,illidan,96,hunter,beastmastery,6,1,5
Ãmi,moon-guard,96,hunter,beastmastery,6,1,5
Ballinpotato,tichondrius,96,hunter,beastmastery,6,1,5
Oldmandave,stormrage,96,hunter,beastmastery,6,1,5
Xcopel,azralon,96,hunter,beastmastery,6,1,5
Bellaphonte,stormrage,96,hunter,beastmastery,6,1,5
Physical,destromath,96,hunter,beastmastery,6,1,5
Espaada,tichondrius,96,hunter,beastmastery,6,1,5
Robious,tichondrius,96,hunter,beastmastery,6,1,5
Darkhunterr,tichondrius,96,hunter,beastmastery,6,1,5
Cocobread,stormreaver,96,hunter,beastmastery,6,1,5
Bosshunt,whisperwind,96,hunter,beastmastery,6,1,5
Jaboe,thrall,96,hunter,beastmastery,6,1,5
Boyarsky,area-52,96,hunter,beastmastery,6,1,5
Justin,agamaggan,96,hunter,beastmastery,6,1,5
Patcherson,kargath,96,hunter,beastmastery,6,1,5
Chosan,sargeras,96,hunter,beastmastery,6,1,5
Bendotexe,stormrage,96,hunter,beastmastery,7,1,6
Divineseraph,dentarg,96,hunter,beastmastery,12,1,11
Tydee,nagrand,96,hunter,beastmastery,12,1,11
Tinsho,drakkari,96,hunter,beastmastery,12,1,11
Kaitoo,tichondrius,96,hunter,beastmastery,12,1,11
Desoh,kelthuzad,96,hunter,beastmastery,12,1,11
Kölhberg,azralon,64,hunter,beastmastery,10,1,9
Jonyvi,stormrage,63,hunter,beastmastery,2,2,0
Triggamikê,tichondrius,63,hunter,beastmastery,2,2,0
Yory,tol-barad,48,hunter,beastmastery,3,1,2
Falsifier,ragnaros,48,hunter,beastmastery,3,1,2
Luckione,destromath,48,hunter,beastmastery,3,1,2
Memorypet,proudmoore,48,hunter,beastmastery,3,1,2
Bowjoblul,stormrage,42,hunter,beastmastery,9,2,7
Voladren,moon-guard,31,hunter,beastmastery,2,1,1
Khillin,destromath,31,hunter,beastmastery,2,1,1
Numbing,sargeras,2233,mage,arcane,100,54,46
Venruki,tichondrius,2137,mage,arcane,78,44,34
Cvark,sargeras,2123,mage,arcane,76,45,31
Ktp,tichondrius,2067,mage,arcane,72,42,30
Junglejape,tichondrius,1967,mage,arcane,54,35,19
Whiterice,zuljin,1879,mage,arcane,50,31,19
Bambambilly,kelthuzad,1864,mage,arcane,78,43,35
Bíscuít,illidan,1864,mage,arcane,139,76,63
Birdfather,tichondrius,1861,mage,arcane,48,33,15
Snortmeth,area-52,1841,mage,arcane,90,58,32
Vampìrelolz,tichondrius,1809,mage,arcane,48,26,22
Oneschool,sargeras,1781,mage,arcane,48,24,24
Juicemage,tichondrius,1779,mage,arcane,54,27,27
Elfmage,tichondrius,1777,mage,arcane,30,19,11
Hallat,archimonde,1775,mage,arcane,281,139,142
Mokelovin,sargeras,1757,mage,arcane,47,26,21
Ezchallenger,undermine,1751,mage,arcane,66,28,38
Lmaginedying,illidan,1715,mage,arcane,30,24,6
Delibro,tichondrius,1709,mage,arcane,46,27,19
Zps,illidan,1706,mage,arcane,72,40,32
Nyj,tichondrius,1695,mage,arcane,53,31,22
Clutchy,gorefiend,1672,mage,arcane,42,29,13
Ligmmah,stormrage,1672,mage,arcane,36,21,15
Maegwynah,jaedenar,1665,mage,arcane,40,20,20
Shwaysted,burning-blade,1657,mage,arcane,42,22,20
Tbkz,amanthul,1656,mage,arcane,42,20,22
Exterminatüs,tichondrius,1652,mage,arcane,81,41,40
Höövalt,illidan,1641,mage,arcane,30,20,10
Xialing,tichondrius,1631,mage,arcane,40,24,16
Magecombe,thrall,1617,mage,arcane,30,17,13
Arianark,sargeras,1616,mage,arcane,42,28,14
Dmgperseç,tichondrius,1612,mage,arcane,30,20,10
Proximalol,tichondrius,1610,mage,arcane,36,20,16
Lucidaze,daggerspine,1608,mage,arcane,116,61,55
Hööva,illidan,1604,mage,arcane,30,17,13
Rhythmdog,tichondrius,1603,mage,arcane,45,21,24
Primearcanis,tol-barad,1601,mage,arcane,48,22,26
Spitemage,tichondrius,1595,mage,arcane,73,32,41
Sestren,zuljin,1591,mage,arcane,73,34,39
Felsparkles,area-52,1589,mage,arcane,54,30,24
Agoniey,illidan,1572,mage,arcane,107,55,52
Dbox,stormscale,1570,mage,arcane,64,36,28
Ject,ragnaros,1557,mage,arcane,95,51,44
Clernlol,emerald-dream,1548,mage,arcane,60,27,33
Perrc,area-52,1546,mage,arcane,174,88,86
Zhanna,nazjatar,1535,mage,arcane,96,47,49
Prosperoh,burning-legion,1526,mage,arcane,48,25,23
Wretchy,ragnaros,1523,mage,arcane,42,25,17
Vênsêr,emerald-dream,1506,mage,arcane,30,16,14
Cyphen,proudmoore,1500,mage,arcane,30,16,14
Linkolni,azralon,1486,mage,arcane,99,54,45
Hennimage,sargeras,1485,mage,arcane,140,82,58
Hustle,frostmourne,1483,mage,arcane,102,53,49
Alode,moon-guard,1461,mage,arcane,30,19,11
Missile,frostmourne,1454,mage,arcane,36,17,19
Waisted,kelthuzad,1431,mage,arcane,27,17,10
Sáron,quelthalas,1412,mage,arcane,72,37,35
Somariais,illidan,1399,mage,arcane,42,20,22
Söngs,goldrinn,1387,mage,arcane,24,15,9
Wizzyx,illidan,1373,mage,arcane,40,21,19
Castarcane,nordrassil,1370,mage,arcane,36,17,19
Avandal,proudmoore,1362,mage,arcane,71,29,42
Valrendor,nazjatar,1359,mage,arcane,90,53,37
Melkdud,wyrmrest-accord,1341,mage,arcane,24,14,10
Themagicman,whisperwind,1324,mage,arcane,42,17,25
Coôler,illidan,1313,mage,arcane,39,16,23
Szrp,stormrage,1306,mage,arcane,51,23,28
Ruzam,area-52,1303,mage,arcane,180,88,92
Draell,drakkari,1301,mage,arcane,54,30,24
Véyda,emerald-dream,1300,mage,arcane,60,30,30
Airbnb,area-52,1299,mage,arcane,46,26,20
Kickpollyplx,lothar,1294,mage,arcane,24,15,9
Maplemage,akama,1293,mage,arcane,82,39,43
Chezzmasterx,misha,1289,mage,arcane,69,34,35
Jedamere,proudmoore,1260,mage,arcane,48,23,25
Strêss,kelthuzad,1255,mage,arcane,123,60,63
Skywalkerino,azralon,1250,mage,arcane,121,63,58
Lünå,onyxia,1247,mage,arcane,24,14,10
Hocusjokus,frostmourne,1246,mage,arcane,18,13,5
Gessin,area-52,1245,mage,arcane,100,50,50
Bananappeal,kelthuzad,1243,mage,arcane,30,13,17
Unlike,sargeras,1235,mage,arcane,71,29,42
Oharvestero,illidan,1234,mage,arcane,25,14,11
Antifreezex,tichondrius,1227,mage,arcane,41,25,16
Kevymarts,tichondrius,1210,mage,arcane,36,14,22
Greenwise,illidan,1170,mage,arcane,54,28,26
Gryd,area-52,1165,mage,arcane,84,44,40
Yonzho,area-52,1160,mage,arcane,20,13,7
Fearhades,drakkari,1159,mage,arcane,24,13,11
Magnesiium,illidan,1148,mage,arcane,22,13,9
Frozonnee,aggramar,1145,mage,arcane,18,12,6
Thewizârd,stormrage,1145,mage,arcane,210,107,103
Allýria,stormrage,1138,mage,arcane,30,12,18
Firehawk,azralon,1129,mage,arcane,23,14,9
Cokézero,frostmourne,1128,mage,arcane,49,24,25
Chëryl,proudmoore,1119,mage,arcane,94,40,54
Badwoman,tichondrius,1111,mage,arcane,36,13,23
Kittikk,tichondrius,1098,mage,arcane,101,47,54
Oyagi,moon-guard,1097,mage,arcane,89,42,47
Gin,nemesis,1091,mage,arcane,30,12,18
Cassanara,moon-guard,1090,mage,arcane,30,13,17
Dereliction,nagrand,1087,mage,arcane,48,22,26
Spart,runetotem,1087,mage,arcane,27,12,15
Klausgc,sargeras,1084,mage,arcane,20,12,8
Holbrook,greymane,1081,mage,arcane,48,17,31
Arcanemagek,tichondrius,1056,mage,arcane,12,11,1
Spellsteål,malganis,1055,mage,arcane,12,11,1
Flaux,sargeras,1055,mage,arcane,18,11,7
Dawitchery,illidan,1055,mage,arcane,24,11,13
Tommagic,tichondrius,1055,mage,arcane,30,11,19
Wïzarduous,mannoroth,1053,mage,arcane,18,11,7
Enthy,frostmourne,1052,mage,arcane,24,11,13
Shmage,dragonmaw,1050,mage,arcane,18,11,7
Astrojrue,sargeras,1049,mage,arcane,23,11,12
Tsarevich,fizzcrank,1039,mage,arcane,42,18,24
Smoks,stormrage,973,mage,arcane,26,12,14
Raeign,frostmourne,972,mage,arcane,141,67,74
Nightsaber,blackrock,960,mage,arcane,12,10,2
Windwìtch,quelthalas,960,mage,arcane,18,10,8
Zerathremar,proudmoore,958,mage,arcane,18,10,8
Balencii,kiljaeden,957,mage,arcane,18,10,8
Haze,hyjal,955,mage,arcane,18,10,8
Tagere,moon-guard,954,mage,arcane,24,10,14
Orderlight,alexstrasza,954,mage,arcane,24,10,14
Wizfajita,malganis,951,mage,arcane,24,10,14
Morkleen,korgath,943,mage,arcane,30,10,20
Shadows,exodar,934,mage,arcane,24,10,14
Akagamix,sargeras,917,mage,arcane,30,14,16
Dietdeww,borean-tundra,913,mage,arcane,18,10,8
Khierlana,hellscream,903,mage,arcane,66,27,39
Mastablastar,windrunner,899,mage,arcane,23,10,13
Jazzgroyper,sargeras,864,mage,arcane,18,9,9
Gachaguy,bleeding-hollow,864,mage,arcane,18,9,9
Viôlentj,area-52,863,mage,arcane,12,9,3
Arcalìte,illidan,863,mage,arcane,15,10,5
Pandazed,proudmoore,863,mage,arcane,18,9,9
Edisia,moon-guard,862,mage,arcane,18,9,9
Sherian,queldorei,832,mage,arcane,18,9,9
Drainbamage,coilfang,810,mage,arcane,54,10,44
Jackson,altar-of-storms,809,mage,arcane,60,17,43
Kirayu,gilneas,798,mage,arcane,16,9,7
Jööz,deathwing,768,mage,arcane,18,8,10
Eludin,aegwynn,768,mage,arcane,18,8,10
Crøwgawd,tichondrius,767,mage,arcane,12,8,4
Watchmepog,tichondrius,767,mage,arcane,12,8,4
Badboykilla,dentarg,767,mage,arcane,12,8,4
Fakebusiness,area-52,767,mage,arcane,18,8,10
Boredmoomoo,thunderlord,765,mage,arcane,12,8,4
Archtype,azralon,764,mage,arcane,24,8,16
Sceledrus,quelthalas,760,mage,arcane,18,8,10
Aycc,tichondrius,735,mage,arcane,17,8,9
Failedwizard,frostmourne,714,mage,arcane,34,10,24
Perkaset,turalyon,703,mage,arcane,17,8,9
Rof,sargeras,672,mage,arcane,12,7,5
Valériemeow,tichondrius,672,mage,arcane,18,7,11
Zezima,spirestone,671,mage,arcane,12,7,5
Murr,boulderfist,671,mage,arcane,12,7,5
Ankidar,quelthalas,671,mage,arcane,18,7,11
Warthormage,stormrage,670,mage,arcane,12,7,5
Austere,boulderfist,670,mage,arcane,12,7,5
Derkrìeger,turalyon,670,mage,arcane,18,7,11
Zimzum,bladefist,666,mage,arcane,12,7,5
Søkø,tichondrius,660,mage,arcane,18,7,11
Karamzov,zuljin,652,mage,arcane,18,7,11
Softbody,barthilas,634,mage,arcane,27,7,20
Arcanochillz,ghostlands,606,mage,arcane,20,7,13
Zukoprince,azralon,576,mage,arcane,6,6,0
Aeghis,stormrage,576,mage,arcane,12,6,6
Astroner,frostmourne,576,mage,arcane,12,6,6
Swàn,stormrage,576,mage,arcane,12,6,6
Fryry,dalaran,576,mage,arcane,12,6,6
Harshx,bleeding-hollow,576,mage,arcane,12,6,6
Nazmagus,hydraxis,576,mage,arcane,18,6,12
Moond,drakkari,575,mage,arcane,12,6,6
Zayth,silvermoon,575,mage,arcane,12,6,6
Mageyoulooks,kelthuzad,575,mage,arcane,18,6,12
Bobalama,tichondrius,573,mage,arcane,24,6,18
Waef,quelthalas,571,mage,arcane,12,6,6
Enfuegoe,tichondrius,571,mage,arcane,12,6,6
Instataterz,eonar,557,mage,arcane,23,6,17
Esien,tichondrius,522,mage,arcane,20,7,13
Unmix,tichondrius,510,mage,arcane,14,6,8
Skillsbro,arthas,480,mage,arcane,6,5,1
Zeró,frostmourne,480,mage,arcane,6,5,1
Maxtorgar,quelthalas,480,mage,arcane,12,5,7
Étel,nemesis,480,mage,arcane,12,5,7
Zulugara,barthilas,480,mage,arcane,12,5,7
Beerbelly,tichondrius,480,mage,arcane,12,5,7
Shäräpova,zuljin,480,mage,arcane,12,5,7
Hansol,farstriders,480,mage,arcane,12,5,7
Cicciozi,sargeras,480,mage,arcane,12,5,7
Diamondx,ragnaros,480,mage,arcane,12,5,7
Wauzcrol,quelthalas,480,mage,arcane,12,5,7
Dagreatone,malganis,480,mage,arcane,12,5,7
Hogdog,illidan,480,mage,arcane,18,5,13
Kosiris,tichondrius,480,mage,arcane,18,5,13
Humpadumplin,wyrmrest-accord,478,mage,arcane,24,5,19
Merlon,dalaran,476,mage,arcane,12,5,7
Larouse,quelthalas,415,mage,arcane,8,5,3
Noescaping,illidan,400,mage,arcane,13,5,8
Garrieto,sargeras,384,mage,arcane,6,4,2
Wanming,tichondrius,384,mage,arcane,6,4,2
Cinnamon,boulderfist,384,mage,arcane,6,4,2
Parapio,tichondrius,384,mage,arcane,6,4,2
Tuggernaug,malganis,384,mage,arcane,6,4,2
Jordèb,sargeras,384,mage,arcane,6,4,2
Blaxmagic,stormrage,384,mage,arcane,6,4,2
Fredcouples,tichondrius,384,mage,arcane,6,4,2
Chilléd,tichondrius,384,mage,arcane,6,4,2
Dogmagetw,tichondrius,384,mage,arcane,6,4,2
Lightsoran,tichondrius,384,mage,arcane,6,4,2
Hasteboy,kelthuzad,384,mage,arcane,6,4,2
Sausage,boulderfist,384,mage,arcane,6,4,2
Lavaera,illidan,384,mage,arcane,6,4,2
Skoals,thrall,384,mage,arcane,6,4,2
Imbusting,kiljaeden,384,mage,arcane,6,4,2
Magicos,frostmourne,384,mage,arcane,6,4,2
Cømbust,frostmourne,384,mage,arcane,6,4,2
Billzeye,dalaran,384,mage,arcane,12,4,8
Hogslop,saurfang,384,mage,arcane,12,4,8
Forestella,tichondrius,384,mage,arcane,12,4,8
Scxut,tichondrius,384,mage,arcane,12,4,8
Khaldyn,tichondrius,384,mage,arcane,12,4,8
Bigbuttangel,borean-tundra,384,mage,arcane,12,4,8
Nedrin,nemesis,384,mage,arcane,12,4,8
Biotic,kiljaeden,384,mage,arcane,12,4,8
Delana,darkspear,384,mage,arcane,12,4,8
Nesomage,destromath,384,mage,arcane,12,4,8
Thetodd,emerald-dream,382,mage,arcane,6,4,2
Preckwinkle,moon-guard,382,mage,arcane,12,4,8
Moogician,aerie-peak,304,mage,arcane,7,4,3
Ærtai,black-dragonflight,304,mage,arcane,7,4,3
Xythros,stormrage,288,mage,arcane,6,3,3
Adrazell,sargeras,288,mage,arcane,6,3,3
Christensen,stormrage,288,mage,arcane,6,3,3
Bobbyyx,sargeras,288,mage,arcane,6,3,3
Pwnstarx,proudmoore,288,mage,arcane,6,3,3
Madpoondog,frostmourne,288,mage,arcane,6,3,3
Myrondor,tichondrius,288,mage,arcane,6,3,3
Sazza,tichondrius,288,mage,arcane,6,3,3
Zerodium,sargeras,288,mage,arcane,6,3,3
Neverbroke,illidan,288,mage,arcane,6,3,3
Milfmaster,aerie-peak,288,mage,arcane,6,3,3
Koro,tichondrius,288,mage,arcane,6,3,3
Unknownblast,kul-tiras,288,mage,arcane,6,3,3
Xzude,korgath,288,mage,arcane,6,3,3
Watchmesleep,tichondrius,288,mage,arcane,6,3,3
Snoogma,illidan,288,mage,arcane,6,3,3
Jizzlez,tichondrius,288,mage,arcane,6,3,3
Natzue,sargeras,288,mage,arcane,6,3,3
Kogin,thrall,288,mage,arcane,6,3,3
Elux,whisperwind,288,mage,arcane,12,3,9
Heflash,azralon,288,mage,arcane,12,3,9
Arçanemage,tichondrius,288,mage,arcane,12,3,9
Fasttwitch,kiljaeden,288,mage,arcane,12,3,9
Toknsmoke,tichondrius,288,mage,arcane,12,3,9
Matmagic,drakkari,288,mage,arcane,13,3,10
Kryptekk,area-52,287,mage,arcane,6,3,3
Calcaster,aegwynn,287,mage,arcane,6,3,3
Ìgnìtìöñ,whisperwind,287,mage,arcane,12,3,9
Grarg,stormrage,286,mage,arcane,6,3,3
Prosperoo,aerie-peak,286,mage,arcane,6,3,3
Culours,stormrage,286,mage,arcane,6,3,3
Arcanin,thunderlord,285,mage,arcane,12,3,9
Etyx,tichondrius,239,mage,arcane,5,3,2
Røcco,azralon,192,mage,arcane,4,3,1
Xpez,stormrage,192,mage,arcane,6,2,4
Barbarabush,hellscream,192,mage,arcane,6,2,4
Opiumlord,tichondrius,192,mage,arcane,6,2,4
Nekrobear,nemesis,192,mage,arcane,6,2,4
Pullmefingy,illidan,192,mage,arcane,6,2,4
Chinkins,illidan,192,mage,arcane,6,2,4
Crinkit,frostmourne,192,mage,arcane,6,2,4
Icebish,skullcrusher,192,mage,arcane,6,2,4
Sheepshot,dentarg,192,mage,arcane,6,2,4
Xunalatu,frostmourne,192,mage,arcane,6,2,4
Akunimon,ragnaros,192,mage,arcane,6,2,4
Ferdabombs,tichondrius,192,mage,arcane,6,2,4
Celciius,stormrage,192,mage,arcane,6,2,4
Mymaage,andorhal,192,mage,arcane,6,2,4
Vengx,tichondrius,192,mage,arcane,6,2,4
Burna,amanthul,192,mage,arcane,6,2,4
Umber,dreadmaul,192,mage,arcane,6,2,4
Emden,khadgar,192,mage,arcane,6,2,4
Mershon,tichondrius,192,mage,arcane,6,2,4
Blastgodx,stormrage,192,mage,arcane,6,2,4
Caimil,echo-isles,192,mage,arcane,6,2,4
Vensyr,stormrage,192,mage,arcane,6,2,4
Frostecho,moon-guard,192,mage,arcane,6,2,4
Alìv,tichondrius,192,mage,arcane,6,2,4
Sweetypie,fenris,192,mage,arcane,6,2,4
Duffs,hyjal,192,mage,arcane,6,2,4
Highafrn,area-52,192,mage,arcane,6,2,4
Fakelovè,area-52,192,mage,arcane,6,2,4
Granmago,azralon,192,mage,arcane,6,2,4
Shimmerpoly,sargeras,192,mage,arcane,6,2,4
Gatka,quelthalas,192,mage,arcane,12,2,10
Compactor,emerald-dream,192,mage,arcane,12,2,10
Baskal,area-52,192,mage,arcane,12,2,10
Mcshwackin,area-52,192,mage,arcane,12,2,10
Vires,kelthuzad,159,mage,arcane,5,2,3
Purpledrank,nagrand,96,mage,arcane,9,2,7
Ignit,stormrage,96,mage,arcane,6,1,5
Octané,illidan,96,mage,arcane,6,1,5
Cubanarox,gallywix,96,mage,arcane,6,1,5
Hvnlyfathr,stormrage,96,mage,arcane,6,1,5
Nazztwren,bleeding-hollow,96,mage,arcane,6,1,5
Gôøglëlòl,nemesis,96,mage,arcane,6,1,5
Burrbon,area-52,96,mage,arcane,6,1,5
Nachtt,sargeras,96,mage,arcane,6,1,5
Lacouet,lightnings-blade,96,mage,arcane,6,1,5
Smôl,emerald-dream,96,mage,arcane,6,1,5
Xlordpagan,sargeras,96,mage,arcane,6,1,5
Coldrin,tichondrius,96,mage,arcane,6,1,5
Mageki,ragnaros,96,mage,arcane,6,1,5
Frozorfs,tichondrius,96,mage,arcane,6,1,5
Krazsus,tichondrius,96,mage,arcane,6,1,5
Flomin,tichondrius,96,mage,arcane,6,1,5
Singheart,tichondrius,96,mage,arcane,6,1,5
Telkham,tichondrius,96,mage,arcane,6,1,5
Needmyvape,moon-guard,96,mage,arcane,6,1,5
Pollybot,tichondrius,96,mage,arcane,6,1,5
Illúmi,moon-guard,96,mage,arcane,6,1,5
Trippy,senjin,96,mage,arcane,6,1,5
Quinnfreeze,boulderfist,96,mage,arcane,6,1,5
Darthez,darkspear,96,mage,arcane,6,1,5
Greaterbust,tichondrius,96,mage,arcane,12,1,11
Poofnpass,malorne,95,mage,arcane,6,1,5
Kralien,dalaran,95,mage,arcane,6,1,5
Frostmaul,dreadmaul,79,mage,arcane,11,1,10
Keepinitnoob,tichondrius,63,mage,arcane,2,2,0
Privilege,dragonmaw,31,mage,arcane,8,1,7
Setback,illidan,2122,mage,fire,138,69,69
Hansol,farstriders,2120,mage,fire,84,42,42
Valériemeow,tichondrius,2097,mage,fire,115,57,58
Taylorlol,tichondrius,2092,mage,fire,104,51,53
Talibandzx,sargeras,2042,mage,fire,159,77,82
Asetback,illidan,2035,mage,fire,120,58,62
Horoba,sargeras,2011,mage,fire,186,90,96
Adjudicatory,tichondrius,2003,mage,fire,69,34,35
Gohonn,emerald-dream,1992,mage,fire,114,68,46
Kasperkar,illidan,1991,mage,fire,239,121,118
Vcamusorz,tichondrius,1969,mage,fire,160,84,76
Aeghis,stormrage,1958,mage,fire,48,26,22
Bigfirebat,tichondrius,1957,mage,fire,84,42,42
Icetomeetyu,bleeding-hollow,1956,mage,fire,130,68,62
Dáddyshark,sargeras,1937,mage,fire,109,51,58
Xiaoxiaochu,tichondrius,1929,mage,fire,146,88,58
Starxen,tichondrius,1915,mage,fire,54,31,23
Poundcakezx,tichondrius,1905,mage,fire,54,28,26
Vazlgs,tichondrius,1902,mage,fire,72,42,30
Peachygamer,stormscale,1891,mage,fire,174,86,88
Yaya,kargath,1883,mage,fire,99,51,48
Udmx,zuljin,1871,mage,fire,73,42,31
Nightsaber,blackrock,1869,mage,fire,42,26,16
Benisp,stormrage,1866,mage,fire,56,28,28
Sorcerous,bloodhoof,1862,mage,fire,129,78,51
Ròÿ,area-52,1861,mage,fire,72,37,35
Csx,turalyon,1857,mage,fire,120,68,52
Purpscurp,illidan,1850,mage,fire,76,45,31
Ksmackm,illidan,1842,mage,fire,65,34,31
Undeadmerlin,zuljin,1834,mage,fire,54,30,24
Rmxd,malganis,1833,mage,fire,90,46,44
Vampìrelolz,tichondrius,1828,mage,fire,47,25,22
Cinnablast,darkspear,1824,mage,fire,26,20,6
Degen,laughing-skull,1824,mage,fire,34,25,9
Fwooshinator,malganis,1823,mage,fire,71,56,15
Såni,tichondrius,1819,mage,fire,67,39,28
Zoryack,azralon,1816,mage,fire,72,39,33
Notini,azralon,1813,mage,fire,96,46,50
Háté,ragnaros,1805,mage,fire,72,31,41
Juju,tichondrius,1796,mage,fire,75,44,31
Kyphosis,illidan,1774,mage,fire,42,24,18
Younghehe,tichondrius,1771,mage,fire,136,74,62
Volkazar,sargeras,1766,mage,fire,39,21,18
Käxs,ragnaros,1762,mage,fire,42,21,21
Getmaged,bleeding-hollow,1749,mage,fire,40,26,14
Kraxos,stormrage,1737,mage,fire,78,44,34
Yorgøs,ragnaros,1736,mage,fire,60,31,29
Highms,stormrage,1727,mage,fire,54,28,26
Stergenutfr,tichondrius,1720,mage,fire,42,27,15
Creaystar,area-52,1714,mage,fire,149,74,75
Ranj,tichondrius,1713,mage,fire,55,25,30
Opisop,kelthuzad,1707,mage,fire,48,24,24
Snoogma,illidan,1702,mage,fire,35,25,10
Mângo,frostmourne,1699,mage,fire,24,18,6
Likebutter,tichondrius,1695,mage,fire,30,22,8
Dagreatone,malganis,1687,mage,fire,46,24,22
Ööf,emerald-dream,1675,mage,fire,54,26,28
Nickioxox,tichondrius,1674,mage,fire,24,18,6
Bighot,tichondrius,1673,mage,fire,90,53,37
Tuniepop,sargeras,1666,mage,fire,83,42,41
Wanming,tichondrius,1662,mage,fire,36,23,13
Firewreckage,malganis,1655,mage,fire,48,24,24
Daddymayhem,proudmoore,1653,mage,fire,54,24,30
Itshug,area-52,1652,mage,fire,53,27,26
Thxo,hyjal,1651,mage,fire,75,36,39
Lycheeoolong,frostmourne,1649,mage,fire,38,22,16
Pootysmooch,sargeras,1639,mage,fire,54,33,21
Rockoe,tichondrius,1630,mage,fire,76,44,32
Trippy,senjin,1630,mage,fire,60,30,30
Varroc,quelthalas,1626,mage,fire,106,48,58
Enthy,frostmourne,1623,mage,fire,60,30,30
Dexpy,tichondrius,1619,mage,fire,37,20,17
Ligmmah,stormrage,1615,mage,fire,42,25,17
Myrondor,tichondrius,1611,mage,fire,78,43,35
Muztaccio,tichondrius,1611,mage,fire,47,25,22
Chainpoly,area-52,1609,mage,fire,37,25,12
Magicmaghar,area-52,1607,mage,fire,30,19,11
Fruitdealerr,tichondrius,1607,mage,fire,48,29,19
Englavian,frostmane,1607,mage,fire,42,21,21
Torched,stormreaver,1605,mage,fire,42,21,21
Zarkanis,tichondrius,1604,mage,fire,49,25,24
Wizarts,ragnaros,1602,mage,fire,42,20,22
Mushys,stormrage,1601,mage,fire,35,22,13
Ârcano,ragnaros,1601,mage,fire,47,25,22
Jardz,area-52,1597,mage,fire,42,21,21
Sakurai,tichondrius,1593,mage,fire,48,28,20
Kev,sentinels,1589,mage,fire,96,53,43
Iceward,frostmourne,1583,mage,fire,54,24,30
Pzaz,moon-guard,1582,mage,fire,50,30,20
Sandylove,zuljin,1582,mage,fire,36,17,19
Hpthewizard,deathwing,1579,mage,fire,89,52,37
Formi,frostmourne,1577,mage,fire,36,19,17
Alenikus,blackhand,1575,mage,fire,56,26,30
Garbagemage,barthilas,1572,mage,fire,78,41,37
Ultrá,stormscale,1561,mage,fire,66,41,25
Murcury,tichondrius,1556,mage,fire,156,80,76
Marrioo,tichondrius,1555,mage,fire,42,22,20
Wickymorph,barthilas,1549,mage,fire,53,25,28
Wotl,tichondrius,1546,mage,fire,121,61,60
Trolson,sargeras,1546,mage,fire,54,26,28
Lilbabyx,stormrage,1538,mage,fire,68,36,32
Xs,stormrage,1534,mage,fire,120,67,53
Djpolymorph,stormrage,1530,mage,fire,88,49,39
Teetems,sargeras,1530,mage,fire,116,59,57
Squantanimo,shadowmoon,1527,mage,fire,53,26,27
Magekylex,proudmoore,1522,mage,fire,99,58,41
Biscobush,turalyon,1519,mage,fire,30,18,12
Crazytime,tichondrius,1519,mage,fire,42,23,19
Dropdeadlol,bonechewer,1517,mage,fire,30,17,13
Fookz,malganis,1515,mage,fire,60,32,28
Imannoyingha,darkspear,1510,mage,fire,71,37,34
Dârkus,sargeras,1509,mage,fire,71,35,36
Mager,dentarg,1508,mage,fire,62,40,22
Oi,frostwolf,1498,mage,fire,51,31,20
Audacy,sargeras,1496,mage,fire,132,64,68
Pòlly,illidan,1495,mage,fire,42,25,17
Fifthelëment,emerald-dream,1493,mage,fire,64,36,28
Eazzybaby,eredar,1490,mage,fire,377,198,179
Singheart,tichondrius,1490,mage,fire,132,66,66
Mariomario,tichondrius,1488,mage,fire,48,29,19
Gigatuts,stormrage,1487,mage,fire,30,16,14
Beerandmagic,zuljin,1487,mage,fire,30,16,14
Coolhandz,tichondrius,1487,mage,fire,47,24,23
Grynthwzrd,stormrage,1484,mage,fire,42,24,18
Worldonfire,ragnaros,1482,mage,fire,124,63,61
Coneofkony,bleeding-hollow,1477,mage,fire,24,16,8
Jojomage,thrall,1473,mage,fire,138,71,67
Chickenspank,stormrage,1473,mage,fire,36,18,18
Nazmagus,hydraxis,1472,mage,fire,69,39,30
Pyroshima,barthilas,1464,mage,fire,83,39,44
Smallbrainz,emerald-dream,1462,mage,fire,60,34,26
Frostpimp,anubarak,1460,mage,fire,60,22,38
Pyroflinger,stormrage,1453,mage,fire,90,46,44
Sparklepoof,tichondrius,1449,mage,fire,29,17,12
Bettybonk,cenarius,1449,mage,fire,42,20,22
Xanthan,runetotem,1437,mage,fire,39,21,18
Lolololololo,kelthuzad,1435,mage,fire,162,79,83
Swaglo,illidan,1435,mage,fire,40,18,22
Ålmøst,tichondrius,1433,mage,fire,59,34,25
Juul,emerald-dream,1426,mage,fire,60,27,33
Øzmage,area-52,1416,mage,fire,21,16,5
Anàrchy,emerald-dream,1411,mage,fire,39,21,18
Purpledrank,nagrand,1411,mage,fire,67,31,36
Eekzlol,illidan,1409,mage,fire,30,16,14
Toastedoats,hyjal,1408,mage,fire,55,28,27
Dreadparadox,bleeding-hollow,1405,mage,fire,34,16,18
Yooyar,barthilas,1403,mage,fire,104,46,58
Whiteyx,saurfang,1399,mage,fire,52,29,23
Leonr,tichondrius,1397,mage,fire,47,27,20
Ruzam,area-52,1394,mage,fire,66,31,35
Jundead,dalaran,1393,mage,fire,79,46,33
Hööva,illidan,1392,mage,fire,71,35,36
Jizzlez,tichondrius,1392,mage,fire,48,23,25
Coôler,illidan,1388,mage,fire,84,40,44
Elwyn,dunemaul,1387,mage,fire,54,27,27
Sydrol,area-52,1384,mage,fire,72,37,35
Leaso,tichondrius,1384,mage,fire,45,22,23
Wïzarduous,mannoroth,1380,mage,fire,30,17,13
Neglect,moknathal,1375,mage,fire,30,16,14
Ferdabombs,tichondrius,1373,mage,fire,48,26,22
Mageonthc,korgath,1368,mage,fire,23,15,8
Rudeswizard,area-52,1368,mage,fire,43,20,23
Melkra,tichondrius,1367,mage,fire,46,23,23
Coltrip,azralon,1359,mage,fire,83,38,45
Skoffla,executus,1354,mage,fire,36,17,19
Jööz,deathwing,1354,mage,fire,33,15,18
Marajaade,tichondrius,1346,mage,fire,74,33,41
Badaszbich,tichondrius,1344,mage,fire,36,20,16
Sikeyzlol,bleeding-hollow,1343,mage,fire,24,14,10
Sorankim,tichondrius,1343,mage,fire,30,14,16
Pinkmagetko,tichondrius,1338,mage,fire,30,14,16
Snanth,black-dragonflight,1337,mage,fire,33,18,15
Búrsting,kelthuzad,1335,mage,fire,24,14,10
Dearasian,ragnaros,1335,mage,fire,60,32,28
Adrazell,sargeras,1333,mage,fire,42,21,21
Gødvana,frostmourne,1331,mage,fire,30,18,12
Banquetmeal,emerald-dream,1330,mage,fire,24,14,10
Anuub,kelthuzad,1320,mage,fire,24,14,10
Holbrook,greymane,1316,mage,fire,49,24,25
Quizzard,blackrock,1310,mage,fire,28,15,13
Raynark,nemesis,1307,mage,fire,30,18,12
Jjijuns,tichondrius,1302,mage,fire,40,18,22
Waffles,ravencrest,1297,mage,fire,56,26,30
Carnelius,bleeding-hollow,1292,mage,fire,63,32,31
Adronicus,tichondrius,1287,mage,fire,60,31,29
Smigui,azralon,1284,mage,fire,146,69,77
Hypernova,vashj,1277,mage,fire,41,19,22
Abzy,sargeras,1264,mage,fire,60,29,31
Helcarwen,area-52,1261,mage,fire,60,30,30
Christjan,tichondrius,1260,mage,fire,138,72,66
Zulugara,barthilas,1258,mage,fire,36,19,17
Reddfire,proudmoore,1253,mage,fire,42,15,27
Mirimida,ragnaros,1251,mage,fire,61,31,30
Alzagen,ragnaros,1249,mage,fire,38,17,21
Babysharky,uther,1249,mage,fire,34,14,20
Tweydey,tichondrius,1247,mage,fire,18,13,5
Charkoalzz,moon-guard,1246,mage,fire,24,13,11
Deepgodsz,azralon,1243,mage,fire,24,13,11
Feogato,proudmoore,1237,mage,fire,60,29,31
Politeness,tichondrius,1233,mage,fire,24,13,11
Mongomike,stormrage,1231,mage,fire,51,21,30
Slumpgodd,frostmourne,1230,mage,fire,30,13,17
Gadgítte,moon-guard,1229,mage,fire,24,13,11
Fíery,blades-edge,1227,mage,fire,60,27,33
Prinseza,quelthalas,1226,mage,fire,29,14,15
Dragonie,nordrassil,1224,mage,fire,45,23,22
Zinnos,tichondrius,1218,mage,fire,30,13,17
Archtype,azralon,1217,mage,fire,18,13,5
Genthruz,ragnaros,1215,mage,fire,48,22,26
Sorrenton,sargeras,1197,mage,fire,24,15,9
Dorkski,bleeding-hollow,1190,mage,fire,67,27,40
Burist,illidan,1185,mage,fire,38,19,19
Esfire,frostmourne,1185,mage,fire,48,23,25
Saladguy,thrall,1181,mage,fire,30,13,17
Zonmague,drakkari,1177,mage,fire,36,17,19
Tamarolfrost,illidan,1158,mage,fire,19,13,6
Gradmage,proudmoore,1156,mage,fire,50,20,30
Maxvila,kelthuzad,1152,mage,fire,18,12,6
Snaregodx,area-52,1151,mage,fire,18,12,6
Farragan,ragnaros,1151,mage,fire,24,12,12
Sunskim,tichondrius,1151,mage,fire,24,12,12
Kjuuler,moon-guard,1151,mage,fire,24,12,12
Dmgdaddy,zuljin,1150,mage,fire,30,12,18
Frostymart,arthas,1149,mage,fire,18,12,6
Rhykx,malganis,1149,mage,fire,18,12,6
Grymorum,ragnaros,1141,mage,fire,30,12,18
Fleët,tichondrius,1139,mage,fire,18,12,6
Hositonet,malganis,1136,mage,fire,45,22,23
Gnarwallx,stormrage,1132,mage,fire,30,12,18
Wawakun,ragnaros,1127,mage,fire,30,14,16
Xzilence,aerie-peak,1118,mage,fire,30,12,18
Sánzunokawa,quelthalas,1109,mage,fire,27,16,11
Noescaping,illidan,1102,mage,fire,24,12,12
Gempette,tichondrius,1095,mage,fire,23,12,11
Wazzerd,moon-guard,1093,mage,fire,27,12,15
Guccilaflur,proudmoore,1082,mage,fire,27,12,15
Crnomage,area-52,1081,mage,fire,23,12,11
Lightsoran,tichondrius,1055,mage,fire,18,11,7
Alorae,wyrmrest-accord,1054,mage,fire,18,11,7
Albbano,tichondrius,1054,mage,fire,18,11,7
Avicci,shattered-halls,1054,mage,fire,30,11,19
Streetember,nemesis,1053,mage,fire,24,11,13
Magibe,thrall,1052,mage,fire,18,11,7
Cinns,moon-guard,1051,mage,fire,24,11,13
Radakos,emerald-dream,1050,mage,fire,24,11,13
Harlloo,the-underbog,1049,mage,fire,24,11,13
Kryptekk,area-52,1048,mage,fire,24,11,13
Garungar,antonidas,1045,mage,fire,18,11,7
Erlendr,moon-guard,1041,mage,fire,44,22,22
Flame,arthas,1028,mage,fire,30,11,19
Strêss,kelthuzad,1020,mage,fire,20,12,8
Asönia,illidan,1020,mage,fire,30,11,19
Bobalama,tichondrius,1012,mage,fire,54,19,35
Magalí,nemesis,1009,mage,fire,24,11,13
Hotjazzfarts,sargeras,1003,mage,fire,61,35,26
Grandpapi,arthas,997,mage,fire,23,11,12
Coldblooded,zuljin,991,mage,fire,41,14,27
Bàttlemage,nagrand,982,mage,fire,36,21,15
Endmepls,ysera,965,mage,fire,96,40,56
Skaq,tichondrius,960,mage,fire,12,10,2
Squidio,stormrage,959,mage,fire,18,10,8
Mokelovin,sargeras,959,mage,fire,18,10,8
Mudohir,stormrage,959,mage,fire,18,10,8
Zakume,stormrage,958,mage,fire,18,10,8
Iguanodon,proudmoore,957,mage,fire,26,11,15
Osh,malorne,957,mage,fire,24,10,14
Preceptør,azralon,957,mage,fire,24,10,14
Sahala,frostmourne,955,mage,fire,24,10,14
Dårks,area-52,955,mage,fire,24,10,14
Ripburn,stormrage,953,mage,fire,47,20,27
Snuurf,ragnaros,953,mage,fire,24,10,14
Etyx,tichondrius,953,mage,fire,30,10,20
Flavaflame,mugthol,952,mage,fire,18,10,8
Hýdro,ghostlands,951,mage,fire,30,16,14
Clapsyou,illidan,951,mage,fire,24,10,14
Christensen,stormrage,948,mage,fire,18,10,8
Abstractgoat,tichondrius,946,mage,fire,30,15,15
Vamkari,ragnaros,942,mage,fire,18,10,8
Sasghengis,frostmourne,930,mage,fire,18,10,8
Coldarei,nagrand,928,mage,fire,27,12,15
Dojacute,frostmourne,910,mage,fire,17,10,7
Isoicast,moon-guard,909,mage,fire,17,10,7
Coldrin,tichondrius,897,mage,fire,28,11,17
Alywgard,sargeras,894,mage,fire,22,10,12
Alaramaria,sargeras,886,mage,fire,18,10,8
Ops,frostmourne,881,mage,fire,27,13,14
Senegau,azralon,877,mage,fire,45,19,26
Zstyle,frostmourne,875,mage,fire,13,10,3
Ddouble,tichondrius,863,mage,fire,18,9,9
Dabsx,moon-guard,863,mage,fire,18,9,9
Snoü,proudmoore,863,mage,fire,24,9,15
Shimmerpoly,sargeras,863,mage,fire,24,9,15
Desfunz,mugthol,862,mage,fire,18,9,9
Fryry,dalaran,860,mage,fire,24,9,15
Baelthezer,moon-guard,858,mage,fire,21,12,9
Halfsquad,malfurion,858,mage,fire,18,9,9
Product,mugthol,858,mage,fire,18,9,9
Freez,garona,858,mage,fire,21,10,11
Gadalka,frostmourne,857,mage,fire,18,9,9
Othokk,tichondrius,852,mage,fire,24,9,15
Arcanemain,kargath,845,mage,fire,36,16,20
Dánó,lightbringer,843,mage,fire,62,26,36
Umber,dreadmaul,829,mage,fire,17,9,8
Ljaie,lightbringer,813,mage,fire,17,9,8
Cymbalta,azralon,789,mage,fire,16,9,7
Pherixsw,stormrage,768,mage,fire,12,8,4
Dandrix,sargeras,768,mage,fire,12,8,4
Mágos,stormrage,768,mage,fire,12,8,4
Blinksz,korgath,768,mage,fire,12,8,4
Wakkaflame,stormrage,768,mage,fire,18,8,10
Salvick,emerald-dream,768,mage,fire,18,8,10
Avócadó,malganis,768,mage,fire,18,8,10
Castana,tichondrius,768,mage,fire,18,8,10
Kawailenard,tichondrius,767,mage,fire,12,8,4
Ingrumatig,tichondrius,767,mage,fire,18,8,10
Ashenlad,moon-guard,766,mage,fire,18,8,10
Tarmiel,quelthalas,765,mage,fire,24,8,16
Putridìty,thrall,762,mage,fire,18,8,10
Orianne,windrunner,750,mage,fire,12,8,4
Pyrlos,terokkar,738,mage,fire,24,9,15
Béssie,area-52,722,mage,fire,18,8,10
Drewann,draenor,704,mage,fire,16,8,8
Amge,uldum,703,mage,fire,14,8,6
Shmagee,azralon,684,mage,fire,13,8,5
Tuggernaug,malganis,672,mage,fire,12,7,5
Xythros,stormrage,672,mage,fire,12,7,5
Warpfactor,malganis,672,mage,fire,12,7,5
Sos,kelthuzad,672,mage,fire,12,7,5
Osirax,frostmane,672,mage,fire,12,7,5
Silimage,area-52,672,mage,fire,12,7,5
Vastlord,stormrage,672,mage,fire,18,7,11
Bigdjohnson,dalaran,672,mage,fire,18,7,11
Keileon,tichondrius,671,mage,fire,12,7,5
Allhitz,ragnaros,671,mage,fire,12,7,5
Lucidaze,daggerspine,671,mage,fire,12,7,5
Mymrmage,mannoroth,671,mage,fire,12,7,5
Blastfire,stormrage,671,mage,fire,12,7,5
Ásune,moon-guard,671,mage,fire,12,7,5
Skryte,mannoroth,671,mage,fire,16,8,8
Magination,frostmourne,671,mage,fire,18,7,11
Alàh,stormscale,671,mage,fire,18,7,11
Dreaming,draktharon,670,mage,fire,12,7,5
Fanshen,tichondrius,670,mage,fire,17,7,10
Supermajor,frostmourne,670,mage,fire,18,7,11
Tmo,mannoroth,670,mage,fire,24,7,17
Slipqt,tichondrius,607,mage,fire,22,7,15
Mômö,argent-dawn,606,mage,fire,22,7,15
Strdelmaker,tichondrius,576,mage,fire,6,6,0
Shmoked,kelthuzad,576,mage,fire,12,6,6
Tearsfórgód,kelthuzad,576,mage,fire,12,6,6
Omagawd,tichondrius,576,mage,fire,12,6,6
Velvetlurker,tichondrius,576,mage,fire,12,6,6
Toteypotter,frostmourne,576,mage,fire,12,6,6
Magicmidget,malganis,576,mage,fire,12,6,6
Magicmichel,malganis,576,mage,fire,12,6,6
Kaylemage,tichondrius,576,mage,fire,12,6,6
Plutón,tichondrius,576,mage,fire,12,6,6
Myfamilygpie,nazgrel,576,mage,fire,12,6,6
Darkisfrosty,tichondrius,576,mage,fire,12,6,6
Leakyboots,illidan,576,mage,fire,12,6,6
Fredcouples,tichondrius,576,mage,fire,12,6,6
Frostboy,borean-tundra,576,mage,fire,12,6,6
Alunarassra,area-52,576,mage,fire,12,6,6
Cuterthanyou,sargeras,576,mage,fire,12,6,6
Wakamage,area-52,576,mage,fire,12,6,6
Aangx,stormrage,576,mage,fire,16,7,9
Linkolni,azralon,576,mage,fire,18,6,12
Stimml,blood-furnace,576,mage,fire,18,6,12
Unknownblast,kul-tiras,576,mage,fire,20,6,14
Zukoprince,azralon,575,mage,fire,6,6,0
Insightæ,frostmourne,575,mage,fire,10,7,3
Magja,bloodhoof,575,mage,fire,12,6,6
Astroblasty,tichondrius,575,mage,fire,18,6,12
Eraticmage,illidan,575,mage,fire,24,6,18
Calínico,quelthalas,575,mage,fire,24,6,18
Spellpowa,khaz-modan,574,mage,fire,12,6,6
Pellemus,malganis,574,mage,fire,12,6,6
Calcaster,aegwynn,573,mage,fire,18,6,12
Ashex,moon-guard,559,mage,fire,18,7,11
Glacier,firetree,543,mage,fire,11,6,5
Youezdawg,tichondrius,480,mage,fire,6,5,1
Tupactopus,tichondrius,480,mage,fire,6,5,1
Hocusjokus,frostmourne,480,mage,fire,6,5,1
Ñïz,bleeding-hollow,480,mage,fire,6,5,1
Mageboy,bonechewer,480,mage,fire,6,5,1
Maxmie,sargeras,480,mage,fire,6,5,1
Chumpp,tichondrius,480,mage,fire,6,5,1
Slavic,sargeras,480,mage,fire,6,5,1
Polypolypoly,kiljaeden,480,mage,fire,10,6,4
Jikario,zuljin,480,mage,fire,12,5,7
Entomas,quelthalas,480,mage,fire,12,5,7
Skillcap,nagrand,480,mage,fire,12,5,7
Chionê,velen,480,mage,fire,12,5,7
Icestory,tichondrius,480,mage,fire,12,5,7
Strumms,tichondrius,480,mage,fire,12,5,7
Bigpøppapump,tichondrius,480,mage,fire,12,5,7
Espyy,area-52,480,mage,fire,12,5,7
Zerosaspect,thrall,480,mage,fire,12,5,7
Pugsmugg,icecrown,480,mage,fire,12,5,7
Kyriê,darkspear,480,mage,fire,12,5,7
Covín,malganis,480,mage,fire,12,5,7
Kevymarts,tichondrius,480,mage,fire,12,5,7
Kqlyy,tichondrius,480,mage,fire,12,5,7
Epod,illidan,480,mage,fire,12,5,7
Cumbus,stormrage,480,mage,fire,12,5,7
Baida,kelthuzad,480,mage,fire,12,5,7
Magicalbuns,illidan,480,mage,fire,12,5,7
Lambsalsa,tichondrius,480,mage,fire,12,5,7
Diamondx,ragnaros,480,mage,fire,12,5,7
Numbing,sargeras,480,mage,fire,12,5,7
Marxeflamer,ragnaros,480,mage,fire,12,5,7
Dìus,malganis,480,mage,fire,12,5,7
Arishasis,tichondrius,480,mage,fire,12,5,7
Honeydutchss,black-dragonflight,480,mage,fire,12,5,7
Marther,whisperwind,480,mage,fire,12,5,7
Arrcadia,darkspear,480,mage,fire,12,5,7
Dbsheep,kul-tiras,480,mage,fire,12,5,7
Aapple,tichondrius,480,mage,fire,17,5,12
Tunax,tichondrius,480,mage,fire,18,5,13
Mageyoulooks,kelthuzad,480,mage,fire,18,5,13
Xunalatu,frostmourne,479,mage,fire,12,5,7
Mescudi,bonechewer,479,mage,fire,12,5,7
Shadowgalaxy,arthas,479,mage,fire,12,5,7
Xannymancan,tichondrius,479,mage,fire,24,5,19
Søkø,tichondrius,478,mage,fire,12,5,7
Apolarus,bonechewer,478,mage,fire,12,5,7
Zendrix,bonechewer,478,mage,fire,12,5,7
Gwenage,tichondrius,472,mage,fire,12,5,7
Shotö,skullcrusher,463,mage,fire,17,5,12
Roastbeefxd,tichondrius,447,mage,fire,11,5,6
Jazen,quelthalas,432,mage,fire,15,6,9
Letitgoo,azralon,430,mage,fire,19,6,13
Chumleyson,eonar,415,mage,fire,8,5,3
Certifried,emerald-dream,415,mage,fire,14,5,9
Firèballin,tichondrius,400,mage,fire,7,5,2
Molassess,illidan,400,mage,fire,13,5,8
Majjix,illidan,384,mage,fire,6,4,2
Gíldrin,proudmoore,384,mage,fire,6,4,2
Pyröz,kelthuzad,384,mage,fire,6,4,2
Cømbust,frostmourne,384,mage,fire,6,4,2
Floatyz,tichondrius,384,mage,fire,6,4,2
Polymedaddi,tichondrius,384,mage,fire,6,4,2
Haze,hyjal,384,mage,fire,6,4,2
Sifr,tichondrius,384,mage,fire,6,4,2
Feenìx,tichondrius,384,mage,fire,6,4,2
Burstyboi,frostmourne,384,mage,fire,6,4,2
Yeetcannøn,illidan,384,mage,fire,6,4,2
Gominsi,tichondrius,384,mage,fire,6,4,2
Minuswizard,dalaran,384,mage,fire,6,4,2
Pollybot,tichondrius,384,mage,fire,6,4,2
Frozonnee,aggramar,384,mage,fire,6,4,2
Refreshments,bleeding-hollow,384,mage,fire,6,4,2
Zokorzik,area-52,384,mage,fire,6,4,2
Fullsheep,emerald-dream,384,mage,fire,6,4,2
Fïtz,quelthalas,384,mage,fire,6,4,2
Keepv,tichondrius,384,mage,fire,6,4,2
Extremeways,tichondrius,384,mage,fire,6,4,2
Belven,proudmoore,384,mage,fire,6,4,2
Crøwgawd,tichondrius,384,mage,fire,6,4,2
Aerligar,area-52,384,mage,fire,6,4,2
Jazzgroyper,sargeras,384,mage,fire,6,4,2
Flaux,sargeras,384,mage,fire,6,4,2
Frogbum,fizzcrank,384,mage,fire,10,5,5
Dytonie,moon-guard,384,mage,fire,9,4,5
Percivaltp,scarlet-crusade,384,mage,fire,12,4,8
Udó,proudmoore,384,mage,fire,12,4,8
Elfmage,tichondrius,384,mage,fire,12,4,8
Droppinbombs,draka,384,mage,fire,12,4,8
Wzrdxz,tichondrius,384,mage,fire,12,4,8
Thiio,tichondrius,384,mage,fire,12,4,8
Felsparkles,area-52,384,mage,fire,12,4,8
Pigdancel,tichondrius,384,mage,fire,12,4,8
Galsola,bronzebeard,384,mage,fire,12,4,8
Sarahbeth,khadgar,384,mage,fire,12,4,8
Spookydookie,dark-iron,384,mage,fire,12,4,8
Aquralina,moon-guard,384,mage,fire,12,4,8
Siayo,stormscale,384,mage,fire,12,4,8
Hogslop,saurfang,384,mage,fire,12,4,8
Gôøglëlòl,nemesis,384,mage,fire,18,4,14
Kronicblast,bleeding-hollow,384,mage,fire,18,4,14
Boptimus,moonrunner,383,mage,fire,6,4,2
Noyade,illidan,383,mage,fire,6,4,2
Drewzz,tichondrius,383,mage,fire,8,4,4
Chuggin,emerald-dream,383,mage,fire,15,5,10
Hockisonz,moon-guard,383,mage,fire,12,4,8
Wetguuch,area-52,383,mage,fire,12,4,8
Soulwiper,illidan,383,mage,fire,17,5,12
Smoney,icecrown,383,mage,fire,18,4,14
Hollfz,nemesis,367,mage,fire,11,4,7
Vixm,stormrage,352,mage,fire,10,5,5
Tmharp,tichondrius,336,mage,fire,9,5,4
Pyrotactics,sargeras,320,mage,fire,10,4,6
Absentbrain,stormrage,288,mage,fire,6,3,3
Zerathremar,proudmoore,288,mage,fire,6,3,3
Herzthroh,stormrage,288,mage,fire,6,3,3
Missingxx,silvermoon,288,mage,fire,6,3,3
Urbadxd,llane,288,mage,fire,6,3,3
Sourpatchkds,emerald-dream,288,mage,fire,6,3,3
Chilléd,tichondrius,288,mage,fire,6,3,3
Aulle,whisperwind,288,mage,fire,6,3,3
Cacaushow,stormrage,288,mage,fire,6,3,3
Jimmyhendrix,wildhammer,288,mage,fire,6,3,3
Gåndalf,ragnaros,288,mage,fire,6,3,3
Kuther,draenor,288,mage,fire,6,3,3
Frostkage,tichondrius,288,mage,fire,6,3,3
Mindthegap,tichondrius,288,mage,fire,6,3,3
Lampert,tichondrius,288,mage,fire,6,3,3
Zenzoh,azuremyst,288,mage,fire,6,3,3
Hasteboy,kelthuzad,288,mage,fire,6,3,3
Botoslàp,dragonmaw,288,mage,fire,6,3,3
Kushjointz,tichondrius,288,mage,fire,6,3,3
Bhalec,kelthuzad,288,mage,fire,6,3,3
Mayumî,moon-guard,288,mage,fire,6,3,3
Zuhbo,moon-guard,288,mage,fire,6,3,3
Garion,moon-guard,288,mage,fire,6,3,3
Ancientmagik,area-52,288,mage,fire,6,3,3
Gö,tichondrius,288,mage,fire,6,3,3
Pollylol,proudmoore,288,mage,fire,6,3,3
Tráshmage,zuljin,288,mage,fire,6,3,3
Slinkyslink,area-52,288,mage,fire,6,3,3
Easyfreeze,sargeras,288,mage,fire,6,3,3
Polyburst,darkspear,288,mage,fire,6,3,3
Azuriex,tichondrius,288,mage,fire,6,3,3
Kyliec,tichondrius,288,mage,fire,6,3,3
Wqnmlgbdy,tichondrius,288,mage,fire,6,3,3
Pecs,kiljaeden,288,mage,fire,6,3,3
Síra,firetree,288,mage,fire,6,3,3
Bergan,sargeras,288,mage,fire,6,3,3
Emvepee,sargeras,288,mage,fire,6,3,3
Thecorruptor,malorne,288,mage,fire,6,3,3
Sabrita,proudmoore,288,mage,fire,6,3,3
Rích,tichondrius,288,mage,fire,6,3,3
Svips,illidan,288,mage,fire,6,3,3
Rhunón,dalaran,288,mage,fire,6,3,3
Ave,anetheron,288,mage,fire,6,3,3
Chez,tichondrius,288,mage,fire,6,3,3
Vengefuly,tichondrius,288,mage,fire,6,3,3
Mntaindew,bleeding-hollow,288,mage,fire,6,3,3
Blinkinghobo,sargeras,288,mage,fire,6,3,3
Nuzzle,boulderfist,288,mage,fire,8,3,5
Danggurl,tichondrius,288,mage,fire,12,3,9
Mendittorosa,tichondrius,288,mage,fire,12,3,9
Keionti,dalaran,288,mage,fire,12,3,9
Fatalexo,tichondrius,288,mage,fire,12,3,9
Gnomegeddons,dalaran,288,mage,fire,24,3,21
Frostyii,stonemaul,287,mage,fire,6,3,3
Aphazia,kiljaeden,287,mage,fire,6,3,3
Harlen,quelthalas,287,mage,fire,6,3,3
Brànd,antonidas,287,mage,fire,6,3,3
Nesomage,destromath,256,mage,fire,10,3,7
Rossanopolis,tichondrius,255,mage,fire,11,3,8
Genozyde,elune,239,mage,fire,5,3,2
Fizario,barthilas,239,mage,fire,5,3,2
Orderlight,alexstrasza,239,mage,fire,5,3,2
Wabï,tichondrius,234,mage,fire,9,4,5
Flomin,tichondrius,234,mage,fire,16,6,10
Cînderellas,proudmoore,234,mage,fire,13,4,9
Rennifer,malganis,192,mage,fire,9,3,6
Burna,amanthul,192,mage,fire,6,2,4
Zuqo,sargeras,192,mage,fire,6,2,4
Randommagi,area-52,192,mage,fire,6,2,4
Rbn,tichondrius,192,mage,fire,6,2,4
Clickhard,suramar,192,mage,fire,6,2,4
Karameltart,barthilas,192,mage,fire,6,2,4
Avandal,proudmoore,192,mage,fire,6,2,4
Massivepoo,barthilas,192,mage,fire,6,2,4
Dohnutt,tichondrius,192,mage,fire,6,2,4
Trebbiano,illidan,192,mage,fire,6,2,4
Chelseâ,emerald-dream,192,mage,fire,6,2,4
Magiër,tichondrius,192,mage,fire,6,2,4
Pendrake,sargeras,192,mage,fire,6,2,4
Chadicewayne,tichondrius,192,mage,fire,6,2,4
Killemz,dragonmaw,192,mage,fire,6,2,4
Pòpsmóke,tichondrius,192,mage,fire,6,2,4
Juniel,bleeding-hollow,192,mage,fire,6,2,4
Jinglehz,frostmourne,192,mage,fire,6,2,4
Snowday,nerzhul,192,mage,fire,6,2,4
Trízín,frostmourne,192,mage,fire,6,2,4
Cradic,tichondrius,192,mage,fire,6,2,4
Ignitex,bleeding-hollow,192,mage,fire,6,2,4
Kymowiz,sargeras,192,mage,fire,6,2,4
Notria,illidan,192,mage,fire,6,2,4
Starguy,terenas,192,mage,fire,6,2,4
Coldnuke,stormrage,192,mage,fire,6,2,4
Aquafiona,garona,192,mage,fire,6,2,4
Ellywizzle,tichondrius,192,mage,fire,6,2,4
Emìlia,malygos,192,mage,fire,6,2,4
Kaboodlz,stormrage,192,mage,fire,6,2,4
Alïce,kelthuzad,192,mage,fire,6,2,4
Likelyhard,tichondrius,192,mage,fire,6,2,4
Coldcaster,mugthol,192,mage,fire,6,2,4
Thedodgex,sargeras,192,mage,fire,6,2,4
Remana,anvilmar,192,mage,fire,6,2,4
Gódsfather,kelthuzad,192,mage,fire,6,2,4
Gtown,kelthuzad,192,mage,fire,6,2,4
Flamiohotman,illidan,192,mage,fire,6,2,4
Josephaqil,tichondrius,192,mage,fire,6,2,4
Parruka,warsong,192,mage,fire,6,2,4
Phantose,sargeras,192,mage,fire,6,2,4
Gotya,tichondrius,192,mage,fire,6,2,4
Missile,frostmourne,192,mage,fire,6,2,4
Shardgodx,kelthuzad,192,mage,fire,6,2,4
Dustychill,illidan,192,mage,fire,6,2,4
Burrbon,area-52,192,mage,fire,6,2,4
Maddoggs,tichondrius,192,mage,fire,6,2,4
Sogood,tanaris,192,mage,fire,6,2,4
Preplex,thrall,192,mage,fire,6,2,4
Yonzho,area-52,192,mage,fire,6,2,4
Magifish,malganis,192,mage,fire,6,2,4
Natzue,sargeras,192,mage,fire,6,2,4
Naimi,malganis,192,mage,fire,6,2,4
Shashyta,drakkari,192,mage,fire,6,2,4
Juicemage,tichondrius,192,mage,fire,6,2,4
Roggitman,emerald-dream,192,mage,fire,6,2,4
Elhechizero,quelthalas,192,mage,fire,6,2,4
Zënith,quelthalas,192,mage,fire,6,2,4
Valodrin,tichondrius,192,mage,fire,6,2,4
Gunzz,aegwynn,192,mage,fire,6,2,4
Defaultx,turalyon,192,mage,fire,6,2,4
Wauzcrol,quelthalas,192,mage,fire,6,2,4
Abrácadaver,frostwolf,192,mage,fire,10,3,7
Arnx,tichondrius,192,mage,fire,11,2,9
Bic,darrowmere,192,mage,fire,12,2,10
Driel,illidan,192,mage,fire,12,2,10
Abruaa,area-52,192,mage,fire,12,2,10
Flippendicus,stormrage,192,mage,fire,12,2,10
Granmago,azralon,192,mage,fire,12,2,10
Spellbrker,stormrage,192,mage,fire,12,2,10
Saydar,stormrage,192,mage,fire,12,2,10
Beji,frostmourne,191,mage,fire,9,2,7
Prosperoo,aerie-peak,191,mage,fire,12,2,10
Neroclover,ysera,191,mage,fire,24,2,22
Madalon,nemesis,160,mage,fire,10,2,8
Zezima,spirestone,159,mage,fire,5,2,3
Kindlin,frostmourne,159,mage,fire,5,2,3
Tungstentoes,shuhalo,144,mage,fire,5,3,2
Fingerblaste,malganis,138,mage,fire,16,3,13
Eromir,dawnbringer,128,mage,fire,4,2,2
Yeweiliang,tichondrius,128,mage,fire,4,2,2
Ratfather,the-forgotten-coast,128,mage,fire,4,2,2
Supremeboxer,tichondrius,127,mage,fire,8,2,6
Neltar,dalaran,112,mage,fire,7,2,5
Jaysaucetv,tichondrius,112,mage,fire,7,2,5
Haliax,bronzebeard,96,mage,fire,3,2,1
Trojay,malganis,96,mage,fire,6,1,5
Dildope,frostmourne,96,mage,fire,6,1,5
Tabuta,ravenholdt,96,mage,fire,6,1,5
Hrichit,tichondrius,96,mage,fire,6,1,5
Eldrielle,frostmourne,96,mage,fire,6,1,5
Eludin,aegwynn,96,mage,fire,6,1,5
Nomidian,area-52,96,mage,fire,6,1,5
Arkuran,proudmoore,96,mage,fire,6,1,5
Iamsol,area-52,96,mage,fire,6,1,5
Muted,frostmourne,96,mage,fire,6,1,5
Dâzk,sargeras,96,mage,fire,6,1,5
Ejzok,dreadmaul,96,mage,fire,6,1,5
Brayni,wyrmrest-accord,96,mage,fire,6,1,5
Couto,tichondrius,96,mage,fire,6,1,5
Hyndoriann,azgalor,96,mage,fire,6,1,5
Tonydippin,illidan,96,mage,fire,6,1,5
Merreda,sargeras,96,mage,fire,6,1,5
Magicmooman,thunderlord,96,mage,fire,6,1,5
Édika,area-52,96,mage,fire,6,1,5
Jarethleon,ragnaros,96,mage,fire,6,1,5
Rolypolyman,tichondrius,96,mage,fire,6,1,5
Ssmurfett,dalaran,96,mage,fire,6,1,5
Scmage,exodar,96,mage,fire,6,1,5
Caldian,wyrmrest-accord,96,mage,fire,6,1,5
Nazztwren,bleeding-hollow,96,mage,fire,6,1,5
Firemids,thrall,96,mage,fire,6,1,5
Lv,stormscale,96,mage,fire,6,1,5
Prosperoh,burning-legion,96,mage,fire,6,1,5
Clutchy,gorefiend,96,mage,fire,6,1,5
Ignit,stormrage,96,mage,fire,6,1,5
Miapolyafoo,stormrage,96,mage,fire,6,1,5
Truewinter,tichondrius,96,mage,fire,6,1,5
Pyrophobia,mannoroth,96,mage,fire,6,1,5
Pyromaniac,stormscale,96,mage,fire,6,1,5
Somnuss,barthilas,96,mage,fire,7,1,6
Vakina,tichondrius,96,mage,fire,8,1,7
Zuroz,dathremar,96,mage,fire,12,1,11
Allesanda,sargeras,96,mage,fire,12,1,11
Mideon,whisperwind,95,mage,fire,6,1,5
Savanali,kelthuzad,79,mage,fire,5,1,4
Jaked,frostmourne,79,mage,fire,5,1,4
Jarvase,mugthol,79,mage,fire,5,1,4
Sossmage,jaedenar,48,mage,fire,3,1,2
Redeyez,arthas,48,mage,fire,9,1,8
Minerves,tichondrius,42,mage,fire,10,3,7
Absolutepowa,bleeding-hollow,31,mage,fire,2,1,1
Squishymage,frostmourne,16,mage,fire,1,1,0
Juicemage,tichondrius,2224,mage,frost,120,65,55
Stonedmonkeý,tichondrius,2072,mage,frost,125,62,63
Cremgotrockd,blackrock,2064,mage,frost,89,50,39
Ghostrr,tichondrius,2044,mage,frost,147,78,69
Lawuera,quelthalas,2011,mage,frost,96,48,48
Easyfreeze,sargeras,1996,mage,frost,48,27,21
Koro,tichondrius,1985,mage,frost,115,61,54
Backjing,tichondrius,1969,mage,frost,87,42,45
Zerodium,sargeras,1938,mage,frost,83,44,39
Hogmantwo,illidan,1935,mage,frost,54,29,25
Douyuweifa,tichondrius,1911,mage,frost,65,31,34
Elkiador,area-52,1909,mage,frost,30,21,9
Valériemeow,tichondrius,1903,mage,frost,70,36,34
Grumpyòlfart,tichondrius,1898,mage,frost,126,64,62
Vazlgs,tichondrius,1896,mage,frost,82,47,35
Ams,aerie-peak,1890,mage,frost,60,33,27
Yeweiliang,tichondrius,1887,mage,frost,252,134,118
Kissradiox,tichondrius,1879,mage,frost,102,51,51
Joe,llane,1877,mage,frost,69,36,33
Kleinz,quelthalas,1863,mage,frost,67,45,22
Tupactopus,tichondrius,1861,mage,frost,54,27,27
Pigdancell,tichondrius,1858,mage,frost,60,25,35
Fròzt,ragnaros,1857,mage,frost,72,31,41
Xanthilia,chogall,1849,mage,frost,96,49,47
Snaregodx,area-52,1845,mage,frost,53,29,24
Hideongp,barthilas,1842,mage,frost,108,54,54
Smuky,stormrage,1834,mage,frost,66,29,37
Dahp,thrall,1831,mage,frost,47,23,24
Stöpwatch,hyjal,1830,mage,frost,60,39,21
Kassmage,skullcrusher,1825,mage,frost,102,45,57
Gelokay,tichondrius,1821,mage,frost,42,25,17
Chrisxo,azuremyst,1820,mage,frost,42,24,18
Chez,tichondrius,1818,mage,frost,30,19,11
Faynet,dalaran,1817,mage,frost,90,48,42
Cømbust,frostmourne,1816,mage,frost,72,50,22
Juicechanel,tichondrius,1816,mage,frost,52,25,27
Quippy,kiljaeden,1813,mage,frost,309,156,153
Leakyboots,illidan,1812,mage,frost,47,25,22
Ribot,sargeras,1812,mage,frost,60,28,32
Koozay,kelthuzad,1805,mage,frost,65,38,27
Maegwynah,stormrage,1804,mage,frost,66,29,37
Instincts,uldum,1796,mage,frost,42,25,17
Ligmmah,stormrage,1792,mage,frost,110,61,49
Mcdfries,tichondrius,1792,mage,frost,48,25,23
Pitball,area-52,1788,mage,frost,55,30,25
Dtbmar,misha,1788,mage,frost,70,32,38
Laserface,bleeding-hollow,1786,mage,frost,30,21,9
Drewdy,stormreaver,1783,mage,frost,30,19,11
Sheepgodx,malganis,1779,mage,frost,35,20,15
Hunchojack,tichondrius,1770,mage,frost,48,21,27
Sestren,zuljin,1766,mage,frost,54,25,29
Factszxy,area-52,1761,mage,frost,41,29,12
Rhythmdog,tichondrius,1758,mage,frost,60,25,35
Valtessa,stormrage,1753,mage,frost,48,30,18
Hogdog,illidan,1751,mage,frost,54,28,26
Téfy,ragnaros,1744,mage,frost,59,34,25
Riddickl,malfurion,1736,mage,frost,90,44,46
Srinshi,sargeras,1736,mage,frost,142,68,74
Corgim,thrall,1730,mage,frost,47,24,23
Ingcho,tichondrius,1730,mage,frost,72,32,40
Illumià,illidan,1719,mage,frost,26,20,6
Polyenjoyerx,ysera,1719,mage,frost,102,54,48
Endymiòn,tichondrius,1718,mage,frost,42,21,21
Traelol,blades-edge,1715,mage,frost,114,58,56
Sifr,tichondrius,1713,mage,frost,36,18,18
Castana,tichondrius,1707,mage,frost,90,40,50
Headbake,malganis,1705,mage,frost,42,24,18
Maebalim,tichondrius,1701,mage,frost,30,18,12
Rizke,tichondrius,1701,mage,frost,35,18,17
Glaciated,the-forgotten-coast,1699,mage,frost,74,38,36
Golfirl,doomhammer,1694,mage,frost,36,20,16
Fromcanadaqc,stormrage,1689,mage,frost,41,24,17
Zinnos,tichondrius,1684,mage,frost,214,105,109
Persia,illidan,1683,mage,frost,53,24,29
Sabrita,proudmoore,1680,mage,frost,92,47,45
Jtizzlè,tichondrius,1679,mage,frost,59,33,26
Christmas,tichondrius,1674,mage,frost,384,196,188
Jerawokee,undermine,1674,mage,frost,61,25,36
Alurion,moon-guard,1673,mage,frost,32,21,11
Arcayne,tichondrius,1667,mage,frost,92,51,41
Tommagic,tichondrius,1666,mage,frost,40,23,17
Mokelovin,sargeras,1663,mage,frost,41,26,15
Stimml,blood-furnace,1662,mage,frost,66,38,28
Venachi,emerald-dream,1658,mage,frost,128,74,54
Tatertots,bladefist,1658,mage,frost,47,18,29
Bmuafgfe,tichondrius,1655,mage,frost,33,20,13
Bambambilly,kelthuzad,1655,mage,frost,75,35,40
Theetwotime,area-52,1654,mage,frost,78,37,41
Minverces,tichondrius,1653,mage,frost,40,23,17
Dexd,laughing-skull,1652,mage,frost,36,23,13
Entm,burning-blade,1651,mage,frost,42,22,20
Tjofmajik,stormrage,1651,mage,frost,42,20,22
Zhangxiaowu,tichondrius,1648,mage,frost,50,32,18
Deallus,tichondrius,1648,mage,frost,76,36,40
Luxør,aegwynn,1647,mage,frost,30,18,12
Zorexx,area-52,1643,mage,frost,61,30,31
Lorlene,frostmourne,1638,mage,frost,115,52,63
Gûmbÿ,illidan,1636,mage,frost,36,28,8
Charmed,black-dragonflight,1635,mage,frost,80,42,38
Lambsalsa,tichondrius,1631,mage,frost,42,18,24
Mayumî,moon-guard,1629,mage,frost,36,19,17
Zezima,spirestone,1625,mage,frost,36,23,13
Dace,tichondrius,1625,mage,frost,36,20,16
Elyandria,proudmoore,1625,mage,frost,42,23,19
Xialing,tichondrius,1625,mage,frost,35,18,17
Tris,malganis,1625,mage,frost,43,19,24
Fgnb,sargeras,1619,mage,frost,36,23,13
Neverblockx,kirin-tor,1618,mage,frost,30,17,13
Gwyn,nemesis,1614,mage,frost,54,29,25
Gôøglëlòl,nemesis,1608,mage,frost,175,86,89
Dillor,tichondrius,1606,mage,frost,124,66,58
Snoogensftw,tichondrius,1602,mage,frost,36,17,19
Syntacks,lightnings-blade,1598,mage,frost,225,112,113
Pichorrá,quelthalas,1595,mage,frost,50,28,22
Blinkbow,tichondrius,1595,mage,frost,102,46,56
Dorsia,jaedenar,1594,mage,frost,28,20,8
Frostpimp,anubarak,1594,mage,frost,62,27,35
Dve,frostmourne,1593,mage,frost,66,40,26
Flâvor,illidan,1593,mage,frost,54,29,25
Praestigium,barthilas,1589,mage,frost,57,31,26
Triuneward,tichondrius,1585,mage,frost,36,20,16
Mageonthcc,korgath,1583,mage,frost,98,49,49
Sheepu,bladefist,1578,mage,frost,88,51,37
Axecap,tichondrius,1578,mage,frost,36,20,16
Enflame,tichondrius,1576,mage,frost,36,27,9
Trolson,sargeras,1575,mage,frost,94,41,53
Squidio,stormrage,1570,mage,frost,125,68,57
Eldrielle,frostmourne,1569,mage,frost,312,162,150
Crithappy,baelgun,1568,mage,frost,48,26,22
Frizbee,sargeras,1567,mage,frost,39,19,20
Nickioxox,tichondrius,1567,mage,frost,41,17,24
Maagin,zuljin,1560,mage,frost,92,51,41
Animatronic,moon-guard,1560,mage,frost,149,73,76
Affewxd,lothar,1557,mage,frost,126,65,61
Orderlight,alexstrasza,1556,mage,frost,59,24,35
Deathrøll,moon-guard,1552,mage,frost,84,48,36
Zeshilol,stormrage,1549,mage,frost,39,19,20
Sáron,quelthalas,1539,mage,frost,54,31,23
Toaststrudel,tichondrius,1537,mage,frost,58,27,31
Biglance,frostmourne,1533,mage,frost,36,17,19
Frostqt,area-52,1532,mage,frost,132,71,61
Yorgøs,ragnaros,1530,mage,frost,30,16,14
Littlejay,kelthuzad,1528,mage,frost,30,16,14
Magetherian,frostmourne,1528,mage,frost,42,21,21
Flaux,sargeras,1526,mage,frost,24,16,8
Floofies,moon-guard,1526,mage,frost,120,59,61
Erîol,ragnaros,1525,mage,frost,46,24,22
Preceptør,azralon,1523,mage,frost,45,22,23
Galacticslug,tichondrius,1519,mage,frost,48,28,20
Savanali,kelthuzad,1518,mage,frost,36,21,15
Revised,sargeras,1518,mage,frost,88,51,37
Qsc,barthilas,1514,mage,frost,103,51,52
Priyel,hyjal,1513,mage,frost,36,19,17
Fawcett,khazgoroth,1511,mage,frost,66,31,35
Atra,spinebreaker,1510,mage,frost,36,16,20
Playsfrost,skullcrusher,1501,mage,frost,106,62,44
Khadberry,aerie-peak,1501,mage,frost,71,34,37
Kazmir,area-52,1494,mage,frost,41,16,25
Soulberg,emerald-dream,1492,mage,frost,71,31,40
Burritsacold,bleeding-hollow,1491,mage,frost,54,26,28
Guyza,frostmourne,1489,mage,frost,41,18,23
Datazonfire,illidan,1488,mage,frost,36,22,14
Deverror,frostmourne,1487,mage,frost,113,50,63
Song,sargeras,1485,mage,frost,83,42,41
Emetah,ysera,1485,mage,frost,60,27,33
Omnislasher,terenas,1482,mage,frost,115,53,62
Pibb,rivendare,1480,mage,frost,48,25,23
Léstat,quelthalas,1479,mage,frost,36,21,15
Frussy,blood-furnace,1478,mage,frost,66,36,30
Cubanmage,drakkari,1477,mage,frost,42,19,23
Genswift,thrall,1475,mage,frost,36,17,19
Fbd,bloodscalp,1473,mage,frost,30,16,14
Scrúmp,tichondrius,1468,mage,frost,30,16,14
Miketao,tichondrius,1468,mage,frost,38,16,22
Enterthevoid,proudmoore,1463,mage,frost,36,21,15
Osnapmage,malganis,1462,mage,frost,244,121,123
Kh,stormrage,1460,mage,frost,81,44,37
Ado,zuluhed,1460,mage,frost,108,56,52
Yulian,tichondrius,1454,mage,frost,79,44,35
Azhim,tichondrius,1453,mage,frost,48,24,24
Tifrodo,azralon,1452,mage,frost,70,39,31
Coôler,illidan,1451,mage,frost,160,90,70
Moyuu,proudmoore,1450,mage,frost,84,39,45
Nereidan,drakkari,1448,mage,frost,56,26,30
Bettybonk,cenarius,1448,mage,frost,42,18,24
Minerves,tichondrius,1446,mage,frost,42,20,22
Corruptionz,nemesis,1441,mage,frost,36,18,18
Pvpbilly,tichondrius,1439,mage,frost,24,15,9
Fròzen,moon-guard,1436,mage,frost,74,35,39
Paü,illidan,1436,mage,frost,70,29,41
Aapple,tichondrius,1433,mage,frost,30,15,15
Sesshomaru,emerald-dream,1433,mage,frost,51,18,33
Vornz,sargeras,1432,mage,frost,61,28,33
Gasolína,stormrage,1431,mage,frost,66,31,35
Respectx,nemesis,1431,mage,frost,58,25,33
Mmine,tichondrius,1430,mage,frost,30,15,15
Kymowiz,sargeras,1423,mage,frost,36,15,21
Myxzz,barthilas,1422,mage,frost,184,93,91
Trebbiano,illidan,1416,mage,frost,103,52,51
Tylers,moon-guard,1415,mage,frost,36,19,17
Gazzuu,ragnaros,1413,mage,frost,42,22,20
Clm,lightnings-blade,1412,mage,frost,65,32,33
Vecna,tichondrius,1411,mage,frost,103,47,56
Mclanda,frostmourne,1409,mage,frost,65,30,35
Perrc,area-52,1407,mage,frost,128,56,72
Canva,barthilas,1406,mage,frost,41,25,16
Umber,dreadmaul,1405,mage,frost,146,69,77
Nate,black-dragonflight,1404,mage,frost,128,65,63
Gunzup,lightnings-blade,1403,mage,frost,30,15,15
Tentaçao,stormrage,1400,mage,frost,45,24,21
Frøzzen,quelthalas,1400,mage,frost,105,49,56
Fakebusiness,area-52,1398,mage,frost,94,45,49
Selless,zuljin,1397,mage,frost,60,33,27
Starscreamm,ragnaros,1394,mage,frost,34,20,14
Mkudos,ragnaros,1394,mage,frost,38,18,20
Crymachine,garrosh,1391,mage,frost,33,17,16
Boejanglz,frostmourne,1390,mage,frost,28,17,11
Affinitty,zuljin,1389,mage,frost,42,24,18
Rích,tichondrius,1389,mage,frost,108,49,59
Hermanmiller,tichondrius,1388,mage,frost,66,32,34
Maguín,tichondrius,1384,mage,frost,30,15,15
Kouks,tichondrius,1383,mage,frost,23,15,8
Plainblaine,illidan,1379,mage,frost,68,32,36
Zoidy,bleeding-hollow,1377,mage,frost,35,15,20
Tagere,moon-guard,1370,mage,frost,80,38,42
Kahili,stormrage,1361,mage,frost,47,19,28
Kevymarts,tichondrius,1358,mage,frost,54,31,23
Koulder,zuljin,1357,mage,frost,30,18,12
Chadyus,illidan,1356,mage,frost,36,15,21
Mëlkart,ragnaros,1350,mage,frost,36,17,19
Anarista,wyrmrest-accord,1345,mage,frost,24,15,9
Vampìrelolz,tichondrius,1344,mage,frost,24,14,10
Osh,malorne,1343,mage,frost,26,15,11
Mâsterkush,tichondrius,1343,mage,frost,46,23,23
Cryogeniks,illidan,1343,mage,frost,30,14,16
Milambehr,elune,1340,mage,frost,30,16,14
Safety,stormreaver,1337,mage,frost,106,57,49
Wolfgangvn,stormrage,1336,mage,frost,31,15,16
Shatturd,sargeras,1336,mage,frost,42,15,27
Forged,tichondrius,1335,mage,frost,24,14,10
Safu,bleeding-hollow,1335,mage,frost,120,63,57
Slipqt,tichondrius,1333,mage,frost,42,15,27
Marisadaze,tichondrius,1331,mage,frost,39,15,24
Gualter,nemesis,1329,mage,frost,96,54,42
Juul,emerald-dream,1328,mage,frost,237,109,128
Vorass,kelthuzad,1325,mage,frost,30,15,15
Lachawr,stormrage,1324,mage,frost,95,51,44
Starkp,ragnaros,1319,mage,frost,153,73,80
Soia,ragnaros,1318,mage,frost,102,52,50
Kabonkle,drakthul,1317,mage,frost,44,17,27
Andorlin,barthilas,1315,mage,frost,47,22,25
Clownspocket,tichondrius,1313,mage,frost,65,36,29
Magicbunny,andorhal,1312,mage,frost,142,71,71
Ragemage,borean-tundra,1311,mage,frost,59,20,39
Mntaindew,bleeding-hollow,1309,mage,frost,35,14,21
Numz,sargeras,1302,mage,frost,94,42,52
Valtaira,wyrmrest-accord,1301,mage,frost,65,39,26
Kryliak,ragnaros,1301,mage,frost,54,31,23
Frostítute,alterac-mountains,1299,mage,frost,60,28,32
Frostitutå,eonar,1293,mage,frost,118,54,64
Icybanter,emerald-dream,1286,mage,frost,30,14,16
Alìv,tichondrius,1281,mage,frost,148,65,83
Dumblexgamer,ragnaros,1280,mage,frost,58,26,32
Thergon,kul-tiras,1279,mage,frost,32,17,15
Derpmanjr,area-52,1277,mage,frost,60,39,21
Skynhet,ragnaros,1277,mage,frost,36,16,20
Cheapsects,drakthul,1272,mage,frost,32,17,15
Meer,stonemaul,1270,mage,frost,30,17,13
Ignit,stormrage,1269,mage,frost,34,17,17
Throatdemon,hakkar,1269,mage,frost,36,15,21
Tarmiel,quelthalas,1267,mage,frost,30,15,15
Vengefuly,tichondrius,1264,mage,frost,34,17,17
Zssy,tichondrius,1263,mage,frost,23,14,9
Samuoa,tichondrius,1261,mage,frost,30,17,13
Feogato,proudmoore,1249,mage,frost,129,64,65
Factsx,area-52,1247,mage,frost,30,13,17
Isellstuff,thrall,1243,mage,frost,30,13,17
Yourefat,emerald-dream,1238,mage,frost,36,20,16
Burstage,destromath,1238,mage,frost,30,13,17
Agniih,azralon,1236,mage,frost,66,31,35
Rankryman,quelthalas,1235,mage,frost,40,20,20
Unleáshed,moonrunner,1229,mage,frost,61,29,32
Satív,moknathal,1228,mage,frost,30,18,12
Zirkur,mannoroth,1228,mage,frost,30,13,17
Frostzadan,quelthalas,1228,mage,frost,54,22,32
Acarilla,stormrage,1228,mage,frost,48,18,30
Jikario,zuljin,1224,mage,frost,30,13,17
Jobar,malganis,1221,mage,frost,24,13,11
Magifish,malganis,1220,mage,frost,30,18,12
Chade,dunemaul,1220,mage,frost,36,15,21
Ruzam,area-52,1216,mage,frost,39,16,23
Featherboo,stormrage,1215,mage,frost,24,14,10
Pocsermage,drakkari,1210,mage,frost,28,13,15
Kromeus,illidan,1210,mage,frost,36,16,20
Ràmdas,hyjal,1208,mage,frost,24,13,11
Canassa,azralon,1208,mage,frost,113,58,55
Wowenjoyer,area-52,1197,mage,frost,70,33,37
Giovannie,zuluhed,1195,mage,frost,24,13,11
Layolis,area-52,1195,mage,frost,56,29,27
Rrite,tichondrius,1192,mage,frost,23,13,10
Arcánè,velen,1191,mage,frost,23,13,10
Valrendor,nazjatar,1191,mage,frost,79,36,43
Gtó,sargeras,1190,mage,frost,29,13,16
Whyammage,dalaran,1185,mage,frost,71,40,31
Copperfield,dreadmaul,1185,mage,frost,80,33,47
Palruki,tichondrius,1185,mage,frost,54,19,35
Sølem,frostmourne,1182,mage,frost,36,16,20
Maigoddess,proudmoore,1180,mage,frost,71,29,42
Sahir,thaurissan,1173,mage,frost,30,14,16
Pendrake,sargeras,1170,mage,frost,34,13,21
Gsr,nerzhul,1169,mage,frost,34,14,20
Zlint,quelthalas,1167,mage,frost,25,13,12
Toesuckerlol,tichondrius,1164,mage,frost,33,16,17
Devlux,area-52,1158,mage,frost,104,50,54
Tyrecgosa,tichondrius,1155,mage,frost,54,26,28
Rekonx,tichondrius,1152,mage,frost,35,15,20
Quietusllil,gurubashi,1151,mage,frost,54,33,21
Kabrax,nerzhul,1150,mage,frost,30,12,18
Pëpz,emerald-dream,1150,mage,frost,30,12,18
Evilear,andorhal,1150,mage,frost,30,12,18
Defarefa,frostmourne,1144,mage,frost,34,14,20
Yungice,hyjal,1144,mage,frost,36,14,22
Diixynormus,illidan,1141,mage,frost,30,17,13
Cheesebuns,proudmoore,1139,mage,frost,30,12,18
Twinklestars,sargeras,1138,mage,frost,48,27,21
Aquariusmoon,bonechewer,1138,mage,frost,42,21,21
Gryd,area-52,1137,mage,frost,52,27,25
Magicmooman,thunderlord,1137,mage,frost,24,12,12
Darkrukia,tichondrius,1137,mage,frost,51,25,26
Who,emerald-dream,1131,mage,frost,40,19,21
Lucyphilis,stormrage,1131,mage,frost,42,18,24
Mageeoh,bleeding-hollow,1128,mage,frost,41,14,27
Khaldyn,tichondrius,1127,mage,frost,126,61,65
Mageyoulooks,kelthuzad,1125,mage,frost,30,12,18
Jejihev,drakkari,1124,mage,frost,24,12,12
Fatum,ragnaros,1124,mage,frost,32,14,18
Elwyn,dunemaul,1123,mage,frost,27,13,14
Nazneen,elune,1122,mage,frost,73,31,42
Gunzz,aegwynn,1122,mage,frost,30,12,18
Paidemago,azralon,1121,mage,frost,24,14,10
Coldfrønt,moon-guard,1120,mage,frost,48,21,27
Couto,tichondrius,1116,mage,frost,23,12,11
Gatka,quelthalas,1116,mage,frost,188,85,103
Bellåtrîx,quelthalas,1115,mage,frost,18,12,6
Drumzter,ragnaros,1114,mage,frost,29,16,13
Osda,azralon,1111,mage,frost,36,19,17
Icegiants,tichondrius,1111,mage,frost,23,12,11
Levitaine,bleeding-hollow,1110,mage,frost,38,19,19
Shäräpova,zuljin,1109,mage,frost,24,12,12
Sturmrevenge,lightnings-blade,1109,mage,frost,102,49,53
Xárdas,quelthalas,1109,mage,frost,52,22,30
Castingmommy,moon-guard,1108,mage,frost,73,37,36
Discoinferno,kelthuzad,1107,mage,frost,21,13,8
Cìfel,quelthalas,1105,mage,frost,19,13,6
Ibalyn,khazgoroth,1104,mage,frost,83,40,43
Twirkin,proudmoore,1102,mage,frost,36,18,18
Somethinglos,sargeras,1102,mage,frost,32,13,19
Cocmagic,kelthuzad,1101,mage,frost,27,13,14
Corucia,echo-isles,1101,mage,frost,148,69,79
Hollerin,whisperwind,1098,mage,frost,18,12,6
Corrmic,winterhoof,1098,mage,frost,30,14,16
Aherom,ragnaros,1095,mage,frost,21,13,8
Magedango,bleeding-hollow,1095,mage,frost,35,14,21
Azzurn,doomhammer,1090,mage,frost,24,13,11
Helcarwen,area-52,1081,mage,frost,31,13,18
Xannymancan,tichondrius,1080,mage,frost,54,21,33
Mindthegap,tichondrius,1079,mage,frost,45,25,20
Gradivous,emerald-dream,1072,mage,frost,70,31,39
Arkoz,tichondrius,1071,mage,frost,18,12,6
Magecombe,thrall,1071,mage,frost,19,12,7
Frostitutex,illidan,1071,mage,frost,25,12,13
Cavit,wyrmrest-accord,1070,mage,frost,50,24,26
Degenhours,illidan,1069,mage,frost,27,13,14
Smáckington,tichondrius,1058,mage,frost,63,26,37
Lildabpen,tichondrius,1057,mage,frost,86,34,52
Luckysir,illidan,1055,mage,frost,24,11,13
Pivnert,boulderfist,1055,mage,frost,24,11,13
Marrioo,tichondrius,1055,mage,frost,24,11,13
Luckysix,illidan,1055,mage,frost,30,11,19
Angerfrost,khazgoroth,1054,mage,frost,36,22,14
Babyspise,nathrezim,1054,mage,frost,18,11,7
Renoria,norgannon,1054,mage,frost,24,11,13
Sheepshot,dentarg,1054,mage,frost,24,11,13
Gadogear,draka,1054,mage,frost,30,11,19
Doubledown,kiljaeden,1053,mage,frost,18,11,7
Nairmage,tichondrius,1053,mage,frost,20,11,9
Magekingz,shattered-halls,1052,mage,frost,42,20,22
Tsuchek,tichondrius,1051,mage,frost,18,11,7
Auralyn,wyrmrest-accord,1051,mage,frost,25,11,14
Zuqo,sargeras,1050,mage,frost,18,11,7
Dejavuh,dalaran,1047,mage,frost,48,25,23
Zibbo,ragnaros,1046,mage,frost,18,11,7
Ceadruk,darkspear,1046,mage,frost,30,14,16
Skywalkerino,azralon,1045,mage,frost,24,11,13
Krabby,malganis,1044,mage,frost,36,11,25
Esun,moon-guard,1042,mage,frost,19,12,7
Devoh,dunemaul,1040,mage,frost,20,11,9
Khrixa,illidan,1036,mage,frost,114,55,59
Pugsmugg,icecrown,1032,mage,frost,49,13,36
Sluagh,terenas,1031,mage,frost,52,24,28
Bobalama,tichondrius,1025,mage,frost,18,14,4
Drbloodmuscl,black-dragonflight,1020,mage,frost,36,15,21
Moonfhang,azralon,1018,mage,frost,153,71,82
Trollsita,thrall,1013,mage,frost,18,11,7
Grudel,archimonde,1011,mage,frost,35,19,16
Sènding,sargeras,1010,mage,frost,42,11,31
Diegoneally,bleeding-hollow,1009,mage,frost,24,11,13
Littlebeth,azjolnerub,1006,mage,frost,48,21,27
Rizzbot,sargeras,1005,mage,frost,75,27,48
Jaymage,agamaggan,994,mage,frost,37,13,24
Ejzok,dreadmaul,992,mage,frost,33,13,20
Megapasta,illidan,989,mage,frost,23,11,12
Superoirity,trollbane,988,mage,frost,48,24,24
Drfrostie,anvilmar,987,mage,frost,20,11,9
Prometheus,crushridge,986,mage,frost,52,27,25
Thatlejund,tichondrius,986,mage,frost,28,11,17
Bòóyah,muradin,980,mage,frost,40,21,19
Icebboxx,tichondrius,979,mage,frost,18,11,7
Damage,skullcrusher,971,mage,frost,25,11,14
Torthie,burning-blade,960,mage,frost,12,10,2
Cumbustyomom,illidan,960,mage,frost,18,10,8
Feener,stormreaver,960,mage,frost,18,10,8
Warmweather,nagrand,959,mage,frost,18,10,8
Walrusxo,kelthuzad,959,mage,frost,18,10,8
Legendkiller,bleeding-hollow,959,mage,frost,18,10,8
Nukedat,proudmoore,959,mage,frost,18,10,8
Qcomberoo,frostmane,959,mage,frost,27,11,16
Aluce,frostmourne,958,mage,frost,18,10,8
Ciaooh,tichondrius,958,mage,frost,18,10,8
Hylord,tichondrius,957,mage,frost,18,10,8
Critique,malorne,956,mage,frost,36,20,16
Epifeni,blackrock,955,mage,frost,30,10,20
Trízín,frostmourne,954,mage,frost,18,10,8
Magicke,azgalor,953,mage,frost,17,11,6
Nnenna,bonechewer,952,mage,frost,18,10,8
Keelaron,proudmoore,949,mage,frost,24,10,14
Evierix,illidan,948,mage,frost,50,17,33
Tyning,blood-furnace,947,mage,frost,24,10,14
Trollings,azralon,943,mage,frost,45,21,24
Onlyfansme,dalaran,939,mage,frost,18,10,8
Wickednoob,malganis,927,mage,frost,66,24,42
Misfyre,malganis,926,mage,frost,24,10,14
Crankweigth,rivendare,923,mage,frost,66,29,37
Tristania,archimonde,921,mage,frost,43,22,21
Xoxmage,frostmourne,921,mage,frost,36,15,21
Bigpinkies,korgath,921,mage,frost,24,10,14
Marschubas,drakthul,917,mage,frost,65,28,37
Aramire,drakkari,911,mage,frost,21,11,10
Moesel,emerald-dream,908,mage,frost,15,11,4
Leocius,daggerspine,906,mage,frost,23,10,13
Redeyez,arthas,900,mage,frost,42,17,25
Radiku,blood-furnace,899,mage,frost,25,11,14
Mageboy,bonechewer,894,mage,frost,29,10,19
Guji,area-52,890,mage,frost,23,11,12
Itoncruxy,tichondrius,886,mage,frost,63,29,34
Scár,blackrock,873,mage,frost,14,10,4
Whosdismage,illidan,864,mage,frost,12,9,3
Rositajonez,terenas,864,mage,frost,12,9,3
Nalabb,illidan,864,mage,frost,12,9,3
Furisheep,stormrage,864,mage,frost,12,9,3
Kaylemage,tichondrius,864,mage,frost,12,9,3
Bamx,stormrage,864,mage,frost,18,9,9
Hyoonsfeet,stormrage,864,mage,frost,18,9,9
Cunzhang,tichondrius,864,mage,frost,18,9,9
Fromcanada,eitrigg,864,mage,frost,18,9,9
Weathersmell,tichondrius,864,mage,frost,18,9,9
Evilnuts,quelthalas,864,mage,frost,19,9,10
Skoals,thrall,864,mage,frost,29,10,19
Seeu,tichondrius,864,mage,frost,30,9,21
Nicemangoes,proudmoore,863,mage,frost,12,9,3
Blinkbotx,proudmoore,863,mage,frost,18,9,9
Lastiari,wyrmrest-accord,863,mage,frost,18,9,9
Blinkharder,stormrage,863,mage,frost,24,9,15
Pyroshima,barthilas,863,mage,frost,28,10,18
Jaked,frostmourne,863,mage,frost,30,9,21
Kitenic,proudmoore,862,mage,frost,12,9,3
Skillcap,nagrand,862,mage,frost,18,9,9
Cryyo,queldorei,862,mage,frost,18,9,9
Raisonmage,tichondrius,862,mage,frost,18,9,9
Åøe,tichondrius,862,mage,frost,18,9,9
Boredomkïlls,burning-legion,862,mage,frost,18,9,9
Jodebabss,dalaran,862,mage,frost,18,9,9
Tunax,tichondrius,862,mage,frost,24,9,15
Shenme,moon-guard,861,mage,frost,20,9,11
Fruza,emerald-dream,860,mage,frost,16,10,6
Rasmin,greymane,860,mage,frost,24,11,13
Remana,anvilmar,859,mage,frost,18,9,9
Plunks,bleeding-hollow,859,mage,frost,39,10,29
Vallet,ragnaros,858,mage,frost,12,9,3
Cùrtiñ,tichondrius,858,mage,frost,30,9,21
Mageolisious,kelthuzad,857,mage,frost,24,9,15
Cransmage,illidan,856,mage,frost,18,9,9
Kaboozles,area-52,853,mage,frost,24,9,15
Soya,sargeras,852,mage,frost,24,9,15
Naoz,ragnaros,851,mage,frost,18,9,9
Worknlurk,malganis,841,mage,frost,18,9,9
Jarethleon,ragnaros,837,mage,frost,21,11,10
Âürõrâ,firetree,834,mage,frost,24,9,15
Hiiamtay,azralon,826,mage,frost,14,10,4
Erykk,mugthol,810,mage,frost,33,10,23
Zionist,earthen-ring,796,mage,frost,14,9,5
Kfortyone,kiljaeden,768,mage,frost,12,8,4
Frightmare,sargeras,768,mage,frost,12,8,4
Tonystonerz,lightnings-blade,768,mage,frost,12,8,4
Nefm,frostmourne,768,mage,frost,12,8,4
Pandazed,stormscale,768,mage,frost,12,8,4
Dearyuanmage,tichondrius,768,mage,frost,12,8,4
Wiztopher,frostmourne,768,mage,frost,12,8,4
Pigdancel,tichondrius,768,mage,frost,18,8,10
Magibe,thrall,768,mage,frost,18,8,10
Yeetcannøn,illidan,768,mage,frost,18,8,10
Lycheeoolong,frostmourne,768,mage,frost,18,8,10
Nôtôrious,thrall,767,mage,frost,12,8,4
Mempool,darkspear,767,mage,frost,12,8,4
Bigdjohnson,dalaran,767,mage,frost,12,8,4
Vamplol,tichondrius,767,mage,frost,18,8,10
Wickymorph,barthilas,767,mage,frost,18,8,10
Qtqq,malganis,767,mage,frost,18,8,10
Badboykilla,dentarg,767,mage,frost,21,9,12
Gardes,tichondrius,767,mage,frost,24,8,16
Travarra,terenas,766,mage,frost,18,8,10
Freez,garona,766,mage,frost,22,9,13
Nynalith,area-52,764,mage,frost,18,8,10
Snowjôb,illidan,764,mage,frost,24,8,16
Marvelcuck,sargeras,763,mage,frost,12,8,4
Crizzpy,tichondrius,762,mage,frost,18,8,10
Keahiláni,area-52,759,mage,frost,15,9,6
Vantus,tichondrius,757,mage,frost,14,8,6
Pizzle,perenolde,755,mage,frost,18,8,10
Ratrider,dreadmaul,752,mage,frost,12,8,4
Fizario,barthilas,751,mage,frost,23,9,14
Artruis,detheroc,748,mage,frost,12,8,4
Bandmaid,emerald-dream,736,mage,frost,16,9,7
Omegablink,sargeras,734,mage,frost,17,8,9
Letitgoo,azralon,733,mage,frost,34,17,17
Heca,tichondrius,719,mage,frost,11,8,3
Stankfreezer,thrall,719,mage,frost,11,8,3
Alùcârd,tichondrius,719,mage,frost,17,8,9
Asparagoose,stormrage,718,mage,frost,17,8,9
Ìgnìtìöñ,whisperwind,718,mage,frost,21,8,13
Creatïne,stormrage,703,mage,frost,16,8,8
Jayfunk,sargeras,702,mage,frost,11,8,3
Mushys,stormrage,672,mage,frost,12,7,5
Emvepee,sargeras,672,mage,frost,12,7,5
Kygores,tichondrius,672,mage,frost,12,7,5
Kujousara,stormrage,672,mage,frost,12,7,5
Myfamilygpie,nazgrel,672,mage,frost,12,7,5
Proximalol,tichondrius,672,mage,frost,12,7,5
Neovim,stormrage,672,mage,frost,12,7,5
Archewing,azjolnerub,672,mage,frost,12,7,5
Sylendron,area-52,672,mage,frost,12,7,5
Hrichit,tichondrius,672,mage,frost,12,7,5
Ntys,frostmourne,672,mage,frost,12,7,5
Ankidar,quelthalas,672,mage,frost,12,7,5
Tibbit,kelthuzad,672,mage,frost,12,7,5
Crnomage,area-52,672,mage,frost,12,7,5
Elfvis,deathwing,672,mage,frost,12,7,5
Toteypotter,frostmourne,672,mage,frost,12,7,5
Chunzhangfs,tichondrius,672,mage,frost,18,7,11
Betrian,quelthalas,672,mage,frost,18,7,11
Coldshouldér,nerzhul,672,mage,frost,18,7,11
Licklix,tichondrius,672,mage,frost,18,7,11
Stealing,barthilas,672,mage,frost,18,7,11
Baleiabranca,stormrage,672,mage,frost,18,7,11
Aosin,wyrmrest-accord,672,mage,frost,18,7,11
Privilege,burning-legion,672,mage,frost,18,7,11
Snoogma,illidan,671,mage,frost,12,7,5
Dairian,whisperwind,671,mage,frost,12,7,5
Khaziiong,scilla,671,mage,frost,12,7,5
Burist,illidan,671,mage,frost,12,7,5
Blinksz,korgath,671,mage,frost,12,7,5
Nihilitý,malganis,671,mage,frost,12,7,5
Zaxrie,malganis,671,mage,frost,12,7,5
Solusek,garona,671,mage,frost,12,7,5
Tokiaro,tortheldrin,671,mage,frost,12,7,5
Därkmägician,tichondrius,671,mage,frost,18,7,11
Kasparhausar,garithos,671,mage,frost,18,7,11
Oharvestero,illidan,671,mage,frost,18,7,11
Annalee,ragnaros,671,mage,frost,18,7,11
Baemers,tichondrius,671,mage,frost,18,7,11
Numaïr,kiljaeden,671,mage,frost,18,7,11
Aulie,burning-blade,670,mage,frost,12,7,5
Kidfurry,wyrmrest-accord,670,mage,frost,12,7,5
Megladon,tichondrius,670,mage,frost,12,7,5
Tchass,skullcrusher,670,mage,frost,12,7,5
Ranje,kiljaeden,670,mage,frost,12,7,5
Starguy,laughing-skull,670,mage,frost,18,7,11
Putosucio,nordrassil,670,mage,frost,18,7,11
Cäelüm,area-52,670,mage,frost,24,7,17
Banída,stormrage,669,mage,frost,12,7,5
Criticalness,illidan,669,mage,frost,12,7,5
Zalatirix,bleeding-hollow,669,mage,frost,12,7,5
Icelordd,ragnaros,669,mage,frost,13,7,6
Memnor,amanthul,668,mage,frost,12,7,5
Bubbleblower,hakkar,667,mage,frost,18,7,11
Tatersmaccs,sargeras,667,mage,frost,18,7,11
Evieril,tichondrius,665,mage,frost,12,7,5
Dánó,lightbringer,663,mage,frost,24,7,17
Tigoditties,emerald-dream,662,mage,frost,12,7,5
Vendizzle,malganis,654,mage,frost,23,7,16
Taylorrain,arthas,650,mage,frost,18,7,11
Slaash,barthilas,639,mage,frost,14,8,6
Shaynna,tichondrius,624,mage,frost,15,7,8
Leeandroo,quelthalas,623,mage,frost,17,7,10
Boldwarp,dalaran,622,mage,frost,11,7,4
Ghostblaze,blackhand,621,mage,frost,15,8,7
Ghrámz,stormrage,607,mage,frost,16,7,9
Gralnur,kelthuzad,606,mage,frost,14,7,7
Parruka,warsong,605,mage,frost,26,7,19
Redhell,dalaran,576,mage,frost,6,6,0
Zstyle,frostmourne,576,mage,frost,12,6,6
Alludèd,illidan,576,mage,frost,12,6,6
Eriktherod,maelstrom,576,mage,frost,12,6,6
Hambürglar,garrosh,576,mage,frost,12,6,6
Supergun,tichondrius,576,mage,frost,12,6,6
Pollylol,proudmoore,576,mage,frost,12,6,6
Saymenre,tichondrius,576,mage,frost,12,6,6
Froshar,ragnaros,576,mage,frost,12,6,6
Johncxvii,sargeras,576,mage,frost,12,6,6
Hýdramist,sargeras,576,mage,frost,12,6,6
Soukidiot,sargeras,576,mage,frost,18,6,12
Fromcanada,tichondrius,576,mage,frost,18,6,12
Bustercraft,kelthuzad,576,mage,frost,18,6,12
Maxtorgar,quelthalas,576,mage,frost,18,6,12
Covil,tichondrius,576,mage,frost,24,6,18
Bloodpumper,thrall,575,mage,frost,12,6,6
Baultery,moon-guard,575,mage,frost,12,6,6
Bootygoats,emerald-dream,575,mage,frost,12,6,6
Oogabooga,lethon,575,mage,frost,12,6,6
Hasty,emerald-dream,575,mage,frost,18,6,12
Aarne,thrall,575,mage,frost,18,6,12
Lucidgaze,bonechewer,575,mage,frost,18,6,12
Fabled,stonemaul,575,mage,frost,18,6,12
Kalzak,hyjal,574,mage,frost,12,6,6
Gelile,tichondrius,574,mage,frost,12,6,6
Kaël,area-52,574,mage,frost,12,6,6
Åquå,area-52,574,mage,frost,12,6,6
Tonepedo,zuljin,574,mage,frost,18,6,12
Lincepotter,quelthalas,574,mage,frost,18,6,12
Zehlks,garrosh,573,mage,frost,12,6,6
Deadmarley,blackhand,572,mage,frost,12,6,6
Ärià,sargeras,571,mage,frost,12,6,6
Sodrezinn,illidan,571,mage,frost,12,6,6
Meliam,tichondrius,557,mage,frost,29,6,23
Arckayne,zuljin,543,mage,frost,11,6,5
Peetufo,whisperwind,542,mage,frost,17,6,11
Ozwauld,emerald-dream,526,mage,frost,11,6,5
Pidge,aggramar,519,mage,frost,22,6,16
Emieralol,tichondrius,512,mage,frost,10,6,4
Aycc,tichondrius,512,mage,frost,10,6,4
Ereblink,proudmoore,511,mage,frost,11,6,5
Zabaione,stormrage,508,mage,frost,16,6,10
Luckysi,illidan,496,mage,frost,13,6,7
Fromcanadaqc,zuljin,480,mage,frost,6,5,1
Arcaneshally,area-52,480,mage,frost,6,5,1
Flavaflame,mugthol,480,mage,frost,6,5,1
Hüz,frostmourne,480,mage,frost,6,5,1
Hansol,farstriders,480,mage,frost,6,5,1
Frosttwoop,moon-guard,480,mage,frost,6,5,1
Elwynnforest,sargeras,480,mage,frost,6,5,1
Jarvase,mugthol,480,mage,frost,10,6,4
Juniel,bleeding-hollow,480,mage,frost,10,6,4
Starguy,terenas,480,mage,frost,12,5,7
Isömetrics,tichondrius,480,mage,frost,12,5,7
Kayenri,area-52,480,mage,frost,12,5,7
Messiaah,tichondrius,480,mage,frost,12,5,7
Hustle,frostmourne,480,mage,frost,12,5,7
Tëy,zuljin,480,mage,frost,12,5,7
Mcshwackin,area-52,480,mage,frost,12,5,7
Adronicus,tichondrius,480,mage,frost,12,5,7
Gadwick,alexstrasza,480,mage,frost,12,5,7
Syndra,korialstrasz,480,mage,frost,12,5,7
Xàr,ragnaros,480,mage,frost,12,5,7
Garbagemage,barthilas,480,mage,frost,12,5,7
Siobhána,moon-guard,480,mage,frost,12,5,7
Cinns,moon-guard,480,mage,frost,12,5,7
Frostytoez,firetree,480,mage,frost,12,5,7
Zime,moon-guard,480,mage,frost,12,5,7
Arendelle,kiljaeden,480,mage,frost,12,5,7
Vires,kelthuzad,480,mage,frost,12,5,7
Saydar,stormrage,480,mage,frost,18,5,13
Dreddpool,barthilas,480,mage,frost,18,5,13
Twiztidwitch,burning-legion,480,mage,frost,18,5,13
Mikwam,proudmoore,479,mage,frost,6,5,1
Piixxiie,sargeras,479,mage,frost,6,5,1
Grimreefer,trollbane,479,mage,frost,12,5,7
Brokser,quelthalas,479,mage,frost,12,5,7
Odinzz,azralon,479,mage,frost,12,5,7
Dimmershnitz,draka,479,mage,frost,12,5,7
Phazora,suramar,479,mage,frost,12,5,7
Cuoreforte,moon-guard,479,mage,frost,12,5,7
Daddyplease,bleeding-hollow,479,mage,frost,12,5,7
Édika,area-52,479,mage,frost,12,5,7
Loa,hydraxis,479,mage,frost,12,5,7
Cezax,frostmourne,479,mage,frost,12,5,7
Limeade,ursin,479,mage,frost,12,5,7
Crimpster,illidan,479,mage,frost,18,5,13
Frenk,moon-guard,479,mage,frost,18,5,13
Srloko,azralon,479,mage,frost,18,5,13
Comaner,frostmourne,447,mage,frost,11,5,6
Summey,tichondrius,431,mage,frost,11,5,6
Cerisium,kiljaeden,431,mage,frost,11,5,6
Lillbean,thunderlord,425,mage,frost,13,6,7
Quinnfreeze,boulderfist,414,mage,frost,11,5,6
Harrypothead,senjin,399,mage,frost,5,5,0
Kutulu,aerie-peak,384,mage,frost,6,4,2
Cewchí,tichondrius,384,mage,frost,6,4,2
Arillius,malganis,384,mage,frost,6,4,2
Ratfather,the-forgotten-coast,384,mage,frost,6,4,2
Zgodspeedz,stormrage,384,mage,frost,6,4,2
Frðstítutè,tichondrius,384,mage,frost,6,4,2
Çhíllßrõ,tichondrius,384,mage,frost,6,4,2
Dashdoor,stormrage,384,mage,frost,6,4,2
Frostkage,tichondrius,384,mage,frost,6,4,2
Lohkey,darkspear,384,mage,frost,6,4,2
Kälis,zuljin,384,mage,frost,6,4,2
Pzaz,moon-guard,384,mage,frost,6,4,2
Vixm,stormrage,384,mage,frost,6,4,2
Wienerjeff,area-52,384,mage,frost,6,4,2
Deadsayru,drakkari,384,mage,frost,6,4,2
Fromcanadaqc,tichondrius,384,mage,frost,6,4,2
Aigam,hyjal,384,mage,frost,6,4,2
Faire,stonemaul,384,mage,frost,6,4,2
Voiddude,proudmoore,384,mage,frost,6,4,2
Myrondor,tichondrius,384,mage,frost,6,4,2
Stinkyblinky,bleeding-hollow,384,mage,frost,6,4,2
Gai,lightnings-blade,384,mage,frost,6,4,2
Scorgasm,thrall,384,mage,frost,6,4,2
Neverbroke,illidan,384,mage,frost,6,4,2
Unlike,sargeras,384,mage,frost,6,4,2
Poonfarmer,zangarmarsh,384,mage,frost,6,4,2
Frobo,mannoroth,384,mage,frost,6,4,2
Reptär,demon-soul,384,mage,frost,6,4,2
Finnese,medivh,384,mage,frost,6,4,2
Tofusmell,illidan,384,mage,frost,6,4,2
Bçøløñápûðgé,illidan,384,mage,frost,6,4,2
Hocusjokus,frostmourne,384,mage,frost,6,4,2
Snipymagus,shattered-hand,384,mage,frost,9,5,4
Iladiin,malganis,384,mage,frost,9,4,5
Yippmagus,area-52,384,mage,frost,12,4,8
Yeuxbleus,tichondrius,384,mage,frost,12,4,8
Klinkr,illidan,384,mage,frost,12,4,8
Darthez,darkspear,384,mage,frost,12,4,8
Dallamar,frostwolf,384,mage,frost,12,4,8
Novokaine,area-52,384,mage,frost,12,4,8
Nexttmage,area-52,384,mage,frost,12,4,8
Splocke,azralon,384,mage,frost,12,4,8
Fantabulous,korgath,384,mage,frost,12,4,8
Numb,trollbane,384,mage,frost,12,4,8
Meduka,proudmoore,384,mage,frost,12,4,8
Horizons,moon-guard,384,mage,frost,12,4,8
Badaszbich,tichondrius,384,mage,frost,12,4,8
Themageguy,eitrigg,384,mage,frost,12,4,8
Bluedustfart,illidan,384,mage,frost,12,4,8
Dead,nemesis,384,mage,frost,12,4,8
Coldcaster,mugthol,384,mage,frost,12,4,8
Nickygift,tichondrius,384,mage,frost,12,4,8
Perkaset,turalyon,384,mage,frost,12,4,8
Ineedashave,shandris,384,mage,frost,12,4,8
Ultrá,stormscale,384,mage,frost,12,4,8
Gemaicy,sargeras,384,mage,frost,12,4,8
Snanth,black-dragonflight,384,mage,frost,18,4,14
Rolypolyman,tichondrius,384,mage,frost,18,4,14
Briélla,area-52,383,mage,frost,6,4,2
Ehduh,onyxia,383,mage,frost,6,4,2
Cynafox,moon-guard,383,mage,frost,12,4,8
Dieselonfire,the-venture-co,382,mage,frost,6,4,2
Freyia,mugthol,382,mage,frost,12,4,8
Kuni,ghostlands,382,mage,frost,12,4,8
Brezman,tichondrius,382,mage,frost,12,4,8
Cowwboydan,malganis,351,mage,frost,8,5,3
Lirahmi,quelthalas,351,mage,frost,11,4,7
Freezeup,area-52,349,mage,frost,14,7,7
Triambukh,grizzly-hills,348,mage,frost,11,4,7
Titsncoke,proudmoore,336,mage,frost,9,4,5
Devkek,area-52,330,mage,frost,22,7,15
Icëblöck,ysera,329,mage,frost,6,5,1
Lezafort,area-52,320,mage,frost,10,4,6
Crøwgawd,tichondrius,304,mage,frost,7,4,3
Scarablast,bleeding-hollow,304,mage,frost,7,4,3
Linsz,nemesis,288,mage,frost,6,3,3
Kaïdis,nemesis,288,mage,frost,6,3,3
Coneofkony,bleeding-hollow,288,mage,frost,6,3,3
Illúmi,moon-guard,288,mage,frost,6,3,3
Percivaltp,scarlet-crusade,288,mage,frost,6,3,3
Betaduck,bleeding-hollow,288,mage,frost,6,3,3
Isuikido,nemesis,288,mage,frost,6,3,3
Lilpolyx,illidan,288,mage,frost,6,3,3
Blinkinghobo,sargeras,288,mage,frost,6,3,3
Youngwiz,arthas,288,mage,frost,6,3,3
Pyroseraph,bleeding-hollow,288,mage,frost,6,3,3
Natallyn,stormrage,288,mage,frost,6,3,3
Üman,bleeding-hollow,288,mage,frost,6,3,3
Missingxx,silvermoon,288,mage,frost,6,3,3
Personah,darkspear,288,mage,frost,6,3,3
Kryptekk,area-52,288,mage,frost,6,3,3
Staytrill,stormreaver,288,mage,frost,6,3,3
Lilsake,sargeras,288,mage,frost,6,3,3
Abruaa,area-52,288,mage,frost,6,3,3
Címegripe,stormrage,288,mage,frost,6,3,3
Léras,stormrage,288,mage,frost,6,3,3
Nksbluedeath,area-52,288,mage,frost,6,3,3
Mäz,malorne,288,mage,frost,6,3,3
Frostytits,spirestone,288,mage,frost,6,3,3
Highafrn,area-52,288,mage,frost,6,3,3
Killemz,dragonmaw,288,mage,frost,6,3,3
Hékate,moon-guard,288,mage,frost,6,3,3
Atwyxn,illidan,288,mage,frost,6,3,3
Eraticmage,illidan,288,mage,frost,6,3,3
Icetooseeyou,barthilas,288,mage,frost,6,3,3
Dragonie,nordrassil,288,mage,frost,6,3,3
Ðontßlink,illidan,288,mage,frost,6,3,3
Murcury,tichondrius,288,mage,frost,6,3,3
Kqlyy,tichondrius,288,mage,frost,6,3,3
Aurumium,illidan,288,mage,frost,6,3,3
Chriglol,black-dragonflight,288,mage,frost,6,3,3
Nalla,nerzhul,288,mage,frost,6,3,3
Toastmg,tichondrius,288,mage,frost,6,3,3
Puvö,tichondrius,288,mage,frost,6,3,3
Bigmêan,boulderfist,288,mage,frost,6,3,3
Coldrin,tichondrius,288,mage,frost,6,3,3
Låvazza,tichondrius,288,mage,frost,6,3,3
Alatria,frostmourne,288,mage,frost,6,3,3
Botoslàp,dragonmaw,288,mage,frost,6,3,3
Bønemage,azralon,288,mage,frost,6,3,3
Murderlin,tichondrius,288,mage,frost,6,3,3
Ariezx,kelthuzad,288,mage,frost,6,3,3
Quinnc,tichondrius,288,mage,frost,6,3,3
Maelista,tichondrius,288,mage,frost,6,3,3
Trozkov,dalaran,288,mage,frost,6,3,3
Ingrumatig,tichondrius,288,mage,frost,6,3,3
Noescaping,illidan,288,mage,frost,6,3,3
Zukoprince,azralon,288,mage,frost,6,3,3
Thxo,hyjal,288,mage,frost,6,3,3
Packaged,emerald-dream,288,mage,frost,6,3,3
Magusia,emerald-dream,288,mage,frost,6,3,3
Urbadxd,llane,288,mage,frost,6,3,3
Kandyperreo,ragnaros,288,mage,frost,6,3,3
Bigchilly,malganis,288,mage,frost,6,3,3
Gobstpper,nagrand,288,mage,frost,6,3,3
Jorzan,kelthuzad,288,mage,frost,6,3,3
Índís,ragnaros,288,mage,frost,6,3,3
Oomoo,malganis,288,mage,frost,6,3,3
Mashii,kiljaeden,288,mage,frost,6,3,3
Cruxx,ragnaros,288,mage,frost,6,3,3
Bound,emerald-dream,288,mage,frost,6,3,3
Etyx,tichondrius,288,mage,frost,10,4,6
Vague,tichondrius,288,mage,frost,9,3,6
Linadeslayer,chogall,288,mage,frost,12,3,9
Daydreamz,lightnings-blade,288,mage,frost,12,3,9
Bravden,area-52,288,mage,frost,12,3,9
Houdiinii,illidan,288,mage,frost,12,3,9
Voidera,wyrmrest-accord,288,mage,frost,12,3,9
Merkkinz,thrall,288,mage,frost,12,3,9
Anuub,kelthuzad,288,mage,frost,12,3,9
Calcaster,aegwynn,288,mage,frost,12,3,9
Fracxure,area-52,288,mage,frost,12,3,9
Frostcakes,quelthalas,288,mage,frost,12,3,9
Argyron,fizzcrank,288,mage,frost,12,3,9
Rabeiro,tichondrius,288,mage,frost,12,3,9
Ezchallenger,undermine,288,mage,frost,12,3,9
Worldonfire,ragnaros,288,mage,frost,12,3,9
Steefers,arygos,288,mage,frost,12,3,9
Grynthwzrd,stormrage,288,mage,frost,12,3,9
Draell,drakkari,288,mage,frost,12,3,9
Radakos,emerald-dream,288,mage,frost,12,3,9
Rastafarix,ragnaros,288,mage,frost,12,3,9
Hqscoltt,azralon,288,mage,frost,12,3,9
Fingeredx,zuljin,288,mage,frost,12,3,9
Magicginger,barthilas,288,mage,frost,12,3,9
Albbano,tichondrius,288,mage,frost,12,3,9
Makén,illidan,287,mage,frost,6,3,3
Gufi,drakkari,287,mage,frost,6,3,3
Icehero,tichondrius,287,mage,frost,6,3,3
Cawyro,caelestrasz,287,mage,frost,12,3,9
Lünâliä,bleeding-hollow,286,mage,frost,6,3,3
Iceehott,kargath,265,mage,frost,13,7,6
Chuekona,ragnaros,256,mage,frost,10,3,7
Unydae,frostmourne,239,mage,frost,5,3,2
Drewann,draenor,239,mage,frost,5,3,2
Cheyz,onyxia,239,mage,frost,5,3,2
Itsoveryo,jubeithos,239,mage,frost,11,3,8
Gtown,kelthuzad,234,mage,frost,11,4,7
Thaldarian,emerald-dream,234,mage,frost,13,4,9
Hotpeachpie,zuljin,234,mage,frost,14,4,10
Skerei,azralon,234,mage,frost,19,4,15
Veritas,wildhammer,192,mage,frost,4,3,1
Abracadaver,greymane,192,mage,frost,4,3,1
Rayricefan,blood-furnace,192,mage,frost,4,3,1
Strêss,kelthuzad,192,mage,frost,6,2,4
Fullmetal,jaedenar,192,mage,frost,6,2,4
Cottonmage,malganis,192,mage,frost,6,2,4
Pyröz,kelthuzad,192,mage,frost,6,2,4
Rapidmage,malganis,192,mage,frost,6,2,4
Afknz,frostmourne,192,mage,frost,6,2,4
Kammany,thrall,192,mage,frost,6,2,4
Westii,illidan,192,mage,frost,6,2,4
Vallfire,malganis,192,mage,frost,6,2,4
Ess,tichondrius,192,mage,frost,6,2,4
Elhechizero,quelthalas,192,mage,frost,6,2,4
Jayma,moon-guard,192,mage,frost,6,2,4
Icetomeetyu,bleeding-hollow,192,mage,frost,6,2,4
Fleët,tichondrius,192,mage,frost,6,2,4
Harlloo,the-underbog,192,mage,frost,6,2,4
Muskybiggie,bleeding-hollow,192,mage,frost,6,2,4
Drdocx,frostmourne,192,mage,frost,6,2,4
Raynark,nemesis,192,mage,frost,6,2,4
Vasthrash,bleeding-hollow,192,mage,frost,6,2,4
Elvin,frostmourne,192,mage,frost,6,2,4
Abstractgoat,tichondrius,192,mage,frost,6,2,4
Bluishhue,thrall,192,mage,frost,6,2,4
Mager,dentarg,192,mage,frost,6,2,4
Fatalexo,tichondrius,192,mage,frost,6,2,4
Whiteyx,saurfang,192,mage,frost,6,2,4
Choctøp,frostmourne,192,mage,frost,6,2,4
Getmaged,bleeding-hollow,192,mage,frost,6,2,4
Fïtz,quelthalas,192,mage,frost,6,2,4
Stìnkfîst,tichondrius,192,mage,frost,6,2,4
Kickpollyplx,lothar,192,mage,frost,6,2,4
Smók,ragnaros,192,mage,frost,6,2,4
Cantblocklul,baelgun,192,mage,frost,6,2,4
Karameltart,barthilas,192,mage,frost,6,2,4
Valire,kelthuzad,192,mage,frost,6,2,4
Crazytime,tichondrius,192,mage,frost,6,2,4
Avicci,shattered-halls,192,mage,frost,6,2,4
Fineous,kalecgos,192,mage,frost,6,2,4
Sophrates,burning-blade,192,mage,frost,6,2,4
Aangx,stormrage,192,mage,frost,6,2,4
Korky,dalvengyr,192,mage,frost,6,2,4
Anyahs,tichondrius,192,mage,frost,6,2,4
Quesomancer,illidan,192,mage,frost,6,2,4
Viccluvin,stormrage,192,mage,frost,6,2,4
Dinklord,azuremyst,192,mage,frost,6,2,4
Mystics,dawnbringer,192,mage,frost,6,2,4
Agoniey,illidan,192,mage,frost,6,2,4
Ayci,velen,192,mage,frost,6,2,4
Xü,stormrage,192,mage,frost,6,2,4
Mageethot,moon-guard,192,mage,frost,6,2,4
Xar,guldan,192,mage,frost,6,2,4
Makius,area-52,192,mage,frost,6,2,4
Winstonchill,zuljin,192,mage,frost,6,2,4
Cradic,tichondrius,192,mage,frost,6,2,4
Moogician,aerie-peak,192,mage,frost,6,2,4
Tanedos,tichondrius,192,mage,frost,6,2,4
Vortex,fenris,192,mage,frost,6,2,4
Wyss,azralon,192,mage,frost,6,2,4
Roarly,stonemaul,192,mage,frost,6,2,4
Cayoux,darkspear,192,mage,frost,6,2,4
Nachtt,sargeras,192,mage,frost,6,2,4
Audacy,sargeras,192,mage,frost,6,2,4
Skdonkay,nerzhul,192,mage,frost,6,2,4
Undeadmager,nerzhul,192,mage,frost,6,2,4
Airsickjet,kiljaeden,192,mage,frost,6,2,4
Arkuran,proudmoore,192,mage,frost,6,2,4
Gradmage,proudmoore,192,mage,frost,6,2,4
Jainamommy,emerald-dream,192,mage,frost,6,2,4
Earff,kiljaeden,192,mage,frost,6,2,4
Iguanodon,proudmoore,192,mage,frost,6,2,4
Drewzz,tichondrius,192,mage,frost,6,2,4
Sparqablink,tichondrius,192,mage,frost,6,2,4
Clickhard,suramar,192,mage,frost,9,2,7
Mageyoulooks,shattered-hand,192,mage,frost,12,2,10
Mendittorosa,tichondrius,192,mage,frost,12,2,10
Tracemaker,emerald-dream,192,mage,frost,12,2,10
Hositonet,malganis,192,mage,frost,12,2,10
Rán,spirestone,192,mage,frost,12,2,10
Converseqt,stormrage,192,mage,frost,12,2,10
Joare,area-52,192,mage,frost,12,2,10
Zerg,fenris,192,mage,frost,12,2,10
Sîmply,zuljin,192,mage,frost,12,2,10
Èvilmage,blackrock,192,mage,frost,12,2,10
Dylanpickles,darkspear,192,mage,frost,12,2,10
Wqnmlgbdy,tichondrius,192,mage,frost,18,2,16
Kahldyn,stormrage,191,mage,frost,4,3,1
Silverstrza,gnomeregan,191,mage,frost,6,2,4
Rathrizar,emerald-dream,191,mage,frost,6,2,4
Hense,stormrage,191,mage,frost,6,2,4
Brynach,trollbane,191,mage,frost,6,2,4
Cheapped,emerald-dream,175,mage,frost,6,3,3
Blakus,tichondrius,159,mage,frost,6,3,3
Frosteddiks,shattered-halls,159,mage,frost,5,2,3
Erudit,tichondrius,144,mage,frost,15,2,13
Shardgodx,kelthuzad,138,mage,frost,8,4,4
Firèballin,tichondrius,128,mage,frost,4,2,2
Máximus,illidan,128,mage,frost,4,2,2
Idamnedu,crushridge,128,mage,frost,4,2,2
Goingmassive,frostmourne,127,mage,frost,4,2,2
Proviet,frostmourne,127,mage,frost,8,2,6
Mongera,bonechewer,126,mage,frost,8,2,6
Sillycole,emerald-dream,96,mage,frost,3,2,1
Thôrsena,ursin,96,mage,frost,3,2,1
Nohealani,dragonmaw,96,mage,frost,3,2,1
Coolhandz,tichondrius,96,mage,frost,6,1,5
Ñõxx,sargeras,96,mage,frost,6,1,5
Ricter,hyjal,96,mage,frost,6,1,5
Freezze,malganis,96,mage,frost,6,1,5
Wuzzo,tichondrius,96,mage,frost,6,1,5
Gnòmêrcy,kelthuzad,96,mage,frost,6,1,5
Mastacombust,illidan,96,mage,frost,6,1,5
Fookz,malganis,96,mage,frost,6,1,5
Michaelbust,tichondrius,96,mage,frost,6,1,5
Magicmom,wyrmrest-accord,96,mage,frost,6,1,5
Astería,ragnaros,96,mage,frost,6,1,5
Dathoe,laughing-skull,96,mage,frost,6,1,5
Soulbite,barthilas,96,mage,frost,6,1,5
Ârcano,ragnaros,96,mage,frost,6,1,5
Yeonmok,tichondrius,96,mage,frost,6,1,5
Sparklmotion,cenarius,96,mage,frost,6,1,5
Mïzzfreeze,haomarush,96,mage,frost,6,1,5
Professor,khadgar,96,mage,frost,6,1,5
Beerandmagic,zuljin,96,mage,frost,6,1,5
Fortemage,tichondrius,96,mage,frost,6,1,5
Neverworks,tichondrius,96,mage,frost,6,1,5
Jizzlez,tichondrius,96,mage,frost,6,1,5
Gíldrin,proudmoore,96,mage,frost,6,1,5
Themose,sargeras,96,mage,frost,6,1,5
Geekm,frostmourne,96,mage,frost,6,1,5
Thiccness,hydraxis,96,mage,frost,6,1,5
Stormfrieza,tichondrius,96,mage,frost,6,1,5
Truewinter,tichondrius,96,mage,frost,6,1,5
Pblastdatass,stormrage,96,mage,frost,6,1,5
Åpollous,frostmourne,96,mage,frost,6,1,5
Ichirou,stormrage,96,mage,frost,6,1,5
Furrblock,tichondrius,96,mage,frost,6,1,5
Alode,moon-guard,96,mage,frost,6,1,5
Adrazell,sargeras,96,mage,frost,6,1,5
Badiatorr,alterac-mountains,96,mage,frost,12,1,11
Zei,bleeding-hollow,96,mage,frost,12,1,11
Taladas,suramar,96,mage,frost,12,1,11
Pyrophobia,mannoroth,96,mage,frost,12,1,11
Pizzatest,area-52,96,mage,frost,12,1,11
Icestory,tichondrius,96,mage,frost,19,1,18
Eirwan,illidan,95,mage,frost,6,1,5
Icemaker,destromath,95,mage,frost,18,1,17
Notria,illidan,79,mage,frost,5,1,4
Buckybever,illidan,79,mage,frost,11,1,10
Frostybihh,bonechewer,64,mage,frost,4,1,3
Taevy,tichondrius,64,mage,frost,4,1,3
Barkäi,ragnaros,48,mage,frost,3,1,2
Lv,stormscale,48,mage,frost,9,1,8
Dazby,tichondrius,42,mage,frost,11,3,8
Dannycarey,tichondrius,2278,monk,mistweaver,78,55,23
Woezx,stormreaver,2264,monk,mistweaver,68,47,21
Sharkpiglet,illidan,2249,monk,mistweaver,90,57,33
Garbagemonk,scilla,2239,monk,mistweaver,185,115,70
Dãnwun,tichondrius,2236,monk,mistweaver,84,52,32
Mysticallx,sargeras,2220,monk,mistweaver,78,50,28
Zenjj,thorium-brotherhood,2211,monk,mistweaver,158,92,66
Jep,tichondrius,2190,monk,mistweaver,138,88,50
Weavied,sargeras,2186,monk,mistweaver,138,74,64
Boogstyle,malganis,2179,monk,mistweaver,100,56,44
Hernameplz,proudmoore,2153,monk,mistweaver,111,60,51
Emoeres,kelthuzad,2151,monk,mistweaver,104,55,49
Cool,crushridge,2148,monk,mistweaver,120,71,49
Linlol,tichondrius,2147,monk,mistweaver,392,225,167
Oblivæon,tichondrius,2143,monk,mistweaver,72,45,27
Sloppyroppy,tichondrius,2143,monk,mistweaver,101,59,42
Moremoretea,tichondrius,2140,monk,mistweaver,87,53,34
Cuteballs,tichondrius,2138,monk,mistweaver,81,50,31
Oldmanswirl,mugthol,2137,monk,mistweaver,84,50,34
Dowsk,tichondrius,2136,monk,mistweaver,88,52,36
Mãsterpõ,tichondrius,2136,monk,mistweaver,194,104,90
Crunchyrollx,tichondrius,2135,monk,mistweaver,66,49,17
Canghaigg,tichondrius,2134,monk,mistweaver,132,85,47
Woggitie,jubeithos,2129,monk,mistweaver,68,45,23
Igriefidiots,tichondrius,2129,monk,mistweaver,71,40,31
Griefgodx,tichondrius,2127,monk,mistweaver,88,49,39
Moonym,nagrand,2126,monk,mistweaver,68,41,27
Vaen,kelthuzad,2126,monk,mistweaver,78,47,31
Wheatsli,malganis,2126,monk,mistweaver,138,81,57
Oliveirarr,tichondrius,2123,monk,mistweaver,126,71,55
Babyfaceqt,skullcrusher,2123,monk,mistweaver,184,103,81
Purgenm,tichondrius,2122,monk,mistweaver,90,52,38
Proghouse,illidan,2118,monk,mistweaver,78,42,36
Secdog,tichondrius,2118,monk,mistweaver,84,44,40
Kicub,emerald-dream,2115,monk,mistweaver,84,44,40
Itzokinlol,malganis,2113,monk,mistweaver,114,70,44
Firewatches,emerald-dream,2113,monk,mistweaver,72,42,30
Akiramenaide,tichondrius,2112,monk,mistweaver,60,43,17
Akkiira,sargeras,2112,monk,mistweaver,72,42,30
Sintifissti,sargeras,2111,monk,mistweaver,62,41,21
Drdabz,illidan,2105,monk,mistweaver,60,35,25
Glqjkglbfgdl,zuljin,2105,monk,mistweaver,126,70,56
Waggìes,moon-guard,2101,monk,mistweaver,83,50,33
Nohandslost,blackrock,2097,monk,mistweaver,194,99,95
Heywhatsup,emerald-dream,2097,monk,mistweaver,102,50,52
Yangroumo,tichondrius,2088,monk,mistweaver,108,66,42
Wagfu,moon-guard,2067,monk,mistweaver,64,38,26
Jiwå,terenas,2066,monk,mistweaver,549,284,265
Parodies,illidan,2065,monk,mistweaver,85,41,44
Drracaryss,sargeras,2060,monk,mistweaver,203,125,78
Gabîmaru,area-52,2058,monk,mistweaver,135,80,55
Heha,tichondrius,2049,monk,mistweaver,179,97,82
Originull,darkspear,2045,monk,mistweaver,95,53,42
Timermørk,kalecgos,2042,monk,mistweaver,66,46,20
Huaren,tichondrius,2042,monk,mistweaver,131,75,56
Fizzlefarmer,moon-guard,2031,monk,mistweaver,89,54,35
Kris,llane,2030,monk,mistweaver,48,31,17
Zuhak,tichondrius,2030,monk,mistweaver,48,28,20
Breadweaver,malganis,2026,monk,mistweaver,72,38,34
Brazfu,skullcrusher,2023,monk,mistweaver,123,74,49
Zhoku,tichondrius,2020,monk,mistweaver,58,34,24
Triixxy,thrall,2018,monk,mistweaver,101,64,37
Gameníne,tichondrius,2012,monk,mistweaver,60,36,24
Punchgodx,greymane,2010,monk,mistweaver,78,46,32
Físterxd,bleeding-hollow,2008,monk,mistweaver,98,60,38
Ðrägønéyèz,malygos,2001,monk,mistweaver,164,89,75
Voidstate,stormrage,2001,monk,mistweaver,131,71,60
Àvríam,stormrage,1999,monk,mistweaver,95,45,50
Taeeun,tichondrius,1994,monk,mistweaver,57,38,19
Tyrfan,sargeras,1994,monk,mistweaver,154,84,70
Bhoredom,kiljaeden,1992,monk,mistweaver,146,80,66
Sevymonk,stormrage,1990,monk,mistweaver,102,62,40
Millé,frostmourne,1989,monk,mistweaver,54,31,23
Thet,sargeras,1989,monk,mistweaver,177,90,87
Wingchungus,sargeras,1987,monk,mistweaver,42,30,12
Raddxd,illidan,1981,monk,mistweaver,47,32,15
Bungfist,stormrage,1977,monk,mistweaver,35,25,10
Leetcoder,tichondrius,1977,monk,mistweaver,159,102,57
Speedcapped,area-52,1974,monk,mistweaver,132,65,67
Martiálfarts,malganis,1973,monk,mistweaver,42,30,12
Chadweave,moon-guard,1970,monk,mistweaver,162,91,71
Liltuna,icecrown,1968,monk,mistweaver,42,26,16
Nfm,cairne,1967,monk,mistweaver,84,47,37
Pragma,kiljaeden,1964,monk,mistweaver,66,37,29
Venfuki,tichondrius,1963,monk,mistweaver,60,35,25
Jakethegreat,moknathal,1963,monk,mistweaver,187,108,79
Zamist,sargeras,1962,monk,mistweaver,66,44,22
Suamw,tichondrius,1956,monk,mistweaver,104,52,52
Hafezassad,illidan,1954,monk,mistweaver,48,23,25
Swurvex,bleeding-hollow,1953,monk,mistweaver,72,34,38
Assez,tichondrius,1951,monk,mistweaver,68,36,32
Vongg,tichondrius,1950,monk,mistweaver,66,36,30
Zuhakmw,tichondrius,1947,monk,mistweaver,78,39,39
Poscom,tichondrius,1944,monk,mistweaver,143,98,45
Grif,nazjatar,1942,monk,mistweaver,207,108,99
Orbgodx,darkspear,1941,monk,mistweaver,48,30,18
Wetchickennz,tichondrius,1940,monk,mistweaver,130,75,55
Mcoos,tichondrius,1937,monk,mistweaver,156,94,62
Ilovekok,sargeras,1933,monk,mistweaver,84,64,20
Wrxx,kelthuzad,1932,monk,mistweaver,322,161,161
Xeus,darkspear,1931,monk,mistweaver,36,25,11
Gsdfjskpx,sargeras,1930,monk,mistweaver,180,92,88
Pandacottoco,azralon,1924,monk,mistweaver,78,44,34
Vaemonka,stormrage,1923,monk,mistweaver,119,70,49
Imdabes,velen,1923,monk,mistweaver,72,39,33
Postmark,tichondrius,1922,monk,mistweaver,60,34,26
Vethosis,illidan,1921,monk,mistweaver,43,27,16
Lmhs,tichondrius,1920,monk,mistweaver,54,32,22
Ònó,quelthalas,1919,monk,mistweaver,67,39,28
Brewsome,bloodhoof,1919,monk,mistweaver,82,43,39
Abellmonk,tichondrius,1910,monk,mistweaver,203,117,86
Paperfist,stormrage,1906,monk,mistweaver,126,87,39
Basedbuck,dalaran,1904,monk,mistweaver,36,23,13
Mavvi,tichondrius,1904,monk,mistweaver,128,71,57
Sillyguy,stormrage,1901,monk,mistweaver,107,69,38
Hydroz,dethecus,1900,monk,mistweaver,54,30,24
Wootzhu,zuljin,1900,monk,mistweaver,98,53,45
Toyotasupra,emerald-dream,1898,monk,mistweaver,72,46,26
Michæ,quelthalas,1898,monk,mistweaver,226,126,100
Kansú,ragnaros,1898,monk,mistweaver,94,49,45
Nilox,sargeras,1896,monk,mistweaver,114,63,51
Zukki,zuljin,1894,monk,mistweaver,130,73,57
Kristië,stormrage,1891,monk,mistweaver,42,30,12
Taichí,tichondrius,1891,monk,mistweaver,65,35,30
Nakedidiot,kelthuzad,1888,monk,mistweaver,54,35,19
Nezly,sargeras,1882,monk,mistweaver,60,29,31
Zeçe,tichondrius,1879,monk,mistweaver,36,23,13
Yasysy,tichondrius,1879,monk,mistweaver,36,22,14
Suhjoon,bleeding-hollow,1878,monk,mistweaver,160,80,80
Toozmania,stormrage,1876,monk,mistweaver,52,31,21
Vramonk,area-52,1875,monk,mistweaver,47,27,20
Sifu,bleeding-hollow,1873,monk,mistweaver,59,36,23
Spicyx,kiljaeden,1871,monk,mistweaver,30,24,6
Tekuto,tichondrius,1871,monk,mistweaver,67,46,21
Xdfu,stormrage,1870,monk,mistweaver,54,35,19
Dro,khadgar,1870,monk,mistweaver,42,22,20
Robocto,area-52,1869,monk,mistweaver,102,61,41
Natalié,caelestrasz,1868,monk,mistweaver,42,29,13
Shùù,tichondrius,1866,monk,mistweaver,65,37,28
Dalillama,stormreaver,1865,monk,mistweaver,48,31,17
Logtich,moon-guard,1864,monk,mistweaver,78,42,36
Nesoween,tichondrius,1863,monk,mistweaver,39,30,9
Ringofpeace,sargeras,1860,monk,mistweaver,36,27,9
Papermade,barthilas,1860,monk,mistweaver,48,26,22
Monktease,tichondrius,1860,monk,mistweaver,66,34,32
Aegea,illidan,1859,monk,mistweaver,55,30,25
Cmonktwo,turalyon,1858,monk,mistweaver,54,31,23
Sevenmonk,tichondrius,1857,monk,mistweaver,54,36,18
Tokol,tichondrius,1857,monk,mistweaver,168,90,78
Esqu,sargeras,1856,monk,mistweaver,36,22,14
Cmonk,turalyon,1856,monk,mistweaver,40,24,16
Piilsburry,sargeras,1855,monk,mistweaver,48,26,22
Shad,frostmourne,1853,monk,mistweaver,102,58,44
ßullsack,barthilas,1852,monk,mistweaver,102,56,46
Zdeg,tichondrius,1852,monk,mistweaver,51,28,23
Ileffsinll,illidan,1851,monk,mistweaver,107,60,47
Cardrik,thrall,1851,monk,mistweaver,143,74,69
Celerein,illidan,1850,monk,mistweaver,112,60,52
Zipmw,tichondrius,1848,monk,mistweaver,66,36,30
Proxy,ragnaros,1846,monk,mistweaver,46,31,15
Tonyboloney,tichondrius,1845,monk,mistweaver,42,25,17
Dampdampdamp,tichondrius,1844,monk,mistweaver,24,20,4
Fîstweave,emerald-dream,1844,monk,mistweaver,77,45,32
Caffeinated,barthilas,1844,monk,mistweaver,166,80,86
Qtmonk,emerald-dream,1843,monk,mistweaver,60,41,19
Yujiro,draktharon,1843,monk,mistweaver,36,23,13
Crabfest,zuljin,1843,monk,mistweaver,60,35,25
Discurzed,barthilas,1841,monk,mistweaver,118,67,51
Morzmyth,nemesis,1841,monk,mistweaver,64,34,30
Xinergy,illidan,1840,monk,mistweaver,98,65,33
Stonemists,ragnaros,1840,monk,mistweaver,65,40,25
Rokkon,sargeras,1840,monk,mistweaver,60,35,25
Fluval,moon-guard,1839,monk,mistweaver,59,41,18
Nabunaga,illidan,1837,monk,mistweaver,42,34,8
Hinåta,thrall,1837,monk,mistweaver,40,26,14
Okchat,emerald-dream,1837,monk,mistweaver,113,72,41
Baychiz,sargeras,1837,monk,mistweaver,42,25,17
Irraeine,malganis,1836,monk,mistweaver,48,31,17
Shiinobi,area-52,1836,monk,mistweaver,81,46,35
Zarenki,tichondrius,1835,monk,mistweaver,73,33,40
Liteup,smolderthorn,1833,monk,mistweaver,396,199,197
Guarantee,tichondrius,1832,monk,mistweaver,182,102,80
Nuriva,tichondrius,1831,monk,mistweaver,48,36,12
Worldhopperx,area-52,1831,monk,mistweaver,60,40,20
Cmonkey,turalyon,1831,monk,mistweaver,48,31,17
Sleeks,bonechewer,1831,monk,mistweaver,102,62,40
Dræmwalker,malygos,1831,monk,mistweaver,505,253,252
Threefanandy,kelthuzad,1830,monk,mistweaver,30,21,9
Carzzy,sargeras,1829,monk,mistweaver,35,23,12
Tirionx,area-52,1828,monk,mistweaver,215,125,90
Baoma,tichondrius,1827,monk,mistweaver,95,55,40
Monklike,illidan,1827,monk,mistweaver,60,30,30
Gentleuncle,tichondrius,1826,monk,mistweaver,125,72,53
Jackouse,frostmourne,1824,monk,mistweaver,50,31,19
Harkwind,azralon,1824,monk,mistweaver,151,89,62
Hugdealer,warsong,1823,monk,mistweaver,80,47,33
Gtmdyjs,illidan,1822,monk,mistweaver,29,20,9
Ekn,tichondrius,1822,monk,mistweaver,30,20,10
Toonington,sargeras,1821,monk,mistweaver,51,37,14
Søpra,zuljin,1821,monk,mistweaver,72,46,26
Tazi,chromaggus,1821,monk,mistweaver,84,50,34
Voltio,frostmane,1820,monk,mistweaver,103,68,35
Chaddington,malorne,1820,monk,mistweaver,48,30,18
Blackoutmonk,stormreaver,1819,monk,mistweaver,95,61,34
Monknutt,tichondrius,1819,monk,mistweaver,56,32,24
Ilovefrogs,stormrage,1819,monk,mistweaver,60,30,30
Malibrew,proudmoore,1817,monk,mistweaver,42,29,13
Ándi,barthilas,1817,monk,mistweaver,53,28,25
Spook,kalecgos,1816,monk,mistweaver,49,35,14
Wolf,shattered-hand,1816,monk,mistweaver,30,19,11
Yobeel,tichondrius,1816,monk,mistweaver,54,23,31
Qup,lightbringer,1815,monk,mistweaver,66,49,17
Xhilong,quelthalas,1815,monk,mistweaver,48,28,20
Lexxbtw,thrall,1815,monk,mistweaver,107,59,48
Ellesig,ragnaros,1814,monk,mistweaver,148,81,67
Canadá,bleeding-hollow,1813,monk,mistweaver,36,27,9
Dancah,eitrigg,1813,monk,mistweaver,30,19,11
Intra,exodar,1812,monk,mistweaver,144,76,68
Mistpump,tichondrius,1811,monk,mistweaver,48,26,22
Cangry,area-52,1809,monk,mistweaver,60,31,29
Phattea,thrall,1808,monk,mistweaver,48,31,17
Djkungfu,thrall,1808,monk,mistweaver,156,95,61
Yokuu,thunderlord,1808,monk,mistweaver,54,29,25
Abeldra,moon-guard,1807,monk,mistweaver,82,42,40
Itdreams,illidan,1806,monk,mistweaver,42,25,17
Timed,shuhalo,1806,monk,mistweaver,49,26,23
Astrino,zuljin,1805,monk,mistweaver,42,29,13
Briàr,area-52,1805,monk,mistweaver,48,27,21
Strongmandan,twisting-nether,1805,monk,mistweaver,42,23,19
Onlyfansx,ragnaros,1805,monk,mistweaver,256,139,117
Mð,vashj,1805,monk,mistweaver,120,64,56
Cenfu,malganis,1805,monk,mistweaver,72,29,43
Cromulent,saurfang,1804,monk,mistweaver,128,68,60
Imdabes,destromath,1804,monk,mistweaver,81,35,46
Vrieden,illidan,1804,monk,mistweaver,99,42,57
Zundor,ghostlands,1802,monk,mistweaver,32,25,7
Kungfoocious,tichondrius,1802,monk,mistweaver,57,33,24
Mixflo,bleeding-hollow,1802,monk,mistweaver,39,20,19
Mistweave,aerie-peak,1801,monk,mistweaver,54,34,20
Vanmonk,eonar,1801,monk,mistweaver,54,33,21
Zengriff,ysondre,1801,monk,mistweaver,54,31,23
Squalicorax,area-52,1801,monk,mistweaver,47,24,23
Jiucho,dalaran,1800,monk,mistweaver,35,23,12
Monjimen,ragnaros,1800,monk,mistweaver,185,107,78
Tiptea,stormrage,1799,monk,mistweaver,42,23,19
Mackiechan,kelthuzad,1797,monk,mistweaver,128,73,55
Dwánesan,tichondrius,1792,monk,mistweaver,66,39,27
Confa,ragnaros,1792,monk,mistweaver,113,49,64
Gamesuxlol,the-underbog,1790,monk,mistweaver,84,51,33
Slunka,tichondrius,1790,monk,mistweaver,42,24,18
Watersheep,darkspear,1786,monk,mistweaver,42,25,17
Rexfiend,tichondrius,1782,monk,mistweaver,24,19,5
Triarcs,area-52,1781,monk,mistweaver,36,24,12
Ttvchickchau,tichondrius,1781,monk,mistweaver,101,63,38
Quitw,tichondrius,1781,monk,mistweaver,55,28,27
Xzeer,illidan,1779,monk,mistweaver,30,25,5
Coomweaver,stormrage,1778,monk,mistweaver,42,22,20
Gummycat,bonechewer,1776,monk,mistweaver,186,100,86
Velzarria,zuljin,1775,monk,mistweaver,42,27,15
Jaja,kiljaeden,1775,monk,mistweaver,42,26,16
Lgee,kelthuzad,1774,monk,mistweaver,30,19,11
Praggers,proudmoore,1771,monk,mistweaver,101,48,53
Canghaimonk,tichondrius,1769,monk,mistweaver,60,28,32
Femalejam,darkspear,1768,monk,mistweaver,54,33,21
Epî,tichondrius,1768,monk,mistweaver,116,58,58
Trackstarx,area-52,1767,monk,mistweaver,30,25,5
Daito,jubeithos,1767,monk,mistweaver,110,62,48
Hepp,stormrage,1764,monk,mistweaver,36,25,11
Melonmuncher,duskwood,1763,monk,mistweaver,69,36,33
Iightning,dentarg,1762,monk,mistweaver,66,40,26
Wigglygiggly,mannoroth,1762,monk,mistweaver,66,38,28
Itspoils,illidan,1759,monk,mistweaver,55,41,14
Crypomunkz,malganis,1758,monk,mistweaver,35,23,12
Manggi,tichondrius,1758,monk,mistweaver,121,76,45
Mikamonk,illidan,1755,monk,mistweaver,75,45,30
Ajizzaÿ,saurfang,1755,monk,mistweaver,53,28,25
Rîce,burning-blade,1754,monk,mistweaver,42,29,13
Grabbitz,kelthuzad,1751,monk,mistweaver,42,27,15
Spinharder,stormrage,1750,monk,mistweaver,65,38,27
Ensaymada,frostmourne,1750,monk,mistweaver,138,71,67
Callmekoldi,dalaran,1748,monk,mistweaver,93,52,41
Jojostar,shadowsong,1747,monk,mistweaver,48,26,22
Tippity,stormrage,1746,monk,mistweaver,37,24,13
Bebuu,proudmoore,1744,monk,mistweaver,65,44,21
Mxf,tichondrius,1743,monk,mistweaver,36,23,13
Bubblepony,illidan,1741,monk,mistweaver,293,151,142
Vernki,laughing-skull,1738,monk,mistweaver,59,36,23
Actualcrime,tichondrius,1738,monk,mistweaver,42,22,20
Starçandy,tichondrius,1737,monk,mistweaver,108,58,50
Decompress,illidan,1734,monk,mistweaver,93,55,38
Ricearolli,area-52,1731,monk,mistweaver,36,26,10
Shlunks,illidan,1730,monk,mistweaver,217,120,97
Ïtächï,illidan,1727,monk,mistweaver,42,19,23
Cystweaver,dalaran,1726,monk,mistweaver,65,41,24
Sayflight,tichondrius,1726,monk,mistweaver,60,26,34
Fistofchanny,tichondrius,1725,monk,mistweaver,104,57,47
Supbro,hyjal,1723,monk,mistweaver,30,18,12
Steelcase,frostmourne,1722,monk,mistweaver,47,26,21
Mvqws,tichondrius,1721,monk,mistweaver,30,24,6
Ðescubra,stormrage,1721,monk,mistweaver,80,44,36
Moushindeiru,sargeras,1719,monk,mistweaver,42,35,7
Alekun,quelthalas,1719,monk,mistweaver,122,66,56
Elesm,area-52,1719,monk,mistweaver,78,28,50
Deathsteel,emerald-dream,1718,monk,mistweaver,29,19,10
Gramazen,tichondrius,1718,monk,mistweaver,42,25,17
Sqmw,tichondrius,1716,monk,mistweaver,30,18,12
Beerflow,stormrage,1714,monk,mistweaver,97,49,48
Alphamist,thrall,1711,monk,mistweaver,30,18,12
Aviee,illidan,1711,monk,mistweaver,108,40,68
Roypoker,illidan,1710,monk,mistweaver,36,25,11
Snuggubae,moon-guard,1710,monk,mistweaver,78,42,36
Yeji,altar-of-storms,1710,monk,mistweaver,85,40,45
Noremaç,frostmourne,1709,monk,mistweaver,36,21,15
Gauche,arygos,1709,monk,mistweaver,168,88,80
Betasquadxd,bleeding-hollow,1707,monk,mistweaver,43,25,18
Gnappyy,tichondrius,1705,monk,mistweaver,30,18,12
Wildfists,tichondrius,1705,monk,mistweaver,427,221,206
Røllitup,illidan,1704,monk,mistweaver,54,34,20
Bloodyxmonk,firetree,1704,monk,mistweaver,55,31,24
Turbokíll,proudmoore,1703,monk,mistweaver,36,22,14
Mexii,hellscream,1702,monk,mistweaver,203,98,105
Sparksgamer,ragnaros,1701,monk,mistweaver,36,18,18
Hansul,tichondrius,1700,monk,mistweaver,83,38,45
Qarmax,azralon,1699,monk,mistweaver,30,18,12
Qxt,tichondrius,1699,monk,mistweaver,52,31,21
Phtarded,stormreaver,1699,monk,mistweaver,86,45,41
Danarolls,spirestone,1697,monk,mistweaver,48,21,27
Krömbopulos,magtheridon,1696,monk,mistweaver,36,24,12
Zaqqari,wyrmrest-accord,1695,monk,mistweaver,48,24,24
Rizzdriver,moon-guard,1694,monk,mistweaver,60,37,23
Sniffinsteak,laughing-skull,1693,monk,mistweaver,24,18,6
Rokk,rivendare,1693,monk,mistweaver,66,35,31
Omihli,sargeras,1692,monk,mistweaver,42,25,17
Linsey,frostmourne,1691,monk,mistweaver,36,20,16
Mariabaraks,darkspear,1690,monk,mistweaver,102,56,46
Greenbrews,area-52,1690,monk,mistweaver,192,100,92
Roogymw,emerald-dream,1688,monk,mistweaver,70,39,31
Lovehate,zuljin,1688,monk,mistweaver,54,27,27
Bromonster,zuljin,1687,monk,mistweaver,36,18,18
Cohenn,tichondrius,1686,monk,mistweaver,24,18,6
Ææøææôææôææô,illidan,1686,monk,mistweaver,126,84,42
Vïolët,moon-guard,1686,monk,mistweaver,123,79,44
Botweaver,proudmoore,1686,monk,mistweaver,80,45,35
Unclety,tichondrius,1685,monk,mistweaver,42,24,18
Ropturttlê,tichondrius,1684,monk,mistweaver,36,24,12
Teewin,area-52,1683,monk,mistweaver,77,55,22
Sypìì,stormrage,1683,monk,mistweaver,42,23,19
Aráshicage,malganis,1681,monk,mistweaver,48,29,19
Janeil,wyrmrest-accord,1681,monk,mistweaver,177,99,78
Fisetèrr,kelthuzad,1680,monk,mistweaver,59,35,24
Motogp,tichondrius,1680,monk,mistweaver,128,61,67
Dwãrf,tichondrius,1678,monk,mistweaver,36,25,11
Alexìn,sargeras,1678,monk,mistweaver,63,40,23
Soprà,zuljin,1677,monk,mistweaver,33,20,13
Stepfistz,aegwynn,1677,monk,mistweaver,66,36,30
Zenox,rexxar,1675,monk,mistweaver,90,46,44
Xblingtron,malganis,1675,monk,mistweaver,59,24,35
Brewy,bloodhoof,1674,monk,mistweaver,24,19,5
Drunkentoker,illidan,1673,monk,mistweaver,48,26,22
Takugava,illidan,1671,monk,mistweaver,60,40,20
Stonymcblaze,malganis,1671,monk,mistweaver,42,25,17
Tezcatyo,malganis,1671,monk,mistweaver,54,32,22
Xcrispy,scilla,1670,monk,mistweaver,30,20,10
Chonmist,darkspear,1670,monk,mistweaver,56,36,20
Fisticufs,bleeding-hollow,1670,monk,mistweaver,42,23,19
Loudpäck,dalaran,1666,monk,mistweaver,41,26,15
Nahr,tichondrius,1666,monk,mistweaver,39,22,17
Nugskis,dalaran,1666,monk,mistweaver,263,135,128
Twoshero,tichondrius,1665,monk,mistweaver,34,22,12
Mememories,tichondrius,1665,monk,mistweaver,74,46,28
Cherep,kiljaeden,1665,monk,mistweaver,93,49,44
Winfred,bleeding-hollow,1663,monk,mistweaver,54,36,18
Smallboots,area-52,1662,monk,mistweaver,24,20,4
Mistweaverxo,malganis,1662,monk,mistweaver,116,65,51
Zuen,ragnaros,1662,monk,mistweaver,200,101,99
Gomon,terenas,1661,monk,mistweaver,29,20,9
Èmacs,barthilas,1661,monk,mistweaver,35,24,11
Seokdenam,tichondrius,1660,monk,mistweaver,84,47,37
Rectus,proudmoore,1659,monk,mistweaver,30,22,8
Dupaweaver,stormrage,1659,monk,mistweaver,59,26,33
Cheetosnmilk,malganis,1658,monk,mistweaver,35,20,15
Serikko,frostmourne,1657,monk,mistweaver,44,26,18
Cööked,illidan,1656,monk,mistweaver,63,33,30
Greenrice,thrall,1655,monk,mistweaver,52,33,19
Velenious,tichondrius,1655,monk,mistweaver,113,68,45
Calvana,tichondrius,1653,monk,mistweaver,101,40,61
Hatsu,madoran,1651,monk,mistweaver,60,29,31
Rexzilla,tichondrius,1648,monk,mistweaver,36,25,11
Suntzulml,quelthalas,1648,monk,mistweaver,48,26,22
Kawali,thrall,1647,monk,mistweaver,48,26,22
Swuseng,tichondrius,1646,monk,mistweaver,36,21,15
Grublord,stormrage,1646,monk,mistweaver,41,21,20
Beez,balnazzar,1645,monk,mistweaver,33,19,14
Miillkz,zuljin,1644,monk,mistweaver,47,25,22
Swoleypoley,tichondrius,1642,monk,mistweaver,36,21,15
Místme,tichondrius,1641,monk,mistweaver,36,22,14
Tenoseven,area-52,1640,monk,mistweaver,21,19,2
Rhorkfist,frostmourne,1640,monk,mistweaver,43,23,20
Djux,zuljin,1639,monk,mistweaver,30,20,10
Copula,illidan,1637,monk,mistweaver,74,34,40
Paralee,tichondrius,1635,monk,mistweaver,48,34,14
Gujunpyó,sargeras,1635,monk,mistweaver,66,40,26
Ropgobbler,muradin,1634,monk,mistweaver,30,18,12
Grandpå,tichondrius,1634,monk,mistweaver,40,23,17
Musachi,barthilas,1634,monk,mistweaver,66,34,32
Gellindra,malganis,1633,monk,mistweaver,24,18,6
Xhangtu,thrall,1633,monk,mistweaver,82,53,29
Misthealz,black-dragonflight,1633,monk,mistweaver,65,40,25
Ermac,kiljaeden,1632,monk,mistweaver,47,32,15
Minaffection,tichondrius,1632,monk,mistweaver,36,19,17
Akkiraa,sargeras,1631,monk,mistweaver,24,17,7
Ludan,eredar,1629,monk,mistweaver,160,85,75
Tazermw,sargeras,1628,monk,mistweaver,56,33,23
Baldbutcute,darkspear,1627,monk,mistweaver,28,19,9
Damndaniel,hyjal,1627,monk,mistweaver,86,42,44
Gooncave,stormrage,1627,monk,mistweaver,52,24,28
Avãrîce,stormrage,1626,monk,mistweaver,24,17,7
Mekawa,gurubashi,1626,monk,mistweaver,24,17,7
Monke,onyxia,1625,monk,mistweaver,42,23,19
Innerchii,tichondrius,1624,monk,mistweaver,24,17,7
Keshir,sargeras,1624,monk,mistweaver,36,22,14
Lilsloptop,moon-guard,1624,monk,mistweaver,143,86,57
Rañga,caelestrasz,1624,monk,mistweaver,66,37,29
Zhíu,ragnaros,1623,monk,mistweaver,54,33,21
Nicotinetap,tichondrius,1623,monk,mistweaver,30,18,12
Kaylux,stormrage,1623,monk,mistweaver,30,17,13
Adop,dark-iron,1622,monk,mistweaver,60,36,24
Proventos,azralon,1622,monk,mistweaver,216,119,97
Ywingtsuan,frostmourne,1622,monk,mistweaver,41,21,20
Whaes,thrall,1621,monk,mistweaver,24,17,7
Valian,tichondrius,1621,monk,mistweaver,42,22,20
Gabaan,azralon,1620,monk,mistweaver,30,17,13
Monkwalker,tichondrius,1620,monk,mistweaver,66,35,31
Barelroll,proudmoore,1619,monk,mistweaver,69,49,20
Swolington,proudmoore,1619,monk,mistweaver,41,26,15
Intertwine,frostmourne,1619,monk,mistweaver,30,17,13
Avz,azralon,1618,monk,mistweaver,30,21,9
Centalink,barthilas,1618,monk,mistweaver,50,34,16
Hunkymonky,thrall,1618,monk,mistweaver,57,35,22
Stormpounder,proudmoore,1616,monk,mistweaver,60,40,20
Locusta,tichondrius,1616,monk,mistweaver,30,19,11
Drinkkin,bleeding-hollow,1616,monk,mistweaver,114,68,46
Wpola,tichondrius,1616,monk,mistweaver,30,17,13
Greenstar,bleeding-hollow,1616,monk,mistweaver,142,74,68
Nekzí,sargeras,1615,monk,mistweaver,30,20,10
Bréwmaster,stormrage,1615,monk,mistweaver,36,17,19
Mukboo,tichondrius,1615,monk,mistweaver,36,17,19
Hitaru,azralon,1614,monk,mistweaver,54,35,19
Keiirah,zuluhed,1614,monk,mistweaver,60,24,36
Pacee,deathwing,1613,monk,mistweaver,24,17,7
Kûshi,stormrage,1613,monk,mistweaver,35,23,12
Kendro,trollbane,1613,monk,mistweaver,59,38,21
Somebodym,illidan,1613,monk,mistweaver,36,22,14
Yunmen,blades-edge,1613,monk,mistweaver,113,61,52
Qords,tichondrius,1612,monk,mistweaver,148,77,71
Pingpang,stormreaver,1610,monk,mistweaver,81,46,35
Korata,frostwolf,1610,monk,mistweaver,42,23,19
Sixsticks,tichondrius,1610,monk,mistweaver,58,30,28
Hîbîscus,illidan,1609,monk,mistweaver,32,17,15
Chessyx,ragnaros,1608,monk,mistweaver,36,17,19
Mîstchievous,sargeras,1607,monk,mistweaver,28,21,7
Jadestørmz,illidan,1607,monk,mistweaver,30,20,10
Liké,tichondrius,1607,monk,mistweaver,36,23,13
Santiaguiño,ragnaros,1607,monk,mistweaver,71,27,44
Slipperybobs,tichondrius,1605,monk,mistweaver,71,46,25
Songwei,barthilas,1605,monk,mistweaver,77,45,32
Tamingpanda,wildhammer,1605,monk,mistweaver,60,33,27
Hiiyaa,tichondrius,1605,monk,mistweaver,84,46,38
Pandaiax,area-52,1605,monk,mistweaver,59,31,28
Luvdeluxe,skullcrusher,1605,monk,mistweaver,61,30,31
Oblivion,wildhammer,1604,monk,mistweaver,61,36,25
Goochtickles,bleeding-hollow,1602,monk,mistweaver,128,79,49
Kariwanji,tichondrius,1602,monk,mistweaver,148,85,63
Gess,stormscale,1602,monk,mistweaver,108,54,54
Xuenws,tichondrius,1602,monk,mistweaver,84,36,48
Elvenmonk,frostmane,1601,monk,mistweaver,30,19,11
Buhmonk,thrall,1601,monk,mistweaver,42,21,21
Zeroxe,area-52,1600,monk,mistweaver,42,30,12
Lunarc,mannoroth,1600,monk,mistweaver,58,41,17
Manchu,stormrage,1599,monk,mistweaver,30,18,12
Wittymonk,illidan,1598,monk,mistweaver,93,53,40
Bodhisattvax,bleeding-hollow,1597,monk,mistweaver,36,21,15
Onees,tichondrius,1596,monk,mistweaver,83,42,41
Bobbybiz,bleeding-hollow,1595,monk,mistweaver,128,74,54
Lightskinmon,area-52,1595,monk,mistweaver,42,23,19
Furyjames,quelthalas,1594,monk,mistweaver,78,33,45
Senseii,dathremar,1592,monk,mistweaver,54,35,19
Merkey,tichondrius,1591,monk,mistweaver,48,26,22
Pp,icecrown,1589,monk,mistweaver,31,27,4
Coralys,sargeras,1587,monk,mistweaver,42,36,6
Neonep,stormrage,1586,monk,mistweaver,130,72,58
Diobrando,illidan,1585,monk,mistweaver,45,29,16
Bussyweaver,sargeras,1585,monk,mistweaver,117,74,43
Kwoon,hyjal,1585,monk,mistweaver,52,30,22
Avm,azralon,1584,monk,mistweaver,48,23,25
Lickthefist,sargeras,1582,monk,mistweaver,24,17,7
Zawlp,sargeras,1582,monk,mistweaver,24,17,7
Ekèl,tichondrius,1581,monk,mistweaver,48,29,19
Patfu,area-52,1581,monk,mistweaver,29,17,12
Yepcocc,lightbringer,1581,monk,mistweaver,29,17,12
Mistpowaz,stormrage,1577,monk,mistweaver,89,50,39
Pumakicks,tichondrius,1576,monk,mistweaver,70,37,33
Sebsws,proudmoore,1575,monk,mistweaver,64,39,25
Lozza,jubeithos,1574,monk,mistweaver,54,32,22
Moonhealsyou,moon-guard,1573,monk,mistweaver,73,44,29
Beboté,quelthalas,1573,monk,mistweaver,205,97,108
Cryptmist,frostmourne,1572,monk,mistweaver,30,21,9
Bootÿmagic,tichondrius,1572,monk,mistweaver,48,33,15
Sodamint,sargeras,1572,monk,mistweaver,48,23,25
Mistastep,tichondrius,1572,monk,mistweaver,84,40,44
Ckqt,stormrage,1569,monk,mistweaver,41,23,18
Boneykicks,tichondrius,1569,monk,mistweaver,42,21,21
Mwgodqtxtko,nazjatar,1564,monk,mistweaver,48,27,21
Bebess,moon-guard,1564,monk,mistweaver,51,28,23
Eatmykïtty,dalaran,1563,monk,mistweaver,36,23,13
Buffmonkdmg,tichondrius,1563,monk,mistweaver,78,41,37
Frogsarecool,stormrage,1563,monk,mistweaver,40,20,20
Badonkadonk,kiljaeden,1563,monk,mistweaver,48,18,30
Tiduskies,crushridge,1562,monk,mistweaver,54,25,29
Fistuhcuffs,sargeras,1561,monk,mistweaver,87,49,38
Aokuâng,malganis,1559,monk,mistweaver,78,51,27
Spaazz,tichondrius,1559,monk,mistweaver,83,53,30
Romdansik,tichondrius,1558,monk,mistweaver,124,69,55
Bunnygal,thaurissan,1557,monk,mistweaver,143,73,70
Planetariumz,bleeding-hollow,1556,monk,mistweaver,259,135,124
Azahri,sargeras,1555,monk,mistweaver,29,19,10
Nelly,grizzly-hills,1552,monk,mistweaver,36,17,19
Nailtech,tichondrius,1550,monk,mistweaver,66,37,29
Sabersatin,sargeras,1550,monk,mistweaver,42,21,21
Crypslegacy,tichondrius,1550,monk,mistweaver,108,53,55
Waataafaak,malganis,1547,monk,mistweaver,66,33,33
Frenchfries,dragonmaw,1547,monk,mistweaver,72,34,38
Ahnlev,ragnaros,1544,monk,mistweaver,101,54,47
Chopschtichs,kiljaeden,1543,monk,mistweaver,35,21,14
Haiyà,malganis,1542,monk,mistweaver,30,17,13
Seung,duskwood,1541,monk,mistweaver,250,121,129
Omii,darkspear,1540,monk,mistweaver,34,17,17
Marsha,tichondrius,1540,monk,mistweaver,66,29,37
Notfw,tichondrius,1540,monk,mistweaver,64,27,37
Jackphan,azralon,1539,monk,mistweaver,78,47,31
Aledal,agamaggan,1538,monk,mistweaver,60,39,21
Snoozzy,kelthuzad,1536,monk,mistweaver,36,17,19
Grizzm,sargeras,1535,monk,mistweaver,60,34,26
Forgèt,kelthuzad,1534,monk,mistweaver,30,16,14
Lonebamboo,tichondrius,1534,monk,mistweaver,50,24,26
Keileas,moon-guard,1534,monk,mistweaver,94,43,51
Kaelastra,stormrage,1532,monk,mistweaver,72,45,27
Bastilaqt,korgath,1532,monk,mistweaver,109,62,47
Hyori,saurfang,1532,monk,mistweaver,30,16,14
Dryungpwnz,zuljin,1530,monk,mistweaver,72,44,28
Flavier,illidan,1530,monk,mistweaver,36,16,20
Brucechez,tichondrius,1529,monk,mistweaver,24,16,8
Chiban,misha,1529,monk,mistweaver,30,18,12
Monkybidness,tichondrius,1529,monk,mistweaver,39,20,19
Dlysezzic,tichondrius,1529,monk,mistweaver,65,33,32
Vynchi,area-52,1527,monk,mistweaver,23,17,6
Carzo,area-52,1527,monk,mistweaver,38,23,15
Timbomist,kelthuzad,1526,monk,mistweaver,30,16,14
Turbofist,bleeding-hollow,1526,monk,mistweaver,35,17,18
Zarma,stormrage,1525,monk,mistweaver,70,42,28
Lépøissøn,tichondrius,1525,monk,mistweaver,30,16,14
Sóntix,sargeras,1523,monk,mistweaver,29,17,12
Tarkir,quelthalas,1523,monk,mistweaver,77,45,32
Metakillër,ragnaros,1522,monk,mistweaver,76,37,39
Dedracula,quelthalas,1521,monk,mistweaver,45,33,12
Swiftm,thrall,1520,monk,mistweaver,141,83,58
Snoodle,korgath,1520,monk,mistweaver,84,48,36
Kiqz,stormrage,1519,monk,mistweaver,30,16,14
Mustaf,stormrage,1517,monk,mistweaver,55,31,24
Ophibrew,zuljin,1516,monk,mistweaver,30,16,14
Versachi,stormreaver,1516,monk,mistweaver,60,30,30
Gnetic,nemesis,1516,monk,mistweaver,68,33,35
Showshoway,tichondrius,1515,monk,mistweaver,71,31,40
Zeroskil,thrall,1514,monk,mistweaver,33,19,14
Pcyesh,nemesis,1514,monk,mistweaver,58,33,25
Colbz,barthilas,1513,monk,mistweaver,24,16,8
Chelada,sargeras,1513,monk,mistweaver,48,22,26
Themonkfunk,bleeding-hollow,1511,monk,mistweaver,36,25,11
Sshri,illidan,1511,monk,mistweaver,121,58,63
Aioffe,emerald-dream,1509,monk,mistweaver,30,16,14
Vorikson,stormrage,1509,monk,mistweaver,156,75,81
Oakleet,bleeding-hollow,1507,monk,mistweaver,48,27,21
Pagtuk,daggerspine,1507,monk,mistweaver,48,23,25
Greenpigo,tichondrius,1504,monk,mistweaver,18,17,1
Ghim,frostmourne,1504,monk,mistweaver,46,18,28
Tamonger,stormrage,1502,monk,mistweaver,182,100,82
Axellrod,tichondrius,1500,monk,mistweaver,60,38,22
Kungfused,frostmourne,1500,monk,mistweaver,36,18,18
Xomonik,borean-tundra,1499,monk,mistweaver,66,39,27
Ferrarí,quelthalas,1499,monk,mistweaver,281,153,128
Lekrosa,thrall,1499,monk,mistweaver,71,38,33
Rockemsockem,gorefiend,1497,monk,mistweaver,60,34,26
Xenitate,bleeding-hollow,1497,monk,mistweaver,30,17,13
Udderpunch,barthilas,1497,monk,mistweaver,30,16,14
Fissg,frostmourne,1496,monk,mistweaver,30,17,13
Märthä,azralon,1496,monk,mistweaver,143,74,69
Tinypunch,emerald-dream,1496,monk,mistweaver,72,34,38
Närza,kelthuzad,1492,monk,mistweaver,42,24,18
Jerumay,tichondrius,1491,monk,mistweaver,35,20,15
Muzzye,frostmourne,1491,monk,mistweaver,143,80,63
Lýøp,illidan,1491,monk,mistweaver,30,16,14
Fistnanweavn,dawnbringer,1488,monk,mistweaver,132,62,70
Rakia,moon-guard,1487,monk,mistweaver,148,71,77
Conormonk,tichondrius,1486,monk,mistweaver,24,18,6
Warzsong,azralon,1486,monk,mistweaver,54,33,21
Buddhabud,sargeras,1485,monk,mistweaver,54,28,26
Swiftyboi,tichondrius,1483,monk,mistweaver,132,64,68
Fehthermane,area-52,1482,monk,mistweaver,70,42,28
Soothinn,tichondrius,1481,monk,mistweaver,36,26,10
Slothman,nagrand,1481,monk,mistweaver,48,27,21
Integrity,durotan,1481,monk,mistweaver,100,53,47
Âfrika,ysondre,1480,monk,mistweaver,65,31,34
Florla,illidan,1479,monk,mistweaver,28,17,11
Banterx,sargeras,1478,monk,mistweaver,53,24,29
Talented,azuremyst,1477,monk,mistweaver,63,41,22
Fister,garithos,1476,monk,mistweaver,58,38,20
Monkpowaz,stormrage,1476,monk,mistweaver,42,26,16
Ichiros,cenarion-circle,1476,monk,mistweaver,88,53,35
Cranekicks,moon-guard,1475,monk,mistweaver,143,79,64
Sangthos,darkspear,1474,monk,mistweaver,102,44,58
Bruceteå,area-52,1473,monk,mistweaver,29,19,10
Mòñk,shattered-halls,1473,monk,mistweaver,42,26,16
Missweaver,sargeras,1473,monk,mistweaver,62,31,31
Clipping,tichondrius,1472,monk,mistweaver,42,26,16
Wheygodx,lothar,1471,monk,mistweaver,42,28,14
Roadrunnerxl,korgath,1471,monk,mistweaver,60,34,26
Tuss,tichondrius,1471,monk,mistweaver,46,18,28
Willowa,frostmourne,1470,monk,mistweaver,50,30,20
Slashsmack,caelestrasz,1470,monk,mistweaver,42,19,23
Hadryan,proudmoore,1469,monk,mistweaver,80,43,37
Scrapfu,proudmoore,1469,monk,mistweaver,66,31,35
Rockcalm,malganis,1468,monk,mistweaver,62,28,34
Brewmanchew,frostmourne,1466,monk,mistweaver,42,26,16
Dovhug,draenor,1465,monk,mistweaver,66,30,36
Gotmonk,aggramar,1464,monk,mistweaver,30,19,11
Buoymoose,bleeding-hollow,1464,monk,mistweaver,30,19,11
Bøkky,frostmourne,1463,monk,mistweaver,48,31,17
Tirêd,sargeras,1459,monk,mistweaver,78,41,37
Gnomepuncher,dalaran,1459,monk,mistweaver,48,25,23
Wohrfnok,illidan,1458,monk,mistweaver,24,16,8
Gotosleepkid,dalaran,1458,monk,mistweaver,35,19,16
Kazov,proudmoore,1458,monk,mistweaver,178,92,86
Fidgetspinna,zuljin,1457,monk,mistweaver,38,18,20
Guïnness,tichondrius,1455,monk,mistweaver,30,18,12
Ghorb,boulderfist,1455,monk,mistweaver,63,33,30
Americå,zuljin,1453,monk,mistweaver,60,39,21
Abdoolah,illidan,1453,monk,mistweaver,48,26,22
Sudury,tichondrius,1451,monk,mistweaver,54,29,25
Baee,cairne,1451,monk,mistweaver,43,17,26
Pomonk,nazjatar,1450,monk,mistweaver,69,45,24
Endér,tichondrius,1450,monk,mistweaver,157,82,75
Aramonk,tichondrius,1449,monk,mistweaver,52,32,20
Xtrememisty,frostmourne,1449,monk,mistweaver,66,35,31
Yurm,moon-guard,1445,monk,mistweaver,24,20,4
Lidela,sargeras,1445,monk,mistweaver,52,27,25
Äncient,quelthalas,1444,monk,mistweaver,63,41,22
Glad,stormscale,1444,monk,mistweaver,258,137,121
Toastage,tichondrius,1443,monk,mistweaver,30,16,14
Strugglebus,sargeras,1438,monk,mistweaver,18,15,3
Elcidx,tichondrius,1438,monk,mistweaver,24,15,9
Tobyblack,illidan,1436,monk,mistweaver,49,27,22
Outhume,eredar,1435,monk,mistweaver,30,15,15
Atsugin,khazgoroth,1435,monk,mistweaver,30,15,15
Dhomonk,rexxar,1434,monk,mistweaver,29,17,12
Monktor,dalaran,1433,monk,mistweaver,72,38,34
Fartknocker,magtheridon,1433,monk,mistweaver,30,15,15
Safiel,proudmoore,1433,monk,mistweaver,118,51,67
Chadmw,illidan,1432,monk,mistweaver,18,15,3
Mungka,tichondrius,1432,monk,mistweaver,94,47,47
Docpalpatine,tichondrius,1432,monk,mistweaver,30,15,15
Pichau,zuljin,1431,monk,mistweaver,21,16,5
Josciel,ragnaros,1430,monk,mistweaver,311,151,160
Iamamonk,kelthuzad,1429,monk,mistweaver,20,17,3
Healzpapi,tichondrius,1428,monk,mistweaver,136,71,65
Fuqame,kiljaeden,1428,monk,mistweaver,42,19,23
Chiang,chogall,1426,monk,mistweaver,23,17,6
Fistlord,zuljin,1425,monk,mistweaver,32,18,14
Tenshu,runetotem,1425,monk,mistweaver,93,48,45
Pøkemonk,malganis,1424,monk,mistweaver,24,15,9
Poundmedaddi,tichondrius,1422,monk,mistweaver,98,62,36
Friskyfister,tichondrius,1422,monk,mistweaver,30,15,15
Leemîn,tichondrius,1421,monk,mistweaver,36,24,12
Spencere,hyjal,1421,monk,mistweaver,30,15,15
Jasonmonk,sargeras,1420,monk,mistweaver,31,19,12
Taijutzu,darkspear,1419,monk,mistweaver,24,15,9
Comonk,area-52,1416,monk,mistweaver,24,15,9
Viralpog,bleeding-hollow,1413,monk,mistweaver,30,16,14
Ralphiex,tichondrius,1411,monk,mistweaver,101,53,48
Ninetrigrams,illidan,1411,monk,mistweaver,32,15,17
Shoumi,turalyon,1410,monk,mistweaver,30,17,13
Ungankable,sargeras,1408,monk,mistweaver,60,32,28
Sobuu,wyrmrest-accord,1406,monk,mistweaver,30,24,6
Puoll,gallywix,1406,monk,mistweaver,93,51,42
Ojiin,wyrmrest-accord,1405,monk,mistweaver,197,105,92
Thirteendads,turalyon,1403,monk,mistweaver,35,17,18
Meshugah,quelthalas,1402,monk,mistweaver,78,34,44
Kylièjenner,gilneas,1401,monk,mistweaver,42,26,16
Phatcheeks,aegwynn,1400,monk,mistweaver,66,37,29
Carlosm,tichondrius,1398,monk,mistweaver,30,19,11
Jèricho,thrall,1397,monk,mistweaver,60,32,28
Zoltwo,sargeras,1395,monk,mistweaver,30,15,15
Edbtz,illidan,1394,monk,mistweaver,24,18,6
Iluvthugnmcz,sargeras,1394,monk,mistweaver,53,25,28
Kemmy,ravencrest,1393,monk,mistweaver,31,17,14
Mcfisted,area-52,1393,monk,mistweaver,57,25,32
Nelda,gorgonnash,1392,monk,mistweaver,36,22,14
Htm,barthilas,1392,monk,mistweaver,41,16,25
Mcfluffey,area-52,1391,monk,mistweaver,89,49,40
Jitsu,frostmane,1387,monk,mistweaver,80,46,34
Mýthik,hyjal,1387,monk,mistweaver,42,22,20
Vum,quelthalas,1385,monk,mistweaver,21,16,5
Mightbweavin,bleeding-hollow,1385,monk,mistweaver,108,48,60
Drama,tichondrius,1384,monk,mistweaver,26,18,8
Flixz,stormrage,1382,monk,mistweaver,48,25,23
Docwang,malganis,1381,monk,mistweaver,42,27,15
Riokhan,ragnaros,1381,monk,mistweaver,54,31,23
Valiantroar,shandris,1381,monk,mistweaver,38,16,22
Noodalie,moon-guard,1378,monk,mistweaver,24,18,6
Shandaspanda,rivendare,1378,monk,mistweaver,54,26,28
Pablojám,ragnaros,1375,monk,mistweaver,42,23,19
Neuron,spirestone,1374,monk,mistweaver,32,15,17
Afabled,drakkari,1373,monk,mistweaver,48,26,22
Ozen,burning-blade,1373,monk,mistweaver,72,37,35
Baroon,chogall,1373,monk,mistweaver,93,40,53
Rhynoo,lothar,1371,monk,mistweaver,96,51,45
Statue,cenarius,1370,monk,mistweaver,23,15,8
Thyfist,frostmourne,1369,monk,mistweaver,28,16,12
Cisneros,doomhammer,1369,monk,mistweaver,81,39,42
Sinistuhm,tichondrius,1368,monk,mistweaver,41,22,19
Bobthedrag,illidan,1366,monk,mistweaver,36,17,19
Vonn,drakkari,1364,monk,mistweaver,72,36,36
Tianji,malganis,1363,monk,mistweaver,42,26,16
Tert,aerie-peak,1363,monk,mistweaver,146,83,63
Lõgan,azralon,1362,monk,mistweaver,46,24,22
Chuks,nerzhul,1358,monk,mistweaver,164,91,73
Reque,illidan,1356,monk,mistweaver,160,89,71
Ataxic,illidan,1355,monk,mistweaver,29,15,14
Vegoku,moon-guard,1354,monk,mistweaver,78,41,37
Pandalee,skullcrusher,1353,monk,mistweaver,36,26,10
Ninjagordu,nemesis,1353,monk,mistweaver,118,57,61
Pandemikmonk,turalyon,1349,monk,mistweaver,48,22,26
Ninjatoots,aerie-peak,1346,monk,mistweaver,59,36,23
Monkqi,lightbringer,1344,monk,mistweaver,30,23,7
Veejaex,stormreaver,1343,monk,mistweaver,18,14,4
Rylens,draka,1343,monk,mistweaver,40,25,15
Lanifear,area-52,1343,monk,mistweaver,29,17,12
Siserfister,sargeras,1343,monk,mistweaver,24,14,10
Mixon,archimonde,1343,monk,mistweaver,24,14,10
Benneroy,moon-guard,1343,monk,mistweaver,24,14,10
Damogen,spinebreaker,1343,monk,mistweaver,30,14,16
Khylu,kelthuzad,1342,monk,mistweaver,18,14,4
Cnww,tichondrius,1342,monk,mistweaver,24,14,10
Emporertrump,bleeding-hollow,1342,monk,mistweaver,85,38,47
Séthrogèn,tichondrius,1341,monk,mistweaver,18,14,4
Cilantrõ,malorne,1341,monk,mistweaver,30,21,9
Bouncymoo,frostmourne,1341,monk,mistweaver,24,14,10
Coldridge,bleeding-hollow,1341,monk,mistweaver,24,14,10
Alternatives,sargeras,1339,monk,mistweaver,18,14,4
Zenmasta,exodar,1336,monk,mistweaver,30,17,13
Ryantiger,tichondrius,1336,monk,mistweaver,30,14,16
Lazeekick,sargeras,1335,monk,mistweaver,30,14,16
Iielia,wyrmrest-accord,1335,monk,mistweaver,35,16,19
Monkeynut,whisperwind,1334,monk,mistweaver,83,46,37
Chañi,ragnaros,1333,monk,mistweaver,59,33,26
Zettelkasten,tichondrius,1332,monk,mistweaver,24,14,10
Chongal,whisperwind,1332,monk,mistweaver,24,14,10
Inebriated,auchindoun,1329,monk,mistweaver,24,14,10
Himah,area-52,1329,monk,mistweaver,30,14,16
Manicata,tichondrius,1328,monk,mistweaver,63,33,30
Tenzing,azgalor,1324,monk,mistweaver,24,14,10
Momochi,malygos,1323,monk,mistweaver,30,16,14
Nerfmonk,spirestone,1322,monk,mistweaver,24,14,10
Jeffdagnome,moon-guard,1320,monk,mistweaver,96,48,48
Gerranni,wyrmrest-accord,1318,monk,mistweaver,24,16,8
Shon,frostmourne,1316,monk,mistweaver,24,14,10
Waxxi,barthilas,1316,monk,mistweaver,102,58,44
Albusventos,azralon,1315,monk,mistweaver,35,21,14
Brewswayne,argent-dawn,1315,monk,mistweaver,24,14,10
Smackdat,azjolnerub,1315,monk,mistweaver,58,29,29
Johnkreese,andorhal,1313,monk,mistweaver,30,14,16
Sweatweaver,frostmourne,1313,monk,mistweaver,64,28,36
Binghe,illidan,1311,monk,mistweaver,30,17,13
Breezymist,doomhammer,1311,monk,mistweaver,30,14,16
Ric,gundrak,1310,monk,mistweaver,69,38,31
Dashenna,illidan,1310,monk,mistweaver,84,32,52
Punch,lothar,1309,monk,mistweaver,31,18,13
Odogin,tichondrius,1307,monk,mistweaver,65,41,24
Dextr,arthas,1302,monk,mistweaver,27,14,13
Kocksnapper,stormreaver,1297,monk,mistweaver,57,32,25
Boozebear,spirestone,1297,monk,mistweaver,118,60,58
Bresmeatfore,barthilas,1295,monk,mistweaver,24,14,10
Güwop,tichondrius,1294,monk,mistweaver,30,14,16
Keyszz,tichondrius,1294,monk,mistweaver,176,77,99
Izolatedrin,tichondrius,1293,monk,mistweaver,17,14,3
Notblakexo,tichondrius,1290,monk,mistweaver,23,14,9
Gomey,bleeding-hollow,1287,monk,mistweaver,26,15,11
Dblfistez,stormreaver,1287,monk,mistweaver,40,16,24
Iovegõd,tichondrius,1286,monk,mistweaver,24,14,10
Gallorex,frostmourne,1286,monk,mistweaver,42,24,18
Kìmjungheal,tichondrius,1281,monk,mistweaver,41,21,20
Chnzhs,tichondrius,1281,monk,mistweaver,58,18,40
Zeiana,proudmoore,1280,monk,mistweaver,38,22,16
Miçrosoft,area-52,1278,monk,mistweaver,66,40,26
Byakugan,moon-guard,1277,monk,mistweaver,41,23,18
Börg,bleeding-hollow,1277,monk,mistweaver,38,19,19
Giatzo,barthilas,1263,monk,mistweaver,55,25,30
Damemasduro,ragnaros,1262,monk,mistweaver,355,166,189
Makimä,stormrage,1260,monk,mistweaver,54,28,26
Onekickman,dalaran,1257,monk,mistweaver,54,30,24
Shinarri,thrall,1253,monk,mistweaver,114,63,51
Omimonk,sargeras,1251,monk,mistweaver,56,24,32
Donnieyen,aerie-peak,1250,monk,mistweaver,19,14,5
Shefcurry,boulderfist,1248,monk,mistweaver,24,13,11
Mwomegalul,sargeras,1248,monk,mistweaver,30,13,17
Ticmonk,frostmourne,1247,monk,mistweaver,18,13,5
Beefyteet,tichondrius,1247,monk,mistweaver,18,13,5
Stinkycok,tichondrius,1247,monk,mistweaver,24,13,11
Gothamonk,tichondrius,1247,monk,mistweaver,24,13,11
Brews,black-dragonflight,1247,monk,mistweaver,25,13,12
Evilstep,tichondrius,1247,monk,mistweaver,60,31,29
Antriai,icecrown,1247,monk,mistweaver,36,13,23
Mirokushan,skywall,1246,monk,mistweaver,117,65,52
Hîddëncløùdx,tichondrius,1245,monk,mistweaver,18,13,5
Floka,bleeding-hollow,1245,monk,mistweaver,18,13,5
Afw,moon-guard,1245,monk,mistweaver,32,18,14
Kênpächi,rexxar,1245,monk,mistweaver,24,13,11
Ieatshrooms,malfurion,1245,monk,mistweaver,60,25,35
Drunkgiraffe,zuljin,1244,monk,mistweaver,18,13,5
Yuï,bleeding-hollow,1244,monk,mistweaver,18,13,5
Mis,tichondrius,1243,monk,mistweaver,24,13,11
React,frostwolf,1242,monk,mistweaver,18,13,5
Psypalm,zuljin,1242,monk,mistweaver,18,13,5
Raígon,ragnaros,1242,monk,mistweaver,24,13,11
Rehder,barthilas,1241,monk,mistweaver,24,13,11
Poppyharlow,saurfang,1240,monk,mistweaver,24,17,7
Noogiie,barthilas,1238,monk,mistweaver,22,14,8
Originalmonk,tichondrius,1237,monk,mistweaver,18,13,5
Monxellius,moon-guard,1237,monk,mistweaver,69,34,35
Oyyo,tichondrius,1237,monk,mistweaver,95,35,60
Sorowblade,lothar,1235,monk,mistweaver,18,13,5
Zenquadz,elune,1234,monk,mistweaver,30,21,9
Lolkungfu,spirestone,1234,monk,mistweaver,24,13,11
Bossmonk,tichondrius,1233,monk,mistweaver,24,13,11
Siddlez,frostmourne,1231,monk,mistweaver,34,25,9
Taichichuan,tichondrius,1231,monk,mistweaver,40,22,18
Azizyzz,barthilas,1231,monk,mistweaver,42,20,22
Fistergand,frostwolf,1229,monk,mistweaver,18,13,5
Shizunô,stormrage,1229,monk,mistweaver,30,14,16
Ludafist,whisperwind,1227,monk,mistweaver,60,32,28
Fkedyourwife,dalaran,1227,monk,mistweaver,30,13,17
Gôrr,tichondrius,1226,monk,mistweaver,42,23,19
Iloki,shuhalo,1226,monk,mistweaver,75,37,38
Göat,emerald-dream,1226,monk,mistweaver,30,13,17
Zefta,moon-guard,1226,monk,mistweaver,42,18,24
Cheesemónk,tichondrius,1222,monk,mistweaver,30,13,17
Cammy,aerie-peak,1219,monk,mistweaver,32,20,12
Troutline,bonechewer,1218,monk,mistweaver,84,50,34
ßrewslèè,tichondrius,1216,monk,mistweaver,38,20,18
Kickbone,tichondrius,1215,monk,mistweaver,48,20,28
Marimonkori,stormscale,1214,monk,mistweaver,51,24,27
Sedition,emerald-dream,1213,monk,mistweaver,317,159,158
Mortimir,echo-isles,1213,monk,mistweaver,30,14,16
Phoenixspark,gnomeregan,1211,monk,mistweaver,18,13,5
Kodrik,tichondrius,1207,monk,mistweaver,66,34,32
Biggoosie,korgath,1206,monk,mistweaver,76,47,29
Kreacher,ravencrest,1199,monk,mistweaver,65,32,33
Michaeljordn,destromath,1199,monk,mistweaver,44,16,28
Pepperoncini,korgath,1199,monk,mistweaver,54,17,37
Menadraene,wyrmrest-accord,1198,monk,mistweaver,26,14,12
Puffpuffp,nazgrel,1196,monk,mistweaver,24,13,11
Darkheälzz,sargeras,1194,monk,mistweaver,93,44,49
Poppinbrews,thrall,1191,monk,mistweaver,28,15,13
Titofresh,quelthalas,1191,monk,mistweaver,33,15,18
Soderbergh,ysera,1185,monk,mistweaver,36,13,23
Orenj,boulderfist,1182,monk,mistweaver,30,16,14
Zonianman,tichondrius,1182,monk,mistweaver,30,13,17
Blackthorne,illidan,1179,monk,mistweaver,30,14,16
Anthuri,frostmourne,1178,monk,mistweaver,41,28,13
Soothem,tichondrius,1178,monk,mistweaver,24,16,8
Haruko,baelgun,1178,monk,mistweaver,40,13,27
Iseeyouqt,tichondrius,1176,monk,mistweaver,20,13,7
Maiitoguy,illidan,1175,monk,mistweaver,30,14,16
Puya,nemesis,1174,monk,mistweaver,30,14,16
Cdeez,malganis,1171,monk,mistweaver,24,13,11
Hamandchi,sargeras,1169,monk,mistweaver,23,16,7
Hie,laughing-skull,1166,monk,mistweaver,90,38,52
Shwankeesha,thrall,1165,monk,mistweaver,28,14,14
Darrhon,illidan,1163,monk,mistweaver,84,39,45
Monkoala,illidan,1160,monk,mistweaver,30,17,13
Madmint,illidan,1159,monk,mistweaver,60,26,34
Valdosta,bloodscalp,1158,monk,mistweaver,48,25,23
Callibella,amanthul,1155,monk,mistweaver,26,13,13
Xaurian,firetree,1153,monk,mistweaver,22,13,9
Magmuruk,garrosh,1152,monk,mistweaver,18,12,6
Austinm,tichondrius,1152,monk,mistweaver,18,12,6
Genjen,bleeding-hollow,1150,monk,mistweaver,18,12,6
Onlythumbs,area-52,1148,monk,mistweaver,18,12,6
Santhz,ragnaros,1148,monk,mistweaver,18,12,6
Trojanz,malganis,1148,monk,mistweaver,24,12,12
Zugroi,frostmourne,1147,monk,mistweaver,12,12,0
Strixx,silvermoon,1147,monk,mistweaver,18,14,4
Drexlla,barthilas,1147,monk,mistweaver,24,15,9
Oochi,illidan,1146,monk,mistweaver,24,12,12
Kaniou,proudmoore,1146,monk,mistweaver,29,13,16
Jagichan,area-52,1145,monk,mistweaver,18,12,6
Monkaveli,ursin,1145,monk,mistweaver,78,37,41
Lørðjimmy,sargeras,1142,monk,mistweaver,18,12,6
Calmemaybe,darkspear,1138,monk,mistweaver,18,12,6
Drfoochi,tichondrius,1138,monk,mistweaver,30,12,18
Lumïnous,moon-guard,1136,monk,mistweaver,30,14,16
Kexti,wyrmrest-accord,1135,monk,mistweaver,45,18,27
Affrika,ragnaros,1133,monk,mistweaver,47,21,26
Szuka,tichondrius,1131,monk,mistweaver,18,12,6
Herbivorous,sargeras,1131,monk,mistweaver,24,12,12
Modelman,area-52,1130,monk,mistweaver,26,14,12
Gobfu,emerald-dream,1130,monk,mistweaver,65,26,39
Fitmonje,drakkari,1126,monk,mistweaver,43,22,21
Boostmonk,terenas,1126,monk,mistweaver,78,34,44
Fistmeister,tichondrius,1125,monk,mistweaver,30,19,11
Whitepotato,bleeding-hollow,1124,monk,mistweaver,86,52,34
Honjada,tichondrius,1121,monk,mistweaver,18,12,6
Purging,draka,1121,monk,mistweaver,59,39,20
Orbii,tichondrius,1111,monk,mistweaver,48,32,16
Lolcutie,shandris,1105,monk,mistweaver,37,21,16
Dokfu,tichondrius,1105,monk,mistweaver,159,86,73
Xulieng,tichondrius,1101,monk,mistweaver,289,147,142
Baittor,proudmoore,1100,monk,mistweaver,21,13,8
Meepmonk,kilrogg,1098,monk,mistweaver,27,13,14
Emenboats,zuljin,1096,monk,mistweaver,70,44,26
Kimonk,proudmoore,1095,monk,mistweaver,36,21,15
Benex,tichondrius,1093,monk,mistweaver,23,12,11
Gentle,cenarius,1093,monk,mistweaver,26,12,14
Brewamp,zuljin,1091,monk,mistweaver,29,13,16
Mongénoio,nemesis,1083,monk,mistweaver,20,12,8
Rowbur,thrall,1077,monk,mistweaver,33,22,11
Harryrichard,sargeras,1073,monk,mistweaver,23,12,11
Lita,barthilas,1071,monk,mistweaver,17,12,5
Raphzen,stormrage,1070,monk,mistweaver,27,13,14
Keeanuweaves,tichondrius,1069,monk,mistweaver,13,12,1
Hakushin,ragnaros,1067,monk,mistweaver,36,20,16
Razod,stormrage,1066,monk,mistweaver,154,74,80
Shaolyyn,zuljin,1062,monk,mistweaver,36,19,17
Ratioed,moon-guard,1061,monk,mistweaver,35,21,14
Boojaa,silvermoon,1058,monk,mistweaver,42,19,23
Lustymonk,kelthuzad,1056,monk,mistweaver,12,11,1
Duelist,the-scryers,1056,monk,mistweaver,12,11,1
Knuqz,stormrage,1056,monk,mistweaver,18,11,7
Mistussy,sargeras,1056,monk,mistweaver,18,11,7
Sharkpiggie,illidan,1056,monk,mistweaver,18,11,7
Jetnoob,sargeras,1056,monk,mistweaver,18,11,7
Haren,gundrak,1056,monk,mistweaver,18,11,7
Kynalla,thunderlord,1055,monk,mistweaver,18,11,7
Undertickle,illidan,1055,monk,mistweaver,18,11,7
Crispeel,tichondrius,1055,monk,mistweaver,18,11,7
Smoovhoov,kiljaeden,1055,monk,mistweaver,18,11,7
Focalors,proudmoore,1055,monk,mistweaver,18,11,7
Alandis,spinebreaker,1055,monk,mistweaver,18,11,7
Shilakamesn,tichondrius,1055,monk,mistweaver,18,11,7
Fkinbis,area-52,1055,monk,mistweaver,18,11,7
Iplus,thrall,1055,monk,mistweaver,18,11,7
Axibar,tichondrius,1055,monk,mistweaver,18,11,7
Lemmetouch,illidan,1055,monk,mistweaver,24,11,13
Oppsimop,frostmourne,1055,monk,mistweaver,24,11,13
Chillionaíre,proudmoore,1055,monk,mistweaver,24,11,13
Evilbit,boulderfist,1054,monk,mistweaver,18,11,7
Igaku,windrunner,1054,monk,mistweaver,18,11,7
Yamatoqt,frostmourne,1054,monk,mistweaver,18,11,7
Mahhnaga,tichondrius,1054,monk,mistweaver,83,34,49
Dreadknotz,hyjal,1054,monk,mistweaver,42,17,25
Hache,azjolnerub,1053,monk,mistweaver,80,34,46
Theymistbuda,kelthuzad,1052,monk,mistweaver,12,11,1
Havasupai,turalyon,1052,monk,mistweaver,18,11,7
Wungpo,the-forgotten-coast,1052,monk,mistweaver,18,11,7
Karnbroo,frostmourne,1052,monk,mistweaver,24,11,13
Bârcõdë,tichondrius,1051,monk,mistweaver,12,11,1
Pappaya,tichondrius,1051,monk,mistweaver,18,11,7
Superbae,area-52,1051,monk,mistweaver,24,11,13
Fistful,destromath,1050,monk,mistweaver,12,11,1
Dégg,thrall,1050,monk,mistweaver,18,11,7
Hazelbazel,bleeding-hollow,1050,monk,mistweaver,18,11,7
Proctology,tichondrius,1047,monk,mistweaver,18,11,7
Ilani,malganis,1047,monk,mistweaver,18,11,7
Redweave,moon-guard,1047,monk,mistweaver,24,11,13
Wraithfire,uldum,1047,monk,mistweaver,30,12,18
Shaolinmists,malganis,1045,monk,mistweaver,12,11,1
Telospateo,ragnaros,1045,monk,mistweaver,24,11,13
Galiplays,zangarmarsh,1042,monk,mistweaver,21,12,9
Raidenmnx,tichondrius,1042,monk,mistweaver,24,11,13
Knaveus,frostmourne,1039,monk,mistweaver,18,11,7
Gguldduk,tichondrius,1038,monk,mistweaver,16,12,4
Thors,gorgonnash,1038,monk,mistweaver,24,13,11
Teancrumpets,wyrmrest-accord,1038,monk,mistweaver,48,20,28
Tadaku,dalaran,1033,monk,mistweaver,37,17,20
Reinah,malganis,1033,monk,mistweaver,30,11,19
Petsëmatary,bleeding-hollow,1032,monk,mistweaver,29,11,18
Merand,tichondrius,1031,monk,mistweaver,36,20,16
Marnartou,zuljin,1026,monk,mistweaver,12,11,1
Kreezoo,tichondrius,1026,monk,mistweaver,33,13,20
Hapgido,deathwing,1025,monk,mistweaver,56,26,30
Hafu,wildhammer,1025,monk,mistweaver,30,11,19
Ambuinc,burning-blade,1024,monk,mistweaver,18,11,7
Dalillamas,sargeras,1023,monk,mistweaver,14,12,2
Ursorcen,frostmourne,1019,monk,mistweaver,27,12,15
Grizzchan,sargeras,1017,monk,mistweaver,17,11,6
Ainz,nagrand,1016,monk,mistweaver,30,15,15
Vitcheztein,ragnaros,1007,monk,mistweaver,17,11,6
Twizzurp,magtheridon,1007,monk,mistweaver,21,12,9
Kfpanda,hellscream,1004,monk,mistweaver,42,19,23
Vencö,tichondrius,1001,monk,mistweaver,33,11,22
Clutchinmist,malganis,1000,monk,mistweaver,40,12,28
Senseipwnda,stormrage,999,monk,mistweaver,23,14,9
Wmo,tichondrius,997,monk,mistweaver,17,11,6
Joeyfists,frostwolf,997,monk,mistweaver,24,11,13
Zendemic,thrall,996,monk,mistweaver,30,17,13
Bbunglee,tichondrius,995,monk,mistweaver,17,11,6
Kpeste,tichondrius,995,monk,mistweaver,42,23,19
Telrande,ysondre,994,monk,mistweaver,35,24,11
Sukrit,darkspear,993,monk,mistweaver,40,19,21
Mintbear,illidan,984,monk,mistweaver,14,11,3
Monkgringo,azralon,983,monk,mistweaver,48,27,21
Bomer,moknathal,980,monk,mistweaver,49,29,20
Moldboy,area-52,975,monk,mistweaver,17,11,6
Winniethepoo,borean-tundra,975,monk,mistweaver,19,11,8
Sipu,wyrmrest-accord,969,monk,mistweaver,41,20,21
Hype,ursin,960,monk,mistweaver,12,10,2
Drizzywow,arathor,960,monk,mistweaver,12,10,2
Titti,korgath,960,monk,mistweaver,18,10,8
Chignar,dathremar,960,monk,mistweaver,18,10,8
Inkar,tichondrius,960,monk,mistweaver,18,10,8
Milkshayx,kiljaeden,960,monk,mistweaver,18,10,8
Mywave,bleeding-hollow,960,monk,mistweaver,18,10,8
Fheng,emerald-dream,960,monk,mistweaver,18,10,8
Dapperdabz,illidan,960,monk,mistweaver,18,10,8
Greenfriend,illidan,960,monk,mistweaver,18,10,8
Mlngo,illidan,960,monk,mistweaver,18,10,8
Gundamfish,tichondrius,960,monk,mistweaver,24,10,14
Blasê,frostmourne,959,monk,mistweaver,12,10,2
Mïstyfïsty,moon-guard,959,monk,mistweaver,12,10,2
Shâdòw,ragnaros,959,monk,mistweaver,12,10,2
Hanlover,tichondrius,959,monk,mistweaver,12,10,2
Cymonka,sargeras,959,monk,mistweaver,18,10,8
Insidedog,frostmourne,959,monk,mistweaver,18,10,8
Chanîng,frostmourne,959,monk,mistweaver,18,10,8
Miniswag,arthas,959,monk,mistweaver,24,10,14
Anabolicx,khazgoroth,959,monk,mistweaver,24,10,14
Squaanched,emerald-dream,959,monk,mistweaver,30,10,20
Ramisan,barthilas,958,monk,mistweaver,18,10,8
Lostinmistz,tichondrius,958,monk,mistweaver,18,10,8
Madkickzack,blades-edge,958,monk,mistweaver,24,10,14
Gngrbeardman,tichondrius,957,monk,mistweaver,24,10,14
Oldfashheals,tichondrius,957,monk,mistweaver,24,10,14
Wessex,sargeras,954,monk,mistweaver,18,10,8
Deadlyzz,gilneas,954,monk,mistweaver,70,37,33
Shinobui,jubeithos,950,monk,mistweaver,18,10,8
Brewtalitops,illidan,950,monk,mistweaver,18,10,8
Teil,illidan,949,monk,mistweaver,18,10,8
Dirtyshef,deathwing,949,monk,mistweaver,45,11,34
Gazzoxsan,chogall,946,monk,mistweaver,25,10,15
Jæmz,moon-guard,944,monk,mistweaver,36,13,23
Mystafista,tichondrius,939,monk,mistweaver,23,10,13
Siamack,illidan,920,monk,mistweaver,14,11,3
Xbrewtal,tichondrius,909,monk,mistweaver,30,17,13
Lovechabill,darkspear,906,monk,mistweaver,17,10,7
Delassian,moon-guard,894,monk,mistweaver,37,16,21
Inbu,tichondrius,893,monk,mistweaver,26,10,16
Stickbundle,illidan,888,monk,mistweaver,15,11,4
Edj,drenden,884,monk,mistweaver,75,37,38
Monkgyfatso,tichondrius,878,monk,mistweaver,11,10,1
Galyndra,darkspear,877,monk,mistweaver,13,10,3
Jonnymon,sargeras,864,monk,mistweaver,12,9,3
Flicksx,arthas,864,monk,mistweaver,12,9,3
Ggonext,wyrmrest-accord,864,monk,mistweaver,12,9,3
Toastsmonk,tichondrius,864,monk,mistweaver,12,9,3
Sâx,stormreaver,864,monk,mistweaver,12,9,3
Horndog,skullcrusher,864,monk,mistweaver,12,9,3
Imnumberone,alterac-mountains,864,monk,mistweaver,12,9,3
Mistyfisty,laughing-skull,864,monk,mistweaver,14,9,5
Kriticalkush,kelthuzad,864,monk,mistweaver,18,9,9
Bobbytheorc,tichondrius,864,monk,mistweaver,18,9,9
Gottí,sargeras,864,monk,mistweaver,18,9,9
Kármah,emerald-dream,864,monk,mistweaver,18,9,9
Pinkfairy,wyrmrest-accord,864,monk,mistweaver,18,9,9
Taelinn,moonrunner,864,monk,mistweaver,24,9,15
Hulkhogan,mugthol,863,monk,mistweaver,14,11,3
Maicuta,thrall,863,monk,mistweaver,12,9,3
Theminivan,sargeras,863,monk,mistweaver,12,9,3
Kazzichi,area-52,863,monk,mistweaver,12,9,3
Ghðst,ragnaros,863,monk,mistweaver,12,9,3
Brewley,thrall,863,monk,mistweaver,12,9,3
Dareelyst,arygos,863,monk,mistweaver,18,9,9
Tjab,kiljaeden,863,monk,mistweaver,18,9,9
Fisthealz,area-52,862,monk,mistweaver,12,9,3
Ørçhid,ravenholdt,862,monk,mistweaver,12,9,3
Zac,veknilash,862,monk,mistweaver,12,9,3
Kungupanda,nesingwary,862,monk,mistweaver,24,9,15
Madussy,zuljin,862,monk,mistweaver,24,9,15
Pimpolhona,nemesis,862,monk,mistweaver,24,9,15
Jhaded,tichondrius,862,monk,mistweaver,24,9,15
Kromrax,stormrage,862,monk,mistweaver,24,9,15
Kirshta,kelthuzad,861,monk,mistweaver,12,9,3
Rosellina,kelthuzad,861,monk,mistweaver,18,9,9
Palomagozzu,ragnaros,860,monk,mistweaver,12,9,3
Håzê,kul-tiras,860,monk,mistweaver,18,9,9
Jugies,emerald-dream,860,monk,mistweaver,18,9,9
Fludz,burning-blade,859,monk,mistweaver,24,9,15
Monkism,warsong,855,monk,mistweaver,12,9,3
Winwakamank,sargeras,855,monk,mistweaver,24,9,15
Gino,proudmoore,852,monk,mistweaver,148,68,80
Eago,sargeras,852,monk,mistweaver,24,9,15
Bullshido,aerie-peak,851,monk,mistweaver,18,9,9
Epptwo,aggramar,851,monk,mistweaver,30,9,21
Lilbee,azjolnerub,845,monk,mistweaver,18,9,9
Sìrtankallot,stormrage,837,monk,mistweaver,32,9,23
Twinktoez,bleeding-hollow,831,monk,mistweaver,14,10,4
Sihgriid,tichondrius,826,monk,mistweaver,20,10,10
Soapy,moon-guard,824,monk,mistweaver,17,9,8
Seaja,malganis,823,monk,mistweaver,93,23,70
Kyndrïa,tichondrius,819,monk,mistweaver,65,26,39
Qlispe,bloodscalp,814,monk,mistweaver,64,32,32
Goodluck,madoran,809,monk,mistweaver,27,10,17
Tokkyo,frostmourne,804,monk,mistweaver,66,15,51
Picoree,frostmourne,799,monk,mistweaver,15,10,5
Mastahp,tichondrius,797,monk,mistweaver,22,9,13
Akfourseven,barthilas,795,monk,mistweaver,71,32,39
Dreamy,mugthol,773,monk,mistweaver,42,12,30
Kaskã,tichondrius,768,monk,mistweaver,12,8,4
Udmonk,tichondrius,768,monk,mistweaver,12,8,4
Itsnoozes,illidan,768,monk,mistweaver,12,8,4
Tuladura,tichondrius,768,monk,mistweaver,12,8,4
Monkzilla,tichondrius,768,monk,mistweaver,12,8,4
Furiousfrank,stormrage,768,monk,mistweaver,12,8,4
Pantypirate,tichondrius,768,monk,mistweaver,12,8,4
Jiskweaver,sargeras,768,monk,mistweaver,12,8,4
Omnly,stormrage,768,monk,mistweaver,12,8,4
Ninjachavez,tichondrius,768,monk,mistweaver,12,8,4
Valhira,kiljaeden,768,monk,mistweaver,12,8,4
Ojarax,bleeding-hollow,768,monk,mistweaver,12,8,4
Feel,frostmourne,768,monk,mistweaver,12,8,4
Torakigai,ghostlands,768,monk,mistweaver,12,8,4
Funkmunk,aegwynn,768,monk,mistweaver,12,8,4
Chevvyy,azshara,768,monk,mistweaver,12,8,4
Tubescreamer,barthilas,768,monk,mistweaver,12,8,4
Sàìñtàsønìà,kelthuzad,768,monk,mistweaver,12,8,4
Ragemore,emerald-dream,768,monk,mistweaver,12,8,4
Garg,malganis,768,monk,mistweaver,12,8,4
Cuckoon,malganis,768,monk,mistweaver,12,8,4
Picklefartjr,malfurion,768,monk,mistweaver,12,8,4
Shquiz,sargeras,768,monk,mistweaver,12,8,4
Scrypter,proudmoore,768,monk,mistweaver,12,8,4
Bralex,black-dragonflight,768,monk,mistweaver,12,8,4
Catmonk,the-forgotten-coast,768,monk,mistweaver,12,8,4
Dreamscapexo,kelthuzad,768,monk,mistweaver,18,8,10
Drunkenfist,chogall,768,monk,mistweaver,18,8,10
Imafqnbaby,tichondrius,768,monk,mistweaver,18,8,10
Donnieyen,area-52,768,monk,mistweaver,18,8,10
Kwatann,bonechewer,768,monk,mistweaver,18,8,10
Erwynz,tichondrius,768,monk,mistweaver,24,8,16
Rileyreidfan,azjolnerub,767,monk,mistweaver,12,8,4
Lenee,frostmourne,767,monk,mistweaver,12,8,4
Blitzcombo,thrall,767,monk,mistweaver,12,8,4
Rolybones,boulderfist,767,monk,mistweaver,12,8,4
Dragonwhirl,stormrage,767,monk,mistweaver,12,8,4
Themys,zuljin,767,monk,mistweaver,12,8,4
Zenspice,stormrage,767,monk,mistweaver,12,8,4
Abird,tichondrius,767,monk,mistweaver,12,8,4
Jeolmyung,tichondrius,767,monk,mistweaver,12,8,4
Voltekkor,tichondrius,767,monk,mistweaver,14,8,6
Juchiyosamu,illidan,767,monk,mistweaver,15,8,7
Elfass,bleeding-hollow,767,monk,mistweaver,18,8,10
Bogez,area-52,767,monk,mistweaver,18,8,10
Barleygar,tichondrius,767,monk,mistweaver,18,8,10
Dabnhash,emerald-dream,767,monk,mistweaver,18,8,10
Kailzchi,area-52,766,monk,mistweaver,12,8,4
Feynzen,frostmourne,766,monk,mistweaver,12,8,4
Artomist,stormrage,766,monk,mistweaver,12,8,4
Selfiestíck,tichondrius,766,monk,mistweaver,12,8,4
Apexian,kelthuzad,766,monk,mistweaver,12,8,4
Trapeez,kelthuzad,766,monk,mistweaver,12,8,4
Fairyeflora,hellscream,766,monk,mistweaver,12,8,4
Wzzi,tichondrius,765,monk,mistweaver,18,8,10
Nuubchi,stormrage,764,monk,mistweaver,18,8,10
Scips,fizzcrank,764,monk,mistweaver,18,8,10
Kushmintz,whisperwind,762,monk,mistweaver,18,8,10
Halfaling,tichondrius,761,monk,mistweaver,12,8,4
Fufu,terokkar,761,monk,mistweaver,18,8,10
Monktyson,barthilas,760,monk,mistweaver,12,8,4
Steenkk,tichondrius,754,monk,mistweaver,18,8,10
Fusionspell,stormrage,747,monk,mistweaver,24,8,16
Prddoss,quelthalas,745,monk,mistweaver,12,8,4
Sätsu,bleeding-hollow,735,monk,mistweaver,17,8,9
Kryflex,frostmourne,720,monk,mistweaver,15,9,6
Thaliondor,stormrage,720,monk,mistweaver,15,9,6
Carlyjepsen,shadowmoon,713,monk,mistweaver,27,9,18
Karynia,illidan,712,monk,mistweaver,15,9,6
Rektfu,emerald-dream,708,monk,mistweaver,21,9,12
Tanskee,sargeras,707,monk,mistweaver,21,9,12
Evílryü,quelthalas,706,monk,mistweaver,15,9,6
Diagrams,tichondrius,703,monk,mistweaver,11,8,3
Hirav,khazgoroth,697,monk,mistweaver,21,9,12
Minttea,kiljaeden,690,monk,mistweaver,28,9,19
Muzzen,fizzcrank,688,monk,mistweaver,13,8,5
Saiyañ,proudmoore,672,monk,mistweaver,12,7,5
Synpunch,tichondrius,672,monk,mistweaver,12,7,5
Missclickx,azralon,672,monk,mistweaver,12,7,5
Phunkymonkey,mannoroth,672,monk,mistweaver,12,7,5
Moönk,tichondrius,672,monk,mistweaver,12,7,5
Lynio,area-52,672,monk,mistweaver,12,7,5
Truefists,stormrage,672,monk,mistweaver,12,7,5
Valelarus,doomhammer,672,monk,mistweaver,12,7,5
Zbell,sargeras,672,monk,mistweaver,12,7,5
Yangzai,tichondrius,672,monk,mistweaver,12,7,5
Mundane,sargeras,672,monk,mistweaver,12,7,5
Agilities,sargeras,672,monk,mistweaver,12,7,5
Ammonk,bloodhoof,672,monk,mistweaver,12,7,5
Copamine,dalaran,672,monk,mistweaver,12,7,5
Tuesdây,wyrmrest-accord,672,monk,mistweaver,12,7,5
Zerker,nagrand,672,monk,mistweaver,12,7,5
Aniwhy,tichondrius,672,monk,mistweaver,12,7,5
Toothpick,blackrock,672,monk,mistweaver,12,7,5
Boorams,tichondrius,672,monk,mistweaver,12,7,5
Darong,tichondrius,672,monk,mistweaver,12,7,5
Pandatrainer,drakkari,672,monk,mistweaver,12,7,5
Mwr,frostmourne,672,monk,mistweaver,12,7,5
Laggytoodope,kelthuzad,672,monk,mistweaver,12,7,5
Prisonike,bleeding-hollow,672,monk,mistweaver,12,7,5
Nerf,malganis,672,monk,mistweaver,12,7,5
Annisokay,bleeding-hollow,672,monk,mistweaver,12,7,5
Ashmisty,kelthuzad,672,monk,mistweaver,12,7,5
Rookere,malganis,672,monk,mistweaver,12,7,5
Fistay,burning-legion,672,monk,mistweaver,15,8,7
Beejae,tichondrius,672,monk,mistweaver,14,7,7
Èxpèrtisè,jubeithos,672,monk,mistweaver,14,7,7
Cungflu,crushridge,672,monk,mistweaver,18,7,11
Thevy,area-52,672,monk,mistweaver,18,7,11
Babychi,frostmourne,672,monk,mistweaver,18,7,11
Monktu,frostmourne,672,monk,mistweaver,18,7,11
Audrun,frostmourne,672,monk,mistweaver,18,7,11
Caliroll,gorefiend,672,monk,mistweaver,18,7,11
Hoofweaver,proudmoore,672,monk,mistweaver,24,7,17
Naxanax,area-52,671,monk,mistweaver,12,7,5
Kurtall,area-52,671,monk,mistweaver,12,7,5
Alisoly,tichondrius,671,monk,mistweaver,12,7,5
Monkydoo,blackhand,671,monk,mistweaver,12,7,5
Touzin,bleeding-hollow,671,monk,mistweaver,12,7,5
Eldrik,stormrage,671,monk,mistweaver,12,7,5
Rôbo,emerald-dream,671,monk,mistweaver,12,7,5
Hornymonkale,thrall,671,monk,mistweaver,12,7,5
Iwonson,mugthol,671,monk,mistweaver,12,7,5
Shórtlived,skullcrusher,671,monk,mistweaver,13,7,6
Táishen,wyrmrest-accord,671,monk,mistweaver,16,8,8
Divaweaver,sargeras,671,monk,mistweaver,18,7,11
Bükki,ragnaros,671,monk,mistweaver,18,7,11
Chitacos,trollbane,671,monk,mistweaver,18,7,11
Bruceki,bleeding-hollow,671,monk,mistweaver,18,7,11
Diligentmonk,illidan,671,monk,mistweaver,21,8,13
Slinger,kalecgos,670,monk,mistweaver,10,8,2
Microdose,blackrock,670,monk,mistweaver,18,7,11
Pandaranga,saurfang,670,monk,mistweaver,28,8,20
Djwushu,blackhand,668,monk,mistweaver,18,7,11
Shoguns,zuljin,667,monk,mistweaver,12,7,5
Balooballs,frostmourne,667,monk,mistweaver,18,7,11
Miretunie,arathor,666,monk,mistweaver,12,7,5
Wetspaghetti,malganis,661,monk,mistweaver,18,7,11
Karu,barthilas,639,monk,mistweaver,18,8,10
Rènh,ragnaros,639,monk,mistweaver,17,7,10
Reflexsivex,malganis,638,monk,mistweaver,11,7,4
Kangeroo,tichondrius,624,monk,mistweaver,15,8,7
Blessedbalor,tichondrius,624,monk,mistweaver,15,7,8
Sourcandyx,area-52,624,monk,mistweaver,15,7,8
Jetchi,proudmoore,623,monk,mistweaver,11,7,4
Bigjuicers,bleeding-hollow,623,monk,mistweaver,11,7,4
Dasubb,crushridge,623,monk,mistweaver,11,7,4
Azz,barthilas,623,monk,mistweaver,11,7,4
Praydoh,tichondrius,623,monk,mistweaver,11,7,4
Brüce,ragnaros,623,monk,mistweaver,15,7,8
Aerona,stormreaver,617,monk,mistweaver,12,8,4
Hirahxx,frostmourne,606,monk,mistweaver,14,7,7
Chainwax,korgath,576,monk,mistweaver,6,6,0
Chrîstmas,proudmoore,576,monk,mistweaver,6,6,0
Fenriranger,tichondrius,576,monk,mistweaver,6,6,0
Watty,zuljin,576,monk,mistweaver,6,6,0
Ezqueue,area-52,576,monk,mistweaver,6,6,0
Bowstâff,lightbringer,576,monk,mistweaver,6,6,0
Onecoolmonk,tichondrius,576,monk,mistweaver,6,6,0
Kaølin,azralon,576,monk,mistweaver,6,6,0
Munkï,tichondrius,576,monk,mistweaver,6,6,0
Kruxx,anvilmar,576,monk,mistweaver,6,6,0
Grimaku,tichondrius,576,monk,mistweaver,12,6,6
Meepmonk,tichondrius,576,monk,mistweaver,12,6,6
Vayce,barthilas,576,monk,mistweaver,12,6,6
Eppsmonk,tichondrius,576,monk,mistweaver,12,6,6
Shaqkobe,stormrage,576,monk,mistweaver,12,6,6
Inkers,detheroc,576,monk,mistweaver,12,6,6
Khungfeu,area-52,576,monk,mistweaver,12,6,6
Faccemelter,illidan,576,monk,mistweaver,12,6,6
Fïish,stormrage,576,monk,mistweaver,12,6,6
Karrigwyn,tichondrius,576,monk,mistweaver,12,6,6
Imakeplaysyo,illidan,576,monk,mistweaver,12,6,6
Steyi,nazjatar,576,monk,mistweaver,12,6,6
Underpants,skullcrusher,576,monk,mistweaver,12,6,6
Peachtea,burning-legion,576,monk,mistweaver,12,6,6
Eightpoint,illidan,576,monk,mistweaver,12,6,6
Dracc,zuljin,576,monk,mistweaver,12,6,6
Saitamâ,tichondrius,576,monk,mistweaver,12,6,6
Dreamfist,emerald-dream,576,monk,mistweaver,12,6,6
Broyoulined,spirestone,576,monk,mistweaver,12,6,6
Nukeproof,stormreaver,576,monk,mistweaver,12,6,6
Boppweave,tichondrius,576,monk,mistweaver,12,6,6
Cerrado,emerald-dream,576,monk,mistweaver,12,6,6
Meisterbrew,garona,576,monk,mistweaver,12,6,6
Até,azralon,576,monk,mistweaver,12,6,6
Dungfish,mugthol,576,monk,mistweaver,12,6,6
Xitearith,ragnaros,576,monk,mistweaver,12,6,6
Sumaran,hydraxis,576,monk,mistweaver,12,6,6
Raonoc,sargeras,576,monk,mistweaver,12,6,6
Krob,bleeding-hollow,576,monk,mistweaver,12,6,6
Janim,illidan,576,monk,mistweaver,12,6,6
Wèave,tichondrius,576,monk,mistweaver,12,6,6
Whoonmonk,tichondrius,576,monk,mistweaver,12,6,6
Danceofchiji,tichondrius,576,monk,mistweaver,12,6,6
Transcend,nerzhul,576,monk,mistweaver,12,6,6
Magnustavick,bleeding-hollow,576,monk,mistweaver,12,6,6
Lumiän,area-52,576,monk,mistweaver,12,6,6
Mtsalt,bleeding-hollow,576,monk,mistweaver,12,6,6
Aiswalle,illidan,576,monk,mistweaver,12,6,6
Jieterchan,malganis,576,monk,mistweaver,12,6,6
Bearmode,wyrmrest-accord,576,monk,mistweaver,12,6,6
Pai,sargeras,576,monk,mistweaver,12,6,6
Roloyolo,illidan,576,monk,mistweaver,18,6,12
Fistweebin,area-52,576,monk,mistweaver,18,6,12
Stonefists,ysondre,576,monk,mistweaver,18,6,12
Simarity,kelthuzad,576,monk,mistweaver,18,6,12
Chìforce,sargeras,576,monk,mistweaver,23,6,17
Littlegeorge,moon-guard,575,monk,mistweaver,6,6,0
Philthyjutsu,moon-guard,575,monk,mistweaver,6,6,0
Kung,tichondrius,575,monk,mistweaver,12,6,6
Hibìscus,tichondrius,575,monk,mistweaver,12,6,6
Fânnybâws,stormrage,575,monk,mistweaver,12,6,6
Itsjohnnylol,azuremyst,575,monk,mistweaver,12,6,6
Misha,akama,575,monk,mistweaver,12,6,6
Soysaucë,malganis,575,monk,mistweaver,12,6,6
Monkney,tichondrius,575,monk,mistweaver,12,6,6
Biglinky,sargeras,575,monk,mistweaver,12,6,6
Nf,zuljin,575,monk,mistweaver,12,6,6
Glitchi,area-52,575,monk,mistweaver,12,6,6
Putisucia,nordrassil,575,monk,mistweaver,12,6,6
Laopow,area-52,575,monk,mistweaver,12,6,6
Ormchi,stormrage,575,monk,mistweaver,13,6,7
Opmother,elune,575,monk,mistweaver,18,6,12
Freepunchz,frostmourne,575,monk,mistweaver,18,6,12
Blorkk,area-52,574,monk,mistweaver,12,6,6
Crãsh,quelthalas,574,monk,mistweaver,12,6,6
Yanedin,dalaran,574,monk,mistweaver,12,6,6
Monjepa,illidan,574,monk,mistweaver,18,6,12
Tubbytiph,ghostlands,574,monk,mistweaver,24,6,18
Hastle,windrunner,573,monk,mistweaver,12,6,6
Ironfistorm,stormrage,573,monk,mistweaver,12,6,6
Bluemyselph,tichondrius,573,monk,mistweaver,18,6,12
Mënace,skullcrusher,572,monk,mistweaver,12,6,6
Gaturis,tichondrius,572,monk,mistweaver,21,7,14
Samanosukee,illidan,571,monk,mistweaver,12,6,6
Paladinei,tichondrius,571,monk,mistweaver,12,6,6
Bógus,tichondrius,571,monk,mistweaver,12,6,6
Dejohnette,quelthalas,565,monk,mistweaver,12,6,6
Boofie,perenolde,559,monk,mistweaver,11,6,5
Sohéi,proudmoore,559,monk,mistweaver,17,6,11
Bradyfour,moon-guard,553,monk,mistweaver,25,8,17
Tcoon,frostmourne,543,monk,mistweaver,14,7,7
Monkeybooze,sargeras,543,monk,mistweaver,14,7,7
Sensey,veknilash,527,monk,mistweaver,11,6,5
Domisalamii,sargeras,527,monk,mistweaver,11,6,5
Exuperjun,emerald-dream,522,monk,mistweaver,16,7,9
Mastamonksta,illidan,512,monk,mistweaver,16,6,10
Räyè,tichondrius,511,monk,mistweaver,8,6,2
Fonnf,nemesis,511,monk,mistweaver,8,6,2
Oldmanwalker,mannoroth,511,monk,mistweaver,11,6,5
Jurassaf,illidan,480,monk,mistweaver,6,5,1
Koyon,sargeras,480,monk,mistweaver,6,5,1
Donatello,arthas,480,monk,mistweaver,6,5,1
Bombshellxo,illidan,480,monk,mistweaver,6,5,1
Woes,stormreaver,480,monk,mistweaver,6,5,1
Møzy,darkspear,480,monk,mistweaver,6,5,1
Pinot,dragonmaw,480,monk,mistweaver,6,5,1
Meepz,arthas,480,monk,mistweaver,6,5,1
Theodôn,dalaran,480,monk,mistweaver,6,5,1
Dragonwarior,zuluhed,480,monk,mistweaver,6,5,1
Kayflock,tichondrius,480,monk,mistweaver,6,5,1
Xiang,dreadmaul,480,monk,mistweaver,6,5,1
Spirits,dreadmaul,480,monk,mistweaver,6,5,1
Pungeebi,tichondrius,480,monk,mistweaver,6,5,1
Zbhm,illidan,480,monk,mistweaver,6,5,1
Rivnn,sargeras,480,monk,mistweaver,6,5,1
Flarks,area-52,480,monk,mistweaver,6,5,1
Elcidw,tichondrius,480,monk,mistweaver,6,5,1
Mistwalk,tichondrius,480,monk,mistweaver,6,5,1
Yajirobei,area-52,480,monk,mistweaver,6,5,1
Møzy,tichondrius,480,monk,mistweaver,6,5,1
Stepfíster,tichondrius,480,monk,mistweaver,6,5,1
Pyoapple,tichondrius,480,monk,mistweaver,6,5,1
Grumpî,tichondrius,480,monk,mistweaver,6,5,1
Zxenn,tichondrius,480,monk,mistweaver,6,5,1
Yuldaddy,tichondrius,480,monk,mistweaver,6,5,1
Chingwang,frostmourne,480,monk,mistweaver,6,5,1
Genia,ragnaros,480,monk,mistweaver,6,5,1
Prf,ragnaros,480,monk,mistweaver,6,5,1
Alvinete,tichondrius,480,monk,mistweaver,6,5,1
Satiremaster,frostmourne,480,monk,mistweaver,6,5,1
Siddharthä,barthilas,480,monk,mistweaver,6,5,1
Choibaedal,tichondrius,480,monk,mistweaver,7,5,2
Ocmonk,hyjal,480,monk,mistweaver,12,5,7
Eraticmonk,illidan,480,monk,mistweaver,12,5,7
Nawzhy,emerald-dream,480,monk,mistweaver,12,5,7
Whipllash,tichondrius,480,monk,mistweaver,12,5,7
Gogumamonk,tichondrius,480,monk,mistweaver,12,5,7
Kaiøken,tichondrius,480,monk,mistweaver,12,5,7
Palumorww,deathwing,480,monk,mistweaver,12,5,7
Paradissô,tichondrius,480,monk,mistweaver,12,5,7
Gnarmony,malganis,480,monk,mistweaver,12,5,7
Judo,khadgar,480,monk,mistweaver,12,5,7
Ouibaguette,kelthuzad,480,monk,mistweaver,12,5,7
Odindad,tichondrius,480,monk,mistweaver,12,5,7
Bigolbootay,tichondrius,480,monk,mistweaver,12,5,7
Nîxs,frostmourne,480,monk,mistweaver,12,5,7
Fortyozkilla,thrall,480,monk,mistweaver,12,5,7
Catchmemaybe,stormscale,480,monk,mistweaver,12,5,7
Otzyy,turalyon,480,monk,mistweaver,12,5,7
Kungfused,antonidas,480,monk,mistweaver,12,5,7
Mmrmonkey,tichondrius,480,monk,mistweaver,12,5,7
Masonn,kiljaeden,480,monk,mistweaver,12,5,7
Amybaby,sargeras,480,monk,mistweaver,12,5,7
Onak,illidan,480,monk,mistweaver,12,5,7
Crìstiano,malganis,480,monk,mistweaver,12,5,7
Rockyßalboa,sargeras,480,monk,mistweaver,12,5,7
Snuzzao,darkspear,480,monk,mistweaver,14,5,9
Blackflag,queldorei,480,monk,mistweaver,18,5,13
Màngø,ragnaros,480,monk,mistweaver,18,5,13
Cckknckr,sargeras,480,monk,mistweaver,24,5,19
Monqq,tichondrius,479,monk,mistweaver,6,5,1
Tianhu,sargeras,479,monk,mistweaver,12,5,7
Paticus,area-52,479,monk,mistweaver,12,5,7
Asliam,undermine,479,monk,mistweaver,12,5,7
Annara,tichondrius,479,monk,mistweaver,12,5,7
Troutz,sargeras,479,monk,mistweaver,12,5,7
Bitrau,destromath,479,monk,mistweaver,12,5,7
Angrybrewski,tichondrius,479,monk,mistweaver,12,5,7
Stephani,turalyon,479,monk,mistweaver,12,5,7
Wisepaw,tichondrius,479,monk,mistweaver,12,5,7
Chugs,malorne,479,monk,mistweaver,18,5,13
Satchelgizmo,tichondrius,479,monk,mistweaver,18,5,13
Ltsneaky,bladefist,479,monk,mistweaver,30,5,25
Shmello,akama,478,monk,mistweaver,6,5,1
Cahuun,baelgun,478,monk,mistweaver,12,5,7
Sahalee,emerald-dream,478,monk,mistweaver,12,5,7
Safigirl,doomhammer,478,monk,mistweaver,12,5,7
Yungsun,ragnaros,463,monk,mistweaver,13,6,7
Pinkgucci,thrall,463,monk,mistweaver,17,5,12
Bengal,arthas,447,monk,mistweaver,11,5,6
Beefdadyfist,tichondrius,440,monk,mistweaver,24,8,16
Ogsimpsonn,tichondrius,432,monk,mistweaver,9,5,4
Boomtac,moon-guard,426,monk,mistweaver,9,6,3
Indrazzxx,jubeithos,426,monk,mistweaver,11,7,4
Bellátíx,quelthalas,426,monk,mistweaver,17,9,8
Obàma,tichondrius,426,monk,mistweaver,13,6,7
Keyndanlamor,sargeras,384,monk,mistweaver,6,4,2
Treysongz,illidan,384,monk,mistweaver,6,4,2
Brucetea,chogall,384,monk,mistweaver,6,4,2
Snoogiee,khazgoroth,384,monk,mistweaver,6,4,2
Bigs,duskwood,384,monk,mistweaver,6,4,2
Teddybéar,illidan,384,monk,mistweaver,6,4,2
Monkatron,arthas,384,monk,mistweaver,6,4,2
Balduglybaby,tichondrius,384,monk,mistweaver,6,4,2
Sekushî,kelthuzad,384,monk,mistweaver,6,4,2
Nakiki,cenarion-circle,384,monk,mistweaver,6,4,2
Kharazina,azralon,384,monk,mistweaver,6,4,2
Tinyboots,area-52,384,monk,mistweaver,6,4,2
Jâzze,zuljin,384,monk,mistweaver,6,4,2
Lyla,aegwynn,384,monk,mistweaver,6,4,2
Nipfuu,maelstrom,384,monk,mistweaver,6,4,2
Crentist,mannoroth,384,monk,mistweaver,6,4,2
Danie,nerzhul,384,monk,mistweaver,6,4,2
Lingerer,aerie-peak,384,monk,mistweaver,6,4,2
Kokochiggy,tichondrius,384,monk,mistweaver,6,4,2
Shakeweightt,blackrock,384,monk,mistweaver,6,4,2
Mightbewôrth,thunderhorn,384,monk,mistweaver,6,4,2
Dude,tichondrius,384,monk,mistweaver,6,4,2
Globalmonk,emerald-dream,384,monk,mistweaver,6,4,2
Kobuya,tichondrius,384,monk,mistweaver,6,4,2
Rizzjutsu,stormrage,384,monk,mistweaver,6,4,2
Ufs,illidan,384,monk,mistweaver,6,4,2
Jellobag,frostmane,384,monk,mistweaver,6,4,2
Blpkosher,tichondrius,384,monk,mistweaver,6,4,2
Justamönk,moon-guard,384,monk,mistweaver,6,4,2
Miley,lethon,384,monk,mistweaver,6,4,2
Dontchattome,sargeras,384,monk,mistweaver,6,4,2
Freeoni,sargeras,384,monk,mistweaver,6,4,2
Brewtillis,tichondrius,384,monk,mistweaver,6,4,2
Jmonks,stormrage,384,monk,mistweaver,6,4,2
Srgtbingo,azgalor,384,monk,mistweaver,6,4,2
Brantkicks,tichondrius,384,monk,mistweaver,6,4,2
Keepcryin,gorefiend,384,monk,mistweaver,6,4,2
Howziexd,tichondrius,384,monk,mistweaver,6,4,2
Nezkabad,frostmourne,384,monk,mistweaver,6,4,2
Macrobrewski,tichondrius,384,monk,mistweaver,6,4,2
Mêlon,tichondrius,384,monk,mistweaver,6,4,2
Mizzycash,malganis,384,monk,mistweaver,12,4,8
Áasuna,ragnaros,384,monk,mistweaver,12,4,8
Hirado,kelthuzad,384,monk,mistweaver,12,4,8
Eqoy,moon-guard,384,monk,mistweaver,12,4,8
Zkingmonk,stormrage,384,monk,mistweaver,12,4,8
Nicolascåge,destromath,384,monk,mistweaver,12,4,8
Jimbojenkins,bleeding-hollow,384,monk,mistweaver,12,4,8
Pax,boulderfist,384,monk,mistweaver,12,4,8
Nutbag,norgannon,384,monk,mistweaver,12,4,8
Valkana,kelthuzad,384,monk,mistweaver,12,4,8
Mockz,dentarg,384,monk,mistweaver,12,4,8
Pandàmonium,frostmourne,384,monk,mistweaver,12,4,8
Samzo,barthilas,384,monk,mistweaver,12,4,8
Zënløvë,tichondrius,384,monk,mistweaver,12,4,8
Macktickle,zuljin,384,monk,mistweaver,12,4,8
Darylphilbin,emerald-dream,384,monk,mistweaver,12,4,8
Shredmw,tichondrius,384,monk,mistweaver,12,4,8
Windwalken,sargeras,384,monk,mistweaver,12,4,8
Darkeiji,stormrage,384,monk,mistweaver,12,4,8
Crakgirl,malganis,384,monk,mistweaver,12,4,8
Hoyocochino,quelthalas,384,monk,mistweaver,12,4,8
Sim,frostmourne,384,monk,mistweaver,12,4,8
Jincíe,area-52,384,monk,mistweaver,12,4,8
Sprinkli,sargeras,384,monk,mistweaver,12,4,8
Iamapotato,tichondrius,384,monk,mistweaver,18,4,14
Åvå,emerald-dream,384,monk,mistweaver,18,4,14
Ragepalm,aegwynn,383,monk,mistweaver,6,4,2
Ghostmk,nagrand,383,monk,mistweaver,12,4,8
Zyemell,tichondrius,383,monk,mistweaver,12,4,8
Esleif,moonrunner,383,monk,mistweaver,12,4,8
Jigong,bleeding-hollow,383,monk,mistweaver,12,4,8
Izgoku,frostmane,383,monk,mistweaver,18,4,14
Rollbot,kelthuzad,382,monk,mistweaver,6,4,2
Metalmønk,nerzhul,360,monk,mistweaver,13,7,6
Sáble,stormrage,351,monk,mistweaver,11,4,7
Bakus,tichondrius,336,monk,mistweaver,11,5,6
Varlena,wyrmrest-accord,330,monk,mistweaver,10,5,5
ßiggiesmallz,barthilas,330,monk,mistweaver,12,5,7
Kimchidelite,gorefiend,319,monk,mistweaver,5,4,1
Fiztingfaded,area-52,319,monk,mistweaver,11,4,7
Whatdaheal,darkspear,313,monk,mistweaver,26,5,21
Roskoh,area-52,303,monk,mistweaver,13,4,9
Drkeen,frostmourne,288,monk,mistweaver,10,5,5
Lindraice,illidan,288,monk,mistweaver,6,3,3
Mccoy,quelthalas,288,monk,mistweaver,6,3,3
Hundski,bleeding-hollow,288,monk,mistweaver,6,3,3
Chingu,ragnaros,288,monk,mistweaver,6,3,3
Fistin,laughing-skull,288,monk,mistweaver,6,3,3
Karaka,ysera,288,monk,mistweaver,6,3,3
Cädemaddöx,stormrage,288,monk,mistweaver,6,3,3
Voguex,area-52,288,monk,mistweaver,6,3,3
Xavelha,tichondrius,288,monk,mistweaver,6,3,3
Notcheez,area-52,288,monk,mistweaver,6,3,3
Loppjr,tichondrius,288,monk,mistweaver,6,3,3
Feelsogöod,tichondrius,288,monk,mistweaver,6,3,3
Alianli,tichondrius,288,monk,mistweaver,6,3,3
Imisswodxo,illidan,288,monk,mistweaver,6,3,3
Stigzz,stormrage,288,monk,mistweaver,6,3,3
Vidrus,gorefiend,288,monk,mistweaver,6,3,3
Spacoli,stormrage,288,monk,mistweaver,6,3,3
Zzizzi,tichondrius,288,monk,mistweaver,6,3,3
Greenteafrãp,bleeding-hollow,288,monk,mistweaver,6,3,3
Pisswalker,area-52,288,monk,mistweaver,6,3,3
Lawroadp,tichondrius,288,monk,mistweaver,6,3,3
Lemeta,tichondrius,288,monk,mistweaver,6,3,3
Saeloon,frostmourne,288,monk,mistweaver,6,3,3
Fammi,stormrage,288,monk,mistweaver,6,3,3
Aphrodîîte,area-52,288,monk,mistweaver,6,3,3
Ighostgirls,thrall,288,monk,mistweaver,6,3,3
Teclas,ragnaros,288,monk,mistweaver,6,3,3
Növa,alterac-mountains,288,monk,mistweaver,6,3,3
Austaar,frostmourne,288,monk,mistweaver,6,3,3
Maripaulita,ragnaros,288,monk,mistweaver,6,3,3
Lundch,tichondrius,288,monk,mistweaver,6,3,3
Streetcreds,bleeding-hollow,288,monk,mistweaver,6,3,3
Maybeyooshi,kelthuzad,288,monk,mistweaver,6,3,3
Fysicalx,zuljin,288,monk,mistweaver,6,3,3
Graoul,thaurissan,288,monk,mistweaver,6,3,3
Ðreadhot,malganis,288,monk,mistweaver,6,3,3
Bosschops,illidan,288,monk,mistweaver,6,3,3
Gguldduck,tichondrius,288,monk,mistweaver,6,3,3
Stunnedheals,arthas,288,monk,mistweaver,6,3,3
Mauvem,tichondrius,288,monk,mistweaver,6,3,3
Billycobham,tichondrius,288,monk,mistweaver,6,3,3
Zeelos,kelthuzad,288,monk,mistweaver,6,3,3
Fistër,area-52,288,monk,mistweaver,6,3,3
Galeindra,whisperwind,288,monk,mistweaver,6,3,3
Giggacuck,frostmourne,288,monk,mistweaver,6,3,3
Rzeznik,boulderfist,288,monk,mistweaver,6,3,3
Möösê,moon-guard,288,monk,mistweaver,6,3,3
Fìst,hyjal,288,monk,mistweaver,6,3,3
Hogarg,emerald-dream,288,monk,mistweaver,6,3,3
Brosiedon,sargeras,288,monk,mistweaver,6,3,3
Miýagi,sargeras,288,monk,mistweaver,6,3,3
Ase,frostwolf,288,monk,mistweaver,6,3,3
Jlowbob,tichondrius,288,monk,mistweaver,6,3,3
Zaçh,frostmane,288,monk,mistweaver,6,3,3
Spiritmist,sargeras,288,monk,mistweaver,6,3,3
Abevx,bonechewer,288,monk,mistweaver,6,3,3
Tambher,lightbringer,288,monk,mistweaver,6,3,3
Jbonk,hyjal,288,monk,mistweaver,6,3,3
Droppinfast,sargeras,288,monk,mistweaver,6,3,3
Saltyone,firetree,288,monk,mistweaver,6,3,3
Quartztiger,sargeras,288,monk,mistweaver,6,3,3
Fitofryfitof,aegwynn,288,monk,mistweaver,6,3,3
Sterow,kiljaeden,288,monk,mistweaver,6,3,3
Grogio,wyrmrest-accord,288,monk,mistweaver,6,3,3
Ryukenshin,proudmoore,288,monk,mistweaver,6,3,3
Kúrios,azralon,288,monk,mistweaver,10,3,7
Selfîe,ysera,288,monk,mistweaver,12,3,9
Mwtouch,nemesis,288,monk,mistweaver,12,3,9
Wizcaulifa,stormrage,288,monk,mistweaver,12,3,9
Absolutvodca,nemesis,288,monk,mistweaver,12,3,9
Wørm,emerald-dream,288,monk,mistweaver,12,3,9
Vchii,tichondrius,288,monk,mistweaver,12,3,9
Chilliweaver,frostmourne,288,monk,mistweaver,12,3,9
Korvishka,malganis,288,monk,mistweaver,12,3,9
Starskreem,tichondrius,287,monk,mistweaver,6,3,3
Deyseddia,azgalor,287,monk,mistweaver,6,3,3
Alanimistw,khadgar,287,monk,mistweaver,6,3,3
Madmoose,smolderthorn,287,monk,mistweaver,6,3,3
Holandri,moon-guard,287,monk,mistweaver,6,3,3
Rosinhood,illidan,287,monk,mistweaver,6,3,3
Gatsbi,arthas,287,monk,mistweaver,6,3,3
Fistidmi,area-52,287,monk,mistweaver,11,4,7
Shlumpuh,tichondrius,287,monk,mistweaver,16,4,12
Lilpielover,zuljin,286,monk,mistweaver,15,4,11
Karkata,sargeras,284,monk,mistweaver,18,3,15
Hinudhera,barthilas,274,monk,mistweaver,25,6,19
Lildae,burning-legion,256,monk,mistweaver,4,4,0
Excitable,moon-guard,234,monk,mistweaver,8,4,4
Zeisei,wyrmrest-accord,234,monk,mistweaver,10,4,6
Friedpanda,kelthuzad,234,monk,mistweaver,16,4,12
Hunchojack,undermine,192,monk,mistweaver,4,3,1
Fortnight,emerald-dream,192,monk,mistweaver,6,2,4
Zåz,nazgrel,192,monk,mistweaver,6,2,4
Wamii,tichondrius,192,monk,mistweaver,6,2,4
Barlyfe,tichondrius,192,monk,mistweaver,6,2,4
Drfistyfingr,malganis,192,monk,mistweaver,6,2,4
Quitschi,tichondrius,192,monk,mistweaver,6,2,4
Inalambrico,quelthalas,192,monk,mistweaver,6,2,4
Hitchslapz,tichondrius,192,monk,mistweaver,6,2,4
Mistbeard,aggramar,192,monk,mistweaver,6,2,4
Lilknucks,bonechewer,192,monk,mistweaver,6,2,4
Tarae,nagrand,192,monk,mistweaver,6,2,4
Fistorcstar,daggerspine,192,monk,mistweaver,6,2,4
Fïstbeaver,malganis,192,monk,mistweaver,6,2,4
Hymasterlol,tichondrius,192,monk,mistweaver,6,2,4
Apparent,lightnings-blade,192,monk,mistweaver,6,2,4
Silkymoves,tichondrius,192,monk,mistweaver,6,2,4
Aquamonk,tichondrius,192,monk,mistweaver,6,2,4
Pumpsx,area-52,192,monk,mistweaver,6,2,4
Selocke,bleeding-hollow,192,monk,mistweaver,6,2,4
Zengoku,zuljin,192,monk,mistweaver,6,2,4
Iililiililil,stormrage,192,monk,mistweaver,6,2,4
Fäded,trollbane,192,monk,mistweaver,6,2,4
Privm,moonrunner,192,monk,mistweaver,6,2,4
Jayjaybrew,area-52,192,monk,mistweaver,6,2,4
Rubntug,zuljin,192,monk,mistweaver,6,2,4
Sebasu,perenolde,192,monk,mistweaver,6,2,4
Chaihard,sargeras,192,monk,mistweaver,6,2,4
Caralia,exodar,192,monk,mistweaver,6,2,4
Foxmacleod,bleeding-hollow,192,monk,mistweaver,6,2,4
Ashenn,area-52,192,monk,mistweaver,6,2,4
Jaybum,sargeras,192,monk,mistweaver,6,2,4
Odradek,thunderlord,192,monk,mistweaver,6,2,4
Hugerichard,wyrmrest-accord,192,monk,mistweaver,6,2,4
Xanzee,area-52,192,monk,mistweaver,6,2,4
Skadouch,wyrmrest-accord,192,monk,mistweaver,6,2,4
Flagreturned,illidan,192,monk,mistweaver,6,2,4
Bodyshot,area-52,192,monk,mistweaver,6,2,4
Jittersx,silvermoon,192,monk,mistweaver,6,2,4
Melocotonn,goldrinn,192,monk,mistweaver,6,2,4
Taipanni,sargeras,192,monk,mistweaver,6,2,4
Nilonsso,sargeras,192,monk,mistweaver,6,2,4
Theriní,stormrage,192,monk,mistweaver,6,2,4
Streetjezus,bloodhoof,192,monk,mistweaver,6,2,4
Acena,stormrage,192,monk,mistweaver,6,2,4
Fumoo,sargeras,192,monk,mistweaver,6,2,4
Tigerlust,sargeras,192,monk,mistweaver,6,2,4
Onepunch,exodar,192,monk,mistweaver,7,2,5
Coffeek,area-52,192,monk,mistweaver,8,2,6
Glowsgreenby,area-52,192,monk,mistweaver,8,2,6
Ðetroitsmash,sargeras,192,monk,mistweaver,12,2,10
Bubblekit,nerzhul,192,monk,mistweaver,12,2,10
Tacoma,sargeras,192,monk,mistweaver,12,2,10
Sanytea,sargeras,192,monk,mistweaver,12,2,10
Monkik,laughing-skull,192,monk,mistweaver,12,2,10
Hellcow,frostmourne,192,monk,mistweaver,12,2,10
Tragictea,zuljin,192,monk,mistweaver,12,2,10
Whynotec,tichondrius,192,monk,mistweaver,12,2,10
Kick,dragonmaw,192,monk,mistweaver,12,2,10
Missmagda,darkspear,192,monk,mistweaver,12,2,10
Mung,boulderfist,192,monk,mistweaver,12,2,10
Fatde,daggerspine,192,monk,mistweaver,18,2,16
Senzmist,lightbringer,191,monk,mistweaver,6,2,4
Realisthands,barthilas,191,monk,mistweaver,6,2,4
Honestworkz,area-52,191,monk,mistweaver,6,2,4
Jeme,tichondrius,191,monk,mistweaver,6,2,4
Rorik,deathwing,191,monk,mistweaver,12,2,10
Phystweaver,malganis,175,monk,mistweaver,11,2,9
Hyugga,azralon,159,monk,mistweaver,5,2,3
Craziediemon,malganis,138,monk,mistweaver,8,3,5
Fijiwater,stormrage,138,monk,mistweaver,9,3,6
ßøøstêðçhåñ,illidan,138,monk,mistweaver,9,3,6
Matsakaicin,azralon,138,monk,mistweaver,10,3,7
Doomstroller,aegwynn,138,monk,mistweaver,11,3,8
Vyostao,ragnaros,138,monk,mistweaver,11,3,8
Averagéjoe,tichondrius,127,monk,mistweaver,8,2,6
Figurines,sargeras,112,monk,mistweaver,7,2,5
Findorato,windrunner,96,monk,mistweaver,6,1,5
Monkuxe,zuljin,96,monk,mistweaver,6,1,5
Kenvuki,emerald-dream,96,monk,mistweaver,6,1,5
Stinx,ragnaros,96,monk,mistweaver,6,1,5
Kungfucheeks,illidan,96,monk,mistweaver,6,1,5
Ünarù,area-52,96,monk,mistweaver,6,1,5
Raylá,kelthuzad,96,monk,mistweaver,6,1,5
Charrek,zuljin,96,monk,mistweaver,6,1,5
Kiawe,zuljin,96,monk,mistweaver,6,1,5
Onegai,illidan,96,monk,mistweaver,6,1,5
Notthefather,area-52,96,monk,mistweaver,6,1,5
Farmerstan,sargeras,96,monk,mistweaver,6,1,5
Fatboyswag,tichondrius,96,monk,mistweaver,6,1,5
Danicah,altar-of-storms,96,monk,mistweaver,6,1,5
Stickyloads,illidan,96,monk,mistweaver,6,1,5
Froggie,illidan,96,monk,mistweaver,6,1,5
Samaera,uther,96,monk,mistweaver,6,1,5
Ruion,moon-guard,96,monk,mistweaver,6,1,5
Squidbillie,moon-guard,96,monk,mistweaver,6,1,5
Shrimptown,dalaran,96,monk,mistweaver,6,1,5
Kayakpunch,moon-guard,96,monk,mistweaver,6,1,5
Frankènmonk,illidan,96,monk,mistweaver,6,1,5
Lainerya,moon-guard,96,monk,mistweaver,6,1,5
Ezpzmonk,bloodscalp,96,monk,mistweaver,6,1,5
Naveex,bleeding-hollow,96,monk,mistweaver,6,1,5
Turkeydinner,frostmourne,96,monk,mistweaver,6,1,5
Súprä,stormrage,96,monk,mistweaver,6,1,5
Ogmonk,skullcrusher,96,monk,mistweaver,6,1,5
Kimmyfists,tichondrius,96,monk,mistweaver,6,1,5
Zrza,tichondrius,96,monk,mistweaver,6,1,5
Lomist,nazjatar,96,monk,mistweaver,6,1,5
Brewtalìty,tichondrius,96,monk,mistweaver,6,1,5
Dankestkhan,korialstrasz,96,monk,mistweaver,6,1,5
Ghostsofur,tichondrius,96,monk,mistweaver,12,1,11
Eliwenn,ragnaros,96,monk,mistweaver,12,1,11
Selectra,malfurion,95,monk,mistweaver,6,1,5
Sputnîk,nemesis,84,monk,mistweaver,16,6,10
Fairymonk,frostwolf,79,monk,mistweaver,5,1,4
Braindi,arathor,79,monk,mistweaver,5,1,4
Clixstermonk,area-52,79,monk,mistweaver,5,1,4
Majinyooshi,kelthuzad,64,monk,mistweaver,4,1,3
Thalreyzian,vashj,64,monk,mistweaver,4,1,3
Deethnutth,bleeding-hollow,63,monk,mistweaver,2,2,0
Sivedrafely,arthas,42,monk,mistweaver,17,2,15
Epucphail,kelthuzad,1219,monk,brewmaster,42,15,27
Omgar,frostmourne,1046,monk,brewmaster,44,17,27
Worldpvp,nerzhul,767,monk,brewmaster,27,9,18
Daesun,quelthalas,672,monk,brewmaster,12,7,5
Robbo,tichondrius,288,monk,brewmaster,6,3,3
Quaria,moon-guard,288,monk,brewmaster,18,3,15
Drunkfight,zuljin,192,monk,brewmaster,18,2,16
Encry,zuljin,191,monk,brewmaster,6,2,4
Ferrarí,quelthalas,79,monk,brewmaster,11,1,10
Neighbors,sargeras,2265,monk,windwalker,103,58,45
Keyam,illidan,2208,monk,windwalker,101,54,47
Iminglee,area-52,2178,monk,windwalker,88,46,42
Sean,nazjatar,2143,monk,windwalker,72,38,34
Senseiww,sargeras,2143,monk,windwalker,126,64,62
Thewy,tichondrius,2132,monk,windwalker,108,55,53
Rickybobbyx,vashj,2129,monk,windwalker,96,50,46
Droguex,tichondrius,2128,monk,windwalker,222,111,111
Cmx,sargeras,2125,monk,windwalker,172,88,84
Riversøng,frostmourne,2115,monk,windwalker,84,46,38
Flattsww,tichondrius,2111,monk,windwalker,274,140,134
Stárset,illidan,2104,monk,windwalker,96,54,42
Iílílílílílí,area-52,2101,monk,windwalker,84,43,41
Fatal,bonechewer,2059,monk,windwalker,118,65,53
Pacmankr,tichondrius,2016,monk,windwalker,105,52,53
Blackpandax,tichondrius,2008,monk,windwalker,107,55,52
Fueld,burning-legion,2000,monk,windwalker,246,125,121
Larryjonés,area-52,1992,monk,windwalker,120,59,61
Lodbork,tichondrius,1974,monk,windwalker,341,178,163
Fínzy,ragnaros,1964,monk,windwalker,54,30,24
Touchofdeáth,stormrage,1963,monk,windwalker,125,69,56
Conngaline,stormreaver,1963,monk,windwalker,227,112,115
Cuteirl,tichondrius,1958,monk,windwalker,42,32,10
Threnody,malganis,1957,monk,windwalker,76,39,37
Nehji,illidan,1956,monk,windwalker,57,31,26
Bdw,tichondrius,1955,monk,windwalker,130,78,52
Hypnøtìze,frostmourne,1953,monk,windwalker,107,56,51
Yerky,stormrage,1951,monk,windwalker,60,32,28
Vybïn,tichondrius,1951,monk,windwalker,181,94,87
Liamllama,barthilas,1945,monk,windwalker,80,41,39
Spotifyfan,ysera,1944,monk,windwalker,147,80,67
Jaxvisto,dalaran,1940,monk,windwalker,95,51,44
Mikephoenix,tichondrius,1934,monk,windwalker,36,23,13
Repbrew,sargeras,1934,monk,windwalker,81,40,41
Madtiger,scilla,1933,monk,windwalker,78,38,40
Wondý,quelthalas,1931,monk,windwalker,173,86,87
Chyx,tichondrius,1931,monk,windwalker,64,30,34
Frootsmoothi,thrall,1929,monk,windwalker,77,38,39
Weathermanxv,kelthuzad,1927,monk,windwalker,105,48,57
Wwlékinhø,azralon,1924,monk,windwalker,54,33,21
Rytes,moon-guard,1908,monk,windwalker,147,74,73
Bigherosixx,tichondrius,1907,monk,windwalker,60,34,26
Dzq,stormrage,1906,monk,windwalker,87,48,39
Chopt,zuljin,1895,monk,windwalker,72,33,39
Serthean,illidan,1891,monk,windwalker,152,77,75
Maozhën,tichondrius,1882,monk,windwalker,60,31,29
Shïvïr,azralon,1877,monk,windwalker,131,66,65
Helvectius,tichondrius,1874,monk,windwalker,150,70,80
Catgallery,tichondrius,1872,monk,windwalker,173,82,91
Artam,thrall,1859,monk,windwalker,65,40,25
Torkscrew,bleeding-hollow,1850,monk,windwalker,36,21,15
Fátë,tichondrius,1848,monk,windwalker,84,37,47
Guylian,tichondrius,1845,monk,windwalker,58,30,28
Tschi,illidan,1844,monk,windwalker,42,29,13
Crashandflow,zuljin,1844,monk,windwalker,48,25,23
Smokechief,hyjal,1841,monk,windwalker,48,27,21
Omnly,stormrage,1841,monk,windwalker,50,26,24
Baddi,uldum,1841,monk,windwalker,94,46,48
Allmight,wyrmrest-accord,1839,monk,windwalker,105,58,47
Kuranchi,sargeras,1836,monk,windwalker,42,23,19
Sunfistway,sargeras,1835,monk,windwalker,80,48,32
Judo,agamaggan,1827,monk,windwalker,57,25,32
Lopez,sargeras,1825,monk,windwalker,54,35,19
Edenx,sargeras,1825,monk,windwalker,42,23,19
Xanaxåddict,sargeras,1823,monk,windwalker,128,66,62
Nelariah,wyrmrest-accord,1822,monk,windwalker,59,28,31
Sentomaru,bleeding-hollow,1820,monk,windwalker,66,33,33
Brewceo,area-52,1817,monk,windwalker,60,32,28
Turbofist,bleeding-hollow,1803,monk,windwalker,42,25,17
Muhli,kiljaeden,1800,monk,windwalker,42,22,20
Screwz,tichondrius,1797,monk,windwalker,56,28,28
Homun,tichondrius,1794,monk,windwalker,59,28,31
Inbu,tichondrius,1790,monk,windwalker,81,35,46
Gigached,zuljin,1787,monk,windwalker,57,27,30
Alps,darkspear,1780,monk,windwalker,48,24,24
Rockyßalboa,sargeras,1774,monk,windwalker,85,50,35
Monkatron,arthas,1770,monk,windwalker,77,38,39
Yuujitsu,sargeras,1768,monk,windwalker,96,48,48
Primez,frostmourne,1763,monk,windwalker,41,22,19
Haharetsdead,illidan,1758,monk,windwalker,125,71,54
Jükedx,stormrage,1756,monk,windwalker,85,52,33
Jåðëðrägøñ,sargeras,1745,monk,windwalker,61,36,25
Kagebunshin,kelthuzad,1744,monk,windwalker,42,25,17
Bruceteå,area-52,1744,monk,windwalker,36,19,17
Zynflex,tichondrius,1743,monk,windwalker,59,27,32
Zenluckydo,grizzly-hills,1740,monk,windwalker,65,39,26
Lker,sargeras,1740,monk,windwalker,60,31,29
Pandagirlw,tichondrius,1735,monk,windwalker,72,43,29
Ambal,hellscream,1734,monk,windwalker,55,32,23
Kárma,malganis,1731,monk,windwalker,42,24,18
Robbo,tichondrius,1730,monk,windwalker,54,25,29
Jasey,area-52,1729,monk,windwalker,29,21,8
Mechamonk,aerie-peak,1728,monk,windwalker,105,46,59
Percentx,tichondrius,1722,monk,windwalker,36,18,18
Khawai,sargeras,1720,monk,windwalker,36,23,13
Boostedww,bloodscalp,1720,monk,windwalker,48,25,23
Takkeya,zuljin,1713,monk,windwalker,42,25,17
Marçi,moon-guard,1713,monk,windwalker,36,21,15
Tenooki,illidan,1707,monk,windwalker,41,19,22
Tippytap,bleeding-hollow,1707,monk,windwalker,54,23,31
Windmónk,tichondrius,1705,monk,windwalker,89,44,45
Monkgyatso,drakthul,1704,monk,windwalker,72,37,35
Titanus,chogall,1702,monk,windwalker,301,156,145
Wolffangfist,sargeras,1695,monk,windwalker,69,42,27
Napbox,bleeding-hollow,1694,monk,windwalker,92,44,48
Furiamvp,stormrage,1693,monk,windwalker,42,23,19
Unhappyclown,tichondrius,1692,monk,windwalker,59,34,25
Sínsayer,tichondrius,1691,monk,windwalker,42,20,22
Jümmy,area-52,1690,monk,windwalker,36,18,18
Pankekz,tichondrius,1689,monk,windwalker,90,48,42
Maomaogun,tichondrius,1687,monk,windwalker,30,23,7
Bamron,fizzcrank,1686,monk,windwalker,101,52,49
Shids,barthilas,1686,monk,windwalker,47,22,25
Vanmonk,eonar,1681,monk,windwalker,36,18,18
Zhoku,tichondrius,1674,monk,windwalker,30,19,11
Tôpsônworld,tichondrius,1671,monk,windwalker,60,35,25
Zenigma,area-52,1670,monk,windwalker,45,24,21
Dea,thrall,1670,monk,windwalker,84,43,41
Rakije,barthilas,1669,monk,windwalker,66,40,26
Bigpoppap,tichondrius,1668,monk,windwalker,54,29,25
Hèllòkîttý,illidan,1666,monk,windwalker,30,19,11
Hæt,stormrage,1665,monk,windwalker,48,23,25
Züdo,area-52,1663,monk,windwalker,51,22,29
Rigi,stormrage,1661,monk,windwalker,95,43,52
Lhiri,moon-guard,1661,monk,windwalker,42,19,23
Hotwatertank,area-52,1658,monk,windwalker,48,29,19
Adamthemonk,proudmoore,1654,monk,windwalker,39,26,13
Dumplíngs,emerald-dream,1647,monk,windwalker,59,27,32
Snebyos,tichondrius,1646,monk,windwalker,42,25,17
Lahri,silvermoon,1646,monk,windwalker,50,27,23
Mists,velen,1645,monk,windwalker,54,31,23
Oxli,emerald-dream,1645,monk,windwalker,46,26,20
Karmerr,proudmoore,1645,monk,windwalker,48,23,25
Ludanford,eitrigg,1643,monk,windwalker,42,22,20
Mastâ,kelthuzad,1642,monk,windwalker,78,41,37
Foxchik,zuljin,1641,monk,windwalker,76,42,34
Capiirotta,nemesis,1639,monk,windwalker,80,48,32
Galaxystrike,illidan,1638,monk,windwalker,36,20,16
Hagano,drakkari,1637,monk,windwalker,77,44,33
Senritsuh,drakkari,1625,monk,windwalker,40,18,22
Tnsnow,illidan,1623,monk,windwalker,36,21,15
Fistyuh,illidan,1621,monk,windwalker,30,20,10
Fuqmeh,darkspear,1621,monk,windwalker,84,42,42
Jigong,bleeding-hollow,1620,monk,windwalker,42,23,19
Karelio,wyrmrest-accord,1619,monk,windwalker,48,22,26
Aidenww,area-52,1618,monk,windwalker,24,17,7
Jbills,muradin,1617,monk,windwalker,53,32,21
Jerax,thunderlord,1617,monk,windwalker,97,55,42
Corsan,illidan,1616,monk,windwalker,42,30,12
Hadoukeñ,thrall,1616,monk,windwalker,41,22,19
Euman,sargeras,1613,monk,windwalker,36,21,15
Shaszx,zuljin,1613,monk,windwalker,41,22,19
Themanski,area-52,1612,monk,windwalker,46,24,22
Xradu,dawnbringer,1611,monk,windwalker,66,41,25
Syerzie,dalaran,1611,monk,windwalker,51,22,29
Fistnu,aggramar,1608,monk,windwalker,83,49,34
Flyingfury,illidan,1604,monk,windwalker,54,25,29
Bruhmesoftly,thrall,1601,monk,windwalker,60,34,26
Pepeloser,illidan,1601,monk,windwalker,48,23,25
Ronk,the-forgotten-coast,1600,monk,windwalker,30,17,13
Dirtypunch,proudmoore,1598,monk,windwalker,42,19,23
Windwalker,blackhand,1597,monk,windwalker,35,19,16
Lingerer,aerie-peak,1593,monk,windwalker,110,57,53
Marcusm,bleeding-hollow,1592,monk,windwalker,33,20,13
Surgarush,moon-guard,1592,monk,windwalker,106,64,42
Druta,illidan,1589,monk,windwalker,42,32,10
Reprap,elune,1582,monk,windwalker,58,33,25
Kogoli,frostwolf,1580,monk,windwalker,101,47,54
Råii,sargeras,1579,monk,windwalker,30,20,10
Wonderx,darkspear,1579,monk,windwalker,30,20,10
Toyotatacoma,bleeding-hollow,1578,monk,windwalker,36,23,13
Copenfist,black-dragonflight,1578,monk,windwalker,36,21,15
Pokinpooters,stormrage,1578,monk,windwalker,108,56,52
Pinot,dragonmaw,1572,monk,windwalker,42,17,25
Meatwrap,mugthol,1566,monk,windwalker,52,26,26
Unlike,tichondrius,1566,monk,windwalker,84,40,44
Daddyrugburn,area-52,1558,monk,windwalker,36,20,16
Sonsia,arthas,1554,monk,windwalker,82,47,35
Bakedmonk,smolderthorn,1553,monk,windwalker,40,19,21
Fistnafurry,tichondrius,1550,monk,windwalker,42,21,21
Chucksandmk,barthilas,1548,monk,windwalker,54,25,29
Therapeutics,moon-guard,1548,monk,windwalker,78,35,43
Nagato,nemesis,1545,monk,windwalker,23,17,6
Borekkar,emerald-dream,1544,monk,windwalker,41,22,19
Chingu,ragnaros,1543,monk,windwalker,123,59,64
Gøgeta,stormrage,1543,monk,windwalker,42,19,23
Vai,korgath,1542,monk,windwalker,36,17,19
Cpapi,sargeras,1540,monk,windwalker,54,24,30
Odi,stonemaul,1535,monk,windwalker,89,42,47
Çraßsßùrgêr,bonechewer,1533,monk,windwalker,24,16,8
Mitras,dragonblight,1529,monk,windwalker,24,16,8
Zaabuza,azralon,1528,monk,windwalker,60,39,21
Fapmonk,illidan,1527,monk,windwalker,30,22,8
Kómugi,area-52,1525,monk,windwalker,95,51,44
Muritors,ragnaros,1523,monk,windwalker,36,17,19
Byakugun,wyrmrest-accord,1522,monk,windwalker,36,21,15
Naagg,tichondrius,1521,monk,windwalker,30,16,14
Yoshifistsu,malganis,1521,monk,windwalker,54,26,28
Odogin,tichondrius,1520,monk,windwalker,65,42,23
Dïsturbedtko,azralon,1519,monk,windwalker,90,42,48
Bløødÿ,ragnaros,1516,monk,windwalker,21,17,4
Wartenja,frostmourne,1516,monk,windwalker,84,41,43
Göllyjee,tichondrius,1516,monk,windwalker,72,30,42
Healzpapi,tichondrius,1513,monk,windwalker,72,48,24
Kutz,proudmoore,1512,monk,windwalker,75,37,38
Sgarbossa,tortheldrin,1509,monk,windwalker,42,16,26
Dabzin,stormrage,1508,monk,windwalker,79,41,38
Arizøna,illidan,1507,monk,windwalker,80,44,36
Hòlygòd,dalaran,1505,monk,windwalker,54,28,26
Phukyu,moon-guard,1504,monk,windwalker,48,26,22
Geekweek,frostmourne,1503,monk,windwalker,30,17,13
Npepper,khadgar,1503,monk,windwalker,52,23,29
Hím,garrosh,1500,monk,windwalker,49,28,21
Banyasong,tichondrius,1497,monk,windwalker,36,21,15
Ascilica,firetree,1495,monk,windwalker,24,16,8
Kawasakii,tichondrius,1495,monk,windwalker,142,75,67
Shishosenin,quelthalas,1495,monk,windwalker,152,72,80
Harde,thrall,1492,monk,windwalker,65,29,36
Varn,frostmourne,1488,monk,windwalker,74,35,39
Simonb,tichondrius,1487,monk,windwalker,54,24,30
Rockemsockem,gorefiend,1485,monk,windwalker,90,48,42
Kiulang,kelthuzad,1483,monk,windwalker,93,44,49
Brewbaker,hyjal,1480,monk,windwalker,38,21,17
Broomooster,bleeding-hollow,1479,monk,windwalker,47,20,27
Ökami,tichondrius,1473,monk,windwalker,48,24,24
Daslow,quelthalas,1468,monk,windwalker,116,62,54
Mastahp,tichondrius,1457,monk,windwalker,42,23,19
Tigerstrikes,sargeras,1456,monk,windwalker,24,16,8
Tyroneßanks,stormrage,1456,monk,windwalker,30,17,13
Showshoway,tichondrius,1450,monk,windwalker,53,23,30
Lickthefist,sargeras,1445,monk,windwalker,24,16,8
Shôckley,tichondrius,1445,monk,windwalker,90,46,44
Zionk,tichondrius,1443,monk,windwalker,42,29,13
Ahrk,emerald-dream,1439,monk,windwalker,58,20,38
Katsübooy,azralon,1437,monk,windwalker,221,113,108
Lavinci,area-52,1437,monk,windwalker,30,15,15
Jegann,tichondrius,1435,monk,windwalker,92,41,51
Fistys,area-52,1433,monk,windwalker,117,60,57
Heiwei,stormrage,1432,monk,windwalker,24,15,9
Elfoverde,stormrage,1430,monk,windwalker,24,15,9
Xuenws,tichondrius,1429,monk,windwalker,24,15,9
Thåi,anubarak,1426,monk,windwalker,42,15,27
Yamoshì,stormrage,1425,monk,windwalker,48,25,23
Domiik,ragnaros,1421,monk,windwalker,30,15,15
Kungxxl,kiljaeden,1419,monk,windwalker,62,33,29
Wind,misha,1416,monk,windwalker,31,22,9
Shlumpuh,tichondrius,1412,monk,windwalker,36,16,20
Gesir,tichondrius,1408,monk,windwalker,30,15,15
Bhodie,zuljin,1407,monk,windwalker,42,16,26
Killmachine,farstriders,1393,monk,windwalker,93,44,49
Milkychi,frostmourne,1392,monk,windwalker,40,15,25
Resolver,stormscale,1385,monk,windwalker,40,23,17
Backfliptime,ragnaros,1383,monk,windwalker,34,19,15
Pepepunch,bleeding-hollow,1381,monk,windwalker,36,15,21
Astrofu,tichondrius,1373,monk,windwalker,64,26,38
Brewmaker,sargeras,1372,monk,windwalker,46,22,24
Shianjuo,ragnaros,1372,monk,windwalker,42,20,22
Tassmonk,hyjal,1367,monk,windwalker,36,17,19
Ghaelessi,senjin,1366,monk,windwalker,71,40,31
Daracus,kelthuzad,1364,monk,windwalker,26,18,8
Bluntdoctor,stormreaver,1361,monk,windwalker,60,22,38
Rïggen,thrall,1360,monk,windwalker,23,15,8
Kriticalkush,kelthuzad,1353,monk,windwalker,24,17,7
Owned,dreadmaul,1349,monk,windwalker,36,23,13
Smoothboxing,tichondrius,1347,monk,windwalker,86,48,38
Sultanofwind,malganis,1344,monk,windwalker,24,14,10
Gún,ragnaros,1344,monk,windwalker,72,34,38
Zuì,sargeras,1342,monk,windwalker,24,14,10
Garmakasmonk,skullcrusher,1341,monk,windwalker,34,19,15
Skymonge,stormrage,1339,monk,windwalker,74,33,41
Pangpoong,tichondrius,1339,monk,windwalker,45,20,25
Plucky,tichondrius,1337,monk,windwalker,32,14,18
Trapeez,kelthuzad,1326,monk,windwalker,58,32,26
Saltystepbro,illidan,1323,monk,windwalker,24,14,10
Butjaum,stormrage,1313,monk,windwalker,40,16,24
Acharä,tichondrius,1305,monk,windwalker,36,20,16
Goonkeg,frostmourne,1304,monk,windwalker,30,14,16
Napoleonic,vashj,1303,monk,windwalker,24,14,10
Jacquelline,moon-guard,1294,monk,windwalker,36,19,17
Dodried,ragnaros,1290,monk,windwalker,52,24,28
Sleýin,tichondrius,1284,monk,windwalker,71,33,38
Fanetö,stormrage,1283,monk,windwalker,48,15,33
Sarious,lightbringer,1282,monk,windwalker,127,65,62
Tacofox,tichondrius,1282,monk,windwalker,48,19,29
Zettelkasten,tichondrius,1266,monk,windwalker,42,21,21
Wutangkillaß,kiljaeden,1266,monk,windwalker,48,18,30
Tino,kelthuzad,1265,monk,windwalker,60,31,29
Weezzyboi,tichondrius,1263,monk,windwalker,42,22,20
Anarska,thrall,1263,monk,windwalker,90,42,48
Natus,greymane,1262,monk,windwalker,36,18,18
Kungfüsed,stormrage,1260,monk,windwalker,24,14,10
Supremekick,frostmourne,1254,monk,windwalker,39,25,14
Opmother,elune,1252,monk,windwalker,35,19,16
Dazzler,ragnaros,1250,monk,windwalker,36,15,21
Hamyu,illidan,1247,monk,windwalker,30,15,15
Prostotak,area-52,1246,monk,windwalker,18,13,5
Zeati,tichondrius,1246,monk,windwalker,18,13,5
Pamii,quelthalas,1246,monk,windwalker,36,13,23
Båshkin,terenas,1245,monk,windwalker,42,19,23
Xiaowën,nemesis,1244,monk,windwalker,43,19,24
Bükki,ragnaros,1243,monk,windwalker,18,13,5
Marstol,bleeding-hollow,1241,monk,windwalker,47,30,17
Nightww,area-52,1241,monk,windwalker,24,13,11
Fimeu,kiljaeden,1240,monk,windwalker,24,13,11
Tianhu,sargeras,1239,monk,windwalker,30,15,15
Screwballz,blackrock,1239,monk,windwalker,51,16,35
Hinakii,dalaran,1230,monk,windwalker,103,44,59
Yrn,crushridge,1229,monk,windwalker,42,21,21
Ruckm,stormrage,1225,monk,windwalker,24,13,11
Xøxo,trollbane,1220,monk,windwalker,24,13,11
Stickyloads,illidan,1220,monk,windwalker,72,33,39
Rufaso,sargeras,1207,monk,windwalker,36,16,20
Gurda,wyrmrest-accord,1204,monk,windwalker,54,25,29
Ofn,moon-guard,1202,monk,windwalker,96,45,51
Xéia,area-52,1201,monk,windwalker,60,23,37
Akanq,tichondrius,1194,monk,windwalker,27,13,14
Ohgiddyttv,dalaran,1188,monk,windwalker,36,13,23
Razielic,frostmourne,1185,monk,windwalker,42,17,25
Sleepÿ,area-52,1171,monk,windwalker,84,34,50
Milktank,medivh,1167,monk,windwalker,69,40,29
Mommysalamii,moon-guard,1167,monk,windwalker,25,13,12
Kandinarra,jubeithos,1156,monk,windwalker,52,28,24
Leehofook,azshara,1154,monk,windwalker,60,27,33
Linkya,daggerspine,1152,monk,windwalker,22,14,8
Xedou,azralon,1151,monk,windwalker,18,12,6
Micai,thrall,1151,monk,windwalker,18,12,6
Soprà,zuljin,1151,monk,windwalker,24,12,12
Xølik,draenor,1150,monk,windwalker,18,12,6
Pikotaro,tichondrius,1150,monk,windwalker,24,12,12
Miýagi,sargeras,1149,monk,windwalker,18,12,6
Anavara,drakkari,1144,monk,windwalker,36,18,18
Madbuffz,nemesis,1143,monk,windwalker,24,12,12
Tenshu,runetotem,1141,monk,windwalker,24,12,12
Delorenzi,hellscream,1137,monk,windwalker,24,12,12
Moopdahoop,stormrage,1136,monk,windwalker,37,22,15
Eavale,destromath,1135,monk,windwalker,24,12,12
Kfpeeves,sargeras,1134,monk,windwalker,30,15,15
Shinjiki,tichondrius,1134,monk,windwalker,29,12,17
Sedition,emerald-dream,1133,monk,windwalker,24,12,12
Highku,drenden,1129,monk,windwalker,18,12,6
Boldyr,sargeras,1128,monk,windwalker,24,12,12
Shinaniganz,chogall,1128,monk,windwalker,42,17,25
Stigzz,stormrage,1118,monk,windwalker,23,12,11
Jimothydab,lightbringer,1117,monk,windwalker,23,12,11
Gorton,lightbringer,1114,monk,windwalker,24,12,12
Imonkalot,destromath,1111,monk,windwalker,55,23,32
Loadedfries,frostmourne,1110,monk,windwalker,24,12,12
Fitmonje,drakkari,1108,monk,windwalker,28,13,15
Phistea,area-52,1102,monk,windwalker,23,12,11
Bonflur,quelthalas,1101,monk,windwalker,235,119,116
Angerday,illidan,1097,monk,windwalker,30,12,18
Jinpo,lightninghoof,1090,monk,windwalker,48,25,23
Silvopanda,azralon,1089,monk,windwalker,71,34,37
Deadlyfist,stormrage,1089,monk,windwalker,47,19,28
Astteell,proudmoore,1089,monk,windwalker,39,13,26
Drektarz,area-52,1085,monk,windwalker,75,33,42
Ojiin,wyrmrest-accord,1079,monk,windwalker,24,13,11
Quanon,stormreaver,1071,monk,windwalker,33,14,19
Calmpunchman,mannoroth,1070,monk,windwalker,25,12,13
Mikeyx,area-52,1056,monk,windwalker,18,11,7
Xyän,bleeding-hollow,1056,monk,windwalker,18,11,7
Madtigon,scilla,1056,monk,windwalker,18,11,7
Baconbiscuit,area-52,1056,monk,windwalker,24,11,13
Yavaxye,stormrage,1056,monk,windwalker,24,11,13
Orkmonk,tichondrius,1055,monk,windwalker,12,11,1
Facekandy,tichondrius,1055,monk,windwalker,16,12,4
Rubntug,zuljin,1055,monk,windwalker,18,11,7
Kungfupurk,bleeding-hollow,1055,monk,windwalker,18,11,7
Songokusan,thrall,1055,monk,windwalker,18,11,7
Sockem,arthas,1055,monk,windwalker,24,11,13
Jdanîel,ragnaros,1055,monk,windwalker,24,11,13
Lidä,tichondrius,1055,monk,windwalker,30,11,19
Jamut,stormrage,1055,monk,windwalker,36,11,25
Monkamax,tichondrius,1054,monk,windwalker,18,11,7
Onepunchman,quelthalas,1053,monk,windwalker,24,11,13
Wimdrewk,quelthalas,1053,monk,windwalker,39,12,27
Hira,zuljin,1052,monk,windwalker,30,11,19
Píñg,area-52,1051,monk,windwalker,30,11,19
Omimonk,sargeras,1050,monk,windwalker,18,11,7
Rocketfist,bleeding-hollow,1050,monk,windwalker,24,11,13
Sandii,azralon,1049,monk,windwalker,51,29,22
Whtnyhuston,sargeras,1049,monk,windwalker,24,11,13
Chowlaos,coilfang,1048,monk,windwalker,18,11,7
Senseî,altar-of-storms,1048,monk,windwalker,30,11,19
Chaosrose,area-52,1044,monk,windwalker,18,11,7
Lexivixi,khazgoroth,1044,monk,windwalker,24,12,12
Tremonk,kelthuzad,1043,monk,windwalker,18,11,7
Monkii,bonechewer,1041,monk,windwalker,21,14,7
Rbs,tichondrius,1041,monk,windwalker,36,11,25
Jnx,emerald-dream,1038,monk,windwalker,24,11,13
Arshavin,skullcrusher,1038,monk,windwalker,30,11,19
Mcnipple,moonrunner,1036,monk,windwalker,18,11,7
Rollsroycist,trollbane,1032,monk,windwalker,37,23,14
Natintell,drakkari,1032,monk,windwalker,71,33,38
Abboo,hyjal,1030,monk,windwalker,24,12,12
Steenkk,tichondrius,1023,monk,windwalker,24,11,13
Kuffy,kelthuzad,1021,monk,windwalker,17,11,6
Rosarìolover,stormrage,1008,monk,windwalker,36,18,18
Brewzllee,tichondrius,1000,monk,windwalker,66,34,32
Scarlos,tichondrius,1000,monk,windwalker,166,81,85
Sébástián,drakkari,984,monk,windwalker,46,24,22
Tobearus,stormscale,974,monk,windwalker,29,13,16
Fettywhopper,kaelthas,960,monk,windwalker,12,10,2
Aýre,ravencrest,960,monk,windwalker,12,10,2
Shadmtwo,tichondrius,960,monk,windwalker,12,10,2
Shírÿu,azralon,960,monk,windwalker,18,10,8
Innerverse,tichondrius,960,monk,windwalker,18,10,8
Telospateo,ragnaros,960,monk,windwalker,18,10,8
Lolqtxd,sargeras,960,monk,windwalker,24,10,14
Dwarfmonk,tichondrius,960,monk,windwalker,24,10,14
Kinkykyle,emerald-dream,960,monk,windwalker,24,10,14
Bearface,blades-edge,960,monk,windwalker,24,10,14
Watercowz,tichondrius,959,monk,windwalker,12,10,2
Ghooch,illidan,959,monk,windwalker,18,10,8
Goldfornudez,area-52,959,monk,windwalker,18,10,8
Quanyaozu,ragnaros,959,monk,windwalker,18,10,8
Schwenkyytv,sargeras,959,monk,windwalker,18,10,8
Stendari,moon-guard,959,monk,windwalker,18,10,8
Jdkick,sargeras,959,monk,windwalker,24,10,14
Åsurã,stormrage,959,monk,windwalker,30,10,20
Squidie,tichondrius,959,monk,windwalker,30,10,20
Creonus,proudmoore,958,monk,windwalker,26,10,16
Mônkdunk,daggerspine,957,monk,windwalker,18,10,8
Avz,azralon,957,monk,windwalker,24,10,14
Ezpzmonk,bloodscalp,956,monk,windwalker,21,11,10
Thalreyzian,vashj,954,monk,windwalker,24,10,14
Megatraun,tichondrius,953,monk,windwalker,18,10,8
Xìðñ,moon-guard,952,monk,windwalker,18,10,8
Alcaquito,goldrinn,950,monk,windwalker,18,10,8
Chigang,deathwing,949,monk,windwalker,24,10,14
Madmint,illidan,941,monk,windwalker,23,11,12
Nutcrakerz,tichondrius,935,monk,windwalker,24,13,11
Mcwallets,moon-guard,933,monk,windwalker,78,33,45
Mynamegeorge,area-52,915,monk,windwalker,24,10,14
Blackychan,scilla,902,monk,windwalker,24,12,12
Ipmán,moon-guard,892,monk,windwalker,41,18,23
Bussÿ,area-52,879,monk,windwalker,17,10,7
Veganbacon,mannoroth,875,monk,windwalker,14,10,4
Poormanx,illidan,864,monk,windwalker,12,9,3
Rhyskrispiez,sargeras,864,monk,windwalker,12,9,3
Danimalz,stormrage,864,monk,windwalker,12,9,3
Hybrid,stormrage,864,monk,windwalker,12,9,3
Garypool,emerald-dream,864,monk,windwalker,15,9,6
Jaige,illidan,864,monk,windwalker,18,9,9
Djjackyd,stormrage,864,monk,windwalker,18,9,9
Molta,tichondrius,864,monk,windwalker,18,9,9
Rocketfrogg,bleeding-hollow,864,monk,windwalker,24,9,15
Tmjojo,tichondrius,864,monk,windwalker,24,9,15
Chiang,chogall,864,monk,windwalker,24,9,15
Jajabelugeng,tichondrius,863,monk,windwalker,12,9,3
Stepsista,sargeras,863,monk,windwalker,18,9,9
Tomatosaucin,area-52,863,monk,windwalker,18,9,9
Azzmane,bronzebeard,863,monk,windwalker,18,9,9
Kahpital,azralon,863,monk,windwalker,18,9,9
Helicopter,borean-tundra,863,monk,windwalker,18,9,9
Somethingre,sargeras,862,monk,windwalker,12,9,3
Chingwang,frostmourne,862,monk,windwalker,12,9,3
Duwhack,wyrmrest-accord,862,monk,windwalker,18,9,9
Kaishya,emerald-dream,861,monk,windwalker,12,9,3
Yodi,hakkar,861,monk,windwalker,12,9,3
Ryútt,illidan,860,monk,windwalker,24,9,15
Romeonjuliet,tichondrius,859,monk,windwalker,18,9,9
Wwmonks,sargeras,857,monk,windwalker,12,9,3
Felgolos,azralon,857,monk,windwalker,15,10,5
Acena,stormrage,856,monk,windwalker,24,9,15
Acindian,malganis,853,monk,windwalker,18,9,9
Tzidkiyahu,barthilas,849,monk,windwalker,12,9,3
Agroétudo,azralon,838,monk,windwalker,18,9,9
Thekilla,aegwynn,827,monk,windwalker,18,9,9
Bradyfour,moon-guard,812,monk,windwalker,17,9,8
Drakfu,tichondrius,806,monk,windwalker,21,10,11
Rykouu,area-52,784,monk,windwalker,19,9,10
Hitchslapz,tichondrius,783,monk,windwalker,13,9,4
Livitsu,aerie-peak,768,monk,windwalker,12,8,4
Shisama,area-52,768,monk,windwalker,12,8,4
Twichyling,tichondrius,768,monk,windwalker,12,8,4
Zoomerxd,stormrage,768,monk,windwalker,12,8,4
Whitepandax,tichondrius,768,monk,windwalker,12,8,4
Hitman,thrall,768,monk,windwalker,12,8,4
Rennafgc,stormrage,768,monk,windwalker,12,8,4
Öñlýfåñs,tichondrius,768,monk,windwalker,12,8,4
Mcbluffin,onyxia,768,monk,windwalker,12,8,4
Tingum,kelthuzad,768,monk,windwalker,16,9,7
Sodamint,sargeras,768,monk,windwalker,18,8,10
Sterow,kiljaeden,768,monk,windwalker,18,8,10
Taggz,thunderlord,768,monk,windwalker,18,8,10
Stepfistz,aegwynn,768,monk,windwalker,18,8,10
Hitt,barthilas,768,monk,windwalker,18,8,10
Gnomepuncher,dalaran,768,monk,windwalker,18,8,10
Slimcognito,zuljin,768,monk,windwalker,18,8,10
Xas,sentinels,768,monk,windwalker,18,8,10
Gelgameks,eredar,768,monk,windwalker,18,8,10
Mahatmä,dalaran,768,monk,windwalker,18,8,10
Rerolled,moon-guard,768,monk,windwalker,18,8,10
Monke,onyxia,768,monk,windwalker,24,8,16
Tews,quelthalas,767,monk,windwalker,12,8,4
Prickhead,sargeras,767,monk,windwalker,15,9,6
Zukki,zuljin,767,monk,windwalker,18,8,10
Metalmønk,nerzhul,767,monk,windwalker,18,8,10
Pipochen,ragnaros,767,monk,windwalker,18,8,10
Niked,tichondrius,767,monk,windwalker,18,8,10
Faashbae,illidan,767,monk,windwalker,18,8,10
Saiyajinsoul,ragnaros,767,monk,windwalker,18,8,10
Anatomyx,kelthuzad,766,monk,windwalker,12,8,4
Nf,zuljin,766,monk,windwalker,12,8,4
Finesse,frostwolf,766,monk,windwalker,12,8,4
Dynamo,blackrock,766,monk,windwalker,18,8,10
Ragraxx,quelthalas,766,monk,windwalker,18,8,10
Bowlbreak,sargeras,765,monk,windwalker,12,8,4
Shocclol,stormrage,764,monk,windwalker,15,9,6
Extinctión,stormscale,762,monk,windwalker,12,8,4
Ryucko,azralon,761,monk,windwalker,12,8,4
Sprinkli,sargeras,761,monk,windwalker,24,8,16
Iamanangel,illidan,759,monk,windwalker,12,8,4
Hehex,bleeding-hollow,751,monk,windwalker,17,8,9
Thäiländiä,bleeding-hollow,745,monk,windwalker,12,8,4
Kilabit,azshara,742,monk,windwalker,22,9,13
Captnmurphy,tichondrius,735,monk,windwalker,11,8,3
Bakha,illidan,703,monk,windwalker,11,8,3
Onepunch,exodar,702,monk,windwalker,14,8,6
Dragonwhirl,stormrage,672,monk,windwalker,12,7,5
Gothamonk,tichondrius,672,monk,windwalker,12,7,5
Garofalo,tichondrius,672,monk,windwalker,12,7,5
Ristion,moon-guard,672,monk,windwalker,12,7,5
Duhäst,sargeras,672,monk,windwalker,12,7,5
Richywayne,bleeding-hollow,672,monk,windwalker,12,7,5
Kudrix,frostwolf,672,monk,windwalker,12,7,5
Lalpu,tichondrius,672,monk,windwalker,12,7,5
Yoojimin,kiljaeden,672,monk,windwalker,12,7,5
Gigagirth,emerald-dream,672,monk,windwalker,12,7,5
Goldx,ragnaros,672,monk,windwalker,12,7,5
Bramicaye,malganis,672,monk,windwalker,12,7,5
Jowtaro,azralon,672,monk,windwalker,12,7,5
Iol,whisperwind,672,monk,windwalker,12,7,5
Shiphappens,barthilas,672,monk,windwalker,12,7,5
Ázão,stormrage,672,monk,windwalker,12,7,5
Dublefist,draktharon,672,monk,windwalker,12,7,5
Thuyvan,barthilas,672,monk,windwalker,12,7,5
Lilpøøter,tichondrius,672,monk,windwalker,12,7,5
Wizcaulifa,stormrage,672,monk,windwalker,12,7,5
Porxhub,tichondrius,672,monk,windwalker,12,7,5
Vuadeira,azralon,672,monk,windwalker,12,7,5
Tokyozesty,area-52,672,monk,windwalker,12,7,5
Jxyfist,illidan,672,monk,windwalker,12,7,5
Buffmonkdmg,tichondrius,672,monk,windwalker,15,8,7
Tapzm,area-52,672,monk,windwalker,18,7,11
Verizani,stormrage,672,monk,windwalker,18,7,11
Slapcîty,bleeding-hollow,672,monk,windwalker,18,7,11
Stevezee,barthilas,672,monk,windwalker,18,7,11
Awcfanboy,bleeding-hollow,672,monk,windwalker,21,8,13
Judgevr,frostmourne,672,monk,windwalker,23,8,15
Zenkam,ragnaros,672,monk,windwalker,24,7,17
Asaltofsorts,tichondrius,671,monk,windwalker,12,7,5
Quietbegger,sargeras,671,monk,windwalker,12,7,5
Keys,earthen-ring,671,monk,windwalker,12,7,5
Convectuoso,illidan,671,monk,windwalker,12,7,5
Jackboi,the-underbog,671,monk,windwalker,18,7,11
Chuchinga,tichondrius,670,monk,windwalker,13,8,5
Minusmonk,dalaran,670,monk,windwalker,12,7,5
Chihad,stormrage,670,monk,windwalker,12,7,5
Cryptique,tichondrius,670,monk,windwalker,12,7,5
Samaelsin,emerald-dream,670,monk,windwalker,24,7,17
Kuungfoo,tichondrius,667,monk,windwalker,12,7,5
Hyun,stormrage,666,monk,windwalker,12,7,5
Kush,dalvengyr,665,monk,windwalker,12,7,5
Traxshin,kelthuzad,664,monk,windwalker,18,7,11
Léesin,stormrage,655,monk,windwalker,17,7,10
Currycooker,tichondrius,655,monk,windwalker,17,7,10
Mùnkey,nagrand,638,monk,windwalker,17,7,10
Sistafistaa,akama,606,monk,windwalker,14,7,7
Sckmonk,tichondrius,606,monk,windwalker,16,7,9
Veso,tichondrius,576,monk,windwalker,6,6,0
Tazermw,sargeras,576,monk,windwalker,6,6,0
Aizu,ragnaros,576,monk,windwalker,6,6,0
Selfîe,ysera,576,monk,windwalker,6,6,0
Aveium,moon-guard,576,monk,windwalker,6,6,0
Goblinitto,archimonde,576,monk,windwalker,6,6,0
Makgøra,malganis,576,monk,windwalker,6,6,0
Srýbrø,illidan,576,monk,windwalker,6,6,0
Griswolld,ragnaros,576,monk,windwalker,6,6,0
Monkfy,moon-guard,576,monk,windwalker,6,6,0
Vandamme,durotan,576,monk,windwalker,12,6,6
Tahs,azralon,576,monk,windwalker,12,6,6
Xua,sargeras,576,monk,windwalker,12,6,6
Gójó,tichondrius,576,monk,windwalker,12,6,6
Jaspier,quelthalas,576,monk,windwalker,12,6,6
Singao,malganis,576,monk,windwalker,12,6,6
Sylash,ragnaros,576,monk,windwalker,12,6,6
Nyofu,moon-guard,576,monk,windwalker,12,6,6
Neejitsu,malganis,576,monk,windwalker,12,6,6
Ranchy,zuljin,576,monk,windwalker,12,6,6
Bakacia,ragnaros,576,monk,windwalker,12,6,6
Monksoon,tichondrius,576,monk,windwalker,12,6,6
Xoir,tichondrius,576,monk,windwalker,12,6,6
Läôtzu,fizzcrank,576,monk,windwalker,12,6,6
Creamchop,stormreaver,576,monk,windwalker,12,6,6
Xuenfu,tichondrius,576,monk,windwalker,12,6,6
Silvyrx,boulderfist,576,monk,windwalker,12,6,6
Tulalong,area-52,576,monk,windwalker,12,6,6
Tinypunch,emerald-dream,576,monk,windwalker,12,6,6
Pinkgucci,thrall,576,monk,windwalker,12,6,6
Mapaly,ragnaros,576,monk,windwalker,12,6,6
Afrosamurai,thrall,576,monk,windwalker,12,6,6
Sxywind,azgalor,576,monk,windwalker,12,6,6
Affected,lightninghoof,576,monk,windwalker,12,6,6
Syffer,sargeras,576,monk,windwalker,12,6,6
Popchi,stormrage,576,monk,windwalker,12,6,6
Forthekicks,tichondrius,576,monk,windwalker,19,8,11
Káizen,area-52,576,monk,windwalker,18,6,12
Hîddènsõündx,tichondrius,576,monk,windwalker,18,6,12
Monjimen,ragnaros,576,monk,windwalker,18,6,12
Awsmonk,malygos,576,monk,windwalker,18,6,12
Jatzai,emerald-dream,576,monk,windwalker,28,6,22
Ipnam,kelthuzad,575,monk,windwalker,10,7,3
Kalrsk,frostmourne,575,monk,windwalker,12,6,6
Rowenoa,tichondrius,575,monk,windwalker,18,6,12
Kajjou,illidan,575,monk,windwalker,20,6,14
Linwong,garithos,574,monk,windwalker,12,6,6
Dragorovich,aerie-peak,574,monk,windwalker,12,6,6
Fistidmi,area-52,573,monk,windwalker,12,6,6
Tøxicø,quelthalas,572,monk,windwalker,16,7,9
Nedpanders,nagrand,564,monk,windwalker,12,6,6
Shindoro,bonechewer,521,monk,windwalker,16,10,6
Ddoongmonk,tichondrius,496,monk,windwalker,13,6,7
Monkskiiz,tichondrius,480,monk,windwalker,6,5,1
Misery,stormscale,480,monk,windwalker,6,5,1
Yenjung,azralon,480,monk,windwalker,6,5,1
Pikadejegue,nemesis,480,monk,windwalker,6,5,1
Hennyww,dalaran,480,monk,windwalker,6,5,1
Kimmyfists,tichondrius,480,monk,windwalker,6,5,1
Varimå,area-52,480,monk,windwalker,6,5,1
Poem,grizzly-hills,480,monk,windwalker,6,5,1
Pleasetouch,emerald-dream,480,monk,windwalker,6,5,1
Iflykites,zuljin,480,monk,windwalker,6,5,1
Xunzao,emerald-dream,480,monk,windwalker,6,5,1
Zakaza,kelthuzad,480,monk,windwalker,6,5,1
Shevchenkô,quelthalas,480,monk,windwalker,6,5,1
Danksweaver,malganis,480,monk,windwalker,6,5,1
Kuranchi,illidan,480,monk,windwalker,6,5,1
Nitrobrewed,stormrage,480,monk,windwalker,6,5,1
Iloveabby,sargeras,480,monk,windwalker,6,5,1
Bibis,sargeras,480,monk,windwalker,6,5,1
Zackesé,area-52,480,monk,windwalker,6,5,1
Miresa,kelthuzad,480,monk,windwalker,6,5,1
Tyrus,kelthuzad,480,monk,windwalker,9,5,4
Zhíu,ragnaros,480,monk,windwalker,12,5,7
Aydowon,illidan,480,monk,windwalker,12,5,7
Tripster,wyrmrest-accord,480,monk,windwalker,12,5,7
Silkzy,frostwolf,480,monk,windwalker,12,5,7
Miuss,illidan,480,monk,windwalker,12,5,7
Plagai,fizzcrank,480,monk,windwalker,12,5,7
Tenkix,zuljin,480,monk,windwalker,12,5,7
Kentodne,stormrage,480,monk,windwalker,12,5,7
Lokimana,zuljin,480,monk,windwalker,12,5,7
Mepepegaclap,malganis,480,monk,windwalker,12,5,7
Xueyu,malganis,480,monk,windwalker,12,5,7
Skyvaan,barthilas,480,monk,windwalker,12,5,7
Güwop,tichondrius,480,monk,windwalker,12,5,7
Akrethar,medivh,480,monk,windwalker,12,5,7
Ferknights,moon-guard,480,monk,windwalker,12,5,7
Zadaa,alleria,480,monk,windwalker,12,5,7
Suntzuvius,tichondrius,480,monk,windwalker,12,5,7
Nject,malganis,480,monk,windwalker,12,5,7
Kickkick,burning-blade,480,monk,windwalker,12,5,7
Smigz,area-52,480,monk,windwalker,12,5,7
Sivedrafely,arthas,480,monk,windwalker,12,5,7
Izu,senjin,480,monk,windwalker,12,5,7
Valdur,sargeras,480,monk,windwalker,12,5,7
Gabaan,azralon,480,monk,windwalker,18,5,13
Vinndz,azralon,480,monk,windwalker,18,5,13
Zmajevratnik,illidan,479,monk,windwalker,6,5,1
Kiukiukiu,tichondrius,479,monk,windwalker,12,5,7
Tamonk,veknilash,478,monk,windwalker,6,5,1
Liänä,quelthalas,476,monk,windwalker,12,5,7
Mcmaplol,tichondrius,447,monk,windwalker,11,5,6
Ighostgirls,thrall,431,monk,windwalker,11,5,6
Trembull,gurubashi,384,monk,windwalker,6,4,2
Lowkn,sargeras,384,monk,windwalker,6,4,2
Fistedby,nesingwary,384,monk,windwalker,6,4,2
Kame,moon-guard,384,monk,windwalker,6,4,2
Hate,korialstrasz,384,monk,windwalker,6,4,2
Wørm,emerald-dream,384,monk,windwalker,6,4,2
Orbgodx,darkspear,384,monk,windwalker,6,4,2
Liucang,archimonde,384,monk,windwalker,6,4,2
Fiddletix,stormrage,384,monk,windwalker,6,4,2
Evanyfist,proudmoore,384,monk,windwalker,6,4,2
Pathad,stormrage,384,monk,windwalker,6,4,2
Monkespin,stormrage,384,monk,windwalker,6,4,2
Coldridge,bleeding-hollow,384,monk,windwalker,6,4,2
Molific,gurubashi,384,monk,windwalker,6,4,2
Gorblox,emerald-dream,384,monk,windwalker,6,4,2
Aedalithe,stormrage,384,monk,windwalker,6,4,2
Kiggo,bonechewer,384,monk,windwalker,6,4,2
Ðøhkø,nemesis,384,monk,windwalker,6,4,2
Illiea,cenarius,384,monk,windwalker,6,4,2
Vernki,laughing-skull,384,monk,windwalker,6,4,2
Cowsgonuts,gorefiend,384,monk,windwalker,6,4,2
Sistuhfista,tichondrius,384,monk,windwalker,6,4,2
Satchelgizmo,tichondrius,384,monk,windwalker,6,4,2
Yogiji,proudmoore,384,monk,windwalker,6,4,2
Preceptonk,azralon,384,monk,windwalker,6,4,2
Xulieng,tichondrius,384,monk,windwalker,6,4,2
Touchbot,tichondrius,384,monk,windwalker,6,4,2
Champoo,executus,384,monk,windwalker,6,4,2
Peacefulpaco,malganis,384,monk,windwalker,6,4,2
Barleygar,tichondrius,384,monk,windwalker,6,4,2
Delaî,dalaran,384,monk,windwalker,6,4,2
Azizyzz,barthilas,384,monk,windwalker,6,4,2
Chaipie,kelthuzad,384,monk,windwalker,6,4,2
Thewyjr,illidan,384,monk,windwalker,6,4,2
Saitamami,tichondrius,384,monk,windwalker,6,4,2
Iarw,tichondrius,384,monk,windwalker,6,4,2
Beverage,frostmourne,384,monk,windwalker,6,4,2
Korgark,tichondrius,384,monk,windwalker,6,4,2
Punchbuggy,frostmourne,384,monk,windwalker,6,4,2
Yeawe,tichondrius,384,monk,windwalker,6,4,2
Callae,dreadmaul,384,monk,windwalker,6,4,2
Research,frostmourne,384,monk,windwalker,6,4,2
Nuclearpunch,tichondrius,384,monk,windwalker,6,4,2
Eçua,tichondrius,384,monk,windwalker,7,4,3
Serenitys,tanaris,384,monk,windwalker,9,4,5
Kfp,gorefiend,384,monk,windwalker,12,4,8
Röllup,area-52,384,monk,windwalker,12,4,8
Merand,tichondrius,384,monk,windwalker,12,4,8
Jxytwo,arygos,384,monk,windwalker,12,4,8
Paracetamonk,kelthuzad,384,monk,windwalker,12,4,8
Fruitpünch,tichondrius,384,monk,windwalker,12,4,8
Threnz,magtheridon,384,monk,windwalker,12,4,8
Wheresmyjuul,malganis,384,monk,windwalker,12,4,8
Ohtani,frostwolf,384,monk,windwalker,12,4,8
Jayr,bleeding-hollow,384,monk,windwalker,12,4,8
Evilstep,tichondrius,384,monk,windwalker,12,4,8
Machita,spirestone,384,monk,windwalker,12,4,8
Cudzingtin,dalaran,384,monk,windwalker,12,4,8
Grocerymonk,malganis,384,monk,windwalker,12,4,8
Ramisan,barthilas,384,monk,windwalker,12,4,8
Graphyt,moon-guard,384,monk,windwalker,12,4,8
Mysticzen,tichondrius,384,monk,windwalker,12,4,8
Excalibrew,malganis,384,monk,windwalker,12,4,8
Chijinx,area-52,384,monk,windwalker,12,4,8
Merçeÿ,tichondrius,384,monk,windwalker,12,4,8
Solrise,wyrmrest-accord,384,monk,windwalker,12,4,8
Ferrarí,quelthalas,384,monk,windwalker,12,4,8
Rookz,drakthul,384,monk,windwalker,12,4,8
Xinvictus,frostmourne,384,monk,windwalker,12,4,8
Hiurge,tichondrius,384,monk,windwalker,12,4,8
Bunnygal,thaurissan,384,monk,windwalker,18,4,14
Zanmonk,moon-guard,383,monk,windwalker,6,4,2
Chugs,malorne,383,monk,windwalker,18,4,14
Viko,llane,382,monk,windwalker,6,4,2
Pastarasta,malganis,382,monk,windwalker,6,4,2
Miyage,emerald-dream,382,monk,windwalker,6,4,2
Broxxenidas,quelthalas,351,monk,windwalker,11,4,7
Nakuang,tichondrius,339,monk,windwalker,24,7,17
Sahhalea,sargeras,319,monk,windwalker,14,4,10
Monklad,malganis,288,monk,windwalker,6,3,3
Shizzyowoxd,bleeding-hollow,288,monk,windwalker,6,3,3
Rhonco,quelthalas,288,monk,windwalker,6,3,3
Harvex,area-52,288,monk,windwalker,6,3,3
Mlngo,illidan,288,monk,windwalker,6,3,3
Mgzx,kelthuzad,288,monk,windwalker,6,3,3
Swurvex,bleeding-hollow,288,monk,windwalker,6,3,3
Bogez,area-52,288,monk,windwalker,6,3,3
Mcfluffey,area-52,288,monk,windwalker,6,3,3
Sosm,kelthuzad,288,monk,windwalker,6,3,3
Hábìtz,area-52,288,monk,windwalker,6,3,3
Jubei,dragonmaw,288,monk,windwalker,6,3,3
Cráne,duskwood,288,monk,windwalker,6,3,3
Bromonster,zuljin,288,monk,windwalker,6,3,3
Frimayadri,area-52,288,monk,windwalker,6,3,3
Redami,gnomeregan,288,monk,windwalker,6,3,3
Tababtz,illidan,288,monk,windwalker,6,3,3
Powerfisterr,stormrage,288,monk,windwalker,6,3,3
Dkdakìng,stormrage,288,monk,windwalker,6,3,3
Bakicaa,dalaran,288,monk,windwalker,6,3,3
Lomist,nazjatar,288,monk,windwalker,6,3,3
Spaaca,kelthuzad,288,monk,windwalker,6,3,3
Idonthustle,area-52,288,monk,windwalker,6,3,3
Reflexsivex,malganis,288,monk,windwalker,6,3,3
Iilmachoggy,stormrage,288,monk,windwalker,6,3,3
Trunkx,area-52,288,monk,windwalker,6,3,3
Triixxy,thrall,288,monk,windwalker,6,3,3
Gulmokk,tichondrius,288,monk,windwalker,6,3,3
Karkata,sargeras,288,monk,windwalker,6,3,3
Tictox,sargeras,288,monk,windwalker,6,3,3
ßluedream,dalaran,288,monk,windwalker,6,3,3
Muffinz,shattered-halls,288,monk,windwalker,6,3,3
Fistay,burning-legion,288,monk,windwalker,6,3,3
Goodluck,madoran,288,monk,windwalker,6,3,3
Dripharder,tichondrius,288,monk,windwalker,6,3,3
Daspmonk,nagrand,288,monk,windwalker,6,3,3
Röllö,tichondrius,288,monk,windwalker,6,3,3
Pusily,tichondrius,288,monk,windwalker,6,3,3
Apølon,azralon,288,monk,windwalker,6,3,3
Burash,frostwolf,288,monk,windwalker,6,3,3
Giatzo,barthilas,288,monk,windwalker,6,3,3
Detox,sargeras,288,monk,windwalker,6,3,3
Choibaedal,tichondrius,288,monk,windwalker,6,3,3
Silestial,sargeras,288,monk,windwalker,6,3,3
Oyyo,tichondrius,288,monk,windwalker,6,3,3
Mattyj,darkspear,288,monk,windwalker,6,3,3
Pandaforlife,area-52,288,monk,windwalker,6,3,3
Highaskite,tichondrius,288,monk,windwalker,6,3,3
Tigerlust,sargeras,288,monk,windwalker,6,3,3
Gngrbeardman,tichondrius,288,monk,windwalker,6,3,3
Tonkchi,khaz-modan,288,monk,windwalker,6,3,3
Bokchoii,sargeras,288,monk,windwalker,6,3,3
Heavytrain,azralon,288,monk,windwalker,6,3,3
Mistérfister,blackrock,288,monk,windwalker,6,3,3
Raires,tichondrius,288,monk,windwalker,6,3,3
Rumlee,sargeras,288,monk,windwalker,6,3,3
Atezo,tichondrius,288,monk,windwalker,6,3,3
Rozlynnww,tichondrius,288,monk,windwalker,6,3,3
Rafyww,tichondrius,288,monk,windwalker,6,3,3
Slurrpslutt,proudmoore,288,monk,windwalker,6,3,3
Gageismonk,mugthol,288,monk,windwalker,6,3,3
Imasterl,proudmoore,288,monk,windwalker,6,3,3
Brewtool,tichondrius,288,monk,windwalker,6,3,3
Dorander,frostmourne,288,monk,windwalker,6,3,3
Evilbit,boulderfist,288,monk,windwalker,6,3,3
Skippa,emerald-dream,288,monk,windwalker,6,3,3
Rampant,anubarak,288,monk,windwalker,9,4,5
Dmhsaint,sargeras,288,monk,windwalker,12,3,9
Bujiburger,frostmourne,288,monk,windwalker,12,3,9
Meatcleave,kiljaeden,288,monk,windwalker,12,3,9
Luckystrike,area-52,288,monk,windwalker,12,3,9
Siddharthä,barthilas,288,monk,windwalker,12,3,9
Senseixww,sargeras,288,monk,windwalker,12,3,9
Vova,bleeding-hollow,288,monk,windwalker,12,3,9
Wwx,whisperwind,288,monk,windwalker,12,3,9
Paramendic,frostwolf,288,monk,windwalker,12,3,9
Mistyfist,bleeding-hollow,288,monk,windwalker,12,3,9
Joreg,moon-guard,288,monk,windwalker,12,3,9
Rockxtv,illidan,288,monk,windwalker,12,3,9
Honkbazz,illidan,288,monk,windwalker,12,3,9
Breakbonez,dalaran,288,monk,windwalker,18,3,15
Brewmooser,area-52,287,monk,windwalker,6,3,3
Ogre,the-venture-co,287,monk,windwalker,6,3,3
Pandalex,draenor,287,monk,windwalker,6,3,3
Thedeäd,stormrage,287,monk,windwalker,12,3,9
Gaziee,tichondrius,271,monk,windwalker,11,3,8
Dafuqk,stormrage,256,monk,windwalker,16,3,13
Raskalnikov,kelthuzad,201,monk,windwalker,14,4,10
Kfchi,tichondrius,192,monk,windwalker,4,3,1
Mùk,tichondrius,192,monk,windwalker,4,3,1
Klamfu,thrall,192,monk,windwalker,4,3,1
Dangodxz,quelthalas,192,monk,windwalker,4,3,1
Novoctek,quelthalas,192,monk,windwalker,6,2,4
Taringa,drakkari,192,monk,windwalker,6,2,4
Deathgoku,norgannon,192,monk,windwalker,6,2,4
Strongmandan,twisting-nether,192,monk,windwalker,6,2,4
Icesmoker,frostmourne,192,monk,windwalker,6,2,4
Deyasth,zuljin,192,monk,windwalker,6,2,4
Brëwslee,twisting-nether,192,monk,windwalker,6,2,4
Lonebamboo,tichondrius,192,monk,windwalker,6,2,4
Hydraoxy,moon-guard,192,monk,windwalker,6,2,4
Giorhno,ragnaros,192,monk,windwalker,6,2,4
Toxicaff,dalaran,192,monk,windwalker,6,2,4
Gøldéngødx,tichondrius,192,monk,windwalker,6,2,4
Hutmok,dalaran,192,monk,windwalker,6,2,4
Möösê,moon-guard,192,monk,windwalker,6,2,4
Fistpumps,thrall,192,monk,windwalker,6,2,4
Coomerww,kelthuzad,192,monk,windwalker,6,2,4
Cranjis,agamaggan,192,monk,windwalker,6,2,4
Sinistuhm,tichondrius,192,monk,windwalker,6,2,4
Pvptone,bleeding-hollow,192,monk,windwalker,6,2,4
Epî,tichondrius,192,monk,windwalker,6,2,4
Bvndio,ragnaros,192,monk,windwalker,6,2,4
Çhëèch,tichondrius,192,monk,windwalker,6,2,4
Boeingair,kelthuzad,192,monk,windwalker,6,2,4
Flattswwjr,tichondrius,192,monk,windwalker,6,2,4
Maisoftheart,barthilas,192,monk,windwalker,6,2,4
Bakusao,bleeding-hollow,192,monk,windwalker,6,2,4
Mannkin,zuluhed,192,monk,windwalker,6,2,4
Thöran,ragnaros,192,monk,windwalker,6,2,4
Dragoro,exodar,192,monk,windwalker,6,2,4
Tadaku,dalaran,192,monk,windwalker,6,2,4
Salanzoww,bleeding-hollow,192,monk,windwalker,6,2,4
Zengawd,magtheridon,192,monk,windwalker,6,2,4
Akiiko,draenor,192,monk,windwalker,6,2,4
Imafqnbaby,tichondrius,192,monk,windwalker,6,2,4
Heävenly,kelthuzad,192,monk,windwalker,6,2,4
Averagéjoe,tichondrius,192,monk,windwalker,6,2,4
Bhoredom,kiljaeden,192,monk,windwalker,6,2,4
Troutz,sargeras,192,monk,windwalker,6,2,4
Privix,tichondrius,192,monk,windwalker,6,2,4
Defacen,illidan,192,monk,windwalker,6,2,4
Saywha,windrunner,192,monk,windwalker,6,2,4
Feelsogöod,tichondrius,192,monk,windwalker,6,2,4
Spirits,dreadmaul,192,monk,windwalker,6,2,4
Wât,bleeding-hollow,192,monk,windwalker,6,2,4
Gumrag,illidan,192,monk,windwalker,6,2,4
Jüdo,barthilas,192,monk,windwalker,6,2,4
Weewalker,wyrmrest-accord,192,monk,windwalker,6,2,4
Xarra,bleeding-hollow,192,monk,windwalker,6,2,4
Prf,ragnaros,192,monk,windwalker,6,2,4
Fuchizaki,ragnaros,192,monk,windwalker,6,2,4
Sickbanga,barthilas,192,monk,windwalker,6,2,4
Transcend,nerzhul,192,monk,windwalker,6,2,4
Kitfisty,kiljaeden,192,monk,windwalker,6,2,4
Induhca,area-52,192,monk,windwalker,6,2,4
Flicksx,arthas,192,monk,windwalker,6,2,4
Hossdelgadoe,kiljaeden,192,monk,windwalker,6,2,4
Liw,quelthalas,192,monk,windwalker,6,2,4
Takazawas,bonechewer,192,monk,windwalker,6,2,4
Homunculusx,bleeding-hollow,192,monk,windwalker,6,2,4
Romeoe,muradin,192,monk,windwalker,6,2,4
Youngnudy,sargeras,192,monk,windwalker,6,2,4
Puraimu,sargeras,192,monk,windwalker,6,2,4
Metios,aggramar,192,monk,windwalker,6,2,4
Selfless,gilneas,192,monk,windwalker,6,2,4
Monkbro,altar-of-storms,192,monk,windwalker,6,2,4
Lìpz,zuljin,192,monk,windwalker,6,2,4
Monkuban,destromath,192,monk,windwalker,6,2,4
Ked,ragnaros,192,monk,windwalker,6,2,4
Pongo,kelthuzad,192,monk,windwalker,12,2,10
Altaidm,ragnaros,192,monk,windwalker,12,2,10
Dankestkhan,korialstrasz,192,monk,windwalker,12,2,10
Xinpa,quelthalas,192,monk,windwalker,12,2,10
Eliwenn,ragnaros,192,monk,windwalker,12,2,10
Razekahl,wyrmrest-accord,192,monk,windwalker,12,2,10
Bruceflea,gurubashi,192,monk,windwalker,18,2,16
Hontaruk,ragnaros,175,monk,windwalker,11,2,9
Habzz,tichondrius,159,monk,windwalker,5,2,3
Wheatsli,malganis,159,monk,windwalker,5,2,3
Goku,frostmourne,159,monk,windwalker,5,2,3
Stellae,emerald-dream,159,monk,windwalker,5,2,3
Fendi,stormrage,159,monk,windwalker,5,2,3
Lazy,shattered-halls,159,monk,windwalker,5,2,3
Clytpuncher,emerald-dream,159,monk,windwalker,5,2,3
Chisuschrist,hyjal,144,monk,windwalker,9,2,7
Heartsies,sargeras,128,monk,windwalker,4,2,2
Raninn,bleeding-hollow,128,monk,windwalker,4,2,2
Prettyflacko,thrall,128,monk,windwalker,4,2,2
Versuri,azralon,128,monk,windwalker,10,2,8
Jayjaybrew,area-52,96,monk,windwalker,3,2,1
Monkwayz,emerald-dream,96,monk,windwalker,3,2,1
Neaxain,tichondrius,96,monk,windwalker,3,2,1
Forestweaver,area-52,96,monk,windwalker,6,1,5
Imingleejr,illidan,96,monk,windwalker,6,1,5
Munnk,stormreaver,96,monk,windwalker,6,1,5
Saruyo,frostmourne,96,monk,windwalker,6,1,5
Tmtricks,tichondrius,96,monk,windwalker,6,1,5
Zinque,emerald-dream,96,monk,windwalker,6,1,5
Piccolo,emerald-dream,96,monk,windwalker,6,1,5
Cerocool,hyjal,96,monk,windwalker,6,1,5
Comical,malygos,96,monk,windwalker,6,1,5
Memurk,bleeding-hollow,96,monk,windwalker,6,1,5
Buddaba,tichondrius,96,monk,windwalker,6,1,5
Ischys,kelthuzad,96,monk,windwalker,6,1,5
Sanemi,amanthul,96,monk,windwalker,6,1,5
Shinobiww,area-52,96,monk,windwalker,6,1,5
Tristantwo,sargeras,96,monk,windwalker,6,1,5
Raekwan,area-52,96,monk,windwalker,6,1,5
Chunlee,tichondrius,96,monk,windwalker,6,1,5
Alkaholik,stormrage,96,monk,windwalker,6,1,5
Quaria,moon-guard,96,monk,windwalker,6,1,5
Omoplàta,illidan,96,monk,windwalker,6,1,5
Windlordx,illidan,96,monk,windwalker,6,1,5
Giriom,thrall,96,monk,windwalker,6,1,5
Okuraseru,bleeding-hollow,96,monk,windwalker,6,1,5
Chipócluda,ragnaros,96,monk,windwalker,6,1,5
Molsonicee,tichondrius,96,monk,windwalker,6,1,5
Æsir,moon-guard,96,monk,windwalker,6,1,5
Lainerya,moon-guard,96,monk,windwalker,6,1,5
Bwan,kelthuzad,96,monk,windwalker,6,1,5
Srgtbingo,azgalor,96,monk,windwalker,6,1,5
Monkanome,gilneas,96,monk,windwalker,6,1,5
Yípman,uldum,96,monk,windwalker,6,1,5
Obiiwan,tichondrius,96,monk,windwalker,6,1,5
Teewin,area-52,96,monk,windwalker,6,1,5
Gablle,tol-barad,96,monk,windwalker,6,1,5
Nbatrap,stormrage,96,monk,windwalker,6,1,5
Yosisoy,zuljin,79,monk,windwalker,5,1,4
Leisa,jaedenar,79,monk,windwalker,5,1,4
Zhatafaq,ragnaros,48,monk,windwalker,3,1,2
Kreese,rivendare,42,monk,windwalker,9,2,7
Cosetteb,proudmoore,31,monk,windwalker,2,1,1
Notamønk,bonechewer,31,monk,windwalker,2,1,1
Rèxpéi,area-52,2157,paladin,holy,84,48,36
Sunita,arthas,2116,paladin,holy,189,99,90
Pattar,area-52,2107,paladin,holy,66,37,29
Holylolz,ragnaros,2059,paladin,holy,168,86,82
Tmborn,tichondrius,2035,paladin,holy,89,40,49
Digglesx,area-52,2012,paladin,holy,78,35,43
Braindeadrsj,anetheron,1990,paladin,holy,161,90,71
Bilmurii,zuljin,1979,paladin,holy,84,46,38
Thejustice,tichondrius,1954,paladin,holy,102,53,49
Nickimahoj,tichondrius,1943,paladin,holy,81,42,39
Eskerda,azralon,1939,paladin,holy,160,77,83
Bombboyoz,area-52,1936,paladin,holy,84,44,40
Bubblebuddyx,tichondrius,1926,paladin,holy,47,22,25
Flõw,gnomeregan,1919,paladin,holy,84,52,32
Hamsti,sargeras,1909,paladin,holy,125,63,62
Flashv,barthilas,1896,paladin,holy,62,32,30
Baelsimp,illidan,1894,paladin,holy,90,47,43
Angrycubanx,black-dragonflight,1887,paladin,holy,50,25,25
Nyctemavanna,ragnaros,1872,paladin,holy,88,48,40
Thejustices,tichondrius,1860,paladin,holy,36,22,14
Curator,emerald-dream,1859,paladin,holy,56,29,27
Sde,kelthuzad,1851,paladin,holy,120,55,65
Dreathhammer,muradin,1849,paladin,holy,42,24,18
Dýstopia,stormrage,1841,paladin,holy,41,21,20
Skillenjoyer,tichondrius,1839,paladin,holy,78,49,29
Cynthianna,tichondrius,1839,paladin,holy,116,61,55
Csupremacy,tichondrius,1839,paladin,holy,64,30,34
Bushyy,tichondrius,1838,paladin,holy,54,26,28
Saacbot,area-52,1831,paladin,holy,69,25,44
Ðáx,sargeras,1828,paladin,holy,75,39,36
Ppgdx,azralon,1826,paladin,holy,78,34,44
Caveyodeler,zuluhed,1822,paladin,holy,47,28,19
Cyphinx,darkspear,1822,paladin,holy,103,48,55
Memnoche,frostmane,1821,paladin,holy,89,53,36
Sacbubldead,area-52,1820,paladin,holy,126,79,47
Truluck,area-52,1820,paladin,holy,111,56,55
Deadlyassian,sargeras,1819,paladin,holy,100,54,46
Fonypally,tichondrius,1815,paladin,holy,332,171,161
Sojupapi,area-52,1813,paladin,holy,96,47,49
Uxe,zuljin,1812,paladin,holy,60,30,30
Judgejim,barthilas,1812,paladin,holy,144,66,78
Fukndibs,kiljaeden,1811,paladin,holy,172,85,87
Sd,kelthuzad,1811,paladin,holy,123,59,64
Bubblist,tichondrius,1811,paladin,holy,68,28,40
Bravepl,tichondrius,1808,paladin,holy,73,28,45
Dracfire,zuljin,1807,paladin,holy,45,24,21
Overwhelm,muradin,1806,paladin,holy,40,22,18
Zetsubõ,stormrage,1806,paladin,holy,54,24,30
Ængelic,barthilas,1803,paladin,holy,202,107,95
Dyppally,moon-guard,1803,paladin,holy,102,51,51
Wtbmana,frostmourne,1801,paladin,holy,72,39,33
Richpiana,nathrezim,1800,paladin,holy,106,60,46
Hongwoosang,tichondrius,1795,paladin,holy,188,89,99
Amourranth,stormrage,1785,paladin,holy,52,30,22
Airbad,tichondrius,1785,paladin,holy,53,23,30
Veejayx,tichondrius,1775,paladin,holy,44,21,23
Fixyouz,mannoroth,1773,paladin,holy,100,48,52
Zilea,kiljaeden,1768,paladin,holy,48,24,24
Duallkore,stormrage,1764,paladin,holy,66,33,33
Hps,argent-dawn,1759,paladin,holy,42,22,20
Scamlikely,tichondrius,1758,paladin,holy,96,49,47
Beyondsausag,malganis,1753,paladin,holy,59,28,31
Defensezone,tichondrius,1749,paladin,holy,74,36,38
Chenzo,exodar,1743,paladin,holy,124,65,59
Colepal,zuljin,1741,paladin,holy,54,23,31
Ihaveajob,zuluhed,1730,paladin,holy,42,23,19
Mercedez,bleeding-hollow,1724,paladin,holy,54,28,26
Brynnhild,stormrage,1722,paladin,holy,102,55,47
Pelletbrain,emerald-dream,1719,paladin,holy,126,61,65
Ckaïnë,stormrage,1714,paladin,holy,68,36,32
Softsister,tichondrius,1713,paladin,holy,42,22,20
Bpalaayo,kelthuzad,1706,paladin,holy,66,26,40
Taargaryenn,tichondrius,1701,paladin,holy,60,32,28
Ivan,tichondrius,1693,paladin,holy,96,44,52
Fortold,bloodhoof,1692,paladin,holy,54,23,31
Virabelle,gurubashi,1690,paladin,holy,48,25,23
Avengom,tichondrius,1685,paladin,holy,315,160,155
Evylinn,burning-legion,1684,paladin,holy,126,69,57
Tenêbrae,area-52,1674,paladin,holy,52,33,19
Thorfinaa,moon-guard,1673,paladin,holy,41,24,17
Sàga,hyjal,1671,paladin,holy,53,29,24
Hats,icecrown,1671,paladin,holy,153,73,80
Mvpj,medivh,1669,paladin,holy,153,78,75
Tylennis,archimonde,1669,paladin,holy,150,66,84
Cheerleader,bleeding-hollow,1668,paladin,holy,138,62,76
Imshmackedd,darkspear,1663,paladin,holy,84,35,49
Tiernoo,illidan,1662,paladin,holy,98,46,52
Landrysdad,malorne,1660,paladin,holy,54,26,28
Sacridas,fizzcrank,1657,paladin,holy,36,20,16
Zunit,laughing-skull,1656,paladin,holy,46,22,24
Ddeuk,tichondrius,1653,paladin,holy,301,156,145
Pallice,queldorei,1651,paladin,holy,96,43,53
Bombboyozjr,area-52,1649,paladin,holy,30,20,10
Kevinthecube,nerzhul,1647,paladin,holy,30,22,8
Ppgddxx,azralon,1643,paladin,holy,30,18,12
Nerfretpls,area-52,1642,paladin,holy,42,20,22
Citylights,tichondrius,1640,paladin,holy,27,19,8
Dazargeros,moon-guard,1638,paladin,holy,132,66,66
Ellyarian,emerald-dream,1635,paladin,holy,42,22,20
Asherm,moon-guard,1635,paladin,holy,92,47,45
Teenytoots,burning-legion,1635,paladin,holy,69,26,43
Yuuichi,moon-guard,1634,paladin,holy,64,29,35
Enzõ,illidan,1632,paladin,holy,42,23,19
Rhunon,dalaran,1631,paladin,holy,78,41,37
Barcie,lothar,1624,paladin,holy,54,18,36
Bopbotx,area-52,1621,paladin,holy,49,17,32
Guerrer,hyjal,1619,paladin,holy,374,195,179
Gospel,duskwood,1617,paladin,holy,65,37,28
Scoopzi,frostmourne,1616,paladin,holy,47,27,20
Ascion,tichondrius,1614,paladin,holy,119,58,61
Chonsic,darkspear,1612,paladin,holy,58,26,32
Sekitar,ragnaros,1611,paladin,holy,155,79,76
Xcuse,tichondrius,1611,paladin,holy,60,30,30
Zergmé,executus,1610,paladin,holy,42,21,21
Jealp,sargeras,1608,paladin,holy,42,26,16
Larryhoova,malganis,1608,paladin,holy,36,20,16
Crâfty,bleeding-hollow,1608,paladin,holy,83,45,38
Minefujiko,tichondrius,1603,paladin,holy,377,191,186
Sinfolly,whisperwind,1602,paladin,holy,58,31,27
Gjoker,azralon,1600,paladin,holy,42,25,17
Pála,dalaran,1600,paladin,holy,158,76,82
Jiraya,nemesis,1598,paladin,holy,79,39,40
Perfect,crushridge,1597,paladin,holy,32,18,14
Wuhb,aerie-peak,1596,paladin,holy,88,44,44
Saveursavior,bleeding-hollow,1595,paladin,holy,99,49,50
Boomda,tichondrius,1594,paladin,holy,80,42,38
Retsincewod,zuluhed,1586,paladin,holy,54,28,26
Zacháry,sargeras,1583,paladin,holy,40,21,19
Kustp,tichondrius,1575,paladin,holy,116,66,50
Regivän,azralon,1575,paladin,holy,78,39,39
Pasda,frostmourne,1575,paladin,holy,53,22,31
Deepnasty,galakrond,1573,paladin,holy,107,55,52
Aluríel,quelthalas,1568,paladin,holy,56,28,28
Erikx,smolderthorn,1566,paladin,holy,78,44,34
Beejae,stormreaver,1565,paladin,holy,41,17,24
Hônòr,thrall,1564,paladin,holy,51,29,22
Forsakenlite,sargeras,1558,paladin,holy,84,36,48
Xinqingle,tichondrius,1557,paladin,holy,154,78,76
Drägonmynuts,tichondrius,1556,paladin,holy,103,43,60
Montageflav,illidan,1554,paladin,holy,56,27,29
Luminainre,zuljin,1553,paladin,holy,71,34,37
Gorgona,illidan,1551,paladin,holy,107,53,54
Crabsaladpal,illidan,1550,paladin,holy,112,62,50
Handsomedan,twisting-nether,1550,paladin,holy,54,26,28
Jiberish,illidan,1548,paladin,holy,110,53,57
Blarr,azshara,1541,paladin,holy,60,25,35
Riptonix,stormrage,1540,paladin,holy,121,66,55
Molki,tichondrius,1539,paladin,holy,93,54,39
Discordnitro,illidan,1539,paladin,holy,36,20,16
Gazapal,thrall,1528,paladin,holy,114,64,50
Solfire,stormreaver,1526,paladin,holy,74,32,42
Rodrigo,frostmourne,1524,paladin,holy,69,34,35
Kidstable,nathrezim,1523,paladin,holy,70,27,43
Avahir,moon-guard,1521,paladin,holy,48,24,24
Beyönd,quelthalas,1520,paladin,holy,78,39,39
Dageraad,tichondrius,1519,paladin,holy,30,16,14
Bigoldman,tichondrius,1519,paladin,holy,72,37,35
Gwok,thrall,1510,paladin,holy,64,34,30
Caitthegreat,malorne,1508,paladin,holy,30,16,14
Humañ,tichondrius,1507,paladin,holy,60,32,28
Raigha,stormrage,1507,paladin,holy,30,16,14
Cjqcjq,tichondrius,1507,paladin,holy,41,21,20
Wokeinator,malganis,1506,paladin,holy,174,96,78
Kdex,tichondrius,1505,paladin,holy,84,37,47
Ageroÿ,sargeras,1503,paladin,holy,61,31,30
Doofum,stormrage,1503,paladin,holy,131,58,73
Brumm,quelthalas,1501,paladin,holy,77,39,38
Devöut,aggramar,1501,paladin,holy,97,47,50
Vitabro,bleeding-hollow,1500,paladin,holy,101,56,45
Dodgeandhoj,nerzhul,1498,paladin,holy,30,16,14
Rarth,nemesis,1497,paladin,holy,47,20,27
Rg,nerzhul,1496,paladin,holy,179,86,93
Jeromee,area-52,1496,paladin,holy,48,19,29
Lightkillerx,thrall,1494,paladin,holy,84,37,47
Xciss,kiljaeden,1493,paladin,holy,103,46,57
Ibury,quelthalas,1492,paladin,holy,101,46,55
Cynical,dalvengyr,1490,paladin,holy,66,40,26
Wonpai,frostmourne,1490,paladin,holy,36,18,18
Nickiminhoj,stormrage,1488,paladin,holy,51,29,22
Handyandy,kelthuzad,1487,paladin,holy,94,50,44
Allitharis,tichondrius,1486,paladin,holy,97,53,44
Condone,earthen-ring,1484,paladin,holy,90,41,49
Leónrey,stormrage,1484,paladin,holy,57,20,37
Runihaveaids,stormrage,1483,paladin,holy,77,37,40
Glørythrives,tichondrius,1483,paladin,holy,45,20,25
Nrpzy,stormrage,1480,paladin,holy,65,32,33
Senorbaxter,emerald-dream,1478,paladin,holy,48,17,31
Jorik,lightbringer,1477,paladin,holy,42,20,22
Granklol,tichondrius,1476,paladin,holy,50,25,25
Percüles,sargeras,1473,paladin,holy,66,38,28
Nume,nesingwary,1469,paladin,holy,24,16,8
Judgemode,the-scryers,1468,paladin,holy,96,41,55
Daenrahh,azralon,1465,paladin,holy,164,84,80
Haitishammer,stormrage,1465,paladin,holy,60,27,33
Konvi,tichondrius,1464,paladin,holy,60,24,36
Cohesion,draenor,1461,paladin,holy,77,35,42
Prettylightx,kelthuzad,1460,paladin,holy,95,44,51
Quertz,sargeras,1458,paladin,holy,41,27,14
Indemnity,wildhammer,1457,paladin,holy,69,40,29
Gankstapwn,tichondrius,1455,paladin,holy,53,24,29
Orphandog,zuljin,1454,paladin,holy,23,16,7
Dewlight,zuljin,1454,paladin,holy,157,75,82
Holyterror,dentarg,1451,paladin,holy,42,23,19
Liå,frostmourne,1449,paladin,holy,78,43,35
Zoeyxo,tichondrius,1448,paladin,holy,80,42,38
Noback,ragnaros,1448,paladin,holy,66,31,35
Kihluxo,frostmourne,1446,paladin,holy,101,56,45
Holyknight,veknilash,1446,paladin,holy,71,32,39
Bushÿ,tichondrius,1444,paladin,holy,88,50,38
Celsica,kelthuzad,1443,paladin,holy,153,73,80
Chowdar,proudmoore,1443,paladin,holy,78,36,42
Holyprotectr,tichondrius,1442,paladin,holy,30,17,13
Droopyz,quelthalas,1440,paladin,holy,48,19,29
Sigmapepe,quelthalas,1436,paladin,holy,96,52,44
Dadcantsac,frostmourne,1436,paladin,holy,75,37,38
Careless,malganis,1435,paladin,holy,30,15,15
Rezmefool,tichondrius,1428,paladin,holy,115,54,61
Mayru,ragnaros,1425,paladin,holy,30,15,15
Mabia,tichondrius,1421,paladin,holy,215,111,104
Jpwx,barthilas,1419,paladin,holy,30,15,15
Decalli,tichondrius,1417,paladin,holy,69,35,34
Danpros,azralon,1417,paladin,holy,66,24,42
Samaze,tichondrius,1413,paladin,holy,87,42,45
Xuanxingchai,tichondrius,1413,paladin,holy,72,30,42
Splashleyy,bleeding-hollow,1413,paladin,holy,60,23,37
Amadeo,hyjal,1410,paladin,holy,77,34,43
Jezëbel,azralon,1408,paladin,holy,24,15,9
Donkeydumper,wyrmrest-accord,1407,paladin,holy,88,48,40
Vasar,tichondrius,1406,paladin,holy,37,26,11
Wonpaiv,frostmourne,1404,paladin,holy,35,15,20
Moonmi,tichondrius,1403,paladin,holy,115,61,54
Oralen,daggerspine,1402,paladin,holy,48,24,24
Talantyr,zuljin,1398,paladin,holy,48,23,25
Wálker,ragnaros,1397,paladin,holy,68,34,34
Paladinaa,lothar,1393,paladin,holy,98,39,59
Nanøha,frostmourne,1391,paladin,holy,82,22,60
Anea,kelthuzad,1388,paladin,holy,32,17,15
Summercarma,area-52,1387,paladin,holy,27,15,12
Nxkita,sargeras,1387,paladin,holy,48,24,24
Heaven,gurubashi,1382,paladin,holy,35,16,19
Rengen,frostmourne,1379,paladin,holy,30,17,13
Twck,hyjal,1374,paladin,holy,114,55,59
Lu,the-venture-co,1371,paladin,holy,34,15,19
Fiate,azralon,1370,paladin,holy,36,16,20
Shaidd,bleeding-hollow,1368,paladin,holy,77,34,43
Saeranella,moon-guard,1366,paladin,holy,106,44,62
Holyhades,auchindoun,1360,paladin,holy,85,46,39
Maeyz,sargeras,1358,paladin,holy,90,41,49
Choonsly,tichondrius,1356,paladin,holy,69,36,33
Omfgitsyang,tichondrius,1354,paladin,holy,23,15,8
Maleguz,azralon,1354,paladin,holy,148,76,72
Danyuel,zuljin,1354,paladin,holy,56,20,36
Palapoxi,arygos,1353,paladin,holy,54,23,31
Saphri,kiljaeden,1353,paladin,holy,63,26,37
Brioc,tichondrius,1352,paladin,holy,30,17,13
Galabanja,malganis,1350,paladin,holy,42,24,18
Goodwood,ghostlands,1350,paladin,holy,42,18,24
Hawtwangs,proudmoore,1349,paladin,holy,48,26,22
Flippo,sargeras,1346,paladin,holy,36,17,19
Quadrifoglio,moon-guard,1344,paladin,holy,199,100,99
Uprise,chogall,1343,paladin,holy,42,19,23
Miswalkpally,ragnaros,1342,paladin,holy,30,14,16
Holymooie,frostmourne,1341,paladin,holy,24,14,10
Chunzhangsqs,tichondrius,1339,paladin,holy,36,14,22
Htmlar,tichondrius,1338,paladin,holy,63,35,28
Therealdeal,sargeras,1338,paladin,holy,51,28,23
Hodl,barthilas,1338,paladin,holy,89,47,42
Xiaoladin,frostmourne,1337,paladin,holy,25,16,9
Güido,stormrage,1337,paladin,holy,42,23,19
Leonrey,stormrage,1337,paladin,holy,43,21,22
Dwarrior,quelthalas,1337,paladin,holy,33,15,18
Finerkane,quelthalas,1334,paladin,holy,138,62,76
Alphanerd,burning-blade,1333,paladin,holy,55,27,28
Minereth,quelthalas,1330,paladin,holy,48,24,24
Buri,tichondrius,1330,paladin,holy,42,17,25
Scrubbinton,zuljin,1330,paladin,holy,48,14,34
Savagegirlz,tichondrius,1329,paladin,holy,72,33,39
Syrenz,khazgoroth,1327,paladin,holy,42,24,18
Castleknight,tichondrius,1327,paladin,holy,36,14,22
Catechism,laughing-skull,1325,paladin,holy,44,24,20
Jordenz,bonechewer,1324,paladin,holy,30,14,16
Consecrated,daggerspine,1324,paladin,holy,75,30,45
Ryhighh,sargeras,1324,paladin,holy,81,32,49
Mcllovin,kiljaeden,1323,paladin,holy,60,28,32
Paladinaiko,nemesis,1322,paladin,holy,111,56,55
Zantdemption,frostmourne,1322,paladin,holy,30,15,15
Kektrixia,tichondrius,1318,paladin,holy,24,15,9
Ùnholypally,jubeithos,1316,paladin,holy,71,42,29
Bakoø,tichondrius,1315,paladin,holy,42,17,25
Valandiel,proudmoore,1315,paladin,holy,61,15,46
Holyramen,illidan,1310,paladin,holy,108,45,63
Ramphastoz,quelthalas,1307,paladin,holy,60,26,34
Ozpal,burning-blade,1305,paladin,holy,38,24,14
Errant,bonechewer,1305,paladin,holy,53,31,22
Kriegmeister,amanthul,1305,paladin,holy,30,14,16
Santiadin,ragnaros,1304,paladin,holy,20,15,5
Dreadrot,azralon,1302,paladin,holy,50,24,26
Sorkar,tichondrius,1301,paladin,holy,129,66,63
Ironpaladin,sargeras,1297,paladin,holy,90,39,51
Dimior,quelthalas,1296,paladin,holy,36,19,17
Vurian,uther,1295,paladin,holy,90,36,54
Gotomars,tichondrius,1295,paladin,holy,42,14,28
Jestiny,amanthul,1290,paladin,holy,49,28,21
Tandury,tichondrius,1277,paladin,holy,42,22,20
Malakor,thrall,1274,paladin,holy,45,22,23
Darkbringer,frostmourne,1268,paladin,holy,36,19,17
Röniin,ragnaros,1267,paladin,holy,244,126,118
Merll,ragnaros,1265,paladin,holy,115,55,60
Affrika,ysondre,1264,paladin,holy,104,52,52
Pallin,sargeras,1264,paladin,holy,90,41,49
Quarall,blackhand,1263,paladin,holy,52,25,27
Mawning,kelthuzad,1259,paladin,holy,45,22,23
Salipally,dalaran,1258,paladin,holy,101,46,55
Brenenk,quelthalas,1257,paladin,holy,65,32,33
Vithar,bleeding-hollow,1257,paladin,holy,116,56,60
Whangsta,tichondrius,1257,paladin,holy,42,19,23
Holysplonk,stonemaul,1255,paladin,holy,72,30,42
Negodoskate,nemesis,1252,paladin,holy,183,89,94
Wukongsunn,dalaran,1251,paladin,holy,30,14,16
Sinay,azshara,1250,paladin,holy,40,23,17
Colbroggins,crushridge,1246,paladin,holy,36,18,18
Chewiipal,dalaran,1245,paladin,holy,39,23,16
Stephon,area-52,1244,paladin,holy,30,13,17
Bubblepigo,tichondrius,1243,paladin,holy,36,22,14
Sologriefer,sargeras,1242,paladin,holy,30,13,17
Scarlet,skywall,1241,paladin,holy,30,13,17
Undefeatæd,korgath,1238,paladin,holy,36,18,18
Kristienna,boulderfist,1236,paladin,holy,35,16,19
Jaenus,azralon,1236,paladin,holy,42,17,25
Cbm,tichondrius,1235,paladin,holy,23,14,9
Judgynomnom,the-underbog,1234,paladin,holy,36,13,23
Kencyxx,tichondrius,1233,paladin,holy,30,13,17
Oldgrumpster,stormrage,1232,paladin,holy,93,43,50
Harryhui,tichondrius,1231,paladin,holy,24,13,11
Aoishie,bleeding-hollow,1229,paladin,holy,84,38,46
Justizz,vashj,1228,paladin,holy,65,35,30
Chopsparks,khadgar,1228,paladin,holy,123,63,60
Enuug,malfurion,1226,paladin,holy,42,23,19
Mundomaloo,quelthalas,1226,paladin,holy,59,31,28
Crocfacex,tichondrius,1226,paladin,holy,46,18,28
Holyredx,bleeding-hollow,1224,paladin,holy,84,45,39
Aellithiene,tichondrius,1221,paladin,holy,30,13,17
Elizzabeth,skullcrusher,1220,paladin,holy,35,21,14
Ramspartan,drakkari,1218,paladin,holy,106,52,54
Boarfarmer,tichondrius,1215,paladin,holy,81,35,46
Saffranzord,azralon,1214,paladin,holy,73,35,38
Kamaelyn,proudmoore,1211,paladin,holy,133,68,65
Fuzed,frostmourne,1211,paladin,holy,141,70,71
Capedcrusade,area-52,1208,paladin,holy,24,13,11
Yérn,barthilas,1208,paladin,holy,42,15,27
Xq,aegwynn,1205,paladin,holy,38,18,20
Hobbsone,trollbane,1204,paladin,holy,107,40,67
Burgalveist,azgalor,1202,paladin,holy,25,15,10
Maaxxee,zuljin,1200,paladin,holy,27,13,14
Bárdokø,ragnaros,1198,paladin,holy,48,23,25
Mörphêus,tichondrius,1197,paladin,holy,54,30,24
Encantado,thrall,1196,paladin,holy,31,15,16
Shorthordeon,kelthuzad,1194,paladin,holy,54,30,24
Dbolpala,frostmourne,1192,paladin,holy,48,26,22
Pallythre,proudmoore,1187,paladin,holy,54,23,31
Diebeatus,zuljin,1181,paladin,holy,48,20,28
Sixtynine,nathrezim,1180,paladin,holy,78,35,43
Myrthedara,kargath,1178,paladin,holy,33,16,17
Lilfingered,malganis,1177,paladin,holy,30,14,16
Hawianbread,stormrage,1174,paladin,holy,24,13,11
Barbaluzz,quelthalas,1174,paladin,holy,257,123,134
Solanin,frostmourne,1169,paladin,holy,51,26,25
Cowladino,tichondrius,1169,paladin,holy,36,15,21
Coltlocks,sargeras,1168,paladin,holy,36,14,22
Hammercy,tichondrius,1155,paladin,holy,73,39,34
Onecmpeter,kelthuzad,1152,paladin,holy,67,38,29
Boxjang,tichondrius,1149,paladin,holy,24,12,12
Abellpally,tichondrius,1149,paladin,holy,24,12,12
Bubblebooty,drakthul,1146,paladin,holy,48,30,18
Renteria,sargeras,1144,paladin,holy,24,12,12
Sinara,detheroc,1143,paladin,holy,119,56,63
Kënsi,quelthalas,1141,paladin,holy,134,68,66
Randuir,proudmoore,1140,paladin,holy,42,20,22
Dazztrain,barthilas,1139,paladin,holy,24,12,12
Deepsearide,illidan,1139,paladin,holy,54,26,28
Exxin,turalyon,1139,paladin,holy,90,40,50
Flareous,moon-guard,1138,paladin,holy,30,12,18
Crüst,proudmoore,1135,paladin,holy,24,12,12
Daik,proudmoore,1134,paladin,holy,24,15,9
Toroke,nemesis,1133,paladin,holy,42,23,19
Toesy,area-52,1128,paladin,holy,58,23,35
Alarter,azralon,1128,paladin,holy,36,13,23
Dóminos,quelthalas,1127,paladin,holy,24,12,12
Stompcomp,tichondrius,1127,paladin,holy,59,29,30
Belmonte,greymane,1125,paladin,holy,18,12,6
Kentö,area-52,1123,paladin,holy,30,14,16
Balanoriaa,azralon,1122,paladin,holy,50,24,26
Faileeria,malganis,1121,paladin,holy,24,16,8
Bonz,ragnaros,1121,paladin,holy,24,12,12
Galeras,norgannon,1120,paladin,holy,107,43,64
Sloppybobby,zuljin,1119,paladin,holy,30,16,14
Ziggzag,hyjal,1117,paladin,holy,78,34,44
Dawnhammer,mugthol,1115,paladin,holy,52,25,27
Palooma,area-52,1115,paladin,holy,48,20,28
Biwi,zuljin,1115,paladin,holy,61,25,36
Zowolf,quelthalas,1108,paladin,holy,65,33,32
Acori,azralon,1108,paladin,holy,39,18,21
Lovehan,tichondrius,1103,paladin,holy,27,12,15
Holysols,zuljin,1102,paladin,holy,24,12,12
Swordstrikes,tichondrius,1096,paladin,holy,23,12,11
Júpiter,kiljaeden,1091,paladin,holy,22,13,9
Rykeran,warsong,1088,paladin,holy,78,46,32
Ëd,moon-guard,1088,paladin,holy,162,79,83
Granitei,quelthalas,1086,paladin,holy,27,13,14
Lobõ,ragnaros,1086,paladin,holy,48,18,30
Odiinn,stormscale,1086,paladin,holy,33,12,21
Maín,tichondrius,1085,paladin,holy,22,12,10
Liadrin,sentinels,1085,paladin,holy,29,12,17
Teloniow,quelthalas,1084,paladin,holy,38,19,19
Spikele,barthilas,1079,paladin,holy,30,13,17
Shocka,norgannon,1078,paladin,holy,90,48,42
Beerüs,crushridge,1069,paladin,holy,27,12,15
Stemi,kelthuzad,1069,paladin,holy,35,12,23
Lycheelz,illidan,1064,paladin,holy,48,26,22
Unworn,proudmoore,1064,paladin,holy,36,17,19
Vidalia,barthilas,1062,paladin,holy,23,12,11
Rajava,gallywix,1062,paladin,holy,48,25,23
Buckybarnes,gorefiend,1060,paladin,holy,36,23,13
Hivers,stormrage,1059,paladin,holy,42,18,24
Mèdic,illidan,1057,paladin,holy,62,34,28
Odriew,sargeras,1056,paladin,holy,18,11,7
Twichy,tichondrius,1055,paladin,holy,18,11,7
Waifu,area-52,1055,paladin,holy,18,11,7
Bushys,tichondrius,1055,paladin,holy,18,11,7
Lazio,frostmourne,1055,paladin,holy,24,11,13
Lickmysacx,tichondrius,1055,paladin,holy,30,11,19
Aldrion,stormrage,1054,paladin,holy,24,11,13
Ricopal,frostmourne,1054,paladin,holy,30,11,19
Shagalaga,tichondrius,1053,paladin,holy,24,11,13
Amiigo,tichondrius,1052,paladin,holy,24,11,13
Malakk,zuljin,1051,paladin,holy,47,25,22
Ramhammerz,sargeras,1051,paladin,holy,54,23,31
Kolmourn,deathwing,1048,paladin,holy,30,11,19
Imabandagins,bleeding-hollow,1045,paladin,holy,18,11,7
Joeboomers,tichondrius,1045,paladin,holy,24,13,11
Resio,illidan,1045,paladin,holy,30,12,18
Overthrrow,kelthuzad,1042,paladin,holy,123,62,61
Hybbo,runetotem,1042,paladin,holy,24,12,12
Yadiyadiyada,barthilas,1038,paladin,holy,18,11,7
Tyriam,stormscale,1038,paladin,holy,18,11,7
Holodecoy,bleeding-hollow,1038,paladin,holy,18,11,7
Mcduss,proudmoore,1037,paladin,holy,18,11,7
Jacobhowda,tichondrius,1037,paladin,holy,30,11,19
Nugsbunne,tichondrius,1035,paladin,holy,115,49,66
Lukas,vashj,1033,paladin,holy,95,46,49
Pheriox,agamaggan,1032,paladin,holy,24,11,13
Starfaith,illidan,1032,paladin,holy,67,27,40
Va,onyxia,1029,paladin,holy,54,26,28
Palqq,tichondrius,1025,paladin,holy,24,11,13
Imajeala,thrall,1024,paladin,holy,28,18,10
Ahundo,stonemaul,1022,paladin,holy,35,18,17
Center,ragnaros,1022,paladin,holy,23,11,12
Palaadiin,sargeras,1016,paladin,holy,42,21,21
Xöchïqüëtzäl,tichondrius,1016,paladin,holy,23,11,12
Varenka,stormrage,1015,paladin,holy,83,36,47
Iamholyman,dragonmaw,1014,paladin,holy,29,14,15
Vamir,magtheridon,1014,paladin,holy,30,13,17
Ihr,kiljaeden,1013,paladin,holy,63,28,35
Jazzmatic,dalaran,1012,paladin,holy,23,11,12
Paladinomoto,sargeras,1011,paladin,holy,29,12,17
Troxnar,ragnaros,1000,paladin,holy,28,18,10
Paulx,malganis,999,paladin,holy,75,40,35
Gigadunker,tichondrius,999,paladin,holy,29,13,16
Seonghwa,kelthuzad,996,paladin,holy,28,18,10
Minouther,area-52,996,paladin,holy,68,25,43
Ðß,arthas,995,paladin,holy,30,15,15
Hzo,tichondrius,989,paladin,holy,17,11,6
Kaina,wildhammer,987,paladin,holy,53,22,31
Colombía,illidan,986,paladin,holy,54,27,27
Agravaine,moon-guard,986,paladin,holy,23,11,12
Ckemosabe,emerald-dream,985,paladin,holy,32,11,21
Adventholy,tichondrius,970,paladin,holy,36,15,21
Photons,emerald-dream,966,paladin,holy,24,13,11
Romeoo,silver-hand,964,paladin,holy,66,26,40
Hammerabi,moon-guard,963,paladin,holy,21,13,8
Thoryin,tichondrius,960,paladin,holy,12,10,2
Síríús,malganis,960,paladin,holy,15,11,4
Censy,tichondrius,960,paladin,holy,18,10,8
Svitanie,bleeding-hollow,960,paladin,holy,80,38,42
Mangoflash,malganis,960,paladin,holy,24,10,14
Bopthebomb,sargeras,959,paladin,holy,18,10,8
Kencyz,tichondrius,959,paladin,holy,18,10,8
Arevia,stormrage,959,paladin,holy,18,10,8
Boundric,emerald-dream,959,paladin,holy,18,10,8
Rhönin,sargeras,959,paladin,holy,24,10,14
Bërzerk,zuluhed,959,paladin,holy,30,10,20
Klam,kelthuzad,958,paladin,holy,24,10,14
Vajuicy,dalaran,957,paladin,holy,24,10,14
Lightswitchx,stormrage,957,paladin,holy,24,10,14
Marklite,area-52,955,paladin,holy,24,10,14
Viviana,shadowmoon,955,paladin,holy,24,10,14
Raenilil,area-52,955,paladin,holy,30,12,18
Avasti,proudmoore,953,paladin,holy,24,10,14
Dragonchaos,ragnaros,953,paladin,holy,27,11,16
Palladomal,azralon,952,paladin,holy,30,10,20
Snnow,stormrage,951,paladin,holy,30,19,11
Motoa,stormrage,951,paladin,holy,18,10,8
Sventyn,frostmourne,951,paladin,holy,25,11,14
Paladam,burning-blade,948,paladin,holy,24,10,14
Holydood,thunderhorn,947,paladin,holy,18,10,8
Nikopala,tichondrius,945,paladin,holy,18,10,8
Tolliver,area-52,944,paladin,holy,18,11,7
Maldobarr,stormrage,944,paladin,holy,24,10,14
Athanaiëll,proudmoore,942,paladin,holy,12,10,2
Blackiron,frostmourne,941,paladin,holy,23,10,13
Swazanaseger,frostmourne,941,paladin,holy,24,10,14
Shâka,stormrage,940,paladin,holy,39,20,19
Doidyph,frostmourne,935,paladin,holy,24,10,14
Eradrae,mannoroth,933,paladin,holy,18,10,8
Saìdelia,moon-guard,929,paladin,holy,71,24,47
Mianheyo,quelthalas,919,paladin,holy,35,14,21
Hentaiangel,kiljaeden,918,paladin,holy,39,19,20
Psychorino,tichondrius,906,paladin,holy,27,10,17
Grumpybubble,sargeras,905,paladin,holy,19,11,8
Zhahira,hakkar,905,paladin,holy,24,10,14
Thaedrun,hydraxis,896,paladin,holy,54,26,28
Fedpowell,tichondrius,894,paladin,holy,23,10,13
Monad,nazjatar,893,paladin,holy,36,15,21
Shananakin,azshara,892,paladin,holy,29,13,16
Huijji,illidan,891,paladin,holy,18,11,7
Moogmodular,malganis,890,paladin,holy,27,11,16
Gênji,eldrethalas,890,paladin,holy,48,16,32
Zakh,proudmoore,882,paladin,holy,26,11,15
Papakatsu,proudmoore,878,paladin,holy,48,22,26
Ascension,amanthul,866,paladin,holy,120,44,76
Bobthemad,proudmoore,864,paladin,holy,12,9,3
Sovice,illidan,864,paladin,holy,12,9,3
Trâshcårt,sargeras,864,paladin,holy,12,9,3
Adrizzyx,barthilas,864,paladin,holy,18,9,9
Rachaelucky,malganis,864,paladin,holy,18,9,9
Airbusx,tichondrius,864,paladin,holy,18,9,9
Deadry,ysera,864,paladin,holy,18,9,9
Zilzag,moon-guard,864,paladin,holy,23,9,14
Diamondwater,tichondrius,864,paladin,holy,24,9,15
Racketyman,illidan,863,paladin,holy,12,9,3
Superzero,area-52,863,paladin,holy,12,9,3
Sutadansa,doomhammer,863,paladin,holy,77,42,35
Gorilla,kiljaeden,863,paladin,holy,48,9,39
Repèntance,stormrage,862,paladin,holy,18,9,9
Sevenword,tichondrius,862,paladin,holy,18,9,9
Kusotarão,nemesis,861,paladin,holy,18,9,9
Palltard,illidan,861,paladin,holy,24,9,15
Chånïng,frostmourne,859,paladin,holy,24,9,15
Spamsalot,malganis,857,paladin,holy,24,9,15
Holyiseasy,alleria,853,paladin,holy,29,11,18
Nedorshock,stormrage,853,paladin,holy,24,9,15
Veronica,sentinels,852,paladin,holy,42,9,33
Vëlar,tichondrius,851,paladin,holy,18,9,9
Mytolo,malganis,851,paladin,holy,24,9,15
Maalik,thrall,844,paladin,holy,18,9,9
Jaok,tichondrius,831,paladin,holy,21,10,11
Bainn,nerzhul,822,paladin,holy,73,31,42
Lavarball,tichondrius,810,paladin,holy,35,11,24
Praisin,zuljin,805,paladin,holy,18,9,9
Justeight,stormrage,804,paladin,holy,22,10,12
Nea,argent-dawn,784,paladin,holy,65,22,43
Buqi,barthilas,782,paladin,holy,27,9,18
Holyfrénzy,thrall,776,paladin,holy,25,9,16
Nualrossan,veknilash,776,paladin,holy,42,14,28
Alkyna,kelthuzad,768,paladin,holy,12,8,4
Kritzyx,stormrage,768,paladin,holy,12,8,4
Swellowsx,tichondrius,768,paladin,holy,12,8,4
Archerxx,ragnaros,768,paladin,holy,12,8,4
Rhönin,illidan,768,paladin,holy,12,8,4
Zero,anetheron,768,paladin,holy,18,8,10
Kensyzs,tichondrius,768,paladin,holy,18,8,10
Everrlasting,tichondrius,768,paladin,holy,18,8,10
Artús,ragnaros,768,paladin,holy,18,8,10
Regivan,nemesis,768,paladin,holy,24,8,16
Blessthfall,bleeding-hollow,768,paladin,holy,36,8,28
Usebandage,sargeras,767,paladin,holy,12,8,4
Mhera,sargeras,767,paladin,holy,12,8,4
Bestpally,alterac-mountains,767,paladin,holy,12,8,4
Zenkk,sargeras,767,paladin,holy,16,9,7
Tigranes,proudmoore,767,paladin,holy,18,8,10
Lanzzelot,goldrinn,767,paladin,holy,18,8,10
Swamprat,zuljin,767,paladin,holy,18,8,10
Zakath,the-underbog,767,paladin,holy,18,8,10
Wonpai,barthilas,767,paladin,holy,18,8,10
Trancelancer,kelthuzad,767,paladin,holy,18,8,10
Miniweiner,proudmoore,767,paladin,holy,18,8,10
Pandahorn,tichondrius,767,paladin,holy,24,8,16
Bebebig,tichondrius,766,paladin,holy,12,8,4
Caike,frostmourne,766,paladin,holy,12,8,4
Notdjalex,zuljin,766,paladin,holy,12,8,4
Hruuhwa,wyrmrest-accord,766,paladin,holy,12,8,4
Thonar,stormrage,765,paladin,holy,12,8,4
Revenere,tichondrius,765,paladin,holy,36,8,28
Grumpy,the-forgotten-coast,764,paladin,holy,12,8,4
Elogant,mannoroth,764,paladin,holy,12,8,4
Pambam,thrall,763,paladin,holy,18,9,9
Clehley,turalyon,760,paladin,holy,24,8,16
Vaalbara,fizzcrank,757,paladin,holy,18,8,10
Blacktemplar,area-52,755,paladin,holy,18,8,10
Darkwingdad,illidan,752,paladin,holy,33,13,20
Willycrow,nordrassil,740,paladin,holy,18,8,10
Mirotchburns,illidan,724,paladin,holy,16,9,7
Holyslapy,illidan,717,paladin,holy,15,9,6
Crinject,sargeras,672,paladin,holy,12,7,5
Ilovecanada,sargeras,672,paladin,holy,12,7,5
Naxzy,quelthalas,672,paladin,holy,12,7,5
Imsuffering,zuljin,672,paladin,holy,12,7,5
Bubblet,bleeding-hollow,672,paladin,holy,12,7,5
Shxz,illidan,672,paladin,holy,12,7,5
Oîn,area-52,672,paladin,holy,12,7,5
Loganholy,tichondrius,672,paladin,holy,12,7,5
Peelmeree,kelthuzad,672,paladin,holy,12,7,5
Bigolbittiez,tichondrius,672,paladin,holy,12,7,5
Busdid,sargeras,672,paladin,holy,12,7,5
Aulty,sargeras,672,paladin,holy,12,7,5
Xiaoholy,barthilas,672,paladin,holy,12,7,5
Gimmethéloot,stormrage,672,paladin,holy,12,7,5
Orekilol,stormrage,672,paladin,holy,18,7,11
Zayiro,eonar,672,paladin,holy,24,7,17
Stompedlawl,illidan,672,paladin,holy,24,7,17
Sensible,sargeras,672,paladin,holy,24,7,17
Boraz,bleeding-hollow,672,paladin,holy,36,7,29
Lördnextdoor,tichondrius,671,paladin,holy,12,7,5
Evanlina,bleeding-hollow,671,paladin,holy,12,7,5
Doktavius,lightbringer,671,paladin,holy,12,7,5
Thin,ragnaros,671,paladin,holy,12,7,5
Loguto,stormrage,671,paladin,holy,18,7,11
Shoppee,jubeithos,671,paladin,holy,18,7,11
Virkas,area-52,671,paladin,holy,18,7,11
Animal,korialstrasz,671,paladin,holy,18,7,11
Lemmiéwinkzz,sargeras,671,paladin,holy,18,7,11
Sýteck,sargeras,671,paladin,holy,24,7,17
Korvén,area-52,670,paladin,holy,12,7,5
Drgn,azgalor,670,paladin,holy,30,7,23
Saxmurderz,tichondrius,669,paladin,holy,12,7,5
Pluto,the-underbog,669,paladin,holy,12,7,5
Stationarity,frostmourne,669,paladin,holy,18,7,11
Røusseff,azralon,669,paladin,holy,18,7,11
Kimahri,anvilmar,669,paladin,holy,36,7,29
Voxoen,bleeding-hollow,668,paladin,holy,12,7,5
Cephadrome,proudmoore,667,paladin,holy,12,7,5
Madcandy,illidan,667,paladin,holy,12,7,5
Bangerzzx,sargeras,663,paladin,holy,18,7,11
Chaós,queldorei,657,paladin,holy,18,7,11
Snowdawg,blackhand,654,paladin,holy,24,7,17
Emojunz,ragnaros,638,paladin,holy,11,7,4
Mycow,tichondrius,638,paladin,holy,17,7,10
Delilahxoxo,mugthol,615,paladin,holy,33,9,24
Mojiberus,wyrmrest-accord,606,paladin,holy,14,7,7
Erán,quelthalas,600,paladin,holy,14,7,7
Turnevil,wyrmrest-accord,591,paladin,holy,19,7,12
Jonfox,stormrage,590,paladin,holy,11,7,4
Lhpal,ragnaros,576,paladin,holy,6,6,0
Bulgecranker,tichondrius,576,paladin,holy,6,6,0
Wonpait,frostmourne,576,paladin,holy,9,7,2
Catharsis,tichondrius,576,paladin,holy,12,6,6
Fadiez,sargeras,576,paladin,holy,12,6,6
Tolentino,elune,576,paladin,holy,12,6,6
Piura,stormreaver,576,paladin,holy,12,6,6
Narcissism,emerald-dream,576,paladin,holy,12,6,6
Squarehammer,blackrock,576,paladin,holy,12,6,6
Dequincy,tichondrius,576,paladin,holy,12,6,6
Amadin,winterhoof,576,paladin,holy,12,6,6
Madorian,bleeding-hollow,576,paladin,holy,18,6,12
Remibear,tichondrius,576,paladin,holy,18,6,12
Kelosia,bonechewer,576,paladin,holy,18,6,12
Santiagolol,ragnaros,576,paladin,holy,24,6,18
Acpally,tichondrius,576,paladin,holy,24,6,18
Leatherfase,dalaran,575,paladin,holy,12,6,6
Jereth,kelthuzad,575,paladin,holy,12,6,6
Kipow,proudmoore,575,paladin,holy,12,6,6
Cassiel,barthilas,575,paladin,holy,12,6,6
Roachpally,area-52,575,paladin,holy,12,6,6
Nøzawkalypse,kelthuzad,575,paladin,holy,12,6,6
Emptyjump,eredar,575,paladin,holy,12,6,6
Vänhélsing,tichondrius,575,paladin,holy,13,6,7
Tig,alleria,575,paladin,holy,18,6,12
Hojadin,area-52,575,paladin,holy,18,6,12
Rhonielson,tichondrius,574,paladin,holy,12,6,6
Hitsilent,warsong,574,paladin,holy,12,6,6
Sixthycent,kiljaeden,574,paladin,holy,12,6,6
Kilion,illidan,574,paladin,holy,18,6,12
Ahsys,tichondrius,574,paladin,holy,18,6,12
Mitshuki,ragnaros,573,paladin,holy,18,6,12
Ducii,stormrage,571,paladin,holy,18,6,12
Cloûd,tichondrius,570,paladin,holy,13,6,7
Maplleafs,kelthuzad,560,paladin,holy,24,6,18
Fayernaa,proudmoore,557,paladin,holy,10,7,3
Powtilted,thrall,543,paladin,holy,11,6,5
Redpally,emerald-dream,543,paladin,holy,16,6,10
Møcha,moon-guard,542,paladin,holy,14,7,7
Heniou,tichondrius,542,paladin,holy,17,6,11
Eboi,daggerspine,542,paladin,holy,26,7,19
Kbot,zuljin,528,paladin,holy,9,6,3
Dispirit,the-forgotten-coast,523,paladin,holy,11,6,5
Mfn,tichondrius,522,paladin,holy,12,7,5
Theebus,tichondrius,522,paladin,holy,23,7,16
Biggestkritz,frostmourne,511,paladin,holy,14,6,8
Trivana,durotan,496,paladin,holy,7,6,1
Holythunderx,tichondrius,496,paladin,holy,19,6,13
Badboí,azralon,480,paladin,holy,6,5,1
Zanduncy,stormrage,480,paladin,holy,6,5,1
Msheen,azralon,480,paladin,holy,6,5,1
Dlt,frostmourne,480,paladin,holy,6,5,1
Zenastra,moon-guard,480,paladin,holy,6,5,1
Gøldenlight,illidan,480,paladin,holy,12,5,7
Gareyn,moon-guard,480,paladin,holy,12,5,7
Zhangliyi,tichondrius,480,paladin,holy,12,5,7
Trycider,lightninghoof,480,paladin,holy,12,5,7
Beila,illidan,480,paladin,holy,12,5,7
Inmortall,illidan,480,paladin,holy,12,5,7
Hamen,frostwolf,480,paladin,holy,12,5,7
Velline,tichondrius,480,paladin,holy,12,5,7
Lyticmartyr,bleeding-hollow,480,paladin,holy,12,5,7
Garethorne,illidan,480,paladin,holy,12,5,7
Tèhflip,tichondrius,480,paladin,holy,12,5,7
Fartburger,saurfang,480,paladin,holy,12,5,7
Saintus,proudmoore,480,paladin,holy,12,5,7
Twoshockz,stormrage,480,paladin,holy,12,5,7
Vaerume,sargeras,480,paladin,holy,12,5,7
Mightypally,area-52,480,paladin,holy,12,5,7
Sprjustice,frostmourne,480,paladin,holy,12,5,7
Bíteme,sargeras,480,paladin,holy,15,6,9
Trevmagoosey,tichondrius,480,paladin,holy,18,5,13
Chrisgrin,malganis,480,paladin,holy,18,5,13
Bubbleosèven,tichondrius,479,paladin,holy,6,5,1
Loabandit,malorne,479,paladin,holy,12,5,7
Tankgreed,quelthalas,479,paladin,holy,12,5,7
Mileihot,quelthalas,479,paladin,holy,12,5,7
Goksuu,ragnaros,479,paladin,holy,12,5,7
Holyshasha,tichondrius,479,paladin,holy,12,5,7
Gyle,stormrage,479,paladin,holy,12,5,7
Joelsama,area-52,479,paladin,holy,12,5,7
Marcopolo,azralon,479,paladin,holy,12,5,7
Mightythorxx,tichondrius,479,paladin,holy,12,5,7
Meistyr,thrall,479,paladin,holy,18,5,13
Boiducéu,azralon,478,paladin,holy,12,5,7
Yobnai,zuljin,478,paladin,holy,12,5,7
Duecesz,area-52,478,paladin,holy,26,5,21
Sovereignt,aggramar,477,paladin,holy,12,5,7
Goingturbo,wyrmrest-accord,477,paladin,holy,12,5,7
Redentor,dalaran,473,paladin,holy,12,5,7
Parts,aerie-peak,468,paladin,holy,30,5,25
Fleshoflíght,azjolnerub,463,paladin,holy,11,5,6
Toastedheals,stormreaver,463,paladin,holy,17,5,12
Blancaflór,ragnaros,447,paladin,holy,11,5,6
Ziggerqt,stormrage,432,paladin,holy,15,5,10
Nivie,moon-guard,430,paladin,holy,15,5,10
Rashell,garrosh,426,paladin,holy,16,7,9
Retribution,mannoroth,426,paladin,holy,23,6,17
Monts,azralon,425,paladin,holy,20,7,13
Ziti,bonechewer,415,paladin,holy,8,5,3
Cyandra,moon-guard,400,paladin,holy,7,5,2
Dewagon,area-52,398,paladin,holy,19,5,14
Immensepower,tichondrius,384,paladin,holy,6,4,2
Ohthatguy,sargeras,384,paladin,holy,6,4,2
Kigz,illidan,384,paladin,holy,6,4,2
Cheers,garona,384,paladin,holy,6,4,2
Arleos,mannoroth,384,paladin,holy,6,4,2
Mywifeisbad,tichondrius,384,paladin,holy,6,4,2
Lightwerk,frostmourne,384,paladin,holy,6,4,2
Icac,stormrage,384,paladin,holy,6,4,2
Îcandy,stormrage,384,paladin,holy,6,4,2
Dumpytrucks,sargeras,384,paladin,holy,6,4,2
Respect,black-dragonflight,384,paladin,holy,6,4,2
Ladanthal,barthilas,384,paladin,holy,6,4,2
Eladore,hakkar,384,paladin,holy,6,4,2
Rc,tichondrius,384,paladin,holy,6,4,2
Decree,rexxar,384,paladin,holy,6,4,2
Sanasana,spirestone,384,paladin,holy,6,4,2
Neurôtoxins,frostmourne,384,paladin,holy,6,4,2
Leddie,stormrage,384,paladin,holy,6,4,2
Devsrdumb,bonechewer,384,paladin,holy,12,4,8
Contémpt,kelthuzad,384,paladin,holy,12,4,8
Waldir,silver-hand,384,paladin,holy,12,4,8
Daflash,emerald-dream,384,paladin,holy,12,4,8
Flow,spinebreaker,384,paladin,holy,12,4,8
Nerfrets,stormrage,384,paladin,holy,12,4,8
Ajlol,thrall,384,paladin,holy,12,4,8
Holygutzz,barthilas,384,paladin,holy,12,4,8
Bighardshock,aggramar,384,paladin,holy,12,4,8
Swolsus,illidan,384,paladin,holy,12,4,8
Nontheism,malganis,384,paladin,holy,12,4,8
Lesauceboss,tichondrius,384,paladin,holy,12,4,8
Wangzu,wildhammer,384,paladin,holy,12,4,8
Bigtimepali,tichondrius,384,paladin,holy,12,4,8
Dimix,sargeras,384,paladin,holy,12,4,8
Nikkixo,ysera,384,paladin,holy,12,4,8
Gotredwings,proudmoore,384,paladin,holy,12,4,8
Healadelphia,illidan,384,paladin,holy,12,4,8
Footjob,baelgun,384,paladin,holy,12,4,8
Cadap,bleeding-hollow,384,paladin,holy,12,4,8
Sacratess,area-52,384,paladin,holy,12,4,8
Palawun,nerzhul,384,paladin,holy,12,4,8
Doorii,tichondrius,384,paladin,holy,18,4,14
Caobobby,tichondrius,384,paladin,holy,18,4,14
Retholyprot,tichondrius,384,paladin,holy,18,4,14
Bloodangelz,sargeras,384,paladin,holy,18,4,14
Kaminasol,quelthalas,384,paladin,holy,18,4,14
Beebopper,illidan,384,paladin,holy,18,4,14
Cutebtw,zuljin,384,paladin,holy,18,4,14
Hímüra,nemesis,384,paladin,holy,18,4,14
Mikeawk,tichondrius,384,paladin,holy,24,4,20
Holyflux,winterhoof,383,paladin,holy,6,4,2
Guççi,thunderlord,383,paladin,holy,12,4,8
Lunchmoney,aggramar,383,paladin,holy,12,4,8
Akromma,drakkari,383,paladin,holy,12,4,8
Vorex,ragnaros,383,paladin,holy,12,4,8
Lightbeard,feathermoon,383,paladin,holy,12,4,8
Thulamon,zuljin,383,paladin,holy,12,4,8
Dreemie,tichondrius,383,paladin,holy,18,4,14
Anjøs,azralon,383,paladin,holy,18,4,14
Alyosya,barthilas,383,paladin,holy,24,4,20
Unsungherø,skywall,382,paladin,holy,6,4,2
Rustacian,area-52,380,paladin,holy,12,4,8
Orleenz,zuljin,379,paladin,holy,12,4,8
Gnomeslapper,frostmourne,351,paladin,holy,11,4,7
Lucciuzz,tichondrius,351,paladin,holy,11,4,7
Aärøn,stormrage,351,paladin,holy,11,4,7
Tarnak,kelthuzad,336,paladin,holy,15,4,11
Nvgesus,undermine,329,paladin,holy,16,5,11
Veeve,emerald-dream,304,paladin,holy,7,4,3
Nulric,moon-guard,304,paladin,holy,13,4,9
Kaleroenin,cenarius,288,paladin,holy,6,3,3
Breesh,nerzhul,288,paladin,holy,6,3,3
Leronos,zuljin,288,paladin,holy,6,3,3
Repgodx,illidan,288,paladin,holy,6,3,3
Gothsick,zuljin,288,paladin,holy,6,3,3
Laythoz,hyjal,288,paladin,holy,6,3,3
Soapgirl,area-52,288,paladin,holy,6,3,3
Datguysname,illidan,288,paladin,holy,6,3,3
Schwârts,blackrock,288,paladin,holy,6,3,3
Drippinheals,eitrigg,288,paladin,holy,6,3,3
Lachaple,illidan,288,paladin,holy,6,3,3
Whitekao,illidan,288,paladin,holy,6,3,3
Botburger,stormrage,288,paladin,holy,6,3,3
Grimmey,azjolnerub,288,paladin,holy,6,3,3
Phut,stormrage,288,paladin,holy,6,3,3
Dayatthespa,stormrage,288,paladin,holy,6,3,3
Hughmyron,stormrage,288,paladin,holy,6,3,3
Alîcë,wyrmrest-accord,288,paladin,holy,6,3,3
Nipon,stormrage,288,paladin,holy,6,3,3
Miggsy,stormrage,288,paladin,holy,6,3,3
Alkina,kelthuzad,288,paladin,holy,6,3,3
Ingrìd,ragnaros,288,paladin,holy,6,3,3
Clare,burning-blade,288,paladin,holy,6,3,3
Kharissia,proudmoore,288,paladin,holy,6,3,3
Loyantal,tichondrius,288,paladin,holy,6,3,3
Twodkittyy,kelthuzad,288,paladin,holy,6,3,3
Aduhrawl,moon-guard,288,paladin,holy,6,3,3
Psalms,lightnings-blade,288,paladin,holy,6,3,3
Holysheesh,cenarion-circle,288,paladin,holy,6,3,3
Luxsit,tichondrius,288,paladin,holy,6,3,3
Mcpuffin,aggramar,288,paladin,holy,6,3,3
Auralyon,tichondrius,288,paladin,holy,6,3,3
Odinns,proudmoore,288,paladin,holy,6,3,3
Wonpæi,frostmourne,288,paladin,holy,6,3,3
Lànd,tichondrius,288,paladin,holy,6,3,3
Paintthinner,frostmourne,288,paladin,holy,6,3,3
Sixty,sargeras,288,paladin,holy,6,3,3
Mindfoolness,sargeras,288,paladin,holy,6,3,3
Iluvitar,kiljaeden,288,paladin,holy,6,3,3
Lamas,kelthuzad,288,paladin,holy,6,3,3
Hazkal,sargeras,288,paladin,holy,6,3,3
Holzinger,quelthalas,288,paladin,holy,6,3,3
Mamothman,barthilas,288,paladin,holy,9,4,5
Reverbz,malganis,288,paladin,holy,12,3,9
Dartherion,shandris,288,paladin,holy,12,3,9
Marleigh,kelthuzad,288,paladin,holy,12,3,9
Hemmyr,deathwing,288,paladin,holy,12,3,9
Yanggongru,sargeras,288,paladin,holy,12,3,9
Teerblood,illidan,288,paladin,holy,12,3,9
Haldry,wyrmrest-accord,288,paladin,holy,12,3,9
Onlycams,sargeras,288,paladin,holy,12,3,9
Westlysñipes,tichondrius,288,paladin,holy,12,3,9
Prâytorian,illidan,288,paladin,holy,12,3,9
Repths,illidan,288,paladin,holy,12,3,9
Thaeldan,archimonde,288,paladin,holy,12,3,9
Dráugus,azralon,288,paladin,holy,12,3,9
Alogagain,frostmourne,288,paladin,holy,18,3,15
Bigboppapump,lightnings-blade,288,paladin,holy,18,3,15
Hugokpz,quelthalas,288,paladin,holy,18,3,15
Flarisic,kelthuzad,288,paladin,holy,18,3,15
Mathalt,area-52,288,paladin,holy,18,3,15
Kelthor,azralon,287,paladin,holy,6,3,3
Holyslapz,nazjatar,287,paladin,holy,6,3,3
Spacebacon,thunderlord,287,paladin,holy,12,3,9
Bullivan,sisters-of-elune,287,paladin,holy,12,3,9
Schnabdain,exodar,285,paladin,holy,18,3,15
Ryuzu,arathor,256,paladin,holy,4,4,0
Antivaxer,frostmourne,255,paladin,holy,11,3,8
Iradruidz,tichondrius,255,paladin,holy,11,3,8
Alltoohuman,nagrand,255,paladin,holy,11,3,8
Holywoof,agamaggan,234,paladin,holy,11,5,6
Itheternal,dalaran,234,paladin,holy,9,4,5
Emilywilis,sargeras,234,paladin,holy,13,4,9
Inarit,thrall,232,paladin,holy,22,5,17
Goldirock,quelthalas,192,paladin,holy,6,2,4
Gilazhar,eldrethalas,192,paladin,holy,6,2,4
Hitabull,hyjal,192,paladin,holy,6,2,4
Irêsha,quelthalas,192,paladin,holy,6,2,4
Elchupalibre,tichondrius,192,paladin,holy,6,2,4
Gabs,quelthalas,192,paladin,holy,6,2,4
Papaa,nemesis,192,paladin,holy,6,2,4
Raiel,aegwynn,192,paladin,holy,6,2,4
Veguê,ragnaros,192,paladin,holy,6,2,4
Smôres,sargeras,192,paladin,holy,6,2,4
Lørdthemar,azralon,192,paladin,holy,6,2,4
Penpal,sargeras,192,paladin,holy,6,2,4
Toonchies,barthilas,192,paladin,holy,6,2,4
Jastella,illidan,192,paladin,holy,6,2,4
Lazydin,tichondrius,192,paladin,holy,6,2,4
Cristineth,tanaris,192,paladin,holy,6,2,4
Mangchì,tichondrius,192,paladin,holy,6,2,4
Zhula,nerzhul,192,paladin,holy,6,2,4
Antoniano,ragnaros,192,paladin,holy,6,2,4
Raywhite,kelthuzad,192,paladin,holy,6,2,4
Traumaboy,terenas,192,paladin,holy,6,2,4
Kagranac,moon-guard,192,paladin,holy,6,2,4
Davinity,senjin,192,paladin,holy,6,2,4
Gnomesexer,illidan,192,paladin,holy,6,2,4
Bakapal,tichondrius,192,paladin,holy,6,2,4
Rawpaladin,blackrock,192,paladin,holy,6,2,4
Trâgedy,azjolnerub,192,paladin,holy,6,2,4
Turnipfãrmer,tichondrius,192,paladin,holy,6,2,4
Romaztlan,area-52,192,paladin,holy,6,2,4
Chinaballoon,moonrunner,192,paladin,holy,6,2,4
Iolwhat,sargeras,192,paladin,holy,6,2,4
Borngood,tichondrius,192,paladin,holy,6,2,4
Stormwinter,azralon,192,paladin,holy,6,2,4
Svane,thunderlord,192,paladin,holy,6,2,4
Sainttom,sargeras,192,paladin,holy,6,2,4
Breach,blades-edge,192,paladin,holy,6,2,4
Flexxborn,thrall,192,paladin,holy,6,2,4
Razzypal,sargeras,192,paladin,holy,6,2,4
Naxzero,shadowsong,192,paladin,holy,8,2,6
Anderentonso,tichondrius,192,paladin,holy,9,2,7
Cehart,windrunner,192,paladin,holy,12,2,10
Carmiínha,azralon,192,paladin,holy,12,2,10
Piupiubiu,stormrage,192,paladin,holy,12,2,10
Trojani,malganis,192,paladin,holy,12,2,10
Willywønka,azgalor,192,paladin,holy,12,2,10
Bighausse,thrall,192,paladin,holy,12,2,10
Juuzou,turalyon,192,paladin,holy,12,2,10
Einheilagr,stormrage,192,paladin,holy,12,2,10
Gavril,kirin-tor,192,paladin,holy,12,2,10
Minzyy,frostmourne,192,paladin,holy,12,2,10
Chimp,kiljaeden,192,paladin,holy,12,2,10
Milkovir,quelthalas,192,paladin,holy,18,2,16
Waifupaladin,azralon,192,paladin,holy,18,2,16
Shoresy,terokkar,192,paladin,holy,18,2,16
Levarious,thunderlord,192,paladin,holy,18,2,16
Holygota,nemesis,191,paladin,holy,6,2,4
Prh,frostmourne,191,paladin,holy,6,2,4
Arobelse,sargeras,191,paladin,holy,12,2,10
Palaknight,tichondrius,190,paladin,holy,12,2,10
Shkafell,ragnaros,159,paladin,holy,5,2,3
Ashera,amanthul,159,paladin,holy,14,3,11
Itsoverninek,emerald-dream,159,paladin,holy,17,2,15
Hearthledger,ragnaros,144,paladin,holy,3,3,0
Hálløwéð,firetree,138,paladin,holy,9,4,5
Whitedozer,darkspear,138,paladin,holy,10,4,6
Myû,korgath,112,paladin,holy,7,2,5
Kenric,quelthalas,96,paladin,holy,3,2,1
Vîxey,ragnaros,96,paladin,holy,6,1,5
Therëv,zuljin,96,paladin,holy,6,1,5
Holycowisroy,illidan,96,paladin,holy,6,1,5
Yikyok,stormrage,96,paladin,holy,6,1,5
Chakris,wyrmrest-accord,96,paladin,holy,6,1,5
Elrecka,stormrage,96,paladin,holy,6,1,5
Evilpallie,illidan,96,paladin,holy,6,1,5
Wings,arygos,96,paladin,holy,6,1,5
Kamí,elune,96,paladin,holy,6,1,5
Syrenadrel,hydraxis,96,paladin,holy,6,1,5
Silreck,ragnaros,96,paladin,holy,6,1,5
Kurook,moon-guard,96,paladin,holy,6,1,5
Rhinno,lothar,96,paladin,holy,6,1,5
Mfpink,thrall,96,paladin,holy,6,1,5
Emmipal,tichondrius,96,paladin,holy,6,1,5
Imabigkidnow,emerald-dream,96,paladin,holy,6,1,5
Mobitz,dalvengyr,96,paladin,holy,6,1,5
Lgbtq,trollbane,96,paladin,holy,6,1,5
Tetulia,quelthalas,96,paladin,holy,6,1,5
ßls,illidan,96,paladin,holy,6,1,5
Wrekster,tichondrius,96,paladin,holy,6,1,5
Deadlyassian,ysera,96,paladin,holy,6,1,5
Vexe,emerald-dream,96,paladin,holy,6,1,5
Goldensmile,frostmourne,96,paladin,holy,6,1,5
Krypton,tichondrius,96,paladin,holy,6,1,5
Arturias,kiljaeden,96,paladin,holy,6,1,5
Sherrill,nagrand,96,paladin,holy,6,1,5
Burgasari,tichondrius,96,paladin,holy,6,1,5
Purdicks,emerald-dream,96,paladin,holy,6,1,5
Zwilliam,frostmourne,96,paladin,holy,6,1,5
Trixzthot,barthilas,96,paladin,holy,6,1,5
Ploppers,sargeras,96,paladin,holy,6,1,5
Elronda,malganis,96,paladin,holy,6,1,5
Luxs,tichondrius,96,paladin,holy,6,1,5
Netéro,skywall,96,paladin,holy,6,1,5
Khaosactual,proudmoore,96,paladin,holy,6,1,5
Badnold,area-52,96,paladin,holy,6,1,5
Palabora,kelthuzad,96,paladin,holy,6,1,5
Keltheas,rivendare,96,paladin,holy,6,1,5
Sevina,twisting-nether,96,paladin,holy,6,1,5
Combidin,garrosh,96,paladin,holy,6,1,5
Timeparadox,illidan,96,paladin,holy,6,1,5
Tfcpaladin,the-forgotten-coast,96,paladin,holy,6,1,5
Nikxx,tichondrius,96,paladin,holy,6,1,5
Criaharn,turalyon,96,paladin,holy,6,1,5
Cremefraichè,tichondrius,96,paladin,holy,6,1,5
Ripadin,dunemaul,96,paladin,holy,11,1,10
Zentrick,whisperwind,96,paladin,holy,12,1,11
Lennon,stormrage,96,paladin,holy,12,1,11
Vanquishyr,stormrage,96,paladin,holy,12,1,11
Midnightboto,dragonmaw,96,paladin,holy,12,1,11
Soloist,tichondrius,96,paladin,holy,12,1,11
Jwilks,black-dragonflight,96,paladin,holy,12,1,11
Ordained,moonrunner,96,paladin,holy,12,1,11
Arlé,stormrage,95,paladin,holy,6,1,5
Ååron,thrall,89,paladin,holy,11,3,8
Tmzoeyqt,tichondrius,84,paladin,holy,9,4,5
Athenia,moon-guard,63,paladin,holy,6,3,3
Jkethuhsnake,ghostlands,48,paladin,holy,21,1,20
Alpinestârs,tichondrius,42,paladin,holy,9,2,7
Justinbebr,tichondrius,42,paladin,holy,14,3,11
Kziwei,stormrage,31,paladin,holy,2,1,1
Durendin,bonechewer,31,paladin,holy,2,1,1
Oghal,frostmourne,9,paladin,holy,23,3,20
Vanguards,tichondrius,2192,paladin,retribution,78,43,35
Theblèss,tichondrius,2158,paladin,retribution,91,48,43
Imitlol,alexstrasza,2154,paladin,retribution,181,91,90
Hamburgeryu,tichondrius,2114,paladin,retribution,94,47,47
Picachü,ragnaros,2104,paladin,retribution,125,63,62
Bullmarket,tichondrius,2104,paladin,retribution,114,57,57
Lanteranth,drenden,2103,paladin,retribution,126,63,63
Yuji,darkspear,2102,paladin,retribution,108,54,54
Hollyflame,tichondrius,2086,paladin,retribution,149,76,73
Quitzz,tichondrius,2050,paladin,retribution,117,58,59
Aldda,azralon,2047,paladin,retribution,122,59,63
Ryuseiblade,ragnaros,2047,paladin,retribution,108,52,56
Xexe,stormreaver,2030,paladin,retribution,150,74,76
Angryvelic,tichondrius,2019,paladin,retribution,87,41,46
Furylolz,tichondrius,2009,paladin,retribution,70,35,35
Memorisë,ragnaros,1998,paladin,retribution,99,57,42
Caperx,tichondrius,1994,paladin,retribution,48,21,27
Notvelic,tichondrius,1993,paladin,retribution,99,46,53
Wasteddwolf,tichondrius,1992,paladin,retribution,99,50,49
Coolvelic,tichondrius,1991,paladin,retribution,138,66,72
Dreamcastx,tichondrius,1984,paladin,retribution,131,64,67
Smortain,tichondrius,1973,paladin,retribution,84,39,45
Bigdickrick,ragnaros,1972,paladin,retribution,54,32,22
Maledraenei,sargeras,1970,paladin,retribution,113,54,59
Ämoureux,bleeding-hollow,1970,paladin,retribution,141,67,74
Alpinestârs,tichondrius,1967,paladin,retribution,122,60,62
Kamadonezuko,illidan,1965,paladin,retribution,59,34,25
Caveyodeler,zuluhed,1962,paladin,retribution,66,31,35
Mashbringer,moon-guard,1958,paladin,retribution,60,33,27
Dreamcastz,tichondrius,1957,paladin,retribution,48,33,15
Ohuo,tichondrius,1955,paladin,retribution,190,105,85
Evanguards,tichondrius,1954,paladin,retribution,113,52,61
Asukaba,sargeras,1950,paladin,retribution,68,33,35
Yccorz,frostmourne,1948,paladin,retribution,154,79,75
Alicê,moon-guard,1946,paladin,retribution,60,30,30
Xuantianchai,tichondrius,1944,paladin,retribution,60,36,24
Conndiment,earthen-ring,1942,paladin,retribution,72,35,37
Dratzq,ragnaros,1938,paladin,retribution,90,49,41
Bestowed,moon-guard,1933,paladin,retribution,87,44,43
Bartharious,malganis,1932,paladin,retribution,78,37,41
Indivisionxp,tichondrius,1928,paladin,retribution,55,34,21
Fuchí,tichondrius,1924,paladin,retribution,159,80,79
Roushex,sargeras,1920,paladin,retribution,66,34,32
Bøgård,sargeras,1919,paladin,retribution,135,68,67
Retroreq,tichondrius,1912,paladin,retribution,154,84,70
Ozzium,ragnaros,1912,paladin,retribution,125,62,63
Daxxj,akama,1910,paladin,retribution,104,46,58
Hammrekt,illidan,1905,paladin,retribution,48,25,23
Furgalicious,area-52,1904,paladin,retribution,125,60,65
Angelguards,tichondrius,1900,paladin,retribution,60,30,30
Danceholy,tichondrius,1894,paladin,retribution,81,39,42
Cønk,khadgar,1892,paladin,retribution,170,100,70
Simplybést,zuljin,1891,paladin,retribution,111,51,60
Xxwitcherxx,stormrage,1890,paladin,retribution,87,48,39
Lazypally,frostmourne,1890,paladin,retribution,48,25,23
Dtaitou,tichondrius,1889,paladin,retribution,60,28,32
Vendatha,darkspear,1887,paladin,retribution,30,25,5
Hellsingwolf,zuljin,1885,paladin,retribution,30,20,10
Pécorino,malganis,1884,paladin,retribution,52,31,21
Ðiviñe,zuluhed,1884,paladin,retribution,78,45,33
Kurôsh,kalecgos,1884,paladin,retribution,72,37,35
Zeldoul,magtheridon,1879,paladin,retribution,71,36,35
Condiments,earthen-ring,1876,paladin,retribution,66,34,32
Voidaz,stormscale,1873,paladin,retribution,60,31,29
Mwqyyds,tichondrius,1871,paladin,retribution,72,32,40
Alexjones,stormrage,1866,paladin,retribution,78,43,35
Reypally,dalaran,1865,paladin,retribution,120,62,58
Xilio,tichondrius,1865,paladin,retribution,72,36,36
Getmeabag,tichondrius,1861,paladin,retribution,54,25,29
Kubota,sargeras,1860,paladin,retribution,48,29,19
Chuoo,proudmoore,1859,paladin,retribution,46,22,24
Draenkz,quelthalas,1858,paladin,retribution,51,31,20
Younghova,kelthuzad,1857,paladin,retribution,66,32,34
Zyzzftw,stormrage,1856,paladin,retribution,53,31,22
Vânguards,tichondrius,1852,paladin,retribution,42,24,18
Foofs,shadowmoon,1851,paladin,retribution,53,26,27
Solanin,frostmourne,1849,paladin,retribution,35,20,15
Kaitúr,stormrage,1849,paladin,retribution,39,21,18
Hurv,area-52,1848,paladin,retribution,53,30,23
Palabora,kelthuzad,1847,paladin,retribution,47,27,20
Nishru,sargeras,1843,paladin,retribution,60,32,28
Divinehammer,proudmoore,1842,paladin,retribution,60,28,32
Retxsilver,thrall,1841,paladin,retribution,100,51,49
Mikhàël,stormscale,1840,paladin,retribution,52,37,15
Luosiding,tichondrius,1840,paladin,retribution,155,68,87
Chuckvandam,illidan,1839,paladin,retribution,54,36,18
Popje,zuljin,1839,paladin,retribution,36,20,16
Grifnballs,agamaggan,1839,paladin,retribution,56,31,25
Immobilized,frostmourne,1839,paladin,retribution,58,29,29
Mvpj,medivh,1839,paladin,retribution,48,23,25
Kushsessions,zuljin,1837,paladin,retribution,42,20,22
Alodorx,tichondrius,1836,paladin,retribution,36,23,13
Kangsang,illidan,1835,paladin,retribution,70,33,37
Dkdldkdld,tichondrius,1833,paladin,retribution,36,27,9
Lilglick,illidan,1833,paladin,retribution,36,21,15
Masqadin,tichondrius,1832,paladin,retribution,36,26,10
Leonilx,tichondrius,1832,paladin,retribution,48,21,27
ßò,area-52,1830,paladin,retribution,46,31,15
Burnning,tichondrius,1830,paladin,retribution,51,27,24
Eldenblade,moon-guard,1829,paladin,retribution,54,31,23
Coldzerox,ragnaros,1829,paladin,retribution,161,82,79
Honeydutchtv,black-dragonflight,1829,paladin,retribution,174,79,95
Hammrekt,kelthuzad,1829,paladin,retribution,47,20,27
Bornterrible,queldorei,1828,paladin,retribution,54,25,29
Talymra,ragnaros,1827,paladin,retribution,66,34,32
Idenline,moon-guard,1827,paladin,retribution,59,30,29
Wolfs,firetree,1826,paladin,retribution,66,29,37
Metallíka,nemesis,1826,paladin,retribution,71,31,40
Tramatic,sargeras,1825,paladin,retribution,54,29,25
Genericuser,sargeras,1825,paladin,retribution,58,30,28
Vip,frostmourne,1824,paladin,retribution,72,37,35
Praysnblaze,zuljin,1824,paladin,retribution,55,28,27
Lundor,ragnaros,1824,paladin,retribution,101,51,50
Apollidin,malganis,1824,paladin,retribution,57,23,34
Bohring,bleeding-hollow,1823,paladin,retribution,48,26,22
Damionblade,proudmoore,1823,paladin,retribution,161,84,77
Saradomin,kelthuzad,1822,paladin,retribution,129,66,63
Olixx,blackrock,1821,paladin,retribution,54,30,24
Kíngkáísér,azralon,1820,paladin,retribution,29,20,9
Yorøchi,azralon,1819,paladin,retribution,57,31,26
Geöspäwn,tichondrius,1819,paladin,retribution,39,20,19
Anbivilent,moon-guard,1819,paladin,retribution,48,23,25
Cardynivans,tichondrius,1819,paladin,retribution,67,25,42
Hargol,stormrage,1818,paladin,retribution,90,43,47
Dorex,moon-guard,1817,paladin,retribution,111,72,39
Dazargeros,moon-guard,1817,paladin,retribution,30,19,11
Dwimberlike,ragnaros,1816,paladin,retribution,56,37,19
Chadsteroid,sargeras,1816,paladin,retribution,48,29,19
Kooi,illidan,1816,paladin,retribution,78,35,43
Tyrillian,aerie-peak,1816,paladin,retribution,48,21,27
Kíngkáiser,azralon,1815,paladin,retribution,46,27,19
Iäl,tichondrius,1815,paladin,retribution,65,27,38
Zulmay,malganis,1814,paladin,retribution,156,78,78
Dorktanian,stormrage,1813,paladin,retribution,78,40,38
Rethumtv,tichondrius,1812,paladin,retribution,72,30,42
Arkadiano,drakkari,1812,paladin,retribution,78,29,49
Animepower,moon-guard,1811,paladin,retribution,94,56,38
Venguards,azralon,1811,paladin,retribution,57,30,27
Zanur,tichondrius,1811,paladin,retribution,136,67,69
Iqt,moon-guard,1811,paladin,retribution,78,32,46
Triston,area-52,1810,paladin,retribution,120,66,54
Lilcyans,ragnaros,1810,paladin,retribution,66,34,32
Primaryee,tichondrius,1810,paladin,retribution,121,53,68
Ladeon,proudmoore,1809,paladin,retribution,72,44,28
Stêvêts,tichondrius,1807,paladin,retribution,36,20,16
Downways,sargeras,1807,paladin,retribution,73,39,34
Profundity,area-52,1807,paladin,retribution,70,37,33
Velstadt,sargeras,1807,paladin,retribution,66,29,37
Gelosagrado,illidan,1807,paladin,retribution,113,48,65
Jhasøn,quelthalas,1806,paladin,retribution,60,40,20
Pornenjoyer,dalaran,1806,paladin,retribution,30,19,11
Darcobs,ragnaros,1806,paladin,retribution,172,90,82
Pambeazley,bronzebeard,1806,paladin,retribution,46,23,23
Pramethious,sargeras,1806,paladin,retribution,72,34,38
Erodan,moon-guard,1806,paladin,retribution,88,38,50
Annihilàtion,frostmourne,1805,paladin,retribution,42,30,12
Antlkd,quelthalas,1805,paladin,retribution,59,31,28
Panncakeman,tichondrius,1804,paladin,retribution,60,33,27
Ironblade,zuljin,1804,paladin,retribution,54,29,25
Palli,moon-guard,1804,paladin,retribution,60,31,29
Lumbersnack,moon-guard,1804,paladin,retribution,75,36,39
Justicejosh,frostmourne,1803,paladin,retribution,42,25,17
Niubcjq,tichondrius,1803,paladin,retribution,42,19,23
Disappearing,stormrage,1802,paladin,retribution,48,31,17
Sâdê,bleeding-hollow,1802,paladin,retribution,36,19,17
Mürlin,illidan,1802,paladin,retribution,117,58,59
Ópsv,quelthalas,1801,paladin,retribution,149,89,60
Parlore,moon-guard,1801,paladin,retribution,144,75,69
Mabia,tichondrius,1801,paladin,retribution,72,37,35
Kádabrak,tichondrius,1794,paladin,retribution,54,34,20
Teknik,stormscale,1793,paladin,retribution,112,57,55
Fylerz,blackhand,1790,paladin,retribution,78,45,33
Mikeqiaodan,tichondrius,1790,paladin,retribution,91,40,51
Zett,jubeithos,1789,paladin,retribution,79,35,44
Trippën,tichondrius,1784,paladin,retribution,145,82,63
Víkk,zuljin,1784,paladin,retribution,176,88,88
Holychris,shadowmoon,1784,paladin,retribution,66,28,38
Andelko,tichondrius,1783,paladin,retribution,36,21,15
Giørther,ragnaros,1783,paladin,retribution,57,29,28
Homelanderp,tichondrius,1779,paladin,retribution,57,30,27
Dampenedxd,bleeding-hollow,1779,paladin,retribution,98,45,53
Zakladchick,illidan,1778,paladin,retribution,48,26,22
Aleríon,ragnaros,1773,paladin,retribution,151,83,68
Rasler,stormrage,1773,paladin,retribution,144,73,71
Syleith,shadow-council,1768,paladin,retribution,115,54,61
Rahkinishu,khaz-modan,1766,paladin,retribution,189,109,80
Koketsu,ragnaros,1766,paladin,retribution,172,83,89
Nr,blood-furnace,1763,paladin,retribution,48,28,20
Malakor,thrall,1762,paladin,retribution,144,74,70
Ðori,tichondrius,1759,paladin,retribution,53,26,27
Beautiful,proudmoore,1756,paladin,retribution,123,62,61
Teniale,moon-guard,1756,paladin,retribution,48,23,25
Sweetfish,kiljaeden,1752,paladin,retribution,42,25,17
Neonblade,illidan,1752,paladin,retribution,88,42,46
Lunalunar,quelthalas,1750,paladin,retribution,53,28,25
Scarotv,malganis,1750,paladin,retribution,60,29,31
Therëv,zuljin,1750,paladin,retribution,71,31,40
Nhsvikings,bleeding-hollow,1748,paladin,retribution,53,29,24
Thørmento,azralon,1748,paladin,retribution,57,23,34
Ssjlimit,tichondrius,1747,paladin,retribution,47,25,22
Hozna,andorhal,1743,paladin,retribution,43,30,13
Htnhy,aegwynn,1743,paladin,retribution,60,24,36
Rashbringer,azgalor,1742,paladin,retribution,67,34,33
Josxth,stormrage,1741,paladin,retribution,54,29,25
Naverpay,tichondrius,1740,paladin,retribution,35,19,16
Awbie,moon-guard,1740,paladin,retribution,48,24,24
Triginhall,moon-guard,1740,paladin,retribution,54,26,28
Helldevil,zuljin,1739,paladin,retribution,48,25,23
Iggÿ,illidan,1739,paladin,retribution,52,24,28
Lvladen,sargeras,1739,paladin,retribution,54,22,32
Angelicwhim,stormrage,1738,paladin,retribution,36,20,16
Handyandy,kelthuzad,1738,paladin,retribution,96,42,54
Bigdaddysdic,illidan,1736,paladin,retribution,72,36,36
Dippedxd,tichondrius,1735,paladin,retribution,60,32,28
Gellehar,barthilas,1735,paladin,retribution,36,19,17
Remethea,sargeras,1733,paladin,retribution,129,67,62
Usdacertifed,lightnings-blade,1733,paladin,retribution,132,65,67
Konesky,dalaran,1732,paladin,retribution,40,21,19
Lilthroatbby,malganis,1732,paladin,retribution,114,49,65
Talivar,kelthuzad,1730,paladin,retribution,60,40,20
Zeyrox,stormrage,1729,paladin,retribution,42,20,22
Alduur,aggramar,1728,paladin,retribution,48,30,18
Agamemnom,tichondrius,1728,paladin,retribution,154,83,71
Cristø,stormrage,1727,paladin,retribution,72,30,42
Quinnzel,barthilas,1726,paladin,retribution,68,37,31
Coleta,stormrage,1725,paladin,retribution,36,25,11
Nah,emerald-dream,1725,paladin,retribution,57,30,27
Riseandgrind,tichondrius,1723,paladin,retribution,36,18,18
Puredecuy,ragnaros,1722,paladin,retribution,42,19,23
Whathehell,black-dragonflight,1720,paladin,retribution,75,37,38
Elegan,frostmourne,1719,paladin,retribution,60,30,30
Apnea,ragnaros,1719,paladin,retribution,90,39,51
Holywaffle,nemesis,1718,paladin,retribution,109,57,52
Scrubble,thrall,1717,paladin,retribution,80,40,40
Notae,icecrown,1717,paladin,retribution,42,21,21
Retrachet,thrall,1717,paladin,retribution,42,21,21
Éætûgýäëí,area-52,1716,paladin,retribution,42,18,24
Dippedlol,tichondrius,1714,paladin,retribution,30,19,11
Jonathein,barthilas,1713,paladin,retribution,82,40,42
Dankrachet,thrall,1713,paladin,retribution,60,25,35
Soverejgn,bleeding-hollow,1712,paladin,retribution,178,80,98
Fussyotter,stormreaver,1709,paladin,retribution,73,41,32
Svinadin,emerald-dream,1708,paladin,retribution,36,21,15
Crismj,tichondrius,1707,paladin,retribution,45,27,18
Luzoscura,quelthalas,1707,paladin,retribution,66,37,29
Alxndrr,area-52,1707,paladin,retribution,42,23,19
Lokâr,lightbringer,1706,paladin,retribution,66,30,36
Egirlret,tichondrius,1706,paladin,retribution,48,21,27
Ashkandi,tichondrius,1705,paladin,retribution,72,35,37
Bakafish,tichondrius,1702,paladin,retribution,24,18,6
Áldin,ragnaros,1702,paladin,retribution,34,21,13
Bizzaz,moon-guard,1702,paladin,retribution,62,27,35
Whosyadaddy,tichondrius,1701,paladin,retribution,48,25,23
Buckey,kilrogg,1699,paladin,retribution,52,28,24
Toughxguy,sargeras,1699,paladin,retribution,62,28,34
Voodoovon,tichondrius,1697,paladin,retribution,89,42,47
Bubblemark,tichondrius,1697,paladin,retribution,91,39,52
Zèrà,thunderhorn,1696,paladin,retribution,42,20,22
Evangelìne,darkspear,1695,paladin,retribution,36,23,13
Practícal,moon-guard,1693,paladin,retribution,66,35,31
Dazn,tichondrius,1693,paladin,retribution,78,26,52
Keltar,burning-blade,1692,paladin,retribution,30,18,12
Justnikop,tichondrius,1692,paladin,retribution,115,56,59
Dârkk,tichondrius,1691,paladin,retribution,36,20,16
Tuuro,stormrage,1690,paladin,retribution,117,56,61
Peledin,azralon,1689,paladin,retribution,59,31,28
Pickleret,emerald-dream,1689,paladin,retribution,96,45,51
Thrax,spirestone,1688,paladin,retribution,82,34,48
ßountystrike,sargeras,1687,paladin,retribution,60,26,34
Nitemareforu,stormreaver,1686,paladin,retribution,42,28,14
Titannious,stormrage,1686,paladin,retribution,107,52,55
Nbtv,tichondrius,1686,paladin,retribution,54,21,33
Xeldar,tichondrius,1685,paladin,retribution,54,28,26
Goldnhart,wyrmrest-accord,1685,paladin,retribution,66,34,32
Wing,frostwolf,1685,paladin,retribution,66,34,32
Kaithen,quelthalas,1684,paladin,retribution,173,88,85
Raxadin,stormrage,1681,paladin,retribution,42,23,19
Palimedic,sargeras,1681,paladin,retribution,78,35,43
Bravepala,tichondrius,1680,paladin,retribution,54,20,34
Konsentrate,tichondrius,1678,paladin,retribution,156,80,76
Mordirhar,tichondrius,1678,paladin,retribution,54,23,31
Loisterly,bladefist,1676,paladin,retribution,98,50,48
Siire,darkspear,1675,paladin,retribution,36,21,15
Mílkywayx,stormrage,1675,paladin,retribution,90,46,44
Oneaßoveall,azralon,1674,paladin,retribution,36,25,11
Zozo,zuljin,1674,paladin,retribution,36,22,14
Flykzu,azralon,1674,paladin,retribution,100,48,52
Tagex,malganis,1673,paladin,retribution,137,69,68
Chriskriego,frostmourne,1671,paladin,retribution,60,24,36
Hólyélf,illidan,1671,paladin,retribution,54,21,33
Johnmacclane,azralon,1670,paladin,retribution,82,43,39
Pantufä,stormrage,1670,paladin,retribution,41,21,20
Genovah,sargeras,1669,paladin,retribution,30,20,10
Zarrakra,daggerspine,1669,paladin,retribution,81,45,36
Accépting,sargeras,1669,paladin,retribution,66,33,33
Pumperjer,tichondrius,1669,paladin,retribution,53,26,27
Boarfarmer,tichondrius,1669,paladin,retribution,48,23,25
Lolcraftv,tichondrius,1667,paladin,retribution,48,22,26
Powermonster,tichondrius,1666,paladin,retribution,42,19,23
Palban,tichondrius,1665,paladin,retribution,48,26,22
Paladincane,sargeras,1665,paladin,retribution,108,54,54
Haiden,goldrinn,1665,paladin,retribution,55,23,32
Christtel,stormrage,1664,paladin,retribution,48,25,23
Ibullyourmom,tichondrius,1664,paladin,retribution,53,24,29
Stompëd,proudmoore,1663,paladin,retribution,62,29,33
Clownfister,barthilas,1662,paladin,retribution,48,25,23
Finaljustice,sargeras,1661,paladin,retribution,30,19,11
Lyrz,sargeras,1661,paladin,retribution,69,40,29
Mortaine,moon-guard,1660,paladin,retribution,47,23,24
Bigjiba,proudmoore,1658,paladin,retribution,48,25,23
Mesmi,moon-guard,1658,paladin,retribution,36,18,18
Sabotsaint,tichondrius,1656,paladin,retribution,49,20,29
Xbloodknight,malganis,1654,paladin,retribution,38,23,15
Paladinomg,darkspear,1654,paladin,retribution,124,71,53
Miktley,area-52,1654,paladin,retribution,42,19,23
Itzcupcake,illidan,1653,paladin,retribution,120,69,51
Duffnroses,tichondrius,1653,paladin,retribution,60,27,33
Backdrop,proudmoore,1652,paladin,retribution,133,67,66
Borrus,malygos,1651,paladin,retribution,72,40,32
Lanach,lightbringer,1651,paladin,retribution,64,33,31
Orivia,spirestone,1651,paladin,retribution,48,23,25
Trixtur,tichondrius,1651,paladin,retribution,60,28,32
Comeuppance,wyrmrest-accord,1649,paladin,retribution,88,46,42
Matthrian,moon-guard,1649,paladin,retribution,60,22,38
Likzebawlz,tichondrius,1648,paladin,retribution,42,25,17
Techno,tichondrius,1647,paladin,retribution,109,57,52
Divínos,area-52,1647,paladin,retribution,60,31,29
Incubus,rexxar,1647,paladin,retribution,48,22,26
Lucy,sargeras,1647,paladin,retribution,48,19,29
Nasnyl,stormrage,1646,paladin,retribution,42,20,22
Parkwons,tichondrius,1646,paladin,retribution,60,23,37
Bigolcriddys,barthilas,1645,paladin,retribution,36,21,15
Geedee,ysera,1645,paladin,retribution,70,39,31
Beaconlol,proudmoore,1644,paladin,retribution,43,29,14
Semellem,bloodhoof,1644,paladin,retribution,42,23,19
Beefjustice,velen,1643,paladin,retribution,48,27,21
Sevik,garithos,1643,paladin,retribution,66,35,31
Hedilyan,azralon,1643,paladin,retribution,90,47,43
Garlond,moon-guard,1642,paladin,retribution,42,25,17
Oathen,proudmoore,1642,paladin,retribution,56,27,29
Serås,silvermoon,1640,paladin,retribution,66,43,23
Forthestreet,tichondrius,1640,paladin,retribution,82,45,37
Lleo,nemesis,1640,paladin,retribution,118,54,64
Bakapal,tichondrius,1639,paladin,retribution,42,22,20
Davinshki,stormrage,1638,paladin,retribution,37,23,14
Pomboxd,stormrage,1638,paladin,retribution,30,18,12
Notneo,zuljin,1638,paladin,retribution,53,31,22
Swiftskillz,bleeding-hollow,1638,paladin,retribution,109,61,48
Brightstar,azjolnerub,1637,paladin,retribution,65,36,29
Dimdabbin,malganis,1637,paladin,retribution,42,22,20
Saccro,area-52,1637,paladin,retribution,114,57,57
Jud,frostmourne,1636,paladin,retribution,90,43,47
Çestlavie,korgath,1634,paladin,retribution,48,24,24
Lightowen,draka,1634,paladin,retribution,46,22,24
Beardy,emerald-dream,1633,paladin,retribution,60,36,24
Craq,alexstrasza,1631,paladin,retribution,56,26,30
Mihawk,drenden,1630,paladin,retribution,24,17,7
Berryblast,shadowmoon,1630,paladin,retribution,30,20,10
Zayblade,dragonblight,1630,paladin,retribution,40,23,17
Mixz,bleeding-hollow,1630,paladin,retribution,42,22,20
Ulrah,moon-guard,1629,paladin,retribution,120,68,52
Thoreal,thrall,1629,paladin,retribution,72,34,38
Ítsyôúñötmé,tichondrius,1627,paladin,retribution,62,35,27
Kíbá,malganis,1627,paladin,retribution,33,18,15
Djdiogø,azralon,1627,paladin,retribution,80,36,44
Shiryn,illidan,1626,paladin,retribution,42,21,21
Quadrifoglio,moon-guard,1625,paladin,retribution,96,52,44
Aeterias,dalaran,1625,paladin,retribution,81,41,40
Inmortall,illidan,1624,paladin,retribution,46,25,21
Clapstick,illidan,1624,paladin,retribution,36,17,19
Watchamebaba,malganis,1624,paladin,retribution,42,17,25
Radacos,emerald-dream,1623,paladin,retribution,160,80,80
Joeyrat,area-52,1623,paladin,retribution,42,20,22
Litler,tichondrius,1622,paladin,retribution,44,30,14
Gobblerr,blackrock,1622,paladin,retribution,30,20,10
Crayt,tichondrius,1622,paladin,retribution,68,31,37
Hazexd,illidan,1621,paladin,retribution,36,20,16
Dashhighborn,sargeras,1621,paladin,retribution,71,38,33
Faladrim,moon-guard,1621,paladin,retribution,160,84,76
Michaelsmith,frostmourne,1621,paladin,retribution,36,17,19
Rukkas,sargeras,1621,paladin,retribution,54,21,33
Valytonz,wyrmrest-accord,1620,paladin,retribution,36,17,19
Gunderbok,emerald-dream,1620,paladin,retribution,45,21,24
Sasorï,stormrage,1620,paladin,retribution,84,36,48
Bbtea,frostmourne,1619,paladin,retribution,48,20,28
Omnnii,tichondrius,1618,paladin,retribution,30,17,13
Glørious,drakkari,1618,paladin,retribution,90,42,48
Lawmower,sargeras,1616,paladin,retribution,54,32,22
Raelan,icecrown,1614,paladin,retribution,71,49,22
Bramot,moon-guard,1613,paladin,retribution,36,20,16
Moolishous,frostmourne,1612,paladin,retribution,83,43,40
Jvbai,area-52,1612,paladin,retribution,87,39,48
Nilin,tichondrius,1611,paladin,retribution,36,21,15
Kevybevy,stormrage,1611,paladin,retribution,150,81,69
Allîe,malganis,1611,paladin,retribution,72,37,35
Rahmie,kiljaeden,1611,paladin,retribution,96,41,55
Purejudgemnt,area-52,1610,paladin,retribution,54,33,21
Moød,ragnaros,1610,paladin,retribution,39,20,19
Beeftink,tichondrius,1609,paladin,retribution,100,51,49
Battlepope,thrall,1609,paladin,retribution,59,27,32
Regivan,nemesis,1609,paladin,retribution,54,21,33
Palejandro,illidan,1608,paladin,retribution,65,33,32
Sololeveling,malganis,1608,paladin,retribution,98,48,50
Golden,tichondrius,1608,paladin,retribution,42,20,22
Andrilsteh,malganis,1608,paladin,retribution,78,35,43
Yezzyll,korgath,1607,paladin,retribution,30,17,13
Dazedpal,tichondrius,1607,paladin,retribution,254,135,119
Trolladin,rivendare,1607,paladin,retribution,110,51,59
Sukilol,tichondrius,1607,paladin,retribution,54,22,32
Eurekasret,ragnaros,1606,paladin,retribution,36,20,16
Marehk,thrall,1606,paladin,retribution,59,32,27
Stônemôuntan,moon-guard,1606,paladin,retribution,72,26,46
Theseusz,tichondrius,1605,paladin,retribution,24,19,5
Chrisader,stormrage,1605,paladin,retribution,36,19,17
Dïlly,area-52,1605,paladin,retribution,84,43,41
Retrodino,anvilmar,1605,paladin,retribution,42,18,24
Elcíd,quelthalas,1605,paladin,retribution,75,28,47
Xeniél,illidan,1604,paladin,retribution,36,19,17
Rycerzforge,ragnaros,1604,paladin,retribution,74,38,36
Actionb,aggramar,1604,paladin,retribution,90,41,49
Zalndraeda,barthilas,1603,paladin,retribution,90,47,43
Skylinator,bleeding-hollow,1603,paladin,retribution,59,26,33
Jowliet,stormrage,1601,paladin,retribution,36,17,19
Cyrenity,tichondrius,1601,paladin,retribution,54,17,37
Telarøn,stormrage,1600,paladin,retribution,165,83,82
Southerly,tichondrius,1598,paladin,retribution,54,26,28
Eneraxx,proudmoore,1598,paladin,retribution,42,17,25
Galatus,tichondrius,1597,paladin,retribution,35,17,18
Happybubbles,tichondrius,1594,paladin,retribution,36,20,16
Layonhánd,ragnaros,1593,paladin,retribution,48,22,26
Alpengeist,turalyon,1591,paladin,retribution,36,19,17
Gimlias,kelthuzad,1591,paladin,retribution,42,21,21
Cøøkïë,frostmourne,1590,paladin,retribution,42,22,20
Torinel,illidan,1590,paladin,retribution,35,17,18
Auralyon,tichondrius,1590,paladin,retribution,42,17,25
Tyirr,kelthuzad,1589,paladin,retribution,78,35,43
Midheaven,moon-guard,1588,paladin,retribution,41,25,16
Sinmca,moon-guard,1588,paladin,retribution,60,34,26
Cowsecration,ragnaros,1585,paladin,retribution,24,17,7
Benoít,zuljin,1583,paladin,retribution,72,40,32
Fótm,bleeding-hollow,1583,paladin,retribution,72,36,36
Lightlana,frostwolf,1583,paladin,retribution,68,34,34
Thenextx,illidan,1583,paladin,retribution,54,20,34
Landeren,khazgoroth,1582,paladin,retribution,48,22,26
Taphos,icecrown,1581,paladin,retribution,53,30,23
Toguro,kelthuzad,1580,paladin,retribution,40,22,18
Chiphazard,stormscale,1579,paladin,retribution,52,22,30
Leztatium,quelthalas,1578,paladin,retribution,36,19,17
Fuknshané,area-52,1577,paladin,retribution,68,32,36
Malacriianza,quelthalas,1576,paladin,retribution,54,30,24
Daddytoad,tichondrius,1576,paladin,retribution,54,24,30
Fìlìgree,tichondrius,1574,paladin,retribution,55,30,25
Seraphini,illidan,1574,paladin,retribution,48,23,25
Traceless,emerald-dream,1573,paladin,retribution,75,42,33
Brokeniron,wyrmrest-accord,1573,paladin,retribution,60,29,31
Varekaì,frostmourne,1572,paladin,retribution,63,34,29
Dzx,nemesis,1572,paladin,retribution,204,109,95
Stackmymoney,kelthuzad,1572,paladin,retribution,50,22,28
Ðoflamingo,area-52,1570,paladin,retribution,48,27,21
Plophero,moon-guard,1570,paladin,retribution,42,21,21
Tobaz,azralon,1569,paladin,retribution,79,43,36
Tesak,emerald-dream,1568,paladin,retribution,48,25,23
Guerrer,hyjal,1567,paladin,retribution,60,33,27
Notbärry,area-52,1567,paladin,retribution,42,22,20
Obsolete,onyxia,1567,paladin,retribution,36,18,18
Coffeepal,tichondrius,1567,paladin,retribution,48,23,25
Mazaltoff,proudmoore,1567,paladin,retribution,72,33,39
Wasembroder,ragnaros,1566,paladin,retribution,71,40,31
Émiluss,stormrage,1566,paladin,retribution,36,18,18
Samgonz,tichondrius,1565,paladin,retribution,48,28,20
Ragarèn,emerald-dream,1565,paladin,retribution,36,17,19
Fionno,quelthalas,1564,paladin,retribution,116,58,58
Tantradin,area-52,1564,paladin,retribution,48,20,28
Rhegyna,quelthalas,1562,paladin,retribution,36,19,17
Mormdring,fizzcrank,1562,paladin,retribution,54,23,31
Rxes,frostmourne,1562,paladin,retribution,75,31,44
Oppressive,moon-guard,1561,paladin,retribution,266,127,139
Kiritazuma,ravencrest,1560,paladin,retribution,66,33,33
Baeflux,kelthuzad,1560,paladin,retribution,48,19,29
Ilovecl,tichondrius,1557,paladin,retribution,48,28,20
Vêgenace,proudmoore,1556,paladin,retribution,48,24,24
Missusomutch,azralon,1556,paladin,retribution,50,17,33
Gokuu,korgath,1555,paladin,retribution,62,33,29
Lit,alexstrasza,1555,paladin,retribution,46,19,27
Crybátt,quelthalas,1553,paladin,retribution,68,35,33
Luminiscente,ragnaros,1553,paladin,retribution,58,29,29
Alexieus,wyrmrest-accord,1553,paladin,retribution,71,32,39
Lumaros,wyrmrest-accord,1552,paladin,retribution,48,25,23
Thastrian,stormreaver,1552,paladin,retribution,60,31,29
Marvallous,area-52,1552,paladin,retribution,40,19,21
Notoriouus,bleeding-hollow,1552,paladin,retribution,42,18,24
Yovan,proudmoore,1551,paladin,retribution,90,51,39
Holybirkkal,arthas,1551,paladin,retribution,47,25,22
Holyjoint,uther,1550,paladin,retribution,92,39,53
Utherpendrag,bladefist,1550,paladin,retribution,66,24,42
Chancellor,azralon,1549,paladin,retribution,138,76,62
Caribourider,tichondrius,1548,paladin,retribution,65,29,36
Pallehx,tichondrius,1547,paladin,retribution,41,18,23
Pinkies,frostmourne,1545,paladin,retribution,48,26,22
Getdiswork,malygos,1545,paladin,retribution,63,29,34
Thaldun,wyrmrest-accord,1541,paladin,retribution,95,41,54
Smallhammer,aegwynn,1540,paladin,retribution,48,21,27
Nqe,area-52,1538,paladin,retribution,34,20,14
Frùglé,sargeras,1538,paladin,retribution,36,20,16
Renckay,ragnaros,1538,paladin,retribution,87,43,44
Celethor,wyrmrest-accord,1537,paladin,retribution,54,30,24
Thepinkdept,proudmoore,1537,paladin,retribution,38,20,18
Greciâ,ragnaros,1535,paladin,retribution,42,18,24
Hammrekt,sargeras,1534,paladin,retribution,24,16,8
Álkair,ragnaros,1534,paladin,retribution,83,36,47
Avenging,wyrmrest-accord,1533,paladin,retribution,24,16,8
Jager,medivh,1533,paladin,retribution,71,41,30
Popwings,azralon,1532,paladin,retribution,28,17,11
Xiaoqingye,tichondrius,1532,paladin,retribution,30,16,14
Shiadfang,tichondrius,1532,paladin,retribution,48,23,25
Mcconnell,sargeras,1530,paladin,retribution,30,16,14
Holyroro,area-52,1530,paladin,retribution,38,20,18
Elëssar,ragnaros,1530,paladin,retribution,77,40,37
Ezcoatl,stormrage,1530,paladin,retribution,92,47,45
Vasharien,nerzhul,1530,paladin,retribution,60,30,30
Alphanerd,burning-blade,1529,paladin,retribution,36,24,12
Beardedbrute,korgath,1529,paladin,retribution,30,16,14
Joeschmo,area-52,1529,paladin,retribution,30,16,14
Schankyy,stormrage,1529,paladin,retribution,36,19,17
Deepsearide,illidan,1529,paladin,retribution,119,61,58
Unfairness,skullcrusher,1528,paladin,retribution,63,33,30
Ástridr,moon-guard,1528,paladin,retribution,95,43,52
Galeast,tichondrius,1528,paladin,retribution,36,16,20
Arturias,kiljaeden,1527,paladin,retribution,77,38,39
Oneshotman,stormrage,1526,paladin,retribution,30,16,14
Beshiki,hakkar,1526,paladin,retribution,264,130,134
Kenpachí,doomhammer,1525,paladin,retribution,42,30,12
Venxpeita,azralon,1525,paladin,retribution,24,16,8
Rektwings,area-52,1525,paladin,retribution,30,16,14
Shaidd,bleeding-hollow,1524,paladin,retribution,98,49,49
Lucianz,ragnaros,1523,paladin,retribution,48,20,28
Filthyape,wyrmrest-accord,1520,paladin,retribution,24,17,7
Anjurus,moon-guard,1519,paladin,retribution,30,16,14
Tzakial,area-52,1519,paladin,retribution,42,16,26
Chewyjitsu,tichondrius,1517,paladin,retribution,30,17,13
Worshipmex,tichondrius,1517,paladin,retribution,36,20,16
Souyiro,sargeras,1517,paladin,retribution,36,16,20
Lorenzinho,azralon,1516,paladin,retribution,80,42,38
Attkdmgcurry,illidan,1515,paladin,retribution,41,16,25
Kawkpaladin,kaelthas,1512,paladin,retribution,54,28,26
Greasysteve,stormrage,1511,paladin,retribution,36,22,14
Malandru,darrowmere,1510,paladin,retribution,36,16,20
Protein,magtheridon,1509,paladin,retribution,42,16,26
Mysticblade,sargeras,1508,paladin,retribution,54,31,23
Cyreus,emerald-dream,1508,paladin,retribution,57,26,31
Varlip,wyrmrest-accord,1508,paladin,retribution,41,16,25
Miemiesage,illidan,1508,paladin,retribution,42,16,26
Aberpal,illidan,1507,paladin,retribution,35,19,16
Yazuka,wyrmrest-accord,1506,paladin,retribution,54,30,24
Istril,ragnaros,1505,paladin,retribution,235,122,113
Jonfox,stormrage,1504,paladin,retribution,48,26,22
Angrytitan,tichondrius,1504,paladin,retribution,42,17,25
Alanthor,ragnaros,1503,paladin,retribution,108,48,60
Xk,kiljaeden,1502,paladin,retribution,30,16,14
Lecheroø,tichondrius,1502,paladin,retribution,30,16,14
Whyta,azralon,1502,paladin,retribution,133,66,67
Rohrn,firetree,1501,paladin,retribution,49,29,20
Savøx,sargeras,1500,paladin,retribution,77,37,40
Killmönger,tichondrius,1499,paladin,retribution,46,20,26
Kookamønga,tichondrius,1498,paladin,retribution,67,32,35
Pocserpala,drakkari,1497,paladin,retribution,24,16,8
Mäýhëm,sargeras,1497,paladin,retribution,36,22,14
Audris,chogall,1497,paladin,retribution,65,29,36
Valardaharis,thunderlord,1497,paladin,retribution,88,39,49
Schwârts,blackrock,1494,paladin,retribution,70,36,34
Preacherfudd,area-52,1493,paladin,retribution,30,16,14
Anivan,moon-guard,1493,paladin,retribution,42,21,21
Sneeber,stormrage,1493,paladin,retribution,66,30,36
Konthrus,azralon,1492,paladin,retribution,59,40,19
Ignasius,blood-furnace,1492,paladin,retribution,42,19,23
Arquidea,tichondrius,1492,paladin,retribution,36,16,20
Ascetic,barthilas,1492,paladin,retribution,174,73,101
Týrael,uldum,1491,paladin,retribution,36,21,15
Kozk,quelthalas,1488,paladin,retribution,129,73,56
Mathieü,zuljin,1488,paladin,retribution,36,20,16
Castïël,area-52,1488,paladin,retribution,151,73,78
Dgâza,tichondrius,1488,paladin,retribution,36,17,19
Jdgmnt,sargeras,1487,paladin,retribution,60,30,30
Joltie,quelthalas,1485,paladin,retribution,131,70,61
Haunter,akama,1485,paladin,retribution,54,25,29
Levian,spirestone,1483,paladin,retribution,90,46,44
Tacien,tichondrius,1483,paladin,retribution,100,49,51
Pàladwarf,stormrage,1483,paladin,retribution,39,19,20
Lebowski,nordrassil,1482,paladin,retribution,36,19,17
Dalgren,quelthalas,1482,paladin,retribution,81,30,51
Galeatus,tichondrius,1481,paladin,retribution,47,17,30
Ralo,khaz-modan,1480,paladin,retribution,30,16,14
Forlam,sargeras,1480,paladin,retribution,108,45,63
Cloaxy,azgalor,1480,paladin,retribution,60,23,37
Areuss,tichondrius,1479,paladin,retribution,29,16,13
Mcholy,thrall,1479,paladin,retribution,38,20,18
Janokaluo,wyrmrest-accord,1479,paladin,retribution,89,46,43
Faowin,sargeras,1478,paladin,retribution,60,27,33
Holydiver,sargeras,1478,paladin,retribution,78,34,44
Insideous,kelthuzad,1478,paladin,retribution,54,23,31
Ellyee,jaedenar,1478,paladin,retribution,46,17,29
Killeralan,quelthalas,1477,paladin,retribution,74,34,40
Shartea,moon-guard,1475,paladin,retribution,46,21,25
Azoruken,quelthalas,1475,paladin,retribution,71,31,40
Arecht,moon-guard,1474,paladin,retribution,30,19,11
Freiermoth,shadowmoon,1474,paladin,retribution,123,63,60
Fressbee,nathrezim,1473,paladin,retribution,41,19,22
Cyniaria,moon-guard,1472,paladin,retribution,60,33,27
Zuthora,alleria,1471,paladin,retribution,70,37,33
Yoboyindahiz,stormrage,1471,paladin,retribution,57,23,34
Rykorth,moon-guard,1470,paladin,retribution,33,20,13
Charleyy,stormscale,1469,paladin,retribution,78,45,33
Cókelol,zuljin,1469,paladin,retribution,60,32,28
Pijbins,moon-guard,1469,paladin,retribution,66,34,32
Purdicks,emerald-dream,1467,paladin,retribution,60,25,35
Dimmadome,frostmourne,1465,paladin,retribution,66,44,22
Toughlife,tichondrius,1464,paladin,retribution,66,25,41
Nohpalli,kelthuzad,1463,paladin,retribution,79,43,36
Bañe,lightbringer,1463,paladin,retribution,81,35,46
Dreyan,wyrmrest-accord,1462,paladin,retribution,47,23,24
Sanguinata,shadowsong,1461,paladin,retribution,47,30,17
Snussp,emerald-dream,1461,paladin,retribution,69,32,37
Hamertime,wyrmrest-accord,1460,paladin,retribution,81,40,41
Lasteroy,nemesis,1459,paladin,retribution,29,16,13
Grîshnâkh,ragnaros,1458,paladin,retribution,95,48,47
Dentarg,garrosh,1456,paladin,retribution,54,29,25
Folgimar,moon-guard,1455,paladin,retribution,72,37,35
Thalorian,azshara,1455,paladin,retribution,51,25,26
Lolslikeomg,malganis,1454,paladin,retribution,72,29,43
Sovereignt,aggramar,1453,paladin,retribution,157,84,73
Monchy,bleeding-hollow,1453,paladin,retribution,52,27,25
Wwanntae,tichondrius,1453,paladin,retribution,60,26,34
Yamush,silver-hand,1452,paladin,retribution,36,18,18
Murtag,bloodscalp,1451,paladin,retribution,36,18,18
Vexxa,nerzhul,1451,paladin,retribution,36,18,18
Liaadrin,azralon,1450,paladin,retribution,32,16,16
Solandiis,tichondrius,1450,paladin,retribution,67,32,35
Airplane,malygos,1449,paladin,retribution,24,16,8
Lustros,stormrage,1449,paladin,retribution,66,28,38
Californía,bleeding-hollow,1448,paladin,retribution,37,23,14
Ellanaria,thrall,1445,paladin,retribution,111,57,54
Aoishie,bleeding-hollow,1444,paladin,retribution,96,45,51
Bladetm,proudmoore,1444,paladin,retribution,53,23,30
Carnagias,bleeding-hollow,1443,paladin,retribution,65,34,31
Andrinn,nemesis,1443,paladin,retribution,36,18,18
Iluminadoor,nemesis,1442,paladin,retribution,29,19,10
Weskar,frostwolf,1440,paladin,retribution,36,21,15
Awake,chogall,1439,paladin,retribution,24,15,9
Kkgame,tichondrius,1439,paladin,retribution,37,19,18
Zadragon,sargeras,1438,paladin,retribution,48,24,24
Dúrnir,stormscale,1437,paladin,retribution,24,15,9
Saakero,illidan,1436,paladin,retribution,24,15,9
Zolktro,stormrage,1435,paladin,retribution,52,27,25
Stax,moon-guard,1435,paladin,retribution,36,15,21
Warmpôcket,proudmoore,1435,paladin,retribution,66,26,40
Lumíty,sargeras,1434,paladin,retribution,125,64,61
Gimli,mannoroth,1434,paladin,retribution,36,15,21
Saakadin,illidan,1431,paladin,retribution,24,15,9
Rasc,barthilas,1431,paladin,retribution,42,18,24
Sprinkills,frostmourne,1430,paladin,retribution,25,18,7
Richiggaa,illidan,1430,paladin,retribution,47,29,18
Konarik,stormrage,1430,paladin,retribution,40,21,19
Theretpally,kelthuzad,1430,paladin,retribution,42,20,22
Forged,steamwheedle-cartel,1430,paladin,retribution,66,29,37
Dréveleth,quelthalas,1430,paladin,retribution,47,15,32
Lmd,tichondrius,1429,paladin,retribution,54,29,25
Onitenshi,stormscale,1429,paladin,retribution,67,31,36
Dawncröwn,stormrage,1429,paladin,retribution,53,17,36
Traize,kelthuzad,1428,paladin,retribution,24,15,9
Talantyr,zuljin,1426,paladin,retribution,78,36,42
Tribiani,lightbringer,1425,paladin,retribution,24,15,9
Dallyon,stormrage,1425,paladin,retribution,24,15,9
Mathalt,area-52,1425,paladin,retribution,51,26,25
Tekar,altar-of-storms,1424,paladin,retribution,42,17,25
Sammyste,elune,1423,paladin,retribution,80,41,39
Shlaps,crushridge,1423,paladin,retribution,42,21,21
Modjytech,tichondrius,1422,paladin,retribution,66,24,42
Astharor,nemesis,1421,paladin,retribution,52,29,23
Arahann,bleeding-hollow,1420,paladin,retribution,29,16,13
Palpinga,kelthuzad,1420,paladin,retribution,44,18,26
Annhette,sargeras,1418,paladin,retribution,31,15,16
Promethèus,jubeithos,1418,paladin,retribution,42,15,27
Napstër,ragnaros,1417,paladin,retribution,36,15,21
Hägär,tichondrius,1416,paladin,retribution,30,15,15
Wagyou,skywall,1416,paladin,retribution,30,15,15
Reckcowning,area-52,1416,paladin,retribution,42,15,27
Hdmi,darkspear,1415,paladin,retribution,41,20,21
Zadquel,ragnaros,1414,paladin,retribution,59,30,29
Belgrieve,proudmoore,1414,paladin,retribution,42,20,22
Pockopea,arygos,1413,paladin,retribution,42,23,19
Savagedemise,barthilas,1413,paladin,retribution,55,28,27
Justicierø,aegwynn,1413,paladin,retribution,42,21,21
Solgrïm,wyrmrest-accord,1412,paladin,retribution,36,18,18
Bubblestar,ragnaros,1412,paladin,retribution,48,22,26
Rhodela,illidan,1412,paladin,retribution,36,16,20
Smashnasty,area-52,1409,paladin,retribution,24,15,9
Arreliya,sargeras,1409,paladin,retribution,30,15,15
Vaqoh,ragnaros,1409,paladin,retribution,36,15,21
Kalboko,twisting-nether,1408,paladin,retribution,45,23,22
Reìarthur,stormrage,1408,paladin,retribution,72,32,40
Kulandis,stormrage,1408,paladin,retribution,57,24,33
Perzeføne,quelthalas,1407,paladin,retribution,35,19,16
Jxke,barthilas,1406,paladin,retribution,29,15,14
Szeq,tichondrius,1405,paladin,retribution,32,16,16
Wesdarian,jaedenar,1405,paladin,retribution,72,31,41
Sconci,whisperwind,1404,paladin,retribution,30,15,15
Zimzob,stormscale,1403,paladin,retribution,30,15,15
Swietomierz,proudmoore,1403,paladin,retribution,48,20,28
Fabolouss,tichondrius,1402,paladin,retribution,66,38,28
Viclovin,stormrage,1400,paladin,retribution,34,17,17
Sländers,sargeras,1400,paladin,retribution,53,24,29
Keltec,bonechewer,1400,paladin,retribution,39,16,23
Tøpbløke,frostmourne,1399,paladin,retribution,55,28,27
Yawnbringer,tichondrius,1399,paladin,retribution,78,37,41
Falaran,azralon,1398,paladin,retribution,56,28,28
Mordered,proudmoore,1396,paladin,retribution,34,15,19
Albïreo,drakkari,1394,paladin,retribution,30,15,15
Rhodius,dalaran,1393,paladin,retribution,42,23,19
Tmac,azralon,1393,paladin,retribution,68,35,33
Belregn,illidan,1393,paladin,retribution,78,36,42
Hurukpaly,azralon,1393,paladin,retribution,42,19,23
Öpäf,steamwheedle-cartel,1393,paladin,retribution,49,21,28
Wésters,quelthalas,1391,paladin,retribution,85,37,48
Tronzyy,trollbane,1391,paladin,retribution,35,15,20
Droden,tichondrius,1390,paladin,retribution,55,29,26
Industry,firetree,1389,paladin,retribution,27,16,11
Mfgspally,kelthuzad,1389,paladin,retribution,30,15,15
Yiqieyouwei,proudmoore,1388,paladin,retribution,36,15,21
Slowedreverb,stormrage,1387,paladin,retribution,81,42,39
Granisdh,aegwynn,1387,paladin,retribution,54,27,27
Erowyn,tichondrius,1385,paladin,retribution,30,15,15
Judgmentor,malganis,1384,paladin,retribution,64,25,39
Urfavxbf,baelgun,1383,paladin,retribution,104,56,48
Lightcast,moon-guard,1382,paladin,retribution,36,17,19
Cillessá,kelthuzad,1378,paladin,retribution,42,17,25
Elsinore,senjin,1377,paladin,retribution,35,19,16
Mitchyc,stormrage,1376,paladin,retribution,60,28,32
Delanadras,kelthuzad,1375,paladin,retribution,47,19,28
Stdee,zuljin,1372,paladin,retribution,57,30,27
Swurvezx,bleeding-hollow,1371,paladin,retribution,23,15,8
Minitas,blackrock,1369,paladin,retribution,42,15,27
Kellissandra,aerie-peak,1368,paladin,retribution,84,34,50
Wlq,frostmourne,1368,paladin,retribution,47,18,29
Kadbury,icecrown,1367,paladin,retribution,103,38,65
Scubàlicous,magtheridon,1366,paladin,retribution,42,19,23
Wîckèd,tichondrius,1366,paladin,retribution,35,15,20
Bilbain,proudmoore,1365,paladin,retribution,167,82,85
Bebopin,tichondrius,1365,paladin,retribution,34,16,18
Erethonis,bladefist,1364,paladin,retribution,48,23,25
Áthz,ragnaros,1363,paladin,retribution,41,21,20
Alvick,icecrown,1363,paladin,retribution,39,16,23
Donao,illidan,1361,paladin,retribution,42,21,21
Sellenagomez,malganis,1359,paladin,retribution,48,21,27
Balrok,cenarius,1358,paladin,retribution,179,88,91
Dfbattlepass,kelthuzad,1357,paladin,retribution,61,32,29
Pallytoot,aerie-peak,1356,paladin,retribution,30,19,11
Messeb,veknilash,1356,paladin,retribution,115,62,53
Wickedwingz,sargeras,1356,paladin,retribution,30,15,15
Bullzor,aerie-peak,1352,paladin,retribution,43,28,15
Andronik,bleeding-hollow,1352,paladin,retribution,33,16,17
Hùck,alexstrasza,1352,paladin,retribution,104,48,56
Tlahtoani,illidan,1350,paladin,retribution,23,15,8
Zantdemption,frostmourne,1349,paladin,retribution,29,15,14
Øxøxø,emerald-dream,1347,paladin,retribution,78,41,37
Ôdenswrath,stormscale,1347,paladin,retribution,68,34,34
Hazmât,illidan,1347,paladin,retribution,81,32,49
Dwurim,moon-guard,1346,paladin,retribution,48,26,22
Kalendawn,moon-guard,1345,paladin,retribution,43,26,17
Ddeadwhisper,executus,1345,paladin,retribution,104,56,48
Chinsta,zuljin,1344,paladin,retribution,24,16,8
Retman,azuremyst,1344,paladin,retribution,42,17,25
Aiseyqt,frostmourne,1343,paladin,retribution,42,25,17
Bossmin,tichondrius,1343,paladin,retribution,24,14,10
Kumdonia,illidan,1343,paladin,retribution,30,14,16
Sôck,zuljin,1343,paladin,retribution,32,14,18
Worder,tichondrius,1342,paladin,retribution,24,15,9
Strøngkiing,bleeding-hollow,1342,paladin,retribution,24,14,10
Samphlty,azralon,1340,paladin,retribution,30,14,16
Outstrike,tichondrius,1340,paladin,retribution,30,14,16
Retsonictwo,tichondrius,1340,paladin,retribution,30,14,16
Xandia,aegwynn,1340,paladin,retribution,42,14,28
Athenauwu,illidan,1339,paladin,retribution,34,15,19
Stöneblood,moon-guard,1339,paladin,retribution,36,14,22
Juffury,illidan,1339,paladin,retribution,42,14,28
Hapii,tichondrius,1338,paladin,retribution,41,16,25
Palajeans,stormrage,1337,paladin,retribution,24,14,10
Neró,quelthalas,1337,paladin,retribution,55,25,30
Hristian,tichondrius,1336,paladin,retribution,24,14,10
Healmeboi,tichondrius,1336,paladin,retribution,24,14,10
Oldicktwist,garrosh,1336,paladin,retribution,42,23,19
Ibustcheeks,sargeras,1334,paladin,retribution,24,14,10
Waffletrain,tichondrius,1334,paladin,retribution,34,15,19
Anafensa,malganis,1334,paladin,retribution,36,14,22
Väkariän,quelthalas,1333,paladin,retribution,30,14,16
Mïkhael,nemesis,1333,paladin,retribution,54,20,34
Yusha,barthilas,1332,paladin,retribution,23,15,8
Snowcrest,cenarius,1332,paladin,retribution,36,17,19
Heraolympian,black-dragonflight,1331,paladin,retribution,24,15,9
Trogdorpwn,bonechewer,1331,paladin,retribution,30,17,13
Ënfos,azralon,1331,paladin,retribution,30,14,16
Däkh,sargeras,1329,paladin,retribution,24,14,10
Yree,ragnaros,1329,paladin,retribution,30,14,16
Amanzhul,quelthalas,1329,paladin,retribution,36,14,22
Brightsaber,tichondrius,1328,paladin,retribution,63,34,29
Melize,area-52,1328,paladin,retribution,93,44,49
Adrockiller,quelthalas,1328,paladin,retribution,38,17,21
Snowcrow,tichondrius,1327,paladin,retribution,80,36,44
Aztraseneco,ragnaros,1325,paladin,retribution,74,40,34
Oschy,moon-guard,1325,paladin,retribution,67,31,36
Akabanee,ragnaros,1324,paladin,retribution,24,14,10
Christman,illidan,1323,paladin,retribution,78,33,45
Jizii,tichondrius,1322,paladin,retribution,24,14,10
Rusinator,bonechewer,1320,paladin,retribution,24,14,10
Sventyn,frostmourne,1320,paladin,retribution,41,14,27
Avantasias,sargeras,1319,paladin,retribution,64,30,34
Bennu,sargeras,1319,paladin,retribution,45,17,28
Taîno,thrall,1318,paladin,retribution,68,35,33
Levarious,thunderlord,1317,paladin,retribution,54,25,29
Hwanko,tichondrius,1316,paladin,retribution,28,20,8
Morneau,malganis,1315,paladin,retribution,204,98,106
Bigdoosa,frostmourne,1309,paladin,retribution,28,16,12
Dcountt,area-52,1307,paladin,retribution,36,14,22
Retrah,azralon,1306,paladin,retribution,24,14,10
Malorian,azgalor,1306,paladin,retribution,42,17,25
Shecara,malygos,1305,paladin,retribution,48,26,22
Arkanica,moon-guard,1305,paladin,retribution,36,15,21
Carolena,thaurissan,1305,paladin,retribution,48,19,29
Krawmwell,lothar,1303,paladin,retribution,54,34,20
Jursch,emerald-dream,1303,paladin,retribution,97,44,53
Happywow,tichondrius,1302,paladin,retribution,59,30,29
Atrayeus,dawnbringer,1300,paladin,retribution,48,21,27
Oneminute,nerzhul,1299,paladin,retribution,42,21,21
Gixpal,skullcrusher,1297,paladin,retribution,24,14,10
Mobitz,dalvengyr,1297,paladin,retribution,36,18,18
Vtyr,nemesis,1297,paladin,retribution,51,23,28
Jøestar,proudmoore,1297,paladin,retribution,36,14,22
Sunwrath,quelthalas,1296,paladin,retribution,72,29,43
Athenariel,bleeding-hollow,1295,paladin,retribution,36,16,20
Haiyaa,frostwolf,1294,paladin,retribution,30,14,16
Jugheadqc,mugthol,1293,paladin,retribution,51,25,26
Paladingirl,darkspear,1292,paladin,retribution,92,50,42
Throwable,illidan,1291,paladin,retribution,40,16,24
Vêndar,ragnaros,1289,paladin,retribution,78,33,45
Chadatron,tichondrius,1288,paladin,retribution,30,15,15
Tutankhammer,stormrage,1286,paladin,retribution,58,28,30
Dedsxy,tichondrius,1286,paladin,retribution,30,14,16
Critxx,tichondrius,1286,paladin,retribution,71,32,39
Broxon,tichondrius,1285,paladin,retribution,58,30,28
Gainen,illidan,1285,paladin,retribution,47,24,23
Heindallr,nemesis,1284,paladin,retribution,36,18,18
Paliodin,dalaran,1284,paladin,retribution,36,15,21
Nadrela,burning-blade,1281,paladin,retribution,42,25,17
Garcinddra,vashj,1281,paladin,retribution,28,15,13
Navicc,zuljin,1279,paladin,retribution,29,14,15
Mikehawkhuge,area-52,1276,paladin,retribution,42,22,20
Rimjobrachel,barthilas,1276,paladin,retribution,57,25,32
Follower,sargeras,1274,paladin,retribution,67,31,36
Hinataa,illidan,1273,paladin,retribution,45,24,21
Webothhateme,tichondrius,1272,paladin,retribution,30,17,13
Khorgus,gundrak,1271,paladin,retribution,54,27,27
Bulioevn,emerald-dream,1271,paladin,retribution,30,14,16
Giulio,moon-guard,1266,paladin,retribution,30,15,15
Formergf,crushridge,1265,paladin,retribution,60,29,31
Tonnerre,silvermoon,1263,paladin,retribution,61,29,32
Galaxahan,bonechewer,1262,paladin,retribution,64,30,34
Ajoladin,illidan,1262,paladin,retribution,42,16,26
Punative,darkspear,1262,paladin,retribution,48,16,32
Garruckadin,dalaran,1261,paladin,retribution,25,14,11
Suncrashkid,nerzhul,1260,paladin,retribution,55,37,18
Herrit,frostmourne,1260,paladin,retribution,72,40,32
Sïrenek,tichondrius,1260,paladin,retribution,55,27,28
Canadianeh,malganis,1260,paladin,retribution,66,28,38
Todesgott,tichondrius,1259,paladin,retribution,30,15,15
Xoxoxoxoxoxo,aegwynn,1259,paladin,retribution,30,14,16
Fogonaventa,nemesis,1259,paladin,retribution,48,16,32
Toyotasupra,azgalor,1258,paladin,retribution,42,24,18
Holyshôckz,stormrage,1258,paladin,retribution,35,16,19
Belena,jaedenar,1258,paladin,retribution,36,16,20
Minlarkwa,frostmourne,1257,paladin,retribution,30,16,14
Aretwin,dalaran,1255,paladin,retribution,30,14,16
Balster,moon-guard,1254,paladin,retribution,43,18,25
Ulessys,bleeding-hollow,1250,paladin,retribution,48,25,23
Dárí,stormrage,1250,paladin,retribution,90,42,48
Irantir,drakkari,1249,paladin,retribution,41,17,24
Zanthus,shadow-council,1248,paladin,retribution,24,13,11
Venturep,azralon,1247,paladin,retribution,24,13,11
Hojdin,tichondrius,1247,paladin,retribution,30,13,17
Davinchi,laughing-skull,1246,paladin,retribution,41,24,17
Beyönd,quelthalas,1246,paladin,retribution,30,13,17
Zephyrvalor,sargeras,1245,paladin,retribution,54,32,22
Pérona,tichondrius,1245,paladin,retribution,30,13,17
Yuccalicious,area-52,1245,paladin,retribution,41,16,25
Hijinxx,antonidas,1244,paladin,retribution,35,16,19
Redemptiøn,nemesis,1244,paladin,retribution,30,13,17
Goons,frostmourne,1244,paladin,retribution,36,13,23
Doktavius,lightbringer,1243,paladin,retribution,24,13,11
Tofuupal,tichondrius,1243,paladin,retribution,30,13,17
Gànnicus,korgath,1243,paladin,retribution,30,13,17
Deployed,kaelthas,1243,paladin,retribution,36,13,23
Tedward,emerald-dream,1242,paladin,retribution,24,13,11
Bebitufiufiu,illidan,1242,paladin,retribution,24,13,11
Vapanor,ragnaros,1241,paladin,retribution,30,13,17
Såssy,moon-guard,1240,paladin,retribution,48,18,30
Saintpower,stormscale,1239,paladin,retribution,24,13,11
Bawek,azralon,1239,paladin,retribution,36,13,23
Deftonia,stormrage,1238,paladin,retribution,65,31,34
Perfectgirl,maiev,1238,paladin,retribution,50,22,28
Rigotakp,illidan,1237,paladin,retribution,24,13,11
Siaaryn,darkspear,1237,paladin,retribution,30,13,17
Pristinne,darkspear,1237,paladin,retribution,82,34,48
Sconey,andorhal,1237,paladin,retribution,34,14,20
Hammerzite,whisperwind,1234,paladin,retribution,24,13,11
Krinkin,illidan,1233,paladin,retribution,36,13,23
Bapped,dalaran,1232,paladin,retribution,30,13,17
Nicret,tichondrius,1230,paladin,retribution,18,13,5
Saucepally,laughing-skull,1229,paladin,retribution,42,21,21
Arlanso,frostmourne,1229,paladin,retribution,34,14,20
Legible,tichondrius,1228,paladin,retribution,28,15,13
Lyricism,tichondrius,1227,paladin,retribution,24,13,11
Lüuz,area-52,1227,paladin,retribution,36,13,23
Thorsenâ,sargeras,1226,paladin,retribution,27,17,10
Hiikari,silver-hand,1225,paladin,retribution,30,14,16
Dankpaladin,frostwolf,1224,paladin,retribution,30,13,17
Amarith,queldorei,1224,paladin,retribution,76,31,45
Arnblass,magtheridon,1224,paladin,retribution,51,19,32
Soana,alexstrasza,1223,paladin,retribution,72,44,28
Vanthor,emerald-dream,1223,paladin,retribution,24,13,11
Albion,sargeras,1222,paladin,retribution,36,13,23
Füriøsa,quelthalas,1221,paladin,retribution,59,29,30
Kiergann,quelthalas,1221,paladin,retribution,48,18,30
Gorriuke,wyrmrest-accord,1220,paladin,retribution,24,13,11
Demihoj,illidan,1220,paladin,retribution,36,13,23
Naghret,area-52,1218,paladin,retribution,24,13,11
Beastyone,tichondrius,1218,paladin,retribution,110,58,52
Ablunedion,illidan,1218,paladin,retribution,30,13,17
Uglymugz,area-52,1218,paladin,retribution,37,16,21
Redeviliu,tichondrius,1217,paladin,retribution,41,15,26
Brucedwal,moon-guard,1216,paladin,retribution,45,22,23
Shusekki,drakkari,1216,paladin,retribution,54,26,28
Aellâ,bloodscalp,1214,paladin,retribution,134,70,64
Kalgormoth,ragnaros,1213,paladin,retribution,29,13,16
Drholypurp,tichondrius,1212,paladin,retribution,23,13,10
Brsjak,frostmourne,1212,paladin,retribution,41,18,23
Páláx,stormrage,1211,paladin,retribution,45,20,25
Serran,durotan,1210,paladin,retribution,36,13,23
Armstrongz,bleeding-hollow,1210,paladin,retribution,36,13,23
Melloow,azralon,1208,paladin,retribution,73,30,43
Huitz,drakkari,1207,paladin,retribution,42,19,23
Xenagos,akama,1207,paladin,retribution,30,13,17
Longinus,eredar,1206,paladin,retribution,24,13,11
Amgirlinv,malganis,1206,paladin,retribution,26,14,12
Clayban,stormrage,1204,paladin,retribution,24,13,11
Rediems,drakkari,1203,paladin,retribution,42,21,21
Sturka,illidan,1203,paladin,retribution,30,15,15
Noskill,moonrunner,1202,paladin,retribution,42,27,15
Hibrael,azralon,1201,paladin,retribution,56,32,24
Stõnêdpimp,agamaggan,1201,paladin,retribution,29,13,16
Cexus,tichondrius,1198,paladin,retribution,23,13,10
Oathden,area-52,1198,paladin,retribution,34,18,16
Finishearlyx,kelthuzad,1198,paladin,retribution,35,13,22
Lucigiorna,stormrage,1197,paladin,retribution,42,18,24
Statícx,ragnaros,1197,paladin,retribution,73,31,42
Spartus,area-52,1191,paladin,retribution,26,15,11
Avelane,caelestrasz,1191,paladin,retribution,52,24,28
Sathandrä,sargeras,1191,paladin,retribution,33,14,19
Dynamais,barthilas,1190,paladin,retribution,42,15,27
Popwingzz,sargeras,1188,paladin,retribution,42,14,28
Reptaur,bleeding-hollow,1185,paladin,retribution,64,31,33
Souljahgirl,demon-soul,1185,paladin,retribution,36,16,20
Holycower,tichondrius,1182,paladin,retribution,24,15,9
Thadose,bonechewer,1182,paladin,retribution,40,24,16
Sugnidrom,frostmourne,1179,paladin,retribution,28,13,15
Hokkan,quelthalas,1176,paladin,retribution,17,13,4
Schnabdain,exodar,1171,paladin,retribution,66,36,30
Dralkou,kaelthas,1171,paladin,retribution,44,14,30
Crosshammer,quelthalas,1170,paladin,retribution,42,20,22
Linias,quelthalas,1169,paladin,retribution,21,14,7
Drágons,stormrage,1167,paladin,retribution,66,29,37
Soopadupa,trollbane,1164,paladin,retribution,68,36,32
Ktwocrank,dalaran,1162,paladin,retribution,31,13,18
Draerys,drakkari,1159,paladin,retribution,36,26,10
Procs,hyjal,1157,paladin,retribution,20,15,5
Meanlight,zuljin,1156,paladin,retribution,60,30,30
Tearet,tichondrius,1152,paladin,retribution,18,12,6
Huavi,tichondrius,1152,paladin,retribution,18,12,6
Hammrekt,dalaran,1152,paladin,retribution,18,12,6
Ghøjan,malganis,1152,paladin,retribution,23,15,8
Scathol,tichondrius,1152,paladin,retribution,24,12,12
Vânguârds,tichondrius,1152,paladin,retribution,24,12,12
Galedance,tichondrius,1152,paladin,retribution,28,13,15
Xalø,ragnaros,1151,paladin,retribution,18,12,6
Cöjax,dalaran,1151,paladin,retribution,18,12,6
Iloveqiqi,sargeras,1151,paladin,retribution,24,12,12
Kuico,ragnaros,1151,paladin,retribution,24,12,12
Dragynfist,malganis,1151,paladin,retribution,30,12,18
Sukmyret,sargeras,1151,paladin,retribution,30,12,18
Geospawn,tichondrius,1151,paladin,retribution,30,12,18
Dayuanzhong,tichondrius,1151,paladin,retribution,32,12,20
Aiethyria,tichondrius,1150,paladin,retribution,18,12,6
Mmbakes,shadowsong,1150,paladin,retribution,18,12,6
Thirtyfivemm,area-52,1150,paladin,retribution,36,19,17
Milizi,zuljin,1150,paladin,retribution,24,12,12
Britanybich,area-52,1150,paladin,retribution,24,12,12
Supercharged,area-52,1150,paladin,retribution,24,12,12
Hurrîcane,illidan,1150,paladin,retribution,30,12,18
Nizzy,caelestrasz,1150,paladin,retribution,30,12,18
Plniss,tichondrius,1150,paladin,retribution,30,12,18
Jaikerino,emerald-dream,1150,paladin,retribution,30,12,18
Streetsaint,frostmourne,1149,paladin,retribution,54,27,27
Zcho,proudmoore,1149,paladin,retribution,24,12,12
Yeeter,thrall,1149,paladin,retribution,24,12,12
Retosterone,stormrage,1149,paladin,retribution,30,12,18
Kadryck,drakkari,1148,paladin,retribution,18,12,6
Leennoox,quelthalas,1148,paladin,retribution,31,17,14
Sigmond,azralon,1148,paladin,retribution,27,13,14
Bigdpally,frostmourne,1148,paladin,retribution,36,12,24
Arkoth,kelthuzad,1147,paladin,retribution,24,12,12
Snoogans,korgath,1147,paladin,retribution,30,12,18
Ödin,scarlet-crusade,1146,paladin,retribution,24,12,12
Barcar,area-52,1146,paladin,retribution,24,12,12
Røshea,hydraxis,1146,paladin,retribution,24,12,12
Véxv,emerald-dream,1146,paladin,retribution,36,12,24
Luminainre,zuljin,1145,paladin,retribution,24,12,12
Deosfires,ragnaros,1145,paladin,retribution,28,13,15
Xdiegox,stormrage,1145,paladin,retribution,30,12,18
Rafaela,alterac-mountains,1144,paladin,retribution,18,12,6
Atterz,azralon,1144,paladin,retribution,30,12,18
Lightshope,coilfang,1143,paladin,retribution,18,12,6
Thoti,tichondrius,1143,paladin,retribution,25,12,13
Scudstock,tichondrius,1143,paladin,retribution,71,34,37
Polypal,zuljin,1143,paladin,retribution,30,12,18
Seongje,tichondrius,1143,paladin,retribution,33,13,20
Stormwinter,azralon,1143,paladin,retribution,36,12,24
Ginbirdup,kelthuzad,1141,paladin,retribution,18,12,6
Smorezz,bonechewer,1141,paladin,retribution,18,12,6
Aowynd,tichondrius,1141,paladin,retribution,55,29,26
Elbigboy,tichondrius,1140,paladin,retribution,83,42,41
Kittylickers,tichondrius,1138,paladin,retribution,84,46,38
Victidin,quelthalas,1138,paladin,retribution,24,12,12
Oopalaoo,azralon,1137,paladin,retribution,24,12,12
Sophany,shattered-halls,1134,paladin,retribution,18,12,6
Jdn,ysera,1134,paladin,retribution,36,17,19
Pallyhealed,tichondrius,1134,paladin,retribution,27,12,15
Carliitoz,quelthalas,1132,paladin,retribution,43,14,29
Tatánka,ragnaros,1130,paladin,retribution,24,12,12
Arun,arthas,1128,paladin,retribution,33,15,18
Chbestafera,nemesis,1127,paladin,retribution,18,12,6
Faaqmee,gorefiend,1126,paladin,retribution,18,12,6
Pìerre,ragnaros,1126,paladin,retribution,86,42,44
Damorte,ragnaros,1125,paladin,retribution,30,15,15
Dirkadirkka,stormrage,1125,paladin,retribution,24,12,12
Sparkchaser,proudmoore,1125,paladin,retribution,24,12,12
Newerlight,tichondrius,1124,paladin,retribution,25,13,12
Grimhammer,the-scryers,1123,paladin,retribution,50,27,23
Canadapants,kelthuzad,1120,paladin,retribution,18,12,6
Zaklehblue,daggerspine,1118,paladin,retribution,60,24,36
Shadowarius,aerie-peak,1117,paladin,retribution,54,24,30
Deathwyz,thunderlord,1116,paladin,retribution,36,14,22
Thal,silvermoon,1113,paladin,retribution,24,13,11
Sandicang,azuremyst,1112,paladin,retribution,54,27,27
Quickthing,dalaran,1111,paladin,retribution,26,14,12
Willhookah,azralon,1111,paladin,retribution,30,16,14
Superzooted,sargeras,1111,paladin,retribution,28,12,16
Vanillur,tichondrius,1109,paladin,retribution,38,16,22
Drekgor,drakkari,1108,paladin,retribution,30,14,16
Uunjaaku,kiljaeden,1107,paladin,retribution,39,18,21
Greatgirthy,hyjal,1106,paladin,retribution,30,13,17
Fortueni,illidan,1103,paladin,retribution,88,51,37
Oraborra,area-52,1103,paladin,retribution,30,12,18
Decareos,tichondrius,1102,paladin,retribution,29,12,17
Trappadin,sargeras,1098,paladin,retribution,30,14,16
Riggar,uther,1098,paladin,retribution,42,18,24
Solomonss,frostmourne,1097,paladin,retribution,52,19,33
Joelanson,blood-furnace,1092,paladin,retribution,30,16,14
Omenix,laughing-skull,1091,paladin,retribution,29,12,17
Cheesetitan,tichondrius,1090,paladin,retribution,52,22,30
Billnighy,alleria,1089,paladin,retribution,30,14,16
Mcbraín,quelthalas,1089,paladin,retribution,30,12,18
Killumminati,tichondrius,1087,paladin,retribution,21,13,8
Slashnroses,tichondrius,1085,paladin,retribution,32,12,20
Avati,sargeras,1084,paladin,retribution,16,12,4
Merculios,stormrage,1083,paladin,retribution,22,12,10
Thaly,shadowmoon,1082,paladin,retribution,30,12,18
Orestis,stormrage,1079,paladin,retribution,23,12,11
Mechelle,thrall,1079,paladin,retribution,50,26,24
Jinfandi,gurubashi,1079,paladin,retribution,30,12,18
Bubblegums,nagrand,1078,paladin,retribution,63,36,27
Eliasor,illidan,1077,paladin,retribution,18,13,5
Zir,frostmourne,1077,paladin,retribution,41,21,20
Warswordz,stormrage,1077,paladin,retribution,40,16,24
Clefairy,arathor,1076,paladin,retribution,39,23,16
Holygerp,darrowmere,1060,paladin,retribution,18,12,6
Thanatiel,area-52,1060,paladin,retribution,33,19,14
Alairius,tichondrius,1059,paladin,retribution,17,13,4
Andras,emerald-dream,1059,paladin,retribution,22,12,10
Makayla,kiljaeden,1056,paladin,retribution,24,11,13
Shôtgun,tichondrius,1056,paladin,retribution,30,11,19
Hefaista,ragnaros,1056,paladin,retribution,30,11,19
Siq,arthas,1056,paladin,retribution,30,11,19
Auxilio,arathor,1056,paladin,retribution,30,11,19
Pathalerix,eonar,1055,paladin,retribution,18,11,7
Volcathos,moon-guard,1055,paladin,retribution,18,11,7
Ricocheto,ragnaros,1055,paladin,retribution,18,11,7
Subtilizer,tichondrius,1055,paladin,retribution,18,11,7
Reptila,bonechewer,1055,paladin,retribution,18,11,7
Redarted,thrall,1055,paladin,retribution,18,11,7
Clee,sargeras,1055,paladin,retribution,18,11,7
Yérn,barthilas,1055,paladin,retribution,24,11,13
Sandokhán,ragnaros,1055,paladin,retribution,24,11,13
Retsaíyan,tichondrius,1055,paladin,retribution,24,11,13
Pallysmack,stormrage,1055,paladin,retribution,24,11,13
Wde,zuljin,1055,paladin,retribution,31,12,19
Hrota,laughing-skull,1054,paladin,retribution,18,11,7
Gannecus,bleeding-hollow,1054,paladin,retribution,18,11,7
Keenos,frostmourne,1054,paladin,retribution,18,11,7
Pallyzo,zuljin,1054,paladin,retribution,24,11,13
Varaben,sargeras,1054,paladin,retribution,36,11,25
Sweetcandy,sargeras,1053,paladin,retribution,18,11,7
Nest,stormrage,1053,paladin,retribution,18,11,7
Sancthia,area-52,1053,paladin,retribution,24,11,13
Divineknight,moonrunner,1053,paladin,retribution,24,11,13
Cripplemakër,stormrage,1052,paladin,retribution,18,11,7
Neovincent,aggramar,1052,paladin,retribution,18,11,7
Vynesonia,emerald-dream,1052,paladin,retribution,21,12,9
Sniper,uther,1052,paladin,retribution,24,11,13
Brolando,hyjal,1052,paladin,retribution,24,11,13
Tuff,ysera,1051,paladin,retribution,18,14,4
Iesous,kiljaeden,1051,paladin,retribution,18,11,7
Ragnore,shadow-council,1051,paladin,retribution,21,12,9
Libertylol,tichondrius,1051,paladin,retribution,28,12,16
Caonizumu,area-52,1051,paladin,retribution,30,11,19
Ranthoril,hydraxis,1050,paladin,retribution,12,11,1
Autoattacker,mannoroth,1050,paladin,retribution,18,11,7
Kaélthas,eonar,1050,paladin,retribution,24,11,13
Cowhair,tichondrius,1050,paladin,retribution,24,11,13
Ødin,turalyon,1049,paladin,retribution,18,11,7
Wickedpälly,kelthuzad,1049,paladin,retribution,18,11,7
Wasimodo,emerald-dream,1049,paladin,retribution,60,29,31
Mangguo,tichondrius,1049,paladin,retribution,24,11,13
Unknownplay,tichondrius,1048,paladin,retribution,18,11,7
Lïgma,dalaran,1048,paladin,retribution,18,11,7
Exulta,illidan,1047,paladin,retribution,54,29,25
Stonekey,warsong,1046,paladin,retribution,18,11,7
Kiboko,tichondrius,1046,paladin,retribution,19,11,8
Theldart,ragnaros,1046,paladin,retribution,24,11,13
Simplesam,draenor,1046,paladin,retribution,30,11,19
Souiler,thunderlord,1045,paladin,retribution,22,12,10
Guji,jubeithos,1045,paladin,retribution,24,11,13
Søøka,azralon,1045,paladin,retribution,36,11,25
Xalixxa,wyrmrest-accord,1044,paladin,retribution,24,11,13
Strobeyjr,tichondrius,1044,paladin,retribution,24,11,13
Lostkanvas,azralon,1043,paladin,retribution,18,11,7
Alpine,nordrassil,1043,paladin,retribution,44,24,20
Rensvall,frostmourne,1043,paladin,retribution,24,13,11
Hyperforce,area-52,1043,paladin,retribution,24,11,13
Missoutale,aerie-peak,1043,paladin,retribution,76,31,45
Neutroo,stormrage,1039,paladin,retribution,24,11,13
Mikezheng,tichondrius,1039,paladin,retribution,30,11,19
Bayaz,emerald-dream,1038,paladin,retribution,18,11,7
Steelbreaker,deathwing,1038,paladin,retribution,24,11,13
Smithulu,kelthuzad,1034,paladin,retribution,26,16,10
Gramaton,malfurion,1034,paladin,retribution,30,11,19
Jeinova,barthilas,1033,paladin,retribution,30,20,10
Mortika,frostmourne,1033,paladin,retribution,30,14,16
Salvations,queldorei,1029,paladin,retribution,42,19,23
Anyatay,ragnaros,1027,paladin,retribution,47,13,34
Soledad,tichondrius,1024,paladin,retribution,24,11,13
Lejeñd,stormrage,1021,paladin,retribution,35,11,24
Furnost,drenden,1019,paladin,retribution,23,11,12
Meltedcheese,destromath,1018,paladin,retribution,24,11,13
Volorick,dalaran,1016,paladin,retribution,38,13,25
Sisterbubble,dathremar,1013,paladin,retribution,29,11,18
Avlystein,wyrmrest-accord,1013,paladin,retribution,71,24,47
Kènjii,sargeras,1009,paladin,retribution,34,16,18
Sanctum,barthilas,1008,paladin,retribution,135,65,70
Keu,emerald-dream,1008,paladin,retribution,63,26,37
Durothar,dalaran,1006,paladin,retribution,24,11,13
Savagefck,sargeras,999,paladin,retribution,18,11,7
Atreuss,moon-guard,996,paladin,retribution,24,12,12
Tyrswrath,sargeras,992,paladin,retribution,36,19,17
Iammj,skywall,990,paladin,retribution,17,11,6
Paim,tol-barad,990,paladin,retribution,26,11,15
Veroth,caelestrasz,988,paladin,retribution,26,11,15
Lêe,dalaran,987,paladin,retribution,15,12,3
Tharkeves,cenarius,987,paladin,retribution,22,11,11
Playandrunn,illidan,984,paladin,retribution,22,11,11
Bigjwpb,illidan,984,paladin,retribution,130,62,68
Cuthroat,area-52,982,paladin,retribution,121,60,61
Johnyfresh,jubeithos,977,paladin,retribution,33,12,21
Hammerhitter,lightbringer,972,paladin,retribution,36,14,22
Bainn,nerzhul,969,paladin,retribution,43,23,20
Kmackk,tichondrius,960,paladin,retribution,18,10,8
Meleegodx,darkspear,960,paladin,retribution,18,10,8
Cesah,tichondrius,960,paladin,retribution,18,10,8
Nattandin,ragnaros,960,paladin,retribution,18,10,8
Fumaçaa,nemesis,960,paladin,retribution,27,13,14
Miketavius,moon-guard,960,paladin,retribution,24,10,14
Komonai,illidan,960,paladin,retribution,24,10,14
Friendfriend,proudmoore,960,paladin,retribution,24,10,14
Bizaro,malganis,960,paladin,retribution,30,10,20
Kikazaru,moon-guard,960,paladin,retribution,30,10,20
Kasoon,illidan,959,paladin,retribution,12,10,2
Jaimi,stormreaver,959,paladin,retribution,12,10,2
Atair,antonidas,959,paladin,retribution,12,10,2
Chainsapally,stormrage,959,paladin,retribution,12,10,2
Darguen,ragnaros,959,paladin,retribution,16,11,5
ßöbby,sargeras,959,paladin,retribution,18,10,8
Chajaaro,ragnaros,959,paladin,retribution,18,10,8
Mundomaloo,quelthalas,959,paladin,retribution,18,10,8
Roddaric,nerzhul,959,paladin,retribution,18,10,8
Daeyang,tichondrius,959,paladin,retribution,18,10,8
Mesaa,illidan,959,paladin,retribution,18,10,8
Vaaga,quelthalas,959,paladin,retribution,18,10,8
Thebubbajay,illidan,959,paladin,retribution,18,10,8
Kayaman,tichondrius,959,paladin,retribution,18,10,8
Dividin,stormrage,959,paladin,retribution,18,10,8
Yugee,doomhammer,959,paladin,retribution,18,10,8
Dontaylor,tichondrius,959,paladin,retribution,24,10,14
Déathkiing,area-52,959,paladin,retribution,24,10,14
Lestaroth,goldrinn,959,paladin,retribution,30,10,20
Zensargge,tichondrius,959,paladin,retribution,36,10,26
Runö,frostmourne,959,paladin,retribution,37,10,27
Eustace,thunderhorn,958,paladin,retribution,18,10,8
Pugnosano,black-dragonflight,958,paladin,retribution,18,10,8
Nuggetpusher,thunderlord,958,paladin,retribution,21,10,11
Cryptdog,illidan,958,paladin,retribution,21,10,11
Evilmerdoc,kelthuzad,958,paladin,retribution,24,10,14
Skilladin,zuljin,958,paladin,retribution,24,10,14
Ssparkk,stormrage,958,paladin,retribution,24,10,14
Umbrasanctus,daggerspine,958,paladin,retribution,24,10,14
Tåine,suramar,958,paladin,retribution,30,10,20
Verdicts,moon-guard,958,paladin,retribution,30,10,20
Vallahad,emerald-dream,957,paladin,retribution,18,10,8
Grünt,ragnaros,957,paladin,retribution,18,10,8
Luxord,ysera,957,paladin,retribution,22,11,11
Esçanór,darkspear,957,paladin,retribution,24,10,14
Uxd,tichondrius,957,paladin,retribution,24,10,14
Angriel,azralon,957,paladin,retribution,24,10,14
Againstfilet,azralon,957,paladin,retribution,36,10,26
Vulkaros,azralon,956,paladin,retribution,12,10,2
Caylorn,illidan,956,paladin,retribution,18,10,8
Antarcticala,frostmourne,956,paladin,retribution,24,10,14
Temote,anvilmar,956,paladin,retribution,24,10,14
Vejita,frostmourne,955,paladin,retribution,18,10,8
Heälmeñow,tichondrius,955,paladin,retribution,24,10,14
Winbott,sargeras,955,paladin,retribution,30,10,20
Emethala,windrunner,954,paladin,retribution,18,10,8
Puresight,kelthuzad,954,paladin,retribution,18,10,8
Cacaine,goldrinn,954,paladin,retribution,21,11,10
Sòl,stormrage,954,paladin,retribution,24,10,14
Didymus,boulderfist,954,paladin,retribution,41,17,24
Justsmiteit,dalaran,953,paladin,retribution,18,10,8
Azëitona,azralon,952,paladin,retribution,18,10,8
Giltronix,thrall,952,paladin,retribution,18,10,8
Exeneyder,elune,952,paladin,retribution,25,10,15
Äeriah,fizzcrank,950,paladin,retribution,24,10,14
ßlððdyßðnez,malganis,949,paladin,retribution,18,10,8
Lashlan,barthilas,946,paladin,retribution,20,10,10
Xhotbutters,korgath,945,paladin,retribution,31,13,18
Gwendolyynn,moon-guard,944,paladin,retribution,16,11,5
Luke,frostwolf,943,paladin,retribution,23,10,13
Ekyu,sargeras,942,paladin,retribution,19,12,7
Thørîm,nazjatar,941,paladin,retribution,24,10,14
Diablosgrim,stormrage,939,paladin,retribution,12,10,2
Zentrick,whisperwind,929,paladin,retribution,36,14,22
Nerfret,zuljin,926,paladin,retribution,14,11,3
Reti,ursin,925,paladin,retribution,107,54,53
Bradoxx,thorium-brotherhood,924,paladin,retribution,24,11,13
Mehchelol,azgalor,923,paladin,retribution,24,14,10
Galanblack,dalaran,923,paladin,retribution,32,13,19
Diësëlsmoke,bronzebeard,917,paladin,retribution,18,10,8
Toepuller,doomhammer,917,paladin,retribution,30,15,15
Goldranger,hakkar,916,paladin,retribution,42,22,20
Kokuryuha,quelthalas,916,paladin,retribution,46,21,25
Sosalo,sargeras,912,paladin,retribution,39,15,24
Rönän,sargeras,911,paladin,retribution,17,10,7
Rebukezz,dalaran,911,paladin,retribution,23,10,13
Allixis,wyrmrest-accord,910,paladin,retribution,29,10,19
Drtom,mannoroth,908,paladin,retribution,21,10,11
Loween,thunderlord,906,paladin,retribution,30,10,20
Lilsquirt,proudmoore,901,paladin,retribution,23,14,9
Luret,tichondrius,896,paladin,retribution,22,10,12
Denthor,lightbringer,894,paladin,retribution,20,10,10
Biggin,garona,867,paladin,retribution,72,18,54
Arimae,turalyon,864,paladin,retribution,12,9,3
Taeret,tichondrius,864,paladin,retribution,12,9,3
Raggnarokk,kelthuzad,864,paladin,retribution,12,9,3
Naughtygames,area-52,864,paladin,retribution,12,9,3
Chrigpal,tichondrius,864,paladin,retribution,12,9,3
Slivkoff,wyrmrest-accord,864,paladin,retribution,12,9,3
Warstompgg,ragnaros,864,paladin,retribution,12,9,3
Kaetix,frostmourne,864,paladin,retribution,12,9,3
Wölfheärt,tichondrius,864,paladin,retribution,12,9,3
Pallyseeker,thrall,864,paladin,retribution,12,9,3
Emiaru,illidan,864,paladin,retribution,16,10,6
Brohtato,area-52,864,paladin,retribution,18,9,9
Gude,sargeras,864,paladin,retribution,18,9,9
Wogyu,area-52,864,paladin,retribution,18,9,9
Syreqt,nemesis,864,paladin,retribution,18,9,9
Xiddin,frostmourne,864,paladin,retribution,18,9,9
Beefdaddyx,tichondrius,864,paladin,retribution,18,9,9
Hardnow,emerald-dream,864,paladin,retribution,18,9,9
Bigdixss,tichondrius,864,paladin,retribution,18,9,9
Thebless,tichondrius,864,paladin,retribution,18,9,9
Axeliee,kiljaeden,864,paladin,retribution,18,9,9
Rockdeath,sargeras,864,paladin,retribution,18,9,9
Héber,nemesis,864,paladin,retribution,18,9,9
Huuzhaa,tichondrius,864,paladin,retribution,18,9,9
Kishou,stormrage,864,paladin,retribution,21,10,11
Diebygcd,tichondrius,864,paladin,retribution,19,9,10
Yáhtzee,tichondrius,864,paladin,retribution,22,10,12
Justeight,stormrage,864,paladin,retribution,21,9,12
Traevel,moon-guard,864,paladin,retribution,24,9,15
Pistis,kelthuzad,864,paladin,retribution,24,9,15
Shakalot,illidan,864,paladin,retribution,24,9,15
Gabbynator,emerald-dream,864,paladin,retribution,24,9,15
Stoof,arygos,864,paladin,retribution,24,9,15
Saintgeórge,frostmourne,864,paladin,retribution,25,9,16
Mightythorxx,tichondrius,863,paladin,retribution,12,9,3
Pallyofhell,area-52,863,paladin,retribution,12,9,3
Heathen,spirestone,863,paladin,retribution,12,9,3
Inquisídor,nemesis,863,paladin,retribution,12,9,3
Jhaann,tichondrius,863,paladin,retribution,18,9,9
Loraven,wyrmrest-accord,863,paladin,retribution,18,9,9
Enril,azgalor,863,paladin,retribution,18,9,9
Paliwarrior,illidan,863,paladin,retribution,18,9,9
Heizero,area-52,863,paladin,retribution,18,9,9
Tarnyb,illidan,863,paladin,retribution,18,9,9
Avacii,illidan,863,paladin,retribution,18,9,9
Øðyn,sargeras,863,paladin,retribution,18,9,9
Blasstar,quelthalas,863,paladin,retribution,18,9,9
Teewrecks,frostmourne,863,paladin,retribution,18,9,9
Articilia,ragnaros,863,paladin,retribution,18,9,9
Thickdam,korgath,863,paladin,retribution,24,9,15
Oppression,kul-tiras,863,paladin,retribution,24,9,15
Galadriele,zuljin,863,paladin,retribution,24,9,15
Derigoth,quelthalas,863,paladin,retribution,24,9,15
Rivzx,tichondrius,863,paladin,retribution,24,9,15
Detrimentãl,nagrand,863,paladin,retribution,24,9,15
Zerohöur,emerald-dream,863,paladin,retribution,30,9,21
Ástedór,ragnaros,862,paladin,retribution,12,9,3
Salaminhoo,azralon,862,paladin,retribution,12,9,3
Badboí,azralon,862,paladin,retribution,12,9,3
Pinelli,aegwynn,862,paladin,retribution,18,9,9
Albagail,draka,862,paladin,retribution,18,9,9
Schalpy,illidan,862,paladin,retribution,18,9,9
Kelthálas,illidan,862,paladin,retribution,24,9,15
Velarelan,moon-guard,862,paladin,retribution,24,9,15
Restitution,area-52,862,paladin,retribution,24,9,15
Holyskeeter,thunderhorn,862,paladin,retribution,25,9,16
Stevas,khazgoroth,861,paladin,retribution,12,9,3
Borélock,kelthuzad,861,paladin,retribution,18,9,9
Rennalux,stormrage,861,paladin,retribution,24,9,15
Aeroßlaze,dragonmaw,860,paladin,retribution,18,9,9
Cyäbyë,frostmourne,860,paladin,retribution,18,9,9
Emmastoned,bleeding-hollow,860,paladin,retribution,24,9,15
Khetzi,thunderhorn,859,paladin,retribution,18,9,9
Layonthis,the-venture-co,859,paladin,retribution,18,9,9
Derethen,emerald-dream,858,paladin,retribution,18,9,9
Alysca,tichondrius,858,paladin,retribution,18,9,9
Irongiant,grizzly-hills,858,paladin,retribution,18,9,9
Dannoruk,ragnaros,858,paladin,retribution,24,9,15
Vick,zuljin,857,paladin,retribution,12,9,3
Holyzeen,darkspear,857,paladin,retribution,17,11,6
Alerz,moon-guard,857,paladin,retribution,15,9,6
Hellhawk,hellscream,856,paladin,retribution,18,9,9
Morddrohung,hyjal,855,paladin,retribution,12,9,3
Adelsman,quelthalas,853,paladin,retribution,18,9,9
Agonyss,quelthalas,853,paladin,retribution,18,9,9
Goldfînger,zuljin,853,paladin,retribution,24,9,15
Mybadfoo,lethon,850,paladin,retribution,12,9,3
Pallydin,smolderthorn,849,paladin,retribution,18,9,9
Leyon,alterac-mountains,847,paladin,retribution,18,9,9
Sycomaniac,illidan,846,paladin,retribution,23,9,14
Morthalos,moon-guard,845,paladin,retribution,23,9,14
Hotdgwatr,bleeding-hollow,843,paladin,retribution,24,10,14
Avaheal,dragonmaw,842,paladin,retribution,23,9,14
Pickypally,moon-guard,835,paladin,retribution,18,9,9
Brioc,tichondrius,832,paladin,retribution,22,9,13
Blulux,ragnaros,829,paladin,retribution,20,10,10
Thorviim,azralon,823,paladin,retribution,23,9,14
Fiate,azralon,815,paladin,retribution,23,9,14
Cozzey,amanthul,810,paladin,retribution,17,9,8
Theboxx,frostmourne,810,paladin,retribution,28,11,17
Ðetroity,stormrage,800,paladin,retribution,21,10,11
Lizzyz,illidan,799,paladin,retribution,20,9,11
Witewolf,illidan,798,paladin,retribution,19,10,9
Erós,azralon,798,paladin,retribution,22,9,13
Layoya,aerie-peak,797,paladin,retribution,16,9,7
Lightfdre,rexxar,797,paladin,retribution,33,11,22
Jdisco,bonechewer,782,paladin,retribution,19,9,10
Noholy,nemesis,777,paladin,retribution,31,10,21
Deltajk,drakkari,771,paladin,retribution,24,9,15
Rendyrend,frostmourne,768,paladin,retribution,12,8,4
Djangø,azuremyst,768,paladin,retribution,12,8,4
Unicornslayr,antonidas,768,paladin,retribution,12,8,4
Takinvcards,area-52,768,paladin,retribution,12,8,4
Dasp,nagrand,768,paladin,retribution,12,8,4
Swellows,tichondrius,768,paladin,retribution,12,8,4
Arellis,barthilas,768,paladin,retribution,12,8,4
Hatchet,skullcrusher,768,paladin,retribution,12,8,4
Nornix,fenris,768,paladin,retribution,12,8,4
Mortalbeef,zuljin,768,paladin,retribution,12,8,4
Rikkupìgu,sargeras,768,paladin,retribution,12,8,4
Tolliver,area-52,768,paladin,retribution,12,8,4
Bubblless,thrall,768,paladin,retribution,12,8,4
Eskynor,sargeras,768,paladin,retribution,12,8,4
Soymilkdrnka,sargeras,768,paladin,retribution,12,8,4
Céllash,tichondrius,768,paladin,retribution,12,8,4
Franckz,ragnaros,768,paladin,retribution,12,8,4
Laboøn,stormrage,768,paladin,retribution,12,8,4
Tanishalfelf,stormrage,768,paladin,retribution,12,8,4
Schmïtty,tichondrius,768,paladin,retribution,12,8,4
Cutebtw,zuljin,768,paladin,retribution,16,9,7
Grimreaperx,azralon,768,paladin,retribution,17,8,9
Roshord,quelthalas,768,paladin,retribution,18,8,10
Gatzu,tichondrius,768,paladin,retribution,18,8,10
Jebpal,tichondrius,768,paladin,retribution,18,8,10
Hôtt,kul-tiras,768,paladin,retribution,18,8,10
Bubbletaunt,frostmourne,768,paladin,retribution,18,8,10
Aurken,ragnaros,768,paladin,retribution,18,8,10
Jachugz,tichondrius,768,paladin,retribution,18,8,10
Hamerfall,tichondrius,768,paladin,retribution,18,8,10
Tævèn,tichondrius,768,paladin,retribution,18,8,10
Jakkatähn,malganis,768,paladin,retribution,18,8,10
Daion,quelthalas,768,paladin,retribution,18,8,10
Auranove,azralon,768,paladin,retribution,18,8,10
Ponytail,dark-iron,768,paladin,retribution,18,8,10
Dynamism,frostmourne,768,paladin,retribution,18,8,10
Cammack,thrall,768,paladin,retribution,18,8,10
Duhvine,malganis,768,paladin,retribution,18,8,10
Gorostas,kelthuzad,768,paladin,retribution,18,8,10
Torosagrado,drakkari,768,paladin,retribution,18,8,10
Vanquishy,burning-legion,768,paladin,retribution,18,8,10
Mattilla,tichondrius,768,paladin,retribution,18,8,10
Blackpie,bleeding-hollow,768,paladin,retribution,18,8,10
Nozfferatu,drakkari,768,paladin,retribution,18,8,10
Dogf,tichondrius,768,paladin,retribution,23,8,15
Vibránium,tichondrius,768,paladin,retribution,24,8,16
Zoliz,tichondrius,768,paladin,retribution,24,8,16
Fây,sargeras,768,paladin,retribution,24,8,16
Bubbleblade,burning-blade,768,paladin,retribution,24,8,16
Healsonyou,windrunner,768,paladin,retribution,24,8,16
Galess,tichondrius,768,paladin,retribution,24,8,16
Isayas,tichondrius,768,paladin,retribution,24,8,16
Adamantïum,azralon,768,paladin,retribution,24,8,16
Rexpeitaboot,azralon,768,paladin,retribution,24,8,16
Roundhere,area-52,768,paladin,retribution,30,8,22
Garethorne,illidan,768,paladin,retribution,30,8,22
Theholysword,tichondrius,768,paladin,retribution,30,8,22
Keit,moon-guard,767,paladin,retribution,12,8,4
Greybrox,barthilas,767,paladin,retribution,12,8,4
Mægenta,tichondrius,767,paladin,retribution,12,8,4
Imhardirl,area-52,767,paladin,retribution,12,8,4
Lunchboxpaly,stormrage,767,paladin,retribution,12,8,4
Vassen,echo-isles,767,paladin,retribution,12,8,4
Smitetheweak,rivendare,767,paladin,retribution,12,8,4
Kaladini,jubeithos,767,paladin,retribution,12,8,4
Lidranas,sargeras,767,paladin,retribution,12,8,4
Dachenkov,tichondrius,767,paladin,retribution,12,8,4
Beachyo,tichondrius,767,paladin,retribution,12,8,4
Husurdaddy,dalaran,767,paladin,retribution,12,8,4
Andallar,nordrassil,767,paladin,retribution,12,8,4
Hqknight,moon-guard,767,paladin,retribution,12,8,4
Porterhousee,bleeding-hollow,767,paladin,retribution,13,8,5
Amlovích,quelthalas,767,paladin,retribution,18,8,10
Ashess,sargeras,767,paladin,retribution,18,8,10
Virtuosi,area-52,767,paladin,retribution,18,8,10
Hughkane,tichondrius,767,paladin,retribution,18,8,10
Bruhstice,area-52,767,paladin,retribution,18,8,10
Stroods,stormrage,767,paladin,retribution,18,8,10
Ironcoco,ragnaros,767,paladin,retribution,18,8,10
Dontsleep,magtheridon,767,paladin,retribution,18,8,10
Nightfallz,farstriders,767,paladin,retribution,18,8,10
Buddyolpally,proudmoore,767,paladin,retribution,18,8,10
Sermon,moon-guard,767,paladin,retribution,18,8,10
Doobiehigh,proudmoore,767,paladin,retribution,18,8,10
Nutsmashèr,illidan,767,paladin,retribution,18,8,10
Phanna,the-forgotten-coast,767,paladin,retribution,18,8,10
Nooplug,illidan,767,paladin,retribution,18,8,10
Releváncé,barthilas,767,paladin,retribution,18,8,10
Pallynation,korgath,767,paladin,retribution,18,8,10
Saifollah,area-52,767,paladin,retribution,30,8,22
Dorzwaz,draka,766,paladin,retribution,12,8,4
Deesqueezie,area-52,766,paladin,retribution,12,8,4
Passion,wyrmrest-accord,766,paladin,retribution,12,8,4
Lainn,zuljin,766,paladin,retribution,12,8,4
Dresdén,skullcrusher,766,paladin,retribution,12,8,4
Otorten,bladefist,766,paladin,retribution,12,8,4
Kylarha,stormrage,766,paladin,retribution,12,8,4
Chippo,aegwynn,766,paladin,retribution,18,8,10
Hanael,quelthalas,766,paladin,retribution,19,8,11
Torvus,bonechewer,766,paladin,retribution,22,9,13
Holyfilers,thunderlord,766,paladin,retribution,24,8,16
Gírthbrooks,hyjal,765,paladin,retribution,12,8,4
Kristary,ragnaros,765,paladin,retribution,12,8,4
Nikinaki,stormrage,765,paladin,retribution,12,8,4
Mothh,terokkar,765,paladin,retribution,12,8,4
Cederas,sargeras,765,paladin,retribution,12,8,4
Gigadorff,stormrage,765,paladin,retribution,18,8,10
Ichigò,sargeras,765,paladin,retribution,18,8,10
Butchur,area-52,765,paladin,retribution,30,8,22
Xanamun,magtheridon,764,paladin,retribution,18,8,10
Iceburg,shadowmoon,764,paladin,retribution,18,8,10
Yenkmeilleur,zuljin,763,paladin,retribution,12,8,4
Guccii,quelthalas,763,paladin,retribution,18,8,10
Deathblazer,blades-edge,763,paladin,retribution,18,8,10
Jebadia,proudmoore,762,paladin,retribution,12,8,4
Gys,ragnaros,762,paladin,retribution,18,8,10
Unicochori,drakkari,762,paladin,retribution,18,8,10
Flisk,garona,761,paladin,retribution,12,8,4
Eldirn,bleeding-hollow,761,paladin,retribution,12,8,4
Lucifuge,twisting-nether,760,paladin,retribution,12,8,4
Darkknes,quelthalas,760,paladin,retribution,18,8,10
Mandragor,borean-tundra,759,paladin,retribution,12,8,4
Eetswaz,frostmourne,759,paladin,retribution,18,9,9
Aladid,aggramar,758,paladin,retribution,12,8,4
Populate,tichondrius,752,paladin,retribution,12,8,4
Cleavix,tichondrius,751,paladin,retribution,35,8,27
Oogablah,wyrmrest-accord,749,paladin,retribution,12,8,4
Maelie,shadowmoon,749,paladin,retribution,12,8,4
Yulasa,area-52,735,paladin,retribution,14,9,5
Tonimâster,misha,735,paladin,retribution,17,8,9
Hekki,ragnaros,735,paladin,retribution,19,8,11
Són,ragnaros,735,paladin,retribution,23,8,15
Whisk,tichondrius,720,paladin,retribution,15,8,7
Mádz,ragnaros,718,paladin,retribution,17,8,9
Mareaaturbo,azralon,716,paladin,retribution,17,8,9
Lilbursty,tichondrius,714,paladin,retribution,19,9,10
Andorsi,elune,714,paladin,retribution,21,9,12
Pantheeon,altar-of-storms,713,paladin,retribution,30,9,21
Connextion,terenas,704,paladin,retribution,16,8,8
Palavittar,azralon,702,paladin,retribution,14,8,6
Wadalee,tichondrius,702,paladin,retribution,26,8,18
Palaðu,azralon,700,paladin,retribution,14,8,6
Àmárìs,tichondrius,700,paladin,retribution,16,8,8
Turtlehoof,thrall,684,paladin,retribution,19,8,11
Meridional,tichondrius,672,paladin,retribution,12,7,5
Dabbicus,tichondrius,672,paladin,retribution,12,7,5
Shadoweelite,sargeras,672,paladin,retribution,12,7,5
Unitiss,velen,672,paladin,retribution,12,7,5
Vozy,bronzebeard,672,paladin,retribution,12,7,5
Fakesimp,illidan,672,paladin,retribution,12,7,5
Ròwdy,area-52,672,paladin,retribution,12,7,5
Wèbb,burning-legion,672,paladin,retribution,12,7,5
Greatwyrm,illidan,672,paladin,retribution,12,7,5
Paltarrd,bleeding-hollow,672,paladin,retribution,12,7,5
Bighoochie,moon-guard,672,paladin,retribution,12,7,5
Qsx,bleeding-hollow,672,paladin,retribution,12,7,5
Armstrong,azralon,672,paladin,retribution,12,7,5
Turner,skullcrusher,672,paladin,retribution,12,7,5
Zaxxous,hyjal,672,paladin,retribution,12,7,5
Pandoro,tichondrius,672,paladin,retribution,12,7,5
Holreshee,tichondrius,672,paladin,retribution,12,7,5
Trejetë,tichondrius,672,paladin,retribution,12,7,5
Greasy,quelthalas,672,paladin,retribution,12,7,5
Aurðra,kiljaeden,672,paladin,retribution,12,7,5
Âllmíght,quelthalas,672,paladin,retribution,12,7,5
Mes,dragonmaw,672,paladin,retribution,12,7,5
Araguaney,bleeding-hollow,672,paladin,retribution,12,7,5
Chäinswellx,area-52,672,paladin,retribution,12,7,5
Lightballz,vashj,672,paladin,retribution,12,7,5
Pals,bronzebeard,672,paladin,retribution,12,7,5
Sathras,madoran,672,paladin,retribution,12,7,5
Bomdia,stormrage,672,paladin,retribution,12,7,5
Mikâel,cairne,672,paladin,retribution,12,7,5
Cathode,area-52,672,paladin,retribution,12,7,5
Nosferätu,illidan,672,paladin,retribution,12,7,5
Holycar,illidan,672,paladin,retribution,12,7,5
Zözo,zuljin,672,paladin,retribution,12,7,5
Bootyfùnk,tichondrius,672,paladin,retribution,12,7,5
Steelemantle,moon-guard,672,paladin,retribution,12,7,5
Kanaki,gilneas,672,paladin,retribution,12,7,5
Noitra,azralon,672,paladin,retribution,12,7,5
Montyer,ragnaros,672,paladin,retribution,12,7,5
Theehopper,shandris,672,paladin,retribution,12,7,5
Furdaddylant,drenden,672,paladin,retribution,12,7,5
Gattís,stormrage,672,paladin,retribution,12,7,5
Ceyh,ragnaros,672,paladin,retribution,12,7,5
Merkzz,arthas,672,paladin,retribution,12,7,5
Hèlfar,wyrmrest-accord,672,paladin,retribution,12,7,5
Montecrîsto,area-52,672,paladin,retribution,12,7,5
Iloveket,blackrock,672,paladin,retribution,12,7,5
Steezyret,barthilas,672,paladin,retribution,12,7,5
Thazadin,barthilas,672,paladin,retribution,16,8,8
Lhacius,drakkari,672,paladin,retribution,16,8,8
Ðreschí,ragnaros,672,paladin,retribution,16,7,9
Teamamerica,proudmoore,672,paladin,retribution,18,7,11
Orin,guldan,672,paladin,retribution,18,7,11
Cuteluna,tichondrius,672,paladin,retribution,18,7,11
Uoenò,moon-guard,672,paladin,retribution,18,7,11
Neverwogx,kirin-tor,672,paladin,retribution,18,7,11
Shoresy,terokkar,672,paladin,retribution,18,7,11
Nocomus,andorhal,672,paladin,retribution,18,7,11
Trfreedomz,frostmourne,672,paladin,retribution,18,7,11
Moistbible,kelthuzad,672,paladin,retribution,18,7,11
Kipow,proudmoore,672,paladin,retribution,18,7,11
Aledin,frostmourne,672,paladin,retribution,18,7,11
Covidin,quelthalas,672,paladin,retribution,18,7,11
Aldhebarán,ragnaros,672,paladin,retribution,18,7,11
Fossilz,sargeras,672,paladin,retribution,18,7,11
Eurthswrath,lightbringer,672,paladin,retribution,18,7,11
Kloud,sargeras,672,paladin,retribution,18,7,11
Gummybearz,doomhammer,672,paladin,retribution,18,7,11
Manryux,tichondrius,672,paladin,retribution,18,7,11
Pâpito,drakkari,672,paladin,retribution,18,7,11
Amntir,sargeras,672,paladin,retribution,18,7,11
Fokatayew,korialstrasz,672,paladin,retribution,18,7,11
Loyality,sargeras,672,paladin,retribution,18,7,11
Anjocaído,nemesis,672,paladin,retribution,18,7,11
Xvetis,thrall,672,paladin,retribution,18,7,11
Bdaws,tichondrius,672,paladin,retribution,18,7,11
Hølyshyt,tichondrius,672,paladin,retribution,18,7,11
Ziti,bonechewer,672,paladin,retribution,18,7,11
Geospawn,bleeding-hollow,672,paladin,retribution,18,7,11
Weike,barthilas,672,paladin,retribution,18,7,11
Hakson,stormrage,672,paladin,retribution,18,7,11
Édzor,area-52,672,paladin,retribution,18,7,11
Hulfsark,stormrage,672,paladin,retribution,18,7,11
Tothegravetv,illidan,672,paladin,retribution,18,7,11
Cliftôn,illidan,672,paladin,retribution,18,7,11
Palaxoto,nemesis,672,paladin,retribution,21,8,13
Kamí,elune,672,paladin,retribution,21,7,14
Kaupe,barthilas,672,paladin,retribution,23,7,16
Zazaron,kiljaeden,672,paladin,retribution,24,7,17
Ledster,kelthuzad,672,paladin,retribution,24,7,17
Goozlight,area-52,672,paladin,retribution,24,7,17
Kyuubî,bloodhoof,672,paladin,retribution,24,7,17
Digider,area-52,672,paladin,retribution,24,7,17
Hayden,stormscale,672,paladin,retribution,24,7,17
Goldmembër,malganis,672,paladin,retribution,24,7,17
Haimdallr,azralon,672,paladin,retribution,24,7,17
Thantore,scilla,672,paladin,retribution,24,7,17
Ganan,frostmane,672,paladin,retribution,24,7,17
Cyanss,ragnaros,672,paladin,retribution,24,7,17
Palabeshar,area-52,672,paladin,retribution,30,7,23
Cryof,illidan,672,paladin,retribution,30,7,23
Nume,nesingwary,672,paladin,retribution,30,7,23
Mhelyssa,goldrinn,671,paladin,retribution,12,7,5
Easiestcomp,sargeras,671,paladin,retribution,12,7,5
Dabnpaladin,kelthuzad,671,paladin,retribution,12,7,5
Shadd,destromath,671,paladin,retribution,12,7,5
Jaybbers,malganis,671,paladin,retribution,12,7,5
Ðrêâð,kirin-tor,671,paladin,retribution,12,7,5
Crematória,azralon,671,paladin,retribution,12,7,5
Miitt,blackrock,671,paladin,retribution,12,7,5
Zerofans,ragnaros,671,paladin,retribution,12,7,5
Darawin,korgath,671,paladin,retribution,12,7,5
Torujo,drakkari,671,paladin,retribution,12,7,5
Prophesied,zuljin,671,paladin,retribution,12,7,5
Thorean,sargeras,671,paladin,retribution,12,7,5
Koohny,stormrage,671,paladin,retribution,12,7,5
Tonytoi,aegwynn,671,paladin,retribution,12,7,5
Talvyr,icecrown,671,paladin,retribution,12,7,5
Lystia,malfurion,671,paladin,retribution,12,7,5
Elemezs,tichondrius,671,paladin,retribution,12,7,5
Ironpaladin,sargeras,671,paladin,retribution,12,7,5
Smuglý,wyrmrest-accord,671,paladin,retribution,12,7,5
Holyretribut,tichondrius,671,paladin,retribution,12,7,5
Tanesdeline,area-52,671,paladin,retribution,12,7,5
Darktank,malganis,671,paladin,retribution,12,7,5
Jåy,nazjatar,671,paladin,retribution,12,7,5
Showfet,dalaran,671,paladin,retribution,16,8,8
Auriol,azshara,671,paladin,retribution,14,7,7
Ziberax,chogall,671,paladin,retribution,16,7,9
Royalfather,tichondrius,671,paladin,retribution,16,7,9
Babyshuangs,illidan,671,paladin,retribution,18,7,11
Tyelca,zuljin,671,paladin,retribution,18,7,11
Sona,jubeithos,671,paladin,retribution,18,7,11
Vaelicus,emerald-dream,671,paladin,retribution,18,7,11
Kaidoz,aegwynn,671,paladin,retribution,18,7,11
Valtariel,wyrmrest-accord,671,paladin,retribution,18,7,11
Dannyram,zuljin,671,paladin,retribution,18,7,11
Giorgyos,ragnaros,671,paladin,retribution,18,7,11
Blaeng,shandris,671,paladin,retribution,18,7,11
Misskilljoy,proudmoore,671,paladin,retribution,18,7,11
Madalynn,quelthalas,671,paladin,retribution,18,7,11
Golozzakum,tichondrius,671,paladin,retribution,18,7,11
Ane,gorefiend,671,paladin,retribution,18,7,11
Sozmsjackson,barthilas,671,paladin,retribution,21,8,13
Doraléous,illidan,671,paladin,retribution,24,7,17
Aduhrawl,moon-guard,671,paladin,retribution,24,7,17
Asunima,wyrmrest-accord,670,paladin,retribution,12,7,5
Vlandor,area-52,670,paladin,retribution,12,7,5
Hanno,azshara,670,paladin,retribution,12,7,5
Holychach,tichondrius,670,paladin,retribution,12,7,5
Itsapoc,sargeras,670,paladin,retribution,12,7,5
Lvlone,sargeras,670,paladin,retribution,12,7,5
Riek,sargeras,670,paladin,retribution,16,8,8
Augus,arygos,670,paladin,retribution,18,7,11
Rampetos,mannoroth,670,paladin,retribution,18,7,11
Jorgevercilo,azralon,670,paladin,retribution,18,7,11
Tpane,kelthuzad,670,paladin,retribution,18,7,11
Areura,hellscream,669,paladin,retribution,12,7,5
Terroll,bonechewer,669,paladin,retribution,13,7,6
Vargonha,azralon,669,paladin,retribution,18,9,9
Denstain,kul-tiras,669,paladin,retribution,18,7,11
Sîegfried,moon-guard,669,paladin,retribution,18,7,11
Salvø,tichondrius,669,paladin,retribution,24,7,17
Sponce,kirin-tor,669,paladin,retribution,30,7,23
Marshman,kelthuzad,668,paladin,retribution,12,7,5
Retgasm,drakthul,668,paladin,retribution,12,7,5
Holyrõller,malganis,668,paladin,retribution,18,7,11
Bennygee,moonrunner,668,paladin,retribution,24,7,17
Eddardstark,agamaggan,667,paladin,retribution,16,8,8
Mandow,tichondrius,667,paladin,retribution,22,8,14
Imsoosmall,sargeras,666,paladin,retribution,12,7,5
Calmador,proudmoore,666,paladin,retribution,12,7,5
Toogud,moon-guard,666,paladin,retribution,21,8,13
Jonnywick,duskwood,665,paladin,retribution,12,7,5
Chaosbubble,burning-legion,665,paladin,retribution,18,7,11
Palgiga,tichondrius,664,paladin,retribution,12,7,5
Dweezill,daggerspine,664,paladin,retribution,18,7,11
Tectorr,proudmoore,661,paladin,retribution,12,7,5
Nicepally,moon-guard,657,paladin,retribution,18,7,11
Pathed,aerie-peak,655,paladin,retribution,17,7,10
Palliful,runetotem,651,paladin,retribution,18,7,11
Superpaladin,stormrage,639,paladin,retribution,17,7,10
Epòc,frostmourne,639,paladin,retribution,20,8,12
Quotation,silvermoon,638,paladin,retribution,14,8,6
Fatalpally,antonidas,633,paladin,retribution,17,7,10
Taéyeon,quelthalas,624,paladin,retribution,15,7,8
Táçô,illidan,623,paladin,retribution,11,7,4
Wingalings,malganis,623,paladin,retribution,11,7,4
Krossfyre,kiljaeden,623,paladin,retribution,17,7,10
Strabic,stormrage,623,paladin,retribution,27,8,19
Jortesh,tichondrius,622,paladin,retribution,15,7,8
Virrata,tichondrius,618,paladin,retribution,14,8,6
Antoniano,ragnaros,617,paladin,retribution,13,8,5
Traditionalp,area-52,617,paladin,retribution,13,8,5
Thorsmites,sargeras,616,paladin,retribution,29,11,18
Krixes,firetree,615,paladin,retribution,18,8,10
Kaharule,akama,608,paladin,retribution,16,7,9
Lalatinx,quelthalas,608,paladin,retribution,16,7,9
Frêyr,barthilas,608,paladin,retribution,22,7,15
Andelk,tichondrius,607,paladin,retribution,11,7,4
Chestbrah,nemesis,607,paladin,retribution,14,7,7
Tolkki,dalaran,607,paladin,retribution,26,7,19
Krønos,nordrassil,602,paladin,retribution,22,7,15
Sixtynine,nathrezim,592,paladin,retribution,31,7,24
Warbird,lightnings-blade,591,paladin,retribution,13,7,6
Theomere,sargeras,586,paladin,retribution,27,10,17
Fibonaci,sargeras,576,paladin,retribution,6,6,0
Bubbledober,tichondrius,576,paladin,retribution,6,6,0
Xandiê,sargeras,576,paladin,retribution,6,6,0
Thøradin,moon-guard,576,paladin,retribution,6,6,0
Ashley,sargeras,576,paladin,retribution,6,6,0
Liht,blood-furnace,576,paladin,retribution,6,6,0
Koyoikonan,tichondrius,576,paladin,retribution,6,6,0
Bigdogchief,stormrage,576,paladin,retribution,6,6,0
Lucard,drakkari,576,paladin,retribution,6,6,0
Rakzan,nerzhul,576,paladin,retribution,12,6,6
Vozy,shandris,576,paladin,retribution,12,6,6
Memepaladin,area-52,576,paladin,retribution,12,6,6
Tacohuntter,stormrage,576,paladin,retribution,12,6,6
Crânkdât,frostmourne,576,paladin,retribution,12,6,6
Cinacalcet,dalaran,576,paladin,retribution,12,6,6
Zèró,terokkar,576,paladin,retribution,12,6,6
Holycrp,proudmoore,576,paladin,retribution,12,6,6
Sacerbelator,zuluhed,576,paladin,retribution,12,6,6
Lmac,frostmourne,576,paladin,retribution,12,6,6
Gambitdin,moon-guard,576,paladin,retribution,12,6,6
Onixx,kargath,576,paladin,retribution,12,6,6
Irushthots,tichondrius,576,paladin,retribution,12,6,6
Thuggrnaut,darkspear,576,paladin,retribution,12,6,6
Banzz,azralon,576,paladin,retribution,12,6,6
Germ,korgath,576,paladin,retribution,12,6,6
Joeseph,stormrage,576,paladin,retribution,12,6,6
Retboy,archimonde,576,paladin,retribution,12,6,6
Outlivz,hyjal,576,paladin,retribution,12,6,6
Kaïty,azralon,576,paladin,retribution,12,6,6
Relentless,magtheridon,576,paladin,retribution,12,6,6
Obeliskk,frostmourne,576,paladin,retribution,12,6,6
Careyprice,area-52,576,paladin,retribution,12,6,6
Ogholyhands,bleeding-hollow,576,paladin,retribution,12,6,6
Cause,farstriders,576,paladin,retribution,12,6,6
Venter,bleeding-hollow,576,paladin,retribution,12,6,6
Rohad,thrall,576,paladin,retribution,12,6,6
Brpistol,azralon,576,paladin,retribution,12,6,6
Emetselchs,tichondrius,576,paladin,retribution,12,6,6
Seeys,tichondrius,576,paladin,retribution,12,6,6
Onnakishi,azralon,576,paladin,retribution,12,6,6
Velyssatha,moon-guard,576,paladin,retribution,12,6,6
Totalaustin,sargeras,576,paladin,retribution,12,6,6
Glynisir,sargeras,576,paladin,retribution,12,6,6
Checkeettpal,sargeras,576,paladin,retribution,12,6,6
Çhñkzrèt,illidan,576,paladin,retribution,12,6,6
Margit,moon-guard,576,paladin,retribution,12,6,6
Xlnc,illidan,576,paladin,retribution,12,6,6
Koûtt,ragnaros,576,paladin,retribution,12,6,6
Truthkeeper,moon-guard,576,paladin,retribution,12,6,6
Cübe,malganis,576,paladin,retribution,12,6,6
Gánico,ragnaros,576,paladin,retribution,12,6,6
Yungcheezy,illidan,576,paladin,retribution,12,6,6
Immensepower,tichondrius,576,paladin,retribution,12,6,6
Jabrohnie,sargeras,576,paladin,retribution,12,6,6
Trixzthot,barthilas,576,paladin,retribution,12,6,6
Bloodyängel,emerald-dream,576,paladin,retribution,12,6,6
Seballedo,drakkari,576,paladin,retribution,12,6,6
Raywhite,kelthuzad,576,paladin,retribution,12,6,6
Soapgirl,area-52,576,paladin,retribution,12,6,6
Proctrlx,tichondrius,576,paladin,retribution,12,6,6
Bronytime,illidan,576,paladin,retribution,12,6,6
Tazanian,aegwynn,576,paladin,retribution,12,6,6
Pállyho,tichondrius,576,paladin,retribution,12,6,6
Troegenator,stormrage,576,paladin,retribution,12,6,6
Thaléros,tichondrius,576,paladin,retribution,12,6,6
Fallenp,hakkar,576,paladin,retribution,12,6,6
Escanøor,stormrage,576,paladin,retribution,12,6,6
Ltt,dalaran,576,paladin,retribution,12,6,6
Gronmpa,nemesis,576,paladin,retribution,12,6,6
Byebyetwinks,khaz-modan,576,paladin,retribution,12,6,6
Cvpal,stormrage,576,paladin,retribution,12,6,6
Illëst,stormrage,576,paladin,retribution,12,6,6
Sonicblazer,darrowmere,576,paladin,retribution,12,6,6
Roguesmoker,zuljin,576,paladin,retribution,12,6,6
Contritus,kiljaeden,576,paladin,retribution,12,6,6
Munaru,illidan,576,paladin,retribution,12,6,6
Crtinsideyou,skullcrusher,576,paladin,retribution,12,6,6
Cybopig,kelthuzad,576,paladin,retribution,12,6,6
Aura,emerald-dream,576,paladin,retribution,12,6,6
Bigkspally,korgath,576,paladin,retribution,12,6,6
Nyroxz,quelthalas,576,paladin,retribution,12,6,6
Lebubbles,azuremyst,576,paladin,retribution,12,6,6
Zägreus,moon-guard,576,paladin,retribution,12,6,6
Shãw,zuljin,576,paladin,retribution,12,6,6
Norlannd,ragnaros,576,paladin,retribution,12,6,6
Bootcrusader,thrall,576,paladin,retribution,15,7,8
Sunwalker,tichondrius,576,paladin,retribution,17,6,11
Nufi,magtheridon,576,paladin,retribution,18,6,12
Exorcìst,tichondrius,576,paladin,retribution,18,6,12
Felwythe,emerald-dream,576,paladin,retribution,18,6,12
Shiftybugar,tichondrius,576,paladin,retribution,18,6,12
Heatyr,malganis,576,paladin,retribution,18,6,12
Respect,moon-guard,576,paladin,retribution,18,6,12
Retz,tichondrius,576,paladin,retribution,18,6,12
Bubblelol,bloodhoof,576,paladin,retribution,18,6,12
Kronicle,bleeding-hollow,576,paladin,retribution,18,6,12
Hetodo,blood-furnace,576,paladin,retribution,18,6,12
Wreathy,sargeras,576,paladin,retribution,18,6,12
Goldskìn,sargeras,576,paladin,retribution,18,6,12
Terrordin,illidan,576,paladin,retribution,18,6,12
Mixnut,tichondrius,576,paladin,retribution,18,6,12
Slaneesh,ragnaros,576,paladin,retribution,18,6,12
Emaus,tichondrius,576,paladin,retribution,18,6,12
Slowmoshend,illidan,576,paladin,retribution,18,6,12
Astolfo,tortheldrin,576,paladin,retribution,18,6,12
Xinqingle,tichondrius,576,paladin,retribution,18,6,12
Riggen,thrall,576,paladin,retribution,18,6,12
Liandroa,stormrage,576,paladin,retribution,18,6,12
Gogofisco,moonrunner,576,paladin,retribution,18,6,12
Niksilp,malfurion,576,paladin,retribution,18,6,12
Jivvy,eredar,576,paladin,retribution,18,6,12
Kochinodin,ragnaros,576,paladin,retribution,18,6,12
Lightslion,stormrage,576,paladin,retribution,18,6,12
Bakednub,malganis,576,paladin,retribution,23,6,17
Pallyfreddyy,frostmourne,576,paladin,retribution,24,6,18
Knobody,emerald-dream,575,paladin,retribution,12,6,6
Heiinneken,queldorei,575,paladin,retribution,12,6,6
Synthetic,moon-guard,575,paladin,retribution,12,6,6
Übermane,illidan,575,paladin,retribution,12,6,6
Ikanacanyon,stormrage,575,paladin,retribution,12,6,6
Potiguar,azralon,575,paladin,retribution,12,6,6
Pocacoco,azralon,575,paladin,retribution,12,6,6
Blëssëd,zuljin,575,paladin,retribution,12,6,6
Yuzuru,mannoroth,575,paladin,retribution,12,6,6
Onecmpeter,kelthuzad,575,paladin,retribution,12,6,6
Haziel,darkspear,575,paladin,retribution,12,6,6
Jovolur,dalaran,575,paladin,retribution,12,6,6
Bingbingcd,tichondrius,575,paladin,retribution,12,6,6
Crixius,eredar,575,paladin,retribution,12,6,6
Laluce,malganis,575,paladin,retribution,12,6,6
Drágônbôrn,tichondrius,575,paladin,retribution,12,6,6
Skyangel,illidan,575,paladin,retribution,12,6,6
Holyginger,barthilas,575,paladin,retribution,15,7,8
Trekpii,area-52,575,paladin,retribution,13,6,7
Rynis,arthas,575,paladin,retribution,16,7,9
Vosailer,illidan,575,paladin,retribution,16,7,9
Amorimbr,area-52,575,paladin,retribution,18,6,12
Killstien,illidan,575,paladin,retribution,18,6,12
Oceangal,illidan,575,paladin,retribution,18,6,12
Vecknilashx,quelthalas,575,paladin,retribution,24,6,18
Ihmperiuus,quelthalas,574,paladin,retribution,12,6,6
Slar,emerald-dream,574,paladin,retribution,12,6,6
Akeero,khaz-modan,574,paladin,retribution,12,6,6
Halordriest,tichondrius,574,paladin,retribution,18,6,12
Darqtank,smolderthorn,574,paladin,retribution,18,6,12
Tamahu,azralon,574,paladin,retribution,18,6,12
Rcon,khadgar,573,paladin,retribution,12,6,6
Phankro,quelthalas,573,paladin,retribution,12,6,6
Tauyoshi,azjolnerub,573,paladin,retribution,12,6,6
Nerfmehpls,ragnaros,573,paladin,retribution,12,6,6
Holyshoc,kiljaeden,573,paladin,retribution,20,6,14
Chadrickk,tichondrius,572,paladin,retribution,12,6,6
Ajaex,area-52,571,paladin,retribution,12,6,6
Kalerien,wildhammer,571,paladin,retribution,12,6,6
Lucent,duskwood,571,paladin,retribution,18,6,12
Niáa,quelthalas,570,paladin,retribution,18,6,12
Bubbleöseven,agamaggan,568,paladin,retribution,17,8,9
Palâdino,azralon,568,paladin,retribution,21,7,14
Juang,arthas,566,paladin,retribution,20,7,13
Sote,lightnings-blade,559,paladin,retribution,15,7,8
Bellamor,burning-blade,543,paladin,retribution,11,6,5
Cherrypally,area-52,543,paladin,retribution,11,6,5
Buffalosaucé,illidan,543,paladin,retribution,17,6,11
Gloren,garrosh,543,paladin,retribution,17,6,11
Suslazin,area-52,543,paladin,retribution,20,7,13
Màli,akama,543,paladin,retribution,23,6,17
Hadagoodlay,zuljin,528,paladin,retribution,15,6,9
Gtate,azjolnerub,527,paladin,retribution,11,6,5
Yulzypal,tichondrius,527,paladin,retribution,11,6,5
Shuckles,windrunner,522,paladin,retribution,20,7,13
Briaelyne,tichondrius,522,paladin,retribution,25,8,17
Ha,bleeding-hollow,522,paladin,retribution,22,7,15
Lítebearer,kelthuzad,521,paladin,retribution,11,6,5
Noblelight,saurfang,520,paladin,retribution,12,7,5
Uhklathel,quelthalas,520,paladin,retribution,27,9,18
Nathaniel,galakrond,511,paladin,retribution,14,6,8
ßìgdám,bleeding-hollow,511,paladin,retribution,17,6,11
Javiermiléi,quelthalas,511,paladin,retribution,26,6,20
Dexko,silvermoon,509,paladin,retribution,12,7,5
Shampin,alexstrasza,495,paladin,retribution,9,7,2
Fionax,frostmourne,495,paladin,retribution,21,6,15
Senorwang,dalaran,494,paladin,retribution,13,6,7
Mikkylol,tichondrius,494,paladin,retribution,16,6,10
Mizumaru,sargeras,480,paladin,retribution,6,5,1
Moozafa,kiljaeden,480,paladin,retribution,6,5,1
Mandymuze,illidan,480,paladin,retribution,6,5,1
Stricken,kul-tiras,480,paladin,retribution,6,5,1
Mollymatt,drenden,480,paladin,retribution,6,5,1
Littlebadbad,tichondrius,480,paladin,retribution,6,5,1
Vaelinarys,ragnaros,480,paladin,retribution,6,5,1
Ganrof,mugthol,480,paladin,retribution,6,5,1
Chopsparks,khadgar,480,paladin,retribution,6,5,1
Pallisix,barthilas,480,paladin,retribution,6,5,1
Akâme,kelthuzad,480,paladin,retribution,6,5,1
Ashbrînger,emerald-dream,480,paladin,retribution,6,5,1
Speedlight,ragnaros,480,paladin,retribution,6,5,1
Devvn,laughing-skull,480,paladin,retribution,6,5,1
Fistrozenemy,illidan,480,paladin,retribution,6,5,1
Kelimir,dathremar,480,paladin,retribution,6,5,1
Pickleparker,stormrage,480,paladin,retribution,6,5,1
Rektributíon,area-52,480,paladin,retribution,6,5,1
Oldlemon,tichondrius,480,paladin,retribution,6,5,1
Capsiel,caelestrasz,480,paladin,retribution,6,5,1
Annii,aegwynn,480,paladin,retribution,6,5,1
Lagwat,sargeras,480,paladin,retribution,6,5,1
Avasti,proudmoore,480,paladin,retribution,6,5,1
Luzmu,azralon,480,paladin,retribution,6,5,1
Kimitail,tichondrius,480,paladin,retribution,6,5,1
Holdup,moon-guard,480,paladin,retribution,6,5,1
Swegswog,frostmourne,480,paladin,retribution,6,5,1
Divenelena,sargeras,480,paladin,retribution,6,5,1
Solidifyxz,area-52,480,paladin,retribution,6,5,1
Demetriusxy,tichondrius,480,paladin,retribution,6,5,1
Excalibur,amanthul,480,paladin,retribution,6,5,1
Mmrdonator,icecrown,480,paladin,retribution,6,5,1
Zeprikito,nemesis,480,paladin,retribution,6,5,1
Amarnath,turalyon,480,paladin,retribution,6,5,1
Sonatas,ursin,480,paladin,retribution,9,6,3
Smaugg,boulderfist,480,paladin,retribution,9,6,3
Frepz,illidan,480,paladin,retribution,10,6,4
Siamac,illidan,480,paladin,retribution,13,7,6
Htmlar,tichondrius,480,paladin,retribution,11,5,6
Dinobe,arthas,480,paladin,retribution,12,5,7
Lücid,arthas,480,paladin,retribution,12,5,7
Thrasheric,ragnaros,480,paladin,retribution,12,5,7
Pique,malganis,480,paladin,retribution,12,5,7
Mateeka,malganis,480,paladin,retribution,12,5,7
Retsupreme,tichondrius,480,paladin,retribution,12,5,7
Valkaurus,drakkari,480,paladin,retribution,12,5,7
Liadryn,kiljaeden,480,paladin,retribution,12,5,7
Gennara,ragnaros,480,paladin,retribution,12,5,7
Cedwarlancy,sargeras,480,paladin,retribution,12,5,7
Gotenks,trollbane,480,paladin,retribution,12,5,7
Retcuzyaknow,illidan,480,paladin,retribution,12,5,7
Suro,moon-guard,480,paladin,retribution,12,5,7
Hegarth,archimonde,480,paladin,retribution,12,5,7
Hallastus,stormrage,480,paladin,retribution,12,5,7
Zhaslk,ragnaros,480,paladin,retribution,12,5,7
Imperious,anetheron,480,paladin,retribution,12,5,7
Shiningtendi,aerie-peak,480,paladin,retribution,12,5,7
Lepirate,emerald-dream,480,paladin,retribution,12,5,7
Jinuhn,illidan,480,paladin,retribution,12,5,7
Thin,ragnaros,480,paladin,retribution,12,5,7
Thickgirl,bleeding-hollow,480,paladin,retribution,12,5,7
Toojazzyleah,proudmoore,480,paladin,retribution,12,5,7
Smiteup,sargeras,480,paladin,retribution,12,5,7
Daddyspit,arthas,480,paladin,retribution,12,5,7
Farmerzonly,tichondrius,480,paladin,retribution,12,5,7
Randvi,sargeras,480,paladin,retribution,12,5,7
Dirtbagg,demon-soul,480,paladin,retribution,12,5,7
Trg,azralon,480,paladin,retribution,12,5,7
Abegáil,area-52,480,paladin,retribution,12,5,7
Gavriel,quelthalas,480,paladin,retribution,12,5,7
Vain,shuhalo,480,paladin,retribution,12,5,7
Aeoliá,moon-guard,480,paladin,retribution,12,5,7
Bettyböp,bleeding-hollow,480,paladin,retribution,12,5,7
Uneazyxx,tichondrius,480,paladin,retribution,12,5,7
Chàrron,garrosh,480,paladin,retribution,12,5,7
Delaswing,quelthalas,480,paladin,retribution,12,5,7
Noleyboo,proudmoore,480,paladin,retribution,12,5,7
Ravage,lothar,480,paladin,retribution,12,5,7
Jaenus,azralon,480,paladin,retribution,12,5,7
Maxduo,bleeding-hollow,480,paladin,retribution,12,5,7
Maanuel,ragnaros,480,paladin,retribution,12,5,7
Itaghí,sargeras,480,paladin,retribution,12,5,7
Ganster,dreadmaul,480,paladin,retribution,12,5,7
Dragomnnm,stormrage,480,paladin,retribution,12,5,7
Faithkiller,garrosh,480,paladin,retribution,12,5,7
ßraveheart,zuljin,480,paladin,retribution,12,5,7
Namiiswan,area-52,480,paladin,retribution,12,5,7
Dehya,sargeras,480,paladin,retribution,12,5,7
Níngjìngy,tichondrius,480,paladin,retribution,12,5,7
Rikku,undermine,480,paladin,retribution,12,5,7
Adrexious,dalaran,480,paladin,retribution,12,5,7
Shinymoo,laughing-skull,480,paladin,retribution,12,5,7
Mikeawk,tichondrius,480,paladin,retribution,12,5,7
Bold,frostmourne,480,paladin,retribution,12,5,7
Hekcthor,ragnaros,480,paladin,retribution,12,5,7
Yellowmay,sargeras,480,paladin,retribution,12,5,7
Sabericdos,proudmoore,480,paladin,retribution,12,5,7
Attkdamdam,illidan,480,paladin,retribution,12,5,7
Walleis,moon-guard,480,paladin,retribution,12,5,7
Zulyourmom,tichondrius,480,paladin,retribution,12,5,7
Yoroding,tichondrius,480,paladin,retribution,12,5,7
Bullpaladin,barthilas,480,paladin,retribution,12,5,7
Nadinebb,proudmoore,480,paladin,retribution,12,5,7
Dipho,illidan,480,paladin,retribution,12,5,7
Shadòw,emerald-dream,480,paladin,retribution,12,5,7
Dalance,draka,480,paladin,retribution,12,5,7
Critadins,thrall,480,paladin,retribution,12,5,7
Unholypally,suramar,480,paladin,retribution,12,5,7
Jaslexa,illidan,480,paladin,retribution,12,5,7
Minzyp,illidan,480,paladin,retribution,12,5,7
Cropcircles,whisperwind,480,paladin,retribution,12,5,7
Xizzor,darkspear,480,paladin,retribution,12,5,7
Callandør,illidan,480,paladin,retribution,12,5,7
Holytankadin,alleria,480,paladin,retribution,12,5,7
Ssawsy,illidan,480,paladin,retribution,12,5,7
Beatman,blades-edge,480,paladin,retribution,12,5,7
Kirklandbeef,gorefiend,480,paladin,retribution,12,5,7
Joonzu,frostmane,480,paladin,retribution,12,5,7
Lightvader,illidan,480,paladin,retribution,12,5,7
Leaelda,wyrmrest-accord,480,paladin,retribution,12,5,7
Methor,thrall,480,paladin,retribution,12,5,7
Dwk,thrall,480,paladin,retribution,12,5,7
Athamon,nemesis,480,paladin,retribution,12,5,7
Connore,stormrage,480,paladin,retribution,12,5,7
Koreancannon,tichondrius,480,paladin,retribution,15,6,9
Chriscoz,korgath,480,paladin,retribution,18,5,13
Deecompose,sargeras,480,paladin,retribution,18,5,13
Tieberion,bleeding-hollow,480,paladin,retribution,18,5,13
Valinorean,nemesis,480,paladin,retribution,18,5,13
Møemøeda,illidan,480,paladin,retribution,18,5,13
Kurasi,frostmourne,480,paladin,retribution,18,5,13
Downs,tichondrius,480,paladin,retribution,18,5,13
Razuel,frostmourne,480,paladin,retribution,18,5,13
Zightmare,azralon,480,paladin,retribution,18,5,13
Typheuz,wyrmrest-accord,480,paladin,retribution,18,5,13
Onemassacre,spirestone,480,paladin,retribution,18,5,13
Holiness,stormreaver,480,paladin,retribution,18,5,13
Photons,emerald-dream,480,paladin,retribution,18,5,13
Holycots,stormrage,480,paladin,retribution,18,5,13
Honeybunza,area-52,480,paladin,retribution,18,5,13
Freddieroach,tichondrius,480,paladin,retribution,18,5,13
Ulcerà,azralon,480,paladin,retribution,18,5,13
Purged,wyrmrest-accord,480,paladin,retribution,18,5,13
Melgamis,quelthalas,480,paladin,retribution,18,5,13
Boogerred,korialstrasz,480,paladin,retribution,18,5,13
Imrahilaf,korialstrasz,480,paladin,retribution,18,5,13
Midnightboto,dragonmaw,480,paladin,retribution,18,5,13
Artherion,kelthuzad,480,paladin,retribution,27,6,21
Spoelstra,dragonmaw,480,paladin,retribution,24,5,19
Trapqueenlol,alterac-mountains,480,paladin,retribution,24,5,19
Zero,garona,480,paladin,retribution,30,5,25
Appolas,shattered-hand,479,paladin,retribution,6,5,1
Kremation,zuljin,479,paladin,retribution,6,5,1
Tooholy,kiljaeden,479,paladin,retribution,6,5,1
Noctis,nerzhul,479,paladin,retribution,12,5,7
Memoríez,zuljin,479,paladin,retribution,12,5,7
Dredberserk,stormrage,479,paladin,retribution,12,5,7
Cowsavior,terenas,479,paladin,retribution,12,5,7
Frostbitee,nerzhul,479,paladin,retribution,12,5,7
Reedeemer,bonechewer,479,paladin,retribution,12,5,7
Khels,gilneas,479,paladin,retribution,12,5,7
Murderous,frostmourne,479,paladin,retribution,12,5,7
Onemorelight,area-52,479,paladin,retribution,12,5,7
Ðarksealz,laughing-skull,479,paladin,retribution,12,5,7
Inqa,thunderlord,479,paladin,retribution,12,5,7
Ashera,amanthul,479,paladin,retribution,12,5,7
Hodne,blackhand,479,paladin,retribution,12,5,7
Zelrich,moon-guard,479,paladin,retribution,12,5,7
Provail,stormrage,479,paladin,retribution,18,5,13
Griz,magtheridon,479,paladin,retribution,18,5,13
Brightfire,dawnbringer,479,paladin,retribution,18,5,13
Romonite,bleeding-hollow,479,paladin,retribution,18,5,13
Palypunchh,darrowmere,478,paladin,retribution,12,6,6
Chengduqq,illidan,478,paladin,retribution,12,5,7
Lagun,wyrmrest-accord,478,paladin,retribution,12,5,7
Neipala,ragnaros,478,paladin,retribution,12,5,7
Benzen,bleeding-hollow,477,paladin,retribution,12,5,7
Jammsheed,arthas,477,paladin,retribution,12,5,7
Kaminasol,quelthalas,477,paladin,retribution,18,5,13
Felordron,silvermoon,475,paladin,retribution,12,5,7
Solstein,dalaran,474,paladin,retribution,12,5,7
Vengecide,proudmoore,473,paladin,retribution,12,5,7
Dubaron,burning-blade,473,paladin,retribution,12,5,7
Pablito,fizzcrank,457,paladin,retribution,21,7,14
Thepallyx,silvermoon,448,paladin,retribution,16,5,11
Jackstank,dragonmaw,447,paladin,retribution,8,6,2
Árèz,frostmourne,441,paladin,retribution,17,7,10
Neverforgot,quelthalas,431,paladin,retribution,11,5,6
Zzf,turalyon,431,paladin,retribution,11,5,6
Regivän,azralon,426,paladin,retribution,12,6,6
Hálløwéð,firetree,426,paladin,retribution,14,6,8
Stankylordz,sargeras,426,paladin,retribution,19,8,11
Rashrind,moon-guard,426,paladin,retribution,23,8,15
Kimochiyuh,illidan,425,paladin,retribution,17,7,10
Ducii,stormrage,424,paladin,retribution,22,6,16
Stahny,thrall,415,paladin,retribution,10,5,5
Saviorsavior,bleeding-hollow,415,paladin,retribution,11,5,6
Artaxerxes,stormrage,415,paladin,retribution,14,5,9
Wrekkin,stormrage,415,paladin,retribution,14,5,9
Epxilon,ragnaros,415,paladin,retribution,14,5,9
Rainingrets,tichondrius,404,paladin,retribution,28,10,18
Iamriched,illidan,400,paladin,retribution,13,5,8
Sydnneeyy,kelthuzad,399,paladin,retribution,5,5,0
Dwarfineas,dalaran,384,paladin,retribution,6,4,2
Lyà,area-52,384,paladin,retribution,6,4,2
Mystictoast,area-52,384,paladin,retribution,6,4,2
Temptrez,bleeding-hollow,384,paladin,retribution,6,4,2
Geesworld,nazjatar,384,paladin,retribution,6,4,2
Bisket,illidan,384,paladin,retribution,6,4,2
Supernampal,sargeras,384,paladin,retribution,6,4,2
Vxm,illidan,384,paladin,retribution,6,4,2
Yuliu,magtheridon,384,paladin,retribution,6,4,2
Täintcrusher,illidan,384,paladin,retribution,6,4,2
Limitier,proudmoore,384,paladin,retribution,6,4,2
Leoros,blackrock,384,paladin,retribution,6,4,2
Tifalockhart,dathremar,384,paladin,retribution,6,4,2
Ironpallyx,garrosh,384,paladin,retribution,6,4,2
Gospel,duskwood,384,paladin,retribution,6,4,2
Panicbubblin,stormrage,384,paladin,retribution,6,4,2
Easiestclass,azshara,384,paladin,retribution,6,4,2
Åphrodite,bleeding-hollow,384,paladin,retribution,6,4,2
Doç,stormrage,384,paladin,retribution,6,4,2
Ezpzxd,arygos,384,paladin,retribution,6,4,2
Gåbrîel,emerald-dream,384,paladin,retribution,6,4,2
Baladine,zuljin,384,paladin,retribution,6,4,2
Rohlin,boulderfist,384,paladin,retribution,6,4,2
Aohxmathoss,zuljin,384,paladin,retribution,6,4,2
Merlinä,illidan,384,paladin,retribution,6,4,2
Darthhelios,illidan,384,paladin,retribution,6,4,2
Gilgamesh,moonrunner,384,paladin,retribution,6,4,2
Kaypross,area-52,384,paladin,retribution,6,4,2
Daylit,proudmoore,384,paladin,retribution,6,4,2
Ruca,icecrown,384,paladin,retribution,6,4,2
Notaefc,icecrown,384,paladin,retribution,6,4,2
Ascencer,spirestone,384,paladin,retribution,6,4,2
Thrandeill,bleeding-hollow,384,paladin,retribution,6,4,2
Trisøn,area-52,384,paladin,retribution,6,4,2
Rhaegorn,drakkari,384,paladin,retribution,6,4,2
Cratt,chromaggus,384,paladin,retribution,6,4,2
Pappablanco,stormrage,384,paladin,retribution,6,4,2
Tayvar,stormrage,384,paladin,retribution,6,4,2
Thottylight,stormrage,384,paladin,retribution,6,4,2
Malicia,malorne,384,paladin,retribution,6,4,2
Khanid,emerald-dream,384,paladin,retribution,6,4,2
Laventus,area-52,384,paladin,retribution,6,4,2
Saulhudson,bleeding-hollow,384,paladin,retribution,6,4,2
Luluwu,stormrage,384,paladin,retribution,6,4,2
Dazztrain,barthilas,384,paladin,retribution,6,4,2
Anstyl,moon-guard,384,paladin,retribution,6,4,2
Crewsade,sargeras,384,paladin,retribution,6,4,2
Daylin,tichondrius,384,paladin,retribution,6,4,2
Candysugar,tichondrius,384,paladin,retribution,6,4,2
Bigolhammer,khadgar,384,paladin,retribution,6,4,2
Malavon,azralon,384,paladin,retribution,6,4,2
Fxxku,tichondrius,384,paladin,retribution,6,4,2
Cobaine,illidan,384,paladin,retribution,6,4,2
Shrektacular,malganis,384,paladin,retribution,6,4,2
Dörisseline,tichondrius,384,paladin,retribution,6,4,2
Dinapal,frostmourne,384,paladin,retribution,6,4,2
Legèndaïry,tichondrius,384,paladin,retribution,6,4,2
Wyrmblood,moon-guard,384,paladin,retribution,6,4,2
Crocfacex,tichondrius,384,paladin,retribution,6,4,2
Reclusiarch,tichondrius,384,paladin,retribution,6,4,2
Taiffan,azralon,384,paladin,retribution,6,4,2
Anaxxie,azralon,384,paladin,retribution,6,4,2
Ðorlie,malganis,384,paladin,retribution,6,4,2
Mikeyqt,nemesis,384,paladin,retribution,6,4,2
Shadp,frostmourne,384,paladin,retribution,6,4,2
Damnhammer,tichondrius,384,paladin,retribution,6,4,2
Holyham,fizzcrank,384,paladin,retribution,6,4,2
Zzerox,ragnaros,384,paladin,retribution,6,4,2
Minikalina,ragnaros,384,paladin,retribution,6,4,2
Sasukee,quelthalas,384,paladin,retribution,6,4,2
Silreck,ragnaros,384,paladin,retribution,6,4,2
Lightsheart,lightbringer,384,paladin,retribution,6,4,2
Balango,azralon,384,paladin,retribution,6,4,2
Pvppaulx,moon-guard,384,paladin,retribution,6,4,2
Hellcallerl,quelthalas,384,paladin,retribution,6,4,2
Ennvy,nemesis,384,paladin,retribution,6,4,2
Zexion,azralon,384,paladin,retribution,6,4,2
Fâmed,tichondrius,384,paladin,retribution,6,4,2
Tiduz,tichondrius,384,paladin,retribution,6,4,2
Farlayne,quelthalas,384,paladin,retribution,6,4,2
Eduardoap,azralon,384,paladin,retribution,6,4,2
Glexann,sargeras,384,paladin,retribution,6,4,2
Seven,blackwing-lair,384,paladin,retribution,6,4,2
Izidar,tichondrius,384,paladin,retribution,10,5,5
Bigddady,quelthalas,384,paladin,retribution,8,4,4
Paladan,tichondrius,384,paladin,retribution,11,4,7
Athenax,area-52,384,paladin,retribution,12,4,8
Msjudged,blackrock,384,paladin,retribution,12,4,8
Exer,ragnaros,384,paladin,retribution,12,4,8
Thaleros,tichondrius,384,paladin,retribution,12,4,8
Eddf,ursin,384,paladin,retribution,12,4,8
Forzanapoli,tichondrius,384,paladin,retribution,12,4,8
Sixty,sargeras,384,paladin,retribution,12,4,8
Psadin,thunderlord,384,paladin,retribution,12,4,8
Akiralons,ragnaros,384,paladin,retribution,12,4,8
Catuvalos,kiljaeden,384,paladin,retribution,12,4,8
Juliusplzher,area-52,384,paladin,retribution,12,4,8
Pallyforeva,sargeras,384,paladin,retribution,12,4,8
Dohsevèn,tichondrius,384,paladin,retribution,12,4,8
Atalzel,kiljaeden,384,paladin,retribution,12,4,8
Murdameek,area-52,384,paladin,retribution,12,4,8
Prettylightx,kelthuzad,384,paladin,retribution,12,4,8
Inareus,agamaggan,384,paladin,retribution,12,4,8
Niolite,ragnaros,384,paladin,retribution,12,4,8
Lânnâ,tichondrius,384,paladin,retribution,12,4,8
Kraggar,arthas,384,paladin,retribution,12,4,8
Smontis,sargeras,384,paladin,retribution,12,4,8
Kyrianjutsu,area-52,384,paladin,retribution,12,4,8
Crazysyco,proudmoore,384,paladin,retribution,12,4,8
Ddawz,proudmoore,384,paladin,retribution,12,4,8
Veshral,arthas,384,paladin,retribution,12,4,8
Miniell,tichondrius,384,paladin,retribution,12,4,8
Greenracer,kiljaeden,384,paladin,retribution,12,4,8
Imcomingbro,blackrock,384,paladin,retribution,12,4,8
Lightahean,proudmoore,384,paladin,retribution,12,4,8
Dmghack,tichondrius,384,paladin,retribution,12,4,8
Lenneth,nordrassil,384,paladin,retribution,12,4,8
Rusticles,aerie-peak,384,paladin,retribution,12,4,8
Mikeelul,tichondrius,384,paladin,retribution,12,4,8
Sigmapepe,quelthalas,384,paladin,retribution,12,4,8
Aricen,thunderhorn,384,paladin,retribution,12,4,8
Eettooko,aegwynn,384,paladin,retribution,12,4,8
Tëmplar,bleeding-hollow,384,paladin,retribution,12,4,8
Rëtribution,tichondrius,384,paladin,retribution,12,4,8
Lokkillos,drakkari,384,paladin,retribution,12,4,8
Oroürke,stormrage,384,paladin,retribution,12,4,8
Retspec,darkspear,384,paladin,retribution,12,4,8
Harke,drakkari,384,paladin,retribution,12,4,8
Taelpalx,stormrage,384,paladin,retribution,12,4,8
Zøzø,zuljin,384,paladin,retribution,12,4,8
Senion,velen,384,paladin,retribution,12,4,8
Givinpowpows,korgath,384,paladin,retribution,12,4,8
Aewynn,nemesis,384,paladin,retribution,12,4,8
Corrán,thrall,384,paladin,retribution,12,4,8
Chuckman,skullcrusher,384,paladin,retribution,12,4,8
Varuul,nerzhul,384,paladin,retribution,12,4,8
Danaimei,tichondrius,384,paladin,retribution,12,4,8
Krypton,tichondrius,384,paladin,retribution,12,4,8
Anastos,anvilmar,384,paladin,retribution,12,4,8
Clariten,ghostlands,384,paladin,retribution,12,4,8
Botch,drenden,384,paladin,retribution,12,4,8
Gripadin,tichondrius,384,paladin,retribution,12,4,8
Blackmuu,malganis,384,paladin,retribution,12,4,8
Roländ,thrall,384,paladin,retribution,12,4,8
Jimithing,senjin,384,paladin,retribution,12,4,8
Minidin,kiljaeden,384,paladin,retribution,12,4,8
Crystahlmeth,sargeras,384,paladin,retribution,12,4,8
Theril,kelthuzad,384,paladin,retribution,12,4,8
Heavener,tichondrius,384,paladin,retribution,12,4,8
Strugglèbus,thrall,384,paladin,retribution,12,4,8
Phattpump,tichondrius,384,paladin,retribution,12,4,8
Drriz,stormrage,384,paladin,retribution,12,4,8
Drízzy,ragnaros,384,paladin,retribution,12,4,8
Àpolo,stormrage,384,paladin,retribution,12,4,8
Adrn,tichondrius,384,paladin,retribution,12,4,8
Roodictz,zuljin,384,paladin,retribution,12,4,8
Baptism,shattered-hand,384,paladin,retribution,12,4,8
Kurook,moon-guard,384,paladin,retribution,12,4,8
Sethy,feathermoon,384,paladin,retribution,12,4,8
Grimdel,moon-guard,384,paladin,retribution,12,4,8
Simonis,windrunner,384,paladin,retribution,12,4,8
Ibull,stormscale,384,paladin,retribution,12,4,8
Júdgedredd,illidan,384,paladin,retribution,12,4,8
Eutectic,moon-guard,384,paladin,retribution,12,4,8
Adauto,illidan,384,paladin,retribution,12,4,8
Illhaveacoke,moon-guard,384,paladin,retribution,12,4,8
Pheonixpally,azralon,384,paladin,retribution,12,4,8
Goloh,shadowmoon,384,paladin,retribution,12,4,8
Dezul,stormscale,384,paladin,retribution,12,4,8
Toxanator,frostmourne,384,paladin,retribution,12,4,8
Bauldrin,moon-guard,384,paladin,retribution,12,4,8
Bigpin,shattered-hand,384,paladin,retribution,12,4,8
Hrizul,drakthul,384,paladin,retribution,12,4,8
Litium,frostmourne,384,paladin,retribution,12,4,8
Simpforomenx,emerald-dream,384,paladin,retribution,12,4,8
Kreigvar,moon-guard,384,paladin,retribution,12,4,8
Smöke,frostmourne,384,paladin,retribution,12,4,8
Talionz,illidan,384,paladin,retribution,12,4,8
Elflicious,illidan,384,paladin,retribution,12,4,8
Aidillon,shadowsong,384,paladin,retribution,12,4,8
Delukk,azralon,384,paladin,retribution,12,4,8
Acquiesce,bleeding-hollow,384,paladin,retribution,16,5,11
Batmanp,quelthalas,384,paladin,retribution,13,4,9
Ccpx,area-52,384,paladin,retribution,18,4,14
Talurius,azralon,384,paladin,retribution,18,4,14
Indemnity,wildhammer,384,paladin,retribution,18,4,14
Ongang,illidan,384,paladin,retribution,18,4,14
Powercelest,quelthalas,384,paladin,retribution,18,4,14
Draknals,illidan,384,paladin,retribution,18,4,14
Caityaj,illidan,384,paladin,retribution,18,4,14
Hupa,crushridge,384,paladin,retribution,18,4,14
Essexqt,blackhand,384,paladin,retribution,18,4,14
Mhakoi,bleeding-hollow,384,paladin,retribution,24,4,20
Iskándar,tichondrius,384,paladin,retribution,24,4,20
Stepurgameup,ghostlands,383,paladin,retribution,6,4,2
Brandforge,thunderlord,383,paladin,retribution,6,4,2
Vinjonc,drenden,383,paladin,retribution,6,4,2
Trodos,quelthalas,383,paladin,retribution,6,4,2
Dabsmaster,dalaran,383,paladin,retribution,6,4,2
Pajjy,azralon,383,paladin,retribution,6,4,2
Praisin,zuljin,383,paladin,retribution,6,4,2
Sinficha,quelthalas,383,paladin,retribution,6,4,2
Vonfraud,lightbringer,383,paladin,retribution,12,4,8
Kennysun,azralon,383,paladin,retribution,12,4,8
Holyburger,hakkar,383,paladin,retribution,12,4,8
Hølydiver,rivendare,383,paladin,retribution,12,4,8
Holyqt,thunderlord,383,paladin,retribution,12,4,8
Funkknight,sargeras,383,paladin,retribution,18,4,14
Hadrianus,azralon,383,paladin,retribution,24,4,20
Kenbad,aegwynn,382,paladin,retribution,6,4,2
Sparklepuss,turalyon,379,paladin,retribution,12,4,8
Amerok,malfurion,378,paladin,retribution,18,4,14
Novachrono,bladefist,367,paladin,retribution,9,5,4
Crucifine,wyrmrest-accord,367,paladin,retribution,11,4,7
Barzø,tichondrius,367,paladin,retribution,11,4,7
Goinglarge,frostmourne,367,paladin,retribution,11,4,7
Mèdic,illidan,367,paladin,retribution,11,4,7
Bibimbop,boulderfist,352,paladin,retribution,13,5,8
Vietnomeez,tichondrius,351,paladin,retribution,11,4,7
Páladian,quelthalas,351,paladin,retribution,11,4,7
Xcream,nemesis,351,paladin,retribution,20,5,15
Bruujqt,moon-guard,336,paladin,retribution,9,5,4
Titansnake,illidan,336,paladin,retribution,9,4,5
Meduselda,kelthuzad,335,paladin,retribution,9,5,4
Botïs,sargeras,335,paladin,retribution,9,5,4
Ethernaly,quelthalas,335,paladin,retribution,11,4,7
Stinaz,quelthalas,335,paladin,retribution,11,4,7
Exwars,moon-guard,330,paladin,retribution,8,5,3
Bastiion,stormrage,320,paladin,retribution,10,4,6
Wellowar,moon-guard,320,paladin,retribution,10,4,6
Làzårus,area-52,320,paladin,retribution,16,4,12
Junmá,tichondrius,319,paladin,retribution,5,4,1
Ruulight,tichondrius,319,paladin,retribution,5,4,1
Jnxzster,sargeras,319,paladin,retribution,8,4,4
Jadelong,azshara,319,paladin,retribution,8,4,4
Karig,sargeras,319,paladin,retribution,8,4,4
Gryphin,moon-guard,319,paladin,retribution,8,4,4
Holyshasha,tichondrius,319,paladin,retribution,8,4,4
Holynaps,malganis,319,paladin,retribution,9,4,5
Darkjewmagic,frostmourne,319,paladin,retribution,14,4,10
Torrthak,area-52,304,paladin,retribution,7,4,3
Paullokis,gallywix,304,paladin,retribution,7,4,3
Releváncé,frostmourne,304,paladin,retribution,19,4,15
Lomis,azgalor,288,paladin,retribution,6,3,3
Bigdamham,tichondrius,288,paladin,retribution,6,3,3
Olsen,stormrage,288,paladin,retribution,6,3,3
Kyperion,stormrage,288,paladin,retribution,6,3,3
Elri,ragnaros,288,paladin,retribution,6,3,3
Sleekz,moon-guard,288,paladin,retribution,6,3,3
Jadedx,stormrage,288,paladin,retribution,6,3,3
Xupalaa,azralon,288,paladin,retribution,6,3,3
Ximenita,ragnaros,288,paladin,retribution,6,3,3
Purekiller,destromath,288,paladin,retribution,6,3,3
Pirofosfato,azralon,288,paladin,retribution,6,3,3
Zercker,ragnaros,288,paladin,retribution,6,3,3
Holyshockss,stormrage,288,paladin,retribution,6,3,3
Bíteme,sargeras,288,paladin,retribution,6,3,3
Heamis,thunderlord,288,paladin,retribution,6,3,3
Mòse,emerald-dream,288,paladin,retribution,6,3,3
Nerilliah,sargeras,288,paladin,retribution,6,3,3
Dráugus,azralon,288,paladin,retribution,6,3,3
Vindictacho,tichondrius,288,paladin,retribution,6,3,3
Wálker,ragnaros,288,paladin,retribution,6,3,3
Jónò,tichondrius,288,paladin,retribution,6,3,3
Apocryphx,stormrage,288,paladin,retribution,6,3,3
Retsuxks,twisting-nether,288,paladin,retribution,6,3,3
Dfz,mannoroth,288,paladin,retribution,6,3,3
Aëriy,moon-guard,288,paladin,retribution,6,3,3
Zeroret,tichondrius,288,paladin,retribution,6,3,3
Pvar,stormrage,288,paladin,retribution,6,3,3
Àxçël,hyjal,288,paladin,retribution,6,3,3
Nâtion,cenarius,288,paladin,retribution,6,3,3
Vynlen,uldaman,288,paladin,retribution,6,3,3
Gstbubble,hyjal,288,paladin,retribution,6,3,3
Kloernstarr,sargeras,288,paladin,retribution,6,3,3
Elhoj,illidan,288,paladin,retribution,6,3,3
Nalenne,alexstrasza,288,paladin,retribution,6,3,3
Kôld,tichondrius,288,paladin,retribution,6,3,3
Sparticuss,frostmane,288,paladin,retribution,6,3,3
Vük,destromath,288,paladin,retribution,6,3,3
Zoroastrø,azralon,288,paladin,retribution,6,3,3
Luxuriousman,fizzcrank,288,paladin,retribution,6,3,3
Pahlevahn,stormrage,288,paladin,retribution,6,3,3
Senisse,illidan,288,paladin,retribution,6,3,3
Deadlyskills,arathor,288,paladin,retribution,6,3,3
Beato,silvermoon,288,paladin,retribution,6,3,3
Meith,ragnaros,288,paladin,retribution,6,3,3
Kahleesy,sargeras,288,paladin,retribution,6,3,3
Tisu,kiljaeden,288,paladin,retribution,6,3,3
Hybrix,tichondrius,288,paladin,retribution,6,3,3
Muffinknight,quelthalas,288,paladin,retribution,6,3,3
Beepsmash,executus,288,paladin,retribution,6,3,3
Halnarran,area-52,288,paladin,retribution,6,3,3
Stamptime,emerald-dream,288,paladin,retribution,6,3,3
Mki,kargath,288,paladin,retribution,6,3,3
Ýøg,tichondrius,288,paladin,retribution,6,3,3
Rillumas,wyrmrest-accord,288,paladin,retribution,6,3,3
Accept,frostmourne,288,paladin,retribution,6,3,3
Runebane,doomhammer,288,paladin,retribution,6,3,3
Moox,wyrmrest-accord,288,paladin,retribution,6,3,3
Gashlycrumb,tichondrius,288,paladin,retribution,6,3,3
Lawdeedawh,tichondrius,288,paladin,retribution,6,3,3
Zenpally,doomhammer,288,paladin,retribution,6,3,3
Merphy,tichondrius,288,paladin,retribution,6,3,3
Selivara,zuljin,288,paladin,retribution,6,3,3
Poisson,wildhammer,288,paladin,retribution,6,3,3
Bleeked,emerald-dream,288,paladin,retribution,6,3,3
Shibbz,illidan,288,paladin,retribution,6,3,3
Jojoboskies,aegwynn,288,paladin,retribution,6,3,3
Holyham,bonechewer,288,paladin,retribution,6,3,3
Barbesacrer,zuljin,288,paladin,retribution,6,3,3
Dev,frostwolf,288,paladin,retribution,6,3,3
Theßest,baelgun,288,paladin,retribution,6,3,3
Reaslovak,jubeithos,288,paladin,retribution,6,3,3
Shakemup,stormrage,288,paladin,retribution,6,3,3
Morlunè,tichondrius,288,paladin,retribution,6,3,3
Kegman,thrall,288,paladin,retribution,6,3,3
Berapal,tichondrius,288,paladin,retribution,6,3,3
Jireen,tichondrius,288,paladin,retribution,6,3,3
Lasonil,zuljin,288,paladin,retribution,6,3,3
Boladosx,azralon,288,paladin,retribution,6,3,3
Fluffnac,tichondrius,288,paladin,retribution,6,3,3
Aeltharix,blackwater-raiders,288,paladin,retribution,6,3,3
Menjo,malganis,288,paladin,retribution,6,3,3
Varezion,vashj,288,paladin,retribution,6,3,3
Taynos,tichondrius,288,paladin,retribution,6,3,3
Nawwll,stonemaul,288,paladin,retribution,6,3,3
Timu,suramar,288,paladin,retribution,6,3,3
Palman,frostmourne,288,paladin,retribution,6,3,3
Flareous,moon-guard,288,paladin,retribution,6,3,3
Justsaiyen,bleeding-hollow,288,paladin,retribution,6,3,3
Rectaluse,dalaran,288,paladin,retribution,6,3,3
Leá,illidan,288,paladin,retribution,6,3,3
Tadaki,dalaran,288,paladin,retribution,6,3,3
Obbzz,spirestone,288,paladin,retribution,6,3,3
Ironboxer,tichondrius,288,paladin,retribution,6,3,3
Doogo,cenarius,288,paladin,retribution,6,3,3
Everith,bleeding-hollow,288,paladin,retribution,6,3,3
Mcfleye,malganis,288,paladin,retribution,6,3,3
Palinator,bleeding-hollow,288,paladin,retribution,6,3,3
Hadory,shattered-halls,288,paladin,retribution,6,3,3
Principe,queldorei,288,paladin,retribution,6,3,3
Minzyy,frostmourne,288,paladin,retribution,6,3,3
Scamadin,tichondrius,288,paladin,retribution,6,3,3
Finnthepally,proudmoore,288,paladin,retribution,6,3,3
Assaultron,dalaran,288,paladin,retribution,6,3,3
Ankhz,area-52,288,paladin,retribution,6,3,3
Rickadin,bleeding-hollow,288,paladin,retribution,6,3,3
Pauliss,sargeras,288,paladin,retribution,6,3,3
Lituation,sargeras,288,paladin,retribution,6,3,3
Bubblet,bleeding-hollow,288,paladin,retribution,6,3,3
Konyfotm,bleeding-hollow,288,paladin,retribution,6,3,3
Pipay,proudmoore,288,paladin,retribution,6,3,3
Kaelel,barthilas,288,paladin,retribution,6,3,3
Krackanut,kelthuzad,288,paladin,retribution,6,3,3
Brahlix,area-52,288,paladin,retribution,6,3,3
Amega,bleeding-hollow,288,paladin,retribution,6,3,3
Kanachi,bleeding-hollow,288,paladin,retribution,6,3,3
Eleonorr,proudmoore,288,paladin,retribution,6,3,3
Mvpp,dalaran,288,paladin,retribution,6,3,3
Valadinna,tichondrius,288,paladin,retribution,6,3,3
Buttflapster,proudmoore,288,paladin,retribution,6,3,3
Syvir,area-52,288,paladin,retribution,6,3,3
Wetterguuch,area-52,288,paladin,retribution,6,3,3
Zakh,proudmoore,288,paladin,retribution,6,3,3
Dimsimbar,frostmourne,288,paladin,retribution,6,3,3
Nerfretpls,area-52,288,paladin,retribution,6,3,3
Astasia,laughing-skull,288,paladin,retribution,6,3,3
Holyshrekt,frostmourne,288,paladin,retribution,6,3,3
Warchaos,skullcrusher,288,paladin,retribution,6,3,3
Orangepa,dalaran,288,paladin,retribution,6,3,3
Lorainn,ragnaros,288,paladin,retribution,6,3,3
Nickotines,kelthuzad,288,paladin,retribution,6,3,3
Reallyfe,skullcrusher,288,paladin,retribution,6,3,3
Aura,stormreaver,288,paladin,retribution,6,3,3
Rockbell,kiljaeden,288,paladin,retribution,6,3,3
Blake,frostmourne,288,paladin,retribution,6,3,3
Nyxkithar,nagrand,288,paladin,retribution,6,3,3
Ahzreal,garona,288,paladin,retribution,6,3,3
Itzon,proudmoore,288,paladin,retribution,6,3,3
Cocodog,kiljaeden,288,paladin,retribution,6,3,3
Yugawn,maiev,288,paladin,retribution,6,3,3
Chiraqret,thunderhorn,288,paladin,retribution,6,3,3
Sóláris,moon-guard,288,paladin,retribution,6,3,3
Bigdumpy,thaurissan,288,paladin,retribution,6,3,3
Hypheríon,ragnaros,288,paladin,retribution,6,3,3
Jestiny,amanthul,288,paladin,retribution,6,3,3
Thortanous,icecrown,288,paladin,retribution,9,4,5
Ivanko,dalaran,288,paladin,retribution,7,3,4
Hermacles,stormrage,288,paladin,retribution,7,3,4
Xanaxlol,sargeras,288,paladin,retribution,10,4,6
Grindlimg,dalaran,288,paladin,retribution,12,3,9
Reehzlol,stormrage,288,paladin,retribution,12,3,9
Bubblebooty,drakthul,288,paladin,retribution,12,3,9
Nik,the-underbog,288,paladin,retribution,12,3,9
Tylnish,hyjal,288,paladin,retribution,12,3,9
Kadabrak,area-52,288,paladin,retribution,12,3,9
Divinedabs,stormrage,288,paladin,retribution,12,3,9
Tarkovkappa,illidan,288,paladin,retribution,12,3,9
Ucvnt,illidan,288,paladin,retribution,12,3,9
Kuoch,shandris,288,paladin,retribution,12,3,9
Corni,kiljaeden,288,paladin,retribution,12,3,9
Eljosco,nordrassil,288,paladin,retribution,12,3,9
Chetmorton,emerald-dream,288,paladin,retribution,12,3,9
Ultrah,area-52,288,paladin,retribution,12,3,9
Koltar,stormrage,288,paladin,retribution,12,3,9
Varthinator,stormrage,288,paladin,retribution,12,3,9
Asukaxt,illidan,288,paladin,retribution,12,3,9
Bulbi,emerald-dream,288,paladin,retribution,12,3,9
Dalden,trollbane,288,paladin,retribution,12,3,9
Johnus,lightbringer,288,paladin,retribution,12,3,9
Dragonbait,khadgar,288,paladin,retribution,12,3,9
Kreigan,hellscream,288,paladin,retribution,12,3,9
Vaaleria,dalaran,288,paladin,retribution,12,3,9
Pallypòwer,garrosh,288,paladin,retribution,12,3,9
Palâdin,zuljin,288,paladin,retribution,12,3,9
Leronos,zuljin,288,paladin,retribution,12,3,9
Elpal,thrall,288,paladin,retribution,12,3,9
Smokeys,sargeras,288,paladin,retribution,12,3,9
Dárkness,blades-edge,288,paladin,retribution,12,3,9
Theodrei,darrowmere,288,paladin,retribution,12,3,9
Cromsecrate,dalaran,288,paladin,retribution,12,3,9
Quelite,sargeras,288,paladin,retribution,12,3,9
Walkerbait,nazgrel,288,paladin,retribution,12,3,9
Jontapally,stormrage,288,paladin,retribution,12,3,9
Slania,area-52,288,paladin,retribution,12,3,9
Marrike,moon-guard,288,paladin,retribution,12,3,9
Spiritkeep,veknilash,288,paladin,retribution,12,3,9
Tíron,dalaran,288,paladin,retribution,12,3,9
Kentö,area-52,288,paladin,retribution,12,3,9
Madworld,moon-guard,288,paladin,retribution,12,3,9
Marthellus,quelthalas,288,paladin,retribution,12,3,9
Chuizz,frostmourne,288,paladin,retribution,12,3,9
Zaeris,proudmoore,288,paladin,retribution,12,3,9
Aenwyl,quelthalas,288,paladin,retribution,12,3,9
Donsagrado,quelthalas,288,paladin,retribution,12,3,9
Rxxkiee,tichondrius,288,paladin,retribution,12,3,9
Dävis,ragnaros,288,paladin,retribution,12,3,9
Stealhearsp,tichondrius,288,paladin,retribution,12,3,9
Gämä,azralon,288,paladin,retribution,12,3,9
Brutaldeath,area-52,288,paladin,retribution,12,3,9
Aduynn,tichondrius,288,paladin,retribution,12,3,9
Sàber,tichondrius,288,paladin,retribution,12,3,9
Jafbe,mugthol,288,paladin,retribution,12,3,9
Tolleytrain,malganis,288,paladin,retribution,12,3,9
Paladatrox,ragnaros,288,paladin,retribution,12,3,9
Lue,boulderfist,288,paladin,retribution,12,3,9
Uzbadkhazad,ragnaros,288,paladin,retribution,12,3,9
Hahe,tichondrius,288,paladin,retribution,12,3,9
Valdi,stonemaul,288,paladin,retribution,12,3,9
Boopif,sargeras,288,paladin,retribution,12,3,9
Wälly,garona,288,paladin,retribution,12,3,9
Yeluh,malganis,288,paladin,retribution,12,3,9
Hardclimacks,frostmourne,288,paladin,retribution,12,3,9
Säv,tichondrius,288,paladin,retribution,12,3,9
Fknnoath,frostmourne,288,paladin,retribution,12,3,9
Dubliner,garona,288,paladin,retribution,12,3,9
Bigplucker,kelthuzad,288,paladin,retribution,12,3,9
Baconsock,kelthuzad,288,paladin,retribution,12,3,9
Pepepally,area-52,288,paladin,retribution,18,3,15
Fourchon,tichondrius,288,paladin,retribution,18,3,15
Whangsta,tichondrius,288,paladin,retribution,24,3,21
Matøs,stormrage,287,paladin,retribution,6,3,3
Iralyn,frostmane,287,paladin,retribution,6,3,3
Soyafed,mugthol,287,paladin,retribution,6,3,3
Kapaw,windrunner,287,paladin,retribution,6,3,3
Covidxlx,hakkar,287,paladin,retribution,6,3,3
Dragollias,anvilmar,287,paladin,retribution,12,3,9
Reathe,llane,287,paladin,retribution,12,3,9
Laylee,anvilmar,287,paladin,retribution,12,3,9
Slædgæhæmmær,bonechewer,287,paladin,retribution,12,3,9
Cruz,silver-hand,286,paladin,retribution,12,3,9
Hukah,darkspear,286,paladin,retribution,18,3,15
Milkmi,frostmourne,271,paladin,retribution,11,3,8
Gabrielú,lightninghoof,256,paladin,retribution,10,3,7
Logaen,stormrage,256,paladin,retribution,16,3,13
Gusset,tichondrius,255,paladin,retribution,8,4,4
Lorgax,alterac-mountains,240,paladin,retribution,9,3,6
Badmix,tichondrius,239,paladin,retribution,5,3,2
Sôsaboy,tichondrius,239,paladin,retribution,5,3,2
Palitard,tichondrius,234,paladin,retribution,7,5,2
Swiftysh,ragnaros,234,paladin,retribution,9,4,5
Stinkystan,korgath,234,paladin,retribution,10,4,6
Wainkywink,malganis,234,paladin,retribution,15,4,11
Draidan,area-52,224,paladin,retribution,10,3,7
Livalil,chogall,224,paladin,retribution,16,3,13
Argonis,shadowsong,223,paladin,retribution,8,3,5
Waffulzz,moonrunner,223,paladin,retribution,8,3,5
Wabukis,twisting-nether,223,paladin,retribution,8,3,5
Ráky,quelthalas,223,paladin,retribution,14,3,11
Keegân,area-52,192,paladin,retribution,4,3,1
Zhspeilian,tichondrius,192,paladin,retribution,11,4,7
Anonymvs,eredar,192,paladin,retribution,9,3,6
Thõre,frostmourne,192,paladin,retribution,9,3,6
Alyxandr,dalaran,192,paladin,retribution,6,2,4
Eull,skullcrusher,192,paladin,retribution,6,2,4
Smolbeef,tichondrius,192,paladin,retribution,6,2,4
Passinpeace,tichondrius,192,paladin,retribution,6,2,4
Arkcadius,frostmourne,192,paladin,retribution,6,2,4
Quiznossubs,kelthuzad,192,paladin,retribution,6,2,4
Varianpally,kelthuzad,192,paladin,retribution,6,2,4
Yeshayah,dalaran,192,paladin,retribution,6,2,4
Snuggymuffin,barthilas,192,paladin,retribution,6,2,4
Bigdret,moon-guard,192,paladin,retribution,6,2,4
Oxoslayeroxo,firetree,192,paladin,retribution,6,2,4
Machoo,laughing-skull,192,paladin,retribution,6,2,4
Schooiez,tichondrius,192,paladin,retribution,6,2,4
Bubbleblast,elune,192,paladin,retribution,6,2,4
Mereoleona,elune,192,paladin,retribution,6,2,4
Bërzerk,zuluhed,192,paladin,retribution,6,2,4
Nicerice,dalaran,192,paladin,retribution,6,2,4
Crazymikey,bleeding-hollow,192,paladin,retribution,6,2,4
Reepr,tichondrius,192,paladin,retribution,6,2,4
Twatiegodx,malganis,192,paladin,retribution,6,2,4
Alasper,malganis,192,paladin,retribution,6,2,4
Paintpumper,malganis,192,paladin,retribution,6,2,4
Calvary,stormscale,192,paladin,retribution,6,2,4
Guanglong,malganis,192,paladin,retribution,6,2,4
Ohsoclose,bleeding-hollow,192,paladin,retribution,6,2,4
Killmode,kelthuzad,192,paladin,retribution,6,2,4
Noscajj,tichondrius,192,paladin,retribution,6,2,4
Morcant,drakkari,192,paladin,retribution,6,2,4
Liht,khazgoroth,192,paladin,retribution,6,2,4
Petunias,malganis,192,paladin,retribution,6,2,4
Hyphenated,frostmourne,192,paladin,retribution,6,2,4
Hinamattsuri,velen,192,paladin,retribution,6,2,4
Loocille,frostmourne,192,paladin,retribution,6,2,4
Felkor,caelestrasz,192,paladin,retribution,6,2,4
Aleio,moon-guard,192,paladin,retribution,6,2,4
Jazzmatic,dalaran,192,paladin,retribution,6,2,4
Stainless,magtheridon,192,paladin,retribution,6,2,4
Sinsy,moon-guard,192,paladin,retribution,6,2,4
Whyurunning,area-52,192,paladin,retribution,6,2,4
Stöny,illidan,192,paladin,retribution,6,2,4
Alexese,area-52,192,paladin,retribution,6,2,4
Retro,magtheridon,192,paladin,retribution,6,2,4
Paladam,burning-blade,192,paladin,retribution,6,2,4
Capedcrusade,area-52,192,paladin,retribution,6,2,4
Crosjudge,zuljin,192,paladin,retribution,6,2,4
Malakk,zuljin,192,paladin,retribution,6,2,4
Freslys,zuljin,192,paladin,retribution,6,2,4
Johnygoodboi,khazgoroth,192,paladin,retribution,6,2,4
Psychlight,quelthalas,192,paladin,retribution,6,2,4
Marcêl,quelthalas,192,paladin,retribution,6,2,4
Izaacckk,hakkar,192,paladin,retribution,6,2,4
Kigz,illidan,192,paladin,retribution,6,2,4
Greatblade,barthilas,192,paladin,retribution,6,2,4
Ordinary,greymane,192,paladin,retribution,6,2,4
Alluxian,zuljin,192,paladin,retribution,6,2,4
Palade,proudmoore,192,paladin,retribution,6,2,4
Kanyewes,zuluhed,192,paladin,retribution,6,2,4
Ugotburstt,arthas,192,paladin,retribution,6,2,4
Ret,onyxia,192,paladin,retribution,6,2,4
Sahbabii,baelgun,192,paladin,retribution,6,2,4
Blackflare,undermine,192,paladin,retribution,6,2,4
Kiloalpha,area-52,192,paladin,retribution,6,2,4
Lilpally,frostmourne,192,paladin,retribution,6,2,4
Blessinofsac,nagrand,192,paladin,retribution,6,2,4
Oxycleän,doomhammer,192,paladin,retribution,6,2,4
Hulc,ysera,192,paladin,retribution,6,2,4
Rochet,kiljaeden,192,paladin,retribution,6,2,4
Dithfeo,tichondrius,192,paladin,retribution,6,2,4
Thejüdge,malfurion,192,paladin,retribution,6,2,4
Alkon,quelthalas,192,paladin,retribution,6,2,4
Verzuhazadon,tichondrius,192,paladin,retribution,6,2,4
Hafra,zuljin,192,paladin,retribution,6,2,4
Bageru,gnomeregan,192,paladin,retribution,6,2,4
Desterro,quelthalas,192,paladin,retribution,6,2,4
Alphönsë,quelthalas,192,paladin,retribution,6,2,4
Virisanctii,stormrage,192,paladin,retribution,6,2,4
Tufybighamer,malganis,192,paladin,retribution,6,2,4
Supermetroid,vashj,192,paladin,retribution,6,2,4
Rây,stormrage,192,paladin,retribution,6,2,4
Buri,tichondrius,192,paladin,retribution,6,2,4
Spyglas,quelthalas,192,paladin,retribution,6,2,4
Prèèd,frostmourne,192,paladin,retribution,6,2,4
Tomackin,quelthalas,192,paladin,retribution,6,2,4
Enjoy,frostmourne,192,paladin,retribution,6,2,4
Tìg,proudmoore,192,paladin,retribution,6,2,4
Xoppo,tichondrius,192,paladin,retribution,6,2,4
Majinpal,illidan,192,paladin,retribution,6,2,4
Fairbairn,tichondrius,192,paladin,retribution,6,2,4
Criskaruz,ragnaros,192,paladin,retribution,6,2,4
Kêy,the-venture-co,192,paladin,retribution,6,2,4
Madnhairy,zuljin,192,paladin,retribution,6,2,4
Farvadin,illidan,192,paladin,retribution,6,2,4
Ðuel,area-52,192,paladin,retribution,6,2,4
Jaok,tichondrius,192,paladin,retribution,6,2,4
Roundbutts,stormrage,192,paladin,retribution,6,2,4
Repèntance,stormrage,192,paladin,retribution,6,2,4
Holypumper,moon-guard,192,paladin,retribution,6,2,4
Gîmply,proudmoore,192,paladin,retribution,6,2,4
Spanx,blackwing-lair,192,paladin,retribution,6,2,4
Felourian,malganis,192,paladin,retribution,6,2,4
Dose,moon-guard,192,paladin,retribution,6,2,4
Herbzilla,haomarush,192,paladin,retribution,6,2,4
Killerspally,area-52,192,paladin,retribution,6,2,4
Byonsay,zuljin,192,paladin,retribution,6,2,4
Blargnarg,area-52,192,paladin,retribution,6,2,4
Bullworm,ragnaros,192,paladin,retribution,6,2,4
Durotar,ragnaros,192,paladin,retribution,6,2,4
Angelscrÿ,stormrage,192,paladin,retribution,6,2,4
Réalg,area-52,192,paladin,retribution,6,2,4
Tôhru,ragnaros,192,paladin,retribution,6,2,4
Siberios,stormrage,192,paladin,retribution,6,2,4
Mazexd,illidan,192,paladin,retribution,6,2,4
Diänë,ragnaros,192,paladin,retribution,6,2,4
Cïelo,dragonmaw,192,paladin,retribution,6,2,4
Toscadin,ragnaros,192,paladin,retribution,6,2,4
Pelegroot,azralon,192,paladin,retribution,6,2,4
Misease,illidan,192,paladin,retribution,6,2,4
Voro,barthilas,192,paladin,retribution,6,2,4
Shaqueefah,illidan,192,paladin,retribution,6,2,4
Holypoizan,tichondrius,192,paladin,retribution,6,2,4
Abivion,stormrage,192,paladin,retribution,6,2,4
Haznthley,proudmoore,192,paladin,retribution,6,2,4
Wards,thunderlord,192,paladin,retribution,6,2,4
Ienhova,area-52,192,paladin,retribution,6,2,4
Guelmin,azralon,192,paladin,retribution,6,2,4
Crânkz,blackrock,192,paladin,retribution,6,2,4
Crijr,ragnaros,192,paladin,retribution,6,2,4
Adavinn,azjolnerub,192,paladin,retribution,6,2,4
Armasexodus,barthilas,192,paladin,retribution,6,2,4
Issac,tichondrius,192,paladin,retribution,6,2,4
Ghatte,azralon,192,paladin,retribution,6,2,4
Oniizuna,thrall,192,paladin,retribution,6,2,4
Corthic,area-52,192,paladin,retribution,6,2,4
Tacosmells,thunderlord,192,paladin,retribution,6,2,4
Pearlx,ragnaros,192,paladin,retribution,6,2,4
Ezekìël,tichondrius,192,paladin,retribution,6,2,4
Thaidron,area-52,192,paladin,retribution,6,2,4
Tyrack,ragnaros,192,paladin,retribution,6,2,4
Forprophet,blackrock,192,paladin,retribution,6,2,4
Svane,thunderlord,192,paladin,retribution,6,2,4
Lunchboxz,nazjatar,192,paladin,retribution,6,2,4
Rùckûs,tichondrius,192,paladin,retribution,6,2,4
Pallypallyy,aerie-peak,192,paladin,retribution,6,2,4
Släyèr,tichondrius,192,paladin,retribution,6,2,4
Blastoise,drakkari,192,paladin,retribution,6,2,4
Juanvaldez,muradin,192,paladin,retribution,6,2,4
Narcolepso,azralon,192,paladin,retribution,6,2,4
Quinnl,dreadmaul,192,paladin,retribution,6,2,4
Rhoruk,turalyon,192,paladin,retribution,6,2,4
Rightz,muradin,192,paladin,retribution,6,2,4
Tmwesker,azralon,192,paladin,retribution,6,2,4
Roity,proudmoore,192,paladin,retribution,6,2,4
Inexcusable,wyrmrest-accord,192,paladin,retribution,6,2,4
Xavorn,illidan,192,paladin,retribution,6,2,4
Tyberas,wyrmrest-accord,192,paladin,retribution,6,2,4
Überlin,whisperwind,192,paladin,retribution,6,2,4
Vankaer,uldum,192,paladin,retribution,6,2,4
Krabbiepatty,wyrmrest-accord,192,paladin,retribution,6,2,4
Theodden,tichondrius,192,paladin,retribution,6,2,4
Parkhwi,tichondrius,192,paladin,retribution,6,2,4
Ramises,nemesis,192,paladin,retribution,6,2,4
Avengzeus,tichondrius,192,paladin,retribution,6,2,4
Piousgecko,illidan,192,paladin,retribution,6,2,4
Mercuryx,tichondrius,192,paladin,retribution,6,2,4
Zoeyxo,tichondrius,192,paladin,retribution,6,2,4
Talions,illidan,192,paladin,retribution,6,2,4
Whittia,wyrmrest-accord,192,paladin,retribution,6,2,4
Jeddmaus,tichondrius,192,paladin,retribution,6,2,4
Lxwd,tichondrius,192,paladin,retribution,6,2,4
Taddedpally,tichondrius,192,paladin,retribution,6,2,4
Brucitenjr,illidan,192,paladin,retribution,6,2,4
Øexørcistta,nemesis,192,paladin,retribution,6,2,4
Thisissus,tichondrius,192,paladin,retribution,6,2,4
Pallylyfe,wyrmrest-accord,192,paladin,retribution,6,2,4
Troyamat,nemesis,192,paladin,retribution,6,2,4
Sigurd,khadgar,192,paladin,retribution,6,2,4
Roél,tichondrius,192,paladin,retribution,6,2,4
Pushabuton,illidan,192,paladin,retribution,6,2,4
Gwff,tichondrius,192,paladin,retribution,6,2,4
Outofholy,stormrage,192,paladin,retribution,6,2,4
Bøzø,stormrage,192,paladin,retribution,6,2,4
Rite,azralon,192,paladin,retribution,6,2,4
Ratkiller,barthilas,192,paladin,retribution,6,2,4
Lightkillerx,thrall,192,paladin,retribution,6,2,4
Bøble,thrall,192,paladin,retribution,6,2,4
Cyliex,illidan,192,paladin,retribution,6,2,4
Juiicebox,darrowmere,192,paladin,retribution,6,2,4
Shanehere,thrall,192,paladin,retribution,6,2,4
Pállymán,proudmoore,192,paladin,retribution,6,2,4
Exalter,malganis,192,paladin,retribution,6,2,4
Dynastyhero,area-52,192,paladin,retribution,6,2,4
Ríf,sargeras,192,paladin,retribution,6,2,4
Chrisqwa,sargeras,192,paladin,retribution,6,2,4
Astrøworld,sargeras,192,paladin,retribution,6,2,4
Motrîn,sargeras,192,paladin,retribution,6,2,4
Toto,sargeras,192,paladin,retribution,6,2,4
Sac,sargeras,192,paladin,retribution,6,2,4
Vengx,sargeras,192,paladin,retribution,6,2,4
Airane,sargeras,192,paladin,retribution,6,2,4
Brifos,sargeras,192,paladin,retribution,6,2,4
Mynnorath,emerald-dream,192,paladin,retribution,6,2,4
Carenye,thunderhorn,192,paladin,retribution,6,2,4
Neydisa,sargeras,192,paladin,retribution,6,2,4
Divineera,frostmourne,192,paladin,retribution,6,2,4
Trê,sargeras,192,paladin,retribution,6,2,4
Kegmight,emerald-dream,192,paladin,retribution,6,2,4
Guacamello,emerald-dream,192,paladin,retribution,6,2,4
Brand,emerald-dream,192,paladin,retribution,6,2,4
Alexandros,the-underbog,192,paladin,retribution,6,2,4
Moltensilver,emerald-dream,192,paladin,retribution,6,2,4
Oynx,emerald-dream,192,paladin,retribution,6,2,4
Strîkes,emerald-dream,192,paladin,retribution,6,2,4
Roseheart,emerald-dream,192,paladin,retribution,6,2,4
Solånar,bloodscalp,192,paladin,retribution,7,2,5
Scyni,kelthuzad,192,paladin,retribution,7,2,5
Murgly,tichondrius,192,paladin,retribution,8,2,6
Takz,daggerspine,192,paladin,retribution,8,2,6
Bebedor,azralon,192,paladin,retribution,9,2,7
Azajudgeman,nemesis,192,paladin,retribution,9,2,7
Dirtfunk,illidan,192,paladin,retribution,12,2,10
Kief,emerald-dream,192,paladin,retribution,12,2,10
Vantz,tichondrius,192,paladin,retribution,12,2,10
Seltzer,tichondrius,192,paladin,retribution,12,2,10
Holyshifts,exodar,192,paladin,retribution,12,2,10
Rîf,malganis,192,paladin,retribution,12,2,10
Anahl,icecrown,192,paladin,retribution,12,2,10
Rayli,dalaran,192,paladin,retribution,12,2,10
Arminhamer,sargeras,192,paladin,retribution,12,2,10
Fazoéli,stormrage,192,paladin,retribution,12,2,10
Dánteé,ragnaros,192,paladin,retribution,12,2,10
Redyomi,drakkari,192,paladin,retribution,12,2,10
Milfcrusader,tichondrius,192,paladin,retribution,12,2,10
Bubzfordubz,sargeras,192,paladin,retribution,12,2,10
Yawnday,farstriders,192,paladin,retribution,12,2,10
Kaiyleigh,sargeras,192,paladin,retribution,12,2,10
Clrty,area-52,192,paladin,retribution,12,2,10
Crasíus,quelthalas,192,paladin,retribution,12,2,10
Cronodxl,quelthalas,192,paladin,retribution,12,2,10
Seratox,illidan,192,paladin,retribution,12,2,10
Ghratadin,bleeding-hollow,192,paladin,retribution,12,2,10
Lamer,proudmoore,192,paladin,retribution,12,2,10
Cabacarl,quelthalas,192,paladin,retribution,12,2,10
Trippierett,bloodscalp,192,paladin,retribution,12,2,10
Goomie,icecrown,192,paladin,retribution,12,2,10
Slithix,stormreaver,192,paladin,retribution,12,2,10
Ricopal,frostmourne,192,paladin,retribution,12,2,10
Sïncere,frostmourne,192,paladin,retribution,12,2,10
Xuanxingchai,tichondrius,192,paladin,retribution,12,2,10
Criixx,malganis,192,paladin,retribution,12,2,10
Paladocka,stormrage,192,paladin,retribution,12,2,10
Aetol,proudmoore,192,paladin,retribution,12,2,10
Backfattammy,bleeding-hollow,192,paladin,retribution,12,2,10
Runandhide,aerie-peak,192,paladin,retribution,18,2,16
Dorisseline,emerald-dream,192,paladin,retribution,18,2,16
Imnoracist,thrall,192,paladin,retribution,18,2,16
Caitlyn,nazjatar,191,paladin,retribution,6,2,4
Nejie,nazjatar,191,paladin,retribution,6,2,4
Túss,khazgoroth,191,paladin,retribution,6,2,4
Vegetå,malganis,180,paladin,retribution,31,6,25
Thugmuffin,thrall,176,paladin,retribution,7,3,4
Wokeinator,malganis,175,paladin,retribution,11,3,8
Baalduru,borean-tundra,175,paladin,retribution,11,2,9
Laysonus,moon-guard,169,paladin,retribution,11,4,7
Bubbletop,tichondrius,169,paladin,retribution,11,4,7
Gordonryan,bleeding-hollow,160,paladin,retribution,10,2,8
Bringbackrmp,tichondrius,159,paladin,retribution,5,2,3
Pallydeen,illidan,159,paladin,retribution,5,2,3
Sorgeno,ursin,159,paladin,retribution,5,2,3
Nalahra,moon-guard,159,paladin,retribution,5,2,3
Prïmavera,azralon,159,paladin,retribution,5,2,3
Zyllo,area-52,159,paladin,retribution,5,2,3
Whoopsie,dragonmaw,159,paladin,retribution,5,2,3
Holeesheett,tichondrius,144,paladin,retribution,9,2,7
Ájummalukout,tichondrius,138,paladin,retribution,9,3,6
Iæl,stormrage,138,paladin,retribution,10,3,7
Åddict,kelthuzad,138,paladin,retribution,10,3,7
Dathromir,stormrage,138,paladin,retribution,15,3,12
Bubbleosèven,tichondrius,138,paladin,retribution,16,3,13
Modafinil,bonechewer,138,paladin,retribution,20,3,17
Kforty,kiljaeden,128,paladin,retribution,4,2,2
Yemotis,emerald-dream,128,paladin,retribution,4,2,2
Molodino,nemesis,128,paladin,retribution,4,2,2
Mikwa,ragnaros,128,paladin,retribution,4,2,2
Khileeha,sargeras,128,paladin,retribution,10,2,8
Sofiora,thunderlord,128,paladin,retribution,10,2,8
Celerios,stormreaver,127,paladin,retribution,8,2,6
Utho,wyrmrest-accord,96,paladin,retribution,3,2,1
Swordstrikes,tichondrius,96,paladin,retribution,3,2,1
Dazak,ragnaros,96,paladin,retribution,3,2,1
Gaismagorm,ragnaros,96,paladin,retribution,3,2,1
Bruwdblood,bleeding-hollow,96,paladin,retribution,6,1,5
Smudgexy,frostmourne,96,paladin,retribution,6,1,5
Poeboyz,stormrage,96,paladin,retribution,6,1,5
Dafoq,stormrage,96,paladin,retribution,6,1,5
Càséy,zuljin,96,paladin,retribution,6,1,5
Lowther,bleeding-hollow,96,paladin,retribution,6,1,5
Holythanos,bleeding-hollow,96,paladin,retribution,6,1,5
Pugnacity,stormrage,96,paladin,retribution,6,1,5
Franchy,stormrage,96,paladin,retribution,6,1,5
Actionman,bleeding-hollow,96,paladin,retribution,6,1,5
Ownedcrazy,stormrage,96,paladin,retribution,6,1,5
Orthín,stormrage,96,paladin,retribution,6,1,5
Palajem,stormrage,96,paladin,retribution,6,1,5
Holyclapzy,stormrage,96,paladin,retribution,6,1,5
Beebopper,illidan,96,paladin,retribution,6,1,5
Zwilliam,frostmourne,96,paladin,retribution,6,1,5
Flashbubble,sargeras,96,paladin,retribution,6,1,5
Gressilin,arthas,96,paladin,retribution,6,1,5
Cyona,gallywix,96,paladin,retribution,6,1,5
Ðeathguise,ysera,96,paladin,retribution,6,1,5
Balloony,stormrage,96,paladin,retribution,6,1,5
Goksuu,ragnaros,96,paladin,retribution,6,1,5
Thumos,sargeras,96,paladin,retribution,6,1,5
Smïthh,area-52,96,paladin,retribution,6,1,5
Chuggawhugga,area-52,96,paladin,retribution,6,1,5
Mindfoolness,sargeras,96,paladin,retribution,6,1,5
Duecesz,area-52,96,paladin,retribution,6,1,5
Tenethor,area-52,96,paladin,retribution,6,1,5
Flashstark,area-52,96,paladin,retribution,6,1,5
Lygophobia,frostmourne,96,paladin,retribution,6,1,5
Chainjustice,area-52,96,paladin,retribution,6,1,5
Thòrisòn,stormrage,96,paladin,retribution,6,1,5
Justtrollin,black-dragonflight,96,paladin,retribution,6,1,5
Shamashjoel,black-dragonflight,96,paladin,retribution,6,1,5
Immunelf,azgalor,96,paladin,retribution,6,1,5
Retx,arthas,96,paladin,retribution,6,1,5
Kaidao,black-dragonflight,96,paladin,retribution,6,1,5
Warhero,sargeras,96,paladin,retribution,6,1,5
Erindor,emerald-dream,96,paladin,retribution,6,1,5
Nytto,lightnings-blade,96,paladin,retribution,6,1,5
Rodrigo,frostmourne,96,paladin,retribution,6,1,5
Djset,blackhand,96,paladin,retribution,6,1,5
Zulzander,kelthuzad,96,paladin,retribution,6,1,5
Bojanglz,frostmourne,96,paladin,retribution,6,1,5
Kaylafell,kelthuzad,96,paladin,retribution,6,1,5
Ariolo,baelgun,96,paladin,retribution,6,1,5
Aldwyn,deathwing,96,paladin,retribution,6,1,5
Ryudoshël,nemesis,96,paladin,retribution,6,1,5
Terppy,stormrage,96,paladin,retribution,6,1,5
Mugann,malganis,96,paladin,retribution,6,1,5
Shádøwy,nemesis,96,paladin,retribution,6,1,5
Krulu,thrall,96,paladin,retribution,6,1,5
Holyflopper,malganis,96,paladin,retribution,6,1,5
Howlerhead,illidan,96,paladin,retribution,6,1,5
Brynleigh,malganis,96,paladin,retribution,6,1,5
Dûälïpä,barthilas,96,paladin,retribution,6,1,5
Marcovk,quelthalas,96,paladin,retribution,6,1,5
Giita,quelthalas,96,paladin,retribution,6,1,5
Scarllye,illidan,96,paladin,retribution,6,1,5
Fistopain,staghelm,96,paladin,retribution,6,1,5
Scah,illidan,96,paladin,retribution,6,1,5
Holyxsmokes,illidan,96,paladin,retribution,6,1,5
Phelix,lightninghoof,96,paladin,retribution,6,1,5
Coffeebean,quelthalas,96,paladin,retribution,6,1,5
Skadooshh,illidan,96,paladin,retribution,6,1,5
Partenna,quelthalas,96,paladin,retribution,6,1,5
Paldan,illidan,96,paladin,retribution,6,1,5
Kënsi,quelthalas,96,paladin,retribution,6,1,5
Sunnix,illidan,96,paladin,retribution,6,1,5
Rodt,dalaran,96,paladin,retribution,6,1,5
Liongolden,azralon,96,paladin,retribution,6,1,5
Wonas,ragnaros,96,paladin,retribution,6,1,5
Retsarro,frostmourne,96,paladin,retribution,6,1,5
Chapichapi,illidan,96,paladin,retribution,6,1,5
Fatkidslag,sargeras,96,paladin,retribution,6,1,5
Burom,kelthuzad,96,paladin,retribution,6,1,5
Conámi,ragnaros,96,paladin,retribution,6,1,5
Wilmâ,ragnaros,96,paladin,retribution,6,1,5
Airndel,illidan,96,paladin,retribution,6,1,5
Parts,aerie-peak,96,paladin,retribution,6,1,5
Ssjgodvy,illidan,96,paladin,retribution,6,1,5
Carloss,drakkari,96,paladin,retribution,6,1,5
Luiiguii,drakkari,96,paladin,retribution,6,1,5
Maeyz,sargeras,96,paladin,retribution,6,1,5
Këys,earthen-ring,96,paladin,retribution,6,1,5
Volphorix,illidan,96,paladin,retribution,6,1,5
Därth,azralon,96,paladin,retribution,6,1,5
Cots,azralon,96,paladin,retribution,6,1,5
Narsys,tichondrius,96,paladin,retribution,6,1,5
Boundric,emerald-dream,96,paladin,retribution,6,1,5
Tradalia,illidan,96,paladin,retribution,6,1,5
Acpally,tichondrius,96,paladin,retribution,6,1,5
Urudith,azralon,96,paladin,retribution,6,1,5
Slantee,illidan,96,paladin,retribution,6,1,5
Aragonns,illidan,96,paladin,retribution,6,1,5
Thechoseno,tichondrius,96,paladin,retribution,6,1,5
Fpaladin,tichondrius,96,paladin,retribution,6,1,5
Damndoi,tichondrius,96,paladin,retribution,6,1,5
Judgémental,bleeding-hollow,96,paladin,retribution,6,1,5
Sneakycastro,bleeding-hollow,96,paladin,retribution,6,1,5
Astraelon,bleeding-hollow,96,paladin,retribution,6,1,5
Minjikim,tichondrius,96,paladin,retribution,6,1,5
Odos,zuljin,96,paladin,retribution,6,1,5
Hasla,tichondrius,96,paladin,retribution,6,1,5
Asellusarc,kelthuzad,96,paladin,retribution,6,1,5
Adobro,tichondrius,96,paladin,retribution,6,1,5
Fourwives,sargeras,96,paladin,retribution,6,1,5
Gazef,proudmoore,96,paladin,retribution,6,1,5
Retrib,tichondrius,96,paladin,retribution,6,1,5
Bogùs,tichondrius,96,paladin,retribution,6,1,5
Lòuisvuttion,tichondrius,96,paladin,retribution,6,1,5
Gdesign,tichondrius,96,paladin,retribution,6,1,5
Solambul,tichondrius,96,paladin,retribution,6,1,5
Tehgodofdmg,tichondrius,96,paladin,retribution,6,1,5
Yøu,tichondrius,96,paladin,retribution,6,1,5
Rg,nerzhul,96,paladin,retribution,6,1,5
Cupidxbye,tichondrius,96,paladin,retribution,6,1,5
Tehbeasty,hyjal,96,paladin,retribution,6,1,5
Ahrieze,moon-guard,96,paladin,retribution,6,1,5
Valadinn,tichondrius,96,paladin,retribution,6,1,5
Zealotry,tichondrius,96,paladin,retribution,6,1,5
Matrium,kiljaeden,96,paladin,retribution,6,1,5
Angusbeef,hyjal,96,paladin,retribution,6,1,5
Scuffedhoj,tichondrius,96,paladin,retribution,6,1,5
Jüstice,tichondrius,96,paladin,retribution,6,1,5
Kamakazê,sargeras,96,paladin,retribution,6,1,5
Alk,windrunner,96,paladin,retribution,6,1,5
Homeboywill,hyjal,96,paladin,retribution,6,1,5
Deviill,winterhoof,96,paladin,retribution,6,1,5
Ashlïe,moon-guard,96,paladin,retribution,6,1,5
Donoph,blades-edge,96,paladin,retribution,6,1,5
Talahar,boulderfist,96,paladin,retribution,6,1,5
Bosmoklikdat,moon-guard,96,paladin,retribution,6,1,5
Bravsirrobin,firetree,96,paladin,retribution,6,1,5
Xkillz,korgath,96,paladin,retribution,6,1,5
Mentalíssues,moon-guard,96,paladin,retribution,6,1,5
Momhips,bloodscalp,96,paladin,retribution,6,1,5
Synnderilla,wyrmrest-accord,96,paladin,retribution,6,1,5
Chakin,burning-legion,96,paladin,retribution,6,1,5
Daelann,moon-guard,96,paladin,retribution,6,1,5
Wantsome,frostmourne,96,paladin,retribution,7,1,6
Lelythia,bleeding-hollow,96,paladin,retribution,7,1,6
Kregar,kelthuzad,96,paladin,retribution,7,1,6
Geykum,tichondrius,96,paladin,retribution,11,1,10
Reinhardburm,quelthalas,96,paladin,retribution,12,1,11
Yobnai,zuljin,96,paladin,retribution,12,1,11
Oshia,destromath,96,paladin,retribution,12,1,11
Hondacivicsi,mannoroth,96,paladin,retribution,12,1,11
Hojpocketx,tichondrius,96,paladin,retribution,12,1,11
Astralweed,quelthalas,96,paladin,retribution,12,1,11
Lorenzojr,sargeras,96,paladin,retribution,12,1,11
Shamo,stormreaver,96,paladin,retribution,12,1,11
Firexfist,gurubashi,96,paladin,retribution,12,1,11
Malisaa,tichondrius,96,paladin,retribution,12,1,11
Séykän,ragnaros,96,paladin,retribution,12,1,11
Catholica,tichondrius,96,paladin,retribution,12,1,11
Æpaldin,tichondrius,96,paladin,retribution,12,1,11
Theadona,runetotem,96,paladin,retribution,12,1,11
Rimorse,illidan,96,paladin,retribution,12,1,11
Roosterface,azjolnerub,96,paladin,retribution,12,1,11
Whosyourdady,azjolnerub,96,paladin,retribution,12,1,11
Hottest,wyrmrest-accord,84,paladin,retribution,13,5,8
Torms,illidan,79,paladin,retribution,3,3,0
Maverickxz,nemesis,79,paladin,retribution,5,1,4
Bowdown,wildhammer,79,paladin,retribution,5,1,4
Goldieg,tichondrius,79,paladin,retribution,5,1,4
Ryxxi,sargeras,79,paladin,retribution,5,1,4
Hivers,stormrage,79,paladin,retribution,11,1,10
Belenor,quelthalas,63,paladin,retribution,2,2,0
Dronedròp,illidan,63,paladin,retribution,2,2,0
Piston,kiljaeden,63,paladin,retribution,2,2,0
Fulgal,jubeithos,48,paladin,retribution,3,1,2
Lawbandit,tichondrius,42,paladin,retribution,10,3,7
Eljefee,emerald-dream,42,paladin,retribution,11,3,8
Dabakle,stormrage,42,paladin,retribution,8,2,6
Newwow,tichondrius,42,paladin,retribution,9,2,7
Voncruz,proudmoore,42,paladin,retribution,12,2,10
Patrious,moon-guard,31,paladin,retribution,2,1,1
Trainstorm,emerald-dream,31,paladin,retribution,2,1,1
Kletüs,quelthalas,16,paladin,retribution,1,1,0
Bluether,sargeras,16,paladin,retribution,1,1,0
Moistsaiyan,blood-furnace,15,paladin,retribution,1,1,0
ßleider,quelthalas,1906,paladin,protection,55,39,16
Ëlmaster,nemesis,1831,paladin,protection,126,80,46
Kierolechita,ragnaros,1807,paladin,protection,118,63,55
Degenratebri,moon-guard,1779,paladin,protection,47,35,12
Motates,malganis,1766,paladin,protection,87,47,40
Zhspeilian,tichondrius,1730,paladin,protection,84,47,37
Sutadansa,doomhammer,1711,paladin,protection,104,51,53
Uglyboyryan,sargeras,1674,paladin,protection,84,51,33
Eclipsor,bleeding-hollow,1657,paladin,protection,48,30,18
Vondonna,moon-guard,1655,paladin,protection,113,65,48
Lxwd,tichondrius,1655,paladin,protection,113,56,57
Aopidsfihjov,stormrage,1649,paladin,protection,48,34,14
Sôlux,quelthalas,1638,paladin,protection,56,31,25
Bighardshock,aggramar,1610,paladin,protection,30,18,12
Höpönpöppö,frostmourne,1589,paladin,protection,36,17,19
Zephyrvalor,sargeras,1580,paladin,protection,134,62,72
Blackmiya,tichondrius,1570,paladin,protection,31,20,11
Øziris,goldrinn,1567,paladin,protection,74,33,41
Rehtua,bleeding-hollow,1557,paladin,protection,83,35,48
Aeythyr,wyrmrest-accord,1495,paladin,protection,54,27,27
Chozverialyz,ysondre,1494,paladin,protection,68,32,36
Crâfty,bleeding-hollow,1485,paladin,protection,35,17,18
Modafinil,bonechewer,1455,paladin,protection,111,53,58
Wowmike,sargeras,1434,paladin,protection,60,28,32
Íaan,drakkari,1433,paladin,protection,70,43,27
Domocho,azgalor,1417,paladin,protection,42,22,20
Arcilys,illidan,1398,paladin,protection,60,29,31
Goldjade,khazgoroth,1366,paladin,protection,47,19,28
Almeta,kelthuzad,1350,paladin,protection,36,18,18
Stormvikingx,darkspear,1336,paladin,protection,24,14,10
Khrome,cenarion-circle,1328,paladin,protection,134,44,90
Jkethuhsnake,ghostlands,1306,paladin,protection,51,31,20
Thorsmites,sargeras,1273,paladin,protection,48,18,30
Rakasho,azralon,1263,paladin,protection,48,15,33
Borrus,malygos,1240,paladin,protection,24,13,11
Poorly,thorium-brotherhood,1210,paladin,protection,24,13,11
Imthabromb,dragonblight,1206,paladin,protection,35,18,17
Lelythia,bleeding-hollow,1161,paladin,protection,65,25,40
Palahogx,sargeras,1150,paladin,protection,24,12,12
Herimi,drakkari,1130,paladin,protection,35,12,23
Gredo,queldorei,1070,paladin,protection,17,12,5
Zakh,proudmoore,1053,paladin,protection,18,11,7
Cusino,tichondrius,1052,paladin,protection,18,11,7
Penitent,barthilas,1052,paladin,protection,18,11,7
Ronor,thorium-brotherhood,1037,paladin,protection,24,11,13
Bubblemark,tichondrius,959,paladin,protection,24,10,14
Ndnpaly,bonechewer,953,paladin,protection,12,10,2
Ratzon,dalaran,950,paladin,protection,18,10,8
Aluvia,malygos,864,paladin,protection,12,9,3
Negativeiq,moon-guard,798,paladin,protection,10,10,0
Courageousz,dalaran,768,paladin,protection,18,8,10
Crusâder,area-52,767,paladin,protection,24,8,16
Kittié,proudmoore,760,paladin,protection,24,8,16
Halnoth,dethecus,702,paladin,protection,11,8,3
Valkaire,area-52,671,paladin,protection,12,7,5
Dirkdigglerz,bleeding-hollow,670,paladin,protection,18,7,11
Bullivan,sisters-of-elune,668,paladin,protection,18,7,11
Whëëls,stormreaver,576,paladin,protection,12,6,6
Sølis,alleria,576,paladin,protection,12,6,6
Bt,quelthalas,575,paladin,protection,12,6,6
Danthorin,malfurion,575,paladin,protection,24,6,18
Dankerton,tichondrius,480,paladin,protection,6,5,1
Kiehui,lightbringer,480,paladin,protection,12,5,7
Lythos,dathremar,384,paladin,protection,6,4,2
Zexion,azralon,384,paladin,protection,15,5,10
Belmorlin,moon-guard,384,paladin,protection,12,4,8
Gîmply,proudmoore,384,paladin,protection,12,4,8
Isecretly,stormrage,335,paladin,protection,7,7,0
Urfavxbf,baelgun,288,paladin,protection,13,3,10
Saeranella,moon-guard,240,paladin,protection,9,3,6
Blâckhârt,saurfang,234,paladin,protection,9,4,5
Lewstelamon,korialstrasz,192,paladin,protection,6,2,4
Hittit,thrall,192,paladin,protection,6,2,4
Xinqingle,tichondrius,192,paladin,protection,6,2,4
Consecrated,daggerspine,192,paladin,protection,12,2,10
Zifre,ragnaros,192,paladin,protection,12,2,10
Dwarvendude,sargeras,159,paladin,protection,11,2,9
Holyknight,veknilash,96,paladin,protection,8,2,6
Bullmarket,tichondrius,96,paladin,protection,6,1,5
Holykura,thrall,96,paladin,protection,6,1,5
Combidin,garrosh,96,paladin,protection,6,1,5
Lasonil,zuljin,96,paladin,protection,6,1,5
Yötönyö,sargeras,2082,priest,holy,114,57,57
Priestlike,tichondrius,2010,priest,holy,127,68,59
Dogbutt,burning-legion,1996,priest,holy,222,111,111
Pickle,illidan,1954,priest,holy,74,42,32
Fluent,emerald-dream,1948,priest,holy,186,90,96
Tirrify,frostmourne,1899,priest,holy,54,29,25
Cokeheals,kelthuzad,1897,priest,holy,42,26,16
Fusira,gurubashi,1894,priest,holy,36,20,16
Pianohouse,illidan,1893,priest,holy,54,29,25
Haruspex,azralon,1876,priest,holy,64,34,30
Jjmms,akama,1862,priest,holy,193,103,90
Teslashield,bleeding-hollow,1856,priest,holy,54,25,29
Ninbara,tichondrius,1851,priest,holy,102,49,53
Lilyxo,bleeding-hollow,1845,priest,holy,72,36,36
Peat,hyjal,1844,priest,holy,54,27,27
Superduperr,illidan,1840,priest,holy,66,33,33
Vandalia,shadowsong,1837,priest,holy,181,89,92
Citrinesta,illidan,1835,priest,holy,197,121,76
Saintjpii,tichondrius,1818,priest,holy,108,66,42
Nickydamous,moon-guard,1817,priest,holy,66,38,28
Mastuti,azralon,1817,priest,holy,59,27,32
Onemission,whisperwind,1817,priest,holy,54,23,31
Iniquitatem,tichondrius,1817,priest,holy,60,23,37
Tromnasty,area-52,1816,priest,holy,90,53,37
Whitetails,illidan,1816,priest,holy,54,31,23
Onikûdaki,sargeras,1814,priest,holy,86,37,49
Cinnalite,darkspear,1813,priest,holy,36,26,10
Sweatynick,proudmoore,1813,priest,holy,227,109,118
Scyner,bleeding-hollow,1811,priest,holy,152,87,65
Dmgisop,illidan,1811,priest,holy,141,80,61
Bloodlinex,malganis,1806,priest,holy,171,102,69
Pipelayerx,illidan,1804,priest,holy,50,25,25
Murkd,tichondrius,1804,priest,holy,145,68,77
Tookiex,stormrage,1796,priest,holy,55,26,29
Gerpe,stormrage,1789,priest,holy,183,101,82
Rustymvp,nagrand,1787,priest,holy,50,24,26
Turnipp,sargeras,1780,priest,holy,42,19,23
Immthuggin,tichondrius,1780,priest,holy,102,43,59
Zenelu,tichondrius,1775,priest,holy,329,162,167
Santyel,ragnaros,1768,priest,holy,72,43,29
Moonideli,moon-guard,1765,priest,holy,72,36,36
Pancakeboi,tichondrius,1759,priest,holy,83,41,42
Goodlife,frostmourne,1753,priest,holy,107,52,55
Dreckie,sargeras,1751,priest,holy,119,58,61
Lëønë,nemesis,1746,priest,holy,130,79,51
Heavyflo,kelthuzad,1746,priest,holy,96,49,47
Nanatoo,sargeras,1743,priest,holy,42,22,20
Zazul,frostmane,1734,priest,holy,107,61,46
Icychain,area-52,1726,priest,holy,35,19,16
Hyouka,area-52,1723,priest,holy,223,114,109
Cheekypriest,stormrage,1714,priest,holy,66,30,36
Cryptron,tichondrius,1701,priest,holy,102,45,57
Gill,proudmoore,1696,priest,holy,118,59,59
Falsegodx,tichondrius,1689,priest,holy,96,50,46
Geoffrred,illidan,1686,priest,holy,54,21,33
Pws,azralon,1683,priest,holy,66,29,37
Candohp,frostmourne,1682,priest,holy,42,22,20
Dream,kelthuzad,1682,priest,holy,54,26,28
Soloqqt,tichondrius,1675,priest,holy,42,24,18
Gaudthree,tichondrius,1675,priest,holy,48,26,22
Minipriest,sargeras,1673,priest,holy,42,20,22
Óst,tichondrius,1673,priest,holy,42,18,24
Wøo,area-52,1672,priest,holy,141,76,65
Iluvthgnmicz,sargeras,1655,priest,holy,57,30,27
Wankenobi,stormrage,1655,priest,holy,260,131,129
Snowymooie,frostmourne,1643,priest,holy,48,22,26
Bopang,emerald-dream,1638,priest,holy,59,27,32
Cosmicyiff,area-52,1635,priest,holy,42,20,22
Elbowbeans,tichondrius,1629,priest,holy,94,43,51
Hardiness,tichondrius,1627,priest,holy,66,45,21
Punkndrublic,sargeras,1625,priest,holy,165,83,82
ßsimp,darrowmere,1623,priest,holy,59,24,35
Washdp,frostmourne,1621,priest,holy,48,21,27
Dypkillet,moon-guard,1612,priest,holy,144,69,75
Leoshi,turalyon,1604,priest,holy,48,27,21
Dylbags,frostmourne,1600,priest,holy,35,21,14
Tarlex,illidan,1589,priest,holy,70,32,38
Soaphia,kelthuzad,1571,priest,holy,124,64,60
Sacrifer,moon-guard,1570,priest,holy,90,48,42
ßeautiful,sargeras,1562,priest,holy,42,22,20
Dgpriest,tichondrius,1559,priest,holy,42,19,23
Krobs,bleeding-hollow,1559,priest,holy,48,20,28
Cerebrill,bleeding-hollow,1557,priest,holy,45,22,23
Dawnside,wyrmrest-accord,1547,priest,holy,406,229,177
Avis,illidan,1539,priest,holy,110,54,56
Heluupa,illidan,1538,priest,holy,113,71,42
Nielbomb,tichondrius,1527,priest,holy,414,206,208
Matthiass,thrall,1526,priest,holy,130,64,66
Sukeena,malganis,1525,priest,holy,83,38,45
Cardinalpéll,frostmourne,1520,priest,holy,41,23,18
Archbishop,stormscale,1514,priest,holy,79,42,37
Ducky,drakthul,1513,priest,holy,60,35,25
Saetia,drenden,1513,priest,holy,69,40,29
Boboxiao,illidan,1512,priest,holy,47,16,31
Cutiepriest,gnomeregan,1511,priest,holy,96,57,39
Bestgirlna,area-52,1509,priest,holy,30,16,14
Strivedaily,proudmoore,1506,priest,holy,151,74,77
Sooyáaa,illidan,1504,priest,holy,96,39,57
Plebiss,burning-blade,1503,priest,holy,149,81,68
Chervz,chogall,1503,priest,holy,42,18,24
Tranquilty,tichondrius,1501,priest,holy,72,31,41
Giveheadpats,moon-guard,1496,priest,holy,164,80,84
Tazzi,chromaggus,1494,priest,holy,79,35,44
Handsumheals,kiljaeden,1493,priest,holy,43,23,20
Oyy,barthilas,1490,priest,holy,78,39,39
Soleyxo,frostmourne,1489,priest,holy,54,31,23
Chadopri,stormrage,1486,priest,holy,42,26,16
Bubbles,drakthul,1485,priest,holy,364,179,185
Xedus,mannoroth,1485,priest,holy,62,28,34
Kostantina,kelthuzad,1484,priest,holy,42,18,24
Tòxìç,stormrage,1480,priest,holy,175,93,82
Goyimhealer,area-52,1476,priest,holy,53,23,30
Pettypriest,dalaran,1474,priest,holy,179,86,93
Symbolofhope,moon-guard,1474,priest,holy,45,20,25
Stonemonkeyp,sargeras,1473,priest,holy,121,64,57
Illyasviel,terenas,1472,priest,holy,103,41,62
Ayanamil,tichondrius,1460,priest,holy,79,57,22
Vampiric,laughing-skull,1457,priest,holy,62,35,27
Griddly,alterac-mountains,1445,priest,holy,55,17,38
Arçhángël,moon-guard,1442,priest,holy,48,27,21
Artiannaa,bleeding-hollow,1436,priest,holy,63,39,24
Necroplasma,area-52,1433,priest,holy,55,31,24
Mizzbehavn,tichondrius,1430,priest,holy,44,24,20
Pesca,proudmoore,1429,priest,holy,36,15,21
Edmen,stormrage,1428,priest,holy,84,40,44
Cantheel,stormrage,1428,priest,holy,84,39,45
Wrinkletink,whisperwind,1426,priest,holy,49,24,25
Duhàst,sargeras,1419,priest,holy,42,22,20
Gosilly,tichondrius,1417,priest,holy,24,15,9
Applepieyum,illidan,1417,priest,holy,60,23,37
Anguishment,stormrage,1416,priest,holy,153,73,80
Wisdumos,frostmourne,1410,priest,holy,36,15,21
Kovaxx,frostmourne,1407,priest,holy,156,74,82
Fyne,kelthuzad,1403,priest,holy,87,35,52
Reverenced,stormrage,1401,priest,holy,84,48,36
Sacredforce,sargeras,1400,priest,holy,66,21,45
Holyb,tichondrius,1395,priest,holy,53,29,24
Merellia,moon-guard,1395,priest,holy,72,37,35
Owlchubz,mannoroth,1395,priest,holy,109,49,60
Aisperwind,shadowsong,1391,priest,holy,42,20,22
Soapfan,kelthuzad,1387,priest,holy,195,94,101
Akaneo,tichondrius,1380,priest,holy,36,18,18
Rolence,tichondrius,1378,priest,holy,44,22,22
Mkenze,moon-guard,1378,priest,holy,114,53,61
Xenatic,emerald-dream,1375,priest,holy,36,18,18
Pottime,tichondrius,1375,priest,holy,48,23,25
Methodist,proudmoore,1374,priest,holy,78,28,50
Cruxave,aegwynn,1366,priest,holy,46,23,23
Sabene,greymane,1364,priest,holy,91,44,47
Heist,kelthuzad,1353,priest,holy,26,16,10
Quartzolio,azralon,1353,priest,holy,59,35,24
Rihen,tichondrius,1353,priest,holy,293,139,154
Etain,bloodscalp,1351,priest,holy,41,21,20
Shaldra,bleeding-hollow,1348,priest,holy,109,64,45
Phearix,zuljin,1348,priest,holy,42,19,23
Esvary,quelthalas,1347,priest,holy,110,59,51
Holyshytt,tichondrius,1346,priest,holy,55,30,25
Sappes,area-52,1346,priest,holy,54,27,27
Dioecesis,moon-guard,1345,priest,holy,83,30,53
Eccentricx,sargeras,1342,priest,holy,24,14,10
Alathea,elune,1337,priest,holy,30,14,16
Ænußís,stormrage,1335,priest,holy,84,46,38
Preacherr,bonechewer,1334,priest,holy,30,17,13
Spriest,kul-tiras,1332,priest,holy,74,41,33
Trufumthunzi,illidan,1330,priest,holy,26,17,9
Healztonic,dalaran,1323,priest,holy,85,38,47
Discospider,sargeras,1316,priest,holy,31,16,15
Operandi,sargeras,1315,priest,holy,29,16,13
Holynug,stormrage,1314,priest,holy,24,14,10
Lexiié,area-52,1312,priest,holy,55,33,22
Gracarix,frostmourne,1309,priest,holy,24,15,9
Mercý,zuljin,1309,priest,holy,60,34,26
Ksâh,bleeding-hollow,1309,priest,holy,36,17,19
Animè,zuluhed,1305,priest,holy,89,52,37
Xinferesia,sargeras,1305,priest,holy,61,25,36
Xrafa,azralon,1301,priest,holy,84,38,46
Maddrox,sargeras,1297,priest,holy,24,14,10
Chemod,quelthalas,1278,priest,holy,35,17,18
Djdazzle,kargath,1278,priest,holy,29,14,15
Duskherald,zuljin,1274,priest,holy,96,45,51
Freshtodeath,malganis,1269,priest,holy,42,23,19
Raskreia,dragonmaw,1268,priest,holy,30,14,16
Threesclass,tichondrius,1262,priest,holy,29,14,15
Anemonie,gorefiend,1258,priest,holy,84,38,46
Junatoh,area-52,1253,priest,holy,49,27,22
Galadrael,quelthalas,1252,priest,holy,35,16,19
Zallstan,zuljin,1249,priest,holy,30,15,15
Bjorke,tichondrius,1247,priest,holy,30,13,17
Tegridyfarm,malganis,1246,priest,holy,28,15,13
Holiermilk,demon-soul,1243,priest,holy,213,95,118
Packet,zuluhed,1241,priest,holy,18,13,5
Fanseband,dalaran,1240,priest,holy,41,22,19
Joeschmoe,proudmoore,1235,priest,holy,24,13,11
Healgirls,dalaran,1230,priest,holy,59,28,31
Nowwow,tichondrius,1230,priest,holy,30,14,16
Aiwa,winterhoof,1229,priest,holy,18,13,5
Littlebat,proudmoore,1226,priest,holy,76,39,37
Zerolimitzz,arthas,1225,priest,holy,48,22,26
Cléah,sargeras,1218,priest,holy,107,49,58
Leggoscams,tichondrius,1217,priest,holy,28,14,14
Firewatcher,sisters-of-elune,1214,priest,holy,30,17,13
Akainuu,nazjatar,1207,priest,holy,55,22,33
Dóctóre,thrall,1205,priest,holy,61,24,37
Stayhealed,tichondrius,1201,priest,holy,45,22,23
Vernis,nazjatar,1200,priest,holy,36,15,21
Dagaen,thunderlord,1199,priest,holy,209,104,105
Pílí,drakkari,1198,priest,holy,60,28,32
Ranøth,deathwing,1197,priest,holy,53,24,29
Valkur,aegwynn,1194,priest,holy,90,39,51
Theophobe,illidan,1190,priest,holy,85,45,40
Dolandir,quelthalas,1181,priest,holy,30,18,12
Kälashnikova,ragnaros,1180,priest,holy,104,51,53
Flemyth,eitrigg,1180,priest,holy,40,16,24
Tytusx,stormrage,1176,priest,holy,26,13,13
Haushauha,azralon,1164,priest,holy,48,23,25
Celinsa,ragnaros,1163,priest,holy,30,14,16
Daisie,bleeding-hollow,1159,priest,holy,42,20,22
Etros,wyrmrest-accord,1156,priest,holy,90,38,52
Milkgulper,illidan,1152,priest,holy,24,12,12
Leonihpriest,nemesis,1151,priest,holy,30,12,18
Trompiscola,quelthalas,1151,priest,holy,30,12,18
Ukizeal,moknathal,1151,priest,holy,42,15,27
Endure,moon-guard,1149,priest,holy,24,12,12
Padrecarras,ragnaros,1146,priest,holy,24,12,12
Maiyennefer,proudmoore,1146,priest,holy,34,13,21
Selket,stormscale,1145,priest,holy,96,42,54
Priestlie,malganis,1141,priest,holy,24,12,12
Meiev,quelthalas,1139,priest,holy,24,12,12
Carray,goldrinn,1138,priest,holy,43,14,29
Kasiry,ragnaros,1137,priest,holy,90,37,53
Tianqing,tichondrius,1126,priest,holy,34,12,22
Benjamints,thrall,1124,priest,holy,24,12,12
Dactylion,moon-guard,1119,priest,holy,24,12,12
Æsir,skullcrusher,1119,priest,holy,30,12,18
Niná,arathor,1114,priest,holy,20,13,7
Zojhira,khazgoroth,1114,priest,holy,66,32,34
Kytiana,blackwing-lair,1088,priest,holy,548,266,282
Atlana,gilneas,1086,priest,holy,18,12,6
Floppytatas,illidan,1085,priest,holy,123,58,65
Veltaxis,moon-guard,1084,priest,holy,110,45,65
Suzzanna,frostmourne,1082,priest,holy,23,13,10
Sôlîånia,alterac-mountains,1081,priest,holy,39,27,12
Deathrina,moon-guard,1079,priest,holy,27,13,14
Fayth,maiev,1070,priest,holy,29,15,14
Mavuiss,barthilas,1069,priest,holy,25,12,13
Beckzz,illidan,1063,priest,holy,24,15,9
Meatboxmoldy,blood-furnace,1056,priest,holy,20,15,5
Pesian,dalaran,1055,priest,holy,22,12,10
Kernelious,illidan,1055,priest,holy,24,11,13
Doob,ghostlands,1050,priest,holy,18,11,7
Dotdotdead,earthen-ring,1049,priest,holy,18,11,7
Hypepriest,sargeras,1049,priest,holy,18,11,7
Yinaiteen,drakkari,1049,priest,holy,52,30,22
Soulhealer,shadowmoon,1048,priest,holy,24,13,11
Berzum,chogall,1048,priest,holy,24,11,13
Swrvlol,emerald-dream,1045,priest,holy,18,11,7
Dylirium,dathremar,1044,priest,holy,18,11,7
Droneboy,moon-guard,1037,priest,holy,24,11,13
Karenpigbear,area-52,1037,priest,holy,120,41,79
Sanaconda,sargeras,1035,priest,holy,30,11,19
Seråphim,sargeras,1021,priest,holy,54,31,23
Dreäveler,stormrage,1007,priest,holy,21,11,10
Souljourner,stormrage,996,priest,holy,48,22,26
Sybenela,proudmoore,994,priest,holy,61,28,33
Priesttess,skullcrusher,981,priest,holy,23,11,12
Ragekiller,lothar,968,priest,holy,48,23,25
Oxynor,zuljin,960,priest,holy,18,10,8
Jameswarren,silvermoon,959,priest,holy,11,11,0
Pèrona,tichondrius,959,priest,holy,24,10,14
Trickyhobo,area-52,958,priest,holy,12,10,2
Iaptop,tichondrius,958,priest,holy,18,10,8
Folate,frostmourne,957,priest,holy,18,10,8
Musashibo,kelthuzad,957,priest,holy,33,11,22
Bugshott,tichondrius,956,priest,holy,32,10,22
Noobepriest,thrall,955,priest,holy,18,10,8
Adrenalinn,illidan,955,priest,holy,18,10,8
Whitepigogo,tichondrius,955,priest,holy,24,10,14
Cappoo,tichondrius,955,priest,holy,36,10,26
Delthas,nagrand,952,priest,holy,124,60,64
Dovoso,kargath,951,priest,holy,26,10,16
Hycinamun,malganis,949,priest,holy,24,10,14
Novous,area-52,944,priest,holy,30,10,20
Kazehanaa,ragnaros,942,priest,holy,18,10,8
Fäctor,bleeding-hollow,941,priest,holy,26,12,14
Holyfizzle,dethecus,936,priest,holy,30,14,16
Taylorsmites,emerald-dream,931,priest,holy,42,18,24
Eredwarraim,akama,930,priest,holy,36,13,23
Jol,aggramar,928,priest,holy,24,10,14
Dipanddøts,area-52,926,priest,holy,17,10,7
Artemix,azralon,903,priest,holy,119,48,71
Edessa,lothar,903,priest,holy,35,10,25
Vìxèn,zuljin,877,priest,holy,31,10,21
Moosepriestx,sargeras,864,priest,holy,18,9,9
Rustymvpfan,nagrand,864,priest,holy,18,9,9
Rootandboot,frostmourne,864,priest,holy,24,9,15
Holyxb,bleeding-hollow,863,priest,holy,18,9,9
Lickless,illidan,863,priest,holy,18,9,9
Glöws,area-52,863,priest,holy,24,9,15
Çummiñs,malganis,862,priest,holy,18,9,9
Kaelthos,quelthalas,862,priest,holy,18,9,9
Padreamarol,ragnaros,859,priest,holy,18,9,9
Sondrak,doomhammer,846,priest,holy,41,16,25
Alicia,nazjatar,844,priest,holy,12,9,3
Psïren,quelthalas,831,priest,holy,28,9,19
Ascian,daggerspine,809,priest,holy,18,10,8
Híkarí,windrunner,796,priest,holy,14,9,5
Gbumy,tichondrius,784,priest,holy,13,9,4
Turnip,zuljin,768,priest,holy,12,8,4
Tookz,stormrage,768,priest,holy,12,8,4
Fotmtrash,the-underbog,768,priest,holy,12,8,4
Voidzx,tichondrius,768,priest,holy,18,8,10
Garbagedisc,scilla,768,priest,holy,24,8,16
Khalesî,ragnaros,767,priest,holy,12,8,4
Hynzor,barthilas,767,priest,holy,30,8,22
Lilyanná,tichondrius,766,priest,holy,12,8,4
Ofmanyfaces,illidan,766,priest,holy,12,8,4
Prayzar,illidan,766,priest,holy,12,8,4
Zeroo,maiev,765,priest,holy,12,8,4
Manatea,moon-guard,765,priest,holy,18,8,10
Zolpidem,quelthalas,765,priest,holy,18,8,10
Lenlune,bloodscalp,763,priest,holy,18,8,10
Hälø,moon-guard,762,priest,holy,12,8,4
Celani,gilneas,762,priest,holy,18,8,10
Bienhechora,quelthalas,760,priest,holy,12,8,4
Mêgumin,area-52,759,priest,holy,12,8,4
Ishtana,bleeding-hollow,734,priest,holy,14,9,5
Fäñcÿ,tichondrius,734,priest,holy,17,8,9
Rylance,burning-blade,720,priest,holy,21,8,13
Bigmommyxo,whisperwind,718,priest,holy,21,9,12
Msdash,tichondrius,717,priest,holy,15,8,7
Saintfulsins,sargeras,716,priest,holy,15,8,7
Jaytee,aggramar,703,priest,holy,14,9,5
Teheleopapi,quelthalas,703,priest,holy,45,9,36
Voidthulhu,stormrage,672,priest,holy,12,7,5
Iilmama,area-52,672,priest,holy,12,7,5
Canibumsmoke,illidan,672,priest,holy,12,7,5
Pevis,thrall,672,priest,holy,12,7,5
Yyuan,tichondrius,672,priest,holy,12,7,5
Nwok,frostmourne,672,priest,holy,12,7,5
Clarifytwo,arathor,672,priest,holy,12,7,5
Beliana,boulderfist,672,priest,holy,16,8,8
Tylexus,tichondrius,672,priest,holy,18,7,11
Sorrowful,mannoroth,672,priest,holy,18,7,11
Jüdaspriest,gorefiend,672,priest,holy,18,7,11
Lagemela,quelthalas,672,priest,holy,24,7,17
Drelia,jubeithos,672,priest,holy,24,7,17
Jordandoesnt,tichondrius,671,priest,holy,12,7,5
Helgar,frostmourne,671,priest,holy,12,7,5
Suppòrt,stormrage,671,priest,holy,12,7,5
Xoraya,proudmoore,671,priest,holy,12,7,5
Akö,jubeithos,671,priest,holy,12,7,5
Chaynal,proudmoore,671,priest,holy,12,7,5
Deidre,illidan,671,priest,holy,16,8,8
Braevera,wyrmrest-accord,671,priest,holy,18,7,11
Arena,lothar,669,priest,holy,12,7,5
Uzakichan,arygos,669,priest,holy,24,7,17
Klassa,thrall,668,priest,holy,17,8,9
Kisstina,tichondrius,667,priest,holy,24,7,17
Stennic,emerald-dream,645,priest,holy,19,9,10
Releknosleep,frostwolf,634,priest,holy,17,7,10
Blackprez,dathremar,613,priest,holy,17,7,10
Punishing,illidan,606,priest,holy,16,7,9
Papadarkness,tichondrius,603,priest,holy,14,7,7
Pikachuwu,moon-guard,586,priest,holy,11,7,4
Hpcando,frostmourne,576,priest,holy,6,6,0
Hysteria,dalaran,576,priest,holy,12,6,6
Sìnz,area-52,576,priest,holy,12,6,6
Îcarus,tichondrius,576,priest,holy,12,6,6
Skylust,azralon,576,priest,holy,12,6,6
Marïmba,azralon,576,priest,holy,12,6,6
Praggy,proudmoore,576,priest,holy,12,6,6
Dadcantdeath,frostmourne,576,priest,holy,12,6,6
Hamburgle,blackrock,576,priest,holy,12,6,6
Bootleg,crushridge,576,priest,holy,12,6,6
Sigx,area-52,576,priest,holy,12,6,6
Jezebëll,nemesis,576,priest,holy,12,6,6
Didntâsk,arthas,576,priest,holy,12,6,6
Shockterror,area-52,576,priest,holy,12,6,6
Becrixx,thunderlord,576,priest,holy,12,6,6
Xhirra,quelthalas,576,priest,holy,18,6,12
Suirr,tichondrius,576,priest,holy,18,6,12
Mattkoster,mannoroth,575,priest,holy,12,6,6
Meowforheals,sargeras,575,priest,holy,12,6,6
Bismund,chogall,575,priest,holy,12,6,6
Darkheals,azralon,575,priest,holy,12,6,6
Därkness,azralon,575,priest,holy,18,6,12
Kephrek,eonar,575,priest,holy,18,6,12
Giusep,tichondrius,575,priest,holy,18,6,12
Sêtsunà,dalaran,575,priest,holy,36,6,30
Veni,kiljaeden,574,priest,holy,18,6,12
Aldryth,lightbringer,571,priest,holy,12,6,6
Altara,malygos,569,priest,holy,12,6,6
Zual,hakkar,569,priest,holy,12,6,6
Satíva,dark-iron,543,priest,holy,11,6,5
Xanky,frostmourne,511,priest,holy,10,6,4
Jâmïè,gurubashi,511,priest,holy,11,6,5
Illooj,eonar,510,priest,holy,19,7,12
Huxleypoo,boulderfist,480,priest,holy,6,5,1
Runalor,zuljin,480,priest,holy,6,5,1
Thisistragic,frostmourne,480,priest,holy,6,5,1
Soulghast,gorefiend,480,priest,holy,6,5,1
Timbobaloo,thrall,480,priest,holy,12,5,7
Secrèt,tichondrius,480,priest,holy,12,5,7
Xeras,ravencrest,480,priest,holy,12,5,7
Blackoss,sargeras,480,priest,holy,12,5,7
Snookp,kiljaeden,480,priest,holy,12,5,7
Rysie,winterhoof,480,priest,holy,12,5,7
Maelei,ragnaros,480,priest,holy,12,5,7
Selidri,proudmoore,480,priest,holy,12,5,7
Írithyll,sargeras,480,priest,holy,12,5,7
Steve,drakthul,480,priest,holy,12,5,7
Holyharlot,sargeras,480,priest,holy,18,5,13
Kaelsgf,kaelthas,480,priest,holy,18,5,13
Lieuwe,kelthuzad,479,priest,holy,6,5,1
Miganmarkle,sargeras,479,priest,holy,12,5,7
Adjectives,nerzhul,479,priest,holy,12,5,7
Arterrmis,barthilas,479,priest,holy,12,5,7
Unni,azralon,479,priest,holy,18,5,13
Amunsu,stormrage,475,priest,holy,12,5,7
Smellybox,area-52,463,priest,holy,13,6,7
Shadowchárm,bleeding-hollow,447,priest,holy,11,5,6
Yav,exodar,384,priest,holy,6,4,2
Amayå,kelthuzad,384,priest,holy,6,4,2
Calissy,proudmoore,384,priest,holy,6,4,2
Chanyt,azralon,384,priest,holy,6,4,2
Xusin,tichondrius,384,priest,holy,6,4,2
Jiñx,destromath,384,priest,holy,6,4,2
Bunnykinz,moon-guard,384,priest,holy,6,4,2
Schátten,spirestone,384,priest,holy,6,4,2
Dankpope,malganis,384,priest,holy,6,4,2
Patchyemoly,frostmourne,384,priest,holy,6,4,2
Priestybear,illidan,384,priest,holy,6,4,2
Mellow,tichondrius,384,priest,holy,12,4,8
Sätîvá,tichondrius,384,priest,holy,12,4,8
Darknuzs,sargeras,384,priest,holy,12,4,8
Bofin,stormrage,384,priest,holy,12,4,8
Clarify,arathor,384,priest,holy,12,4,8
Döyöuliftbro,tichondrius,384,priest,holy,12,4,8
Yumä,kiljaeden,384,priest,holy,12,4,8
Hoglet,moon-guard,384,priest,holy,12,4,8
Carti,bleeding-hollow,384,priest,holy,12,4,8
Frozencherry,elune,384,priest,holy,12,4,8
Hazzang,tichondrius,384,priest,holy,12,4,8
Aeøns,sargeras,384,priest,holy,18,4,14
Chambler,aegwynn,384,priest,holy,18,4,14
Pavle,laughing-skull,384,priest,holy,19,4,15
Dyianah,wyrmrest-accord,383,priest,holy,12,4,8
Healia,tichondrius,383,priest,holy,12,4,8
Messra,dathremar,381,priest,holy,18,4,14
Conno,thunderlord,379,priest,holy,12,4,8
Hatxsu,emerald-dream,372,priest,holy,22,8,14
Stradey,tichondrius,367,priest,holy,11,4,7
Sharkda,frostmourne,350,priest,holy,17,4,13
Santamuerte,agamaggan,336,priest,holy,15,4,11
Yidra,illidan,335,priest,holy,11,4,7
Qtasiangirl,emerald-dream,330,priest,holy,21,5,16
Boogiedo,area-52,319,priest,holy,5,4,1
Kabutta,stormrage,318,priest,holy,14,4,10
Whehaw,kelthuzad,288,priest,holy,6,3,3
Mëïsoön,quelthalas,288,priest,holy,6,3,3
Vynlanesh,illidan,288,priest,holy,6,3,3
Grindr,ragnaros,288,priest,holy,6,3,3
Lullabya,tichondrius,288,priest,holy,6,3,3
Orderic,ragnaros,288,priest,holy,6,3,3
Ärchangél,tichondrius,288,priest,holy,6,3,3
Ñÿx,arthas,288,priest,holy,6,3,3
Calvisper,thunderlord,288,priest,holy,6,3,3
Charbosan,gorgonnash,288,priest,holy,6,3,3
Estaria,the-forgotten-coast,288,priest,holy,6,3,3
Tseirpyeroc,area-52,288,priest,holy,6,3,3
Greet,hyjal,288,priest,holy,6,3,3
Dividëd,stormrage,288,priest,holy,6,3,3
Smiteyducks,stormrage,288,priest,holy,6,3,3
Trying,ysera,288,priest,holy,6,3,3
Madomie,bladefist,288,priest,holy,6,3,3
Raphan,stormrage,288,priest,holy,6,3,3
Toje,korgath,288,priest,holy,6,3,3
Wubbi,blackrock,288,priest,holy,6,3,3
Alwaystry,tichondrius,288,priest,holy,6,3,3
Laurens,fenris,288,priest,holy,6,3,3
Meatguzzler,tichondrius,288,priest,holy,6,3,3
Miamama,hydraxis,288,priest,holy,6,3,3
Zesho,firetree,288,priest,holy,6,3,3
Healdog,thrall,288,priest,holy,6,3,3
Duonaiameng,illidan,288,priest,holy,6,3,3
Bagoheals,area-52,288,priest,holy,6,3,3
Discountay,burning-legion,288,priest,holy,6,3,3
Nerfdisc,azralon,288,priest,holy,6,3,3
Pej,emerald-dream,288,priest,holy,6,3,3
Crypthion,emerald-dream,288,priest,holy,6,3,3
Xtcbtc,sargeras,288,priest,holy,6,3,3
Purgeoften,sargeras,288,priest,holy,6,3,3
Swis,area-52,288,priest,holy,12,3,9
Disperse,vashj,288,priest,holy,12,3,9
Smitepie,malganis,288,priest,holy,12,3,9
Irilde,proudmoore,288,priest,holy,12,3,9
Ísábella,ragnaros,288,priest,holy,12,3,9
Lalight,tichondrius,288,priest,holy,12,3,9
Sarkozzlol,tichondrius,288,priest,holy,12,3,9
Jezuz,aerie-peak,288,priest,holy,12,3,9
Fertalize,maiev,288,priest,holy,18,3,15
Pringlés,suramar,288,priest,holy,18,3,15
Fìngerbanger,lightnings-blade,287,priest,holy,6,3,3
Priestognic,azralon,287,priest,holy,6,3,3
Korhíl,ragnaros,287,priest,holy,6,3,3
Auradaluz,stormrage,287,priest,holy,12,3,9
Ftheman,tichondrius,234,priest,holy,17,4,13
Halö,doomhammer,223,priest,holy,14,3,11
Speyside,medivh,192,priest,holy,6,2,4
Pandap,dalaran,192,priest,holy,6,2,4
Spïcÿ,frostmourne,192,priest,holy,6,2,4
Sinthe,stormrage,192,priest,holy,6,2,4
Mindgoblin,terokkar,192,priest,holy,6,2,4
Voltstein,dalaran,192,priest,holy,6,2,4
Gusho,frostmourne,192,priest,holy,6,2,4
Hypodontia,caelestrasz,192,priest,holy,6,2,4
Wagnerr,jubeithos,192,priest,holy,6,2,4
Nodorme,quelthalas,192,priest,holy,6,2,4
Silentprayer,area-52,192,priest,holy,6,2,4
Mitras,moon-guard,192,priest,holy,6,2,4
Daddyhammer,area-52,192,priest,holy,6,2,4
Belfortx,tichondrius,192,priest,holy,6,2,4
Saenax,area-52,192,priest,holy,6,2,4
Verboden,kelthuzad,192,priest,holy,6,2,4
Faedre,smolderthorn,192,priest,holy,6,2,4
Arodar,wyrmrest-accord,192,priest,holy,6,2,4
Tuulipp,aegwynn,192,priest,holy,6,2,4
ßræcher,black-dragonflight,192,priest,holy,6,2,4
Whitelabel,proudmoore,192,priest,holy,6,2,4
Twodxo,kelthuzad,192,priest,holy,6,2,4
Mendx,tichondrius,192,priest,holy,6,2,4
Mommyafk,moon-guard,192,priest,holy,6,2,4
Gles,quelthalas,192,priest,holy,6,2,4
Ôp,sargeras,192,priest,holy,6,2,4
Opas,rivendare,192,priest,holy,6,2,4
Igotubrah,malganis,192,priest,holy,6,2,4
Jonhey,tichondrius,192,priest,holy,6,2,4
Tïto,blackrock,192,priest,holy,6,2,4
Dchi,tichondrius,192,priest,holy,6,2,4
Jilt,aerie-peak,192,priest,holy,6,2,4
Shemhazai,ragnaros,192,priest,holy,6,2,4
Langyi,tichondrius,192,priest,holy,10,2,8
Fraggydaddy,frostmourne,192,priest,holy,12,2,10
Nevertelsp,malganis,192,priest,holy,12,2,10
Påticus,area-52,192,priest,holy,13,2,11
Remixcandoit,malganis,191,priest,holy,6,2,4
Mikeliteo,blades-edge,190,priest,holy,12,2,10
Rebirthed,kelthuzad,172,priest,holy,82,39,43
Sneaks,frostmourne,159,priest,holy,5,2,3
Identìty,moon-guard,138,priest,holy,8,3,5
Pumpss,area-52,138,priest,holy,11,3,8
Bigvuqoffdam,area-52,138,priest,holy,16,3,13
Plzhelp,cairne,136,priest,holy,9,3,6
Burtier,zuljin,96,priest,holy,6,1,5
Tammyone,emerald-dream,96,priest,holy,6,1,5
Lasaldra,quelthalas,96,priest,holy,6,1,5
Hiroshikun,azshara,96,priest,holy,6,1,5
Faithmelter,stormrage,96,priest,holy,6,1,5
Qnarisha,tichondrius,96,priest,holy,6,1,5
Hüde,stormrage,96,priest,holy,6,1,5
Yungsherm,tichondrius,96,priest,holy,6,1,5
Akami,tichondrius,96,priest,holy,6,1,5
Haedn,azralon,96,priest,holy,6,1,5
Janova,tichondrius,96,priest,holy,6,1,5
Novoul,stormrage,96,priest,holy,6,1,5
Alëssana,illidan,96,priest,holy,6,1,5
Minamy,tichondrius,96,priest,holy,6,1,5
Olassi,stormrage,96,priest,holy,6,1,5
Kagura,dunemaul,96,priest,holy,6,1,5
Angelicduck,illidan,96,priest,holy,6,1,5
Sukmysplooge,queldorei,96,priest,holy,6,1,5
Bloodcure,ysera,96,priest,holy,6,1,5
Breathkeeper,proudmoore,96,priest,holy,6,1,5
Majjic,proudmoore,96,priest,holy,6,1,5
Bigboyadam,frostmourne,96,priest,holy,6,1,5
Lilpaprika,sargeras,96,priest,holy,6,1,5
Bunked,bleeding-hollow,96,priest,holy,6,1,5
Badgoy,dalaran,96,priest,holy,6,1,5
Deryus,dalaran,96,priest,holy,6,1,5
Shadyvoodoo,barthilas,96,priest,holy,6,1,5
Rakel,nathrezim,96,priest,holy,6,1,5
Tuuros,wyrmrest-accord,96,priest,holy,6,1,5
Nancynibbler,bleeding-hollow,96,priest,holy,6,1,5
Missjules,illidan,96,priest,holy,6,1,5
Sarïya,moon-guard,96,priest,holy,6,1,5
Bofuri,barthilas,96,priest,holy,6,1,5
Øliverxp,lightbringer,96,priest,holy,6,1,5
Alaskaa,moon-guard,96,priest,holy,6,1,5
Gutrose,area-52,96,priest,holy,12,1,11
Gillís,thrall,96,priest,holy,12,1,11
Barryp,wyrmrest-accord,96,priest,holy,12,1,11
Djriest,sargeras,96,priest,holy,12,1,11
Whalexo,kelthuzad,84,priest,holy,17,4,13
Brownsnooter,sargeras,79,priest,holy,5,1,4
Helorren,nagrand,79,priest,holy,11,1,10
Wiralyn,nathrezim,79,priest,holy,11,1,10
Pûnishër,illidan,42,priest,holy,9,2,7
Èfflux,sargeras,2252,priest,discipline,97,56,41
Whammiez,tichondrius,2243,priest,discipline,84,50,34
Strickmaney,nathrezim,2237,priest,discipline,258,139,119
Yefri,ravencrest,2210,priest,discipline,107,65,42
Reedyjrrtv,tichondrius,2172,priest,discipline,95,53,42
Gentlewoman,ragnaros,2160,priest,discipline,81,50,31
Pesian,dalaran,2153,priest,discipline,233,121,112
Cinnamontage,illidan,2142,priest,discipline,114,64,50
Castsmite,tichondrius,2141,priest,discipline,99,52,47
Undrcvr,sargeras,2140,priest,discipline,90,47,43
Shikinomi,illidan,2133,priest,discipline,78,46,32
Wcnmb,blackrock,2123,priest,discipline,72,46,26
Jiangfeng,tichondrius,2120,priest,discipline,72,37,35
Celestiah,kelthuzad,2119,priest,discipline,72,37,35
Nusrah,tichondrius,2114,priest,discipline,87,45,42
Frksake,area-52,2111,priest,discipline,192,114,78
Sÿnpriest,illidan,2111,priest,discipline,384,193,191
Kovulol,area-52,2107,priest,discipline,126,67,59
Néylo,illidan,2106,priest,discipline,112,56,56
Psyches,dalaran,2106,priest,discipline,109,50,59
Woolp,frostmourne,2102,priest,discipline,100,58,42
Changwongpk,kelthuzad,2101,priest,discipline,237,124,113
Søryn,madoran,2100,priest,discipline,102,52,50
Bholebender,tichondrius,2085,priest,discipline,89,47,42
Classmaster,stormrage,2082,priest,discipline,159,90,69
Ante,stonemaul,2075,priest,discipline,108,59,49
Zxxkawaii,tichondrius,2075,priest,discipline,163,85,78
Kkelly,stormrage,2053,priest,discipline,250,126,124
Esqueue,illidan,2044,priest,discipline,54,26,28
Lemonmint,tichondrius,2040,priest,discipline,94,46,48
Shazdo,illidan,2039,priest,discipline,60,39,21
Twocrshort,area-52,2037,priest,discipline,125,78,47
Baldzx,sargeras,2034,priest,discipline,221,121,100
Instoway,illidan,2029,priest,discipline,150,89,61
Pancakeboi,tichondrius,2028,priest,discipline,101,47,54
Crutched,blackhand,2022,priest,discipline,60,35,25
Zámmy,area-52,2021,priest,discipline,65,44,21
Redonkulos,shattered-hand,2021,priest,discipline,162,85,77
Idkmyname,proudmoore,2018,priest,discipline,58,29,29
Proxs,sargeras,2017,priest,discipline,213,108,105
Blessxo,ragnaros,2016,priest,discipline,96,45,51
Rmpmeeper,kilrogg,2013,priest,discipline,60,35,25
Smokezter,area-52,2013,priest,discipline,135,70,65
Cosmicyiff,area-52,2010,priest,discipline,100,57,43
Stepxo,sargeras,2005,priest,discipline,105,59,46
Reilacoste,moon-guard,2002,priest,discipline,83,41,42
Rukiyou,frostwolf,1997,priest,discipline,108,50,58
Xajen,illidan,1996,priest,discipline,84,39,45
Eluneslight,tichondrius,1990,priest,discipline,78,40,38
Markers,spinebreaker,1989,priest,discipline,130,64,66
Mauvex,stormrage,1986,priest,discipline,476,233,243
Boykoz,zuljin,1982,priest,discipline,91,48,43
Crabsp,illidan,1981,priest,discipline,132,68,64
Crutch,blackhand,1980,priest,discipline,54,30,24
Praemal,tichondrius,1980,priest,discipline,96,42,54
Dayx,malganis,1974,priest,discipline,90,45,45
Sonicboomsz,azralon,1973,priest,discipline,116,59,57
Poporeborn,tichondrius,1973,priest,discipline,183,91,92
Amine,tichondrius,1970,priest,discipline,60,34,26
Azzäm,tichondrius,1970,priest,discipline,90,48,42
Astüty,illidan,1967,priest,discipline,66,37,29
Supaflute,tichondrius,1967,priest,discipline,72,32,40
Clearclouds,tichondrius,1964,priest,discipline,180,97,83
Abepriest,zuljin,1964,priest,discipline,204,106,98
Praitne,tichondrius,1963,priest,discipline,113,59,54
Leorid,stormrage,1963,priest,discipline,148,71,77
Aratis,bleeding-hollow,1961,priest,discipline,90,44,46
Etharass,illidan,1960,priest,discipline,78,34,44
Veivei,tichondrius,1959,priest,discipline,47,31,16
Hospetal,tichondrius,1955,priest,discipline,146,74,72
Awàken,sargeras,1952,priest,discipline,57,35,22
Iilmama,area-52,1948,priest,discipline,105,55,50
Gotdro,kelthuzad,1942,priest,discipline,68,36,32
Mimikyú,tichondrius,1941,priest,discipline,96,41,55
Gosharbg,tichondrius,1940,priest,discipline,34,24,10
Devinere,tichondrius,1940,priest,discipline,336,185,151
Sarkozzlol,tichondrius,1938,priest,discipline,84,43,41
Goodlife,frostmourne,1936,priest,discipline,65,30,35
Quaree,stormrage,1935,priest,discipline,501,258,243
Ccgo,tichondrius,1933,priest,discipline,84,42,42
Plaedo,stormscale,1932,priest,discipline,52,28,24
Fádé,illidan,1932,priest,discipline,97,48,49
Namilol,tichondrius,1931,priest,discipline,54,30,24
Budings,tichondrius,1927,priest,discipline,143,77,66
Diabloluckie,tichondrius,1926,priest,discipline,96,50,46
Curachon,darkspear,1926,priest,discipline,93,42,51
Indiglo,arthas,1925,priest,discipline,60,37,23
Fannyny,tichondrius,1924,priest,discipline,102,66,36
Invincible,ragnaros,1924,priest,discipline,80,45,35
Balsak,zuljin,1924,priest,discipline,152,72,80
Solecíto,ragnaros,1923,priest,discipline,77,53,24
Vinnydiesel,tichondrius,1918,priest,discipline,66,32,34
Hamstip,sargeras,1915,priest,discipline,72,46,26
Thefiveoh,malganis,1914,priest,discipline,27,23,4
Muhfinx,tichondrius,1911,priest,discipline,47,27,20
Artíst,sargeras,1911,priest,discipline,119,64,55
Varenon,stormrage,1910,priest,discipline,159,90,69
Penanceperry,bleeding-hollow,1910,priest,discipline,191,88,103
Lovelike,tichondrius,1907,priest,discipline,63,36,27
Velftrixi,sargeras,1907,priest,discipline,168,87,81
Omhz,tichondrius,1905,priest,discipline,96,49,47
Yanye,tichondrius,1902,priest,discipline,136,72,64
Riseandshine,illidan,1896,priest,discipline,54,38,16
Evicereith,ragnaros,1896,priest,discipline,42,25,17
Miamama,hydraxis,1896,priest,discipline,99,52,47
Adûnaic,frostmourne,1895,priest,discipline,272,134,138
Pølupoker,illidan,1895,priest,discipline,59,27,32
Capcana,tichondrius,1893,priest,discipline,90,50,40
Boriz,frostmourne,1892,priest,discipline,79,44,35
Myles,alexstrasza,1891,priest,discipline,52,32,20
Aitri,hakkar,1890,priest,discipline,85,41,44
Zerorizz,tichondrius,1890,priest,discipline,42,20,22
Ndzy,malganis,1890,priest,discipline,48,21,27
Haunting,nerzhul,1886,priest,discipline,209,103,106
Usefirstaid,sargeras,1883,priest,discipline,42,26,16
Wapriest,blades-edge,1883,priest,discipline,468,235,233
Frostinal,illidan,1882,priest,discipline,114,61,53
Khaoshealer,destromath,1882,priest,discipline,136,67,69
Abt,proudmoore,1882,priest,discipline,66,31,35
Usedwrap,sargeras,1881,priest,discipline,78,43,35
Throatgoated,moon-guard,1881,priest,discipline,47,21,26
Kck,sentinels,1880,priest,discipline,89,42,47
Cremona,tichondrius,1878,priest,discipline,84,39,45
Chee,bleeding-hollow,1875,priest,discipline,36,24,12
Sñ,illidan,1874,priest,discipline,48,27,21
Rileymcgerr,tichondrius,1873,priest,discipline,42,24,18
Praeyer,area-52,1873,priest,discipline,368,184,184
Exdric,kiljaeden,1873,priest,discipline,72,36,36
Mumrah,antonidas,1873,priest,discipline,113,56,57
Rawze,tichondrius,1873,priest,discipline,69,32,37
Dellaptop,sargeras,1871,priest,discipline,88,51,37
Nerfthedoc,blackrock,1869,priest,discipline,55,34,21
Reydehaiti,ragnaros,1869,priest,discipline,54,31,23
Montagehey,illidan,1868,priest,discipline,83,43,40
Lidoradra,zuljin,1867,priest,discipline,77,36,41
Notatk,tichondrius,1866,priest,discipline,221,99,122
Shallwedance,tichondrius,1864,priest,discipline,74,43,31
Candyshack,area-52,1863,priest,discipline,88,51,37
Spoõks,darkspear,1862,priest,discipline,141,69,72
Cokeheals,tichondrius,1861,priest,discipline,60,29,31
Bubblekanush,tichondrius,1859,priest,discipline,36,22,14
Reecepack,moon-guard,1859,priest,discipline,53,31,22
Athênå,tichondrius,1859,priest,discipline,186,106,80
Usebindwound,sargeras,1857,priest,discipline,108,65,43
Highskrizzle,thrall,1857,priest,discipline,67,37,30
Jjmms,akama,1857,priest,discipline,114,59,55
Duw,icecrown,1857,priest,discipline,151,75,76
Phludd,malganis,1856,priest,discipline,82,45,37
Ravnica,kelthuzad,1856,priest,discipline,82,43,39
Shadey,onyxia,1855,priest,discipline,54,26,28
Nayzoh,darkspear,1855,priest,discipline,78,37,41
Vidzar,area-52,1854,priest,discipline,42,28,14
Drsquiddy,tichondrius,1854,priest,discipline,47,30,17
Stayspooked,moon-guard,1852,priest,discipline,54,31,23
Jtheals,illidan,1852,priest,discipline,35,20,15
Vizzy,stormrage,1852,priest,discipline,90,48,42
Centalinkxo,frostmourne,1851,priest,discipline,72,36,36
Cardinaldave,frostmourne,1850,priest,discipline,48,26,22
Shieldspamx,tichondrius,1850,priest,discipline,89,41,48
Lumies,tichondrius,1848,priest,discipline,42,21,21
Bigshieldlol,illidan,1847,priest,discipline,60,39,21
Chromielol,tichondrius,1847,priest,discipline,54,31,23
Tzïñåçåñ,tichondrius,1847,priest,discipline,54,29,25
Voidnoodles,area-52,1846,priest,discipline,60,32,28
Cavityx,illidan,1844,priest,discipline,52,30,22
Dacine,illidan,1843,priest,discipline,60,30,30
Nickydamous,moon-guard,1843,priest,discipline,66,31,35
Jiangfenglol,tichondrius,1843,priest,discipline,54,24,30
Chk,moon-guard,1842,priest,discipline,106,51,55
Zelená,trollbane,1841,priest,discipline,128,77,51
Meoveryou,stormrage,1840,priest,discipline,86,47,39
Syliva,frostmourne,1840,priest,discipline,65,30,35
Hectorz,zuljin,1840,priest,discipline,64,29,35
Alisas,malganis,1840,priest,discipline,118,51,67
Donutpriest,kelthuzad,1839,priest,discipline,78,44,34
ßeyonder,tichondrius,1839,priest,discipline,96,44,52
Koalakazamza,shadow-council,1839,priest,discipline,62,28,34
Shamáng,tichondrius,1838,priest,discipline,62,33,29
Psyjes,stormrage,1837,priest,discipline,105,67,38
Tistapriest,proudmoore,1837,priest,discipline,70,41,29
Waggers,moon-guard,1837,priest,discipline,42,23,19
Lotion,icecrown,1837,priest,discipline,48,25,23
Fotmvark,stormrage,1837,priest,discipline,66,31,35
Binipriest,tichondrius,1835,priest,discipline,67,40,27
Jamino,jubeithos,1835,priest,discipline,111,60,51
Tmeugene,tichondrius,1835,priest,discipline,40,21,19
Bugweeb,sargeras,1834,priest,discipline,87,56,31
Layons,nemesis,1834,priest,discipline,134,86,48
Thottsteal,queldorei,1834,priest,discipline,60,31,29
Ameliarys,sargeras,1833,priest,discipline,103,51,52
Sons,zuljin,1832,priest,discipline,54,29,25
Oghealz,lightnings-blade,1832,priest,discipline,54,27,27
Mcgg,tichondrius,1832,priest,discipline,122,58,64
Cklifer,tichondrius,1831,priest,discipline,34,20,14
Msai,tichondrius,1830,priest,discipline,114,68,46
Strvnge,malganis,1830,priest,discipline,60,28,32
Joezyxz,tichondrius,1829,priest,discipline,133,67,66
Snackermz,tichondrius,1829,priest,discipline,77,32,45
Cpks,tichondrius,1828,priest,discipline,76,48,28
Baphomet,hyjal,1828,priest,discipline,88,53,35
Misatomori,tichondrius,1828,priest,discipline,54,28,26
Didy,dark-iron,1828,priest,discipline,58,27,31
Epitoh,bleeding-hollow,1828,priest,discipline,78,36,42
Sleetherp,barthilas,1827,priest,discipline,64,37,27
Meloxicamm,tichondrius,1827,priest,discipline,100,51,49
Fracxured,sargeras,1827,priest,discipline,68,31,37
Bloodyxx,bleeding-hollow,1825,priest,discipline,34,23,11
Buffle,zuluhed,1825,priest,discipline,66,38,28
Yokuz,thunderlord,1825,priest,discipline,48,26,22
Mackulate,tichondrius,1825,priest,discipline,65,34,31
Cokeheals,kelthuzad,1825,priest,discipline,54,28,26
Aprîl,quelthalas,1825,priest,discipline,72,37,35
Däzzlë,quelthalas,1825,priest,discipline,72,35,37
Pnsp,perenolde,1824,priest,discipline,42,30,12
Xholyshietz,emerald-dream,1824,priest,discipline,71,48,23
Pervysaged,sargeras,1824,priest,discipline,60,40,20
Anasuzana,stormrage,1824,priest,discipline,48,28,20
Cya,deathwing,1824,priest,discipline,54,30,24
Senzy,tichondrius,1824,priest,discipline,144,79,65
Mancito,mannoroth,1824,priest,discipline,144,74,70
Swurvexo,bleeding-hollow,1823,priest,discipline,47,28,19
Barthol,malygos,1823,priest,discipline,225,115,110
Sprankels,bleeding-hollow,1823,priest,discipline,108,55,53
Likethis,ragnaros,1823,priest,discipline,275,138,137
Luhkx,stormrage,1823,priest,discipline,54,25,29
Ohsop,chogall,1822,priest,discipline,49,33,16
Dairy,the-underbog,1822,priest,discipline,49,29,20
Memoria,emerald-dream,1822,priest,discipline,117,60,57
Zachon,sargeras,1822,priest,discipline,54,27,27
Oohso,chogall,1821,priest,discipline,91,43,48
Jerkingit,tichondrius,1821,priest,discipline,64,30,34
Ultrà,ragnaros,1820,priest,discipline,71,44,27
Wreklol,tichondrius,1820,priest,discipline,60,34,26
Dietcokee,stormrage,1820,priest,discipline,62,31,31
Ujelin,kiljaeden,1820,priest,discipline,48,24,24
Tophr,illidan,1819,priest,discipline,41,24,17
Soojwa,frostmourne,1819,priest,discipline,54,24,30
Novel,moon-guard,1817,priest,discipline,30,24,6
Gaudthree,tichondrius,1817,priest,discipline,46,25,21
Akuzaki,illidan,1817,priest,discipline,54,25,29
Sliktrik,area-52,1817,priest,discipline,65,29,36
Dapp,barthilas,1817,priest,discipline,77,33,44
Cynthus,dalvengyr,1816,priest,discipline,102,60,42
Lichtschreit,zuljin,1816,priest,discipline,41,24,17
Juicyturon,moon-guard,1816,priest,discipline,77,45,32
Dispassion,dalaran,1816,priest,discipline,58,33,25
Woodowl,tichondrius,1816,priest,discipline,46,25,21
Bamboon,tanaris,1816,priest,discipline,102,55,47
Jackski,nemesis,1816,priest,discipline,48,25,23
Badrapture,sargeras,1815,priest,discipline,92,69,23
Discopenguin,kelthuzad,1815,priest,discipline,54,30,24
Engle,arathor,1815,priest,discipline,42,22,20
Badnsweaty,sargeras,1815,priest,discipline,76,38,38
Ousïa,quelthalas,1815,priest,discipline,164,81,83
Mommyafk,moon-guard,1815,priest,discipline,54,25,29
Fullmetals,azralon,1814,priest,discipline,53,30,23
Zuwukey,kirin-tor,1814,priest,discipline,163,85,78
Tanmo,illidan,1814,priest,discipline,96,50,46
Syllè,area-52,1814,priest,discipline,48,24,24
Fibbre,tichondrius,1814,priest,discipline,121,54,67
Razdaz,twisting-nether,1814,priest,discipline,66,29,37
Relicx,firetree,1813,priest,discipline,54,33,21
Hoonjojjyang,tichondrius,1813,priest,discipline,66,37,29
Morboo,proudmoore,1813,priest,discipline,78,43,35
Svzy,illidan,1813,priest,discipline,48,26,22
Ritzzx,ragnaros,1813,priest,discipline,59,31,28
Sasha,muradin,1813,priest,discipline,142,70,72
Falsity,kelthuzad,1813,priest,discipline,66,32,34
Ahoy,sargeras,1812,priest,discipline,75,46,29
Abstention,area-52,1812,priest,discipline,66,35,31
Fatbellyx,sargeras,1812,priest,discipline,72,36,36
Faeleath,emerald-dream,1812,priest,discipline,56,27,29
Tyrrshadow,skywall,1811,priest,discipline,104,58,46
Tallïa,stormrage,1811,priest,discipline,155,82,73
Wübbie,emerald-dream,1810,priest,discipline,72,40,32
Paytin,illidan,1810,priest,discipline,71,32,39
Arguseonp,proudmoore,1809,priest,discipline,54,37,17
Ãbelladanger,area-52,1809,priest,discipline,65,43,22
Jemine,tichondrius,1809,priest,discipline,108,64,44
Thepumps,sargeras,1809,priest,discipline,73,43,30
Bkwhopper,emerald-dream,1809,priest,discipline,131,75,56
Paramour,laughing-skull,1809,priest,discipline,108,59,49
Fhinky,tichondrius,1809,priest,discipline,201,103,98
Jaquels,sargeras,1809,priest,discipline,130,65,65
Dabaojian,tichondrius,1809,priest,discipline,60,28,32
Aube,frostmourne,1809,priest,discipline,51,23,28
Antts,tichondrius,1808,priest,discipline,48,31,17
Tiestô,tichondrius,1808,priest,discipline,42,25,17
Vbear,dunemaul,1808,priest,discipline,71,39,32
Pkkdestiny,archimonde,1808,priest,discipline,71,37,34
Catbabyorz,tichondrius,1808,priest,discipline,84,41,43
Pns,perenolde,1808,priest,discipline,66,32,34
Oogs,tichondrius,1808,priest,discipline,65,27,38
Buhroketwo,thrall,1807,priest,discipline,66,41,25
Dopeypriest,area-52,1807,priest,discipline,120,68,52
Gices,area-52,1806,priest,discipline,36,24,12
Ayakashi,frostmourne,1806,priest,discipline,75,46,29
Wormface,moon-guard,1806,priest,discipline,58,35,23
Releriel,area-52,1806,priest,discipline,58,31,27
Inthemix,stormreaver,1806,priest,discipline,376,197,179
Yezhua,zuljin,1806,priest,discipline,84,44,40
Purplebeauty,tichondrius,1805,priest,discipline,198,119,79
Leapofdoubt,zuljin,1805,priest,discipline,250,132,118
Rylla,illidan,1805,priest,discipline,66,34,32
Öxhö,tichondrius,1804,priest,discipline,44,31,13
Ðsco,tichondrius,1804,priest,discipline,36,24,12
Absorbs,stormrage,1804,priest,discipline,30,19,11
Fearmen,tichondrius,1804,priest,discipline,59,33,26
Reignen,tichondrius,1804,priest,discipline,165,92,73
Selath,ragnaros,1804,priest,discipline,47,26,21
Angelumlucis,frostmane,1804,priest,discipline,145,80,65
Syrillia,wildhammer,1804,priest,discipline,142,78,64
Astroverse,tichondrius,1804,priest,discipline,52,28,24
Temérios,azralon,1804,priest,discipline,48,24,24
Cln,bleeding-hollow,1804,priest,discipline,65,32,33
Thaldrum,tichondrius,1804,priest,discipline,79,30,49
Curney,stormrage,1803,priest,discipline,65,46,19
Jinais,zuluhed,1803,priest,discipline,48,33,15
Phillthevoid,sargeras,1803,priest,discipline,45,29,16
Applecare,illidan,1803,priest,discipline,102,60,42
Tarlex,illidan,1803,priest,discipline,168,94,74
Goldsunx,emerald-dream,1803,priest,discipline,152,85,67
Cbalnom,tichondrius,1803,priest,discipline,70,37,33
Manyhot,tichondrius,1802,priest,discipline,51,32,19
Yrñwiotøø,illidan,1802,priest,discipline,54,33,21
Seifong,frostmourne,1802,priest,discipline,125,68,57
Retardèr,tichondrius,1801,priest,discipline,97,68,29
Reverendtun,area-52,1801,priest,discipline,83,55,28
Vànhendrix,tichondrius,1801,priest,discipline,53,29,24
Wânda,tichondrius,1801,priest,discipline,111,57,54
Cupitan,tichondrius,1801,priest,discipline,50,22,28
Bigmomcook,tichondrius,1800,priest,discipline,215,125,90
Imissdave,dethecus,1800,priest,discipline,48,27,21
Narakku,sargeras,1800,priest,discipline,108,59,49
Bwgyx,area-52,1800,priest,discipline,42,22,20
Louisé,hydraxis,1800,priest,discipline,42,22,20
Bibleblak,stormrage,1800,priest,discipline,102,53,49
Alola,illidan,1800,priest,discipline,135,69,66
Anyra,stormrage,1799,priest,discipline,51,26,25
Bomí,tichondrius,1799,priest,discipline,84,41,43
Olark,durotan,1799,priest,discipline,286,139,147
Fearinoculúm,bleeding-hollow,1798,priest,discipline,24,19,5
Mimz,trollbane,1798,priest,discipline,48,24,24
Comebaack,stormrage,1797,priest,discipline,98,51,47
Celestiah,illidan,1796,priest,discipline,54,28,26
Impvp,tichondrius,1795,priest,discipline,89,49,40
Deathtones,barthilas,1793,priest,discipline,131,72,59
Valothrian,area-52,1791,priest,discipline,148,78,70
Wormclergy,tichondrius,1791,priest,discipline,80,39,41
Neverbeen,tichondrius,1790,priest,discipline,347,189,158
Shnozberry,tichondrius,1790,priest,discipline,102,43,59
Bublehead,zuljin,1789,priest,discipline,114,56,58
Xiaoqunzi,tichondrius,1787,priest,discipline,36,22,14
Analogxz,nemesis,1787,priest,discipline,138,68,70
Euphorz,tichondrius,1786,priest,discipline,36,19,17
Tiernocookie,illidan,1786,priest,discipline,323,162,161
Osis,rivendare,1786,priest,discipline,135,66,69
Hadoka,ragnaros,1786,priest,discipline,54,23,31
Tmversace,tichondrius,1781,priest,discipline,112,56,56
Usedmedkit,sargeras,1780,priest,discipline,47,28,19
Vaaynee,ragnaros,1780,priest,discipline,108,57,51
Discflips,dalaran,1779,priest,discipline,210,106,104
Wandynha,nemesis,1776,priest,discipline,59,32,27
Deathlullaby,malganis,1775,priest,discipline,42,21,21
Isilador,moon-guard,1775,priest,discipline,95,44,51
Legendary,ragnaros,1775,priest,discipline,72,30,42
Pesca,proudmoore,1774,priest,discipline,125,59,66
Compxx,barthilas,1772,priest,discipline,48,30,18
Jezebëll,nemesis,1772,priest,discipline,186,98,88
Zins,emerald-dream,1771,priest,discipline,72,34,38
Nohéalforu,stormrage,1770,priest,discipline,47,25,22
Canibumsmoke,illidan,1769,priest,discipline,69,37,32
Auxp,tichondrius,1769,priest,discipline,59,23,36
Dannycarrier,tichondrius,1768,priest,discipline,30,21,9
Rlzpriest,tichondrius,1768,priest,discipline,107,56,51
Írithyll,stormrage,1767,priest,discipline,59,33,26
Pibkac,stormrage,1767,priest,discipline,69,34,35
Breakmoon,tichondrius,1767,priest,discipline,66,27,39
Sebpriest,proudmoore,1764,priest,discipline,42,20,22
Ragretsxo,darkspear,1763,priest,discipline,78,41,37
Deadpriesst,arthas,1763,priest,discipline,72,36,36
Qipriest,tichondrius,1763,priest,discipline,54,19,35
Hugemilkys,tichondrius,1762,priest,discipline,85,46,39
Pnub,aggramar,1762,priest,discipline,75,37,38
Hotgirlshiit,dalaran,1762,priest,discipline,286,137,149
Gochuxx,tichondrius,1761,priest,discipline,66,34,32
Youhealme,area-52,1759,priest,discipline,48,31,17
Raysx,stormrage,1759,priest,discipline,83,37,46
Kaddy,mannoroth,1757,priest,discipline,130,60,70
Demaholy,illidan,1755,priest,discipline,107,56,51
Papabrokuttv,sargeras,1755,priest,discipline,42,19,23
Jaytee,aggramar,1754,priest,discipline,72,33,39
Inquisitionx,frostmourne,1753,priest,discipline,164,93,71
Stoneflute,emerald-dream,1752,priest,discipline,130,78,52
Healum,nemesis,1752,priest,discipline,78,45,33
Quèénstar,tichondrius,1752,priest,discipline,73,29,44
Corvenna,zuljin,1751,priest,discipline,48,27,21
Høwtokill,azralon,1750,priest,discipline,71,24,47
Chiot,tichondrius,1748,priest,discipline,55,42,13
Raizy,stormrage,1748,priest,discipline,53,26,27
Ferguss,ragnaros,1747,priest,discipline,79,42,37
Grimacê,sargeras,1747,priest,discipline,62,29,33
Klydasoreass,malganis,1745,priest,discipline,42,26,16
Alarin,whisperwind,1745,priest,discipline,60,30,30
Ninbara,tichondrius,1745,priest,discipline,59,27,32
Onikûdaki,sargeras,1744,priest,discipline,53,24,29
Evilear,tichondrius,1743,priest,discipline,54,25,29
Natoshi,illidan,1742,priest,discipline,48,25,23
Qtasiangirl,emerald-dream,1742,priest,discipline,85,38,47
Shadheda,andorhal,1738,priest,discipline,56,26,30
Paidtowin,frostmourne,1738,priest,discipline,56,21,35
Orderic,ragnaros,1736,priest,discipline,57,32,25
Marcìano,bleeding-hollow,1736,priest,discipline,64,35,29
Cursèlol,tichondrius,1736,priest,discipline,66,33,33
Pgpriest,kelthuzad,1736,priest,discipline,84,41,43
Kostantina,kelthuzad,1736,priest,discipline,130,58,72
Kelthax,sargeras,1736,priest,discipline,54,23,31
Niark,frostmourne,1736,priest,discipline,48,20,28
Luwoona,tichondrius,1735,priest,discipline,54,23,31
Maybedead,tichondrius,1734,priest,discipline,42,26,16
Obscure,malygos,1734,priest,discipline,74,32,42
Toastspriest,tichondrius,1733,priest,discipline,83,51,32
Trebrooke,sargeras,1732,priest,discipline,155,86,69
Sinday,zuljin,1732,priest,discipline,60,29,31
Nyluh,deathwing,1731,priest,discipline,56,29,27
Saelom,frostmourne,1730,priest,discipline,78,49,29
Murth,laughing-skull,1729,priest,discipline,47,30,17
Vandamnation,barthilas,1729,priest,discipline,104,51,53
Airelia,sargeras,1728,priest,discipline,54,28,26
Kabugi,illidan,1727,priest,discipline,78,41,37
Åpples,tichondrius,1727,priest,discipline,71,31,40
Apoorstudent,tichondrius,1726,priest,discipline,116,72,44
Mxfd,tichondrius,1726,priest,discipline,47,27,20
Dévore,dalaran,1726,priest,discipline,46,25,21
Cody,magtheridon,1725,priest,discipline,54,40,14
Conifer,emerald-dream,1725,priest,discipline,60,35,25
Holyhõ,stormrage,1725,priest,discipline,48,27,21
Heart,misha,1725,priest,discipline,120,66,54
Dontlineme,tichondrius,1723,priest,discipline,142,64,78
Xtcbtc,sargeras,1723,priest,discipline,69,30,39
Xidis,vashj,1723,priest,discipline,71,29,42
Sobamian,tichondrius,1723,priest,discipline,90,36,54
Mååxxee,zuljin,1722,priest,discipline,30,18,12
Zaryx,wildhammer,1722,priest,discipline,42,24,18
Änanti,tichondrius,1722,priest,discipline,54,29,25
Vegetable,suramar,1722,priest,discipline,36,18,18
Philmacrakn,stormrage,1721,priest,discipline,167,81,86
Mindseye,azgalor,1721,priest,discipline,102,48,54
Leticia,magtheridon,1719,priest,discipline,100,48,52
Jexso,tichondrius,1719,priest,discipline,163,78,85
Opriest,queldorei,1718,priest,discipline,54,27,27
Ooit,tichondrius,1717,priest,discipline,24,22,2
Eetsqt,barthilas,1717,priest,discipline,108,70,38
Stinkiez,area-52,1717,priest,discipline,70,36,34
Priceléss,tichondrius,1715,priest,discipline,24,18,6
Woobgasm,sargeras,1715,priest,discipline,72,46,26
Barthbelro,kiljaeden,1714,priest,discipline,69,40,29
Kragenn,malganis,1713,priest,discipline,165,83,82
Deathwisher,illidan,1712,priest,discipline,54,28,26
Ukishizumi,tichondrius,1712,priest,discipline,131,67,64
Kastep,tichondrius,1712,priest,discipline,88,44,44
Smitelytius,tichondrius,1711,priest,discipline,30,18,12
Touchrr,tichondrius,1710,priest,discipline,108,58,50
Veejae,tichondrius,1710,priest,discipline,42,22,20
Størmy,kiljaeden,1709,priest,discipline,240,131,109
Dorgondra,wyrmrest-accord,1709,priest,discipline,48,26,22
Dippyboi,whisperwind,1709,priest,discipline,48,25,23
Meltmeltz,nerzhul,1708,priest,discipline,65,29,36
Selenitax,sargeras,1707,priest,discipline,68,30,38
Asthenia,saurfang,1706,priest,discipline,120,59,61
Sarïya,moon-guard,1706,priest,discipline,125,61,64
Sodezz,stormrage,1705,priest,discipline,36,21,15
Memoriesorz,tichondrius,1705,priest,discipline,214,119,95
Forti,sargeras,1705,priest,discipline,156,74,82
Squaanchy,bleeding-hollow,1705,priest,discipline,129,61,68
Bellaelle,stormrage,1704,priest,discipline,42,22,20
Nightcráwler,illidan,1702,priest,discipline,89,47,42
Bennito,moon-guard,1701,priest,discipline,72,30,42
Bisholan,frostwolf,1700,priest,discipline,63,31,32
Tanzen,andorhal,1699,priest,discipline,36,21,15
Beowulfy,stormrage,1699,priest,discipline,48,27,21
Holyster,tichondrius,1699,priest,discipline,38,18,20
Gibens,tichondrius,1698,priest,discipline,124,63,61
Séxgodx,tichondrius,1698,priest,discipline,53,24,29
Clydeington,illidan,1697,priest,discipline,49,29,20
Taipriest,frostmourne,1697,priest,discipline,198,87,111
Saviorlol,tichondrius,1697,priest,discipline,53,23,30
Mixful,bleeding-hollow,1696,priest,discipline,40,27,13
Vcainyfairy,stormrage,1696,priest,discipline,290,148,142
Nickzx,tichondrius,1694,priest,discipline,52,36,16
Adrio,malorne,1694,priest,discipline,224,109,115
Geon,sargeras,1693,priest,discipline,107,53,54
Catonement,moon-guard,1693,priest,discipline,430,208,222
Veiveilol,tichondrius,1693,priest,discipline,59,24,35
Acpriest,tichondrius,1692,priest,discipline,87,46,41
Bosspriest,tichondrius,1691,priest,discipline,48,23,25
Jimmythedon,mugthol,1691,priest,discipline,48,22,26
Elilium,tichondrius,1690,priest,discipline,74,46,28
Pigogo,tichondrius,1690,priest,discipline,45,26,19
Rythmzz,kiljaeden,1690,priest,discipline,60,30,30
Highprofile,proudmoore,1690,priest,discipline,36,18,18
Nxghtmares,tichondrius,1690,priest,discipline,360,175,185
Rotbaron,bleeding-hollow,1690,priest,discipline,84,35,49
Blasphêmy,malganis,1689,priest,discipline,68,42,26
Mastaspell,illidan,1689,priest,discipline,31,18,13
Elybele,sargeras,1689,priest,discipline,114,61,53
Leonilcx,tichondrius,1689,priest,discipline,481,238,243
Kujox,tichondrius,1689,priest,discipline,47,20,27
Yobell,tichondrius,1688,priest,discipline,36,23,13
Argylemomo,emerald-dream,1688,priest,discipline,202,103,99
Probs,frostmourne,1688,priest,discipline,112,57,55
Whalexo,kelthuzad,1688,priest,discipline,89,45,44
Sweetnipsbro,tichondrius,1688,priest,discipline,71,35,36
Luciuz,tichondrius,1688,priest,discipline,55,25,30
Cayleey,stormrage,1687,priest,discipline,66,29,37
Mygameslaggy,area-52,1687,priest,discipline,72,29,43
Twopiece,blackrock,1683,priest,discipline,30,18,12
Bfts,illidan,1682,priest,discipline,126,67,59
Wildsmite,hyjal,1682,priest,discipline,216,99,117
Shrimpouh,illidan,1681,priest,discipline,54,31,23
Plaguebaby,stormrage,1681,priest,discipline,45,23,22
Ieveling,skywall,1681,priest,discipline,65,30,35
Justafkoutpr,gorefiend,1680,priest,discipline,30,23,7
Lingdums,tichondrius,1680,priest,discipline,31,18,13
Caveria,emerald-dream,1679,priest,discipline,72,39,33
Poosydoodlez,malganis,1679,priest,discipline,105,48,57
Rámmstein,wyrmrest-accord,1678,priest,discipline,120,65,55
Nabukom,destromath,1678,priest,discipline,52,25,27
Danceslol,area-52,1678,priest,discipline,42,20,22
Holyfall,sargeras,1676,priest,discipline,220,116,104
Mintadnade,nemesis,1676,priest,discipline,119,60,59
Fordranger,frostmourne,1676,priest,discipline,40,20,20
Mcfref,tichondrius,1675,priest,discipline,93,50,43
Bacpack,area-52,1675,priest,discipline,125,66,59
Bonehead,warsong,1675,priest,discipline,48,23,25
Bonigan,sargeras,1673,priest,discipline,101,64,37
Hanley,tichondrius,1673,priest,discipline,79,46,33
Jammeslight,quelthalas,1673,priest,discipline,124,67,57
Merit,emerald-dream,1672,priest,discipline,144,76,68
Aco,tichondrius,1672,priest,discipline,150,79,71
Claverr,stormrage,1670,priest,discipline,33,20,13
Serakiki,nemesis,1670,priest,discipline,72,41,31
Playsoon,illidan,1669,priest,discipline,114,64,50
Holécriss,tichondrius,1669,priest,discipline,125,68,57
Vampirê,tichondrius,1669,priest,discipline,48,24,24
Kagemetsu,sargeras,1669,priest,discipline,152,74,78
Boostedpi,tichondrius,1669,priest,discipline,44,21,23
Jmlz,tichondrius,1668,priest,discipline,36,23,13
Alomari,zuljin,1668,priest,discipline,32,19,13
Oyy,barthilas,1668,priest,discipline,48,24,24
Klitarus,barthilas,1668,priest,discipline,48,23,25
Wonpaipri,frostmourne,1667,priest,discipline,65,31,34
Nelpesh,tichondrius,1666,priest,discipline,60,27,33
Crysknife,korgath,1664,priest,discipline,35,20,15
Buhroke,thrall,1663,priest,discipline,33,19,14
Skunkbishop,sargeras,1663,priest,discipline,185,86,99
Shocklol,stormrage,1662,priest,discipline,29,22,7
Apathist,sargeras,1662,priest,discipline,66,44,22
Hallucinogen,kelthuzad,1662,priest,discipline,95,51,44
Hideonlight,barthilas,1662,priest,discipline,400,205,195
Fisp,moon-guard,1661,priest,discipline,72,33,39
Resisted,gorefiend,1660,priest,discipline,238,120,118
Sanddglokta,tichondrius,1658,priest,discipline,210,102,108
Yunnan,executus,1657,priest,discipline,78,43,35
Caveron,tichondrius,1657,priest,discipline,42,23,19
Geekynerd,frostmourne,1656,priest,discipline,80,57,23
Syo,dreadmaul,1656,priest,discipline,95,48,47
Toopriestly,deathwing,1656,priest,discipline,65,32,33
Silkydeath,frostmourne,1655,priest,discipline,42,24,18
Theravus,moon-guard,1655,priest,discipline,124,67,57
Arianagrande,garona,1654,priest,discipline,89,48,41
Darknuz,sargeras,1654,priest,discipline,53,27,26
Perceptions,dalaran,1653,priest,discipline,36,23,13
Kathere,tichondrius,1653,priest,discipline,42,23,19
Zunitpriest,laughing-skull,1653,priest,discipline,36,18,18
Dpendant,frostmourne,1653,priest,discipline,66,31,35
Vtp,frostmourne,1652,priest,discipline,70,40,30
Glassbirds,stormrage,1652,priest,discipline,48,25,23
Vanderbeek,frostmourne,1651,priest,discipline,66,33,33
Somefire,proudmoore,1650,priest,discipline,155,78,77
Ixchelune,kelthuzad,1649,priest,discipline,237,119,118
Bloodyx,bleeding-hollow,1649,priest,discipline,118,56,62
Nopang,tichondrius,1649,priest,discipline,167,77,90
Chañing,frostmourne,1649,priest,discipline,72,33,39
Andreslol,sargeras,1648,priest,discipline,36,21,15
Tanthsondis,illidan,1648,priest,discipline,48,27,21
Cixelpvp,area-52,1648,priest,discipline,47,22,25
Deadpla,ragnaros,1648,priest,discipline,83,36,47
Krewesin,ravencrest,1647,priest,discipline,43,22,21
Lòthnalar,ragnaros,1647,priest,discipline,60,29,31
Synsparks,tichondrius,1647,priest,discipline,60,25,35
Supôrte,nemesis,1646,priest,discipline,53,33,20
Klttzz,sargeras,1646,priest,discipline,60,32,28
Rosaparksxo,sargeras,1645,priest,discipline,70,35,35
Cavatea,illidan,1645,priest,discipline,42,21,21
Döllyy,illidan,1645,priest,discipline,42,21,21
Deathallpoly,tichondrius,1644,priest,discipline,246,127,119
Honeyduutch,black-dragonflight,1644,priest,discipline,72,37,35
Barrenbuffet,zuljin,1644,priest,discipline,44,22,22
Pawnza,tichondrius,1644,priest,discipline,72,34,38
Scab,anetheron,1644,priest,discipline,106,49,57
Beelzebul,illidan,1644,priest,discipline,60,26,34
Toddmund,tichondrius,1644,priest,discipline,64,25,39
Despairx,tichondrius,1642,priest,discipline,54,35,19
Ÿsk,tichondrius,1642,priest,discipline,84,47,37
Kuell,ragnaros,1642,priest,discipline,53,29,24
Selfless,barthilas,1642,priest,discipline,60,26,34
Reiae,malganis,1642,priest,discipline,70,27,43
Googolplex,tichondrius,1640,priest,discipline,51,36,15
Lolcrafthd,ragnaros,1640,priest,discipline,64,36,28
Alguîen,ragnaros,1640,priest,discipline,115,61,54
Noted,aegwynn,1639,priest,discipline,68,44,24
Randompreest,stormrage,1639,priest,discipline,42,23,19
Aetyn,tichondrius,1638,priest,discipline,55,31,24
Lunarina,hyjal,1638,priest,discipline,167,75,92
Marejaynez,tichondrius,1638,priest,discipline,111,48,63
Bigsmart,tichondrius,1637,priest,discipline,44,22,22
Yaz,emerald-dream,1637,priest,discipline,47,23,24
Evvylou,stormrage,1637,priest,discipline,42,19,23
Onineko,bleeding-hollow,1636,priest,discipline,46,25,21
Hungrybone,proudmoore,1636,priest,discipline,526,262,264
Ketapriest,frostmourne,1636,priest,discipline,136,67,69
Oopsy,bleeding-hollow,1636,priest,discipline,48,23,25
Rmx,illidan,1635,priest,discipline,35,18,17
Grizzlysmite,stormrage,1635,priest,discipline,343,168,175
Mangolatte,frostmourne,1634,priest,discipline,55,41,14
Ngin,queldorei,1634,priest,discipline,36,21,15
Sêlbus,stormrage,1634,priest,discipline,179,95,84
Beejaex,stormreaver,1634,priest,discipline,48,22,26
Narodiz,nemesis,1633,priest,discipline,42,23,19
Huxleypoo,boulderfist,1633,priest,discipline,42,22,20
Mclyte,whisperwind,1633,priest,discipline,149,77,72
Jâmïè,gurubashi,1632,priest,discipline,41,31,10
Persimmons,lightbringer,1632,priest,discipline,87,46,41
Antagzy,bleeding-hollow,1631,priest,discipline,54,33,21
Discgoddess,proudmoore,1631,priest,discipline,103,54,49
Chewey,tichondrius,1631,priest,discipline,48,23,25
Gödtier,frostwolf,1631,priest,discipline,42,18,24
Meip,illidan,1630,priest,discipline,24,17,7
Skadín,stormrage,1630,priest,discipline,155,92,63
Jennyle,sargeras,1630,priest,discipline,48,26,22
Bluecho,tichondrius,1629,priest,discipline,48,25,23
Shastea,crushridge,1629,priest,discipline,58,30,28
Powerwordwap,malganis,1629,priest,discipline,53,23,30
Bustit,azgalor,1628,priest,discipline,52,28,24
Stepsistér,ragnaros,1628,priest,discipline,36,19,17
Kazgry,illidan,1628,priest,discipline,42,22,20
Ayabae,illidan,1628,priest,discipline,638,313,325
Twêet,frostmourne,1628,priest,discipline,162,72,90
Hootheals,illidan,1627,priest,discipline,34,21,13
Çammy,frostmourne,1626,priest,discipline,24,17,7
Andrew,sargeras,1626,priest,discipline,30,20,10
Discavow,bleeding-hollow,1626,priest,discipline,51,31,20
Luthiene,area-52,1626,priest,discipline,174,99,75
Brothercarl,stormrage,1626,priest,discipline,95,51,44
Raxekk,stormrage,1626,priest,discipline,48,25,23
Slickwilly,bloodhoof,1626,priest,discipline,257,125,132
Psycozis,hyjal,1625,priest,discipline,262,138,124
Yeeseafood,tichondrius,1625,priest,discipline,36,17,19
Peelforheals,nordrassil,1625,priest,discipline,48,21,27
Jatral,azralon,1625,priest,discipline,53,23,30
Amberturd,cenarius,1625,priest,discipline,54,20,34
Vinvictus,tichondrius,1624,priest,discipline,225,108,117
Ussmissouri,area-52,1624,priest,discipline,141,63,78
Incisions,moon-guard,1623,priest,discipline,84,49,35
Caesus,sargeras,1623,priest,discipline,124,70,54
Illuminare,sargeras,1623,priest,discipline,154,82,72
Gamist,area-52,1623,priest,discipline,132,70,62
Chookspriest,tichondrius,1623,priest,discipline,74,37,37
Liteztvp,tichondrius,1623,priest,discipline,150,68,82
Dream,kelthuzad,1622,priest,discipline,30,17,13
Wickedpriest,malganis,1622,priest,discipline,54,25,29
Kûrtt,azralon,1622,priest,discipline,42,19,23
Sätîvá,tichondrius,1621,priest,discipline,38,20,18
Vsat,illidan,1621,priest,discipline,48,23,25
Tammyone,emerald-dream,1620,priest,discipline,66,42,24
Pigro,area-52,1620,priest,discipline,30,19,11
Samirah,arthas,1620,priest,discipline,36,20,16
Halfcutt,tichondrius,1620,priest,discipline,48,23,25
Dolm,tichondrius,1619,priest,discipline,190,99,91
Baddmachine,illidan,1619,priest,discipline,47,21,26
Iyoui,tichondrius,1618,priest,discipline,24,17,7
Rigxy,arthas,1618,priest,discipline,51,35,16
Archìtects,wyrmrest-accord,1618,priest,discipline,42,25,17
Timbobaloo,thrall,1618,priest,discipline,58,33,25
Syrul,tichondrius,1618,priest,discipline,63,34,29
Esciel,ragnaros,1618,priest,discipline,72,32,40
Punisherror,area-52,1618,priest,discipline,52,22,30
Astrøpriest,tichondrius,1618,priest,discipline,54,22,32
Jmr,onyxia,1617,priest,discipline,24,17,7
Khathor,kargath,1617,priest,discipline,30,17,13
Gurlyounasty,khazgoroth,1617,priest,discipline,103,55,48
Trollpreist,tichondrius,1617,priest,discipline,106,53,53
Prayussy,tichondrius,1616,priest,discipline,135,72,63
Hoshx,sargeras,1615,priest,discipline,66,40,26
Kraamur,area-52,1615,priest,discipline,96,57,39
Jîtters,silvermoon,1615,priest,discipline,84,45,39
Downturn,tichondrius,1615,priest,discipline,36,17,19
Catbabyeah,tichondrius,1614,priest,discipline,36,26,10
Buchöna,quelthalas,1614,priest,discipline,77,41,36
Zymmie,moon-guard,1614,priest,discipline,78,34,44
Iovedoctor,tichondrius,1614,priest,discipline,78,25,53
Sâsh,stormrage,1613,priest,discipline,72,40,32
Nolar,shadowmoon,1613,priest,discipline,36,20,16
Mudshadow,tichondrius,1613,priest,discipline,97,53,44
Aåurøra,stormrage,1613,priest,discipline,46,23,23
ßðßßÿ,area-52,1613,priest,discipline,42,21,21
Onezor,frostmourne,1612,priest,discipline,66,34,32
Kks,tichondrius,1612,priest,discipline,90,46,44
Shrax,emerald-dream,1612,priest,discipline,132,64,68
Gsek,nemesis,1611,priest,discipline,36,23,13
Scruge,frostmourne,1611,priest,discipline,55,32,23
Slumpbusterx,bonechewer,1611,priest,discipline,67,36,31
Vincejddp,zuljin,1611,priest,discipline,199,105,94
Haill,quelthalas,1611,priest,discipline,76,38,38
Shadoris,antonidas,1611,priest,discipline,48,23,25
Cinsare,moon-guard,1610,priest,discipline,84,49,35
Swagraptor,stormreaver,1610,priest,discipline,98,54,44
Blathers,malganis,1610,priest,discipline,92,48,44
Interworld,illidan,1610,priest,discipline,50,24,26
Mortteus,agamaggan,1610,priest,discipline,60,28,32
Pleasant,dathremar,1610,priest,discipline,123,52,71
Valeilah,illidan,1609,priest,discipline,102,68,34
Ryno,cenarion-circle,1609,priest,discipline,38,20,18
Fõrcedtowipe,tichondrius,1609,priest,discipline,180,93,87
Gsek,azralon,1608,priest,discipline,54,34,20
Wrekkit,area-52,1608,priest,discipline,84,42,42
Dawgshiz,tichondrius,1608,priest,discipline,40,20,20
Reginaa,nemesis,1608,priest,discipline,65,30,35
Buttfive,illidan,1608,priest,discipline,58,24,34
Exøtic,tichondrius,1607,priest,discipline,30,21,9
Indigojuly,sargeras,1607,priest,discipline,52,31,21
Milkkz,zuljin,1607,priest,discipline,36,20,16
Swartzp,tichondrius,1607,priest,discipline,104,55,49
Darknus,sargeras,1607,priest,discipline,78,37,41
Ggsaurusrex,area-52,1607,priest,discipline,36,17,19
Teewat,illidan,1606,priest,discipline,42,23,19
Kazuret,ragnaros,1606,priest,discipline,242,125,117
Lovesy,burning-legion,1606,priest,discipline,60,30,30
Luciellis,sargeras,1606,priest,discipline,48,23,25
Darkispriest,tichondrius,1606,priest,discipline,36,17,19
Trojanphobia,bleeding-hollow,1605,priest,discipline,36,20,16
Yoggismydad,emerald-dream,1605,priest,discipline,185,95,90
Snakedoc,emerald-dream,1605,priest,discipline,66,33,33
Crypcanheal,sargeras,1605,priest,discipline,349,165,184
Horzp,bleeding-hollow,1605,priest,discipline,42,17,25
Míkò,sargeras,1604,priest,discipline,18,17,1
Hoglet,moon-guard,1604,priest,discipline,65,39,26
Djc,tichondrius,1604,priest,discipline,78,40,38
Priestass,bleeding-hollow,1604,priest,discipline,78,37,41
Deathsmoke,ragnaros,1604,priest,discipline,58,27,31
Vern,laughing-skull,1604,priest,discipline,78,29,49
Lines,sargeras,1603,priest,discipline,70,38,32
Fukneasy,darkspear,1603,priest,discipline,37,20,17
Iamgess,kilrogg,1603,priest,discipline,42,22,20
Moalboal,tichondrius,1603,priest,discipline,102,52,50
Daburnz,bleeding-hollow,1603,priest,discipline,72,36,36
Fäctor,bleeding-hollow,1603,priest,discipline,78,36,42
Resortv,illidan,1602,priest,discipline,42,32,10
Arcalon,thrall,1602,priest,discipline,86,45,41
Gromkekz,area-52,1602,priest,discipline,73,38,35
Crizem,bleeding-hollow,1602,priest,discipline,242,119,123
Ünagi,thrall,1602,priest,discipline,77,34,43
Beeffdaddy,tichondrius,1602,priest,discipline,87,38,49
Mealmassttr,frostmourne,1602,priest,discipline,66,27,39
Flatëarth,tichondrius,1601,priest,discipline,54,33,21
Mepisth,sargeras,1600,priest,discipline,66,36,30
Zarakonna,illidan,1600,priest,discipline,60,32,28
Charbosan,gorgonnash,1600,priest,discipline,471,246,225
Eccentrixx,mannoroth,1600,priest,discipline,54,28,26
Obsolete,area-52,1600,priest,discipline,36,17,19
Marython,tichondrius,1600,priest,discipline,52,22,30
Puttles,tichondrius,1600,priest,discipline,60,22,38
Dbod,tichondrius,1599,priest,discipline,186,98,88
Joeyslaps,frostwolf,1599,priest,discipline,53,26,27
Zunari,thrall,1599,priest,discipline,48,23,25
Andypr,illidan,1599,priest,discipline,54,20,34
Muffinboy,illidan,1599,priest,discipline,48,17,31
Dupaforted,stormrage,1598,priest,discipline,71,26,45
Wøo,area-52,1597,priest,discipline,45,28,17
Zulazane,azralon,1597,priest,discipline,208,114,94
Choochang,sargeras,1596,priest,discipline,29,22,7
Weapestrong,tichondrius,1596,priest,discipline,30,18,12
Emytoty,ragnaros,1596,priest,discipline,138,75,63
Ivorytiger,bleeding-hollow,1596,priest,discipline,42,19,23
Rmxx,illidan,1595,priest,discipline,119,64,55
Jhivagosp,tichondrius,1594,priest,discipline,36,20,16
Bonoo,tichondrius,1594,priest,discipline,282,147,135
Famemolol,tichondrius,1594,priest,discipline,213,105,108
Gummachine,tichondrius,1594,priest,discipline,36,17,19
Comana,frostmourne,1594,priest,discipline,53,25,28
Drtyror,area-52,1593,priest,discipline,24,17,7
Planchebois,zuljin,1592,priest,discipline,36,20,16
Isteri,thrall,1590,priest,discipline,52,26,26
Woosanghong,tichondrius,1590,priest,discipline,90,44,46
Emotionally,sargeras,1589,priest,discipline,30,20,10
Arzaei,quelthalas,1589,priest,discipline,74,39,35
Eggsdenny,illidan,1588,priest,discipline,36,17,19
Primael,tichondrius,1587,priest,discipline,40,18,22
Conezy,frostmourne,1586,priest,discipline,60,32,28
Bistek,bleeding-hollow,1586,priest,discipline,148,74,74
Rilad,icecrown,1586,priest,discipline,180,86,94
Hasby,area-52,1585,priest,discipline,60,38,22
Tuniepope,sargeras,1585,priest,discipline,57,34,23
Priestreto,zuljin,1585,priest,discipline,77,42,35
Alaran,magtheridon,1584,priest,discipline,35,21,14
Ärchangél,tichondrius,1584,priest,discipline,54,28,26
Zerokool,moonrunner,1583,priest,discipline,42,25,17
Rómmul,azralon,1582,priest,discipline,65,33,32
Tecnica,kelthuzad,1582,priest,discipline,107,51,56
Maomaoangel,tichondrius,1581,priest,discipline,42,22,20
Shieldharder,stormrage,1581,priest,discipline,39,18,21
Gus,the-venture-co,1580,priest,discipline,78,44,34
Trengodqt,destromath,1580,priest,discipline,113,57,56
Cringepriest,area-52,1579,priest,discipline,54,33,21
Bigwap,illidan,1579,priest,discipline,60,29,31
Krusheal,tichondrius,1578,priest,discipline,35,18,17
Knucklesandy,tichondrius,1576,priest,discipline,35,17,18
Predolph,illidan,1575,priest,discipline,48,26,22
Blindingstar,area-52,1574,priest,discipline,57,33,24
Brxddx,sargeras,1574,priest,discipline,71,34,37
Anahka,tichondrius,1574,priest,discipline,42,18,24
Summersetisl,tichondrius,1574,priest,discipline,42,18,24
Gankdez,kelthuzad,1573,priest,discipline,99,52,47
Pinchevato,ragnaros,1573,priest,discipline,200,103,97
Bloodify,azralon,1573,priest,discipline,95,46,49
Kihlupr,frostmourne,1573,priest,discipline,58,25,33
Bubblebuddí,tichondrius,1572,priest,discipline,68,37,31
Dellitor,illidan,1572,priest,discipline,41,21,20
Holymagetv,tichondrius,1572,priest,discipline,39,18,21
Archeo,area-52,1572,priest,discipline,60,19,41
Malpractíce,zuljin,1571,priest,discipline,95,50,45
Tokaru,frostmourne,1571,priest,discipline,56,26,30
Valdurai,stormrage,1570,priest,discipline,41,23,18
Bingleboi,area-52,1570,priest,discipline,166,90,76
Önagashøw,azralon,1570,priest,discipline,265,135,130
Life,thrall,1570,priest,discipline,95,48,47
Badhabit,zuluhed,1570,priest,discipline,91,40,51
Ariês,tichondrius,1570,priest,discipline,54,20,34
Ppsp,azralon,1569,priest,discipline,42,25,17
Leliane,tichondrius,1569,priest,discipline,48,27,21
Ol,firetree,1569,priest,discipline,51,25,26
Trickyhobo,area-52,1567,priest,discipline,66,40,26
Feymuhs,blackrock,1567,priest,discipline,90,48,42
Fairlightpp,zuljin,1567,priest,discipline,72,36,36
Jiñx,destromath,1566,priest,discipline,260,136,124
Alexsp,amanthul,1565,priest,discipline,76,45,31
Erinzdern,quelthalas,1565,priest,discipline,58,31,27
Mylo,azralon,1564,priest,discipline,42,23,19
Nijoral,tichondrius,1564,priest,discipline,348,182,166
Scarabless,bleeding-hollow,1564,priest,discipline,138,62,76
Deadnyx,tichondrius,1562,priest,discipline,36,20,16
Hadtogothere,kelthuzad,1562,priest,discipline,209,103,106
Valyx,tichondrius,1561,priest,discipline,116,63,53
Jylertason,kelthuzad,1561,priest,discipline,52,25,27
Verna,dunemaul,1560,priest,discipline,85,47,38
Tyksu,area-52,1560,priest,discipline,94,50,44
Shadzx,andorhal,1559,priest,discipline,35,17,18
Moustachío,stormrage,1559,priest,discipline,53,24,29
Spliffs,tichondrius,1559,priest,discipline,77,29,48
Melitele,magtheridon,1558,priest,discipline,36,21,15
Highasf,sargeras,1558,priest,discipline,72,41,31
Vanco,tichondrius,1558,priest,discipline,59,32,27
Juckerr,tichondrius,1558,priest,discipline,156,82,74
Säcrilege,drakkari,1558,priest,discipline,177,92,85
Twistinfate,hyjal,1558,priest,discipline,119,58,61
Thadino,nagrand,1558,priest,discipline,66,32,34
Zsofi,rivendare,1558,priest,discipline,89,41,48
Mellow,tichondrius,1558,priest,discipline,74,34,40
Qenq,tichondrius,1557,priest,discipline,30,17,13
Gucciflops,tichondrius,1557,priest,discipline,48,25,23
Kaeda,drenden,1557,priest,discipline,54,27,27
Sensaye,dalaran,1557,priest,discipline,75,37,38
Ropriest,frostmourne,1557,priest,discipline,59,29,30
Zizziz,tichondrius,1557,priest,discipline,54,26,28
Datdarnbéar,stormrage,1557,priest,discipline,54,25,29
Karebenniian,area-52,1554,priest,discipline,96,48,48
Shesaidthat,stormrage,1554,priest,discipline,189,93,96
Carti,bleeding-hollow,1553,priest,discipline,226,125,101
Sacrify,ragnaros,1553,priest,discipline,60,29,31
Rustypinball,bleeding-hollow,1552,priest,discipline,29,19,10
Rhima,tichondrius,1552,priest,discipline,97,51,46
Rexîfy,zuljin,1551,priest,discipline,41,25,16
Mfynch,sargeras,1551,priest,discipline,66,40,26
Grannieslove,sargeras,1551,priest,discipline,48,28,20
Zachlol,area-52,1551,priest,discipline,90,52,38
Gommacura,stormrage,1551,priest,discipline,178,93,85
Pilixil,bleeding-hollow,1551,priest,discipline,42,21,21
Sorrowful,mannoroth,1550,priest,discipline,30,19,11
Unisia,tichondrius,1550,priest,discipline,98,41,57
Fámóus,stormrage,1549,priest,discipline,83,30,53
Nisagerx,tichondrius,1548,priest,discipline,33,19,14
Aralia,ragnaros,1548,priest,discipline,87,42,45
Kaguyä,ragnaros,1547,priest,discipline,41,24,17
Luhhx,sargeras,1547,priest,discipline,36,19,17
Azureslaps,tichondrius,1547,priest,discipline,212,106,106
Lydra,ragnaros,1547,priest,discipline,195,91,104
Sâishâ,proudmoore,1547,priest,discipline,188,84,104
Jugeumx,proudmoore,1547,priest,discipline,48,19,29
Uriyel,quelthalas,1546,priest,discipline,119,62,57
Sacredlight,malygos,1546,priest,discipline,99,51,48
Linarindil,hyjal,1546,priest,discipline,102,51,51
Kflexx,hydraxis,1546,priest,discipline,110,40,70
Hennywhite,sargeras,1545,priest,discipline,90,42,48
Shadöwtest,quelthalas,1545,priest,discipline,113,49,64
Goo,boulderfist,1544,priest,discipline,36,22,14
Nutshotxx,skullcrusher,1544,priest,discipline,154,67,87
Herder,zuljin,1543,priest,discipline,41,25,16
Justashadow,zangarmarsh,1542,priest,discipline,103,59,44
Kimjongdots,illidan,1542,priest,discipline,44,24,20
Bigdaddios,dalaran,1542,priest,discipline,41,18,23
Metick,illidan,1542,priest,discipline,48,18,30
Zórg,stormrage,1541,priest,discipline,56,30,26
Makuwu,area-52,1541,priest,discipline,93,49,44
Winss,tichondrius,1541,priest,discipline,220,114,106
Qmabayteckkl,tichondrius,1540,priest,discipline,42,23,19
Alex,boulderfist,1540,priest,discipline,189,90,99
Dawnsy,arygos,1540,priest,discipline,44,20,24
Haduth,area-52,1539,priest,discipline,114,58,56
Healbaby,illidan,1539,priest,discipline,157,78,79
Avis,illidan,1538,priest,discipline,50,33,17
Daddydoeet,zuljin,1538,priest,discipline,36,19,17
Rourk,medivh,1537,priest,discipline,84,41,43
Zllik,illidan,1536,priest,discipline,84,44,40
Santhiel,ragnaros,1535,priest,discipline,42,18,24
Iinu,tichondrius,1534,priest,discipline,113,62,51
Highmoon,kelthuzad,1534,priest,discipline,30,16,14
Sevÿ,malygos,1534,priest,discipline,40,20,20
Feedya,tichondrius,1534,priest,discipline,311,153,158
Gilthðniel,quelthalas,1534,priest,discipline,219,104,115
Maid,demon-soul,1534,priest,discipline,63,28,35
Dëàthwîsh,tichondrius,1533,priest,discipline,30,16,14
Priesmatco,area-52,1533,priest,discipline,81,40,41
Androalis,thaurissan,1532,priest,discipline,36,20,16
Pocserpriest,drakkari,1532,priest,discipline,38,17,21
Cazuex,ragnaros,1531,priest,discipline,24,16,8
Pryst,bonechewer,1531,priest,discipline,54,28,26
Bryelx,ragnaros,1531,priest,discipline,108,55,53
Vañity,malganis,1531,priest,discipline,66,33,33
Robdàwg,illidan,1531,priest,discipline,36,16,20
Johanna,tichondrius,1530,priest,discipline,24,16,8
Scræm,sargeras,1530,priest,discipline,97,44,53
Aríola,frostmourne,1529,priest,discipline,69,37,32
Finnabustt,tichondrius,1529,priest,discipline,94,49,45
Luvenia,sargeras,1529,priest,discipline,114,58,56
Halö,area-52,1529,priest,discipline,54,26,28
Griddly,alterac-mountains,1528,priest,discipline,102,56,46
Truce,moon-guard,1528,priest,discipline,77,39,38
Beefoverload,durotan,1527,priest,discipline,96,46,50
Swapsy,illidan,1526,priest,discipline,47,27,20
Jacksreturne,kelthuzad,1526,priest,discipline,338,168,170
Alëssana,illidan,1526,priest,discipline,122,60,62
Umbrous,ysera,1525,priest,discipline,42,18,24
Matics,tichondrius,1524,priest,discipline,56,29,27
Thedude,spirestone,1524,priest,discipline,36,16,20
Oesobagi,tichondrius,1523,priest,discipline,68,39,29
Sonofbetch,emerald-dream,1523,priest,discipline,55,30,25
Bloodytears,kiljaeden,1523,priest,discipline,138,65,73
Razledazzled,grizzly-hills,1523,priest,discipline,74,34,40
Propagàndhi,daggerspine,1523,priest,discipline,104,45,59
Zortkis,garithos,1523,priest,discipline,52,20,32
Madhairy,ragnaros,1522,priest,discipline,126,65,61
Niurouchuan,tichondrius,1522,priest,discipline,123,60,63
Winsforgoldd,area-52,1521,priest,discipline,34,17,17
Pheener,stormreaver,1521,priest,discipline,198,97,101
Aphrodìtë,tichondrius,1521,priest,discipline,78,38,40
Magpul,arthas,1521,priest,discipline,36,16,20
Jâldabaoth,area-52,1520,priest,discipline,48,29,19
Ezzy,bleeding-hollow,1520,priest,discipline,48,24,24
Pedobearx,ragnaros,1520,priest,discipline,54,22,32
Hideyason,area-52,1519,priest,discipline,60,31,29
Augustrox,ragnaros,1519,priest,discipline,42,21,21
Dædrà,stormrage,1519,priest,discipline,76,37,39
Blessrish,icecrown,1519,priest,discipline,66,31,35
Aleykz,illidan,1518,priest,discipline,41,24,17
Nanoboost,dark-iron,1518,priest,discipline,477,233,244
Shunio,illidan,1518,priest,discipline,54,23,31
Bobelgum,emerald-dream,1517,priest,discipline,36,26,10
Bonnieron,frostmourne,1516,priest,discipline,77,39,38
Triangle,draka,1516,priest,discipline,36,17,19
Drupmonst,dalaran,1516,priest,discipline,60,26,34
Lavenderism,moon-guard,1515,priest,discipline,54,29,25
Friendzonefw,illidan,1515,priest,discipline,126,60,66
Lauretânia,nemesis,1515,priest,discipline,72,32,40
Marantbourge,frostmourne,1514,priest,discipline,122,57,65
Fakechow,nathrezim,1513,priest,discipline,95,47,48
Josquin,illidan,1513,priest,discipline,47,22,25
Inssania,ragnaros,1513,priest,discipline,60,28,32
Gustáv,sargeras,1512,priest,discipline,72,37,35
Evilspreist,arthas,1512,priest,discipline,108,48,60
Absørptiøn,area-52,1511,priest,discipline,42,23,19
Mse,eonar,1511,priest,discipline,48,26,22
Galestick,illidan,1511,priest,discipline,30,16,14
Nottahealer,anvilmar,1511,priest,discipline,36,18,18
Doggyy,tichondrius,1510,priest,discipline,148,82,66
Manascythe,illidan,1510,priest,discipline,46,22,24
Zroheals,illidan,1510,priest,discipline,101,45,56
Cexcexyomi,tichondrius,1509,priest,discipline,61,33,28
Agraheals,barthilas,1509,priest,discipline,42,22,20
Life,amanthul,1508,priest,discipline,64,39,25
Ballzach,ysera,1508,priest,discipline,197,102,95
Euphotic,tichondrius,1507,priest,discipline,55,29,26
Hawtzp,stormrage,1506,priest,discipline,42,24,18
Akëla,nemesis,1506,priest,discipline,42,18,24
Zinnar,dalaran,1506,priest,discipline,96,38,58
Chainsalight,stormrage,1505,priest,discipline,144,77,67
Altarboy,agamaggan,1505,priest,discipline,62,30,32
Perothon,garrosh,1505,priest,discipline,60,27,33
Legó,illidan,1504,priest,discipline,60,29,31
Scrollozaddy,illidan,1503,priest,discipline,81,56,25
Rháényra,tichondrius,1502,priest,discipline,36,20,16
Dachenchen,tichondrius,1501,priest,discipline,24,16,8
Artista,quelthalas,1501,priest,discipline,100,54,46
Nerfdisc,azralon,1501,priest,discipline,142,75,67
Yoozi,sargeras,1501,priest,discipline,126,63,63
Lelenia,tichondrius,1501,priest,discipline,49,22,27
Soulcleave,dark-iron,1501,priest,discipline,42,16,26
Howiecakes,bloodhoof,1501,priest,discipline,45,17,28
Luffzie,barthilas,1500,priest,discipline,54,35,19
Bailez,malganis,1500,priest,discipline,49,27,22
Valtres,tichondrius,1499,priest,discipline,30,16,14
Minii,tichondrius,1498,priest,discipline,31,19,12
Jpray,bleeding-hollow,1498,priest,discipline,115,62,53
Healther,firetree,1498,priest,discipline,30,16,14
Approved,moon-guard,1498,priest,discipline,156,75,81
Inkders,detheroc,1498,priest,discipline,58,26,32
Boundword,emerald-dream,1498,priest,discipline,54,22,32
Yorp,tichondrius,1497,priest,discipline,72,36,36
Thottee,bleeding-hollow,1497,priest,discipline,120,55,65
Valixia,sargeras,1497,priest,discipline,90,41,49
Tajee,area-52,1496,priest,discipline,107,57,50
Namemetwo,malganis,1496,priest,discipline,42,20,22
Doutoodou,tichondrius,1495,priest,discipline,94,55,39
Amarexlol,stormrage,1495,priest,discipline,54,27,27
Zivn,tichondrius,1494,priest,discipline,588,306,282
Sgiath,alleria,1493,priest,discipline,42,30,12
Sleezi,emerald-dream,1493,priest,discipline,60,34,26
Weezyxo,tichondrius,1493,priest,discipline,46,19,27
Betterheals,tichondrius,1492,priest,discipline,145,79,66
Bubblerwrapp,malganis,1492,priest,discipline,36,17,19
Delrey,sargeras,1491,priest,discipline,38,19,19
Saiyana,frostmourne,1491,priest,discipline,148,72,76
Pootzy,malganis,1491,priest,discipline,72,27,45
Kalilol,tichondrius,1490,priest,discipline,132,61,71
Akayayuelol,tichondrius,1488,priest,discipline,24,19,5
Discobluntzz,tichondrius,1488,priest,discipline,54,31,23
Labraidor,tichondrius,1488,priest,discipline,185,81,104
Orzington,laughing-skull,1487,priest,discipline,74,40,34
Watchemeyolo,tichondrius,1487,priest,discipline,66,35,31
Luxyel,azralon,1487,priest,discipline,149,65,84
Zeusqt,azralon,1486,priest,discipline,168,90,78
Windroseh,proudmoore,1486,priest,discipline,60,32,28
Blobble,tichondrius,1486,priest,discipline,102,45,57
Tëmpting,moon-guard,1485,priest,discipline,50,25,25
Zilah,ravencrest,1485,priest,discipline,72,33,39
Aerdaras,illidan,1485,priest,discipline,80,36,44
Bater,mugthol,1484,priest,discipline,34,18,16
Dingldangle,tichondrius,1483,priest,discipline,144,70,74
Nidüz,stormrage,1483,priest,discipline,144,68,76
Blacklightz,korgath,1483,priest,discipline,91,42,49
Prff,ragnaros,1483,priest,discipline,42,19,23
Drully,moon-guard,1482,priest,discipline,83,41,42
Zaemyn,dalaran,1482,priest,discipline,44,20,24
Tartapelle,zuljin,1481,priest,discipline,78,44,34
Vemilli,tichondrius,1481,priest,discipline,40,20,20
Holypuffs,burning-legion,1481,priest,discipline,59,27,32
Hysteria,dalaran,1480,priest,discipline,70,33,37
Sstar,area-52,1479,priest,discipline,24,16,8
Besó,proudmoore,1479,priest,discipline,102,58,44
Keyoshe,altar-of-storms,1479,priest,discipline,90,43,47
Lyrä,kiljaeden,1478,priest,discipline,55,29,26
Confesiional,area-52,1478,priest,discipline,68,31,37
Fenian,frostmourne,1477,priest,discipline,119,60,59
Jjløver,tichondrius,1476,priest,discipline,24,16,8
Rëckful,area-52,1476,priest,discipline,599,303,296
Slipzie,sargeras,1475,priest,discipline,53,31,22
Zenobiai,hyjal,1475,priest,discipline,115,60,55
Xîîaotong,tichondrius,1473,priest,discipline,37,23,14
Mistàclean,tichondrius,1473,priest,discipline,77,38,39
Swagndragon,zuljin,1473,priest,discipline,86,42,44
Weakwind,burning-blade,1471,priest,discipline,44,25,19
Ricekak,haomarush,1471,priest,discipline,66,37,29
Rufían,quelthalas,1471,priest,discipline,48,25,23
Feorlar,tichondrius,1471,priest,discipline,66,32,34
Mäí,ragnaros,1470,priest,discipline,60,41,19
Bigtimeplay,tichondrius,1470,priest,discipline,42,25,17
Yugewap,hyjal,1470,priest,discipline,102,60,42
Doesine,area-52,1469,priest,discipline,42,25,17
Skillfull,chogall,1468,priest,discipline,211,112,99
Purged,shadowmoon,1468,priest,discipline,262,136,126
Sandfire,thrall,1467,priest,discipline,30,16,14
Stargoddess,illidan,1467,priest,discipline,168,84,84
Shadowdaddy,barthilas,1466,priest,discipline,72,39,33
Curemeste,illidan,1466,priest,discipline,90,47,43
Preacharóund,frostmourne,1466,priest,discipline,72,36,36
Yeyoz,tichondrius,1466,priest,discipline,70,33,37
Wöödy,area-52,1465,priest,discipline,32,18,14
Brian,lightnings-blade,1465,priest,discipline,46,24,22
Fearnought,stormrage,1464,priest,discipline,55,29,26
Vullena,moon-guard,1464,priest,discipline,60,28,32
Oiled,barthilas,1463,priest,discipline,47,29,18
Dib,arathor,1463,priest,discipline,48,25,23
Gðttlich,stormrage,1462,priest,discipline,38,19,19
Fallenumbra,area-52,1461,priest,discipline,77,44,33
Priestsz,stormrage,1461,priest,discipline,151,78,73
Ínfocus,area-52,1460,priest,discipline,120,57,63
Syfy,thrall,1460,priest,discipline,108,45,63
Growth,fizzcrank,1460,priest,discipline,60,24,36
Floratil,ragnaros,1459,priest,discipline,54,21,33
Nexp,tichondrius,1458,priest,discipline,41,29,12
Xerzosh,area-52,1458,priest,discipline,132,70,62
Prayf,area-52,1458,priest,discipline,92,43,49
Forsakenz,jaedenar,1458,priest,discipline,60,27,33
Darenlor,tichondrius,1458,priest,discipline,93,40,53
Shykaii,azralon,1456,priest,discipline,108,61,47
Crashed,frostmourne,1456,priest,discipline,36,20,16
Kälëy,ragnaros,1456,priest,discipline,59,31,28
Akovob,tichondrius,1456,priest,discipline,50,25,25
Merkinhealz,darkspear,1456,priest,discipline,48,24,24
Sineater,zuljin,1456,priest,discipline,77,36,41
Tiannatrump,stormrage,1455,priest,discipline,53,31,22
Triggaz,tichondrius,1455,priest,discipline,100,54,46
Calientaeggs,drakkari,1454,priest,discipline,104,57,47
Huevos,blackwing-lair,1454,priest,discipline,144,76,68
Giveheadpats,moon-guard,1454,priest,discipline,101,47,54
Modotszilla,bleeding-hollow,1454,priest,discipline,36,16,20
Hermeneutic,illidan,1454,priest,discipline,39,17,22
Jaindoe,illidan,1453,priest,discipline,84,46,38
Ünarû,illidan,1452,priest,discipline,102,57,45
Puddín,area-52,1452,priest,discipline,84,42,42
Xeras,misha,1452,priest,discipline,47,21,26
Azaradet,ragnaros,1452,priest,discipline,78,31,47
Sadnez,illidan,1451,priest,discipline,91,51,40
Billzerian,nemesis,1451,priest,discipline,36,20,16
Spookynun,moon-guard,1450,priest,discipline,216,122,94
Vezaxx,barthilas,1450,priest,discipline,108,55,53
Phasmaaxd,tichondrius,1450,priest,discipline,59,29,30
Vampiric,laughing-skull,1449,priest,discipline,36,20,16
Wisher,tichondrius,1447,priest,discipline,110,45,65
Priøst,tichondrius,1446,priest,discipline,63,38,25
Newchaos,hakkar,1446,priest,discipline,40,24,16
Zäelly,moon-guard,1446,priest,discipline,192,98,94
Mileslol,azgalor,1446,priest,discipline,68,34,34
Mamabless,quelthalas,1445,priest,discipline,460,238,222
Stynke,bleeding-hollow,1445,priest,discipline,54,16,38
Sappes,area-52,1443,priest,discipline,154,87,67
Specialed,wildhammer,1443,priest,discipline,65,36,29
Yótecuro,quelthalas,1443,priest,discipline,66,31,35
Raisonpriest,tichondrius,1442,priest,discipline,84,44,40
Kiritomauti,ragnaros,1442,priest,discipline,42,18,24
Mannius,tichondrius,1441,priest,discipline,54,26,28
Shadowblax,thrall,1441,priest,discipline,160,75,85
Saentha,sargeras,1440,priest,discipline,48,23,25
Docmcstufins,darkspear,1440,priest,discipline,65,31,34
Kristyenna,boulderfist,1440,priest,discipline,42,20,22
Goodvybes,tichondrius,1440,priest,discipline,54,23,31
Tallshiraz,destromath,1439,priest,discipline,24,19,5
Cubski,darkspear,1439,priest,discipline,30,15,15
Umadcüzubad,azralon,1439,priest,discipline,115,54,61
Keepyaheadup,malganis,1438,priest,discipline,18,15,3
Grimspriest,moon-guard,1438,priest,discipline,30,16,14
Disperse,vashj,1438,priest,discipline,138,62,76
Tekneeq,barthilas,1438,priest,discipline,42,16,26
Rabbix,aggramar,1437,priest,discipline,30,19,11
Mason,winterhoof,1437,priest,discipline,24,15,9
Yotinha,stormrage,1437,priest,discipline,24,15,9
Joesus,kelthuzad,1437,priest,discipline,38,17,21
Vivián,tichondrius,1436,priest,discipline,115,63,52
Compåctdisc,sargeras,1436,priest,discipline,36,18,18
Jacob,shadowmoon,1436,priest,discipline,153,74,79
Draazja,dalaran,1436,priest,discipline,126,60,66
Mandymuze,barthilas,1436,priest,discipline,71,31,40
Amãnita,illidan,1436,priest,discipline,35,15,20
Pphill,aegwynn,1436,priest,discipline,48,19,29
Murdock,the-forgotten-coast,1435,priest,discipline,56,31,25
Bootycough,malganis,1435,priest,discipline,63,32,31
Nasser,tichondrius,1435,priest,discipline,30,15,15
Sliding,wyrmrest-accord,1435,priest,discipline,30,15,15
Miix,proudmoore,1434,priest,discipline,18,15,3
Luminous,moon-guard,1434,priest,discipline,137,73,64
Apâthy,area-52,1434,priest,discipline,48,20,28
Lípjju,tichondrius,1434,priest,discipline,36,15,21
Soméone,sargeras,1433,priest,discipline,128,70,58
Baali,moon-guard,1432,priest,discipline,29,21,8
Amorus,illidan,1432,priest,discipline,60,40,20
Madjak,lightnings-blade,1432,priest,discipline,90,52,38
Necrodiva,magtheridon,1432,priest,discipline,84,43,41
Rôôk,kiljaeden,1432,priest,discipline,56,26,30
Lullabya,tichondrius,1431,priest,discipline,24,15,9
Havocshadows,deathwing,1431,priest,discipline,176,107,69
Tiskka,magtheridon,1431,priest,discipline,62,27,35
Elysiana,wyrmrest-accord,1430,priest,discipline,18,15,3
Jinxaleyster,ragnaros,1430,priest,discipline,113,64,49
Eridan,moon-guard,1429,priest,discipline,65,33,32
Kwaremont,sargeras,1429,priest,discipline,30,15,15
Faithmelter,stormrage,1429,priest,discipline,49,24,25
Jilt,aerie-peak,1428,priest,discipline,90,53,37
ßlest,stormrage,1428,priest,discipline,96,56,40
Tainna,quelthalas,1428,priest,discipline,78,44,34
Healthreat,area-52,1428,priest,discipline,58,31,27
Elexy,tichondrius,1428,priest,discipline,72,37,35
Luanwanx,tichondrius,1427,priest,discipline,48,26,22
Cherryfuzz,sargeras,1427,priest,discipline,89,45,44
Braffuki,frostmourne,1427,priest,discipline,95,45,50
Pumtootoot,tichondrius,1427,priest,discipline,36,15,21
Basisc,frostmourne,1426,priest,discipline,177,99,78
Starshollow,ragnaros,1426,priest,discipline,37,18,19
Haizsu,tichondrius,1426,priest,discipline,53,23,30
Clockwororan,tichondrius,1425,priest,discipline,24,15,9
Femìnazzi,ragnaros,1425,priest,discipline,64,35,29
Voicekal,sargeras,1425,priest,discipline,77,41,36
Blodwell,illidan,1425,priest,discipline,96,48,48
Teeds,stormrage,1425,priest,discipline,69,34,35
Langyi,tichondrius,1424,priest,discipline,72,41,31
Staysmall,stormrage,1424,priest,discipline,30,15,15
Manryu,tichondrius,1424,priest,discipline,48,17,31
Dreadpriate,emerald-dream,1423,priest,discipline,92,46,46
Shakky,queldorei,1423,priest,discipline,78,34,44
Nolan,drakkari,1422,priest,discipline,47,27,20
Zørb,area-52,1422,priest,discipline,54,31,23
Ketaminè,tichondrius,1422,priest,discipline,48,25,23
Miaria,chogall,1422,priest,discipline,126,63,63
Eavin,laughing-skull,1422,priest,discipline,231,115,116
Wpj,barthilas,1422,priest,discipline,51,17,34
Bloatie,zuljin,1421,priest,discipline,42,28,14
Izikial,illidan,1421,priest,discipline,48,24,24
Holycast,arygos,1420,priest,discipline,24,15,9
Sackura,quelthalas,1420,priest,discipline,49,26,23
Machinecoach,stormrage,1419,priest,discipline,30,15,15
Brotatochip,andorhal,1419,priest,discipline,49,24,25
Malavidax,malganis,1419,priest,discipline,108,45,63
Wïgjaw,tichondrius,1419,priest,discipline,60,25,35
Takethat,emerald-dream,1418,priest,discipline,54,32,22
Zjqf,akama,1418,priest,discipline,179,89,90
Whehaw,kelthuzad,1418,priest,discipline,114,54,60
Holyish,proudmoore,1418,priest,discipline,42,19,23
Vundead,tichondrius,1418,priest,discipline,36,16,20
Spazmode,malganis,1417,priest,discipline,75,38,37
Strawson,quelthalas,1417,priest,discipline,84,40,44
Sibble,boulderfist,1416,priest,discipline,38,17,21
Shonkee,tichondrius,1415,priest,discipline,27,16,11
Sasaberry,frostmourne,1415,priest,discipline,169,80,89
Dtsgx,tichondrius,1414,priest,discipline,27,16,11
Chimiechurro,proudmoore,1414,priest,discipline,72,37,35
Suitoo,ragnaros,1414,priest,discipline,30,15,15
Ankhxiety,area-52,1414,priest,discipline,71,33,38
Aubine,sargeras,1414,priest,discipline,41,15,26
Ananiel,moon-guard,1413,priest,discipline,24,15,9
Hiraa,frostmourne,1413,priest,discipline,24,15,9
Artiannaa,bleeding-hollow,1413,priest,discipline,42,24,18
Clancygilroy,thrall,1413,priest,discipline,90,44,46
Daluu,tichondrius,1413,priest,discipline,51,18,33
Accismus,khadgar,1412,priest,discipline,78,37,41
Feløre,quelthalas,1411,priest,discipline,46,29,17
Angusb,sargeras,1410,priest,discipline,80,35,45
Joktips,proudmoore,1409,priest,discipline,84,45,39
Buqisama,barthilas,1409,priest,discipline,72,29,43
Jamesxupttv,draenor,1408,priest,discipline,52,28,24
Shelak,frostmourne,1408,priest,discipline,62,33,29
Eatmyfear,quelthalas,1408,priest,discipline,247,122,125
Verchou,shattered-hand,1408,priest,discipline,36,15,21
Midoopriest,proudmoore,1408,priest,discipline,36,15,21
Justanoutlaw,darkspear,1407,priest,discipline,36,21,15
Kawin,goldrinn,1407,priest,discipline,101,54,47
Sunenergy,tichondrius,1407,priest,discipline,78,41,37
Dmlx,frostmourne,1406,priest,discipline,72,47,25
Smirkinlive,illidan,1405,priest,discipline,32,20,12
Seáoflions,aggramar,1405,priest,discipline,24,15,9
Eshimä,quelthalas,1405,priest,discipline,69,40,29
Tryst,the-underbog,1404,priest,discipline,60,37,23
Iivelaughluv,kiljaeden,1404,priest,discipline,33,20,13
Gurgs,emerald-dream,1404,priest,discipline,32,16,16
Nihilm,emerald-dream,1404,priest,discipline,69,31,38
Itsmaám,moon-guard,1403,priest,discipline,42,25,17
Pitayakiller,tichondrius,1403,priest,discipline,29,15,14
Gwyneth,whisperwind,1403,priest,discipline,80,35,45
Nek,malganis,1402,priest,discipline,85,50,35
Nicety,skywall,1402,priest,discipline,50,22,28
Jelzz,area-52,1401,priest,discipline,28,17,11
Dipadre,azralon,1401,priest,discipline,42,25,17
Cezure,stormrage,1401,priest,discipline,227,119,108
Bubbahotep,laughing-skull,1401,priest,discipline,52,25,27
Khyonne,nemesis,1400,priest,discipline,68,37,31
Oomed,bonechewer,1400,priest,discipline,106,55,51
Hunanbeef,kiljaeden,1400,priest,discipline,58,29,29
Cathêlay,bleeding-hollow,1400,priest,discipline,73,35,38
Napzz,sargeras,1399,priest,discipline,36,21,15
Shnítzel,thrall,1399,priest,discipline,103,51,52
Smegmancer,korgath,1399,priest,discipline,54,24,30
Ringofvalor,lightnings-blade,1398,priest,discipline,101,52,49
Lonpriest,stormrage,1396,priest,discipline,174,79,95
Slippedadisc,kelthuzad,1396,priest,discipline,42,19,23
Ðohko,ragnaros,1395,priest,discipline,36,20,16
Ems,dawnbringer,1394,priest,discipline,29,15,14
Karminha,azralon,1393,priest,discipline,24,17,7
Freck,stormrage,1393,priest,discipline,42,25,17
Icônz,malganis,1393,priest,discipline,59,31,28
Lilblackguys,stormrage,1393,priest,discipline,102,50,52
Darkquinn,boulderfist,1393,priest,discipline,242,114,128
Scriptz,frostwolf,1393,priest,discipline,66,30,36
Raggasoca,malganis,1393,priest,discipline,99,44,55
Ðiplø,tichondrius,1392,priest,discipline,35,21,14
Donzorro,ragnaros,1392,priest,discipline,87,46,41
Tluoc,nemesis,1391,priest,discipline,47,25,22
Smittën,barthilas,1390,priest,discipline,72,40,32
Phayzz,area-52,1390,priest,discipline,123,63,60
Welovan,sargeras,1390,priest,discipline,46,23,23
Chofis,nathrezim,1389,priest,discipline,36,24,12
Leviathanh,tichondrius,1389,priest,discipline,42,27,15
Zygotes,tichondrius,1388,priest,discipline,27,16,11
Xyló,area-52,1388,priest,discipline,118,65,53
Dårc,tichondrius,1386,priest,discipline,89,52,37
Unholywizard,sargeras,1386,priest,discipline,66,37,29
Vexyy,tichondrius,1385,priest,discipline,32,19,13
Mursey,sargeras,1385,priest,discipline,111,51,60
Tungus,shadowsong,1384,priest,discipline,97,51,46
Voltstein,dalaran,1384,priest,discipline,68,32,36
Palpitine,kiljaeden,1383,priest,discipline,48,26,22
Arkenes,dalaran,1383,priest,discipline,78,41,37
Wholeness,kelthuzad,1383,priest,discipline,48,21,27
Sinnertitanz,quelthalas,1382,priest,discipline,84,44,40
Holykushed,tichondrius,1382,priest,discipline,38,19,19
Sukmysplooge,queldorei,1382,priest,discipline,66,28,38
Bradythree,moon-guard,1380,priest,discipline,26,16,10
Jinniu,azralon,1380,priest,discipline,42,17,25
Bøness,area-52,1379,priest,discipline,94,50,44
Helarix,malganis,1379,priest,discipline,127,58,69
Winnzhor,bonechewer,1378,priest,discipline,41,27,14
Evpray,area-52,1377,priest,discipline,24,18,6
Lexinalis,stormrage,1376,priest,discipline,29,17,12
Fádéd,tichondrius,1376,priest,discipline,29,15,14
Hazzang,tichondrius,1376,priest,discipline,78,37,41
Laüren,ragnaros,1376,priest,discipline,100,44,56
Sixfiggas,darkspear,1375,priest,discipline,24,17,7
Dlysexic,barthilas,1375,priest,discipline,66,35,31
Sistamaggie,bleeding-hollow,1375,priest,discipline,66,33,33
Jeresh,sargeras,1375,priest,discipline,59,17,42
Bhoyka,ragnaros,1374,priest,discipline,27,16,11
Lolweedbro,illidan,1374,priest,discipline,31,17,14
Drinkndrive,tichondrius,1374,priest,discipline,51,27,24
Risedead,azralon,1373,priest,discipline,91,50,41
Zombieheals,gundrak,1373,priest,discipline,53,27,26
Halcyon,eonar,1372,priest,discipline,74,34,40
Karazhan,burning-legion,1371,priest,discipline,44,19,25
Glauga,azralon,1371,priest,discipline,42,17,25
Safetyy,bleeding-hollow,1370,priest,discipline,29,15,14
Jìtters,silvermoon,1370,priest,discipline,36,17,19
Onjah,kiljaeden,1369,priest,discipline,60,25,35
Exploded,moon-guard,1369,priest,discipline,73,30,43
Krindil,korgath,1367,priest,discipline,47,29,18
Rickjames,laughing-skull,1367,priest,discipline,74,43,31
Pipete,frostmourne,1367,priest,discipline,95,52,43
Yürika,emerald-dream,1367,priest,discipline,48,17,31
Meditåtion,tichondrius,1366,priest,discipline,102,48,54
Solsano,stormrage,1365,priest,discipline,76,44,32
Kurobankai,tichondrius,1364,priest,discipline,30,15,15
Toxictampax,azjolnerub,1364,priest,discipline,64,25,39
Halfyo,dragonmaw,1363,priest,discipline,90,49,41
Nometh,emerald-dream,1363,priest,discipline,66,30,36
Handyheals,frostmourne,1362,priest,discipline,101,54,47
Füuzin,stormrage,1362,priest,discipline,66,34,32
Curasia,drakkari,1360,priest,discipline,57,37,20
Sadistic,hyjal,1360,priest,discipline,61,25,36
Helianna,whisperwind,1360,priest,discipline,54,20,34
Trummp,tichondrius,1359,priest,discipline,75,40,35
Powerwordzz,dragonmaw,1359,priest,discipline,72,36,36
Itsme,quelthalas,1359,priest,discipline,71,32,39
Nêrô,dalaran,1359,priest,discipline,48,21,27
Nomsayin,stormrage,1358,priest,discipline,19,15,4
Crucïfïx,stormrage,1358,priest,discipline,70,41,29
Nexoox,drakkari,1358,priest,discipline,42,23,19
Tûbes,trollbane,1358,priest,discipline,101,42,59
Replacednewb,chogall,1357,priest,discipline,51,27,24
Aerdune,dalaran,1356,priest,discipline,68,36,32
Easypriest,tichondrius,1356,priest,discipline,66,32,34
Empower,garrosh,1355,priest,discipline,45,29,16
Bigskill,proudmoore,1355,priest,discipline,36,17,19
Masochist,barthilas,1353,priest,discipline,100,61,39
Msdash,tichondrius,1353,priest,discipline,42,23,19
Icetraygang,suramar,1353,priest,discipline,380,200,180
Victrix,tichondrius,1353,priest,discipline,112,47,65
Dotsfortots,malfurion,1352,priest,discipline,29,15,14
Chìbiusa,gurubashi,1352,priest,discipline,106,52,54
Aurajade,queldorei,1349,priest,discipline,30,15,15
Beñzi,sargeras,1348,priest,discipline,26,16,10
Dxskadi,stormrage,1348,priest,discipline,156,68,88
Renews,azralon,1346,priest,discipline,46,25,21
Revreal,thrall,1346,priest,discipline,48,25,23
Benedictüs,tichondrius,1345,priest,discipline,154,77,77
Pelagius,suramar,1345,priest,discipline,44,19,25
Temkcalb,ragnaros,1344,priest,discipline,84,42,42
Hoppus,stormrage,1344,priest,discipline,90,44,46
Helibix,bleeding-hollow,1344,priest,discipline,50,20,30
Bohomagz,tichondrius,1343,priest,discipline,24,14,10
Tyreliy,eitrigg,1343,priest,discipline,150,78,72
Fadewench,sargeras,1343,priest,discipline,41,21,20
Míssdank,tichondrius,1343,priest,discipline,36,18,18
Crazykitsune,thaurissan,1342,priest,discipline,42,27,15
Lawroade,tichondrius,1342,priest,discipline,67,36,31
Mitoloshi,ragnaros,1342,priest,discipline,114,55,59
Jthealz,tichondrius,1342,priest,discipline,30,14,16
Kobayashy,ragnaros,1341,priest,discipline,36,21,15
Redcoolaid,moon-guard,1341,priest,discipline,24,14,10
Armî,ragnaros,1341,priest,discipline,30,15,15
Pettypriest,dalaran,1341,priest,discipline,31,15,16
Zoap,stormrage,1341,priest,discipline,60,26,34
Teiam,skullcrusher,1340,priest,discipline,24,14,10
Psÿçhë,stormrage,1340,priest,discipline,30,14,16
Eyolo,tichondrius,1340,priest,discipline,30,14,16
Storylord,malganis,1340,priest,discipline,30,14,16
Yeshùa,drakkari,1340,priest,discipline,110,51,59
Protega,illidan,1339,priest,discipline,18,14,4
Fleckyy,tichondrius,1339,priest,discipline,36,14,22
Ksâh,bleeding-hollow,1338,priest,discipline,18,14,4
Vehlind,quelthalas,1338,priest,discipline,101,52,49
Knoskeezy,proudmoore,1337,priest,discipline,18,14,4
Mateekie,malganis,1337,priest,discipline,40,21,19
Monâ,sargeras,1337,priest,discipline,30,14,16
Foxspritques,area-52,1337,priest,discipline,58,16,42
Lilazngirl,stormrage,1336,priest,discipline,30,19,11
Devilwithin,moon-guard,1336,priest,discipline,29,18,11
Metagameswag,tichondrius,1335,priest,discipline,24,14,10
Xxqq,illidan,1335,priest,discipline,24,14,10
Sinsuu,tichondrius,1334,priest,discipline,36,19,17
Erossenin,proudmoore,1334,priest,discipline,30,15,15
Healmedaddyy,korgath,1334,priest,discipline,130,60,70
Dederpriest,stormrage,1333,priest,discipline,18,14,4
Rblood,emerald-dream,1332,priest,discipline,54,33,21
Billymaays,azgalor,1332,priest,discipline,73,37,36
Mangueroide,quelthalas,1332,priest,discipline,90,44,46
Cathiah,darkspear,1331,priest,discipline,146,76,70
Noveh,tichondrius,1331,priest,discipline,36,17,19
Bathenape,bleeding-hollow,1330,priest,discipline,40,23,17
Holyfromrmp,tichondrius,1330,priest,discipline,72,35,37
Decline,balnazzar,1330,priest,discipline,30,14,16
Xuun,illidan,1329,priest,discipline,71,42,29
Paidessanto,azralon,1329,priest,discipline,92,53,39
Themoon,tichondrius,1328,priest,discipline,24,14,10
Draxxankou,tanaris,1328,priest,discipline,55,28,27
Mythica,gurubashi,1327,priest,discipline,84,50,34
Raydz,altar-of-storms,1327,priest,discipline,266,127,139
Danrien,azralon,1326,priest,discipline,34,20,14
Aveil,bloodscalp,1326,priest,discipline,34,20,14
Naranjitá,ragnaros,1324,priest,discipline,24,14,10
Edmust,black-dragonflight,1324,priest,discipline,24,14,10
Rvxy,tichondrius,1324,priest,discipline,84,42,42
Namî,barthilas,1323,priest,discipline,179,97,82
Jaysontatum,gurubashi,1323,priest,discipline,33,17,16
Muuq,frostmourne,1323,priest,discipline,143,70,73
Heltor,sargeras,1323,priest,discipline,66,25,41
Kaeshia,proudmoore,1322,priest,discipline,30,18,12
Lucsor,malganis,1322,priest,discipline,101,50,51
Burroviejo,quelthalas,1322,priest,discipline,40,17,23
Javox,drakkari,1321,priest,discipline,24,14,10
Aldrych,malganis,1321,priest,discipline,48,26,22
Sòraka,tichondrius,1321,priest,discipline,56,30,26
Xtty,thrall,1321,priest,discipline,31,15,16
Tonybanderas,shattered-halls,1321,priest,discipline,30,14,16
Sinnon,turalyon,1320,priest,discipline,30,17,13
Srwilly,ragnaros,1320,priest,discipline,81,42,39
Kafarmer,frostmourne,1320,priest,discipline,83,43,40
Bionix,stormrage,1320,priest,discipline,66,33,33
Mkowns,tichondrius,1319,priest,discipline,24,14,10
Nadiaxo,moon-guard,1319,priest,discipline,65,35,30
Nøzmonica,kelthuzad,1319,priest,discipline,32,15,17
Psychic,bladefist,1317,priest,discipline,24,14,10
Lethalrosé,thrall,1316,priest,discipline,24,14,10
Malevolently,illidan,1316,priest,discipline,137,62,75
ßræcher,black-dragonflight,1315,priest,discipline,30,20,10
Chaøz,emerald-dream,1314,priest,discipline,41,24,17
Thelondon,tichondrius,1314,priest,discipline,27,15,12
Flab,tichondrius,1314,priest,discipline,30,15,15
Blaydun,elune,1313,priest,discipline,114,66,48
Moontearss,tichondrius,1313,priest,discipline,48,25,23
Kms,sargeras,1313,priest,discipline,51,26,25
Jsuschristix,zuljin,1311,priest,discipline,36,23,13
Misfyt,emerald-dream,1311,priest,discipline,54,25,29
Goodwin,darkspear,1310,priest,discipline,48,29,19
Chîna,hyjal,1310,priest,discipline,126,76,50
Heallarious,stormrage,1310,priest,discipline,50,30,20
Leprêtre,hakkar,1310,priest,discipline,30,16,14
Tazzi,chromaggus,1309,priest,discipline,24,14,10
Diabiitus,stormrage,1309,priest,discipline,63,36,27
Mellerwine,azralon,1309,priest,discipline,300,156,144
Anymoon,tichondrius,1308,priest,discipline,66,36,30
Booyâh,muradin,1308,priest,discipline,54,27,27
Novous,area-52,1308,priest,discipline,50,24,26
Majesticar,moon-guard,1307,priest,discipline,30,20,10
Médíc,dalaran,1307,priest,discipline,63,32,31
Xpera,dalaran,1307,priest,discipline,77,37,40
Unholyhand,moon-guard,1307,priest,discipline,36,15,21
Aesudan,dalaran,1306,priest,discipline,51,27,24
Priestgobrr,emerald-dream,1305,priest,discipline,50,30,20
Ruthlèss,ragnaros,1305,priest,discipline,54,28,26
Fairylìght,stormrage,1305,priest,discipline,61,22,39
Dahrwin,thrall,1303,priest,discipline,42,24,18
Plznokill,tichondrius,1303,priest,discipline,36,18,18
Gustavustus,barthilas,1303,priest,discipline,42,14,28
Juliusceazer,skywall,1302,priest,discipline,116,66,50
Poorass,sargeras,1301,priest,discipline,30,19,11
Aedarelyn,ysera,1301,priest,discipline,42,22,20
Textmepls,barthilas,1300,priest,discipline,30,19,11
Gäindalt,tichondrius,1300,priest,discipline,30,18,12
Pyta,frostmourne,1299,priest,discipline,38,17,21
Rotass,hyjal,1298,priest,discipline,54,30,24
Phonomena,malganis,1298,priest,discipline,90,48,42
Krané,area-52,1298,priest,discipline,51,24,27
Wildmanfrank,tichondrius,1297,priest,discipline,37,21,16
Mechahomo,dalaran,1297,priest,discipline,52,28,24
Zóe,eredar,1297,priest,discipline,40,21,19
ßoogey,tichondrius,1297,priest,discipline,35,17,18
Penetron,tichondrius,1297,priest,discipline,53,22,31
Volkova,quelthalas,1296,priest,discipline,48,26,22
Dabbinton,chogall,1296,priest,discipline,52,26,26
Hydramîst,ragnaros,1296,priest,discipline,36,15,21
Sportsgloss,tichondrius,1295,priest,discipline,36,16,20
Overpriest,ragnaros,1294,priest,discipline,28,14,14
Theheal,ragnaros,1293,priest,discipline,57,19,38
Dadthegreat,bonechewer,1292,priest,discipline,42,25,17
Penitentrowr,illidan,1292,priest,discipline,57,31,26
Usmond,azralon,1292,priest,discipline,48,23,25
Halliburton,illidan,1292,priest,discipline,56,26,30
Cyphrus,hyjal,1292,priest,discipline,35,15,20
Unfriend,sargeras,1291,priest,discipline,48,22,26
Lyxx,kelthuzad,1290,priest,discipline,22,15,7
Icychain,area-52,1289,priest,discipline,34,15,19
Troublmaker,illidan,1288,priest,discipline,46,24,22
Markspell,stormrage,1286,priest,discipline,133,72,61
Iwonthealu,senjin,1286,priest,discipline,30,16,14
Khaleth,suramar,1286,priest,discipline,48,20,28
Matchakatt,tichondrius,1285,priest,discipline,49,31,18
Brounly,drakkari,1285,priest,discipline,72,36,36
Yayoo,exodar,1285,priest,discipline,33,16,17
Klowdz,burning-blade,1285,priest,discipline,54,23,31
Quickq,barthilas,1283,priest,discipline,36,22,14
Penancepapi,stormrage,1283,priest,discipline,30,14,16
Cuddly,shandris,1283,priest,discipline,84,38,46
Jaskil,skywall,1282,priest,discipline,60,32,28
Sauile,kelthuzad,1281,priest,discipline,60,32,28
Dismybracket,tichondrius,1281,priest,discipline,42,20,22
Lifeswap,area-52,1281,priest,discipline,54,21,33
Elixia,maiev,1280,priest,discipline,36,20,16
Ðiscipline,kelthuzad,1280,priest,discipline,68,33,35
Dzpi,azralon,1280,priest,discipline,48,23,25
Saadboii,thrall,1279,priest,discipline,55,29,26
Briefs,stormrage,1278,priest,discipline,21,15,6
Souriel,tichondrius,1278,priest,discipline,78,41,37
Kakao,stormreaver,1278,priest,discipline,120,51,69
Ggums,tichondrius,1277,priest,discipline,45,19,26
Oprawinfree,tichondrius,1276,priest,discipline,54,29,25
Knifê,moon-guard,1276,priest,discipline,102,52,50
Rbgeezus,lightnings-blade,1275,priest,discipline,107,55,52
Lowkii,malfurion,1275,priest,discipline,35,17,18
Nylaza,kiljaeden,1274,priest,discipline,71,28,43
Melforn,moon-guard,1273,priest,discipline,35,14,21
Fanatic,nemesis,1271,priest,discipline,97,48,49
Discgolfsux,sargeras,1271,priest,discipline,50,19,31
Healmegently,bonechewer,1271,priest,discipline,45,15,30
Themøn,quelthalas,1270,priest,discipline,30,16,14
Derlanger,frostmourne,1270,priest,discipline,48,25,23
Twotimechamp,azshara,1269,priest,discipline,50,26,24
Zumbaoqepdqt,quelthalas,1269,priest,discipline,42,19,23
Nanabritches,moon-guard,1268,priest,discipline,74,41,33
Aggravating,mugthol,1267,priest,discipline,176,89,87
Testament,greymane,1267,priest,discipline,120,58,62
Miraz,the-venture-co,1266,priest,discipline,53,29,24
Ahane,wyrmrest-accord,1266,priest,discipline,36,15,21
Náay,ragnaros,1265,priest,discipline,29,19,10
Rakpriest,nerzhul,1264,priest,discipline,26,15,11
Keskima,malganis,1263,priest,discipline,81,51,30
Soaphia,kelthuzad,1263,priest,discipline,84,47,37
Tempgnome,stonemaul,1263,priest,discipline,85,44,41
Wise,wildhammer,1262,priest,discipline,70,37,33
Saràh,stormscale,1262,priest,discipline,94,43,51
Reindharth,quelthalas,1262,priest,discipline,84,35,49
Emlix,tichondrius,1262,priest,discipline,42,14,28
Fesix,akama,1261,priest,discipline,30,17,13
Hideyourkids,stormreaver,1261,priest,discipline,42,18,24
Pico,spirestone,1260,priest,discipline,36,20,16
Hobbs,trollbane,1260,priest,discipline,42,22,20
Wanaatlarboy,dark-iron,1259,priest,discipline,35,21,14
Jestiann,aegwynn,1259,priest,discipline,193,100,93
Alawn,wyrmrest-accord,1259,priest,discipline,120,52,68
Tarny,tichondrius,1258,priest,discipline,40,24,16
Kymosolop,sargeras,1258,priest,discipline,25,14,11
Skall,kirin-tor,1258,priest,discipline,41,21,20
Ickarus,anubarak,1257,priest,discipline,84,47,37
Kenzao,nemesis,1257,priest,discipline,64,30,34
Lge,kelthuzad,1257,priest,discipline,31,14,17
Dartonya,thrall,1257,priest,discipline,36,15,21
Xmasmiracle,korgath,1256,priest,discipline,94,54,40
Gurkorr,boulderfist,1256,priest,discipline,45,20,25
Eleeira,zuljin,1256,priest,discipline,36,15,21
Nìght,trollbane,1255,priest,discipline,96,51,45
Thotznprayrz,bleeding-hollow,1254,priest,discipline,36,23,13
Kuriyasu,emerald-dream,1254,priest,discipline,88,41,47
Chavkoraken,stormrage,1254,priest,discipline,38,15,23
Fatherßrian,draktharon,1253,priest,discipline,30,16,14
Cajl,dathremar,1253,priest,discipline,109,48,61
Mchinder,tanaris,1252,priest,discipline,33,18,15
Yidra,illidan,1252,priest,discipline,30,15,15
Këyglock,kelthuzad,1252,priest,discipline,203,86,117
Kapriestun,tichondrius,1250,priest,discipline,54,32,22
Dosarix,sargeras,1250,priest,discipline,40,23,17
Burpees,dalaran,1250,priest,discipline,28,15,13
Dominantz,khazgoroth,1250,priest,discipline,36,15,21
Frikapp,stormrage,1248,priest,discipline,24,13,11
Allhubris,stormrage,1248,priest,discipline,24,13,11
Lalaliza,kelthuzad,1248,priest,discipline,24,13,11
Webbii,frostmourne,1248,priest,discipline,48,21,27
Curiosities,kiljaeden,1248,priest,discipline,30,13,17
Kayern,kelthuzad,1247,priest,discipline,18,13,5
Meatboxmoldy,blood-furnace,1247,priest,discipline,24,13,11
Lvcia,thrall,1247,priest,discipline,70,35,35
Pce,korialstrasz,1247,priest,discipline,34,13,21
Picurry,frostmourne,1246,priest,discipline,24,13,11
Peacetreaty,bleeding-hollow,1246,priest,discipline,24,13,11
Nearo,barthilas,1246,priest,discipline,30,13,17
Madmilesstv,zuljin,1246,priest,discipline,30,13,17
Akuhei,illidan,1245,priest,discipline,18,13,5
Youaint,sargeras,1245,priest,discipline,30,13,17
Blessedelf,tichondrius,1245,priest,discipline,42,14,28
Croissånt,illidan,1244,priest,discipline,18,13,5
Bòngu,tichondrius,1244,priest,discipline,30,13,17
Haetas,zuljin,1243,priest,discipline,30,13,17
Meiev,quelthalas,1243,priest,discipline,36,13,23
Velandrys,earthen-ring,1242,priest,discipline,24,13,11
Grapës,jubeithos,1242,priest,discipline,48,23,25
Kukion,uldum,1242,priest,discipline,30,13,17
Gránd,emerald-dream,1242,priest,discipline,36,13,23
Sofhya,ragnaros,1241,priest,discipline,94,49,45
Harborcoat,whisperwind,1241,priest,discipline,35,14,21
Fullfear,lothar,1240,priest,discipline,24,13,11
Creòle,area-52,1240,priest,discipline,24,13,11
Seriosity,kelthuzad,1240,priest,discipline,30,13,17
Discobish,sargeras,1239,priest,discipline,30,13,17
Dics,barthilas,1238,priest,discipline,18,13,5
Misaosan,azralon,1238,priest,discipline,60,29,31
Saviorsélf,tichondrius,1238,priest,discipline,78,35,43
Rêvelation,trollbane,1237,priest,discipline,36,18,18
Xuxao,azralon,1237,priest,discipline,35,15,20
Xinnie,illidan,1237,priest,discipline,36,15,21
Hootin,whisperwind,1236,priest,discipline,23,14,9
Holycoww,lightnings-blade,1236,priest,discipline,24,13,11
Voidathon,sargeras,1235,priest,discipline,24,13,11
Bonkerwaffle,kelthuzad,1235,priest,discipline,54,29,25
Betrthenadam,bleeding-hollow,1235,priest,discipline,66,32,34
Magicßoy,magtheridon,1235,priest,discipline,60,29,31
Karmatron,chogall,1235,priest,discipline,30,13,17
Catpictures,stormrage,1235,priest,discipline,30,13,17
Mauriel,proudmoore,1234,priest,discipline,30,13,17
Zapix,tichondrius,1234,priest,discipline,30,13,17
Axelrod,tichondrius,1234,priest,discipline,30,13,17
Dispelbot,kelthuzad,1233,priest,discipline,88,54,34
Scirzzy,tichondrius,1233,priest,discipline,24,13,11
Kinkypriest,tichondrius,1233,priest,discipline,24,13,11
Sanitater,frostmourne,1232,priest,discipline,72,34,38
Chernota,kiljaeden,1232,priest,discipline,30,13,17
Kuroyanagi,ragnaros,1232,priest,discipline,36,13,23
Xora,frostmourne,1232,priest,discipline,36,13,23
Menorsita,tichondrius,1231,priest,discipline,90,43,47
Theboogieman,magtheridon,1231,priest,discipline,54,25,29
Peristalsis,nesingwary,1231,priest,discipline,30,13,17
Holyxb,bleeding-hollow,1231,priest,discipline,36,13,23
Presto,kalecgos,1230,priest,discipline,18,14,4
Stormìst,korgath,1230,priest,discipline,18,13,5
Shïtheals,frostmourne,1230,priest,discipline,42,25,17
Riotgearmd,sargeras,1229,priest,discipline,30,17,13
Lichae,ragnaros,1229,priest,discipline,48,24,24
Kurtsheals,destromath,1228,priest,discipline,60,31,29
Krypticus,tichondrius,1227,priest,discipline,48,28,20
Aape,frostmourne,1227,priest,discipline,24,13,11
Holyren,sargeras,1227,priest,discipline,81,43,38
Notfandy,tichondrius,1227,priest,discipline,36,13,23
Gurbooz,tichondrius,1225,priest,discipline,77,35,42
Bendoverbb,tichondrius,1225,priest,discipline,30,13,17
Eneco,alleria,1223,priest,discipline,162,93,69
Ahitaro,ragnaros,1223,priest,discipline,60,18,42
Haø,stormrage,1222,priest,discipline,194,92,102
Finake,kelthuzad,1221,priest,discipline,61,34,27
Aynone,blood-furnace,1221,priest,discipline,126,60,66
Pòba,malganis,1220,priest,discipline,30,13,17
Kaonn,frostmourne,1219,priest,discipline,185,91,94
Séraphin,proudmoore,1219,priest,discipline,37,16,21
Jic,barthilas,1219,priest,discipline,66,25,41
Nonamegame,sargeras,1218,priest,discipline,78,42,36
Såge,chogall,1218,priest,discipline,147,76,71
Yvága,ragnaros,1217,priest,discipline,48,27,21
Smashhley,bleeding-hollow,1216,priest,discipline,24,13,11
Russbell,ragnaros,1215,priest,discipline,125,54,71
Aipata,stormrage,1214,priest,discipline,44,24,20
Orìsel,wyrmrest-accord,1214,priest,discipline,93,42,51
Castnngcouch,tichondrius,1213,priest,discipline,175,85,90
Armspriest,stormrage,1212,priest,discipline,47,24,23
Visse,auchindoun,1212,priest,discipline,211,98,113
Nóin,tichondrius,1212,priest,discipline,72,33,39
Wísh,emerald-dream,1211,priest,discipline,60,35,25
Dotersacer,quelthalas,1211,priest,discipline,31,15,16
Deckardkane,stormrage,1209,priest,discipline,32,14,18
Bröke,nemesis,1208,priest,discipline,60,32,28
Ariavish,area-52,1208,priest,discipline,48,25,23
Kodaks,frostmourne,1208,priest,discipline,75,37,38
Methodist,sargeras,1207,priest,discipline,24,13,11
Pixa,tichondrius,1207,priest,discipline,72,33,39
Kithlas,emerald-dream,1206,priest,discipline,18,13,5
Nothinsexual,frostmourne,1206,priest,discipline,26,14,12
Dpshealer,azralon,1206,priest,discipline,66,29,37
Tdmheals,zuluhed,1204,priest,discipline,24,18,6
Pactosombrio,azralon,1204,priest,discipline,94,52,42
Svrite,area-52,1204,priest,discipline,29,15,14
Rowman,frostmourne,1204,priest,discipline,47,22,25
Libationz,area-52,1204,priest,discipline,108,49,59
Vancake,quelthalas,1204,priest,discipline,156,69,87
Psychiatrist,darkspear,1204,priest,discipline,58,25,33
Inferis,ragnaros,1203,priest,discipline,348,173,175
Ithvedriel,moon-guard,1203,priest,discipline,67,32,35
Ðelight,ragnaros,1202,priest,discipline,42,18,24
Wrathchildd,azralon,1201,priest,discipline,84,42,42
Healzyew,dragonmaw,1201,priest,discipline,73,28,45
Defilex,tichondrius,1199,priest,discipline,21,14,7
Zephxd,illidan,1199,priest,discipline,64,31,33
Terenor,thrall,1199,priest,discipline,42,13,29
Jtewatch,zuljin,1197,priest,discipline,30,23,7
Sasafras,feathermoon,1196,priest,discipline,78,39,39
Cast,bronzebeard,1196,priest,discipline,42,17,25
Abhu,quelthalas,1195,priest,discipline,31,18,13
Deadlydocc,illidan,1195,priest,discipline,33,18,15
Fozil,area-52,1194,priest,discipline,62,33,29
Bladam,bleeding-hollow,1192,priest,discipline,27,13,14
Tomseleck,frostmourne,1191,priest,discipline,29,13,16
Healyoudead,draenor,1191,priest,discipline,41,15,26
Dokthekim,frostmourne,1190,priest,discipline,26,14,12
Holyycrit,kelthuzad,1189,priest,discipline,30,16,14
Rinmaru,dark-iron,1188,priest,discipline,24,14,10
Goingserious,frostmourne,1188,priest,discipline,81,46,35
Iltharaph,illidan,1188,priest,discipline,25,14,11
Ktqt,moon-guard,1188,priest,discipline,148,70,78
Yukih,tichondrius,1188,priest,discipline,41,17,24
Inarius,dragonblight,1188,priest,discipline,42,17,25
Kruciphix,tichondrius,1187,priest,discipline,29,20,9
Kaxleigh,emerald-dream,1187,priest,discipline,29,18,11
Sëv,stormrage,1187,priest,discipline,29,14,15
Phaille,chromaggus,1185,priest,discipline,80,41,39
Eirenth,bleeding-hollow,1184,priest,discipline,18,14,4
Tesserak,tichondrius,1184,priest,discipline,105,49,56
Unwòke,dalaran,1182,priest,discipline,24,14,10
Happydot,stormrage,1182,priest,discipline,30,14,16
Belletrael,wyrmrest-accord,1182,priest,discipline,70,32,38
Kßnstuff,area-52,1182,priest,discipline,37,15,22
Doubtmyfaith,frostmourne,1181,priest,discipline,42,21,21
Gongá,moon-guard,1179,priest,discipline,87,33,54
Icyspicy,shadowsong,1177,priest,discipline,59,26,33
Iwillsaveyou,tichondrius,1177,priest,discipline,40,16,24
Damoclexz,area-52,1176,priest,discipline,72,38,34
Dittless,stormrage,1176,priest,discipline,36,16,20
Jagelclam,gorefiend,1175,priest,discipline,47,22,25
Kethseth,ragnaros,1175,priest,discipline,102,45,57
Hiheals,anvilmar,1174,priest,discipline,36,20,16
Slewt,aggramar,1173,priest,discipline,24,13,11
Mindlames,bleeding-hollow,1173,priest,discipline,68,30,38
Minimelo,stormrage,1172,priest,discipline,23,13,10
Spyzz,gilneas,1172,priest,discipline,36,18,18
Aliciab,andorhal,1172,priest,discipline,78,36,42
Psïcopata,gallywix,1171,priest,discipline,54,16,38
Toastanator,wyrmrest-accord,1170,priest,discipline,143,81,62
Eîr,tichondrius,1170,priest,discipline,66,24,42
Kerazul,sargeras,1169,priest,discipline,42,20,22
Moralism,moon-guard,1167,priest,discipline,38,22,16
Killían,darkspear,1166,priest,discipline,37,20,17
Zadae,area-52,1166,priest,discipline,51,26,25
Kafzial,zuljin,1162,priest,discipline,74,43,31
Priést,stormrage,1162,priest,discipline,36,13,23
Varbirttok,sargeras,1160,priest,discipline,37,14,23
Dralaan,proudmoore,1159,priest,discipline,63,26,37
Semirg,moon-guard,1158,priest,discipline,30,13,17
Köto,dalaran,1157,priest,discipline,23,13,10
Coldphobia,uldum,1157,priest,discipline,32,14,18
Gobnik,illidan,1156,priest,discipline,24,16,8
Khallmir,goldrinn,1156,priest,discipline,36,15,21
Voidwyrm,tichondrius,1155,priest,discipline,72,39,33
Xaerwolaeth,area-52,1155,priest,discipline,34,16,18
Abalowpt,nemesis,1154,priest,discipline,36,16,20
Sylvphrena,stormrage,1152,priest,discipline,18,12,6
Maraagsdad,tichondrius,1152,priest,discipline,18,12,6
Kalyndaxo,frostmourne,1152,priest,discipline,24,12,12
Teddyy,tichondrius,1152,priest,discipline,24,12,12
Ultradumb,ragnaros,1152,priest,discipline,24,12,12
Swagdemøn,kelthuzad,1152,priest,discipline,24,12,12
Ømegagødx,illidan,1152,priest,discipline,30,12,18
Eudog,zuljin,1151,priest,discipline,12,12,0
Addisonraee,tichondrius,1151,priest,discipline,12,12,0
Faithbuild,emerald-dream,1151,priest,discipline,18,12,6
Skeepsi,area-52,1151,priest,discipline,30,18,12
Randrimm,stormrage,1151,priest,discipline,24,12,12
Pewwpew,malganis,1151,priest,discipline,24,12,12
Hyoeun,dragonmaw,1151,priest,discipline,24,12,12
Alphôn,bleeding-hollow,1151,priest,discipline,24,12,12
Sshhaaddooww,tichondrius,1151,priest,discipline,24,12,12
Kiriko,mannoroth,1151,priest,discipline,24,12,12
Momorabbit,tichondrius,1151,priest,discipline,30,12,18
Attenea,illidan,1151,priest,discipline,36,12,24
Ilmx,illidan,1150,priest,discipline,12,12,0
Pastapizza,zuljin,1150,priest,discipline,12,12,0
Aaff,tichondrius,1150,priest,discipline,18,12,6
Chkashaa,emerald-dream,1150,priest,discipline,42,21,21
Rhaist,sargeras,1150,priest,discipline,36,18,18
Glöws,area-52,1150,priest,discipline,24,12,12
Papafajita,area-52,1150,priest,discipline,24,12,12
Ahealer,alterac-mountains,1150,priest,discipline,24,12,12
Wartrix,bonechewer,1150,priest,discipline,24,12,12
Icesnowli,tichondrius,1150,priest,discipline,24,12,12
Cenrtrix,stormrage,1150,priest,discipline,24,12,12
Crunchywater,stormrage,1150,priest,discipline,24,12,12
Abercromby,malganis,1150,priest,discipline,25,12,13
Penancedeez,moon-guard,1150,priest,discipline,35,15,20
Maxximuss,bleeding-hollow,1150,priest,discipline,42,17,25
Dayquills,illidan,1150,priest,discipline,30,12,18
Bakara,jubeithos,1150,priest,discipline,36,12,24
Profpepper,tichondrius,1149,priest,discipline,18,12,6
Marethelia,stonemaul,1149,priest,discipline,18,12,6
Sungji,tichondrius,1149,priest,discipline,24,12,12
Pakc,tichondrius,1149,priest,discipline,24,12,12
Shadowchaos,malganis,1149,priest,discipline,24,12,12
Nerfholyplz,illidan,1149,priest,discipline,24,12,12
Kitenix,proudmoore,1149,priest,discipline,35,14,21
Gigaflex,sargeras,1148,priest,discipline,24,12,12
Amaranth,the-forgotten-coast,1148,priest,discipline,24,12,12
Luminatio,quelthalas,1148,priest,discipline,76,36,40
Ekros,illidan,1147,priest,discipline,25,13,12
Opscurum,bleeding-hollow,1147,priest,discipline,24,12,12
Cigarillõ,thrall,1147,priest,discipline,24,12,12
Nutsin,tichondrius,1147,priest,discipline,30,12,18
Scrubgames,garrosh,1146,priest,discipline,12,12,0
Bakerstr,tichondrius,1146,priest,discipline,18,12,6
Lynnar,stormrage,1146,priest,discipline,54,30,24
Smightful,garona,1146,priest,discipline,24,12,12
Invocational,moon-guard,1146,priest,discipline,35,15,20
Lilbaldjosh,frostmourne,1146,priest,discipline,36,12,24
Atelios,azralon,1145,priest,discipline,18,13,5
Benin,shattered-hand,1144,priest,discipline,18,12,6
Mashpotato,aerie-peak,1144,priest,discipline,24,13,11
Mindkilla,area-52,1143,priest,discipline,84,46,38
Thoaxx,magtheridon,1143,priest,discipline,24,12,12
Depressedboy,wyrmrest-accord,1143,priest,discipline,24,12,12
Fìngerbanger,lightnings-blade,1143,priest,discipline,66,28,38
Mutilla,tichondrius,1142,priest,discipline,18,12,6
Supski,destromath,1141,priest,discipline,24,12,12
Vanhealsing,tichondrius,1141,priest,discipline,24,12,12
Ulzaar,nerzhul,1141,priest,discipline,42,12,30
Osombra,azralon,1139,priest,discipline,36,17,19
Boibussy,tichondrius,1139,priest,discipline,30,13,17
Draniev,azralon,1138,priest,discipline,83,44,39
Elvspriesly,doomhammer,1138,priest,discipline,104,51,53
Drywàter,tichondrius,1137,priest,discipline,81,45,36
Hanuroa,tichondrius,1136,priest,discipline,184,92,92
Brotherheals,nagrand,1136,priest,discipline,60,30,30
Inot,nemesis,1136,priest,discipline,41,12,29
Blessings,aerie-peak,1135,priest,discipline,66,34,32
Senumbra,tichondrius,1134,priest,discipline,24,12,12
Faerline,kelthuzad,1134,priest,discipline,29,12,17
Myeryc,frostmourne,1134,priest,discipline,35,12,23
Arodar,wyrmrest-accord,1132,priest,discipline,24,12,12
Goodbyekiss,illidan,1132,priest,discipline,65,31,34
Thinmintt,wyrmrest-accord,1132,priest,discipline,60,25,35
Ayakoji,proudmoore,1132,priest,discipline,30,12,18
Ihealyoudeal,korgath,1130,priest,discipline,18,12,6
Charybdis,bonechewer,1129,priest,discipline,92,56,36
Makkima,area-52,1129,priest,discipline,48,20,28
Corthien,thrall,1129,priest,discipline,30,12,18
Pushap,blood-furnace,1128,priest,discipline,66,36,30
Mäy,greymane,1128,priest,discipline,24,12,12
Cyrilien,tichondrius,1127,priest,discipline,52,29,23
Ragnarøk,warsong,1127,priest,discipline,30,12,18
Zolibeth,azshara,1124,priest,discipline,24,15,9
Eluv,area-52,1122,priest,discipline,30,16,14
Ðåmìéñ,tichondrius,1122,priest,discipline,24,12,12
Fulldesire,dalaran,1121,priest,discipline,63,38,25
Londog,vashj,1121,priest,discipline,78,36,42
Lanäthel,sargeras,1119,priest,discipline,16,13,3
Primeevil,black-dragonflight,1119,priest,discipline,24,14,10
Priestøuchme,tichondrius,1119,priest,discipline,23,13,10
Nardhead,sargeras,1118,priest,discipline,36,20,16
Hoochiemomma,kelthuzad,1115,priest,discipline,18,12,6
Cvstodia,tichondrius,1115,priest,discipline,24,12,12
Vitalizes,nagrand,1114,priest,discipline,30,13,17
Celf,ragnaros,1113,priest,discipline,30,12,18
Sístermary,stormrage,1112,priest,discipline,24,16,8
Tetha,fizzcrank,1112,priest,discipline,30,14,16
Steezyy,black-dragonflight,1112,priest,discipline,65,30,35
Foxyy,wildhammer,1112,priest,discipline,35,14,21
Trustheals,tichondrius,1109,priest,discipline,36,22,14
Rhayzel,ragnaros,1108,priest,discipline,30,15,15
Fushia,emerald-dream,1107,priest,discipline,45,16,29
Optîmuskrayt,tichondrius,1106,priest,discipline,83,40,43
Tootsieroll,dark-iron,1106,priest,discipline,53,25,28
Abbot,zangarmarsh,1105,priest,discipline,120,56,64
Opri,andorhal,1104,priest,discipline,48,20,28
Ataraksija,sargeras,1103,priest,discipline,21,13,8
Anäster,ragnaros,1103,priest,discipline,47,24,23
Kloudypriest,moon-guard,1103,priest,discipline,47,24,23
Súlfuro,quelthalas,1103,priest,discipline,83,39,44
Averli,moon-guard,1103,priest,discipline,42,18,24
Khamata,kelthuzad,1100,priest,discipline,30,12,18
Wheresmyvape,tichondrius,1098,priest,discipline,20,13,7
Steck,illidan,1098,priest,discipline,30,15,15
Lilbabynaga,stormrage,1097,priest,discipline,63,23,40
Vákc,quelthalas,1096,priest,discipline,23,12,11
Draiger,quelthalas,1096,priest,discipline,36,14,22
Fistavert,stormreaver,1095,priest,discipline,24,12,12
Joní,malganis,1094,priest,discipline,29,13,16
Shaytyme,tichondrius,1094,priest,discipline,34,13,21
Mcdizzle,bloodscalp,1093,priest,discipline,90,41,49
Valonar,emerald-dream,1090,priest,discipline,29,13,16
Zacksnotcool,sargeras,1090,priest,discipline,33,13,20
Benmem,illidan,1089,priest,discipline,64,30,34
Bigdaddyku,hyjal,1088,priest,discipline,34,20,14
Holysmokesx,tichondrius,1087,priest,discipline,22,12,10
Antiraus,aerie-peak,1086,priest,discipline,24,13,11
Alizeë,illidan,1086,priest,discipline,119,63,56
Fatherfilth,frostwolf,1086,priest,discipline,30,14,16
Deehilie,illidan,1085,priest,discipline,37,19,18
Solkadp,tichondrius,1085,priest,discipline,28,12,16
Quavö,tichondrius,1085,priest,discipline,68,29,39
Kidha,stormrage,1085,priest,discipline,60,19,41
Enkognito,tichondrius,1083,priest,discipline,34,23,11
Vaddaru,kirin-tor,1083,priest,discipline,66,38,28
Cypress,dreadmaul,1082,priest,discipline,140,70,70
Sadury,tichondrius,1081,priest,discipline,47,30,17
Spellpower,azralon,1081,priest,discipline,29,13,16
Puralux,balnazzar,1080,priest,discipline,24,15,9
Synes,bleeding-hollow,1080,priest,discipline,34,12,22
Tmpriest,tichondrius,1080,priest,discipline,48,12,36
Fregè,ysera,1078,priest,discipline,30,12,18
Novoc,blackhand,1076,priest,discipline,36,17,19
Anakou,emerald-dream,1074,priest,discipline,23,13,10
Redchord,kiljaeden,1072,priest,discipline,33,13,20
Psïren,quelthalas,1070,priest,discipline,24,13,11
Nenemsis,drakkari,1070,priest,discipline,26,12,14
Tricklee,tichondrius,1068,priest,discipline,23,12,11
Kyoku,tanaris,1067,priest,discipline,23,12,11
Zhaann,kelthuzad,1067,priest,discipline,30,14,16
Twinkmuncher,proudmoore,1065,priest,discipline,25,12,13
Mtito,drakkari,1063,priest,discipline,25,13,12
Vahlen,azralon,1062,priest,discipline,23,12,11
Jmjeezy,tichondrius,1056,priest,discipline,18,11,7
Maghobou,tichondrius,1056,priest,discipline,18,11,7
Lespaula,ragnaros,1056,priest,discipline,24,12,12
Walterwhite,bleeding-hollow,1056,priest,discipline,30,11,19
Ogneus,crushridge,1056,priest,discipline,30,11,19
Naelsaze,tichondrius,1055,priest,discipline,12,11,1
Crucifer,proudmoore,1055,priest,discipline,12,11,1
Piftw,illidan,1055,priest,discipline,18,11,7
Vehex,malganis,1055,priest,discipline,18,11,7
Septmoon,tichondrius,1055,priest,discipline,18,11,7
Ffej,bleeding-hollow,1055,priest,discipline,24,11,13
Tooziq,stormrage,1055,priest,discipline,24,11,13
Anastasiá,barthilas,1055,priest,discipline,30,11,19
Wintrow,sargeras,1055,priest,discipline,30,11,19
Lampvpgerl,illidan,1055,priest,discipline,36,11,25
Turrec,illidan,1054,priest,discipline,12,11,1
Aiss,malganis,1054,priest,discipline,16,12,4
Missyoung,tichondrius,1054,priest,discipline,18,11,7
Honeyweiss,cairne,1054,priest,discipline,24,12,12
Sentactic,illidan,1054,priest,discipline,27,13,14
Dpsmercy,sargeras,1054,priest,discipline,24,11,13
Goneqt,illidan,1054,priest,discipline,30,11,19
Doubt,eredar,1053,priest,discipline,18,11,7
Whitepigogo,tichondrius,1053,priest,discipline,18,11,7
Slavoj,gurubashi,1052,priest,discipline,41,19,22
ßlackøut,sargeras,1052,priest,discipline,24,11,13
Spacecowboyz,stormrage,1052,priest,discipline,24,11,13
Kerith,ragnaros,1051,priest,discipline,34,24,10
Efrem,tichondrius,1051,priest,discipline,60,28,32
Darkills,tichondrius,1051,priest,discipline,24,11,13
Daleyn,ragnaros,1051,priest,discipline,24,11,13
Lumia,quelthalas,1051,priest,discipline,30,11,19
Saviorr,dalaran,1051,priest,discipline,30,11,19
Moopha,zuljin,1050,priest,discipline,12,11,1
Zarfel,ragnaros,1050,priest,discipline,18,11,7
Silnetlee,tichondrius,1050,priest,discipline,18,11,7
Prniss,tichondrius,1050,priest,discipline,18,11,7
Lalight,tichondrius,1050,priest,discipline,30,11,19
Jabreez,illidan,1049,priest,discipline,18,11,7
Posabilties,bleeding-hollow,1049,priest,discipline,24,11,13
Wíckéd,frostmourne,1049,priest,discipline,30,11,19
Inmortar,dalaran,1049,priest,discipline,30,11,19
Zhatfko,illidan,1049,priest,discipline,36,11,25
Sajahsa,moon-guard,1048,priest,discipline,25,15,10
Ricksanchez,moonrunner,1047,priest,discipline,24,11,13
Jackflashh,hakkar,1047,priest,discipline,78,35,43
Quinnx,tichondrius,1046,priest,discipline,24,11,13
Feff,shuhalo,1046,priest,discipline,30,11,19
Aud,kiljaeden,1045,priest,discipline,12,11,1
Knez,ragnaros,1045,priest,discipline,18,11,7
Lilbabe,stormrage,1043,priest,discipline,24,11,13
Femalema,tichondrius,1042,priest,discipline,27,13,14
Flexeggette,illidan,1042,priest,discipline,31,14,17
Holyhog,whisperwind,1042,priest,discipline,33,13,20
Bedläm,kilrogg,1042,priest,discipline,30,11,19
Dottinu,area-52,1040,priest,discipline,12,11,1
Notdavido,illidan,1040,priest,discipline,18,11,7
Sinthe,stormrage,1039,priest,discipline,18,12,6
Sendia,hydraxis,1038,priest,discipline,66,31,35
Dalowks,area-52,1038,priest,discipline,30,11,19
Gungagingong,queldorei,1035,priest,discipline,18,11,7
Mottsarella,mugthol,1035,priest,discipline,66,37,29
Linarelitha,area-52,1035,priest,discipline,38,18,20
Donoras,ursin,1033,priest,discipline,18,11,7
Uchihalol,tichondrius,1032,priest,discipline,24,11,13
Geulis,illidan,1030,priest,discipline,65,30,35
Discotecno,tichondrius,1030,priest,discipline,24,11,13
Uljinoo,blackwing-lair,1028,priest,discipline,38,16,22
Egraner,drakkari,1027,priest,discipline,24,11,13
Bakharftw,nemesis,1023,priest,discipline,28,17,11
Astalail,emerald-dream,1022,priest,discipline,22,11,11
Mxd,bleeding-hollow,1021,priest,discipline,20,12,8
Taedrid,stormrage,1021,priest,discipline,59,22,37
Mgfoxxie,scarlet-crusade,1020,priest,discipline,30,12,18
Gnralways,andorhal,1020,priest,discipline,39,12,27
Thadan,uldaman,1019,priest,discipline,24,11,13
Sév,frostmane,1017,priest,discipline,190,89,101
Nightmxres,zuljin,1016,priest,discipline,30,11,19
Shaydeep,nagrand,1015,priest,discipline,22,12,10
Jèf,stormrage,1015,priest,discipline,23,11,12
Profît,stormrage,1014,priest,discipline,24,12,12
Anneyann,fenris,1012,priest,discipline,18,12,6
Sublety,aerie-peak,1011,priest,discipline,30,14,16
Drãith,magtheridon,1009,priest,discipline,24,12,12
Dynopriest,kelthuzad,1007,priest,discipline,29,11,18
Happylonely,farstriders,1006,priest,discipline,15,11,4
Lesserfaith,sargeras,1006,priest,discipline,21,11,10
Lördgrim,stormrage,1002,priest,discipline,25,13,12
Ketone,malganis,1002,priest,discipline,81,41,40
Tikel,ragnaros,1001,priest,discipline,21,11,10
Stinkyfingr,frostmourne,1000,priest,discipline,42,15,27
Ayezex,tichondrius,999,priest,discipline,30,12,18
Aerîs,magtheridon,998,priest,discipline,34,12,22
Classifiedcc,illidan,997,priest,discipline,29,16,13
Bårriër,darkspear,996,priest,discipline,23,12,11
Methodist,proudmoore,996,priest,discipline,34,12,22
Rescueherø,tichondrius,992,priest,discipline,24,14,10
Robertsmurda,emerald-dream,992,priest,discipline,22,11,11
Macoa,zuljin,992,priest,discipline,54,25,29
Norastanne,moon-guard,992,priest,discipline,27,12,15
Cilpri,emerald-dream,991,priest,discipline,16,11,5
Lamont,archimonde,991,priest,discipline,32,11,21
Carbonated,zuljin,986,priest,discipline,17,11,6
Scaloni,proudmoore,980,priest,discipline,17,11,6
Diamontie,tichondrius,977,priest,discipline,26,16,10
Alurand,bleeding-hollow,976,priest,discipline,18,11,7
Hèáls,tichondrius,975,priest,discipline,66,29,37
Cellestine,aggramar,975,priest,discipline,31,11,20
Exsufficate,frostmourne,974,priest,discipline,22,12,10
Sölemn,barthilas,971,priest,discipline,53,21,32
Mikkik,zuljin,970,priest,discipline,30,18,12
Sharkda,frostmourne,965,priest,discipline,39,20,19
Cezanne,tichondrius,961,priest,discipline,125,52,73
Charón,tichondrius,960,priest,discipline,12,10,2
Tinyheal,sargeras,960,priest,discipline,12,10,2
Swaggie,skullcrusher,960,priest,discipline,12,10,2
Harlei,tichondrius,960,priest,discipline,18,11,7
Bswagxx,illidan,960,priest,discipline,18,10,8
Ggwizkaboo,tichondrius,960,priest,discipline,18,10,8
Likehisname,tichondrius,960,priest,discipline,18,10,8
Fishondabeat,proudmoore,960,priest,discipline,18,10,8
Shadina,gorefiend,960,priest,discipline,18,10,8
Barley,chogall,960,priest,discipline,18,10,8
Testzpriests,dalaran,960,priest,discipline,18,10,8
Ishyeboi,stormrage,960,priest,discipline,18,10,8
Wbu,frostmourne,960,priest,discipline,18,10,8
Belielosong,moon-guard,960,priest,discipline,57,29,28
Fyne,kelthuzad,960,priest,discipline,21,10,11
Fotmtrash,the-underbog,960,priest,discipline,24,10,14
Nobodystarx,steamwheedle-cartel,960,priest,discipline,24,10,14
Ajxoz,thrall,960,priest,discipline,24,10,14
Kk,fizzcrank,959,priest,discipline,12,10,2
Hm,the-scryers,959,priest,discipline,12,10,2
Kóba,bleeding-hollow,959,priest,discipline,12,10,2
Jinforever,tichondrius,959,priest,discipline,12,10,2
Elimix,frostmourne,959,priest,discipline,12,10,2
Henchwoman,stormrage,959,priest,discipline,12,10,2
Krupticus,tichondrius,959,priest,discipline,16,11,5
Cigma,magtheridon,959,priest,discipline,18,10,8
Gutrìck,tichondrius,959,priest,discipline,18,10,8
Gamepass,tichondrius,959,priest,discipline,18,10,8
Pocket,alleria,959,priest,discipline,18,10,8
Thorzan,eredar,959,priest,discipline,18,10,8
Jzd,dreadmaul,959,priest,discipline,18,10,8
Budlyy,dalaran,959,priest,discipline,18,10,8
Crøws,ragnaros,959,priest,discipline,18,10,8
Tamzy,eredar,959,priest,discipline,18,10,8
Itachî,ravencrest,959,priest,discipline,18,10,8
Oduum,tichondrius,959,priest,discipline,18,10,8
Arianthe,darrowmere,959,priest,discipline,18,10,8
Csjy,illidan,959,priest,discipline,18,10,8
Azrïel,mannoroth,959,priest,discipline,29,16,13
Stylébender,tichondrius,959,priest,discipline,24,10,14
Feivalentine,illidan,959,priest,discipline,24,10,14
Mosquito,tichondrius,959,priest,discipline,24,10,14
Dorazòn,bleeding-hollow,959,priest,discipline,24,10,14
Tshik,ragnaros,959,priest,discipline,24,10,14
Johadorr,shadowsong,959,priest,discipline,24,10,14
Byck,tichondrius,959,priest,discipline,30,10,20
Grimoz,illidan,959,priest,discipline,36,10,26
Rebzyyx,tichondrius,958,priest,discipline,12,10,2
Phrìke,illidan,958,priest,discipline,18,10,8
Raivn,illidan,958,priest,discipline,18,10,8
Glitterballs,khazgoroth,958,priest,discipline,18,10,8
Spx,frostmourne,958,priest,discipline,18,10,8
Tîg,nemesis,958,priest,discipline,21,10,11
Rhennythal,tichondrius,958,priest,discipline,24,10,14
Xävier,farstriders,958,priest,discipline,24,10,14
Fashion,bleeding-hollow,957,priest,discipline,12,10,2
Senpriest,ragnaros,957,priest,discipline,18,10,8
Akkassha,zuljin,957,priest,discipline,18,10,8
Wilburre,sargeras,957,priest,discipline,18,10,8
Bigchalupaz,sargeras,957,priest,discipline,18,10,8
Rellington,frostwolf,957,priest,discipline,24,10,14
Emmelly,whisperwind,957,priest,discipline,24,10,14
Chanyt,azralon,956,priest,discipline,12,10,2
Rigityrekt,aggramar,956,priest,discipline,18,13,5
Hoffmanx,emerald-dream,956,priest,discipline,18,10,8
Aexdawg,malganis,956,priest,discipline,18,10,8
Alphe,sargeras,956,priest,discipline,18,10,8
Ripscrew,area-52,956,priest,discipline,18,10,8
Huck,khazgoroth,955,priest,discipline,18,10,8
Galaxypepe,medivh,955,priest,discipline,23,10,13
Çõrlëøñè,illidan,955,priest,discipline,24,10,14
Bachaterah,skullcrusher,955,priest,discipline,24,10,14
Fidalus,stormrage,955,priest,discipline,38,10,28
Hanklin,lightnings-blade,954,priest,discipline,18,10,8
Chinsta,tichondrius,954,priest,discipline,24,10,14
Kerahk,drakkari,954,priest,discipline,26,10,16
Anthoras,stormrage,953,priest,discipline,18,10,8
Spõt,stormrage,953,priest,discipline,24,10,14
Flagged,azgalor,953,priest,discipline,24,10,14
Worthy,runetotem,952,priest,discipline,18,10,8
Kjpriest,kelthuzad,952,priest,discipline,18,10,8
Jessicä,malganis,952,priest,discipline,18,10,8
Xiöm,quelthalas,952,priest,discipline,24,10,14
Atyourcervix,emerald-dream,951,priest,discipline,18,10,8
Daijoubu,lightnings-blade,951,priest,discipline,24,10,14
Discbubbles,moonrunner,950,priest,discipline,18,10,8
Throwinshadê,stormrage,950,priest,discipline,90,46,44
Zeas,moon-guard,950,priest,discipline,66,23,43
Threlad,elune,949,priest,discipline,18,10,8
Howdydoo,azshara,949,priest,discipline,31,10,21
Cravex,stormrage,948,priest,discipline,30,14,16
Filterz,korgath,948,priest,discipline,24,10,14
Samsunglions,tichondrius,947,priest,discipline,18,10,8
Moomagic,sargeras,945,priest,discipline,42,16,26
Lusch,stormscale,943,priest,discipline,61,32,29
Praiz,tichondrius,942,priest,discipline,24,15,9
Youngboys,stormreaver,942,priest,discipline,30,16,14
Icemeilarda,illidan,940,priest,discipline,81,32,49
Sisterdeáth,area-52,938,priest,discipline,24,11,13
Neehow,hyjal,936,priest,discipline,12,10,2
Miel,kargath,935,priest,discipline,60,22,38
Preezoo,tichondrius,932,priest,discipline,30,10,20
Toastedheal,stormreaver,927,priest,discipline,20,11,9
Voidwulf,azgalor,924,priest,discipline,107,52,55
Kauldër,illidan,924,priest,discipline,23,10,13
Rymzxx,ragnaros,918,priest,discipline,19,11,8
Thekingheals,draenor,918,priest,discipline,28,14,14
Aladelre,aerie-peak,914,priest,discipline,26,11,15
Matafuka,ragnaros,913,priest,discipline,22,11,11
Luxah,bloodhoof,911,priest,discipline,15,11,4
Twistedead,illidan,911,priest,discipline,21,11,10
Priestrix,frostmourne,910,priest,discipline,55,22,33
Brock,lightbringer,905,priest,discipline,27,11,16
Ðanté,the-venture-co,904,priest,discipline,22,13,9
Eluko,tichondrius,904,priest,discipline,21,11,10
Ohashi,ragnaros,902,priest,discipline,18,11,7
Fujinpriest,azralon,894,priest,discipline,28,10,18
Aladdinlol,tichondrius,894,priest,discipline,34,10,24
Chapitä,drakkari,893,priest,discipline,16,10,6
Tezcatyo,area-52,891,priest,discipline,17,10,7
Kaizzen,gorgonnash,891,priest,discipline,17,10,7
Lunett,area-52,887,priest,discipline,34,10,24
Deusthanatos,medivh,879,priest,discipline,28,12,16
Khinthazin,barthilas,878,priest,discipline,42,20,22
Arfaxad,quelthalas,864,priest,discipline,12,9,3
Trinaty,senjin,864,priest,discipline,12,9,3
Gillette,thunderlord,864,priest,discipline,12,9,3
Néy,illidan,864,priest,discipline,12,9,3
Squiddyjr,tichondrius,864,priest,discipline,12,9,3
Mswatermelon,malganis,864,priest,discipline,16,10,6
Marcalus,garrosh,864,priest,discipline,15,9,6
Gekko,azgalor,864,priest,discipline,18,9,9
Arcmage,malganis,864,priest,discipline,18,9,9
Toteme,proudmoore,864,priest,discipline,18,9,9
Jonesypriest,tichondrius,864,priest,discipline,18,9,9
Sinnskløft,tichondrius,864,priest,discipline,18,9,9
Challengerz,suramar,864,priest,discipline,18,9,9
Cinnalite,darkspear,864,priest,discipline,18,9,9
Inmotion,tichondrius,864,priest,discipline,18,9,9
June,dragonmaw,864,priest,discipline,18,9,9
Zlowbly,ragnaros,864,priest,discipline,18,9,9
Wv,kelthuzad,864,priest,discipline,18,9,9
Healthyadult,zuluhed,864,priest,discipline,18,9,9
Biggunsaint,icecrown,864,priest,discipline,18,9,9
Kencyx,tichondrius,864,priest,discipline,18,9,9
Ilovedailies,frostmourne,864,priest,discipline,18,9,9
Shadooe,tichondrius,864,priest,discipline,18,9,9
Phurbosjr,sargeras,864,priest,discipline,18,9,9
Renfury,bleeding-hollow,864,priest,discipline,24,9,15
Dasaq,sargeras,864,priest,discipline,24,9,15
Lostmind,malganis,864,priest,discipline,24,9,15
Dakp,sargeras,864,priest,discipline,24,9,15
Voidgames,area-52,864,priest,discipline,24,9,15
Ninbará,stormrage,864,priest,discipline,24,9,15
Marminator,stormrage,864,priest,discipline,24,9,15
Neuro,barthilas,863,priest,discipline,12,9,3
Djxkidrock,moon-guard,863,priest,discipline,12,9,3
Davinatrans,azralon,863,priest,discipline,12,9,3
Boycrazy,nerzhul,863,priest,discipline,12,9,3
Stroserous,hyjal,863,priest,discipline,12,9,3
Starpass,illidan,863,priest,discipline,12,9,3
Helleamh,tichondrius,863,priest,discipline,12,9,3
Maleklek,azralon,863,priest,discipline,12,9,3
Frotters,kiljaeden,863,priest,discipline,18,9,9
Hottymcdotty,black-dragonflight,863,priest,discipline,18,9,9
Fugazy,barthilas,863,priest,discipline,18,9,9
Iamrisen,tichondrius,863,priest,discipline,18,9,9
Lemmiewinkzx,sargeras,863,priest,discipline,18,9,9
Digop,azralon,863,priest,discipline,18,9,9
Oprst,tichondrius,863,priest,discipline,18,9,9
Darkmoonsun,frostmourne,863,priest,discipline,18,9,9
Aleana,ragnaros,863,priest,discipline,18,9,9
Dojacatx,frostmourne,863,priest,discipline,24,9,15
Mudbuttman,kelthuzad,863,priest,discipline,24,9,15
Marshpillow,barthilas,863,priest,discipline,24,9,15
Bubblerenew,altar-of-storms,863,priest,discipline,24,9,15
Shadowgobbo,thrall,863,priest,discipline,24,9,15
Mothra,ragnaros,862,priest,discipline,12,9,3
Gäindalf,tichondrius,862,priest,discipline,16,10,6
Drerrdaytv,kelthuzad,862,priest,discipline,18,9,9
Redclover,tichondrius,862,priest,discipline,18,9,9
Ppomx,tichondrius,862,priest,discipline,18,9,9
Neuroflex,proudmoore,862,priest,discipline,18,9,9
Satanshealer,terokkar,862,priest,discipline,18,9,9
Rondrica,stormscale,862,priest,discipline,18,9,9
Tyrea,kiljaeden,862,priest,discipline,18,9,9
Lacerating,illidan,862,priest,discipline,18,9,9
Releknosleep,frostwolf,862,priest,discipline,19,9,10
Auras,boulderfist,862,priest,discipline,22,10,12
Padragon,tichondrius,862,priest,discipline,24,9,15
Discountay,burning-legion,861,priest,discipline,18,9,9
Ohgiddy,dalaran,861,priest,discipline,24,9,15
Blinxed,tichondrius,861,priest,discipline,24,9,15
Jeraphìm,tichondrius,860,priest,discipline,18,9,9
Imcringing,illidan,860,priest,discipline,18,9,9
Mawlaana,frostmourne,860,priest,discipline,18,9,9
Ilickdeadppl,sargeras,860,priest,discipline,18,9,9
Discalaneous,tichondrius,860,priest,discipline,27,9,18
Forestpriest,area-52,859,priest,discipline,18,9,9
Moresbo,frostmourne,859,priest,discipline,18,9,9
Pacopriest,tichondrius,859,priest,discipline,18,9,9
Greif,garrosh,859,priest,discipline,18,9,9
Rakket,moon-guard,859,priest,discipline,18,9,9
Divinity,hellscream,858,priest,discipline,24,9,15
Mando,area-52,857,priest,discipline,56,27,29
Rugaru,emerald-dream,857,priest,discipline,21,10,11
Talbadontu,thrall,856,priest,discipline,24,9,15
Caiitlynn,quelthalas,856,priest,discipline,24,9,15
Jebadiia,tichondrius,855,priest,discipline,31,12,19
Maiyennefer,proudmoore,855,priest,discipline,24,9,15
Igotdots,scilla,854,priest,discipline,42,18,24
Sunayriah,illidan,853,priest,discipline,12,9,3
Coachbombae,tichondrius,853,priest,discipline,12,9,3
Mangoes,scilla,853,priest,discipline,20,9,11
Whitegirlirl,blackrock,850,priest,discipline,12,9,3
Radgars,frostmourne,843,priest,discipline,19,13,6
Timeglass,kelthuzad,841,priest,discipline,17,9,8
Brahskeet,illidan,841,priest,discipline,30,9,21
Chastised,moon-guard,834,priest,discipline,228,92,136
Thelonioüs,tichondrius,832,priest,discipline,55,20,35
Rockrock,zuljin,831,priest,discipline,14,11,3
Swu,tichondrius,830,priest,discipline,26,10,16
Delithara,tichondrius,826,priest,discipline,18,9,9
Naniwa,ragnaros,825,priest,discipline,27,10,17
Mydranol,tichondrius,824,priest,discipline,29,9,20
Serana,maelstrom,822,priest,discipline,95,46,49
Yea,shadow-council,814,priest,discipline,15,9,6
Såx,stormreaver,814,priest,discipline,21,9,12
Nuvea,tichondrius,814,priest,discipline,21,9,12
Faxingberlin,sargeras,814,priest,discipline,29,9,20
Shadowdeathx,bleeding-hollow,813,priest,discipline,17,9,8
Wellheeled,norgannon,806,priest,discipline,21,9,12
Nepy,stormrage,805,priest,discipline,22,10,12
Painpaws,moon-guard,800,priest,discipline,22,9,13
Plaedito,stormscale,799,priest,discipline,17,9,8
Slaac,malfurion,799,priest,discipline,17,9,8
Goldenfatty,blackrock,798,priest,discipline,20,9,11
Ðrip,burning-legion,796,priest,discipline,16,9,7
Eclìpsè,barthilas,795,priest,discipline,20,9,11
Unholydomina,zuljin,794,priest,discipline,15,9,6
Winston,tichondrius,784,priest,discipline,19,9,10
Cityboyy,tichondrius,784,priest,discipline,19,9,10
Ezelra,frostmourne,783,priest,discipline,17,9,8
Aupascamarad,tichondrius,783,priest,discipline,17,9,8
Caz,sargeras,775,priest,discipline,24,12,12
Myòvó,tichondrius,768,priest,discipline,12,8,4
Heeka,kelthuzad,768,priest,discipline,12,8,4
Xzliak,area-52,768,priest,discipline,12,8,4
Blesstwo,ragnaros,768,priest,discipline,12,8,4
Yansuanmu,tichondrius,768,priest,discipline,12,8,4
Criiltwo,area-52,768,priest,discipline,12,8,4
Spriestbro,emerald-dream,768,priest,discipline,12,8,4
Discipline,the-scryers,768,priest,discipline,12,8,4
Tastyloads,illidan,768,priest,discipline,12,8,4
Voltekkeh,tichondrius,768,priest,discipline,12,8,4
Bananass,sargeras,768,priest,discipline,12,8,4
Lovesthebox,frostmourne,768,priest,discipline,12,8,4
Müsic,stormrage,768,priest,discipline,12,8,4
Chocopp,illidan,768,priest,discipline,12,8,4
Airalia,bleeding-hollow,768,priest,discipline,12,8,4
Saintpleb,sargeras,768,priest,discipline,12,8,4
Soupbean,zuljin,768,priest,discipline,12,8,4
Evèlyn,dathremar,768,priest,discipline,12,8,4
Soloqqt,tichondrius,768,priest,discipline,12,8,4
Meren,kelthuzad,768,priest,discipline,12,8,4
Censyz,tichondrius,768,priest,discipline,12,8,4
Qohoo,tichondrius,768,priest,discipline,12,8,4
Ñightelf,area-52,768,priest,discipline,12,8,4
Vonpaolo,emerald-dream,768,priest,discipline,12,8,4
Aikinorz,tichondrius,768,priest,discipline,18,8,10
Amayå,kelthuzad,768,priest,discipline,18,8,10
Benedictiion,tichondrius,768,priest,discipline,18,8,10
Haquin,malganis,768,priest,discipline,18,8,10
Jodaa,sargeras,768,priest,discipline,18,8,10
Sontïx,sargeras,768,priest,discipline,18,8,10
Jacqueline,tichondrius,768,priest,discipline,18,8,10
Dehf,bleeding-hollow,768,priest,discipline,18,8,10
Troja,malganis,768,priest,discipline,18,8,10
Sotore,bleeding-hollow,768,priest,discipline,18,8,10
Smiliebomb,tichondrius,768,priest,discipline,18,8,10
Derpmodé,staghelm,768,priest,discipline,18,8,10
Diwara,ragnaros,768,priest,discipline,18,8,10
Melielectra,tichondrius,768,priest,discipline,18,8,10
Muffingal,tichondrius,768,priest,discipline,18,8,10
Sussywussy,stormrage,768,priest,discipline,18,8,10
Physics,frostmane,768,priest,discipline,18,8,10
Manbelow,bleeding-hollow,768,priest,discipline,27,9,18
Hugeshield,stormrage,768,priest,discipline,24,8,16
Dylan,shuhalo,768,priest,discipline,24,8,16
Melshiesty,stormrage,768,priest,discipline,24,8,16
Voidrisu,sargeras,768,priest,discipline,24,8,16
Mavalie,zuljin,768,priest,discipline,24,8,16
Epijho,area-52,767,priest,discipline,12,8,4
Spicey,korgath,767,priest,discipline,12,8,4
Elkies,area-52,767,priest,discipline,12,8,4
Kencyy,tichondrius,767,priest,discipline,12,8,4
Gawlas,azshara,767,priest,discipline,12,8,4
Iulu,doomhammer,767,priest,discipline,12,8,4
Powerranger,senjin,767,priest,discipline,12,8,4
Shinemyhead,stormrage,767,priest,discipline,12,8,4
Piusxll,tichondrius,767,priest,discipline,12,8,4
Lucènt,frostmourne,767,priest,discipline,12,8,4
Daegal,malfurion,767,priest,discipline,12,8,4
Urgetopurge,dunemaul,767,priest,discipline,12,8,4
Alarisa,chogall,767,priest,discipline,12,8,4
Cassiuss,kelthuzad,767,priest,discipline,12,8,4
Ryuuka,sargeras,767,priest,discipline,12,8,4
Mariels,quelthalas,767,priest,discipline,12,8,4
Lelyna,stormrage,767,priest,discipline,12,8,4
Rainny,proudmoore,767,priest,discipline,12,8,4
Yotinha,nemesis,767,priest,discipline,12,8,4
Kynsias,stormrage,767,priest,discipline,15,8,7
Beansofdean,proudmoore,767,priest,discipline,18,8,10
Zyklonova,frostmourne,767,priest,discipline,18,8,10
Brakála,ragnaros,767,priest,discipline,18,8,10
Analiesa,moon-guard,767,priest,discipline,18,8,10
Grotti,ragnaros,767,priest,discipline,18,8,10
Therialjp,ragnaros,767,priest,discipline,18,8,10
Datspice,stormrage,767,priest,discipline,18,8,10
Hellsembrace,lightbringer,767,priest,discipline,18,8,10
Hesus,deathwing,767,priest,discipline,18,8,10
Jùdas,ravencrest,767,priest,discipline,18,8,10
Holyslap,nerzhul,767,priest,discipline,18,8,10
Cäpriestsunn,thrall,767,priest,discipline,18,8,10
Luxury,blackrock,767,priest,discipline,18,8,10
Hl,dalaran,767,priest,discipline,24,8,16
Providennce,tichondrius,767,priest,discipline,24,8,16
Èuneekz,thrall,767,priest,discipline,24,8,16
Oniizanagi,thrall,767,priest,discipline,24,8,16
Fatherdan,blackrock,767,priest,discipline,24,8,16
Showakoi,ragnaros,767,priest,discipline,28,9,19
Snoog,tichondrius,767,priest,discipline,30,8,22
Shirley,skywall,767,priest,discipline,30,8,22
Dorós,coilfang,766,priest,discipline,12,8,4
Abzorbed,stormrage,766,priest,discipline,12,8,4
Juniorfloyd,tichondrius,766,priest,discipline,12,8,4
Payperbuff,tichondrius,766,priest,discipline,12,8,4
Xhaajyh,area-52,766,priest,discipline,12,8,4
Spitefuldirk,dalaran,766,priest,discipline,12,8,4
Grizzblessed,sargeras,766,priest,discipline,12,8,4
Jerserra,emerald-dream,766,priest,discipline,12,8,4
Spriest,kul-tiras,766,priest,discipline,18,8,10
Gõd,zuluhed,766,priest,discipline,18,8,10
Via,chogall,766,priest,discipline,18,8,10
Bandaidvibes,tichondrius,765,priest,discipline,12,8,4
Pollyphia,kiljaeden,765,priest,discipline,12,8,4
Fhelurian,quelthalas,765,priest,discipline,18,8,10
Aybaby,kiljaeden,765,priest,discipline,18,8,10
Darrong,darkspear,764,priest,discipline,18,8,10
Healrat,thrall,764,priest,discipline,18,8,10
Itchybubble,emerald-dream,763,priest,discipline,12,8,4
Lätöxïkä,alleria,763,priest,discipline,17,8,9
Rókue,silvermoon,763,priest,discipline,18,8,10
Squatrack,tichondrius,763,priest,discipline,24,8,16
Badazzfrank,tichondrius,762,priest,discipline,18,8,10
Lytherina,aegwynn,761,priest,discipline,12,8,4
Mommyshere,vashj,761,priest,discipline,18,8,10
Oniyuri,dark-iron,760,priest,discipline,12,8,4
Fluxus,sargeras,760,priest,discipline,12,8,4
Runemidgard,illidan,760,priest,discipline,18,8,10
Cheuksin,korgath,759,priest,discipline,12,8,4
Flannigan,veknilash,753,priest,discipline,12,8,4
Whitepi,tichondrius,751,priest,discipline,21,9,12
Healloween,stormrage,749,priest,discipline,12,8,4
Peacebewithu,echo-isles,749,priest,discipline,12,8,4
Iseeyoulookn,stormrage,743,priest,discipline,23,10,13
Valith,bleeding-hollow,735,priest,discipline,16,9,7
Pokebox,frostmourne,735,priest,discipline,16,8,8
Unholyshield,frostmourne,734,priest,discipline,17,8,9
Itssehctap,chogall,732,priest,discipline,14,9,5
Aloragon,tichondrius,732,priest,discipline,17,8,9
Alterboy,garrosh,724,priest,discipline,18,8,10
Invoice,bloodscalp,719,priest,discipline,17,8,9
Pðpë,area-52,718,priest,discipline,11,8,3
Clarity,arthas,718,priest,discipline,15,9,6
Ivf,darrowmere,714,priest,discipline,29,10,19
Inmøthep,ragnaros,713,priest,discipline,22,9,13
Trashdiscx,stormrage,707,priest,discipline,25,11,14
Drethor,saurfang,702,priest,discipline,16,8,8
Styléßéndérx,illidan,687,priest,discipline,11,8,3
Gdessairmed,exodar,686,priest,discipline,19,8,11
Läsombra,area-52,684,priest,discipline,17,9,8
Termiina,hyjal,684,priest,discipline,25,8,17
Vaticly,hyjal,672,priest,discipline,12,7,5
Taboogie,tichondrius,672,priest,discipline,12,7,5
Walpurgis,skywall,672,priest,discipline,12,7,5
Artirie,darkspear,672,priest,discipline,12,7,5
Dirtydebbie,lightnings-blade,672,priest,discipline,12,7,5
Pavesarii,proudmoore,672,priest,discipline,12,7,5
Mattgarska,tichondrius,672,priest,discipline,12,7,5
Dances,emerald-dream,672,priest,discipline,12,7,5
Bnn,arathor,672,priest,discipline,12,7,5
Aeyde,proudmoore,672,priest,discipline,12,7,5
Fialiadia,illidan,672,priest,discipline,12,7,5
Skcits,sargeras,672,priest,discipline,12,7,5
Anmu,illidan,672,priest,discipline,12,7,5
Afflickzz,kelthuzad,672,priest,discipline,12,7,5
Nosgoróth,quelthalas,672,priest,discipline,12,7,5
Dráugr,ragnaros,672,priest,discipline,12,7,5
Thewaker,tichondrius,672,priest,discipline,12,7,5
Kiloe,tichondrius,672,priest,discipline,12,7,5
Nerfdisc,elune,672,priest,discipline,12,7,5
Tslacalls,malganis,672,priest,discipline,12,7,5
Vels,blackrock,672,priest,discipline,12,7,5
Woolly,tichondrius,672,priest,discipline,12,7,5
Carboload,thrall,672,priest,discipline,12,7,5
Omsi,emerald-dream,672,priest,discipline,12,7,5
Niik,tichondrius,672,priest,discipline,12,7,5
Kymomeh,sargeras,672,priest,discipline,12,7,5
Iatemykids,tichondrius,672,priest,discipline,12,7,5
Dudebanger,sargeras,672,priest,discipline,12,7,5
Washdp,frostmourne,672,priest,discipline,12,7,5
Sadsadge,sargeras,672,priest,discipline,12,7,5
Sentenel,duskwood,672,priest,discipline,12,7,5
Fäÿë,tichondrius,672,priest,discipline,12,7,5
Clevelandboy,blackrock,672,priest,discipline,12,7,5
Littleshower,illidan,672,priest,discipline,12,7,5
Greyx,moon-guard,672,priest,discipline,12,7,5
Littlehcl,tichondrius,672,priest,discipline,12,7,5
Deagled,tichondrius,672,priest,discipline,12,7,5
Hypes,korgath,672,priest,discipline,12,7,5
Iol,spinebreaker,672,priest,discipline,12,7,5
Kencys,tichondrius,672,priest,discipline,12,7,5
Ninielly,stormrage,672,priest,discipline,14,8,6
Siddhar,illidan,672,priest,discipline,13,7,6
Shenanígans,malganis,672,priest,discipline,18,7,11
Joeybats,frostwolf,672,priest,discipline,18,7,11
Jagsp,area-52,672,priest,discipline,18,7,11
Mastahspell,illidan,672,priest,discipline,18,7,11
Yaksa,proudmoore,672,priest,discipline,18,7,11
Rafers,tichondrius,672,priest,discipline,18,7,11
Criminalsp,frostmourne,672,priest,discipline,18,7,11
Iwillrezguys,tichondrius,672,priest,discipline,18,7,11
Marmintor,stormrage,672,priest,discipline,18,7,11
Rigotakx,illidan,672,priest,discipline,18,7,11
Kepp,korgath,672,priest,discipline,18,7,11
Xayda,area-52,672,priest,discipline,18,7,11
Overshields,caelestrasz,672,priest,discipline,18,7,11
Aryeinna,illidan,672,priest,discipline,18,7,11
Jugeum,proudmoore,672,priest,discipline,18,7,11
Meepsw,stormrage,672,priest,discipline,18,7,11
Döyöuliftbro,tichondrius,672,priest,discipline,18,7,11
Whateverbrah,tichondrius,672,priest,discipline,21,8,13
Stríkes,emerald-dream,672,priest,discipline,24,7,17
Babymieo,illidan,672,priest,discipline,24,7,17
Remusha,dalaran,672,priest,discipline,24,7,17
Zortroz,tichondrius,671,priest,discipline,10,8,2
Thalladori,area-52,671,priest,discipline,16,10,6
Honypot,ysondre,671,priest,discipline,12,7,5
Popeofdope,queldorei,671,priest,discipline,12,7,5
Demonwizard,sargeras,671,priest,discipline,12,7,5
Mahelet,drakkari,671,priest,discipline,12,7,5
Debigheal,stormrage,671,priest,discipline,12,7,5
Guerisser,hyjal,671,priest,discipline,12,7,5
Trinidy,illidan,671,priest,discipline,12,7,5
Fatherjerry,kiljaeden,671,priest,discipline,12,7,5
Lightschosen,malganis,671,priest,discipline,12,7,5
Travakel,proudmoore,671,priest,discipline,12,7,5
Beocca,nerzhul,671,priest,discipline,12,7,5
Jeremey,darkspear,671,priest,discipline,12,7,5
Bombinburbon,durotan,671,priest,discipline,12,7,5
Maenard,emerald-dream,671,priest,discipline,12,7,5
Zarfs,burning-blade,671,priest,discipline,12,7,5
Unholyio,barthilas,671,priest,discipline,12,7,5
Skgangmm,tichondrius,671,priest,discipline,12,7,5
Clerkbum,emerald-dream,671,priest,discipline,12,7,5
Saphet,draktharon,671,priest,discipline,12,7,5
Linlight,stormrage,671,priest,discipline,12,7,5
Lumyra,malganis,671,priest,discipline,12,7,5
Randomheal,dunemaul,671,priest,discipline,18,7,11
Adofthealer,illidan,671,priest,discipline,18,7,11
Canharm,tichondrius,671,priest,discipline,18,7,11
Voyou,icecrown,671,priest,discipline,18,7,11
Sreykalip,frostmourne,671,priest,discipline,18,7,11
Vania,tortheldrin,671,priest,discipline,18,7,11
Caeda,icecrown,671,priest,discipline,24,7,17
Shastyr,tichondrius,671,priest,discipline,24,7,17
Malansuo,wyrmrest-accord,671,priest,discipline,30,7,23
Antìdote,tichondrius,670,priest,discipline,12,7,5
Thrudarkness,thrall,670,priest,discipline,12,7,5
Lavvari,durotan,670,priest,discipline,12,7,5
Susannahh,goldrinn,670,priest,discipline,12,7,5
Mitras,moon-guard,670,priest,discipline,12,7,5
Xð,jubeithos,670,priest,discipline,12,7,5
Donus,frostmane,670,priest,discipline,12,7,5
Panelopie,maiev,670,priest,discipline,12,7,5
Jivita,lightbringer,670,priest,discipline,12,7,5
Angelicduck,illidan,670,priest,discipline,12,7,5
Spiceenjoyer,emerald-dream,670,priest,discipline,15,8,7
Xeras,ravencrest,670,priest,discipline,18,7,11
Kerfos,azralon,669,priest,discipline,10,8,2
Feelmyheels,frostmourne,669,priest,discipline,12,7,5
Gabryanna,emerald-dream,669,priest,discipline,18,7,11
Evelien,kiljaeden,669,priest,discipline,24,7,17
Jikoguu,stormscale,669,priest,discipline,24,7,17
Nielic,arygos,668,priest,discipline,12,7,5
Butterflyblu,ragnaros,668,priest,discipline,13,7,6
Albertth,ragnaros,668,priest,discipline,18,7,11
Butterblessr,thunderlord,668,priest,discipline,19,7,12
Todrecas,ragnaros,667,priest,discipline,12,7,5
Tassik,dalaran,667,priest,discipline,18,7,11
Mortecraft,sargeras,666,priest,discipline,12,7,5
Tenet,stormscale,666,priest,discipline,18,7,11
Crossblesser,alleria,663,priest,discipline,12,7,5
Ödin,tichondrius,663,priest,discipline,22,8,14
Sezyks,malganis,655,priest,discipline,17,7,10
Rcx,sargeras,655,priest,discipline,17,7,10
Neutrino,quelthalas,655,priest,discipline,17,7,10
Ibangedaqt,malganis,647,priest,discipline,26,11,15
Elomszz,tichondrius,640,priest,discipline,16,7,9
Creamedcorn,tichondrius,639,priest,discipline,11,7,4
Spicer,eredar,639,priest,discipline,11,7,4
Stunsilence,malganis,639,priest,discipline,14,8,6
Gankchange,tichondrius,639,priest,discipline,14,8,6
Sofluffy,burning-blade,638,priest,discipline,17,7,10
Lalo,bleeding-hollow,638,priest,discipline,23,7,16
Fumes,ghostlands,638,priest,discipline,24,7,17
Calliah,moknathal,637,priest,discipline,11,7,4
Jeffo,baelgun,636,priest,discipline,17,7,10
Futatsi,zuljin,634,priest,discipline,23,7,16
Swagacious,malganis,624,priest,discipline,13,8,5
Holysmegma,dreadmaul,623,priest,discipline,11,7,4
Ezpríest,kelthuzad,623,priest,discipline,11,7,4
Archcerion,stormreaver,621,priest,discipline,15,8,7
Szx,akama,618,priest,discipline,22,8,14
Bibops,area-52,618,priest,discipline,25,8,17
Elevatez,stormrage,608,priest,discipline,10,7,3
Åffliction,sargeras,607,priest,discipline,11,7,4
Meatguzzler,tichondrius,607,priest,discipline,11,7,4
Coolzo,dethecus,607,priest,discipline,14,8,6
Jimyo,tichondrius,607,priest,discipline,15,7,8
Karamapang,illidan,607,priest,discipline,16,7,9
Astroluma,illidan,607,priest,discipline,17,7,10
Played,dark-iron,607,priest,discipline,26,7,19
Codiroli,tichondrius,606,priest,discipline,14,7,7
Forprophet,proudmoore,606,priest,discipline,22,7,15
Dreamskull,aegwynn,605,priest,discipline,14,7,7
Athzziry,ragnaros,599,priest,discipline,21,7,14
Gnepe,sargeras,591,priest,discipline,14,7,7
Eldoras,zuljin,576,priest,discipline,6,6,0
Wizeau,dalaran,576,priest,discipline,6,6,0
Syndrox,kelthuzad,576,priest,discipline,6,6,0
Porffy,malygos,576,priest,discipline,6,6,0
Càptain,moon-guard,576,priest,discipline,6,6,0
Delai,dalaran,576,priest,discipline,6,6,0
Healia,tichondrius,576,priest,discipline,6,6,0
Thirddps,illidan,576,priest,discipline,6,6,0
Pearl,chogall,576,priest,discipline,6,6,0
Illmatíc,malganis,576,priest,discipline,6,6,0
Lisau,tichondrius,576,priest,discipline,12,6,6
Saelomism,frostmourne,576,priest,discipline,12,6,6
Jpgpng,tichondrius,576,priest,discipline,12,6,6
Metius,smolderthorn,576,priest,discipline,12,6,6
Purpskurp,stormrage,576,priest,discipline,12,6,6
Shwayp,zuljin,576,priest,discipline,12,6,6
Shoepooper,kelthuzad,576,priest,discipline,12,6,6
Boppdot,tichondrius,576,priest,discipline,12,6,6
Saintjpii,tichondrius,576,priest,discipline,12,6,6
Bloodfaith,stormrage,576,priest,discipline,12,6,6
Ariste,tichondrius,576,priest,discipline,12,6,6
Brezi,azralon,576,priest,discipline,12,6,6
Fatherjohnny,azuremyst,576,priest,discipline,12,6,6
Cency,tichondrius,576,priest,discipline,12,6,6
Ferilla,illidan,576,priest,discipline,12,6,6
Inukimi,sargeras,576,priest,discipline,12,6,6
Flarkyllama,area-52,576,priest,discipline,12,6,6
Trezz,hakkar,576,priest,discipline,12,6,6
Nokzo,dalaran,576,priest,discipline,12,6,6
Tuxen,wyrmrest-accord,576,priest,discipline,12,6,6
Slobmygnob,illidan,576,priest,discipline,12,6,6
Randyortonn,tichondrius,576,priest,discipline,12,6,6
Scripture,stormreaver,576,priest,discipline,12,6,6
Seleniax,sargeras,576,priest,discipline,12,6,6
Wøah,stormrage,576,priest,discipline,12,6,6
Jackski,aerie-peak,576,priest,discipline,12,6,6
Meshuggah,archimonde,576,priest,discipline,12,6,6
Redkiwi,illidan,576,priest,discipline,12,6,6
Johncrank,bleeding-hollow,576,priest,discipline,12,6,6
Epik,moknathal,576,priest,discipline,12,6,6
Wodpriestx,stormrage,576,priest,discipline,12,6,6
Thelastfight,frostmourne,576,priest,discipline,12,6,6
Ifortalot,lothar,576,priest,discipline,12,6,6
Degenerates,blood-furnace,576,priest,discipline,12,6,6
Bigsàd,proudmoore,576,priest,discipline,12,6,6
Seléne,tichondrius,576,priest,discipline,12,6,6
Pissfeet,tichondrius,576,priest,discipline,12,6,6
Mthwz,tichondrius,576,priest,discipline,12,6,6
Skiza,stormrage,576,priest,discipline,12,6,6
Syncope,garona,576,priest,discipline,12,6,6
Wabie,illidan,576,priest,discipline,12,6,6
Kzo,gnomeregan,576,priest,discipline,12,6,6
Aloxc,drakkari,576,priest,discipline,12,6,6
Decades,moon-guard,576,priest,discipline,12,6,6
Ilovemia,zuljin,576,priest,discipline,12,6,6
Panikâ,thrall,576,priest,discipline,12,6,6
Stankychimpo,malganis,576,priest,discipline,12,6,6
Punchyxz,illidan,576,priest,discipline,12,6,6
Kawasakix,tichondrius,576,priest,discipline,12,6,6
Nikkazul,drakkari,576,priest,discipline,12,6,6
Darkinfusion,illidan,576,priest,discipline,12,6,6
Notskynet,tichondrius,576,priest,discipline,12,6,6
Eirua,proudmoore,576,priest,discipline,12,6,6
Neep,turalyon,576,priest,discipline,12,6,6
Xiaochenchen,tichondrius,576,priest,discipline,12,6,6
Janna,jubeithos,576,priest,discipline,12,6,6
Zerola,sargeras,576,priest,discipline,12,6,6
Wizpell,area-52,576,priest,discipline,12,6,6
Joanoarc,destromath,576,priest,discipline,12,6,6
Fenders,stormrage,576,priest,discipline,12,6,6
Obstetrician,tichondrius,576,priest,discipline,12,6,6
Nelfpriest,khadgar,576,priest,discipline,12,6,6
Frankoizz,quelthalas,576,priest,discipline,12,6,6
Duubz,kelthuzad,576,priest,discipline,12,6,6
Alcoric,illidan,576,priest,discipline,12,6,6
Moselol,tichondrius,576,priest,discipline,12,6,6
Imfresh,illidan,576,priest,discipline,12,6,6
Flatlining,illidan,576,priest,discipline,12,6,6
Prostrat,deathwing,576,priest,discipline,12,6,6
Celypriest,moon-guard,576,priest,discipline,12,6,6
Azurestorm,tichondrius,576,priest,discipline,12,6,6
Napr,proudmoore,576,priest,discipline,12,6,6
Treri,bleeding-hollow,576,priest,discipline,12,6,6
Chicoryx,illidan,576,priest,discipline,12,6,6
Instaboned,sargeras,576,priest,discipline,12,6,6
Bumps,zuljin,576,priest,discipline,12,6,6
Chawp,kelthuzad,576,priest,discipline,12,6,6
Padrë,tichondrius,576,priest,discipline,12,6,6
Kiddonia,whisperwind,576,priest,discipline,15,7,8
Bigfirebet,tichondrius,576,priest,discipline,15,7,8
Preyforme,tichondrius,576,priest,discipline,13,6,7
Dadcantdeath,frostmourne,576,priest,discipline,14,6,8
Repriest,malganis,576,priest,discipline,18,6,12
Oymay,illidan,576,priest,discipline,18,6,12
Asmødeus,bleeding-hollow,576,priest,discipline,18,6,12
Ershackleton,illidan,576,priest,discipline,18,6,12
Ancilx,area-52,576,priest,discipline,18,6,12
Jazmiine,ragnaros,576,priest,discipline,18,6,12
Dots,tichondrius,576,priest,discipline,18,6,12
Komicks,tichondrius,576,priest,discipline,18,6,12
Høðj,tichondrius,576,priest,discipline,18,6,12
Starp,tichondrius,576,priest,discipline,18,6,12
Buffhpriest,tichondrius,576,priest,discipline,18,6,12
Jiedx,tichondrius,576,priest,discipline,18,6,12
Priestmass,dalaran,576,priest,discipline,18,6,12
Hårper,area-52,576,priest,discipline,18,6,12
Slthrysnake,area-52,576,priest,discipline,18,6,12
Fartnutts,dalaran,576,priest,discipline,18,6,12
Scpzi,frostmourne,576,priest,discipline,18,6,12
Jarzo,thunderhorn,576,priest,discipline,18,6,12
Dgpriest,tichondrius,576,priest,discipline,18,6,12
Junethegreat,tichondrius,576,priest,discipline,18,6,12
Peaky,moonrunner,576,priest,discipline,18,6,12
Vineller,malganis,576,priest,discipline,18,6,12
Keepsleepin,stormrage,576,priest,discipline,18,6,12
Çørrúptíøñz,tichondrius,576,priest,discipline,18,6,12
Synaptikk,proudmoore,576,priest,discipline,18,6,12
Sandelios,aggramar,576,priest,discipline,18,6,12
Mylà,ragnaros,576,priest,discipline,20,6,14
Drupith,dalaran,576,priest,discipline,24,6,18
Cûrry,bleeding-hollow,576,priest,discipline,24,6,18
Felixfire,moon-guard,576,priest,discipline,24,6,18
Nachòs,wildhammer,575,priest,discipline,6,6,0
Astrìx,tichondrius,575,priest,discipline,6,6,0
Kephrek,eonar,575,priest,discipline,6,6,0
Göats,emerald-dream,575,priest,discipline,12,6,6
Forroc,stormrage,575,priest,discipline,12,6,6
Preachermang,laughing-skull,575,priest,discipline,12,6,6
Mpshield,kiljaeden,575,priest,discipline,12,6,6
Lobstersock,malganis,575,priest,discipline,12,6,6
Imhotap,illidan,575,priest,discipline,12,6,6
Yusarin,garona,575,priest,discipline,12,6,6
Artmend,malganis,575,priest,discipline,12,6,6
Kajagoogoö,emerald-dream,575,priest,discipline,12,6,6
Silveri,thrall,575,priest,discipline,12,6,6
Pinaybebe,kiljaeden,575,priest,discipline,12,6,6
Exanthrope,stormrage,575,priest,discipline,12,6,6
Aanora,illidan,575,priest,discipline,12,6,6
Wickedmoon,emerald-dream,575,priest,discipline,12,6,6
Nevertelsp,malganis,575,priest,discipline,12,6,6
Moarhaste,kelthuzad,575,priest,discipline,12,6,6
Brahmin,nazjatar,575,priest,discipline,12,6,6
Lúçíd,sargeras,575,priest,discipline,12,6,6
Healdog,thrall,575,priest,discipline,12,6,6
Uncensøred,tichondrius,575,priest,discipline,12,6,6
Swaptohealer,misha,575,priest,discipline,12,6,6
Herzattacken,malganis,575,priest,discipline,12,6,6
Demimo,frostwolf,575,priest,discipline,12,6,6
Galastine,emerald-dream,575,priest,discipline,12,6,6
Mcfluffin,aggramar,575,priest,discipline,12,6,6
Peeinbottles,stormrage,575,priest,discipline,16,7,9
Biltpeter,tichondrius,575,priest,discipline,15,6,9
Flexxwzkaboo,thrall,575,priest,discipline,18,6,12
Mortaroth,doomhammer,575,priest,discipline,18,6,12
Naxiest,stormrage,575,priest,discipline,18,6,12
Kosiris,stormrage,575,priest,discipline,18,6,12
Lìlí,tichondrius,575,priest,discipline,18,6,12
Xyberius,barthilas,575,priest,discipline,18,6,12
Baldpate,tichondrius,575,priest,discipline,24,6,18
Papadarkness,tichondrius,574,priest,discipline,24,6,18
Reilean,sargeras,573,priest,discipline,12,6,6
Prebruisz,baelgun,573,priest,discipline,12,6,6
Ságrádá,area-52,573,priest,discipline,12,6,6
Pharaoh,deathwing,573,priest,discipline,12,6,6
Lookfig,frostmourne,573,priest,discipline,18,6,12
Bigchip,sargeras,573,priest,discipline,24,6,18
Marpi,quelthalas,572,priest,discipline,24,6,18
Clergy,arthas,571,priest,discipline,12,6,6
Voidlordd,kelthuzad,571,priest,discipline,12,6,6
Terric,shattered-hand,570,priest,discipline,12,6,6
Thøt,malganis,570,priest,discipline,12,6,6
Jaster,proudmoore,570,priest,discipline,14,6,8
Antipreist,bonechewer,567,priest,discipline,12,6,6
Crossbones,cenarion-circle,566,priest,discipline,12,6,6
Emmarîl,sargeras,559,priest,discipline,17,6,11
Justfaith,barthilas,558,priest,discipline,17,6,11
Zeno,haomarush,557,priest,discipline,11,6,5
Wingchick,azshara,557,priest,discipline,24,6,18
Earface,blades-edge,543,priest,discipline,14,7,7
Tapel,khazgoroth,543,priest,discipline,18,7,11
Awaken,nerzhul,543,priest,discipline,17,6,11
Surfgang,tichondrius,543,priest,discipline,17,6,11
Shemhazai,ragnaros,542,priest,discipline,14,7,7
Mørbol,tichondrius,541,priest,discipline,14,7,7
Itxo,quelthalas,540,priest,discipline,10,7,3
Haidees,akama,540,priest,discipline,10,7,3
Moonlightx,destromath,528,priest,discipline,9,7,2
Xiaz,lightbringer,528,priest,discipline,12,8,4
Dotdotdead,earthen-ring,522,priest,discipline,16,7,9
Twistèr,zuljin,522,priest,discipline,26,7,19
Identìty,moon-guard,521,priest,discipline,28,7,21
Ethari,crushridge,520,priest,discipline,21,7,14
Enphý,quelthalas,511,priest,discipline,11,6,5
Oneinurdome,moknathal,511,priest,discipline,14,6,8
Bigtang,kiljaeden,511,priest,discipline,14,6,8
Lilmad,stormrage,511,priest,discipline,20,6,14
Moneymurph,blackrock,511,priest,discipline,26,6,20
Pavarotti,laughing-skull,510,priest,discipline,20,6,14
Jessikal,quelthalas,496,priest,discipline,13,6,7
Yait,tichondrius,495,priest,discipline,14,7,7
Aquandrelea,aegwynn,480,priest,discipline,6,5,1
Laggytwodope,tichondrius,480,priest,discipline,6,5,1
Corov,korgath,480,priest,discipline,6,5,1
Danawhitex,thrall,480,priest,discipline,6,5,1
Bulleitrye,emerald-dream,480,priest,discipline,6,5,1
Aetonyx,anvilmar,480,priest,discipline,6,5,1
Privx,bleeding-hollow,480,priest,discipline,6,5,1
Kardinalkeso,frostmourne,480,priest,discipline,6,5,1
Sixnoh,moonrunner,480,priest,discipline,6,5,1
Çøçø,tichondrius,480,priest,discipline,6,5,1
Kebab,tichondrius,480,priest,discipline,6,5,1
Djd,frostmourne,480,priest,discipline,6,5,1
Hateutoo,sargeras,480,priest,discipline,6,5,1
Lily,blackrock,480,priest,discipline,6,5,1
Darknuzs,sargeras,480,priest,discipline,6,5,1
Compromise,the-scryers,480,priest,discipline,6,5,1
Eneldz,quelthalas,480,priest,discipline,6,5,1
Gosarix,tichondrius,480,priest,discipline,6,5,1
Azuremissile,tichondrius,480,priest,discipline,6,5,1
Dzikuss,aegwynn,480,priest,discipline,6,5,1
Uncletouchy,illidan,480,priest,discipline,6,5,1
Káldorei,proudmoore,480,priest,discipline,6,5,1
Xorriz,bleeding-hollow,480,priest,discipline,6,5,1
Holyhand,auchindoun,480,priest,discipline,6,5,1
Azari,illidan,480,priest,discipline,6,5,1
Lildubs,bloodhoof,480,priest,discipline,6,5,1
Sharkbones,tichondrius,480,priest,discipline,6,5,1
Deacoderx,area-52,480,priest,discipline,6,5,1
Stegp,kelthuzad,480,priest,discipline,6,5,1
Radackan,quelthalas,480,priest,discipline,6,5,1
Cxmplex,malganis,480,priest,discipline,6,5,1
Nawtyforever,tichondrius,480,priest,discipline,6,5,1
Karnival,aggramar,480,priest,discipline,6,5,1
Phantømz,zuljin,480,priest,discipline,6,5,1
Matin,frostmourne,480,priest,discipline,9,5,4
Azngød,tichondrius,480,priest,discipline,12,5,7
Alleeyy,tichondrius,480,priest,discipline,12,5,7
Rofrofmu,aegwynn,480,priest,discipline,12,5,7
Vérse,stormrage,480,priest,discipline,12,5,7
Skwishee,illidan,480,priest,discipline,12,5,7
Makeshiftz,zuljin,480,priest,discipline,12,5,7
Htx,dunemaul,480,priest,discipline,12,5,7
Shôta,kelthuzad,480,priest,discipline,12,5,7
Shadowcrash,zuljin,480,priest,discipline,12,5,7
Feyns,illidan,480,priest,discipline,12,5,7
Ptam,tichondrius,480,priest,discipline,12,5,7
Doublesix,malganis,480,priest,discipline,12,5,7
Câstiêl,malganis,480,priest,discipline,12,5,7
Goonie,spirestone,480,priest,discipline,12,5,7
Tòxìç,stormrage,480,priest,discipline,12,5,7
Yaheals,gorefiend,480,priest,discipline,12,5,7
Drzz,tichondrius,480,priest,discipline,12,5,7
Justgoon,tichondrius,480,priest,discipline,12,5,7
Altaeres,tichondrius,480,priest,discipline,12,5,7
Krazyapollo,tichondrius,480,priest,discipline,12,5,7
Whosjoe,tichondrius,480,priest,discipline,12,5,7
Sypii,stormrage,480,priest,discipline,12,5,7
Upsahl,area-52,480,priest,discipline,12,5,7
Augus,velen,480,priest,discipline,12,5,7
Rompenepes,drakkari,480,priest,discipline,12,5,7
Sipmemaster,tichondrius,480,priest,discipline,12,5,7
Scyndar,bonechewer,480,priest,discipline,12,5,7
Jackymv,kelthuzad,480,priest,discipline,12,5,7
Arcosis,turalyon,480,priest,discipline,12,5,7
Rúbybest,tichondrius,480,priest,discipline,12,5,7
Bubblebeasst,area-52,480,priest,discipline,12,5,7
Jangma,tichondrius,480,priest,discipline,12,5,7
Goosemongler,bleeding-hollow,480,priest,discipline,12,5,7
Alpacasama,illidan,480,priest,discipline,12,5,7
Xpenance,ragnaros,480,priest,discipline,12,5,7
Nursébeardy,whisperwind,480,priest,discipline,12,5,7
Sabela,moon-guard,480,priest,discipline,12,5,7
Detainedz,malganis,480,priest,discipline,12,5,7
Lchcl,tichondrius,480,priest,discipline,12,5,7
Vyrah,area-52,480,priest,discipline,12,5,7
Dweem,stormrage,480,priest,discipline,12,5,7
Qoon,tichondrius,480,priest,discipline,12,5,7
Góndhi,tichondrius,480,priest,discipline,12,5,7
Raslin,bonechewer,480,priest,discipline,12,5,7
Batiatus,moon-guard,480,priest,discipline,12,5,7
Blavkata,area-52,480,priest,discipline,12,5,7
Pumice,destromath,480,priest,discipline,12,5,7
Mdibaxx,tichondrius,480,priest,discipline,12,5,7
Dènalí,area-52,480,priest,discipline,12,5,7
Wtfamdoing,quelthalas,480,priest,discipline,12,5,7
Piffbadar,tichondrius,480,priest,discipline,12,5,7
Tamtwo,the-forgotten-coast,480,priest,discipline,12,5,7
Deeply,tichondrius,480,priest,discipline,12,5,7
Hotlink,daggerspine,480,priest,discipline,12,5,7
Ajazz,zuljin,480,priest,discipline,12,5,7
Bluffzp,boulderfist,480,priest,discipline,12,5,7
Giraffebaitt,zuljin,480,priest,discipline,12,5,7
Healryyduff,barthilas,480,priest,discipline,12,5,7
Lindsanp,illidan,480,priest,discipline,12,5,7
Soulbane,frostmourne,480,priest,discipline,12,5,7
Robbailey,dalvengyr,480,priest,discipline,12,5,7
Amperx,wyrmrest-accord,480,priest,discipline,12,5,7
Drmattydubz,tichondrius,480,priest,discipline,12,5,7
Äpriest,sargeras,480,priest,discipline,12,5,7
Inflate,frostmourne,480,priest,discipline,12,5,7
Anellas,sargeras,480,priest,discipline,12,5,7
Lolkwtf,sargeras,480,priest,discipline,12,5,7
Takomochi,sargeras,480,priest,discipline,12,5,7
Sacredmoon,dreadmaul,480,priest,discipline,12,5,7
Taikosqt,azralon,480,priest,discipline,12,5,7
Canswersp,sargeras,480,priest,discipline,12,5,7
Stubby,shadowsong,480,priest,discipline,12,5,7
Takosoufflé,emerald-dream,480,priest,discipline,12,5,7
Abbydaddy,illidan,480,priest,discipline,12,5,7
Mywifesaidno,sargeras,480,priest,discipline,12,5,7
Humblemumble,barthilas,480,priest,discipline,12,5,7
Ón,tichondrius,480,priest,discipline,12,5,7
Ophiuchus,jubeithos,480,priest,discipline,12,5,7
Somethingkoo,sargeras,480,priest,discipline,17,7,10
Fleshliight,area-52,480,priest,discipline,15,6,9
Gatty,kiljaeden,480,priest,discipline,13,5,8
Fréákk,ragnaros,480,priest,discipline,18,5,13
Kark,tichondrius,480,priest,discipline,18,5,13
Nuditwo,malganis,480,priest,discipline,18,5,13
Fearufaraway,tichondrius,480,priest,discipline,18,5,13
Pasher,sargeras,480,priest,discipline,18,5,13
Bebe,fizzcrank,480,priest,discipline,18,5,13
Phenic,aggramar,480,priest,discipline,18,5,13
Cheekypriest,stormrage,480,priest,discipline,18,5,13
Piskel,vashj,480,priest,discipline,18,5,13
Ticheals,tichondrius,480,priest,discipline,18,5,13
Klerick,kiljaeden,480,priest,discipline,18,5,13
Healiesuwu,kiljaeden,480,priest,discipline,18,5,13
Vetisrx,thrall,480,priest,discipline,18,5,13
Aguadejamica,tichondrius,480,priest,discipline,18,5,13
Discpriestxo,malganis,480,priest,discipline,18,5,13
Georgepells,barthilas,480,priest,discipline,24,5,19
Tonymòntana,area-52,479,priest,discipline,6,5,1
Kasamm,nazjatar,479,priest,discipline,6,5,1
Sevioletté,wyrmrest-accord,479,priest,discipline,6,5,1
Remixcandoit,malganis,479,priest,discipline,6,5,1
Krisdavra,thrall,479,priest,discipline,6,5,1
Taiji,whisperwind,479,priest,discipline,6,5,1
Berzap,frostmourne,479,priest,discipline,6,5,1
Ghettobarbie,kelthuzad,479,priest,discipline,6,5,1
Audacy,azuremyst,479,priest,discipline,9,5,4
Techninë,chogall,479,priest,discipline,12,5,7
Healzutwo,tichondrius,479,priest,discipline,12,5,7
Tubelight,sargeras,479,priest,discipline,12,5,7
Aalicya,tanaris,479,priest,discipline,12,5,7
Krynoobz,senjin,479,priest,discipline,12,5,7
Drayen,korgath,479,priest,discipline,12,5,7
Viehweg,azralon,479,priest,discipline,12,5,7
Demished,zuljin,479,priest,discipline,12,5,7
Ibuyfeetpics,tichondrius,479,priest,discipline,12,5,7
Frazzysparks,stormrage,479,priest,discipline,12,5,7
Amäo,illidan,479,priest,discipline,12,5,7
Bloodsorrow,ragnaros,479,priest,discipline,12,5,7
Selea,frostwolf,479,priest,discipline,12,5,7
Chadlyfe,tichondrius,479,priest,discipline,12,5,7
Gaaq,stormrage,479,priest,discipline,12,5,7
Chopstix,senjin,479,priest,discipline,12,5,7
Blackbubba,tichondrius,479,priest,discipline,12,5,7
Crusifixx,tichondrius,479,priest,discipline,18,5,13
Pyper,medivh,479,priest,discipline,18,5,13
Kaladaz,destromath,478,priest,discipline,12,5,7
Jeanmarc,aerie-peak,478,priest,discipline,18,5,13
Eumalfa,dalaran,477,priest,discipline,6,5,1
Bellack,emerald-dream,477,priest,discipline,12,5,7
Goldenlilly,moon-guard,477,priest,discipline,18,5,13
Lotzofhealz,wyrmrest-accord,476,priest,discipline,12,5,7
Forober,queldorei,466,priest,discipline,39,14,25
Faíthless,sargeras,447,priest,discipline,11,5,6
Hungzilla,malganis,447,priest,discipline,11,5,6
Shadowkr,tichondrius,447,priest,discipline,11,5,6
Darkascended,arthas,447,priest,discipline,14,6,8
Agrotothemax,tichondrius,432,priest,discipline,15,5,10
Fxxkdamn,tichondrius,432,priest,discipline,21,6,15
Frenchfries,sargeras,431,priest,discipline,11,5,6
Texmix,stormrage,431,priest,discipline,21,6,15
Leejungjae,tichondrius,426,priest,discipline,15,6,9
Slùm,barthilas,416,priest,discipline,10,5,5
Shinomiko,frostmourne,415,priest,discipline,19,5,14
Melsebek,stormrage,415,priest,discipline,20,5,15
Elbowbeans,tichondrius,414,priest,discipline,16,5,11
Whodatpriest,blackhand,399,priest,discipline,5,5,0
Normill,bonechewer,399,priest,discipline,7,5,2
Bunked,bleeding-hollow,392,priest,discipline,23,7,16
Miniambá,tichondrius,384,priest,discipline,6,4,2
Tristanp,frostmourne,384,priest,discipline,6,4,2
Lavigne,tichondrius,384,priest,discipline,6,4,2
Fenty,nemesis,384,priest,discipline,6,4,2
Remuni,tichondrius,384,priest,discipline,6,4,2
Jixxersp,malganis,384,priest,discipline,6,4,2
Cosenzza,tichondrius,384,priest,discipline,6,4,2
Potatopriest,frostmourne,384,priest,discipline,6,4,2
Crueldotz,illidan,384,priest,discipline,6,4,2
Hiphopanomis,arthas,384,priest,discipline,6,4,2
Yunggawd,illidan,384,priest,discipline,6,4,2
Antifaithx,frostmourne,384,priest,discipline,6,4,2
Onipapae,frostmourne,384,priest,discipline,6,4,2
Lebanese,frostmourne,384,priest,discipline,6,4,2
Altari,whisperwind,384,priest,discipline,6,4,2
Rashad,proudmoore,384,priest,discipline,6,4,2
Meemó,area-52,384,priest,discipline,6,4,2
Optimism,frostmane,384,priest,discipline,6,4,2
Ðyluxx,blackwater-raiders,384,priest,discipline,6,4,2
Zhanay,ragnaros,384,priest,discipline,6,4,2
Healaryduff,skullcrusher,384,priest,discipline,6,4,2
Jaxthree,illidan,384,priest,discipline,6,4,2
Ritalyn,korgath,384,priest,discipline,6,4,2
Kàobeini,tichondrius,384,priest,discipline,6,4,2
Zenelu,tichondrius,384,priest,discipline,6,4,2
Chambler,aegwynn,384,priest,discipline,6,4,2
Lithelin,frostmourne,384,priest,discipline,6,4,2
Mødilon,nemesis,384,priest,discipline,6,4,2
Gardiancloun,sargeras,384,priest,discipline,6,4,2
Djchickpea,chogall,384,priest,discipline,6,4,2
Metéora,nemesis,384,priest,discipline,6,4,2
Acenthe,sargeras,384,priest,discipline,6,4,2
Celanea,bleeding-hollow,384,priest,discipline,6,4,2
Mightydrëk,malganis,384,priest,discipline,6,4,2
Sevros,moon-guard,384,priest,discipline,6,4,2
Wilita,drakkari,384,priest,discipline,6,4,2
Béépboop,tichondrius,384,priest,discipline,6,4,2
Crode,bleeding-hollow,384,priest,discipline,6,4,2
Conney,mugthol,384,priest,discipline,6,4,2
Priesticules,illidan,384,priest,discipline,6,4,2
Lavazzå,tichondrius,384,priest,discipline,6,4,2
Gdlsheretic,sargeras,384,priest,discipline,6,4,2
Babygsuss,tichondrius,384,priest,discipline,6,4,2
Ruems,area-52,384,priest,discipline,6,4,2
Vyndïllïn,tichondrius,384,priest,discipline,6,4,2
Celani,gilneas,384,priest,discipline,6,4,2
Anddori,moknathal,384,priest,discipline,6,4,2
Febronia,aerie-peak,384,priest,discipline,6,4,2
Chemdawwg,aerie-peak,384,priest,discipline,6,4,2
Uglydiego,quelthalas,384,priest,discipline,6,4,2
Äni,sargeras,384,priest,discipline,6,4,2
Goyqqp,illidan,384,priest,discipline,6,4,2
Blzy,area-52,384,priest,discipline,6,4,2
Rahmynpriest,tichondrius,384,priest,discipline,6,4,2
Packa,khaz-modan,384,priest,discipline,6,4,2
Ðescub0962D2,stormrage,384,priest,discipline,6,4,2
Tomp,tichondrius,384,priest,discipline,6,4,2
Sigurdr,muradin,384,priest,discipline,6,4,2
Madskills,shadow-council,384,priest,discipline,6,4,2
Granger,senjin,384,priest,discipline,6,4,2
Gregorovich,ragnaros,384,priest,discipline,6,4,2
Demongodtren,blackrock,384,priest,discipline,6,4,2
Dimedaddy,tichondrius,384,priest,discipline,6,4,2
Goseoa,tichondrius,384,priest,discipline,6,4,2
Zil,spinebreaker,384,priest,discipline,6,4,2
Batface,frostmourne,384,priest,discipline,6,4,2
Spyderco,mugthol,384,priest,discipline,6,4,2
Galandora,kelthuzad,384,priest,discipline,6,4,2
Myds,sargeras,384,priest,discipline,6,4,2
Lexaprö,moon-guard,384,priest,discipline,6,4,2
Ahnassi,stormrage,384,priest,discipline,6,4,2
Prïestitute,zuljin,384,priest,discipline,6,4,2
Bubbleboi,malganis,384,priest,discipline,6,4,2
Subscribe,khazgoroth,384,priest,discipline,6,4,2
Feminizm,tichondrius,384,priest,discipline,6,4,2
Papaheal,runetotem,384,priest,discipline,6,4,2
Zaperama,tichondrius,384,priest,discipline,6,4,2
Ranthrough,tichondrius,384,priest,discipline,6,4,2
Goatedpriest,kelthuzad,384,priest,discipline,6,4,2
Deathrina,moon-guard,384,priest,discipline,6,4,2
Yunganal,sargeras,384,priest,discipline,6,4,2
Dreaminz,tichondrius,384,priest,discipline,6,4,2
Soupbeanx,zuljin,384,priest,discipline,6,4,2
Seí,barthilas,384,priest,discipline,6,4,2
Nordheal,stormrage,384,priest,discipline,6,4,2
Sensitive,eitrigg,384,priest,discipline,6,4,2
Merçy,zuljin,384,priest,discipline,6,4,2
Leebow,tichondrius,384,priest,discipline,6,4,2
Aethestan,zuljin,384,priest,discipline,6,4,2
Pridesp,tichondrius,384,priest,discipline,6,4,2
Discotec,stormrage,384,priest,discipline,6,4,2
Fûsoya,zuljin,384,priest,discipline,6,4,2
Pprriieesst,tichondrius,384,priest,discipline,6,4,2
Stepbrohelp,barthilas,384,priest,discipline,6,4,2
Dioecesis,moon-guard,384,priest,discipline,6,4,2
Sip,sargeras,384,priest,discipline,6,4,2
Chü,dalaran,384,priest,discipline,6,4,2
Monkeyp,barthilas,384,priest,discipline,6,4,2
Fadedyourgo,tichondrius,384,priest,discipline,6,4,2
Popeachini,sargeras,384,priest,discipline,6,4,2
Brodel,dark-iron,384,priest,discipline,9,4,5
Poonanixo,gundrak,384,priest,discipline,10,4,6
Nvøsuperstar,zuljin,384,priest,discipline,15,5,10
Holyshiitzz,illidan,384,priest,discipline,12,4,8
Mezervescent,thrall,384,priest,discipline,12,4,8
Ganelm,vashj,384,priest,discipline,12,4,8
Exisa,stormrage,384,priest,discipline,12,4,8
Chaxiubao,stormrage,384,priest,discipline,12,4,8
Skydemons,malganis,384,priest,discipline,12,4,8
Gothmidget,illidan,384,priest,discipline,12,4,8
Sìrena,tichondrius,384,priest,discipline,12,4,8
Barclan,destromath,384,priest,discipline,12,4,8
Tangykiwi,dalaran,384,priest,discipline,12,4,8
Bearfriend,malorne,384,priest,discipline,12,4,8
Larisa,moon-guard,384,priest,discipline,12,4,8
Staywild,tichondrius,384,priest,discipline,12,4,8
Holynova,nerzhul,384,priest,discipline,12,4,8
Jonahas,sargeras,384,priest,discipline,12,4,8
Ophailea,thrall,384,priest,discipline,12,4,8
Akewnón,stormrage,384,priest,discipline,12,4,8
Wìd,khazgoroth,384,priest,discipline,12,4,8
Echoos,proudmoore,384,priest,discipline,12,4,8
Conorpriest,tichondrius,384,priest,discipline,12,4,8
Haruspex,azralon,384,priest,discipline,12,4,8
Jejer,moon-guard,384,priest,discipline,12,4,8
Billiard,stormrage,384,priest,discipline,12,4,8
Peavzian,kiljaeden,384,priest,discipline,12,4,8
Srazul,azralon,384,priest,discipline,12,4,8
Gooseundead,tichondrius,384,priest,discipline,12,4,8
Madpriest,blades-edge,384,priest,discipline,12,4,8
Xalty,emerald-dream,384,priest,discipline,12,4,8
Dabrat,darkspear,384,priest,discipline,12,4,8
Plebiss,burning-blade,384,priest,discipline,12,4,8
Ioudas,ragnaros,384,priest,discipline,12,4,8
Someonesxy,aggramar,384,priest,discipline,12,4,8
Amys,kargath,384,priest,discipline,12,4,8
Vyvivienx,tichondrius,384,priest,discipline,12,4,8
Villageidiot,lightbringer,384,priest,discipline,12,4,8
Seyler,barthilas,384,priest,discipline,12,4,8
Nancynibbler,bleeding-hollow,384,priest,discipline,12,4,8
Darkxrp,bleeding-hollow,384,priest,discipline,12,4,8
Lankyschlong,frostmourne,384,priest,discipline,12,4,8
Littlean,frostmourne,384,priest,discipline,12,4,8
Burkett,sargeras,384,priest,discipline,12,4,8
Kikyo,antonidas,384,priest,discipline,12,4,8
Ollarlamente,zuljin,384,priest,discipline,12,4,8
Darkspearr,tichondrius,384,priest,discipline,12,4,8
Zaphfkiel,ragnaros,384,priest,discipline,12,4,8
Pontiffvelen,area-52,384,priest,discipline,12,4,8
Ranksix,area-52,384,priest,discipline,12,4,8
Lucet,aegwynn,384,priest,discipline,12,4,8
Karmapi,malganis,384,priest,discipline,12,4,8
Suekmydisc,frostmourne,384,priest,discipline,12,4,8
Auttø,area-52,384,priest,discipline,12,4,8
Priestmode,garona,384,priest,discipline,12,4,8
Phobe,windrunner,384,priest,discipline,12,4,8
Danceofpales,bleeding-hollow,384,priest,discipline,12,4,8
Giannis,garrosh,384,priest,discipline,12,4,8
Melithor,frostmourne,384,priest,discipline,12,4,8
Disperse,sargeras,384,priest,discipline,12,4,8
Steefe,arygos,384,priest,discipline,12,4,8
Healbilli,archimonde,384,priest,discipline,12,4,8
Mucgib,frostmourne,384,priest,discipline,18,4,14
Kymohek,sargeras,384,priest,discipline,18,4,14
Kibariyb,drakkari,384,priest,discipline,18,4,14
Polythis,kelthuzad,384,priest,discipline,18,4,14
Rainms,sargeras,384,priest,discipline,18,4,14
Disçxrespeçt,cairne,384,priest,discipline,18,4,14
Discodork,bleeding-hollow,383,priest,discipline,6,4,2
Gabrieleron,quelthalas,383,priest,discipline,6,4,2
Needalung,stormrage,383,priest,discipline,6,4,2
Fanaeth,arathor,383,priest,discipline,6,4,2
Lifesavér,tichondrius,383,priest,discipline,6,4,2
Notahero,tichondrius,383,priest,discipline,6,4,2
Coorslite,proudmoore,383,priest,discipline,6,4,2
Meddyglyn,area-52,383,priest,discipline,6,4,2
Mirex,tichondrius,383,priest,discipline,6,4,2
Shén,barthilas,383,priest,discipline,6,4,2
Looneý,drakkari,383,priest,discipline,18,6,12
Uckuck,illidan,383,priest,discipline,12,4,8
Theleena,malorne,383,priest,discipline,12,4,8
Chêrubim,arthas,383,priest,discipline,12,4,8
Whatisholy,bleeding-hollow,383,priest,discipline,12,4,8
Sybal,suramar,383,priest,discipline,12,4,8
Anoxic,kiljaeden,383,priest,discipline,12,4,8
Nocturnimal,grizzly-hills,382,priest,discipline,12,4,8
Väin,proudmoore,381,priest,discipline,12,4,8
Divinebones,gurubashi,381,priest,discipline,12,4,8
Touchedbygud,frostmourne,381,priest,discipline,12,4,8
Primela,sargeras,381,priest,discipline,12,4,8
Malhotra,amanthul,381,priest,discipline,12,4,8
Bunnychloe,sargeras,381,priest,discipline,12,4,8
Shenanigans,illidan,367,priest,discipline,11,4,7
Burtier,zuljin,367,priest,discipline,11,4,7
Gringotaco,tichondrius,362,priest,discipline,20,7,13
Scrïpt,thaurissan,351,priest,discipline,11,4,7
Llaarrkkss,tichondrius,351,priest,discipline,11,4,7
Kuwapre,proudmoore,336,priest,discipline,9,5,4
Proftimothy,tichondrius,336,priest,discipline,9,5,4
Rosabell,ragnaros,336,priest,discipline,21,4,17
Grianné,mannoroth,335,priest,discipline,9,4,5
Causeoflife,eitrigg,335,priest,discipline,11,4,7
Siobhin,wyrmrest-accord,335,priest,discipline,11,4,7
Subvert,zuljin,330,priest,discipline,7,5,2
Tmnaarcanttv,tichondrius,330,priest,discipline,7,5,2
Xiangjiao,tichondrius,330,priest,discipline,17,6,11
Takedisdisc,tichondrius,330,priest,discipline,17,6,11
Lilgeek,kelthuzad,330,priest,discipline,21,5,16
Leviosa,bleeding-hollow,319,priest,discipline,8,4,4
Rôxxy,thrall,319,priest,discipline,8,4,4
Smarttakka,emerald-dream,319,priest,discipline,8,4,4
Manachai,the-forgotten-coast,319,priest,discipline,14,4,10
Klizzy,tichondrius,319,priest,discipline,14,4,10
Rancidcookie,tichondrius,304,priest,discipline,13,4,9
Educated,tichondrius,303,priest,discipline,20,4,16
Fouroneo,tichondrius,288,priest,discipline,6,3,3
Idhealthat,tichondrius,288,priest,discipline,6,3,3
Kynnen,mannoroth,288,priest,discipline,6,3,3
Sassygayboyx,bleeding-hollow,288,priest,discipline,6,3,3
Wiseguise,illidan,288,priest,discipline,6,3,3
Frye,bleeding-hollow,288,priest,discipline,6,3,3
Tooeasy,vashj,288,priest,discipline,6,3,3
Poøpoopeepee,tichondrius,288,priest,discipline,6,3,3
Îcecube,sargeras,288,priest,discipline,6,3,3
Maniacx,stormrage,288,priest,discipline,6,3,3
Drrunk,bleeding-hollow,288,priest,discipline,6,3,3
Serenderpity,moon-guard,288,priest,discipline,6,3,3
Midget,darkspear,288,priest,discipline,6,3,3
Bernietopper,tichondrius,288,priest,discipline,6,3,3
Frogfrompad,tichondrius,288,priest,discipline,6,3,3
Strokingmydx,illidan,288,priest,discipline,6,3,3
Amoureuxz,bleeding-hollow,288,priest,discipline,6,3,3
Swinee,tichondrius,288,priest,discipline,6,3,3
Bgundy,sargeras,288,priest,discipline,6,3,3
Hellokuti,silvermoon,288,priest,discipline,6,3,3
Alleviate,frostmourne,288,priest,discipline,6,3,3
Zugzugheal,bleeding-hollow,288,priest,discipline,6,3,3
Sojumike,proudmoore,288,priest,discipline,6,3,3
Adelda,nazjatar,288,priest,discipline,6,3,3
Bigpoppapwn,darkspear,288,priest,discipline,6,3,3
Minzyx,tichondrius,288,priest,discipline,6,3,3
Kiazma,zuljin,288,priest,discipline,6,3,3
Nevermyndz,bleeding-hollow,288,priest,discipline,6,3,3
Imagees,stormscale,288,priest,discipline,6,3,3
Cromagnøn,dalaran,288,priest,discipline,6,3,3
Kelody,zuljin,288,priest,discipline,6,3,3
Kabutta,stormrage,288,priest,discipline,6,3,3
Filthmaster,moon-guard,288,priest,discipline,6,3,3
Huckdaddy,tichondrius,288,priest,discipline,6,3,3
Kleiâ,tichondrius,288,priest,discipline,6,3,3
Sterycraiied,stormreaver,288,priest,discipline,6,3,3
Éxploït,tichondrius,288,priest,discipline,6,3,3
Hükk,kalecgos,288,priest,discipline,6,3,3
Empyreanlite,dalaran,288,priest,discipline,6,3,3
Dradinx,illidan,288,priest,discipline,6,3,3
Epicp,sargeras,288,priest,discipline,6,3,3
Oxicontin,sargeras,288,priest,discipline,6,3,3
Icarryozz,darkspear,288,priest,discipline,6,3,3
Havefaith,whisperwind,288,priest,discipline,6,3,3
Sæýfír,illidan,288,priest,discipline,6,3,3
Näme,frostmourne,288,priest,discipline,6,3,3
Eddiethehead,zuljin,288,priest,discipline,6,3,3
Relianth,stormrage,288,priest,discipline,6,3,3
Ææae,nemesis,288,priest,discipline,6,3,3
Xsy,stormrage,288,priest,discipline,6,3,3
Iamsatan,illidan,288,priest,discipline,6,3,3
Keyohh,tichondrius,288,priest,discipline,6,3,3
Krewed,ravencrest,288,priest,discipline,6,3,3
Sophistdew,proudmoore,288,priest,discipline,6,3,3
Zzavidwong,tichondrius,288,priest,discipline,6,3,3
Kaiah,gorefiend,288,priest,discipline,6,3,3
Thattpriest,thrall,288,priest,discipline,6,3,3
Magazíne,tichondrius,288,priest,discipline,6,3,3
Heelznfeelz,tichondrius,288,priest,discipline,6,3,3
Mindmelts,gallywix,288,priest,discipline,6,3,3
Ayoheals,zuljin,288,priest,discipline,6,3,3
Mindgamez,stormreaver,288,priest,discipline,6,3,3
Blackdeathx,tichondrius,288,priest,discipline,6,3,3
Umbramortìs,tichondrius,288,priest,discipline,6,3,3
Pwrwordthicc,illidan,288,priest,discipline,6,3,3
Shadowform,illidan,288,priest,discipline,6,3,3
Rotnn,thrall,288,priest,discipline,6,3,3
Niniua,tichondrius,288,priest,discipline,6,3,3
Diamondz,emerald-dream,288,priest,discipline,6,3,3
Psyfriend,area-52,288,priest,discipline,6,3,3
Ellipsiz,area-52,288,priest,discipline,6,3,3
Mks,barthilas,288,priest,discipline,6,3,3
Jesstor,frostmourne,288,priest,discipline,6,3,3
Vanzera,thrall,288,priest,discipline,6,3,3
Madalôn,nemesis,288,priest,discipline,6,3,3
Sandreth,bonechewer,288,priest,discipline,6,3,3
Popeofhope,queldorei,288,priest,discipline,6,3,3
Randomprist,area-52,288,priest,discipline,6,3,3
Pzx,zuljin,288,priest,discipline,6,3,3
Healyhaney,stormrage,288,priest,discipline,6,3,3
Furydos,zuljin,288,priest,discipline,6,3,3
Kawesha,emerald-dream,288,priest,discipline,6,3,3
Humps,sargeras,288,priest,discipline,6,3,3
Khaospriest,proudmoore,288,priest,discipline,6,3,3
Scandi,tichondrius,288,priest,discipline,6,3,3
Wale,akama,288,priest,discipline,6,3,3
Grafîx,frostmourne,288,priest,discipline,6,3,3
Nutdrip,tichondrius,288,priest,discipline,6,3,3
Ìdiot,saurfang,288,priest,discipline,6,3,3
Healznfeel,tichondrius,288,priest,discipline,6,3,3
Illegalkill,tichondrius,288,priest,discipline,6,3,3
Alucardibee,turalyon,288,priest,discipline,6,3,3
Calcifer,drakkari,288,priest,discipline,6,3,3
Boogiê,illidan,288,priest,discipline,6,3,3
Tempname,thunderhorn,288,priest,discipline,6,3,3
Megz,zuljin,288,priest,discipline,6,3,3
Kakera,tichondrius,288,priest,discipline,6,3,3
Bessias,area-52,288,priest,discipline,6,3,3
Edmen,stormrage,288,priest,discipline,6,3,3
Dìngobaby,stormrage,288,priest,discipline,6,3,3
Jinzp,area-52,288,priest,discipline,6,3,3
Irar,tichondrius,288,priest,discipline,6,3,3
Killduran,hellscream,288,priest,discipline,6,3,3
Oofx,darkspear,288,priest,discipline,6,3,3
Aspéct,aegwynn,288,priest,discipline,6,3,3
Pumpkinpino,stormrage,288,priest,discipline,6,3,3
Moirâ,silvermoon,288,priest,discipline,6,3,3
Tmall,tichondrius,288,priest,discipline,6,3,3
Trezz,aegwynn,288,priest,discipline,6,3,3
Mooray,thrall,288,priest,discipline,6,3,3
Decastro,silvermoon,288,priest,discipline,6,3,3
Zuuji,frostmourne,288,priest,discipline,6,3,3
Ashidox,proudmoore,288,priest,discipline,6,3,3
Spiritbear,thrall,288,priest,discipline,6,3,3
Kaldoon,azjolnerub,288,priest,discipline,6,3,3
Animityz,illidan,288,priest,discipline,6,3,3
Methandrial,hyjal,288,priest,discipline,6,3,3
Illiteratex,sargeras,288,priest,discipline,6,3,3
Sasagui,bloodscalp,288,priest,discipline,6,3,3
Daryldeath,tichondrius,288,priest,discipline,6,3,3
Numinous,wyrmrest-accord,288,priest,discipline,6,3,3
Lostnthought,aggramar,288,priest,discipline,6,3,3
Aia,frostwolf,288,priest,discipline,6,3,3
Sinzex,tichondrius,288,priest,discipline,6,3,3
Sabene,greymane,288,priest,discipline,6,3,3
Bestworldxz,illidan,288,priest,discipline,6,3,3
Tarwow,moon-guard,288,priest,discipline,6,3,3
Triazolam,illidan,288,priest,discipline,6,3,3
Kefkå,sargeras,288,priest,discipline,6,3,3
Dredre,aggramar,288,priest,discipline,6,3,3
Pulso,area-52,288,priest,discipline,6,3,3
Yannigirl,area-52,288,priest,discipline,6,3,3
Dumbthott,illidan,288,priest,discipline,6,3,3
Partypack,stormrage,288,priest,discipline,6,3,3
Germanica,area-52,288,priest,discipline,6,3,3
Jjaeminkim,area-52,288,priest,discipline,6,3,3
Tigrania,proudmoore,288,priest,discipline,6,3,3
Dudurr,zuluhed,288,priest,discipline,6,3,3
Shaddäye,andorhal,288,priest,discipline,6,3,3
Nokizzgrizz,sargeras,288,priest,discipline,6,3,3
Liminality,illidan,288,priest,discipline,6,3,3
Chervz,chogall,288,priest,discipline,6,3,3
Seyvyur,black-dragonflight,288,priest,discipline,6,3,3
Nikci,tichondrius,288,priest,discipline,6,3,3
Àneres,illidan,288,priest,discipline,6,3,3
Nyxvoid,ragnaros,288,priest,discipline,6,3,3
Buc,barthilas,288,priest,discipline,6,3,3
Chaner,scarlet-crusade,288,priest,discipline,6,3,3
Aenbubble,tichondrius,288,priest,discipline,6,3,3
Zegron,rexxar,288,priest,discipline,6,3,3
Elise,ravenholdt,288,priest,discipline,6,3,3
Okiin,malganis,288,priest,discipline,6,3,3
Fausto,kiljaeden,288,priest,discipline,6,3,3
Kovie,twisting-nether,288,priest,discipline,6,3,3
Zaradomin,kelthuzad,288,priest,discipline,6,3,3
Nineoneone,kilrogg,288,priest,discipline,6,3,3
Lyriczx,kelthuzad,288,priest,discipline,6,3,3
Namecusein,ragnaros,288,priest,discipline,6,3,3
Alladys,shattered-hand,288,priest,discipline,6,3,3
Hypnogypsy,malganis,288,priest,discipline,6,3,3
Paradoxbot,kelthuzad,288,priest,discipline,6,3,3
Heratic,malganis,288,priest,discipline,6,3,3
Barackhobama,malganis,288,priest,discipline,6,3,3
Xusin,tichondrius,288,priest,discipline,6,3,3
Haedn,azralon,288,priest,discipline,6,3,3
Lifeswaplol,kelthuzad,288,priest,discipline,6,3,3
Fackinheals,kelthuzad,288,priest,discipline,6,3,3
Discs,detheroc,288,priest,discipline,6,3,3
Diskope,kelthuzad,288,priest,discipline,6,3,3
Eiricka,kelthuzad,288,priest,discipline,6,3,3
Whackagnome,kelthuzad,288,priest,discipline,9,4,5
Waterßoÿ,emerald-dream,288,priest,discipline,9,4,5
Aarei,stormrage,288,priest,discipline,10,4,6
Catboynahj,dalaran,288,priest,discipline,8,3,5
Atheistbtw,sargeras,288,priest,discipline,16,5,11
Skimpdubs,bleeding-hollow,288,priest,discipline,12,3,9
Virydian,stormrage,288,priest,discipline,12,3,9
Zrn,bleeding-hollow,288,priest,discipline,12,3,9
Fitzop,frostmourne,288,priest,discipline,12,3,9
Snupyfangirl,area-52,288,priest,discipline,12,3,9
Googus,bleeding-hollow,288,priest,discipline,12,3,9
Avipriest,area-52,288,priest,discipline,12,3,9
Kymmei,warsong,288,priest,discipline,12,3,9
Hail,kaelthas,288,priest,discipline,12,3,9
Doomageddon,thorium-brotherhood,288,priest,discipline,12,3,9
Die,crushridge,288,priest,discipline,12,3,9
Xalatath,stormrage,288,priest,discipline,12,3,9
Realheal,tichondrius,288,priest,discipline,12,3,9
Frag,frostmourne,288,priest,discipline,12,3,9
Tý,frostmourne,288,priest,discipline,12,3,9
Xavaat,nerzhul,288,priest,discipline,12,3,9
Itha,illidan,288,priest,discipline,12,3,9
Manaburnout,blackhand,288,priest,discipline,12,3,9
Quartzolio,azralon,288,priest,discipline,12,3,9
Soleyxo,frostmourne,288,priest,discipline,12,3,9
Lightshizzle,illidan,288,priest,discipline,12,3,9
Gwenoviere,whisperwind,288,priest,discipline,12,3,9
Nogetget,frostmourne,288,priest,discipline,12,3,9
Paztech,arthas,288,priest,discipline,12,3,9
Hokon,tortheldrin,288,priest,discipline,12,3,9
Kurnak,arthas,288,priest,discipline,12,3,9
Autogenic,malganis,288,priest,discipline,12,3,9
Phillyrivers,area-52,288,priest,discipline,12,3,9
Xìdís,vashj,288,priest,discipline,12,3,9
Slackinhealz,thrall,288,priest,discipline,12,3,9
Phantøms,zuljin,288,priest,discipline,12,3,9
Disconelf,barthilas,288,priest,discipline,12,3,9
Nsquared,illidan,288,priest,discipline,12,3,9
Solestro,malganis,288,priest,discipline,12,3,9
Krewtoo,illidan,288,priest,discipline,12,3,9
Devili,wyrmrest-accord,288,priest,discipline,12,3,9
Gloomswrath,illidan,288,priest,discipline,12,3,9
Shattgreen,malganis,288,priest,discipline,12,3,9
Bree,area-52,288,priest,discipline,12,3,9
Jahratu,tichondrius,288,priest,discipline,12,3,9
Aaxahfon,moon-guard,288,priest,discipline,12,3,9
Bån,ragnaros,288,priest,discipline,12,3,9
Decokim,tichondrius,288,priest,discipline,12,3,9
Zemms,tichondrius,288,priest,discipline,12,3,9
Muriaticacid,tichondrius,288,priest,discipline,12,3,9
Chaddadbod,emerald-dream,288,priest,discipline,12,3,9
Twohpriest,aerie-peak,288,priest,discipline,12,3,9
Bugshott,tichondrius,288,priest,discipline,12,3,9
Bewbeez,fizzcrank,288,priest,discipline,12,3,9
Pedialyte,kiljaeden,288,priest,discipline,12,3,9
Dumplolz,quelthalas,288,priest,discipline,12,3,9
Bandagebabe,sargeras,288,priest,discipline,12,3,9
Abefromann,sargeras,288,priest,discipline,12,3,9
Shadowdroid,tichondrius,288,priest,discipline,12,3,9
Kaztorz,tichondrius,288,priest,discipline,16,3,13
Moc,jubeithos,288,priest,discipline,18,3,15
Chirho,malganis,288,priest,discipline,18,3,15
Pïque,proudmoore,288,priest,discipline,18,3,15
Pravant,illidan,288,priest,discipline,18,3,15
Imgold,emerald-dream,287,priest,discipline,6,3,3
Solzal,korgath,287,priest,discipline,6,3,3
Wobbleskank,tichondrius,287,priest,discipline,6,3,3
Dorkulous,wyrmrest-accord,287,priest,discipline,12,3,9
Kagayaku,aegwynn,287,priest,discipline,12,3,9
Priestkofwa,tichondrius,287,priest,discipline,12,3,9
Kataró,tichondrius,286,priest,discipline,12,3,9
Poodledad,wyrmrest-accord,255,priest,discipline,8,4,4
Prèèst,proudmoore,255,priest,discipline,11,3,8
Stormlighter,proudmoore,255,priest,discipline,11,3,8
Plaguepumper,sargeras,255,priest,discipline,11,3,8
Imamu,tichondrius,251,priest,discipline,35,16,19
Holycwap,stormrage,240,priest,discipline,9,3,6
Holdentudikz,area-52,239,priest,discipline,5,3,2
Koalakazamzy,shadow-council,239,priest,discipline,5,3,2
Pasquell,emerald-dream,239,priest,discipline,5,3,2
Yumä,kiljaeden,239,priest,discipline,5,3,2
Mawwt,moon-guard,239,priest,discipline,5,3,2
Canô,quelthalas,239,priest,discipline,5,3,2
Skruffles,black-dragonflight,239,priest,discipline,5,3,2
Murillio,moon-guard,239,priest,discipline,5,3,2
Pohky,area-52,239,priest,discipline,5,3,2
Wodturbo,bleeding-hollow,234,priest,discipline,7,4,3
Johnnweedd,ragnaros,234,priest,discipline,8,4,4
Priêsty,stormrage,234,priest,discipline,9,4,5
Onahaihu,tichondrius,234,priest,discipline,14,4,10
Gloomyspp,illidan,234,priest,discipline,14,4,10
Islada,illidan,233,priest,discipline,18,4,14
Hycinamun,malganis,223,priest,discipline,8,3,5
Holyshield,jubeithos,223,priest,discipline,8,3,5
Wagonss,stormrage,222,priest,discipline,25,7,18
Reâpêr,kelthuzad,201,priest,discipline,13,4,9
Berzum,chogall,192,priest,discipline,4,3,1
Jedrick,malganis,192,priest,discipline,4,3,1
Deckx,khazgoroth,192,priest,discipline,6,4,2
Notthebappo,malganis,192,priest,discipline,11,4,7
Tedesq,stormrage,192,priest,discipline,9,3,6
Lunarras,aggramar,192,priest,discipline,6,2,4
Patagoniabae,kelthuzad,192,priest,discipline,6,2,4
Makdaddy,skullcrusher,192,priest,discipline,6,2,4
Davedawg,emerald-dream,192,priest,discipline,6,2,4
Brazen,emerald-dream,192,priest,discipline,6,2,4
Haushauha,azralon,192,priest,discipline,6,2,4
Jpandha,azralon,192,priest,discipline,6,2,4
Ansgar,eonar,192,priest,discipline,6,2,4
Ligthsoul,ragnaros,192,priest,discipline,6,2,4
Zereht,ragnaros,192,priest,discipline,6,2,4
Médic,guldan,192,priest,discipline,6,2,4
Plasmax,ragnaros,192,priest,discipline,6,2,4
Genevieve,aggramar,192,priest,discipline,6,2,4
Linaelinatia,area-52,192,priest,discipline,6,2,4
Shadowpáin,ragnaros,192,priest,discipline,6,2,4
Saenax,area-52,192,priest,discipline,6,2,4
Verboden,kelthuzad,192,priest,discipline,6,2,4
Disc,haomarush,192,priest,discipline,6,2,4
Ocxpriest,azralon,192,priest,discipline,6,2,4
Zarakih,azralon,192,priest,discipline,6,2,4
Mayzal,emerald-dream,192,priest,discipline,6,2,4
Trienolone,emerald-dream,192,priest,discipline,6,2,4
Nars,draka,192,priest,discipline,6,2,4
Keaina,malganis,192,priest,discipline,6,2,4
Stilla,kelthuzad,192,priest,discipline,6,2,4
Gwendalynne,tichondrius,192,priest,discipline,6,2,4
Spampws,aerie-peak,192,priest,discipline,6,2,4
Holyshafted,kelthuzad,192,priest,discipline,6,2,4
Stennic,emerald-dream,192,priest,discipline,6,2,4
Vikingkøng,ragnaros,192,priest,discipline,6,2,4
Thangthangin,icecrown,192,priest,discipline,6,2,4
Cryptoccocus,zuljin,192,priest,discipline,6,2,4
Heartsblood,whisperwind,192,priest,discipline,6,2,4
Hotdice,bleeding-hollow,192,priest,discipline,6,2,4
Castholy,nordrassil,192,priest,discipline,6,2,4
Bigmommyxo,whisperwind,192,priest,discipline,6,2,4
Chazzwizz,area-52,192,priest,discipline,6,2,4
Slenden,illidan,192,priest,discipline,6,2,4
Feelmydisc,bonechewer,192,priest,discipline,6,2,4
Drbønghitmd,tichondrius,192,priest,discipline,6,2,4
Pimeharder,tichondrius,192,priest,discipline,6,2,4
Stiffmeister,bleeding-hollow,192,priest,discipline,6,2,4
Dilonpi,area-52,192,priest,discipline,6,2,4
Gwenholy,hakkar,192,priest,discipline,6,2,4
Príest,nordrassil,192,priest,discipline,6,2,4
Halloweenx,area-52,192,priest,discipline,6,2,4
Noteenurse,blackrock,192,priest,discipline,6,2,4
Budheals,spirestone,192,priest,discipline,6,2,4
Discyple,ysera,192,priest,discipline,6,2,4
Ubbzy,illidan,192,priest,discipline,6,2,4
Coldstone,bloodhoof,192,priest,discipline,6,2,4
Holytipz,stormrage,192,priest,discipline,6,2,4
Cub,darkspear,192,priest,discipline,6,2,4
Keygodx,illidan,192,priest,discipline,6,2,4
Boostvoid,terenas,192,priest,discipline,6,2,4
Easywins,sargeras,192,priest,discipline,6,2,4
Snowlily,illidan,192,priest,discipline,6,2,4
Mordaren,arthas,192,priest,discipline,6,2,4
Yoxxoo,tichondrius,192,priest,discipline,6,2,4
Mindgoblin,terokkar,192,priest,discipline,6,2,4
Baldy,arthas,192,priest,discipline,6,2,4
Bestwizardx,tichondrius,192,priest,discipline,6,2,4
Penicilin,terokkar,192,priest,discipline,6,2,4
Nejisaiyan,sargeras,192,priest,discipline,6,2,4
Hankspank,hakkar,192,priest,discipline,6,2,4
Soulclap,sargeras,192,priest,discipline,6,2,4
Bmox,borean-tundra,192,priest,discipline,6,2,4
Sabalonely,tichondrius,192,priest,discipline,6,2,4
Jaq,altar-of-storms,192,priest,discipline,6,2,4
Linkolln,sargeras,192,priest,discipline,6,2,4
Novakaynersj,anetheron,192,priest,discipline,6,2,4
Krossvoid,thrall,192,priest,discipline,6,2,4
Qnarisha,tichondrius,192,priest,discipline,6,2,4
Pingleangel,tichondrius,192,priest,discipline,6,2,4
Whitesharks,tichondrius,192,priest,discipline,6,2,4
Tulip,frostmourne,192,priest,discipline,6,2,4
Kustem,tichondrius,192,priest,discipline,6,2,4
Noobepriest,thrall,192,priest,discipline,6,2,4
Shalther,thrall,192,priest,discipline,6,2,4
Benjamints,thrall,192,priest,discipline,6,2,4
Bubblewrap,wyrmrest-accord,192,priest,discipline,6,2,4
Coffeek,sargeras,192,priest,discipline,6,2,4
Rickmason,frostmane,192,priest,discipline,6,2,4
Discogs,frostmourne,192,priest,discipline,6,2,4
Járngreipr,nerzhul,192,priest,discipline,6,2,4
Roivas,bleeding-hollow,192,priest,discipline,6,2,4
Mindfak,bleeding-hollow,192,priest,discipline,6,2,4
Kìttý,cenarius,192,priest,discipline,6,2,4
Plaguesus,dalaran,192,priest,discipline,6,2,4
Corpsen,frostmourne,192,priest,discipline,6,2,4
Helorren,nagrand,192,priest,discipline,6,2,4
Ayani,khadgar,192,priest,discipline,6,2,4
Meowforheals,sargeras,192,priest,discipline,6,2,4
Kaeruz,stormrage,192,priest,discipline,6,2,4
Insomnya,sargeras,192,priest,discipline,6,2,4
Mhanaburn,nerzhul,192,priest,discipline,6,2,4
Vivø,nemesis,192,priest,discipline,6,2,4
Krevs,proudmoore,192,priest,discipline,6,2,4
Qmine,tichondrius,192,priest,discipline,6,2,4
Smallz,silvermoon,192,priest,discipline,6,2,4
Râven,proudmoore,192,priest,discipline,6,2,4
Dinkk,stormrage,192,priest,discipline,6,2,4
Sheriff,lightbringer,192,priest,discipline,6,2,4
Rbmxp,barthilas,192,priest,discipline,6,2,4
Kimbeloria,bleeding-hollow,192,priest,discipline,6,2,4
Goatedhp,dalaran,192,priest,discipline,6,2,4
Mentiroso,kaelthas,192,priest,discipline,6,2,4
Xeroxlivee,tichondrius,192,priest,discipline,6,2,4
Phatheals,norgannon,192,priest,discipline,6,2,4
Kaldrbock,sargeras,192,priest,discipline,6,2,4
Quasenada,stormrage,192,priest,discipline,6,2,4
Tamilu,terenas,192,priest,discipline,6,2,4
Holydrop,sargeras,192,priest,discipline,6,2,4
Whitecaster,tichondrius,192,priest,discipline,6,2,4
Riztwo,moon-guard,192,priest,discipline,6,2,4
Faedre,smolderthorn,192,priest,discipline,6,2,4
Schadên,wyrmrest-accord,192,priest,discipline,6,2,4
Hundski,darkspear,192,priest,discipline,6,2,4
Issaley,tichondrius,192,priest,discipline,6,2,4
Irixus,zuljin,192,priest,discipline,6,2,4
Çherished,stormrage,192,priest,discipline,6,2,4
Aelap,malganis,192,priest,discipline,6,2,4
Skellieman,malorne,192,priest,discipline,6,2,4
Meaning,tichondrius,192,priest,discipline,6,2,4
Dimanche,thunderlord,192,priest,discipline,6,2,4
Dxs,hydraxis,192,priest,discipline,6,2,4
Djwienerbum,darkspear,192,priest,discipline,6,2,4
Machiomora,dunemaul,192,priest,discipline,6,2,4
Skêptic,tichondrius,192,priest,discipline,6,2,4
Stepbroplzno,barthilas,192,priest,discipline,6,2,4
Wiccano,stormrage,192,priest,discipline,6,2,4
Ôp,sargeras,192,priest,discipline,6,2,4
Mattkoster,mannoroth,192,priest,discipline,6,2,4
Qtpriestx,tichondrius,192,priest,discipline,6,2,4
Rezy,darkspear,192,priest,discipline,6,2,4
Brokennurse,area-52,192,priest,discipline,7,2,5
Lightski,thunderlord,192,priest,discipline,7,2,5
Patchyemoly,frostmourne,192,priest,discipline,8,2,6
Rewena,silver-hand,192,priest,discipline,12,2,10
Canyounaut,kelthuzad,192,priest,discipline,12,2,10
Lûdløw,kelthuzad,192,priest,discipline,12,2,10
Grâfix,barthilas,192,priest,discipline,12,2,10
Ularim,tichondrius,192,priest,discipline,12,2,10
Meatbaoo,tichondrius,192,priest,discipline,12,2,10
Fearward,silvermoon,192,priest,discipline,12,2,10
Majiinbuu,maelstrom,192,priest,discipline,12,2,10
Vyvanse,azuremyst,192,priest,discipline,12,2,10
Deadmoron,illidan,192,priest,discipline,12,2,10
Fiéstah,illidan,192,priest,discipline,12,2,10
Kuazi,frostmourne,192,priest,discipline,12,2,10
Toguol,stormrage,192,priest,discipline,12,2,10
Prilance,hyjal,192,priest,discipline,12,2,10
Häle,bloodscalp,192,priest,discipline,12,2,10
Bolognypony,norgannon,192,priest,discipline,12,2,10
Jordiest,dalaran,192,priest,discipline,12,2,10
Ergoproxy,barthilas,192,priest,discipline,18,2,16
Charlie,azshara,191,priest,discipline,6,2,4
Leoi,fenris,191,priest,discipline,6,2,4
Myobi,tichondrius,191,priest,discipline,6,2,4
Frothyfran,icecrown,191,priest,discipline,12,2,10
Mynigajeff,zuljin,185,priest,discipline,14,4,10
Akåsha,zuljin,175,priest,discipline,11,2,9
Gabuncher,barthilas,175,priest,discipline,11,2,9
Strict,the-forgotten-coast,159,priest,discipline,5,2,3
Cruxave,aegwynn,159,priest,discipline,5,2,3
Hotpockets,detheroc,159,priest,discipline,5,2,3
Dinogingy,lightbringer,159,priest,discipline,5,2,3
Pochis,bleeding-hollow,159,priest,discipline,8,3,5
Yuhstin,sargeras,159,priest,discipline,8,3,5
ßßxßß,tichondrius,144,priest,discipline,3,3,0
Saintguard,tichondrius,138,priest,discipline,7,3,4
Mesiausx,stormrage,138,priest,discipline,8,3,5
Prayanmantis,tichondrius,138,priest,discipline,8,3,5
Tylennin,hyjal,138,priest,discipline,13,4,9
Desiree,emerald-dream,138,priest,discipline,13,4,9
Ariadneminos,illidan,138,priest,discipline,11,3,8
Theophobe,illidan,138,priest,discipline,19,5,14
Strepsis,icecrown,128,priest,discipline,4,2,2
Dangerhealz,frostmourne,128,priest,discipline,4,2,2
Càipirinha,tichondrius,128,priest,discipline,4,2,2
Fadinglol,tichondrius,128,priest,discipline,4,2,2
Krathe,azralon,128,priest,discipline,4,2,2
Juvell,illidan,96,priest,discipline,3,2,1
Tmspongwo,tichondrius,96,priest,discipline,3,2,1
Standback,wyrmrest-accord,96,priest,discipline,3,2,1
Shadp,tichondrius,96,priest,discipline,3,2,1
Allaurah,thrall,96,priest,discipline,3,2,1
Nickerbocker,nazgrel,96,priest,discipline,6,1,5
Yessír,stormrage,96,priest,discipline,6,1,5
Dwennalous,stormrage,96,priest,discipline,6,1,5
Kireepilef,ragnaros,96,priest,discipline,6,1,5
Doobzy,proudmoore,96,priest,discipline,6,1,5
Nonbinary,trollbane,96,priest,discipline,6,1,5
Worstpriest,stormscale,96,priest,discipline,6,1,5
Edessa,lothar,96,priest,discipline,6,1,5
Baerybonds,kiljaeden,96,priest,discipline,6,1,5
Annoka,sargeras,96,priest,discipline,6,1,5
Shaylari,kelthuzad,96,priest,discipline,6,1,5
Thasar,azgalor,96,priest,discipline,6,1,5
Religions,wyrmrest-accord,96,priest,discipline,6,1,5
Common,tichondrius,96,priest,discipline,6,1,5
Runecarver,anvilmar,96,priest,discipline,6,1,5
Clárke,tichondrius,96,priest,discipline,6,1,5
Ripchadman,tichondrius,96,priest,discipline,6,1,5
Nekkz,sargeras,96,priest,discipline,6,1,5
Løøtgoblin,skullcrusher,96,priest,discipline,6,1,5
Yogirabbit,kiljaeden,96,priest,discipline,6,1,5
Sukeena,malganis,96,priest,discipline,6,1,5
Omgnerfz,zuljin,96,priest,discipline,6,1,5
Kunof,ragnaros,96,priest,discipline,6,1,5
Djriest,sargeras,96,priest,discipline,6,1,5
Púrg,frostmourne,96,priest,discipline,6,1,5
Apbrady,sargeras,96,priest,discipline,6,1,5
Spêc,frostmourne,96,priest,discipline,6,1,5
Lzzp,azralon,96,priest,discipline,6,1,5
Wreklol,sargeras,96,priest,discipline,6,1,5
Shadeven,nagrand,96,priest,discipline,6,1,5
Aeøns,sargeras,96,priest,discipline,6,1,5
Raihn,garrosh,96,priest,discipline,6,1,5
Tooflyy,sargeras,96,priest,discipline,6,1,5
Mannybtuggin,kelthuzad,96,priest,discipline,6,1,5
Jaseyrae,emerald-dream,96,priest,discipline,6,1,5
Fatherwyatt,bleeding-hollow,96,priest,discipline,6,1,5
Ugamie,proudmoore,96,priest,discipline,6,1,5
Hairyleg,kelthuzad,96,priest,discipline,6,1,5
Rickitz,bleeding-hollow,96,priest,discipline,6,1,5
Breathkeeper,proudmoore,96,priest,discipline,6,1,5
Mêatpuppet,kiljaeden,96,priest,discipline,6,1,5
Kimmie,kelthuzad,96,priest,discipline,6,1,5
Ndz,wyrmrest-accord,96,priest,discipline,6,1,5
Blosinrosin,lightbringer,96,priest,discipline,6,1,5
Tisifone,ragnaros,96,priest,discipline,6,1,5
Trupriest,alleria,96,priest,discipline,6,1,5
Floofball,medivh,96,priest,discipline,6,1,5
Snotanygood,alleria,96,priest,discipline,6,1,5
Regzi,stormrage,96,priest,discipline,6,1,5
Halfcab,runetotem,96,priest,discipline,6,1,5
Terripriest,sargeras,96,priest,discipline,6,1,5
Ivermectin,eredar,96,priest,discipline,6,1,5
Canklez,stormscale,96,priest,discipline,6,1,5
Ilikis,tichondrius,96,priest,discipline,6,1,5
Fades,hellscream,96,priest,discipline,6,1,5
Shelleypin,bleeding-hollow,96,priest,discipline,6,1,5
Scenekîd,moon-guard,96,priest,discipline,6,1,5
Minamy,tichondrius,96,priest,discipline,6,1,5
Mêga,illidan,96,priest,discipline,6,1,5
Vayr,thrall,96,priest,discipline,6,1,5
Leach,darkspear,96,priest,discipline,6,1,5
Bingoreferee,kelthuzad,96,priest,discipline,6,1,5
Saltedaddy,tichondrius,96,priest,discipline,6,1,5
Billyscousin,chogall,96,priest,discipline,6,1,5
Rahna,azralon,96,priest,discipline,6,1,5
Orethon,thrall,96,priest,discipline,6,1,5
Tatereh,illidan,96,priest,discipline,6,1,5
Lifejuice,tichondrius,96,priest,discipline,6,1,5
Shåde,skullcrusher,96,priest,discipline,6,1,5
Hordehealin,laughing-skull,96,priest,discipline,6,1,5
Kyrabon,ragnaros,96,priest,discipline,6,1,5
Braxxten,tichondrius,96,priest,discipline,6,1,5
Rookieone,thrall,96,priest,discipline,6,1,5
Kryoff,illidan,96,priest,discipline,6,1,5
Battlemage,magtheridon,96,priest,discipline,6,1,5
Pastortee,sargeras,96,priest,discipline,6,1,5
Gódriç,emerald-dream,96,priest,discipline,6,1,5
Radiance,aggramar,96,priest,discipline,6,1,5
Mistnamed,emerald-dream,96,priest,discipline,6,1,5
Moonideli,moon-guard,96,priest,discipline,6,1,5
Ayzen,emerald-dream,96,priest,discipline,6,1,5
Payforheals,malganis,96,priest,discipline,6,1,5
Robinophelia,sargeras,96,priest,discipline,6,1,5
Nineoneoneh,stormrage,96,priest,discipline,6,1,5
Tichealstwo,tichondrius,96,priest,discipline,6,1,5
Keynnish,sargeras,96,priest,discipline,6,1,5
Drmuhammad,sargeras,96,priest,discipline,6,1,5
Holddacheese,area-52,96,priest,discipline,6,1,5
Barelylegalx,tichondrius,96,priest,discipline,6,1,5
Lildes,tichondrius,96,priest,discipline,6,1,5
Mïsstres,area-52,96,priest,discipline,6,1,5
Vandi,moon-guard,96,priest,discipline,6,1,5
Cenzlyor,arthas,96,priest,discipline,6,1,5
Spspsp,illidan,96,priest,discipline,6,1,5
Hionlife,tichondrius,96,priest,discipline,6,1,5
Kagura,dunemaul,96,priest,discipline,6,1,5
Prayforhealz,tichondrius,96,priest,discipline,6,1,5
Dchi,tichondrius,96,priest,discipline,6,1,5
Throwshade,moon-guard,96,priest,discipline,6,1,5
Trixor,area-52,96,priest,discipline,6,1,5
Dáhealz,tichondrius,96,priest,discipline,6,1,5
Thh,emerald-dream,96,priest,discipline,6,1,5
Lingt,drakkari,96,priest,discipline,6,1,5
Holnderoth,malganis,96,priest,discipline,6,1,5
Priestmika,illidan,96,priest,discipline,6,1,5
Wilcarfegus,draka,96,priest,discipline,6,1,5
Aneresxo,illidan,96,priest,discipline,6,1,5
Soliidsnake,area-52,96,priest,discipline,6,1,5
Escence,jubeithos,96,priest,discipline,6,1,5
Tabzorbing,illidan,96,priest,discipline,6,1,5
Lenigrast,blackrock,96,priest,discipline,6,1,5
Galice,archimonde,96,priest,discipline,6,1,5
Capixaba,stormrage,96,priest,discipline,6,1,5
Powerwordqt,kalecgos,96,priest,discipline,6,1,5
Merxy,bleeding-hollow,96,priest,discipline,6,1,5
Dawnside,wyrmrest-accord,96,priest,discipline,12,1,11
Ssmushi,tichondrius,96,priest,discipline,12,1,11
Gusgp,tichondrius,96,priest,discipline,12,1,11
Sifts,proudmoore,96,priest,discipline,12,1,11
Sevenlions,stormrage,96,priest,discipline,12,1,11
Mallzahar,darkspear,96,priest,discipline,12,1,11
Chewboppa,zuljin,96,priest,discipline,12,1,11
Erinyn,area-52,96,priest,discipline,12,1,11
Torgasm,frostmourne,96,priest,discipline,12,1,11
Punkndrublic,sargeras,96,priest,discipline,12,1,11
Timéo,zuljin,96,priest,discipline,18,1,17
Mixxd,shuhalo,95,priest,discipline,6,1,5
Larry,tichondrius,79,priest,discipline,5,1,4
Sáito,area-52,79,priest,discipline,5,1,4
Oldmanlou,spirestone,63,priest,discipline,14,2,12
Wyldpiece,frostmourne,42,priest,discipline,7,3,4
Jqueryy,tichondrius,42,priest,discipline,11,3,8
Bigpimpnz,wildhammer,42,priest,discipline,14,3,11
Küno,kelthuzad,42,priest,discipline,10,2,8
Londy,area-52,42,priest,discipline,16,3,13
Alathan,sargeras,31,priest,discipline,2,1,1
Nås,elune,31,priest,discipline,2,1,1
Jennaôrtega,tichondrius,2312,priest,shadow,84,54,30
Orchidp,tichondrius,2302,priest,shadow,216,136,80
Yeazy,stormrage,2296,priest,shadow,108,62,46
Ejr,altar-of-storms,2247,priest,shadow,103,55,48
Kishoengi,sargeras,2239,priest,shadow,90,56,34
Pboo,tichondrius,2232,priest,shadow,66,41,25
Edd,tichondrius,2215,priest,shadow,158,84,74
Yeona,tichondrius,2195,priest,shadow,101,60,41
Mearas,kelthuzad,2189,priest,shadow,88,52,36
Disemble,illidan,2186,priest,shadow,78,44,34
Techbadar,tichondrius,2185,priest,shadow,125,65,60
Eradication,frostmourne,2168,priest,shadow,93,61,32
Dyrr,barthilas,2164,priest,shadow,102,55,47
Zçythe,tichondrius,2158,priest,shadow,84,51,33
Geovanni,barthilas,2147,priest,shadow,89,47,42
Moraver,kelthuzad,2141,priest,shadow,74,39,35
Zlipz,frostmourne,2125,priest,shadow,66,42,24
Dream,tichondrius,2122,priest,shadow,126,63,63
Yenïza,illidan,2111,priest,shadow,148,81,67
Kottun,stormrage,2110,priest,shadow,66,38,28
Lìám,frostmourne,2110,priest,shadow,187,102,85
Bayter,frostmourne,2105,priest,shadow,181,97,84
Strwbrynaner,sargeras,2098,priest,shadow,150,79,71
Ombravuota,blades-edge,2085,priest,shadow,153,83,70
Oohhmágáá,azralon,2079,priest,shadow,66,48,18
Scandi,tichondrius,2053,priest,shadow,60,35,25
Vtp,frostmourne,2052,priest,shadow,116,66,50
Nekroscream,queldorei,2050,priest,shadow,95,53,42
Xiaozhui,tichondrius,2046,priest,shadow,75,41,34
Spamndam,tichondrius,2045,priest,shadow,54,32,22
Laundryday,korgath,2043,priest,shadow,96,51,45
Pdfileclass,tichondrius,2039,priest,shadow,54,36,18
Eunu,tichondrius,2036,priest,shadow,132,65,67
Targora,lightninghoof,2030,priest,shadow,72,42,30
Omenx,emerald-dream,2018,priest,shadow,48,30,18
Expr,area-52,2016,priest,shadow,84,47,37
Knowknow,tichondrius,2013,priest,shadow,108,57,51
Welplayedman,emerald-dream,2009,priest,shadow,60,35,25
Kiriko,mannoroth,2009,priest,shadow,95,54,41
Maskali,tichondrius,2009,priest,shadow,138,66,72
Arobahn,tichondrius,2008,priest,shadow,100,54,46
Zlips,frostmourne,2006,priest,shadow,75,37,38
Gâdzêd,kelthuzad,2003,priest,shadow,62,38,24
Babyh,tichondrius,1994,priest,shadow,77,41,36
Keygodx,illidan,1977,priest,shadow,59,36,23
Viyana,stormrage,1977,priest,shadow,204,104,100
Talbadar,tichondrius,1973,priest,shadow,66,42,24
Apbrady,sargeras,1973,priest,shadow,66,35,31
Blax,stormscale,1972,priest,shadow,78,43,35
Aro,tichondrius,1966,priest,shadow,60,32,28
Mamísonga,ragnaros,1965,priest,shadow,71,35,36
Helmsman,tichondrius,1960,priest,shadow,100,56,44
Urelz,illidan,1956,priest,shadow,30,21,9
Greaterfade,stormrage,1952,priest,shadow,60,34,26
Maìden,sargeras,1946,priest,shadow,54,30,24
Shibuu,moon-guard,1942,priest,shadow,52,28,24
Garpd,tichondrius,1938,priest,shadow,72,47,25
Ysuran,moon-guard,1930,priest,shadow,184,106,78
Katallyst,tichondrius,1926,priest,shadow,77,36,41
Zyrith,sargeras,1925,priest,shadow,69,36,33
Sin,guldan,1924,priest,shadow,268,144,124
Kuraga,bleeding-hollow,1922,priest,shadow,332,177,155
Cheesëburg,illidan,1915,priest,shadow,54,28,26
Pbxx,tichondrius,1914,priest,shadow,52,31,21
Amyyds,illidan,1907,priest,shadow,95,61,34
Ousïa,quelthalas,1905,priest,shadow,88,44,44
Erebusz,tichondrius,1903,priest,shadow,72,36,36
Yberisa,zuljin,1897,priest,shadow,55,34,21
Soapee,illidan,1896,priest,shadow,191,96,95
Holydose,moon-guard,1893,priest,shadow,78,34,44
Criminalsp,frostmourne,1889,priest,shadow,54,29,25
Metasp,sargeras,1887,priest,shadow,60,32,28
Meehx,illidan,1886,priest,shadow,102,65,37
Louloudots,malganis,1880,priest,shadow,66,34,32
Netheerix,tichondrius,1879,priest,shadow,51,30,21
Stinkiez,area-52,1878,priest,shadow,229,119,110
Delasoul,malganis,1876,priest,shadow,63,37,26
Sênju,thrall,1875,priest,shadow,65,35,30
Blackoss,sargeras,1874,priest,shadow,53,27,26
Mythsnake,ragnaros,1872,priest,shadow,49,29,20
Soar,ravencrest,1872,priest,shadow,47,26,21
Atarri,illidan,1868,priest,shadow,54,31,23
Creapture,zuluhed,1864,priest,shadow,42,24,18
Xayp,kelthuzad,1863,priest,shadow,101,73,28
Keliarc,sargeras,1863,priest,shadow,60,34,26
Taylorsp,tichondrius,1863,priest,shadow,76,42,34
Voidkay,tichondrius,1862,priest,shadow,42,35,7
Wizkxjwap,tichondrius,1862,priest,shadow,36,24,12
Puppyboyx,moon-guard,1861,priest,shadow,62,31,31
Fungame,malganis,1855,priest,shadow,50,35,15
Tamajka,the-forgotten-coast,1855,priest,shadow,93,49,44
Itkev,area-52,1854,priest,shadow,35,27,8
Couldntbeme,sargeras,1852,priest,shadow,54,31,23
Kattallyst,tichondrius,1851,priest,shadow,42,24,18
Asmødeus,bleeding-hollow,1851,priest,shadow,71,37,34
Echoos,proudmoore,1849,priest,shadow,42,28,14
Yoggismydad,emerald-dream,1847,priest,shadow,48,29,19
Wafflezsp,frostmourne,1847,priest,shadow,120,62,58
Sapoopettas,quelthalas,1845,priest,shadow,54,26,28
Niark,frostmourne,1844,priest,shadow,46,24,22
Griffsp,sargeras,1844,priest,shadow,203,101,102
Remixsp,malganis,1840,priest,shadow,42,24,18
Jugeumx,proudmoore,1838,priest,shadow,42,25,17
Marfas,illidan,1837,priest,shadow,62,30,32
Emopriestqt,tichondrius,1836,priest,shadow,114,68,46
Niurouchuan,tichondrius,1834,priest,shadow,62,31,31
Plztrainme,spinebreaker,1831,priest,shadow,106,58,48
Phubar,stormreaver,1831,priest,shadow,78,34,44
Remedio,emerald-dream,1830,priest,shadow,33,21,12
Cøtt,emerald-dream,1829,priest,shadow,48,30,18
Doma,malganis,1829,priest,shadow,43,26,17
Yb,kelthuzad,1829,priest,shadow,54,32,22
Auttø,area-52,1829,priest,shadow,45,26,19
Kalantris,ragnaros,1828,priest,shadow,64,41,23
Throwshade,moon-guard,1828,priest,shadow,89,56,33
Giriosp,thrall,1827,priest,shadow,31,22,9
Ensanity,stormrage,1826,priest,shadow,60,33,27
Gromkekz,area-52,1826,priest,shadow,72,33,39
Celypriest,moon-guard,1825,priest,shadow,30,25,5
Ptam,tichondrius,1825,priest,shadow,47,26,21
Idiotgarbage,moon-guard,1824,priest,shadow,48,26,22
Snozberry,malganis,1822,priest,shadow,66,36,30
Mindslips,tichondrius,1821,priest,shadow,144,82,62
Sodíum,wyrmrest-accord,1821,priest,shadow,65,33,32
Bearoom,frostmourne,1820,priest,shadow,66,39,27
Kydraah,ragnaros,1820,priest,shadow,47,27,20
Plaguesus,dalaran,1820,priest,shadow,64,35,29
Vil,lightnings-blade,1819,priest,shadow,90,50,40
Nevertelsp,malganis,1818,priest,shadow,122,79,43
Dots,tichondrius,1816,priest,shadow,53,33,20
Katarot,area-52,1816,priest,shadow,51,30,21
Discipline,chogall,1816,priest,shadow,48,26,22
Hollister,illidan,1816,priest,shadow,246,132,114
Blissily,sargeras,1814,priest,shadow,75,47,28
Irasponsible,stormrage,1814,priest,shadow,42,23,19
Holytalk,tichondrius,1814,priest,shadow,60,30,30
Drupith,dalaran,1814,priest,shadow,54,27,27
Melonsoda,stormrage,1813,priest,shadow,48,26,22
Resonator,laughing-skull,1813,priest,shadow,46,22,24
Invain,executus,1812,priest,shadow,30,24,6
Xannè,tichondrius,1811,priest,shadow,60,30,30
Tomcruisé,zuljin,1810,priest,shadow,54,31,23
Llamabush,malganis,1809,priest,shadow,39,26,13
Doublesix,malganis,1809,priest,shadow,72,43,29
Krelaeren,tichondrius,1809,priest,shadow,65,33,32
Cixelpvp,area-52,1809,priest,shadow,54,26,28
Arthrix,sargeras,1807,priest,shadow,72,46,26
Ericxd,area-52,1807,priest,shadow,77,38,39
Edai,malganis,1806,priest,shadow,229,124,105
Ghostz,alleria,1805,priest,shadow,54,36,18
Pesca,proudmoore,1805,priest,shadow,60,35,25
Jomm,area-52,1805,priest,shadow,69,37,32
Exoticfather,area-52,1805,priest,shadow,60,30,30
Saintpleb,sargeras,1804,priest,shadow,92,64,28
Panndaz,tichondrius,1803,priest,shadow,30,19,11
Metricdotem,terenas,1803,priest,shadow,42,26,16
Euthanasìa,deathwing,1803,priest,shadow,70,31,39
Korrà,turalyon,1802,priest,shadow,30,19,11
Hástür,quelthalas,1801,priest,shadow,121,67,54
Eclipsë,malganis,1800,priest,shadow,24,19,5
Soyul,tichondrius,1795,priest,shadow,72,41,31
Stresscube,tichondrius,1794,priest,shadow,34,20,14
Axelrod,tichondrius,1792,priest,shadow,48,29,19
Ðemi,zuljin,1792,priest,shadow,60,36,24
Brokenspc,tichondrius,1791,priest,shadow,94,53,41
Girthed,bloodscalp,1785,priest,shadow,68,40,28
Desaros,tichondrius,1782,priest,shadow,72,41,31
Estéve,wyrmrest-accord,1781,priest,shadow,95,47,48
Alisasa,tichondrius,1780,priest,shadow,42,24,18
Jydge,tichondrius,1780,priest,shadow,39,22,17
Ericzssp,tichondrius,1779,priest,shadow,45,25,20
Evenly,tichondrius,1777,priest,shadow,108,58,50
Jojotwo,illidan,1777,priest,shadow,60,30,30
Palmerin,ravencrest,1775,priest,shadow,81,45,36
Snookp,kiljaeden,1774,priest,shadow,166,86,80
Shadowforsho,sargeras,1771,priest,shadow,64,30,34
Zlowbly,ragnaros,1762,priest,shadow,89,46,43
Sleepynuj,stormrage,1757,priest,shadow,66,41,25
Inflate,frostmourne,1757,priest,shadow,78,42,36
Ussmissouri,area-52,1755,priest,shadow,134,72,62
Orgasmiq,frostmourne,1755,priest,shadow,84,45,39
Lauretânia,nemesis,1754,priest,shadow,66,35,31
Afromon,suramar,1750,priest,shadow,72,45,27
Mepisth,sargeras,1748,priest,shadow,72,46,26
What,drakthul,1745,priest,shadow,42,26,16
Brickzyhehe,dalaran,1745,priest,shadow,95,47,48
Impérial,stormrage,1744,priest,shadow,179,107,72
Zhiwanam,tichondrius,1744,priest,shadow,53,31,22
Derisha,ragnaros,1742,priest,shadow,78,43,35
Mindburn,nemesis,1742,priest,shadow,84,38,46
Laokele,tichondrius,1731,priest,shadow,48,29,19
Dildocrates,darkspear,1730,priest,shadow,48,28,20
Aristedes,thrall,1729,priest,shadow,35,20,15
Xmewo,sargeras,1728,priest,shadow,41,25,16
Ðantex,thrall,1728,priest,shadow,254,131,123
Jthreetx,kelthuzad,1722,priest,shadow,34,19,15
Peggable,moon-guard,1718,priest,shadow,42,23,19
Jeseck,quelthalas,1718,priest,shadow,46,23,23
Brokentrojan,moon-guard,1718,priest,shadow,48,23,25
Crbandit,moon-guard,1716,priest,shadow,85,54,31
Disxlyec,barthilas,1711,priest,shadow,112,60,52
Bagjoe,illidan,1711,priest,shadow,117,60,57
Nishishabi,tichondrius,1707,priest,shadow,48,24,24
Priestine,dreadmaul,1706,priest,shadow,150,81,69
Furbog,area-52,1705,priest,shadow,30,20,10
Shwayp,zuljin,1702,priest,shadow,36,22,14
Twoboo,bleeding-hollow,1701,priest,shadow,72,40,32
Voidazepam,zuljin,1700,priest,shadow,84,49,35
Aformoflove,tichondrius,1700,priest,shadow,41,21,20
Krytical,illidan,1699,priest,shadow,123,75,48
Shadowblastx,sargeras,1696,priest,shadow,48,29,19
Cavaliersr,ragnaros,1696,priest,shadow,90,53,37
Milan,dalaran,1694,priest,shadow,63,39,24
Voiders,area-52,1691,priest,shadow,169,99,70
Ticklefingrs,malganis,1689,priest,shadow,42,25,17
Álvarez,tichondrius,1689,priest,shadow,86,43,43
Mindgoblin,terokkar,1689,priest,shadow,36,18,18
Pengwinxl,agamaggan,1683,priest,shadow,36,20,16
Giveheadpats,moon-guard,1683,priest,shadow,216,118,98
Woodney,ragnaros,1676,priest,shadow,30,19,11
Dovoso,kargath,1676,priest,shadow,48,28,20
Darkvagician,malganis,1676,priest,shadow,36,19,17
Cmg,sargeras,1673,priest,shadow,42,22,20
Evx,demon-soul,1673,priest,shadow,96,50,46
Swungzebra,stormrage,1672,priest,shadow,134,81,53
Psyfiend,alterac-mountains,1672,priest,shadow,36,20,16
Missyoung,tichondrius,1671,priest,shadow,42,24,18
Clownface,tichondrius,1671,priest,shadow,42,24,18
Manic,skywall,1671,priest,shadow,144,79,65
Silero,dalaran,1668,priest,shadow,69,47,22
Scarabless,bleeding-hollow,1667,priest,shadow,54,30,24
Felrynpr,malganis,1665,priest,shadow,35,21,14
Esteedees,bonechewer,1665,priest,shadow,60,30,30
Nuggs,mannoroth,1665,priest,shadow,42,21,21
Nvøsuperstar,zuljin,1664,priest,shadow,42,21,21
Soný,stormrage,1663,priest,shadow,46,25,21
Xdipi,proudmoore,1662,priest,shadow,44,25,19
Mushill,tichondrius,1662,priest,shadow,48,26,22
Saintjudys,tichondrius,1661,priest,shadow,30,19,11
Swaggylee,tichondrius,1661,priest,shadow,40,22,18
Zachlol,area-52,1658,priest,shadow,66,36,30
Deadsp,thrall,1657,priest,shadow,115,58,57
Shadowkr,tichondrius,1656,priest,shadow,42,26,16
Uploading,moon-guard,1655,priest,shadow,30,19,11
Pluse,bonechewer,1655,priest,shadow,52,31,21
Insanity,azuremyst,1655,priest,shadow,101,53,48
Moonideli,moon-guard,1654,priest,shadow,30,19,11
Ilovealina,gorefiend,1653,priest,shadow,30,21,9
Littlewench,sargeras,1647,priest,shadow,80,45,35
Kultil,dalaran,1646,priest,shadow,66,39,27
Painful,malganis,1645,priest,shadow,62,36,26
Amarexlol,stormrage,1645,priest,shadow,60,34,26
Sigx,area-52,1643,priest,shadow,30,21,9
Trenbologni,illidan,1637,priest,shadow,156,90,66
Nullreferenc,frostmourne,1637,priest,shadow,75,42,33
Ellindria,spinebreaker,1637,priest,shadow,47,26,21
Partypriest,tichondrius,1637,priest,shadow,66,36,30
Iuka,emerald-dream,1637,priest,shadow,107,56,51
Kovie,twisting-nether,1636,priest,shadow,112,68,44
Murkqz,stormrage,1634,priest,shadow,42,24,18
Dillydackx,sargeras,1634,priest,shadow,108,60,48
Alip,tichondrius,1633,priest,shadow,64,41,23
Cxrsed,illidan,1633,priest,shadow,36,20,16
Slasheal,caelestrasz,1633,priest,shadow,84,43,41
Cixelp,area-52,1631,priest,shadow,42,23,19
Fantasía,moon-guard,1631,priest,shadow,66,28,38
Safe,illidan,1629,priest,shadow,97,51,46
Fireballingg,tichondrius,1625,priest,shadow,30,18,12
Ranthrough,tichondrius,1624,priest,shadow,66,43,23
Snuffp,sargeras,1623,priest,shadow,108,70,38
Shalla,blackrock,1623,priest,shadow,72,37,35
Bobbyvagene,area-52,1622,priest,shadow,36,17,19
Dirtyysanta,tichondrius,1619,priest,shadow,29,18,11
Solstunn,moon-guard,1619,priest,shadow,48,24,24
Ilostmybible,quelthalas,1619,priest,shadow,46,23,23
Iogical,kelthuzad,1618,priest,shadow,116,70,46
Sînkaî,demon-soul,1617,priest,shadow,118,70,48
Skrillô,emerald-dream,1617,priest,shadow,42,20,22
Wenger,crushridge,1616,priest,shadow,120,61,59
Kwõnc,tichondrius,1614,priest,shadow,44,24,20
Djcyrus,barthilas,1614,priest,shadow,36,19,17
Fig,nazgrel,1614,priest,shadow,78,41,37
Holyxb,bleeding-hollow,1613,priest,shadow,54,32,22
Mêdúsa,area-52,1613,priest,shadow,46,24,22
Vallfiresp,malganis,1612,priest,shadow,40,22,18
Shelize,kirin-tor,1611,priest,shadow,163,83,80
Adopted,wyrmrest-accord,1607,priest,shadow,60,34,26
Bandages,stormreaver,1606,priest,shadow,104,57,47
Deuz,quelthalas,1606,priest,shadow,84,37,47
Manofmystery,dalaran,1605,priest,shadow,30,19,11
Shadowdurps,area-52,1604,priest,shadow,66,36,30
Clamchowdy,kiljaeden,1603,priest,shadow,27,18,9
Pumpss,area-52,1603,priest,shadow,49,28,21
Sarâda,moon-guard,1603,priest,shadow,156,82,74
Madcaddies,bonechewer,1603,priest,shadow,42,19,23
Shadork,area-52,1602,priest,shadow,49,31,18
Aspéct,aegwynn,1602,priest,shadow,30,17,13
Dispèrsion,darkspear,1601,priest,shadow,46,21,25
Hotphoyou,moon-guard,1600,priest,shadow,60,39,21
Manifestor,illidan,1600,priest,shadow,86,51,35
Machinecoach,stormrage,1600,priest,shadow,40,20,20
Vyabl,thrall,1599,priest,shadow,42,24,18
Gusho,frostmourne,1599,priest,shadow,175,88,87
Scalpell,tichondrius,1598,priest,shadow,154,80,74
Wifegrip,tichondrius,1598,priest,shadow,42,19,23
Nexumbra,dunemaul,1597,priest,shadow,66,37,29
Radicional,azralon,1596,priest,shadow,36,20,16
Minamy,tichondrius,1593,priest,shadow,30,17,13
Pestee,quelthalas,1592,priest,shadow,140,81,59
Graviton,tichondrius,1591,priest,shadow,54,31,23
Greyyan,wyrmrest-accord,1589,priest,shadow,178,102,76
Fâêlyn,wyrmrest-accord,1589,priest,shadow,52,24,28
Dahliá,frostmourne,1587,priest,shadow,60,33,27
Aethestan,zuljin,1587,priest,shadow,65,30,35
Ventusp,azralon,1586,priest,shadow,35,21,14
Occult,bloodscalp,1584,priest,shadow,93,45,48
Vaala,jubeithos,1580,priest,shadow,60,30,30
Ajazz,zuljin,1578,priest,shadow,36,22,14
Milkgrabber,bleeding-hollow,1578,priest,shadow,103,57,46
Voidshift,tichondrius,1578,priest,shadow,277,142,135
Brothercarl,stormrage,1576,priest,shadow,48,24,24
Çummiñs,malganis,1575,priest,shadow,36,21,15
Nøfaith,area-52,1574,priest,shadow,106,48,58
Heàvenly,moon-guard,1573,priest,shadow,36,21,15
Shmage,malganis,1573,priest,shadow,48,24,24
Raptorjésus,azjolnerub,1573,priest,shadow,36,18,18
Griddly,alterac-mountains,1568,priest,shadow,36,21,15
Marantbourge,frostmourne,1566,priest,shadow,75,45,30
Sorrentin,ragnaros,1566,priest,shadow,58,31,27
Crazyherb,azralon,1565,priest,shadow,83,47,36
Vashrapani,stormrage,1563,priest,shadow,237,120,117
Nevermôre,area-52,1562,priest,shadow,42,27,15
Ethandryl,kelthuzad,1558,priest,shadow,39,23,16
Alex,boulderfist,1557,priest,shadow,54,31,23
Sìnz,area-52,1555,priest,shadow,36,26,10
Nightcráwler,illidan,1553,priest,shadow,42,25,17
Seedisc,kelthuzad,1552,priest,shadow,36,23,13
Krazé,tichondrius,1552,priest,shadow,78,39,39
Softs,area-52,1549,priest,shadow,83,42,41
Cyanovoid,thrall,1549,priest,shadow,36,18,18
Nonamegame,sargeras,1548,priest,shadow,30,18,12
Khelleya,moon-guard,1543,priest,shadow,48,26,22
Ezrashade,tichondrius,1541,priest,shadow,71,36,35
Ratleen,malganis,1541,priest,shadow,194,93,101
Stepho,dalaran,1539,priest,shadow,42,19,23
Lilithice,moon-guard,1537,priest,shadow,48,25,23
Faeinia,elune,1534,priest,shadow,105,61,44
Ikillfast,tichondrius,1533,priest,shadow,54,32,22
Imabeast,stormrage,1532,priest,shadow,52,26,26
Dotdotwin,illidan,1531,priest,shadow,71,43,28
Mealmassttr,frostmourne,1531,priest,shadow,36,18,18
Vtplz,bleeding-hollow,1530,priest,shadow,29,17,12
Drossv,shadowmoon,1528,priest,shadow,36,16,20
Stankychimpo,malganis,1526,priest,shadow,30,16,14
Sochron,stormrage,1526,priest,shadow,62,28,34
Purpskurp,stormrage,1525,priest,shadow,42,20,22
Suery,hyjal,1525,priest,shadow,65,27,38
Aqurielen,turalyon,1522,priest,shadow,35,23,12
Whitehandpr,tichondrius,1522,priest,shadow,242,121,121
Márceline,stormrage,1520,priest,shadow,64,40,24
Rhoku,nesingwary,1519,priest,shadow,36,21,15
Elogant,frostmourne,1516,priest,shadow,48,20,28
Keepitlegal,sargeras,1515,priest,shadow,30,16,14
Vynlanesh,illidan,1515,priest,shadow,78,37,41
Delbringer,moon-guard,1513,priest,shadow,31,19,12
Tënëbrë,nemesis,1508,priest,shadow,30,20,10
Bigboyadam,frostmourne,1508,priest,shadow,64,42,22
Juicymist,moon-guard,1508,priest,shadow,148,86,62
Lowkii,malfurion,1505,priest,shadow,63,41,22
Wobbleskank,tichondrius,1505,priest,shadow,78,47,31
Iuvrainee,area-52,1503,priest,shadow,78,40,38
Benjamints,thrall,1502,priest,shadow,54,32,22
Frankeebutt,stormrage,1501,priest,shadow,36,22,14
Justfaith,barthilas,1501,priest,shadow,61,29,32
Swp,sargeras,1499,priest,shadow,36,24,12
Carniosso,azralon,1498,priest,shadow,116,58,58
Moralism,moon-guard,1495,priest,shadow,199,109,90
Flickmybick,sargeras,1495,priest,shadow,63,32,31
Dischaffy,shadowmoon,1491,priest,shadow,42,29,13
Azheel,stormrage,1490,priest,shadow,65,26,39
Toddmund,tichondrius,1489,priest,shadow,56,27,29
Teeprie,drakthul,1488,priest,shadow,36,24,12
Beckðn,tichondrius,1488,priest,shadow,82,43,39
Fïo,proudmoore,1488,priest,shadow,66,32,34
Chenny,darkspear,1486,priest,shadow,62,36,26
Azagthøth,ravenholdt,1478,priest,shadow,239,122,117
Lucael,durotan,1476,priest,shadow,42,23,19
Bornagain,gundrak,1476,priest,shadow,35,16,19
Plebcakès,sargeras,1474,priest,shadow,43,23,20
Iminyou,kelthuzad,1472,priest,shadow,36,22,14
Antìdote,tichondrius,1470,priest,shadow,104,57,47
Londy,area-52,1464,priest,shadow,272,136,136
Cuaiminator,ragnaros,1463,priest,shadow,87,47,40
Rhick,azralon,1462,priest,shadow,24,17,7
Daysgone,bleeding-hollow,1462,priest,shadow,94,57,37
Plzdontlos,hyjal,1461,priest,shadow,36,22,14
Boogiê,illidan,1460,priest,shadow,36,21,15
Xannis,thrall,1460,priest,shadow,42,23,19
Xæl,tichondrius,1457,priest,shadow,58,35,23
Fritzi,shattered-hand,1456,priest,shadow,30,17,13
Numinous,wyrmrest-accord,1456,priest,shadow,68,35,33
Lelyna,stormrage,1454,priest,shadow,36,22,14
Øbara,frostmourne,1454,priest,shadow,52,29,23
Csheweishan,aerie-peak,1454,priest,shadow,42,20,22
Thelordx,barthilas,1450,priest,shadow,48,23,25
Spoõks,darkspear,1449,priest,shadow,50,21,29
Methandrial,hyjal,1447,priest,shadow,85,42,43
Kadralin,illidan,1445,priest,shadow,54,27,27
Sezyks,malganis,1444,priest,shadow,30,23,7
Astoshan,moon-guard,1444,priest,shadow,101,60,41
Kokai,area-52,1440,priest,shadow,18,15,3
Wdnmmd,proudmoore,1440,priest,shadow,85,40,45
Nozp,stormrage,1439,priest,shadow,30,15,15
Secrèt,tichondrius,1438,priest,shadow,24,15,9
Teddipriest,tichondrius,1438,priest,shadow,24,15,9
Inmotion,tichondrius,1437,priest,shadow,24,15,9
ßarracuda,illidan,1436,priest,shadow,48,32,16
Rida,zuljin,1436,priest,shadow,38,24,14
Drmuhammad,sargeras,1436,priest,shadow,24,15,9
Onegil,tichondrius,1436,priest,shadow,75,38,37
Gershwinner,daggerspine,1436,priest,shadow,30,15,15
Covidchamp,proudmoore,1431,priest,shadow,24,15,9
Ciem,tichondrius,1431,priest,shadow,24,15,9
ßroßraßroski,sargeras,1431,priest,shadow,36,22,14
Sheiizy,azralon,1430,priest,shadow,24,15,9
Pepps,proudmoore,1427,priest,shadow,274,139,135
Aguitardient,ragnaros,1426,priest,shadow,33,19,14
Stusy,tichondrius,1425,priest,shadow,71,44,27
Invincible,ragnaros,1422,priest,shadow,30,15,15
Pastortee,sargeras,1420,priest,shadow,48,27,21
Finfangfoom,laughing-skull,1419,priest,shadow,36,15,21
Bigmollet,tichondrius,1418,priest,shadow,77,32,45
Lilmix,hydraxis,1417,priest,shadow,41,26,15
Bûdussy,bonechewer,1417,priest,shadow,31,17,14
Imhðtep,ragnaros,1415,priest,shadow,42,21,21
Kilal,sargeras,1414,priest,shadow,30,20,10
Strokkerx,azralon,1413,priest,shadow,89,48,41
Sandelios,aggramar,1408,priest,shadow,42,28,14
Voidscrypt,thrall,1406,priest,shadow,100,60,40
Chewthefat,darkspear,1406,priest,shadow,29,15,14
Deeaann,tichondrius,1405,priest,shadow,179,91,88
Whorticiå,area-52,1403,priest,shadow,89,38,51
Bastét,skullcrusher,1402,priest,shadow,108,60,48
Shirubamoya,gurubashi,1401,priest,shadow,41,23,18
Frorgnence,stormrage,1400,priest,shadow,30,22,8
Mindboink,malganis,1399,priest,shadow,76,41,35
Wowgreatgame,tichondrius,1399,priest,shadow,53,27,26
Brothofnzoth,emerald-dream,1398,priest,shadow,38,16,22
Malikeht,drakkari,1394,priest,shadow,48,25,23
Suicider,emerald-dream,1394,priest,shadow,123,56,67
Luvkak,tichondrius,1391,priest,shadow,29,15,14
Dipírex,azralon,1389,priest,shadow,84,40,44
Shadyvoodoo,barthilas,1388,priest,shadow,74,41,33
Ashtahius,ragnaros,1386,priest,shadow,95,56,39
Fäÿë,tichondrius,1386,priest,shadow,54,26,28
Kuazi,khazgoroth,1386,priest,shadow,116,54,62
Muurielle,quelthalas,1385,priest,shadow,60,31,29
Bloodify,azralon,1385,priest,shadow,53,26,27
Showakoi,ragnaros,1384,priest,shadow,48,25,23
Nüt,malganis,1381,priest,shadow,41,21,20
Jeanbi,ragnaros,1380,priest,shadow,120,67,53
Healztonic,dalaran,1380,priest,shadow,72,32,40
Wongÿ,tichondrius,1377,priest,shadow,24,20,4
Lawgiva,thrall,1377,priest,shadow,30,19,11
Miniimenx,azralon,1375,priest,shadow,41,29,12
Akuvurá,nemesis,1373,priest,shadow,29,19,10
Sekhen,area-52,1370,priest,shadow,33,18,15
Urspareparts,sargeras,1370,priest,shadow,89,48,41
Spõõky,illidan,1368,priest,shadow,26,15,11
Tyisanity,tichondrius,1368,priest,shadow,68,32,36
Samsypriest,frostmourne,1367,priest,shadow,28,17,11
Abientot,tichondrius,1366,priest,shadow,48,23,25
Saphet,draktharon,1365,priest,shadow,88,55,33
Danoc,tichondrius,1360,priest,shadow,29,15,14
Habann,frostmourne,1360,priest,shadow,131,65,66
Bugsbright,tichondrius,1351,priest,shadow,75,36,39
Dawnkìn,bleeding-hollow,1348,priest,shadow,108,54,54
Poague,area-52,1343,priest,shadow,24,14,10
Chazzwizz,area-52,1343,priest,shadow,30,14,16
Flay,dragonmaw,1342,priest,shadow,18,14,4
Palumorp,deathwing,1342,priest,shadow,18,14,4
Thaumaturgy,chogall,1342,priest,shadow,24,14,10
Cixelp,tichondrius,1342,priest,shadow,30,14,16
Verbeka,nemesis,1338,priest,shadow,18,14,4
Haø,stormrage,1337,priest,shadow,29,15,14
Bibleblak,stormrage,1337,priest,shadow,30,14,16
Cheez,tichondrius,1336,priest,shadow,58,25,33
Tidals,sargeras,1335,priest,shadow,24,14,10
Scriptö,fizzcrank,1334,priest,shadow,66,44,22
Hüde,stormrage,1334,priest,shadow,102,53,49
Shadelink,tichondrius,1333,priest,shadow,30,14,16
Boogle,frostmourne,1333,priest,shadow,59,26,33
Leach,darkspear,1332,priest,shadow,53,21,32
Dreaminz,tichondrius,1331,priest,shadow,24,14,10
Lirien,kelthuzad,1328,priest,shadow,42,15,27
Aedaki,garona,1326,priest,shadow,88,49,39
Pfl,sargeras,1321,priest,shadow,63,33,30
Maynard,ragnaros,1321,priest,shadow,60,30,30
Rammstèin,sargeras,1314,priest,shadow,30,14,16
Timreaper,barthilas,1311,priest,shadow,35,21,14
Alisaie,dalvengyr,1308,priest,shadow,52,27,25
Locjawbe,area-52,1307,priest,shadow,35,18,17
Shén,barthilas,1306,priest,shadow,83,53,30
Synkiz,darkspear,1306,priest,shadow,24,14,10
Uncletouches,thrall,1303,priest,shadow,30,14,16
Alvorr,ragnaros,1302,priest,shadow,36,20,16
Xionys,sargeras,1296,priest,shadow,30,14,16
Mamofwar,arthas,1296,priest,shadow,66,29,37
Healingstats,tichondrius,1295,priest,shadow,23,14,9
Onipapae,frostmourne,1295,priest,shadow,70,36,34
Øvøxø,emerald-dream,1295,priest,shadow,33,15,18
Beautifulgir,illidan,1294,priest,shadow,24,15,9
Xaneo,kelthuzad,1290,priest,shadow,23,14,9
Ancene,illidan,1290,priest,shadow,42,24,18
Àx,draka,1290,priest,shadow,32,18,14
Nóin,tichondrius,1289,priest,shadow,65,27,38
Chádeervas,nemesis,1285,priest,shadow,33,20,13
Dorraheals,tichondrius,1275,priest,shadow,29,15,14
Pandarue,tichondrius,1273,priest,shadow,33,16,17
Reos,jubeithos,1267,priest,shadow,42,25,17
Layrissa,whisperwind,1266,priest,shadow,24,15,9
Lyriczx,kelthuzad,1265,priest,shadow,42,18,24
Stankylegz,tichondrius,1262,priest,shadow,24,15,9
Festær,area-52,1254,priest,shadow,42,23,19
Synergize,korgath,1254,priest,shadow,60,30,30
Jwx,malganis,1248,priest,shadow,18,13,5
Madcuzyaknow,bleeding-hollow,1248,priest,shadow,24,13,11
Mentalprison,khazgoroth,1248,priest,shadow,24,13,11
Avraf,sargeras,1246,priest,shadow,24,13,11
Gelato,velen,1246,priest,shadow,24,13,11
Headbrake,malganis,1246,priest,shadow,24,13,11
Bubblepop,blackhand,1245,priest,shadow,18,13,5
Vanisa,hellscream,1245,priest,shadow,29,16,13
Fanfansp,tichondrius,1244,priest,shadow,18,13,5
Goodlife,frostmourne,1244,priest,shadow,24,13,11
Yayonaise,tichondrius,1244,priest,shadow,24,13,11
Crayon,stormrage,1244,priest,shadow,30,13,17
Sakuraginero,illidan,1243,priest,shadow,24,13,11
Fancycorpse,tichondrius,1243,priest,shadow,30,13,17
Shadowjisha,emerald-dream,1243,priest,shadow,33,14,19
Amentia,area-52,1242,priest,shadow,24,13,11
Ashidox,proudmoore,1242,priest,shadow,27,14,13
Nodoubt,barthilas,1242,priest,shadow,35,13,22
Houzz,frostmourne,1241,priest,shadow,18,13,5
Xedus,mannoroth,1240,priest,shadow,74,37,37
Ascian,daggerspine,1239,priest,shadow,30,13,17
Holydarkness,quelthalas,1239,priest,shadow,42,17,25
Dilly,tichondrius,1238,priest,shadow,21,14,7
Nums,tichondrius,1236,priest,shadow,42,22,20
Amideus,dunemaul,1236,priest,shadow,30,13,17
Vaporachi,emerald-dream,1234,priest,shadow,24,13,11
Shadowyeti,illidan,1233,priest,shadow,18,13,5
Jiedx,tichondrius,1230,priest,shadow,29,14,15
Marni,akama,1227,priest,shadow,86,38,48
Kaermor,stormrage,1227,priest,shadow,66,28,38
Harisleidy,quelthalas,1226,priest,shadow,24,13,11
Simplyfaded,black-dragonflight,1226,priest,shadow,24,13,11
Jeffgordo,tichondrius,1223,priest,shadow,24,13,11
Antoz,kelthuzad,1222,priest,shadow,49,28,21
Vílja,moon-guard,1219,priest,shadow,94,41,53
Sorrowful,mannoroth,1208,priest,shadow,29,13,16
Lilpika,illidan,1205,priest,shadow,30,13,17
Estelars,aggramar,1202,priest,shadow,35,18,17
Discpi,illidan,1202,priest,shadow,78,34,44
Senumbra,tichondrius,1200,priest,shadow,36,16,20
Sècret,tichondrius,1199,priest,shadow,23,13,10
Zyræl,stormrage,1199,priest,shadow,85,35,50
Niias,hyjal,1192,priest,shadow,24,13,11
Chinchillin,demon-soul,1187,priest,shadow,90,48,42
Pristoleiro,azralon,1182,priest,shadow,17,13,4
Shadøwheal,stormrage,1180,priest,shadow,18,13,5
Darksheals,barthilas,1176,priest,shadow,30,22,8
Foli,zuljin,1166,priest,shadow,20,13,7
Aflstan,frostmourne,1159,priest,shadow,51,30,21
Trollypriest,darkspear,1157,priest,shadow,94,44,50
Halselin,senjin,1156,priest,shadow,31,16,15
Snakklè,illidan,1152,priest,shadow,18,13,5
Bubbyflay,area-52,1151,priest,shadow,18,12,6
Cozies,stormreaver,1151,priest,shadow,24,12,12
Cathery,tichondrius,1151,priest,shadow,24,12,12
Achíllesheal,stormrage,1147,priest,shadow,42,16,26
Zolgeta,exodar,1146,priest,shadow,29,18,11
Shadowhazed,tichondrius,1145,priest,shadow,18,12,6
Dayquills,illidan,1145,priest,shadow,24,12,12
Lidole,barthilas,1145,priest,shadow,30,12,18
Agraciada,illidan,1142,priest,shadow,18,12,6
Overcastedxo,kelthuzad,1142,priest,shadow,42,25,17
Tye,medivh,1141,priest,shadow,24,12,12
Anrop,illidan,1140,priest,shadow,18,12,6
Knglizward,stormrage,1140,priest,shadow,59,33,26
Kibariyb,drakkari,1139,priest,shadow,30,12,18
Grianné,mannoroth,1134,priest,shadow,18,12,6
Unholyreáper,magtheridon,1132,priest,shadow,24,12,12
Abolita,korgath,1113,priest,shadow,66,32,34
Urmorphine,area-52,1112,priest,shadow,170,89,81
Võid,tichondrius,1103,priest,shadow,23,12,11
Wetleaftx,chogall,1097,priest,shadow,18,13,5
Demples,darkspear,1095,priest,shadow,18,12,6
Dockani,sargeras,1091,priest,shadow,24,12,12
Himikko,illidan,1087,priest,shadow,28,12,16
Scormm,runetotem,1073,priest,shadow,24,13,11
Manofmystery,drenden,1071,priest,shadow,17,12,5
Shinyspriest,tichondrius,1068,priest,shadow,42,16,26
Freebolte,frostmourne,1056,priest,shadow,12,11,1
Nawzyh,emerald-dream,1056,priest,shadow,18,11,7
Royx,stormreaver,1056,priest,shadow,24,11,13
Patagoniabae,kelthuzad,1055,priest,shadow,12,11,1
Destta,stormrage,1055,priest,shadow,16,12,4
Nobutter,archimonde,1055,priest,shadow,18,11,7
Pwrwordsquee,lightbringer,1055,priest,shadow,18,11,7
Saevita,area-52,1055,priest,shadow,18,11,7
Iceveins,illidan,1055,priest,shadow,18,11,7
Heihunüwang,kargath,1055,priest,shadow,18,11,7
Eskettit,korgath,1054,priest,shadow,12,11,1
Sleezi,emerald-dream,1054,priest,shadow,18,11,7
Fouroneo,tichondrius,1054,priest,shadow,18,11,7
Büd,sargeras,1054,priest,shadow,18,11,7
Faedyspriest,sargeras,1052,priest,shadow,18,11,7
Moc,jubeithos,1052,priest,shadow,18,11,7
Bhruno,proudmoore,1052,priest,shadow,18,11,7
Darkshadows,ravenholdt,1052,priest,shadow,18,11,7
Tsmc,moon-guard,1052,priest,shadow,24,11,13
Shadowbee,kargath,1051,priest,shadow,18,11,7
Féarlust,demon-soul,1051,priest,shadow,18,11,7
Badnfluence,kiljaeden,1046,priest,shadow,18,11,7
Bestwizardx,tichondrius,1046,priest,shadow,18,11,7
Coors,lightnings-blade,1046,priest,shadow,24,11,13
Nocturnalx,moon-guard,1045,priest,shadow,18,11,7
Xammys,malganis,1043,priest,shadow,18,11,7
Hephiron,area-52,1042,priest,shadow,30,11,19
Emlix,tichondrius,1042,priest,shadow,30,11,19
Galice,archimonde,1038,priest,shadow,48,23,25
Kàiju,zuljin,1027,priest,shadow,30,11,19
Vinasky,moon-guard,1022,priest,shadow,26,12,14
Task,korgath,1010,priest,shadow,29,11,18
Oglilptown,thunderlord,1005,priest,shadow,60,33,27
Ipse,azshara,1002,priest,shadow,66,36,30
Deadcode,frostmane,1000,priest,shadow,33,12,21
Sinkz,ragnaros,992,priest,shadow,16,11,5
Pocket,alleria,991,priest,shadow,22,11,11
Healtheze,kelthuzad,989,priest,shadow,14,11,3
Jhivagosp,tichondrius,988,priest,shadow,22,11,11
Daemoon,deathwing,973,priest,shadow,20,12,8
Discountay,burning-legion,965,priest,shadow,20,11,9
Illushadio,area-52,963,priest,shadow,15,12,3
Claudiosip,tichondrius,960,priest,shadow,12,10,2
Mmrassassin,stormrage,960,priest,shadow,12,10,2
Anoumenon,tichondrius,960,priest,shadow,18,10,8
Pèrona,tichondrius,960,priest,shadow,18,10,8
Kissmyvoìd,frostmourne,960,priest,shadow,18,10,8
Whysoserious,duskwood,960,priest,shadow,18,10,8
Evilgeniusx,area-52,960,priest,shadow,18,10,8
Míslead,kelthuzad,959,priest,shadow,12,10,2
Dxsc,tichondrius,959,priest,shadow,12,10,2
Inflìctìøn,frostmourne,959,priest,shadow,12,10,2
Synergia,drakkari,959,priest,shadow,12,10,2
Chillypriest,azjolnerub,959,priest,shadow,18,10,8
Xtradotz,tichondrius,959,priest,shadow,18,10,8
Philmacrakn,stormrage,959,priest,shadow,18,10,8
Mimósa,quelthalas,959,priest,shadow,18,10,8
Delai,dalaran,959,priest,shadow,18,10,8
Keepsleepin,stormrage,959,priest,shadow,24,10,14
Terý,dalaran,959,priest,shadow,24,10,14
Ightdoe,zuljin,958,priest,shadow,12,10,2
Eraseme,bleeding-hollow,958,priest,shadow,18,10,8
Shadeven,nagrand,958,priest,shadow,18,10,8
Fathersmits,area-52,958,priest,shadow,18,10,8
Volkova,quelthalas,958,priest,shadow,18,10,8
Tatzis,frostmourne,958,priest,shadow,18,10,8
Porffy,malygos,958,priest,shadow,18,10,8
Exigyo,quelthalas,957,priest,shadow,23,13,10
Voidork,tichondrius,957,priest,shadow,18,10,8
Rizzle,emerald-dream,956,priest,shadow,18,10,8
Mortivore,azralon,956,priest,shadow,24,10,14
Gankdalf,draktharon,955,priest,shadow,18,10,8
Aeonar,alleria,954,priest,shadow,18,10,8
Ragnálodbrok,ragnaros,953,priest,shadow,18,10,8
Xora,frostmourne,952,priest,shadow,18,10,8
Etan,thrall,952,priest,shadow,18,10,8
Hurtfeet,sargeras,951,priest,shadow,32,12,20
Farnkxd,bleeding-hollow,925,priest,shadow,32,11,21
Thrageqt,sargeras,908,priest,shadow,20,11,9
Silmeriá,darkspear,904,priest,shadow,29,11,18
Theodorous,frostmourne,903,priest,shadow,22,11,11
Exen,moon-guard,894,priest,shadow,18,11,7
Fullfear,lothar,894,priest,shadow,20,10,10
Yoggsarodney,tichondrius,880,priest,shadow,13,10,3
Vamp,proudmoore,878,priest,shadow,17,10,7
Csonka,stormrage,868,priest,shadow,38,13,25
Taxzury,tichondrius,864,priest,shadow,12,9,3
Feverx,tichondrius,864,priest,shadow,12,9,3
Æë,area-52,864,priest,shadow,12,9,3
Wololo,emerald-dream,864,priest,shadow,18,9,9
Bumps,zuljin,864,priest,shadow,18,9,9
Swurvexo,bleeding-hollow,864,priest,shadow,24,9,15
Beloriath,ragnaros,863,priest,shadow,12,9,3
Ðecease,thrall,863,priest,shadow,18,9,9
Delrey,sargeras,863,priest,shadow,18,9,9
Woosanghong,tichondrius,863,priest,shadow,18,9,9
Xtcbtc,sargeras,863,priest,shadow,18,9,9
Efxsp,sargeras,863,priest,shadow,24,9,15
Shadhoee,sargeras,863,priest,shadow,30,9,21
Pozcas,blood-furnace,862,priest,shadow,12,9,3
Everblack,executus,862,priest,shadow,12,9,3
Suirr,tichondrius,862,priest,shadow,12,9,3
Arzeuz,ragnaros,862,priest,shadow,18,9,9
Dóctóre,thrall,862,priest,shadow,18,9,9
Constentien,tichondrius,862,priest,shadow,18,9,9
Touchypriest,jaedenar,862,priest,shadow,18,9,9
Shadowflux,thunderlord,862,priest,shadow,30,9,21
Nekkz,sargeras,861,priest,shadow,12,9,3
Grimdox,tichondrius,861,priest,shadow,12,9,3
Healixd,area-52,861,priest,shadow,24,9,15
Melas,stormrage,861,priest,shadow,24,9,15
Viejiyoh,ragnaros,860,priest,shadow,18,9,9
Wankenobi,stormrage,859,priest,shadow,18,9,9
Methodist,sargeras,859,priest,shadow,24,9,15
Aeingel,amanthul,859,priest,shadow,30,9,21
Sacerthu,goldrinn,858,priest,shadow,18,9,9
Ed,crushridge,858,priest,shadow,18,9,9
Beansontoast,wyrmrest-accord,857,priest,shadow,12,9,3
Zaxine,moon-guard,854,priest,shadow,30,9,21
Hibot,illidan,849,priest,shadow,24,9,15
Lightbanter,emerald-dream,846,priest,shadow,24,9,15
Kagamì,frostmane,843,priest,shadow,31,9,22
Pipiwiwi,tichondrius,831,priest,shadow,16,9,7
Cymin,dalaran,816,priest,shadow,21,10,11
Jeängrey,tichondrius,815,priest,shadow,15,10,5
Stylonious,hyjal,815,priest,shadow,15,9,6
Buc,barthilas,813,priest,shadow,15,9,6
Dernièreplac,blackrock,810,priest,shadow,15,10,5
Fledgeling,frostmourne,799,priest,shadow,14,9,5
Fedodesubaco,gallywix,782,priest,shadow,21,10,11
Silentólògy,malganis,768,priest,shadow,12,8,4
Mindeas,the-forgotten-coast,768,priest,shadow,12,8,4
Stungods,frostmourne,768,priest,shadow,12,8,4
Mindfulness,tichondrius,768,priest,shadow,12,8,4
Cloribestmom,tichondrius,768,priest,shadow,12,8,4
Madmelter,emerald-dream,768,priest,shadow,12,8,4
Lastbubble,area-52,768,priest,shadow,12,8,4
Oxycodex,thrall,768,priest,shadow,12,8,4
Ruzhi,moon-guard,768,priest,shadow,12,8,4
Nohealerhere,frostmourne,768,priest,shadow,12,8,4
Nutdrip,tichondrius,768,priest,shadow,12,8,4
Skraitbussin,tichondrius,768,priest,shadow,12,8,4
Jugeum,proudmoore,768,priest,shadow,12,8,4
Dazull,bleeding-hollow,768,priest,shadow,12,8,4
Originull,emerald-dream,768,priest,shadow,18,8,10
Ripchadman,tichondrius,768,priest,shadow,18,8,10
Lillyp,malganis,768,priest,shadow,18,8,10
Alucardibee,turalyon,768,priest,shadow,18,8,10
Skepix,lightbringer,768,priest,shadow,18,8,10
Àústîn,moon-guard,768,priest,shadow,18,8,10
Deacoderx,area-52,768,priest,shadow,18,8,10
Zeromisx,proudmoore,768,priest,shadow,18,8,10
Iluvwizkx,malganis,768,priest,shadow,18,8,10
Hairyboxx,frostmourne,767,priest,shadow,12,8,4
Tungus,shadowsong,767,priest,shadow,12,8,4
Easyrevenge,kelthuzad,767,priest,shadow,12,8,4
Ddark,tichondrius,767,priest,shadow,12,8,4
Faithplusone,zuljin,767,priest,shadow,12,8,4
Oldmanlou,spirestone,767,priest,shadow,12,8,4
Rogspriest,sargeras,767,priest,shadow,12,8,4
Shadowlords,emerald-dream,767,priest,shadow,12,8,4
Sgssg,illidan,767,priest,shadow,12,8,4
Badxjuju,frostmourne,767,priest,shadow,18,8,10
Smitepie,malganis,767,priest,shadow,18,8,10
Irangara,gorefiend,767,priest,shadow,18,8,10
Priestzerath,azralon,767,priest,shadow,18,8,10
Powerwordcry,stormrage,767,priest,shadow,18,8,10
Twistedtéa,garrosh,767,priest,shadow,18,8,10
Aránhell,ragnaros,766,priest,shadow,12,8,4
Sãoleozinho,azralon,766,priest,shadow,12,8,4
Solrina,khazgoroth,766,priest,shadow,12,8,4
Krypts,shadow-council,766,priest,shadow,12,8,4
Jinzan,stormrage,766,priest,shadow,18,8,10
Rigotakx,illidan,766,priest,shadow,18,8,10
Maricotä,azralon,765,priest,shadow,12,8,4
Bmô,stormrage,765,priest,shadow,18,8,10
Kumojorno,gilneas,765,priest,shadow,18,8,10
Allsmite,aerie-peak,765,priest,shadow,24,8,16
Puerquirri,quelthalas,763,priest,shadow,18,8,10
Likeleela,azshara,763,priest,shadow,24,8,16
Drkwispers,stormrage,762,priest,shadow,18,8,10
Castnngcouch,tichondrius,762,priest,shadow,18,8,10
Sôuljah,skywall,760,priest,shadow,26,10,16
Eslaughter,twisting-nether,759,priest,shadow,12,8,4
Tinypuppyy,sargeras,759,priest,shadow,24,8,16
Battlepope,the-scryers,755,priest,shadow,20,9,11
Memoria,emerald-dream,751,priest,shadow,15,9,6
Heheheg,tichondrius,751,priest,shadow,23,8,15
Maldicius,emerald-dream,735,priest,shadow,17,8,9
Misslost,nerzhul,729,priest,shadow,17,8,9
Strazloraz,baelgun,719,priest,shadow,11,8,3
Meegoshy,azuremyst,718,priest,shadow,17,8,9
Mikó,dawnbringer,714,priest,shadow,29,10,19
Sempiternus,barthilas,713,priest,shadow,20,9,11
Pnub,aggramar,703,priest,shadow,17,9,8
Yrrep,kelthuzad,703,priest,shadow,16,8,8
Mòrbídìtý,area-52,672,priest,shadow,12,7,5
Lontra,zangarmarsh,672,priest,shadow,12,7,5
Bestpimp,frostmane,672,priest,shadow,12,7,5
Chicoryx,illidan,672,priest,shadow,12,7,5
Jojoxxz,illidan,672,priest,shadow,12,7,5
Hårper,area-52,672,priest,shadow,12,7,5
Pikeysplol,illidan,672,priest,shadow,12,7,5
Såx,stormreaver,672,priest,shadow,12,7,5
Kwiksi,arthas,672,priest,shadow,12,7,5
Moonlightx,destromath,672,priest,shadow,12,7,5
Diddlur,black-dragonflight,672,priest,shadow,12,7,5
Wodturbo,bleeding-hollow,672,priest,shadow,12,7,5
Bucksp,zuljin,672,priest,shadow,12,7,5
Ayooblitz,guldan,672,priest,shadow,12,7,5
Xiphoidz,frostmourne,672,priest,shadow,12,7,5
Jah,frostmourne,672,priest,shadow,12,7,5
Folesian,tichondrius,672,priest,shadow,12,7,5
Aeøns,sargeras,672,priest,shadow,12,7,5
Bugweeb,sargeras,672,priest,shadow,12,7,5
Blackaries,frostmourne,672,priest,shadow,12,7,5
Duhpriest,frostmourne,672,priest,shadow,12,7,5
Grëýmåttèr,moon-guard,672,priest,shadow,12,7,5
Twítch,bonechewer,672,priest,shadow,12,7,5
Didy,dark-iron,672,priest,shadow,12,7,5
Badbwoi,frostmourne,672,priest,shadow,12,7,5
Zuuji,frostmourne,672,priest,shadow,12,7,5
Phéonìx,zuljin,672,priest,shadow,12,7,5
Nightelffeet,stormrage,672,priest,shadow,12,7,5
Fatzoid,the-forgotten-coast,672,priest,shadow,12,7,5
Gles,quelthalas,672,priest,shadow,13,7,6
Evelën,azralon,672,priest,shadow,18,7,11
Nightious,malganis,672,priest,shadow,18,7,11
Acpriest,tichondrius,672,priest,shadow,18,7,11
Tanzen,andorhal,672,priest,shadow,18,7,11
Veressà,quelthalas,672,priest,shadow,22,8,14
Chês,tichondrius,672,priest,shadow,24,7,17
Lilmermaid,laughing-skull,671,priest,shadow,12,7,5
Moonpenance,windrunner,671,priest,shadow,12,7,5
Ghedeloco,tichondrius,671,priest,shadow,12,7,5
Nastyyshadow,aegwynn,671,priest,shadow,12,7,5
Clayphace,darkspear,671,priest,shadow,12,7,5
Preyforme,tichondrius,671,priest,shadow,12,7,5
Voltstein,dalaran,671,priest,shadow,12,7,5
Darkrics,barthilas,671,priest,shadow,12,7,5
Pottime,tichondrius,671,priest,shadow,18,7,11
Nachòs,wildhammer,671,priest,shadow,18,7,11
Torangi,tichondrius,671,priest,shadow,18,7,11
Havefaith,whisperwind,671,priest,shadow,18,7,11
Deffaultz,turalyon,671,priest,shadow,18,7,11
Anathamaz,stormrage,671,priest,shadow,18,7,11
Ramaven,arygos,671,priest,shadow,18,7,11
Shadowtreta,azralon,670,priest,shadow,12,7,5
Bobbeans,area-52,670,priest,shadow,12,7,5
Tonybromoo,kelthuzad,670,priest,shadow,12,7,5
Nerfdisc,azralon,670,priest,shadow,12,7,5
Montcrief,tichondrius,670,priest,shadow,12,7,5
Littlebagel,nesingwary,670,priest,shadow,12,7,5
Iseeyoulookn,stormrage,670,priest,shadow,16,8,8
Lyxorr,area-52,670,priest,shadow,18,7,11
Shadzie,sargeras,670,priest,shadow,18,7,11
Gabryanna,emerald-dream,669,priest,shadow,24,7,17
Lõkî,malganis,667,priest,shadow,12,7,5
Bellalugosi,auchindoun,667,priest,shadow,12,7,5
Crashed,frostmourne,654,priest,shadow,17,7,10
Popejack,stormrage,654,priest,shadow,17,7,10
Nizeurflayzz,tichondrius,648,priest,shadow,20,10,10
Lucifena,darkspear,639,priest,shadow,11,7,4
Metaila,aerie-peak,639,priest,shadow,11,7,4
Goodvybz,illidan,639,priest,shadow,17,7,10
Emmitson,scarlet-crusade,638,priest,shadow,28,7,21
Chiliy,frostmourne,623,priest,shadow,11,7,4
Propumper,dalaran,607,priest,shadow,11,7,4
Valloren,kalecgos,606,priest,shadow,14,7,7
Flowerpetals,emerald-dream,599,priest,shadow,21,7,14
Pootzy,malganis,592,priest,shadow,13,7,6
Mastahmind,illidan,591,priest,shadow,13,7,6
Ìforted,zuljin,587,priest,shadow,19,7,12
Sydgames,area-52,576,priest,shadow,6,6,0
Caricius,ravenholdt,576,priest,shadow,6,6,0
Henrywhopper,fizzcrank,576,priest,shadow,6,6,0
Blindingstar,area-52,576,priest,shadow,6,6,0
Moonwald,moon-guard,576,priest,shadow,6,6,0
Innovate,dragonmaw,576,priest,shadow,6,6,0
Deckx,khazgoroth,576,priest,shadow,10,7,3
Yungjim,the-forgotten-coast,576,priest,shadow,12,6,6
Evansong,frostmane,576,priest,shadow,12,6,6
Tiernocookie,illidan,576,priest,shadow,12,6,6
Slimfo,sargeras,576,priest,shadow,12,6,6
Studiosxz,tichondrius,576,priest,shadow,12,6,6
Imshadow,azralon,576,priest,shadow,12,6,6
Fxxkdamn,tichondrius,576,priest,shadow,12,6,6
Sped,saurfang,576,priest,shadow,12,6,6
Mydixi,stormrage,576,priest,shadow,12,6,6
Ôverweight,sargeras,576,priest,shadow,12,6,6
Bipölar,area-52,576,priest,shadow,12,6,6
Bearuwu,frostmourne,576,priest,shadow,12,6,6
Verbane,frostmourne,576,priest,shadow,12,6,6
Jeremyissped,proudmoore,576,priest,shadow,12,6,6
Spookyman,malganis,576,priest,shadow,12,6,6
Mks,barthilas,576,priest,shadow,12,6,6
Rachelstarrx,hyjal,576,priest,shadow,12,6,6
Voidgodtko,tichondrius,576,priest,shadow,12,6,6
Voidhearted,tichondrius,576,priest,shadow,12,6,6
Valerift,moon-guard,576,priest,shadow,12,6,6
Spriestbro,emerald-dream,576,priest,shadow,12,6,6
Fitchbucker,sargeras,576,priest,shadow,12,6,6
Lostnlight,aggramar,576,priest,shadow,12,6,6
Pønt,sargeras,576,priest,shadow,12,6,6
Kessavannell,frostwolf,576,priest,shadow,12,6,6
Küno,kelthuzad,576,priest,shadow,12,6,6
Virsyti,area-52,576,priest,shadow,12,6,6
Qadris,tichondrius,576,priest,shadow,12,6,6
Drognar,lightbringer,576,priest,shadow,12,6,6
Heàl,akama,576,priest,shadow,12,6,6
Disembly,illidan,576,priest,shadow,12,6,6
Soulrulerx,tichondrius,576,priest,shadow,18,6,12
Caeda,icecrown,576,priest,shadow,18,6,12
Mscleo,lothar,576,priest,shadow,18,6,12
Osmatspriest,firetree,576,priest,shadow,18,6,12
Mindgamez,stormreaver,576,priest,shadow,18,6,12
Jexso,tichondrius,576,priest,shadow,19,6,13
Cykle,blackrock,576,priest,shadow,24,6,18
Xð,jubeithos,575,priest,shadow,12,6,6
Vashyy,stormrage,575,priest,shadow,12,6,6
Grympriest,wyrmrest-accord,575,priest,shadow,12,6,6
Drsonny,proudmoore,575,priest,shadow,12,6,6
Xinthra,stormrage,575,priest,shadow,12,6,6
Mìdnìght,ragnaros,575,priest,shadow,12,6,6
Creedence,jubeithos,575,priest,shadow,17,6,11
Nyktøs,quelthalas,575,priest,shadow,18,6,12
Ëlliot,stormrage,574,priest,shadow,12,6,6
Duhk,moon-guard,574,priest,shadow,12,6,6
Jamashud,mannoroth,571,priest,shadow,12,6,6
Raelintha,kelthuzad,571,priest,shadow,15,7,8
Holysheht,icecrown,566,priest,shadow,12,6,6
Rotass,hyjal,559,priest,shadow,11,6,5
Duckdemon,ragnaros,559,priest,shadow,17,6,11
Holydestroyr,dentarg,527,priest,shadow,21,6,15
Kundalini,boulderfist,526,priest,shadow,11,6,5
Totorostarp,tichondrius,521,priest,shadow,22,8,14
Ceoofvoid,moon-guard,511,priest,shadow,8,6,2
By,bonechewer,496,priest,shadow,7,6,1
Drteabaghaam,zuljin,480,priest,shadow,6,5,1
Pri,jubeithos,480,priest,shadow,6,5,1
Likelydapper,tichondrius,480,priest,shadow,6,5,1
Megamind,elune,480,priest,shadow,6,5,1
Ukishizumi,tichondrius,480,priest,shadow,6,5,1
Jâmïè,gurubashi,480,priest,shadow,6,5,1
Chervz,chogall,480,priest,shadow,6,5,1
Diyel,area-52,480,priest,shadow,6,5,1
Yuhstin,sargeras,480,priest,shadow,6,5,1
Talkura,tichondrius,480,priest,shadow,6,5,1
Flynni,bleeding-hollow,480,priest,shadow,6,5,1
Plaguepumper,sargeras,480,priest,shadow,6,5,1
Altera,drakkari,480,priest,shadow,6,5,1
Bradythree,moon-guard,480,priest,shadow,6,5,1
Hypochondria,moon-guard,480,priest,shadow,6,5,1
Fiéstah,illidan,480,priest,shadow,6,5,1
Luokni,illidan,480,priest,shadow,6,5,1
Tensorflow,tichondrius,480,priest,shadow,6,5,1
Jezebëll,nemesis,480,priest,shadow,6,5,1
Lillyspr,malganis,480,priest,shadow,6,5,1
Nawtyforever,tichondrius,480,priest,shadow,6,5,1
Ahleven,tichondrius,480,priest,shadow,6,5,1
Hadoka,ragnaros,480,priest,shadow,6,5,1
ßluedreamx,tichondrius,480,priest,shadow,6,5,1
Rattyp,barthilas,480,priest,shadow,6,5,1
Corthien,thrall,480,priest,shadow,6,5,1
Kaidow,wyrmrest-accord,480,priest,shadow,6,5,1
Death,firetree,480,priest,shadow,6,5,1
Seanuts,emerald-dream,480,priest,shadow,6,5,1
Voltétt,tichondrius,480,priest,shadow,6,5,1
Rykispriest,tichondrius,480,priest,shadow,6,5,1
Komy,tichondrius,480,priest,shadow,6,5,1
Nadrii,illidan,480,priest,shadow,16,8,8
Soulistic,arygos,480,priest,shadow,12,5,7
Hriest,tichondrius,480,priest,shadow,12,5,7
Moä,nemesis,480,priest,shadow,12,5,7
Enchantrez,frostmourne,480,priest,shadow,12,5,7
Glek,tichondrius,480,priest,shadow,12,5,7
Orderic,ragnaros,480,priest,shadow,12,5,7
Seraphims,moon-guard,480,priest,shadow,12,5,7
Cryptron,tichondrius,480,priest,shadow,12,5,7
Jenastreaux,wyrmrest-accord,480,priest,shadow,12,5,7
Spriest,kul-tiras,480,priest,shadow,12,5,7
Optimism,frostmane,480,priest,shadow,12,5,7
Mookelina,stormrage,480,priest,shadow,12,5,7
Minnowhead,kelthuzad,480,priest,shadow,12,5,7
Holliebell,zuljin,480,priest,shadow,12,5,7
Aghorï,sargeras,480,priest,shadow,12,5,7
Lucariö,area-52,480,priest,shadow,12,5,7
Goblindruid,bleeding-hollow,480,priest,shadow,12,5,7
Barelylegalx,tichondrius,480,priest,shadow,12,5,7
Sohalexs,tichondrius,480,priest,shadow,12,5,7
Mdt,tichondrius,480,priest,shadow,12,5,7
Sársaukis,illidan,480,priest,shadow,12,5,7
Littledog,velen,480,priest,shadow,12,5,7
Onizukakeiji,hyjal,480,priest,shadow,12,5,7
Xijinping,chogall,480,priest,shadow,12,5,7
Arataxx,area-52,480,priest,shadow,12,5,7
Flukex,tichondrius,480,priest,shadow,12,5,7
Hygeïa,lightbringer,480,priest,shadow,12,5,7
Fatzzbtw,illidan,480,priest,shadow,12,5,7
Helleamh,tichondrius,480,priest,shadow,12,5,7
Pokeyoobutt,hydraxis,480,priest,shadow,12,5,7
Heion,detheroc,480,priest,shadow,12,5,7
Faydes,arthas,480,priest,shadow,13,5,8
Stillmatick,tichondrius,480,priest,shadow,16,6,10
Zerohoür,emerald-dream,480,priest,shadow,16,6,10
Nedajoon,tichondrius,480,priest,shadow,17,6,11
Azrothlol,kul-tiras,480,priest,shadow,18,5,13
Drakracs,doomhammer,480,priest,shadow,18,5,13
Sybal,suramar,480,priest,shadow,19,5,14
Merlynaah,azralon,479,priest,shadow,6,5,1
Roylwcheese,illidan,479,priest,shadow,6,5,1
Phantomz,malganis,479,priest,shadow,12,5,7
Wolfeclipse,sargeras,479,priest,shadow,12,5,7
Amestroada,nemesis,479,priest,shadow,12,5,7
Knoxy,fizzcrank,479,priest,shadow,12,5,7
Drkvagician,tichondrius,479,priest,shadow,12,5,7
Rippmmr,frostmourne,479,priest,shadow,18,5,13
Noodloctopus,area-52,478,priest,shadow,10,6,4
Antiraus,aerie-peak,478,priest,shadow,12,5,7
Valeknun,stormrage,477,priest,shadow,6,5,1
Khaibit,stormrage,475,priest,shadow,12,5,7
Blonkie,azgalor,474,priest,shadow,12,5,7
Wiiuwiiu,malganis,447,priest,shadow,11,5,6
Forober,queldorei,446,priest,shadow,10,6,4
Ryanrealz,tichondrius,432,priest,shadow,9,6,3
Sohalex,tichondrius,431,priest,shadow,11,5,6
Shietamazon,tichondrius,426,priest,shadow,16,6,10
Warklaw,frostmourne,415,priest,shadow,14,5,9
Reignsp,malganis,400,priest,shadow,7,5,2
Ampela,dalaran,400,priest,shadow,13,5,8
Nizr,bleeding-hollow,399,priest,shadow,5,5,0
Vengep,sargeras,384,priest,shadow,6,4,2
Carosene,thrall,384,priest,shadow,6,4,2
Iifa,medivh,384,priest,shadow,6,4,2
Härpocrates,area-52,384,priest,shadow,6,4,2
Mugiwarà,stormrage,384,priest,shadow,6,4,2
Sukes,korgath,384,priest,shadow,6,4,2
Pootang,hyjal,384,priest,shadow,6,4,2
Nås,elune,384,priest,shadow,6,4,2
Shådøw,destromath,384,priest,shadow,6,4,2
Icarryozz,darkspear,384,priest,shadow,6,4,2
Rustinheber,stormscale,384,priest,shadow,6,4,2
Itha,illidan,384,priest,shadow,6,4,2
Shiikari,terenas,384,priest,shadow,6,4,2
Kynyssaelz,proudmoore,384,priest,shadow,6,4,2
Airil,mugthol,384,priest,shadow,6,4,2
Frúdgé,illidan,384,priest,shadow,6,4,2
Shieldspamx,tichondrius,384,priest,shadow,6,4,2
Äni,sargeras,384,priest,shadow,6,4,2
Dzikuss,aegwynn,384,priest,shadow,6,4,2
Ikiteforhash,zuljin,384,priest,shadow,6,4,2
Ðrip,burning-legion,384,priest,shadow,6,4,2
Zeacho,proudmoore,384,priest,shadow,6,4,2
Ayzen,emerald-dream,384,priest,shadow,6,4,2
Bax,kilrogg,384,priest,shadow,6,4,2
Krythe,laughing-skull,384,priest,shadow,6,4,2
Floofball,medivh,384,priest,shadow,6,4,2
Yuricksus,malganis,384,priest,shadow,6,4,2
Spôoky,illidan,384,priest,shadow,6,4,2
Voidathon,sargeras,384,priest,shadow,6,4,2
Plushys,emerald-dream,384,priest,shadow,6,4,2
Killían,darkspear,384,priest,shadow,6,4,2
Iemon,vashj,384,priest,shadow,6,4,2
Sungsh,zuljin,384,priest,shadow,6,4,2
Chapyh,malganis,384,priest,shadow,6,4,2
Mitogen,malganis,384,priest,shadow,6,4,2
Káldorei,proudmoore,384,priest,shadow,6,4,2
Whosjoe,tichondrius,384,priest,shadow,6,4,2
Adíos,malganis,384,priest,shadow,6,4,2
Guillotine,azralon,384,priest,shadow,6,4,2
Dyé,hydraxis,384,priest,shadow,6,4,2
Prostrat,deathwing,384,priest,shadow,6,4,2
Haedn,azralon,384,priest,shadow,6,4,2
Valtres,tichondrius,384,priest,shadow,6,4,2
Ydonburi,tichondrius,384,priest,shadow,6,4,2
Skgangmm,tichondrius,384,priest,shadow,6,4,2
Kks,tichondrius,384,priest,shadow,6,4,2
Despairx,tichondrius,384,priest,shadow,6,4,2
Balverix,tichondrius,384,priest,shadow,6,4,2
Tiinkerbell,moon-guard,384,priest,shadow,6,4,2
Minarhy,moon-guard,384,priest,shadow,6,4,2
Cheach,echo-isles,384,priest,shadow,6,4,2
Comoli,tichondrius,384,priest,shadow,6,4,2
Mindflay,tichondrius,384,priest,shadow,6,4,2
Prydas,tichondrius,384,priest,shadow,6,4,2
Quartzolio,azralon,384,priest,shadow,6,4,2
Diskordia,stormrage,384,priest,shadow,6,4,2
Rôss,tichondrius,384,priest,shadow,6,4,2
Feminizm,tichondrius,384,priest,shadow,6,4,2
Omnivoîd,tichondrius,384,priest,shadow,6,4,2
Unclecam,tichondrius,384,priest,shadow,6,4,2
Píty,ragnaros,384,priest,shadow,6,4,2
Mfn,deathwing,384,priest,shadow,11,4,7
Oligan,quelthalas,384,priest,shadow,12,4,8
Fhelurian,quelthalas,384,priest,shadow,12,4,8
Nonbinary,trollbane,384,priest,shadow,12,4,8
Mannyelf,ragnaros,384,priest,shadow,12,4,8
Dialis,frostmourne,384,priest,shadow,12,4,8
Lätöxïkä,alleria,384,priest,shadow,12,4,8
Tokaru,frostmourne,384,priest,shadow,12,4,8
Jikoguu,stormscale,384,priest,shadow,12,4,8
Fáll,bleeding-hollow,384,priest,shadow,12,4,8
Labraidor,tichondrius,384,priest,shadow,12,4,8
Junethegreat,tichondrius,384,priest,shadow,12,4,8
Ralphiez,tichondrius,384,priest,shadow,12,4,8
Reverendpope,tichondrius,384,priest,shadow,12,4,8
Shadylotion,stormrage,384,priest,shadow,12,4,8
Holydrop,sargeras,384,priest,shadow,12,4,8
Aerith,barthilas,384,priest,shadow,12,4,8
Drosslolz,illidan,384,priest,shadow,12,4,8
Tuggyp,tichondrius,384,priest,shadow,12,4,8
Grimmyreap,malygos,384,priest,shadow,12,4,8
Influencing,moon-guard,384,priest,shadow,12,4,8
Vynardis,arygos,384,priest,shadow,12,4,8
Fatäl,moon-guard,384,priest,shadow,12,4,8
Deathbyhot,gorefiend,384,priest,shadow,12,4,8
Mìçah,fizzcrank,384,priest,shadow,12,4,8
Demoñ,deathwing,384,priest,shadow,12,4,8
Vaeryl,stormrage,384,priest,shadow,12,4,8
Tenaebreu,tichondrius,384,priest,shadow,13,4,9
Arca,cenarion-circle,384,priest,shadow,18,4,14
Whisper,zuljin,383,priest,shadow,12,4,8
Rijonkulous,area-52,383,priest,shadow,12,4,8
Jammý,barthilas,383,priest,shadow,12,4,8
Unfriend,sargeras,383,priest,shadow,12,4,8
Hermïs,stormrage,383,priest,shadow,12,4,8
Kkpriest,frostmourne,382,priest,shadow,6,4,2
Daisydux,emerald-dream,382,priest,shadow,6,4,2
Geulis,illidan,382,priest,shadow,12,4,8
Romero,blood-furnace,382,priest,shadow,12,4,8
Bwansandi,blackrock,370,priest,shadow,38,8,30
Thotsndots,blood-furnace,351,priest,shadow,8,5,3
Sgiath,alleria,330,priest,shadow,15,6,9
Libationz,area-52,329,priest,shadow,19,7,12
Dtbündertree,nordrassil,319,priest,shadow,5,4,1
Coolbie,korgath,319,priest,shadow,14,4,10
Oxytoxin,sargeras,304,priest,shadow,7,4,3
Creata,frostmourne,304,priest,shadow,7,4,3
Peazyqt,tichondrius,304,priest,shadow,7,4,3
Sealife,kelthuzad,288,priest,shadow,6,3,3
Snackabre,moon-guard,288,priest,shadow,6,3,3
Nuclease,turalyon,288,priest,shadow,6,3,3
Pogchamp,alterac-mountains,288,priest,shadow,6,3,3
Haransimongo,area-52,288,priest,shadow,6,3,3
Xandir,kaelthas,288,priest,shadow,6,3,3
Chroma,amanthul,288,priest,shadow,6,3,3
Jaliera,malganis,288,priest,shadow,6,3,3
Mïndgames,kelthuzad,288,priest,shadow,6,3,3
Samio,area-52,288,priest,shadow,6,3,3
Russbell,ragnaros,288,priest,shadow,6,3,3
Slogger,illidan,288,priest,shadow,6,3,3
Furìøns,nemesis,288,priest,shadow,6,3,3
Fight,icecrown,288,priest,shadow,6,3,3
Halîth,terenas,288,priest,shadow,6,3,3
Issaley,tichondrius,288,priest,shadow,6,3,3
Aliciab,andorhal,288,priest,shadow,6,3,3
Mallox,quelthalas,288,priest,shadow,6,3,3
Empyreanlite,dalaran,288,priest,shadow,6,3,3
Etherrion,area-52,288,priest,shadow,6,3,3
Spõt,stormrage,288,priest,shadow,6,3,3
Whittysp,tichondrius,288,priest,shadow,6,3,3
Mightyp,malganis,288,priest,shadow,6,3,3
Wrathhealer,hellscream,288,priest,shadow,6,3,3
Shaðows,malganis,288,priest,shadow,6,3,3
Valsong,argent-dawn,288,priest,shadow,6,3,3
Lotros,area-52,288,priest,shadow,6,3,3
Whalexo,kelthuzad,288,priest,shadow,6,3,3
Reginaa,nemesis,288,priest,shadow,6,3,3
Vullena,moon-guard,288,priest,shadow,6,3,3
Fenix,bloodhoof,288,priest,shadow,6,3,3
Mhorkarion,quelthalas,288,priest,shadow,6,3,3
Lolsodacans,malganis,288,priest,shadow,6,3,3
Ej,altar-of-storms,288,priest,shadow,6,3,3
Shakarot,illidan,288,priest,shadow,6,3,3
Caiitlynn,quelthalas,288,priest,shadow,6,3,3
Döllyy,illidan,288,priest,shadow,6,3,3
Beneficium,nazjatar,288,priest,shadow,6,3,3
Reâpêr,kelthuzad,288,priest,shadow,6,3,3
Dumpesitwo,frostmourne,288,priest,shadow,6,3,3
Spspsp,illidan,288,priest,shadow,6,3,3
Intheway,bleeding-hollow,288,priest,shadow,6,3,3
Elitë,frostmourne,288,priest,shadow,6,3,3
Worldhealer,area-52,288,priest,shadow,6,3,3
Ricksanchez,moonrunner,288,priest,shadow,6,3,3
Nizanz,illidan,288,priest,shadow,6,3,3
Kindyx,ragnaros,288,priest,shadow,6,3,3
Ozzx,stormrage,288,priest,shadow,6,3,3
ßoy,amanthul,288,priest,shadow,6,3,3
Xuxu,frostmourne,288,priest,shadow,6,3,3
ßìrth,kelthuzad,288,priest,shadow,6,3,3
Lucènt,frostmourne,288,priest,shadow,6,3,3
Egraner,drakkari,288,priest,shadow,6,3,3
Studpriest,tichondrius,288,priest,shadow,6,3,3
Voidballs,tichondrius,288,priest,shadow,6,3,3
Mockr,kiljaeden,288,priest,shadow,6,3,3
Bubbleguppyx,tichondrius,288,priest,shadow,6,3,3
Eddysmokes,tichondrius,288,priest,shadow,6,3,3
Pics,emerald-dream,288,priest,shadow,6,3,3
Seniorpickle,emerald-dream,288,priest,shadow,6,3,3
Enaan,proudmoore,288,priest,shadow,6,3,3
Ossirus,emerald-dream,288,priest,shadow,6,3,3
Drelia,jubeithos,288,priest,shadow,6,3,3
Moselol,tichondrius,288,priest,shadow,6,3,3
Pezziate,tichondrius,288,priest,shadow,6,3,3
Limèria,emerald-dream,288,priest,shadow,6,3,3
Quantumgoat,tichondrius,288,priest,shadow,6,3,3
Envyion,sargeras,288,priest,shadow,6,3,3
Alykus,emerald-dream,288,priest,shadow,6,3,3
Deathzpirit,kiljaeden,288,priest,shadow,6,3,3
Toxictampax,azjolnerub,288,priest,shadow,6,3,3
Unclelively,dragonmaw,288,priest,shadow,6,3,3
Leyspring,moon-guard,288,priest,shadow,6,3,3
Xxmewo,sargeras,288,priest,shadow,6,3,3
Cappoo,tichondrius,288,priest,shadow,6,3,3
Auras,boulderfist,288,priest,shadow,6,3,3
Soloqqt,tichondrius,288,priest,shadow,6,3,3
Runakk,stonemaul,288,priest,shadow,6,3,3
Likesshadows,tichondrius,288,priest,shadow,6,3,3
Bbeaie,tichondrius,288,priest,shadow,6,3,3
Îcecube,sargeras,288,priest,shadow,6,3,3
Synisteria,sargeras,288,priest,shadow,6,3,3
Strokkerzin,azralon,288,priest,shadow,6,3,3
Snoog,tichondrius,288,priest,shadow,6,3,3
Randyortonn,tichondrius,288,priest,shadow,6,3,3
Nylaza,kiljaeden,288,priest,shadow,6,3,3
Plumpkinn,kiljaeden,288,priest,shadow,6,3,3
Sandrö,sargeras,288,priest,shadow,6,3,3
Chewit,kargath,288,priest,shadow,6,3,3
Shadowzypher,wyrmrest-accord,288,priest,shadow,6,3,3
Achllia,proudmoore,288,priest,shadow,6,3,3
Onahaihu,tichondrius,288,priest,shadow,9,4,5
Xeras,ravencrest,288,priest,shadow,12,3,9
Dunnbledore,area-52,288,priest,shadow,12,3,9
Shadowpain,the-underbog,288,priest,shadow,12,3,9
Shadøwbølt,tichondrius,288,priest,shadow,12,3,9
Cpoppa,sargeras,288,priest,shadow,12,3,9
Cloax,azgalor,288,priest,shadow,12,3,9
Scaryspise,nathrezim,288,priest,shadow,12,3,9
Valuations,tichondrius,288,priest,shadow,12,3,9
Tylored,zuljin,288,priest,shadow,12,3,9
Poppyp,stormrage,288,priest,shadow,12,3,9
Sybenela,proudmoore,288,priest,shadow,12,3,9
Alphawon,area-52,288,priest,shadow,12,3,9
Pactosombrio,azralon,288,priest,shadow,12,3,9
Stantz,burning-legion,288,priest,shadow,12,3,9
Astari,illidan,288,priest,shadow,12,3,9
Aurilain,malganis,288,priest,shadow,12,3,9
Messiahp,illidan,288,priest,shadow,18,3,15
Shadowbishop,barthilas,287,priest,shadow,6,3,3
Angro,ragnaros,287,priest,shadow,6,3,3
Grímmz,veknilash,287,priest,shadow,7,3,4
Bernhard,azralon,239,priest,shadow,5,3,2
Shadowblax,thrall,192,priest,shadow,4,3,1
Holyhand,auchindoun,192,priest,shadow,4,3,1
Plenipotent,moon-guard,192,priest,shadow,11,5,6
Lzzp,azralon,192,priest,shadow,6,2,4
Geoat,barthilas,192,priest,shadow,6,2,4
Mitoloshi,ragnaros,192,priest,shadow,6,2,4
Midget,darkspear,192,priest,shadow,6,2,4
Andso,azralon,192,priest,shadow,6,2,4
Ptheld,tichondrius,192,priest,shadow,6,2,4
Darkenside,moon-guard,192,priest,shadow,6,2,4
Jessticalz,frostmourne,192,priest,shadow,6,2,4
Pandiwoodney,ragnaros,192,priest,shadow,6,2,4
Clistyn,quelthalas,192,priest,shadow,6,2,4
Nodorme,quelthalas,192,priest,shadow,6,2,4
Jdcii,tichondrius,192,priest,shadow,6,2,4
Priést,stormrage,192,priest,shadow,6,2,4
Lolsithlord,tichondrius,192,priest,shadow,6,2,4
Pipete,frostmourne,192,priest,shadow,6,2,4
Senadori,azjolnerub,192,priest,shadow,6,2,4
Murkqz,azralon,192,priest,shadow,6,2,4
Beertriarch,frostmourne,192,priest,shadow,6,2,4
Bumbleedot,azralon,192,priest,shadow,6,2,4
Dotdotdead,earthen-ring,192,priest,shadow,6,2,4
Púrg,frostmourne,192,priest,shadow,6,2,4
Kälashnikova,ragnaros,192,priest,shadow,6,2,4
Gineska,tichondrius,192,priest,shadow,6,2,4
Kryoff,illidan,192,priest,shadow,6,2,4
Furryoflife,suramar,192,priest,shadow,6,2,4
Lifejuice,tichondrius,192,priest,shadow,6,2,4
Shmmoie,frostmourne,192,priest,shadow,6,2,4
Melithor,frostmourne,192,priest,shadow,6,2,4
Brounly,drakkari,192,priest,shadow,6,2,4
Hail,kaelthas,192,priest,shadow,6,2,4
Cxmplex,malganis,192,priest,shadow,6,2,4
Detainedz,malganis,192,priest,shadow,6,2,4
Onlyphantoms,kelthuzad,192,priest,shadow,6,2,4
Enochian,hyjal,192,priest,shadow,6,2,4
Zyte,stormrage,192,priest,shadow,6,2,4
Jmanhealz,stormrage,192,priest,shadow,6,2,4
Ateras,emerald-dream,192,priest,shadow,6,2,4
Selspriest,kelthuzad,192,priest,shadow,6,2,4
Shrax,emerald-dream,192,priest,shadow,6,2,4
Sorojín,zuljin,192,priest,shadow,6,2,4
Innergee,aegwynn,192,priest,shadow,6,2,4
Dippyzs,alterac-mountains,192,priest,shadow,6,2,4
Dagaen,thunderlord,192,priest,shadow,6,2,4
Juliusceazer,skywall,192,priest,shadow,6,2,4
Projectalice,ravencrest,192,priest,shadow,6,2,4
Dogfrompark,illidan,192,priest,shadow,6,2,4
Horsegirls,kelthuzad,192,priest,shadow,6,2,4
Scenekîd,moon-guard,192,priest,shadow,6,2,4
Lemmiewinkzx,sargeras,192,priest,shadow,6,2,4
Clickbait,spirestone,192,priest,shadow,6,2,4
Slctivhealng,area-52,192,priest,shadow,6,2,4
Layons,nemesis,192,priest,shadow,6,2,4
Kabutta,stormrage,192,priest,shadow,6,2,4
Byungsik,terenas,192,priest,shadow,6,2,4
Orethon,thrall,192,priest,shadow,6,2,4
Vanzera,thrall,192,priest,shadow,6,2,4
Sâishâ,proudmoore,192,priest,shadow,6,2,4
Jjaeminkim,area-52,192,priest,shadow,6,2,4
Apâthy,area-52,192,priest,shadow,6,2,4
Sshhaaddooww,tichondrius,192,priest,shadow,6,2,4
Tomriddlle,sargeras,192,priest,shadow,6,2,4
Anxìetý,area-52,192,priest,shadow,6,2,4
Laq,proudmoore,192,priest,shadow,6,2,4
Cryptoccocus,zuljin,192,priest,shadow,6,2,4
Hevnlyst,proudmoore,192,priest,shadow,6,2,4
Psychohazard,area-52,192,priest,shadow,6,2,4
Quinnx,tichondrius,192,priest,shadow,6,2,4
Wheelson,wildhammer,192,priest,shadow,6,2,4
Ozztwo,tichondrius,192,priest,shadow,12,2,10
Kulrig,shuhalo,192,priest,shadow,12,2,10
Alizhe,ragnaros,192,priest,shadow,12,2,10
Tmpriest,tichondrius,175,priest,shadow,11,2,9
Chü,dalaran,169,priest,shadow,12,5,7
Tiizz,malganis,159,priest,shadow,5,2,3
Gobananas,bleeding-hollow,159,priest,shadow,5,2,3
Saltheril,burning-blade,159,priest,shadow,5,2,3
Dekomori,quelthalas,159,priest,shadow,5,2,3
Vorial,cenarion-circle,159,priest,shadow,5,2,3
Gaeira,azralon,159,priest,shadow,11,2,9
Winss,tichondrius,128,priest,shadow,4,2,2
Cravex,stormrage,128,priest,shadow,4,2,2
Sätîvá,tichondrius,96,priest,shadow,3,2,1
Priestthingz,area-52,96,priest,shadow,8,2,6
Jaquels,sargeras,96,priest,shadow,6,1,5
Sadury,tichondrius,96,priest,shadow,6,1,5
Tusket,black-dragonflight,96,priest,shadow,6,1,5
Vdip,illidan,96,priest,shadow,6,1,5
Lilskizz,dalaran,96,priest,shadow,6,1,5
Younext,sargeras,96,priest,shadow,6,1,5
Shadowreck,malganis,96,priest,shadow,6,1,5
Irilde,proudmoore,96,priest,shadow,6,1,5
Powerwordwap,malganis,96,priest,shadow,6,1,5
Tmspongwo,tichondrius,96,priest,shadow,6,1,5
Wrinkletink,whisperwind,96,priest,shadow,6,1,5
Bigdaddios,dalaran,96,priest,shadow,6,1,5
Syrillia,wildhammer,96,priest,shadow,6,1,5
Cultists,tichondrius,96,priest,shadow,6,1,5
Nightboxer,tichondrius,96,priest,shadow,6,1,5
Dawnbréaker,azralon,96,priest,shadow,6,1,5
Milliyakk,area-52,96,priest,shadow,6,1,5
Mangemoélqc,darkspear,96,priest,shadow,6,1,5
Teccalil,tichondrius,96,priest,shadow,6,1,5
Amikam,barthilas,96,priest,shadow,6,1,5
Omygawd,tichondrius,96,priest,shadow,6,1,5
Oxyy,aerie-peak,96,priest,shadow,6,1,5
Vyndictus,shattered-hand,96,priest,shadow,6,1,5
Baerybonds,kiljaeden,96,priest,shadow,6,1,5
Shadolord,illidan,96,priest,shadow,6,1,5
Paingivër,drakkari,96,priest,shadow,6,1,5
Jxkep,frostmourne,96,priest,shadow,6,1,5
Óst,tichondrius,96,priest,shadow,6,1,5
Whatsittoya,tichondrius,96,priest,shadow,6,1,5
Cärdi,frostmourne,96,priest,shadow,6,1,5
Lôvecraft,frostmourne,96,priest,shadow,6,1,5
Shädë,emerald-dream,96,priest,shadow,6,1,5
Vineller,malganis,96,priest,shadow,6,1,5
Voidrisu,sargeras,96,priest,shadow,6,1,5
Kodaks,frostmourne,96,priest,shadow,6,1,5
Dazzlems,tichondrius,96,priest,shadow,6,1,5
Rays,drakkari,96,priest,shadow,6,1,5
Galestick,illidan,96,priest,shadow,6,1,5
Nancynibbler,bleeding-hollow,96,priest,shadow,6,1,5
Mauriel,proudmoore,96,priest,shadow,6,1,5
Kelody,zuljin,96,priest,shadow,6,1,5
Althlon,emerald-dream,96,priest,shadow,6,1,5
Lleak,tichondrius,96,priest,shadow,6,1,5
Ibangedaqt,malganis,96,priest,shadow,6,1,5
Psyward,tichondrius,96,priest,shadow,6,1,5
Lukaspriest,proudmoore,96,priest,shadow,6,1,5
Shadowftw,illidan,96,priest,shadow,6,1,5
Dadsalad,zuljin,96,priest,shadow,6,1,5
Fámóus,stormrage,96,priest,shadow,6,1,5
Toddo,trollbane,96,priest,shadow,6,1,5
Jèf,stormrage,96,priest,shadow,6,1,5
Releknosleep,frostwolf,96,priest,shadow,6,1,5
Soonya,arygos,96,priest,shadow,9,1,8
Murdangus,moon-guard,96,priest,shadow,12,1,11
Jpray,bleeding-hollow,96,priest,shadow,12,1,11
Xic,thrall,79,priest,shadow,5,1,4
Runswithrain,lethon,79,priest,shadow,5,1,4
Kunof,ragnaros,79,priest,shadow,5,1,4
Jadon,sargeras,63,priest,shadow,2,2,0
Bublethenrun,cenarius,48,priest,shadow,3,1,2
Ràvn,emerald-dream,48,priest,shadow,3,1,2
Fadehojx,illidan,42,priest,shadow,9,2,7
Shaurana,stormrage,31,priest,shadow,8,1,7
Pilixil,bleeding-hollow,16,priest,shadow,1,1,0
Trågédy,azjolnerub,16,priest,shadow,1,1,0
Yellowrose,kelthuzad,2006,rogue,outlaw,75,42,33
Weran,tichondrius,1890,rogue,outlaw,54,28,26
Dvn,stormrage,1844,rogue,outlaw,54,32,22
Sadiator,illidan,1810,rogue,outlaw,59,31,28
Millspec,tichondrius,1762,rogue,outlaw,117,58,59
Welinth,thunderlord,1750,rogue,outlaw,396,201,195
Millspec,zuljin,1730,rogue,outlaw,42,25,17
Dennerdz,tichondrius,1688,rogue,outlaw,47,19,28
Arena,uldum,1672,rogue,outlaw,41,20,21
Lycanthropî,illidan,1655,rogue,outlaw,80,37,43
Xylvána,kiljaeden,1640,rogue,outlaw,66,31,35
Lardiconn,thrall,1628,rogue,outlaw,42,30,12
Deadracer,moon-guard,1624,rogue,outlaw,54,29,25
Lazeestab,sargeras,1618,rogue,outlaw,172,95,77
Supherr,sargeras,1608,rogue,outlaw,41,20,21
Càgil,stormrage,1607,rogue,outlaw,34,19,15
Jmaxx,tichondrius,1603,rogue,outlaw,51,32,19
Gnøver,ragnaros,1585,rogue,outlaw,88,45,43
Supine,illidan,1539,rogue,outlaw,109,58,51
Mirâge,illidan,1533,rogue,outlaw,50,28,22
Kentaki,tichondrius,1515,rogue,outlaw,60,33,27
Velskud,area-52,1494,rogue,outlaw,58,31,27
Karambit,frostmourne,1494,rogue,outlaw,102,45,57
Trêl,velen,1485,rogue,outlaw,81,39,42
Combo,norgannon,1484,rogue,outlaw,102,61,41
Blackmont,bleeding-hollow,1483,rogue,outlaw,53,32,21
Disrawen,ragnaros,1457,rogue,outlaw,282,138,144
Jenaki,gurubashi,1442,rogue,outlaw,62,32,30
Jolly,frostmourne,1440,rogue,outlaw,53,22,31
Itsuksiko,quelthalas,1435,rogue,outlaw,40,21,19
Omnïslash,stormrage,1433,rogue,outlaw,42,17,25
Gotosor,quelthalas,1415,rogue,outlaw,144,73,71
Sapsis,shandris,1409,rogue,outlaw,47,22,25
Shindeiru,area-52,1399,rogue,outlaw,43,30,13
Bleaklord,emerald-dream,1373,rogue,outlaw,48,17,31
Snakeblisken,emerald-dream,1352,rogue,outlaw,36,15,21
Hobblefoot,proudmoore,1340,rogue,outlaw,46,24,22
Dogeggs,area-52,1331,rogue,outlaw,30,14,16
Dross,shadowmoon,1325,rogue,outlaw,30,14,16
Chrisdorner,area-52,1316,rogue,outlaw,25,14,11
Jakamungo,area-52,1315,rogue,outlaw,46,22,24
Reyskywalker,kelthuzad,1303,rogue,outlaw,24,15,9
Mgzx,tichondrius,1295,rogue,outlaw,48,25,23
Ntrfighter,tichondrius,1258,rogue,outlaw,71,36,35
Wátchyoúrbák,wyrmrest-accord,1247,rogue,outlaw,30,14,16
Redimído,quelthalas,1244,rogue,outlaw,27,14,13
Gothamzzing,tichondrius,1242,rogue,outlaw,24,13,11
Houlton,moon-guard,1234,rogue,outlaw,24,13,11
Cheddery,dalaran,1151,rogue,outlaw,36,17,19
Swingonya,stormrage,1150,rogue,outlaw,18,12,6
Corevis,moon-guard,1149,rogue,outlaw,24,12,12
Luolan,kargath,1149,rogue,outlaw,39,13,26
Fastblast,wyrmrest-accord,1146,rogue,outlaw,24,12,12
Mabushi,sargeras,1135,rogue,outlaw,42,15,27
Azarha,zuljin,1117,rogue,outlaw,58,32,26
Vanorn,aerie-peak,1108,rogue,outlaw,54,17,37
Zarthrox,bladefist,1105,rogue,outlaw,30,16,14
Johnnyelbows,tichondrius,1078,rogue,outlaw,27,13,14
Wujn,tichondrius,1050,rogue,outlaw,24,11,13
Lumifer,quelthalas,1050,rogue,outlaw,54,18,36
Adevoir,hakkar,1049,rogue,outlaw,48,24,24
Xyleth,azgalor,1048,rogue,outlaw,53,20,33
Thèory,sargeras,1044,rogue,outlaw,24,11,13
Valefarr,emerald-dream,1043,rogue,outlaw,29,13,16
Mechamind,draka,1034,rogue,outlaw,18,11,7
Thuganomics,dark-iron,1008,rogue,outlaw,27,12,15
Emoond,ragnaros,989,rogue,outlaw,27,13,14
Farstrider,tichondrius,985,rogue,outlaw,72,27,45
Inhume,eredar,960,rogue,outlaw,24,10,14
Larmx,tichondrius,960,rogue,outlaw,24,10,14
Straite,area-52,959,rogue,outlaw,18,10,8
Quapi,tichondrius,959,rogue,outlaw,18,10,8
Preceptor,azralon,956,rogue,outlaw,24,10,14
Nitroxy,quelthalas,950,rogue,outlaw,24,10,14
Badpatatas,proudmoore,913,rogue,outlaw,42,10,32
Shninzy,senjin,910,rogue,outlaw,31,11,20
Tanadoril,wyrmrest-accord,863,rogue,outlaw,18,9,9
Asdestroyerr,tichondrius,863,rogue,outlaw,18,9,9
Stabbythorus,stormrage,862,rogue,outlaw,18,9,9
Bebesita,sisters-of-elune,860,rogue,outlaw,18,9,9
Phraze,silvermoon,859,rogue,outlaw,30,14,16
Zogbu,stormrage,858,rogue,outlaw,18,9,9
Coalie,tichondrius,816,rogue,outlaw,15,9,6
Zeed,ragnaros,802,rogue,outlaw,24,10,14
Lesty,kelthuzad,768,rogue,outlaw,12,8,4
Deepsyo,frostmourne,768,rogue,outlaw,12,8,4
Airi,darkspear,768,rogue,outlaw,18,8,10
Synj,frostmourne,767,rogue,outlaw,12,8,4
Tarnished,ravenholdt,766,rogue,outlaw,24,8,16
Slitherex,thunderlord,763,rogue,outlaw,21,9,12
Itricku,tichondrius,759,rogue,outlaw,48,14,34
Thompson,bloodscalp,672,rogue,outlaw,12,7,5
Drsinz,tichondrius,671,rogue,outlaw,18,7,11
Slowtime,quelthalas,671,rogue,outlaw,18,7,11
Cosmicò,trollbane,670,rogue,outlaw,12,7,5
Evilkoreanz,tichondrius,670,rogue,outlaw,12,7,5
Jamesallen,silvermoon,659,rogue,outlaw,12,7,5
Roxy,ghostlands,623,rogue,outlaw,17,7,10
Esky,tichondrius,576,rogue,outlaw,12,6,6
Deeppockets,sargeras,576,rogue,outlaw,12,6,6
Cidi,moon-guard,576,rogue,outlaw,18,6,12
Zanith,wyrmrest-accord,575,rogue,outlaw,12,6,6
Sprork,kiljaeden,575,rogue,outlaw,18,6,12
Drakariano,ragnaros,575,rogue,outlaw,18,6,12
Deddyy,zuljin,574,rogue,outlaw,18,6,12
Bonizzi,stormrage,573,rogue,outlaw,12,6,6
Marraya,area-52,573,rogue,outlaw,12,6,6
Abatoire,wyrmrest-accord,572,rogue,outlaw,12,6,6
Listrew,stormrage,571,rogue,outlaw,12,6,6
Maglove,nemesis,571,rogue,outlaw,12,6,6
Tsubamë,tichondrius,480,rogue,outlaw,6,5,1
Tmpikaboo,tichondrius,480,rogue,outlaw,6,5,1
Galfuran,burning-legion,480,rogue,outlaw,12,5,7
Sekkelx,moon-guard,480,rogue,outlaw,12,5,7
Alexyy,blades-edge,480,rogue,outlaw,12,5,7
Spikiera,silvermoon,480,rogue,outlaw,18,5,13
Earthinhorn,frostmourne,480,rogue,outlaw,18,5,13
Sasskei,malganis,479,rogue,outlaw,12,5,7
Kasharo,tichondrius,479,rogue,outlaw,12,5,7
Stabbymcgee,duskwood,478,rogue,outlaw,12,5,7
Alerana,dathremar,474,rogue,outlaw,12,5,7
Darthkelso,arathor,465,rogue,outlaw,24,5,19
Kents,tichondrius,384,rogue,outlaw,6,4,2
Flashmob,zuljin,384,rogue,outlaw,6,4,2
Alandoril,tichondrius,384,rogue,outlaw,6,4,2
Xylvana,kiljaeden,384,rogue,outlaw,6,4,2
Krypticstab,malganis,384,rogue,outlaw,6,4,2
Xavar,malganis,384,rogue,outlaw,6,4,2
Dayvanie,area-52,384,rogue,outlaw,12,4,8
Blingtronx,malganis,384,rogue,outlaw,12,4,8
Showclass,stormrage,384,rogue,outlaw,12,4,8
Subnini,kelthuzad,384,rogue,outlaw,18,4,14
Gheez,quelthalas,383,rogue,outlaw,6,4,2
Katanië,moon-guard,383,rogue,outlaw,12,4,8
Houdinilogic,skullcrusher,381,rogue,outlaw,12,4,8
Daftjack,bleeding-hollow,381,rogue,outlaw,12,4,8
Ningaturtle,korgath,376,rogue,outlaw,18,4,14
Fennick,tanaris,351,rogue,outlaw,11,4,7
Siamés,quelthalas,319,rogue,outlaw,14,4,10
Homeschoolx,moon-guard,288,rogue,outlaw,6,3,3
Whaazz,emerald-dream,288,rogue,outlaw,6,3,3
Dicenslice,proudmoore,288,rogue,outlaw,6,3,3
Peteylee,stormrage,288,rogue,outlaw,6,3,3
Bootypie,hyjal,288,rogue,outlaw,6,3,3
Karmagoodttv,stormrage,288,rogue,outlaw,6,3,3
Pikartz,stormrage,288,rogue,outlaw,6,3,3
Lacero,bonechewer,288,rogue,outlaw,6,3,3
Machos,azralon,288,rogue,outlaw,6,3,3
Movze,area-52,288,rogue,outlaw,6,3,3
Amorfirion,frostmourne,288,rogue,outlaw,6,3,3
Ghøstfäce,tichondrius,288,rogue,outlaw,6,3,3
Hedillyan,azralon,288,rogue,outlaw,6,3,3
Bàndit,wyrmrest-accord,288,rogue,outlaw,6,3,3
Daehyun,moknathal,288,rogue,outlaw,6,3,3
Alexdelion,tichondrius,288,rogue,outlaw,6,3,3
Drpibb,ghostlands,288,rogue,outlaw,12,3,9
Xzarfi,moon-guard,288,rogue,outlaw,18,3,15
Stabyou,sentinels,287,rogue,outlaw,6,3,3
Grimthorn,icecrown,285,rogue,outlaw,12,3,9
Fryphilip,dalaran,256,rogue,outlaw,10,3,7
Hotboxthefox,illidan,253,rogue,outlaw,11,3,8
Mud,saurfang,192,rogue,outlaw,6,2,4
Touchthetip,bleeding-hollow,192,rogue,outlaw,6,2,4
Duskeron,cenarius,192,rogue,outlaw,6,2,4
Remonezero,moon-guard,192,rogue,outlaw,6,2,4
Jsyn,kiljaeden,192,rogue,outlaw,6,2,4
Slobernocker,stormrage,192,rogue,outlaw,6,2,4
Creamcakepop,stormrage,192,rogue,outlaw,6,2,4
Nestha,quelthalas,192,rogue,outlaw,6,2,4
Prisonshank,arthas,192,rogue,outlaw,6,2,4
Jebubs,tichondrius,192,rogue,outlaw,6,2,4
ßuu,sargeras,192,rogue,outlaw,6,2,4
Sxs,kiljaeden,192,rogue,outlaw,12,2,10
Òklahomie,frostwolf,191,rogue,outlaw,6,2,4
Landrik,trollbane,191,rogue,outlaw,6,2,4
Philliamson,azgalor,190,rogue,outlaw,12,2,10
Madge,area-52,96,rogue,outlaw,6,1,5
Lu,lethon,96,rogue,outlaw,6,1,5
Sindor,azralon,96,rogue,outlaw,6,1,5
Reginageorge,azuremyst,96,rogue,outlaw,6,1,5
Vîllâîn,tichondrius,96,rogue,outlaw,6,1,5
Downsix,sargeras,96,rogue,outlaw,6,1,5
Happyslice,stormrage,96,rogue,outlaw,6,1,5
Neilyo,barthilas,96,rogue,outlaw,6,1,5
Xm,sargeras,96,rogue,outlaw,6,1,5
Rinestiria,arthas,96,rogue,outlaw,6,1,5
Hîzzÿ,ghostlands,96,rogue,outlaw,12,1,11
Culpera,undermine,95,rogue,outlaw,6,1,5
Lawyergamer,bonechewer,63,rogue,outlaw,2,2,0
Aliasfaker,stormrage,16,rogue,outlaw,1,1,0
Erebüs,thunderlord,2227,rogue,subtlety,78,50,28
Battzii,wyrmrest-accord,2147,rogue,subtlety,516,268,248
Ymxxworld,tichondrius,2107,rogue,subtlety,96,49,47
Lies,dalaran,2010,rogue,subtlety,87,43,44
Ajl,drenden,1999,rogue,subtlety,88,47,41
Flashmob,zuljin,1983,rogue,subtlety,50,25,25
Danrathm,sargeras,1958,rogue,subtlety,79,44,35
Roguesparrow,illidan,1931,rogue,subtlety,104,61,43
Røgüë,malganis,1929,rogue,subtlety,60,32,28
Alexdelion,tichondrius,1923,rogue,subtlety,66,34,32
Rangoons,tichondrius,1894,rogue,subtlety,60,36,24
Norbury,tichondrius,1893,rogue,subtlety,83,40,43
Stealthypoop,kelthuzad,1887,rogue,subtlety,89,45,44
Slashthunder,blades-edge,1876,rogue,subtlety,54,29,25
Needbuff,tichondrius,1865,rogue,subtlety,54,25,29
Coopi,tichondrius,1853,rogue,subtlety,115,60,55
Scuffedjr,tichondrius,1852,rogue,subtlety,84,37,47
Himitu,tichondrius,1849,rogue,subtlety,89,46,43
Yázim,tichondrius,1848,rogue,subtlety,55,33,22
Coregx,tichondrius,1842,rogue,subtlety,36,24,12
Rõý,area-52,1837,rogue,subtlety,42,23,19
Stunsofpuns,sargeras,1833,rogue,subtlety,60,33,27
Brucerogue,tichondrius,1833,rogue,subtlety,200,107,93
Maulline,tichondrius,1828,rogue,subtlety,42,20,22
Cydonian,ragnaros,1827,rogue,subtlety,96,54,42
Fátálíty,tichondrius,1827,rogue,subtlety,60,30,30
Ulley,sargeras,1826,rogue,subtlety,120,67,53
Smkgpvp,stormrage,1823,rogue,subtlety,68,43,25
Clern,emerald-dream,1818,rogue,subtlety,65,35,30
Ðèãth,area-52,1818,rogue,subtlety,36,19,17
Celèphaïs,tichondrius,1817,rogue,subtlety,63,30,33
Wetit,illidan,1816,rogue,subtlety,78,52,26
Zerogh,tichondrius,1811,rogue,subtlety,129,75,54
Bigpump,lothar,1809,rogue,subtlety,60,33,27
Bruítzy,barthilas,1809,rogue,subtlety,156,82,74
Kellenx,moon-guard,1809,rogue,subtlety,139,71,68
Wizlysnipz,tichondrius,1808,rogue,subtlety,60,35,25
Díor,azralon,1807,rogue,subtlety,124,70,54
Stabem,moon-guard,1800,rogue,subtlety,57,36,21
Wazowskiy,tichondrius,1781,rogue,subtlety,70,31,39
Axtually,proudmoore,1778,rogue,subtlety,60,38,22
Silentkush,arthas,1774,rogue,subtlety,48,28,20
Dvin,stormrage,1770,rogue,subtlety,54,30,24
Gyokkó,sargeras,1770,rogue,subtlety,36,20,16
Ganknvanish,tichondrius,1757,rogue,subtlety,156,77,79
Shinigâmì,tichondrius,1749,rogue,subtlety,78,52,26
Aaronjlol,tichondrius,1747,rogue,subtlety,36,23,13
Baeruto,thunderlord,1726,rogue,subtlety,24,18,6
Poizzon,emerald-dream,1704,rogue,subtlety,59,33,26
Nicoaa,tichondrius,1702,rogue,subtlety,133,71,62
Kidcutti,proudmoore,1701,rogue,subtlety,56,26,30
Assassìn,moon-guard,1697,rogue,subtlety,158,86,72
Whoox,khazgoroth,1695,rogue,subtlety,42,29,13
Xiaozhi,tichondrius,1692,rogue,subtlety,52,26,26
Okaylmao,tichondrius,1685,rogue,subtlety,30,21,9
Greyyfox,illidan,1680,rogue,subtlety,51,23,28
Majk,eldrethalas,1674,rogue,subtlety,52,24,28
Bezeta,azralon,1672,rogue,subtlety,203,111,92
Vyrenn,destromath,1672,rogue,subtlety,81,42,39
Jaos,tichondrius,1667,rogue,subtlety,42,22,20
Beanlord,spinebreaker,1654,rogue,subtlety,42,25,17
Lxw,frostmourne,1652,rogue,subtlety,37,20,17
Blakezilla,tichondrius,1648,rogue,subtlety,48,29,19
Bobsaget,kiljaeden,1642,rogue,subtlety,53,26,27
Zipperx,tichondrius,1641,rogue,subtlety,65,34,31
Steef,arygos,1638,rogue,subtlety,80,48,32
Furt,frostmourne,1633,rogue,subtlety,44,25,19
Kenpàchi,kelthuzad,1626,rogue,subtlety,36,21,15
Bruitzygg,barthilas,1619,rogue,subtlety,44,20,24
Preceptor,azralon,1614,rogue,subtlety,86,44,42
Eekz,sargeras,1613,rogue,subtlety,128,67,61
Themosk,malganis,1613,rogue,subtlety,36,18,18
Haiev,tichondrius,1613,rogue,subtlety,54,26,28
Pxb,sargeras,1609,rogue,subtlety,36,17,19
Piscís,sargeras,1606,rogue,subtlety,54,28,26
Yesua,ragnaros,1604,rogue,subtlety,181,90,91
Runakó,kelthuzad,1603,rogue,subtlety,48,21,27
Hayzarc,malfurion,1598,rogue,subtlety,42,21,21
Kalvish,dalaran,1597,rogue,subtlety,29,17,12
Camlaw,area-52,1594,rogue,subtlety,84,47,37
Wowamaze,aegwynn,1587,rogue,subtlety,82,46,36
Saprìse,darkspear,1582,rogue,subtlety,30,19,11
Tarny,illidan,1579,rogue,subtlety,58,25,33
Plado,tichondrius,1574,rogue,subtlety,47,27,20
Trizin,frostmourne,1563,rogue,subtlety,84,45,39
Turtlespeed,thrall,1559,rogue,subtlety,69,38,31
Cahlee,sargeras,1554,rogue,subtlety,64,26,38
Grelinho,stormrage,1554,rogue,subtlety,66,26,40
Klawz,norgannon,1553,rogue,subtlety,42,24,18
Îzu,ysera,1553,rogue,subtlety,51,27,24
Cut,ragnaros,1544,rogue,subtlety,81,40,41
Eekz,illidan,1535,rogue,subtlety,203,113,90
Mitsurí,sargeras,1534,rogue,subtlety,24,16,8
Fela,crushridge,1531,rogue,subtlety,132,67,65
Rosoma,kelthuzad,1530,rogue,subtlety,40,23,17
Dissociated,stormrage,1523,rogue,subtlety,47,17,30
Mayhemghost,rexxar,1515,rogue,subtlety,42,25,17
Killmebaby,lightnings-blade,1514,rogue,subtlety,48,26,22
Kainm,stormrage,1514,rogue,subtlety,248,130,118
Bombman,tichondrius,1513,rogue,subtlety,53,23,30
Kinbaal,bleeding-hollow,1511,rogue,subtlety,36,22,14
Kaliasteddin,area-52,1509,rogue,subtlety,45,23,22
Tulis,frostmourne,1507,rogue,subtlety,152,92,60
Quinity,wyrmrest-accord,1505,rogue,subtlety,97,53,44
Illmatíc,kelthuzad,1502,rogue,subtlety,29,16,13
Galaxybrain,icecrown,1498,rogue,subtlety,120,76,44
Dysxliec,dalaran,1485,rogue,subtlety,36,16,20
Garrotte,tichondrius,1478,rogue,subtlety,69,26,43
Pince,black-dragonflight,1475,rogue,subtlety,36,21,15
Lurios,rivendare,1475,rogue,subtlety,76,39,37
Errorless,moon-guard,1475,rogue,subtlety,42,21,21
Mosedz,tichondrius,1474,rogue,subtlety,48,28,20
Åer,dalaran,1470,rogue,subtlety,83,41,42
Gnøver,ragnaros,1463,rogue,subtlety,114,66,48
Stankyx,bleeding-hollow,1460,rogue,subtlety,66,37,29
Rufian,ursin,1460,rogue,subtlety,36,18,18
Vigílant,proudmoore,1460,rogue,subtlety,72,35,37
Greasybbsea,illidan,1459,rogue,subtlety,60,28,32
Scenna,stormrage,1457,rogue,subtlety,72,30,42
Vyll,stormrage,1452,rogue,subtlety,31,16,15
Bugser,tichondrius,1451,rogue,subtlety,60,32,28
Trucidovaco,daggerspine,1449,rogue,subtlety,88,40,48
Speedboi,skullcrusher,1448,rogue,subtlety,98,61,37
Eridian,tichondrius,1445,rogue,subtlety,49,23,26
Cuizhudi,tichondrius,1440,rogue,subtlety,26,17,9
Kyubïx,ragnaros,1437,rogue,subtlety,48,27,21
Kaylyth,whisperwind,1436,rogue,subtlety,36,15,21
Minaciki,tichondrius,1434,rogue,subtlety,24,15,9
Epipenqt,dark-iron,1431,rogue,subtlety,42,26,16
Hunchó,area-52,1431,rogue,subtlety,65,38,27
Brrant,tichondrius,1430,rogue,subtlety,24,15,9
Yoskit,tichondrius,1429,rogue,subtlety,24,15,9
Pichichi,frostmourne,1426,rogue,subtlety,39,24,15
Kibbs,korgath,1422,rogue,subtlety,60,30,30
Cv,proudmoore,1417,rogue,subtlety,30,18,12
Toxsith,tichondrius,1416,rogue,subtlety,36,22,14
Murked,barthilas,1416,rogue,subtlety,36,21,15
Rougething,bleeding-hollow,1415,rogue,subtlety,36,17,19
Xleo,drakkari,1414,rogue,subtlety,137,67,70
Axerax,draka,1412,rogue,subtlety,30,15,15
Secrettecbot,barthilas,1411,rogue,subtlety,30,18,12
Fulkrem,wyrmrest-accord,1410,rogue,subtlety,74,34,40
Worrglaive,dalaran,1404,rogue,subtlety,90,46,44
Luradfate,dalaran,1397,rogue,subtlety,178,91,87
Sasugay,sargeras,1391,rogue,subtlety,38,21,17
Sapyalater,thrall,1389,rogue,subtlety,150,78,72
Klâng,tichondrius,1389,rogue,subtlety,49,22,27
Neuschurke,warsong,1386,rogue,subtlety,42,23,19
Sgtbuttfat,dalaran,1385,rogue,subtlety,41,20,21
Saintt,khaz-modan,1384,rogue,subtlety,24,16,8
Sapùwú,stormrage,1384,rogue,subtlety,90,48,42
Roguetrix,stormrage,1384,rogue,subtlety,32,16,16
Fofree,hyjal,1382,rogue,subtlety,24,15,9
Frusciante,nemesis,1378,rogue,subtlety,42,18,24
Chãlons,tichondrius,1376,rogue,subtlety,78,37,41
Usernameqtxo,kelthuzad,1376,rogue,subtlety,63,27,36
Ojibwe,tichondrius,1373,rogue,subtlety,28,15,13
Kolander,tichondrius,1373,rogue,subtlety,58,29,29
Abacura,moon-guard,1364,rogue,subtlety,48,29,19
Ironfistofcn,tichondrius,1364,rogue,subtlety,60,32,28
Techie,frostmane,1363,rogue,subtlety,27,15,12
Mistnazgul,quelthalas,1358,rogue,subtlety,76,43,33
Axiy,stormrage,1357,rogue,subtlety,30,15,15
Odelöt,drakkari,1356,rogue,subtlety,78,43,35
Raymga,tichondrius,1355,rogue,subtlety,48,29,19
Søprøle,ragnaros,1355,rogue,subtlety,86,50,36
Emrogr,tichondrius,1354,rogue,subtlety,66,36,30
Narcoleptic,dalaran,1346,rogue,subtlety,84,40,44
Deadguys,tichondrius,1344,rogue,subtlety,54,25,29
Swanl,stormrage,1343,rogue,subtlety,36,17,19
Pargo,quelthalas,1342,rogue,subtlety,37,18,19
Corrier,tichondrius,1340,rogue,subtlety,24,14,10
Lyfallah,proudmoore,1338,rogue,subtlety,121,66,55
Spacebase,illidan,1337,rogue,subtlety,24,14,10
Tolthe,hyjal,1333,rogue,subtlety,48,21,27
Saltypwncake,illidan,1331,rogue,subtlety,30,14,16
Genève,dreadmaul,1327,rogue,subtlety,24,14,10
Pikabuu,bleeding-hollow,1326,rogue,subtlety,39,16,23
Gankolicious,nerzhul,1317,rogue,subtlety,18,14,4
Lagault,muradin,1316,rogue,subtlety,66,38,28
Tamsy,the-forgotten-coast,1315,rogue,subtlety,21,15,6
Sabedoria,barthilas,1314,rogue,subtlety,77,40,37
Threeplates,silvermoon,1310,rogue,subtlety,30,14,16
Pocketman,barthilas,1299,rogue,subtlety,59,24,35
Tapwaterx,illidan,1299,rogue,subtlety,36,14,22
Skoalr,thrall,1295,rogue,subtlety,28,16,12
Vanvanlords,azralon,1291,rogue,subtlety,32,15,17
Turec,illidan,1290,rogue,subtlety,29,14,15
Ikmagine,icecrown,1281,rogue,subtlety,42,17,25
Täy,thrall,1280,rogue,subtlety,47,23,24
Thugspice,stormrage,1279,rogue,subtlety,53,26,27
Pegglerogue,fizzcrank,1275,rogue,subtlety,56,24,32
Lisnp,tichondrius,1274,rogue,subtlety,200,94,106
Ikerz,tichondrius,1272,rogue,subtlety,27,14,13
Pinksleep,sargeras,1266,rogue,subtlety,48,20,28
Hollfex,nemesis,1265,rogue,subtlety,44,22,22
Pleodonis,tichondrius,1263,rogue,subtlety,45,18,27
Sahima,tichondrius,1262,rogue,subtlety,110,58,52
Lefteex,tichondrius,1260,rogue,subtlety,45,25,20
Gothblade,malganis,1258,rogue,subtlety,30,15,15
Imgunnacrumb,malganis,1249,rogue,subtlety,116,58,58
Tmpikaboo,tichondrius,1248,rogue,subtlety,18,13,5
Howton,kelthuzad,1248,rogue,subtlety,18,13,5
Unshut,tichondrius,1247,rogue,subtlety,18,13,5
Lxke,stormrage,1247,rogue,subtlety,18,13,5
Calebrogue,illidan,1247,rogue,subtlety,18,13,5
Termkilledu,moon-guard,1244,rogue,subtlety,30,18,12
Trc,illidan,1243,rogue,subtlety,24,13,11
Endlesswaltz,zuljin,1243,rogue,subtlety,30,13,17
Prrey,hydraxis,1242,rogue,subtlety,30,13,17
Mcromance,khadgar,1242,rogue,subtlety,54,23,31
Liryth,lightninghoof,1240,rogue,subtlety,39,22,17
Stealthkid,tichondrius,1237,rogue,subtlety,24,13,11
Lululee,tichondrius,1237,rogue,subtlety,36,13,23
Jinglez,frostmourne,1236,rogue,subtlety,18,13,5
Variat,azralon,1235,rogue,subtlety,54,25,29
Oddblade,stormrage,1232,rogue,subtlety,24,14,10
Kawagreen,tichondrius,1232,rogue,subtlety,33,17,16
Shellby,tichondrius,1221,rogue,subtlety,56,29,27
Vaith,wyrmrest-accord,1221,rogue,subtlety,30,13,17
Loquen,ragnaros,1218,rogue,subtlety,24,13,11
Noxik,blackrock,1217,rogue,subtlety,34,19,15
Drsinz,tichondrius,1217,rogue,subtlety,67,28,39
Trâshy,stormrage,1215,rogue,subtlety,25,14,11
Stanley,mugthol,1212,rogue,subtlety,24,13,11
Dessenia,illidan,1208,rogue,subtlety,73,44,29
Mendiant,azralon,1206,rogue,subtlety,24,13,11
Xoltin,tichondrius,1201,rogue,subtlety,68,28,40
Arakine,uldaman,1200,rogue,subtlety,21,14,7
Tigerinu,stormreaver,1194,rogue,subtlety,23,13,10
Kylerxius,korgath,1192,rogue,subtlety,36,21,15
Lilstab,hakkar,1191,rogue,subtlety,104,50,54
Arbitér,moonrunner,1191,rogue,subtlety,58,20,38
Frèyjä,bleeding-hollow,1186,rogue,subtlety,78,39,39
Elmabrox,quelthalas,1183,rogue,subtlety,45,20,25
Roxeni,tichondrius,1181,rogue,subtlety,28,13,15
Eraticrogue,illidan,1178,rogue,subtlety,29,13,16
Abogansterr,ragnaros,1167,rogue,subtlety,78,42,36
Poohpants,frostmourne,1166,rogue,subtlety,71,34,37
Zarkans,proudmoore,1163,rogue,subtlety,30,16,14
Guiguzidr,illidan,1159,rogue,subtlety,48,24,24
Mirajoo,tichondrius,1157,rogue,subtlety,64,27,37
Gyrfalcon,spirestone,1156,rogue,subtlety,154,72,82
Paulpitation,blood-furnace,1155,rogue,subtlety,39,15,24
Antos,tichondrius,1152,rogue,subtlety,18,12,6
Håkünämãtåtä,stormrage,1152,rogue,subtlety,18,12,6
Bèstworld,dalaran,1152,rogue,subtlety,24,12,12
Vendettita,quelthalas,1151,rogue,subtlety,18,12,6
Esky,tichondrius,1151,rogue,subtlety,24,12,12
Onîkudaki,sargeras,1151,rogue,subtlety,30,12,18
Stealthyxd,arthas,1150,rogue,subtlety,36,12,24
Itskanashi,frostmourne,1148,rogue,subtlety,69,30,39
Smormu,bonechewer,1144,rogue,subtlety,24,12,12
Oilydaimon,tichondrius,1143,rogue,subtlety,61,29,32
Rigotak,illidan,1139,rogue,subtlety,24,12,12
Smashol,barthilas,1136,rogue,subtlety,54,23,31
Micromoon,windrunner,1131,rogue,subtlety,36,13,23
Draculà,wyrmrest-accord,1130,rogue,subtlety,30,17,13
Vangroen,quelthalas,1129,rogue,subtlety,24,14,10
Hypermix,tichondrius,1129,rogue,subtlety,24,12,12
Miraclesap,stormrage,1127,rogue,subtlety,82,48,34
Meer,balnazzar,1125,rogue,subtlety,34,24,10
Dustt,stormrage,1125,rogue,subtlety,18,12,6
Doklim,spinebreaker,1122,rogue,subtlety,74,42,32
Cutthroat,aegwynn,1121,rogue,subtlety,45,20,25
Jeri,gundrak,1113,rogue,subtlety,30,17,13
Drapezz,kelthuzad,1110,rogue,subtlety,29,16,13
Humphugull,skullcrusher,1108,rogue,subtlety,35,12,23
Venace,agamaggan,1104,rogue,subtlety,23,12,11
Jadier,emerald-dream,1103,rogue,subtlety,23,12,11
Prisonshank,arthas,1093,rogue,subtlety,61,36,25
Santyno,ragnaros,1085,rogue,subtlety,114,54,60
Noriel,dathremar,1085,rogue,subtlety,30,13,17
Jaanmonty,frostmourne,1081,rogue,subtlety,24,12,12
Hotcarl,kiljaeden,1077,rogue,subtlety,28,14,14
Riskgo,frostwolf,1071,rogue,subtlety,24,12,12
Vanishman,ragnaros,1063,rogue,subtlety,24,12,12
Larmx,tichondrius,1056,rogue,subtlety,12,11,1
Sixcombopts,area-52,1056,rogue,subtlety,18,11,7
Queuethunder,blades-edge,1055,rogue,subtlety,12,11,1
Ozzinton,kelthuzad,1055,rogue,subtlety,18,11,7
Esmeraldas,frostmourne,1054,rogue,subtlety,18,11,7
Tootsio,tichondrius,1054,rogue,subtlety,18,11,7
Rabe,nagrand,1053,rogue,subtlety,24,11,13
Ninetaildfox,arthas,1051,rogue,subtlety,18,11,7
Yanh,tichondrius,1051,rogue,subtlety,24,11,13
Brangs,ragnaros,1050,rogue,subtlety,18,11,7
Corntens,area-52,1050,rogue,subtlety,20,11,9
Négrá,ragnaros,1048,rogue,subtlety,18,11,7
Trolladrão,goldrinn,1048,rogue,subtlety,24,11,13
Ðarkrøøxs,stormrage,1048,rogue,subtlety,24,11,13
Laotrec,nemesis,1045,rogue,subtlety,33,12,21
Olg,arathor,1043,rogue,subtlety,71,36,35
Hyperdexia,stormrage,1042,rogue,subtlety,88,47,41
Orangez,malfurion,1040,rogue,subtlety,18,11,7
Soulvex,barthilas,1040,rogue,subtlety,18,11,7
Abaløne,tichondrius,1037,rogue,subtlety,55,22,33
Undreas,kiljaeden,1035,rogue,subtlety,193,97,96
Kaminokage,barthilas,1035,rogue,subtlety,33,12,21
Shadownibba,illidan,1032,rogue,subtlety,36,18,18
Kachimodo,illidan,1029,rogue,subtlety,42,20,22
Ambushr,tichondrius,1028,rogue,subtlety,18,11,7
Sneakyshots,emerald-dream,1017,rogue,subtlety,13,11,2
Slackness,bleeding-hollow,1015,rogue,subtlety,61,35,26
Nadari,cenarius,1015,rogue,subtlety,30,13,17
Fateapocryph,azralon,1014,rogue,subtlety,26,13,13
Korviz,area-52,1008,rogue,subtlety,60,30,30
Bloodwish,tichondrius,1007,rogue,subtlety,23,11,12
Ghost,shattered-halls,1006,rogue,subtlety,68,27,41
Log,blackhand,1004,rogue,subtlety,36,18,18
Relidria,thrall,1002,rogue,subtlety,30,18,12
Feragho,tichondrius,992,rogue,subtlety,34,11,23
Sadtears,thrall,990,rogue,subtlety,16,11,5
Weenies,illidan,989,rogue,subtlety,17,11,6
Jalaroot,frostmourne,985,rogue,subtlety,23,13,10
Bubblesr,whisperwind,980,rogue,subtlety,48,22,26
Lesliechow,sargeras,967,rogue,subtlety,52,28,24
Ascherx,veknilash,960,rogue,subtlety,12,10,2
Scuffedsr,tichondrius,960,rogue,subtlety,12,10,2
Æsshayádlay,tichondrius,960,rogue,subtlety,24,10,14
Eazyg,tichondrius,959,rogue,subtlety,18,10,8
Spaca,kelthuzad,959,rogue,subtlety,18,10,8
Zaszune,stormrage,958,rogue,subtlety,18,10,8
Lucki,tichondrius,958,rogue,subtlety,18,10,8
Harkknight,sargeras,958,rogue,subtlety,104,53,51
Aszombie,tichondrius,957,rogue,subtlety,12,10,2
Stuntedscamp,bleeding-hollow,957,rogue,subtlety,24,10,14
Shilaya,dreadmaul,957,rogue,subtlety,24,10,14
Géminis,sargeras,956,rogue,subtlety,18,10,8
Reclusivexo,tichondrius,956,rogue,subtlety,24,10,14
Înfêrnô,emerald-dream,955,rogue,subtlety,24,10,14
Kilrogga,azshara,953,rogue,subtlety,24,12,12
Topapple,mugthol,952,rogue,subtlety,24,11,13
Moufwash,sargeras,952,rogue,subtlety,24,10,14
Onara,quelthalas,929,rogue,subtlety,24,12,12
Swayo,tichondrius,920,rogue,subtlety,18,10,8
Toe,boulderfist,912,rogue,subtlety,27,13,14
Rarkalth,azralon,907,rogue,subtlety,35,10,25
Silentmoralz,tichondrius,903,rogue,subtlety,35,10,25
Skallywagg,emerald-dream,902,rogue,subtlety,46,18,28
Linkzq,frostmourne,895,rogue,subtlety,23,10,13
Sxs,kiljaeden,878,rogue,subtlety,23,10,13
Bimbogirl,dalaran,865,rogue,subtlety,22,11,11
Yodiegang,tichondrius,864,rogue,subtlety,12,9,3
Votekanye,bleeding-hollow,864,rogue,subtlety,12,9,3
Zeiss,tichondrius,864,rogue,subtlety,18,9,9
Ðankbud,barthilas,864,rogue,subtlety,21,10,11
Ideology,azgalor,864,rogue,subtlety,24,9,15
Acid,warsong,863,rogue,subtlety,12,9,3
Illoo,frostmourne,863,rogue,subtlety,18,9,9
ßeep,windrunner,863,rogue,subtlety,18,9,9
Proddivus,stormrage,863,rogue,subtlety,30,9,21
Neilyo,barthilas,862,rogue,subtlety,18,9,9
Hattorikun,proudmoore,862,rogue,subtlety,18,9,9
Twotimed,magtheridon,862,rogue,subtlety,18,9,9
Poolover,barthilas,862,rogue,subtlety,18,9,9
Mermm,burning-blade,862,rogue,subtlety,18,9,9
Cosmicò,trollbane,861,rogue,subtlety,12,9,3
Blitzree,thrall,861,rogue,subtlety,12,9,3
Lanres,stormrage,860,rogue,subtlety,12,9,3
Biggisdiggis,tichondrius,860,rogue,subtlety,12,9,3
Dionavelynn,area-52,860,rogue,subtlety,18,9,9
Raqed,eredar,860,rogue,subtlety,18,9,9
Lozion,malganis,860,rogue,subtlety,24,9,15
Overzz,azralon,859,rogue,subtlety,21,9,12
Gannjalord,frostmane,858,rogue,subtlety,22,10,12
Harlyfknquin,jubeithos,857,rogue,subtlety,18,9,9
Jhors,tichondrius,856,rogue,subtlety,18,9,9
Esker,dragonmaw,854,rogue,subtlety,18,9,9
Suñg,tichondrius,854,rogue,subtlety,24,9,15
Macsap,frostmourne,850,rogue,subtlety,24,9,15
Alexon,wyrmrest-accord,848,rogue,subtlety,72,30,42
Dizzm,area-52,847,rogue,subtlety,12,9,3
Revelationzz,turalyon,846,rogue,subtlety,16,10,6
Aelnoor,ragnaros,846,rogue,subtlety,24,9,15
Ayo,exodar,845,rogue,subtlety,18,9,9
Cutindle,illidan,842,rogue,subtlety,18,9,9
Elßronkas,quelthalas,836,rogue,subtlety,48,21,27
Zamji,tichondrius,834,rogue,subtlety,20,9,11
Yellowdeep,tichondrius,831,rogue,subtlety,14,10,4
Trillkage,tichondrius,797,rogue,subtlety,26,9,17
Hahaurblind,perenolde,796,rogue,subtlety,22,9,13
Redtvco,blackrock,789,rogue,subtlety,17,9,8
Fearnomore,destromath,783,rogue,subtlety,66,23,43
Asoj,tichondrius,768,rogue,subtlety,12,8,4
Wîzz,bleeding-hollow,768,rogue,subtlety,12,8,4
Originalfake,sargeras,768,rogue,subtlety,12,8,4
Czd,frostmourne,768,rogue,subtlety,12,8,4
Nicørøbin,tichondrius,768,rogue,subtlety,12,8,4
Lesty,kelthuzad,768,rogue,subtlety,12,8,4
Decóm,zuljin,768,rogue,subtlety,16,9,7
Köfy,quelthalas,768,rogue,subtlety,17,8,9
Shreddér,tichondrius,768,rogue,subtlety,18,8,10
Hiyõ,tichondrius,768,rogue,subtlety,18,8,10
Rooke,draktharon,768,rogue,subtlety,18,8,10
Taidath,area-52,768,rogue,subtlety,18,8,10
Getfkdkid,tichondrius,768,rogue,subtlety,24,8,16
Donnice,area-52,767,rogue,subtlety,12,8,4
Kiingspade,tichondrius,767,rogue,subtlety,12,8,4
Nítzy,quelthalas,767,rogue,subtlety,18,8,10
Ilesire,frostmourne,767,rogue,subtlety,18,8,10
Chancelör,illidan,766,rogue,subtlety,12,8,4
Razmir,malfurion,766,rogue,subtlety,18,8,10
Bríng,illidan,764,rogue,subtlety,12,8,4
Yato,mugthol,764,rogue,subtlety,12,8,4
Subtlepuddle,bleeding-hollow,764,rogue,subtlety,24,8,16
Vexyz,tichondrius,763,rogue,subtlety,18,8,10
Sildin,sargeras,762,rogue,subtlety,12,8,4
Defaces,illidan,762,rogue,subtlety,12,8,4
Abatoire,wyrmrest-accord,762,rogue,subtlety,18,8,10
Khorgan,mugthol,762,rogue,subtlety,24,8,16
Shivlightnin,tichondrius,762,rogue,subtlety,24,8,16
Ricros,bleeding-hollow,760,rogue,subtlety,20,10,10
Mhasto,azralon,759,rogue,subtlety,18,8,10
Kerimoynihan,barthilas,757,rogue,subtlety,28,11,17
Aynrand,drakkari,757,rogue,subtlety,29,8,21
Nijanari,wyrmrest-accord,754,rogue,subtlety,24,8,16
Bladefang,quelthalas,732,rogue,subtlety,17,10,7
Wimpz,hyjal,672,rogue,subtlety,12,7,5
Flaremagnet,whisperwind,672,rogue,subtlety,12,7,5
Sandorroguee,stormrage,672,rogue,subtlety,12,7,5
Joeyzord,stormrage,672,rogue,subtlety,12,7,5
Bobfoonk,tichondrius,672,rogue,subtlety,12,7,5
Coughsyrup,sargeras,672,rogue,subtlety,12,7,5
Xvds,tichondrius,672,rogue,subtlety,12,7,5
Frooty,stormrage,672,rogue,subtlety,12,7,5
Àsgà,area-52,672,rogue,subtlety,12,7,5
Feyahni,wyrmrest-accord,672,rogue,subtlety,12,7,5
Bloodyhairy,area-52,672,rogue,subtlety,12,7,5
Spytes,kiljaeden,672,rogue,subtlety,18,7,11
Memoríst,frostmourne,672,rogue,subtlety,18,7,11
Misthios,chogall,672,rogue,subtlety,18,7,11
Clicksbtns,area-52,672,rogue,subtlety,18,7,11
Niwbor,azralon,672,rogue,subtlety,24,7,17
Keepitshadow,frostmourne,671,rogue,subtlety,12,7,5
Kazzo,tichondrius,671,rogue,subtlety,12,7,5
Liquidmojo,tichondrius,671,rogue,subtlety,12,7,5
Darkìs,tichondrius,671,rogue,subtlety,12,7,5
Gatõ,quelthalas,671,rogue,subtlety,12,7,5
Christiaan,area-52,671,rogue,subtlety,12,7,5
Nezumikami,malganis,671,rogue,subtlety,18,7,11
Felistrien,wyrmrest-accord,671,rogue,subtlety,18,7,11
Brilliance,skywall,671,rogue,subtlety,18,7,11
Sapzz,tichondrius,671,rogue,subtlety,18,7,11
Jdmg,azralon,670,rogue,subtlety,12,7,5
Takamoto,windrunner,670,rogue,subtlety,18,7,11
Rykojin,sargeras,669,rogue,subtlety,12,7,5
Anteccessor,tichondrius,669,rogue,subtlety,18,7,11
Deathben,tichondrius,669,rogue,subtlety,24,7,17
Jagó,malganis,667,rogue,subtlety,12,7,5
Chompycat,tichondrius,667,rogue,subtlety,18,7,11
Srmazakre,ragnaros,667,rogue,subtlety,18,7,11
Dogedealer,ragnaros,665,rogue,subtlety,12,7,5
Kody,dalaran,639,rogue,subtlety,17,7,10
Lilshanker,tichondrius,617,rogue,subtlety,22,8,14
Mhün,malganis,607,rogue,subtlety,16,7,9
Gptcodeplay,tichondrius,576,rogue,subtlety,6,6,0
Caldø,tichondrius,576,rogue,subtlety,6,6,0
Deadshank,bleeding-hollow,576,rogue,subtlety,6,6,0
Homarx,quelthalas,576,rogue,subtlety,10,7,3
Popss,whisperwind,576,rogue,subtlety,12,6,6
Lymon,azralon,576,rogue,subtlety,12,6,6
Nihue,terenas,576,rogue,subtlety,12,6,6
Candren,area-52,576,rogue,subtlety,12,6,6
Shadxr,tichondrius,576,rogue,subtlety,12,6,6
Topfloorboss,illidan,576,rogue,subtlety,12,6,6
Vlone,icecrown,576,rogue,subtlety,12,6,6
Palumor,deathwing,576,rogue,subtlety,12,6,6
Unholydood,bonechewer,576,rogue,subtlety,12,6,6
Pamaaj,sargeras,576,rogue,subtlety,12,6,6
Kindasorry,illidan,576,rogue,subtlety,12,6,6
Fkq,emerald-dream,576,rogue,subtlety,12,6,6
Littlescrub,frostmourne,576,rogue,subtlety,12,6,6
Xedi,illidan,576,rogue,subtlety,12,6,6
Revila,bleeding-hollow,576,rogue,subtlety,12,6,6
Jannie,rexxar,576,rogue,subtlety,12,6,6
Tmpikaboo,mugthol,576,rogue,subtlety,12,6,6
Cinnashank,darkspear,576,rogue,subtlety,18,6,12
Goopthicc,sargeras,576,rogue,subtlety,18,6,12
Kents,tichondrius,576,rogue,subtlety,18,6,12
Drakariano,ragnaros,576,rogue,subtlety,18,6,12
Swippz,tichondrius,576,rogue,subtlety,18,6,12
Struggle,sargeras,576,rogue,subtlety,24,6,18
Jácket,area-52,576,rogue,subtlety,24,6,18
Whothekilla,tichondrius,575,rogue,subtlety,12,6,6
Mcnastier,dunemaul,575,rogue,subtlety,12,6,6
Gank,jubeithos,575,rogue,subtlety,12,6,6
Jinxkiller,tichondrius,575,rogue,subtlety,12,6,6
Maulgryve,frostwolf,575,rogue,subtlety,12,6,6
Hiarolson,stormrage,575,rogue,subtlety,12,6,6
Krolczz,tichondrius,575,rogue,subtlety,12,6,6
Calvin,moon-guard,575,rogue,subtlety,12,6,6
Superharry,tichondrius,575,rogue,subtlety,12,6,6
Zogbu,stormrage,575,rogue,subtlety,18,6,12
Ballflicker,malganis,575,rogue,subtlety,18,6,12
Dreamcatcher,azralon,575,rogue,subtlety,18,6,12
Poofus,vashj,575,rogue,subtlety,18,6,12
Alttee,proudmoore,573,rogue,subtlety,12,6,6
Iapologize,area-52,572,rogue,subtlety,12,6,6
Xylow,garona,571,rogue,subtlety,27,6,21
Degrok,quelthalas,568,rogue,subtlety,12,6,6
Confianzudo,ragnaros,567,rogue,subtlety,18,6,12
Hmmkek,frostmourne,527,rogue,subtlety,11,6,5
Zelthy,frostmourne,510,rogue,subtlety,11,6,5
Yurasick,lightbringer,480,rogue,subtlety,6,5,1
Towncar,kelthuzad,480,rogue,subtlety,6,5,1
Kwins,cenarion-circle,480,rogue,subtlety,6,5,1
Oceboomer,frostmourne,480,rogue,subtlety,6,5,1
Deepsyo,frostmourne,480,rogue,subtlety,6,5,1
Ghoarie,sargeras,480,rogue,subtlety,6,5,1
Tmskitsou,tichondrius,480,rogue,subtlety,10,6,4
Monkeykongr,lightnings-blade,480,rogue,subtlety,12,5,7
Filid,frostmourne,480,rogue,subtlety,12,5,7
Wooluncle,tichondrius,480,rogue,subtlety,12,5,7
Uchihaputin,tichondrius,480,rogue,subtlety,12,5,7
Atulano,wyrmrest-accord,480,rogue,subtlety,12,5,7
Milafortnite,tichondrius,480,rogue,subtlety,12,5,7
Xandroesh,darkspear,480,rogue,subtlety,12,5,7
Henya,magtheridon,480,rogue,subtlety,12,5,7
Blakezillax,tichondrius,480,rogue,subtlety,12,5,7
Danielsylerr,drakkari,480,rogue,subtlety,12,5,7
Pwnsauce,frostmourne,480,rogue,subtlety,12,5,7
Scrubzz,barthilas,480,rogue,subtlety,12,5,7
Defthands,tichondrius,480,rogue,subtlety,12,5,7
Blinky,blades-edge,480,rogue,subtlety,12,5,7
Wowcode,tichondrius,480,rogue,subtlety,12,5,7
Grinjuk,area-52,480,rogue,subtlety,12,5,7
Pjh,sargeras,480,rogue,subtlety,12,5,7
Orihimesz,azralon,480,rogue,subtlety,12,5,7
Jon,the-venture-co,480,rogue,subtlety,12,5,7
Clayton,frostmourne,480,rogue,subtlety,12,5,7
Killdrunk,stormrage,480,rogue,subtlety,12,5,7
Twnice,tichondrius,480,rogue,subtlety,12,5,7
Chimpo,ravencrest,480,rogue,subtlety,12,5,7
Tiladar,tichondrius,480,rogue,subtlety,12,5,7
Liqwid,stormrage,480,rogue,subtlety,12,5,7
Arsènè,whisperwind,480,rogue,subtlety,13,5,8
Faelanna,stormrage,480,rogue,subtlety,13,5,8
Reinaldojr,azralon,480,rogue,subtlety,18,5,13
Vex,durotan,480,rogue,subtlety,18,5,13
Psychostabby,tichondrius,480,rogue,subtlety,18,5,13
Greasymario,kelthuzad,480,rogue,subtlety,18,5,13
Tekrul,area-52,480,rogue,subtlety,24,5,19
Zitihait,amanthul,479,rogue,subtlety,6,5,1
Stêf,zuljin,479,rogue,subtlety,6,5,1
Catoline,bleeding-hollow,479,rogue,subtlety,12,5,7
Toodlles,stormrage,479,rogue,subtlety,12,5,7
Qlog,tichondrius,479,rogue,subtlety,12,5,7
Arÿaa,azralon,479,rogue,subtlety,12,5,7
Kekdasneak,dragonmaw,479,rogue,subtlety,18,5,13
Abdullahh,tichondrius,478,rogue,subtlety,12,5,7
Smokepipe,nerzhul,478,rogue,subtlety,12,5,7
Falra,wyrmrest-accord,478,rogue,subtlety,18,5,13
Hattrìck,area-52,478,rogue,subtlety,18,5,13
Indivisible,thunderlord,477,rogue,subtlety,12,5,7
Liamoz,amanthul,475,rogue,subtlety,12,5,7
Fingolfin,terenas,447,rogue,subtlety,11,5,6
Backtoch,sargeras,447,rogue,subtlety,11,5,6
Arwy,stormrage,447,rogue,subtlety,11,5,6
Pangppy,tichondrius,431,rogue,subtlety,11,5,6
Sketchyweas,sargeras,426,rogue,subtlety,14,6,8
Cayladin,tichondrius,416,rogue,subtlety,10,5,5
Luriél,stormrage,415,rogue,subtlety,10,5,5
Deadopps,stormrage,384,rogue,subtlety,6,4,2
Xemnxnt,stormrage,384,rogue,subtlety,6,4,2
Foreverioi,tichondrius,384,rogue,subtlety,6,4,2
Coldkill,bleeding-hollow,384,rogue,subtlety,6,4,2
Evasionx,tichondrius,384,rogue,subtlety,6,4,2
Nines,icecrown,384,rogue,subtlety,6,4,2
Chauva,zuljin,384,rogue,subtlety,6,4,2
Sapntapx,malganis,384,rogue,subtlety,6,4,2
Invokesap,area-52,384,rogue,subtlety,6,4,2
Prepcoin,malganis,384,rogue,subtlety,6,4,2
Malgoria,tichondrius,384,rogue,subtlety,6,4,2
Brocolini,zuljin,384,rogue,subtlety,6,4,2
Donpeon,hellscream,384,rogue,subtlety,6,4,2
Suggmadi,stormrage,384,rogue,subtlety,6,4,2
Bootimus,illidan,384,rogue,subtlety,6,4,2
Wrldstars,illidan,384,rogue,subtlety,6,4,2
Memnõch,emerald-dream,384,rogue,subtlety,6,4,2
Astutý,illidan,384,rogue,subtlety,6,4,2
Unoshade,illidan,384,rogue,subtlety,6,4,2
Sinary,cenarion-circle,384,rogue,subtlety,6,4,2
Exacerbatê,mannoroth,384,rogue,subtlety,6,4,2
Seerenai,moon-guard,384,rogue,subtlety,6,4,2
Thèllè,sargeras,384,rogue,subtlety,6,4,2
Siyeong,tichondrius,384,rogue,subtlety,6,4,2
Smang,mugthol,384,rogue,subtlety,6,4,2
Qq,doomhammer,384,rogue,subtlety,6,4,2
ßackshots,kelthuzad,384,rogue,subtlety,6,4,2
Nightcloud,tichondrius,384,rogue,subtlety,6,4,2
Dåve,tichondrius,384,rogue,subtlety,6,4,2
Altaureen,thrall,384,rogue,subtlety,6,4,2
Gøblìn,tichondrius,384,rogue,subtlety,12,4,8
Seutobinhaa,stormrage,384,rogue,subtlety,12,4,8
Zzffqsm,tichondrius,384,rogue,subtlety,12,4,8
Morpheûs,tichondrius,384,rogue,subtlety,12,4,8
Flankks,sargeras,384,rogue,subtlety,12,4,8
Freshcakes,darkspear,384,rogue,subtlety,12,4,8
Blackstabyth,thrall,384,rogue,subtlety,12,4,8
ßaltø,bleeding-hollow,384,rogue,subtlety,12,4,8
Muggzy,emerald-dream,384,rogue,subtlety,12,4,8
Twinkasz,nemesis,384,rogue,subtlety,12,4,8
Miamiganster,lothar,384,rogue,subtlety,12,4,8
Ntshaav,illidan,384,rogue,subtlety,12,4,8
Elishadowed,proudmoore,384,rogue,subtlety,12,4,8
Restinpeacex,bleeding-hollow,384,rogue,subtlety,12,4,8
Tàlion,emerald-dream,384,rogue,subtlety,12,4,8
Lazaruslong,stormrage,384,rogue,subtlety,12,4,8
Mercaderps,frostmourne,384,rogue,subtlety,12,4,8
Oksanaastan,tichondrius,384,rogue,subtlety,18,4,14
Schnozz,lightbringer,383,rogue,subtlety,6,4,2
Freego,quelthalas,383,rogue,subtlety,6,4,2
Betrayerz,darkspear,383,rogue,subtlety,12,4,8
Ràinê,dalaran,383,rogue,subtlety,12,4,8
Hènnéssy,frostmourne,383,rogue,subtlety,12,4,8
Maewyn,aerie-peak,383,rogue,subtlety,13,4,9
Toxiccarnage,ghostlands,383,rogue,subtlety,14,4,10
Shadowpunx,nemesis,382,rogue,subtlety,6,4,2
Knife,moon-guard,381,rogue,subtlety,12,4,8
Jjp,tichondrius,367,rogue,subtlety,11,4,7
Sinice,draka,351,rogue,subtlety,8,5,3
Samuraii,zuljin,335,rogue,subtlety,11,4,7
Idsapdat,illidan,330,rogue,subtlety,9,6,3
Peeryl,daggerspine,327,rogue,subtlety,15,5,10
Rawdawged,illidan,320,rogue,subtlety,16,4,12
Grima,azralon,319,rogue,subtlety,14,4,10
Shadowreapz,barthilas,288,rogue,subtlety,6,3,3
Roguish,kiljaeden,288,rogue,subtlety,6,3,3
Dìngapoof,tichondrius,288,rogue,subtlety,6,3,3
Antijax,stormrage,288,rogue,subtlety,6,3,3
Castsequence,khaz-modan,288,rogue,subtlety,6,3,3
Schneric,stormrage,288,rogue,subtlety,6,3,3
Hemorrhages,tichondrius,288,rogue,subtlety,6,3,3
Yamillpgk,ragnaros,288,rogue,subtlety,6,3,3
Støné,azjolnerub,288,rogue,subtlety,6,3,3
Junemylove,tichondrius,288,rogue,subtlety,6,3,3
Raidei,elune,288,rogue,subtlety,6,3,3
Anbuartist,dalaran,288,rogue,subtlety,6,3,3
Gongarn,thrall,288,rogue,subtlety,6,3,3
Ãnimefãnx,moon-guard,288,rogue,subtlety,6,3,3
Vellkann,azralon,288,rogue,subtlety,6,3,3
Leftyleaf,proudmoore,288,rogue,subtlety,6,3,3
Stunjunky,area-52,288,rogue,subtlety,6,3,3
Sinfate,bleeding-hollow,288,rogue,subtlety,6,3,3
Isonlydosex,tichondrius,288,rogue,subtlety,6,3,3
Yurkarogue,tichondrius,288,rogue,subtlety,6,3,3
Luolan,kargath,288,rogue,subtlety,6,3,3
Metalz,exodar,288,rogue,subtlety,6,3,3
Screwzx,tichondrius,288,rogue,subtlety,6,3,3
Sit,frostwolf,288,rogue,subtlety,6,3,3
Creayuncle,area-52,288,rogue,subtlety,6,3,3
Amatoxin,tichondrius,288,rogue,subtlety,6,3,3
Gåñðøñ,stormscale,288,rogue,subtlety,6,3,3
Reverel,tichondrius,288,rogue,subtlety,6,3,3
Snackable,tichondrius,288,rogue,subtlety,6,3,3
Thargal,tichondrius,288,rogue,subtlety,6,3,3
Zurza,proudmoore,288,rogue,subtlety,6,3,3
Dödoubleg,stormrage,288,rogue,subtlety,6,3,3
Ralæriel,wyrmrest-accord,288,rogue,subtlety,6,3,3
Zarrth,malganis,288,rogue,subtlety,6,3,3
Draiygo,nerzhul,288,rogue,subtlety,6,3,3
Zefeckz,tichondrius,288,rogue,subtlety,6,3,3
Tonjuras,uther,288,rogue,subtlety,6,3,3
Cron,arygos,288,rogue,subtlety,6,3,3
Saulgoodz,tichondrius,288,rogue,subtlety,6,3,3
Bumboklaat,bleeding-hollow,288,rogue,subtlety,6,3,3
Commodore,arthas,288,rogue,subtlety,6,3,3
Taraminkadot,sargeras,288,rogue,subtlety,9,4,5
Siniel,scarlet-crusade,288,rogue,subtlety,9,4,5
ßutthead,malganis,288,rogue,subtlety,7,3,4
Veatrix,zuljin,288,rogue,subtlety,12,3,9
Yülia,skywall,288,rogue,subtlety,12,3,9
Bumpamoose,aggramar,288,rogue,subtlety,12,3,9
Maløkeirø,stormrage,288,rogue,subtlety,12,3,9
Terala,perenolde,288,rogue,subtlety,12,3,9
Corchô,moon-guard,288,rogue,subtlety,12,3,9
Yottsu,proudmoore,288,rogue,subtlety,12,3,9
Grinz,sargeras,288,rogue,subtlety,12,3,9
Zapersapp,malygos,288,rogue,subtlety,12,3,9
Hogstradamus,malganis,288,rogue,subtlety,12,3,9
Jexy,barthilas,288,rogue,subtlety,12,3,9
Miloandotis,malganis,288,rogue,subtlety,12,3,9
Carpe,barthilas,288,rogue,subtlety,12,3,9
Relaxsingh,tichondrius,288,rogue,subtlety,18,3,15
Wolfmans,trollbane,287,rogue,subtlety,6,3,3
Framsteg,kelthuzad,287,rogue,subtlety,6,3,3
Witherblade,area-52,287,rogue,subtlety,6,3,3
Urukzog,ragnaros,287,rogue,subtlety,6,3,3
Minnicent,amanthul,287,rogue,subtlety,18,3,15
Cerebrian,malygos,286,rogue,subtlety,6,3,3
Tareduwu,area-52,286,rogue,subtlety,18,3,15
Samllnuts,area-52,285,rogue,subtlety,12,3,9
Notlim,azralon,240,rogue,subtlety,9,3,6
Wulfcrest,moon-guard,239,rogue,subtlety,5,3,2
Uncleblinker,proudmoore,239,rogue,subtlety,5,3,2
Youngdraco,tichondrius,239,rogue,subtlety,5,3,2
Radagon,fenris,234,rogue,subtlety,9,4,5
Dogpaws,moon-guard,192,rogue,subtlety,4,3,1
Tigbits,frostmourne,192,rogue,subtlety,9,3,6
Jsnlol,zuljin,192,rogue,subtlety,6,2,4
ßecomeðeath,tichondrius,192,rogue,subtlety,6,2,4
Mãtthew,tichondrius,192,rogue,subtlety,6,2,4
Smakkey,tichondrius,192,rogue,subtlety,6,2,4
Boredomkills,frostmane,192,rogue,subtlety,6,2,4
Sathrion,zuljin,192,rogue,subtlety,6,2,4
Yourhomieaj,tichondrius,192,rogue,subtlety,6,2,4
Meadview,bleeding-hollow,192,rogue,subtlety,6,2,4
Sapsis,shandris,192,rogue,subtlety,6,2,4
Nubes,illidan,192,rogue,subtlety,6,2,4
Pootymunchin,daggerspine,192,rogue,subtlety,6,2,4
Draef,illidan,192,rogue,subtlety,6,2,4
Toomuchcap,aggramar,192,rogue,subtlety,6,2,4
Teribád,area-52,192,rogue,subtlety,6,2,4
Elvesnknives,stormrage,192,rogue,subtlety,6,2,4
Jujudaddy,sargeras,192,rogue,subtlety,6,2,4
Smolblade,nordrassil,192,rogue,subtlety,6,2,4
Kami,kelthuzad,192,rogue,subtlety,6,2,4
Runescape,frostmourne,192,rogue,subtlety,6,2,4
Heegawn,proudmoore,192,rogue,subtlety,6,2,4
Badonka,aggramar,192,rogue,subtlety,6,2,4
Xyltann,bleeding-hollow,192,rogue,subtlety,6,2,4
Antmang,bleeding-hollow,192,rogue,subtlety,6,2,4
Chêckmatê,darkspear,192,rogue,subtlety,6,2,4
Wyyre,hyjal,192,rogue,subtlety,6,2,4
Gzl,frostmourne,192,rogue,subtlety,6,2,4
Shankmcganks,chogall,192,rogue,subtlety,6,2,4
Stateless,kelthuzad,192,rogue,subtlety,6,2,4
Surplus,stormscale,192,rogue,subtlety,6,2,4
Notty,kelthuzad,192,rogue,subtlety,6,2,4
Reflexiv,malganis,192,rogue,subtlety,6,2,4
Pouet,caelestrasz,192,rogue,subtlety,6,2,4
Lmorningstar,altar-of-storms,192,rogue,subtlety,6,2,4
Joegamer,sargeras,192,rogue,subtlety,6,2,4
Jeezy,shadowmoon,192,rogue,subtlety,6,2,4
Wètdream,sargeras,192,rogue,subtlety,6,2,4
Söda,emerald-dream,192,rogue,subtlety,6,2,4
Slycndice,tortheldrin,192,rogue,subtlety,6,2,4
Picaropanda,quelthalas,192,rogue,subtlety,6,2,4
Dions,ragnaros,192,rogue,subtlety,6,2,4
Coalie,tichondrius,192,rogue,subtlety,6,2,4
Nemoye,tichondrius,192,rogue,subtlety,6,2,4
Grue,gundrak,192,rogue,subtlety,6,2,4
Åaron,thrall,192,rogue,subtlety,6,2,4
Macklittle,area-52,192,rogue,subtlety,6,2,4
Slíçk,tichondrius,192,rogue,subtlety,6,2,4
Lennysnephew,tichondrius,192,rogue,subtlety,6,2,4
Tothegravetv,sargeras,192,rogue,subtlety,6,2,4
Kahlx,azralon,192,rogue,subtlety,6,2,4
Brustent,icecrown,192,rogue,subtlety,6,2,4
Lenik,azuremyst,192,rogue,subtlety,6,2,4
Nlynn,veknilash,192,rogue,subtlety,6,2,4
Letsgobranon,sargeras,192,rogue,subtlety,6,2,4
Rehze,area-52,192,rogue,subtlety,6,2,4
Jâm,nerzhul,192,rogue,subtlety,6,2,4
Faxingberlin,skullcrusher,192,rogue,subtlety,6,2,4
Sneakyt,shadow-council,192,rogue,subtlety,6,2,4
Terrorstrike,tichondrius,192,rogue,subtlety,6,2,4
Buddymelon,thrall,192,rogue,subtlety,6,2,4
Tìlt,whisperwind,192,rogue,subtlety,6,2,4
Skorsh,wyrmrest-accord,192,rogue,subtlety,6,2,4
Skitsöu,tichondrius,192,rogue,subtlety,6,2,4
Bambooßobby,area-52,192,rogue,subtlety,6,2,4
Icantsleep,tichondrius,192,rogue,subtlety,6,2,4
Xenitech,bleeding-hollow,192,rogue,subtlety,8,2,6
Bâerâ,bloodscalp,192,rogue,subtlety,8,2,6
Flèè,illidan,192,rogue,subtlety,12,2,10
Mitchrogue,barthilas,192,rogue,subtlety,12,2,10
Trinktick,doomhammer,192,rogue,subtlety,12,2,10
Krius,blood-furnace,192,rogue,subtlety,12,2,10
Ezmate,frostmourne,192,rogue,subtlety,12,2,10
Brickjohnson,illidan,192,rogue,subtlety,12,2,10
Barmiah,stormrage,192,rogue,subtlety,12,2,10
Cerel,baelgun,192,rogue,subtlety,12,2,10
Glíz,bloodscalp,192,rogue,subtlety,12,2,10
Zeriek,stormrage,192,rogue,subtlety,12,2,10
Kidcudi,bonechewer,192,rogue,subtlety,12,2,10
Onulyo,tichondrius,192,rogue,subtlety,12,2,10
Kestor,barthilas,192,rogue,subtlety,12,2,10
Zabava,malganis,192,rogue,subtlety,12,2,10
Mccarter,bonechewer,191,rogue,subtlety,6,2,4
Allirra,ragnaros,191,rogue,subtlety,6,2,4
Lancarlorïus,ragnaros,191,rogue,subtlety,6,2,4
Eliasael,moon-guard,159,rogue,subtlety,5,2,3
Suhwooh,area-52,159,rogue,subtlety,5,2,3
Koobbo,tichondrius,159,rogue,subtlety,5,2,3
Opensap,tichondrius,159,rogue,subtlety,5,2,3
Ganksterqt,dentarg,138,rogue,subtlety,10,3,7
Mdrogue,sargeras,128,rogue,subtlety,4,2,2
Cheapdeal,frostmourne,128,rogue,subtlety,4,2,2
Fadedx,darkspear,128,rogue,subtlety,4,2,2
Namig,cenarion-circle,128,rogue,subtlety,4,2,2
Swickwockdus,azralon,112,rogue,subtlety,7,2,5
Amonn,arthas,96,rogue,subtlety,3,2,1
Kidneyisntop,illidan,96,rogue,subtlety,6,1,5
Bonizzi,stormrage,96,rogue,subtlety,6,1,5
Wrin,sargeras,96,rogue,subtlety,6,1,5
Páige,ragnaros,96,rogue,subtlety,6,1,5
Dabrat,frostwolf,96,rogue,subtlety,6,1,5
Mídnìght,aegwynn,96,rogue,subtlety,6,1,5
Yoodoo,nemesis,96,rogue,subtlety,6,1,5
Ironrod,shadowmoon,96,rogue,subtlety,6,1,5
Originkorean,terenas,96,rogue,subtlety,6,1,5
Rotbreath,bleeding-hollow,96,rogue,subtlety,6,1,5
Illidin,executus,96,rogue,subtlety,6,1,5
Sawred,bonechewer,96,rogue,subtlety,6,1,5
Frootylol,stormrage,96,rogue,subtlety,6,1,5
Ivanapavlov,kelthuzad,96,rogue,subtlety,6,1,5
Nevatell,malganis,96,rogue,subtlety,6,1,5
Valekk,stormscale,96,rogue,subtlety,6,1,5
Steffmaister,tichondrius,96,rogue,subtlety,6,1,5
Reurog,garrosh,96,rogue,subtlety,6,1,5
Anadrol,sargeras,96,rogue,subtlety,6,1,5
Skinnymayne,laughing-skull,96,rogue,subtlety,6,1,5
Bloodbrawl,caelestrasz,96,rogue,subtlety,6,1,5
Docheatt,dalaran,96,rogue,subtlety,6,1,5
Twinkrogue,firetree,96,rogue,subtlety,6,1,5
Dedrater,shadowmoon,96,rogue,subtlety,6,1,5
Bloodyblades,blackhand,96,rogue,subtlety,6,1,5
Crypblade,sargeras,96,rogue,subtlety,6,1,5
Studders,kiljaeden,96,rogue,subtlety,6,1,5
Slobernocker,stormrage,96,rogue,subtlety,6,1,5
Cotuffa,drakkari,96,rogue,subtlety,6,1,5
Onetwostep,tichondrius,96,rogue,subtlety,6,1,5
Deepcutz,barthilas,96,rogue,subtlety,6,1,5
Jokerr,proudmoore,96,rogue,subtlety,6,1,5
Satanicrizz,tichondrius,96,rogue,subtlety,6,1,5
Chitovera,tichondrius,96,rogue,subtlety,6,1,5
Quackerjacks,lightnings-blade,96,rogue,subtlety,6,1,5
Macc,khazgoroth,96,rogue,subtlety,6,1,5
Flelfo,quelthalas,96,rogue,subtlety,12,1,11
Uchihà,sargeras,95,rogue,subtlety,6,1,5
Drpibb,ghostlands,63,rogue,subtlety,2,2,0
Saraelith,moon-guard,48,rogue,subtlety,3,1,2
Rocanról,quelthalas,42,rogue,subtlety,6,2,4
Thenelis,dalaran,42,rogue,subtlety,11,2,9
Traumashears,proudmoore,31,rogue,subtlety,2,1,1
Demonioverde,ragnaros,31,rogue,subtlety,2,1,1
Betakong,quelthalas,31,rogue,subtlety,2,1,1
Mirrorx,tichondrius,2136,rogue,assassination,162,81,81
Sllabymkcus,sargeras,2126,rogue,assassination,72,37,35
Larmx,tichondrius,2111,rogue,assassination,78,40,38
Xiaochulol,tichondrius,2039,rogue,assassination,78,40,38
Zarkk,kelthuzad,2017,rogue,assassination,119,57,62
Ånko,tichondrius,1891,rogue,assassination,60,27,33
Alethal,tichondrius,1873,rogue,assassination,60,33,27
Snortedgfuel,drenden,1871,rogue,assassination,48,23,25
Lemon,arygos,1851,rogue,assassination,47,20,27
Poonanixo,frostmourne,1846,rogue,assassination,78,38,40
Feinting,moon-guard,1839,rogue,assassination,76,35,41
Jon,the-venture-co,1838,rogue,assassination,54,27,27
Sio,bleeding-hollow,1837,rogue,assassination,60,30,30
Ajúmma,tichondrius,1831,rogue,assassination,57,23,34
Jjp,tichondrius,1827,rogue,assassination,65,33,32
Köfy,quelthalas,1826,rogue,assassination,72,34,38
Relän,ragnaros,1805,rogue,assassination,59,33,26
Sairak,tichondrius,1804,rogue,assassination,101,49,52
Plumblossomx,tichondrius,1803,rogue,assassination,54,24,30
Slickyo,malganis,1792,rogue,assassination,30,20,10
Alterfate,wyrmrest-accord,1788,rogue,assassination,60,30,30
Bloodlessftw,azralon,1783,rogue,assassination,75,33,42
Thargal,tichondrius,1747,rogue,assassination,60,32,28
Lunatixz,emerald-dream,1723,rogue,assassination,47,24,23
Niarzz,tichondrius,1722,rogue,assassination,60,35,25
Ybby,tichondrius,1714,rogue,assassination,68,34,34
Bellamor,tichondrius,1710,rogue,assassination,90,54,36
Cutercarver,proudmoore,1687,rogue,assassination,60,27,33
Vmoney,draenor,1685,rogue,assassination,30,18,12
Vél,blackrock,1674,rogue,assassination,42,22,20
Whooxx,khazgoroth,1673,rogue,assassination,66,29,37
Riventrix,zuljin,1668,rogue,assassination,59,27,32
Johnnycryp,barthilas,1652,rogue,assassination,53,27,26
Bellicoses,tichondrius,1651,rogue,assassination,155,84,71
Ivanrah,zuljin,1648,rogue,assassination,45,20,25
Rapcher,illidan,1632,rogue,assassination,148,75,73
Doraz,tichondrius,1632,rogue,assassination,102,51,51
Josex,lightbringer,1632,rogue,assassination,48,20,28
Gyutaro,black-dragonflight,1629,rogue,assassination,282,143,139
Sheerlol,stormrage,1626,rogue,assassination,49,24,25
Beaconlight,tichondrius,1624,rogue,assassination,48,20,28
Assassìn,moon-guard,1618,rogue,assassination,48,27,21
Ulley,sargeras,1610,rogue,assassination,50,28,22
Purplechil,garrosh,1610,rogue,assassination,79,38,41
Osuba,proudmoore,1604,rogue,assassination,72,33,39
Elinarra,sargeras,1603,rogue,assassination,42,21,21
Ultranumb,sargeras,1602,rogue,assassination,44,23,21
Lucidstorm,tichondrius,1593,rogue,assassination,30,17,13
Seroth,tichondrius,1590,rogue,assassination,24,17,7
Foreverioi,tichondrius,1589,rogue,assassination,48,27,21
Sparqxx,tichondrius,1589,rogue,assassination,199,100,99
Chêckmatê,darkspear,1589,rogue,assassination,54,25,29
Devstrike,sargeras,1587,rogue,assassination,53,25,28
Isàputàp,tichondrius,1585,rogue,assassination,54,30,24
Katovo,tichondrius,1584,rogue,assassination,36,21,15
Xagreth,illidan,1579,rogue,assassination,40,20,20
Bukaboo,tichondrius,1577,rogue,assassination,24,20,4
Spikiera,silvermoon,1575,rogue,assassination,36,20,16
Garrotte,tichondrius,1574,rogue,assassination,98,44,54
Nsns,drenden,1571,rogue,assassination,143,70,73
Hickery,frostmourne,1571,rogue,assassination,60,26,34
Ãnimefãnx,moon-guard,1564,rogue,assassination,131,64,67
Wxvi,tichondrius,1563,rogue,assassination,54,30,24
Miamiganster,lothar,1550,rogue,assassination,120,54,66
Kenyel,frostmourne,1543,rogue,assassination,84,37,47
Replayz,stormrage,1540,rogue,assassination,78,34,44
Quefist,sargeras,1533,rogue,assassination,38,18,20
Sinepymkcus,illidan,1532,rogue,assassination,36,16,20
Kidneyshiv,stormrage,1531,rogue,assassination,36,20,16
Skeezy,vashj,1523,rogue,assassination,48,17,31
Wujn,tichondrius,1514,rogue,assassination,62,32,30
Tryedge,moon-guard,1512,rogue,assassination,36,19,17
Notjawn,arthas,1507,rogue,assassination,138,74,64
Staabzz,thrall,1505,rogue,assassination,66,27,39
Xilorio,skullcrusher,1496,rogue,assassination,48,24,24
Onetwostep,tichondrius,1492,rogue,assassination,39,17,22
Stabem,moon-guard,1487,rogue,assassination,153,82,71
Kiosh,tichondrius,1485,rogue,assassination,78,36,42
Sizka,sargeras,1483,rogue,assassination,102,48,54
Paraisbae,tichondrius,1480,rogue,assassination,36,20,16
Camlaw,area-52,1477,rogue,assassination,55,26,29
Creamypeach,stormrage,1477,rogue,assassination,51,24,27
Gøblìn,tichondrius,1469,rogue,assassination,91,40,51
Pandrogue,shadowsong,1467,rogue,assassination,36,21,15
Smkgpvp,stormrage,1456,rogue,assassination,29,16,13
Blackmont,bleeding-hollow,1456,rogue,assassination,60,26,34
Cleam,darkspear,1432,rogue,assassination,36,19,17
Coquìn,proudmoore,1429,rogue,assassination,80,39,41
Pirrow,moon-guard,1426,rogue,assassination,46,25,21
Hypnothot,tichondrius,1425,rogue,assassination,108,36,72
Happyslice,stormrage,1415,rogue,assassination,27,16,11
Nightdelphya,azralon,1411,rogue,assassination,42,15,27
Rêdrum,illidan,1411,rogue,assassination,60,19,41
Youwho,kiljaeden,1410,rogue,assassination,87,42,45
Lcl,proudmoore,1400,rogue,assassination,226,114,112
Leônhart,thrall,1399,rogue,assassination,36,16,20
Playmaker,frostwolf,1396,rogue,assassination,156,82,74
Apocalipto,barthilas,1393,rogue,assassination,53,23,30
Páïgèvêntürã,bleeding-hollow,1367,rogue,assassination,32,15,17
Boonee,frostmourne,1363,rogue,assassination,71,33,38
Valråvn,bloodscalp,1359,rogue,assassination,23,15,8
Itokuri,ysera,1341,rogue,assassination,36,16,20
Strîkér,tichondrius,1339,rogue,assassination,31,15,16
Swexee,area-52,1339,rogue,assassination,60,26,34
Røgüë,malganis,1338,rogue,assassination,30,14,16
Wxva,tichondrius,1331,rogue,assassination,30,14,16
Galaily,proudmoore,1329,rogue,assassination,78,36,42
Urukzog,ragnaros,1327,rogue,assassination,36,19,17
Ezmate,frostmourne,1320,rogue,assassination,43,15,28
Shankeez,tichondrius,1319,rogue,assassination,30,14,16
Driprat,area-52,1316,rogue,assassination,24,14,10
Vannisshh,shattered-halls,1315,rogue,assassination,129,60,69
Ninjadoo,tichondrius,1301,rogue,assassination,44,17,27
Powerjuicer,tichondrius,1300,rogue,assassination,66,31,35
Greenlemons,lightnings-blade,1297,rogue,assassination,42,24,18
Kindasorry,illidan,1290,rogue,assassination,54,23,31
Gorgdrake,illidan,1283,rogue,assassination,78,39,39
Aynrand,drakkari,1281,rogue,assassination,36,16,20
Keepitshadow,frostmourne,1279,rogue,assassination,89,45,44
Spooky,bleeding-hollow,1277,rogue,assassination,66,33,33
Doomcore,barthilas,1276,rogue,assassination,41,21,20
Blindfun,emerald-dream,1275,rogue,assassination,33,19,14
Omnìslash,area-52,1274,rogue,assassination,26,15,11
Keylâ,thrall,1264,rogue,assassination,62,33,29
Seengivenchy,zuljin,1262,rogue,assassination,26,14,12
Zirkir,mannoroth,1262,rogue,assassination,32,14,18
Hiddencosts,proudmoore,1260,rogue,assassination,85,41,44
Sinnister,queldorei,1259,rogue,assassination,47,20,27
Grasiel,tichondrius,1257,rogue,assassination,50,20,30
Regios,shadowmoon,1255,rogue,assassination,71,31,40
Lemonlemon,arygos,1247,rogue,assassination,24,13,11
Sênorita,tichondrius,1246,rogue,assassination,36,13,23
Lakeshark,stormrage,1246,rogue,assassination,36,13,23
Worm,demon-soul,1240,rogue,assassination,36,16,20
Roollz,nemesis,1240,rogue,assassination,33,14,19
Dianiss,ragnaros,1234,rogue,assassination,24,13,11
Raskapashan,moon-guard,1229,rogue,assassination,36,13,23
Pst,spirestone,1227,rogue,assassination,24,14,10
Shinobick,kelthuzad,1222,rogue,assassination,30,15,15
Morgoophh,azralon,1208,rogue,assassination,86,44,42
Lórdx,illidan,1189,rogue,assassination,56,25,31
Fakie,quelthalas,1176,rogue,assassination,37,21,16
Beedie,malganis,1169,rogue,assassination,69,31,38
Engels,quelthalas,1168,rogue,assassination,30,13,17
Mìtsuru,proudmoore,1165,rogue,assassination,36,20,16
Jeshka,wyrmrest-accord,1162,rogue,assassination,36,16,20
Indivisible,thunderlord,1160,rogue,assassination,48,26,22
Rizzboy,tichondrius,1153,rogue,assassination,30,13,17
Lycanthropì,illidan,1151,rogue,assassination,18,12,6
Kenteenx,tichondrius,1151,rogue,assassination,30,12,18
Kriszov,moon-guard,1149,rogue,assassination,142,71,71
Lesentixd,stormrage,1149,rogue,assassination,30,12,18
Slycndice,tortheldrin,1148,rogue,assassination,78,45,33
Odetodindel,nerzhul,1146,rogue,assassination,60,32,28
Sergioz,quelthalas,1143,rogue,assassination,54,23,31
Ixìa,vashj,1135,rogue,assassination,30,12,18
Laotrec,nemesis,1126,rogue,assassination,24,12,12
Gogothirteen,kiljaeden,1117,rogue,assassination,30,15,15
Copler,tichondrius,1110,rogue,assassination,48,17,31
Roguepvp,stormrage,1108,rogue,assassination,64,35,29
Nikhlaus,ragnaros,1107,rogue,assassination,24,13,11
Altarys,ragnaros,1103,rogue,assassination,27,15,12
Chingado,kaelthas,1102,rogue,assassination,30,12,18
Dysxliec,dalaran,1101,rogue,assassination,35,12,23
Tortador,quelthalas,1098,rogue,assassination,50,25,25
Smoketoad,tichondrius,1081,rogue,assassination,30,15,15
Cashbigknife,area-52,1061,rogue,assassination,70,28,42
Aiden,burning-legion,1056,rogue,assassination,18,11,7
Lycanthropî,illidan,1056,rogue,assassination,24,11,13
Ziggee,sargeras,1055,rogue,assassination,50,25,25
Grafting,tichondrius,1055,rogue,assassination,24,11,13
Nayle,dalaran,1054,rogue,assassination,24,11,13
Zipperx,tichondrius,1053,rogue,assassination,30,11,19
Stuns,azshara,1052,rogue,assassination,18,11,7
Kazzo,tichondrius,1050,rogue,assassination,18,11,7
Adrianstab,dalaran,1049,rogue,assassination,36,19,17
Dothras,stormrage,1047,rogue,assassination,81,37,44
Torshe,sargeras,1046,rogue,assassination,18,11,7
Looprevil,andorhal,1043,rogue,assassination,24,14,10
Osiriko,thunderlord,1028,rogue,assassination,108,57,51
Oddblade,stormrage,1025,rogue,assassination,36,11,25
Skigskag,shadowsong,1024,rogue,assassination,73,34,39
Sheinnér,ragnaros,998,rogue,assassination,25,12,13
Rodanheim,burning-blade,996,rogue,assassination,30,11,19
Roguecity,tichondrius,987,rogue,assassination,106,39,67
Karing,onyxia,977,rogue,assassination,22,11,11
Pegglerogue,fizzcrank,977,rogue,assassination,84,37,47
Headless,dragonmaw,972,rogue,assassination,41,22,19
Jonuts,bleeding-hollow,960,rogue,assassination,18,10,8
Lakeshark,tichondrius,960,rogue,assassination,18,10,8
Dizzymoods,stormrage,960,rogue,assassination,24,10,14
Kents,tichondrius,960,rogue,assassination,24,10,14
Nhic,tichondrius,959,rogue,assassination,24,10,14
Øsi,icecrown,959,rogue,assassination,30,10,20
Cerut,illidan,957,rogue,assassination,18,10,8
Vindzl,azralon,957,rogue,assassination,24,10,14
Snoopdrogado,sargeras,956,rogue,assassination,18,11,7
Zamorant,emerald-dream,956,rogue,assassination,48,10,38
Average,burning-blade,954,rogue,assassination,27,10,17
Sangreale,nemesis,953,rogue,assassination,18,10,8
Pál,quelthalas,950,rogue,assassination,18,10,8
Problemchild,rexxar,949,rogue,assassination,24,10,14
Vozzy,proudmoore,947,rogue,assassination,30,17,13
Elithr,nemesis,944,rogue,assassination,18,10,8
Skoorbals,tichondrius,938,rogue,assassination,22,11,11
Atomicgoat,tichondrius,928,rogue,assassination,33,12,21
Teach,illidan,920,rogue,assassination,73,23,50
Papadopolous,zuluhed,917,rogue,assassination,26,11,15
Wolgan,nemesis,916,rogue,assassination,55,25,30
Vastørogue,azralon,913,rogue,assassination,37,16,21
Endlesswaltz,zuljin,912,rogue,assassination,27,10,17
Thenelis,dalaran,897,rogue,assassination,43,10,33
Evilsanta,sargeras,893,rogue,assassination,25,10,15
Criptoniø,azralon,879,rogue,assassination,24,11,13
Unlucký,sargeras,864,rogue,assassination,12,9,3
Ahjii,malganis,864,rogue,assassination,30,9,21
Brendantko,arthas,863,rogue,assassination,18,9,9
Whoox,khazgoroth,863,rogue,assassination,30,9,21
Mcskipa,sargeras,862,rogue,assassination,12,9,3
Chakarr,stormrage,861,rogue,assassination,12,9,3
Stillsol,stormrage,861,rogue,assassination,12,9,3
Yanhuaa,illidan,861,rogue,assassination,18,9,9
Ballflicker,malganis,857,rogue,assassination,30,9,21
Wreatus,moon-guard,825,rogue,assassination,48,16,32
Píxíedúst,black-dragonflight,812,rogue,assassination,34,10,24
Zxytox,hyjal,806,rogue,assassination,21,10,11
Zapersapp,malygos,803,rogue,assassination,28,10,18
Ôñéèýèdkíñg,stormrage,768,rogue,assassination,12,8,4
Frez,amanthul,768,rogue,assassination,18,8,10
Clairered,tichondrius,768,rogue,assassination,18,8,10
Snakegødx,sargeras,768,rogue,assassination,21,9,12
Exeg,tichondrius,767,rogue,assassination,12,8,4
Kzx,illidan,767,rogue,assassination,12,8,4
Lyliym,frostmourne,767,rogue,assassination,12,8,4
Dockside,stormrage,767,rogue,assassination,12,8,4
Gøblìn,stormrage,767,rogue,assassination,15,9,6
Zetéra,ragnaros,767,rogue,assassination,18,8,10
Shiddlesz,area-52,767,rogue,assassination,18,8,10
Sagatha,bleeding-hollow,767,rogue,assassination,18,8,10
Xshadowt,ragnaros,767,rogue,assassination,24,8,16
Sindor,azralon,767,rogue,assassination,30,8,22
Mylovejunex,tichondrius,766,rogue,assassination,12,8,4
Lakki,chromaggus,766,rogue,assassination,18,8,10
ßackshots,kelthuzad,766,rogue,assassination,18,8,10
Velsad,sargeras,764,rogue,assassination,18,8,10
Hattrìck,area-52,763,rogue,assassination,24,8,16
Picaroxp,drakkari,762,rogue,assassination,12,8,4
Zropi,quelthalas,762,rogue,assassination,24,8,16
Pikacuulo,ragnaros,760,rogue,assassination,31,9,22
Snoor,nemesis,753,rogue,assassination,21,9,12
Killua,dalaran,752,rogue,assassination,18,8,10
Ñovä,tichondrius,750,rogue,assassination,18,8,10
Snub,aerie-peak,713,rogue,assassination,28,8,20
Ghoulzer,tichondrius,704,rogue,assassination,10,8,2
Superharry,tichondrius,702,rogue,assassination,22,8,14
Shninzy,senjin,672,rogue,assassination,12,7,5
Skitsöu,tichondrius,672,rogue,assassination,12,7,5
Sotypical,area-52,672,rogue,assassination,12,7,5
Chriseanrock,illidan,672,rogue,assassination,12,7,5
Jaganz,stormrage,672,rogue,assassination,12,7,5
Nogodplsno,stormrage,672,rogue,assassination,18,7,11
Elwynë,tichondrius,672,rogue,assassination,18,7,11
Mydearest,tichondrius,672,rogue,assassination,18,7,11
Shyzuku,drakkari,672,rogue,assassination,18,7,11
Helecho,tichondrius,672,rogue,assassination,18,7,11
Khrezin,tichondrius,672,rogue,assassination,18,7,11
Zaszune,stormrage,672,rogue,assassination,18,7,11
Wongcha,darkspear,672,rogue,assassination,18,7,11
Sanozü,azralon,672,rogue,assassination,18,7,11
Alizashea,stormrage,671,rogue,assassination,12,7,5
Ambushr,tichondrius,671,rogue,assassination,12,7,5
Deepman,gorefiend,671,rogue,assassination,12,7,5
Løgîc,tichondrius,671,rogue,assassination,12,7,5
Johnthefum,malganis,671,rogue,assassination,18,7,11
Ezzdeath,tichondrius,671,rogue,assassination,18,7,11
Showclass,stormrage,671,rogue,assassination,18,7,11
Tìnkerton,wyrmrest-accord,671,rogue,assassination,24,7,17
Cjayy,bleeding-hollow,670,rogue,assassination,18,7,11
Jagó,malganis,669,rogue,assassination,18,7,11
Respia,proudmoore,668,rogue,assassination,18,7,11
Sinistro,bleeding-hollow,667,rogue,assassination,12,7,5
Jakkov,blackrock,666,rogue,assassination,18,7,11
Slickdude,stormrage,666,rogue,assassination,24,7,17
Kiorz,tichondrius,665,rogue,assassination,12,7,5
Slootslayer,azshara,662,rogue,assassination,18,7,11
Lambs,blackhand,623,rogue,assassination,11,7,4
Runakó,kelthuzad,623,rogue,assassination,11,7,4
Pochomän,ragnaros,618,rogue,assassination,16,9,7
Onulyo,tichondrius,618,rogue,assassination,16,8,8
Núm,tichondrius,618,rogue,assassination,21,8,13
Hookahrogue,area-52,576,rogue,assassination,6,6,0
Stabasaurus,blood-furnace,576,rogue,assassination,12,6,6
Mosedz,tichondrius,576,rogue,assassination,12,6,6
Viicky,ghostlands,576,rogue,assassination,12,6,6
Olé,azralon,576,rogue,assassination,12,6,6
Turec,illidan,576,rogue,assassination,12,6,6
Luriél,stormrage,576,rogue,assassination,12,6,6
Jaywas,tichondrius,576,rogue,assassination,12,6,6
Bloodygoat,area-52,576,rogue,assassination,12,6,6
Twoheaded,frostmourne,576,rogue,assassination,12,6,6
Wansuiye,tichondrius,576,rogue,assassination,18,6,12
Slipperydog,jubeithos,576,rogue,assassination,18,6,12
Çõvìd,malganis,576,rogue,assassination,30,6,24
Cox,bleeding-hollow,575,rogue,assassination,6,6,0
Blaçkout,thrall,575,rogue,assassination,12,6,6
Robinsony,tichondrius,575,rogue,assassination,12,6,6
Theblindsap,dalaran,575,rogue,assassination,12,6,6
Vendëttä,quelthalas,575,rogue,assassination,12,6,6
Sgnome,quelthalas,575,rogue,assassination,18,6,12
Manersi,akama,575,rogue,assassination,18,6,12
Eldan,moon-guard,575,rogue,assassination,24,6,18
Aurrora,kiljaeden,574,rogue,assassination,17,6,11
Mcvillain,kelthuzad,573,rogue,assassination,12,6,6
Daggerback,bleeding-hollow,571,rogue,assassination,9,7,2
Escape,elune,571,rogue,assassination,12,6,6
Akalio,laughing-skull,571,rogue,assassination,18,6,12
Addvilpm,wyrmrest-accord,570,rogue,assassination,12,6,6
Vitalz,bloodscalp,568,rogue,assassination,18,6,12
Annastasiya,moon-guard,568,rogue,assassination,18,6,12
Euweu,azralon,567,rogue,assassination,18,6,12
Tiptoez,bleeding-hollow,565,rogue,assassination,12,6,6
Hellwolf,azgalor,565,rogue,assassination,13,6,7
Drpepzi,tichondrius,565,rogue,assassination,24,6,18
Genève,dreadmaul,526,rogue,assassination,11,6,5
Purcius,moon-guard,480,rogue,assassination,6,5,1
Lvx,frostmourne,480,rogue,assassination,6,5,1
Pwnsauce,frostmourne,480,rogue,assassination,7,5,2
Enyr,frostmourne,480,rogue,assassination,12,5,7
Madge,area-52,480,rogue,assassination,12,5,7
Vimit,tichondrius,480,rogue,assassination,12,5,7
Fuzzyslow,stormrage,480,rogue,assassination,12,5,7
Surprises,azralon,480,rogue,assassination,12,5,7
Xalsathoth,sargeras,480,rogue,assassination,12,5,7
Kahlx,azralon,480,rogue,assassination,12,5,7
Breakxcvii,bleeding-hollow,480,rogue,assassination,12,5,7
Stealthdeath,quelthalas,480,rogue,assassination,12,5,7
Tberg,emerald-dream,480,rogue,assassination,12,5,7
Bloore,fizzcrank,480,rogue,assassination,12,5,7
Gomma,stormrage,480,rogue,assassination,12,5,7
Pkkrevolt,archimonde,480,rogue,assassination,16,6,10
Xm,sargeras,480,rogue,assassination,18,5,13
Senpaifuta,proudmoore,479,rogue,assassination,12,5,7
Mashad,moon-guard,479,rogue,assassination,12,5,7
Stepper,aegwynn,479,rogue,assassination,12,5,7
Møfshanks,sargeras,479,rogue,assassination,12,5,7
Meilh,emerald-dream,479,rogue,assassination,12,5,7
Poofhottie,lightbringer,479,rogue,assassination,12,5,7
Eliasael,moon-guard,479,rogue,assassination,15,6,9
Cynalia,sargeras,479,rogue,assassination,15,5,10
Rinestiria,arthas,479,rogue,assassination,18,5,13
Maison,ragnaros,478,rogue,assassination,12,5,7
Villainrogue,stormrage,478,rogue,assassination,12,5,7
Bonizzi,stormrage,478,rogue,assassination,12,5,7
Lethalist,whisperwind,476,rogue,assassination,12,5,7
Killdead,warsong,473,rogue,assassination,12,5,7
Peeryl,daggerspine,472,rogue,assassination,12,5,7
Savagedeeps,stormreaver,472,rogue,assassination,12,5,7
Julius,malganis,447,rogue,assassination,8,6,2
Shizz,tichondrius,447,rogue,assassination,14,6,8
Inaniss,tichondrius,415,rogue,assassination,8,5,3
Minnicent,amanthul,413,rogue,assassination,10,5,5
Betakong,quelthalas,384,rogue,assassination,6,4,2
Ahji,malganis,384,rogue,assassination,6,4,2
Buckbreaker,stormrage,384,rogue,assassination,6,4,2
Schleazy,emerald-dream,384,rogue,assassination,6,4,2
Alavennian,tichondrius,384,rogue,assassination,6,4,2
Venomsnáke,tichondrius,384,rogue,assassination,6,4,2
Yurkarogue,tichondrius,384,rogue,assassination,6,4,2
Arlom,daggerspine,384,rogue,assassination,6,4,2
Kayriss,antonidas,384,rogue,assassination,6,4,2
Kágé,ragnaros,384,rogue,assassination,6,4,2
Fofree,hyjal,384,rogue,assassination,6,4,2
Csguixuan,aerie-peak,384,rogue,assassination,6,4,2
Grima,azralon,384,rogue,assassination,6,4,2
Chokonet,gurubashi,384,rogue,assassination,6,4,2
Taessin,kelthuzad,384,rogue,assassination,6,4,2
Hollowtipzz,tichondrius,384,rogue,assassination,6,4,2
Colom,moon-guard,384,rogue,assassination,6,4,2
Slizard,boulderfist,384,rogue,assassination,6,4,2
Tmpikaboo,tichondrius,384,rogue,assassination,6,4,2
Shigoo,sargeras,384,rogue,assassination,6,4,2
Rîa,area-52,384,rogue,assassination,12,4,8
Ninjamf,bleeding-hollow,384,rogue,assassination,12,4,8
Cryoph,illidan,384,rogue,assassination,12,4,8
Mirâge,illidan,384,rogue,assassination,12,4,8
Shadøw,the-forgotten-coast,384,rogue,assassination,12,4,8
Gridisx,wyrmrest-accord,384,rogue,assassination,12,4,8
Hirian,misha,384,rogue,assassination,12,4,8
Saiine,drenden,384,rogue,assassination,12,4,8
Cv,proudmoore,384,rogue,assassination,12,4,8
Thepitt,stormrage,384,rogue,assassination,12,4,8
Tri,the-underbog,384,rogue,assassination,12,4,8
Kargargar,thrall,384,rogue,assassination,12,4,8
Sillikitti,tichondrius,384,rogue,assassination,12,4,8
Psilocin,sargeras,384,rogue,assassination,12,4,8
Girio,thrall,384,rogue,assassination,12,4,8
Celèphaïs,tichondrius,384,rogue,assassination,12,4,8
Skinnymayne,laughing-skull,384,rogue,assassination,18,4,14
Azrek,sargeras,384,rogue,assassination,18,4,14
Gladlol,stormrage,384,rogue,assassination,18,4,14
Kdrx,thrall,384,rogue,assassination,18,4,14
Nikjawar,illidan,383,rogue,assassination,6,4,2
Ñinjå,alleria,383,rogue,assassination,12,4,8
Corteleve,nemesis,383,rogue,assassination,12,4,8
Steeldiesel,sargeras,383,rogue,assassination,12,4,8
Setsu,sargeras,383,rogue,assassination,13,4,9
Kalandar,moon-guard,382,rogue,assassination,12,4,8
Tralisong,azshara,382,rogue,assassination,12,4,8
Hésta,moon-guard,382,rogue,assassination,12,4,8
Wrinklevoss,proudmoore,382,rogue,assassination,12,4,8
Slobernocker,stormrage,381,rogue,assassination,12,4,8
Sneakyfoot,gorgonnash,374,rogue,assassination,25,4,21
Tolthe,hyjal,351,rogue,assassination,11,4,7
Siniel,scarlet-crusade,336,rogue,assassination,9,4,5
Riggie,turalyon,335,rogue,assassination,11,4,7
Whatsåpp,gallywix,320,rogue,assassination,10,4,6
Coopi,tichondrius,320,rogue,assassination,10,4,6
Pícáróóná,ragnaros,320,rogue,assassination,16,4,12
Xvds,tichondrius,319,rogue,assassination,14,4,10
Ziedrich,frostmourne,318,rogue,assassination,10,4,6
Gulvzer,tichondrius,288,rogue,assassination,6,3,3
Åmg,tichondrius,288,rogue,assassination,6,3,3
Jarcus,aggramar,288,rogue,assassination,6,3,3
Bigtengu,tichondrius,288,rogue,assassination,6,3,3
Steffmaister,tichondrius,288,rogue,assassination,6,3,3
Cron,arygos,288,rogue,assassination,6,3,3
Rýuu,bleeding-hollow,288,rogue,assassination,6,3,3
Dïeb,zuljin,288,rogue,assassination,6,3,3
Lyapunov,tichondrius,288,rogue,assassination,6,3,3
Corrier,tichondrius,288,rogue,assassination,6,3,3
Ncb,bleeding-hollow,288,rogue,assassination,6,3,3
Emvee,kelthuzad,288,rogue,assassination,6,3,3
Mügi,ragnaros,288,rogue,assassination,6,3,3
Toxicplyer,malganis,288,rogue,assassination,6,3,3
Maciota,area-52,288,rogue,assassination,6,3,3
Alkal,stormreaver,288,rogue,assassination,6,3,3
Jannie,rexxar,288,rogue,assassination,6,3,3
Sonymf,frostmourne,288,rogue,assassination,6,3,3
Calebrogue,illidan,288,rogue,assassination,6,3,3
Scarrog,wyrmrest-accord,288,rogue,assassination,6,3,3
Peaches,akama,288,rogue,assassination,6,3,3
Wowamaze,aegwynn,288,rogue,assassination,6,3,3
Kidneyisntop,illidan,288,rogue,assassination,6,3,3
Chipetan,hyjal,288,rogue,assassination,6,3,3
Syxs,sargeras,288,rogue,assassination,6,3,3
Twinkasz,nemesis,288,rogue,assassination,6,3,3
Esraxo,frostmourne,288,rogue,assassination,6,3,3
Saltypwncake,illidan,288,rogue,assassination,6,3,3
Thâïßòÿgøóñ,jubeithos,288,rogue,assassination,6,3,3
Deeshdosh,illidan,288,rogue,assassination,6,3,3
Yenrab,illidan,288,rogue,assassination,6,3,3
Anímosity,darkspear,288,rogue,assassination,6,3,3
Punkyass,azralon,288,rogue,assassination,6,3,3
Mcjagerx,darkspear,288,rogue,assassination,6,3,3
Prodixybn,illidan,288,rogue,assassination,6,3,3
Alithileria,moon-guard,288,rogue,assassination,6,3,3
Kk,dalaran,288,rogue,assassination,6,3,3
Brlsels,azralon,288,rogue,assassination,6,3,3
Joeyzord,stormrage,288,rogue,assassination,12,3,9
Cydonian,ragnaros,288,rogue,assassination,12,3,9
Tìlt,whisperwind,288,rogue,assassination,12,3,9
Arïa,drakkari,288,rogue,assassination,12,3,9
Shortcut,khadgar,288,rogue,assassination,12,3,9
Ereshkigall,ragnaros,288,rogue,assassination,12,3,9
Atulano,wyrmrest-accord,288,rogue,assassination,12,3,9
Trinktick,doomhammer,288,rogue,assassination,12,3,9
Lilgoosie,korgath,288,rogue,assassination,12,3,9
Karmagoodttv,stormrage,288,rogue,assassination,12,3,9
Benielfman,illidan,288,rogue,assassination,12,3,9
Aevaela,duskwood,288,rogue,assassination,12,3,9
Elevorra,frostmourne,288,rogue,assassination,12,3,9
Alttee,proudmoore,288,rogue,assassination,12,3,9
Pintofwoc,area-52,288,rogue,assassination,12,3,9
Sunshinezx,frostmourne,288,rogue,assassination,12,3,9
Chersy,tichondrius,288,rogue,assassination,17,3,14
Loligotyou,stormrage,288,rogue,assassination,18,3,15
Revozy,azralon,287,rogue,assassination,6,3,3
Clipp,wildhammer,287,rogue,assassination,6,3,3
Gilhela,bloodhoof,287,rogue,assassination,6,3,3
Fllokii,arygos,287,rogue,assassination,6,3,3
Moridra,demon-soul,287,rogue,assassination,6,3,3
Lyndra,thunderlord,287,rogue,assassination,12,3,9
Anarusekkusu,wyrmrest-accord,287,rogue,assassination,12,3,9
Olg,arathor,287,rogue,assassination,12,3,9
Sanguinnar,nemesis,285,rogue,assassination,12,3,9
Clothies,zuljin,285,rogue,assassination,12,3,9
Synesh,moon-guard,255,rogue,assassination,11,3,8
Thoxic,barthilas,239,rogue,assassination,5,3,2
Tamsy,the-forgotten-coast,239,rogue,assassination,5,3,2
Walnutrog,area-52,234,rogue,assassination,11,5,6
Pãndã,stormrage,234,rogue,assassination,13,4,9
Skairipa,agamaggan,232,rogue,assassination,7,4,3
Yoodoo,nemesis,192,rogue,assassination,6,2,4
Haeqn,nemesis,192,rogue,assassination,6,2,4
Historymaker,tichondrius,192,rogue,assassination,6,2,4
Jerzs,tichondrius,192,rogue,assassination,6,2,4
Zogbu,stormrage,192,rogue,assassination,6,2,4
Gilbertgr,boulderfist,192,rogue,assassination,6,2,4
Swingonya,stormrage,192,rogue,assassination,6,2,4
Dessenia,illidan,192,rogue,assassination,6,2,4
Slashinsteev,dalaran,192,rogue,assassination,6,2,4
Novarra,tichondrius,192,rogue,assassination,6,2,4
Karmakula,wildhammer,192,rogue,assassination,6,2,4
Katmira,tichondrius,192,rogue,assassination,6,2,4
Cktko,stormrage,192,rogue,assassination,6,2,4
Apssal,tichondrius,192,rogue,assassination,6,2,4
Ganksterqt,dentarg,192,rogue,assassination,6,2,4
Someone,ravencrest,192,rogue,assassination,6,2,4
Karlemagne,blackrock,192,rogue,assassination,6,2,4
Nicknasty,kelthuzad,192,rogue,assassination,6,2,4
Combo,norgannon,192,rogue,assassination,6,2,4
Muffens,alterac-mountains,192,rogue,assassination,6,2,4
Støné,azjolnerub,192,rogue,assassination,6,2,4
Salätzar,quelthalas,192,rogue,assassination,6,2,4
Roguemain,smolderthorn,192,rogue,assassination,6,2,4
Wowslayer,bleeding-hollow,192,rogue,assassination,6,2,4
Swickwockdus,azralon,192,rogue,assassination,6,2,4
Mermm,burning-blade,192,rogue,assassination,6,2,4
Vanishcdc,area-52,192,rogue,assassination,6,2,4
Lesty,kelthuzad,192,rogue,assassination,6,2,4
Bladä,area-52,192,rogue,assassination,6,2,4
Poohkié,malganis,192,rogue,assassination,6,2,4
Thianir,emerald-dream,192,rogue,assassination,6,2,4
Frostheartyy,azralon,192,rogue,assassination,6,2,4
Sneakysharky,frostmourne,192,rogue,assassination,6,2,4
Itskanashi,frostmourne,192,rogue,assassination,6,2,4
Tagerung,malganis,192,rogue,assassination,6,2,4
Ssjseem,sargeras,192,rogue,assassination,6,2,4
Quickflash,bloodhoof,192,rogue,assassination,6,2,4
Kellthzard,goldrinn,192,rogue,assassination,6,2,4
Roguegirl,alexstrasza,192,rogue,assassination,6,2,4
Ilesire,frostmourne,192,rogue,assassination,6,2,4
Darkfalleng,azralon,192,rogue,assassination,6,2,4
Jaanmonty,frostmourne,192,rogue,assassination,6,2,4
Sellers,tichondrius,192,rogue,assassination,6,2,4
Escurecer,azralon,192,rogue,assassination,6,2,4
Ennmaa,azralon,192,rogue,assassination,6,2,4
Zaozaa,frostmourne,192,rogue,assassination,6,2,4
Miloandotis,malganis,192,rogue,assassination,6,2,4
Gentlesaop,blackrock,192,rogue,assassination,6,2,4
Liridor,quelthalas,192,rogue,assassination,11,2,9
Youngtugger,daggerspine,192,rogue,assassination,11,2,9
Pleodonis,tichondrius,192,rogue,assassination,12,2,10
Bloodwish,tichondrius,192,rogue,assassination,12,2,10
Geradyn,stormrage,192,rogue,assassination,12,2,10
Slowtime,quelthalas,192,rogue,assassination,12,2,10
Subculture,emerald-dream,192,rogue,assassination,12,2,10
Nikosneako,tichondrius,192,rogue,assassination,12,2,10
Alts,tichondrius,192,rogue,assassination,12,2,10
Nines,icecrown,192,rogue,assassination,12,2,10
Seltzie,bleeding-hollow,192,rogue,assassination,12,2,10
Impkasn,tichondrius,192,rogue,assassination,12,2,10
Cryptixx,blades-edge,191,rogue,assassination,6,2,4
Diatonic,illidan,191,rogue,assassination,6,2,4
Cretos,jaedenar,191,rogue,assassination,6,2,4
Swiftbones,burning-blade,191,rogue,assassination,6,2,4
Dabrat,frostwolf,191,rogue,assassination,12,2,10
Donpablò,area-52,175,rogue,assassination,11,2,9
ßalto,bleeding-hollow,160,rogue,assassination,10,2,8
Vandalyze,sargeras,159,rogue,assassination,5,2,3
Xavar,malganis,159,rogue,assassination,5,2,3
Stâbitha,bloodscalp,138,rogue,assassination,20,4,16
Canesuckr,stormrage,96,rogue,assassination,6,1,5
Nubes,illidan,96,rogue,assassination,6,1,5
Lululee,tichondrius,96,rogue,assassination,6,1,5
Nebiroth,illidan,96,rogue,assassination,6,1,5
Preceptor,azralon,96,rogue,assassination,6,1,5
Sevrow,wyrmrest-accord,96,rogue,assassination,6,1,5
Assakiller,azralon,96,rogue,assassination,6,1,5
Touchthetip,bleeding-hollow,96,rogue,assassination,6,1,5
Bubbski,area-52,96,rogue,assassination,6,1,5
Buhuhbles,area-52,96,rogue,assassination,6,1,5
Ràinê,dalaran,96,rogue,assassination,6,1,5
Ntshaav,illidan,96,rogue,assassination,6,1,5
Rokkhan,blackrock,96,rogue,assassination,6,1,5
Greased,arthas,96,rogue,assassination,6,1,5
Twotimed,magtheridon,96,rogue,assassination,6,1,5
Finlander,area-52,96,rogue,assassination,6,1,5
Clicksbtns,area-52,96,rogue,assassination,6,1,5
Mõtaru,stormrage,96,rogue,assassination,6,1,5
Saintjon,bleeding-hollow,96,rogue,assassination,6,1,5
Nightmarës,frostmourne,96,rogue,assassination,6,1,5
Khlapncheeks,emerald-dream,96,rogue,assassination,6,1,5
Flinchyy,dalaran,96,rogue,assassination,6,1,5
Burtonee,aegwynn,96,rogue,assassination,6,1,5
Icantsleep,tichondrius,96,rogue,assassination,6,1,5
Scylas,stormrage,96,rogue,assassination,6,1,5
Docheatt,dalaran,96,rogue,assassination,6,1,5
Twinkrogue,firetree,96,rogue,assassination,6,1,5
Bourrasque,frostmourne,96,rogue,assassination,6,1,5
Harlyquinn,barthilas,96,rogue,assassination,6,1,5
Slycraft,gorgonnash,96,rogue,assassination,6,1,5
Stêf,zuljin,96,rogue,assassination,6,1,5
Zitihait,amanthul,96,rogue,assassination,6,1,5
Lu,lethon,96,rogue,assassination,6,1,5
Rykojin,sargeras,96,rogue,assassination,6,1,5
Meritra,ragnaros,96,rogue,assassination,6,1,5
Darkdessoft,ragnaros,96,rogue,assassination,6,1,5
Sømeøne,malygos,96,rogue,assassination,6,1,5
Wuzi,azralon,96,rogue,assassination,6,1,5
Kiskapolyus,thrall,96,rogue,assassination,6,1,5
Brianä,quelthalas,96,rogue,assassination,6,1,5
Rafikaa,ragnaros,96,rogue,assassination,6,1,5
Deathxx,destromath,96,rogue,assassination,6,1,5
Yohigo,quelthalas,96,rogue,assassination,6,1,5
Moiatropos,ragnaros,96,rogue,assassination,6,1,5
Combøz,tichondrius,96,rogue,assassination,6,1,5
Vladtsepesh,stormrage,96,rogue,assassination,12,1,11
Keljadian,black-dragonflight,96,rogue,assassination,12,1,11
Kistef,tichondrius,96,rogue,assassination,12,1,11
Voidbrain,area-52,96,rogue,assassination,12,1,11
Véndéttá,area-52,96,rogue,assassination,12,1,11
Karparog,ragnaros,96,rogue,assassination,12,1,11
Xô,lothar,96,rogue,assassination,12,1,11
Radiantrogue,nordrassil,79,rogue,assassination,5,1,4
Averagepimpn,tichondrius,79,rogue,assassination,5,1,4
Stabbindude,illidan,48,rogue,assassination,3,1,2
Botches,bonechewer,48,rogue,assassination,3,1,2
Sûshì,tichondrius,48,rogue,assassination,9,1,8
Naoyuki,stormrage,42,rogue,assassination,7,2,5
Ajy,tichondrius,31,rogue,assassination,2,1,1
Najmoiran,area-52,31,rogue,assassination,2,1,1
Ascherx,illidan,16,rogue,assassination,1,1,0
Iissham,darkspear,2192,shaman,restoration,152,87,65
Spagetje,tichondrius,2189,shaman,restoration,191,105,86
Xtremeorc,area-52,2159,shaman,restoration,66,39,27
Plewt,zuljin,2150,shaman,restoration,130,70,60
Dyllbar,tichondrius,2138,shaman,restoration,110,57,53
Aameng,tichondrius,2136,shaman,restoration,102,54,48
Tréway,area-52,2135,shaman,restoration,66,41,25
Skipperx,thrall,2134,shaman,restoration,72,43,29
Restobyte,moon-guard,2124,shaman,restoration,72,44,28
Akwesy,stormrage,2114,shaman,restoration,95,54,41
Shamaen,kelthuzad,2107,shaman,restoration,86,51,35
Selketh,area-52,2107,shaman,restoration,79,46,33
Zavoky,tichondrius,2096,shaman,restoration,114,65,49
Svanteson,wyrmrest-accord,2073,shaman,restoration,120,62,58
Vicioushands,illidan,2047,shaman,restoration,66,37,29
Kantok,quelthalas,2031,shaman,restoration,77,48,29
Timpossible,tichondrius,2030,shaman,restoration,320,165,155
Itsallgoodx,tichondrius,2008,shaman,restoration,114,55,59
Ilavayoualot,malganis,2006,shaman,restoration,130,62,68
Smlz,garrosh,1998,shaman,restoration,68,38,30
Sizure,frostmourne,1998,shaman,restoration,124,64,60
Corianderism,tichondrius,1982,shaman,restoration,77,40,37
Ravaburst,sargeras,1975,shaman,restoration,72,36,36
Berquon,tichondrius,1974,shaman,restoration,78,40,38
Lötus,tichondrius,1966,shaman,restoration,92,50,42
Abovesky,proudmoore,1955,shaman,restoration,150,72,78
Breuer,tichondrius,1951,shaman,restoration,122,60,62
Samyeh,tichondrius,1947,shaman,restoration,53,35,18
Boyfromhell,stormrage,1941,shaman,restoration,97,47,50
Cruv,thrall,1936,shaman,restoration,96,47,49
Jangbi,malganis,1934,shaman,restoration,246,129,117
Menc,frostmourne,1924,shaman,restoration,114,56,58
Laji,cairne,1923,shaman,restoration,168,90,78
Terapatrik,area-52,1921,shaman,restoration,164,84,80
Kurtcx,tichondrius,1920,shaman,restoration,159,82,77
Bigbadsac,frostmourne,1920,shaman,restoration,114,58,56
Slimdavey,tichondrius,1916,shaman,restoration,155,86,69
Oryxx,kiljaeden,1912,shaman,restoration,78,36,42
Plorenz,illidan,1905,shaman,restoration,54,34,20
Nepos,dragonmaw,1891,shaman,restoration,66,34,32
Yungtooth,emerald-dream,1890,shaman,restoration,53,29,24
Däbü,tichondrius,1887,shaman,restoration,84,40,44
Smrtdeath,zuljin,1884,shaman,restoration,53,30,23
Stormtitan,malganis,1881,shaman,restoration,86,42,44
Gragomga,area-52,1877,shaman,restoration,102,51,51
Tisaa,illidan,1876,shaman,restoration,30,20,10
Yooseafood,tichondrius,1871,shaman,restoration,54,31,23
Madoka,llane,1870,shaman,restoration,54,31,23
Dehsaw,illidan,1867,shaman,restoration,96,50,46
Bozzyy,illidan,1865,shaman,restoration,66,37,29
Hulan,tichondrius,1865,shaman,restoration,36,20,16
Kellogsz,malganis,1864,shaman,restoration,96,43,53
Ratedpvp,thrall,1862,shaman,restoration,159,93,66
Laydboiyo,tichondrius,1861,shaman,restoration,66,32,34
Hódoong,tichondrius,1857,shaman,restoration,46,24,22
Peyn,shadowsong,1856,shaman,restoration,54,31,23
Bômi,tichondrius,1856,shaman,restoration,172,90,82
Badshock,tichondrius,1855,shaman,restoration,42,32,10
Moistbeans,tichondrius,1854,shaman,restoration,48,26,22
Oridean,area-52,1854,shaman,restoration,42,22,20
Baodan,azshara,1847,shaman,restoration,83,42,41
Moldymeatbox,emerald-dream,1847,shaman,restoration,96,47,49
Oceangrown,emerald-dream,1847,shaman,restoration,45,22,23
Blackpïnk,tichondrius,1846,shaman,restoration,155,83,72
Helga,hellscream,1845,shaman,restoration,48,29,19
Nemix,barthilas,1844,shaman,restoration,42,27,15
Shamcena,the-scryers,1842,shaman,restoration,51,28,23
Üchihamadarâ,tichondrius,1841,shaman,restoration,49,30,19
Shamanbini,tichondrius,1839,shaman,restoration,47,26,21
Chocopuff,bleeding-hollow,1838,shaman,restoration,66,33,33
Erwin,bonechewer,1837,shaman,restoration,154,90,64
Waymond,khadgar,1837,shaman,restoration,80,44,36
Crazyshamañ,akama,1837,shaman,restoration,53,27,26
Caibeeshammy,tichondrius,1835,shaman,restoration,162,77,85
Stylesp,tichondrius,1833,shaman,restoration,60,32,28
Wanghaisham,kelthuzad,1830,shaman,restoration,123,63,60
Chobawn,tichondrius,1829,shaman,restoration,60,32,28
Bluekid,barthilas,1828,shaman,restoration,54,30,24
Beyoncé,lethon,1826,shaman,restoration,53,30,23
Hathul,bleeding-hollow,1826,shaman,restoration,60,33,27
Vlly,tichondrius,1826,shaman,restoration,59,27,32
Tuskcrusher,dalaran,1825,shaman,restoration,72,30,42
Ogctkoy,illidan,1824,shaman,restoration,102,51,51
Gjök,nemesis,1824,shaman,restoration,54,22,32
Cryochemist,tichondrius,1819,shaman,restoration,29,23,6
Bigspaghetti,thrall,1818,shaman,restoration,66,31,35
Totempack,stormrage,1817,shaman,restoration,54,26,28
Chairstain,kelthuzad,1816,shaman,restoration,60,33,27
Eboy,thrall,1816,shaman,restoration,67,33,34
Papatooties,tichondrius,1815,shaman,restoration,202,97,105
Ogran,stormscale,1815,shaman,restoration,54,25,29
Chomang,stormreaver,1814,shaman,restoration,96,47,49
Shawmen,zuljin,1813,shaman,restoration,181,100,81
Ericzlassoz,tichondrius,1812,shaman,restoration,66,42,24
Dantheman,twisting-nether,1810,shaman,restoration,42,23,19
Waterbro,tichondrius,1809,shaman,restoration,101,57,44
Meatballs,kirin-tor,1809,shaman,restoration,62,31,31
Desee,bleeding-hollow,1809,shaman,restoration,54,27,27
Orochisháman,stormrage,1808,shaman,restoration,42,22,20
Ookmetide,bleeding-hollow,1807,shaman,restoration,52,29,23
Willy,icecrown,1807,shaman,restoration,87,44,43
Nediar,tichondrius,1805,shaman,restoration,30,23,7
Totemgripper,moon-guard,1804,shaman,restoration,65,39,26
Hydrocheck,tichondrius,1804,shaman,restoration,94,54,40
Astrøcyte,tichondrius,1804,shaman,restoration,96,46,50
Nanosec,tichondrius,1803,shaman,restoration,36,23,13
Cmsi,tichondrius,1803,shaman,restoration,42,23,19
Huáxià,tichondrius,1802,shaman,restoration,60,32,28
Nktx,tichondrius,1800,shaman,restoration,118,66,52
Zaapi,dalaran,1800,shaman,restoration,108,60,48
Nazugresha,bleeding-hollow,1800,shaman,restoration,42,23,19
Shockmematty,tichondrius,1798,shaman,restoration,36,25,11
Shanasty,bleeding-hollow,1797,shaman,restoration,54,29,25
Inmø,ragnaros,1797,shaman,restoration,36,19,17
Hodoongs,tichondrius,1797,shaman,restoration,49,23,26
Cigaretter,tichondrius,1793,shaman,restoration,56,25,31
Mybbro,kiljaeden,1792,shaman,restoration,87,42,45
Nayro,bleeding-hollow,1787,shaman,restoration,378,206,172
Baseballcap,sargeras,1781,shaman,restoration,54,28,26
Booramqt,tichondrius,1780,shaman,restoration,47,27,20
Semtechs,tichondrius,1777,shaman,restoration,246,117,129
Blazingtotem,dunemaul,1775,shaman,restoration,125,64,61
Splashz,illidan,1768,shaman,restoration,65,31,34
Stórmstruck,area-52,1767,shaman,restoration,48,29,19
Kimflo,tichondrius,1767,shaman,restoration,285,138,147
Bobbybigdam,tichondrius,1752,shaman,restoration,93,50,43
Mandleman,tichondrius,1751,shaman,restoration,128,73,55
Magma,spirestone,1747,shaman,restoration,96,61,35
Gatorwavez,bleeding-hollow,1746,shaman,restoration,89,51,38
Warríed,sargeras,1746,shaman,restoration,59,29,30
Toazty,stormscale,1745,shaman,restoration,75,44,31
Mastashamsta,illidan,1745,shaman,restoration,48,25,23
Blackfancy,thrall,1744,shaman,restoration,56,32,24
Chessyc,ragnaros,1739,shaman,restoration,48,21,27
Tokuma,illidan,1738,shaman,restoration,52,26,26
Petzah,barthilas,1736,shaman,restoration,42,20,22
Ozmats,malganis,1734,shaman,restoration,65,32,33
Rantòn,bleeding-hollow,1733,shaman,restoration,59,27,32
Vayces,barthilas,1731,shaman,restoration,182,97,85
Møp,spirestone,1730,shaman,restoration,103,54,49
Haedodae,tichondrius,1727,shaman,restoration,63,25,38
Krazyc,sargeras,1726,shaman,restoration,90,47,43
Suzhixie,akama,1724,shaman,restoration,102,41,61
Phxhouse,illidan,1722,shaman,restoration,324,159,165
Aureal,malganis,1721,shaman,restoration,88,55,33
Patzog,area-52,1718,shaman,restoration,30,18,12
Ribbeye,tichondrius,1717,shaman,restoration,125,63,62
Cardïß,tichondrius,1716,shaman,restoration,30,18,12
Epicthesloth,sargeras,1716,shaman,restoration,47,23,24
Moocatpie,illidan,1715,shaman,restoration,76,45,31
Inpantsment,barthilas,1714,shaman,restoration,151,78,73
Bizzarro,azgalor,1713,shaman,restoration,79,40,39
Sasgöb,illidan,1713,shaman,restoration,65,29,36
Itsyabøiwill,area-52,1712,shaman,restoration,48,30,18
Vrom,whisperwind,1710,shaman,restoration,60,37,23
Kurtxc,tichondrius,1707,shaman,restoration,24,18,6
Shacewoman,altar-of-storms,1706,shaman,restoration,156,71,85
Sìxnìne,tichondrius,1706,shaman,restoration,62,28,34
Tobírama,bleeding-hollow,1705,shaman,restoration,54,23,31
Slm,bleeding-hollow,1704,shaman,restoration,24,18,6
Hustlenflow,tichondrius,1704,shaman,restoration,54,29,25
Kafkaesk,tichondrius,1704,shaman,restoration,54,21,33
Elementz,tichondrius,1703,shaman,restoration,222,116,106
Cpplol,tichondrius,1702,shaman,restoration,41,25,16
Erbicklet,ragnaros,1701,shaman,restoration,148,77,71
Texmawave,moon-guard,1700,shaman,restoration,91,57,34
Groundingtot,hydraxis,1699,shaman,restoration,42,25,17
Lavalavalava,eonar,1699,shaman,restoration,42,18,24
Uncleilli,tichondrius,1699,shaman,restoration,53,20,33
Lingduacn,tichondrius,1698,shaman,restoration,36,18,18
Wtbtotem,tichondrius,1697,shaman,restoration,48,24,24
Wraethy,illidan,1695,shaman,restoration,109,60,49
Scroogz,emerald-dream,1693,shaman,restoration,48,24,24
Horizonsham,stormrage,1690,shaman,restoration,42,25,17
Illiteratex,tichondrius,1689,shaman,restoration,32,19,13
Ittøki,tichondrius,1689,shaman,restoration,41,24,17
Rockzoa,tichondrius,1688,shaman,restoration,60,27,33
Záheer,arthas,1685,shaman,restoration,72,38,34
Solidhomme,tichondrius,1684,shaman,restoration,42,23,19
Belarix,emerald-dream,1682,shaman,restoration,133,59,74
Bizzarra,azshara,1681,shaman,restoration,39,26,13
Ibreakanklez,bleeding-hollow,1681,shaman,restoration,42,20,22
Exshocks,tichondrius,1680,shaman,restoration,42,25,17
Pookiexo,illidan,1677,shaman,restoration,35,22,13
Zoeyzour,illidan,1676,shaman,restoration,144,80,64
Raywhiter,tichondrius,1676,shaman,restoration,62,29,33
Devastaterr,bleeding-hollow,1675,shaman,restoration,84,44,40
Diulama,tichondrius,1673,shaman,restoration,39,28,11
Urga,hyjal,1672,shaman,restoration,36,20,16
Spiritry,tichondrius,1667,shaman,restoration,60,35,25
Chonchastic,darkspear,1666,shaman,restoration,48,23,25
Stonetides,tichondrius,1665,shaman,restoration,48,23,25
Semnicktotem,area-52,1663,shaman,restoration,60,30,30
Bogz,korgath,1663,shaman,restoration,113,51,62
Isagii,stormrage,1662,shaman,restoration,42,26,16
Reppinsix,sargeras,1662,shaman,restoration,58,24,34
Chazzwozza,area-52,1660,shaman,restoration,41,22,19
Bluepigo,tichondrius,1660,shaman,restoration,59,24,35
Lingdusm,tichondrius,1657,shaman,restoration,36,20,16
Zuescannon,kelthuzad,1656,shaman,restoration,84,39,45
Novoz,tichondrius,1653,shaman,restoration,42,24,18
Whameradetu,suramar,1653,shaman,restoration,71,31,40
Svondo,illidan,1652,shaman,restoration,31,21,10
Win,blackwing-lair,1651,shaman,restoration,36,21,15
Bolteon,malganis,1648,shaman,restoration,30,21,9
Nethyxsoy,frostmourne,1648,shaman,restoration,42,29,13
Rollintotems,bleeding-hollow,1648,shaman,restoration,54,23,31
Jizzlewizwiz,tichondrius,1647,shaman,restoration,163,81,82
Jsell,zuljin,1646,shaman,restoration,56,28,28
Flappygooch,illidan,1646,shaman,restoration,84,35,49
Amdshaman,thrall,1645,shaman,restoration,67,37,30
Bigmontana,tichondrius,1644,shaman,restoration,36,21,15
Gabant,azralon,1644,shaman,restoration,42,19,23
Annte,stonemaul,1642,shaman,restoration,46,23,23
Weoo,doomhammer,1642,shaman,restoration,48,23,25
Thunderspark,tichondrius,1641,shaman,restoration,36,24,12
Gordonramsai,sargeras,1641,shaman,restoration,272,148,124
Hoshwear,azralon,1639,shaman,restoration,48,31,17
Beastofmagic,illidan,1638,shaman,restoration,125,68,57
Cheddaman,kiljaeden,1637,shaman,restoration,48,21,27
Singleorigin,tichondrius,1637,shaman,restoration,89,33,56
Bigamez,azuremyst,1636,shaman,restoration,122,71,51
Krilick,blackrock,1635,shaman,restoration,104,57,47
Daddybeaarr,thrall,1635,shaman,restoration,55,25,30
Gjok,nemesis,1634,shaman,restoration,59,20,39
Xruok,kelthuzad,1633,shaman,restoration,33,20,13
Quitnectar,aggramar,1633,shaman,restoration,48,24,24
Dingfu,sargeras,1632,shaman,restoration,153,89,64
Shortbusqt,hyjal,1631,shaman,restoration,42,23,19
Wawsham,tichondrius,1631,shaman,restoration,48,19,29
Eatmymeatbal,illidan,1628,shaman,restoration,53,23,30
Lacid,tichondrius,1627,shaman,restoration,62,40,22
Fujiyama,dark-iron,1626,shaman,restoration,114,63,51
Zeonard,ragnaros,1626,shaman,restoration,64,34,30
Lilgeeh,kelthuzad,1626,shaman,restoration,36,18,18
Grizze,bonechewer,1626,shaman,restoration,90,41,49
Goranzo,emerald-dream,1626,shaman,restoration,54,24,30
Peegee,zuluhed,1626,shaman,restoration,60,24,36
Sin,bleeding-hollow,1625,shaman,restoration,30,17,13
Oldguy,ragnaros,1622,shaman,restoration,59,30,29
Grymn,sargeras,1622,shaman,restoration,136,59,77
Thuntard,bleeding-hollow,1621,shaman,restoration,48,23,25
Pingatronx,ragnaros,1619,shaman,restoration,36,17,19
Héadshot,bleeding-hollow,1619,shaman,restoration,65,28,37
Bigdictuna,sargeras,1616,shaman,restoration,131,74,57
Mitchestic,illidan,1615,shaman,restoration,42,17,25
Montageb,illidan,1614,shaman,restoration,32,23,9
Skoobasteeve,sargeras,1614,shaman,restoration,69,39,30
World,frostmourne,1614,shaman,restoration,47,25,22
Quendella,aggramar,1613,shaman,restoration,42,25,17
Polared,hyjal,1613,shaman,restoration,52,25,27
Skipler,stormrage,1610,shaman,restoration,48,25,23
Drammah,malganis,1610,shaman,restoration,48,19,29
Akheeta,tichondrius,1608,shaman,restoration,51,37,14
Ðoomed,kiljaeden,1608,shaman,restoration,30,19,11
Bubbacheeks,area-52,1608,shaman,restoration,42,23,19
Plzdontlos,illidan,1607,shaman,restoration,113,69,44
Randomshammy,area-52,1606,shaman,restoration,30,17,13
Astrauk,nemesis,1606,shaman,restoration,76,43,33
Raxshock,stormrage,1606,shaman,restoration,42,22,20
Prêttylights,bleeding-hollow,1605,shaman,restoration,30,17,13
Hexrz,area-52,1605,shaman,restoration,42,21,21
Sliditin,tichondrius,1604,shaman,restoration,36,25,11
Oninobu,sargeras,1604,shaman,restoration,28,18,10
Hurú,azralon,1604,shaman,restoration,36,21,15
Kratór,kelthuzad,1603,shaman,restoration,47,31,16
Fernetbrança,ragnaros,1603,shaman,restoration,48,26,22
Telchar,quelthalas,1602,shaman,restoration,102,62,40
Asnalda,emerald-dream,1602,shaman,restoration,51,30,21
Rugmat,tichondrius,1602,shaman,restoration,48,24,24
Purgebotx,bleeding-hollow,1601,shaman,restoration,114,70,44
Foilcap,bonechewer,1600,shaman,restoration,296,144,152
Ddogz,illidan,1600,shaman,restoration,48,21,27
Gulmuwu,zuljin,1599,shaman,restoration,38,22,16
Mastlau,tichondrius,1599,shaman,restoration,30,17,13
Tevya,dalvengyr,1598,shaman,restoration,78,44,34
Tideoverdose,tichondrius,1594,shaman,restoration,36,19,17
Charlesby,tichondrius,1593,shaman,restoration,126,73,53
Shocksauce,tichondrius,1590,shaman,restoration,53,28,25
Tzyorz,illidan,1589,shaman,restoration,54,31,23
Xzxz,sargeras,1588,shaman,restoration,109,60,49
Besylate,illidan,1586,shaman,restoration,80,39,41
Shamsom,tichondrius,1586,shaman,restoration,104,49,55
Kolanji,akama,1585,shaman,restoration,41,22,19
Muggz,sargeras,1585,shaman,restoration,42,19,23
Improvedx,akama,1583,shaman,restoration,41,21,20
Tpokes,sargeras,1580,shaman,restoration,36,18,18
Kromgul,malfurion,1580,shaman,restoration,42,19,23
Turborundat,area-52,1579,shaman,restoration,201,115,86
Flubydont,icecrown,1578,shaman,restoration,48,24,24
Sewerperson,zuljin,1578,shaman,restoration,36,18,18
Ethikas,tichondrius,1577,shaman,restoration,36,20,16
Rynoh,dalaran,1575,shaman,restoration,109,54,55
Rainz,aggramar,1574,shaman,restoration,42,22,20
Arkerus,emerald-dream,1573,shaman,restoration,36,22,14
Dawnyshock,arygos,1573,shaman,restoration,41,19,22
Strives,icecrown,1573,shaman,restoration,48,21,27
Improvize,malganis,1571,shaman,restoration,53,25,28
Rogrim,malganis,1570,shaman,restoration,48,24,24
Sikotics,area-52,1568,shaman,restoration,111,58,53
Moosk,zuluhed,1567,shaman,restoration,51,27,24
Spurske,emerald-dream,1564,shaman,restoration,78,32,46
Bigdampurge,illidan,1563,shaman,restoration,95,49,46
Gyrogg,scilla,1563,shaman,restoration,381,194,187
Waater,lightbringer,1562,shaman,restoration,86,49,37
Bwinthewomb,stormrage,1561,shaman,restoration,136,74,62
Gki,tichondrius,1560,shaman,restoration,37,26,11
Mudlùst,moon-guard,1560,shaman,restoration,62,35,27
Wilmar,ragnaros,1560,shaman,restoration,66,33,33
Intruzionall,barthilas,1558,shaman,restoration,136,72,64
Rulf,proudmoore,1558,shaman,restoration,90,34,56
Bighaircut,darkspear,1555,shaman,restoration,72,33,39
Kimchimi,tichondrius,1553,shaman,restoration,66,41,25
Goatedsham,dalaran,1553,shaman,restoration,65,36,29
Pherolex,tichondrius,1550,shaman,restoration,42,23,19
Tehrani,winterhoof,1550,shaman,restoration,36,18,18
Hwyl,frostmourne,1549,shaman,restoration,60,27,33
Lanzero,chogall,1547,shaman,restoration,42,30,12
Steveyy,frostmourne,1544,shaman,restoration,27,17,10
Tyar,area-52,1543,shaman,restoration,137,64,73
Chainstuff,area-52,1541,shaman,restoration,29,17,12
Santiagodx,ragnaros,1541,shaman,restoration,36,20,16
Akubai,kelthuzad,1537,shaman,restoration,60,30,30
Riptideafk,sargeras,1536,shaman,restoration,48,25,23
Redek,sargeras,1534,shaman,restoration,167,92,75
Namso,tichondrius,1534,shaman,restoration,30,16,14
Mistarklean,malganis,1534,shaman,restoration,99,42,57
Ärtful,illidan,1533,shaman,restoration,30,22,8
Aguinha,azralon,1533,shaman,restoration,60,33,27
Succmytotems,tichondrius,1533,shaman,restoration,69,33,36
Tides,skullcrusher,1533,shaman,restoration,42,18,24
Draidosh,area-52,1532,shaman,restoration,36,23,13
Benta,zuljin,1530,shaman,restoration,64,35,29
Spongemama,tichondrius,1530,shaman,restoration,47,25,22
Rookieshaman,tichondrius,1528,shaman,restoration,24,16,8
Belshiro,sargeras,1528,shaman,restoration,90,39,51
Dogecoincäsh,sargeras,1527,shaman,restoration,46,25,21
Kayadee,stormrage,1527,shaman,restoration,63,29,34
Rinnan,malganis,1524,shaman,restoration,97,48,49
Platewalrus,illidan,1523,shaman,restoration,30,16,14
Hehew,kelthuzad,1523,shaman,restoration,122,61,61
Killercam,maiev,1523,shaman,restoration,207,102,105
Furrytotems,darkspear,1523,shaman,restoration,120,56,64
Kaytahn,proudmoore,1520,shaman,restoration,66,36,30
Rocyt,sargeras,1520,shaman,restoration,66,35,31
Boxfour,tichondrius,1519,shaman,restoration,36,16,20
Hairyrichard,zuljin,1517,shaman,restoration,629,324,305
Jbalvi,ragnaros,1516,shaman,restoration,75,44,31
Freesolo,barthilas,1516,shaman,restoration,152,76,76
Zuralah,nemesis,1515,shaman,restoration,46,25,21
Shamankïng,proudmoore,1512,shaman,restoration,77,40,37
Prowdt,azralon,1511,shaman,restoration,299,153,146
Worldx,barthilas,1511,shaman,restoration,84,40,44
Heniu,tichondrius,1511,shaman,restoration,36,16,20
Shamansrock,tichondrius,1509,shaman,restoration,36,16,20
Gemoz,tichondrius,1508,shaman,restoration,24,16,8
Draüguss,azralon,1508,shaman,restoration,72,35,37
Shamxrob,sargeras,1507,shaman,restoration,72,42,30
Plâto,stormrage,1507,shaman,restoration,30,16,14
Gattious,illidan,1507,shaman,restoration,48,25,23
Trapghost,cenarius,1506,shaman,restoration,87,41,46
Packspiritqt,tichondrius,1505,shaman,restoration,42,21,21
Shulace,area-52,1505,shaman,restoration,36,17,19
Harigomi,tichondrius,1504,shaman,restoration,112,56,56
Randomshammy,stormrage,1504,shaman,restoration,54,27,27
Cokehealsx,tichondrius,1503,shaman,restoration,30,16,14
Agharn,moon-guard,1503,shaman,restoration,51,26,25
Shadowz,alexstrasza,1502,shaman,restoration,30,18,12
Foragorn,stormrage,1502,shaman,restoration,103,47,56
Rsdyxjh,tichondrius,1502,shaman,restoration,45,19,26
Drekkhal,area-52,1498,shaman,restoration,54,30,24
Ban,blackrock,1498,shaman,restoration,39,21,18
Hachikø,frostmourne,1498,shaman,restoration,54,25,29
Yarl,ragnaros,1497,shaman,restoration,30,19,11
Elementàlius,quelthalas,1497,shaman,restoration,71,32,39
Mentyb,emerald-dream,1491,shaman,restoration,42,16,26
Hyonkh,tichondrius,1487,shaman,restoration,77,45,32
Cultsulyvahn,tichondrius,1487,shaman,restoration,43,21,22
Kaaying,tichondrius,1487,shaman,restoration,43,17,26
Pawbed,aegwynn,1484,shaman,restoration,58,34,24
Chitoss,gorgonnash,1484,shaman,restoration,59,30,29
Thegil,tichondrius,1484,shaman,restoration,72,32,40
ßread,illidan,1484,shaman,restoration,56,21,35
Trenhance,stormrage,1481,shaman,restoration,30,23,7
Krewesham,uldaman,1481,shaman,restoration,28,17,11
Wuruizec,illidan,1481,shaman,restoration,47,23,24
Abellone,tichondrius,1480,shaman,restoration,33,17,16
Ryukims,tichondrius,1477,shaman,restoration,35,17,18
Defac,proudmoore,1475,shaman,restoration,72,42,30
Maxchungie,azshara,1475,shaman,restoration,30,16,14
Angelabaaby,proudmoore,1475,shaman,restoration,60,28,32
Yossarabi,bleeding-hollow,1475,shaman,restoration,54,23,31
Brainal,sargeras,1472,shaman,restoration,60,25,35
Pissticles,bleeding-hollow,1471,shaman,restoration,150,75,75
Neosham,frostwolf,1470,shaman,restoration,42,16,26
Ballistíc,boulderfist,1468,shaman,restoration,60,34,26
Philbert,boulderfist,1466,shaman,restoration,42,25,17
Shockszz,onyxia,1466,shaman,restoration,108,50,58
Ãrthor,stormrage,1464,shaman,restoration,66,37,29
Hirah,frostmourne,1460,shaman,restoration,23,16,7
Smartakkar,emerald-dream,1460,shaman,restoration,57,36,21
Nilstorm,quelthalas,1458,shaman,restoration,72,38,34
Kwzy,stormrage,1457,shaman,restoration,51,26,25
Goatpornbad,sargeras,1457,shaman,restoration,96,44,52
Tizz,quelthalas,1456,shaman,restoration,112,54,58
Whoshealing,lightninghoof,1455,shaman,restoration,66,35,31
Harth,zuljin,1454,shaman,restoration,72,40,32
Ssaotizi,tichondrius,1454,shaman,restoration,196,91,105
Totemgoddess,nemesis,1453,shaman,restoration,42,20,22
Carltonbanks,aggramar,1452,shaman,restoration,36,18,18
Tidalstorm,ragnaros,1450,shaman,restoration,90,52,38
Mkyz,tichondrius,1450,shaman,restoration,52,28,24
Enalen,argent-dawn,1449,shaman,restoration,57,34,23
Buffduude,shadowsong,1449,shaman,restoration,48,22,26
Bluedynamite,tichondrius,1449,shaman,restoration,42,18,24
Hugebrain,proudmoore,1448,shaman,restoration,118,48,70
Bazinguinha,azralon,1445,shaman,restoration,36,19,17
Subnôize,bleeding-hollow,1444,shaman,restoration,44,30,14
Joltik,area-52,1444,shaman,restoration,173,84,89
Rumkin,malganis,1443,shaman,restoration,72,40,32
Vzla,ragnaros,1443,shaman,restoration,78,41,37
Milkkshake,illidan,1443,shaman,restoration,250,116,134
Vanklayser,ragnaros,1440,shaman,restoration,72,34,38
Nezzuk,quelthalas,1439,shaman,restoration,42,22,20
Breadx,khaz-modan,1439,shaman,restoration,30,15,15
Miketheseal,bleeding-hollow,1437,shaman,restoration,36,15,21
Glocksitotem,malganis,1436,shaman,restoration,63,37,26
Creatine,area-52,1436,shaman,restoration,71,37,34
Tenyks,tichondrius,1436,shaman,restoration,51,26,25
Halfinha,nemesis,1436,shaman,restoration,157,76,81
Sarkhanvol,aggramar,1435,shaman,restoration,24,17,7
Dawny,arygos,1435,shaman,restoration,36,15,21
Siyusm,illidan,1435,shaman,restoration,60,21,39
Ghomragar,antonidas,1434,shaman,restoration,24,15,9
Wardruna,andorhal,1434,shaman,restoration,24,15,9
Lustlolol,korgath,1433,shaman,restoration,75,33,42
Geser,silvermoon,1432,shaman,restoration,44,26,18
Insertyzs,azralon,1431,shaman,restoration,66,36,30
Kabasan,illidan,1431,shaman,restoration,60,27,33
Totem,burning-legion,1431,shaman,restoration,36,16,20
Fatherrtime,illidan,1430,shaman,restoration,48,26,22
Erthshawk,wildhammer,1429,shaman,restoration,60,30,30
Fierymoo,frostmourne,1429,shaman,restoration,36,15,21
Totembarx,illidan,1428,shaman,restoration,42,29,13
Duregar,tichondrius,1425,shaman,restoration,24,15,9
Wuargh,area-52,1423,shaman,restoration,214,114,100
Kelta,kelthuzad,1423,shaman,restoration,30,15,15
Naweiv,caelestrasz,1422,shaman,restoration,30,15,15
Samanl,tichondrius,1420,shaman,restoration,77,44,33
Cinematticz,tichondrius,1420,shaman,restoration,101,51,50
Pýe,bleeding-hollow,1420,shaman,restoration,42,21,21
Slothstorm,barthilas,1419,shaman,restoration,59,31,28
Springtide,thrall,1416,shaman,restoration,53,26,27
Djshammy,barthilas,1414,shaman,restoration,80,42,38
Bearmanshrek,tichondrius,1414,shaman,restoration,72,26,46
Tawahka,hyjal,1412,shaman,restoration,179,87,92
Bitxxnumber,tichondrius,1411,shaman,restoration,175,94,81
Enflexi,lightbringer,1411,shaman,restoration,53,26,27
Tundertotem,tichondrius,1410,shaman,restoration,57,32,25
Orkwa,bleeding-hollow,1410,shaman,restoration,68,32,36
Catchclause,eonar,1409,shaman,restoration,30,15,15
Fuzzymuzzy,illidan,1407,shaman,restoration,30,15,15
Pèpé,sargeras,1405,shaman,restoration,32,19,13
Zizö,barthilas,1404,shaman,restoration,42,19,23
Trúnks,magtheridon,1402,shaman,restoration,48,27,21
Supdaug,vashj,1402,shaman,restoration,66,32,34
Buffdestru,azralon,1401,shaman,restoration,95,55,40
Sploosh,norgannon,1401,shaman,restoration,36,20,16
Bluetooth,stormrage,1401,shaman,restoration,89,39,50
Ironcrag,moon-guard,1398,shaman,restoration,200,102,98
Stylesp,area-52,1396,shaman,restoration,125,58,67
Mlpz,black-dragonflight,1395,shaman,restoration,42,22,20
Circuits,malganis,1395,shaman,restoration,35,18,17
Drinkharder,stormrage,1395,shaman,restoration,34,16,18
Arginine,tichondrius,1395,shaman,restoration,42,15,27
Kachupinsito,ragnaros,1394,shaman,restoration,79,42,37
Prøduce,tichondrius,1393,shaman,restoration,45,27,18
Kakiscala,proudmoore,1393,shaman,restoration,30,16,14
ßøvîn,thrall,1393,shaman,restoration,71,36,35
Windfrenzy,thrall,1392,shaman,restoration,36,15,21
Nomediocur,moknathal,1390,shaman,restoration,59,23,36
Rizam,malganis,1389,shaman,restoration,42,33,9
Shaquillius,tichondrius,1389,shaman,restoration,36,17,19
Amperage,spirestone,1387,shaman,restoration,46,22,24
Soowecide,tichondrius,1387,shaman,restoration,60,23,37
Elex,frostmourne,1386,shaman,restoration,36,15,21
Shazik,spirestone,1386,shaman,restoration,54,21,33
Fungus,firetree,1384,shaman,restoration,42,23,19
Fishman,exodar,1382,shaman,restoration,101,45,56
Onepunchsham,illidan,1382,shaman,restoration,70,31,39
Çruces,illidan,1381,shaman,restoration,36,17,19
Lanuur,moon-guard,1379,shaman,restoration,54,31,23
Kephax,eonar,1378,shaman,restoration,69,34,35
Kiojin,ragnaros,1375,shaman,restoration,180,97,83
Voluptuous,mannoroth,1374,shaman,restoration,301,150,151
Praxis,tichondrius,1374,shaman,restoration,142,70,72
Jensenx,proudmoore,1374,shaman,restoration,82,38,44
Kandin,icecrown,1373,shaman,restoration,71,36,35
Kirawindu,zuljin,1371,shaman,restoration,42,25,17
Kaili,illidan,1370,shaman,restoration,41,25,16
Gromgrai,bleeding-hollow,1368,shaman,restoration,53,30,23
Charmize,azralon,1366,shaman,restoration,60,32,28
Krevsham,proudmoore,1364,shaman,restoration,56,23,33
Ralinta,tichondrius,1364,shaman,restoration,77,27,50
Wooskier,tichondrius,1363,shaman,restoration,45,25,20
Ryùko,proudmoore,1363,shaman,restoration,60,19,41
Fwwrs,illidan,1359,shaman,restoration,25,16,9
Sàuron,tichondrius,1359,shaman,restoration,37,20,17
Wyått,emerald-dream,1359,shaman,restoration,95,43,52
Fàrrò,thrall,1355,shaman,restoration,30,20,10
Alexustexas,tichondrius,1353,shaman,restoration,30,16,14
Message,agamaggan,1353,shaman,restoration,546,270,276
Tumble,frostmourne,1352,shaman,restoration,105,51,54
Køtømine,ragnaros,1349,shaman,restoration,58,36,22
Chandye,proudmoore,1348,shaman,restoration,72,27,45
Orjamba,barthilas,1347,shaman,restoration,29,17,12
Daddyk,gnomeregan,1347,shaman,restoration,53,30,23
Crittingbull,veknilash,1347,shaman,restoration,88,42,46
Lildunny,tichondrius,1346,shaman,restoration,36,15,21
Kultirio,quelthalas,1344,shaman,restoration,61,32,29
Elemen,quelthalas,1344,shaman,restoration,97,48,49
Unchaman,ragnaros,1344,shaman,restoration,50,19,31
Jîneth,tichondrius,1343,shaman,restoration,24,14,10
Esqueue,sargeras,1343,shaman,restoration,24,14,10
Squimbert,tichondrius,1343,shaman,restoration,30,14,16
Muscleyuan,tichondrius,1342,shaman,restoration,35,14,21
Camer,sargeras,1341,shaman,restoration,18,14,4
Fluxxy,tichondrius,1341,shaman,restoration,36,14,22
Xoweeknd,bleeding-hollow,1340,shaman,restoration,30,14,16
Nyathera,barthilas,1339,shaman,restoration,42,24,18
Durogh,darkspear,1336,shaman,restoration,36,14,22
Shakrakhan,tichondrius,1335,shaman,restoration,30,14,16
Boggins,dalaran,1334,shaman,restoration,42,21,21
Aseew,drakkari,1334,shaman,restoration,66,31,35
Libragirl,tichondrius,1334,shaman,restoration,42,18,24
Azhen,ragnaros,1333,shaman,restoration,102,51,51
Goobie,crushridge,1332,shaman,restoration,18,14,4
Zinns,dalaran,1332,shaman,restoration,30,15,15
Jazzlightnin,tichondrius,1331,shaman,restoration,36,14,22
Leca,tichondrius,1328,shaman,restoration,30,14,16
Huroth,proudmoore,1328,shaman,restoration,42,14,28
Brongar,bleeding-hollow,1327,shaman,restoration,42,14,28
Meatballer,queldorei,1325,shaman,restoration,77,42,35
Crazytotems,dalaran,1325,shaman,restoration,106,55,51
Ginkuma,illidan,1325,shaman,restoration,30,14,16
Afgoox,tichondrius,1324,shaman,restoration,84,47,37
Gangzmmsk,tichondrius,1322,shaman,restoration,18,14,4
Zuljiba,illidan,1322,shaman,restoration,60,35,25
Restosud,crushridge,1320,shaman,restoration,30,18,12
Sittinn,malganis,1320,shaman,restoration,30,14,16
Infsham,hyjal,1320,shaman,restoration,60,27,33
Cleanfossil,stormrage,1319,shaman,restoration,41,24,17
Eekumbokum,bleeding-hollow,1318,shaman,restoration,50,29,21
Bearlysober,draka,1318,shaman,restoration,44,24,20
Badião,azralon,1318,shaman,restoration,131,58,73
Clutchinbuds,malganis,1318,shaman,restoration,48,21,27
Xaltas,moon-guard,1314,shaman,restoration,24,16,8
Vibration,akama,1312,shaman,restoration,78,41,37
Barbosina,stormrage,1311,shaman,restoration,220,113,107
Ithappens,senjin,1310,shaman,restoration,30,16,14
Reuxxe,area-52,1310,shaman,restoration,149,74,75
Entropey,daggerspine,1310,shaman,restoration,30,14,16
Zetli,tichondrius,1310,shaman,restoration,48,19,29
Orlá,moon-guard,1310,shaman,restoration,54,18,36
Hefestos,nemesis,1309,shaman,restoration,30,14,16
Absorblife,barthilas,1309,shaman,restoration,69,31,38
Toteapole,malganis,1308,shaman,restoration,76,42,34
Aelwydx,quelthalas,1307,shaman,restoration,239,124,115
Feldstar,stormrage,1306,shaman,restoration,95,43,52
Torgah,tichondrius,1305,shaman,restoration,90,44,46
Genjuu,proudmoore,1304,shaman,restoration,42,20,22
Wunderwaffe,the-underbog,1303,shaman,restoration,46,22,24
Hüsky,dalaran,1303,shaman,restoration,42,14,28
Tumble,barthilas,1302,shaman,restoration,52,26,26
Badgeshock,area-52,1301,shaman,restoration,108,48,60
Cæl,azralon,1300,shaman,restoration,35,20,15
Bigtoy,frostmane,1296,shaman,restoration,42,14,28
Hicys,azralon,1292,shaman,restoration,38,23,15
Slaggdaddy,durotan,1292,shaman,restoration,30,14,16
Thunderborn,laughing-skull,1292,shaman,restoration,30,14,16
Derkx,thrall,1289,shaman,restoration,24,20,4
Graveman,illidan,1289,shaman,restoration,75,37,38
Aviator,muradin,1288,shaman,restoration,36,19,17
Belgrom,tichondrius,1287,shaman,restoration,42,23,19
Drazic,area-52,1286,shaman,restoration,49,28,21
Mynigabob,zuljin,1285,shaman,restoration,148,83,65
Shamorrhoids,frostmourne,1285,shaman,restoration,137,70,67
Ketaminedrip,illidan,1284,shaman,restoration,42,22,20
Stargun,korgath,1284,shaman,restoration,147,76,71
Alraxion,ragnaros,1281,shaman,restoration,84,41,43
Ulala,azshara,1280,shaman,restoration,72,31,41
Hasselshock,area-52,1280,shaman,restoration,94,40,54
Aemi,tichondrius,1279,shaman,restoration,102,45,57
Youneverknow,frostmourne,1278,shaman,restoration,137,68,69
Noobcrits,tichondrius,1276,shaman,restoration,24,14,10
Mudeng,tichondrius,1276,shaman,restoration,60,30,30
Retgarr,tichondrius,1272,shaman,restoration,30,17,13
Foodlust,sargeras,1272,shaman,restoration,108,57,51
Tákhisis,darkspear,1271,shaman,restoration,72,33,39
Angelicrain,stormrage,1269,shaman,restoration,30,16,14
Thomastides,tichondrius,1268,shaman,restoration,78,36,42
Pushaheal,tichondrius,1267,shaman,restoration,42,23,19
Aceshamm,kelthuzad,1265,shaman,restoration,42,20,22
Joocer,emerald-dream,1265,shaman,restoration,60,27,33
Shiestys,tichondrius,1264,shaman,restoration,33,23,10
Shohzegky,azralon,1264,shaman,restoration,91,40,51
Defnotheals,kelthuzad,1261,shaman,restoration,84,38,46
Menah,moon-guard,1260,shaman,restoration,36,20,16
Hauby,zuljin,1259,shaman,restoration,48,15,33
Shimansham,aegwynn,1258,shaman,restoration,155,74,81
Jaandar,saurfang,1257,shaman,restoration,72,36,36
Woodrose,frostmourne,1257,shaman,restoration,52,24,28
Tedmosbe,tichondrius,1257,shaman,restoration,78,32,46
Ragerax,trollbane,1254,shaman,restoration,23,16,7
Brislin,sargeras,1252,shaman,restoration,105,51,54
Mishalla,tichondrius,1252,shaman,restoration,60,22,38
Luto,tichondrius,1251,shaman,restoration,130,71,59
Blodbar,kiljaeden,1249,shaman,restoration,36,24,12
Peppito,illidan,1249,shaman,restoration,45,27,18
Watchmytrem,ragnaros,1249,shaman,restoration,60,20,40
Evilabev,bonechewer,1248,shaman,restoration,24,13,11
Toroph,azralon,1248,shaman,restoration,30,16,14
Bigwave,zuluhed,1248,shaman,restoration,30,15,15
Tôôz,stormrage,1247,shaman,restoration,18,13,5
Drfentanylx,emerald-dream,1247,shaman,restoration,24,13,11
Krishshammy,azshara,1247,shaman,restoration,100,48,52
Moorgl,tichondrius,1246,shaman,restoration,24,13,11
Funkesapien,tichondrius,1246,shaman,restoration,24,13,11
Tacho,bleeding-hollow,1246,shaman,restoration,34,15,19
Hooldcool,tichondrius,1245,shaman,restoration,77,41,36
Tayictwo,tichondrius,1244,shaman,restoration,24,13,11
Shoxx,wyrmrest-accord,1243,shaman,restoration,24,13,11
Nyf,khazgoroth,1243,shaman,restoration,24,13,11
Jsoto,ghostlands,1243,shaman,restoration,30,13,17
Colterr,thunderhorn,1242,shaman,restoration,24,13,11
Sharmut,bleeding-hollow,1242,shaman,restoration,117,59,58
Harbert,black-dragonflight,1240,shaman,restoration,36,17,19
Maserati,korialstrasz,1240,shaman,restoration,54,23,31
Shamfold,illidan,1239,shaman,restoration,24,13,11
Jnzz,area-52,1239,shaman,restoration,24,13,11
Beefstocks,area-52,1238,shaman,restoration,66,32,34
Lastdwarf,tichondrius,1237,shaman,restoration,18,13,5
Shamakazi,tichondrius,1237,shaman,restoration,31,14,17
Sleepysham,kelthuzad,1237,shaman,restoration,36,13,23
Chingobling,illidan,1234,shaman,restoration,24,13,11
Krolii,tichondrius,1234,shaman,restoration,80,33,47
Shamicare,stormrage,1232,shaman,restoration,136,75,61
Kinjin,dragonmaw,1232,shaman,restoration,30,13,17
Quakess,zuljin,1232,shaman,restoration,36,13,23
Xajsham,tichondrius,1231,shaman,restoration,96,51,45
Satrixss,ragnaros,1231,shaman,restoration,56,28,28
Conjunction,azjolnerub,1231,shaman,restoration,29,13,16
Fênrisulfer,area-52,1231,shaman,restoration,89,37,52
Kikkóman,malganis,1230,shaman,restoration,48,25,23
Lüca,wyrmrest-accord,1229,shaman,restoration,256,139,117
Edemental,area-52,1229,shaman,restoration,129,61,68
Sindury,tichondrius,1226,shaman,restoration,54,28,26
Splonkydonky,stonemaul,1225,shaman,restoration,24,13,11
Ozzai,ragnaros,1225,shaman,restoration,42,15,27
Shaokhang,emerald-dream,1222,shaman,restoration,52,19,33
Hoong,garrosh,1219,shaman,restoration,32,17,15
Lavablurst,stormrage,1218,shaman,restoration,59,23,36
Babytiramisu,stormrage,1217,shaman,restoration,36,16,20
Ekuku,tichondrius,1215,shaman,restoration,40,19,21
Smashtheface,nagrand,1211,shaman,restoration,54,27,27
Killdeaderer,barthilas,1209,shaman,restoration,90,54,36
Certz,dark-iron,1209,shaman,restoration,39,15,24
Terdsammich,malganis,1205,shaman,restoration,42,21,21
Thunderphury,proudmoore,1205,shaman,restoration,35,13,22
Patoron,proudmoore,1204,shaman,restoration,34,17,17
Bluffin,stormrage,1200,shaman,restoration,18,14,4
Magnethor,frostmourne,1200,shaman,restoration,42,24,18
Redbulls,azralon,1198,shaman,restoration,96,54,42
Cruelface,sargeras,1196,shaman,restoration,26,14,12
Synkrona,tichondrius,1191,shaman,restoration,38,16,22
Furti,daggerspine,1190,shaman,restoration,34,16,18
Kinshaman,lightnings-blade,1188,shaman,restoration,55,26,29
Lokhtar,zuljin,1184,shaman,restoration,36,17,19
Getwetand,quelthalas,1182,shaman,restoration,103,51,52
Stabix,tichondrius,1181,shaman,restoration,66,31,35
Rimmington,frostmourne,1179,shaman,restoration,54,24,30
Dcãicer,quelthalas,1178,shaman,restoration,25,15,10
Käck,tichondrius,1178,shaman,restoration,56,27,29
Flametide,proudmoore,1176,shaman,restoration,35,20,15
Dabmarinø,tichondrius,1174,shaman,restoration,24,14,10
Vanty,proudmoore,1170,shaman,restoration,29,13,16
Shammimane,tichondrius,1169,shaman,restoration,107,53,54
Hedbang,kiljaeden,1169,shaman,restoration,60,24,36
Wazöö,sargeras,1168,shaman,restoration,63,28,35
Oomshamm,area-52,1167,shaman,restoration,130,68,62
Shazikial,illidan,1167,shaman,restoration,38,18,20
Restoramen,frostmourne,1166,shaman,restoration,24,13,11
Senzxlolxz,lightbringer,1165,shaman,restoration,45,29,16
Onpoint,frostmourne,1165,shaman,restoration,23,13,10
Hammerme,barthilas,1161,shaman,restoration,101,35,66
Stahlman,blackhand,1160,shaman,restoration,48,17,31
Delayy,destromath,1155,shaman,restoration,65,29,36
Drboidzerg,tichondrius,1154,shaman,restoration,32,20,12
Dahmerjr,area-52,1153,shaman,restoration,78,43,35
Dbmx,tichondrius,1152,shaman,restoration,24,12,12
Badjojò,ragnaros,1152,shaman,restoration,24,12,12
Rawdòggin,emerald-dream,1152,shaman,restoration,33,13,20
Ruupaul,kiljaeden,1151,shaman,restoration,18,12,6
Booramz,tichondrius,1151,shaman,restoration,18,12,6
Lignipzyo,doomhammer,1151,shaman,restoration,24,12,12
Sunyang,tichondrius,1151,shaman,restoration,24,12,12
Suyy,tichondrius,1151,shaman,restoration,30,12,18
Gödöfbüdå,tichondrius,1150,shaman,restoration,18,12,6
Uglybastrd,stormrage,1150,shaman,restoration,24,12,12
Uhd,malganis,1150,shaman,restoration,32,13,19
Ixis,bleeding-hollow,1149,shaman,restoration,18,12,6
Noolube,barthilas,1148,shaman,restoration,24,12,12
Jineluki,emerald-dream,1148,shaman,restoration,53,23,30
Mcwindyfists,zuljin,1148,shaman,restoration,30,12,18
Flamehorns,malganis,1147,shaman,restoration,18,12,6
Xiaoxiboy,tichondrius,1147,shaman,restoration,24,12,12
Ricn,tichondrius,1147,shaman,restoration,24,12,12
Tesle,illidan,1147,shaman,restoration,30,12,18
Dduddaddu,tichondrius,1146,shaman,restoration,24,12,12
Bitruff,tichondrius,1146,shaman,restoration,24,12,12
Mäjorlazer,lightbringer,1144,shaman,restoration,18,12,6
Boltadeez,tichondrius,1144,shaman,restoration,24,12,12
Szeav,tichondrius,1143,shaman,restoration,24,12,12
Redds,tichondrius,1141,shaman,restoration,18,12,6
Hannamayzing,arathor,1135,shaman,restoration,30,12,18
Mandinga,warsong,1134,shaman,restoration,65,28,37
Solaraa,proudmoore,1133,shaman,restoration,28,13,15
Gsync,tichondrius,1131,shaman,restoration,41,27,14
Smooths,bloodscalp,1131,shaman,restoration,30,16,14
Meanbetty,illidan,1131,shaman,restoration,24,12,12
Lechaman,hakkar,1131,shaman,restoration,66,22,44
Darrann,kiljaeden,1126,shaman,restoration,18,12,6
Dinaliia,lothar,1126,shaman,restoration,36,16,20
Donmills,tichondrius,1122,shaman,restoration,24,12,12
Laterallus,nagrand,1121,shaman,restoration,67,34,33
Rocksteddy,area-52,1120,shaman,restoration,24,12,12
Fencepost,bleeding-hollow,1118,shaman,restoration,18,12,6
Kunio,proudmoore,1117,shaman,restoration,24,12,12
Shamanceylol,barthilas,1116,shaman,restoration,21,13,8
Tartar,lightbringer,1112,shaman,restoration,29,18,11
Cameltotêm,frostmourne,1109,shaman,restoration,24,14,10
Taò,tichondrius,1109,shaman,restoration,84,38,46
Roxzid,area-52,1105,shaman,restoration,20,13,7
Shammyguy,stormreaver,1103,shaman,restoration,50,23,27
Totemist,tichondrius,1100,shaman,restoration,36,12,24
Thräll,shuhalo,1097,shaman,restoration,190,93,97
Sparks,ragnaros,1093,shaman,restoration,23,12,11
Stormburst,sargeras,1092,shaman,restoration,42,20,22
Peanutto,illidan,1090,shaman,restoration,48,28,20
Taquitho,quelthalas,1088,shaman,restoration,69,29,40
Mikeisbadwow,tichondrius,1086,shaman,restoration,16,12,4
Ðno,frostmourne,1086,shaman,restoration,17,12,5
Saicey,zuljin,1081,shaman,restoration,54,24,30
Grimmzhul,daggerspine,1077,shaman,restoration,90,43,47
Turbluscious,frostmourne,1074,shaman,restoration,49,26,23
Elharm,ragnaros,1072,shaman,restoration,36,13,23
Hazorele,nagrand,1069,shaman,restoration,48,23,25
Grullander,hakkar,1063,shaman,restoration,36,20,16
Sekkuo,kiljaeden,1061,shaman,restoration,60,28,32
Littledream,quelthalas,1061,shaman,restoration,58,26,32
Nickwoper,emerald-dream,1056,shaman,restoration,18,11,7
Biofly,thrall,1056,shaman,restoration,18,11,7
Lfgzookeeper,malganis,1056,shaman,restoration,18,11,7
Brocules,aerie-peak,1056,shaman,restoration,24,11,13
Censyzz,tichondrius,1056,shaman,restoration,24,11,13
Imd,tichondrius,1055,shaman,restoration,18,11,7
Specifyz,arathor,1055,shaman,restoration,18,11,7
Sweetpotatoe,malganis,1055,shaman,restoration,24,11,13
Pericazo,sargeras,1055,shaman,restoration,24,11,13
Haard,area-52,1055,shaman,restoration,24,11,13
Jtrxs,tichondrius,1055,shaman,restoration,24,11,13
Mindgooblin,sargeras,1055,shaman,restoration,36,11,25
Ituma,tichondrius,1054,shaman,restoration,18,11,7
Damoclez,jubeithos,1054,shaman,restoration,18,11,7
Sipo,tichondrius,1054,shaman,restoration,18,11,7
Earthfirex,ragnaros,1054,shaman,restoration,18,11,7
Keybordternr,tichondrius,1054,shaman,restoration,24,11,13
Elmonkeyloco,bleeding-hollow,1053,shaman,restoration,18,11,7
Yoshìmìtsu,illidan,1053,shaman,restoration,24,11,13
Murm,burning-blade,1053,shaman,restoration,24,11,13
Velesa,kiljaeden,1052,shaman,restoration,30,11,19
Urin,emerald-dream,1051,shaman,restoration,21,11,10
Psiexrcst,tichondrius,1051,shaman,restoration,24,11,13
Glark,tichondrius,1051,shaman,restoration,24,11,13
Bluebones,frostmane,1050,shaman,restoration,18,11,7
Dragum,blackrock,1050,shaman,restoration,30,11,19
Blowurbubble,tichondrius,1049,shaman,restoration,18,11,7
Groundded,tichondrius,1049,shaman,restoration,29,11,18
Ryuukas,illidan,1047,shaman,restoration,18,11,7
Mcstop,tanaris,1046,shaman,restoration,36,15,21
Babibolo,duskwood,1045,shaman,restoration,18,11,7
Tràuma,caelestrasz,1045,shaman,restoration,45,13,32
Edhance,area-52,1044,shaman,restoration,18,11,7
Gl,nordrassil,1043,shaman,restoration,18,11,7
Saraguthix,dalaran,1043,shaman,restoration,30,11,19
Twoflower,frostmourne,1043,shaman,restoration,66,24,42
Mvpstorm,darkspear,1041,shaman,restoration,24,11,13
Zugzugthug,moon-guard,1040,shaman,restoration,84,33,51
Exportgold,barthilas,1039,shaman,restoration,24,11,13
Truemooin,wyrmrest-accord,1036,shaman,restoration,215,105,110
Bóòchainz,tichondrius,1024,shaman,restoration,16,12,4
Anttoekneeoh,thrall,1024,shaman,restoration,24,12,12
Mastrionilol,stormrage,1023,shaman,restoration,34,11,23
Jìmmybuckets,tichondrius,1022,shaman,restoration,17,11,6
Dextex,azralon,1022,shaman,restoration,47,26,21
Lavatotem,stormrage,1021,shaman,restoration,41,20,21
Narikó,aggramar,1017,shaman,restoration,30,17,13
Nupi,thaurissan,1013,shaman,restoration,59,26,33
Lazi,frostmourne,1008,shaman,restoration,27,12,15
Volsdeep,illidan,1007,shaman,restoration,21,11,10
Speedranger,stormrage,1004,shaman,restoration,42,15,27
Fio,nerzhul,1002,shaman,restoration,176,81,95
Baygone,tichondrius,1002,shaman,restoration,24,11,13
Shamankie,tichondrius,999,shaman,restoration,40,13,27
Hentaistorm,kiljaeden,998,shaman,restoration,80,41,39
Wâgu,moon-guard,992,shaman,restoration,28,11,17
Kencyzz,tichondrius,991,shaman,restoration,17,11,6
Vogaz,ragnaros,991,shaman,restoration,28,11,17
Nottrhall,azralon,990,shaman,restoration,14,11,3
Teardrinker,korgath,988,shaman,restoration,30,11,19
Faegle,area-52,984,shaman,restoration,24,11,13
Doomgodx,tichondrius,983,shaman,restoration,36,16,20
Illeh,illidan,983,shaman,restoration,36,15,21
Banterx,emerald-dream,979,shaman,restoration,35,12,23
Andrastia,thrall,976,shaman,restoration,24,15,9
Shammystic,quelthalas,972,shaman,restoration,48,17,31
Shamadran,hyjal,971,shaman,restoration,23,11,12
Njjshamm,thrall,969,shaman,restoration,36,16,20
Tharapita,bleeding-hollow,968,shaman,restoration,33,12,21
Superchunk,shattered-hand,965,shaman,restoration,102,53,49
Twinkolava,nemesis,961,shaman,restoration,19,11,8
Yunotho,sargeras,960,shaman,restoration,18,10,8
Naisayyds,tichondrius,960,shaman,restoration,18,10,8
Hst,barthilas,960,shaman,restoration,18,10,8
Freerath,tichondrius,960,shaman,restoration,22,10,12
Enhancex,frostwolf,960,shaman,restoration,24,10,14
Ekss,tichondrius,960,shaman,restoration,30,10,20
Chenguanxi,tichondrius,959,shaman,restoration,12,10,2
Farfar,tichondrius,959,shaman,restoration,12,10,2
Zensarg,tichondrius,959,shaman,restoration,18,10,8
Nobiggy,tichondrius,959,shaman,restoration,24,10,14
Forcè,bleeding-hollow,959,shaman,restoration,24,10,14
Cosmô,sargeras,959,shaman,restoration,30,10,20
Ggoong,tichondrius,959,shaman,restoration,36,10,26
Vinceshamwow,lightbringer,958,shaman,restoration,12,10,2
Furiousnick,stormrage,958,shaman,restoration,18,10,8
Shyva,frostmourne,958,shaman,restoration,18,10,8
Torric,kalecgos,958,shaman,restoration,18,10,8
Zechary,proudmoore,958,shaman,restoration,18,10,8
Thundershade,deathwing,958,shaman,restoration,24,10,14
Lawlsham,korgath,957,shaman,restoration,12,10,2
Halloweenz,area-52,957,shaman,restoration,18,10,8
Athayis,malorne,957,shaman,restoration,59,31,28
Eggrollninja,illidan,956,shaman,restoration,12,10,2
Maakasarg,tichondrius,956,shaman,restoration,24,10,14
Orcstain,moknathal,956,shaman,restoration,28,11,17
Karaaka,ysera,956,shaman,restoration,30,10,20
Cameltótém,sargeras,955,shaman,restoration,18,10,8
Oohkillemm,silvermoon,955,shaman,restoration,18,10,8
Johnnyblue,frostmourne,954,shaman,restoration,24,10,14
Tequíla,quelthalas,952,shaman,restoration,18,10,8
Mikeyodinson,area-52,952,shaman,restoration,24,10,14
Bruhh,stormscale,951,shaman,restoration,18,10,8
Romcomx,tichondrius,951,shaman,restoration,24,10,14
Soulmiracle,tichondrius,951,shaman,restoration,24,10,14
Overcåst,barthilas,951,shaman,restoration,36,10,26
Kisimi,proudmoore,950,shaman,restoration,18,10,8
Haether,madoran,949,shaman,restoration,65,31,34
Problamatic,tichondrius,949,shaman,restoration,24,10,14
Tabby,emerald-dream,948,shaman,restoration,24,10,14
Daxetan,area-52,947,shaman,restoration,18,10,8
Fíxer,tichondrius,933,shaman,restoration,19,11,8
Boppshock,tichondrius,928,shaman,restoration,16,11,5
Mikeoxxgigg,kelthuzad,927,shaman,restoration,51,28,23
Rastablaze,darkspear,926,shaman,restoration,70,27,43
Artsha,tol-barad,925,shaman,restoration,18,11,7
Roostershama,tichondrius,925,shaman,restoration,20,11,9
Siksika,bloodscalp,924,shaman,restoration,18,10,8
Psilocypher,nazjatar,923,shaman,restoration,18,11,7
Klev,frostmourne,921,shaman,restoration,33,12,21
Jorko,dathremar,918,shaman,restoration,26,16,10
Malløry,mugthol,917,shaman,restoration,30,12,18
Joyrex,spinebreaker,912,shaman,restoration,21,11,10
Kawixxi,ysondre,912,shaman,restoration,25,13,12
Meskthemage,barthilas,911,shaman,restoration,17,10,7
Flexexpress,stormrage,911,shaman,restoration,17,10,7
Privxd,bleeding-hollow,910,shaman,restoration,17,10,7
Mainstreamx,sargeras,908,shaman,restoration,33,10,23
Ttvfoxyllama,tichondrius,906,shaman,restoration,28,12,16
Alestorm,nemesis,899,shaman,restoration,28,12,16
Msooli,tichondrius,895,shaman,restoration,11,10,1
Holdmytotum,tichondrius,895,shaman,restoration,17,10,7
Swifteyy,area-52,883,shaman,restoration,22,10,12
Astàròth,malganis,880,shaman,restoration,13,10,3
Orochishaman,stormrage,864,shaman,restoration,12,9,3
Washedupty,illidan,864,shaman,restoration,12,9,3
Èmaxx,barthilas,864,shaman,restoration,12,9,3
Iadyboi,kiljaeden,864,shaman,restoration,12,9,3
Seiunsky,area-52,864,shaman,restoration,12,9,3
Bakenquake,tichondrius,864,shaman,restoration,12,9,3
ßonevoyage,malganis,864,shaman,restoration,12,9,3
Owtyobwol,area-52,864,shaman,restoration,12,9,3
Flatt,uther,864,shaman,restoration,18,9,9
Medullarum,suramar,864,shaman,restoration,18,9,9
Momolagbbit,tichondrius,864,shaman,restoration,18,9,9
Hexcalibur,laughing-skull,864,shaman,restoration,18,9,9
Neviahz,illidan,864,shaman,restoration,18,9,9
Awyiss,dreadmaul,864,shaman,restoration,18,9,9
Polarities,malganis,864,shaman,restoration,24,9,15
Wildmaster,ragnaros,864,shaman,restoration,30,9,21
Kzxs,illidan,863,shaman,restoration,12,9,3
Jaegertotem,stormrage,863,shaman,restoration,12,9,3
Køre,tichondrius,863,shaman,restoration,12,9,3
Balsonz,zuljin,863,shaman,restoration,12,9,3
Ryeqt,illidan,863,shaman,restoration,18,9,9
Snoff,burning-blade,863,shaman,restoration,18,9,9
Darcheros,quelthalas,863,shaman,restoration,18,9,9
Murica,area-52,863,shaman,restoration,18,9,9
Yeeraldyn,quelthalas,863,shaman,restoration,24,9,15
Xiwg,tichondrius,863,shaman,restoration,24,9,15
Mastrionilol,dragonmaw,863,shaman,restoration,24,9,15
Shocksfuker,stormrage,862,shaman,restoration,20,10,10
Obrahma,burning-legion,862,shaman,restoration,18,9,9
Drünk,hyjal,862,shaman,restoration,18,9,9
Turtleinmud,frostmourne,862,shaman,restoration,18,9,9
Vywolf,frostmourne,862,shaman,restoration,27,11,16
Milkstress,whisperwind,861,shaman,restoration,24,9,15
Macdab,malganis,860,shaman,restoration,18,9,9
Esanim,tichondrius,860,shaman,restoration,18,9,9
Wagesisdeath,illidan,859,shaman,restoration,24,9,15
Aargonos,tichondrius,858,shaman,restoration,12,9,3
Shockburst,dalaran,858,shaman,restoration,18,9,9
Ironfart,destromath,858,shaman,restoration,18,9,9
Blois,thunderlord,857,shaman,restoration,18,9,9
Klaital,boulderfist,855,shaman,restoration,12,9,3
Yakella,trollbane,854,shaman,restoration,12,9,3
Mtnju,eredar,852,shaman,restoration,18,9,9
Chablez,shattered-hand,849,shaman,restoration,18,9,9
Slëvin,frostmourne,848,shaman,restoration,30,9,21
Ayahuassca,illidan,847,shaman,restoration,44,19,25
Spampurge,blackwing-lair,841,shaman,restoration,25,11,14
Scrototëm,azralon,833,shaman,restoration,24,9,15
Dreadxtotems,illidan,830,shaman,restoration,17,9,8
Deadlyshocks,gilneas,827,shaman,restoration,35,17,18
Sittingwolf,stormreaver,825,shaman,restoration,17,9,8
Angelbie,tichondrius,815,shaman,restoration,15,10,5
Touchmytotmm,tichondrius,768,shaman,restoration,12,8,4
Multran,stormscale,768,shaman,restoration,12,8,4
Coreygunz,illidan,768,shaman,restoration,12,8,4
Hexistential,tichondrius,768,shaman,restoration,12,8,4
Kensyz,tichondrius,768,shaman,restoration,12,8,4
Tarròò,bleeding-hollow,768,shaman,restoration,12,8,4
Stormlashx,sargeras,768,shaman,restoration,12,8,4
Xiaoshaman,frostmourne,768,shaman,restoration,12,8,4
Animus,dark-iron,768,shaman,restoration,12,8,4
Shxl,zuljin,768,shaman,restoration,12,8,4
Ophitotem,zuljin,768,shaman,restoration,12,8,4
Ggdumpy,tichondrius,768,shaman,restoration,12,8,4
Xannysnapper,zuljin,768,shaman,restoration,12,8,4
Vernzi,laughing-skull,768,shaman,restoration,12,8,4
Doubletåp,emerald-dream,768,shaman,restoration,12,8,4
Xiaoshaman,tichondrius,768,shaman,restoration,12,8,4
Wolvez,tichondrius,768,shaman,restoration,18,8,10
Jisthexx,senjin,768,shaman,restoration,18,8,10
Gorillox,chogall,768,shaman,restoration,18,8,10
Toastjr,frostmourne,768,shaman,restoration,18,8,10
Luckyscatter,frostmourne,768,shaman,restoration,18,8,10
Edisto,darkspear,768,shaman,restoration,18,8,10
Traumateam,tichondrius,768,shaman,restoration,18,8,10
Deathwards,frostmane,768,shaman,restoration,18,8,10
Songo,frostmane,768,shaman,restoration,18,8,10
Kaddya,mannoroth,768,shaman,restoration,18,8,10
Taronì,zuljin,768,shaman,restoration,18,8,10
Earthuncle,illidan,768,shaman,restoration,24,8,16
Vernacks,area-52,767,shaman,restoration,12,8,4
Vazlah,tichondrius,767,shaman,restoration,12,8,4
Mymojo,tichondrius,767,shaman,restoration,12,8,4
Veeve,kelthuzad,767,shaman,restoration,12,8,4
Totemism,warsong,767,shaman,restoration,12,8,4
Klimax,tichondrius,767,shaman,restoration,12,8,4
Squirtrussel,boulderfist,767,shaman,restoration,12,8,4
Earthentotem,tichondrius,767,shaman,restoration,18,8,10
Chrigshock,black-dragonflight,767,shaman,restoration,18,8,10
Zombaschamy,ragnaros,767,shaman,restoration,18,8,10
Agrîm,tichondrius,767,shaman,restoration,24,8,16
Thunderfucj,tichondrius,767,shaman,restoration,24,8,16
Totemlord,lightnings-blade,766,shaman,restoration,18,8,10
Skylet,azralon,766,shaman,restoration,18,8,10
Rapwnzel,tichondrius,766,shaman,restoration,18,8,10
Santral,ragnaros,766,shaman,restoration,19,8,11
Nooch,malganis,766,shaman,restoration,27,9,18
Elementorx,stormrage,766,shaman,restoration,24,8,16
Magatotem,sargeras,766,shaman,restoration,24,8,16
Angron,barthilas,765,shaman,restoration,12,8,4
Skippe,hyjal,764,shaman,restoration,12,8,4
Mochiko,frostmourne,764,shaman,restoration,18,8,10
Vulcanik,quelthalas,764,shaman,restoration,24,8,16
Vínnie,tichondrius,763,shaman,restoration,18,8,10
ßøn,altar-of-storms,762,shaman,restoration,12,8,4
Shamnnoodlez,area-52,762,shaman,restoration,18,8,10
Qüickeze,khazgoroth,761,shaman,restoration,12,8,4
Cremecheese,crushridge,760,shaman,restoration,12,8,4
Eleshortal,azuremyst,759,shaman,restoration,18,8,10
Geoleo,stormrage,758,shaman,restoration,18,8,10
Kordir,kiljaeden,756,shaman,restoration,24,8,16
Tremór,frostmourne,755,shaman,restoration,18,8,10
Amonamarth,tichondrius,753,shaman,restoration,18,8,10
Getpurged,thrall,751,shaman,restoration,17,8,9
Shubba,thrall,747,shaman,restoration,12,8,4
Plop,tichondrius,736,shaman,restoration,10,9,1
Treris,bleeding-hollow,719,shaman,restoration,11,8,3
Immabòt,tichondrius,719,shaman,restoration,17,8,9
Notragii,kelthuzad,719,shaman,restoration,17,8,9
Luxiaa,tichondrius,714,shaman,restoration,23,9,14
Kencysz,tichondrius,714,shaman,restoration,23,9,14
Trouvaille,tichondrius,714,shaman,restoration,25,9,16
Kenithwest,tichondrius,703,shaman,restoration,11,8,3
Xinz,guldan,703,shaman,restoration,11,8,3
Wasuwant,frostmourne,703,shaman,restoration,14,8,6
Garbagedump,burning-legion,703,shaman,restoration,14,8,6
Kikahna,stormreaver,683,shaman,restoration,22,9,13
Paaman,proudmoore,672,shaman,restoration,12,7,5
Dizzyswift,tichondrius,672,shaman,restoration,12,7,5
Strykked,illidan,672,shaman,restoration,12,7,5
Boltekka,tichondrius,672,shaman,restoration,12,7,5
Invokeesorin,area-52,672,shaman,restoration,12,7,5
Restosêxual,tichondrius,672,shaman,restoration,12,7,5
Miroen,tichondrius,672,shaman,restoration,12,7,5
Esoterikk,malganis,672,shaman,restoration,12,7,5
Hexmix,muradin,672,shaman,restoration,12,7,5
Kencyi,tichondrius,672,shaman,restoration,12,7,5
Crakmane,kelthuzad,672,shaman,restoration,12,7,5
Gornu,nemesis,672,shaman,restoration,12,7,5
Fàlc,stormrage,672,shaman,restoration,12,7,5
Daxotv,sargeras,672,shaman,restoration,12,7,5
Sorgal,area-52,672,shaman,restoration,12,7,5
Elîas,tichondrius,672,shaman,restoration,12,7,5
Girthquake,agamaggan,672,shaman,restoration,12,7,5
Kyma,black-dragonflight,672,shaman,restoration,12,7,5
Dadbar,tichondrius,672,shaman,restoration,12,7,5
Symbox,tichondrius,672,shaman,restoration,12,7,5
Abulailah,sargeras,672,shaman,restoration,12,7,5
Zerwyn,senjin,672,shaman,restoration,12,7,5
Dektide,zuljin,672,shaman,restoration,12,7,5
Flõp,dalaran,672,shaman,restoration,12,7,5
Laodo,tichondrius,672,shaman,restoration,16,8,8
Zrosurge,stormrage,672,shaman,restoration,14,7,7
Smeagles,ragnaros,672,shaman,restoration,18,7,11
Chlckenx,tichondrius,672,shaman,restoration,18,7,11
Nosekandyz,chogall,672,shaman,restoration,18,7,11
Morphose,tichondrius,672,shaman,restoration,18,7,11
Lindsanx,illidan,672,shaman,restoration,18,7,11
Flekzs,blackhand,671,shaman,restoration,12,7,5
Winchi,stormrage,671,shaman,restoration,12,7,5
Pakdis,sargeras,671,shaman,restoration,12,7,5
Lurue,tichondrius,671,shaman,restoration,12,7,5
Raininwishes,aegwynn,671,shaman,restoration,12,7,5
Rokvahn,illidan,671,shaman,restoration,12,7,5
Chebbs,bleeding-hollow,671,shaman,restoration,12,7,5
Shamiggels,sargeras,671,shaman,restoration,12,7,5
Otem,frostmourne,671,shaman,restoration,16,7,9
Caobuloso,azralon,671,shaman,restoration,18,7,11
Hamshamwitch,shadowmoon,671,shaman,restoration,18,7,11
Lvcianrs,thrall,671,shaman,restoration,18,7,11
Crynoobs,senjin,670,shaman,restoration,12,7,5
Mengemort,crushridge,670,shaman,restoration,12,7,5
Stormcallerr,sargeras,670,shaman,restoration,12,7,5
Shamanastic,tichondrius,670,shaman,restoration,12,7,5
Bethorá,suramar,670,shaman,restoration,12,7,5
Totori,stormscale,670,shaman,restoration,12,7,5
Grakkah,thrall,670,shaman,restoration,18,7,11
Víì,tichondrius,670,shaman,restoration,24,7,17
Yamishka,dalaran,669,shaman,restoration,18,7,11
Vulkova,illidan,669,shaman,restoration,18,7,11
Thordan,lothar,669,shaman,restoration,18,7,11
Hatethetotem,bleeding-hollow,668,shaman,restoration,12,7,5
Evilraven,tichondrius,668,shaman,restoration,18,7,11
Detropolis,illidan,668,shaman,restoration,48,7,41
Dennwoop,sargeras,666,shaman,restoration,22,8,14
Lfhotmoms,moon-guard,665,shaman,restoration,11,9,2
Ruadhri,moon-guard,665,shaman,restoration,12,7,5
Churgarm,zuljin,665,shaman,restoration,18,7,11
Zoodoo,nagrand,663,shaman,restoration,30,7,23
Lamente,ragnaros,655,shaman,restoration,17,7,10
Stormsurgë,bleeding-hollow,640,shaman,restoration,10,8,2
Koomrog,frostmourne,638,shaman,restoration,14,8,6
Alátreon,azralon,623,shaman,restoration,15,7,8
Deacoderz,area-52,618,shaman,restoration,14,8,6
Bigbrenx,tichondrius,607,shaman,restoration,14,7,7
Drfate,kargath,604,shaman,restoration,16,7,9
Matrìx,sargeras,594,shaman,restoration,26,8,18
Kassix,illidan,576,shaman,restoration,6,6,0
Sbrinz,thrall,576,shaman,restoration,6,6,0
Pangniu,illidan,576,shaman,restoration,6,6,0
Jimmyapple,illidan,576,shaman,restoration,6,6,0
Jordnöt,moon-guard,576,shaman,restoration,9,6,3
Xenvale,illidan,576,shaman,restoration,12,6,6
Ccmeifbald,moon-guard,576,shaman,restoration,12,6,6
Tcurts,stormrage,576,shaman,restoration,12,6,6
Gratiens,zuljin,576,shaman,restoration,12,6,6
Iamg,kilrogg,576,shaman,restoration,12,6,6
Lunds,tichondrius,576,shaman,restoration,12,6,6
Fevolution,dreadmaul,576,shaman,restoration,12,6,6
Caprise,tichondrius,576,shaman,restoration,12,6,6
Burstekka,tichondrius,576,shaman,restoration,12,6,6
Bombadil,korgath,576,shaman,restoration,12,6,6
Akamâ,stormrage,576,shaman,restoration,12,6,6
Trewlolz,sargeras,576,shaman,restoration,12,6,6
Nisthesham,tichondrius,576,shaman,restoration,12,6,6
Mazekheen,barthilas,576,shaman,restoration,12,6,6
Motatos,malganis,576,shaman,restoration,12,6,6
Abev,bonechewer,576,shaman,restoration,12,6,6
Pex,sargeras,576,shaman,restoration,12,6,6
Spiritbb,area-52,576,shaman,restoration,12,6,6
Aespeon,stormrage,576,shaman,restoration,12,6,6
Cencyzz,tichondrius,576,shaman,restoration,12,6,6
Eccentrix,mannoroth,576,shaman,restoration,12,6,6
Hhex,tichondrius,576,shaman,restoration,12,6,6
Joeschhmoe,tichondrius,576,shaman,restoration,12,6,6
Potf,illidan,576,shaman,restoration,12,6,6
Littleshasha,tichondrius,576,shaman,restoration,12,6,6
Ajj,thrall,576,shaman,restoration,12,6,6
Scadouche,korgath,576,shaman,restoration,12,6,6
Lindnerx,malganis,576,shaman,restoration,12,6,6
Ataia,tichondrius,576,shaman,restoration,12,6,6
Bakayarøu,tichondrius,576,shaman,restoration,12,6,6
Nehpets,kiljaeden,576,shaman,restoration,12,6,6
Icehole,kelthuzad,576,shaman,restoration,12,6,6
Pikapiko,tichondrius,576,shaman,restoration,12,6,6
Chogramm,illidan,576,shaman,restoration,12,6,6
Atsukaia,tichondrius,576,shaman,restoration,12,6,6
Handzum,blades-edge,576,shaman,restoration,12,6,6
Weqeqwqwqex,ragnaros,576,shaman,restoration,12,6,6
Sweatshirtz,tanaris,576,shaman,restoration,12,6,6
Mariansaurus,ragnaros,576,shaman,restoration,12,6,6
Gullirachad,stormrage,576,shaman,restoration,12,6,6
Oppaswag,tichondrius,576,shaman,restoration,12,6,6
Rubmytiki,skywall,576,shaman,restoration,18,6,12
Jukedlawl,illidan,576,shaman,restoration,18,6,12
Alett,arathor,576,shaman,restoration,18,6,12
Kÿlé,darkspear,576,shaman,restoration,18,6,12
Greensween,thrall,576,shaman,restoration,19,6,13
Blck,malorne,576,shaman,restoration,23,7,16
Shampowl,jaedenar,576,shaman,restoration,20,6,14
Anußis,stormrage,576,shaman,restoration,24,6,18
Slowpo,illidan,576,shaman,restoration,24,6,18
Battleobobby,medivh,576,shaman,restoration,29,6,23
Donojo,zuljin,575,shaman,restoration,12,6,6
Todem,stormrage,575,shaman,restoration,12,6,6
Quequin,quelthalas,575,shaman,restoration,12,6,6
Powerpress,thunderlord,575,shaman,restoration,12,6,6
Fallhazard,malganis,575,shaman,restoration,12,6,6
Zqshaman,tichondrius,575,shaman,restoration,12,6,6
Lhost,tanaris,575,shaman,restoration,12,6,6
Yarockheal,malganis,575,shaman,restoration,12,6,6
Mâyo,thrall,575,shaman,restoration,12,6,6
Sarevoc,sargeras,575,shaman,restoration,12,6,6
Cùìó,barthilas,575,shaman,restoration,12,6,6
Tagliatelle,kelthuzad,575,shaman,restoration,15,7,8
Numbreseven,frostmourne,575,shaman,restoration,14,6,8
Ragnarüz,ragnaros,575,shaman,restoration,19,7,12
Spiritwler,tichondrius,575,shaman,restoration,18,6,12
Girafasuarx,korgath,575,shaman,restoration,18,6,12
Killerphreak,mannoroth,574,shaman,restoration,12,6,6
Luciuzz,tichondrius,574,shaman,restoration,12,6,6
Dodirt,laughing-skull,574,shaman,restoration,12,6,6
Kunshíí,bleeding-hollow,574,shaman,restoration,15,6,9
Gimlyman,madoran,567,shaman,restoration,12,6,6
Trustfall,rexxar,566,shaman,restoration,12,6,6
Bloodmoôn,frostmourne,566,shaman,restoration,18,6,12
Earthnsky,bleeding-hollow,543,shaman,restoration,11,6,5
Desgarcon,zuljin,543,shaman,restoration,11,6,5
Hoghlinn,stormrage,541,shaman,restoration,8,7,1
Tsunamic,sargeras,528,shaman,restoration,15,6,9
Galaxiya,blackhand,525,shaman,restoration,21,7,14
Htsu,quelthalas,522,shaman,restoration,16,7,9
Woof,agamaggan,522,shaman,restoration,29,7,22
Señordoge,malganis,511,shaman,restoration,14,6,8
Dankestmemes,illidan,480,shaman,restoration,6,5,1
Oprawinfuryy,thrall,480,shaman,restoration,6,5,1
Hexgodx,illidan,480,shaman,restoration,6,5,1
Spekgawd,emerald-dream,480,shaman,restoration,6,5,1
Yehbeen,tichondrius,480,shaman,restoration,6,5,1
Nuggsfxce,frostmourne,480,shaman,restoration,6,5,1
Blueclass,akama,480,shaman,restoration,6,5,1
Binishaman,tichondrius,480,shaman,restoration,6,5,1
Nymrose,stormrage,480,shaman,restoration,6,5,1
Cantshear,zuljin,480,shaman,restoration,6,5,1
Esterosa,tichondrius,480,shaman,restoration,6,5,1
Skelesham,zuljin,480,shaman,restoration,6,5,1
Lavamon,illidan,480,shaman,restoration,6,5,1
Çhïcagø,aegwynn,480,shaman,restoration,6,5,1
Dgshaman,tichondrius,480,shaman,restoration,6,5,1
Oopy,icecrown,480,shaman,restoration,6,5,1
Cheddatotz,illidan,480,shaman,restoration,6,5,1
Royblue,illidan,480,shaman,restoration,6,5,1
Juked,aegwynn,480,shaman,restoration,12,5,7
Zingysham,tichondrius,480,shaman,restoration,12,5,7
Elmoss,thrall,480,shaman,restoration,12,5,7
Weebzealot,kelthuzad,480,shaman,restoration,12,5,7
Vegaslights,tichondrius,480,shaman,restoration,12,5,7
Nagish,alexstrasza,480,shaman,restoration,12,5,7
Hijodelrayo,drakkari,480,shaman,restoration,12,5,7
Bröxigâr,wyrmrest-accord,480,shaman,restoration,12,5,7
Sâxman,stormreaver,480,shaman,restoration,12,5,7
Teftx,area-52,480,shaman,restoration,12,5,7
Devastian,quelthalas,480,shaman,restoration,12,5,7
Sixtyninelol,thunderlord,480,shaman,restoration,12,5,7
Nøir,drakkari,480,shaman,restoration,12,5,7
Synkronaqt,tichondrius,480,shaman,restoration,12,5,7
Kwesy,tichondrius,480,shaman,restoration,12,5,7
Plotwave,bleeding-hollow,480,shaman,restoration,12,5,7
Goresx,tichondrius,480,shaman,restoration,12,5,7
Dyllbat,illidan,480,shaman,restoration,12,5,7
Bignutters,bleeding-hollow,480,shaman,restoration,12,5,7
Enzÿte,tichondrius,480,shaman,restoration,12,5,7
Tmkaldärýs,tichondrius,480,shaman,restoration,12,5,7
Boryndor,stormrage,480,shaman,restoration,12,5,7
Dókki,tichondrius,480,shaman,restoration,12,5,7
Azrlol,illidan,480,shaman,restoration,12,5,7
Astotems,tichondrius,480,shaman,restoration,12,5,7
Wegoagain,tichondrius,480,shaman,restoration,12,5,7
Krupto,tichondrius,480,shaman,restoration,12,5,7
Nøzurbo,area-52,480,shaman,restoration,12,5,7
Doop,kiljaeden,480,shaman,restoration,12,5,7
Deyodin,illidan,480,shaman,restoration,12,5,7
Thonty,sargeras,480,shaman,restoration,12,5,7
Derbain,caelestrasz,480,shaman,restoration,12,5,7
Pohtayto,darkspear,480,shaman,restoration,12,5,7
Huulu,blades-edge,480,shaman,restoration,12,5,7
Daintydan,illidan,480,shaman,restoration,12,5,7
Totemfizzle,spirestone,480,shaman,restoration,12,5,7
Juicypork,moon-guard,480,shaman,restoration,12,5,7
Baltarian,emerald-dream,480,shaman,restoration,12,5,7
Larvabust,azralon,480,shaman,restoration,12,5,7
Oriyani,sargeras,480,shaman,restoration,12,5,7
Cherryboy,illidan,480,shaman,restoration,12,5,7
Fidelityfx,sargeras,480,shaman,restoration,12,5,7
Shämpäin,moon-guard,480,shaman,restoration,12,5,7
Saviørkai,barthilas,480,shaman,restoration,12,5,7
Stumpyjoe,terokkar,480,shaman,restoration,13,5,8
Dùffman,jubeithos,480,shaman,restoration,16,6,10
Yoloswage,tichondrius,480,shaman,restoration,21,6,15
Oilburner,malganis,480,shaman,restoration,18,5,13
Rekashaki,illidan,480,shaman,restoration,18,5,13
Localxhero,stormrage,480,shaman,restoration,18,5,13
Krisu,kelthuzad,480,shaman,restoration,18,5,13
Animac,bleeding-hollow,480,shaman,restoration,18,5,13
Intress,moon-guard,479,shaman,restoration,6,5,1
Sâvage,zuljin,479,shaman,restoration,6,5,1
Greenberry,bonechewer,479,shaman,restoration,10,6,4
Highmountain,tichondrius,479,shaman,restoration,12,5,7
Fläkky,area-52,479,shaman,restoration,12,5,7
Blkpowerfist,malganis,479,shaman,restoration,12,5,7
Bobaflexqt,korgath,479,shaman,restoration,12,5,7
Turksham,tichondrius,479,shaman,restoration,12,5,7
Beardedone,durotan,479,shaman,restoration,12,5,7
Youngneal,sargeras,479,shaman,restoration,12,5,7
Çatastrophe,dalaran,479,shaman,restoration,12,5,7
Tattoö,elune,479,shaman,restoration,12,5,7
Nytestalker,sargeras,479,shaman,restoration,18,5,13
Alphamael,lightbringer,479,shaman,restoration,19,5,14
Vaginix,tichondrius,478,shaman,restoration,18,5,13
Stahlye,proudmoore,477,shaman,restoration,6,5,1
Timprecu,azralon,477,shaman,restoration,12,5,7
Pileef,thrall,473,shaman,restoration,13,7,6
Uderlol,tichondrius,448,shaman,restoration,10,5,5
Danil,emerald-dream,447,shaman,restoration,11,5,6
Brocklee,farstriders,447,shaman,restoration,16,5,11
Akhae,duskwood,445,shaman,restoration,14,6,8
Jakjohnson,stormrage,432,shaman,restoration,9,5,4
Lampstand,wildhammer,431,shaman,restoration,11,5,6
Mythruxx,sargeras,426,shaman,restoration,14,6,8
Ggezlmao,bleeding-hollow,426,shaman,restoration,16,6,10
Zio,akama,425,shaman,restoration,14,6,8
Wragnus,tichondrius,425,shaman,restoration,15,6,9
Eloquent,emerald-dream,423,shaman,restoration,18,6,12
Lebs,barthilas,415,shaman,restoration,8,5,3
Shockjoy,malganis,415,shaman,restoration,11,5,6
Chûnk,tichondrius,400,shaman,restoration,13,5,8
Clapton,darkspear,400,shaman,restoration,19,5,14
Aeølus,tichondrius,384,shaman,restoration,6,4,2
Udungoofedd,the-underbog,384,shaman,restoration,6,4,2
Curador,nemesis,384,shaman,restoration,6,4,2
Excaliburumb,tichondrius,384,shaman,restoration,6,4,2
Sidnii,tichondrius,384,shaman,restoration,6,4,2
Viprus,nerzhul,384,shaman,restoration,6,4,2
Ârtík,tichondrius,384,shaman,restoration,6,4,2
Sagester,illidan,384,shaman,restoration,6,4,2
Gotmolk,illidan,384,shaman,restoration,6,4,2
Yeamn,saurfang,384,shaman,restoration,6,4,2
Xiaoya,tichondrius,384,shaman,restoration,6,4,2
Hoonjojjyans,tichondrius,384,shaman,restoration,6,4,2
Thormodin,destromath,384,shaman,restoration,6,4,2
Humpvack,tichondrius,384,shaman,restoration,6,4,2
Bhann,tichondrius,384,shaman,restoration,6,4,2
Shamankofwa,tichondrius,384,shaman,restoration,6,4,2
Kustum,tichondrius,384,shaman,restoration,6,4,2
Smeeza,frostmourne,384,shaman,restoration,6,4,2
Éarl,sargeras,384,shaman,restoration,6,4,2
Stylebenderx,frostmourne,384,shaman,restoration,6,4,2
Weathersmell,sargeras,384,shaman,restoration,6,4,2
Piaopiao,skywall,384,shaman,restoration,6,4,2
Cháningtotem,frostmourne,384,shaman,restoration,6,4,2
Aletcheoddox,sargeras,384,shaman,restoration,6,4,2
Tisaa,tichondrius,384,shaman,restoration,6,4,2
Nepshock,stormrage,384,shaman,restoration,6,4,2
Príde,ragnaros,384,shaman,restoration,6,4,2
Arkilios,tichondrius,384,shaman,restoration,6,4,2
Telnos,emerald-dream,384,shaman,restoration,6,4,2
Totesmcgoatz,arthas,384,shaman,restoration,6,4,2
Boonno,tichondrius,384,shaman,restoration,6,4,2
Kaîowas,malganis,384,shaman,restoration,6,4,2
Castia,sargeras,384,shaman,restoration,6,4,2
Shocknrot,maelstrom,384,shaman,restoration,6,4,2
Xillicit,sargeras,384,shaman,restoration,6,4,2
Hordeoeuvre,zuljin,384,shaman,restoration,6,4,2
Acdc,zuljin,384,shaman,restoration,6,4,2
Intravz,tichondrius,384,shaman,restoration,6,4,2
Bigboorst,kelthuzad,384,shaman,restoration,6,4,2
Gumballin,sargeras,384,shaman,restoration,8,4,4
Saksa,garrosh,384,shaman,restoration,12,4,8
Galeswind,sargeras,384,shaman,restoration,12,4,8
Qitian,tichondrius,384,shaman,restoration,12,4,8
Naturasol,quelthalas,384,shaman,restoration,12,4,8
Dadidun,tichondrius,384,shaman,restoration,12,4,8
Ayev,illidan,384,shaman,restoration,12,4,8
Kobecoopper,sargeras,384,shaman,restoration,12,4,8
Misakism,sargeras,384,shaman,restoration,12,4,8
Toobeastly,deathwing,384,shaman,restoration,12,4,8
Xändra,ragnaros,384,shaman,restoration,12,4,8
Fluiid,tichondrius,384,shaman,restoration,12,4,8
Lollzerz,the-forgotten-coast,384,shaman,restoration,12,4,8
Tyrión,aggramar,384,shaman,restoration,12,4,8
Shamanese,emerald-dream,384,shaman,restoration,12,4,8
Bäsedgód,tichondrius,384,shaman,restoration,12,4,8
Ngentotem,frostmourne,384,shaman,restoration,12,4,8
Pjtremblay,frostmourne,384,shaman,restoration,12,4,8
Cgq,tichondrius,384,shaman,restoration,12,4,8
Bacnbitz,hellscream,384,shaman,restoration,12,4,8
Mythshaman,tichondrius,384,shaman,restoration,12,4,8
Shâmbulance,hyjal,384,shaman,restoration,12,4,8
Wolfsokar,emerald-dream,384,shaman,restoration,12,4,8
Stackinheals,thrall,384,shaman,restoration,12,4,8
Healswin,sargeras,384,shaman,restoration,12,4,8
Ränton,bleeding-hollow,384,shaman,restoration,12,4,8
Boyyo,maiev,384,shaman,restoration,12,4,8
Porkbrains,emerald-dream,384,shaman,restoration,16,5,11
Dukaman,malganis,384,shaman,restoration,18,4,14
Conductivity,frostmourne,384,shaman,restoration,18,4,14
Kermut,frostmourne,384,shaman,restoration,18,4,14
Bøx,ragnaros,383,shaman,restoration,6,4,2
Rockyisback,illidan,383,shaman,restoration,6,4,2
Hexnation,frostmourne,383,shaman,restoration,6,4,2
Rikswordfire,wyrmrest-accord,383,shaman,restoration,12,4,8
Huugsnkissez,sargeras,383,shaman,restoration,12,4,8
Foogus,tichondrius,383,shaman,restoration,12,4,8
Tandarin,burning-legion,383,shaman,restoration,12,4,8
Ctrlaltelite,burning-blade,383,shaman,restoration,12,4,8
Ânûbis,sargeras,383,shaman,restoration,12,4,8
Sndtome,stormrage,383,shaman,restoration,12,4,8
Elementium,azshara,383,shaman,restoration,12,4,8
Shockshow,zuljin,382,shaman,restoration,12,4,8
Huukron,emerald-dream,382,shaman,restoration,12,4,8
Turbö,hyjal,382,shaman,restoration,12,4,8
Uggbootz,amanthul,379,shaman,restoration,25,4,21
Pche,tichondrius,367,shaman,restoration,11,4,7
Rainingheals,auchindoun,352,shaman,restoration,14,5,9
Shamanakin,emerald-dream,351,shaman,restoration,8,5,3
Tineer,tichondrius,336,shaman,restoration,9,4,5
Avidas,malganis,331,shaman,restoration,15,4,11
Vudu,terokkar,330,shaman,restoration,13,5,8
Stitchez,illidan,330,shaman,restoration,21,5,16
Elevatezxo,stormrage,304,shaman,restoration,7,4,3
Wulfey,sargeras,288,shaman,restoration,6,3,3
Shamjam,moon-guard,288,shaman,restoration,6,3,3
Samac,ravencrest,288,shaman,restoration,6,3,3
Shearx,illidan,288,shaman,restoration,6,3,3
Väsain,wyrmrest-accord,288,shaman,restoration,6,3,3
Voron,kiljaeden,288,shaman,restoration,6,3,3
Smackzs,sargeras,288,shaman,restoration,6,3,3
Pressyocds,darkspear,288,shaman,restoration,6,3,3
Youngie,dathremar,288,shaman,restoration,6,3,3
Digglr,tichondrius,288,shaman,restoration,6,3,3
Sonsii,tichondrius,288,shaman,restoration,6,3,3
Tigs,alleria,288,shaman,restoration,6,3,3
Bigbadpercy,frostmourne,288,shaman,restoration,6,3,3
Phinoi,tichondrius,288,shaman,restoration,6,3,3
Restoele,tichondrius,288,shaman,restoration,6,3,3
Nanishock,area-52,288,shaman,restoration,6,3,3
Curtrex,amanthul,288,shaman,restoration,6,3,3
Gucciblunts,sargeras,288,shaman,restoration,6,3,3
Puntress,barthilas,288,shaman,restoration,6,3,3
Alwinaa,kiljaeden,288,shaman,restoration,6,3,3
Totumstroker,thrall,288,shaman,restoration,6,3,3
Dragonsauce,grizzly-hills,288,shaman,restoration,6,3,3
Sumdumshaman,illidan,288,shaman,restoration,6,3,3
Blaiserpub,tichondrius,288,shaman,restoration,6,3,3
Hiermy,tichondrius,288,shaman,restoration,6,3,3
Wreckaholic,alterac-mountains,288,shaman,restoration,6,3,3
Skrubbles,bleeding-hollow,288,shaman,restoration,6,3,3
Rakkasham,blackrock,288,shaman,restoration,6,3,3
Ñoobshaman,tichondrius,288,shaman,restoration,6,3,3
Slimshämmy,area-52,288,shaman,restoration,6,3,3
Massif,emerald-dream,288,shaman,restoration,6,3,3
Tym,sargeras,288,shaman,restoration,6,3,3
Gunx,darkspear,288,shaman,restoration,6,3,3
Daggonet,sargeras,288,shaman,restoration,6,3,3
Fruityrudyy,area-52,288,shaman,restoration,6,3,3
Chacham,tichondrius,288,shaman,restoration,6,3,3
Cloudsh,silvermoon,288,shaman,restoration,6,3,3
Eleresto,tichondrius,288,shaman,restoration,6,3,3
Zoltide,sargeras,288,shaman,restoration,6,3,3
Apathcat,the-forgotten-coast,288,shaman,restoration,6,3,3
Akupapu,illidan,288,shaman,restoration,6,3,3
Taproots,ursin,288,shaman,restoration,6,3,3
Maana,dragonmaw,288,shaman,restoration,6,3,3
Totemtots,illidan,288,shaman,restoration,6,3,3
Biased,sargeras,288,shaman,restoration,6,3,3
Wastedlink,tichondrius,288,shaman,restoration,6,3,3
Maheva,ragnaros,288,shaman,restoration,6,3,3
Hitchsláp,tichondrius,288,shaman,restoration,6,3,3
Drwaters,lightnings-blade,288,shaman,restoration,6,3,3
Bovinefever,kiljaeden,288,shaman,restoration,6,3,3
Xueticsham,tichondrius,288,shaman,restoration,6,3,3
Slimcube,illidan,288,shaman,restoration,6,3,3
Mudtide,tichondrius,288,shaman,restoration,6,3,3
Laucian,malganis,288,shaman,restoration,6,3,3
Uwuxdlol,tichondrius,288,shaman,restoration,6,3,3
Cloudycloud,tichondrius,288,shaman,restoration,6,3,3
Tampíco,ragnaros,288,shaman,restoration,6,3,3
Sreve,malganis,288,shaman,restoration,6,3,3
Illmental,kelthuzad,288,shaman,restoration,6,3,3
Snowkingx,illidan,288,shaman,restoration,6,3,3
Gargrax,malganis,288,shaman,restoration,6,3,3
Rollînçoàl,malganis,288,shaman,restoration,6,3,3
Herpeaz,kelthuzad,288,shaman,restoration,6,3,3
Yunqboichay,kelthuzad,288,shaman,restoration,6,3,3
Catnïp,maelstrom,288,shaman,restoration,6,3,3
Megadabs,malganis,288,shaman,restoration,6,3,3
Kanntok,quelthalas,288,shaman,restoration,6,3,3
Spencêrf,illidan,288,shaman,restoration,6,3,3
Millionvoltz,tichondrius,288,shaman,restoration,6,3,3
Squidazzle,tichondrius,288,shaman,restoration,8,3,5
Rebelutioni,lothar,288,shaman,restoration,11,3,8
Loanomi,zuljin,288,shaman,restoration,12,3,9
Mochomò,ragnaros,288,shaman,restoration,12,3,9
Meatyball,tichondrius,288,shaman,restoration,12,3,9
Sooweecide,tichondrius,288,shaman,restoration,12,3,9
Equinsuochha,silvermoon,288,shaman,restoration,12,3,9
Calliope,burning-legion,288,shaman,restoration,12,3,9
Pootergash,shadowmoon,288,shaman,restoration,12,3,9
Sliccricc,doomhammer,288,shaman,restoration,12,3,9
Chocobomb,burning-blade,288,shaman,restoration,12,3,9
Scion,thaurissan,288,shaman,restoration,12,3,9
Oomme,area-52,288,shaman,restoration,12,3,9
Possessing,illidan,288,shaman,restoration,12,3,9
Zéwel,tichondrius,288,shaman,restoration,12,3,9
Strawberryz,sargeras,288,shaman,restoration,12,3,9
Showkinho,azralon,288,shaman,restoration,12,3,9
Trysts,wyrmrest-accord,288,shaman,restoration,12,3,9
Mondaymood,illidan,288,shaman,restoration,12,3,9
Galarix,nerzhul,288,shaman,restoration,18,3,15
Valien,kiljaeden,287,shaman,restoration,6,3,3
Racsors,ragnaros,287,shaman,restoration,6,3,3
Trovac,azralon,287,shaman,restoration,6,3,3
Laveidem,frostmourne,287,shaman,restoration,12,3,9
Nottoshammy,dalaran,287,shaman,restoration,12,3,9
Garurt,daggerspine,286,shaman,restoration,12,6,6
Tarlonygg,malganis,281,shaman,restoration,15,6,9
Reddleman,stormrage,256,shaman,restoration,16,3,13
Hilung,lightnings-blade,255,shaman,restoration,11,3,8
Smniss,tichondrius,239,shaman,restoration,5,3,2
Shamanship,haomarush,239,shaman,restoration,5,3,2
Lickerman,stormreaver,239,shaman,restoration,5,3,2
Shamyshame,quelthalas,234,shaman,restoration,6,4,2
Succies,emerald-dream,234,shaman,restoration,16,4,12
Bigripnow,sargeras,234,shaman,restoration,20,4,16
Tokelahoma,stormrage,234,shaman,restoration,22,4,18
Sannyasin,azralon,192,shaman,restoration,6,2,4
Juraf,malganis,192,shaman,restoration,6,2,4
Tamzlol,the-forgotten-coast,192,shaman,restoration,6,2,4
Waterspinach,tichondrius,192,shaman,restoration,6,2,4
Jimmybutler,tichondrius,192,shaman,restoration,6,2,4
Ändiroba,azralon,192,shaman,restoration,6,2,4
Dwârf,tichondrius,192,shaman,restoration,6,2,4
Oprawîndfury,tichondrius,192,shaman,restoration,6,2,4
Cpkzlol,tichondrius,192,shaman,restoration,6,2,4
Dallìa,tichondrius,192,shaman,restoration,6,2,4
Twistër,illidan,192,shaman,restoration,6,2,4
Konga,korialstrasz,192,shaman,restoration,6,2,4
Umadilia,area-52,192,shaman,restoration,6,2,4
Raxxom,tichondrius,192,shaman,restoration,6,2,4
Ara,zuljin,192,shaman,restoration,6,2,4
Duality,shattered-halls,192,shaman,restoration,6,2,4
Purpose,nerzhul,192,shaman,restoration,6,2,4
Subhealth,tichondrius,192,shaman,restoration,6,2,4
Ioki,spirestone,192,shaman,restoration,6,2,4
Aderra,garrosh,192,shaman,restoration,6,2,4
Plutoshaker,tichondrius,192,shaman,restoration,6,2,4
Timbosteve,thrall,192,shaman,restoration,6,2,4
Dabrat,lightnings-blade,192,shaman,restoration,6,2,4
Relâx,icecrown,192,shaman,restoration,6,2,4
Lakeshow,tichondrius,192,shaman,restoration,6,2,4
Zhangyider,illidan,192,shaman,restoration,6,2,4
Thundertusks,norgannon,192,shaman,restoration,6,2,4
Óompaloompa,frostmourne,192,shaman,restoration,6,2,4
Lolcàt,tichondrius,192,shaman,restoration,6,2,4
Mjxholland,aegwynn,192,shaman,restoration,6,2,4
Mauiiei,sargeras,192,shaman,restoration,6,2,4
Notviscent,illidan,192,shaman,restoration,6,2,4
Nbax,tichondrius,192,shaman,restoration,6,2,4
Zâppý,stormrage,192,shaman,restoration,6,2,4
Keldara,aerie-peak,192,shaman,restoration,6,2,4
Cawlin,stormrage,192,shaman,restoration,6,2,4
Kupnicki,zuljin,192,shaman,restoration,6,2,4
Chainandrain,frostmourne,192,shaman,restoration,6,2,4
Lequandarius,sargeras,192,shaman,restoration,6,2,4
Yngvii,tichondrius,192,shaman,restoration,6,2,4
Hruggol,bleeding-hollow,192,shaman,restoration,6,2,4
Sid,frostmourne,192,shaman,restoration,6,2,4
Karnnages,cenarion-circle,192,shaman,restoration,6,2,4
Chungxs,illidan,192,shaman,restoration,6,2,4
Firesurge,sargeras,192,shaman,restoration,6,2,4
Heebeegeebee,stormrage,192,shaman,restoration,6,2,4
Valcn,moon-guard,192,shaman,restoration,6,2,4
Ezeya,area-52,192,shaman,restoration,6,2,4
Shäman,anetheron,192,shaman,restoration,6,2,4
Zugzugpurge,thrall,192,shaman,restoration,6,2,4
Bloodlustxo,frostmourne,192,shaman,restoration,6,2,4
Linkandwink,nerzhul,192,shaman,restoration,6,2,4
Gbe,tichondrius,192,shaman,restoration,6,2,4
Shamansz,stormrage,192,shaman,restoration,6,2,4
Sphaerus,tichondrius,192,shaman,restoration,6,2,4
Dhalishama,thrall,192,shaman,restoration,6,2,4
Gwenstifani,sargeras,192,shaman,restoration,6,2,4
Suspend,gorgonnash,192,shaman,restoration,9,2,7
Kitanoo,kiljaeden,192,shaman,restoration,12,2,10
Bizzy,black-dragonflight,192,shaman,restoration,12,2,10
Wasiri,illidan,192,shaman,restoration,12,2,10
Lomínark,stormrage,192,shaman,restoration,12,2,10
Rhaksh,sargeras,192,shaman,restoration,12,2,10
Rueem,area-52,192,shaman,restoration,12,2,10
Awool,lightbringer,192,shaman,restoration,12,2,10
Soomer,frostmourne,192,shaman,restoration,12,2,10
Aoiiro,dentarg,192,shaman,restoration,12,2,10
Monchsham,area-52,192,shaman,restoration,13,2,11
Kicksave,illidan,192,shaman,restoration,18,2,16
Shockbot,stormscale,192,shaman,restoration,18,2,16
Bootsix,area-52,192,shaman,restoration,18,2,16
Doctermoo,daggerspine,192,shaman,restoration,28,3,25
Roogys,emerald-dream,192,shaman,restoration,22,2,20
Vazan,arthas,191,shaman,restoration,6,2,4
Malsturm,stormrage,191,shaman,restoration,6,2,4
Donix,destromath,191,shaman,restoration,6,2,4
Machalo,sargeras,191,shaman,restoration,6,2,4
Fóurelements,malganis,191,shaman,restoration,6,2,4
Jammylol,frostmourne,180,shaman,restoration,21,6,15
Nolij,sargeras,159,shaman,restoration,5,2,3
Restomilk,tichondrius,159,shaman,restoration,5,2,3
Drowsbad,tichondrius,138,shaman,restoration,10,4,6
Bigdaddyion,thrall,138,shaman,restoration,9,3,6
Swampy,tanaris,138,shaman,restoration,9,3,6
Uggerz,barthilas,138,shaman,restoration,9,3,6
Hueymagoo,firetree,112,shaman,restoration,13,2,11
Jbahr,hyjal,96,shaman,restoration,3,2,1
Eleshamanz,tichondrius,96,shaman,restoration,6,1,5
Liltex,malganis,96,shaman,restoration,6,1,5
Dodey,malganis,96,shaman,restoration,6,1,5
Bayslaps,tichondrius,96,shaman,restoration,6,1,5
Slacken,kiljaeden,96,shaman,restoration,6,1,5
Dasckisham,area-52,96,shaman,restoration,6,1,5
Cyberheler,quelthalas,96,shaman,restoration,6,1,5
Ogeez,area-52,96,shaman,restoration,6,1,5
Daiablo,barthilas,96,shaman,restoration,6,1,5
Iightning,frostwolf,96,shaman,restoration,6,1,5
Restorates,tichondrius,96,shaman,restoration,6,1,5
Stickshaman,sargeras,96,shaman,restoration,6,1,5
Billydreams,drakkari,96,shaman,restoration,6,1,5
Tchamí,blackrock,96,shaman,restoration,6,1,5
Meshugga,scarlet-crusade,96,shaman,restoration,6,1,5
Shapaman,tichondrius,96,shaman,restoration,6,1,5
Ashamanist,barthilas,96,shaman,restoration,6,1,5
Toyletpaper,mugthol,96,shaman,restoration,6,1,5
Camdoc,destromath,96,shaman,restoration,6,1,5
Schmutz,emerald-dream,96,shaman,restoration,6,1,5
Zorg,area-52,96,shaman,restoration,6,1,5
Galiffa,area-52,96,shaman,restoration,6,1,5
Célty,moon-guard,96,shaman,restoration,6,1,5
Teathin,ragnaros,96,shaman,restoration,6,1,5
Babehmakr,lightnings-blade,96,shaman,restoration,6,1,5
Twizzhurp,bleeding-hollow,96,shaman,restoration,6,1,5
Muruaic,dentarg,96,shaman,restoration,6,1,5
Meramin,illidan,96,shaman,restoration,6,1,5
Wannabecdeww,kelthuzad,96,shaman,restoration,6,1,5
Shamoover,kelthuzad,96,shaman,restoration,6,1,5
Finnaburstt,tichondrius,96,shaman,restoration,6,1,5
Totemrack,tichondrius,96,shaman,restoration,6,1,5
Movemaker,shattered-hand,96,shaman,restoration,6,1,5
Paniczone,madoran,96,shaman,restoration,6,1,5
Thenewsherek,maelstrom,96,shaman,restoration,6,1,5
Hadèes,zuljin,96,shaman,restoration,6,1,5
Sshhammann,tichondrius,96,shaman,restoration,6,1,5
Restoz,thrall,96,shaman,restoration,6,1,5
Average,bonechewer,96,shaman,restoration,6,1,5
Cluffatty,tichondrius,96,shaman,restoration,6,1,5
Sleepysham,anubarak,96,shaman,restoration,6,1,5
Asanako,illidan,96,shaman,restoration,6,1,5
Calicø,durotan,96,shaman,restoration,7,1,6
Finark,tichondrius,96,shaman,restoration,7,1,6
Bigbøss,stormrage,96,shaman,restoration,12,1,11
Hexpert,firetree,96,shaman,restoration,12,1,11
Meatlog,dalaran,96,shaman,restoration,12,1,11
Njolmir,khazgoroth,96,shaman,restoration,12,1,11
Tinytiddies,chogall,96,shaman,restoration,12,1,11
Tehbeast,khadgar,96,shaman,restoration,12,1,11
Okdopey,area-52,95,shaman,restoration,6,1,5
Interwebzz,tichondrius,95,shaman,restoration,18,1,17
Lupog,illidan,89,shaman,restoration,8,4,4
Dirtyshammy,mugthol,79,shaman,restoration,11,1,10
Totèm,tichondrius,64,shaman,restoration,4,1,3
Ryforges,frostmourne,63,shaman,restoration,2,2,0
Cónò,tichondrius,42,shaman,restoration,11,4,7
Annöying,ysera,42,shaman,restoration,6,2,4
Applicable,tichondrius,42,shaman,restoration,9,2,7
Julíp,tichondrius,42,shaman,restoration,10,2,8
Shamining,illidan,31,shaman,restoration,2,1,1
Darkn,cenarion-circle,31,shaman,restoration,2,1,1
Cashe,kiljaeden,2368,shaman,elemental,126,80,46
Ttvozzyxy,tichondrius,2349,shaman,elemental,115,72,43
Bronzer,tichondrius,2325,shaman,elemental,75,53,22
Meatbeaterx,aggramar,2195,shaman,elemental,87,48,39
Thegloc,illidan,2168,shaman,elemental,59,36,23
Itzgucci,illidan,2143,shaman,elemental,80,46,34
Benanderson,tichondrius,2137,shaman,elemental,104,59,45
Bøøgaa,proudmoore,2137,shaman,elemental,107,57,50
Jimmysporty,malganis,2135,shaman,elemental,84,43,41
Jgmbs,dalaran,2134,shaman,elemental,106,64,42
Axelsteel,illidan,2132,shaman,elemental,66,45,21
Hitzz,malganis,2127,shaman,elemental,78,49,29
Lardaz,darkspear,2118,shaman,elemental,60,37,23
Crøwgød,tichondrius,2112,shaman,elemental,103,60,43
Hollowbaby,tichondrius,2101,shaman,elemental,73,48,25
Ranjeesh,frostmourne,2098,shaman,elemental,126,71,55
Iavalash,bleeding-hollow,2070,shaman,elemental,160,81,79
Bujii,frostmourne,2068,shaman,elemental,113,62,51
Jeasham,malganis,2055,shaman,elemental,113,58,55
Manofsand,drenden,2027,shaman,elemental,155,82,73
Tisaa,tichondrius,2025,shaman,elemental,66,32,34
Reckfulq,proudmoore,1990,shaman,elemental,108,70,38
Yejinok,tichondrius,1969,shaman,elemental,102,53,49
Shiggenbasta,tichondrius,1966,shaman,elemental,72,39,33
Kaandel,azralon,1960,shaman,elemental,114,54,60
Chunchünmaru,area-52,1957,shaman,elemental,71,40,31
Billycool,tichondrius,1948,shaman,elemental,54,34,20
Bakenquake,tichondrius,1947,shaman,elemental,92,48,44
Joedna,tichondrius,1940,shaman,elemental,70,36,34
Sasageyo,tichondrius,1929,shaman,elemental,81,47,34
Safeword,nesingwary,1919,shaman,elemental,68,39,29
Sleepysham,kelthuzad,1909,shaman,elemental,72,41,31
Scaman,tichondrius,1903,shaman,elemental,36,23,13
Makazar,tichondrius,1901,shaman,elemental,42,26,16
Ultron,deathwing,1890,shaman,elemental,143,74,69
Hedeadxs,illidan,1882,shaman,elemental,60,30,30
Matikz,boulderfist,1878,shaman,elemental,142,78,64
Powerdown,blackrock,1878,shaman,elemental,65,32,33
Tremordrfear,lightbringer,1877,shaman,elemental,30,20,10
Tyar,area-52,1876,shaman,elemental,45,31,14
Juicébox,tichondrius,1874,shaman,elemental,62,35,27
Cùìó,barthilas,1868,shaman,elemental,54,25,29
Kimkar,bleeding-hollow,1862,shaman,elemental,42,23,19
Shockay,tichondrius,1861,shaman,elemental,56,30,26
Geodude,executus,1851,shaman,elemental,41,25,16
Johnsju,sargeras,1847,shaman,elemental,63,33,30
Chemjenn,korgath,1838,shaman,elemental,84,37,47
Skkarz,malganis,1834,shaman,elemental,65,40,25
Depression,baelgun,1834,shaman,elemental,54,33,21
Mavz200744,area-52,1833,shaman,elemental,77,42,35
Starmaker,malganis,1833,shaman,elemental,44,23,21
Molerat,illidan,1830,shaman,elemental,140,65,75
Gaymakaí,sargeras,1828,shaman,elemental,48,27,21
Hotdogwaterx,tichondrius,1817,shaman,elemental,62,42,20
Dxxlol,tichondrius,1816,shaman,elemental,30,26,4
Trenzix,sargeras,1815,shaman,elemental,142,67,75
Beyoncé,lethon,1813,shaman,elemental,42,25,17
Snookìe,sargeras,1813,shaman,elemental,58,28,30
Wangyinanmin,tichondrius,1812,shaman,elemental,30,19,11
Illchayqt,frostmourne,1809,shaman,elemental,41,24,17
Elefusion,sargeras,1806,shaman,elemental,36,22,14
Swigadee,tichondrius,1806,shaman,elemental,72,33,39
Bismarks,frostmourne,1805,shaman,elemental,66,38,28
Hexxás,bloodscalp,1805,shaman,elemental,39,22,17
Luhz,tichondrius,1805,shaman,elemental,48,22,26
Drazziqt,malganis,1803,shaman,elemental,45,27,18
Nonomori,frostmourne,1802,shaman,elemental,48,30,18
Torchic,drakkari,1801,shaman,elemental,60,31,29
Monkeysham,dathremar,1800,shaman,elemental,48,30,18
Elementàlius,quelthalas,1800,shaman,elemental,80,46,34
Utilitytotem,moon-guard,1800,shaman,elemental,102,56,46
Mackq,tichondrius,1800,shaman,elemental,103,54,49
Scherzer,frostwolf,1800,shaman,elemental,90,42,48
Foudre,malganis,1798,shaman,elemental,30,19,11
Zoeytur,sargeras,1793,shaman,elemental,48,25,23
Emppege,tichondrius,1789,shaman,elemental,69,30,39
Vkzz,sargeras,1784,shaman,elemental,49,23,26
Ãmg,tichondrius,1779,shaman,elemental,36,24,12
Gangmembr,illidan,1779,shaman,elemental,36,21,15
Zipzsham,maiev,1776,shaman,elemental,45,33,12
Zqsyyds,illidan,1770,shaman,elemental,35,19,16
Orksham,tichondrius,1770,shaman,elemental,48,24,24
Meatbeaterx,bleeding-hollow,1768,shaman,elemental,42,23,19
Møp,spirestone,1766,shaman,elemental,66,39,27
Donkeyteeth,bleeding-hollow,1766,shaman,elemental,66,38,28
Dampenedxx,bleeding-hollow,1748,shaman,elemental,101,56,45
Blmqt,stormrage,1741,shaman,elemental,35,25,10
Brezel,azralon,1740,shaman,elemental,42,27,15
Hexistential,tichondrius,1731,shaman,elemental,34,26,8
Uglymuger,tichondrius,1730,shaman,elemental,62,30,32
Taranís,sargeras,1730,shaman,elemental,54,25,29
Sshaman,tichondrius,1728,shaman,elemental,58,26,32
Bronzers,tichondrius,1723,shaman,elemental,30,18,12
Apyôn,tichondrius,1719,shaman,elemental,42,24,18
Liquidmagma,deathwing,1715,shaman,elemental,42,24,18
Ayumihamasai,tichondrius,1710,shaman,elemental,60,33,27
Whameradetu,suramar,1706,shaman,elemental,59,26,33
Notahappyone,area-52,1703,shaman,elemental,48,34,14
Osev,stormrage,1703,shaman,elemental,36,21,15
Carondes,proudmoore,1703,shaman,elemental,57,29,28
Mytotemisbig,lothar,1694,shaman,elemental,59,38,21
Notbpage,burning-blade,1694,shaman,elemental,102,51,51
Sonire,tichondrius,1691,shaman,elemental,161,78,83
Soyboyxxo,barthilas,1691,shaman,elemental,83,40,43
Shockyshock,emerald-dream,1683,shaman,elemental,46,29,17
Swiatek,ragnaros,1681,shaman,elemental,43,25,18
Enkix,drakkari,1681,shaman,elemental,42,23,19
Cyhren,illidan,1679,shaman,elemental,54,33,21
Gorjun,stormrage,1679,shaman,elemental,81,38,43
Zugzugdogg,destromath,1674,shaman,elemental,42,23,19
Buffele,tichondrius,1672,shaman,elemental,42,18,24
Jerkdaddy,aggramar,1668,shaman,elemental,30,19,11
Sweatshock,frostmourne,1667,shaman,elemental,92,57,35
Buju,bleeding-hollow,1666,shaman,elemental,140,78,62
Baddaboom,sargeras,1664,shaman,elemental,61,31,30
Illmental,kelthuzad,1658,shaman,elemental,85,44,41
Mercs,frostmourne,1653,shaman,elemental,44,25,19
Kawj,eonar,1652,shaman,elemental,36,21,15
Dyxlol,tichondrius,1652,shaman,elemental,56,25,31
Thaelia,azgalor,1650,shaman,elemental,40,23,17
Walabi,tichondrius,1649,shaman,elemental,50,22,28
Gravygumdrop,tichondrius,1648,shaman,elemental,80,39,41
Zeylhe,proudmoore,1647,shaman,elemental,54,26,28
Hecstacy,dalaran,1645,shaman,elemental,36,23,13
Hexzy,moon-guard,1645,shaman,elemental,47,23,24
Fàlç,stormrage,1644,shaman,elemental,36,21,15
Smoketide,stormrage,1644,shaman,elemental,47,21,26
Shockisha,sisters-of-elune,1644,shaman,elemental,52,23,29
Meatyball,tichondrius,1642,shaman,elemental,35,22,13
Streetmeat,crushridge,1640,shaman,elemental,125,64,61
Deckìn,proudmoore,1637,shaman,elemental,112,60,52
Triknolov,dalaran,1636,shaman,elemental,47,22,25
Billydreams,drakkari,1634,shaman,elemental,123,59,64
Imnumberl,sargeras,1630,shaman,elemental,78,51,27
Hexecute,tichondrius,1630,shaman,elemental,30,17,13
Loxshox,gnomeregan,1628,shaman,elemental,162,84,78
Tenyks,tichondrius,1627,shaman,elemental,40,22,18
Fiftybeers,frostmourne,1627,shaman,elemental,35,19,16
Handzum,blades-edge,1627,shaman,elemental,36,18,18
Caserguy,sargeras,1619,shaman,elemental,52,21,31
Mulak,frostmourne,1616,shaman,elemental,110,54,56
Duality,shattered-halls,1615,shaman,elemental,59,38,21
Flüke,tichondrius,1615,shaman,elemental,42,23,19
Chajaa,ragnaros,1615,shaman,elemental,165,83,82
Squealer,sargeras,1612,shaman,elemental,74,37,37
Gangstà,stormrage,1611,shaman,elemental,66,30,36
Datbigthing,frostmourne,1609,shaman,elemental,54,22,32
Thündermoose,tichondrius,1608,shaman,elemental,42,21,21
Taxd,sargeras,1605,shaman,elemental,40,21,19
Jaimenohex,illidan,1603,shaman,elemental,36,19,17
Nutty,dentarg,1602,shaman,elemental,42,24,18
Tulol,tichondrius,1602,shaman,elemental,114,54,60
Opaltsing,tichondrius,1601,shaman,elemental,39,19,20
Daddykooll,tichondrius,1600,shaman,elemental,36,22,14
Igotu,tichondrius,1595,shaman,elemental,30,17,13
Setò,quelthalas,1591,shaman,elemental,42,22,20
Zelthakaru,emerald-dream,1587,shaman,elemental,42,18,24
Imense,sargeras,1584,shaman,elemental,42,24,18
Ssjgreen,illidan,1580,shaman,elemental,54,26,28
Isekai,alterac-mountains,1579,shaman,elemental,139,69,70
Zap,wyrmrest-accord,1576,shaman,elemental,78,39,39
Cepheí,bleeding-hollow,1573,shaman,elemental,42,19,23
ßævis,magtheridon,1572,shaman,elemental,24,17,7
Óompaloompa,frostmourne,1570,shaman,elemental,42,25,17
Topax,vashj,1568,shaman,elemental,35,21,14
Hadèes,zuljin,1567,shaman,elemental,144,72,72
Heavyboxer,tichondrius,1565,shaman,elemental,42,20,22
Indika,stormrage,1560,shaman,elemental,30,18,12
Climhazard,senjin,1555,shaman,elemental,36,18,18
Shellshocka,korgath,1554,shaman,elemental,38,20,18
Generators,area-52,1553,shaman,elemental,177,88,89
Dtab,tichondrius,1552,shaman,elemental,36,18,18
Illbuyurmom,tichondrius,1552,shaman,elemental,37,17,20
Washedupty,illidan,1550,shaman,elemental,106,53,53
Doodleburger,dathremar,1545,shaman,elemental,50,41,9
Drogues,tichondrius,1543,shaman,elemental,47,26,21
Univearth,emerald-dream,1542,shaman,elemental,66,34,32
Borheals,tichondrius,1538,shaman,elemental,32,18,14
Pikopiko,tichondrius,1535,shaman,elemental,24,16,8
Robot,illidan,1534,shaman,elemental,30,16,14
Simada,tichondrius,1532,shaman,elemental,30,16,14
Harrypotqueu,zuljin,1527,shaman,elemental,30,16,14
Thundermatt,aegwynn,1525,shaman,elemental,81,39,42
Draghul,frostwolf,1520,shaman,elemental,43,24,19
Yasmiel,zuljin,1517,shaman,elemental,54,24,30
Honeybean,tichondrius,1516,shaman,elemental,60,29,31
Clapton,darkspear,1515,shaman,elemental,47,21,26
Magtark,frostwolf,1509,shaman,elemental,30,16,14
Uglymugshock,tichondrius,1509,shaman,elemental,54,24,30
Rss,barthilas,1507,shaman,elemental,47,25,22
Tuntar,ragnaros,1504,shaman,elemental,110,58,52
Cowish,illidan,1487,shaman,elemental,42,23,19
Soulrak,tichondrius,1486,shaman,elemental,94,44,50
Chandye,proudmoore,1485,shaman,elemental,36,16,20
Groundme,malganis,1484,shaman,elemental,29,16,13
Huskër,tichondrius,1483,shaman,elemental,64,38,26
Innvious,sargeras,1483,shaman,elemental,60,28,32
Gloi,ragnaros,1481,shaman,elemental,31,19,12
Evilraven,tichondrius,1477,shaman,elemental,167,82,85
Defrout,kelthuzad,1469,shaman,elemental,54,25,29
Stitchis,black-dragonflight,1466,shaman,elemental,51,29,22
Gahaa,tichondrius,1464,shaman,elemental,23,16,7
Joehogan,stormrage,1463,shaman,elemental,67,40,27
Drazzella,arthas,1445,shaman,elemental,41,19,22
Däbü,tichondrius,1440,shaman,elemental,24,15,9
Lovesthegear,blackrock,1438,shaman,elemental,24,15,9
Biberom,kelthuzad,1434,shaman,elemental,57,32,25
Nøir,drakkari,1432,shaman,elemental,48,20,28
Waterground,tichondrius,1428,shaman,elemental,31,16,15
Saraguthix,dalaran,1427,shaman,elemental,60,27,33
Zugzugthug,moon-guard,1426,shaman,elemental,107,58,49
Cgq,tichondrius,1425,shaman,elemental,54,28,26
Snapstr,illidan,1419,shaman,elemental,36,15,21
Hufflefluffs,kiljaeden,1418,shaman,elemental,38,23,15
Letronix,azralon,1418,shaman,elemental,36,15,21
Blacklm,tichondrius,1413,shaman,elemental,24,15,9
Plotious,antonidas,1413,shaman,elemental,36,19,17
Dumpweed,stormscale,1413,shaman,elemental,42,21,21
Gumballin,sargeras,1412,shaman,elemental,85,41,44
Malosa,hyjal,1411,shaman,elemental,41,16,25
Ragnards,ragnaros,1410,shaman,elemental,38,18,20
Morluné,tichondrius,1407,shaman,elemental,54,26,28
Zappynips,frostmourne,1399,shaman,elemental,39,20,19
Liloggie,illidan,1385,shaman,elemental,23,15,8
Shampainn,demon-soul,1383,shaman,elemental,65,33,32
Ceedlamb,kelthuzad,1381,shaman,elemental,66,34,32
Chonkymilk,illidan,1373,shaman,elemental,44,18,26
Zechary,proudmoore,1372,shaman,elemental,48,19,29
Venekk,shattered-hand,1366,shaman,elemental,29,17,12
Rythia,elune,1363,shaman,elemental,40,18,22
Telain,quelthalas,1360,shaman,elemental,84,42,42
Conductivity,frostmourne,1351,shaman,elemental,30,15,15
Rinnobunen,wyrmrest-accord,1347,shaman,elemental,30,15,15
Spoonforkorc,thrall,1342,shaman,elemental,24,14,10
Hurky,sargeras,1340,shaman,elemental,85,43,42
Eimear,kelthuzad,1336,shaman,elemental,24,14,10
Cocainbear,emerald-dream,1332,shaman,elemental,39,20,19
Rolltìde,tichondrius,1328,shaman,elemental,129,72,57
Totem,burning-legion,1327,shaman,elemental,24,14,10
Ekstasiel,azralon,1323,shaman,elemental,54,28,26
Mittss,sargeras,1323,shaman,elemental,76,39,37
Lenin,nathrezim,1316,shaman,elemental,62,24,38
Jaapo,barthilas,1313,shaman,elemental,61,31,30
Ralae,zuljin,1310,shaman,elemental,23,14,9
Luvstospooj,thaurissan,1308,shaman,elemental,55,23,32
Hüsky,dalaran,1305,shaman,elemental,29,14,15
Hueymagoo,firetree,1295,shaman,elemental,24,14,10
Malrom,kelthuzad,1293,shaman,elemental,243,124,119
Orkuss,illidan,1281,shaman,elemental,23,14,9
Ffaísca,azralon,1279,shaman,elemental,38,19,19
Shamanzinh,azralon,1262,shaman,elemental,36,19,17
Sugirukifuja,stormrage,1258,shaman,elemental,23,16,7
Gambezee,kelthuzad,1247,shaman,elemental,30,13,17
Missedkick,tichondrius,1246,shaman,elemental,18,13,5
Clarix,quelthalas,1241,shaman,elemental,24,13,11
Kkangsiki,tichondrius,1233,shaman,elemental,30,13,17
Edenorion,ragnaros,1232,shaman,elemental,42,20,22
Moacmathi,quelthalas,1232,shaman,elemental,54,23,31
Snewboii,malganis,1231,shaman,elemental,24,13,11
Porkfririe,kelthuzad,1224,shaman,elemental,34,14,20
Yasuriyamile,illidan,1222,shaman,elemental,82,36,46
Chaposz,tichondrius,1221,shaman,elemental,30,13,17
Totemtown,darkspear,1220,shaman,elemental,42,17,25
Synerggy,hakkar,1217,shaman,elemental,114,57,57
Engara,frostmane,1216,shaman,elemental,29,13,16
Øten,area-52,1214,shaman,elemental,30,20,10
Beerofdoom,proudmoore,1214,shaman,elemental,30,15,15
Vulkuro,quelthalas,1214,shaman,elemental,30,13,17
Yippeekiyay,zuluhed,1212,shaman,elemental,33,14,19
Grezzkall,malganis,1207,shaman,elemental,39,19,20
Syile,stormrage,1206,shaman,elemental,26,14,12
Omegaman,lightninghoof,1204,shaman,elemental,69,35,34
Stormsanta,emerald-dream,1203,shaman,elemental,29,13,16
Faygodream,illidan,1203,shaman,elemental,30,13,17
Rafiki,haomarush,1198,shaman,elemental,48,19,29
Mhaal,wyrmrest-accord,1196,shaman,elemental,77,31,46
Alphamael,lightbringer,1195,shaman,elemental,41,21,20
Forgediniron,stormrage,1195,shaman,elemental,36,17,19
Cptnmagma,bleeding-hollow,1189,shaman,elemental,118,55,63
Kumer,tichondrius,1171,shaman,elemental,22,13,9
Bazinguinha,azralon,1169,shaman,elemental,36,15,21
Srbski,emerald-dream,1167,shaman,elemental,26,13,13
Zhokal,quelthalas,1166,shaman,elemental,125,65,60
Jaycobb,area-52,1159,shaman,elemental,30,13,17
Zugdabou,bonechewer,1155,shaman,elemental,66,30,36
Pasto,bleeding-hollow,1152,shaman,elemental,18,12,6
Kustys,tichondrius,1151,shaman,elemental,18,12,6
Krupto,tichondrius,1151,shaman,elemental,24,12,12
Kang,terenas,1150,shaman,elemental,18,12,6
Smiteums,sargeras,1150,shaman,elemental,24,12,12
Poonqtx,frostmourne,1149,shaman,elemental,18,12,6
Electriik,kiljaeden,1146,shaman,elemental,18,12,6
Ratson,ragnaros,1144,shaman,elemental,24,12,12
Yodahh,daggerspine,1131,shaman,elemental,27,15,12
Exoticz,barthilas,1131,shaman,elemental,38,12,26
Johnwilke,area-52,1123,shaman,elemental,43,17,26
Bravederp,kelthuzad,1120,shaman,elemental,63,31,32
Shockazulu,vashj,1109,shaman,elemental,42,22,20
Shamarock,stonemaul,1103,shaman,elemental,42,23,19
Afgoox,tichondrius,1097,shaman,elemental,30,21,9
Yunow,ragnaros,1096,shaman,elemental,48,20,28
Nooglee,malganis,1085,shaman,elemental,27,12,15
Omnath,zuluhed,1083,shaman,elemental,35,19,16
Zappz,thunderlord,1082,shaman,elemental,60,34,26
Karashamy,ragnaros,1078,shaman,elemental,28,12,16
Shammpain,barthilas,1075,shaman,elemental,41,22,19
Semasham,khazgoroth,1068,shaman,elemental,25,12,13
Xoelement,borean-tundra,1062,shaman,elemental,24,12,12
Hazzathxy,tichondrius,1056,shaman,elemental,18,11,7
Petrafk,illidan,1056,shaman,elemental,18,11,7
Bestshamus,sargeras,1056,shaman,elemental,18,11,7
Miroen,tichondrius,1056,shaman,elemental,24,11,13
Pubechin,jubeithos,1056,shaman,elemental,24,11,13
Highsteakss,tichondrius,1055,shaman,elemental,12,11,1
Kymo,tichondrius,1055,shaman,elemental,18,11,7
Smooths,bloodscalp,1055,shaman,elemental,18,11,7
Pipesable,ragnaros,1055,shaman,elemental,18,11,7
Ndndurkadurk,malganis,1055,shaman,elemental,18,11,7
Bootietootie,bleeding-hollow,1055,shaman,elemental,18,11,7
Laelyk,kiljaeden,1055,shaman,elemental,24,11,13
Thuntard,bleeding-hollow,1055,shaman,elemental,24,11,13
Kigoros,bleeding-hollow,1054,shaman,elemental,18,11,7
Sumnah,sargeras,1054,shaman,elemental,42,22,20
Blastuh,kiljaeden,1053,shaman,elemental,18,11,7
Ectomee,tichondrius,1051,shaman,elemental,18,11,7
Taeilendar,ragnaros,1050,shaman,elemental,24,11,13
Nazz,cenarion-circle,1048,shaman,elemental,18,11,7
Üchihamadarâ,tichondrius,1046,shaman,elemental,27,12,15
Skwiglz,tichondrius,1045,shaman,elemental,63,29,34
Minzysm,illidan,1045,shaman,elemental,24,11,13
Enflexi,lightbringer,1044,shaman,elemental,24,11,13
Baltharzhard,saurfang,1040,shaman,elemental,24,11,13
Darkrock,echo-isles,1033,shaman,elemental,24,12,12
Asanako,illidan,1028,shaman,elemental,46,20,26
Rollypolli,gnomeregan,1022,shaman,elemental,72,36,36
Olani,nesingwary,1022,shaman,elemental,38,12,26
Treesntotemz,darkspear,1020,shaman,elemental,18,11,7
Cavolt,stormrage,1017,shaman,elemental,23,11,12
Geladoo,gallywix,1008,shaman,elemental,56,23,33
Wälee,sargeras,1004,shaman,elemental,77,37,40
Firecracker,warsong,1003,shaman,elemental,52,29,23
Shambix,illidan,1002,shaman,elemental,19,12,7
Cheweydadawg,shandris,990,shaman,elemental,23,11,12
Soartotes,sargeras,987,shaman,elemental,22,11,11
Shamanic,dunemaul,984,shaman,elemental,83,31,52
Saanrixa,jubeithos,981,shaman,elemental,72,24,48
Bronan,laughing-skull,976,shaman,elemental,54,20,34
Mistayl,bleeding-hollow,968,shaman,elemental,30,12,18
Dewoverload,garithos,960,shaman,elemental,12,10,2
Smrtdeath,zuljin,960,shaman,elemental,12,10,2
Smeagles,ragnaros,960,shaman,elemental,18,10,8
Mazadu,malganis,960,shaman,elemental,18,10,8
Àspect,aegwynn,960,shaman,elemental,18,10,8
Bigdaddyion,thrall,960,shaman,elemental,18,10,8
Shøckys,tichondrius,960,shaman,elemental,24,10,14
Molbeato,uldum,960,shaman,elemental,24,10,14
Hexoffend,zuljin,959,shaman,elemental,18,10,8
Kodyaj,illidan,959,shaman,elemental,18,10,8
Ñîmåbè,tichondrius,959,shaman,elemental,18,10,8
Tidalstorm,thrall,959,shaman,elemental,18,10,8
Ryukims,tichondrius,959,shaman,elemental,18,10,8
Fruityrudyy,area-52,958,shaman,elemental,18,10,8
Enhancers,sargeras,958,shaman,elemental,18,10,8
Aingry,darkspear,958,shaman,elemental,18,10,8
Moartotems,kelthuzad,957,shaman,elemental,12,10,2
Korlog,tichondrius,957,shaman,elemental,12,10,2
Charabon,ragnaros,957,shaman,elemental,18,10,8
Tunegrote,ragnaros,957,shaman,elemental,24,10,14
Redlava,turalyon,956,shaman,elemental,12,10,2
Shockshammy,kiljaeden,956,shaman,elemental,18,10,8
Sanlu,tichondrius,955,shaman,elemental,59,27,32
Kakaaroto,nemesis,954,shaman,elemental,18,10,8
Tinkd,stormrage,953,shaman,elemental,18,10,8
Izreborn,tichondrius,953,shaman,elemental,24,10,14
Vktr,drakkari,953,shaman,elemental,24,10,14
Discokid,norgannon,951,shaman,elemental,24,10,14
Lezzer,ragnaros,944,shaman,elemental,30,10,20
Proignite,drakthul,934,shaman,elemental,35,17,18
Lavablaster,kelthuzad,932,shaman,elemental,12,10,2
Gorron,frostwolf,929,shaman,elemental,24,10,14
Dooman,area-52,927,shaman,elemental,30,10,20
Golozok,zuljin,923,shaman,elemental,23,10,13
Bushdeedit,stormrage,910,shaman,elemental,23,10,13
Aragog,malygos,899,shaman,elemental,32,16,16
Threehandz,bleeding-hollow,886,shaman,elemental,55,20,35
Boomsele,tichondrius,880,shaman,elemental,13,10,3
Trilz,barthilas,880,shaman,elemental,19,10,9
Zeroclue,area-52,879,shaman,elemental,17,10,7
Destroçadorx,azralon,872,shaman,elemental,20,10,10
Notragii,kelthuzad,864,shaman,elemental,12,9,3
Planetwaves,malganis,864,shaman,elemental,12,9,3
Jer,tichondrius,864,shaman,elemental,12,9,3
Helga,hellscream,864,shaman,elemental,12,9,3
Koalatricks,shadow-council,864,shaman,elemental,12,9,3
Oldcregg,emerald-dream,864,shaman,elemental,12,9,3
Councilman,illidan,864,shaman,elemental,18,9,9
Exceedër,ragnaros,864,shaman,elemental,18,9,9
Ehhmacros,doomhammer,864,shaman,elemental,18,9,9
Owtyobwol,area-52,864,shaman,elemental,18,9,9
Zuescannon,kelthuzad,864,shaman,elemental,18,9,9
Earthclap,tichondrius,864,shaman,elemental,24,9,15
Ðomzy,tichondrius,863,shaman,elemental,12,9,3
Poseidon,kiljaeden,863,shaman,elemental,18,9,9
Earthfirex,ragnaros,863,shaman,elemental,18,9,9
Onnyx,proudmoore,863,shaman,elemental,18,9,9
Blöw,tichondrius,863,shaman,elemental,18,9,9
Skyten,quelthalas,863,shaman,elemental,21,10,11
Dtrumpx,tichondrius,863,shaman,elemental,24,9,15
Xodeus,frostmourne,863,shaman,elemental,24,9,15
Thaél,proudmoore,863,shaman,elemental,24,9,15
Luxenor,kelthuzad,862,shaman,elemental,12,9,3
Tottemic,blackrock,862,shaman,elemental,18,9,9
Phagocytosis,illidan,861,shaman,elemental,18,9,9
Grandwolf,ragnaros,861,shaman,elemental,18,9,9
Jensenx,proudmoore,861,shaman,elemental,24,9,15
Grukall,galakrond,860,shaman,elemental,12,9,3
Ayahuaskah,illidan,860,shaman,elemental,18,9,9
Galabanjø,malganis,860,shaman,elemental,24,9,15
Velekar,moon-guard,858,shaman,elemental,24,9,15
Gorakh,illidan,856,shaman,elemental,18,9,9
Dellnar,nagrand,847,shaman,elemental,18,9,9
Justballs,stormscale,835,shaman,elemental,18,9,9
Shàmpow,darkspear,823,shaman,elemental,17,9,8
Vegaslights,tichondrius,816,shaman,elemental,21,9,12
Thanwirn,ragnaros,809,shaman,elemental,24,9,15
Relâx,icecrown,779,shaman,elemental,19,9,10
Bagovs,tichondrius,768,shaman,elemental,12,8,4
Supbrø,zuluhed,768,shaman,elemental,12,8,4
Xammaa,illidan,768,shaman,elemental,12,8,4
Morabebi,tichondrius,768,shaman,elemental,12,8,4
Talonga,moon-guard,768,shaman,elemental,12,8,4
Biggiechief,illidan,768,shaman,elemental,12,8,4
Squidzy,tichondrius,768,shaman,elemental,12,8,4
Caninius,sargeras,768,shaman,elemental,18,8,10
Shocksrus,arthas,768,shaman,elemental,18,8,10
Momothewolf,malganis,767,shaman,elemental,12,8,4
Shockerfist,thunderlord,767,shaman,elemental,12,8,4
Endorovich,mannoroth,767,shaman,elemental,18,8,10
Mazdamundï,ragnaros,767,shaman,elemental,24,8,16
Kowabounga,ragnaros,766,shaman,elemental,18,8,10
Fênrisulfer,area-52,766,shaman,elemental,18,8,10
Nírnez,ragnaros,765,shaman,elemental,24,8,16
Cheddatotz,illidan,764,shaman,elemental,12,8,4
Pãníç,bladefist,764,shaman,elemental,18,8,10
Maldini,tol-barad,764,shaman,elemental,18,8,10
Toho,ragnaros,764,shaman,elemental,18,8,10
Neebon,jubeithos,763,shaman,elemental,12,8,4
Shammany,stormrage,763,shaman,elemental,18,8,10
Teekona,tichondrius,763,shaman,elemental,18,8,10
Lowiqpleb,tichondrius,719,shaman,elemental,17,8,9
Pileef,thrall,704,shaman,elemental,10,8,2
Dmt,exodar,704,shaman,elemental,22,8,14
Fwwrs,illidan,703,shaman,elemental,14,8,6
Makogo,earthen-ring,686,shaman,elemental,13,8,5
Xinz,guldan,672,shaman,elemental,12,7,5
Shambergler,tichondrius,672,shaman,elemental,12,7,5
Drmeatballmd,tichondrius,672,shaman,elemental,12,7,5
Totemzie,illidan,672,shaman,elemental,12,7,5
Thoraq,bleeding-hollow,672,shaman,elemental,12,7,5
Ayetex,kelthuzad,672,shaman,elemental,12,7,5
Willy,icecrown,672,shaman,elemental,12,7,5
Tatespeech,barthilas,672,shaman,elemental,12,7,5
Chazzwozza,area-52,672,shaman,elemental,12,7,5
Pericazo,sargeras,672,shaman,elemental,12,7,5
Ðøææøð,stormrage,672,shaman,elemental,12,7,5
Rahkarg,korgath,672,shaman,elemental,12,7,5
Xpire,ragnaros,672,shaman,elemental,12,7,5
Humorlava,tichondrius,672,shaman,elemental,12,7,5
Cuban,kelthuzad,672,shaman,elemental,12,7,5
Glizzyjamon,sargeras,672,shaman,elemental,12,7,5
Neotrad,proudmoore,672,shaman,elemental,18,7,11
Eravas,thrall,672,shaman,elemental,18,7,11
Hengler,emerald-dream,672,shaman,elemental,18,7,11
Desdìnova,tortheldrin,672,shaman,elemental,18,7,11
Dansham,zuljin,672,shaman,elemental,24,7,17
Jacori,malganis,671,shaman,elemental,12,7,5
Ôprawindfury,mugthol,671,shaman,elemental,12,7,5
Lenå,moon-guard,671,shaman,elemental,12,7,5
Hairyrichard,zuljin,671,shaman,elemental,12,7,5
Xantoor,area-52,670,shaman,elemental,12,7,5
Grimlên,skullcrusher,669,shaman,elemental,18,7,11
Phuamya,dalaran,667,shaman,elemental,12,7,5
Mîkâ,area-52,664,shaman,elemental,18,7,11
Jyster,area-52,664,shaman,elemental,24,7,17
Totempoke,frostmourne,654,shaman,elemental,11,7,4
Cardanø,illidan,652,shaman,elemental,29,7,22
Cheesewheelz,arthas,651,shaman,elemental,22,7,15
Megalithic,moon-guard,639,shaman,elemental,14,8,6
Koongram,area-52,623,shaman,elemental,11,7,4
Shizzänk,illidan,606,shaman,elemental,11,7,4
Boltadeez,tichondrius,576,shaman,elemental,6,6,0
Adutchcowboy,tichondrius,576,shaman,elemental,6,6,0
Kasparøv,tichondrius,576,shaman,elemental,6,6,0
Funuser,hellscream,576,shaman,elemental,9,7,2
Doorti,area-52,576,shaman,elemental,12,6,6
Sheriffbj,emerald-dream,576,shaman,elemental,12,6,6
Cornivore,malganis,576,shaman,elemental,12,6,6
Jnzz,area-52,576,shaman,elemental,12,6,6
Doommjölnir,sargeras,576,shaman,elemental,12,6,6
Hydroponicz,sargeras,576,shaman,elemental,12,6,6
Finark,tichondrius,576,shaman,elemental,12,6,6
Rubmytotêm,tichondrius,576,shaman,elemental,12,6,6
Redpocket,zuluhed,576,shaman,elemental,12,6,6
Getwetand,quelthalas,576,shaman,elemental,12,6,6
Orkshammy,illidan,576,shaman,elemental,12,6,6
Thunderfaker,tichondrius,576,shaman,elemental,12,6,6
Bustinbooty,kiljaeden,576,shaman,elemental,12,6,6
Storminlorka,sargeras,576,shaman,elemental,12,6,6
Soo,kiljaeden,576,shaman,elemental,12,6,6
Tairen,ragnaros,576,shaman,elemental,12,6,6
Deyodin,illidan,576,shaman,elemental,12,6,6
Traindablue,illidan,576,shaman,elemental,12,6,6
Shockjob,frostmourne,576,shaman,elemental,12,6,6
Zzarit,tichondrius,576,shaman,elemental,13,6,7
Shøckolate,magtheridon,575,shaman,elemental,12,6,6
Deggle,frostwolf,575,shaman,elemental,12,6,6
Procdepartme,area-52,575,shaman,elemental,12,6,6
Skribblez,tichondrius,575,shaman,elemental,12,6,6
Nuofu,illidan,575,shaman,elemental,12,6,6
Apocalypsehb,quelthalas,575,shaman,elemental,12,6,6
Seinnome,azralon,575,shaman,elemental,12,6,6
Moctezumma,area-52,575,shaman,elemental,12,6,6
Nemei,zuljin,575,shaman,elemental,12,6,6
Shachone,zuljin,575,shaman,elemental,12,6,6
Drewshammy,zuljin,575,shaman,elemental,12,6,6
Nomahuata,cenarion-circle,575,shaman,elemental,18,6,12
Grimitt,suramar,575,shaman,elemental,18,6,12
Coffee,mugthol,574,shaman,elemental,18,6,12
Tideborn,azralon,572,shaman,elemental,16,7,9
Totempaul,frostmourne,570,shaman,elemental,18,6,12
Asy,tichondrius,559,shaman,elemental,11,6,5
Aitex,kelthuzad,543,shaman,elemental,15,7,8
Thanen,the-scryers,541,shaman,elemental,16,6,10
Aseew,drakkari,522,shaman,elemental,21,9,12
Zerium,nemesis,495,shaman,elemental,19,6,13
Farku,illidan,480,shaman,elemental,6,5,1
Sxr,moon-guard,480,shaman,elemental,6,5,1
Meatballsx,tichondrius,480,shaman,elemental,6,5,1
Kebboz,frostmourne,480,shaman,elemental,6,5,1
Shamxrob,sargeras,480,shaman,elemental,6,5,1
Lfhotmoms,moon-guard,480,shaman,elemental,6,5,1
Afri,tichondrius,480,shaman,elemental,6,5,1
Vulcansh,azralon,480,shaman,elemental,6,5,1
Hurìon,coilfang,480,shaman,elemental,6,5,1
Lff,stormrage,480,shaman,elemental,6,5,1
Firedchips,tichondrius,480,shaman,elemental,17,8,9
Zajashuna,malganis,480,shaman,elemental,12,5,7
Shamberheard,kelthuzad,480,shaman,elemental,12,5,7
Adesaa,illidan,480,shaman,elemental,12,5,7
Sgorr,illidan,480,shaman,elemental,12,5,7
Zeebouzy,illidan,480,shaman,elemental,12,5,7
Gjaj,tichondrius,480,shaman,elemental,12,5,7
Kanasya,quelthalas,480,shaman,elemental,12,5,7
Arukz,tichondrius,480,shaman,elemental,12,5,7
Wobbleshock,tichondrius,480,shaman,elemental,12,5,7
Everyst,darkspear,480,shaman,elemental,12,5,7
Delement,ragnaros,480,shaman,elemental,12,5,7
Zò,zuljin,480,shaman,elemental,12,5,7
Shamigo,tichondrius,480,shaman,elemental,12,5,7
Eluulne,silvermoon,480,shaman,elemental,12,5,7
Flamestrife,illidan,480,shaman,elemental,12,5,7
Mariarlee,proudmoore,480,shaman,elemental,12,5,7
Cónò,tichondrius,480,shaman,elemental,12,5,7
Slumpinator,tichondrius,480,shaman,elemental,12,5,7
Twistedteas,tichondrius,480,shaman,elemental,12,5,7
Stayz,tichondrius,480,shaman,elemental,12,5,7
Chomolungma,azralon,480,shaman,elemental,12,5,7
Vashidda,stormrage,480,shaman,elemental,12,5,7
Daerönn,azralon,480,shaman,elemental,12,5,7
Richode,burning-legion,480,shaman,elemental,12,5,7
Jènova,whisperwind,480,shaman,elemental,12,5,7
Totemchucker,stormrage,480,shaman,elemental,15,6,9
Shuñk,frostmourne,480,shaman,elemental,18,5,13
Helapoon,area-52,480,shaman,elemental,18,5,13
Firesurge,sargeras,480,shaman,elemental,18,5,13
Arialial,hyjal,480,shaman,elemental,18,5,13
Lugak,ragnaros,480,shaman,elemental,18,5,13
Advìl,area-52,480,shaman,elemental,18,5,13
Madeleines,goldrinn,479,shaman,elemental,6,5,1
Shanão,nemesis,479,shaman,elemental,6,5,1
Killdeaderer,barthilas,479,shaman,elemental,6,5,1
Ðarkvolts,stormrage,479,shaman,elemental,12,5,7
Sparkyy,kelthuzad,479,shaman,elemental,12,5,7
Doughboy,khadgar,478,shaman,elemental,14,6,8
Dizzytotem,dalaran,478,shaman,elemental,12,5,7
Daiskei,nordrassil,476,shaman,elemental,12,5,7
Kinjin,dragonmaw,415,shaman,elemental,14,5,9
Ripklanian,blood-furnace,400,shaman,elemental,13,5,8
Clamson,tichondrius,384,shaman,elemental,6,4,2
Thorlottie,stormrage,384,shaman,elemental,6,4,2
Shammyqua,tichondrius,384,shaman,elemental,6,4,2
Ruugo,malganis,384,shaman,elemental,6,4,2
Merkal,illidan,384,shaman,elemental,6,4,2
Thandius,arygos,384,shaman,elemental,6,4,2
Madelements,tichondrius,384,shaman,elemental,6,4,2
Littz,malganis,384,shaman,elemental,6,4,2
Jimmyapple,illidan,384,shaman,elemental,6,4,2
Blueku,tichondrius,384,shaman,elemental,6,4,2
Simped,bleeding-hollow,384,shaman,elemental,6,4,2
Jeffspicele,emerald-dream,384,shaman,elemental,6,4,2
Dragaru,illidan,384,shaman,elemental,6,4,2
Novoz,tichondrius,384,shaman,elemental,6,4,2
Cduck,zuljin,384,shaman,elemental,6,4,2
Weebdestroyr,illidan,384,shaman,elemental,6,4,2
Aishel,area-52,384,shaman,elemental,6,4,2
Dgshaman,tichondrius,384,shaman,elemental,6,4,2
Munchies,madoran,384,shaman,elemental,6,4,2
Lukora,stonemaul,384,shaman,elemental,6,4,2
Drakhe,proudmoore,384,shaman,elemental,6,4,2
Zenan,stormreaver,384,shaman,elemental,6,4,2
Boogiefever,area-52,384,shaman,elemental,6,4,2
Lasso,shattered-hand,384,shaman,elemental,6,4,2
Elebro,emerald-dream,384,shaman,elemental,6,4,2
Stormflow,dalaran,384,shaman,elemental,6,4,2
Hexellént,kiljaeden,384,shaman,elemental,6,4,2
Creativemind,ragnaros,384,shaman,elemental,6,4,2
Dingfu,sargeras,384,shaman,elemental,6,4,2
Vodord,arathor,384,shaman,elemental,6,4,2
Dromus,dalvengyr,384,shaman,elemental,6,4,2
Greensween,thrall,384,shaman,elemental,6,4,2
Ktom,runetotem,384,shaman,elemental,6,4,2
Brickzilla,dalaran,384,shaman,elemental,6,4,2
Stormsage,jubeithos,384,shaman,elemental,6,4,2
Seraøth,area-52,384,shaman,elemental,6,4,2
Wodgodx,sargeras,384,shaman,elemental,6,4,2
Graveshocks,illidan,384,shaman,elemental,6,4,2
Bitamin,frostmourne,384,shaman,elemental,6,4,2
Minigible,tichondrius,384,shaman,elemental,6,4,2
Borgmash,chogall,384,shaman,elemental,6,4,2
Kilydily,destromath,384,shaman,elemental,6,4,2
Muffïn,moon-guard,384,shaman,elemental,6,4,2
Super,azshara,384,shaman,elemental,14,5,9
Sin,bleeding-hollow,384,shaman,elemental,12,4,8
Oohkillemm,silvermoon,384,shaman,elemental,12,4,8
Kushnations,chogall,384,shaman,elemental,12,4,8
Pozcaster,tichondrius,384,shaman,elemental,12,4,8
Feetfungus,area-52,384,shaman,elemental,12,4,8
Zizö,barthilas,384,shaman,elemental,12,4,8
Shrektar,cenarius,384,shaman,elemental,12,4,8
Lavasurge,area-52,384,shaman,elemental,12,4,8
Sjostrom,proudmoore,384,shaman,elemental,12,4,8
Ayatsu,thrall,384,shaman,elemental,12,4,8
Fatherrtime,illidan,384,shaman,elemental,12,4,8
Krimz,executus,384,shaman,elemental,12,4,8
Rudoboy,ragnaros,384,shaman,elemental,12,4,8
Elryl,sargeras,384,shaman,elemental,12,4,8
Popsoot,area-52,384,shaman,elemental,12,4,8
Hansolorz,tichondrius,384,shaman,elemental,18,4,14
Vjeze,frostmourne,384,shaman,elemental,18,4,14
Pepîllo,ragnaros,384,shaman,elemental,24,4,20
Nezzuk,quelthalas,383,shaman,elemental,6,4,2
Machalo,sargeras,383,shaman,elemental,12,4,8
Potatopirate,burning-legion,381,shaman,elemental,18,4,14
Coffeeblacc,magtheridon,379,shaman,elemental,12,4,8
Babyblake,malganis,351,shaman,elemental,8,5,3
Shk,illidan,351,shaman,elemental,11,4,7
Råys,turalyon,350,shaman,elemental,11,4,7
Stormfronts,kelthuzad,336,shaman,elemental,9,4,5
Trashaman,garona,336,shaman,elemental,9,4,5
Nondracil,ragnaros,336,shaman,elemental,14,4,10
Taraneh,garrosh,325,shaman,elemental,15,5,10
Orochishaman,stormrage,319,shaman,elemental,5,4,1
Sweetbabyraé,bleeding-hollow,304,shaman,elemental,7,4,3
Tsunamibrew,moon-guard,302,shaman,elemental,9,4,5
Shamyuna,dalaran,288,shaman,elemental,6,3,3
Earthfurÿ,quelthalas,288,shaman,elemental,6,3,3
Shocks,alleria,288,shaman,elemental,6,3,3
Malgrave,ragnaros,288,shaman,elemental,6,3,3
Mabite,frostmourne,288,shaman,elemental,6,3,3
Fluffyhex,sargeras,288,shaman,elemental,6,3,3
Fattizer,sargeras,288,shaman,elemental,6,3,3
Axshaman,darkspear,288,shaman,elemental,6,3,3
Éarl,sargeras,288,shaman,elemental,6,3,3
Shadeele,cenarius,288,shaman,elemental,6,3,3
Healingtime,nerzhul,288,shaman,elemental,6,3,3
Häzel,nerzhul,288,shaman,elemental,6,3,3
Blakki,barthilas,288,shaman,elemental,6,3,3
Shizamm,hyjal,288,shaman,elemental,6,3,3
Dì,barthilas,288,shaman,elemental,6,3,3
Daiablo,barthilas,288,shaman,elemental,6,3,3
Passion,sargeras,288,shaman,elemental,6,3,3
Rokogg,thrall,288,shaman,elemental,6,3,3
Shamtactic,thrall,288,shaman,elemental,6,3,3
Arckos,thrall,288,shaman,elemental,6,3,3
Dràgoon,thrall,288,shaman,elemental,6,3,3
Doop,kiljaeden,288,shaman,elemental,6,3,3
Autisty,sargeras,288,shaman,elemental,6,3,3
Groink,kiljaeden,288,shaman,elemental,6,3,3
Flowerchild,proudmoore,288,shaman,elemental,6,3,3
Mønønøke,tichondrius,288,shaman,elemental,6,3,3
Largerwang,sargeras,288,shaman,elemental,6,3,3
Gödöfbüdå,tichondrius,288,shaman,elemental,6,3,3
Applicable,tichondrius,288,shaman,elemental,6,3,3
Bizle,jaedenar,288,shaman,elemental,6,3,3
Ieeguen,tichondrius,288,shaman,elemental,6,3,3
Ggoong,tichondrius,288,shaman,elemental,6,3,3
Statikrage,eonar,288,shaman,elemental,6,3,3
Fobb,area-52,288,shaman,elemental,6,3,3
Trenhance,stormrage,288,shaman,elemental,6,3,3
Rampàge,ragnaros,288,shaman,elemental,6,3,3
Vanëssão,stormrage,288,shaman,elemental,6,3,3
Tokelahoma,stormrage,288,shaman,elemental,6,3,3
Spacemilk,stormrage,288,shaman,elemental,6,3,3
Ragor,quelthalas,288,shaman,elemental,6,3,3
Raiden,gorgonnash,288,shaman,elemental,6,3,3
Fanatix,moon-guard,288,shaman,elemental,6,3,3
Ioki,spirestone,288,shaman,elemental,6,3,3
Zlateral,malganis,288,shaman,elemental,6,3,3
Bolteon,malganis,288,shaman,elemental,6,3,3
Improvize,malganis,288,shaman,elemental,6,3,3
Zynt,illidan,288,shaman,elemental,6,3,3
Zon,laughing-skull,288,shaman,elemental,6,3,3
Malito,ursin,288,shaman,elemental,6,3,3
Palcyon,eonar,288,shaman,elemental,6,3,3
Vibration,akama,288,shaman,elemental,6,3,3
Talfur,area-52,288,shaman,elemental,6,3,3
Scrymax,area-52,288,shaman,elemental,6,3,3
Groundfaults,bleeding-hollow,288,shaman,elemental,6,3,3
Exsh,area-52,288,shaman,elemental,6,3,3
Shàman,durotan,288,shaman,elemental,6,3,3
Beatryx,the-scryers,288,shaman,elemental,6,3,3
Blaydin,elune,288,shaman,elemental,6,3,3
Shajay,area-52,288,shaman,elemental,6,3,3
Grimnur,bleeding-hollow,288,shaman,elemental,11,3,8
Emptee,area-52,288,shaman,elemental,12,3,9
Oznog,bleeding-hollow,288,shaman,elemental,12,3,9
Winiethepoöh,stormrage,288,shaman,elemental,12,3,9
Tdub,frostmourne,288,shaman,elemental,12,3,9
Maxchamo,ragnaros,288,shaman,elemental,12,3,9
Tawahka,hyjal,288,shaman,elemental,12,3,9
Taquitho,quelthalas,288,shaman,elemental,12,3,9
Bloodytotemz,emerald-dream,288,shaman,elemental,12,3,9
Káládin,malganis,288,shaman,elemental,12,3,9
Arakye,stormrage,287,shaman,elemental,6,3,3
Strikzjr,frostmourne,287,shaman,elemental,6,3,3
Cropdustr,sargeras,286,shaman,elemental,6,3,3
Nuggitz,tichondrius,286,shaman,elemental,9,4,5
Hexytimexoqt,thrall,255,shaman,elemental,11,3,8
Hannibol,tichondrius,255,shaman,elemental,11,3,8
Oxxnabatko,amanthul,240,shaman,elemental,9,3,6
Spunjie,frostmourne,239,shaman,elemental,5,3,2
Liamus,amanthul,239,shaman,elemental,5,3,2
Sarahfe,wyrmrest-accord,239,shaman,elemental,5,3,2
Olex,zuluhed,192,shaman,elemental,6,2,4
Hehew,kelthuzad,192,shaman,elemental,6,2,4
Dehsaw,illidan,192,shaman,elemental,6,2,4
Snoocher,kelthuzad,192,shaman,elemental,6,2,4
Bigbadbolt,malganis,192,shaman,elemental,6,2,4
Rokhnar,zuljin,192,shaman,elemental,6,2,4
Shamans,zuljin,192,shaman,elemental,6,2,4
Dadadabang,frostmourne,192,shaman,elemental,6,2,4
Yssyyds,illidan,192,shaman,elemental,6,2,4
Ric,malganis,192,shaman,elemental,6,2,4
Gorillox,chogall,192,shaman,elemental,6,2,4
Killtotem,illidan,192,shaman,elemental,6,2,4
Lenxd,dalaran,192,shaman,elemental,6,2,4
Zugharder,illidan,192,shaman,elemental,6,2,4
Tuksha,alleria,192,shaman,elemental,6,2,4
Shockbot,stormscale,192,shaman,elemental,6,2,4
Smellyogre,area-52,192,shaman,elemental,6,2,4
Beazel,moon-guard,192,shaman,elemental,6,2,4
Bitflip,jubeithos,192,shaman,elemental,6,2,4
Naextramus,ragnaros,192,shaman,elemental,6,2,4
Tampíco,ragnaros,192,shaman,elemental,6,2,4
Ladash,ragnaros,192,shaman,elemental,6,2,4
Whitecake,frostmourne,192,shaman,elemental,6,2,4
Thormzz,tichondrius,192,shaman,elemental,6,2,4
Sumyl,ragnaros,192,shaman,elemental,6,2,4
Folus,azjolnerub,192,shaman,elemental,6,2,4
Shåmwowz,sargeras,192,shaman,elemental,6,2,4
Wrestleman,drakthul,192,shaman,elemental,6,2,4
Dantheman,twisting-nether,192,shaman,elemental,6,2,4
Matzahmeal,skywall,192,shaman,elemental,6,2,4
Manitbaggins,earthen-ring,192,shaman,elemental,6,2,4
Boodissy,tichondrius,192,shaman,elemental,6,2,4
Tartar,lightbringer,192,shaman,elemental,6,2,4
Lilmollet,tichondrius,192,shaman,elemental,6,2,4
Grandmaster,frostmourne,192,shaman,elemental,6,2,4
Yangsangchu,tichondrius,192,shaman,elemental,6,2,4
Piffzorz,tichondrius,192,shaman,elemental,6,2,4
Funeropolis,stormrage,192,shaman,elemental,6,2,4
Britisy,stormrage,192,shaman,elemental,6,2,4
Moodizzle,tichondrius,192,shaman,elemental,6,2,4
Oppaswag,tichondrius,192,shaman,elemental,6,2,4
Krilick,blackrock,192,shaman,elemental,6,2,4
Ínfected,azralon,192,shaman,elemental,6,2,4
Kanbar,emerald-dream,192,shaman,elemental,6,2,4
Yellowfev,thrall,192,shaman,elemental,6,2,4
Zaxibow,area-52,192,shaman,elemental,6,2,4
Saltywap,proudmoore,192,shaman,elemental,6,2,4
Sid,frostmourne,192,shaman,elemental,6,2,4
Puntress,barthilas,192,shaman,elemental,6,2,4
Alleys,tichondrius,192,shaman,elemental,6,2,4
Wempa,moon-guard,192,shaman,elemental,6,2,4
Trizzeh,moon-guard,192,shaman,elemental,6,2,4
Praisegodx,stormrage,192,shaman,elemental,6,2,4
Stickshaman,sargeras,192,shaman,elemental,6,2,4
Withinfinity,stormrage,192,shaman,elemental,6,2,4
Zeldrys,emerald-dream,192,shaman,elemental,6,2,4
Heniu,tichondrius,192,shaman,elemental,6,2,4
Jbahr,hyjal,192,shaman,elemental,6,2,4
Thuggliife,frostmourne,192,shaman,elemental,6,2,4
Blastj,tichondrius,192,shaman,elemental,6,2,4
Oriyani,sargeras,192,shaman,elemental,6,2,4
Shamsky,tichondrius,192,shaman,elemental,6,2,4
Pacapinchhit,azgalor,192,shaman,elemental,6,2,4
Zuroster,kiljaeden,192,shaman,elemental,7,2,5
Harrìson,tichondrius,192,shaman,elemental,12,2,10
Mega,azralon,192,shaman,elemental,12,2,10
Jazzblast,tichondrius,192,shaman,elemental,12,2,10
Jedley,azshara,192,shaman,elemental,12,2,10
Rìddles,malygos,192,shaman,elemental,12,2,10
Cowtidetotem,thrall,192,shaman,elemental,12,2,10
Fluffy,smolderthorn,192,shaman,elemental,12,2,10
Fulingyu,moon-guard,192,shaman,elemental,12,2,10
Azl,guldan,192,shaman,elemental,13,2,11
Eleveil,emerald-dream,191,shaman,elemental,6,2,4
Hakaskry,caelestrasz,191,shaman,elemental,12,2,10
Hazzardttvz,illidan,159,shaman,elemental,5,2,3
Kidkovid,illidan,159,shaman,elemental,17,2,15
Noslol,bronzebeard,138,shaman,elemental,9,3,6
Uracemytotem,kiljaeden,138,shaman,elemental,10,3,7
Bycrax,ragnaros,128,shaman,elemental,4,2,2
Mynigabob,zuljin,128,shaman,elemental,4,2,2
Rahloo,sargeras,127,shaman,elemental,8,2,6
Obiwonsamdi,illidan,96,shaman,elemental,6,1,5
Ognerkish,black-dragonflight,96,shaman,elemental,6,1,5
Succies,emerald-dream,96,shaman,elemental,6,1,5
Sàuron,tichondrius,96,shaman,elemental,6,1,5
Girafasuarx,korgath,96,shaman,elemental,6,1,5
Juicemcroose,zuljin,96,shaman,elemental,6,1,5
Zral,emerald-dream,96,shaman,elemental,6,1,5
Bouje,frostmourne,96,shaman,elemental,6,1,5
Seanie,bleeding-hollow,96,shaman,elemental,6,1,5
Zorgen,anvilmar,96,shaman,elemental,6,1,5
Firevag,hakkar,96,shaman,elemental,6,1,5
Ludacrìtz,stormrage,96,shaman,elemental,6,1,5
Healsquish,area-52,96,shaman,elemental,6,1,5
Cathxy,kelthuzad,96,shaman,elemental,6,1,5
Jalgago,tichondrius,96,shaman,elemental,6,1,5
Bullcowsby,darkspear,96,shaman,elemental,6,1,5
Drmn,frostmourne,96,shaman,elemental,6,1,5
Toxidizetkö,azralon,96,shaman,elemental,6,1,5
Ravaburst,sargeras,96,shaman,elemental,6,1,5
Sinsar,illidan,96,shaman,elemental,6,1,5
Stormklepter,fizzcrank,96,shaman,elemental,6,1,5
Mugiwára,ragnaros,96,shaman,elemental,6,1,5
Gan,silvermoon,96,shaman,elemental,6,1,5
Aegaeonlol,tichondrius,96,shaman,elemental,6,1,5
Akó,quelthalas,96,shaman,elemental,6,1,5
Teathin,ragnaros,96,shaman,elemental,6,1,5
Mcshockturds,tichondrius,96,shaman,elemental,6,1,5
Oldshammy,eldrethalas,96,shaman,elemental,6,1,5
Shamofshame,garrosh,96,shaman,elemental,12,1,11
Ëìê,tichondrius,96,shaman,elemental,18,1,17
Eleshamanz,tichondrius,79,shaman,elemental,5,1,4
Camltotem,tichondrius,79,shaman,elemental,5,1,4
Docadams,chogall,79,shaman,elemental,5,1,4
Esbet,echo-isles,79,shaman,elemental,11,1,10
Mcstop,tanaris,64,shaman,elemental,4,1,3
Hentaistorm,kiljaeden,48,shaman,elemental,3,1,2
Gurdle,frostwolf,48,shaman,elemental,3,1,2
Hothouse,malganis,31,shaman,elemental,2,1,1
Saul,tichondrius,2218,shaman,enhancement,66,42,24
Aýanokoji,tichondrius,2201,shaman,enhancement,137,74,63
Alleys,tichondrius,2179,shaman,enhancement,171,88,83
Rauthgar,dalaran,2148,shaman,enhancement,90,51,39
Opoy,sargeras,2142,shaman,enhancement,201,112,89
Nopnopajnin,tichondrius,2135,shaman,enhancement,112,57,55
Skydre,area-52,2131,shaman,enhancement,89,54,35
Jimmyjobs,tichondrius,2129,shaman,enhancement,114,70,44
Pizzashaman,illidan,2128,shaman,enhancement,106,63,43
Ftyue,area-52,2116,shaman,enhancement,112,59,53
Stew,illidan,2114,shaman,enhancement,113,61,52
Doomwìnds,stormrage,2111,shaman,enhancement,144,81,63
Wetdraenei,moon-guard,2102,shaman,enhancement,271,152,119
Lustingchery,area-52,2101,shaman,enhancement,63,41,22
Mítsurí,tichondrius,2093,shaman,enhancement,138,66,72
Veggiess,emerald-dream,2083,shaman,enhancement,300,150,150
Baseballcap,sargeras,2070,shaman,enhancement,96,58,38
Zarktwo,azralon,2066,shaman,enhancement,114,59,55
Shakeys,tichondrius,2032,shaman,enhancement,71,45,26
Musclebrain,tichondrius,2021,shaman,enhancement,138,67,71
Axegerd,quelthalas,2016,shaman,enhancement,129,71,58
Realypump,area-52,2015,shaman,enhancement,78,42,36
Swrdfsh,tichondrius,2004,shaman,enhancement,168,92,76
Zarasvati,tichondrius,2004,shaman,enhancement,119,63,56
Futeuncle,tichondrius,1991,shaman,enhancement,54,28,26
Dano,tichondrius,1981,shaman,enhancement,96,54,42
Crowns,tichondrius,1981,shaman,enhancement,78,36,42
Windshearbøt,tichondrius,1977,shaman,enhancement,71,43,28
Dopeysimida,illidan,1976,shaman,enhancement,92,57,35
Spippippin,illidan,1972,shaman,enhancement,80,42,38
Musclebrains,tichondrius,1969,shaman,enhancement,66,36,30
Zootywild,tichondrius,1963,shaman,enhancement,123,69,54
Proctopus,moon-guard,1958,shaman,enhancement,142,77,65
Imchuckbass,tichondrius,1957,shaman,enhancement,104,55,49
Superchief,altar-of-storms,1954,shaman,enhancement,86,50,36
Musclebrainz,tichondrius,1952,shaman,enhancement,54,26,28
Balgron,emerald-dream,1949,shaman,enhancement,52,26,26
Ohmálley,tichondrius,1944,shaman,enhancement,62,40,22
Shk,illidan,1938,shaman,enhancement,60,36,24
Ogeezkush,zuljin,1935,shaman,enhancement,160,93,67
Rozboiclique,frostmourne,1929,shaman,enhancement,132,89,43
Heisna,stormrage,1920,shaman,enhancement,259,143,116
Smxxn,tichondrius,1913,shaman,enhancement,66,31,35
Eityhdz,tichondrius,1912,shaman,enhancement,401,207,194
Watergirl,thaurissan,1912,shaman,enhancement,128,65,63
Grommi,proudmoore,1907,shaman,enhancement,202,99,103
Temar,sargeras,1905,shaman,enhancement,81,54,27
Scaman,tichondrius,1904,shaman,enhancement,24,20,4
Cowaii,illidan,1904,shaman,enhancement,60,37,23
Rukagar,barthilas,1902,shaman,enhancement,72,42,30
Keyturn,tichondrius,1899,shaman,enhancement,78,36,42
Oosheratchet,illidan,1896,shaman,enhancement,52,36,16
Kushnations,chogall,1896,shaman,enhancement,36,20,16
Tastydonut,blackrock,1893,shaman,enhancement,65,40,25
Jayhastotems,area-52,1890,shaman,enhancement,96,69,27
Olxsixsm,illidan,1884,shaman,enhancement,74,48,26
Bestshamus,sargeras,1883,shaman,enhancement,71,42,29
Gìmli,tichondrius,1882,shaman,enhancement,65,37,28
Earlainn,stormrage,1879,shaman,enhancement,72,41,31
Plsnerfret,stormrage,1876,shaman,enhancement,48,33,15
Stormrageman,tichondrius,1875,shaman,enhancement,81,49,32
Windfury,chogall,1870,shaman,enhancement,66,35,31
Antek,quelthalas,1868,shaman,enhancement,141,86,55
Doomberrie,thrall,1864,shaman,enhancement,102,59,43
Zarrka,tichondrius,1864,shaman,enhancement,36,20,16
Ballinhance,illidan,1858,shaman,enhancement,48,28,20
Wonima,tichondrius,1858,shaman,enhancement,35,20,15
Zanderpla,kelthuzad,1856,shaman,enhancement,72,41,31
Timzero,tichondrius,1855,shaman,enhancement,60,33,27
Lavitris,illidan,1854,shaman,enhancement,42,29,13
Konfuzious,emerald-dream,1849,shaman,enhancement,123,72,51
Norlak,antonidas,1849,shaman,enhancement,60,32,28
Undertów,area-52,1847,shaman,enhancement,48,26,22
Rawdòggin,emerald-dream,1844,shaman,enhancement,42,30,12
Xakaeri,hyjal,1844,shaman,enhancement,60,36,24
Vanhalestorm,frostmourne,1841,shaman,enhancement,58,30,28
Artenior,stormrage,1841,shaman,enhancement,89,44,45
Megalithic,moon-guard,1840,shaman,enhancement,62,44,18
Ishano,area-52,1839,shaman,enhancement,48,23,25
Berxek,tichondrius,1835,shaman,enhancement,48,27,21
Thuntard,bleeding-hollow,1835,shaman,enhancement,66,33,33
Beañ,barthilas,1830,shaman,enhancement,303,153,150
Shamanabuser,illidan,1825,shaman,enhancement,60,27,33
Kiddfurious,kelthuzad,1823,shaman,enhancement,72,36,36
Midwestern,emerald-dream,1822,shaman,enhancement,44,26,18
Blueraccoon,tichondrius,1821,shaman,enhancement,57,35,22
Hooftoface,moon-guard,1821,shaman,enhancement,72,40,32
Gladdorta,azralon,1821,shaman,enhancement,54,30,24
Btruez,tichondrius,1819,shaman,enhancement,63,35,28
Thunderlaw,area-52,1819,shaman,enhancement,82,44,38
Whírlwínd,area-52,1818,shaman,enhancement,30,19,11
Harrypotqueu,zuljin,1817,shaman,enhancement,54,29,25
Léxar,sargeras,1817,shaman,enhancement,72,33,39
Sarthuul,emerald-dream,1814,shaman,enhancement,48,30,18
Thrallas,frostmourne,1814,shaman,enhancement,54,33,21
Boombigshaq,ysera,1813,shaman,enhancement,38,25,13
Louiev,bleeding-hollow,1812,shaman,enhancement,48,28,20
Legendslayar,area-52,1811,shaman,enhancement,42,27,15
Typhe,bleeding-hollow,1811,shaman,enhancement,30,19,11
Nygiants,tichondrius,1810,shaman,enhancement,24,19,5
Xibalba,khaz-modan,1810,shaman,enhancement,96,57,39
Sassyx,steamwheedle-cartel,1810,shaman,enhancement,48,27,21
Iamashaman,malganis,1810,shaman,enhancement,302,154,148
Algresh,muradin,1809,shaman,enhancement,36,19,17
Bikboisteez,barthilas,1808,shaman,enhancement,92,47,45
Shakeysham,tichondrius,1806,shaman,enhancement,24,19,5
Lashandtrash,tichondrius,1806,shaman,enhancement,30,19,11
Garai,emerald-dream,1805,shaman,enhancement,105,55,50
Niuniudada,illidan,1805,shaman,enhancement,84,39,45
Kltz,sargeras,1804,shaman,enhancement,41,23,18
Ëxceeder,ragnaros,1803,shaman,enhancement,78,46,32
Madonion,zuljin,1803,shaman,enhancement,60,31,29
Blakki,barthilas,1801,shaman,enhancement,66,40,26
Turbowolf,sargeras,1800,shaman,enhancement,98,43,55
Landlordxx,area-52,1795,shaman,enhancement,52,32,20
Fwwrs,illidan,1793,shaman,enhancement,37,26,11
Mcshockturds,tichondrius,1791,shaman,enhancement,137,77,60
Cunkinator,stormrage,1787,shaman,enhancement,91,61,30
Turdfergesen,destromath,1787,shaman,enhancement,64,33,31
Wautyriex,area-52,1783,shaman,enhancement,48,23,25
Cammeez,area-52,1781,shaman,enhancement,79,41,38
Krovn,stormrage,1772,shaman,enhancement,60,33,27
Novedz,illidan,1767,shaman,enhancement,62,32,30
Muisor,quelthalas,1763,shaman,enhancement,60,33,27
Biubiuz,tichondrius,1757,shaman,enhancement,96,60,36
Shylabuffkin,area-52,1755,shaman,enhancement,64,35,29
Shearx,illidan,1754,shaman,enhancement,69,41,28
Beaviis,frostmourne,1749,shaman,enhancement,48,29,19
Soshatsumi,tichondrius,1749,shaman,enhancement,76,42,34
Boboyaga,emerald-dream,1748,shaman,enhancement,42,21,21
Kalvishdam,dalaran,1746,shaman,enhancement,36,25,11
Mercó,bleeding-hollow,1741,shaman,enhancement,48,26,22
Metako,sargeras,1737,shaman,enhancement,71,38,33
Electricity,tichondrius,1735,shaman,enhancement,73,31,42
Thromjin,ragnaros,1731,shaman,enhancement,65,39,26
Xaltas,moon-guard,1727,shaman,enhancement,72,46,26
Darkcnight,stormrage,1727,shaman,enhancement,54,31,23
Adalid,thrall,1724,shaman,enhancement,42,31,11
Reflexsivx,malganis,1722,shaman,enhancement,48,29,19
Hallofcost,illidan,1715,shaman,enhancement,54,34,20
Cwippin,proudmoore,1712,shaman,enhancement,134,77,57
Slapnarp,wyrmrest-accord,1710,shaman,enhancement,82,42,40
Nyckysh,illidan,1706,shaman,enhancement,76,41,35
Stewtwo,illidan,1705,shaman,enhancement,39,22,17
Wrathics,emerald-dream,1702,shaman,enhancement,60,32,28
Stormnala,zuljin,1700,shaman,enhancement,41,26,15
Tdlz,tichondrius,1698,shaman,enhancement,62,41,21
Bbshock,stormrage,1698,shaman,enhancement,84,50,34
Halfzugzug,sargeras,1697,shaman,enhancement,30,21,9
Axelsteel,illidan,1697,shaman,enhancement,48,21,27
Bitsuey,frostmourne,1696,shaman,enhancement,84,46,38
Stonetrog,blackrock,1695,shaman,enhancement,24,19,5
Platanos,proudmoore,1694,shaman,enhancement,68,40,28
Xiaoxiaoxi,tichondrius,1694,shaman,enhancement,42,23,19
Miketideson,proudmoore,1693,shaman,enhancement,72,38,34
Hecks,malorne,1692,shaman,enhancement,90,49,41
Zappithorus,stormrage,1691,shaman,enhancement,36,24,12
Sonofabat,spirestone,1689,shaman,enhancement,124,67,57
Shamezee,stormreaver,1689,shaman,enhancement,47,22,25
Plzbuffme,dalaran,1688,shaman,enhancement,54,34,20
Jàro,thrall,1688,shaman,enhancement,42,20,22
Asumo,azralon,1687,shaman,enhancement,63,34,29
Elryl,sargeras,1686,shaman,enhancement,116,64,52
Gorgonash,magtheridon,1684,shaman,enhancement,42,22,20
Durozu,tichondrius,1682,shaman,enhancement,36,18,18
Vortexfury,area-52,1682,shaman,enhancement,42,20,22
Wingshaman,illidan,1680,shaman,enhancement,196,104,92
Geeblast,area-52,1676,shaman,enhancement,53,34,19
Bòómz,stormrage,1674,shaman,enhancement,130,62,68
Jazzlightnin,tichondrius,1670,shaman,enhancement,29,18,11
Pla,tichondrius,1670,shaman,enhancement,144,82,62
Volkuul,zuljin,1669,shaman,enhancement,72,40,32
Synivabyatch,eonar,1668,shaman,enhancement,66,37,29
Onlyshams,dalaran,1666,shaman,enhancement,36,22,14
Bodai,magtheridon,1666,shaman,enhancement,36,21,15
Shocksrus,arthas,1665,shaman,enhancement,42,25,17
Doex,thrall,1662,shaman,enhancement,42,21,21
Tandrian,daggerspine,1662,shaman,enhancement,36,18,18
Dcg,hyjal,1654,shaman,enhancement,47,22,25
Døømsdáy,thrall,1652,shaman,enhancement,90,49,41
Vonvulviln,emerald-dream,1651,shaman,enhancement,41,21,20
Windflex,emerald-dream,1651,shaman,enhancement,85,43,42
Roysoy,stormrage,1648,shaman,enhancement,72,45,27
Shinian,tichondrius,1648,shaman,enhancement,39,23,16
Haishoe,stormrage,1647,shaman,enhancement,52,31,21
Judgeesham,bleeding-hollow,1647,shaman,enhancement,45,23,22
Shapaman,tichondrius,1644,shaman,enhancement,30,22,8
Volsdeep,illidan,1644,shaman,enhancement,52,31,21
Elemores,tichondrius,1642,shaman,enhancement,66,40,26
Loabud,tichondrius,1641,shaman,enhancement,30,18,12
Dalianyen,bladefist,1638,shaman,enhancement,40,19,21
Ràntòn,bleeding-hollow,1637,shaman,enhancement,35,24,11
Seanan,tichondrius,1635,shaman,enhancement,42,28,14
Askpuntee,sargeras,1635,shaman,enhancement,42,25,17
Lavamon,illidan,1631,shaman,enhancement,48,26,22
Orkuss,illidan,1631,shaman,enhancement,48,25,23
Tettnanger,azralon,1630,shaman,enhancement,31,19,12
Slashpity,stormrage,1630,shaman,enhancement,63,33,30
Omaguap,tichondrius,1628,shaman,enhancement,50,29,21
Toobeastly,deathwing,1628,shaman,enhancement,42,24,18
Flabby,lightbringer,1627,shaman,enhancement,36,17,19
Hxzard,stormrage,1626,shaman,enhancement,36,17,19
Stormbash,ragnaros,1626,shaman,enhancement,54,23,31
Åvarice,shattered-halls,1626,shaman,enhancement,54,22,32
Alablast,malganis,1625,shaman,enhancement,36,21,15
Jyupaonaiwa,tichondrius,1625,shaman,enhancement,30,17,13
Shamom,silver-hand,1624,shaman,enhancement,112,64,48
Zapnclap,tichondrius,1623,shaman,enhancement,42,24,18
Smash,fenris,1623,shaman,enhancement,82,42,40
Frëdstorm,kelthuzad,1622,shaman,enhancement,91,45,46
Ironaddictz,kiljaeden,1620,shaman,enhancement,51,30,21
Venmoo,illidan,1620,shaman,enhancement,42,20,22
Ceasebelief,tichondrius,1619,shaman,enhancement,30,21,9
Deyodin,illidan,1619,shaman,enhancement,26,18,8
Shamikazi,crushridge,1617,shaman,enhancement,119,69,50
Shamgawd,illidan,1617,shaman,enhancement,36,20,16
Bjorengahr,emerald-dream,1615,shaman,enhancement,30,20,10
Keeba,wyrmrest-accord,1615,shaman,enhancement,48,27,21
Forksin,tichondrius,1615,shaman,enhancement,48,20,28
Meataballa,the-underbog,1614,shaman,enhancement,24,17,7
Stýlébéñdér,kelthuzad,1613,shaman,enhancement,24,17,7
Yakora,stormrage,1613,shaman,enhancement,36,22,14
Drakhe,proudmoore,1612,shaman,enhancement,110,60,50
Robdaman,tichondrius,1607,shaman,enhancement,24,18,6
Egirlshmu,stormrage,1606,shaman,enhancement,48,28,20
Kindaretro,tichondrius,1605,shaman,enhancement,42,27,15
Totemnikiel,stormrage,1602,shaman,enhancement,84,39,45
Revtide,thrall,1597,shaman,enhancement,30,19,11
Soupi,illidan,1597,shaman,enhancement,66,39,27
Poizele,tichondrius,1594,shaman,enhancement,270,147,123
Aibheit,area-52,1592,shaman,enhancement,24,22,2
Jerykco,drakkari,1591,shaman,enhancement,36,20,16
Nøname,azshara,1591,shaman,enhancement,149,74,75
Tootshock,illidan,1585,shaman,enhancement,42,21,21
Deemmorti,stormrage,1584,shaman,enhancement,46,26,20
Split,zuljin,1581,shaman,enhancement,154,86,68
Anadal,kargath,1580,shaman,enhancement,42,19,23
Zavar,tichondrius,1579,shaman,enhancement,77,40,37
Täcti,tichondrius,1579,shaman,enhancement,60,31,29
Struck,emerald-dream,1576,shaman,enhancement,104,66,38
Harrìson,tichondrius,1575,shaman,enhancement,29,17,12
Gambazzlok,terokkar,1573,shaman,enhancement,42,25,17
Thunda,black-dragonflight,1572,shaman,enhancement,30,21,9
Zeroshocks,kelthuzad,1572,shaman,enhancement,30,19,11
Eliteshamann,tichondrius,1570,shaman,enhancement,42,23,19
Nÿh,quelthalas,1569,shaman,enhancement,48,27,21
Ðr,earthen-ring,1569,shaman,enhancement,104,57,47
Shamanees,area-52,1567,shaman,enhancement,106,52,54
Shmnsm,kiljaeden,1565,shaman,enhancement,42,18,24
Krûde,tichondrius,1564,shaman,enhancement,95,56,39
Uracemytotem,kiljaeden,1562,shaman,enhancement,84,51,33
Armønixx,ragnaros,1562,shaman,enhancement,108,62,46
ßurstmedaddy,bleeding-hollow,1557,shaman,enhancement,36,27,9
Dankthunda,stormrage,1557,shaman,enhancement,114,63,51
Thiccsha,moon-guard,1554,shaman,enhancement,36,17,19
Cayed,stormscale,1553,shaman,enhancement,84,44,40
Eyecandi,barthilas,1553,shaman,enhancement,121,60,61
Dirtyunique,tichondrius,1549,shaman,enhancement,84,49,35
Beaversniper,tichondrius,1549,shaman,enhancement,42,20,22
Shámdemons,area-52,1547,shaman,enhancement,78,46,32
Killavicious,area-52,1547,shaman,enhancement,54,24,30
Speedrush,nagrand,1546,shaman,enhancement,38,25,13
Thilv,ravenholdt,1543,shaman,enhancement,30,19,11
Mindfields,barthilas,1542,shaman,enhancement,73,42,31
Clappadactyl,frostmourne,1542,shaman,enhancement,63,34,29
Heäven,malganis,1539,shaman,enhancement,139,75,64
Grx,tichondrius,1539,shaman,enhancement,41,22,19
Small,alleria,1538,shaman,enhancement,60,32,28
Thewindman,sargeras,1535,shaman,enhancement,48,22,26
Gorillahazed,tichondrius,1535,shaman,enhancement,90,41,49
Anzet,ragnaros,1534,shaman,enhancement,24,16,8
Derzwaz,draka,1532,shaman,enhancement,29,17,12
Shoresy,kaelthas,1531,shaman,enhancement,36,20,16
Khormac,moon-guard,1529,shaman,enhancement,64,43,21
Larrylardazz,tichondrius,1529,shaman,enhancement,85,51,34
Loadiez,frostmourne,1527,shaman,enhancement,30,21,9
Shamwows,dalaran,1524,shaman,enhancement,142,69,73
Hurrikaine,dalaran,1522,shaman,enhancement,80,40,40
Greenydapooh,nerzhul,1515,shaman,enhancement,30,16,14
Bräindëad,hyjal,1514,shaman,enhancement,54,32,22
Wortwort,tichondrius,1514,shaman,enhancement,83,40,43
Clenlift,emerald-dream,1510,shaman,enhancement,102,57,45
Hellamental,malganis,1509,shaman,enhancement,30,16,14
Hehew,kelthuzad,1508,shaman,enhancement,42,26,16
Deshamann,illidan,1507,shaman,enhancement,59,24,35
Tumble,frostmourne,1504,shaman,enhancement,84,46,38
Mixn,frostmourne,1503,shaman,enhancement,75,46,29
Kronkxd,malganis,1501,shaman,enhancement,30,16,14
Smartbunny,illidan,1500,shaman,enhancement,222,108,114
Sinestario,illidan,1497,shaman,enhancement,50,28,22
Elementin,kelthuzad,1495,shaman,enhancement,78,37,41
Justincasé,sargeras,1494,shaman,enhancement,66,31,35
Earthfirex,ragnaros,1493,shaman,enhancement,48,25,23
Hephron,area-52,1493,shaman,enhancement,72,32,40
Quakenbake,emerald-dream,1491,shaman,enhancement,33,20,13
Shockmehard,area-52,1486,shaman,enhancement,59,49,10
Nomoreswap,zuljin,1486,shaman,enhancement,24,16,8
Udb,the-scryers,1486,shaman,enhancement,29,18,11
Taowth,tichondrius,1486,shaman,enhancement,29,16,13
Konga,korialstrasz,1483,shaman,enhancement,38,22,16
Ragnarocck,sargeras,1479,shaman,enhancement,75,36,39
Dashmmy,dalaran,1478,shaman,enhancement,54,26,28
Zugzugenh,stormrage,1475,shaman,enhancement,36,18,18
Atthegates,illidan,1472,shaman,enhancement,90,37,53
Arlikai,arthas,1470,shaman,enhancement,59,20,39
Makocc,tichondrius,1469,shaman,enhancement,62,28,34
Lakindrentv,gorefiend,1467,shaman,enhancement,30,17,13
Skyzik,area-52,1465,shaman,enhancement,54,34,20
Woof,agamaggan,1464,shaman,enhancement,30,16,14
Earthlsflat,tichondrius,1463,shaman,enhancement,31,21,10
Daddyzap,stormrage,1462,shaman,enhancement,104,58,46
Lyrzsa,blackwing-lair,1461,shaman,enhancement,44,27,17
Flirstatic,nemesis,1459,shaman,enhancement,97,52,45
Amasaei,bleeding-hollow,1453,shaman,enhancement,54,26,28
Somebozo,darkspear,1453,shaman,enhancement,72,32,40
Goribash,wyrmrest-accord,1449,shaman,enhancement,42,26,16
Sndhlp,tichondrius,1446,shaman,enhancement,28,20,8
Calich,kelthuzad,1445,shaman,enhancement,38,23,15
Zmogon,quelthalas,1445,shaman,enhancement,32,16,16
Stubbywayne,area-52,1445,shaman,enhancement,112,54,58
Lavabone,dalaran,1443,shaman,enhancement,54,21,33
Rexoss,hyjal,1442,shaman,enhancement,117,60,57
Tamtam,gorefiend,1438,shaman,enhancement,24,15,9
Gaelfury,malganis,1436,shaman,enhancement,42,22,20
Qvibin,tichondrius,1435,shaman,enhancement,30,21,9
Scrötotem,saurfang,1435,shaman,enhancement,71,40,31
Däbü,tichondrius,1435,shaman,enhancement,30,15,15
Friednocap,kelthuzad,1435,shaman,enhancement,48,21,27
Rojhaz,stormrage,1433,shaman,enhancement,42,25,17
Maribain,barthilas,1432,shaman,enhancement,60,37,23
Whydead,sargeras,1431,shaman,enhancement,72,40,32
Riptiedx,barthilas,1430,shaman,enhancement,24,15,9
Earfshock,thrall,1428,shaman,enhancement,74,41,33
Iamurfather,magtheridon,1427,shaman,enhancement,89,45,44
Convolutedx,tichondrius,1427,shaman,enhancement,30,15,15
Ventus,thrall,1427,shaman,enhancement,54,25,29
Teeroll,frostmourne,1426,shaman,enhancement,36,22,14
Cowely,madoran,1423,shaman,enhancement,30,17,13
Rokogg,thrall,1422,shaman,enhancement,121,68,53
Raazzasham,moon-guard,1422,shaman,enhancement,65,34,31
Silyshamshyt,stormrage,1421,shaman,enhancement,24,15,9
Neyavv,tichondrius,1418,shaman,enhancement,40,20,20
Mackandal,tichondrius,1417,shaman,enhancement,80,39,41
Tyven,tichondrius,1415,shaman,enhancement,42,17,25
Mudroller,moon-guard,1414,shaman,enhancement,52,24,28
Lavawreckage,malganis,1412,shaman,enhancement,48,25,23
Dimitrio,azralon,1409,shaman,enhancement,42,18,24
Fhenh,proudmoore,1408,shaman,enhancement,64,35,29
Getacho,stormrage,1407,shaman,enhancement,102,46,56
Nankdug,tichondrius,1405,shaman,enhancement,45,24,21
Tizzl,kelthuzad,1403,shaman,enhancement,30,17,13
Surtel,tichondrius,1401,shaman,enhancement,66,28,38
Djasura,blackhand,1400,shaman,enhancement,47,25,22
Shabenn,proudmoore,1400,shaman,enhancement,48,18,30
Zzar,daggerspine,1398,shaman,enhancement,36,20,16
Scrototëm,azralon,1398,shaman,enhancement,57,27,30
Djelemental,darkspear,1394,shaman,enhancement,27,17,10
Shamann,azshara,1393,shaman,enhancement,57,29,28
Stickysham,illidan,1391,shaman,enhancement,30,20,10
Shipmatekev,sargeras,1386,shaman,enhancement,54,29,25
Zktz,warsong,1385,shaman,enhancement,31,17,14
Rbmx,frostmourne,1384,shaman,enhancement,70,41,29
Abigdude,frostmourne,1384,shaman,enhancement,47,24,23
Lazugga,area-52,1378,shaman,enhancement,80,42,38
Tyzek,illidan,1375,shaman,enhancement,42,26,16
Gettatotem,frostmourne,1373,shaman,enhancement,30,17,13
Shamrockcawk,malganis,1372,shaman,enhancement,30,21,9
Raylord,ragnaros,1364,shaman,enhancement,83,46,37
Montí,moon-guard,1361,shaman,enhancement,83,51,32
Grohltusk,barthilas,1360,shaman,enhancement,42,24,18
Borwald,dalaran,1359,shaman,enhancement,90,45,45
Johnwilke,area-52,1356,shaman,enhancement,119,59,60
Hagass,tichondrius,1354,shaman,enhancement,55,26,29
Isbabani,moon-guard,1353,shaman,enhancement,30,16,14
Argrax,sargeras,1350,shaman,enhancement,36,24,12
Chalked,stormrage,1348,shaman,enhancement,93,46,47
Orcshamen,tichondrius,1347,shaman,enhancement,42,24,18
Mybadshawty,tichondrius,1347,shaman,enhancement,72,32,40
Drumman,skullcrusher,1346,shaman,enhancement,70,39,31
Pockethealer,emerald-dream,1344,shaman,enhancement,108,54,54
Xiaoxiboy,tichondrius,1342,shaman,enhancement,18,14,4
Keyturns,tichondrius,1342,shaman,enhancement,18,14,4
Dugomik,malganis,1342,shaman,enhancement,77,39,38
Tsaheylu,barthilas,1342,shaman,enhancement,48,22,26
Kaediea,moon-guard,1341,shaman,enhancement,18,14,4
Rngena,trollbane,1341,shaman,enhancement,24,14,10
Dashinra,stormrage,1341,shaman,enhancement,26,15,11
Clumpen,thunderhorn,1341,shaman,enhancement,29,16,13
Crøwgød,tichondrius,1340,shaman,enhancement,24,14,10
Trashfarmer,tichondrius,1340,shaman,enhancement,78,35,43
Stormgraves,moon-guard,1337,shaman,enhancement,24,14,10
Thromir,blackwing-lair,1333,shaman,enhancement,30,17,13
Tkarfuno,exodar,1333,shaman,enhancement,30,14,16
Aldinatir,ragnaros,1332,shaman,enhancement,24,14,10
Clownshòes,tichondrius,1328,shaman,enhancement,30,17,13
Psilocypher,nazjatar,1327,shaman,enhancement,26,19,7
Leschaises,skullcrusher,1325,shaman,enhancement,27,18,9
Firevag,hakkar,1321,shaman,enhancement,72,38,34
Bessame,sargeras,1320,shaman,enhancement,82,41,41
Shamorrhoids,frostmourne,1311,shaman,enhancement,118,62,56
Harvesting,azralon,1311,shaman,enhancement,30,14,16
Prymalfury,illidan,1311,shaman,enhancement,84,37,47
Díesel,azralon,1306,shaman,enhancement,29,14,15
Obeilius,illidan,1303,shaman,enhancement,49,25,24
Lüca,wyrmrest-accord,1303,shaman,enhancement,130,65,65
Whichdoctah,proudmoore,1302,shaman,enhancement,30,14,16
Blasho,ragnaros,1302,shaman,enhancement,48,19,29
Atroll,moonrunner,1300,shaman,enhancement,48,20,28
Rongkhan,tichondrius,1296,shaman,enhancement,35,20,15
Vapus,area-52,1294,shaman,enhancement,89,47,42
Cbomberz,tichondrius,1294,shaman,enhancement,37,18,19
Murlook,sargeras,1292,shaman,enhancement,58,37,21
Fyahchaming,drakkari,1288,shaman,enhancement,34,19,15
Jackofstorms,veknilash,1285,shaman,enhancement,56,25,31
Baloneyfiveo,kiljaeden,1284,shaman,enhancement,32,17,15
Stormwolf,emerald-dream,1284,shaman,enhancement,36,18,18
Mairn,tichondrius,1282,shaman,enhancement,42,20,22
Piffenstien,malganis,1282,shaman,enhancement,54,25,29
Deathjoker,icecrown,1279,shaman,enhancement,48,26,22
Peynful,shadowsong,1277,shaman,enhancement,23,14,9
Zechary,proudmoore,1273,shaman,enhancement,54,33,21
Jäyp,thrall,1270,shaman,enhancement,30,14,16
Popsmoke,gnomeregan,1265,shaman,enhancement,23,14,9
Datblueboi,dalaran,1263,shaman,enhancement,76,39,37
Gorebog,feathermoon,1259,shaman,enhancement,42,23,19
Obrahma,burning-legion,1258,shaman,enhancement,24,16,8
Taò,tichondrius,1254,shaman,enhancement,75,37,38
Holosoul,bleeding-hollow,1254,shaman,enhancement,67,27,40
Ryuuraix,area-52,1245,shaman,enhancement,21,14,7
Mobi,tichondrius,1243,shaman,enhancement,24,13,11
Lenin,nathrezim,1242,shaman,enhancement,18,13,5
Dalthragoz,tichondrius,1239,shaman,enhancement,24,13,11
Dalsun,turalyon,1237,shaman,enhancement,30,13,17
Furrybâstard,wyrmrest-accord,1235,shaman,enhancement,24,13,11
Githealed,kelthuzad,1234,shaman,enhancement,27,15,12
Vozs,proudmoore,1233,shaman,enhancement,60,34,26
Willy,icecrown,1230,shaman,enhancement,23,13,10
Magmao,quelthalas,1228,shaman,enhancement,38,22,16
Lamagra,nemesis,1227,shaman,enhancement,18,13,5
Kasukaga,shadowmoon,1227,shaman,enhancement,54,23,31
Uglykunt,barthilas,1224,shaman,enhancement,111,62,49
Netherfury,illidan,1224,shaman,enhancement,51,28,23
Totesmagotes,scilla,1223,shaman,enhancement,18,13,5
Shamantwo,windrunner,1223,shaman,enhancement,24,13,11
Kohatan,moon-guard,1220,shaman,enhancement,28,14,14
Mullten,sargeras,1219,shaman,enhancement,36,15,21
Kamíhameha,stormrage,1218,shaman,enhancement,44,20,24
Zheúz,azralon,1218,shaman,enhancement,32,14,18
Onezap,trollbane,1214,shaman,enhancement,43,17,26
Hammeredd,hyjal,1212,shaman,enhancement,36,18,18
Slowgrath,burning-legion,1202,shaman,enhancement,33,19,14
Sinsar,illidan,1200,shaman,enhancement,35,13,22
Trenbolone,maiev,1194,shaman,enhancement,48,26,22
Killbro,blackrock,1194,shaman,enhancement,62,24,38
Spiderjohn,sargeras,1189,shaman,enhancement,30,18,12
Gdiafplox,thunderhorn,1186,shaman,enhancement,54,27,27
Lightnessx,stormrage,1185,shaman,enhancement,36,13,23
Djshammy,barthilas,1183,shaman,enhancement,28,15,13
Àspec,aegwynn,1182,shaman,enhancement,16,13,3
Enhancementz,azralon,1174,shaman,enhancement,68,37,31
Mëister,stormrage,1170,shaman,enhancement,47,18,29
Finnaburstt,tichondrius,1162,shaman,enhancement,54,29,25
Parallels,blackrock,1161,shaman,enhancement,45,16,29
Camdoc,destromath,1156,shaman,enhancement,41,19,22
Robis,thrall,1156,shaman,enhancement,84,38,46
Splendapapi,stormrage,1155,shaman,enhancement,38,13,25
Gangmember,shadowmoon,1152,shaman,enhancement,18,12,6
Crownsx,tichondrius,1152,shaman,enhancement,24,12,12
Jinxicle,illidan,1151,shaman,enhancement,18,12,6
Shamcowhah,frostmourne,1151,shaman,enhancement,18,12,6
Lutheran,dragonmaw,1151,shaman,enhancement,35,14,21
Nyknicks,tichondrius,1150,shaman,enhancement,18,12,6
Hanhze,quelthalas,1150,shaman,enhancement,30,18,12
Dialtone,blackrock,1150,shaman,enhancement,30,12,18
Rainjig,emerald-dream,1149,shaman,enhancement,21,12,9
Olíndo,tichondrius,1146,shaman,enhancement,18,12,6
Seltheran,tichondrius,1146,shaman,enhancement,18,12,6
Saraguthix,dalaran,1141,shaman,enhancement,18,12,6
Fourstorms,gundrak,1141,shaman,enhancement,37,19,18
Extraguacpls,tichondrius,1139,shaman,enhancement,18,12,6
Wagar,dawnbringer,1139,shaman,enhancement,30,12,18
Sydstorm,frostmourne,1137,shaman,enhancement,18,12,6
Popz,dark-iron,1128,shaman,enhancement,18,12,6
ßøn,altar-of-storms,1125,shaman,enhancement,33,16,17
Astroglyde,emerald-dream,1123,shaman,enhancement,24,12,12
Chapope,quelthalas,1120,shaman,enhancement,22,14,8
Shøxic,perenolde,1118,shaman,enhancement,18,12,6
Drokron,azralon,1118,shaman,enhancement,36,17,19
Catiçero,azralon,1117,shaman,enhancement,30,12,18
Schlemiel,barthilas,1112,shaman,enhancement,82,36,46
Cseril,bonechewer,1111,shaman,enhancement,71,41,30
Lassoway,illidan,1110,shaman,enhancement,30,12,18
Synshenrongt,thrall,1109,shaman,enhancement,166,68,98
Lilpump,boulderfist,1106,shaman,enhancement,26,13,13
Shaminism,chromaggus,1103,shaman,enhancement,23,12,11
Groundfaults,bleeding-hollow,1103,shaman,enhancement,29,12,17
Ashida,stormrage,1086,shaman,enhancement,26,14,12
Nîghtstalker,vashj,1081,shaman,enhancement,52,20,32
Svddëndëath,sargeras,1079,shaman,enhancement,60,22,38
Valkriie,tichondrius,1072,shaman,enhancement,19,12,7
Shamgødx,dalaran,1056,shaman,enhancement,12,11,1
Gamergirlx,area-52,1056,shaman,enhancement,18,11,7
Gatorwaves,bleeding-hollow,1056,shaman,enhancement,18,11,7
Pedaphil,frostmourne,1056,shaman,enhancement,18,11,7
Dä,tichondrius,1056,shaman,enhancement,24,11,13
Shamawolf,stormrage,1055,shaman,enhancement,12,11,1
Leaning,wyrmrest-accord,1055,shaman,enhancement,18,11,7
Shampowl,jaedenar,1055,shaman,enhancement,30,11,19
Möuthbläster,malganis,1054,shaman,enhancement,12,11,1
Syraak,elune,1054,shaman,enhancement,15,12,3
Rtÿo,area-52,1054,shaman,enhancement,18,11,7
Balldo,stormrage,1054,shaman,enhancement,30,11,19
Buffdudé,illidan,1052,shaman,enhancement,24,11,13
Peepingtotem,tichondrius,1052,shaman,enhancement,24,11,13
Faminex,dragonmaw,1051,shaman,enhancement,12,11,1
Elementalïst,durotan,1051,shaman,enhancement,18,11,7
Kungfuvoodoo,tichondrius,1050,shaman,enhancement,18,11,7
Dronesum,tichondrius,1050,shaman,enhancement,24,11,13
Totegoat,nazjatar,1050,shaman,enhancement,30,11,19
Scams,bleeding-hollow,1049,shaman,enhancement,30,18,12
Vöödooranger,stormrage,1048,shaman,enhancement,18,11,7
Eze,tichondrius,1047,shaman,enhancement,19,12,7
Sparkqt,sargeras,1047,shaman,enhancement,18,11,7
Hazak,nemesis,1047,shaman,enhancement,42,19,23
Johnnygeh,stormrage,1047,shaman,enhancement,30,11,19
Stormwolf,azjolnerub,1045,shaman,enhancement,36,20,16
Jamblee,sargeras,1043,shaman,enhancement,18,11,7
Jyster,area-52,1043,shaman,enhancement,48,18,30
Sigir,darrowmere,1042,shaman,enhancement,24,11,13
Trulos,stormrage,1041,shaman,enhancement,18,11,7
Bobaflexqt,korgath,1039,shaman,enhancement,18,11,7
Hannibol,tichondrius,1036,shaman,enhancement,72,25,47
Allmeatie,hyjal,1035,shaman,enhancement,18,11,7
Zalkran,area-52,1034,shaman,enhancement,24,15,9
Lovetides,area-52,1031,shaman,enhancement,24,14,10
Sevare,area-52,1023,shaman,enhancement,21,12,9
Tøtëm,tichondrius,1021,shaman,enhancement,28,12,16
Raxabico,nemesis,1017,shaman,enhancement,32,12,20
Pùffball,anvilmar,1011,shaman,enhancement,57,29,28
Tukkutz,moon-guard,1006,shaman,enhancement,27,12,15
Dedlystorm,dalaran,1003,shaman,enhancement,18,12,6
Hoodfigga,tichondrius,1002,shaman,enhancement,23,11,12
Bigbólts,emerald-dream,1001,shaman,enhancement,18,12,6
Stroheim,warsong,1000,shaman,enhancement,21,12,9
Poseidonxd,lightbringer,1000,shaman,enhancement,23,13,10
Slaughterdog,coilfang,995,shaman,enhancement,22,13,9
Prinkipíssa,tichondrius,994,shaman,enhancement,36,16,20
Pwnôgraphy,kelthuzad,989,shaman,enhancement,14,11,3
Deckìn,proudmoore,987,shaman,enhancement,14,11,3
Shomani,madoran,983,shaman,enhancement,29,11,18
Shammybreakx,malganis,971,shaman,enhancement,35,20,15
Ctrlaltelite,burning-blade,971,shaman,enhancement,36,11,25
Freyía,illidan,960,shaman,enhancement,12,10,2
Futeboy,tichondrius,960,shaman,enhancement,18,10,8
Enhance,sargeras,960,shaman,enhancement,18,10,8
Mcb,barthilas,960,shaman,enhancement,18,10,8
Beanerburst,frostwolf,960,shaman,enhancement,24,11,13
Zatchbell,lightnings-blade,960,shaman,enhancement,30,13,17
Lokrath,zangarmarsh,959,shaman,enhancement,12,10,2
Pikachil,tichondrius,959,shaman,enhancement,15,11,4
Vonnsmallpp,area-52,959,shaman,enhancement,18,10,8
Kumboi,frostmourne,959,shaman,enhancement,24,10,14
Unezx,tichondrius,958,shaman,enhancement,12,10,2
Marginalized,tichondrius,958,shaman,enhancement,18,10,8
Ggsggs,akama,958,shaman,enhancement,18,10,8
Leotis,tichondrius,957,shaman,enhancement,18,10,8
Kandin,icecrown,957,shaman,enhancement,24,10,14
Keroh,blackrock,956,shaman,enhancement,18,10,8
Súrtr,sargeras,955,shaman,enhancement,18,10,8
Aelpian,emerald-dream,954,shaman,enhancement,18,10,8
Ryntyntyn,blood-furnace,954,shaman,enhancement,24,10,14
Beardcramps,tichondrius,954,shaman,enhancement,30,10,20
Pumpz,magtheridon,953,shaman,enhancement,24,10,14
Fireclaws,bleeding-hollow,952,shaman,enhancement,18,10,8
Bloodytotemz,emerald-dream,944,shaman,enhancement,18,10,8
Iamegirl,moon-guard,935,shaman,enhancement,23,10,13
Hordeymaori,jubeithos,929,shaman,enhancement,80,38,42
Çhïcagø,aegwynn,928,shaman,enhancement,28,10,18
Thanwirn,ragnaros,924,shaman,enhancement,30,13,17
Wälee,sargeras,921,shaman,enhancement,18,10,8
Gammacide,sargeras,921,shaman,enhancement,29,10,19
Oct,thrall,912,shaman,enhancement,36,18,18
Grimlên,skullcrusher,910,shaman,enhancement,32,12,20
Wigwog,hyjal,901,shaman,enhancement,18,10,8
Interruptbøt,tichondrius,895,shaman,enhancement,11,10,1
Ongruge,hyjal,895,shaman,enhancement,60,22,38
Orfelix,nemesis,889,shaman,enhancement,30,11,19
ßlessedx,tichondrius,875,shaman,enhancement,17,10,7
Nibrax,moknathal,864,shaman,enhancement,12,9,3
Solbis,tichondrius,864,shaman,enhancement,12,9,3
Blackenergy,stormrage,864,shaman,enhancement,12,9,3
Deixw,tichondrius,864,shaman,enhancement,12,9,3
Raídyn,sargeras,864,shaman,enhancement,12,9,3
Cyclrin,sargeras,864,shaman,enhancement,12,9,3
Lickerman,stormreaver,863,shaman,enhancement,12,9,3
Ephraalin,frostmourne,863,shaman,enhancement,18,9,9
Chaac,firetree,863,shaman,enhancement,18,9,9
Rubious,cenarius,863,shaman,enhancement,19,9,10
Okkoto,malfurion,862,shaman,enhancement,12,9,3
Ginjij,thrall,862,shaman,enhancement,18,9,9
Îvôry,bloodhoof,862,shaman,enhancement,18,9,9
Tigtotem,malganis,861,shaman,enhancement,12,9,3
Gorgrom,thunderlord,861,shaman,enhancement,12,9,3
Canabal,eonar,861,shaman,enhancement,18,9,9
Dilfmaster,tichondrius,861,shaman,enhancement,21,10,11
Forgediniron,stormrage,859,shaman,enhancement,18,9,9
Rikswordfire,wyrmrest-accord,859,shaman,enhancement,23,9,14
Hazorele,nagrand,857,shaman,enhancement,18,9,9
Bilbobaggenz,sargeras,854,shaman,enhancement,18,9,9
Windfuryshm,emerald-dream,853,shaman,enhancement,18,9,9
Pingatronx,ragnaros,849,shaman,enhancement,19,12,7
Shayymann,exodar,843,shaman,enhancement,24,9,15
Googurt,barthilas,831,shaman,enhancement,17,9,8
Taowth,area-52,831,shaman,enhancement,29,9,20
Britisy,stormrage,825,shaman,enhancement,24,10,14
Yâmz,area-52,813,shaman,enhancement,21,10,11
Poagrious,bonechewer,804,shaman,enhancement,34,11,23
Thorael,borean-tundra,798,shaman,enhancement,11,9,2
Totemclass,bleeding-hollow,768,shaman,enhancement,12,8,4
Ennoku,khadgar,768,shaman,enhancement,12,8,4
Plznostepmom,tichondrius,768,shaman,enhancement,12,8,4
Chillpoppin,emerald-dream,768,shaman,enhancement,12,8,4
Clasm,tichondrius,768,shaman,enhancement,12,8,4
Cinderfury,magtheridon,768,shaman,enhancement,12,8,4
Onamakawash,black-dragonflight,768,shaman,enhancement,12,8,4
Mobiediqônú,skywall,768,shaman,enhancement,12,8,4
Arázi,wyrmrest-accord,768,shaman,enhancement,18,8,10
Pinechanga,ragnaros,768,shaman,enhancement,18,8,10
Sethbrogen,vashj,768,shaman,enhancement,18,8,10
Napski,cenarius,768,shaman,enhancement,24,8,16
Tyranitaur,frostmourne,768,shaman,enhancement,24,8,16
Faultline,khadgar,767,shaman,enhancement,12,8,4
Elevatezxo,stormrage,767,shaman,enhancement,12,8,4
Volrog,magtheridon,767,shaman,enhancement,18,8,10
Garabashi,boulderfist,767,shaman,enhancement,18,8,10
Cuban,kelthuzad,767,shaman,enhancement,18,8,10
Niteshammy,lothar,767,shaman,enhancement,18,8,10
Finaplex,spirestone,767,shaman,enhancement,18,8,10
Reptimus,sargeras,767,shaman,enhancement,24,8,16
Vekku,ragnaros,766,shaman,enhancement,12,8,4
Chamxz,ragnaros,766,shaman,enhancement,12,8,4
Mcgraff,frostmourne,766,shaman,enhancement,12,8,4
Adhdeeznuts,frostmourne,766,shaman,enhancement,18,8,10
Shometrin,tichondrius,766,shaman,enhancement,18,8,10
Triní,ragnaros,761,shaman,enhancement,18,8,10
Orendail,jubeithos,758,shaman,enhancement,24,8,16
Shimshak,destromath,756,shaman,enhancement,18,8,10
Kumu,stormscale,735,shaman,enhancement,11,8,3
Ryb,sargeras,735,shaman,enhancement,14,9,5
Radan,kelthuzad,735,shaman,enhancement,17,8,9
Dàfèng,wyrmrest-accord,719,shaman,enhancement,23,8,15
Blackshami,quelthalas,718,shaman,enhancement,18,8,10
Pwnskillz,area-52,712,shaman,enhancement,17,8,9
Shamvandám,kiljaeden,710,shaman,enhancement,24,10,14
Hammerdog,illidan,703,shaman,enhancement,16,8,8
Grìmlock,lightbringer,687,shaman,enhancement,13,8,5
Battleimp,kelthuzad,672,shaman,enhancement,12,7,5
Døømwinds,tichondrius,672,shaman,enhancement,12,7,5
Flukz,nazjatar,672,shaman,enhancement,12,7,5
Eimear,kelthuzad,672,shaman,enhancement,12,7,5
Overpowered,korgath,672,shaman,enhancement,12,7,5
Enhance,bleeding-hollow,672,shaman,enhancement,12,7,5
Lividelement,area-52,672,shaman,enhancement,12,7,5
Mattzander,kiljaeden,672,shaman,enhancement,12,7,5
Jofstrom,tichondrius,672,shaman,enhancement,12,7,5
Asy,tichondrius,672,shaman,enhancement,12,7,5
Vlal,tichondrius,672,shaman,enhancement,12,7,5
Goondruka,area-52,672,shaman,enhancement,12,7,5
Shockshack,illidan,672,shaman,enhancement,12,7,5
Yaytotems,sargeras,672,shaman,enhancement,12,7,5
Shokaria,frostwolf,672,shaman,enhancement,17,8,9
Stronghit,tichondrius,672,shaman,enhancement,18,7,11
Kidkovid,illidan,672,shaman,enhancement,18,7,11
Raywhiter,tichondrius,672,shaman,enhancement,22,8,14
Hexondabeach,barthilas,671,shaman,enhancement,12,7,5
Shomminn,tichondrius,671,shaman,enhancement,12,7,5
Murm,burning-blade,671,shaman,enhancement,12,7,5
Ayahuaska,darkspear,671,shaman,enhancement,12,7,5
Checkmâte,emerald-dream,671,shaman,enhancement,12,7,5
Nondracil,ragnaros,671,shaman,enhancement,18,7,11
Gwyste,moon-guard,671,shaman,enhancement,18,7,11
Hrotah,wyrmrest-accord,671,shaman,enhancement,18,7,11
Naesala,thunderlord,671,shaman,enhancement,18,7,11
Enhancee,bonechewer,671,shaman,enhancement,18,7,11
Zald,shattered-halls,671,shaman,enhancement,18,7,11
Velekar,moon-guard,671,shaman,enhancement,21,8,13
Radiology,garithos,670,shaman,enhancement,12,7,5
Morehammeerr,thunderlord,670,shaman,enhancement,12,7,5
Drewshammy,zuljin,670,shaman,enhancement,12,7,5
Kigorami,nerzhul,670,shaman,enhancement,18,7,11
Orcgirth,kiljaeden,670,shaman,enhancement,21,8,13
Bhaelfury,moon-guard,669,shaman,enhancement,12,7,5
Halajo,thrall,669,shaman,enhancement,15,8,7
Vladd,hellscream,669,shaman,enhancement,18,7,11
Helljumper,illidan,669,shaman,enhancement,21,8,13
Blaçktide,thrall,665,shaman,enhancement,12,7,5
Facebooksux,sargeras,657,shaman,enhancement,12,7,5
Shammich,vashj,655,shaman,enhancement,11,7,4
Speedmonster,hellscream,655,shaman,enhancement,19,8,11
Darshidarsh,emerald-dream,640,shaman,enhancement,16,7,9
Relyts,tichondrius,638,shaman,enhancement,18,9,9
Xapoxy,nemesis,636,shaman,enhancement,14,8,6
Rhagnar,warsong,623,shaman,enhancement,11,7,4
Intress,moon-guard,607,shaman,enhancement,10,7,3
Shockolatte,sargeras,607,shaman,enhancement,11,7,4
Eanne,moon-guard,592,shaman,enhancement,19,7,12
Ftierspec,frostmourne,576,shaman,enhancement,6,6,0
Eletastic,tichondrius,576,shaman,enhancement,6,6,0
Ambevsulfr,deathwing,576,shaman,enhancement,6,6,0
Vuduü,stormrage,576,shaman,enhancement,6,6,0
Pikoom,tichondrius,576,shaman,enhancement,6,6,0
Kyzen,tichondrius,576,shaman,enhancement,12,6,6
Stoneseed,steamwheedle-cartel,576,shaman,enhancement,12,6,6
Uggoluga,dalaran,576,shaman,enhancement,12,6,6
ßigðåddy,ghostlands,576,shaman,enhancement,12,6,6
Agpx,tichondrius,576,shaman,enhancement,12,6,6
Owtyobwol,area-52,576,shaman,enhancement,12,6,6
Enhpower,area-52,576,shaman,enhancement,12,6,6
Lindsanx,illidan,576,shaman,enhancement,12,6,6
Crucybletv,korgath,576,shaman,enhancement,12,6,6
Stormdancer,elune,576,shaman,enhancement,12,6,6
Fischerman,barthilas,576,shaman,enhancement,12,6,6
Strønklesøn,drakthul,576,shaman,enhancement,12,6,6
Scarlo,bleeding-hollow,576,shaman,enhancement,12,6,6
Måståçåstå,bleeding-hollow,576,shaman,enhancement,12,6,6
Kêtchpup,wyrmrest-accord,576,shaman,enhancement,12,6,6
Gódsgíft,tichondrius,576,shaman,enhancement,12,6,6
Grippysockz,dalaran,576,shaman,enhancement,12,6,6
Groovesh,thrall,576,shaman,enhancement,14,6,8
Pipers,frostmourne,576,shaman,enhancement,18,6,12
Ferdashock,tichondrius,576,shaman,enhancement,18,6,12
Gluestick,shadowmoon,576,shaman,enhancement,18,6,12
Enhancex,frostwolf,576,shaman,enhancement,18,6,12
Gingeroo,stonemaul,575,shaman,enhancement,12,6,6
Eternalife,khazgoroth,575,shaman,enhancement,12,6,6
Somethingdop,sargeras,575,shaman,enhancement,12,6,6
Fevolution,dreadmaul,575,shaman,enhancement,12,6,6
Naextramus,ragnaros,575,shaman,enhancement,12,6,6
Argues,tichondrius,575,shaman,enhancement,12,6,6
Oaktar,bleeding-hollow,575,shaman,enhancement,12,6,6
Nuofu,illidan,575,shaman,enhancement,16,7,9
Gundar,chogall,575,shaman,enhancement,18,6,12
Flaméy,stormrage,575,shaman,enhancement,18,6,12
Zeebouzy,illidan,575,shaman,enhancement,18,6,12
Talfur,area-52,575,shaman,enhancement,18,6,12
Møp,spirestone,575,shaman,enhancement,18,6,12
Golkork,quelthalas,574,shaman,enhancement,12,6,6
Esko,magtheridon,574,shaman,enhancement,18,6,12
Størmbreäker,tichondrius,572,shaman,enhancement,12,6,6
Hazreti,zuljin,572,shaman,enhancement,18,6,12
Charr,nemesis,571,shaman,enhancement,12,6,6
Fadesrp,moon-guard,571,shaman,enhancement,12,6,6
Karlpoppa,thunderhorn,571,shaman,enhancement,12,6,6
Ðg,tichondrius,569,shaman,enhancement,18,6,12
Maxsimiliano,emerald-dream,559,shaman,enhancement,18,6,12
Noveske,arthas,522,shaman,enhancement,15,7,8
Monadazs,ragnaros,511,shaman,enhancement,8,6,2
Zaxibow,area-52,496,shaman,enhancement,19,6,13
Fiercegoblin,drakkari,493,shaman,enhancement,19,6,13
Nakamora,tichondrius,480,shaman,enhancement,6,5,1
Daysub,crushridge,480,shaman,enhancement,6,5,1
Tactíc,chromaggus,480,shaman,enhancement,6,5,1
Badshock,tichondrius,480,shaman,enhancement,6,5,1
Bofah,draktharon,480,shaman,enhancement,6,5,1
Rokudo,dragonmaw,480,shaman,enhancement,6,5,1
Iava,dalaran,480,shaman,enhancement,6,5,1
Zappiiboii,malganis,480,shaman,enhancement,6,5,1
Krunggar,azralon,480,shaman,enhancement,6,5,1
Beatmán,blades-edge,480,shaman,enhancement,6,5,1
Nekorii,bleeding-hollow,480,shaman,enhancement,6,5,1
Mynigabob,zuljin,480,shaman,enhancement,6,5,1
Dörnèr,malganis,480,shaman,enhancement,6,5,1
Matzahmeal,skywall,480,shaman,enhancement,12,5,7
Zèus,draka,480,shaman,enhancement,12,5,7
Spencesham,sargeras,480,shaman,enhancement,12,5,7
Sleepysham,anubarak,480,shaman,enhancement,12,5,7
Capivarãão,stormrage,480,shaman,enhancement,12,5,7
Tiostroke,stormrage,480,shaman,enhancement,12,5,7
Indaka,kiljaeden,480,shaman,enhancement,12,5,7
Hroth,tanaris,480,shaman,enhancement,12,5,7
Macumbolo,nemesis,480,shaman,enhancement,12,5,7
Kultirio,quelthalas,480,shaman,enhancement,12,5,7
Scrototæm,area-52,480,shaman,enhancement,12,5,7
Earthclap,tichondrius,480,shaman,enhancement,12,5,7
Stankydad,tichondrius,480,shaman,enhancement,12,5,7
Electrikz,moonrunner,480,shaman,enhancement,12,5,7
Meatlog,dalaran,480,shaman,enhancement,12,5,7
Loliqueenfae,illidan,480,shaman,enhancement,12,5,7
Azzula,tichondrius,480,shaman,enhancement,13,5,8
Kushgodd,kiljaeden,480,shaman,enhancement,18,5,13
Gyokuken,stormrage,480,shaman,enhancement,18,5,13
Fíren,area-52,480,shaman,enhancement,18,5,13
Tugnar,ragnaros,479,shaman,enhancement,12,5,7
Denki,nesingwary,479,shaman,enhancement,12,5,7
Dushkanar,barthilas,479,shaman,enhancement,12,5,7
Aegaeonlol,tichondrius,479,shaman,enhancement,18,5,13
Shamgoddam,illidan,479,shaman,enhancement,18,5,13
Brorogan,aerie-peak,478,shaman,enhancement,12,5,7
Enkkiz,ragnaros,477,shaman,enhancement,12,5,7
Curtrex,amanthul,431,shaman,enhancement,11,5,6
Flamestrife,illidan,426,shaman,enhancement,28,8,20
Ezzroz,guldan,384,shaman,enhancement,6,4,2
Sorgal,area-52,384,shaman,enhancement,6,4,2
Slurslinger,area-52,384,shaman,enhancement,6,4,2
Utilitytotem,moon-guard,384,shaman,enhancement,6,4,2
Aureal,malganis,384,shaman,enhancement,6,4,2
Shalkahn,malganis,384,shaman,enhancement,6,4,2
Kylani,thrall,384,shaman,enhancement,6,4,2
Hruggol,bleeding-hollow,384,shaman,enhancement,6,4,2
Angrytotems,ragnaros,384,shaman,enhancement,6,4,2
Shamsz,frostmourne,384,shaman,enhancement,6,4,2
Tokyotimxxo,malganis,384,shaman,enhancement,6,4,2
Megumi,aggramar,384,shaman,enhancement,6,4,2
Goldshîre,tichondrius,384,shaman,enhancement,6,4,2
Kisseyfaçaí,kelthuzad,384,shaman,enhancement,6,4,2
Dingfu,sargeras,384,shaman,enhancement,6,4,2
Protoaster,tichondrius,384,shaman,enhancement,6,4,2
Bioshocked,korgath,384,shaman,enhancement,6,4,2
Hooluu,frostmourne,384,shaman,enhancement,6,4,2
Yildiri,area-52,384,shaman,enhancement,6,4,2
Wools,frostmourne,384,shaman,enhancement,6,4,2
Jènova,whisperwind,384,shaman,enhancement,6,4,2
Bussybutter,sargeras,384,shaman,enhancement,6,4,2
Mastrionilol,dragonmaw,384,shaman,enhancement,6,4,2
Justkitettv,stormrage,384,shaman,enhancement,6,4,2
Katojune,tichondrius,384,shaman,enhancement,6,4,2
Taikø,area-52,384,shaman,enhancement,6,4,2
Azumaa,tichondrius,384,shaman,enhancement,6,4,2
Notglads,thrall,384,shaman,enhancement,6,4,2
Lukora,stonemaul,384,shaman,enhancement,6,4,2
Skipler,stormrage,384,shaman,enhancement,6,4,2
Grimwind,tichondrius,384,shaman,enhancement,6,4,2
Meramin,illidan,384,shaman,enhancement,6,4,2
Jamieslays,korgath,384,shaman,enhancement,6,4,2
Eleshortal,azuremyst,384,shaman,enhancement,9,4,5
Gangdan,emerald-dream,384,shaman,enhancement,12,4,8
Solka,illidan,384,shaman,enhancement,12,4,8
Tictactotem,lothar,384,shaman,enhancement,12,4,8
Emppege,tichondrius,384,shaman,enhancement,12,4,8
Neeman,malganis,384,shaman,enhancement,12,4,8
Vertrág,malganis,384,shaman,enhancement,12,4,8
Nehrakgu,wyrmrest-accord,384,shaman,enhancement,12,4,8
Piril,moon-guard,384,shaman,enhancement,12,4,8
Bloudabadee,emerald-dream,384,shaman,enhancement,12,4,8
Gaurudon,zuljin,384,shaman,enhancement,12,4,8
Skizzymars,malganis,384,shaman,enhancement,12,4,8
Grimdil,quelthalas,384,shaman,enhancement,18,4,14
Jacniclstorm,frostmourne,383,shaman,enhancement,6,4,2
Toeto,darrowmere,383,shaman,enhancement,6,4,2
Ghogann,bleeding-hollow,383,shaman,enhancement,6,4,2
Rhal,ragnaros,383,shaman,enhancement,6,4,2
Rocktor,alleria,383,shaman,enhancement,6,4,2
Kalashnikov,maiev,383,shaman,enhancement,12,4,8
Shambostik,thrall,383,shaman,enhancement,12,4,8
Icedogg,malganis,380,shaman,enhancement,12,4,8
Notahealz,zuljin,367,shaman,enhancement,11,4,7
Töpg,garrosh,352,shaman,enhancement,10,4,6
Admetis,vashj,351,shaman,enhancement,17,4,13
Thorsén,ursin,335,shaman,enhancement,17,4,13
Jeaunoo,darkspear,330,shaman,enhancement,14,5,9
Sasageyo,tichondrius,319,shaman,enhancement,8,4,4
Xulangshammy,illidan,319,shaman,enhancement,11,4,7
Tempestsmash,tichondrius,304,shaman,enhancement,7,4,3
Tekashi,muradin,304,shaman,enhancement,13,4,9
Sourcreamqtx,stormrage,288,shaman,enhancement,6,3,3
Haititnahtou,kaelthas,288,shaman,enhancement,6,3,3
Freshoranges,blood-furnace,288,shaman,enhancement,6,3,3
Dreamers,anvilmar,288,shaman,enhancement,6,3,3
Painfury,zuljin,288,shaman,enhancement,6,3,3
Lennylemons,stormrage,288,shaman,enhancement,6,3,3
Mavz200744,area-52,288,shaman,enhancement,6,3,3
Swifteyy,area-52,288,shaman,enhancement,6,3,3
Defiant,azgalor,288,shaman,enhancement,6,3,3
Jibbajabber,laughing-skull,288,shaman,enhancement,6,3,3
Sleepysham,kelthuzad,288,shaman,enhancement,6,3,3
Zoma,elune,288,shaman,enhancement,6,3,3
Ulala,azshara,288,shaman,enhancement,6,3,3
Ftp,kelthuzad,288,shaman,enhancement,6,3,3
Frèya,uldaman,288,shaman,enhancement,6,3,3
Korgen,area-52,288,shaman,enhancement,6,3,3
Shlongers,illidan,288,shaman,enhancement,6,3,3
Luxenor,kelthuzad,288,shaman,enhancement,6,3,3
Newele,thrall,288,shaman,enhancement,6,3,3
Vanmaichet,azshara,288,shaman,enhancement,6,3,3
Electabuzz,arygos,288,shaman,enhancement,6,3,3
Dogcompany,tichondrius,288,shaman,enhancement,6,3,3
Jokerxksx,tichondrius,288,shaman,enhancement,6,3,3
Glexhex,tichondrius,288,shaman,enhancement,6,3,3
Vivean,kelthuzad,288,shaman,enhancement,6,3,3
Jhivone,tichondrius,288,shaman,enhancement,6,3,3
Shawkedu,tichondrius,288,shaman,enhancement,6,3,3
Cluffatty,tichondrius,288,shaman,enhancement,6,3,3
Getwetand,quelthalas,288,shaman,enhancement,6,3,3
Falasha,bloodscalp,288,shaman,enhancement,6,3,3
Gojiras,barthilas,288,shaman,enhancement,6,3,3
Arckos,thrall,288,shaman,enhancement,6,3,3
Gorszu,proudmoore,288,shaman,enhancement,6,3,3
Gimpanzee,kiljaeden,288,shaman,enhancement,6,3,3
Nìke,nazgrel,288,shaman,enhancement,6,3,3
Jumoma,thrall,288,shaman,enhancement,6,3,3
Morderus,aegwynn,288,shaman,enhancement,6,3,3
Argena,bonechewer,288,shaman,enhancement,6,3,3
Murig,bladefist,288,shaman,enhancement,6,3,3
Ban,blackrock,288,shaman,enhancement,6,3,3
Aruçar,drakkari,288,shaman,enhancement,6,3,3
Bovinefony,blackrock,288,shaman,enhancement,6,3,3
Xantíd,wyrmrest-accord,288,shaman,enhancement,6,3,3
Emtflakes,darkspear,288,shaman,enhancement,6,3,3
Slowdown,malganis,288,shaman,enhancement,6,3,3
Shamaro,malganis,288,shaman,enhancement,6,3,3
Botu,malorne,288,shaman,enhancement,6,3,3
Torvi,saurfang,288,shaman,enhancement,6,3,3
Toyletpaper,mugthol,288,shaman,enhancement,6,3,3
Thiccwater,frostmourne,288,shaman,enhancement,6,3,3
Chavezlives,area-52,288,shaman,enhancement,6,3,3
Mundi,madoran,288,shaman,enhancement,6,3,3
Dwightjr,emerald-dream,288,shaman,enhancement,6,3,3
Corkrain,sargeras,288,shaman,enhancement,6,3,3
Smeeza,frostmourne,288,shaman,enhancement,6,3,3
Cars,jaedenar,288,shaman,enhancement,6,3,3
Slowkeeper,azralon,288,shaman,enhancement,6,3,3
Owiez,sargeras,288,shaman,enhancement,6,3,3
Gumballin,sargeras,288,shaman,enhancement,6,3,3
Jaftter,quelthalas,288,shaman,enhancement,9,4,5
Putinsdad,tichondrius,288,shaman,enhancement,10,4,6
Kakiscala,proudmoore,288,shaman,enhancement,11,3,8
Bobbymooshay,area-52,288,shaman,enhancement,12,3,9
Wickyz,moon-guard,288,shaman,enhancement,12,3,9
Drgiggleheim,tichondrius,288,shaman,enhancement,12,3,9
Jajxshammy,rivendare,288,shaman,enhancement,12,3,9
Drahlos,tichondrius,288,shaman,enhancement,12,3,9
Jireñ,area-52,288,shaman,enhancement,12,3,9
Spacex,velen,288,shaman,enhancement,12,3,9
Shockfreak,stormrage,288,shaman,enhancement,12,3,9
Gudac,tichondrius,288,shaman,enhancement,12,3,9
Smeagðl,tichondrius,288,shaman,enhancement,12,3,9
Azl,guldan,288,shaman,enhancement,12,3,9
Rockbass,sargeras,288,shaman,enhancement,12,3,9
Hammaam,illidan,288,shaman,enhancement,12,3,9
Regeneration,darkspear,288,shaman,enhancement,12,3,9
Malsturm,stormrage,288,shaman,enhancement,12,3,9
Faelzão,nemesis,288,shaman,enhancement,12,3,9
Azão,stormrage,288,shaman,enhancement,12,3,9
Fishmoley,zuljin,288,shaman,enhancement,12,3,9
Xaryu,shuhalo,287,shaman,enhancement,12,3,9
Dnttazemebro,area-52,286,shaman,enhancement,6,3,3
ßodycount,area-52,240,shaman,enhancement,9,3,6
Deeznuts,the-forgotten-coast,239,shaman,enhancement,5,3,2
Sølbi,tichondrius,239,shaman,enhancement,5,3,2
Caobuloso,azralon,239,shaman,enhancement,5,3,2
Totojar,alexstrasza,234,shaman,enhancement,10,4,6
Smooths,bloodscalp,234,shaman,enhancement,19,5,14
Forge,maelstrom,223,shaman,enhancement,8,3,5
Szael,durotan,192,shaman,enhancement,6,2,4
Thorlottie,stormrage,192,shaman,enhancement,6,2,4
Spicyballs,coilfang,192,shaman,enhancement,6,2,4
Sparklebunny,dark-iron,192,shaman,enhancement,6,2,4
Killamanjaro,alterac-mountains,192,shaman,enhancement,6,2,4
Durogh,darkspear,192,shaman,enhancement,6,2,4
Tamzlol,the-forgotten-coast,192,shaman,enhancement,6,2,4
Kelce,stormrage,192,shaman,enhancement,6,2,4
Shamutari,sargeras,192,shaman,enhancement,6,2,4
Rinjio,zuljin,192,shaman,enhancement,6,2,4
Stnky,cairne,192,shaman,enhancement,6,2,4
Tuugo,mannoroth,192,shaman,enhancement,6,2,4
Cutedraenei,destromath,192,shaman,enhancement,6,2,4
Stallos,zuljin,192,shaman,enhancement,6,2,4
Fatluma,zuljin,192,shaman,enhancement,6,2,4
Maicer,goldrinn,192,shaman,enhancement,6,2,4
Brenqt,nemesis,192,shaman,enhancement,6,2,4
Jbahr,hyjal,192,shaman,enhancement,6,2,4
Badjujubruh,thrall,192,shaman,enhancement,6,2,4
Pissticles,bleeding-hollow,192,shaman,enhancement,6,2,4
Dadajuju,azralon,192,shaman,enhancement,6,2,4
Sluggox,bleeding-hollow,192,shaman,enhancement,6,2,4
Kulnash,auchindoun,192,shaman,enhancement,6,2,4
Kumer,tichondrius,192,shaman,enhancement,6,2,4
Boj,magtheridon,192,shaman,enhancement,6,2,4
Jahahahamon,arthas,192,shaman,enhancement,6,2,4
Emptyy,azralon,192,shaman,enhancement,6,2,4
Bullcowsby,darkspear,192,shaman,enhancement,6,2,4
Hothandxo,illidan,192,shaman,enhancement,6,2,4
Unhapintadaa,azralon,192,shaman,enhancement,6,2,4
Shaminja,kiljaeden,192,shaman,enhancement,6,2,4
Zenitsue,sargeras,192,shaman,enhancement,6,2,4
Totemzie,illidan,192,shaman,enhancement,6,2,4
Whameradetu,suramar,192,shaman,enhancement,6,2,4
Twistër,illidan,192,shaman,enhancement,6,2,4
Saltt,proudmoore,192,shaman,enhancement,6,2,4
Thrallzballz,firetree,192,shaman,enhancement,6,2,4
Brofessor,frostwolf,192,shaman,enhancement,6,2,4
Scarshamxn,frostmourne,192,shaman,enhancement,6,2,4
Girthquake,agamaggan,192,shaman,enhancement,6,2,4
Pericazo,sargeras,192,shaman,enhancement,6,2,4
Hèllzpyro,sargeras,192,shaman,enhancement,6,2,4
Friedshammy,frostmourne,192,shaman,enhancement,6,2,4
Zentius,thunderhorn,192,shaman,enhancement,6,2,4
Amzurs,area-52,192,shaman,enhancement,6,2,4
Vjeze,frostmourne,192,shaman,enhancement,6,2,4
Ôprawindfury,mugthol,192,shaman,enhancement,6,2,4
Daiablo,barthilas,192,shaman,enhancement,6,2,4
Amärök,area-52,192,shaman,enhancement,6,2,4
Valcannos,area-52,192,shaman,enhancement,6,2,4
Bootsix,area-52,192,shaman,enhancement,6,2,4
Shamanakin,emerald-dream,192,shaman,enhancement,6,2,4
Freesolo,barthilas,192,shaman,enhancement,6,2,4
Böc,tichondrius,192,shaman,enhancement,6,2,4
Jammylol,frostmourne,192,shaman,enhancement,6,2,4
Vitaminc,garona,192,shaman,enhancement,6,2,4
Ceedlamb,kelthuzad,192,shaman,enhancement,6,2,4
Stormfronts,kelthuzad,192,shaman,enhancement,6,2,4
Milkmeforhp,frostmourne,192,shaman,enhancement,6,2,4
Shamnick,malganis,192,shaman,enhancement,6,2,4
Electrica,quelthalas,192,shaman,enhancement,6,2,4
Skyten,quelthalas,192,shaman,enhancement,6,2,4
Wìzz,zuljin,192,shaman,enhancement,6,2,4
Khuufu,fizzcrank,192,shaman,enhancement,6,2,4
Immunize,tichondrius,192,shaman,enhancement,6,2,4
Víì,tichondrius,192,shaman,enhancement,6,2,4
Zeldrys,emerald-dream,192,shaman,enhancement,6,2,4
Shamflu,tichondrius,192,shaman,enhancement,6,2,4
Jasonnworb,tichondrius,192,shaman,enhancement,6,2,4
ßeesy,emerald-dream,192,shaman,enhancement,6,2,4
Soapmactavis,sargeras,192,shaman,enhancement,6,2,4
Ectomee,tichondrius,192,shaman,enhancement,6,2,4
Bitxxnumber,tichondrius,192,shaman,enhancement,6,2,4
Kinzle,tichondrius,192,shaman,enhancement,6,2,4
Dennwoop,sargeras,192,shaman,enhancement,6,2,4
Rayjamalblk,tichondrius,192,shaman,enhancement,6,2,4
Mishalla,tichondrius,192,shaman,enhancement,6,2,4
Meattoilet,tichondrius,192,shaman,enhancement,6,2,4
Meatyball,tichondrius,192,shaman,enhancement,6,2,4
Slapchainz,tichondrius,192,shaman,enhancement,6,2,4
Legendmatic,illidan,192,shaman,enhancement,12,2,10
Chontu,area-52,192,shaman,enhancement,12,2,10
Zuljiba,illidan,192,shaman,enhancement,12,2,10
Tarresh,azralon,192,shaman,enhancement,12,2,10
Stylebend,area-52,192,shaman,enhancement,12,2,10
Shockszz,onyxia,192,shaman,enhancement,12,2,10
Calmconflict,daggerspine,191,shaman,enhancement,6,2,4
Dahmerjr,area-52,191,shaman,enhancement,6,2,4
Dønßlack,thunderhorn,159,shaman,enhancement,5,2,3
Skuffedx,spirestone,159,shaman,enhancement,5,2,3
Nuggitz,tichondrius,159,shaman,enhancement,5,2,3
Shamto,zuljin,144,shaman,enhancement,3,3,0
Reavs,illidan,138,shaman,enhancement,16,3,13
Thanen,the-scryers,137,shaman,enhancement,10,3,7
Flashyjoe,tichondrius,128,shaman,enhancement,4,2,2
Badgeshock,area-52,128,shaman,enhancement,4,2,2
Bogz,korgath,128,shaman,enhancement,4,2,2
Ludacrìtz,stormrage,112,shaman,enhancement,7,2,5
Tekdar,kiljaeden,96,shaman,enhancement,3,2,1
Shamcakes,kilrogg,96,shaman,enhancement,17,3,14
Succies,emerald-dream,96,shaman,enhancement,6,1,5
Tritun,proudmoore,96,shaman,enhancement,6,1,5
Sweettooth,area-52,96,shaman,enhancement,6,1,5
Totemtîme,frostmourne,96,shaman,enhancement,6,1,5
Okdopey,area-52,96,shaman,enhancement,6,1,5
Drekkhal,area-52,96,shaman,enhancement,6,1,5
Stormsanta,emerald-dream,96,shaman,enhancement,6,1,5
Karmar,proudmoore,96,shaman,enhancement,6,1,5
Aiggiggigne,sargeras,96,shaman,enhancement,6,1,5
Ikora,crushridge,96,shaman,enhancement,6,1,5
Sandmanatee,crushridge,96,shaman,enhancement,6,1,5
Geladoo,gallywix,96,shaman,enhancement,6,1,5
Hangellyca,azralon,96,shaman,enhancement,6,1,5
Tictactotum,hyjal,96,shaman,enhancement,6,1,5
Shamofshame,garrosh,96,shaman,enhancement,6,1,5
Paramecium,sargeras,96,shaman,enhancement,6,1,5
Muyg,staghelm,96,shaman,enhancement,6,1,5
Bigsquatzy,bleeding-hollow,96,shaman,enhancement,6,1,5
Mawcus,zuljin,96,shaman,enhancement,6,1,5
Thunderblood,nerzhul,96,shaman,enhancement,6,1,5
Zapsquidzap,illidan,96,shaman,enhancement,6,1,5
Ohtoro,zuljin,96,shaman,enhancement,6,1,5
Acéz,korgath,96,shaman,enhancement,6,1,5
Jëks,azjolnerub,96,shaman,enhancement,6,1,5
Shamikkazee,illidan,96,shaman,enhancement,6,1,5
Jags,baelgun,96,shaman,enhancement,6,1,5
Axshaman,darkspear,96,shaman,enhancement,6,1,5
Pileef,thrall,96,shaman,enhancement,6,1,5
Blackjackxx,frostmourne,96,shaman,enhancement,6,1,5
Sèktor,dalaran,96,shaman,enhancement,6,1,5
Sureofname,frostmourne,96,shaman,enhancement,6,1,5
Wangbangjr,mugthol,96,shaman,enhancement,6,1,5
Kinjin,dragonmaw,96,shaman,enhancement,6,1,5
Alferian,moon-guard,96,shaman,enhancement,6,1,5
Zoeyzour,illidan,96,shaman,enhancement,6,1,5
Beazel,moon-guard,96,shaman,enhancement,6,1,5
Threehandz,bleeding-hollow,96,shaman,enhancement,8,1,7
Thallor,stormrage,96,shaman,enhancement,12,1,11
Smokeymcpots,khazgoroth,95,shaman,enhancement,6,1,5
Dilldoughnut,sargeras,79,shaman,enhancement,5,1,4
Shablam,daggerspine,64,shaman,enhancement,10,1,9
Engorgdshock,tichondrius,63,shaman,enhancement,2,2,0
Totemlord,lightnings-blade,31,shaman,enhancement,2,1,1
Rykku,illidan,16,shaman,enhancement,1,1,0
Mlx,proudmoore,2345,warlock,demonology,119,69,50
Wildimp,aerie-peak,2323,warlock,demonology,108,66,42
Btsfangirl,moon-guard,2262,warlock,demonology,98,57,41
Zuelu,tichondrius,2252,warlock,demonology,85,53,32
Wzxx,tichondrius,2222,warlock,demonology,84,46,38
Wildimpx,sargeras,2206,warlock,demonology,95,52,43
Beyourselff,tichondrius,2192,warlock,demonology,145,78,67
Mixtape,stormrage,2178,warlock,demonology,77,47,30
Bahamas,bleeding-hollow,2166,warlock,demonology,78,46,32
Gentleq,tichondrius,2149,warlock,demonology,99,53,46
Ediya,tichondrius,2141,warlock,demonology,96,49,47
Fishorz,tichondrius,2128,warlock,demonology,89,47,42
Harambê,sargeras,2127,warlock,demonology,36,27,9
Awdam,tichondrius,2114,warlock,demonology,96,50,46
Ensebado,azralon,2111,warlock,demonology,140,78,62
Falco,azshara,2110,warlock,demonology,66,38,28
Synkz,blood-furnace,2110,warlock,demonology,72,38,34
Cosmosxx,illidan,2110,warlock,demonology,112,58,54
Ogchaos,tichondrius,2107,warlock,demonology,78,45,33
Wesyane,anetheron,2092,warlock,demonology,101,53,48
Bronzerl,tichondrius,2083,warlock,demonology,40,28,12
Erock,korgath,2082,warlock,demonology,54,42,12
Kaossqt,azralon,2082,warlock,demonology,102,54,48
Xadge,tichondrius,2076,warlock,demonology,73,40,33
Ztlivid,area-52,2075,warlock,demonology,163,88,75
Erlandesher,tichondrius,2075,warlock,demonology,83,41,42
Etuskaa,tichondrius,2066,warlock,demonology,113,57,56
Vexxes,malganis,2053,warlock,demonology,114,62,52
Oymmander,illidan,2046,warlock,demonology,56,37,19
Miredö,tichondrius,2040,warlock,demonology,48,30,18
Gianni,chogall,2039,warlock,demonology,83,41,42
Fatass,cairne,2028,warlock,demonology,60,33,27
Eazyw,stormrage,2024,warlock,demonology,95,47,48
Sslock,sargeras,2008,warlock,demonology,71,37,34
Ziffy,emerald-dream,2008,warlock,demonology,66,34,32
Nocrackrocks,stormrage,2007,warlock,demonology,117,66,51
Persistencss,tichondrius,2004,warlock,demonology,42,26,16
Elbrujon,sargeras,2002,warlock,demonology,107,55,52
Awangdemon,tichondrius,1997,warlock,demonology,54,27,27
Lilballz,tichondrius,1987,warlock,demonology,42,24,18
Babyaga,illidan,1981,warlock,demonology,54,33,21
Teivlol,mugthol,1980,warlock,demonology,90,48,42
Extreme,blackwing-lair,1978,warlock,demonology,78,53,25
Toiletghost,tichondrius,1973,warlock,demonology,56,35,21
Ihaveapowers,maiev,1973,warlock,demonology,114,58,56
Patoquenn,azralon,1966,warlock,demonology,54,32,22
Xygg,tichondrius,1962,warlock,demonology,48,29,19
Ofc,malganis,1961,warlock,demonology,48,29,19
Paygo,tichondrius,1956,warlock,demonology,51,30,21
Ketahole,warsong,1949,warlock,demonology,99,50,49
Naughtybolts,sargeras,1941,warlock,demonology,80,46,34
Amazingamez,sargeras,1940,warlock,demonology,137,66,71
Baka,moon-guard,1937,warlock,demonology,54,29,25
Stopdot,lightnings-blade,1934,warlock,demonology,76,38,38
Bwonsamdijin,tichondrius,1924,warlock,demonology,77,38,39
Shadowmoonon,tichondrius,1921,warlock,demonology,43,21,22
Aramith,tichondrius,1912,warlock,demonology,60,36,24
Lemmefear,illidan,1911,warlock,demonology,30,20,10
Littlerod,tichondrius,1909,warlock,demonology,48,26,22
Lilgigs,stormrage,1909,warlock,demonology,60,30,30
Sofan,dalaran,1905,warlock,demonology,58,33,25
Lockedinn,mannoroth,1904,warlock,demonology,91,54,37
Babydots,stormreaver,1903,warlock,demonology,112,59,53
Percadu,barthilas,1902,warlock,demonology,54,32,22
Demondisco,tichondrius,1901,warlock,demonology,83,40,43
Daerde,malganis,1900,warlock,demonology,47,27,20
Siphoned,darkspear,1900,warlock,demonology,53,27,26
Deadlpoo,stormscale,1899,warlock,demonology,81,41,40
Xiyangpvp,tichondrius,1898,warlock,demonology,54,31,23
Lemmepvponu,illidan,1896,warlock,demonology,48,30,18
Alisa,moon-guard,1896,warlock,demonology,60,28,32
Lrry,dalaran,1893,warlock,demonology,144,84,60
Bleachkk,tichondrius,1888,warlock,demonology,42,29,13
Maadhum,illidan,1888,warlock,demonology,57,31,26
Rakshama,chogall,1885,warlock,demonology,42,25,17
Debao,malganis,1881,warlock,demonology,60,29,31
Snuufels,area-52,1879,warlock,demonology,54,32,22
Petattack,nerzhul,1878,warlock,demonology,125,60,65
Tessarath,area-52,1876,warlock,demonology,41,26,15
Kimchiblast,tichondrius,1876,warlock,demonology,48,28,20
Ceeloftw,tichondrius,1873,warlock,demonology,90,47,43
Zydiva,sargeras,1872,warlock,demonology,118,62,56
Huajianmanwu,tichondrius,1872,warlock,demonology,166,87,79
Sàill,tichondrius,1871,warlock,demonology,35,22,13
Thranlock,area-52,1863,warlock,demonology,102,50,52
Mhael,lightninghoof,1856,warlock,demonology,54,32,22
Atheø,ragnaros,1854,warlock,demonology,42,23,19
Bbangtimo,tichondrius,1852,warlock,demonology,36,20,16
Bigdaddylol,ragnaros,1849,warlock,demonology,53,30,23
Demyo,tichondrius,1849,warlock,demonology,38,21,17
Unhòólylck,ragnaros,1848,warlock,demonology,46,25,21
Redfish,tichondrius,1847,warlock,demonology,34,20,14
Phóbòs,tichondrius,1843,warlock,demonology,54,40,14
Kerrigan,the-venture-co,1842,warlock,demonology,66,38,28
Darkzell,azralon,1841,warlock,demonology,48,30,18
Ccona,tichondrius,1835,warlock,demonology,42,23,19
Jyhoona,chromaggus,1835,warlock,demonology,184,99,85
Speakeasy,malygos,1835,warlock,demonology,58,29,29
Åmön,zuljin,1832,warlock,demonology,66,32,34
ßøßßÿßøûçhêr,tichondrius,1831,warlock,demonology,36,25,11
Drakatattwo,tichondrius,1831,warlock,demonology,42,23,19
Spicyfingers,illidan,1829,warlock,demonology,48,29,19
Evildeath,tichondrius,1829,warlock,demonology,48,26,22
Bic,thrall,1828,warlock,demonology,66,45,21
Lowrcase,zuljin,1828,warlock,demonology,42,24,18
Xoboroz,moon-guard,1827,warlock,demonology,60,29,31
Playtoy,moon-guard,1826,warlock,demonology,142,71,71
Jerclard,proudmoore,1825,warlock,demonology,90,51,39
Castingfear,barthilas,1825,warlock,demonology,48,27,21
Dowal,whisperwind,1824,warlock,demonology,54,28,26
Sharaßha,moon-guard,1820,warlock,demonology,69,41,28
Dapete,malorne,1818,warlock,demonology,53,30,23
Arcinian,kelthuzad,1817,warlock,demonology,66,39,27
Boltqt,tichondrius,1815,warlock,demonology,36,22,14
Richards,thrall,1812,warlock,demonology,42,32,10
Ltr,moon-guard,1811,warlock,demonology,30,22,8
Abrocket,alleria,1811,warlock,demonology,30,19,11
Voidxo,tichondrius,1811,warlock,demonology,36,22,14
Bronzel,tichondrius,1811,warlock,demonology,42,25,17
Raegon,kiljaeden,1811,warlock,demonology,39,23,16
Errogant,area-52,1810,warlock,demonology,60,30,30
Beckypls,zuljin,1809,warlock,demonology,36,27,9
Dounutlock,area-52,1809,warlock,demonology,54,33,21
Chilipeppa,wyrmrest-accord,1808,warlock,demonology,60,34,26
Mälwaré,tichondrius,1808,warlock,demonology,58,29,29
Chaosthekid,malganis,1807,warlock,demonology,40,25,15
Reneqtxo,jubeithos,1806,warlock,demonology,30,19,11
Xacayth,ragnaros,1804,warlock,demonology,80,47,33
Rakudemon,ragnaros,1804,warlock,demonology,147,77,70
Dlhmlock,tichondrius,1803,warlock,demonology,35,23,12
Darkborkain,tichondrius,1803,warlock,demonology,30,19,11
Thelockzx,azralon,1801,warlock,demonology,60,28,32
Broccoleh,area-52,1799,warlock,demonology,41,25,16
Tarth,sargeras,1797,warlock,demonology,96,48,48
Magë,ursin,1796,warlock,demonology,78,34,44
Lockeslock,sargeras,1795,warlock,demonology,112,59,53
Hugebolt,tichondrius,1793,warlock,demonology,48,28,20
Jaganshi,tichondrius,1791,warlock,demonology,52,29,23
Búmchúm,frostmourne,1788,warlock,demonology,54,34,20
Keylloggz,sargeras,1779,warlock,demonology,102,53,49
Aidadeshu,tichondrius,1778,warlock,demonology,60,28,32
Flocka,agamaggan,1773,warlock,demonology,42,33,9
Axelrodx,tichondrius,1773,warlock,demonology,42,27,15
Qp,thrall,1771,warlock,demonology,38,28,10
Atheô,ragnaros,1769,warlock,demonology,53,28,25
Spreadlove,emerald-dream,1766,warlock,demonology,138,74,64
Sasaology,frostmourne,1765,warlock,demonology,54,31,23
Döremi,tichondrius,1760,warlock,demonology,35,21,14
Villaìn,moon-guard,1759,warlock,demonology,87,38,49
Nüts,blackrock,1753,warlock,demonology,38,20,18
Procalypse,stormrage,1748,warlock,demonology,30,22,8
Coèrce,tichondrius,1748,warlock,demonology,29,19,10
ßállin,illidan,1745,warlock,demonology,35,22,13
Mcpickls,illidan,1740,warlock,demonology,48,26,22
Michae,tichondrius,1740,warlock,demonology,48,25,23
Feldren,wyrmrest-accord,1739,warlock,demonology,59,33,26
Arityy,tichondrius,1738,warlock,demonology,33,23,10
Chanigay,tichondrius,1737,warlock,demonology,35,20,15
Dreadlõck,malganis,1737,warlock,demonology,78,39,39
Wls,frostmourne,1736,warlock,demonology,47,27,20
Beatinu,draenor,1732,warlock,demonology,42,26,16
Nethron,the-venture-co,1731,warlock,demonology,66,33,33
Ðëâthløck,tichondrius,1729,warlock,demonology,47,25,22
Hadoukën,hyjal,1727,warlock,demonology,90,44,46
Overclocked,destromath,1726,warlock,demonology,24,18,6
Domenic,sentinels,1725,warlock,demonology,46,26,20
Lemmewin,illidan,1724,warlock,demonology,24,18,6
Playßøy,area-52,1724,warlock,demonology,30,18,12
Ökïlôck,proudmoore,1722,warlock,demonology,36,18,18
Aroug,aggramar,1720,warlock,demonology,84,43,41
Devilman,darkspear,1720,warlock,demonology,129,64,65
Missalice,nesingwary,1719,warlock,demonology,36,22,14
Muchas,area-52,1717,warlock,demonology,30,18,12
Fadedemon,area-52,1716,warlock,demonology,42,32,10
Zver,drakkari,1712,warlock,demonology,48,29,19
Eastwitch,ragnaros,1712,warlock,demonology,90,39,51
Larixpotanin,tichondrius,1709,warlock,demonology,42,23,19
Dätura,tichondrius,1708,warlock,demonology,32,21,11
Hulkyy,illidan,1706,warlock,demonology,89,53,36
Milkybøng,area-52,1705,warlock,demonology,99,61,38
Dëvïl,ragnaros,1702,warlock,demonology,62,39,23
Dìablo,area-52,1702,warlock,demonology,78,43,35
Ourlegacy,tichondrius,1695,warlock,demonology,40,24,16
Fksm,tichondrius,1692,warlock,demonology,36,20,16
Gamecover,azralon,1691,warlock,demonology,51,30,21
Ciprýan,azralon,1691,warlock,demonology,58,26,32
Stopdottroll,zuljin,1690,warlock,demonology,30,18,12
Metrow,area-52,1688,warlock,demonology,30,18,12
Houdneeznuts,tichondrius,1688,warlock,demonology,150,81,69
Melisândre,kiljaeden,1687,warlock,demonology,47,23,24
Leeka,tichondrius,1687,warlock,demonology,48,23,25
Notomorrow,tichondrius,1686,warlock,demonology,146,87,59
Lockiator,moon-guard,1686,warlock,demonology,41,24,17
Amgs,frostmourne,1685,warlock,demonology,36,26,10
Dotman,tichondrius,1685,warlock,demonology,48,23,25
Dogegg,tichondrius,1685,warlock,demonology,66,28,38
Säbrine,zuljin,1679,warlock,demonology,73,35,38
Døtyou,area-52,1676,warlock,demonology,35,18,17
Juswannarock,tichondrius,1676,warlock,demonology,51,25,26
Oluluo,andorhal,1675,warlock,demonology,35,19,16
Zörkô,zuljin,1675,warlock,demonology,60,26,34
Shinyballz,tichondrius,1673,warlock,demonology,35,18,17
Obséssèd,aggramar,1670,warlock,demonology,42,26,16
Bigfatballz,tichondrius,1670,warlock,demonology,40,24,16
Wrathh,stormscale,1669,warlock,demonology,45,20,25
Narmazulnn,area-52,1666,warlock,demonology,41,25,16
Altairo,illidan,1666,warlock,demonology,76,39,37
Mcpickl,illidan,1662,warlock,demonology,54,25,29
Funkminot,illidan,1661,warlock,demonology,211,111,100
Archibalding,area-52,1656,warlock,demonology,42,26,16
Skanckqt,malganis,1654,warlock,demonology,48,26,22
Rathul,bonechewer,1654,warlock,demonology,55,27,28
Vcain,stormrage,1652,warlock,demonology,66,31,35
Gihaewon,tichondrius,1650,warlock,demonology,30,20,10
Eriebos,area-52,1647,warlock,demonology,48,27,21
Xaryl,stormrage,1646,warlock,demonology,48,25,23
Soreanus,illidan,1645,warlock,demonology,42,28,14
Dlchem,tichondrius,1644,warlock,demonology,70,37,33
Phogy,bleeding-hollow,1644,warlock,demonology,71,35,36
Cinderwhip,moon-guard,1643,warlock,demonology,123,59,64
Miryem,illidan,1642,warlock,demonology,49,30,19
Juxsr,nerzhul,1642,warlock,demonology,42,22,20
Gløcked,area-52,1637,warlock,demonology,30,19,11
Blastfinger,tichondrius,1637,warlock,demonology,42,24,18
Suzüki,tichondrius,1635,warlock,demonology,36,19,17
Fearedu,thunderhorn,1633,warlock,demonology,101,47,54
Gørb,wyrmrest-accord,1632,warlock,demonology,36,22,14
Graendol,tichondrius,1630,warlock,demonology,30,17,13
Innocentius,illidan,1630,warlock,demonology,70,37,33
Sickmade,zuljin,1628,warlock,demonology,70,44,26
Spicyfingerx,illidan,1627,warlock,demonology,30,20,10
Aoepump,tichondrius,1627,warlock,demonology,30,17,13
Ggooudan,tichondrius,1625,warlock,demonology,29,21,8
Raidspot,bleeding-hollow,1624,warlock,demonology,60,36,24
Stonelocke,area-52,1624,warlock,demonology,65,34,31
Fabriziø,ragnaros,1622,warlock,demonology,30,21,9
Kreâtor,tichondrius,1622,warlock,demonology,71,40,31
Demonicsmoke,darrowmere,1622,warlock,demonology,104,56,48
Diabolock,proudmoore,1620,warlock,demonology,36,20,16
Bagn,tichondrius,1620,warlock,demonology,42,23,19
Mcpickles,illidan,1618,warlock,demonology,30,19,11
Epinetheus,stormrage,1617,warlock,demonology,54,23,31
Buymymixtåpe,ursin,1615,warlock,demonology,33,21,12
Zantology,frostmourne,1615,warlock,demonology,54,31,23
Krýptizl,frostmourne,1615,warlock,demonology,81,45,36
Ministàff,ursin,1615,warlock,demonology,36,17,19
Xlilgee,kelthuzad,1614,warlock,demonology,30,17,13
Abismoarmdr,ragnaros,1613,warlock,demonology,115,66,49
Alndron,thrall,1613,warlock,demonology,36,17,19
Shooterg,tichondrius,1613,warlock,demonology,42,18,24
Yükina,stormrage,1611,warlock,demonology,54,29,25
Mcjoy,akama,1608,warlock,demonology,121,72,49
Hentry,sargeras,1608,warlock,demonology,47,25,22
Eternalsmile,tichondrius,1606,warlock,demonology,36,21,15
Cambolts,tichondrius,1604,warlock,demonology,36,20,16
Toestye,lightbringer,1600,warlock,demonology,108,56,52
Harrydotterr,bonechewer,1598,warlock,demonology,60,29,31
Valkynaris,chogall,1594,warlock,demonology,30,20,10
Warlocklmao,malganis,1594,warlock,demonology,36,19,17
Raisa,chogall,1593,warlock,demonology,42,20,22
Yanlexx,stormrage,1592,warlock,demonology,86,44,42
Amour,wyrmrest-accord,1592,warlock,demonology,58,26,32
Empiratore,quelthalas,1590,warlock,demonology,42,20,22
Doombaby,zuljin,1588,warlock,demonology,48,30,18
Lazymongoose,frostmourne,1588,warlock,demonology,114,61,53
Invisibles,barthilas,1586,warlock,demonology,29,17,12
Voltshot,tichondrius,1584,warlock,demonology,165,87,78
Kìllèrgf,area-52,1584,warlock,demonology,78,39,39
Goorock,area-52,1581,warlock,demonology,78,40,38
Dreamsw,frostmourne,1578,warlock,demonology,36,18,18
Agertis,frostmourne,1578,warlock,demonology,42,18,24
Fearmebro,bleeding-hollow,1577,warlock,demonology,72,45,27
Spookyfurry,area-52,1576,warlock,demonology,48,33,15
Smallj,zuljin,1576,warlock,demonology,54,27,27
Redbullsz,bleeding-hollow,1573,warlock,demonology,68,34,34
Hoana,azralon,1570,warlock,demonology,87,50,37
Xephostwo,area-52,1567,warlock,demonology,42,20,22
Th,kiljaeden,1567,warlock,demonology,53,23,30
Caesaros,quelthalas,1563,warlock,demonology,87,40,47
Necronemesis,arthas,1556,warlock,demonology,60,27,33
Curseifier,frostmourne,1554,warlock,demonology,44,23,21
Fullxd,quelthalas,1551,warlock,demonology,48,28,20
Deathcyth,crushridge,1550,warlock,demonology,123,69,54
Spooknjuke,bleeding-hollow,1546,warlock,demonology,41,26,15
Wickdways,daggerspine,1546,warlock,demonology,54,32,22
Bauchalain,area-52,1541,warlock,demonology,36,21,15
Soulrulerxc,tichondrius,1534,warlock,demonology,30,16,14
Isometrics,barthilas,1534,warlock,demonology,30,16,14
Canobio,tichondrius,1531,warlock,demonology,18,16,2
Silentfears,tichondrius,1531,warlock,demonology,27,20,7
Forsâken,tichondrius,1531,warlock,demonology,95,42,53
Cilium,illidan,1530,warlock,demonology,35,20,15
Almostoogood,illidan,1526,warlock,demonology,24,16,8
Wollylock,dark-iron,1520,warlock,demonology,52,25,27
Ktlock,frostmourne,1518,warlock,demonology,96,53,43
Sadgellation,arthas,1514,warlock,demonology,30,19,11
Fãttyqt,sargeras,1513,warlock,demonology,52,35,17
Dárklórd,dalaran,1512,warlock,demonology,144,76,68
Krolczdots,tichondrius,1505,warlock,demonology,30,18,12
Proletariat,moon-guard,1503,warlock,demonology,64,38,26
Parmenides,tichondrius,1502,warlock,demonology,112,56,56
Bigdotenergi,tichondrius,1501,warlock,demonology,24,16,8
Icemanliddel,area-52,1500,warlock,demonology,35,16,19
Mindfulchimp,sargeras,1499,warlock,demonology,36,21,15
Rasildur,ragnaros,1496,warlock,demonology,43,17,26
Heartpvp,tichondrius,1495,warlock,demonology,54,27,27
Shigero,tichondrius,1494,warlock,demonology,30,19,11
Eriand,nordrassil,1482,warlock,demonology,102,51,51
Zhoull,thrall,1479,warlock,demonology,48,23,25
Grixis,zuluhed,1478,warlock,demonology,36,23,13
Rotsndotss,thrall,1469,warlock,demonology,42,19,23
Prägä,drakkari,1467,warlock,demonology,45,23,22
Khanaan,illidan,1466,warlock,demonology,30,16,14
Blavindy,illidan,1461,warlock,demonology,54,26,28
Sugarwaffles,area-52,1460,warlock,demonology,60,33,27
Kandrus,moon-guard,1454,warlock,demonology,92,43,49
Iselltacos,dalaran,1451,warlock,demonology,25,16,9
Immortallock,tichondrius,1449,warlock,demonology,54,27,27
Tsunamibaby,anvilmar,1440,warlock,demonology,54,30,24
Discordance,zuljin,1439,warlock,demonology,24,15,9
Darkwîngduck,illidan,1439,warlock,demonology,24,15,9
Invalid,frostmourne,1438,warlock,demonology,18,15,3
Cosmosxi,illidan,1437,warlock,demonology,24,15,9
Sosahawk,stormrage,1437,warlock,demonology,30,15,15
Lamo,dawnbringer,1437,warlock,demonology,112,54,58
Dottcha,blackrock,1436,warlock,demonology,24,15,9
Chaosboltlol,tichondrius,1436,warlock,demonology,30,15,15
Valerik,azralon,1435,warlock,demonology,42,20,22
Synisterlock,moon-guard,1432,warlock,demonology,36,18,18
Saevitar,area-52,1431,warlock,demonology,30,15,15
Garcheros,ragnaros,1427,warlock,demonology,27,16,11
Aomniloltv,zuljin,1426,warlock,demonology,24,15,9
Voidwarlord,tichondrius,1420,warlock,demonology,47,26,21
Yuengling,illidan,1420,warlock,demonology,30,15,15
Arlenna,sargeras,1419,warlock,demonology,122,57,65
Gromy,lightnings-blade,1415,warlock,demonology,50,30,20
Smartpimp,tichondrius,1414,warlock,demonology,24,15,9
Kuyog,illidan,1411,warlock,demonology,60,30,30
Mothapucka,thrall,1410,warlock,demonology,35,16,19
Laggyturbo,barthilas,1409,warlock,demonology,66,38,28
Dcpwns,arthas,1405,warlock,demonology,42,18,24
Monstir,sargeras,1396,warlock,demonology,31,16,15
Suminl,tichondrius,1392,warlock,demonology,24,15,9
Guisls,azralon,1386,warlock,demonology,54,22,32
Tiná,tichondrius,1385,warlock,demonology,27,15,12
Lemongillo,stormrage,1378,warlock,demonology,35,20,15
Mysteryannie,tichondrius,1371,warlock,demonology,70,42,28
Narcan,arthas,1371,warlock,demonology,29,16,13
Guldorum,kiljaeden,1355,warlock,demonology,24,15,9
Gimmeprecog,tichondrius,1344,warlock,demonology,18,14,4
Voidxx,tichondrius,1343,warlock,demonology,18,14,4
Ellynaria,nemesis,1343,warlock,demonology,18,14,4
Biubius,tichondrius,1343,warlock,demonology,24,14,10
Doomdm,zuljin,1342,warlock,demonology,24,14,10
Paparoxy,illidan,1341,warlock,demonology,24,14,10
Maral,kelthuzad,1341,warlock,demonology,27,15,12
Juleno,quelthalas,1341,warlock,demonology,27,15,12
Demonalien,malganis,1339,warlock,demonology,18,14,4
Jamesiyah,moon-guard,1332,warlock,demonology,48,23,25
Ézman,tichondrius,1330,warlock,demonology,24,14,10
Bestwarlock,skywall,1328,warlock,demonology,30,14,16
Eldriptch,kelthuzad,1325,warlock,demonology,27,15,12
Superjuno,sargeras,1319,warlock,demonology,18,14,4
Dawdrax,gallywix,1313,warlock,demonology,22,15,7
Kuroyt,drakkari,1311,warlock,demonology,30,14,16
Jokerks,tichondrius,1310,warlock,demonology,23,14,9
Avoidence,tanaris,1308,warlock,demonology,24,14,10
Sû,stormrage,1301,warlock,demonology,82,39,43
Shadowflame,skullcrusher,1299,warlock,demonology,91,48,43
Salacia,chogall,1286,warlock,demonology,81,39,42
Gauul,illidan,1281,warlock,demonology,70,39,31
Heathncraig,illidan,1279,warlock,demonology,50,29,21
Screampied,sargeras,1279,warlock,demonology,53,24,29
Tizzy,malganis,1276,warlock,demonology,32,21,11
Valerilma,azralon,1276,warlock,demonology,36,16,20
Cornboil,tichondrius,1274,warlock,demonology,57,27,30
Willsayan,ragnaros,1266,warlock,demonology,42,16,26
Bluffzlock,boulderfist,1260,warlock,demonology,23,14,9
Wazog,jubeithos,1250,warlock,demonology,30,16,14
Gotfear,zuljin,1249,warlock,demonology,141,70,71
Scalpelx,tichondrius,1248,warlock,demonology,18,13,5
Adonege,tichondrius,1248,warlock,demonology,24,13,11
Drakatat,tichondrius,1248,warlock,demonology,24,13,11
Deathboltx,zuljin,1248,warlock,demonology,24,13,11
Pfhear,area-52,1247,warlock,demonology,24,13,11
Feinnx,dalaran,1246,warlock,demonology,30,13,17
Thalsiani,moon-guard,1239,warlock,demonology,24,13,11
Drain,proudmoore,1233,warlock,demonology,18,13,5
Felorc,wyrmrest-accord,1232,warlock,demonology,36,21,15
Lpharji,tichondrius,1231,warlock,demonology,24,13,11
Alaren,korgath,1231,warlock,demonology,36,13,23
Brawndelock,stormrage,1228,warlock,demonology,24,13,11
Welendiock,malganis,1228,warlock,demonology,43,21,22
Zeeref,stormrage,1206,warlock,demonology,30,13,17
Arcaangell,sargeras,1195,warlock,demonology,51,27,24
Memon,frostmane,1187,warlock,demonology,29,13,16
Syndrielle,emerald-dream,1175,warlock,demonology,42,16,26
Artmaster,nordrassil,1174,warlock,demonology,30,20,10
Snuffer,detheroc,1164,warlock,demonology,30,13,17
Adistril,bleeding-hollow,1161,warlock,demonology,42,13,29
Voidxz,tichondrius,1152,warlock,demonology,18,12,6
Avery,mannoroth,1152,warlock,demonology,24,12,12
Medzor,tichondrius,1152,warlock,demonology,24,12,12
Blliizz,aegwynn,1151,warlock,demonology,18,12,6
Tazerr,sargeras,1151,warlock,demonology,24,12,12
Mongobros,illidan,1151,warlock,demonology,24,12,12
Lentil,zuljin,1150,warlock,demonology,18,12,6
Edzeá,frostmourne,1150,warlock,demonology,24,12,12
Chipt,kelthuzad,1149,warlock,demonology,30,12,18
Bosongo,boulderfist,1147,warlock,demonology,18,12,6
Theseance,dalaran,1147,warlock,demonology,24,12,12
Emperator,quelthalas,1146,warlock,demonology,22,13,9
Tickleskin,windrunner,1146,warlock,demonology,25,13,12
Nyhn,bleeding-hollow,1144,warlock,demonology,18,12,6
Critthis,illidan,1141,warlock,demonology,24,12,12
Helyana,illidan,1140,warlock,demonology,18,12,6
Saltiernuts,malganis,1128,warlock,demonology,48,22,26
Warlockafk,darkspear,1109,warlock,demonology,18,12,6
Löksöflöve,sargeras,1101,warlock,demonology,60,25,35
Politepvperx,kelthuzad,1070,warlock,demonology,17,12,5
Lilmollyboy,demon-soul,1068,warlock,demonology,13,12,1
Igortrikadva,zuljin,1056,warlock,demonology,12,11,1
Bøltqt,tichondrius,1056,warlock,demonology,12,11,1
Inmøtion,tichondrius,1056,warlock,demonology,18,11,7
Netherhigh,tichondrius,1056,warlock,demonology,36,17,19
Zzooxxqt,area-52,1056,warlock,demonology,24,11,13
Betterone,azralon,1055,warlock,demonology,18,11,7
Cendit,malganis,1055,warlock,demonology,18,11,7
Fotmspec,area-52,1055,warlock,demonology,18,11,7
Homeschooler,darkspear,1055,warlock,demonology,18,11,7
Comina,kelthuzad,1055,warlock,demonology,24,11,13
Praemonium,dalaran,1054,warlock,demonology,18,11,7
Greasymario,area-52,1053,warlock,demonology,18,11,7
Thelocker,stormrage,1051,warlock,demonology,18,11,7
Adlfcritler,emerald-dream,1049,warlock,demonology,18,11,7
Zinkro,quelthalas,1049,warlock,demonology,22,12,10
Tròll,moon-guard,1049,warlock,demonology,54,25,29
Moryan,malfurion,1049,warlock,demonology,27,12,15
Tartamuda,ragnaros,1037,warlock,demonology,30,11,19
Rickrock,gnomeregan,1034,warlock,demonology,18,11,7
Rannieck,dark-iron,1022,warlock,demonology,16,12,4
Kronii,jubeithos,1006,warlock,demonology,17,11,6
Lukelock,azralon,990,warlock,demonology,22,11,11
Celestialock,tichondrius,984,warlock,demonology,16,11,5
Mocreia,azralon,981,warlock,demonology,28,11,17
Thekook,illidan,971,warlock,demonology,25,12,13
Hecataeus,stormrage,960,warlock,demonology,12,10,2
Meltlordqt,mannoroth,960,warlock,demonology,12,10,2
Evianne,skywall,960,warlock,demonology,18,10,8
Idiocy,stormrage,960,warlock,demonology,18,10,8
Joung,tichondrius,960,warlock,demonology,18,10,8
Vexice,firetree,960,warlock,demonology,18,10,8
Millions,barthilas,960,warlock,demonology,24,10,14
Slothycrip,emerald-dream,960,warlock,demonology,30,10,20
Zrò,bleeding-hollow,959,warlock,demonology,12,10,2
Syraxi,illidan,959,warlock,demonology,18,10,8
Hâm,dalaran,959,warlock,demonology,36,10,26
Daesire,moon-guard,957,warlock,demonology,18,10,8
Lockswagger,stormrage,956,warlock,demonology,18,10,8
Zaintv,illidan,955,warlock,demonology,18,10,8
Leine,proudmoore,955,warlock,demonology,24,10,14
Methrocks,emerald-dream,953,warlock,demonology,24,10,14
Uzag,mugthol,949,warlock,demonology,24,10,14
Jojofann,nemesis,911,warlock,demonology,17,10,7
Tichondrus,ragnaros,911,warlock,demonology,23,10,13
Sheara,silver-hand,905,warlock,demonology,24,10,14
Twinklockxx,mannoroth,895,warlock,demonology,23,10,13
Apples,ravencrest,894,warlock,demonology,17,10,7
Douzz,frostmourne,864,warlock,demonology,12,9,3
Impenjoyer,tichondrius,864,warlock,demonology,12,9,3
Hellbraive,queldorei,864,warlock,demonology,12,9,3
Evanylock,proudmoore,864,warlock,demonology,18,9,9
Louu,emerald-dream,864,warlock,demonology,18,9,9
Bewær,deathwing,864,warlock,demonology,18,9,9
Dxhusky,tichondrius,864,warlock,demonology,18,9,9
Deboltzaru,ragnaros,864,warlock,demonology,19,9,10
Gulßad,tichondrius,863,warlock,demonology,12,9,3
Fatals,thrall,863,warlock,demonology,12,9,3
Jorloz,ragnaros,863,warlock,demonology,12,9,3
Ezgamejr,tichondrius,863,warlock,demonology,12,9,3
Criticalpets,stormrage,863,warlock,demonology,18,9,9
Skullsoul,arthas,863,warlock,demonology,18,9,9
Päpï,tichondrius,862,warlock,demonology,12,9,3
Harleyjames,ravenholdt,862,warlock,demonology,12,9,3
Kothoped,wyrmrest-accord,861,warlock,demonology,24,9,15
Oopsíe,nagrand,860,warlock,demonology,24,9,15
Braylon,azuremyst,856,warlock,demonology,18,9,9
Stankidanky,illidan,854,warlock,demonology,12,9,3
Kymochaos,sargeras,847,warlock,demonology,17,9,8
Orbvoid,sargeras,845,warlock,demonology,24,9,15
Demoniclily,kiljaeden,816,warlock,demonology,21,9,12
Haxtoss,stormrage,815,warlock,demonology,11,9,2
Yoyoling,illidan,794,warlock,demonology,19,10,9
Kotica,stormrage,781,warlock,demonology,16,9,7
Xanetor,illidan,768,warlock,demonology,12,8,4
Bigboltkazar,tichondrius,768,warlock,demonology,12,8,4
Saeph,burning-legion,768,warlock,demonology,12,8,4
Pvtpotato,tichondrius,768,warlock,demonology,12,8,4
Westhofs,sargeras,768,warlock,demonology,12,8,4
Marshyxd,tichondrius,768,warlock,demonology,12,8,4
Esdreel,ragnaros,768,warlock,demonology,12,8,4
Mukkamuk,shadowmoon,768,warlock,demonology,12,8,4
Gnumbnutz,blades-edge,768,warlock,demonology,12,8,4
Moramont,stormrage,768,warlock,demonology,12,8,4
Asmion,earthen-ring,768,warlock,demonology,12,8,4
Joseph,draktharon,768,warlock,demonology,18,8,10
Niava,tichondrius,768,warlock,demonology,18,8,10
Vasqu,stormrage,768,warlock,demonology,18,8,10
Nismo,trollbane,768,warlock,demonology,18,8,10
Bïcho,queldorei,768,warlock,demonology,18,8,10
Neutrinowal,tichondrius,768,warlock,demonology,24,8,16
Gibberishss,tichondrius,767,warlock,demonology,12,8,4
Regime,deathwing,767,warlock,demonology,12,8,4
Rosacrutian,tichondrius,767,warlock,demonology,12,8,4
Krumlax,thrall,767,warlock,demonology,12,8,4
Shâdowman,stormrage,767,warlock,demonology,12,8,4
Fullmelt,azjolnerub,767,warlock,demonology,18,8,10
Damerus,illidan,767,warlock,demonology,21,9,12
Boltsfordays,dalaran,767,warlock,demonology,24,8,16
Bojàck,stormrage,766,warlock,demonology,12,8,4
Nezsarek,sargeras,766,warlock,demonology,12,8,4
Elioknight,area-52,766,warlock,demonology,18,8,10
Sørceress,bonechewer,765,warlock,demonology,12,8,4
Lustyclam,tichondrius,765,warlock,demonology,12,8,4
Cvntpvntcans,kelthuzad,764,warlock,demonology,18,8,10
Pulentinskin,quelthalas,764,warlock,demonology,24,8,16
Es,velen,761,warlock,demonology,24,8,16
Eklypso,kelthuzad,714,warlock,demonology,20,9,11
Jweezy,malganis,672,warlock,demonology,12,7,5
Devilin,drakkari,672,warlock,demonology,12,7,5
Protomán,agamaggan,672,warlock,demonology,12,7,5
Deammon,tichondrius,672,warlock,demonology,12,7,5
Aruotnof,nemesis,672,warlock,demonology,12,7,5
Djvetis,blackhand,672,warlock,demonology,12,7,5
Xyguoguo,tichondrius,672,warlock,demonology,12,7,5
Løckyun,tichondrius,672,warlock,demonology,12,7,5
Løcalplugxø,barthilas,672,warlock,demonology,12,7,5
Demonmal,frostmourne,672,warlock,demonology,12,7,5
Agla,quelthalas,672,warlock,demonology,12,7,5
Sauronne,illidan,672,warlock,demonology,12,7,5
Sorenbjerga,zuljin,672,warlock,demonology,12,7,5
Dadtired,tichondrius,672,warlock,demonology,12,7,5
Lifeinsuranc,tichondrius,672,warlock,demonology,12,7,5
Bestcookies,malganis,672,warlock,demonology,12,7,5
Isömetrics,barthilas,672,warlock,demonology,12,7,5
Idoovoodoo,burning-legion,672,warlock,demonology,12,7,5
Daxxter,tichondrius,672,warlock,demonology,12,7,5
Evarona,gorefiend,672,warlock,demonology,18,7,11
Matrriixx,proudmoore,672,warlock,demonology,18,7,11
Ranil,mannoroth,672,warlock,demonology,18,7,11
Saldori,malganis,671,warlock,demonology,12,7,5
Glortheeb,spirestone,671,warlock,demonology,12,7,5
Pollodelight,deathwing,671,warlock,demonology,12,7,5
Celindeyn,stormrage,671,warlock,demonology,12,7,5
Nëcrophil,area-52,671,warlock,demonology,12,7,5
Zorah,quelthalas,671,warlock,demonology,12,7,5
Menedemus,amanthul,671,warlock,demonology,18,7,11
Dotsfired,crushridge,671,warlock,demonology,18,7,11
Varian,quelthalas,671,warlock,demonology,18,7,11
Deanwarlock,sargeras,670,warlock,demonology,12,7,5
Lokiiee,azuremyst,664,warlock,demonology,12,7,5
Tsmcfker,tichondrius,654,warlock,demonology,17,7,10
Voldamorte,tichondrius,639,warlock,demonology,17,7,10
Chlomakï,azralon,622,warlock,demonology,11,7,4
Chaosboltex,tichondrius,618,warlock,demonology,14,8,6
Phyxylock,stormrage,576,warlock,demonology,6,6,0
Nðm,tichondrius,576,warlock,demonology,6,6,0
Ritzhul,nordrassil,576,warlock,demonology,6,6,0
Lcomi,tichondrius,576,warlock,demonology,6,6,0
Warlockluo,tichondrius,576,warlock,demonology,12,6,6
Yaldin,nemesis,576,warlock,demonology,12,6,6
Hers,vashj,576,warlock,demonology,12,6,6
Seekma,gallywix,576,warlock,demonology,12,6,6
Destructio,tichondrius,576,warlock,demonology,12,6,6
Eddybigbolts,tichondrius,576,warlock,demonology,12,6,6
Marothredd,nathrezim,576,warlock,demonology,12,6,6
Sorath,blackrock,576,warlock,demonology,12,6,6
Aboode,blackrock,576,warlock,demonology,12,6,6
Scarletdemon,malganis,576,warlock,demonology,12,6,6
Epícburn,illidan,576,warlock,demonology,12,6,6
Jæja,wyrmrest-accord,576,warlock,demonology,12,6,6
Projectpump,kelthuzad,576,warlock,demonology,12,6,6
Chaosblade,burning-blade,576,warlock,demonology,12,6,6
Muchopower,ragnaros,576,warlock,demonology,12,6,6
Dalah,illidan,576,warlock,demonology,12,6,6
Antigotenent,sargeras,576,warlock,demonology,12,6,6
Davidofbowie,burning-legion,576,warlock,demonology,12,6,6
Kyralena,stormrage,576,warlock,demonology,12,6,6
Bellath,azralon,576,warlock,demonology,12,6,6
Zoerina,fizzcrank,576,warlock,demonology,12,6,6
Artzul,tichondrius,576,warlock,demonology,15,7,8
Dreadful,frostmourne,576,warlock,demonology,18,6,12
Shadowhax,area-52,576,warlock,demonology,18,6,12
Shadü,tichondrius,576,warlock,demonology,25,6,19
Voidgown,moon-guard,575,warlock,demonology,12,6,6
Sylvanes,emerald-dream,575,warlock,demonology,12,6,6
Xenagos,antonidas,575,warlock,demonology,12,6,6
Canning,shuhalo,575,warlock,demonology,18,6,12
Nécromonster,illidan,574,warlock,demonology,18,6,12
Undeadcurse,frostmourne,574,warlock,demonology,24,6,18
Westhøf,sargeras,543,warlock,demonology,11,6,5
Kronicdotz,bleeding-hollow,528,warlock,demonology,9,7,2
Penzer,stormrage,528,warlock,demonology,15,6,9
Creepydotman,mannoroth,511,warlock,demonology,14,6,8
Gigagnomer,kelthuzad,480,warlock,demonology,6,5,1
Tiatiatia,illidan,480,warlock,demonology,6,5,1
Sinixx,tichondrius,480,warlock,demonology,6,5,1
Floorlamp,anvilmar,480,warlock,demonology,6,5,1
Gavvi,frostmourne,480,warlock,demonology,6,5,1
Symplicìty,area-52,480,warlock,demonology,6,5,1
Necrotko,malganis,480,warlock,demonology,6,5,1
Séptima,illidan,480,warlock,demonology,6,5,1
Zehzet,area-52,480,warlock,demonology,6,5,1
Seutóóbinha,stormrage,480,warlock,demonology,6,5,1
Scalpelexis,stormrage,480,warlock,demonology,6,5,1
Aînzooalgown,ragnaros,480,warlock,demonology,6,5,1
Velrose,thrall,480,warlock,demonology,6,5,1
Zjxy,tichondrius,480,warlock,demonology,6,5,1
Drainedd,blades-edge,480,warlock,demonology,6,5,1
Zeexi,illidan,480,warlock,demonology,6,5,1
Igniz,tichondrius,480,warlock,demonology,6,5,1
Dodgebolts,khaz-modan,480,warlock,demonology,6,5,1
Ötì,altar-of-storms,480,warlock,demonology,6,5,1
Cidkagenou,sargeras,480,warlock,demonology,7,5,2
Mêdìvh,tichondrius,480,warlock,demonology,12,5,7
Breeak,sargeras,480,warlock,demonology,12,5,7
Dewandoritos,kelthuzad,480,warlock,demonology,12,5,7
Wheremyshoes,area-52,480,warlock,demonology,12,5,7
Liuh,tichondrius,480,warlock,demonology,12,5,7
Søcks,tichondrius,480,warlock,demonology,12,5,7
Tubarão,azralon,480,warlock,demonology,12,5,7
Sinápsís,ragnaros,480,warlock,demonology,12,5,7
Rumpology,illidan,480,warlock,demonology,12,5,7
Dapperdanxy,tichondrius,480,warlock,demonology,12,5,7
Zarinista,veknilash,480,warlock,demonology,12,5,7
Tribulatiön,moon-guard,480,warlock,demonology,12,5,7
Mânuel,akama,480,warlock,demonology,12,5,7
Alataar,sargeras,480,warlock,demonology,12,5,7
Rooms,sargeras,480,warlock,demonology,12,5,7
Yungwilly,silvermoon,480,warlock,demonology,12,5,7
Grandpapapa,tichondrius,480,warlock,demonology,12,5,7
Grineed,emerald-dream,480,warlock,demonology,12,5,7
Gandreleda,wyrmrest-accord,480,warlock,demonology,16,6,10
Paleontology,moon-guard,480,warlock,demonology,14,5,9
Stinkmeaner,chogall,479,warlock,demonology,12,5,7
Yury,scarlet-crusade,479,warlock,demonology,12,5,7
Omegawarlock,quelthalas,479,warlock,demonology,18,5,13
Sathorastus,spirestone,448,warlock,demonology,10,6,4
Bâppo,antonidas,426,warlock,demonology,14,7,7
Agaros,zuljin,426,warlock,demonology,17,6,11
Rosalynda,azralon,398,warlock,demonology,10,5,5
Peterdotz,whisperwind,384,warlock,demonology,6,4,2
Curpt,the-scryers,384,warlock,demonology,6,4,2
Xekk,wyrmrest-accord,384,warlock,demonology,6,4,2
Brujever,ragnaros,384,warlock,demonology,6,4,2
Mazzaleen,area-52,384,warlock,demonology,6,4,2
Alchan,tichondrius,384,warlock,demonology,6,4,2
Thefunk,tichondrius,384,warlock,demonology,6,4,2
Deatthmoon,stormrage,384,warlock,demonology,6,4,2
Lambe,tichondrius,384,warlock,demonology,6,4,2
Menemies,malganis,384,warlock,demonology,6,4,2
Bellatriks,nemesis,384,warlock,demonology,6,4,2
Viejitaa,quelthalas,384,warlock,demonology,6,4,2
Frustration,darkspear,384,warlock,demonology,6,4,2
Oniyooshi,kelthuzad,384,warlock,demonology,6,4,2
Il,nerzhul,384,warlock,demonology,6,4,2
Syndel,drakkari,384,warlock,demonology,6,4,2
Coomerdoomer,stormrage,384,warlock,demonology,6,4,2
Quonton,tichondrius,384,warlock,demonology,6,4,2
Kernlberton,tichondrius,384,warlock,demonology,6,4,2
Drix,wyrmrest-accord,384,warlock,demonology,6,4,2
Meelady,tichondrius,384,warlock,demonology,6,4,2
Ardam,cenarion-circle,384,warlock,demonology,6,4,2
Hordefella,malganis,384,warlock,demonology,6,4,2
Vesaloth,zuljin,384,warlock,demonology,6,4,2
Ethero,emerald-dream,384,warlock,demonology,6,4,2
Omertà,staghelm,384,warlock,demonology,6,4,2
Bigmancam,illidan,384,warlock,demonology,6,4,2
Rodneyjones,emerald-dream,384,warlock,demonology,6,4,2
Conjur,barthilas,384,warlock,demonology,6,4,2
Meep,madoran,384,warlock,demonology,6,4,2
Twototheone,illidan,384,warlock,demonology,6,4,2
Fokâi,sargeras,384,warlock,demonology,6,4,2
Bashel,sargeras,384,warlock,demonology,6,4,2
Eflock,barthilas,384,warlock,demonology,6,4,2
Mssy,illidan,384,warlock,demonology,6,4,2
Moräl,frostmourne,384,warlock,demonology,6,4,2
Dashaad,illidan,384,warlock,demonology,6,4,2
Nerolock,frostmourne,384,warlock,demonology,6,4,2
Hélà,sargeras,384,warlock,demonology,6,4,2
Salaszar,illidan,384,warlock,demonology,6,4,2
Metic,firetree,384,warlock,demonology,6,4,2
Kyrionn,azralon,384,warlock,demonology,6,4,2
Logixo,sargeras,384,warlock,demonology,7,4,3
Warlooch,area-52,384,warlock,demonology,9,5,4
Woudini,malganis,384,warlock,demonology,10,5,5
Ddorangmoon,tichondrius,384,warlock,demonology,12,4,8
Puchador,sargeras,384,warlock,demonology,12,4,8
Diekast,tichondrius,384,warlock,demonology,12,4,8
Dogcookie,moon-guard,384,warlock,demonology,12,4,8
Jezzika,azralon,384,warlock,demonology,12,4,8
Naydene,moon-guard,384,warlock,demonology,12,4,8
Tahmrin,quelthalas,384,warlock,demonology,12,4,8
Dagadon,arathor,384,warlock,demonology,12,4,8
Pìnto,illidan,384,warlock,demonology,12,4,8
Naz,shadowsong,384,warlock,demonology,12,4,8
Srz,stormrage,384,warlock,demonology,12,4,8
Soulrman,tichondrius,384,warlock,demonology,12,4,8
Uarus,tichondrius,384,warlock,demonology,12,4,8
Arckádia,stormrage,384,warlock,demonology,12,4,8
Arsaurelica,blackrock,384,warlock,demonology,12,4,8
Nefertarie,illidan,384,warlock,demonology,12,4,8
Ven,dalaran,384,warlock,demonology,12,4,8
Deatt,deathwing,384,warlock,demonology,12,4,8
Warlack,jubeithos,384,warlock,demonology,12,4,8
Çheesestick,dalaran,384,warlock,demonology,12,4,8
Xoxoxu,frostmourne,384,warlock,demonology,12,4,8
Ragnalock,laughing-skull,384,warlock,demonology,14,4,10
Tofulery,tichondrius,384,warlock,demonology,18,4,14
Greems,tichondrius,383,warlock,demonology,6,4,2
Voodootidies,proudmoore,382,warlock,demonology,9,4,5
Freshimps,blood-furnace,367,warlock,demonology,11,4,7
Sharee,azuremyst,363,warlock,demonology,11,4,7
Ärminvßuurën,barthilas,351,warlock,demonology,11,4,7
Minichompei,frostmourne,319,warlock,demonology,5,4,1
Sumondeznuts,wyrmrest-accord,319,warlock,demonology,5,4,1
Naokishi,stormrage,288,warlock,demonology,6,3,3
Graveland,frostwolf,288,warlock,demonology,6,3,3
Feartool,stormrage,288,warlock,demonology,6,3,3
Gotty,stormrage,288,warlock,demonology,6,3,3
Darthael,stormrage,288,warlock,demonology,6,3,3
Tynks,mannoroth,288,warlock,demonology,6,3,3
Kogath,thunderlord,288,warlock,demonology,6,3,3
Disgustingfk,illidan,288,warlock,demonology,6,3,3
Domwarlock,uther,288,warlock,demonology,6,3,3
Diebydots,blackrock,288,warlock,demonology,6,3,3
Leonito,tichondrius,288,warlock,demonology,6,3,3
Pikslol,bleeding-hollow,288,warlock,demonology,6,3,3
Psyløck,bleeding-hollow,288,warlock,demonology,6,3,3
Lamdyn,moon-guard,288,warlock,demonology,6,3,3
Molguzano,ragnaros,288,warlock,demonology,6,3,3
Neruvian,tichondrius,288,warlock,demonology,6,3,3
Capslock,arthas,288,warlock,demonology,6,3,3
Bral,hyjal,288,warlock,demonology,6,3,3
Khatrat,azralon,288,warlock,demonology,6,3,3
Fëlgibson,illidan,288,warlock,demonology,6,3,3
Schrader,sargeras,288,warlock,demonology,6,3,3
Zanlockos,dalaran,288,warlock,demonology,6,3,3
Nockdreal,azralon,288,warlock,demonology,6,3,3
Whydemono,tichondrius,288,warlock,demonology,6,3,3
Elementzero,malorne,288,warlock,demonology,6,3,3
Ðemented,bleeding-hollow,288,warlock,demonology,6,3,3
Archleon,smolderthorn,288,warlock,demonology,6,3,3
Juankkii,bonechewer,288,warlock,demonology,6,3,3
Drelgun,aerie-peak,288,warlock,demonology,6,3,3
Criptix,bleeding-hollow,288,warlock,demonology,6,3,3
Locksoul,area-52,288,warlock,demonology,6,3,3
Lockinha,azralon,288,warlock,demonology,6,3,3
Asmodeun,malganis,288,warlock,demonology,6,3,3
Poggun,tichondrius,288,warlock,demonology,6,3,3
Faraday,laughing-skull,288,warlock,demonology,6,3,3
Demonia,dathremar,288,warlock,demonology,6,3,3
Azland,proudmoore,288,warlock,demonology,6,3,3
Deadlylock,gilneas,288,warlock,demonology,6,3,3
Munick,spirestone,288,warlock,demonology,6,3,3
Asiopdu,tichondrius,288,warlock,demonology,6,3,3
Nipz,korialstrasz,288,warlock,demonology,6,3,3
Itzlandox,emerald-dream,288,warlock,demonology,6,3,3
Ðamndaddy,sargeras,288,warlock,demonology,6,3,3
Soulruler,tichondrius,288,warlock,demonology,6,3,3
Lilthicy,sargeras,288,warlock,demonology,6,3,3
Rumjugs,barthilas,288,warlock,demonology,6,3,3
Keezus,area-52,288,warlock,demonology,6,3,3
Superbroly,area-52,288,warlock,demonology,6,3,3
Jennifear,sargeras,288,warlock,demonology,6,3,3
Lhordeign,area-52,288,warlock,demonology,6,3,3
Sangala,malganis,288,warlock,demonology,6,3,3
Guldylox,kiljaeden,288,warlock,demonology,6,3,3
Nightterrour,frostmourne,288,warlock,demonology,6,3,3
Zhul,nerzhul,288,warlock,demonology,6,3,3
Sooshi,malganis,288,warlock,demonology,6,3,3
Lefteexd,tichondrius,288,warlock,demonology,6,3,3
Khamzatt,proudmoore,288,warlock,demonology,6,3,3
Drerrday,kelthuzad,288,warlock,demonology,6,3,3
Hauntsin,hyjal,288,warlock,demonology,6,3,3
Agonie,tichondrius,288,warlock,demonology,6,3,3
Areolaz,kelthuzad,288,warlock,demonology,6,3,3
Hgma,tichondrius,288,warlock,demonology,6,3,3
Crtyodautr,skullcrusher,288,warlock,demonology,6,3,3
Iamfear,shuhalo,288,warlock,demonology,6,3,3
Saffuky,frostmourne,288,warlock,demonology,6,3,3
Okul,frostmourne,288,warlock,demonology,6,3,3
Fatuglyegirl,sargeras,288,warlock,demonology,6,3,3
Imbooms,blackrock,288,warlock,demonology,6,3,3
Crispee,azuremyst,288,warlock,demonology,12,3,9
Killvilock,kelthuzad,288,warlock,demonology,12,3,9
Dàmagicman,drakthul,288,warlock,demonology,12,3,9
Wineburger,frostmourne,288,warlock,demonology,12,3,9
Albbanoo,tichondrius,288,warlock,demonology,12,3,9
Constantine,exodar,288,warlock,demonology,12,3,9
Strax,shattered-hand,288,warlock,demonology,12,3,9
Kwrhitom,zuljin,288,warlock,demonology,12,3,9
Nostractus,azralon,287,warlock,demonology,6,3,3
Ijustsharded,area-52,255,warlock,demonology,11,3,8
Ceeloww,illidan,239,warlock,demonology,5,3,2
Slugworth,rivendare,239,warlock,demonology,5,3,2
Quetzâlcoâtl,sargeras,239,warlock,demonology,5,3,2
Uwantpeach,tichondrius,239,warlock,demonology,5,3,2
Bänno,bleeding-hollow,239,warlock,demonology,5,3,2
Frankandbean,dawnbringer,234,warlock,demonology,7,4,3
Predictions,sargeras,234,warlock,demonology,10,5,5
Apøçàlÿpsè,firetree,234,warlock,demonology,11,5,6
Schofen,tichondrius,234,warlock,demonology,13,4,9
Cocoabuttâ,stormrage,192,warlock,demonology,4,3,1
Javirr,ragnaros,192,warlock,demonology,15,5,10
Kaertis,emerald-dream,192,warlock,demonology,9,3,6
Felforyouu,illidan,192,warlock,demonology,6,2,4
Cursedkash,stormrage,192,warlock,demonology,6,2,4
Lilbiackguy,stormrage,192,warlock,demonology,6,2,4
Xblessed,stormrage,192,warlock,demonology,6,2,4
Sakyameil,area-52,192,warlock,demonology,6,2,4
Dedology,area-52,192,warlock,demonology,6,2,4
Nanicide,kelthuzad,192,warlock,demonology,6,2,4
Griffoz,frostwolf,192,warlock,demonology,6,2,4
Watchmeport,onyxia,192,warlock,demonology,6,2,4
Knobbynobbas,stormrage,192,warlock,demonology,6,2,4
Feardr,frostmourne,192,warlock,demonology,6,2,4
Buboñic,area-52,192,warlock,demonology,6,2,4
Darkboltz,area-52,192,warlock,demonology,6,2,4
Wearelegionx,frostmourne,192,warlock,demonology,6,2,4
Firemike,kelthuzad,192,warlock,demonology,6,2,4
Warfeen,malganis,192,warlock,demonology,6,2,4
Infecçäo,stormrage,192,warlock,demonology,6,2,4
Sinissa,ysondre,192,warlock,demonology,6,2,4
Sheshð,stormrage,192,warlock,demonology,6,2,4
Reckzet,stormrage,192,warlock,demonology,6,2,4
Ziroken,crushridge,192,warlock,demonology,6,2,4
Qic,runetotem,192,warlock,demonology,6,2,4
Caesis,illidan,192,warlock,demonology,6,2,4
Irene,nagrand,192,warlock,demonology,6,2,4
Medallok,laughing-skull,192,warlock,demonology,6,2,4
Demic,thrall,192,warlock,demonology,6,2,4
Maroth,elune,192,warlock,demonology,6,2,4
Expiredonion,bleeding-hollow,192,warlock,demonology,6,2,4
Stuffs,wyrmrest-accord,192,warlock,demonology,6,2,4
Boon,spirestone,192,warlock,demonology,6,2,4
Ggaayyooii,anubarak,192,warlock,demonology,6,2,4
Zerowarlock,stormrage,192,warlock,demonology,6,2,4
Koffay,bleeding-hollow,192,warlock,demonology,6,2,4
Trippednfel,stormrage,192,warlock,demonology,6,2,4
Easymac,thunderlord,192,warlock,demonology,6,2,4
Rokdas,area-52,192,warlock,demonology,6,2,4
Feldotz,illidan,192,warlock,demonology,6,2,4
Draindeez,sargeras,192,warlock,demonology,6,2,4
Zevoc,tichondrius,192,warlock,demonology,6,2,4
Borudo,thrall,192,warlock,demonology,6,2,4
Ragdoll,illidan,192,warlock,demonology,6,2,4
Greenbeanzs,tichondrius,192,warlock,demonology,6,2,4
Hentailust,kiljaeden,192,warlock,demonology,6,2,4
Capïrota,nemesis,192,warlock,demonology,6,2,4
Brough,illidan,192,warlock,demonology,6,2,4
Kaosqt,nemesis,192,warlock,demonology,6,2,4
Evilempire,sargeras,192,warlock,demonology,6,2,4
Doomtome,moon-guard,192,warlock,demonology,6,2,4
Sphîñx,sargeras,192,warlock,demonology,6,2,4
Ceelowtf,sargeras,192,warlock,demonology,6,2,4
Promancer,drakkari,192,warlock,demonology,6,2,4
Vendareth,earthen-ring,192,warlock,demonology,6,2,4
Barbieelf,sargeras,192,warlock,demonology,6,2,4
Zalissel,proudmoore,192,warlock,demonology,6,2,4
Xuker,tichondrius,192,warlock,demonology,6,2,4
Draino,tichondrius,192,warlock,demonology,6,2,4
Wreckquiem,draka,192,warlock,demonology,6,2,4
Eternitty,nemesis,192,warlock,demonology,6,2,4
Yuckytoetoe,emerald-dream,192,warlock,demonology,6,2,4
Rôsé,tichondrius,192,warlock,demonology,6,2,4
Destructo,illidan,192,warlock,demonology,6,2,4
Anukh,emerald-dream,192,warlock,demonology,6,2,4
Daliadark,sargeras,192,warlock,demonology,6,2,4
Malegnant,proudmoore,192,warlock,demonology,6,2,4
Soulbane,tol-barad,192,warlock,demonology,6,2,4
Geauxst,tichondrius,192,warlock,demonology,6,2,4
Drkdestro,boulderfist,192,warlock,demonology,12,2,10
Timerad,maelstrom,192,warlock,demonology,14,2,12
Tunacanthicc,moon-guard,159,warlock,demonology,5,2,3
Jafi,coilfang,159,warlock,demonology,5,2,3
Wårloçk,tichondrius,159,warlock,demonology,5,2,3
Gartlarrey,daggerspine,158,warlock,demonology,14,3,11
Cslice,magtheridon,128,warlock,demonology,4,2,2
Tazlock,blackrock,128,warlock,demonology,10,2,8
Tonyxx,tichondrius,96,warlock,demonology,6,1,5
Malzahard,ragnaros,96,warlock,demonology,6,1,5
Overlard,illidan,96,warlock,demonology,6,1,5
Bmó,stormrage,96,warlock,demonology,6,1,5
Yora,illidan,96,warlock,demonology,6,1,5
Ñinelyfe,frostmourne,96,warlock,demonology,6,1,5
Borthrel,moon-guard,96,warlock,demonology,6,1,5
Erimegara,ragnaros,96,warlock,demonology,6,1,5
Xalithra,moon-guard,96,warlock,demonology,6,1,5
Thugpenus,frostmane,96,warlock,demonology,6,1,5
Nùts,frostmourne,96,warlock,demonology,6,1,5
Shortbuhz,tichondrius,96,warlock,demonology,6,1,5
Flangy,kiljaeden,96,warlock,demonology,6,1,5
Varvanta,proudmoore,96,warlock,demonology,6,1,5
Isthismeta,tichondrius,96,warlock,demonology,6,1,5
Halloweèn,kelthuzad,96,warlock,demonology,6,1,5
Shadococo,tichondrius,96,warlock,demonology,6,1,5
Uggaboogga,malganis,96,warlock,demonology,6,1,5
Oreo,velen,96,warlock,demonology,6,1,5
Zíppen,proudmoore,96,warlock,demonology,6,1,5
Kajayak,nazjatar,96,warlock,demonology,6,1,5
Solöw,tichondrius,96,warlock,demonology,6,1,5
Laklin,stormscale,96,warlock,demonology,6,1,5
Fashon,barthilas,96,warlock,demonology,6,1,5
Bilidin,azralon,96,warlock,demonology,6,1,5
Hâunted,khazgoroth,96,warlock,demonology,6,1,5
Sidiouss,dreadmaul,96,warlock,demonology,6,1,5
Hsxcx,stonemaul,96,warlock,demonology,6,1,5
Fearedit,bleeding-hollow,96,warlock,demonology,6,1,5
Osteogenesis,quelthalas,96,warlock,demonology,6,1,5
Nameflagged,arathor,96,warlock,demonology,6,1,5
Sinful,darkspear,96,warlock,demonology,6,1,5
Damdochael,bleeding-hollow,96,warlock,demonology,6,1,5
Quinsnyder,zuljin,96,warlock,demonology,6,1,5
Amauder,moon-guard,96,warlock,demonology,6,1,5
Skured,maiev,96,warlock,demonology,6,1,5
Velondris,illidan,96,warlock,demonology,6,1,5
Badstepbro,sargeras,96,warlock,demonology,6,1,5
Glizzÿ,thrall,96,warlock,demonology,6,1,5
Jazzycj,bleeding-hollow,96,warlock,demonology,6,1,5
Rylal,illidan,96,warlock,demonology,6,1,5
Eriss,exodar,96,warlock,demonology,6,1,5
Decrepticus,kargath,96,warlock,demonology,6,1,5
Fluximilian,azralon,96,warlock,demonology,7,1,6
Vèigarr,frostmourne,96,warlock,demonology,9,1,8
Kecca,azralon,96,warlock,demonology,15,1,14
Mamabolts,kelthuzad,79,warlock,demonology,5,1,4
Shaurial,zuljin,48,warlock,demonology,3,1,2
Locksyy,tichondrius,31,warlock,demonology,2,1,1
Warlow,mugthol,31,warlock,demonology,8,1,7
Camila,lightnings-blade,16,warlock,demonology,1,1,0
Voidchaos,whisperwind,2335,warlock,destruction,184,103,81
Reverence,tichondrius,2283,warlock,destruction,101,64,37
Mengqil,tichondrius,2267,warlock,destruction,114,64,50
Singleaf,stormrage,2255,warlock,destruction,98,57,41
Locean,tichondrius,2224,warlock,destruction,94,56,38
Demonicxs,area-52,2211,warlock,destruction,101,56,45
Drexia,tichondrius,2208,warlock,destruction,54,41,13
Hahahahahha,stormrage,2187,warlock,destruction,71,44,27
Warzog,wyrmrest-accord,2186,warlock,destruction,78,49,29
Kamohoalii,bleeding-hollow,2181,warlock,destruction,72,46,26
Dannyl,tichondrius,2178,warlock,destruction,60,41,19
Nos,bleeding-hollow,2170,warlock,destruction,70,43,27
Diabolicalz,sargeras,2169,warlock,destruction,93,52,41
Nosw,bleeding-hollow,2167,warlock,destruction,72,43,29
Søülætër,bleeding-hollow,2161,warlock,destruction,66,42,24
Mcdudebro,malganis,2160,warlock,destruction,60,40,20
Ihavestds,tichondrius,2158,warlock,destruction,60,35,25
Impenjoyer,tichondrius,2154,warlock,destruction,66,41,25
Playßøy,area-52,2154,warlock,destruction,78,45,33
Jonboyy,illidan,2154,warlock,destruction,96,51,45
Truetime,tichondrius,2147,warlock,destruction,84,46,38
Woahlock,thrall,2146,warlock,destruction,64,40,24
Ihatemyson,tichondrius,2144,warlock,destruction,59,33,26
Ellynaria,nemesis,2142,warlock,destruction,78,51,27
Sarcophagus,duskwood,2142,warlock,destruction,108,58,50
Tomatobob,thrall,2136,warlock,destruction,84,44,40
Igortrikadva,zuljin,2135,warlock,destruction,72,43,29
Mclovn,suramar,2135,warlock,destruction,101,57,44
Leredi,stormrage,2135,warlock,destruction,146,78,68
Yifaruhún,illidan,2132,warlock,destruction,78,58,20
Deideimeow,illidan,2130,warlock,destruction,65,42,23
Darthael,stormrage,2130,warlock,destruction,188,112,76
Drâkedog,illidan,2128,warlock,destruction,66,38,28
Medzor,tichondrius,2128,warlock,destruction,93,53,40
Loopsy,stormrage,2126,warlock,destruction,115,64,51
Sockems,guldan,2125,warlock,destruction,90,51,39
Demonman,kirin-tor,2124,warlock,destruction,72,41,31
Dodgeykun,khaz-modan,2123,warlock,destruction,83,53,30
Rizzard,lightnings-blade,2123,warlock,destruction,107,64,43
Zyzx,malganis,2120,warlock,destruction,59,37,22
Hudwinx,illidan,2119,warlock,destruction,78,47,31
Drakedogee,illidan,2119,warlock,destruction,66,35,31
Bananapan,tichondrius,2116,warlock,destruction,66,44,22
Dyenamik,stormrage,2116,warlock,destruction,65,36,29
Usurpest,bleeding-hollow,2114,warlock,destruction,79,50,29
Dean,frostmourne,2111,warlock,destruction,66,33,33
Alucarduo,emerald-dream,2110,warlock,destruction,72,39,33
Ghoul,demon-soul,2109,warlock,destruction,60,35,25
Mjn,tichondrius,2107,warlock,destruction,100,51,49
Stingzz,azralon,2106,warlock,destruction,61,38,23
Chaosboltex,tichondrius,2106,warlock,destruction,72,41,31
Pillçosby,bleeding-hollow,2106,warlock,destruction,139,71,68
Babyaga,illidan,2106,warlock,destruction,85,42,43
Xavier,wyrmrest-accord,2105,warlock,destruction,87,50,37
Jcm,hyjal,2104,warlock,destruction,59,41,18
Dottle,frostmourne,2104,warlock,destruction,66,39,27
Dae,burning-legion,2103,warlock,destruction,59,38,21
Bufflockmore,tichondrius,2103,warlock,destruction,112,62,50
Kaytoxic,tichondrius,2103,warlock,destruction,72,39,33
Ohmend,thrall,2102,warlock,destruction,69,45,24
Disembolt,illidan,2102,warlock,destruction,66,41,25
Rainbowdate,tichondrius,2101,warlock,destruction,36,29,7
Implify,tichondrius,2101,warlock,destruction,142,73,69
Nvlnx,tichondrius,2096,warlock,destruction,95,55,40
Kruxxqt,illidan,2096,warlock,destruction,251,135,116
Gimmeprecog,tichondrius,2091,warlock,destruction,62,38,24
Dxxz,tichondrius,2089,warlock,destruction,85,47,38
Thugonomicz,demon-soul,2071,warlock,destruction,54,37,17
Quinsnyder,zuljin,2071,warlock,destruction,186,94,92
Butterboyx,stormrage,2068,warlock,destruction,77,46,31
Thumperrz,frostmourne,2068,warlock,destruction,71,37,34
Luvana,kelthuzad,2066,warlock,destruction,65,42,23
Demofire,tichondrius,2063,warlock,destruction,63,39,24
Idotû,tichondrius,2063,warlock,destruction,161,87,74
Mazewl,illidan,2062,warlock,destruction,93,63,30
Vapeboi,bleeding-hollow,2060,warlock,destruction,54,33,21
Insanetroll,stormrage,2059,warlock,destruction,66,46,20
Etuskaa,tichondrius,2056,warlock,destruction,78,46,32
Revenid,tichondrius,2049,warlock,destruction,72,42,30
Slantsix,tichondrius,2049,warlock,destruction,72,40,32
Colombø,gallywix,2048,warlock,destruction,140,74,66
Breeped,tichondrius,2044,warlock,destruction,108,68,40
Foresthills,sargeras,2044,warlock,destruction,96,50,46
Uwantpeach,tichondrius,2043,warlock,destruction,46,34,12
Hàrrydotter,darkspear,2041,warlock,destruction,58,36,22
Horror,moon-guard,2041,warlock,destruction,75,35,40
Brainless,tichondrius,2040,warlock,destruction,109,66,43
Cux,malganis,2038,warlock,destruction,78,40,38
Sinápsís,ragnaros,2035,warlock,destruction,54,36,18
Cc,hellscream,2035,warlock,destruction,114,75,39
Kaidow,tichondrius,2033,warlock,destruction,78,50,28
Instabilityx,tichondrius,2028,warlock,destruction,71,42,29
Audition,ragnaros,2026,warlock,destruction,90,47,43
Usainboltzz,tichondrius,2017,warlock,destruction,42,32,10
Duukka,malganis,2015,warlock,destruction,96,53,43
Truenatestes,proudmoore,2012,warlock,destruction,59,33,26
Ðlrwêcïûj,stormrage,2009,warlock,destruction,48,34,14
Napiersdot,tichondrius,2009,warlock,destruction,72,39,33
Epícburn,illidan,1996,warlock,destruction,30,21,9
Darkmagicc,tichondrius,1995,warlock,destruction,96,48,48
Äran,azralon,1992,warlock,destruction,48,28,20
Scørrgx,azralon,1990,warlock,destruction,66,34,32
Albbanoo,tichondrius,1985,warlock,destruction,137,73,64
Kyranu,tichondrius,1984,warlock,destruction,97,52,45
Deadlpoo,stormscale,1984,warlock,destruction,154,81,73
Tacobelf,magtheridon,1980,warlock,destruction,129,73,56
Zhul,nerzhul,1979,warlock,destruction,63,40,23
Fotmspec,area-52,1976,warlock,destruction,66,46,20
Dazu,illidan,1972,warlock,destruction,95,51,44
Zeari,sargeras,1972,warlock,destruction,109,55,54
Calvarr,bleeding-hollow,1970,warlock,destruction,77,45,32
Butteredbun,stormrage,1969,warlock,destruction,90,54,36
Salanzø,bleeding-hollow,1965,warlock,destruction,54,31,23
Mizmagius,moon-guard,1965,warlock,destruction,65,31,34
Reneqtxo,frostmourne,1964,warlock,destruction,86,59,27
Boltsnhoes,illidan,1961,warlock,destruction,78,46,32
Blackyeonnam,tichondrius,1959,warlock,destruction,86,46,40
Hrrpeuh,zuljin,1959,warlock,destruction,76,38,38
Pernicious,bladefist,1959,warlock,destruction,167,81,86
Lopenx,korgath,1957,warlock,destruction,122,64,58
Ztlivid,area-52,1956,warlock,destruction,60,41,19
Seangnong,tichondrius,1953,warlock,destruction,54,34,20
Freddiewill,tichondrius,1953,warlock,destruction,96,60,36
Panna,tichondrius,1948,warlock,destruction,173,90,83
Kyrmax,malganis,1946,warlock,destruction,96,52,44
Heckindoggø,tichondrius,1945,warlock,destruction,57,34,23
Slipnslide,malganis,1944,warlock,destruction,48,31,17
Rakshama,chogall,1944,warlock,destruction,45,26,19
Xertling,sargeras,1941,warlock,destruction,55,38,17
Nightmanx,sargeras,1941,warlock,destruction,53,31,22
Nðm,tichondrius,1939,warlock,destruction,102,50,52
Zyltan,tichondrius,1938,warlock,destruction,36,25,11
Isodjdojk,sargeras,1938,warlock,destruction,58,34,24
Balveer,tichondrius,1937,warlock,destruction,35,21,14
Abrocket,alleria,1931,warlock,destruction,59,33,26
Destroyy,greymane,1930,warlock,destruction,48,28,20
Sourslock,shadowsong,1929,warlock,destruction,72,44,28
Beegbeechy,nesingwary,1929,warlock,destruction,72,41,31
Chaosjedi,stormrage,1928,warlock,destruction,83,44,39
Archimondee,rivendare,1928,warlock,destruction,84,42,42
Felfeels,area-52,1926,warlock,destruction,54,33,21
Yuoalx,tichondrius,1922,warlock,destruction,72,38,34
Kaelith,kelthuzad,1920,warlock,destruction,103,53,50
Deathair,tichondrius,1918,warlock,destruction,54,31,23
Shadowhax,area-52,1918,warlock,destruction,90,47,43
Mayelinvail,moon-guard,1917,warlock,destruction,72,41,31
Benafflockz,kelthuzad,1913,warlock,destruction,65,41,24
Vileröze,zuljin,1909,warlock,destruction,72,40,32
Heresucacok,frostmourne,1908,warlock,destruction,30,20,10
Turiggyjr,tichondrius,1908,warlock,destruction,59,33,26
Forestfruit,tichondrius,1907,warlock,destruction,36,23,13
Dreadful,frostmourne,1907,warlock,destruction,81,49,32
Whatisthis,tichondrius,1906,warlock,destruction,36,20,16
Yoyoyosup,stormrage,1905,warlock,destruction,48,32,16
Ribman,stormrage,1905,warlock,destruction,54,27,27
Hellsparks,malganis,1903,warlock,destruction,48,29,19
Koitis,tichondrius,1901,warlock,destruction,38,25,13
Laiquisha,zuljin,1900,warlock,destruction,49,29,20
Ozmat,spirestone,1900,warlock,destruction,36,20,16
Amez,grizzly-hills,1900,warlock,destruction,60,33,27
Tott,hellscream,1898,warlock,destruction,50,26,24
Scatz,sargeras,1897,warlock,destruction,36,33,3
Fingerslock,malganis,1897,warlock,destruction,102,52,50
Maadhum,illidan,1894,warlock,destruction,72,32,40
Belandyr,stormrage,1893,warlock,destruction,36,20,16
Stilltrilly,tichondrius,1892,warlock,destruction,36,25,11
Sitomey,emerald-dream,1892,warlock,destruction,54,33,21
Eggós,sargeras,1888,warlock,destruction,156,81,75
Sonlyc,tichondrius,1886,warlock,destruction,66,33,33
Genzy,tichondrius,1885,warlock,destruction,102,49,53
Madthelock,sargeras,1884,warlock,destruction,42,20,22
Warcalk,stormrage,1882,warlock,destruction,60,37,23
Vexe,tichondrius,1880,warlock,destruction,38,29,9
Humanwarlock,spirestone,1879,warlock,destruction,57,32,25
Latchlock,malganis,1877,warlock,destruction,102,62,40
Chaosbolt,bloodhoof,1876,warlock,destruction,54,31,23
Tommybahama,velen,1875,warlock,destruction,64,39,25
Roxmysox,darkspear,1875,warlock,destruction,84,43,41
Pikslol,bleeding-hollow,1874,warlock,destruction,48,27,21
Ignorai,illidan,1874,warlock,destruction,118,66,52
Warlockwars,amanthul,1874,warlock,destruction,166,83,83
Dottcha,blackrock,1873,warlock,destruction,84,45,39
Zarinista,veknilash,1872,warlock,destruction,73,38,35
Twinklockxx,mannoroth,1872,warlock,destruction,143,66,77
Hommer,tichondrius,1870,warlock,destruction,57,34,23
Alchandil,tichondrius,1868,warlock,destruction,36,26,10
Amazingamez,sargeras,1867,warlock,destruction,72,39,33
Dustywlx,area-52,1865,warlock,destruction,74,45,29
Pheadas,deathwing,1865,warlock,destruction,42,20,22
Painful,mannoroth,1863,warlock,destruction,84,52,32
Tonyxx,tichondrius,1863,warlock,destruction,88,47,41
Sweatystain,tichondrius,1862,warlock,destruction,58,36,22
Drakwlya,tichondrius,1859,warlock,destruction,48,30,18
Luhgëek,tichondrius,1856,warlock,destruction,47,29,18
Amgs,frostmourne,1855,warlock,destruction,101,55,46
Soulrulerxc,tichondrius,1854,warlock,destruction,42,27,15
Maggotworm,sargeras,1854,warlock,destruction,129,80,49
Darksummoner,kaelthas,1853,warlock,destruction,84,46,38
Immolate,eitrigg,1852,warlock,destruction,48,29,19
Drugmuffin,tichondrius,1852,warlock,destruction,48,28,20
Milkdrunk,blackrock,1852,warlock,destruction,119,61,58
Eqx,illidan,1851,warlock,destruction,54,31,23
Mistrnesbitt,malganis,1850,warlock,destruction,48,25,23
Whodatman,illidan,1849,warlock,destruction,36,27,9
Synkz,blood-furnace,1849,warlock,destruction,42,24,18
Threeinches,kelthuzad,1848,warlock,destruction,158,94,64
Mycelium,greymane,1848,warlock,destruction,34,20,14
Wwlock,area-52,1847,warlock,destruction,110,57,53
Dotorama,sargeras,1846,warlock,destruction,41,30,11
Brazlem,blackrock,1846,warlock,destruction,49,34,15
Verbzz,tichondrius,1846,warlock,destruction,36,23,13
Illinkin,illidan,1846,warlock,destruction,108,65,43
Narila,firetree,1846,warlock,destruction,36,21,15
Lemmepvponu,illidan,1846,warlock,destruction,59,28,31
Ñpç,bleeding-hollow,1844,warlock,destruction,83,44,39
Boxtrolls,ragnaros,1843,warlock,destruction,48,28,20
Chilipeppa,wyrmrest-accord,1842,warlock,destruction,36,27,9
Herpalock,illidan,1842,warlock,destruction,78,34,44
Rocketman,hydraxis,1841,warlock,destruction,48,32,16
Urukái,dalaran,1841,warlock,destruction,105,62,43
Rizzofsparta,stormrage,1841,warlock,destruction,48,27,21
Benafflockzz,kelthuzad,1840,warlock,destruction,66,44,22
Millidots,bleeding-hollow,1840,warlock,destruction,54,31,23
Sithaholic,wildhammer,1840,warlock,destruction,60,33,27
Cosmosxx,illidan,1838,warlock,destruction,42,31,11
Enter,saurfang,1838,warlock,destruction,36,24,12
Jaspieno,illidan,1838,warlock,destruction,48,29,19
Dragonixs,ragnaros,1837,warlock,destruction,96,53,43
Curse,agamaggan,1836,warlock,destruction,108,63,45
Wife,bleeding-hollow,1836,warlock,destruction,60,31,29
Sibëria,quelthalas,1835,warlock,destruction,48,35,13
Badstep,tichondrius,1835,warlock,destruction,51,30,21
Gigabiga,area-52,1834,warlock,destruction,24,20,4
Soragen,barthilas,1834,warlock,destruction,54,37,17
Farathos,ragnaros,1834,warlock,destruction,114,71,43
Puchador,sargeras,1834,warlock,destruction,120,64,56
Charlieo,barthilas,1833,warlock,destruction,48,32,16
Gotthmog,nerzhul,1833,warlock,destruction,48,30,18
Giantgobrin,zuljin,1832,warlock,destruction,48,30,18
Neverending,malganis,1831,warlock,destruction,43,25,18
Buu,veknilash,1830,warlock,destruction,54,33,21
Rhelialock,stormrage,1830,warlock,destruction,36,21,15
Suaveaye,tichondrius,1829,warlock,destruction,54,31,23
Nezlock,moon-guard,1829,warlock,destruction,92,45,47
Shequita,stormrage,1825,warlock,destruction,48,37,11
Agaros,zuljin,1825,warlock,destruction,49,30,19
Dàmagicman,drakthul,1824,warlock,destruction,48,32,16
Realgodlock,proudmoore,1824,warlock,destruction,86,41,45
Dipicrowcaw,tichondrius,1822,warlock,destruction,24,19,5
Hakai,bleeding-hollow,1822,warlock,destruction,80,51,29
Warsmock,tichondrius,1822,warlock,destruction,35,20,15
Punstable,tichondrius,1821,warlock,destruction,91,52,39
Drazh,area-52,1821,warlock,destruction,57,32,25
Róckroad,lightnings-blade,1820,warlock,destruction,42,26,16
Azaradx,sargeras,1819,warlock,destruction,84,54,30
Yipláw,stormrage,1819,warlock,destruction,36,23,13
Puginlock,illidan,1819,warlock,destruction,60,38,22
Bumbleebolt,azralon,1817,warlock,destruction,24,19,5
Sereniaa,sargeras,1817,warlock,destruction,38,20,18
Wraithlord,chogall,1816,warlock,destruction,51,32,19
Eav,area-52,1816,warlock,destruction,48,30,18
Reallymagic,malganis,1816,warlock,destruction,106,63,43
Bismorc,frostmourne,1816,warlock,destruction,42,23,19
Dunnin,dalaran,1815,warlock,destruction,36,22,14
Savlonicsego,stormrage,1815,warlock,destruction,78,45,33
Frappucino,wyrmrest-accord,1814,warlock,destruction,30,23,7
Løcalplugxø,barthilas,1814,warlock,destruction,102,69,33
Shinjuro,stormrage,1814,warlock,destruction,36,24,12
Slpxoxo,sargeras,1814,warlock,destruction,54,30,24
Wzxx,tichondrius,1814,warlock,destruction,117,62,55
Crayonchewer,alleria,1814,warlock,destruction,60,31,29
Zaef,kelthuzad,1814,warlock,destruction,88,45,43
Famerap,tichondrius,1813,warlock,destruction,36,25,11
Wiredftw,illidan,1813,warlock,destruction,30,19,11
Sacalawia,drakkari,1813,warlock,destruction,45,27,18
Zauber,magtheridon,1812,warlock,destruction,44,29,15
Destructio,tichondrius,1812,warlock,destruction,54,31,23
Marshyw,tichondrius,1812,warlock,destruction,36,19,17
Bellaswans,hyjal,1811,warlock,destruction,54,33,21
Naroy,malygos,1811,warlock,destruction,38,21,17
Thegodd,nemesis,1811,warlock,destruction,54,28,26
Venticm,tichondrius,1810,warlock,destruction,42,26,16
Alchan,tichondrius,1810,warlock,destruction,65,38,27
Tonnon,stormrage,1810,warlock,destruction,72,42,30
Fartymårty,tichondrius,1810,warlock,destruction,36,21,15
Omnireaper,tichondrius,1810,warlock,destruction,54,29,25
Berkz,stormrage,1810,warlock,destruction,66,33,33
Oof,dalaran,1809,warlock,destruction,30,22,8
Ashlet,kelthuzad,1809,warlock,destruction,48,30,18
Necroboi,alterac-mountains,1809,warlock,destruction,46,28,18
Fanzhiyi,illidan,1808,warlock,destruction,43,27,16
Blackchinese,zuljin,1808,warlock,destruction,138,73,65
Niava,tichondrius,1808,warlock,destruction,54,28,26
Payn,kiljaeden,1808,warlock,destruction,54,26,28
Pigii,tichondrius,1807,warlock,destruction,24,19,5
Drthiccbolts,malganis,1807,warlock,destruction,47,29,18
Drdoom,sargeras,1807,warlock,destruction,36,22,14
Aidadeshu,tichondrius,1807,warlock,destruction,60,32,28
Yeepzbytre,bleeding-hollow,1806,warlock,destruction,42,32,10
Almostoogood,illidan,1806,warlock,destruction,30,19,11
Elfwarlock,aerie-peak,1806,warlock,destruction,40,25,15
Belenas,tichondrius,1806,warlock,destruction,48,28,20
Nigthdeath,nemesis,1806,warlock,destruction,173,91,82
Döremi,tichondrius,1805,warlock,destruction,48,28,20
Veleza,kiljaeden,1805,warlock,destruction,82,47,35
Vulcke,kelthuzad,1805,warlock,destruction,47,23,24
Expiredfood,stormreaver,1803,warlock,destruction,42,26,16
Bod,bleeding-hollow,1803,warlock,destruction,42,24,18
Neghros,illidan,1803,warlock,destruction,101,52,49
Scârecrow,stormrage,1802,warlock,destruction,72,46,26
Barbieelf,sargeras,1802,warlock,destruction,127,69,58
Struggles,emerald-dream,1802,warlock,destruction,159,85,74
Mamosa,stormrage,1801,warlock,destruction,72,52,20
Leeroydots,area-52,1801,warlock,destruction,48,34,14
Geekmonster,tichondrius,1801,warlock,destruction,54,33,21
Seltzi,illidan,1801,warlock,destruction,47,25,22
Necrochemist,frostmane,1800,warlock,destruction,24,19,5
Salival,chogall,1800,warlock,destruction,27,21,6
Xervas,frostmourne,1800,warlock,destruction,54,33,21
Soulbane,nemesis,1800,warlock,destruction,36,22,14
Warmstreak,blackrock,1800,warlock,destruction,48,28,20
Lapidate,malganis,1800,warlock,destruction,59,33,26
Sherlóck,duskwood,1798,warlock,destruction,54,28,26
Cróhns,bleeding-hollow,1797,warlock,destruction,133,83,50
Kartharian,wyrmrest-accord,1795,warlock,destruction,106,52,54
Feardotjpg,stormrage,1791,warlock,destruction,42,29,13
Brujoalfa,ragnaros,1791,warlock,destruction,109,64,45
Shadøwy,nemesis,1791,warlock,destruction,184,102,82
Feinnx,dalaran,1789,warlock,destruction,64,34,30
Omegapasta,illidan,1788,warlock,destruction,72,34,38
Coilsinfive,tichondrius,1787,warlock,destruction,30,19,11
Wreyz,mannoroth,1783,warlock,destruction,72,39,33
Eskyx,tichondrius,1783,warlock,destruction,42,22,20
Nevermindxd,barthilas,1783,warlock,destruction,66,32,34
Positivity,thunderhorn,1782,warlock,destruction,48,30,18
Ercaz,frostmourne,1781,warlock,destruction,42,20,22
Dupapad,stormrage,1780,warlock,destruction,65,31,34
Jakjub,kelthuzad,1778,warlock,destruction,54,31,23
Grq,stormrage,1775,warlock,destruction,69,43,26
Screwed,tichondrius,1773,warlock,destruction,96,49,47
Tenaciousd,malganis,1772,warlock,destruction,42,21,21
Alùcärd,tichondrius,1772,warlock,destruction,54,25,29
Twilson,moon-guard,1771,warlock,destruction,54,29,25
Radicalz,ragnaros,1771,warlock,destruction,37,19,18
Karimbenzema,tichondrius,1770,warlock,destruction,48,28,20
Jierd,tichondrius,1769,warlock,destruction,40,24,16
Doughnut,mugthol,1768,warlock,destruction,60,34,26
Lifeinsuranc,tichondrius,1767,warlock,destruction,30,19,11
Trundle,area-52,1766,warlock,destruction,29,21,8
Disgustingfk,illidan,1766,warlock,destruction,60,37,23
Aryoc,ragnaros,1765,warlock,destruction,54,35,19
Åbyssal,stormrage,1765,warlock,destruction,93,59,34
Kogath,thunderlord,1763,warlock,destruction,86,50,36
Sidgnosis,stormrage,1763,warlock,destruction,123,67,56
Kakistocracy,kelthuzad,1761,warlock,destruction,30,23,7
Firenzy,dalaran,1760,warlock,destruction,61,34,27
Antinurse,bleeding-hollow,1760,warlock,destruction,72,40,32
Andelaylas,tichondrius,1758,warlock,destruction,48,33,15
Sosahawk,stormrage,1758,warlock,destruction,96,61,35
Tìdals,zuljin,1757,warlock,destruction,38,25,13
Nick,llane,1757,warlock,destruction,36,23,13
Darkwidow,sargeras,1756,warlock,destruction,114,55,59
Locodwarf,frostmourne,1756,warlock,destruction,248,119,129
Squishyboy,tichondrius,1755,warlock,destruction,57,30,27
Ravëncläw,quelthalas,1755,warlock,destruction,67,35,32
Flattsl,tichondrius,1755,warlock,destruction,84,39,45
Obliceress,crushridge,1754,warlock,destruction,42,26,16
Screampies,tichondrius,1754,warlock,destruction,46,27,19
Ibrroski,proudmoore,1753,warlock,destruction,24,20,4
Kissmybolts,frostmourne,1752,warlock,destruction,54,28,26
Bigdamege,tichondrius,1749,warlock,destruction,43,27,16
Symaitiel,azralon,1749,warlock,destruction,60,33,27
Isoldmysoul,stormrage,1745,warlock,destruction,66,32,34
Magnetix,arthas,1744,warlock,destruction,169,87,82
Thinktank,tichondrius,1743,warlock,destruction,42,25,17
Halloweèn,kelthuzad,1741,warlock,destruction,131,74,57
Qualio,thrall,1740,warlock,destruction,57,28,29
Darkmagician,kelthuzad,1735,warlock,destruction,30,22,8
Hädes,frostwolf,1734,warlock,destruction,42,29,13
Uranusa,proudmoore,1733,warlock,destruction,48,23,25
Mânuel,akama,1731,warlock,destruction,30,22,8
Evilclass,tichondrius,1729,warlock,destruction,30,23,7
Harmfuul,illidan,1728,warlock,destruction,45,28,17
Kairiesmirk,illidan,1727,warlock,destruction,58,32,26
Nasn,black-dragonflight,1726,warlock,destruction,50,31,19
Babybolt,frostmourne,1726,warlock,destruction,54,25,29
Marcelium,greymane,1724,warlock,destruction,30,21,9
Scathey,area-52,1724,warlock,destruction,102,61,41
Mindrekt,azralon,1723,warlock,destruction,60,44,16
Daylyt,sargeras,1723,warlock,destruction,27,19,8
Popdotdropit,frostwolf,1723,warlock,destruction,72,42,30
Gucciflops,bleeding-hollow,1723,warlock,destruction,48,23,25
Philsbad,lightbringer,1722,warlock,destruction,74,42,32
Inmøtion,tichondrius,1721,warlock,destruction,36,18,18
Chaoticchaos,kelthuzad,1719,warlock,destruction,29,19,10
Notprint,sargeras,1718,warlock,destruction,30,18,12
Agni,gurubashi,1718,warlock,destruction,126,66,60
Bigulinhos,nemesis,1717,warlock,destruction,30,18,12
Meatmanxtrem,sargeras,1717,warlock,destruction,48,27,21
Yidhra,aerie-peak,1717,warlock,destruction,99,55,44
Spooked,khadgar,1716,warlock,destruction,36,24,12
Koramoz,area-52,1715,warlock,destruction,111,55,56
Lockfoxyy,tichondrius,1714,warlock,destruction,30,21,9
Ashoraya,area-52,1714,warlock,destruction,42,29,13
Podda,shuhalo,1713,warlock,destruction,47,29,18
Azlloa,tichondrius,1713,warlock,destruction,36,22,14
Hehimx,bleeding-hollow,1711,warlock,destruction,24,18,6
Evanylock,proudmoore,1711,warlock,destruction,35,21,14
Richãrd,area-52,1709,warlock,destruction,49,26,23
Wårløck,stormrage,1707,warlock,destruction,24,18,6
Cocaineparty,tichondrius,1707,warlock,destruction,53,29,24
Fredwinsta,laughing-skull,1706,warlock,destruction,24,18,6
Drain,proudmoore,1706,warlock,destruction,54,36,18
Evatar,malganis,1705,warlock,destruction,30,19,11
Eggpower,tichondrius,1703,warlock,destruction,40,23,17
Grandmama,tichondrius,1702,warlock,destruction,36,21,15
Rettek,bleeding-hollow,1701,warlock,destruction,30,21,9
Stormrift,sargeras,1701,warlock,destruction,68,39,29
Doclove,destromath,1700,warlock,destruction,94,51,43
Wolfstein,tichondrius,1699,warlock,destruction,24,18,6
Frightbright,sargeras,1698,warlock,destruction,31,18,13
Daartaru,quelthalas,1698,warlock,destruction,90,48,42
Zehoc,thrall,1698,warlock,destruction,66,33,33
Krikxy,tichondrius,1697,warlock,destruction,44,24,20
Feetsampler,stormrage,1697,warlock,destruction,46,21,25
Iskiplegday,illidan,1697,warlock,destruction,101,43,58
Sairic,azralon,1696,warlock,destruction,48,36,12
Zírds,stormrage,1696,warlock,destruction,42,22,20
Doombaby,zuljin,1694,warlock,destruction,76,50,26
Iconicxo,thrall,1693,warlock,destruction,72,39,33
Hellwish,tichondrius,1692,warlock,destruction,60,30,30
Pk,azralon,1691,warlock,destruction,24,18,6
Dotandforget,tichondrius,1691,warlock,destruction,36,24,12
Dferreira,azralon,1691,warlock,destruction,96,56,40
Cbx,kelthuzad,1690,warlock,destruction,36,28,8
Aluaris,earthen-ring,1690,warlock,destruction,30,23,7
Chaosbeard,korgath,1690,warlock,destruction,62,36,26
Buboñic,area-52,1690,warlock,destruction,47,27,20
Muffîn,moon-guard,1689,warlock,destruction,98,60,38
Demonicsnap,bleeding-hollow,1689,warlock,destruction,47,27,20
Hellparks,malganis,1688,warlock,destruction,36,23,13
Cloudynightz,tichondrius,1688,warlock,destruction,71,42,29
Lockfaceguy,agamaggan,1688,warlock,destruction,48,26,22
Tahmrin,quelthalas,1687,warlock,destruction,40,23,17
Dautenit,illidan,1687,warlock,destruction,66,32,34
Bobbyshmurdå,frostmourne,1686,warlock,destruction,48,29,19
Tribulatiön,moon-guard,1685,warlock,destruction,161,91,70
Contagion,dragonmaw,1685,warlock,destruction,36,20,16
Oblivious,firetree,1685,warlock,destruction,172,88,84
Cvoaw,bonechewer,1683,warlock,destruction,36,23,13
Vamprixlz,illidan,1680,warlock,destruction,37,25,12
Droptopp,malganis,1680,warlock,destruction,42,27,15
Brutalsummon,frostmourne,1680,warlock,destruction,63,34,29
Yaresly,kelthuzad,1678,warlock,destruction,38,25,13
Gavrhin,area-52,1678,warlock,destruction,41,26,15
Sakyameil,area-52,1678,warlock,destruction,42,25,17
Razlock,moon-guard,1677,warlock,destruction,177,94,83
Breeak,sargeras,1676,warlock,destruction,48,31,17
Dipixd,tichondrius,1675,warlock,destruction,24,22,2
Gianni,chogall,1675,warlock,destruction,42,24,18
Terrorbytes,frostmourne,1675,warlock,destruction,68,38,30
Feardadots,tichondrius,1674,warlock,destruction,69,46,23
Deathhawkz,ravencrest,1674,warlock,destruction,30,19,11
Monika,anetheron,1674,warlock,destruction,40,23,17
Làsko,area-52,1673,warlock,destruction,78,39,39
Pyatpree,bleeding-hollow,1671,warlock,destruction,30,19,11
Intentionz,sargeras,1671,warlock,destruction,41,24,17
Mlxd,tichondrius,1670,warlock,destruction,24,19,5
Nocrackrocks,stormrage,1670,warlock,destruction,34,22,12
Bouldrlickr,dragonmaw,1669,warlock,destruction,42,25,17
Razzakka,stormrage,1669,warlock,destruction,147,75,72
Rxjr,sargeras,1669,warlock,destruction,65,33,32
Nooko,frostmourne,1668,warlock,destruction,30,18,12
Ðiêsel,malganis,1668,warlock,destruction,57,32,25
Covidmaster,frostmourne,1668,warlock,destruction,59,32,27
Manapouli,area-52,1667,warlock,destruction,33,21,12
Levantine,barthilas,1667,warlock,destruction,45,24,21
Chaosbôlt,proudmoore,1667,warlock,destruction,78,39,39
Daimonic,bronzebeard,1666,warlock,destruction,36,23,13
Zimer,moon-guard,1665,warlock,destruction,60,34,26
Rotshtëin,tichondrius,1665,warlock,destruction,143,72,71
Degred,tichondrius,1664,warlock,destruction,45,34,11
Cenich,darkspear,1663,warlock,destruction,37,25,12
Evilempire,sargeras,1663,warlock,destruction,36,22,14
Ralerhard,kelthuzad,1663,warlock,destruction,46,27,19
Olgee,tortheldrin,1663,warlock,destruction,53,30,23
Grandpa,daggerspine,1663,warlock,destruction,61,33,28
Dartthvader,azralon,1661,warlock,destruction,92,45,47
Hynnis,nemesis,1659,warlock,destruction,48,32,16
Vallàx,area-52,1658,warlock,destruction,72,36,36
Bytezlk,area-52,1657,warlock,destruction,30,20,10
Kâyn,area-52,1657,warlock,destruction,59,30,29
Deangood,tichondrius,1656,warlock,destruction,152,77,75
Mursay,tichondrius,1655,warlock,destruction,30,23,7
Steebi,tichondrius,1655,warlock,destruction,36,23,13
Warmandei,dalaran,1653,warlock,destruction,48,30,18
Lockforyou,frostmourne,1652,warlock,destruction,60,36,24
Stølo,deathwing,1651,warlock,destruction,94,65,29
Zoagen,ragnaros,1650,warlock,destruction,28,20,8
Midoolock,proudmoore,1650,warlock,destruction,48,31,17
Mchawi,tichondrius,1649,warlock,destruction,36,22,14
Cheqmate,moon-guard,1648,warlock,destruction,43,25,18
Noggét,frostmourne,1647,warlock,destruction,102,61,41
Juicestarr,barthilas,1647,warlock,destruction,60,27,33
Nt,burning-legion,1646,warlock,destruction,37,30,7
Missmonday,tichondrius,1646,warlock,destruction,36,20,16
Neverportx,kirin-tor,1645,warlock,destruction,36,21,15
Plasticware,korgath,1645,warlock,destruction,36,20,16
Critthis,illidan,1644,warlock,destruction,35,25,10
Krokusx,illidan,1643,warlock,destruction,78,41,37
Devilman,darkspear,1643,warlock,destruction,109,57,52
Debigbolt,area-52,1642,warlock,destruction,30,22,8
Josaith,moon-guard,1642,warlock,destruction,83,49,34
Katrisse,aegwynn,1642,warlock,destruction,60,32,28
Barovir,tichondrius,1642,warlock,destruction,42,22,20
Chaosage,sargeras,1640,warlock,destruction,42,28,14
Vyrecks,hyjal,1640,warlock,destruction,36,21,15
Spaceghóst,bleeding-hollow,1640,warlock,destruction,93,49,44
Galfear,malganis,1639,warlock,destruction,153,82,71
Fearmebro,bleeding-hollow,1639,warlock,destruction,139,72,67
Pyralock,malfurion,1638,warlock,destruction,48,25,23
Demonclock,sargeras,1637,warlock,destruction,39,24,15
Gottawiz,illidan,1637,warlock,destruction,36,22,14
Ardentia,malganis,1637,warlock,destruction,54,30,24
Arenis,stormrage,1636,warlock,destruction,36,25,11
Xylâ,emerald-dream,1636,warlock,destruction,39,22,17
Dëstró,tichondrius,1636,warlock,destruction,41,23,18
Eyoeyo,tichondrius,1636,warlock,destruction,42,18,24
Killabeesack,tichondrius,1635,warlock,destruction,43,25,18
Bénâfflock,area-52,1634,warlock,destruction,54,32,22
Leônidos,ghostlands,1634,warlock,destruction,60,33,27
Snerp,frostmourne,1634,warlock,destruction,78,40,38
Guldoom,tichondrius,1631,warlock,destruction,18,17,1
Deammon,tichondrius,1631,warlock,destruction,36,24,12
Sagatt,illidan,1631,warlock,destruction,68,37,31
Lafourche,tichondrius,1631,warlock,destruction,48,26,22
Ddorangmoon,tichondrius,1630,warlock,destruction,42,25,17
Dipixyz,tichondrius,1630,warlock,destruction,30,17,13
Tanskeeh,sargeras,1630,warlock,destruction,64,35,29
Holunging,illidan,1630,warlock,destruction,36,19,17
Psyløck,bleeding-hollow,1629,warlock,destruction,48,29,19
Dewandoritos,kelthuzad,1629,warlock,destruction,30,17,13
Hiddentech,saurfang,1629,warlock,destruction,30,17,13
Whitexzz,tichondrius,1629,warlock,destruction,30,17,13
Ltoplaylock,area-52,1628,warlock,destruction,24,17,7
Undeadzx,tichondrius,1627,warlock,destruction,36,19,17
Meep,madoran,1626,warlock,destruction,59,35,24
Nahz,tichondrius,1626,warlock,destruction,30,17,13
Sîthfu,tichondrius,1626,warlock,destruction,177,95,82
Killvilock,kelthuzad,1626,warlock,destruction,55,29,26
Døomsday,hyjal,1626,warlock,destruction,42,21,21
Byndedlock,dragonmaw,1625,warlock,destruction,33,20,13
Vvivienx,tichondrius,1625,warlock,destruction,30,17,13
Dovahkini,stormrage,1625,warlock,destruction,47,23,24
Zandõx,jubeithos,1624,warlock,destruction,42,27,15
Exilegd,proudmoore,1624,warlock,destruction,41,26,15
Matafé,kelthuzad,1623,warlock,destruction,30,20,10
Maddotts,malganis,1622,warlock,destruction,30,23,7
Thotblood,stormrage,1622,warlock,destruction,24,18,6
Lïttle,stormrage,1622,warlock,destruction,57,34,23
Permaslowed,kiljaeden,1622,warlock,destruction,40,22,18
Richãrdjr,area-52,1621,warlock,destruction,24,17,7
Elmobolt,thrall,1620,warlock,destruction,37,27,10
Jarasseck,malganis,1620,warlock,destruction,48,25,23
Penzer,stormrage,1618,warlock,destruction,36,20,16
Dolut,azralon,1617,warlock,destruction,54,31,23
Restolock,destromath,1617,warlock,destruction,60,34,26
Mephizar,moon-guard,1617,warlock,destruction,50,25,25
Infecçäo,stormrage,1616,warlock,destruction,72,43,29
Stocktonslap,saurfang,1616,warlock,destruction,111,63,48
Keylloggz,sargeras,1616,warlock,destruction,68,36,32
Esså,jaedenar,1616,warlock,destruction,42,18,24
Paparoxy,illidan,1616,warlock,destruction,42,18,24
Jpepps,perenolde,1615,warlock,destruction,41,28,13
Ðarkñess,burning-legion,1615,warlock,destruction,66,38,28
Dxhusky,illidan,1614,warlock,destruction,36,20,16
Birez,kelthuzad,1614,warlock,destruction,56,28,28
Alfaflux,tol-barad,1614,warlock,destruction,47,23,24
Leruss,zangarmarsh,1614,warlock,destruction,37,17,20
Saltiez,sargeras,1613,warlock,destruction,24,18,6
Calidaze,tichondrius,1613,warlock,destruction,62,35,27
Jussmollett,arygos,1613,warlock,destruction,59,32,27
Anujy,moon-guard,1612,warlock,destruction,60,38,22
Thirdsol,stormrage,1612,warlock,destruction,29,18,11
Belzebud,area-52,1612,warlock,destruction,93,56,37
Wayce,burning-blade,1612,warlock,destruction,45,26,19
Absoluté,nemesis,1612,warlock,destruction,30,17,13
Hypnotikal,illidan,1611,warlock,destruction,30,22,8
Bigjmmywiggl,illidan,1611,warlock,destruction,67,36,31
Woezz,tichondrius,1610,warlock,destruction,75,41,34
Apøçàlÿpsè,firetree,1610,warlock,destruction,60,32,28
Pigmahz,malganis,1610,warlock,destruction,47,24,23
Omleaf,malganis,1610,warlock,destruction,36,18,18
Gigabiga,tol-barad,1609,warlock,destruction,24,17,7
Horloc,moon-guard,1609,warlock,destruction,68,38,30
Brickedx,malfurion,1609,warlock,destruction,71,35,36
Ayrr,zuljin,1608,warlock,destruction,30,17,13
Gnomlette,smolderthorn,1608,warlock,destruction,98,53,45
Lemonfire,area-52,1608,warlock,destruction,36,19,17
Notspeedy,tichondrius,1608,warlock,destruction,75,32,43
Lostanubis,tichondrius,1607,warlock,destruction,39,24,15
Dottx,frostmourne,1607,warlock,destruction,30,17,13
Xivra,thrall,1606,warlock,destruction,30,20,10
Macdeezylock,sargeras,1605,warlock,destruction,36,23,13
Javirr,ragnaros,1605,warlock,destruction,36,23,13
Vugaddi,illidan,1605,warlock,destruction,30,19,11
Hordeadlock,illidan,1604,warlock,destruction,60,31,29
Nosferatu,arthas,1602,warlock,destruction,26,20,6
Sslock,sargeras,1602,warlock,destruction,46,26,20
Espyn,silvermoon,1602,warlock,destruction,105,51,54
Juswannarock,tichondrius,1601,warlock,destruction,33,22,11
Lyonesse,frostmourne,1601,warlock,destruction,34,21,13
Hâm,dalaran,1601,warlock,destruction,96,46,50
Dapete,malorne,1600,warlock,destruction,36,26,10
Locknug,tichondrius,1600,warlock,destruction,132,74,58
Kurifodo,illidan,1600,warlock,destruction,59,33,26
Warlockmf,sargeras,1599,warlock,destruction,79,47,32
Belford,tichondrius,1598,warlock,destruction,49,25,24
Glôck,lightbringer,1597,warlock,destruction,50,21,29
Closetslut,moon-guard,1596,warlock,destruction,24,20,4
Serveq,tichondrius,1595,warlock,destruction,79,42,37
Guula,alexstrasza,1595,warlock,destruction,42,22,20
Dotcoin,tichondrius,1594,warlock,destruction,30,17,13
Rotfull,burning-legion,1594,warlock,destruction,39,18,21
Wheremyshoes,area-52,1593,warlock,destruction,141,68,73
Jerearderedo,thrall,1592,warlock,destruction,42,24,18
Grindwald,echo-isles,1592,warlock,destruction,49,26,23
Kernlberton,tichondrius,1592,warlock,destruction,48,25,23
Larryfisher,drenden,1591,warlock,destruction,30,19,11
Cairo,emerald-dream,1591,warlock,destruction,207,107,100
Dots,haomarush,1591,warlock,destruction,60,31,29
Yisuschríst,quelthalas,1591,warlock,destruction,41,21,20
Demonkiiller,kelthuzad,1591,warlock,destruction,48,19,29
Caustikk,malganis,1587,warlock,destruction,44,25,19
Buffwarlocks,senjin,1587,warlock,destruction,48,26,22
Vasago,jubeithos,1586,warlock,destruction,59,31,28
Parishiltoon,frostmourne,1586,warlock,destruction,46,19,27
Tothegrave,sargeras,1585,warlock,destruction,35,22,13
Kuroyt,drakkari,1583,warlock,destruction,42,26,16
Conradlenoir,illidan,1582,warlock,destruction,30,18,12
Malagas,tichondrius,1580,warlock,destruction,33,22,11
Booßiemiles,area-52,1580,warlock,destruction,79,50,29
Gerthclas,aggramar,1579,warlock,destruction,35,24,11
Bbclover,thrall,1579,warlock,destruction,29,19,10
Korose,tichondrius,1579,warlock,destruction,142,72,70
Felnightz,area-52,1577,warlock,destruction,36,18,18
Charnoob,kelthuzad,1577,warlock,destruction,48,23,25
Soreanus,illidan,1576,warlock,destruction,28,20,8
Zhaphrax,frostmourne,1574,warlock,destruction,71,34,37
Chachanoobx,sargeras,1573,warlock,destruction,96,63,33
Necrotic,mannoroth,1572,warlock,destruction,54,21,33
Sixv,barthilas,1571,warlock,destruction,24,17,7
Stankbigly,thrall,1571,warlock,destruction,38,23,15
Carmelasin,moon-guard,1570,warlock,destruction,60,39,21
Melôck,area-52,1569,warlock,destruction,30,20,10
Strykerliath,bleeding-hollow,1568,warlock,destruction,37,21,16
Kály,azralon,1567,warlock,destruction,39,20,19
Khrom,illidan,1565,warlock,destruction,64,32,32
Meraz,zuljin,1564,warlock,destruction,28,17,11
Whathurts,tichondrius,1564,warlock,destruction,86,42,44
Uow,stormrage,1564,warlock,destruction,42,20,22
Kossnen,shandris,1562,warlock,destruction,34,19,15
Revérence,sargeras,1559,warlock,destruction,30,17,13
Zalord,mannoroth,1559,warlock,destruction,100,43,57
Khurze,area-52,1558,warlock,destruction,57,29,28
Chnos,mugthol,1557,warlock,destruction,29,17,12
Promethian,proudmoore,1556,warlock,destruction,53,23,30
Lilbiackguy,stormrage,1555,warlock,destruction,72,45,27
Jaythuzad,stormrage,1555,warlock,destruction,68,36,32
Niked,sargeras,1553,warlock,destruction,114,67,47
Brettmackson,area-52,1553,warlock,destruction,57,32,25
Flxmin,area-52,1551,warlock,destruction,52,27,25
Wiildgoose,area-52,1550,warlock,destruction,30,21,9
Resuah,tichondrius,1549,warlock,destruction,51,25,26
Bayfayth,zuljin,1546,warlock,destruction,92,52,40
Jnxzlock,sargeras,1546,warlock,destruction,61,34,27
Darthðotspam,mugthol,1542,warlock,destruction,60,40,20
Gluestik,shadowmoon,1542,warlock,destruction,46,23,23
Remua,tichondrius,1540,warlock,destruction,29,18,11
Dragoska,kiljaeden,1540,warlock,destruction,30,17,13
Cryptos,kalecgos,1538,warlock,destruction,38,22,16
Hadouh,stormrage,1537,warlock,destruction,29,17,12
Manthos,sargeras,1537,warlock,destruction,63,24,39
Chadica,malganis,1534,warlock,destruction,18,16,2
Katastrophïk,area-52,1534,warlock,destruction,30,16,14
Burnzul,bleeding-hollow,1533,warlock,destruction,36,18,18
Scarletdemon,malganis,1532,warlock,destruction,65,35,30
Xiyangpvp,tichondrius,1532,warlock,destruction,42,16,26
Captrollol,tichondrius,1531,warlock,destruction,60,30,30
Slurpme,stormscale,1529,warlock,destruction,24,16,8
Beetlejoos,stormreaver,1529,warlock,destruction,30,16,14
Brucelock,proudmoore,1528,warlock,destruction,24,16,8
Kelifan,sargeras,1528,warlock,destruction,66,43,23
Scarified,illidan,1527,warlock,destruction,36,16,20
Somethingud,tichondrius,1527,warlock,destruction,77,31,46
Badmagic,area-52,1526,warlock,destruction,60,33,27
Isarac,zuljin,1524,warlock,destruction,54,35,19
Nefandous,malganis,1524,warlock,destruction,90,52,38
Dauntx,proudmoore,1524,warlock,destruction,30,16,14
Sidious,jubeithos,1523,warlock,destruction,38,24,14
Dotte,tichondrius,1523,warlock,destruction,48,27,21
Conspiration,sargeras,1522,warlock,destruction,24,19,5
Xêlsnåp,steamwheedle-cartel,1519,warlock,destruction,91,53,38
Thravis,tichondrius,1518,warlock,destruction,36,20,16
Picklepuller,arthas,1517,warlock,destruction,42,28,14
Misolock,sargeras,1515,warlock,destruction,48,23,25
Austeeny,wyrmrest-accord,1513,warlock,destruction,31,21,10
Politex,malganis,1513,warlock,destruction,64,40,24
Fshi,frostmourne,1513,warlock,destruction,96,56,40
Lockybalboah,turalyon,1513,warlock,destruction,54,30,24
Pauldiesel,ragnaros,1512,warlock,destruction,30,16,14
Trewlocke,sargeras,1511,warlock,destruction,24,16,8
Ezdagor,quelthalas,1511,warlock,destruction,136,73,63
Tharki,darkspear,1510,warlock,destruction,52,27,25
Kuoma,boulderfist,1510,warlock,destruction,109,53,56
Joseph,draktharon,1509,warlock,destruction,66,35,31
Derok,bleeding-hollow,1509,warlock,destruction,203,95,108
Guldåniel,tichondrius,1508,warlock,destruction,30,16,14
Yanned,hakkar,1507,warlock,destruction,92,50,42
Luckehlock,firetree,1506,warlock,destruction,53,23,30
Dinglerdots,tichondrius,1502,warlock,destruction,27,21,6
Jugaa,arthas,1502,warlock,destruction,41,29,12
Yaldin,nemesis,1501,warlock,destruction,115,66,49
Bosongo,boulderfist,1501,warlock,destruction,65,37,28
Cbolt,tichondrius,1501,warlock,destruction,36,20,16
Deboltzaru,ragnaros,1501,warlock,destruction,85,42,43
Daenon,kiljaeden,1500,warlock,destruction,30,16,14
Sauromann,sargeras,1499,warlock,destruction,60,34,26
Hellbòund,mugthol,1499,warlock,destruction,30,17,13
Jennifear,sargeras,1499,warlock,destruction,50,28,22
Fiddlesticks,draka,1498,warlock,destruction,24,17,7
Odiums,area-52,1498,warlock,destruction,77,44,33
Kyoarnez,quelthalas,1498,warlock,destruction,48,24,24
Nattydots,sargeras,1497,warlock,destruction,49,25,24
Firewõrks,moon-guard,1496,warlock,destruction,30,17,13
Kascade,drakkari,1493,warlock,destruction,44,23,21
Memnøch,emerald-dream,1492,warlock,destruction,41,24,17
Teesolinia,stormrage,1491,warlock,destruction,36,22,14
Darkÿoda,malganis,1490,warlock,destruction,44,22,22
Goomgoom,doomhammer,1489,warlock,destruction,114,50,64
Terrival,illidan,1487,warlock,destruction,41,22,19
Dynamó,tichondrius,1483,warlock,destruction,74,37,37
Gingery,the-underbog,1483,warlock,destruction,71,34,37
Humanreapers,malganis,1482,warlock,destruction,31,22,9
Dercair,korgath,1480,warlock,destruction,30,18,12
Beyourselff,tichondrius,1479,warlock,destruction,35,16,19
Dloq,azgalor,1478,warlock,destruction,117,70,47
Borthrel,moon-guard,1478,warlock,destruction,108,60,48
Yükina,stormrage,1477,warlock,destruction,88,45,43
Chàõs,tichondrius,1477,warlock,destruction,54,27,27
Tofulery,tichondrius,1475,warlock,destruction,50,23,27
Sickgurl,stormrage,1474,warlock,destruction,42,26,16
Bauchalain,area-52,1474,warlock,destruction,38,19,19
Gatewayoncd,frostmourne,1474,warlock,destruction,54,25,29
Revenus,tichondrius,1473,warlock,destruction,47,17,30
Glenfarclas,tichondrius,1471,warlock,destruction,43,19,24
Obscurity,tichondrius,1470,warlock,destruction,36,17,19
Demondots,sargeras,1469,warlock,destruction,54,31,23
Tunacanthicc,moon-guard,1469,warlock,destruction,108,55,53
Laylowl,tichondrius,1468,warlock,destruction,36,22,14
Gharlock,tichondrius,1468,warlock,destruction,32,19,13
Shadowxlock,misha,1468,warlock,destruction,95,51,44
Magy,deathwing,1467,warlock,destruction,48,30,18
Pwz,azralon,1465,warlock,destruction,108,60,48
Noxdolor,stormreaver,1465,warlock,destruction,36,20,16
Squatchamp,sargeras,1463,warlock,destruction,36,20,16
Hootenanny,korialstrasz,1463,warlock,destruction,42,18,24
Meatybolts,nagrand,1462,warlock,destruction,60,36,24
Annereyn,stormrage,1462,warlock,destruction,35,16,19
Jakeyboii,frostmourne,1459,warlock,destruction,51,33,18
Falcorr,area-52,1459,warlock,destruction,34,19,15
Noxfear,azralon,1458,warlock,destruction,24,18,6
Diabhlaí,tichondrius,1457,warlock,destruction,54,35,19
Avelmi,daggerspine,1456,warlock,destruction,60,28,32
Darknessgodd,goldrinn,1454,warlock,destruction,49,29,20
Dunbu,illidan,1454,warlock,destruction,109,60,49
Hellcon,area-52,1452,warlock,destruction,58,38,20
Masefield,moon-guard,1452,warlock,destruction,38,18,20
Kalellock,azralon,1451,warlock,destruction,102,52,50
Vexedconvex,area-52,1451,warlock,destruction,233,114,119
Aksness,stormrage,1448,warlock,destruction,36,18,18
Eriess,burning-blade,1447,warlock,destruction,54,24,30
Sickmade,zuljin,1445,warlock,destruction,24,16,8
Mcjoy,akama,1445,warlock,destruction,224,114,110
Maleficmango,tichondrius,1444,warlock,destruction,36,23,13
Agonie,tichondrius,1443,warlock,destruction,186,95,91
Zetsu,zuljin,1443,warlock,destruction,205,103,102
Ðemented,bleeding-hollow,1442,warlock,destruction,27,16,11
Marcedlc,ragnaros,1442,warlock,destruction,42,24,18
Munar,quelthalas,1442,warlock,destruction,87,44,43
Jaboltz,tichondrius,1441,warlock,destruction,25,16,9
Mantis,proudmoore,1441,warlock,destruction,43,23,20
Nttslock,tichondrius,1441,warlock,destruction,42,22,20
Atrofourth,tichondrius,1441,warlock,destruction,48,23,25
Warlockgomes,azralon,1440,warlock,destruction,127,63,64
Discordant,trollbane,1439,warlock,destruction,36,23,13
Indelock,drenden,1439,warlock,destruction,24,15,9
Janeciap,tichondrius,1439,warlock,destruction,24,15,9
Chaosmorty,tichondrius,1439,warlock,destruction,39,24,15
Danaowns,spirestone,1439,warlock,destruction,30,15,15
Selwitch,dalaran,1438,warlock,destruction,18,15,3
Spectro,laughing-skull,1438,warlock,destruction,18,15,3
Sâlâñzø,bleeding-hollow,1438,warlock,destruction,18,15,3
Dewars,aggramar,1438,warlock,destruction,54,28,26
Deathmásk,ragnaros,1437,warlock,destruction,18,15,3
Goofycupcake,drakthul,1437,warlock,destruction,18,15,3
Kaytoxics,tichondrius,1437,warlock,destruction,18,15,3
Imbooms,blackrock,1437,warlock,destruction,30,15,15
Jämeson,tichondrius,1436,warlock,destruction,24,15,9
Artzul,tichondrius,1436,warlock,destruction,60,25,35
Bourrasq,illidan,1435,warlock,destruction,18,15,3
Mastasnipah,illidan,1435,warlock,destruction,30,15,15
Zettian,quelthalas,1434,warlock,destruction,30,15,15
Felacid,tichondrius,1433,warlock,destruction,48,28,20
Mcrfan,illidan,1432,warlock,destruction,18,15,3
Sëcond,azralon,1432,warlock,destruction,24,15,9
Twototheone,illidan,1432,warlock,destruction,91,47,44
Kayersoul,tichondrius,1432,warlock,destruction,30,15,15
Wasrenai,tichondrius,1432,warlock,destruction,41,20,21
Dance,sargeras,1431,warlock,destruction,18,15,3
Naughtybolts,sargeras,1430,warlock,destruction,18,15,3
Verminosa,nemesis,1429,warlock,destruction,24,15,9
Conorloco,tichondrius,1429,warlock,destruction,36,15,21
Demontos,darkspear,1427,warlock,destruction,48,24,24
Demonicus,thunderlord,1427,warlock,destruction,48,21,27
Pestilocks,area-52,1426,warlock,destruction,26,18,8
Reficul,frostmourne,1426,warlock,destruction,36,15,21
Stonnerz,ragnaros,1425,warlock,destruction,24,16,8
Shadowfork,illidan,1424,warlock,destruction,24,15,9
Thralord,blackrock,1424,warlock,destruction,30,18,12
Straightlock,sargeras,1424,warlock,destruction,53,22,31
Kanekiskid,mannoroth,1423,warlock,destruction,42,29,13
Laklin,stormscale,1423,warlock,destruction,62,29,33
Çrayoneater,tichondrius,1423,warlock,destruction,52,22,30
Soiedentaire,illidan,1422,warlock,destruction,36,30,6
Nueleth,frostmourne,1422,warlock,destruction,47,24,23
Tulu,muradin,1421,warlock,destruction,42,26,16
Loçk,zuljin,1421,warlock,destruction,57,26,31
Yuh,moon-guard,1420,warlock,destruction,18,15,3
Fearloom,tichondrius,1420,warlock,destruction,151,78,73
Decrepticus,kargath,1419,warlock,destruction,44,26,18
Krokodiil,tichondrius,1418,warlock,destruction,36,24,12
Dotsyu,frostmourne,1418,warlock,destruction,44,25,19
Flor,khadgar,1417,warlock,destruction,134,65,69
Deatthmoon,stormrage,1415,warlock,destruction,24,15,9
Chéztér,proudmoore,1415,warlock,destruction,79,39,40
Locker,lightnings-blade,1414,warlock,destruction,30,18,12
Jezwazerox,area-52,1413,warlock,destruction,69,36,33
Budgetkroozz,illidan,1413,warlock,destruction,30,15,15
Bilidin,azralon,1413,warlock,destruction,93,41,52
Vindicated,azgalor,1412,warlock,destruction,25,20,5
Yorchziel,ragnaros,1412,warlock,destruction,88,47,41
Thicclöcc,tichondrius,1410,warlock,destruction,30,15,15
Parmenides,tichondrius,1410,warlock,destruction,42,19,23
Johnnybegood,frostmourne,1409,warlock,destruction,24,15,9
Impdad,destromath,1408,warlock,destruction,36,26,10
Blackguldan,illidan,1405,warlock,destruction,24,15,9
Lightname,arthas,1404,warlock,destruction,24,17,7
Raizël,ragnaros,1404,warlock,destruction,49,28,21
Lockerdoo,aegwynn,1404,warlock,destruction,30,17,13
Bellanomikus,stormrage,1404,warlock,destruction,60,25,35
Drudotzz,hyjal,1403,warlock,destruction,30,16,14
Adderall,altar-of-storms,1402,warlock,destruction,42,20,22
Nezsarek,sargeras,1401,warlock,destruction,152,66,86
Antistar,barthilas,1400,warlock,destruction,43,27,16
Perples,dalaran,1399,warlock,destruction,54,27,27
Lockssy,tichondrius,1398,warlock,destruction,95,56,39
Momshutup,sargeras,1397,warlock,destruction,23,15,8
Iongestpp,bleeding-hollow,1395,warlock,destruction,42,22,20
Rotsndotss,thrall,1393,warlock,destruction,33,16,17
Shadococo,tichondrius,1393,warlock,destruction,36,16,20
Adhauto,illidan,1390,warlock,destruction,113,62,51
Exofilth,thrall,1390,warlock,destruction,36,15,21
Tergale,illidan,1388,warlock,destruction,66,28,38
Nazzlock,lethon,1387,warlock,destruction,29,16,13
Rangmar,ragnaros,1385,warlock,destruction,39,18,21
Loadybigbolt,dalaran,1385,warlock,destruction,39,17,22
Gorelami,tichondrius,1384,warlock,destruction,42,23,19
Evillyñ,tichondrius,1384,warlock,destruction,48,25,23
Necrotic,antonidas,1379,warlock,destruction,66,33,33
Eldriptch,kelthuzad,1379,warlock,destruction,30,15,15
Coreleron,proudmoore,1378,warlock,destruction,61,29,32
Siccwidit,area-52,1378,warlock,destruction,74,34,40
Avae,frostmourne,1376,warlock,destruction,78,42,36
Lockonthc,korgath,1375,warlock,destruction,32,16,16
Kecca,azralon,1373,warlock,destruction,60,33,27
Telvanni,sargeras,1371,warlock,destruction,30,21,9
Doublebolt,illidan,1371,warlock,destruction,57,36,21
Connect,borean-tundra,1371,warlock,destruction,35,18,17
Dessoft,ragnaros,1371,warlock,destruction,36,17,19
Notchinese,kiljaeden,1371,warlock,destruction,35,16,19
Foxfoxfel,thrall,1369,warlock,destruction,24,16,8
Lladyyheartt,nesingwary,1368,warlock,destruction,48,26,22
Év,azralon,1367,warlock,destruction,36,16,20
Extinção,azralon,1366,warlock,destruction,56,35,21
Getpissed,emerald-dream,1365,warlock,destruction,65,32,33
Critneyfearz,stormscale,1365,warlock,destruction,47,22,25
Blindingsun,kiljaeden,1365,warlock,destruction,72,27,45
Jhop,sargeras,1364,warlock,destruction,54,31,23
Luxenna,malganis,1363,warlock,destruction,84,40,44
Saddestboi,proudmoore,1362,warlock,destruction,36,23,13
Esteedees,moon-guard,1361,warlock,destruction,42,16,26
Wackykid,azralon,1360,warlock,destruction,80,36,44
Spicywhite,tichondrius,1359,warlock,destruction,25,15,10
Freggen,shadowsong,1358,warlock,destruction,24,15,9
Iceameri,tichondrius,1358,warlock,destruction,36,19,17
Azöd,tichondrius,1356,warlock,destruction,63,40,23
Matdamon,barthilas,1354,warlock,destruction,60,33,27
Xoxoxu,frostmourne,1352,warlock,destruction,26,15,11
Ptheven,area-52,1351,warlock,destruction,28,19,9
Neodron,thrall,1351,warlock,destruction,57,38,19
Demonista,illidan,1349,warlock,destruction,19,15,4
Karadelice,stormrage,1349,warlock,destruction,54,29,25
Razizzles,malganis,1345,warlock,destruction,72,42,30
Zinkro,quelthalas,1345,warlock,destruction,50,17,33
Odjure,zuljin,1344,warlock,destruction,23,14,9
Soulruler,tichondrius,1344,warlock,destruction,24,14,10
Chazzlock,area-52,1344,warlock,destruction,24,14,10
Spreadnhiv,thrall,1344,warlock,destruction,42,18,24
Loksoflove,tichondrius,1343,warlock,destruction,18,14,4
Kryl,kiljaeden,1343,warlock,destruction,24,14,10
Starta,tichondrius,1343,warlock,destruction,24,14,10
Sktfäker,sargeras,1343,warlock,destruction,24,14,10
Toggafputuhs,illidan,1343,warlock,destruction,24,14,10
Súpersonic,tichondrius,1343,warlock,destruction,24,14,10
Gingerlocky,barthilas,1343,warlock,destruction,94,44,50
Austen,tichondrius,1343,warlock,destruction,55,24,31
Wizlox,illidan,1343,warlock,destruction,80,33,47
Lockonomicz,tichondrius,1342,warlock,destruction,24,14,10
Marware,quelthalas,1342,warlock,destruction,30,14,16
Plaintive,moon-guard,1341,warlock,destruction,24,14,10
Shadowsloc,tichondrius,1340,warlock,destruction,24,14,10
Bobbygoulant,tichondrius,1340,warlock,destruction,259,128,131
Grammapatty,tichondrius,1339,warlock,destruction,24,14,10
Aemma,proudmoore,1338,warlock,destruction,18,14,4
Pantypeeler,barthilas,1338,warlock,destruction,60,35,25
Scãryz,jubeithos,1338,warlock,destruction,50,29,21
Magiaoscurax,quelthalas,1338,warlock,destruction,42,20,22
Veerdz,area-52,1338,warlock,destruction,30,14,16
Éx,jubeithos,1337,warlock,destruction,18,14,4
Dealcloud,tichondrius,1337,warlock,destruction,56,29,27
Gingerspise,nathrezim,1337,warlock,destruction,30,14,16
Vilebeing,frostmourne,1336,warlock,destruction,18,14,4
Bunnyhugs,gorefiend,1336,warlock,destruction,18,14,4
Sugmabone,zuluhed,1336,warlock,destruction,24,17,7
Gukky,misha,1336,warlock,destruction,89,55,34
Memon,frostmane,1336,warlock,destruction,36,19,17
Fearsntears,stormrage,1336,warlock,destruction,36,14,22
Theredwoman,emerald-dream,1335,warlock,destruction,30,14,16
Swapsfour,area-52,1334,warlock,destruction,24,14,10
Lòthloria,mannoroth,1334,warlock,destruction,149,74,75
Majinbuû,malganis,1334,warlock,destruction,30,14,16
Lilibe,tichondrius,1334,warlock,destruction,42,19,23
Spongebobjrj,tichondrius,1331,warlock,destruction,36,20,16
Aomniloltv,zuljin,1331,warlock,destruction,47,24,23
Grandpapapa,tichondrius,1330,warlock,destruction,54,22,32
Darksolace,dalaran,1329,warlock,destruction,24,14,10
Freestyle,blackwater-raiders,1328,warlock,destruction,54,34,20
Celeden,emerald-dream,1327,warlock,destruction,30,18,12
Lockdogg,mannoroth,1327,warlock,destruction,24,14,10
Salties,magtheridon,1326,warlock,destruction,24,14,10
Kevin,moon-guard,1323,warlock,destruction,24,14,10
Drcameron,zuljin,1322,warlock,destruction,24,15,9
Ehcsrop,doomhammer,1322,warlock,destruction,80,41,39
Gòtti,frostmourne,1320,warlock,destruction,24,14,10
Griget,runetotem,1320,warlock,destruction,47,24,23
Jugerdotz,sargeras,1320,warlock,destruction,30,14,16
Notäçultist,nagrand,1317,warlock,destruction,30,17,13
Jeramie,darkspear,1317,warlock,destruction,38,17,21
Zephee,queldorei,1315,warlock,destruction,36,22,14
Predictions,sargeras,1315,warlock,destruction,35,17,18
Undies,demon-soul,1314,warlock,destruction,72,39,33
Jecklez,tichondrius,1312,warlock,destruction,135,70,65
Verdoso,stormrage,1310,warlock,destruction,30,16,14
Condevil,quelthalas,1308,warlock,destruction,35,21,14
Dotyoazz,tichondrius,1308,warlock,destruction,38,22,16
Dotsfired,crushridge,1307,warlock,destruction,24,15,9
Downbad,ysera,1305,warlock,destruction,37,16,21
Gscar,area-52,1303,warlock,destruction,48,28,20
Wadoom,tichondrius,1302,warlock,destruction,48,23,25
Felqueenn,windrunner,1301,warlock,destruction,30,19,11
Mickylock,tichondrius,1301,warlock,destruction,75,43,32
Voidchaos,korgath,1300,warlock,destruction,18,14,4
Bustednut,nerzhul,1293,warlock,destruction,74,40,34
Rauwërrs,azralon,1292,warlock,destruction,55,26,29
Kombat,amanthul,1292,warlock,destruction,71,32,39
Stinkychef,hyjal,1287,warlock,destruction,18,14,4
Lolimalock,bleeding-hollow,1286,warlock,destruction,35,19,16
Haxlock,azralon,1282,warlock,destruction,34,15,19
Chuwhee,sargeras,1282,warlock,destruction,48,14,34
Awfeelya,sargeras,1281,warlock,destruction,29,17,12
Sylestrio,feathermoon,1281,warlock,destruction,42,18,24
Hurriicane,stormrage,1280,warlock,destruction,92,48,44
Ahrimus,area-52,1275,warlock,destruction,28,14,14
Potatostew,dalaran,1273,warlock,destruction,36,14,22
Derfflinger,tichondrius,1270,warlock,destruction,118,49,69
Felryssa,kiljaeden,1269,warlock,destruction,60,29,31
Prinzheinric,quelthalas,1267,warlock,destruction,33,21,12
Kyle,shandris,1267,warlock,destruction,45,21,24
Schmok,terenas,1266,warlock,destruction,34,20,14
Thizzmaa,area-52,1266,warlock,destruction,31,16,15
Lockednloade,tichondrius,1265,warlock,destruction,51,28,23
Gattsonn,kiljaeden,1259,warlock,destruction,42,15,27
Tichonkimc,tichondrius,1256,warlock,destruction,32,16,16
Mordekhay,tichondrius,1255,warlock,destruction,62,30,32
Ticktóck,ghostlands,1253,warlock,destruction,19,14,5
Kortinanga,tichondrius,1252,warlock,destruction,54,30,24
Iiferna,sargeras,1252,warlock,destruction,107,51,56
Eurygnomous,thrall,1252,warlock,destruction,30,14,16
Ganosh,aggramar,1251,warlock,destruction,56,31,25
Beastsuper,tichondrius,1248,warlock,destruction,24,13,11
Voqo,shandris,1247,warlock,destruction,18,13,5
Nahalmaeim,tichondrius,1247,warlock,destruction,18,13,5
Pressurë,tichondrius,1247,warlock,destruction,18,13,5
Rèdrùm,tichondrius,1247,warlock,destruction,24,13,11
Kimsoul,zuljin,1247,warlock,destruction,24,13,11
Grenswood,arathor,1247,warlock,destruction,27,14,13
Lotussama,anetheron,1246,warlock,destruction,18,13,5
Skanckqt,malganis,1246,warlock,destruction,24,13,11
Inaane,thrall,1246,warlock,destruction,24,13,11
Hauntsin,hyjal,1246,warlock,destruction,30,13,17
Destructo,illidan,1245,warlock,destruction,30,13,17
Sladez,tichondrius,1245,warlock,destruction,36,13,23
Toastwl,tichondrius,1244,warlock,destruction,18,13,5
Pkzy,azralon,1244,warlock,destruction,24,13,11
Lhandus,drakkari,1243,warlock,destruction,24,13,11
Nigsy,nagrand,1242,warlock,destruction,24,13,11
Spòngwò,tichondrius,1242,warlock,destruction,24,13,11
Felpsychosis,illidan,1242,warlock,destruction,66,33,33
Wineburger,frostmourne,1241,warlock,destruction,18,13,5
Mothmayhem,moon-guard,1241,warlock,destruction,24,13,11
Shadü,tichondrius,1241,warlock,destruction,36,14,22
Babydots,stormreaver,1240,warlock,destruction,24,13,11
Sendnudez,nemesis,1240,warlock,destruction,24,13,11
Covírus,azralon,1237,warlock,destruction,18,13,5
Evapilot,tichondrius,1237,warlock,destruction,24,13,11
Pruevolf,tichondrius,1236,warlock,destruction,80,35,45
Xbqss,illidan,1236,warlock,destruction,30,13,17
Rainymood,frostmourne,1233,warlock,destruction,18,13,5
Munick,spirestone,1233,warlock,destruction,24,13,11
Dalruk,wyrmrest-accord,1232,warlock,destruction,18,13,5
Klatuu,stonemaul,1232,warlock,destruction,24,15,9
Chaotíc,zuljin,1231,warlock,destruction,24,13,11
Sû,stormrage,1231,warlock,destruction,54,19,35
Wåbi,tichondrius,1228,warlock,destruction,30,13,17
Impieties,emerald-dream,1228,warlock,destruction,36,14,22
Ellneggro,zuljin,1226,warlock,destruction,18,13,5
Mèrlin,aerie-peak,1226,warlock,destruction,18,13,5
Titusvorenus,runetotem,1226,warlock,destruction,24,13,11
Rickyspanish,malygos,1226,warlock,destruction,30,13,17
Zoluraan,proudmoore,1225,warlock,destruction,39,25,14
Kyrionn,azralon,1225,warlock,destruction,24,13,11
Blockk,moknathal,1216,warlock,destruction,62,26,36
Zydaria,stormrage,1213,warlock,destruction,30,18,12
Erevas,area-52,1213,warlock,destruction,24,14,10
Prototyp,azralon,1212,warlock,destruction,18,13,5
Daeykras,crushridge,1209,warlock,destruction,28,17,11
Beldiinlock,khazgoroth,1207,warlock,destruction,69,35,34
Felinå,hyjal,1206,warlock,destruction,39,24,15
Valval,moon-guard,1206,warlock,destruction,60,21,39
Superbroly,area-52,1204,warlock,destruction,30,16,14
Luulloo,proudmoore,1203,warlock,destruction,54,29,25
Blew,bleeding-hollow,1200,warlock,destruction,15,14,1
Nhen,daggerspine,1196,warlock,destruction,113,63,50
Zaeloc,ragnaros,1195,warlock,destruction,42,13,29
Nybeth,malganis,1194,warlock,destruction,23,13,10
Spookyfurry,area-52,1192,warlock,destruction,30,13,17
Umdur,zuljin,1191,warlock,destruction,27,13,14
Mocreia,azralon,1191,warlock,destruction,53,23,30
Bénn,moon-guard,1189,warlock,destruction,60,39,21
Cørruption,emerald-dream,1188,warlock,destruction,47,22,25
Pancakestack,stormrage,1187,warlock,destruction,73,38,35
Kärên,proudmoore,1185,warlock,destruction,22,16,6
Sutra,tichondrius,1185,warlock,destruction,23,14,9
Chodetamer,lethon,1180,warlock,destruction,29,18,11
Necrodeath,malygos,1180,warlock,destruction,30,15,15
Maldíta,quelthalas,1180,warlock,destruction,117,52,65
Kemchaos,illidan,1179,warlock,destruction,48,21,27
Kidsoul,illidan,1178,warlock,destruction,97,46,51
Nanodingo,tichondrius,1176,warlock,destruction,59,30,29
Funnysoxx,caelestrasz,1171,warlock,destruction,28,13,15
Covenslave,nemesis,1169,warlock,destruction,205,95,110
Ilovedemons,aegwynn,1168,warlock,destruction,42,26,16
Rodimus,hyjal,1167,warlock,destruction,87,50,37
Bawldimort,stormrage,1165,warlock,destruction,89,46,43
Dex,jubeithos,1163,warlock,destruction,47,13,34
Theporkchunk,nordrassil,1162,warlock,destruction,24,17,7
Aerozyn,wyrmrest-accord,1161,warlock,destruction,30,16,14
Dudda,sargeras,1152,warlock,destruction,12,12,0
Rightwaylovê,illidan,1152,warlock,destruction,18,12,6
Osmatz,area-52,1152,warlock,destruction,18,12,6
Sphoo,tichondrius,1152,warlock,destruction,18,12,6
Dxhusky,tichondrius,1151,warlock,destruction,18,12,6
Blastamastah,tichondrius,1151,warlock,destruction,18,12,6
Shutupthug,illidan,1151,warlock,destruction,18,12,6
Lockdotsftw,illidan,1151,warlock,destruction,24,12,12
Oceangrownx,emerald-dream,1151,warlock,destruction,24,12,12
Flûké,tichondrius,1151,warlock,destruction,24,12,12
Homeboyardee,the-venture-co,1151,warlock,destruction,24,12,12
Asmit,firetree,1151,warlock,destruction,28,13,15
Zaiocian,tichondrius,1151,warlock,destruction,26,12,14
Mattypatty,the-forgotten-coast,1150,warlock,destruction,18,12,6
Dralok,area-52,1150,warlock,destruction,18,12,6
Ñigorshedøn,area-52,1150,warlock,destruction,18,12,6
Cesily,frostmourne,1150,warlock,destruction,24,12,12
Iggyiggy,sargeras,1149,warlock,destruction,24,12,12
Siellisele,illidan,1149,warlock,destruction,24,12,12
Ole,area-52,1149,warlock,destruction,27,13,14
Poock,goldrinn,1148,warlock,destruction,18,12,6
Kylaria,emerald-dream,1148,warlock,destruction,24,12,12
Gwar,khazgoroth,1148,warlock,destruction,90,35,55
Omarlil,kelthuzad,1147,warlock,destruction,18,12,6
Aboode,blackrock,1147,warlock,destruction,29,13,16
Nadirius,shadowmoon,1146,warlock,destruction,18,12,6
Shïrõ,tichondrius,1145,warlock,destruction,18,12,6
Handler,earthen-ring,1142,warlock,destruction,42,28,14
Gridwild,drakkari,1142,warlock,destruction,24,12,12
Løvesick,zuljin,1141,warlock,destruction,30,12,18
Sunkuna,aerie-peak,1141,warlock,destruction,36,13,23
Hawkstalker,thaurissan,1140,warlock,destruction,40,21,19
Nadek,tichondrius,1140,warlock,destruction,24,12,12
Lessance,dalaran,1138,warlock,destruction,24,12,12
Cælohin,tichondrius,1132,warlock,destruction,24,12,12
Dlchem,tichondrius,1126,warlock,destruction,18,12,6
Timmerstar,tichondrius,1124,warlock,destruction,42,20,22
Rageraff,trollbane,1121,warlock,destruction,30,18,12
Nocchi,amanthul,1119,warlock,destruction,22,12,10
Aeonora,akama,1117,warlock,destruction,18,12,6
Josemb,ragnaros,1114,warlock,destruction,26,14,12
Ðeãdman,bleeding-hollow,1112,warlock,destruction,20,13,7
Marvolö,darkspear,1112,warlock,destruction,24,15,9
Kracky,tichondrius,1104,warlock,destruction,86,49,37
Anstik,area-52,1103,warlock,destruction,15,13,2
Mshyde,gurubashi,1100,warlock,destruction,18,12,6
Madgettike,stormrage,1094,warlock,destruction,36,22,14
Varuuss,ragnaros,1092,warlock,destruction,21,12,9
Mindfulchimp,sargeras,1092,warlock,destruction,23,12,11
Cheiff,tichondrius,1092,warlock,destruction,42,16,26
Imprecátion,tichondrius,1089,warlock,destruction,41,12,29
Taìnted,lightbringer,1088,warlock,destruction,28,12,16
Medeia,tichondrius,1087,warlock,destruction,23,12,11
Skynflute,tichondrius,1087,warlock,destruction,28,12,16
Escro,azgalor,1085,warlock,destruction,66,38,28
Spicý,sargeras,1084,warlock,destruction,63,31,32
Punishment,jubeithos,1080,warlock,destruction,17,12,5
Wìckedelf,area-52,1078,warlock,destruction,57,29,28
Locksoul,area-52,1077,warlock,destruction,36,18,18
Phreaky,area-52,1072,warlock,destruction,36,17,19
Juniorsalanu,quelthalas,1067,warlock,destruction,24,13,11
Toby,azralon,1066,warlock,destruction,25,12,13
Romminus,zuljin,1065,warlock,destruction,19,12,7
Davnport,frostmourne,1065,warlock,destruction,38,12,26
Luke,lightnings-blade,1062,warlock,destruction,18,12,6
Caesaros,quelthalas,1057,warlock,destruction,25,12,13
Bumbleebolts,azralon,1056,warlock,destruction,12,11,1
Boltsnhoez,tichondrius,1056,warlock,destruction,16,12,4
Boodizz,frostmourne,1056,warlock,destruction,18,11,7
Thragèqt,sargeras,1056,warlock,destruction,18,11,7
Drböb,area-52,1056,warlock,destruction,18,11,7
Tacticalderp,bleeding-hollow,1056,warlock,destruction,24,11,13
Drsmegmaz,dreadmaul,1056,warlock,destruction,24,11,13
Edeklock,frostmourne,1055,warlock,destruction,12,11,1
Gladyr,frostmourne,1055,warlock,destruction,18,11,7
Alktrz,azralon,1055,warlock,destruction,18,11,7
Dreadxbolts,stormrage,1055,warlock,destruction,18,11,7
Fabiusbilex,tichondrius,1055,warlock,destruction,18,11,7
Mindheist,stormrage,1055,warlock,destruction,18,11,7
Matilla,tichondrius,1055,warlock,destruction,18,11,7
Feardotzrun,illidan,1055,warlock,destruction,18,11,7
Sahdude,illidan,1055,warlock,destruction,18,11,7
Tuzadin,tichondrius,1055,warlock,destruction,18,11,7
Ðòt,nagrand,1055,warlock,destruction,18,11,7
Guldansbicep,illidan,1055,warlock,destruction,22,12,10
Bolsheivik,dentarg,1054,warlock,destruction,18,11,7
Vigius,dalaran,1054,warlock,destruction,18,11,7
Locksolo,tichondrius,1054,warlock,destruction,18,11,7
Spudzies,bleeding-hollow,1054,warlock,destruction,24,11,13
Dipz,zuljin,1053,warlock,destruction,18,11,7
Buffwarlockz,stormrage,1053,warlock,destruction,18,11,7
Faënn,zuljin,1053,warlock,destruction,18,11,7
Baldandugly,illidan,1052,warlock,destruction,18,11,7
Honchoe,illidan,1052,warlock,destruction,18,11,7
Trastham,malganis,1052,warlock,destruction,24,11,13
Blanklee,tichondrius,1051,warlock,destruction,12,11,1
Unprønuncea,azralon,1050,warlock,destruction,25,11,14
Taylôr,proudmoore,1049,warlock,destruction,24,11,13
Tirp,illidan,1048,warlock,destruction,24,11,13
Pokemebutt,hydraxis,1046,warlock,destruction,18,11,7
Patagucci,bleeding-hollow,1046,warlock,destruction,18,11,7
Nazgal,tichondrius,1046,warlock,destruction,21,12,9
Ltr,moon-guard,1045,warlock,destruction,18,11,7
Haloren,moon-guard,1044,warlock,destruction,18,11,7
Barathron,tichondrius,1044,warlock,destruction,36,11,25
Xenagos,antonidas,1043,warlock,destruction,30,11,19
Seeword,sargeras,1039,warlock,destruction,18,11,7
Gambel,duskwood,1038,warlock,destruction,24,11,13
Saraphina,maiev,1033,warlock,destruction,108,44,64
Mysophobia,frostmourne,1032,warlock,destruction,53,22,31
Baiss,tichondrius,1030,warlock,destruction,18,11,7
Danoinfelizz,nemesis,1029,warlock,destruction,15,12,3
Noriaeradra,illidan,1025,warlock,destruction,24,13,11
Shedara,ragnaros,1023,warlock,destruction,17,11,6
Getsmoked,moknathal,1023,warlock,destruction,23,11,12
Cumbledor,bleeding-hollow,1023,warlock,destruction,26,12,14
Darthlockz,illidan,1020,warlock,destruction,18,11,7
Cascades,icecrown,1019,warlock,destruction,96,38,58
Nathalyâ,drakkari,1018,warlock,destruction,60,28,32
Superbvious,lothar,1012,warlock,destruction,37,13,24
Bobthedoc,sargeras,1011,warlock,destruction,23,11,12
Faliceu,sargeras,1006,warlock,destruction,26,11,15
Panyc,tichondrius,1002,warlock,destruction,23,11,12
Ticklebolts,tichondrius,1001,warlock,destruction,34,12,22
Valerilma,azralon,998,warlock,destruction,23,11,12
Wingzerø,tichondrius,988,warlock,destruction,23,11,12
Nevermorde,area-52,986,warlock,destruction,23,11,12
Wafflezcb,frostmourne,976,warlock,destruction,19,11,8
Hanoaa,tichondrius,975,warlock,destruction,11,11,0
Nikôlas,stormrage,975,warlock,destruction,48,21,27
Zíppen,proudmoore,970,warlock,destruction,61,30,31
Plagueis,zuluhed,969,warlock,destruction,25,11,14
Kimis,azralon,963,warlock,destruction,24,14,10
Drwongmd,sargeras,960,warlock,destruction,12,10,2
Jaboy,dragonmaw,960,warlock,destruction,12,10,2
Fxckyuo,tichondrius,960,warlock,destruction,12,10,2
Kammuany,sargeras,960,warlock,destruction,12,10,2
Retwarr,tichondrius,960,warlock,destruction,12,10,2
Maldivà,tichondrius,960,warlock,destruction,12,10,2
Nino,barthilas,960,warlock,destruction,12,10,2
Letmecastpls,tichondrius,960,warlock,destruction,12,10,2
Lockbtw,altar-of-storms,960,warlock,destruction,12,10,2
Wanglock,blackrock,960,warlock,destruction,12,10,2
Minglocked,proudmoore,960,warlock,destruction,12,10,2
Lilshedon,kelthuzad,960,warlock,destruction,12,10,2
Fearem,tichondrius,960,warlock,destruction,15,11,4
Teefgap,sargeras,960,warlock,destruction,18,10,8
Baka,moon-guard,960,warlock,destruction,18,10,8
Veryezgame,tichondrius,960,warlock,destruction,18,10,8
Areufearious,sargeras,960,warlock,destruction,18,10,8
Teivlol,mugthol,960,warlock,destruction,18,10,8
Dimanel,moon-guard,960,warlock,destruction,18,10,8
Contägion,bleeding-hollow,960,warlock,destruction,24,10,14
Dkdakìng,dalaran,959,warlock,destruction,12,10,2
Foxar,stormrage,959,warlock,destruction,12,10,2
Mixolydian,malganis,959,warlock,destruction,12,10,2
Britnyfearz,illidan,959,warlock,destruction,12,10,2
Percaddict,illidan,959,warlock,destruction,12,10,2
Naughtybôlts,sargeras,959,warlock,destruction,15,10,5
Knockknock,llane,959,warlock,destruction,18,10,8
Kongal,tichondrius,959,warlock,destruction,18,10,8
Years,moon-guard,959,warlock,destruction,18,10,8
Sixonenine,boulderfist,959,warlock,destruction,18,10,8
Soulicit,kelthuzad,959,warlock,destruction,18,10,8
Notatryhard,emerald-dream,959,warlock,destruction,18,10,8
Maral,kelthuzad,959,warlock,destruction,18,10,8
Thânàtös,malganis,959,warlock,destruction,18,10,8
Wickedry,antonidas,959,warlock,destruction,18,10,8
Riptyler,illidan,959,warlock,destruction,18,10,8
Pykorrg,ragnaros,959,warlock,destruction,24,10,14
Asetiks,tichondrius,959,warlock,destruction,24,10,14
Trobgol,bleeding-hollow,958,warlock,destruction,12,10,2
Helraz,darkspear,958,warlock,destruction,12,10,2
Mørgoth,thrall,958,warlock,destruction,18,10,8
Yibbel,area-52,958,warlock,destruction,18,10,8
Chrishasnen,moon-guard,958,warlock,destruction,24,10,14
Morcegø,azralon,958,warlock,destruction,24,10,14
Newty,zuljin,957,warlock,destruction,12,10,2
Xerozus,tichondrius,957,warlock,destruction,18,10,8
Dialalock,frostmourne,957,warlock,destruction,18,10,8
Dercrow,quelthalas,957,warlock,destruction,18,10,8
Kåos,kelthuzad,957,warlock,destruction,18,10,8
Greasymario,area-52,957,warlock,destruction,22,11,11
Dippidydot,illidan,957,warlock,destruction,24,10,14
Ragnalock,laughing-skull,956,warlock,destruction,18,10,8
Manã,wyrmrest-accord,956,warlock,destruction,18,10,8
Muchoprecogo,tichondrius,956,warlock,destruction,18,10,8
Graced,dalaran,956,warlock,destruction,18,10,8
Dårkfyre,kiljaeden,956,warlock,destruction,18,10,8
Raidspot,bleeding-hollow,956,warlock,destruction,24,10,14
Yarrz,kelthuzad,955,warlock,destruction,12,10,2
Friendd,frostmourne,955,warlock,destruction,18,10,8
Zaintv,illidan,955,warlock,destruction,18,10,8
Chaoticstorm,area-52,955,warlock,destruction,18,10,8
Dvorakk,frostmourne,954,warlock,destruction,15,11,4
Harleyjames,ravenholdt,953,warlock,destruction,18,10,8
Sñeed,sargeras,953,warlock,destruction,25,11,14
Siliconsnipe,tichondrius,952,warlock,destruction,12,10,2
Punjj,jubeithos,952,warlock,destruction,18,10,8
Huuchie,moon-guard,951,warlock,destruction,18,10,8
Puscifear,azralon,951,warlock,destruction,30,10,20
Sojupain,kaelthas,950,warlock,destruction,12,10,2
Moreedotss,malganis,947,warlock,destruction,30,10,20
Hamadan,azralon,946,warlock,destruction,24,10,14
Cursé,stormrage,944,warlock,destruction,18,10,8
Mogran,twisting-nether,934,warlock,destruction,18,10,8
Marlett,destromath,929,warlock,destruction,107,56,51
Neph,malganis,927,warlock,destruction,20,11,9
Goal,malganis,927,warlock,destruction,20,11,9
Astarõth,zuljin,926,warlock,destruction,26,11,15
Twohandedkil,stormrage,920,warlock,destruction,26,11,15
Keleiron,velen,916,warlock,destruction,18,10,8
Xekk,wyrmrest-accord,910,warlock,destruction,23,10,13
Wawfw,bleeding-hollow,909,warlock,destruction,15,11,4
Rnicu,bonechewer,908,warlock,destruction,45,18,27
Locksyy,tichondrius,907,warlock,destruction,29,10,19
Lockyy,khaz-modan,904,warlock,destruction,26,11,15
Ppoonlock,tichondrius,896,warlock,destruction,22,10,12
Katsby,moon-guard,894,warlock,destruction,17,10,7
Fiennx,dalaran,894,warlock,destruction,17,10,7
Rakudemon,ragnaros,894,warlock,destruction,20,10,10
Savagetheron,korgath,887,warlock,destruction,18,10,8
Lafuke,tichondrius,880,warlock,destruction,13,10,3
Pyria,boulderfist,877,warlock,destruction,13,10,3
Drezx,frostmourne,864,warlock,destruction,12,9,3
Matthewx,stormrage,864,warlock,destruction,12,9,3
Whaad,tichondrius,864,warlock,destruction,12,9,3
Lysitheä,moon-guard,864,warlock,destruction,12,9,3
Pengliyuaner,illidan,864,warlock,destruction,12,9,3
Fenriakshog,zuljin,864,warlock,destruction,12,9,3
Baddummy,tichondrius,864,warlock,destruction,12,9,3
Liuh,tichondrius,864,warlock,destruction,12,9,3
Soulbane,jubeithos,864,warlock,destruction,12,9,3
Quickzmaster,blackrock,864,warlock,destruction,12,9,3
Golock,tichondrius,864,warlock,destruction,12,9,3
Moóndust,bleeding-hollow,864,warlock,destruction,12,9,3
Pugnatwo,kelthuzad,864,warlock,destruction,12,9,3
Lokiy,ragnaros,864,warlock,destruction,12,9,3
Voidsoda,whisperwind,864,warlock,destruction,12,9,3
Frustration,darkspear,864,warlock,destruction,12,9,3
Rice,lothar,864,warlock,destruction,12,9,3
Øutbreak,thrall,864,warlock,destruction,12,9,3
Bonita,garona,864,warlock,destruction,12,9,3
Raxxis,moon-guard,864,warlock,destruction,12,9,3
Stuffs,wyrmrest-accord,864,warlock,destruction,18,9,9
Bigolehogger,area-52,864,warlock,destruction,18,9,9
Miroir,illidan,864,warlock,destruction,18,9,9
Wampeter,azshara,864,warlock,destruction,18,9,9
Voidxo,tichondrius,864,warlock,destruction,18,9,9
Itstista,proudmoore,864,warlock,destruction,18,9,9
Biggbolts,tichondrius,864,warlock,destruction,18,9,9
Shadowmoonon,tichondrius,864,warlock,destruction,18,9,9
Reflexlock,malganis,864,warlock,destruction,18,9,9
Oymmander,illidan,864,warlock,destruction,18,9,9
Woopie,malfurion,864,warlock,destruction,18,9,9
Shendù,stormrage,864,warlock,destruction,24,9,15
Greedy,garrosh,863,warlock,destruction,12,9,3
Azrezzael,area-52,863,warlock,destruction,12,9,3
Shooff,area-52,863,warlock,destruction,12,9,3
Ahrimaan,illidan,863,warlock,destruction,12,9,3
Mateekabr,malganis,863,warlock,destruction,12,9,3
Mjndewb,tichondrius,863,warlock,destruction,12,9,3
Zycas,tichondrius,863,warlock,destruction,12,9,3
Pacopico,illidan,863,warlock,destruction,12,9,3
Glergarby,stormscale,863,warlock,destruction,15,10,5
Tromeo,sargeras,863,warlock,destruction,18,9,9
Ruknài,barthilas,863,warlock,destruction,18,9,9
Rothmar,bleeding-hollow,863,warlock,destruction,18,9,9
Cyio,zuljin,863,warlock,destruction,18,9,9
Minzyw,illidan,863,warlock,destruction,18,9,9
Rhabdo,ravenholdt,863,warlock,destruction,18,9,9
Dmox,darkspear,863,warlock,destruction,18,9,9
Nethron,the-venture-co,863,warlock,destruction,18,9,9
Goarage,tichondrius,863,warlock,destruction,22,10,12
Rokdas,area-52,863,warlock,destruction,24,9,15
Cogitoergo,stormrage,862,warlock,destruction,12,9,3
Cvntpvntcans,kelthuzad,862,warlock,destruction,12,9,3
Locklockdead,earthen-ring,862,warlock,destruction,12,9,3
Çhåos,destromath,862,warlock,destruction,12,9,3
Namig,aerie-peak,862,warlock,destruction,12,9,3
Pyresworn,wyrmrest-accord,862,warlock,destruction,12,9,3
Artheás,azralon,862,warlock,destruction,18,9,9
Nmelock,malganis,862,warlock,destruction,18,9,9
Breaad,tichondrius,862,warlock,destruction,24,9,15
Tanathoz,thrall,862,warlock,destruction,28,10,18
Methandmmkay,illidan,861,warlock,destruction,15,10,5
Funnelcakies,area-52,861,warlock,destruction,18,9,9
Warlo,moonrunner,860,warlock,destruction,12,9,3
Shipmatelock,stormrage,860,warlock,destruction,12,9,3
Damdochael,bleeding-hollow,860,warlock,destruction,24,9,15
Githany,hyjal,859,warlock,destruction,18,9,9
Gorskij,frostwolf,859,warlock,destruction,19,9,10
Cynwise,arathor,858,warlock,destruction,18,9,9
Hookslinger,barthilas,856,warlock,destruction,18,9,9
Shadohz,lightnings-blade,855,warlock,destruction,12,9,3
Klummzy,tichondrius,850,warlock,destruction,18,9,9
Vampir,hellscream,850,warlock,destruction,24,9,15
Rustý,illidan,834,warlock,destruction,17,9,8
Jannus,wyrmrest-accord,834,warlock,destruction,26,11,15
Freakdoa,blades-edge,834,warlock,destruction,53,20,33
Ovosound,tichondrius,815,warlock,destruction,11,9,2
Chaospump,frostmourne,815,warlock,destruction,17,9,8
Rockzilatour,tichondrius,815,warlock,destruction,17,9,8
Metamòrph,malganis,810,warlock,destruction,16,10,6
Taneverah,wyrmrest-accord,799,warlock,destruction,11,9,2
Felancholy,illidan,788,warlock,destruction,14,10,4
Tempestzone,barthilas,775,warlock,destruction,19,10,9
Roblockz,illidan,768,warlock,destruction,12,8,4
Necrotiá,tichondrius,768,warlock,destruction,12,8,4
Dazedl,stormrage,768,warlock,destruction,12,8,4
Shatteroidz,darkspear,768,warlock,destruction,12,8,4
Kápz,darkspear,768,warlock,destruction,12,8,4
Romdi,tichondrius,768,warlock,destruction,12,8,4
Elldiablo,darkspear,768,warlock,destruction,12,8,4
Dëception,ragnaros,768,warlock,destruction,12,8,4
Munje,bleeding-hollow,768,warlock,destruction,12,8,4
Badhombre,tichondrius,768,warlock,destruction,12,8,4
Searinox,scilla,768,warlock,destruction,12,8,4
Aptukk,archimonde,768,warlock,destruction,12,8,4
Zunexx,malganis,768,warlock,destruction,12,8,4
Flavakid,malganis,768,warlock,destruction,12,8,4
Clorvenna,zuljin,768,warlock,destruction,12,8,4
Falsaqt,area-52,768,warlock,destruction,12,8,4
Flake,kelthuzad,768,warlock,destruction,12,8,4
Xidothewitch,stormrage,768,warlock,destruction,12,8,4
Dadtired,tichondrius,768,warlock,destruction,12,8,4
Shinagae,tichondrius,768,warlock,destruction,12,8,4
Diznei,nemesis,768,warlock,destruction,12,8,4
Palumorl,deathwing,768,warlock,destruction,12,8,4
Rebolting,tichondrius,768,warlock,destruction,12,8,4
Narzhul,drakkari,768,warlock,destruction,12,8,4
Slackjaww,kiljaeden,768,warlock,destruction,12,8,4
Blodrain,tichondrius,768,warlock,destruction,12,8,4
Smeezles,frostmourne,768,warlock,destruction,12,8,4
Idoovoodoo,burning-legion,768,warlock,destruction,12,8,4
Flackory,tichondrius,768,warlock,destruction,12,8,4
Identiti,tichondrius,768,warlock,destruction,12,8,4
Devi,executus,768,warlock,destruction,12,8,4
Fearsponce,dragonmaw,768,warlock,destruction,12,8,4
Pandasrlegit,burning-blade,768,warlock,destruction,12,8,4
Bopplock,tichondrius,768,warlock,destruction,12,8,4
Fece,area-52,768,warlock,destruction,12,8,4
Ayedss,dalaran,768,warlock,destruction,12,8,4
Søulswap,tichondrius,768,warlock,destruction,12,8,4
Esolock,malganis,768,warlock,destruction,12,8,4
Nyhn,bleeding-hollow,768,warlock,destruction,13,8,5
Westtung,tichondrius,768,warlock,destruction,13,8,5
Metic,firetree,768,warlock,destruction,16,9,7
Demfearslol,terokkar,768,warlock,destruction,18,8,10
Soulripped,area-52,768,warlock,destruction,18,8,10
Bbangtimo,tichondrius,768,warlock,destruction,18,8,10
Westhofxx,sargeras,768,warlock,destruction,18,8,10
Kallym,azralon,768,warlock,destruction,18,8,10
Gneçro,area-52,768,warlock,destruction,18,8,10
Iniboltquity,tichondrius,768,warlock,destruction,18,8,10
Accentuate,tichondrius,767,warlock,destruction,12,8,4
Yonz,area-52,767,warlock,destruction,12,8,4
Coil,kiljaeden,767,warlock,destruction,12,8,4
Diabolous,malganis,767,warlock,destruction,12,8,4
Ranil,mannoroth,767,warlock,destruction,12,8,4
Shadowlifts,kelthuzad,767,warlock,destruction,12,8,4
Killafornia,runetotem,767,warlock,destruction,12,8,4
Lynnilock,area-52,767,warlock,destruction,12,8,4
Hugechungusw,frostmourne,767,warlock,destruction,12,8,4
Egirlgamer,sargeras,767,warlock,destruction,12,8,4
Destruction,frostmourne,767,warlock,destruction,12,8,4
Shikyo,lightnings-blade,767,warlock,destruction,18,8,10
Forsâken,tichondrius,767,warlock,destruction,18,8,10
Windwolff,dalvengyr,767,warlock,destruction,18,8,10
Hargol,azralon,767,warlock,destruction,18,8,10
Síkaría,malganis,767,warlock,destruction,18,8,10
Alizondemdik,azralon,767,warlock,destruction,18,8,10
Aldaill,moon-guard,767,warlock,destruction,18,8,10
Sauronne,illidan,767,warlock,destruction,18,8,10
Katsurägi,tichondrius,767,warlock,destruction,18,8,10
Plexwl,sargeras,767,warlock,destruction,24,8,16
Raglans,amanthul,766,warlock,destruction,12,8,4
Devdolittle,tichondrius,766,warlock,destruction,12,8,4
Jelluz,ghostlands,766,warlock,destruction,12,8,4
Staudt,mugthol,766,warlock,destruction,12,8,4
Doomers,frostmourne,766,warlock,destruction,12,8,4
Faldoras,kalecgos,766,warlock,destruction,12,8,4
Mandley,nazgrel,766,warlock,destruction,18,8,10
Darkboltz,area-52,765,warlock,destruction,12,8,4
Blankdots,sargeras,765,warlock,destruction,12,8,4
Skullsoul,arthas,765,warlock,destruction,18,8,10
Deseo,moon-guard,764,warlock,destruction,12,8,4
Cursedtool,quelthalas,764,warlock,destruction,15,9,6
Guinegobbler,hyjal,764,warlock,destruction,20,8,12
Esoo,kul-tiras,763,warlock,destruction,12,8,4
Caryn,dalaran,763,warlock,destruction,18,8,10
Disrespex,kelthuzad,762,warlock,destruction,18,8,10
Djfear,tichondrius,762,warlock,destruction,18,8,10
Degynlock,wyrmrest-accord,762,warlock,destruction,24,8,16
Shooterg,tichondrius,761,warlock,destruction,18,8,10
Myshadow,gorefiend,758,warlock,destruction,24,8,16
Mordror,azralon,746,warlock,destruction,17,8,9
Nobuyori,tichondrius,745,warlock,destruction,24,9,15
Oldwing,illidan,735,warlock,destruction,23,8,15
Fellraiser,bleeding-hollow,720,warlock,destruction,15,8,7
Notoriusmma,illidan,720,warlock,destruction,19,10,9
Sotera,bleeding-hollow,719,warlock,destruction,11,8,3
Rentblod,azralon,719,warlock,destruction,11,8,3
Lökdown,dalaran,714,warlock,destruction,15,11,4
Castngcouch,tichondrius,711,warlock,destruction,21,10,11
Boltsfordays,dalaran,706,warlock,destruction,20,9,11
Tinyjo,sargeras,703,warlock,destruction,11,8,3
Ihaveapowers,maiev,703,warlock,destruction,11,8,3
Bäbz,barthilas,703,warlock,destruction,11,8,3
Demotional,wyrmrest-accord,703,warlock,destruction,14,8,6
Liljamie,stormrage,703,warlock,destruction,17,8,9
Screampied,sargeras,699,warlock,destruction,20,8,12
Getfeared,emerald-dream,672,warlock,destruction,10,8,2
Flággedname,area-52,672,warlock,destruction,12,7,5
Glizzÿ,thrall,672,warlock,destruction,12,7,5
Says,gorefiend,672,warlock,destruction,12,7,5
Haì,illidan,672,warlock,destruction,12,7,5
Lockâsf,tichondrius,672,warlock,destruction,12,7,5
Lessthanjake,zuljin,672,warlock,destruction,12,7,5
Suminl,tichondrius,672,warlock,destruction,12,7,5
Vafa,kelthuzad,672,warlock,destruction,12,7,5
Sonovabeech,winterhoof,672,warlock,destruction,12,7,5
Ðòm,tichondrius,672,warlock,destruction,12,7,5
Flicks,arthas,672,warlock,destruction,12,7,5
Blair,wildhammer,672,warlock,destruction,12,7,5
Sofan,dalaran,672,warlock,destruction,12,7,5
Thewkama,tichondrius,672,warlock,destruction,12,7,5
Luciusvrenus,tichondrius,672,warlock,destruction,12,7,5
Insànity,bleeding-hollow,672,warlock,destruction,12,7,5
Tamzin,kelthuzad,672,warlock,destruction,12,7,5
Snikpan,silver-hand,672,warlock,destruction,12,7,5
Dipgodx,bleeding-hollow,672,warlock,destruction,12,7,5
Soranpotter,tichondrius,672,warlock,destruction,12,7,5
Aegywn,gorgonnash,672,warlock,destruction,12,7,5
Iboltudie,tichondrius,672,warlock,destruction,12,7,5
Schlutty,malganis,672,warlock,destruction,12,7,5
Lokintots,darkspear,672,warlock,destruction,12,7,5
Ko,nordrassil,672,warlock,destruction,12,7,5
Tatordotzz,tichondrius,672,warlock,destruction,12,7,5
Uggaboogga,malganis,672,warlock,destruction,12,7,5
Clingrita,tichondrius,672,warlock,destruction,12,7,5
Westhofz,sargeras,672,warlock,destruction,12,7,5
Méphisto,emerald-dream,672,warlock,destruction,12,7,5
Felforyouu,illidan,672,warlock,destruction,12,7,5
Dötkill,illidan,672,warlock,destruction,12,7,5
Mokfernal,tichondrius,672,warlock,destruction,12,7,5
Kymamd,sargeras,672,warlock,destruction,12,7,5
Ztc,dalaran,672,warlock,destruction,12,7,5
Zelophobiaz,crushridge,672,warlock,destruction,12,7,5
Hellfires,ragnaros,672,warlock,destruction,12,7,5
Furryfears,gurubashi,672,warlock,destruction,12,7,5
Busterbob,tichondrius,672,warlock,destruction,12,7,5
Kountdrakula,tichondrius,672,warlock,destruction,12,7,5
Balepyre,moon-guard,672,warlock,destruction,12,7,5
Rothslock,tichondrius,672,warlock,destruction,12,7,5
Sylvarri,stormrage,672,warlock,destruction,12,7,5
Dplexs,jubeithos,672,warlock,destruction,12,7,5
Yikës,stormrage,672,warlock,destruction,12,7,5
Bosswarlock,tichondrius,672,warlock,destruction,13,7,6
Anasúi,quelthalas,672,warlock,destruction,18,7,11
Necrófear,tichondrius,672,warlock,destruction,18,7,11
Dmacxl,tichondrius,672,warlock,destruction,18,7,11
Sourmilkz,zuljin,672,warlock,destruction,18,7,11
Starwitch,darkspear,672,warlock,destruction,18,7,11
Modot,tichondrius,672,warlock,destruction,18,7,11
Zantology,frostmourne,672,warlock,destruction,18,7,11
Shivalx,tichondrius,671,warlock,destruction,12,7,5
Strawberryz,boulderfist,671,warlock,destruction,12,7,5
Sonnagalook,sargeras,671,warlock,destruction,12,7,5
Watchmegate,darkspear,671,warlock,destruction,12,7,5
Dirtybóy,tichondrius,671,warlock,destruction,12,7,5
Azâziel,ragnaros,671,warlock,destruction,12,7,5
Zyraxx,moon-guard,671,warlock,destruction,12,7,5
Demosthenes,nazjatar,671,warlock,destruction,12,7,5
Mérli,quelthalas,671,warlock,destruction,12,7,5
Aroris,silver-hand,671,warlock,destruction,12,7,5
Naba,malorne,671,warlock,destruction,12,7,5
Boltondahoes,sargeras,671,warlock,destruction,12,7,5
Irunaways,stormrage,671,warlock,destruction,12,7,5
Yury,scarlet-crusade,671,warlock,destruction,12,7,5
Grimzo,mugthol,671,warlock,destruction,12,7,5
Bhupzy,barthilas,671,warlock,destruction,12,7,5
Saicinxd,darkspear,671,warlock,destruction,12,7,5
Soulwipe,dethecus,671,warlock,destruction,12,7,5
Hadit,malganis,671,warlock,destruction,15,8,7
Blastyboat,terenas,671,warlock,destruction,16,8,8
Vetislock,thrall,671,warlock,destruction,18,7,11
Jhivtwo,tichondrius,671,warlock,destruction,18,7,11
Hellslayer,frostmourne,671,warlock,destruction,18,7,11
Ørfna,zuljin,671,warlock,destruction,18,7,11
Jvilla,tichondrius,671,warlock,destruction,18,7,11
Wollylock,dark-iron,671,warlock,destruction,18,7,11
Kachauwoo,kiljaeden,671,warlock,destruction,18,7,11
Altazor,thunderlord,671,warlock,destruction,24,7,17
Balfast,quelthalas,671,warlock,destruction,24,7,17
Fearlord,shattered-hand,671,warlock,destruction,24,7,17
Doomtome,moon-guard,671,warlock,destruction,26,7,19
Lagcursed,frostmourne,670,warlock,destruction,12,7,5
Amilkman,area-52,670,warlock,destruction,12,7,5
Tørturë,tichondrius,670,warlock,destruction,12,7,5
Cazadorius,jubeithos,670,warlock,destruction,13,7,6
Heartpvp,tichondrius,670,warlock,destruction,18,7,11
Revenancer,smolderthorn,669,warlock,destruction,12,7,5
Kristenßell,senjin,669,warlock,destruction,12,7,5
Otus,echo-isles,669,warlock,destruction,12,7,5
Sumonníng,tichondrius,669,warlock,destruction,18,7,11
Juan,borean-tundra,668,warlock,destruction,18,7,11
Sneakywarlok,dalaran,668,warlock,destruction,19,7,12
Deathjerky,thrall,667,warlock,destruction,12,7,5
Saltboi,azjolnerub,640,warlock,destruction,16,7,9
Voidxx,tichondrius,639,warlock,destruction,11,7,4
Shendotigans,illidan,639,warlock,destruction,17,7,10
Demondan,magtheridon,638,warlock,destruction,23,7,16
Buildsuccess,tichondrius,623,warlock,destruction,17,7,10
Cassetes,tichondrius,622,warlock,destruction,11,7,4
Perfsx,bleeding-hollow,607,warlock,destruction,14,7,7
Honne,sargeras,607,warlock,destruction,14,7,7
Furrlokc,tichondrius,607,warlock,destruction,16,7,9
Djvetis,blackhand,592,warlock,destruction,13,7,6
Surleshilla,malganis,592,warlock,destruction,13,7,6
Studathlete,tichondrius,592,warlock,destruction,13,7,6
Malevolent,velen,576,warlock,destruction,6,6,0
Schrader,sargeras,576,warlock,destruction,6,6,0
Ebølarot,tichondrius,576,warlock,destruction,6,6,0
Denotate,zuljin,576,warlock,destruction,6,6,0
Menggoth,tichondrius,576,warlock,destruction,6,6,0
Gabbagoul,sargeras,576,warlock,destruction,6,6,0
Chaoscoach,sargeras,576,warlock,destruction,6,6,0
Bronzel,tichondrius,576,warlock,destruction,6,6,0
Mitchosx,frostmourne,576,warlock,destruction,6,6,0
Redsolojdc,tichondrius,576,warlock,destruction,6,6,0
Notstingz,azralon,576,warlock,destruction,6,6,0
Doobielock,kelthuzad,576,warlock,destruction,6,6,0
Çxb,tichondrius,576,warlock,destruction,6,6,0
Drainerx,kelthuzad,576,warlock,destruction,6,6,0
Qp,thrall,576,warlock,destruction,6,6,0
Kòngal,tichondrius,576,warlock,destruction,6,6,0
Winipuhmalo,quelthalas,576,warlock,destruction,6,6,0
Broovid,tichondrius,576,warlock,destruction,13,7,6
Riskydemon,azralon,576,warlock,destruction,12,6,6
Crimsonela,emerald-dream,576,warlock,destruction,12,6,6
Wolfib,tichondrius,576,warlock,destruction,12,6,6
Graingrippin,malganis,576,warlock,destruction,12,6,6
Bowltz,chogall,576,warlock,destruction,12,6,6
Aikus,quelthalas,576,warlock,destruction,12,6,6
Klol,proudmoore,576,warlock,destruction,12,6,6
Souldrain,malganis,576,warlock,destruction,12,6,6
Ronnietherat,tichondrius,576,warlock,destruction,12,6,6
Imbadatpvp,tichondrius,576,warlock,destruction,12,6,6
Zeromech,sargeras,576,warlock,destruction,12,6,6
Metafin,quelthalas,576,warlock,destruction,12,6,6
Sauzith,area-52,576,warlock,destruction,12,6,6
Limeriax,emerald-dream,576,warlock,destruction,12,6,6
Geegas,malganis,576,warlock,destruction,12,6,6
Kmüz,drakkari,576,warlock,destruction,12,6,6
Kulgar,aerie-peak,576,warlock,destruction,12,6,6
Quadrillion,stormrage,576,warlock,destruction,12,6,6
Tjdotter,stormrage,576,warlock,destruction,12,6,6
Zedonius,dragonmaw,576,warlock,destruction,12,6,6
Andrewpg,zuljin,576,warlock,destruction,12,6,6
Donutd,stormrage,576,warlock,destruction,12,6,6
Kreemy,ysera,576,warlock,destruction,12,6,6
Sepültüra,quelthalas,576,warlock,destruction,12,6,6
Indrah,tichondrius,576,warlock,destruction,12,6,6
Footyl,stormrage,576,warlock,destruction,12,6,6
Tonifortnite,emerald-dream,576,warlock,destruction,12,6,6
Vravras,kelthuzad,576,warlock,destruction,12,6,6
Aureboros,sargeras,576,warlock,destruction,12,6,6
Liability,zuljin,576,warlock,destruction,12,6,6
Ïmpdance,tichondrius,576,warlock,destruction,12,6,6
Eboknight,area-52,576,warlock,destruction,12,6,6
Manethail,aegwynn,576,warlock,destruction,12,6,6
Maèlstrom,area-52,576,warlock,destruction,12,6,6
Árkadiano,drakkari,576,warlock,destruction,12,6,6
Coffeezx,malganis,576,warlock,destruction,12,6,6
Peeberson,tichondrius,576,warlock,destruction,12,6,6
Massivebolts,area-52,576,warlock,destruction,12,6,6
Itsmeagain,area-52,576,warlock,destruction,12,6,6
Ritua,dragonmaw,576,warlock,destruction,12,6,6
Manalis,zuljin,576,warlock,destruction,12,6,6
Plutö,thrall,576,warlock,destruction,12,6,6
Cöpeñhagen,illidan,576,warlock,destruction,12,6,6
Sumrule,dreadmaul,576,warlock,destruction,12,6,6
Iemonv,vashj,576,warlock,destruction,12,6,6
Girthlock,tichondrius,576,warlock,destruction,12,6,6
Charmandfarm,nerzhul,576,warlock,destruction,12,6,6
Asamsbinladn,illidan,576,warlock,destruction,12,6,6
Emptysoul,illidan,576,warlock,destruction,12,6,6
Celash,barthilas,576,warlock,destruction,12,6,6
Hiro,steamwheedle-cartel,576,warlock,destruction,12,6,6
Draxxus,barthilas,576,warlock,destruction,12,6,6
Flu,darkspear,576,warlock,destruction,12,6,6
Sdiaz,illidan,576,warlock,destruction,12,6,6
Canobio,tichondrius,576,warlock,destruction,12,6,6
Bhris,wildhammer,576,warlock,destruction,12,6,6
Truepain,tichondrius,576,warlock,destruction,12,6,6
Zephidel,thrall,576,warlock,destruction,12,6,6
Shigero,tichondrius,576,warlock,destruction,12,6,6
Lokkup,dalaran,576,warlock,destruction,12,6,6
Beamin,dentarg,576,warlock,destruction,12,6,6
Dunkindots,dalaran,576,warlock,destruction,12,6,6
Draenil,eredar,576,warlock,destruction,12,6,6
Betrili,tichondrius,576,warlock,destruction,12,6,6
Tlock,azjolnerub,576,warlock,destruction,12,6,6
Wzrdtrx,deathwing,576,warlock,destruction,18,6,12
Lamdyn,moon-guard,576,warlock,destruction,18,6,12
Bêlthazor,kelthuzad,576,warlock,destruction,18,6,12
Brough,illidan,576,warlock,destruction,18,6,12
Plutheros,stormrage,576,warlock,destruction,18,6,12
Xdta,frostmourne,576,warlock,destruction,18,6,12
Jinxdacat,shandris,576,warlock,destruction,18,6,12
Tenletters,kirin-tor,576,warlock,destruction,18,6,12
Esoteríc,sargeras,576,warlock,destruction,18,6,12
Lenestus,stormrage,576,warlock,destruction,18,6,12
Feoona,hyjal,576,warlock,destruction,18,6,12
Rathianna,sargeras,575,warlock,destruction,12,6,6
Crankshaft,nordrassil,575,warlock,destruction,12,6,6
Beelzibub,firetree,575,warlock,destruction,12,6,6
Nytefels,skullcrusher,575,warlock,destruction,12,6,6
Azracore,illidan,575,warlock,destruction,12,6,6
Méhoe,bleeding-hollow,575,warlock,destruction,12,6,6
Edielyth,proudmoore,575,warlock,destruction,12,6,6
Naparima,stormreaver,575,warlock,destruction,12,6,6
Baphomët,tichondrius,575,warlock,destruction,12,6,6
Shadowy,dragonblight,575,warlock,destruction,12,6,6
Daimon,kaelthas,575,warlock,destruction,12,6,6
Zezkin,alexstrasza,575,warlock,destruction,16,7,9
Yetiaids,tichondrius,575,warlock,destruction,18,6,12
Oluluo,andorhal,575,warlock,destruction,18,6,12
Trayga,illidan,574,warlock,destruction,6,6,0
Ggumx,tichondrius,574,warlock,destruction,12,6,6
Persephoné,blackrock,574,warlock,destruction,12,6,6
Totti,tol-barad,574,warlock,destruction,12,6,6
Hungovermate,barthilas,574,warlock,destruction,12,6,6
Tesdeez,tichondrius,574,warlock,destruction,12,6,6
Träzyn,kiljaeden,574,warlock,destruction,18,6,12
Supercracker,bleeding-hollow,572,warlock,destruction,18,6,12
Fidobiu,stormrage,571,warlock,destruction,12,6,6
Expiredonion,bleeding-hollow,559,warlock,destruction,11,6,5
Friend,frostmourne,559,warlock,destruction,17,6,11
Drdotngo,tichondrius,543,warlock,destruction,8,7,1
Imsupercool,bleeding-hollow,543,warlock,destruction,11,6,5
Promancer,drakkari,528,warlock,destruction,9,6,3
Tm,dalaran,527,warlock,destruction,11,6,5
Loch,destromath,527,warlock,destruction,11,6,5
Exillis,barthilas,527,warlock,destruction,17,6,11
Tesowenn,tichondrius,522,warlock,destruction,15,7,8
Locdup,sargeras,512,warlock,destruction,22,6,16
Ðêcimatê,frostmourne,511,warlock,destruction,12,6,6
Glifosáto,quelthalas,510,warlock,destruction,10,8,2
Ràistlin,madoran,494,warlock,destruction,11,6,5
Spiritofodin,grizzly-hills,480,warlock,destruction,6,5,1
Domenic,sentinels,480,warlock,destruction,6,5,1
Phyxylock,stormrage,480,warlock,destruction,6,5,1
Karmalock,malganis,480,warlock,destruction,6,5,1
Babyvet,stormreaver,480,warlock,destruction,6,5,1
Shokran,frostmourne,480,warlock,destruction,6,5,1
Ozric,quelthalas,480,warlock,destruction,6,5,1
Neruvian,tichondrius,480,warlock,destruction,6,5,1
Dotlockndrop,stormreaver,480,warlock,destruction,6,5,1
Reportmenerd,tichondrius,480,warlock,destruction,6,5,1
Adonegege,tichondrius,480,warlock,destruction,6,5,1
Delarae,frostmourne,480,warlock,destruction,6,5,1
Jalean,illidan,480,warlock,destruction,6,5,1
Jfet,sargeras,480,warlock,destruction,6,5,1
Chewybolt,illidan,480,warlock,destruction,6,5,1
Oreganow,icecrown,480,warlock,destruction,6,5,1
Arnan,korgath,480,warlock,destruction,6,5,1
Addonic,hyjal,480,warlock,destruction,6,5,1
Unicornspit,tichondrius,480,warlock,destruction,6,5,1
Poonanifotm,gundrak,480,warlock,destruction,6,5,1
Stíngz,nemesis,480,warlock,destruction,6,5,1
Beranflakes,darkspear,480,warlock,destruction,6,5,1
Cheesëbolt,illidan,480,warlock,destruction,6,5,1
Popnloc,tichondrius,480,warlock,destruction,6,5,1
Dippindotz,scilla,480,warlock,destruction,6,5,1
Gritzixx,frostmourne,480,warlock,destruction,6,5,1
Halftism,sargeras,480,warlock,destruction,6,5,1
Novah,balnazzar,480,warlock,destruction,6,5,1
Onidium,area-52,480,warlock,destruction,6,5,1
Khaozx,ragnaros,480,warlock,destruction,6,5,1
Humblegodd,illidan,480,warlock,destruction,6,5,1
Destructium,stormrage,480,warlock,destruction,6,5,1
Leîa,tichondrius,480,warlock,destruction,6,5,1
Cytosine,medivh,480,warlock,destruction,6,5,1
Bolèyn,moon-guard,480,warlock,destruction,6,5,1
Púp,bleeding-hollow,480,warlock,destruction,6,5,1
Felegance,proudmoore,480,warlock,destruction,6,5,1
Mørøs,tichondrius,480,warlock,destruction,6,5,1
Malékíth,ragnaros,480,warlock,destruction,6,5,1
Cloperry,area-52,480,warlock,destruction,6,5,1
Elprup,tichondrius,480,warlock,destruction,6,5,1
Kabroom,boulderfist,480,warlock,destruction,6,5,1
Blorgaflob,thaurissan,480,warlock,destruction,6,5,1
Balencinaga,frostmourne,480,warlock,destruction,6,5,1
Yuckytoetoe,emerald-dream,480,warlock,destruction,6,5,1
Rorvask,area-52,480,warlock,destruction,6,5,1
Ikite,zuljin,480,warlock,destruction,6,5,1
Zakhim,zuljin,480,warlock,destruction,6,5,1
Ohthemisery,sargeras,480,warlock,destruction,6,5,1
Efuc,tichondrius,480,warlock,destruction,6,5,1
Wodwarlock,thrall,480,warlock,destruction,6,5,1
Virûs,vashj,480,warlock,destruction,6,5,1
Xiáoyan,tichondrius,480,warlock,destruction,6,5,1
Cheylock,stormrage,480,warlock,destruction,6,5,1
Michae,tichondrius,480,warlock,destruction,6,5,1
Halfmade,tichondrius,480,warlock,destruction,6,5,1
Corruptblxck,tichondrius,480,warlock,destruction,9,6,3
Shadowflame,skullcrusher,480,warlock,destruction,12,5,7
Lockwell,tichondrius,480,warlock,destruction,12,5,7
Rytaint,emerald-dream,480,warlock,destruction,12,5,7
Gameface,garrosh,480,warlock,destruction,12,5,7
Justganmore,tichondrius,480,warlock,destruction,12,5,7
Stizzy,eredar,480,warlock,destruction,12,5,7
Gnimms,sargeras,480,warlock,destruction,12,5,7
Ascendant,amanthul,480,warlock,destruction,12,5,7
Lildottythot,malganis,480,warlock,destruction,12,5,7
Wediditjoe,kelthuzad,480,warlock,destruction,12,5,7
Pveisboring,tichondrius,480,warlock,destruction,12,5,7
Daremyth,azralon,480,warlock,destruction,12,5,7
Sylvine,korgath,480,warlock,destruction,12,5,7
Darezs,frostmourne,480,warlock,destruction,12,5,7
Bellgrande,shadowmoon,480,warlock,destruction,12,5,7
Macnab,malganis,480,warlock,destruction,12,5,7
Enmama,malganis,480,warlock,destruction,12,5,7
Souljäboy,bleeding-hollow,480,warlock,destruction,12,5,7
Richards,thrall,480,warlock,destruction,12,5,7
Snapp,kelthuzad,480,warlock,destruction,12,5,7
Lockandload,malfurion,480,warlock,destruction,12,5,7
Imhereforrbg,moon-guard,480,warlock,destruction,12,5,7
Archleon,smolderthorn,480,warlock,destruction,12,5,7
Mitryc,illidan,480,warlock,destruction,12,5,7
Koei,tichondrius,480,warlock,destruction,12,5,7
Jankity,kelthuzad,480,warlock,destruction,12,5,7
Redmil,quelthalas,480,warlock,destruction,12,5,7
Locknes,kiljaeden,480,warlock,destruction,12,5,7
Oppaijuggler,tichondrius,480,warlock,destruction,12,5,7
Crashcrash,area-52,480,warlock,destruction,12,5,7
Rainali,tichondrius,480,warlock,destruction,12,5,7
Seraphserius,laughing-skull,480,warlock,destruction,12,5,7
Kubera,mannoroth,480,warlock,destruction,12,5,7
Arkangel,dalvengyr,480,warlock,destruction,12,5,7
Wombogombo,malganis,480,warlock,destruction,12,5,7
Chaoz,aggramar,480,warlock,destruction,12,5,7
Totsdots,blackrock,480,warlock,destruction,12,5,7
Gallynna,moon-guard,480,warlock,destruction,12,5,7
Pontoontim,mugthol,480,warlock,destruction,12,5,7
Errogant,area-52,480,warlock,destruction,12,5,7
Dommön,ragnaros,480,warlock,destruction,12,5,7
Yurick,frostmourne,480,warlock,destruction,12,5,7
Topboypepito,tichondrius,480,warlock,destruction,12,5,7
Daemonixx,vashj,480,warlock,destruction,12,5,7
Sukmalock,proudmoore,480,warlock,destruction,15,6,9
Ëliphas,tichondrius,480,warlock,destruction,18,5,13
Corezach,proudmoore,480,warlock,destruction,18,5,13
Osteogenesis,quelthalas,479,warlock,destruction,12,5,7
Grix,uldaman,479,warlock,destruction,12,5,7
Loccdawg,laughing-skull,479,warlock,destruction,12,5,7
Kelici,borean-tundra,479,warlock,destruction,12,5,7
Esmaldo,tichondrius,479,warlock,destruction,12,5,7
Vordz,amanthul,479,warlock,destruction,12,5,7
Stallrooks,moon-guard,479,warlock,destruction,12,5,7
Fearndot,draenor,479,warlock,destruction,15,6,9
Daemonddred,hakkar,479,warlock,destruction,18,5,13
Giled,runetotem,478,warlock,destruction,12,5,7
Saintvil,drakkari,477,warlock,destruction,6,5,1
Casusita,area-52,472,warlock,destruction,12,5,7
Klapincheeks,malganis,468,warlock,destruction,38,8,30
Viejitaa,quelthalas,447,warlock,destruction,10,6,4
Døtbomb,stormrage,447,warlock,destruction,11,5,6
Britnyfears,korgath,447,warlock,destruction,16,5,11
Heizx,area-52,432,warlock,destruction,15,5,10
Brútek,moon-guard,431,warlock,destruction,11,5,6
Empowerdlock,garrosh,416,warlock,destruction,10,5,5
Gorontar,kelthuzad,415,warlock,destruction,14,5,9
Thelynx,chogall,384,warlock,destruction,6,4,2
Saruon,proudmoore,384,warlock,destruction,6,4,2
Toomanymind,stormrage,384,warlock,destruction,6,4,2
Chumbing,sargeras,384,warlock,destruction,6,4,2
Slappndemons,mugthol,384,warlock,destruction,6,4,2
Lîlý,bleeding-hollow,384,warlock,destruction,6,4,2
Phreekish,bleeding-hollow,384,warlock,destruction,6,4,2
Espanol,magtheridon,384,warlock,destruction,6,4,2
Moramont,stormrage,384,warlock,destruction,6,4,2
Norastrum,area-52,384,warlock,destruction,6,4,2
Sprenn,bleeding-hollow,384,warlock,destruction,6,4,2
Mailerdaemön,proudmoore,384,warlock,destruction,6,4,2
Donttouchme,azralon,384,warlock,destruction,6,4,2
Demonchurch,area-52,384,warlock,destruction,6,4,2
Galtur,azralon,384,warlock,destruction,6,4,2
Souwantwar,kiljaeden,384,warlock,destruction,6,4,2
Siltharious,senjin,384,warlock,destruction,6,4,2
Smnslock,emerald-dream,384,warlock,destruction,6,4,2
Rodneyjones,emerald-dream,384,warlock,destruction,6,4,2
Adøràßøltz,tichondrius,384,warlock,destruction,6,4,2
Iamfear,shuhalo,384,warlock,destruction,6,4,2
Drakatat,tichondrius,384,warlock,destruction,6,4,2
Pegorn,illidan,384,warlock,destruction,6,4,2
Zzat,area-52,384,warlock,destruction,6,4,2
Damienn,wyrmrest-accord,384,warlock,destruction,6,4,2
Asalaviik,illidan,384,warlock,destruction,6,4,2
Crnowarlock,area-52,384,warlock,destruction,6,4,2
Fearoshimá,thrall,384,warlock,destruction,6,4,2
Jerothia,lethon,384,warlock,destruction,6,4,2
Rendori,the-scryers,384,warlock,destruction,6,4,2
Extreme,blackwing-lair,384,warlock,destruction,6,4,2
Khaos,norgannon,384,warlock,destruction,6,4,2
Underchicken,blackrock,384,warlock,destruction,6,4,2
Zver,drakkari,384,warlock,destruction,6,4,2
Menedemus,amanthul,384,warlock,destruction,6,4,2
Sheetzlock,azgalor,384,warlock,destruction,6,4,2
Yëët,wildhammer,384,warlock,destruction,6,4,2
Lockiana,zuljin,384,warlock,destruction,6,4,2
Ñever,winterhoof,384,warlock,destruction,6,4,2
Dotsamoray,frostmourne,384,warlock,destruction,6,4,2
Outkãst,illidan,384,warlock,destruction,6,4,2
Elcidoo,tichondrius,384,warlock,destruction,6,4,2
Solöw,tichondrius,384,warlock,destruction,6,4,2
Frem,eonar,384,warlock,destruction,6,4,2
Hollowl,tichondrius,384,warlock,destruction,6,4,2
Calcadius,zuljin,384,warlock,destruction,6,4,2
Wreckquiem,burning-blade,384,warlock,destruction,6,4,2
Rhelialock,icecrown,384,warlock,destruction,6,4,2
Smallj,zuljin,384,warlock,destruction,6,4,2
Biger,nemesis,384,warlock,destruction,6,4,2
Magvezx,kelthuzad,384,warlock,destruction,6,4,2
Raven,baelgun,384,warlock,destruction,6,4,2
Wiredftwx,illidan,384,warlock,destruction,6,4,2
Zonss,tichondrius,384,warlock,destruction,6,4,2
Litemeatlary,kelthuzad,384,warlock,destruction,6,4,2
Tsmcfker,tichondrius,384,warlock,destruction,6,4,2
Fatherbolt,tichondrius,384,warlock,destruction,6,4,2
Drgiggles,tichondrius,384,warlock,destruction,6,4,2
Thinkchair,sargeras,384,warlock,destruction,6,4,2
Xlilgee,kelthuzad,384,warlock,destruction,6,4,2
Leroybrown,alterac-mountains,384,warlock,destruction,6,4,2
Fullmelt,azjolnerub,384,warlock,destruction,6,4,2
Crackhammer,sargeras,384,warlock,destruction,6,4,2
Deathtones,moon-guard,384,warlock,destruction,6,4,2
Wallzz,stormrage,384,warlock,destruction,6,4,2
Gordoxin,area-52,384,warlock,destruction,6,4,2
Doubledigit,tichondrius,384,warlock,destruction,6,4,2
Cønsfèáracy,sargeras,384,warlock,destruction,6,4,2
Qfear,tichondrius,384,warlock,destruction,6,4,2
Kerrigan,the-venture-co,384,warlock,destruction,6,4,2
Quetzâlcoâtl,sargeras,384,warlock,destruction,6,4,2
Afflackxl,sargeras,384,warlock,destruction,6,4,2
Laytome,stormreaver,384,warlock,destruction,6,4,2
Deathcoill,frostmourne,384,warlock,destruction,6,4,2
Arredivh,blackhand,384,warlock,destruction,6,4,2
Eatmybeef,ravencrest,384,warlock,destruction,6,4,2
Eazyw,stormrage,384,warlock,destruction,6,4,2
Asiopdu,tichondrius,384,warlock,destruction,6,4,2
Dottcom,laughing-skull,384,warlock,destruction,6,4,2
Tuugadark,echo-isles,384,warlock,destruction,6,4,2
Wømanizer,azralon,384,warlock,destruction,6,4,2
Ozidus,tichondrius,384,warlock,destruction,6,4,2
Ðarkbat,ragnaros,384,warlock,destruction,6,4,2
Superspreadr,silvermoon,384,warlock,destruction,6,4,2
Synisterlock,moon-guard,384,warlock,destruction,6,4,2
Woofbolt,malganis,384,warlock,destruction,6,4,2
Antigotenent,sargeras,384,warlock,destruction,6,4,2
Jxstinl,tichondrius,384,warlock,destruction,6,4,2
Necrotko,malganis,384,warlock,destruction,6,4,2
Anthaxel,dalaran,384,warlock,destruction,6,4,2
Balden,fenris,384,warlock,destruction,6,4,2
Stambye,ragnaros,384,warlock,destruction,6,4,2
Ardamelech,quelthalas,384,warlock,destruction,6,4,2
Kroshuto,ragnaros,384,warlock,destruction,6,4,2
Cursebolt,tichondrius,384,warlock,destruction,6,4,2
Roota,dalaran,384,warlock,destruction,6,4,2
Dottzie,malganis,384,warlock,destruction,6,4,2
Warfeen,malganis,384,warlock,destruction,6,4,2
Tizzy,malganis,384,warlock,destruction,6,4,2
Deebeel,sargeras,384,warlock,destruction,6,4,2
Cowboydann,malganis,384,warlock,destruction,6,4,2
Agla,quelthalas,384,warlock,destruction,6,4,2
Beerbolt,dalaran,384,warlock,destruction,6,4,2
Syraxi,illidan,384,warlock,destruction,6,4,2
Hawtchili,illidan,384,warlock,destruction,6,4,2
Sumondeznuts,wyrmrest-accord,384,warlock,destruction,9,5,4
Renatis,malganis,384,warlock,destruction,9,5,4
Deathboltx,zuljin,384,warlock,destruction,9,5,4
Ahp,stormrage,384,warlock,destruction,9,5,4
Meathat,gorefiend,384,warlock,destruction,9,5,4
Krozu,bleeding-hollow,384,warlock,destruction,12,4,8
Jáws,zuljin,384,warlock,destruction,12,4,8
Evarona,gorefiend,384,warlock,destruction,12,4,8
Rumpology,illidan,384,warlock,destruction,12,4,8
Medraut,wyrmrest-accord,384,warlock,destruction,12,4,8
Puddulz,thrall,384,warlock,destruction,12,4,8
Catastrophk,malganis,384,warlock,destruction,12,4,8
Cursedoll,ragnaros,384,warlock,destruction,12,4,8
Regent,nemesis,384,warlock,destruction,12,4,8
Mokushiroku,trollbane,384,warlock,destruction,12,4,8
Aededa,proudmoore,384,warlock,destruction,12,4,8
Nazrakin,malganis,384,warlock,destruction,12,4,8
Pãni,area-52,384,warlock,destruction,12,4,8
Praemonium,dalaran,384,warlock,destruction,12,4,8
Awangdemon,tichondrius,384,warlock,destruction,12,4,8
Letsfckingo,tichondrius,384,warlock,destruction,12,4,8
Damerus,illidan,384,warlock,destruction,12,4,8
Overlard,illidan,384,warlock,destruction,12,4,8
Darksòúl,stormrage,384,warlock,destruction,12,4,8
Mostlyundead,darkspear,384,warlock,destruction,12,4,8
Destructing,hyjal,384,warlock,destruction,12,4,8
Soulinite,fizzcrank,384,warlock,destruction,12,4,8
Perfidien,tichondrius,384,warlock,destruction,12,4,8
Kholdstarev,thunderlord,384,warlock,destruction,12,4,8
Spacedots,illidan,384,warlock,destruction,12,4,8
Poisondeepnu,malganis,384,warlock,destruction,12,4,8
Offendor,stormrage,384,warlock,destruction,12,4,8
Giggideez,bleeding-hollow,384,warlock,destruction,12,4,8
Threk,quelthalas,384,warlock,destruction,12,4,8
Hateslocks,bladefist,384,warlock,destruction,12,4,8
Oxylock,magtheridon,384,warlock,destruction,12,4,8
Blumercricet,stormrage,384,warlock,destruction,12,4,8
Carcine,frostwolf,384,warlock,destruction,12,4,8
Ktlock,frostmourne,384,warlock,destruction,12,4,8
Flocka,agamaggan,384,warlock,destruction,12,4,8
Dotsandchill,dalaran,384,warlock,destruction,12,4,8
Syileria,frostmourne,384,warlock,destruction,12,4,8
Pitou,akama,384,warlock,destruction,12,4,8
Daedayus,frostwolf,384,warlock,destruction,12,4,8
Dotington,frostmourne,384,warlock,destruction,12,4,8
Lønewølf,sargeras,384,warlock,destruction,12,4,8
Capslockfury,frostmourne,384,warlock,destruction,12,4,8
Tarth,sargeras,384,warlock,destruction,12,4,8
Stepmommie,moon-guard,384,warlock,destruction,12,4,8
Fowll,frostwolf,384,warlock,destruction,12,4,8
Mozbet,kiljaeden,384,warlock,destruction,13,4,9
Pvman,onyxia,384,warlock,destruction,18,4,14
Ravikk,dalaran,384,warlock,destruction,18,4,14
Gorski,frostwolf,383,warlock,destruction,6,4,2
Halkroz,nathrezim,383,warlock,destruction,6,4,2
Thulium,dawnbringer,383,warlock,destruction,6,4,2
Destroyaz,stormreaver,383,warlock,destruction,6,4,2
Downing,drakkari,383,warlock,destruction,12,4,8
Asheräh,stormrage,383,warlock,destruction,12,4,8
Fearanddots,moon-guard,383,warlock,destruction,12,4,8
Kurmenos,uldum,382,warlock,destruction,6,4,2
Mageline,thrall,382,warlock,destruction,18,4,14
Fartonomus,illidan,381,warlock,destruction,12,4,8
Valintine,khadgar,367,warlock,destruction,9,5,4
Vanvídd,ragnaros,351,warlock,destruction,11,4,7
Gobbledeez,moknathal,349,warlock,destruction,19,5,14
Gyxx,exodar,336,warlock,destruction,9,4,5
Tangslock,skullcrusher,335,warlock,destruction,11,4,7
Lockazo,quelthalas,330,warlock,destruction,11,6,5
Sooshi,malganis,330,warlock,destruction,11,6,5
Sojulord,sargeras,320,warlock,destruction,10,4,6
Saintläurent,bleeding-hollow,319,warlock,destruction,5,4,1
Fancynuts,kiljaeden,319,warlock,destruction,5,4,1
Jackscar,windrunner,319,warlock,destruction,5,4,1
Velsona,moon-guard,319,warlock,destruction,8,4,4
Lockedyaup,skullcrusher,319,warlock,destruction,8,4,4
Valkynaris,chogall,319,warlock,destruction,14,4,10
Nutzosaurus,darkspear,288,warlock,destruction,6,3,3
Siphoned,darkspear,288,warlock,destruction,6,3,3
Amuros,illidan,288,warlock,destruction,6,3,3
Ratedtorgast,illidan,288,warlock,destruction,6,3,3
Yuvirayz,illidan,288,warlock,destruction,6,3,3
Felsgoodman,illidan,288,warlock,destruction,6,3,3
Pikvas,darkspear,288,warlock,destruction,6,3,3
Ärminvßuurën,barthilas,288,warlock,destruction,6,3,3
Dìpndots,wyrmrest-accord,288,warlock,destruction,6,3,3
Gurlock,illidan,288,warlock,destruction,6,3,3
Papablasty,nagrand,288,warlock,destruction,6,3,3
Dashaad,illidan,288,warlock,destruction,6,3,3
Youkeyoh,illidan,288,warlock,destruction,6,3,3
Lübelock,illidan,288,warlock,destruction,6,3,3
Mastroguise,illidan,288,warlock,destruction,6,3,3
Velvalla,chogall,288,warlock,destruction,6,3,3
Borudo,thrall,288,warlock,destruction,6,3,3
Avadakedavra,warsong,288,warlock,destruction,6,3,3
Ðëâthløck,tichondrius,288,warlock,destruction,6,3,3
Nihilus,anvilmar,288,warlock,destruction,6,3,3
Fatals,thrall,288,warlock,destruction,6,3,3
Vxms,barthilas,288,warlock,destruction,6,3,3
Sweetjezuz,barthilas,288,warlock,destruction,6,3,3
Saffuky,frostmourne,288,warlock,destruction,6,3,3
Rumplefust,thrall,288,warlock,destruction,6,3,3
Zalurk,emerald-dream,288,warlock,destruction,6,3,3
Ceeloftw,tichondrius,288,warlock,destruction,6,3,3
Merlinsbeard,zuluhed,288,warlock,destruction,6,3,3
Darthzugzug,gorefiend,288,warlock,destruction,6,3,3
Hairydottr,malganis,288,warlock,destruction,6,3,3
Slothdots,tichondrius,288,warlock,destruction,6,3,3
Shadow,frostwolf,288,warlock,destruction,6,3,3
Sanzofunke,area-52,288,warlock,destruction,6,3,3
Ragnorök,medivh,288,warlock,destruction,6,3,3
Mamabolts,kelthuzad,288,warlock,destruction,6,3,3
Larsiezwei,spirestone,288,warlock,destruction,6,3,3
Ghettobeluga,area-52,288,warlock,destruction,6,3,3
Niétzsché,emerald-dream,288,warlock,destruction,6,3,3
Milkybøng,area-52,288,warlock,destruction,6,3,3
Kronman,zuluhed,288,warlock,destruction,6,3,3
Silkxy,frostwolf,288,warlock,destruction,6,3,3
Warlockluo,tichondrius,288,warlock,destruction,6,3,3
Deejaye,frostmourne,288,warlock,destruction,6,3,3
Aruotnof,nemesis,288,warlock,destruction,6,3,3
Speakeasy,malygos,288,warlock,destruction,6,3,3
Ägnar,nemesis,288,warlock,destruction,6,3,3
Ñevaeh,emerald-dream,288,warlock,destruction,6,3,3
Desconjuro,nemesis,288,warlock,destruction,6,3,3
Poggyjones,tichondrius,288,warlock,destruction,6,3,3
Dluttysots,emerald-dream,288,warlock,destruction,6,3,3
Rockalock,burning-blade,288,warlock,destruction,6,3,3
Mfcalamity,uldum,288,warlock,destruction,6,3,3
Cancer,bloodscalp,288,warlock,destruction,6,3,3
Peterdotz,whisperwind,288,warlock,destruction,6,3,3
Æsidius,tichondrius,288,warlock,destruction,6,3,3
Souldotz,proudmoore,288,warlock,destruction,6,3,3
Dotbot,blades-edge,288,warlock,destruction,6,3,3
Neversoft,bleeding-hollow,288,warlock,destruction,6,3,3
Ðáyshéll,kelthuzad,288,warlock,destruction,6,3,3
Voldamorte,tichondrius,288,warlock,destruction,6,3,3
Ijustsharded,area-52,288,warlock,destruction,6,3,3
Jishtructo,frostmourne,288,warlock,destruction,6,3,3
Blakedogx,tichondrius,288,warlock,destruction,6,3,3
Chesterfear,quelthalas,288,warlock,destruction,6,3,3
Buttkins,tichondrius,288,warlock,destruction,6,3,3
Blaxzlock,stormscale,288,warlock,destruction,6,3,3
Oleg,bleeding-hollow,288,warlock,destruction,6,3,3
Jerclard,proudmoore,288,warlock,destruction,6,3,3
Lockabeesha,chogall,288,warlock,destruction,6,3,3
Tiptonb,tichondrius,288,warlock,destruction,6,3,3
Pheríe,sargeras,288,warlock,destruction,6,3,3
Markov,goldrinn,288,warlock,destruction,6,3,3
Voldormort,uldaman,288,warlock,destruction,6,3,3
Itsawarlock,thunderlord,288,warlock,destruction,6,3,3
Devi,destromath,288,warlock,destruction,6,3,3
Feeltheviibe,zuljin,288,warlock,destruction,6,3,3
Unquit,frostmourne,288,warlock,destruction,6,3,3
Blastindotz,frostmane,288,warlock,destruction,6,3,3
Imports,tichondrius,288,warlock,destruction,6,3,3
Hamdulla,tichondrius,288,warlock,destruction,6,3,3
Dogcookie,moon-guard,288,warlock,destruction,6,3,3
Héllboy,akama,288,warlock,destruction,6,3,3
Fatass,cairne,288,warlock,destruction,6,3,3
Feartool,stormrage,288,warlock,destruction,6,3,3
Phénom,tichondrius,288,warlock,destruction,6,3,3
Vasqu,stormrage,288,warlock,destruction,6,3,3
Maledictivus,stormrage,288,warlock,destruction,6,3,3
Pillçosby,tichondrius,288,warlock,destruction,6,3,3
Ökïlôck,proudmoore,288,warlock,destruction,6,3,3
Shawzyy,tichondrius,288,warlock,destruction,6,3,3
Embraces,tichondrius,288,warlock,destruction,6,3,3
Shâdowman,stormrage,288,warlock,destruction,6,3,3
Warlocknroll,frostmourne,288,warlock,destruction,6,3,3
Fungiforest,kelthuzad,288,warlock,destruction,6,3,3
Sàill,tichondrius,288,warlock,destruction,6,3,3
Zuelu,tichondrius,288,warlock,destruction,6,3,3
Odelgabiana,area-52,288,warlock,destruction,6,3,3
Espanyolo,zuljin,288,warlock,destruction,6,3,3
Xephostwo,area-52,288,warlock,destruction,6,3,3
Gingerlock,stonemaul,288,warlock,destruction,6,3,3
Warlooch,area-52,288,warlock,destruction,6,3,3
Xblessed,stormrage,288,warlock,destruction,6,3,3
Wondon,tichondrius,288,warlock,destruction,6,3,3
Joung,tichondrius,288,warlock,destruction,6,3,3
Tomathus,moon-guard,288,warlock,destruction,6,3,3
Metaphors,stormrage,288,warlock,destruction,6,3,3
Ganondolph,sargeras,288,warlock,destruction,6,3,3
Fearedit,bleeding-hollow,288,warlock,destruction,6,3,3
Vampydark,quelthalas,288,warlock,destruction,6,3,3
Háydn,azuremyst,288,warlock,destruction,6,3,3
Ciprýan,azralon,288,warlock,destruction,6,3,3
Karter,anetheron,288,warlock,destruction,6,3,3
Lillpfudd,area-52,288,warlock,destruction,6,3,3
Maleficist,bleeding-hollow,288,warlock,destruction,6,3,3
Carpedemon,malganis,288,warlock,destruction,6,3,3
Creedmore,sargeras,288,warlock,destruction,6,3,3
Nòpê,tichondrius,288,warlock,destruction,6,3,3
Striga,staghelm,288,warlock,destruction,6,3,3
Pennÿ,quelthalas,288,warlock,destruction,6,3,3
Famouslos,anetheron,288,warlock,destruction,6,3,3
Toxicatedz,azralon,288,warlock,destruction,6,3,3
Trainwreck,sargeras,288,warlock,destruction,6,3,3
Enaria,queldorei,288,warlock,destruction,6,3,3
Bhalthazar,staghelm,288,warlock,destruction,6,3,3
Pocserlock,drakkari,288,warlock,destruction,6,3,3
Dohmie,argent-dawn,288,warlock,destruction,6,3,3
Cocoabuttâ,stormrage,288,warlock,destruction,6,3,3
Uwubolt,moon-guard,288,warlock,destruction,6,3,3
Drelgun,aerie-peak,288,warlock,destruction,6,3,3
Bunami,kiljaeden,288,warlock,destruction,6,3,3
Atheô,ragnaros,288,warlock,destruction,6,3,3
Rerolledfotm,sargeras,288,warlock,destruction,6,3,3
Eiram,ragnaros,288,warlock,destruction,6,3,3
Muchopower,ragnaros,288,warlock,destruction,6,3,3
Crucifieds,tichondrius,288,warlock,destruction,6,3,3
Anastadora,proudmoore,288,warlock,destruction,6,3,3
Nismo,trollbane,288,warlock,destruction,6,3,3
Hauntgød,tichondrius,288,warlock,destruction,6,3,3
Reyaena,moon-guard,288,warlock,destruction,6,3,3
Tamzlock,the-forgotten-coast,288,warlock,destruction,6,3,3
Famelol,tichondrius,288,warlock,destruction,6,3,3
Amauder,moon-guard,288,warlock,destruction,6,3,3
Gotfear,zuljin,288,warlock,destruction,6,3,3
Geofar,bleeding-hollow,288,warlock,destruction,6,3,3
Ÿoucantwin,kiljaeden,288,warlock,destruction,6,3,3
Gasgrassnass,sargeras,288,warlock,destruction,6,3,3
Meltingface,bleeding-hollow,288,warlock,destruction,6,3,3
Astarothe,proudmoore,288,warlock,destruction,6,3,3
Taldaroth,moon-guard,288,warlock,destruction,7,3,4
Ellipsispain,bleeding-hollow,288,warlock,destruction,7,3,4
Fluximilian,azralon,288,warlock,destruction,10,4,6
Dampenedx,bleeding-hollow,288,warlock,destruction,10,4,6
Gorgaron,zuljin,288,warlock,destruction,12,3,9
Mireffect,auchindoun,288,warlock,destruction,12,3,9
Drwolfman,bonechewer,288,warlock,destruction,12,3,9
Prelick,illidan,288,warlock,destruction,12,3,9
Wickedt,ragnaros,288,warlock,destruction,12,3,9
Zeeref,stormrage,288,warlock,destruction,12,3,9
Darkhadouken,sargeras,288,warlock,destruction,12,3,9
Demonâ,ragnaros,288,warlock,destruction,12,3,9
Sankestones,burning-legion,288,warlock,destruction,12,3,9
Shaddaj,illidan,288,warlock,destruction,12,3,9
Wyrelock,hyjal,288,warlock,destruction,12,3,9
Gotty,stormrage,288,warlock,destruction,12,3,9
Hachiui,galakrond,288,warlock,destruction,12,3,9
Trotndot,dragonmaw,288,warlock,destruction,12,3,9
Reluxify,dalaran,288,warlock,destruction,12,3,9
Rabiesdot,tichondrius,288,warlock,destruction,12,3,9
Feladrae,wyrmrest-accord,288,warlock,destruction,12,3,9
Fearfactory,lethon,288,warlock,destruction,12,3,9
Fazzlock,nagrand,288,warlock,destruction,12,3,9
Gdpx,malganis,288,warlock,destruction,12,3,9
Cexdragon,tichondrius,288,warlock,destruction,14,3,11
Gulliftonan,zuljin,288,warlock,destruction,18,3,15
Izmadara,frostmane,287,warlock,destruction,6,3,3
Verybaked,sargeras,287,warlock,destruction,6,3,3
Kklock,frostmourne,287,warlock,destruction,6,3,3
Infortunium,sargeras,287,warlock,destruction,6,3,3
Brenmen,tichondrius,287,warlock,destruction,6,3,3
Trrolling,jubeithos,287,warlock,destruction,12,5,7
Alvatio,tichondrius,287,warlock,destruction,12,3,9
Evilbacon,stormrage,287,warlock,destruction,12,3,9
Elyzier,gallywix,286,warlock,destruction,12,3,9
Drunklockdot,tichondrius,271,warlock,destruction,11,3,8
Ainzeal,nagrand,256,warlock,destruction,4,4,0
Sophia,wildhammer,255,warlock,destruction,8,4,4
Mikejones,dawnbringer,255,warlock,destruction,14,4,10
Draisien,moon-guard,250,warlock,destruction,7,5,2
Blightbeast,area-52,239,warlock,destruction,5,3,2
Infectionl,ragnaros,239,warlock,destruction,5,3,2
Lustyclam,tichondrius,239,warlock,destruction,5,3,2
Nawtychannel,aegwynn,239,warlock,destruction,5,3,2
Nozixx,thrall,224,warlock,destruction,10,3,7
Particles,proudmoore,192,warlock,destruction,4,3,1
Perfidious,altar-of-storms,192,warlock,destruction,4,3,1
Gregfearnrun,area-52,192,warlock,destruction,4,3,1
Mldxd,undermine,192,warlock,destruction,4,3,1
Portalgun,tichondrius,192,warlock,destruction,4,3,1
Draindeez,sargeras,192,warlock,destruction,9,3,6
Yungwilly,silvermoon,192,warlock,destruction,6,2,4
Nuradzec,illidan,192,warlock,destruction,6,2,4
Royalmace,dethecus,192,warlock,destruction,6,2,4
Morganith,ravenholdt,192,warlock,destruction,6,2,4
Leine,proudmoore,192,warlock,destruction,6,2,4
Ibanez,bleeding-hollow,192,warlock,destruction,6,2,4
Sinissa,ysondre,192,warlock,destruction,6,2,4
Sinsky,darkspear,192,warlock,destruction,6,2,4
Leno,twisting-nether,192,warlock,destruction,6,2,4
Lolokayhaha,vashj,192,warlock,destruction,6,2,4
Zoboo,zuljin,192,warlock,destruction,6,2,4
Sinnâcle,illidan,192,warlock,destruction,6,2,4
Iadminl,moon-guard,192,warlock,destruction,6,2,4
Checkit,zuljin,192,warlock,destruction,6,2,4
Nazug,dark-iron,192,warlock,destruction,6,2,4
Asaveyous,wyrmrest-accord,192,warlock,destruction,6,2,4
Klisman,azralon,192,warlock,destruction,6,2,4
Albuuss,daggerspine,192,warlock,destruction,6,2,4
Fstndantilus,moonrunner,192,warlock,destruction,6,2,4
Sorenbjerga,zuljin,192,warlock,destruction,6,2,4
Cholock,anubarak,192,warlock,destruction,6,2,4
Lhorgainz,area-52,192,warlock,destruction,6,2,4
Nameflagged,arathor,192,warlock,destruction,6,2,4
Imindanger,frostmourne,192,warlock,destruction,6,2,4
Hadeys,amanthul,192,warlock,destruction,6,2,4
Fantumz,illidan,192,warlock,destruction,6,2,4
Guisls,azralon,192,warlock,destruction,6,2,4
Diabolock,proudmoore,192,warlock,destruction,6,2,4
Brawndelock,stormrage,192,warlock,destruction,6,2,4
Fluffylockk,bloodscalp,192,warlock,destruction,6,2,4
Demonia,dathremar,192,warlock,destruction,6,2,4
Spicyfingers,illidan,192,warlock,destruction,6,2,4
Loçkshow,hyjal,192,warlock,destruction,6,2,4
Æonas,bladefist,192,warlock,destruction,6,2,4
Disapoin,stormrage,192,warlock,destruction,6,2,4
Muffinlol,frostmourne,192,warlock,destruction,6,2,4
Reckzet,stormrage,192,warlock,destruction,6,2,4
Sulívan,azralon,192,warlock,destruction,6,2,4
Gadalann,area-52,192,warlock,destruction,6,2,4
Kelthutard,area-52,192,warlock,destruction,6,2,4
Pinguswalrus,stormrage,192,warlock,destruction,6,2,4
Oopsíe,nagrand,192,warlock,destruction,6,2,4
Njunx,queldorei,192,warlock,destruction,6,2,4
Stîgz,stormrage,192,warlock,destruction,6,2,4
Locksama,area-52,192,warlock,destruction,6,2,4
Becà,stormrage,192,warlock,destruction,6,2,4
Qbl,wyrmrest-accord,192,warlock,destruction,6,2,4
Shanelle,korgath,192,warlock,destruction,6,2,4
Vetic,area-52,192,warlock,destruction,6,2,4
Mutexlock,whisperwind,192,warlock,destruction,6,2,4
Dach,moon-guard,192,warlock,destruction,6,2,4
Sugarfire,nemesis,192,warlock,destruction,6,2,4
Fjklock,nemesis,192,warlock,destruction,6,2,4
Apokálipse,frostmourne,192,warlock,destruction,6,2,4
Darkbaron,khadgar,192,warlock,destruction,6,2,4
Cthuga,frostmourne,192,warlock,destruction,6,2,4
Sathorastus,spirestone,192,warlock,destruction,6,2,4
Lazzie,thrall,192,warlock,destruction,6,2,4
Mothapucka,thrall,192,warlock,destruction,6,2,4
Arthürr,thrall,192,warlock,destruction,6,2,4
Theredwolf,zuljin,192,warlock,destruction,6,2,4
Itzlandox,emerald-dream,192,warlock,destruction,6,2,4
Medusablood,area-52,192,warlock,destruction,6,2,4
Gløcked,area-52,192,warlock,destruction,6,2,4
Ðuckworth,azralon,192,warlock,destruction,6,2,4
Gvz,tichondrius,192,warlock,destruction,6,2,4
Adalaya,emerald-dream,192,warlock,destruction,6,2,4
Goldieloc,sargeras,192,warlock,destruction,6,2,4
Outlanderr,tichondrius,192,warlock,destruction,6,2,4
Aliciayd,andorhal,192,warlock,destruction,6,2,4
Bleachkk,tichondrius,192,warlock,destruction,6,2,4
Gihaewon,tichondrius,192,warlock,destruction,6,2,4
Ourlegacy,tichondrius,192,warlock,destruction,6,2,4
Harambê,sargeras,192,warlock,destruction,6,2,4
Xaraki,skullcrusher,192,warlock,destruction,6,2,4
Brillina,windrunner,192,warlock,destruction,6,2,4
Biznam,tichondrius,192,warlock,destruction,6,2,4
Teahourse,tichondrius,192,warlock,destruction,6,2,4
Camila,lightnings-blade,192,warlock,destruction,6,2,4
Marshyxd,tichondrius,192,warlock,destruction,6,2,4
Hollows,burning-blade,192,warlock,destruction,6,2,4
Konarik,nagrand,192,warlock,destruction,6,2,4
Zephiy,kelthuzad,192,warlock,destruction,6,2,4
Raghog,kelthuzad,192,warlock,destruction,6,2,4
Voltshot,tichondrius,192,warlock,destruction,6,2,4
Chipt,kelthuzad,192,warlock,destruction,6,2,4
Lõck,tichondrius,192,warlock,destruction,6,2,4
Montaine,malganis,192,warlock,destruction,6,2,4
Ballpain,sargeras,192,warlock,destruction,6,2,4
Innerforce,tichondrius,192,warlock,destruction,6,2,4
Savemykoalas,tichondrius,192,warlock,destruction,6,2,4
Abbyshapiro,kelthuzad,192,warlock,destruction,6,2,4
Infant,agamaggan,192,warlock,destruction,6,2,4
Mykiel,sargeras,192,warlock,destruction,6,2,4
Yordich,kelthuzad,192,warlock,destruction,6,2,4
Diablox,silvermoon,192,warlock,destruction,6,2,4
Shredlock,tichondrius,192,warlock,destruction,6,2,4
Ozgwad,thunderhorn,192,warlock,destruction,6,2,4
Dotnrunn,kelthuzad,192,warlock,destruction,6,2,4
Startx,tichondrius,192,warlock,destruction,6,2,4
Daesire,moon-guard,192,warlock,destruction,6,2,4
Cynnd,tichondrius,192,warlock,destruction,6,2,4
Azazil,malganis,192,warlock,destruction,6,2,4
Cityswimmer,malganis,192,warlock,destruction,6,2,4
Dotcòm,illidan,192,warlock,destruction,6,2,4
Ramone,turalyon,192,warlock,destruction,6,2,4
Dedremus,korialstrasz,192,warlock,destruction,6,2,4
Tirisfel,tichondrius,192,warlock,destruction,6,2,4
Deiformis,malganis,192,warlock,destruction,6,2,4
Bludlock,illidan,192,warlock,destruction,6,2,4
Terminall,quelthalas,192,warlock,destruction,6,2,4
Ðamndaddy,sargeras,192,warlock,destruction,6,2,4
Omegawarlock,quelthalas,192,warlock,destruction,6,2,4
Theboss,arygos,192,warlock,destruction,6,2,4
Deanwarlock,sargeras,192,warlock,destruction,6,2,4
Theyfearbuda,kelthuzad,192,warlock,destruction,6,2,4
Silverfire,ragnaros,192,warlock,destruction,6,2,4
Åchse,ragnaros,192,warlock,destruction,6,2,4
Ricklock,aggramar,192,warlock,destruction,6,2,4
Dotdoctor,thrall,192,warlock,destruction,9,2,7
Whydemono,tichondrius,192,warlock,destruction,10,2,8
Kandrus,moon-guard,192,warlock,destruction,12,2,10
Dapperdanxy,tichondrius,192,warlock,destruction,12,2,10
Asumi,nemesis,192,warlock,destruction,12,2,10
Wizie,arthas,192,warlock,destruction,12,2,10
Luntrazz,arthas,192,warlock,destruction,12,2,10
Moknuhg,emerald-dream,192,warlock,destruction,12,2,10
Abramerlin,tichondrius,192,warlock,destruction,12,2,10
Bladebank,kirin-tor,192,warlock,destruction,12,2,10
Thediaz,quelthalas,191,warlock,destruction,6,2,4
Mystickittie,aerie-peak,191,warlock,destruction,6,2,4
Eldrien,spirestone,191,warlock,destruction,12,2,10
Hayhatchie,nagrand,159,warlock,destruction,5,2,3
Fearfeaster,tichondrius,159,warlock,destruction,5,2,3
Dotyoazz,stormrage,159,warlock,destruction,5,2,3
Eatmyboltz,hyjal,159,warlock,destruction,5,2,3
Prds,illidan,159,warlock,destruction,5,2,3
Hentailust,kiljaeden,128,warlock,destruction,4,2,2
Thegoatmen,stormrage,128,warlock,destruction,4,2,2
Miggazzizle,senjin,128,warlock,destruction,4,2,2
Rosacrutian,tichondrius,128,warlock,destruction,4,2,2
Oreo,velen,112,warlock,destruction,7,2,5
Goodforyou,stormscale,96,warlock,destruction,3,2,1
Ministàff,ursin,96,warlock,destruction,3,2,1
Crankak,zuljin,96,warlock,destruction,3,2,1
Willsayan,ragnaros,96,warlock,destruction,3,2,1
Rëappér,ragnaros,96,warlock,destruction,6,1,5
Alcorick,moon-guard,96,warlock,destruction,6,1,5
Kaotiq,area-52,96,warlock,destruction,6,1,5
Hinatasu,greymane,96,warlock,destruction,6,1,5
Karpawarlock,ragnaros,96,warlock,destruction,6,1,5
Gamecobra,greymane,96,warlock,destruction,6,1,5
Pspot,kiljaeden,96,warlock,destruction,6,1,5
Gsr,bleeding-hollow,96,warlock,destruction,6,1,5
Vexxes,malganis,96,warlock,destruction,6,1,5
Heffyboi,frostmourne,96,warlock,destruction,6,1,5
Kraguenöth,drakkari,96,warlock,destruction,6,1,5
Plaguedoctor,stormrage,96,warlock,destruction,6,1,5
Lucifuhrerr,tichondrius,96,warlock,destruction,6,1,5
Lawkdown,dark-iron,96,warlock,destruction,6,1,5
Badufin,azralon,96,warlock,destruction,6,1,5
Bfaclâssic,zuljin,96,warlock,destruction,6,1,5
Lokiiee,azuremyst,96,warlock,destruction,6,1,5
Shidded,lightbringer,96,warlock,destruction,6,1,5
Chilevael,sargeras,96,warlock,destruction,6,1,5
Acribal,quelthalas,96,warlock,destruction,6,1,5
Demonist,moon-guard,96,warlock,destruction,6,1,5
Siinistuh,tichondrius,96,warlock,destruction,6,1,5
Lizlock,stormrage,96,warlock,destruction,6,1,5
Monstir,sargeras,96,warlock,destruction,6,1,5
Basticor,moon-guard,96,warlock,destruction,6,1,5
Dotomizer,moonrunner,96,warlock,destruction,6,1,5
Däemön,area-52,96,warlock,destruction,6,1,5
Mcpickl,illidan,96,warlock,destruction,6,1,5
Seutóóbinha,stormrage,96,warlock,destruction,6,1,5
Lockswagger,stormrage,96,warlock,destruction,6,1,5
Tartamuda,ragnaros,96,warlock,destruction,6,1,5
Brothadoinks,zuljin,96,warlock,destruction,6,1,5
Sheara,silver-hand,96,warlock,destruction,6,1,5
Elaïla,area-52,96,warlock,destruction,6,1,5
Proletariat,moon-guard,96,warlock,destruction,6,1,5
Mílkduds,zuljin,96,warlock,destruction,6,1,5
Raebolts,area-52,96,warlock,destruction,6,1,5
Killulock,area-52,96,warlock,destruction,6,1,5
Biigdaddyy,kelthuzad,96,warlock,destruction,6,1,5
Lazymongoose,frostmourne,96,warlock,destruction,6,1,5
Koillock,bleeding-hollow,96,warlock,destruction,6,1,5
Xaryus,barthilas,96,warlock,destruction,6,1,5
Adlfcritler,emerald-dream,96,warlock,destruction,6,1,5
Trïnîty,tichondrius,96,warlock,destruction,6,1,5
Stonelocke,area-52,96,warlock,destruction,6,1,5
Niubeelol,tichondrius,96,warlock,destruction,6,1,5
Scatach,area-52,96,warlock,destruction,6,1,5
Lockedinn,mannoroth,96,warlock,destruction,6,1,5
Bigdoinks,nagrand,96,warlock,destruction,6,1,5
Gulgrin,eldrethalas,96,warlock,destruction,6,1,5
Infear,area-52,96,warlock,destruction,6,1,5
Cornboil,tichondrius,96,warlock,destruction,6,1,5
Vendareth,earthen-ring,96,warlock,destruction,6,1,5
Ezgamejr,tichondrius,96,warlock,destruction,6,1,5
Resima,stormscale,96,warlock,destruction,6,1,5
Wesyane,anetheron,96,warlock,destruction,6,1,5
Demonellea,frostmourne,96,warlock,destruction,6,1,5
Jiwonpark,goldrinn,96,warlock,destruction,6,1,5
Yuengling,illidan,96,warlock,destruction,6,1,5
Lilcarmy,emerald-dream,96,warlock,destruction,6,1,5
Kurtcodrain,blackhand,96,warlock,destruction,6,1,5
Erindevil,demon-soul,96,warlock,destruction,6,1,5
Vandenso,stormrage,96,warlock,destruction,6,1,5
Jill,thunderhorn,96,warlock,destruction,6,1,5
Ensanaty,dalaran,96,warlock,destruction,6,1,5
Darkmatter,frostmourne,96,warlock,destruction,6,1,5
Kothoped,wyrmrest-accord,96,warlock,destruction,6,1,5
Ãids,khadgar,96,warlock,destruction,6,1,5
Voky,whisperwind,96,warlock,destruction,6,1,5
Amour,wyrmrest-accord,96,warlock,destruction,6,1,5
Saytiri,tichondrius,96,warlock,destruction,6,1,5
Charlîe,vashj,96,warlock,destruction,6,1,5
Juwi,frostmourne,96,warlock,destruction,6,1,5
Sailuhh,frostwolf,96,warlock,destruction,6,1,5
Wickedicky,alleria,96,warlock,destruction,6,1,5
Bosshoglock,whisperwind,96,warlock,destruction,6,1,5
Wherelock,area-52,96,warlock,destruction,7,1,6
Beamac,cenarius,96,warlock,destruction,8,1,7
Anubís,vashj,79,warlock,destruction,5,1,4
Epicgaymer,zuljin,79,warlock,destruction,5,1,4
Felse,stormrage,64,warlock,destruction,10,1,9
Thiccdoinkz,tichondrius,63,warlock,destruction,2,2,0
Kosugi,kelthuzad,42,warlock,destruction,8,2,6
Lazzarros,area-52,42,warlock,destruction,10,2,8
Heathncraig,illidan,31,warlock,destruction,2,1,1
Moräl,frostmourne,31,warlock,destruction,2,1,1
Amarexd,stormrage,31,warlock,destruction,2,1,1
Americanbull,moon-guard,2157,warrior,fury,247,133,114
Grimgrip,frostmane,2131,warrior,fury,92,53,39
Joshiman,area-52,2124,warrior,fury,78,42,36
Cabelastwo,tichondrius,2124,warrior,fury,87,46,41
Cabelas,tichondrius,2112,warrior,fury,89,45,44
Thrator,wyrmrest-accord,2110,warrior,fury,108,55,53
Riproarin,stormrage,2105,warrior,fury,92,53,39
Braxxínn,tichondrius,2023,warrior,fury,42,34,8
Sworda,sargeras,2017,warrior,fury,77,48,29
Warqt,kelthuzad,1983,warrior,fury,89,49,40
Gazzef,thrall,1980,warrior,fury,66,38,28
Ragwreck,bleeding-hollow,1959,warrior,fury,68,35,33
Sandronb,illidan,1938,warrior,fury,83,41,42
Eno,ragnaros,1937,warrior,fury,69,46,23
Alabamá,sargeras,1925,warrior,fury,36,21,15
Furrytakeda,kelthuzad,1925,warrior,fury,72,39,33
Wienertoes,tichondrius,1904,warrior,fury,102,55,47
Veevz,proudmoore,1894,warrior,fury,48,26,22
Brodestar,sargeras,1874,warrior,fury,42,28,14
Badvelic,tichondrius,1874,warrior,fury,46,28,18
Shîzu,moon-guard,1868,warrior,fury,102,67,35
Vèév,proudmoore,1867,warrior,fury,56,37,19
Damonadrann,proudmoore,1859,warrior,fury,66,34,32
Lahired,drakkari,1857,warrior,fury,119,54,65
Dowser,goldrinn,1852,warrior,fury,131,69,62
Melifehorde,tichondrius,1848,warrior,fury,216,110,106
Cannabiddies,illidan,1845,warrior,fury,42,22,20
Larrybiscuit,moon-guard,1839,warrior,fury,156,95,61
Hlt,tichondrius,1839,warrior,fury,54,31,23
Esilox,area-52,1836,warrior,fury,42,28,14
Jenjang,proudmoore,1834,warrior,fury,83,52,31
Zanzaa,sargeras,1830,warrior,fury,67,37,30
Brainhaze,tichondrius,1829,warrior,fury,36,21,15
Ragwreckz,bleeding-hollow,1826,warrior,fury,52,32,20
Soymong,frostmourne,1825,warrior,fury,116,74,42
Mty,tichondrius,1824,warrior,fury,54,35,19
Szauren,stormrage,1824,warrior,fury,63,31,32
Apocalyptist,stormrage,1821,warrior,fury,99,58,41
Bosswin,tichondrius,1820,warrior,fury,53,28,25
Skyja,quelthalas,1820,warrior,fury,42,22,20
Gorehardt,illidan,1820,warrior,fury,48,22,26
Veyrin,stormrage,1818,warrior,fury,138,81,57
Isahri,moon-guard,1818,warrior,fury,110,64,46
Orchilles,illidan,1817,warrior,fury,60,35,25
Damiansuv,moon-guard,1817,warrior,fury,154,89,65
Jírky,ragnaros,1816,warrior,fury,240,134,106
Zujuzo,moon-guard,1815,warrior,fury,111,64,47
Neôn,frostmourne,1815,warrior,fury,66,37,29
Ragemane,illidan,1815,warrior,fury,66,35,31
Darkduke,tichondrius,1813,warrior,fury,33,21,12
Donutwar,proudmoore,1813,warrior,fury,54,30,24
Barafang,wyrmrest-accord,1811,warrior,fury,234,125,109
Kennäy,azralon,1810,warrior,fury,46,28,18
Psychogenic,barthilas,1810,warrior,fury,102,60,42
Zyzz,scarlet-crusade,1807,warrior,fury,72,41,31
Killuall,sargeras,1807,warrior,fury,42,23,19
Yawdamper,illidan,1805,warrior,fury,51,32,19
Starshattr,bleeding-hollow,1805,warrior,fury,108,64,44
Seoní,wyrmrest-accord,1805,warrior,fury,76,43,33
Franticlol,tichondrius,1802,warrior,fury,90,59,31
Cubie,malganis,1802,warrior,fury,75,40,35
Tøpg,sargeras,1801,warrior,fury,55,32,23
Ágsdóùblémàú,bleeding-hollow,1794,warrior,fury,120,66,54
Rekatron,area-52,1783,warrior,fury,49,25,24
Sàndman,malganis,1775,warrior,fury,39,23,16
Splasch,kelthuzad,1775,warrior,fury,41,20,21
Jimjinjin,tichondrius,1770,warrior,fury,54,29,25
Rôxi,malganis,1770,warrior,fury,118,58,60
Choppiechop,area-52,1763,warrior,fury,42,26,16
Rynkae,moon-guard,1762,warrior,fury,36,20,16
Alteryx,sargeras,1761,warrior,fury,196,112,84
Gladheateher,bonechewer,1759,warrior,fury,42,22,20
Onionsauce,frostmourne,1758,warrior,fury,149,82,67
Taras,blackhand,1754,warrior,fury,57,25,32
Chopped,wyrmrest-accord,1750,warrior,fury,93,43,50
Alarìon,malganis,1745,warrior,fury,45,31,14
Bigfatork,area-52,1741,warrior,fury,76,38,38
Dripgodx,malganis,1736,warrior,fury,54,30,24
Gooberbear,frostmourne,1732,warrior,fury,115,64,51
Shadax,bleeding-hollow,1730,warrior,fury,134,72,62
Beanstrom,tichondrius,1729,warrior,fury,77,39,38
Escånor,moon-guard,1728,warrior,fury,25,19,6
Eazyc,tichondrius,1724,warrior,fury,48,26,22
Biaa,tichondrius,1723,warrior,fury,30,18,12
Eggroll,emerald-dream,1720,warrior,fury,90,54,36
Slamurai,moon-guard,1719,warrior,fury,24,18,6
Duochuanjun,illidan,1719,warrior,fury,48,26,22
Warroiser,quelthalas,1716,warrior,fury,55,33,22
Coldshots,stormreaver,1710,warrior,fury,42,28,14
Shibaraku,tichondrius,1704,warrior,fury,214,107,107
Mphx,tichondrius,1702,warrior,fury,30,18,12
Zangetsy,sargeras,1697,warrior,fury,57,35,22
Daedrion,dalaran,1697,warrior,fury,54,30,24
Mochigome,moon-guard,1696,warrior,fury,97,49,48
Scolpi,stormrage,1695,warrior,fury,76,42,34
Drashi,nazjatar,1693,warrior,fury,42,29,13
Slughorn,moon-guard,1693,warrior,fury,78,37,41
Blgjb,tichondrius,1693,warrior,fury,66,30,36
Ttvdjrio,area-52,1689,warrior,fury,30,20,10
Onîkudakì,sargeras,1689,warrior,fury,91,55,36
Mulish,frostmourne,1681,warrior,fury,67,40,27
Scrotedog,area-52,1680,warrior,fury,55,24,31
Tyroe,thunderhorn,1679,warrior,fury,36,22,14
Torbajhorn,moon-guard,1676,warrior,fury,66,34,32
Fearless,moon-guard,1675,warrior,fury,126,68,58
Thugdorr,sargeras,1675,warrior,fury,102,53,49
Aotha,moon-guard,1674,warrior,fury,26,18,8
Morfoggore,ragnaros,1673,warrior,fury,55,25,30
Rendwarchief,garrosh,1668,warrior,fury,145,76,69
Velarrine,illidan,1667,warrior,fury,67,37,30
Festergrin,area-52,1665,warrior,fury,60,32,28
Moistt,nesingwary,1660,warrior,fury,32,22,10
Hairygrundel,area-52,1660,warrior,fury,42,27,15
Ethyrie,ragnaros,1660,warrior,fury,38,19,19
Gnomageddon,anetheron,1653,warrior,fury,82,39,43
Kholusia,kul-tiras,1649,warrior,fury,112,53,59
Keltanas,quelthalas,1645,warrior,fury,71,37,34
Faren,agamaggan,1643,warrior,fury,167,91,76
Youaredafeds,moon-guard,1641,warrior,fury,125,71,54
Eregor,sargeras,1638,warrior,fury,48,24,24
Budgetclap,nordrassil,1636,warrior,fury,36,18,18
Dardash,ragnaros,1634,warrior,fury,30,21,9
Kellyboitv,frostmourne,1628,warrior,fury,42,20,22
Wagù,moon-guard,1626,warrior,fury,30,21,9
Colorx,sargeras,1625,warrior,fury,52,30,22
Ðåddý,stormrage,1625,warrior,fury,107,52,55
Ugriker,skullcrusher,1623,warrior,fury,42,26,16
Ruuthless,sargeras,1623,warrior,fury,51,30,21
Flexid,tichondrius,1622,warrior,fury,66,34,32
Ediann,elune,1619,warrior,fury,77,45,32
Rinima,tichondrius,1616,warrior,fury,72,37,35
Furíous,thunderhorn,1616,warrior,fury,48,23,25
Illaedan,quelthalas,1611,warrior,fury,42,18,24
Noramed,moon-guard,1610,warrior,fury,54,30,24
Khrull,khazgoroth,1609,warrior,fury,74,40,34
Damburga,tichondrius,1608,warrior,fury,42,27,15
Leviqt,moon-guard,1606,warrior,fury,36,21,15
Lilgucci,stonemaul,1602,warrior,fury,36,20,16
Bulgrim,moon-guard,1601,warrior,fury,42,21,21
Soulfang,stormscale,1600,warrior,fury,36,20,16
Brutality,kirin-tor,1598,warrior,fury,107,57,50
Gaazhel,quelthalas,1598,warrior,fury,97,49,48
Ssamba,shattered-hand,1597,warrior,fury,30,17,13
Darkbunny,thaurissan,1597,warrior,fury,78,40,38
Gigatroll,tichondrius,1592,warrior,fury,59,30,29
Påpi,sargeras,1591,warrior,fury,72,43,29
Wampzug,azshara,1591,warrior,fury,78,37,41
Igoboom,bleeding-hollow,1585,warrior,fury,46,25,21
Tanorai,area-52,1582,warrior,fury,42,27,15
Sayjaki,stormrage,1582,warrior,fury,48,26,22
Sithlõrd,moon-guard,1580,warrior,fury,54,27,27
Trôca,ragnaros,1575,warrior,fury,48,25,23
Tenger,velen,1574,warrior,fury,100,56,44
Easons,tichondrius,1574,warrior,fury,54,24,30
Wolfcultist,moon-guard,1572,warrior,fury,117,54,63
Dann,ragnaros,1569,warrior,fury,59,35,24
Wöûlöû,trollbane,1568,warrior,fury,85,46,39
Zuggrok,zuljin,1564,warrior,fury,114,53,61
Romus,spirestone,1562,warrior,fury,42,26,16
Khargrok,ragnaros,1561,warrior,fury,75,44,31
Daelganis,blood-furnace,1560,warrior,fury,36,19,17
Fearlessly,moon-guard,1559,warrior,fury,124,68,56
Gûard,stormrage,1558,warrior,fury,52,27,25
Rikbielo,dragonmaw,1554,warrior,fury,67,37,30
Morguez,tichondrius,1552,warrior,fury,66,37,29
Garobber,stormrage,1552,warrior,fury,36,17,19
Zareshi,sargeras,1546,warrior,fury,116,64,52
Sugmad,area-52,1545,warrior,fury,48,22,26
Bigßiceps,tichondrius,1544,warrior,fury,30,18,12
Tádakatsu,sargeras,1544,warrior,fury,103,53,50
Ohdang,dark-iron,1543,warrior,fury,90,51,39
Raggnarsøøn,ragnaros,1543,warrior,fury,99,46,53
Kortera,malganis,1542,warrior,fury,30,22,8
Dwarlan,stormrage,1539,warrior,fury,60,38,22
Stavsie,tichondrius,1535,warrior,fury,30,17,13
Impalle,nazjatar,1531,warrior,fury,54,33,21
Invdeath,azralon,1529,warrior,fury,35,19,16
Philsbbqnow,dark-iron,1525,warrior,fury,24,16,8
Chillawigs,kelthuzad,1524,warrior,fury,30,19,11
Abomlnatlon,tichondrius,1524,warrior,fury,36,22,14
Zombad,azralon,1522,warrior,fury,30,18,12
Okme,tichondrius,1522,warrior,fury,36,16,20
Warrmachine,mannoroth,1520,warrior,fury,132,75,57
Crohdey,madoran,1519,warrior,fury,120,65,55
Zitfrlt,wildhammer,1515,warrior,fury,87,39,48
Playbox,area-52,1514,warrior,fury,83,37,46
Mytharion,sargeras,1511,warrior,fury,30,18,12
Linker,ragnaros,1511,warrior,fury,42,25,17
Ragnararagor,ragnaros,1510,warrior,fury,245,122,123
Machomanran,zuljin,1509,warrior,fury,89,47,42
Jorked,drakkari,1509,warrior,fury,68,35,33
Dcashmoney,moon-guard,1508,warrior,fury,59,33,26
Benchpress,bleeding-hollow,1508,warrior,fury,60,30,30
Anandamide,frostwolf,1503,warrior,fury,51,27,24
Chounshiryu,drakkari,1502,warrior,fury,231,120,111
Grômm,tichondrius,1500,warrior,fury,63,33,30
Brøsk,azralon,1500,warrior,fury,48,24,24
Nimna,moon-guard,1499,warrior,fury,59,29,30
Sigiswald,cenarion-circle,1491,warrior,fury,30,16,14
Viagraliker,tichondrius,1490,warrior,fury,45,28,17
Arágorn,sargeras,1490,warrior,fury,30,18,12
Albinosword,azralon,1488,warrior,fury,74,37,37
Shádo,darkspear,1485,warrior,fury,36,23,13
Rafurk,area-52,1483,warrior,fury,30,18,12
Ronok,ghostlands,1481,warrior,fury,42,26,16
Know,anetheron,1480,warrior,fury,39,25,14
Ikoré,saurfang,1480,warrior,fury,81,44,37
Karusuke,stormrage,1472,warrior,fury,36,21,15
Hammerock,ragnaros,1469,warrior,fury,29,16,13
Hôdû,tichondrius,1466,warrior,fury,58,32,26
Jubeithos,draktharon,1466,warrior,fury,60,28,32
Venirith,moon-guard,1465,warrior,fury,76,39,37
Nixe,caelestrasz,1465,warrior,fury,80,38,42
Stoopkid,uldum,1465,warrior,fury,36,16,20
Jimseung,tichondrius,1459,warrior,fury,36,16,20
Celere,azralon,1458,warrior,fury,54,23,31
Éomer,eitrigg,1457,warrior,fury,48,31,17
Commandó,proudmoore,1457,warrior,fury,47,30,17
Mandremin,moon-guard,1456,warrior,fury,24,17,7
Thyssara,moon-guard,1456,warrior,fury,45,25,20
Rhann,kelthuzad,1454,warrior,fury,42,22,20
Wazy,ragnaros,1448,warrior,fury,60,28,32
Pootyspootz,warsong,1442,warrior,fury,30,17,13
Bestgrunt,tichondrius,1442,warrior,fury,42,17,25
Smexxin,tichondrius,1439,warrior,fury,24,15,9
Varith,sargeras,1439,warrior,fury,48,21,27
Cohëëd,kelthuzad,1436,warrior,fury,60,31,29
Wurrukattezz,tichondrius,1435,warrior,fury,38,22,16
Elken,haomarush,1434,warrior,fury,48,26,22
Mankus,tichondrius,1432,warrior,fury,90,45,45
Kazora,zuljin,1425,warrior,fury,24,15,9
Errejota,illidan,1424,warrior,fury,36,18,18
Mikejustice,kelthuzad,1423,warrior,fury,88,43,45
Murderwalk,shadowmoon,1422,warrior,fury,39,19,20
Attractive,silvermoon,1420,warrior,fury,103,57,46
Heenguer,azralon,1420,warrior,fury,60,31,29
Majindoom,illidan,1418,warrior,fury,47,27,20
Hêllseeker,ragnaros,1417,warrior,fury,36,18,18
Zerríck,moon-guard,1415,warrior,fury,36,18,18
Weesten,aerie-peak,1411,warrior,fury,138,80,58
Teyroporah,azralon,1409,warrior,fury,39,20,19
Warsongwolf,tichondrius,1409,warrior,fury,78,36,42
Aarmii,ragnaros,1408,warrior,fury,36,18,18
Burtiera,wyrmrest-accord,1407,warrior,fury,54,33,21
Koffray,malfurion,1405,warrior,fury,39,20,19
Exëqt,area-52,1404,warrior,fury,60,25,35
Sálieri,ragnaros,1403,warrior,fury,36,19,17
Apeal,skullcrusher,1403,warrior,fury,84,44,40
Braxtön,moon-guard,1401,warrior,fury,45,20,25
Xurug,zuljin,1400,warrior,fury,30,15,15
Sensho,azralon,1398,warrior,fury,24,15,9
Fluffytaco,illidan,1396,warrior,fury,36,20,16
Gorrtog,stormrage,1395,warrior,fury,84,36,48
Slaggdad,illidan,1395,warrior,fury,62,26,36
Lyonele,moon-guard,1394,warrior,fury,50,28,22
Ourhero,malganis,1392,warrior,fury,27,16,11
Zekken,blades-edge,1392,warrior,fury,77,39,38
Fearlessxq,tichondrius,1390,warrior,fury,72,38,34
Iskandr,amanthul,1389,warrior,fury,75,35,40
Swiftslaýer,vashj,1383,warrior,fury,35,16,19
Kratøz,tichondrius,1382,warrior,fury,36,18,18
Fendimonster,tichondrius,1379,warrior,fury,136,74,62
Swiffy,stormrage,1375,warrior,fury,46,29,17
Kaladbolg,tichondrius,1369,warrior,fury,24,15,9
Zootonius,bloodscalp,1368,warrior,fury,36,20,16
Firmware,illidan,1368,warrior,fury,34,15,19
Crushanater,tichondrius,1364,warrior,fury,33,17,16
Spaceguybro,whisperwind,1364,warrior,fury,36,18,18
Assaulttank,drenden,1361,warrior,fury,30,15,15
Nebgleb,bleeding-hollow,1360,warrior,fury,24,16,8
Emotionaldps,malygos,1360,warrior,fury,141,74,67
Calzonez,bloodscalp,1354,warrior,fury,24,15,9
Matthegreat,area-52,1354,warrior,fury,51,25,26
Eatmyblade,wyrmrest-accord,1350,warrior,fury,169,76,93
Cenanuandra,gnomeregan,1349,warrior,fury,40,21,19
Rageinc,jubeithos,1347,warrior,fury,56,24,32
Arfzz,zangarmarsh,1343,warrior,fury,36,16,20
Girioo,thrall,1342,warrior,fury,18,14,4
Moriax,azralon,1342,warrior,fury,53,26,27
Oddyseey,moon-guard,1341,warrior,fury,24,14,10
Rekill,emerald-dream,1337,warrior,fury,24,14,10
Berawar,tichondrius,1335,warrior,fury,24,14,10
Ensïs,moon-guard,1335,warrior,fury,54,22,32
Kombatwombat,kaelthas,1334,warrior,fury,18,14,4
Ciellë,proudmoore,1334,warrior,fury,27,17,10
Ciege,illidan,1333,warrior,fury,24,14,10
Johnnysnowx,sargeras,1332,warrior,fury,54,26,28
Breaker,undermine,1331,warrior,fury,30,14,16
Gromarth,wyrmrest-accord,1329,warrior,fury,29,16,13
Screwz,blackrock,1328,warrior,fury,78,43,35
Bondeye,stormrage,1325,warrior,fury,83,38,45
Dhaemom,azralon,1324,warrior,fury,47,23,24
Ivanzaytsev,ragnaros,1321,warrior,fury,66,32,34
Violençe,malganis,1320,warrior,fury,30,14,16
Galaxarr,bonechewer,1319,warrior,fury,65,32,33
Wuushang,area-52,1315,warrior,fury,42,22,20
Hellframe,ysondre,1315,warrior,fury,42,17,25
Warföx,stormrage,1310,warrior,fury,36,15,21
Tüssèll,khazgoroth,1306,warrior,fury,97,48,49
Badoosh,kaelthas,1302,warrior,fury,23,15,8
Goleus,emerald-dream,1299,warrior,fury,42,17,25
Youserg,khazgoroth,1298,warrior,fury,70,32,38
Xeto,ragnaros,1296,warrior,fury,34,20,14
Sperow,malygos,1296,warrior,fury,26,15,11
Fabian,kelthuzad,1296,warrior,fury,76,40,36
Noten,thunderlord,1295,warrior,fury,60,30,30
Kelandrin,illidan,1292,warrior,fury,24,15,9
Vapyr,moon-guard,1291,warrior,fury,23,14,9
Savikk,earthen-ring,1287,warrior,fury,36,21,15
Zweihänder,nemesis,1284,warrior,fury,23,14,9
Thywub,proudmoore,1284,warrior,fury,30,14,16
Lighttaker,proudmoore,1280,warrior,fury,72,38,34
Rsage,lightbringer,1274,warrior,fury,116,59,57
Zenrrei,ragnaros,1272,warrior,fury,22,14,8
Grumok,tichondrius,1267,warrior,fury,26,14,12
Ivoryana,kelthuzad,1266,warrior,fury,48,25,23
Paí,nemesis,1265,warrior,fury,24,15,9
Elbetoques,ragnaros,1261,warrior,fury,30,18,12
Lilcha,stormrage,1258,warrior,fury,36,15,21
Garce,aerie-peak,1253,warrior,fury,31,16,15
Vandrad,stormrage,1252,warrior,fury,123,56,67
Varlekt,frostmourne,1251,warrior,fury,53,25,28
Kurishjadar,tichondrius,1251,warrior,fury,66,31,35
Elonownesme,zuljin,1251,warrior,fury,44,20,24
Wariorphilip,moon-guard,1250,warrior,fury,30,18,12
Wakkawar,stormrage,1248,warrior,fury,48,24,24
Carnemontana,shadowsong,1246,warrior,fury,24,17,7
Torkscreww,bleeding-hollow,1243,warrior,fury,24,13,11
Buckleboot,illidan,1242,warrior,fury,24,13,11
Rendard,sargeras,1242,warrior,fury,24,13,11
Tinyexcute,tichondrius,1242,warrior,fury,24,13,11
Tdaddy,lightbringer,1242,warrior,fury,121,61,60
Rerollrogue,thrall,1241,warrior,fury,55,19,36
Robocöp,quelthalas,1239,warrior,fury,24,13,11
Jarheadz,bleeding-hollow,1238,warrior,fury,18,13,5
Skipowawa,area-52,1237,warrior,fury,30,16,14
Atracasöl,ragnaros,1236,warrior,fury,24,13,11
Hârambe,kiljaeden,1235,warrior,fury,24,13,11
Zephyron,moonrunner,1231,warrior,fury,38,18,20
Renseven,frostmourne,1230,warrior,fury,36,19,17
Cjay,bleeding-hollow,1229,warrior,fury,30,13,17
Honduranhary,sargeras,1227,warrior,fury,28,16,12
Groggam,illidan,1226,warrior,fury,24,13,11
Osannd,tichondrius,1226,warrior,fury,48,19,29
Furiousangel,area-52,1223,warrior,fury,36,19,17
Vornicar,moon-guard,1221,warrior,fury,32,14,18
Koraciá,illidan,1215,warrior,fury,36,17,19
Grosjambes,turalyon,1214,warrior,fury,30,18,12
Tenebrocity,stormrage,1213,warrior,fury,42,19,23
Breinan,ragnaros,1205,warrior,fury,51,26,25
Kaíroz,quelthalas,1203,warrior,fury,42,24,18
Kyle,kargath,1201,warrior,fury,28,17,11
Rendus,hyjal,1198,warrior,fury,54,21,33
Cliveswife,frostmourne,1196,warrior,fury,17,13,4
Bigglyjoobs,tichondrius,1195,warrior,fury,23,13,10
Tinycutty,frostmourne,1189,warrior,fury,23,13,10
Furyknight,velen,1187,warrior,fury,43,23,20
Nemesioh,tichondrius,1184,warrior,fury,59,25,34
Antei,thunderlord,1171,warrior,fury,23,13,10
Zèldris,gallywix,1171,warrior,fury,109,61,48
Liljon,windrunner,1166,warrior,fury,36,17,19
Zorhn,skywall,1161,warrior,fury,24,18,6
Darthwarr,bleeding-hollow,1156,warrior,fury,35,23,12
Líliúm,ragnaros,1151,warrior,fury,31,19,12
Takeda,sargeras,1151,warrior,fury,30,12,18
Hellamoist,tichondrius,1150,warrior,fury,18,12,6
Ganzism,tichondrius,1150,warrior,fury,24,12,12
Ganzi,tichondrius,1150,warrior,fury,24,12,12
Notcoverage,tichondrius,1150,warrior,fury,24,12,12
Ganzar,nesingwary,1148,warrior,fury,24,12,12
Nordama,stormrage,1147,warrior,fury,18,12,6
Zuggyboi,moon-guard,1147,warrior,fury,18,12,6
Synalia,sargeras,1147,warrior,fury,24,12,12
Zarxc,quelthalas,1147,warrior,fury,24,12,12
Orrof,antonidas,1147,warrior,fury,69,25,44
Galigiggs,emerald-dream,1146,warrior,fury,18,12,6
Lòrdnasher,tichondrius,1146,warrior,fury,21,13,8
Ianprime,the-scryers,1146,warrior,fury,24,12,12
Setseno,stormrage,1145,warrior,fury,24,12,12
Kanekhy,ragnaros,1143,warrior,fury,28,13,15
Casmier,tichondrius,1141,warrior,fury,18,12,6
Joxer,nordrassil,1141,warrior,fury,30,13,17
Balbyo,shattered-hand,1139,warrior,fury,30,12,18
Sansãocore,nemesis,1138,warrior,fury,28,13,15
Originalkhan,stormrage,1138,warrior,fury,30,12,18
Talismantate,quelthalas,1135,warrior,fury,18,12,6
Makcumba,ragnaros,1132,warrior,fury,24,12,12
Zoldian,tichondrius,1132,warrior,fury,29,14,15
Chahta,shadowsong,1125,warrior,fury,18,12,6
Cougaloo,sargeras,1123,warrior,fury,42,17,25
Rekitralph,tichondrius,1116,warrior,fury,30,13,17
Irontarkus,garrosh,1112,warrior,fury,18,12,6
Sphílly,thrall,1107,warrior,fury,36,19,17
Tyraelius,kiljaeden,1103,warrior,fury,39,24,15
Smallestwar,zuljin,1093,warrior,fury,41,16,25
Xfootman,quelthalas,1092,warrior,fury,42,25,17
Roxon,hellscream,1088,warrior,fury,83,41,42
Duxor,sargeras,1086,warrior,fury,22,12,10
Kolosaltwo,tichondrius,1084,warrior,fury,23,12,11
Dodiru,azralon,1084,warrior,fury,27,13,14
Brodîn,tichondrius,1083,warrior,fury,54,30,24
Elsee,drakkari,1080,warrior,fury,26,12,14
Undmyaxe,shattered-halls,1078,warrior,fury,24,13,11
Bigjier,proudmoore,1078,warrior,fury,26,12,14
Fatguy,tichondrius,1076,warrior,fury,60,29,31
Assmut,stormrage,1074,warrior,fury,35,15,20
Lucymay,kelthuzad,1072,warrior,fury,36,19,17
Starplatinum,aerie-peak,1060,warrior,fury,30,12,18
Xcuses,area-52,1055,warrior,fury,18,11,7
Ragingboner,aggramar,1055,warrior,fury,18,11,7
Tctc,emerald-dream,1055,warrior,fury,18,11,7
Nicfury,alterac-mountains,1055,warrior,fury,18,11,7
Flaco,tichondrius,1055,warrior,fury,21,12,9
Gorbagglúk,azralon,1055,warrior,fury,30,15,15
Zerkxi,kelthuzad,1053,warrior,fury,18,11,7
Hjomura,quelthalas,1053,warrior,fury,18,11,7
Serviettski,zuljin,1053,warrior,fury,24,12,12
Cupper,tichondrius,1052,warrior,fury,24,11,13
Axesage,tichondrius,1051,warrior,fury,24,11,13
Radisa,sargeras,1051,warrior,fury,30,11,19
Mäjka,dalaran,1050,warrior,fury,24,11,13
Ráionshin,quelthalas,1049,warrior,fury,24,11,13
Trco,quelthalas,1047,warrior,fury,18,11,7
Tayne,ragnaros,1046,warrior,fury,18,11,7
Marcuss,bonechewer,1043,warrior,fury,18,11,7
Garmeg,nemesis,1041,warrior,fury,42,16,26
Jellyjamz,zuljin,1032,warrior,fury,30,14,16
Owwycowwy,area-52,1032,warrior,fury,36,15,21
Ashwalker,malganis,1022,warrior,fury,20,12,8
Rumka,draktharon,1015,warrior,fury,65,26,39
Wyrmscream,moon-guard,1011,warrior,fury,84,40,44
Éeu,anubarak,1008,warrior,fury,112,58,54
Mandragorn,kelthuzad,1004,warrior,fury,27,11,16
Crazysharpz,thaurissan,1001,warrior,fury,29,12,17
Leturen,emerald-dream,999,warrior,fury,25,12,13
Painfulangel,nesingwary,994,warrior,fury,20,15,5
Warchine,malganis,994,warrior,fury,27,12,15
Baeowar,area-52,994,warrior,fury,39,13,26
Shoteiotoshi,ragnaros,991,warrior,fury,35,18,17
Yêawen,tichondrius,990,warrior,fury,20,11,9
Jonÿ,sargeras,989,warrior,fury,84,44,40
Curacao,dark-iron,987,warrior,fury,26,11,15
Darkarus,drakkari,979,warrior,fury,30,13,17
Pulp,sargeras,976,warrior,fury,19,11,8
Judessi,kiljaeden,971,warrior,fury,20,11,9
Brugo,area-52,960,warrior,fury,30,18,12
Dawx,thrall,960,warrior,fury,18,10,8
Jingson,moon-guard,959,warrior,fury,12,10,2
Râvik,illidan,959,warrior,fury,18,10,8
Hasbullaa,proudmoore,959,warrior,fury,18,10,8
Ymìr,moon-guard,959,warrior,fury,18,10,8
Orrkky,jubeithos,959,warrior,fury,18,10,8
Giannï,chogall,959,warrior,fury,18,10,8
Genrÿuusai,azralon,958,warrior,fury,18,10,8
Wrniss,tichondrius,958,warrior,fury,18,10,8
Lechonk,suramar,958,warrior,fury,18,10,8
Strëngth,aggramar,958,warrior,fury,18,10,8
Basedaf,frostmourne,958,warrior,fury,24,10,14
Venóm,moon-guard,957,warrior,fury,18,10,8
Farklesnarf,tichondrius,957,warrior,fury,18,10,8
Quuavo,tichondrius,957,warrior,fury,18,10,8
Limpninny,dalaran,957,warrior,fury,21,10,11
Modì,sargeras,957,warrior,fury,24,10,14
Harlow,spirestone,955,warrior,fury,24,10,14
Nordrages,stormrage,953,warrior,fury,18,10,8
Ironpanzer,thrall,952,warrior,fury,18,10,8
Maytrixx,stormrage,950,warrior,fury,12,10,2
Jellybomb,sargeras,950,warrior,fury,24,10,14
Shaøkahn,azralon,938,warrior,fury,26,11,15
Hùlksmâsh,zuljin,924,warrior,fury,23,13,10
Ghostlyedge,turalyon,918,warrior,fury,72,25,47
Warkinit,proudmoore,915,warrior,fury,22,10,12
Harkeigh,wyrmrest-accord,909,warrior,fury,17,10,7
Akusenshi,dragonblight,899,warrior,fury,24,11,13
Samdarkblade,kilrogg,898,warrior,fury,33,10,23
Grievouz,nemesis,894,warrior,fury,17,10,7
Copinhodagua,azralon,889,warrior,fury,19,11,8
Maximad,moon-guard,864,warrior,fury,12,9,3
Michaela,moon-guard,864,warrior,fury,12,9,3
Notacop,malygos,864,warrior,fury,12,9,3
Agragar,zuljin,864,warrior,fury,12,9,3
Ggull,tichondrius,864,warrior,fury,18,9,9
Astrëa,quelthalas,864,warrior,fury,18,9,9
Naelynh,quelthalas,864,warrior,fury,18,9,9
Baylîfe,illidan,864,warrior,fury,18,9,9
Elmosmash,thrall,864,warrior,fury,18,9,9
Hìm,tichondrius,864,warrior,fury,24,9,15
Sonyanalogue,frostmourne,864,warrior,fury,24,9,15
Lootacris,illidan,864,warrior,fury,24,9,15
Likelygood,tichondrius,863,warrior,fury,12,9,3
Hoodlark,lightbringer,863,warrior,fury,12,9,3
Okkin,cairne,863,warrior,fury,12,9,3
Neurötic,ragnaros,863,warrior,fury,12,9,3
Squonks,kelthuzad,863,warrior,fury,12,9,3
Zastrow,dalaran,863,warrior,fury,18,9,9
Whitetaure,arthas,863,warrior,fury,18,9,9
Liltom,sargeras,863,warrior,fury,18,9,9
Youjumpijump,frostmourne,863,warrior,fury,24,9,15
Gzilla,queldorei,863,warrior,fury,24,9,15
Wishayzka,drakkari,862,warrior,fury,18,9,9
Nowarriororc,thrall,862,warrior,fury,18,9,9
Rediger,aggramar,861,warrior,fury,34,15,19
Rageraz,trollbane,860,warrior,fury,12,9,3
Asuna,burning-blade,860,warrior,fury,18,9,9
Maddzspin,tichondrius,860,warrior,fury,18,9,9
Groguu,windrunner,859,warrior,fury,18,9,9
Stunninchaos,shattered-hand,859,warrior,fury,24,9,15
Lovehandlez,proudmoore,858,warrior,fury,18,9,9
Rücküs,tichondrius,858,warrior,fury,18,9,9
Goinberserk,tichondrius,854,warrior,fury,22,9,13
Rocketcayton,veknilash,845,warrior,fury,18,9,9
Trufsoturi,bleeding-hollow,845,warrior,fury,23,9,14
Cannan,the-underbog,841,warrior,fury,39,10,29
Kajing,boulderfist,836,warrior,fury,19,10,9
Machâ,illidan,830,warrior,fury,17,9,8
Magdar,daggerspine,813,warrior,fury,28,9,19
Futtmebuck,emerald-dream,810,warrior,fury,18,10,8
Sïxsnacks,stormrage,799,warrior,fury,16,9,7
Bargorengar,skullcrusher,797,warrior,fury,108,48,60
Tyranatusk,malganis,783,warrior,fury,11,9,2
Klim,grizzly-hills,781,warrior,fury,25,9,16
Cüba,nemesis,770,warrior,fury,24,9,15
Ryse,aegwynn,768,warrior,fury,12,8,4
Verigan,barthilas,768,warrior,fury,12,8,4
Bbcapitalist,blackrock,768,warrior,fury,12,8,4
Rimshotts,sargeras,768,warrior,fury,12,8,4
Stimm,blood-furnace,768,warrior,fury,12,8,4
Bamag,dethecus,768,warrior,fury,12,8,4
Bornclueless,illidan,768,warrior,fury,12,8,4
ßdm,illidan,768,warrior,fury,12,8,4
Angryexe,zuljin,768,warrior,fury,12,8,4
Beforever,kiljaeden,768,warrior,fury,12,8,4
Akenox,area-52,768,warrior,fury,12,8,4
Swìll,illidan,768,warrior,fury,12,8,4
Volgarr,zuljin,768,warrior,fury,12,8,4
Sulze,tichondrius,768,warrior,fury,15,9,6
Shimizuken,tichondrius,768,warrior,fury,18,8,10
Cheiftain,dalaran,768,warrior,fury,18,8,10
Oohsht,tichondrius,768,warrior,fury,18,8,10
Asstastic,bonechewer,768,warrior,fury,18,8,10
Icebringer,frostmourne,768,warrior,fury,24,8,16
Cannonballz,sargeras,767,warrior,fury,12,8,4
Dagrone,drakkari,767,warrior,fury,12,8,4
Rodahn,emerald-dream,767,warrior,fury,12,8,4
Moggos,firetree,767,warrior,fury,12,8,4
Hydrolisk,area-52,767,warrior,fury,12,8,4
Gorethrax,tichondrius,767,warrior,fury,18,8,10
Wíldcat,illidan,767,warrior,fury,18,8,10
Mers,garrosh,767,warrior,fury,18,8,10
Ungabunga,frostwolf,767,warrior,fury,18,8,10
Funk,illidan,767,warrior,fury,18,8,10
Zêtt,drakkari,767,warrior,fury,18,8,10
Dtrumpo,moon-guard,767,warrior,fury,18,8,10
Droggo,cenarius,766,warrior,fury,12,8,4
Drumann,hyjal,766,warrior,fury,12,8,4
Theßull,frostmourne,766,warrior,fury,12,8,4
Arågòrn,stormrage,766,warrior,fury,18,8,10
Corbray,frostmourne,766,warrior,fury,24,8,16
Stinkyfuq,area-52,764,warrior,fury,12,8,4
Haelerostus,moon-guard,763,warrior,fury,36,13,23
Trendxx,stormrage,763,warrior,fury,24,8,16
Huri,nemesis,763,warrior,fury,30,8,22
Frettyhooman,blood-furnace,762,warrior,fury,12,8,4
Blackpro,sargeras,762,warrior,fury,12,8,4
Creedz,dreadmaul,761,warrior,fury,18,8,10
Alandris,icecrown,760,warrior,fury,18,10,8
Uhtred,moonrunner,757,warrior,fury,18,8,10
Kessahh,moon-guard,755,warrior,fury,12,8,4
Kilp,thrall,751,warrior,fury,17,8,9
Marleau,bleeding-hollow,742,warrior,fury,21,9,12
Arngrimm,area-52,735,warrior,fury,14,9,5
Azmael,sargeras,735,warrior,fury,17,8,9
Onionlord,wyrmrest-accord,719,warrior,fury,11,8,3
Pigonhae,zuljin,713,warrior,fury,19,10,9
Zaraki,moon-guard,704,warrior,fury,16,8,8
Eleronogoth,draka,704,warrior,fury,16,8,8
Udmwarrior,zuljin,704,warrior,fury,16,8,8
Chippurrz,illidan,685,warrior,fury,11,8,3
Eino,llane,672,warrior,fury,12,7,5
Canduin,queldorei,672,warrior,fury,12,7,5
Ðêed,area-52,672,warrior,fury,12,7,5
Vuraxx,area-52,672,warrior,fury,12,7,5
Funsyze,garona,672,warrior,fury,12,7,5
Unbreakkable,tichondrius,672,warrior,fury,12,7,5
Ladderx,area-52,672,warrior,fury,12,7,5
Krunas,quelthalas,672,warrior,fury,12,7,5
Käggai,khadgar,672,warrior,fury,12,7,5
Doczz,malganis,672,warrior,fury,12,7,5
Ðow,burning-blade,672,warrior,fury,12,7,5
Sypii,malganis,672,warrior,fury,12,7,5
Ruckw,stormrage,672,warrior,fury,12,7,5
Maar,lightbringer,672,warrior,fury,12,7,5
Ðrëäd,area-52,672,warrior,fury,12,7,5
Xårren,stormrage,672,warrior,fury,12,7,5
Dós,emerald-dream,672,warrior,fury,12,7,5
Cryposlice,malganis,672,warrior,fury,18,7,11
Warhand,frostmourne,672,warrior,fury,18,7,11
Mardrex,korgath,672,warrior,fury,18,7,11
Blxckbeard,hyjal,672,warrior,fury,18,7,11
Endlesskilla,destromath,672,warrior,fury,18,7,11
Mullf,stormrage,671,warrior,fury,12,7,5
Zikeno,dalaran,671,warrior,fury,12,7,5
Quintonious,dark-iron,671,warrior,fury,12,7,5
Nokak,borean-tundra,671,warrior,fury,12,7,5
Pelikanesis,arthas,671,warrior,fury,12,7,5
Iorak,queldorei,671,warrior,fury,12,7,5
Mág,burning-legion,671,warrior,fury,12,7,5
Remudan,tichondrius,671,warrior,fury,18,7,11
Xochicotzin,mugthol,671,warrior,fury,18,7,11
Ghurrk,hyjal,671,warrior,fury,18,7,11
Ragnir,kelthuzad,671,warrior,fury,18,7,11
Aggravation,bleeding-hollow,671,warrior,fury,18,7,11
Tiqokz,sargeras,670,warrior,fury,12,7,5
Ganon,garrosh,670,warrior,fury,12,7,5
Melankoma,sargeras,670,warrior,fury,12,7,5
Kræzee,kelthuzad,670,warrior,fury,18,7,11
Djfredsd,tichondrius,670,warrior,fury,18,7,11
Xauce,queldorei,670,warrior,fury,24,7,17
Markodarko,gilneas,669,warrior,fury,12,7,5
Rafaeldantas,azralon,669,warrior,fury,12,7,5
Gamoosh,illidan,669,warrior,fury,20,7,13
Deáthwing,steamwheedle-cartel,669,warrior,fury,24,7,17
Shadowtitanx,korgath,669,warrior,fury,30,7,23
Warbane,barthilas,667,warrior,fury,18,7,11
Siiss,stormrage,665,warrior,fury,21,9,12
Keateane,frostmourne,662,warrior,fury,12,7,5
Studsrus,aegwynn,662,warrior,fury,18,7,11
Crashacorn,stormrage,659,warrior,fury,18,7,11
Jendal,ragnaros,658,warrior,fury,12,7,5
Zambonibob,eonar,657,warrior,fury,12,7,5
Naughtytwat,tichondrius,639,warrior,fury,14,8,6
Zovudo,area-52,638,warrior,fury,14,8,6
Wintz,dreadmaul,638,warrior,fury,14,8,6
Donjuan,skullcrusher,637,warrior,fury,20,8,12
Furryhorv,frostmourne,608,warrior,fury,22,7,15
Vorthax,korgath,607,warrior,fury,14,7,7
Rohkvan,illidan,607,warrior,fury,14,7,7
Noktyn,haomarush,591,warrior,fury,11,7,4
Taiine,moon-guard,576,warrior,fury,6,6,0
Whateverzhan,tichondrius,576,warrior,fury,12,6,6
Azázyel,quelthalas,576,warrior,fury,12,6,6
Snowflakee,jaedenar,576,warrior,fury,12,6,6
Ggludan,area-52,576,warrior,fury,12,6,6
Yükana,quelthalas,576,warrior,fury,12,6,6
Kaivax,tichondrius,576,warrior,fury,12,6,6
Whittyxc,tichondrius,576,warrior,fury,12,6,6
Vinvivenna,emerald-dream,576,warrior,fury,12,6,6
Ðrënch,tichondrius,576,warrior,fury,12,6,6
Dëåth,azgalor,576,warrior,fury,12,6,6
Jcßot,exodar,576,warrior,fury,12,6,6
Ezcharger,kelthuzad,576,warrior,fury,12,6,6
Lurtras,exodar,576,warrior,fury,12,6,6
Gamelagged,area-52,576,warrior,fury,12,6,6
Strongerjaw,tichondrius,576,warrior,fury,12,6,6
Alysson,moon-guard,576,warrior,fury,12,6,6
Prestico,ragnaros,576,warrior,fury,12,6,6
Skoll,illidan,576,warrior,fury,12,6,6
Carnemølida,thrall,576,warrior,fury,12,6,6
Rigil,the-forgotten-coast,576,warrior,fury,12,6,6
Tacrolimus,thrall,576,warrior,fury,12,6,6
Nertharul,zuljin,576,warrior,fury,12,6,6
Progesterone,bleeding-hollow,576,warrior,fury,12,6,6
Benieswar,frostmourne,576,warrior,fury,12,6,6
Zartren,khazgoroth,576,warrior,fury,12,6,6
Disarmed,proudmoore,576,warrior,fury,12,6,6
Endurefen,sargeras,576,warrior,fury,12,6,6
Décapitator,area-52,576,warrior,fury,18,6,12
Xiosè,ragnaros,576,warrior,fury,18,6,12
Digitaldj,frostmourne,576,warrior,fury,18,6,12
Dragnol,quelthalas,575,warrior,fury,6,6,0
Burninated,tichondrius,575,warrior,fury,12,6,6
Elleaux,bloodscalp,575,warrior,fury,12,6,6
Trackhawk,moon-guard,575,warrior,fury,12,6,6
Metalstorms,firetree,575,warrior,fury,12,6,6
Lorelie,malganis,575,warrior,fury,12,6,6
Plidan,shuhalo,575,warrior,fury,12,6,6
Xenyn,malganis,575,warrior,fury,12,6,6
Isitorganic,nesingwary,575,warrior,fury,12,6,6
Luckychaos,bleeding-hollow,575,warrior,fury,12,6,6
Uggtrick,zuljin,575,warrior,fury,12,6,6
Icon,tichondrius,575,warrior,fury,18,6,12
Redblade,bleeding-hollow,575,warrior,fury,18,6,12
Rageroni,tichondrius,574,warrior,fury,12,6,6
Badairplane,gilneas,574,warrior,fury,12,6,6
Axekill,bleeding-hollow,574,warrior,fury,18,6,12
Siegeshatter,moon-guard,574,warrior,fury,24,6,18
Shiddoshi,ragnaros,569,warrior,fury,12,6,6
Alexthar,drakkari,560,warrior,fury,24,6,18
Alaricck,quelthalas,543,warrior,fury,14,7,7
Freakin,ragnaros,543,warrior,fury,16,6,10
Ghonad,windrunner,541,warrior,fury,17,6,11
Thorkéll,proudmoore,541,warrior,fury,23,6,17
Sinbãd,sargeras,527,warrior,fury,11,6,5
Agarto,illidan,526,warrior,fury,11,6,5
Cornmaster,darkspear,522,warrior,fury,18,10,8
Nïckböï,misha,519,warrior,fury,11,6,5
Tryhardr,sargeras,480,warrior,fury,6,5,1
Onyx,auchindoun,480,warrior,fury,6,5,1
Gahenk,chogall,480,warrior,fury,6,5,1
Bearlornan,frostmourne,480,warrior,fury,6,5,1
Yepkorean,tichondrius,480,warrior,fury,6,5,1
Orkussw,illidan,480,warrior,fury,6,5,1
Finnin,nathrezim,480,warrior,fury,6,5,1
Invinciblé,tichondrius,480,warrior,fury,6,5,1
Smorc,stormrage,480,warrior,fury,6,5,1
Äléx,frostmourne,480,warrior,fury,6,5,1
Swingretzky,zuljin,480,warrior,fury,6,5,1
Colonclogger,proudmoore,480,warrior,fury,6,5,1
Perserve,thunderlord,480,warrior,fury,6,5,1
Deseroth,illidan,480,warrior,fury,6,5,1
Ramseyx,dalaran,480,warrior,fury,6,5,1
Tazmanianfur,akama,480,warrior,fury,6,5,1
Korsarro,frostmourne,480,warrior,fury,6,5,1
Falconheart,wyrmrest-accord,480,warrior,fury,6,5,1
Balrog,firetree,480,warrior,fury,6,5,1
Devaya,ragnaros,480,warrior,fury,6,5,1
Goon,frostmourne,480,warrior,fury,6,5,1
Hyperdevil,ragnaros,480,warrior,fury,9,6,3
Victoriaöus,emerald-dream,480,warrior,fury,9,5,4
Nondracio,ragnaros,480,warrior,fury,12,5,7
Pápý,ragnaros,480,warrior,fury,12,5,7
Krovikân,area-52,480,warrior,fury,12,5,7
Maltrate,hyjal,480,warrior,fury,12,5,7
Slamuëladams,bleeding-hollow,480,warrior,fury,12,5,7
Ironsavage,frostmourne,480,warrior,fury,12,5,7
Ðìbs,moon-guard,480,warrior,fury,12,5,7
Riftgar,hyjal,480,warrior,fury,12,5,7
Coalpit,emerald-dream,480,warrior,fury,12,5,7
Nukemdown,darkspear,480,warrior,fury,12,5,7
Andorane,bleeding-hollow,480,warrior,fury,12,5,7
Iwillcrushyo,darkspear,480,warrior,fury,12,5,7
Trekk,azralon,480,warrior,fury,12,5,7
Crøm,tichondrius,480,warrior,fury,12,5,7
Clansy,moon-guard,480,warrior,fury,12,5,7
Wraithvlad,moon-guard,480,warrior,fury,12,5,7
Carnith,arthas,480,warrior,fury,12,5,7
Ghostwalker,akama,480,warrior,fury,12,5,7
Axesomebody,tichondrius,480,warrior,fury,12,5,7
Buhurt,sargeras,480,warrior,fury,12,5,7
Còlòssal,moknathal,480,warrior,fury,12,5,7
Sleazedog,kelthuzad,480,warrior,fury,12,5,7
Himiko,kaelthas,480,warrior,fury,12,5,7
Warkaiser,ragnaros,480,warrior,fury,12,5,7
Marimadelene,aegwynn,480,warrior,fury,12,5,7
Gurukakko,ragnaros,480,warrior,fury,12,5,7
Brutalpløx,illidan,480,warrior,fury,12,5,7
Chainsa,stormrage,480,warrior,fury,12,5,7
Izhansheni,illidan,480,warrior,fury,12,5,7
Conflíct,illidan,480,warrior,fury,12,5,7
Chop,khadgar,480,warrior,fury,12,5,7
Taurenosaur,illidan,480,warrior,fury,12,5,7
Pingolona,nemesis,480,warrior,fury,12,5,7
Cubanßûrst,stormrage,480,warrior,fury,12,5,7
Wangjianguo,illidan,480,warrior,fury,12,5,7
Gadlfuerte,ragnaros,480,warrior,fury,14,5,9
Honorloxo,bleeding-hollow,480,warrior,fury,18,5,13
Spinspin,borean-tundra,480,warrior,fury,18,5,13
Dragonrage,tanaris,480,warrior,fury,18,5,13
Georgedubya,illidan,480,warrior,fury,18,5,13
Tupacsback,stormrage,479,warrior,fury,6,5,1
Vonkinky,sargeras,479,warrior,fury,6,5,1
Zirtag,proudmoore,479,warrior,fury,6,5,1
Olegg,laughing-skull,479,warrior,fury,12,5,7
Ksubîî,frostmourne,479,warrior,fury,12,5,7
Warsero,tichondrius,479,warrior,fury,12,5,7
Ragemarley,dalaran,479,warrior,fury,12,5,7
Rodorn,frostmourne,479,warrior,fury,16,6,10
Supersquish,moon-guard,479,warrior,fury,18,5,13
Arrad,sargeras,479,warrior,fury,18,5,13
Madaroy,stormrage,478,warrior,fury,12,5,7
Welgo,moon-guard,478,warrior,fury,12,5,7
Fabszord,nemesis,476,warrior,fury,12,5,7
Veganwarrior,quelthalas,469,warrior,fury,18,5,13
Rageverd,malganis,432,warrior,fury,9,5,4
Thalloom,thaurissan,432,warrior,fury,15,5,10
Avatarl,ragnaros,432,warrior,fury,15,5,10
Glaros,blood-furnace,431,warrior,fury,11,5,6
Leónard,moon-guard,431,warrior,fury,11,5,6
Sukstofuk,frostmourne,431,warrior,fury,11,5,6
Hugz,thrall,431,warrior,fury,11,5,6
Panterra,azralon,426,warrior,fury,16,7,9
Dolsorae,malganis,426,warrior,fury,16,6,10
Forerunner,tichondrius,416,warrior,fury,10,5,5
Israelelel,azralon,416,warrior,fury,10,5,5
Stompgnomes,malganis,414,warrior,fury,14,5,9
Lucicicia,bronzebeard,384,warrior,fury,6,4,2
Ymirock,area-52,384,warrior,fury,6,4,2
Unpaused,kelthuzad,384,warrior,fury,6,4,2
Sarachnis,area-52,384,warrior,fury,6,4,2
Nikomasked,kelthuzad,384,warrior,fury,6,4,2
Chash,frostmourne,384,warrior,fury,6,4,2
Tylerdurdenx,dalaran,384,warrior,fury,6,4,2
Affeine,malganis,384,warrior,fury,6,4,2
Akaínu,area-52,384,warrior,fury,6,4,2
Hellsinga,stormrage,384,warrior,fury,6,4,2
Cidrick,stormrage,384,warrior,fury,6,4,2
Slashen,sargeras,384,warrior,fury,6,4,2
Drengarusk,area-52,384,warrior,fury,6,4,2
Painedd,stormrage,384,warrior,fury,6,4,2
Qram,illidan,384,warrior,fury,6,4,2
Jàmiè,wyrmrest-accord,384,warrior,fury,6,4,2
Blackbaba,illidan,384,warrior,fury,6,4,2
Tomatogodx,sargeras,384,warrior,fury,6,4,2
Youngmoneyd,illidan,384,warrior,fury,6,4,2
Midweststuna,kul-tiras,384,warrior,fury,6,4,2
Carfal,spirestone,384,warrior,fury,6,4,2
Breké,moon-guard,384,warrior,fury,6,4,2
Brogdar,moon-guard,384,warrior,fury,6,4,2
Darkirondadi,frostmourne,384,warrior,fury,6,4,2
Varkiren,moon-guard,384,warrior,fury,6,4,2
Squishmello,hyjal,384,warrior,fury,6,4,2
Coldlòve,akama,384,warrior,fury,6,4,2
Alerish,quelthalas,384,warrior,fury,6,4,2
Spraten,bonechewer,384,warrior,fury,6,4,2
Chopemupp,area-52,384,warrior,fury,6,4,2
Murghol,malganis,384,warrior,fury,6,4,2
Phandrosa,ragnaros,384,warrior,fury,6,4,2
Techanina,aerie-peak,384,warrior,fury,6,4,2
Inocencius,ragnaros,384,warrior,fury,6,4,2
Wolurog,emerald-dream,384,warrior,fury,6,4,2
Jutank,sargeras,384,warrior,fury,6,4,2
Heyzulnut,whisperwind,384,warrior,fury,6,4,2
Nerjinzul,bloodscalp,384,warrior,fury,6,4,2
Hasbullá,ragnaros,384,warrior,fury,6,4,2
Gtrain,barthilas,384,warrior,fury,6,4,2
Testees,senjin,384,warrior,fury,6,4,2
Samuluo,tichondrius,384,warrior,fury,6,4,2
Ankhxiety,sargeras,384,warrior,fury,6,4,2
Willcharge,tichondrius,384,warrior,fury,6,4,2
Suzushi,tichondrius,384,warrior,fury,6,4,2
Kamidaren,tichondrius,384,warrior,fury,6,4,2
Hewman,aerie-peak,384,warrior,fury,6,4,2
Methodicaly,aerie-peak,384,warrior,fury,6,4,2
Youdumbaut,tichondrius,384,warrior,fury,6,4,2
Braxxinn,tichondrius,384,warrior,fury,6,4,2
Obiwun,azgalor,384,warrior,fury,6,4,2
Negrus,sargeras,384,warrior,fury,11,4,7
Rägnarök,stormrage,384,warrior,fury,12,4,8
Gorm,greymane,384,warrior,fury,12,4,8
Tyrannus,chogall,384,warrior,fury,12,4,8
Krodah,quelthalas,384,warrior,fury,12,4,8
Çampbêll,area-52,384,warrior,fury,12,4,8
Beetcoyne,azuremyst,384,warrior,fury,12,4,8
Muradinpica,stormrage,384,warrior,fury,12,4,8
Bladetko,tichondrius,384,warrior,fury,12,4,8
Zibby,malganis,384,warrior,fury,12,4,8
Agonistes,emerald-dream,384,warrior,fury,12,4,8
Corazondleón,ragnaros,384,warrior,fury,12,4,8
Cýnzz,frostmourne,384,warrior,fury,12,4,8
Skrot,stormrage,384,warrior,fury,12,4,8
Luosifen,tichondrius,384,warrior,fury,12,4,8
Shinshido,tichondrius,384,warrior,fury,12,4,8
Hukzula,illidan,384,warrior,fury,12,4,8
Goremack,hellscream,384,warrior,fury,12,4,8
Metalhaed,thrall,384,warrior,fury,12,4,8
Aislistraee,moon-guard,384,warrior,fury,12,4,8
Potan,thrall,384,warrior,fury,12,4,8
Rezzett,wyrmrest-accord,384,warrior,fury,12,4,8
Chacca,suramar,384,warrior,fury,12,4,8
Eamonvalda,dalaran,384,warrior,fury,12,4,8
Dotlom,wyrmrest-accord,384,warrior,fury,12,4,8
Goatmanee,tichondrius,384,warrior,fury,12,4,8
Lsays,tichondrius,384,warrior,fury,18,4,14
Awell,azralon,383,warrior,fury,6,4,2
Nelissa,runetotem,383,warrior,fury,6,4,2
Villäïness,daggerspine,383,warrior,fury,6,4,2
Hæmomancy,moon-guard,383,warrior,fury,12,4,8
Galadon,amanthul,383,warrior,fury,12,4,8
Rahmholz,bonechewer,383,warrior,fury,12,4,8
Drovik,malygos,383,warrior,fury,12,4,8
Anger,zuljin,383,warrior,fury,24,4,20
Fangerbiter,destromath,382,warrior,fury,6,4,2
Ünö,proudmoore,382,warrior,fury,6,4,2
Solveighelga,drakkari,381,warrior,fury,12,4,8
Bonebreakr,tichondrius,381,warrior,fury,24,4,20
Glennyballs,dalaran,379,warrior,fury,12,4,8
Baxel,arthas,367,warrior,fury,11,4,7
Gotrekson,azralon,351,warrior,fury,11,4,7
Guerreraa,ragnaros,351,warrior,fury,11,4,7
Ghazzghkull,illidan,351,warrior,fury,11,4,7
Darkrevel,dalvengyr,335,warrior,fury,11,4,7
Kíngkaisér,azralon,330,warrior,fury,15,6,9
Huleo,tichondrius,330,warrior,fury,14,5,9
Mataviejitos,ragnaros,329,warrior,fury,16,7,9
Washim,area-52,319,warrior,fury,5,4,1
Rohde,nemesis,319,warrior,fury,8,4,4
Decimateme,tichondrius,288,warrior,fury,6,3,3
Kurowar,drakkari,288,warrior,fury,6,3,3
Hithen,quelthalas,288,warrior,fury,6,3,3
Govosh,thrall,288,warrior,fury,6,3,3
Instakill,garrosh,288,warrior,fury,6,3,3
Kreamyumyums,tichondrius,288,warrior,fury,6,3,3
Vodak,daggerspine,288,warrior,fury,6,3,3
Swiftÿ,gurubashi,288,warrior,fury,6,3,3
Pancárcho,quelthalas,288,warrior,fury,6,3,3
Demøletiøn,stormrage,288,warrior,fury,6,3,3
Connero,stormrage,288,warrior,fury,6,3,3
Aeros,winterhoof,288,warrior,fury,6,3,3
Kàli,kiljaeden,288,warrior,fury,6,3,3
Áres,spinebreaker,288,warrior,fury,6,3,3
Kimed,nordrassil,288,warrior,fury,6,3,3
Corgii,khaz-modan,288,warrior,fury,6,3,3
Slãmpiece,stormrage,288,warrior,fury,6,3,3
Malystik,ragnaros,288,warrior,fury,6,3,3
Lightswords,stormrage,288,warrior,fury,6,3,3
Corvesio,wyrmrest-accord,288,warrior,fury,6,3,3
Nginx,queldorei,288,warrior,fury,6,3,3
Maarilayne,wyrmrest-accord,288,warrior,fury,6,3,3
Riggs,stonemaul,288,warrior,fury,6,3,3
Resize,wyrmrest-accord,288,warrior,fury,6,3,3
Bhutjolokia,ragnaros,288,warrior,fury,6,3,3
Kåyotix,proudmoore,288,warrior,fury,6,3,3
Smeshyou,kelthuzad,288,warrior,fury,6,3,3
Yagluth,illidan,288,warrior,fury,6,3,3
Arthurston,tichondrius,288,warrior,fury,6,3,3
Zerrekarr,wyrmrest-accord,288,warrior,fury,6,3,3
Kujø,wyrmrest-accord,288,warrior,fury,6,3,3
Archibaldo,darkspear,288,warrior,fury,6,3,3
Madblackcat,illidan,288,warrior,fury,6,3,3
Greenugly,tichondrius,288,warrior,fury,6,3,3
Pongk,tichondrius,288,warrior,fury,6,3,3
Sixtydolla,kelthuzad,288,warrior,fury,6,3,3
Illmindofpoo,kelthuzad,288,warrior,fury,6,3,3
Wårrior,kelthuzad,288,warrior,fury,6,3,3
Jethrix,kelthuzad,288,warrior,fury,6,3,3
Painfulsin,tichondrius,288,warrior,fury,6,3,3
Oprampage,illidan,288,warrior,fury,6,3,3
Ruffless,skullcrusher,288,warrior,fury,6,3,3
Lechee,silvermoon,288,warrior,fury,6,3,3
Vengxdor,stormrage,288,warrior,fury,6,3,3
Lindsanv,illidan,288,warrior,fury,6,3,3
Kénblock,tichondrius,288,warrior,fury,6,3,3
Rowdyanders,area-52,288,warrior,fury,6,3,3
Morasar,area-52,288,warrior,fury,6,3,3
Xragnar,area-52,288,warrior,fury,6,3,3
Guillotinè,area-52,288,warrior,fury,6,3,3
Gros,exodar,288,warrior,fury,6,3,3
Seymourbot,illidan,288,warrior,fury,6,3,3
Fartden,tichondrius,288,warrior,fury,6,3,3
Rí,moon-guard,288,warrior,fury,6,3,3
Executie,duskwood,288,warrior,fury,6,3,3
Mcdowëll,moon-guard,288,warrior,fury,6,3,3
Colössal,moon-guard,288,warrior,fury,6,3,3
Riechst,quelthalas,288,warrior,fury,6,3,3
Wargasms,alterac-mountains,288,warrior,fury,6,3,3
Aùstin,moon-guard,288,warrior,fury,6,3,3
Tâlos,magtheridon,288,warrior,fury,6,3,3
Zangre,stormrage,288,warrior,fury,6,3,3
Ironbark,elune,288,warrior,fury,6,3,3
Barbarìan,bleeding-hollow,288,warrior,fury,6,3,3
Uncritable,dalaran,288,warrior,fury,6,3,3
Vongrave,moonrunner,288,warrior,fury,6,3,3
Gryl,stormrage,288,warrior,fury,6,3,3
Kahn,andorhal,288,warrior,fury,6,3,3
Scran,sargeras,288,warrior,fury,6,3,3
Akarì,emerald-dream,288,warrior,fury,6,3,3
Razzik,emerald-dream,288,warrior,fury,6,3,3
Santhvel,jubeithos,288,warrior,fury,6,3,3
Carborr,frostmourne,288,warrior,fury,6,3,3
Glexecute,sargeras,288,warrior,fury,6,3,3
Beârz,the-underbog,288,warrior,fury,6,3,3
Wwesheamus,frostmourne,288,warrior,fury,6,3,3
Daddyd,sargeras,288,warrior,fury,6,3,3
Taywar,sargeras,288,warrior,fury,6,3,3
Wescer,frostmourne,288,warrior,fury,6,3,3
Bothar,sargeras,288,warrior,fury,6,3,3
Makeranbing,barthilas,288,warrior,fury,6,3,3
Herkja,barthilas,288,warrior,fury,6,3,3
Orcveinz,tichondrius,288,warrior,fury,11,5,6
Tríxman,moon-guard,288,warrior,fury,12,3,9
Pastorpeen,thrall,288,warrior,fury,12,3,9
Flexìn,tichondrius,288,warrior,fury,12,3,9
Krimmjðw,sargeras,288,warrior,fury,12,3,9
Barcëlð,frostmourne,288,warrior,fury,12,3,9
Warseed,ragnaros,288,warrior,fury,12,3,9
Goaco,drakkari,288,warrior,fury,12,3,9
Rólex,tichondrius,288,warrior,fury,12,3,9
Kromgrall,tichondrius,288,warrior,fury,12,3,9
Zelekron,emerald-dream,288,warrior,fury,12,3,9
Kimuraa,hyjal,288,warrior,fury,12,3,9
Apolio,magtheridon,288,warrior,fury,12,3,9
Blackscale,grizzly-hills,288,warrior,fury,12,3,9
Leonz,undermine,288,warrior,fury,12,3,9
Ratface,frostmourne,288,warrior,fury,12,3,9
Kuragdem,trollbane,288,warrior,fury,12,3,9
Banggo,frostmourne,288,warrior,fury,12,3,9
Lodog,proudmoore,288,warrior,fury,12,3,9
Eadsmasher,jubeithos,287,warrior,fury,6,3,3
Lourdadmiwal,aegwynn,287,warrior,fury,6,3,3
Disclone,tichondrius,287,warrior,fury,6,3,3
Deltong,bonechewer,287,warrior,fury,6,3,3
Monsterpepe,tichondrius,287,warrior,fury,12,3,9
Boothtowolf,the-forgotten-coast,286,warrior,fury,6,3,3
Bigdaddyzees,bleeding-hollow,255,warrior,fury,11,3,8
Offthecharts,mannoroth,254,warrior,fury,11,3,8
Kitiará,area-52,240,warrior,fury,9,4,5
Chupelo,tichondrius,239,warrior,fury,5,3,2
Moelolita,illidan,239,warrior,fury,5,3,2
Shapur,tichondrius,239,warrior,fury,5,3,2
Reagzy,stormrage,234,warrior,fury,10,4,6
Schlosh,laughing-skull,223,warrior,fury,8,3,5
Heirel,kelthuzad,208,warrior,fury,7,3,4
Çórý,area-52,192,warrior,fury,4,3,1
Sabers,mannoroth,192,warrior,fury,6,2,4
Hughmungús,frostmourne,192,warrior,fury,6,2,4
ßoris,grizzly-hills,192,warrior,fury,6,2,4
Shandrar,frostmourne,192,warrior,fury,6,2,4
Snugglebuggs,stormrage,192,warrior,fury,6,2,4
Bachyr,stormrage,192,warrior,fury,6,2,4
Azrailz,stormrage,192,warrior,fury,6,2,4
Halò,thrall,192,warrior,fury,6,2,4
Yadiig,illidan,192,warrior,fury,6,2,4
Mordoo,zuljin,192,warrior,fury,6,2,4
Cartmain,illidan,192,warrior,fury,6,2,4
Outo,stormrage,192,warrior,fury,6,2,4
Draxxarlol,zuljin,192,warrior,fury,6,2,4
Gangelx,illidan,192,warrior,fury,6,2,4
Boombop,zuljin,192,warrior,fury,6,2,4
Beatmeat,frostmourne,192,warrior,fury,6,2,4
Jägernaught,stormrage,192,warrior,fury,6,2,4
Bonafidesimp,stormrage,192,warrior,fury,6,2,4
Rundai,zuljin,192,warrior,fury,6,2,4
Therealflex,zuljin,192,warrior,fury,6,2,4
Veyronn,stormrage,192,warrior,fury,6,2,4
Drugdilla,zuljin,192,warrior,fury,6,2,4
Munanio,stormrage,192,warrior,fury,6,2,4
Saltyareolas,destromath,192,warrior,fury,6,2,4
Itzyourmom,nazjatar,192,warrior,fury,6,2,4
Warmul,bleeding-hollow,192,warrior,fury,6,2,4
Iapologiz,illidan,192,warrior,fury,6,2,4
Blademaw,stormreaver,192,warrior,fury,6,2,4
Melithiae,barthilas,192,warrior,fury,6,2,4
Ragetide,illidan,192,warrior,fury,6,2,4
Aboveaverage,arthas,192,warrior,fury,6,2,4
Painstake,illidan,192,warrior,fury,6,2,4
Gakatarc,thrall,192,warrior,fury,6,2,4
Yeèzy,stormrage,192,warrior,fury,6,2,4
Joog,kalecgos,192,warrior,fury,6,2,4
Aisinbro,illidan,192,warrior,fury,6,2,4
Hadowar,thrall,192,warrior,fury,6,2,4
Faywarsong,area-52,192,warrior,fury,6,2,4
Tappyz,area-52,192,warrior,fury,6,2,4
Sveenn,area-52,192,warrior,fury,6,2,4
Reäl,dalaran,192,warrior,fury,6,2,4
Cellyndia,area-52,192,warrior,fury,6,2,4
Assamith,nemesis,192,warrior,fury,6,2,4
Ballinx,illidan,192,warrior,fury,6,2,4
Tarkvs,ragnaros,192,warrior,fury,6,2,4
Kokixz,tichondrius,192,warrior,fury,6,2,4
Rageroidz,area-52,192,warrior,fury,6,2,4
Clerond,tichondrius,192,warrior,fury,6,2,4
Fooko,lethon,192,warrior,fury,6,2,4
Zdokk,sargeras,192,warrior,fury,6,2,4
Good,garona,192,warrior,fury,6,2,4
Druckerz,lightnings-blade,192,warrior,fury,6,2,4
Tacomeat,malorne,192,warrior,fury,6,2,4
Tigas,icecrown,192,warrior,fury,6,2,4
Smasher,garona,192,warrior,fury,6,2,4
Koppo,kelthuzad,192,warrior,fury,6,2,4
Kachigas,sargeras,192,warrior,fury,6,2,4
Zareos,azralon,192,warrior,fury,6,2,4
Ultraa,lightbringer,192,warrior,fury,6,2,4
Mfgodofwar,kelthuzad,192,warrior,fury,6,2,4
Twilightzza,sargeras,192,warrior,fury,6,2,4
Tortag,malganis,192,warrior,fury,6,2,4
Xorjak,tichondrius,192,warrior,fury,6,2,4
Maintarget,malganis,192,warrior,fury,6,2,4
Matahorda,darkspear,192,warrior,fury,6,2,4
Filamon,dentarg,192,warrior,fury,6,2,4
Noor,tichondrius,192,warrior,fury,6,2,4
Kaniks,dalaran,192,warrior,fury,6,2,4
Nebraskapete,wyrmrest-accord,192,warrior,fury,6,2,4
Elchacál,ragnaros,192,warrior,fury,6,2,4
Amberlym,ragnaros,192,warrior,fury,6,2,4
Horahloux,ragnaros,192,warrior,fury,6,2,4
Wqnmlgbd,tichondrius,192,warrior,fury,6,2,4
Slamspam,the-underbog,192,warrior,fury,6,2,4
Ghostkin,ragnaros,192,warrior,fury,6,2,4
Containerbox,korgath,192,warrior,fury,6,2,4
Erikx,ragnaros,192,warrior,fury,6,2,4
Lox,blades-edge,192,warrior,fury,6,2,4
Koast,aerie-peak,192,warrior,fury,6,2,4
Shrexecute,tichondrius,192,warrior,fury,6,2,4
Bobisyourmom,tichondrius,192,warrior,fury,6,2,4
Lokiullr,tichondrius,192,warrior,fury,6,2,4
Gromkhor,tichondrius,192,warrior,fury,6,2,4
Saltyniples,aegwynn,192,warrior,fury,6,2,4
Impaling,moon-guard,192,warrior,fury,6,2,4
Deafwarrior,sargeras,192,warrior,fury,6,2,4
Illicitiri,sargeras,192,warrior,fury,6,2,4
Peekyblinder,kiljaeden,192,warrior,fury,6,2,4
Stugwar,moon-guard,192,warrior,fury,6,2,4
Wariorwang,tichondrius,192,warrior,fury,6,2,4
Skollyd,tichondrius,192,warrior,fury,6,2,4
Estrozo,sargeras,192,warrior,fury,6,2,4
Jäëgër,moon-guard,192,warrior,fury,6,2,4
Daymancometh,proudmoore,192,warrior,fury,6,2,4
Sîn,sargeras,192,warrior,fury,6,2,4
Tempusbane,proudmoore,192,warrior,fury,6,2,4
Xenogears,boulderfist,192,warrior,fury,6,2,4
Neifle,tichondrius,192,warrior,fury,6,2,4
Xanåtos,moon-guard,192,warrior,fury,6,2,4
Gromtalin,sargeras,192,warrior,fury,6,2,4
Linios,tichondrius,192,warrior,fury,6,2,4
Mortaldznuts,tichondrius,192,warrior,fury,6,2,4
Eîghtysîx,sargeras,192,warrior,fury,6,2,4
Bighamm,tichondrius,192,warrior,fury,6,2,4
Ëdwärd,moon-guard,192,warrior,fury,6,2,4
Bonesheild,ursin,192,warrior,fury,11,2,9
Thiccsauce,wyrmrest-accord,192,warrior,fury,12,2,10
Norru,moon-guard,192,warrior,fury,12,2,10
Queterompo,ragnaros,192,warrior,fury,12,2,10
Doappy,darkspear,192,warrior,fury,12,2,10
Naabii,moon-guard,191,warrior,fury,6,2,4
Werrewolf,kul-tiras,191,warrior,fury,6,2,4
Wayne,kargath,160,warrior,fury,16,2,14
Crankyhorn,stormrage,159,warrior,fury,5,2,3
Chiffonade,kelthuzad,144,warrior,fury,5,3,2
Tankieone,aggramar,138,warrior,fury,17,3,14
Rhohan,ysera,128,warrior,fury,4,2,2
Bootskrapp,azgalor,112,warrior,fury,7,2,5
Bradockqt,azralon,96,warrior,fury,3,2,1
Dokoba,bleeding-hollow,96,warrior,fury,6,1,5
Lawlstørm,stormrage,96,warrior,fury,6,1,5
Warriorlee,jubeithos,96,warrior,fury,6,1,5
Xiaohuzi,tichondrius,96,warrior,fury,6,1,5
Trollchopo,kiljaeden,96,warrior,fury,6,1,5
Bbyè,tichondrius,96,warrior,fury,6,1,5
Gristly,sargeras,96,warrior,fury,6,1,5
Tamagoshi,kiljaeden,96,warrior,fury,6,1,5
Murrdock,nesingwary,96,warrior,fury,6,1,5
Flywar,nesingwary,96,warrior,fury,6,1,5
Andro,arthas,96,warrior,fury,6,1,5
Aftershóck,daggerspine,96,warrior,fury,6,1,5
Nerdturd,mannoroth,96,warrior,fury,6,1,5
Grândmâ,zuljin,96,warrior,fury,6,1,5
Kaikah,aegwynn,96,warrior,fury,6,1,5
Warritha,ragnaros,96,warrior,fury,6,1,5
Kevinersaa,frostmourne,96,warrior,fury,6,1,5
Broxar,area-52,96,warrior,fury,6,1,5
Rexxous,hyjal,96,warrior,fury,6,1,5
Genesisxp,barthilas,96,warrior,fury,6,1,5
Xehm,tichondrius,96,warrior,fury,6,1,5
Flabergaster,skullcrusher,96,warrior,fury,6,1,5
Dabdaddyy,dawnbringer,96,warrior,fury,6,1,5
Aiforix,gorefiend,96,warrior,fury,6,1,5
Bigk,korgath,96,warrior,fury,6,1,5
Orsex,ragnaros,96,warrior,fury,6,1,5
Gymnopolar,barthilas,96,warrior,fury,6,1,5
Srze,azralon,96,warrior,fury,6,1,5
Carnagè,area-52,96,warrior,fury,6,1,5
Polox,ragnaros,96,warrior,fury,6,1,5
Neotico,quelthalas,96,warrior,fury,6,1,5
Draann,kirin-tor,96,warrior,fury,6,1,5
Choppin,sargeras,96,warrior,fury,6,1,5
Ustadbaba,area-52,96,warrior,fury,6,1,5
Trén,hydraxis,96,warrior,fury,6,1,5
Freanor,azralon,96,warrior,fury,6,1,5
Horabad,terenas,96,warrior,fury,6,1,5
Lifaen,zangarmarsh,96,warrior,fury,6,1,5
Magarrior,shadowsong,96,warrior,fury,6,1,5
Smashkuntz,lightnings-blade,96,warrior,fury,6,1,5
Warrbull,spirestone,96,warrior,fury,6,1,5
Bumrushed,tichondrius,96,warrior,fury,6,1,5
Aladarith,moon-guard,96,warrior,fury,6,1,5
Girthyslaps,frostmourne,96,warrior,fury,6,1,5
Spartacam,frostmourne,96,warrior,fury,6,1,5
Vvengencezz,the-underbog,96,warrior,fury,6,1,5
Augutra,moon-guard,96,warrior,fury,6,1,5
Largegayman,sargeras,96,warrior,fury,6,1,5
Nasrôth,korialstrasz,96,warrior,fury,6,1,5
Kreigër,area-52,96,warrior,fury,6,1,5
Osselan,moon-guard,96,warrior,fury,6,1,5
Iceice,dalaran,96,warrior,fury,6,1,5
ßallinjr,illidan,96,warrior,fury,6,1,5
Arkayla,moon-guard,96,warrior,fury,6,1,5
Pcprincipal,khadgar,96,warrior,fury,6,1,5
Jujuassgeter,darkspear,96,warrior,fury,12,1,11
Zaxari,gurubashi,96,warrior,fury,12,1,11
Shhiraq,zuljin,96,warrior,fury,12,1,11
Gigglamesh,muradin,64,warrior,fury,4,1,3
Cremosö,azralon,64,warrior,fury,4,1,3
Coverage,frostmourne,63,warrior,fury,2,2,0
Mchamstring,stormrage,63,warrior,fury,3,2,1
Kirikash,illidan,42,warrior,fury,6,2,4
Ztg,tichondrius,42,warrior,fury,11,2,9
Vioar,hyjal,31,warrior,fury,2,1,1
Thiccbiscuit,area-52,2168,warrior,arms,133,67,66
Zhanwudix,tichondrius,2162,warrior,arms,111,62,49
Killbørn,azralon,2156,warrior,arms,90,47,43
Río,area-52,2156,warrior,arms,130,67,63
Turtleboy,feathermoon,2141,warrior,arms,79,45,34
Todory,moon-guard,2137,warrior,arms,155,78,77
Ðêed,area-52,2133,warrior,arms,81,46,35
Dpoy,tichondrius,2128,warrior,arms,108,54,54
Kraftyx,bleeding-hollow,2125,warrior,arms,72,44,28
Huzha,tichondrius,2114,warrior,arms,117,64,53
Warried,sargeras,2113,warrior,arms,66,37,29
Tyranitar,proudmoore,2113,warrior,arms,90,50,40
Strife,sargeras,2112,warrior,arms,56,32,24
Buckwar,zuljin,2110,warrior,arms,72,39,33
Vituu,sargeras,2104,warrior,arms,104,54,50
Edgarllama,sargeras,2103,warrior,arms,87,48,39
ßallinjr,illidan,2103,warrior,arms,90,46,44
Récksus,tichondrius,2101,warrior,arms,74,43,31
Nikomasked,kelthuzad,2100,warrior,arms,66,37,29
Schonkopf,moon-guard,2100,warrior,arms,90,46,44
Vø,agamaggan,2097,warrior,arms,141,73,68
Islonely,tichondrius,2090,warrior,arms,96,47,49
Killborn,tichondrius,2049,warrior,arms,103,50,53
Leans,sargeras,2048,warrior,arms,143,78,65
Grantlol,illidan,2033,warrior,arms,66,40,26
Orclog,illidan,2033,warrior,arms,72,37,35
Perfs,bleeding-hollow,2031,warrior,arms,90,48,42
Exzistance,area-52,2026,warrior,arms,71,40,31
Ssamök,ragnaros,2026,warrior,arms,281,141,140
Gyracide,area-52,2016,warrior,arms,101,49,52
Recksus,tichondrius,2011,warrior,arms,66,44,22
Kimchikick,tichondrius,2004,warrior,arms,150,80,70
Foxxfighter,thrall,2000,warrior,arms,77,40,37
Cloudxxy,kiljaeden,1988,warrior,arms,69,38,31
Sziw,tichondrius,1983,warrior,arms,168,91,77
Exespamtwo,area-52,1980,warrior,arms,180,97,83
Ironbad,sargeras,1975,warrior,arms,94,50,44
Lyrics,tichondrius,1969,warrior,arms,62,32,30
Icarryrats,tichondrius,1967,warrior,arms,81,39,42
Bighamm,tichondrius,1965,warrior,arms,71,40,31
Mítos,quelthalas,1965,warrior,arms,186,97,89
Massacretko,area-52,1962,warrior,arms,88,50,38
Zankets,area-52,1955,warrior,arms,132,67,65
Foraken,dragonmaw,1948,warrior,arms,59,36,23
Belàriá,tichondrius,1948,warrior,arms,66,36,30
Exëqt,nemesis,1946,warrior,arms,96,51,45
Icanfixher,moon-guard,1944,warrior,arms,308,155,153
Ikkyuo,proudmoore,1944,warrior,arms,66,32,34
Yermalx,tichondrius,1941,warrior,arms,54,30,24
Nuqipq,tichondrius,1936,warrior,arms,48,27,21
Barrbarossa,stormrage,1932,warrior,arms,139,73,66
Hapigirl,tichondrius,1929,warrior,arms,42,30,12
Executeqt,azralon,1928,warrior,arms,143,81,62
Kalpok,tichondrius,1928,warrior,arms,58,30,28
Ricorecklezz,korgath,1925,warrior,arms,66,32,34
Gormag,sargeras,1917,warrior,arms,54,32,22
Smorc,stormrage,1917,warrior,arms,60,31,29
Bigbait,hyjal,1912,warrior,arms,72,36,36
Szw,tichondrius,1909,warrior,arms,131,82,49
Cosmicsteel,tichondrius,1908,warrior,arms,88,51,37
Solastro,malganis,1906,warrior,arms,74,35,39
Destrey,emerald-dream,1905,warrior,arms,71,41,30
Yermalt,tichondrius,1905,warrior,arms,80,41,39
Ælilblessedñ,azralon,1904,warrior,arms,148,76,72
Madblackcat,illidan,1902,warrior,arms,58,34,24
Marfas,hyjal,1901,warrior,arms,147,80,67
Og,shattered-hand,1900,warrior,arms,41,25,16
Ignid,tichondrius,1900,warrior,arms,72,32,40
Eqztw,tichondrius,1897,warrior,arms,83,58,25
Paoxiaolol,tichondrius,1890,warrior,arms,73,47,26
Bhaldur,sargeras,1889,warrior,arms,86,49,37
Azaks,drakkari,1889,warrior,arms,48,27,21
Joshiguy,area-52,1889,warrior,arms,78,36,42
Etchiasoko,gurubashi,1888,warrior,arms,42,30,12
Pezy,frostmourne,1887,warrior,arms,114,57,57
Bacchanal,illidan,1884,warrior,arms,78,37,41
Comehnrfce,illidan,1882,warrior,arms,92,43,49
Masumura,kaelthas,1877,warrior,arms,62,31,31
Tryhardr,sargeras,1875,warrior,arms,119,65,54
Dishonorkill,dentarg,1873,warrior,arms,37,25,12
Trezturbo,tichondrius,1871,warrior,arms,105,56,49
Veilsidewar,kelthuzad,1870,warrior,arms,206,113,93
Huugg,skullcrusher,1869,warrior,arms,81,43,38
Cammerz,area-52,1864,warrior,arms,72,36,36
Salgadoryan,stormrage,1864,warrior,arms,166,79,87
Dawx,thrall,1862,warrior,arms,65,32,33
Jadeemerald,kelthuzad,1856,warrior,arms,60,34,26
Betterthanu,azralon,1856,warrior,arms,168,87,81
Spìke,thrall,1856,warrior,arms,149,75,74
Pooshshi,illidan,1855,warrior,arms,60,29,31
Falindrah,moon-guard,1854,warrior,arms,66,32,34
Archosaurs,illidan,1854,warrior,arms,48,23,25
Evnine,illidan,1853,warrior,arms,39,29,10
Rafheeki,tichondrius,1853,warrior,arms,90,49,41
Ksharer,tichondrius,1853,warrior,arms,65,31,34
Boblennon,tichondrius,1852,warrior,arms,60,25,35
Zacharyx,tichondrius,1851,warrior,arms,179,88,91
Ruzoc,frostmourne,1851,warrior,arms,112,50,62
Demetor,skywall,1850,warrior,arms,53,27,26
Xîonorc,ragnaros,1850,warrior,arms,150,76,74
Icon,tichondrius,1846,warrior,arms,46,35,11
Blozar,illidan,1846,warrior,arms,60,30,30
Blackpînk,tichondrius,1845,warrior,arms,54,32,22
Pdbq,tichondrius,1845,warrior,arms,48,28,20
Rageroidz,area-52,1845,warrior,arms,54,29,25
Randydanger,illidan,1845,warrior,arms,66,32,34
Battousai,kiljaeden,1844,warrior,arms,54,27,27
Sukonamí,draka,1842,warrior,arms,60,33,27
Krunnknator,azralon,1840,warrior,arms,41,26,15
Kigame,tichondrius,1840,warrior,arms,96,53,43
Narwhål,tichondrius,1840,warrior,arms,90,44,46
Warney,tichondrius,1838,warrior,arms,53,31,22
Uzza,stormrage,1838,warrior,arms,60,34,26
Draus,nemesis,1838,warrior,arms,119,67,52
Bahlahkay,proudmoore,1838,warrior,arms,42,22,20
Kylewalker,tichondrius,1838,warrior,arms,71,32,39
Kydrav,khadgar,1837,warrior,arms,46,25,21
Adaana,kargath,1836,warrior,arms,119,70,49
Vatix,sargeras,1836,warrior,arms,50,28,22
Ânticide,darkspear,1836,warrior,arms,72,37,35
Bigdude,frostwolf,1835,warrior,arms,54,36,18
Croc,frostmourne,1834,warrior,arms,32,21,11
Fleegugeegu,malganis,1834,warrior,arms,90,45,45
Nilah,tichondrius,1833,warrior,arms,41,24,17
Bùbbájr,emerald-dream,1833,warrior,arms,54,29,25
Yossarrion,frostwolf,1833,warrior,arms,48,25,23
Arthurjlol,tichondrius,1833,warrior,arms,54,24,30
Brilliance,suramar,1832,warrior,arms,60,30,30
Hildemir,tichondrius,1831,warrior,arms,88,52,36
Darrowshire,moon-guard,1831,warrior,arms,41,23,18
Frëdsmite,kelthuzad,1831,warrior,arms,144,77,67
Xiaoheihei,tichondrius,1831,warrior,arms,150,77,73
Granzelion,tichondrius,1829,warrior,arms,96,46,50
Damage,malganis,1829,warrior,arms,48,23,25
Cushman,tichondrius,1828,warrior,arms,96,57,39
Ruinenlust,zuljin,1828,warrior,arms,60,28,32
Elpappa,tichondrius,1827,warrior,arms,48,42,6
Sanquelme,ragnaros,1827,warrior,arms,63,32,31
Jonathann,suramar,1827,warrior,arms,132,65,67
Samuluo,tichondrius,1827,warrior,arms,66,30,36
Blaíze,ragnaros,1826,warrior,arms,44,24,20
Grayview,sargeras,1826,warrior,arms,77,41,36
Seblleddo,drakkari,1826,warrior,arms,66,34,32
Rebied,ragnaros,1826,warrior,arms,90,40,50
Warriorbloo,sargeras,1825,warrior,arms,72,39,33
Lebanesemvp,tichondrius,1825,warrior,arms,85,45,40
Sandycrack,blackrock,1825,warrior,arms,60,30,30
Coby,wildhammer,1823,warrior,arms,65,36,29
Bigdaddyxo,whisperwind,1823,warrior,arms,47,24,23
Cyster,proudmoore,1822,warrior,arms,42,24,18
Kiggs,tichondrius,1822,warrior,arms,48,27,21
Soultarius,area-52,1822,warrior,arms,69,36,33
Kurï,duskwood,1822,warrior,arms,51,24,27
Pkkcrisis,archimonde,1822,warrior,arms,60,28,32
Soloqandy,moon-guard,1821,warrior,arms,60,29,31
Kamoo,bonechewer,1820,warrior,arms,48,27,21
Meccsecute,tichondrius,1820,warrior,arms,102,54,48
Anautumnday,tichondrius,1820,warrior,arms,48,24,24
Aggnilia,proudmoore,1820,warrior,arms,102,50,52
Honock,ragnaros,1820,warrior,arms,72,34,38
Yeawen,tichondrius,1818,warrior,arms,42,23,19
Beanbags,zangarmarsh,1818,warrior,arms,66,34,32
Nozmok,proudmoore,1818,warrior,arms,65,33,32
Arivok,hyjal,1818,warrior,arms,89,43,46
Thugdorr,sargeras,1818,warrior,arms,70,33,37
Shadowstingg,tichondrius,1817,warrior,arms,65,30,35
Missrend,hyjal,1816,warrior,arms,114,57,57
Berzek,area-52,1816,warrior,arms,59,23,36
Leoneceo,azralon,1815,warrior,arms,84,51,33
Destram,kelthuzad,1815,warrior,arms,107,57,50
Anti,nerzhul,1814,warrior,arms,57,30,27
Dissector,ragnaros,1814,warrior,arms,54,28,26
Zapatín,quelthalas,1814,warrior,arms,67,32,35
Mäddôx,tichondrius,1814,warrior,arms,126,60,66
Slaten,barthilas,1813,warrior,arms,107,57,50
Ðìbs,moon-guard,1813,warrior,arms,59,31,28
Onebraincell,stormrage,1811,warrior,arms,48,34,14
Orçaos,ragnaros,1811,warrior,arms,120,69,51
Glocç,sargeras,1811,warrior,arms,112,59,53
Knuklez,tichondrius,1811,warrior,arms,64,33,31
Dangerousd,kiljaeden,1811,warrior,arms,60,30,30
Kaimedran,moon-guard,1810,warrior,arms,48,30,18
Kriloth,frostmourne,1810,warrior,arms,50,30,20
Bussupshut,kelthuzad,1810,warrior,arms,64,32,32
Ürürææae,sargeras,1810,warrior,arms,189,94,95
Melifehorde,tichondrius,1809,warrior,arms,42,25,17
Møcat,illidan,1809,warrior,arms,90,52,38
Gryffith,bleeding-hollow,1809,warrior,arms,81,36,45
Ciz,emerald-dream,1808,warrior,arms,64,34,30
Spartus,kelthuzad,1808,warrior,arms,78,32,46
Crøm,tichondrius,1807,warrior,arms,48,29,19
Tutifrutiø,azralon,1807,warrior,arms,102,48,54
Darkduet,tichondrius,1806,warrior,arms,64,30,34
Sickwidit,kiljaeden,1805,warrior,arms,49,28,21
Noblewinter,sargeras,1805,warrior,arms,36,19,17
Menethíl,tichondrius,1805,warrior,arms,52,27,25
Wootzu,zuljin,1805,warrior,arms,54,27,27
Tankypandazd,stormrage,1805,warrior,arms,174,81,93
Mildlol,tichondrius,1804,warrior,arms,42,25,17
Peinx,ragnaros,1804,warrior,arms,59,31,28
Blackpinkx,tichondrius,1804,warrior,arms,42,19,23
Vascoes,alleria,1803,warrior,arms,168,92,76
Chakø,tichondrius,1803,warrior,arms,66,36,30
Ariést,bleeding-hollow,1803,warrior,arms,42,20,22
Cgelangdula,tichondrius,1802,warrior,arms,54,28,26
Marsshine,tichondrius,1802,warrior,arms,42,19,23
Matesan,jubeithos,1801,warrior,arms,48,28,20
Hìm,tichondrius,1801,warrior,arms,54,28,26
Undefied,moon-guard,1800,warrior,arms,45,27,18
Strongbaby,tichondrius,1800,warrior,arms,42,23,19
Zira,thrall,1800,warrior,arms,115,59,56
Këther,tichondrius,1800,warrior,arms,66,33,33
Kustybuckets,korgath,1798,warrior,arms,46,27,19
Hèphæstús,sargeras,1792,warrior,arms,84,48,36
Sponsored,argent-dawn,1792,warrior,arms,59,26,33
Huuzha,tichondrius,1791,warrior,arms,53,28,25
Debbie,bleeding-hollow,1790,warrior,arms,60,31,29
Bigglyjoobs,tichondrius,1787,warrior,arms,78,38,40
Relerocker,area-52,1786,warrior,arms,77,43,34
Wulouzhan,tichondrius,1785,warrior,arms,83,49,34
Hbrandy,tichondrius,1784,warrior,arms,47,26,21
Vâlôr,tichondrius,1782,warrior,arms,39,26,13
Thlam,muradin,1782,warrior,arms,107,58,49
Ígnatius,malganis,1781,warrior,arms,48,31,17
Samwolok,tichondrius,1780,warrior,arms,36,19,17
Mecc,tichondrius,1780,warrior,arms,48,23,25
Zindawg,frostmourne,1778,warrior,arms,186,89,97
Nanchobo,tichondrius,1778,warrior,arms,66,28,38
Hoboedd,area-52,1776,warrior,arms,40,22,18
Dogmar,staghelm,1776,warrior,arms,92,46,46
Wolfsbanne,khadgar,1775,warrior,arms,114,67,47
Okita,bleeding-hollow,1775,warrior,arms,88,45,43
Picarus,thunderhorn,1772,warrior,arms,60,32,28
Sharer,tichondrius,1772,warrior,arms,36,19,17
Noodlezz,moon-guard,1772,warrior,arms,65,31,34
Tùngrâu,frostmourne,1769,warrior,arms,160,83,77
Dalan,korgath,1766,warrior,arms,48,30,18
Rólex,tichondrius,1766,warrior,arms,54,25,29
Krbigcow,tichondrius,1764,warrior,arms,96,49,47
Goodlikeplay,ragnaros,1762,warrior,arms,48,25,23
Invalidoath,tichondrius,1760,warrior,arms,54,27,27
Dawxw,thrall,1759,warrior,arms,41,24,17
Kurodia,quelthalas,1758,warrior,arms,72,30,42
Yonkerss,garrosh,1756,warrior,arms,95,51,44
Doublezuglol,tichondrius,1756,warrior,arms,89,47,42
Dabdaddyy,dawnbringer,1755,warrior,arms,93,43,50
Genghiz,azralon,1752,warrior,arms,60,35,25
Dramalas,lightbringer,1751,warrior,arms,263,136,127
Warfuse,illidan,1749,warrior,arms,126,63,63
Nànchobo,tichondrius,1749,warrior,arms,72,31,41
Goonassassin,tichondrius,1748,warrior,arms,48,24,24
Hoodrch,azralon,1747,warrior,arms,59,31,28
Smashxx,area-52,1744,warrior,arms,89,49,40
Ogrelurd,malygos,1743,warrior,arms,42,22,20
Ollena,wyrmrest-accord,1743,warrior,arms,66,32,34
Iwillcrushyo,darkspear,1743,warrior,arms,54,26,28
Razw,frostmourne,1742,warrior,arms,36,23,13
Madwolf,tichondrius,1742,warrior,arms,67,29,38
Støne,draktharon,1741,warrior,arms,65,36,29
Stáclin,ragnaros,1740,warrior,arms,348,193,155
Wartruë,tichondrius,1738,warrior,arms,256,136,120
Mynameyaff,tichondrius,1735,warrior,arms,103,62,41
Afrikunt,tichondrius,1733,warrior,arms,54,30,24
Lvlthreemage,fizzcrank,1733,warrior,arms,66,31,35
Nightheller,stormrage,1733,warrior,arms,78,33,45
Hoobaz,area-52,1732,warrior,arms,34,19,15
Slaught,kelthuzad,1731,warrior,arms,76,37,39
Brendanshwab,bleeding-hollow,1730,warrior,arms,42,23,19
Kames,garrosh,1727,warrior,arms,101,49,52
Nïcowo,ragnaros,1727,warrior,arms,74,35,39
Tiredkev,tichondrius,1726,warrior,arms,60,32,28
Isnlonely,tichondrius,1725,warrior,arms,30,18,12
Swifty,anvilmar,1725,warrior,arms,30,18,12
Jdubz,frostmourne,1725,warrior,arms,42,23,19
Crushedlol,bleeding-hollow,1725,warrior,arms,42,22,20
Athalen,nemesis,1724,warrior,arms,67,33,34
Swordborne,moon-guard,1722,warrior,arms,94,43,51
Itsfall,tichondrius,1721,warrior,arms,42,21,21
Sick,azralon,1720,warrior,arms,52,27,25
Izugyou,thrall,1718,warrior,arms,48,29,19
Kruma,stormscale,1715,warrior,arms,31,18,13
Cåfe,tichondrius,1715,warrior,arms,119,66,53
Überwältigen,thrall,1715,warrior,arms,42,18,24
Mezdrì,quelthalas,1714,warrior,arms,54,33,21
Asstastic,bonechewer,1714,warrior,arms,125,56,69
Bigladmike,sargeras,1714,warrior,arms,48,21,27
Basedaf,frostmourne,1713,warrior,arms,84,45,39
Murderbell,tichondrius,1711,warrior,arms,84,42,42
Lindsanv,illidan,1710,warrior,arms,80,47,33
Warginger,malygos,1710,warrior,arms,41,23,18
Illing,tichondrius,1710,warrior,arms,136,74,62
Boomergodx,stormrage,1708,warrior,arms,78,43,35
Pachacutecxx,ragnaros,1708,warrior,arms,75,40,35
Smashies,kelthuzad,1708,warrior,arms,47,24,23
Raahjz,sargeras,1708,warrior,arms,66,32,34
Chaytin,bleeding-hollow,1707,warrior,arms,50,27,23
Paoxiaoevs,tichondrius,1707,warrior,arms,36,18,18
Heater,stormrage,1705,warrior,arms,89,44,45
Unhòólyshy,ragnaros,1704,warrior,arms,42,27,15
Niubzs,tichondrius,1704,warrior,arms,53,27,26
Míasma,ragnaros,1703,warrior,arms,54,24,30
Maddawgg,mugthol,1702,warrior,arms,46,23,23
Misakizs,illidan,1701,warrior,arms,61,26,35
Zarrdune,darkspear,1700,warrior,arms,30,21,9
Coldlòve,akama,1699,warrior,arms,30,20,10
Milough,nesingwary,1699,warrior,arms,78,47,31
Thrator,wyrmrest-accord,1699,warrior,arms,42,23,19
Rocta,tichondrius,1698,warrior,arms,86,47,39
Johnburns,tichondrius,1698,warrior,arms,36,19,17
Urdem,moon-guard,1696,warrior,arms,96,51,45
Kpc,tichondrius,1696,warrior,arms,60,24,36
Mantistabogn,zuluhed,1695,warrior,arms,76,39,37
Ashtonx,sargeras,1694,warrior,arms,36,24,12
Lôwkeyfix,illidan,1694,warrior,arms,96,46,50
Anukhar,emerald-dream,1693,warrior,arms,72,42,30
Delphont,stormrage,1693,warrior,arms,107,59,48
Zaÿne,moon-guard,1692,warrior,arms,87,41,46
Rookìe,illidan,1690,warrior,arms,101,54,47
Bbyè,tichondrius,1690,warrior,arms,203,105,98
Bozzy,illidan,1690,warrior,arms,77,34,43
Kâdé,malganis,1689,warrior,arms,30,18,12
Lostsummer,frostmourne,1689,warrior,arms,58,31,27
Trackstarz,llane,1688,warrior,arms,134,75,59
Raveve,area-52,1688,warrior,arms,65,35,30
Bigbrick,stormrage,1688,warrior,arms,90,44,46
Polydopam,tichondrius,1688,warrior,arms,86,42,44
Zastrow,dalaran,1686,warrior,arms,84,33,51
Meowdaa,proudmoore,1686,warrior,arms,72,24,48
Sindevelor,tichondrius,1684,warrior,arms,89,50,39
Bebob,tichondrius,1684,warrior,arms,62,33,29
Bmo,chogall,1684,warrior,arms,87,44,43
Chimbrila,azralon,1684,warrior,arms,102,44,58
Nazraill,aggramar,1683,warrior,arms,75,42,33
Marvachi,moon-guard,1683,warrior,arms,62,32,30
Shinigamix,steamwheedle-cartel,1682,warrior,arms,48,29,19
Sosimi,tichondrius,1681,warrior,arms,68,41,27
Stonesoup,kelthuzad,1680,warrior,arms,83,33,50
Gtr,illidan,1679,warrior,arms,48,31,17
Fartazz,zuljin,1673,warrior,arms,84,40,44
Franziskaner,frostmourne,1673,warrior,arms,126,59,67
Cokeroom,tichondrius,1672,warrior,arms,55,33,22
Arkkaine,sargeras,1672,warrior,arms,81,42,39
Partyx,tichondrius,1672,warrior,arms,211,106,105
Pusspeepers,kelthuzad,1671,warrior,arms,39,18,21
Trágus,azralon,1670,warrior,arms,95,56,39
Qingmei,illidan,1670,warrior,arms,60,26,34
Winota,frostmourne,1669,warrior,arms,30,22,8
Brøly,sargeras,1669,warrior,arms,78,35,43
Amlahj,stormrage,1668,warrior,arms,53,30,23
Hydranoid,ragnaros,1666,warrior,arms,50,24,26
Legoyoda,zuljin,1663,warrior,arms,54,29,25
Edgárllama,sargeras,1663,warrior,arms,38,20,18
Groundpound,sargeras,1663,warrior,arms,78,41,37
Colössal,moon-guard,1663,warrior,arms,94,48,46
Fluffyarm,sargeras,1663,warrior,arms,161,81,80
Tastý,moon-guard,1663,warrior,arms,48,20,28
Ystkk,tichondrius,1662,warrior,arms,42,25,17
Warbeshar,area-52,1662,warrior,arms,42,21,21
Khørnë,ragnaros,1661,warrior,arms,54,30,24
Hickorie,sargeras,1661,warrior,arms,78,41,37
Killbórn,azralon,1660,warrior,arms,30,19,11
Bugsberserk,tichondrius,1658,warrior,arms,101,54,47
Twshizgd,proudmoore,1657,warrior,arms,139,68,71
Axazel,drakkari,1657,warrior,arms,56,27,29
Iwillcrushu,tichondrius,1655,warrior,arms,77,40,37
Golem,frostmourne,1655,warrior,arms,54,27,27
Sineatér,frostmourne,1654,warrior,arms,61,30,31
Maktarax,zuljin,1654,warrior,arms,40,18,22
Soupwar,moon-guard,1653,warrior,arms,64,33,31
Rynrak,tichondrius,1653,warrior,arms,41,19,22
Kilgorath,area-52,1652,warrior,arms,60,26,34
Bakadoom,illidan,1651,warrior,arms,66,34,32
Allyer,darkspear,1650,warrior,arms,42,23,19
Creøn,silvermoon,1650,warrior,arms,68,35,33
Phabian,frostmourne,1648,warrior,arms,41,22,19
Zenrrei,ragnaros,1647,warrior,arms,96,53,43
Arx,frostwolf,1647,warrior,arms,123,66,57
Droguernaut,tichondrius,1646,warrior,arms,59,30,29
Bøek,area-52,1646,warrior,arms,86,39,47
Xwarz,drakkari,1645,warrior,arms,42,19,23
Wolfcultist,moon-guard,1645,warrior,arms,48,20,28
Forakenna,dragonmaw,1644,warrior,arms,29,20,9
Rainingblooð,blackrock,1644,warrior,arms,103,53,50
Kekbyemmr,illidan,1644,warrior,arms,48,22,26
Morfoggore,ragnaros,1643,warrior,arms,54,28,26
Kromgrall,tichondrius,1643,warrior,arms,161,75,86
Pipedoctor,kelthuzad,1642,warrior,arms,30,21,9
Smokes,sargeras,1642,warrior,arms,108,49,59
Tatsuu,tichondrius,1640,warrior,arms,264,131,133
Sonjeba,malganis,1640,warrior,arms,70,32,38
Fulaixiong,illidan,1639,warrior,arms,51,34,17
Wargasmx,tichondrius,1638,warrior,arms,46,22,24
Ngu,eldrethalas,1636,warrior,arms,53,26,27
Jottman,tichondrius,1635,warrior,arms,72,31,41
Ciskokido,illidan,1634,warrior,arms,42,23,19
Stick,tichondrius,1634,warrior,arms,101,54,47
Wingaling,malganis,1633,warrior,arms,54,24,30
Matrias,tichondrius,1632,warrior,arms,100,58,42
Lexíbelle,korgath,1631,warrior,arms,36,21,15
Delakos,frostmourne,1630,warrior,arms,66,37,29
Crowsfall,aggramar,1630,warrior,arms,196,99,97
Shazbøt,tichondrius,1630,warrior,arms,45,19,26
Furykets,proudmoore,1629,warrior,arms,38,19,19
Yabahdabah,stormrage,1628,warrior,arms,81,45,36
Tatërs,zuljin,1628,warrior,arms,42,22,20
Hõdõnsin,tichondrius,1628,warrior,arms,57,26,31
Ikaikasan,illidan,1627,warrior,arms,32,22,10
Hookahboss,area-52,1627,warrior,arms,40,21,19
Vauquelin,tichondrius,1626,warrior,arms,60,33,27
Zeroskill,cenarius,1626,warrior,arms,60,28,32
Kazecap,proudmoore,1626,warrior,arms,66,29,37
Gravewurm,twisting-nether,1625,warrior,arms,36,21,15
Orgnosh,tichondrius,1625,warrior,arms,96,52,44
Gutting,moon-guard,1625,warrior,arms,36,18,18
Duxor,sargeras,1625,warrior,arms,54,24,30
Jgillz,sargeras,1624,warrior,arms,30,17,13
Bâlthor,quelthalas,1624,warrior,arms,110,57,53
Zenchi,nerzhul,1624,warrior,arms,55,24,31
Bddg,tichondrius,1623,warrior,arms,30,18,12
Testflight,tichondrius,1623,warrior,arms,54,30,24
Bwandøn,moon-guard,1623,warrior,arms,76,38,38
Painsoul,illidan,1622,warrior,arms,40,21,19
Ôn,tichondrius,1622,warrior,arms,107,52,55
Ðrex,nagrand,1621,warrior,arms,45,27,18
Chadwarr,tichondrius,1621,warrior,arms,31,17,14
Twilightrain,tichondrius,1621,warrior,arms,261,138,123
Kirown,quelthalas,1621,warrior,arms,98,45,53
Jdubzr,frostmourne,1621,warrior,arms,48,22,26
Stooklol,tichondrius,1621,warrior,arms,54,22,32
Swagramarr,area-52,1619,warrior,arms,81,43,38
Morioso,boulderfist,1619,warrior,arms,60,26,34
Szeo,tichondrius,1617,warrior,arms,24,17,7
Achilex,sargeras,1617,warrior,arms,127,66,61
Bromro,tichondrius,1617,warrior,arms,116,55,61
Ryängosling,azralon,1616,warrior,arms,150,83,67
Necroticism,bleeding-hollow,1616,warrior,arms,36,17,19
Slamuëladams,bleeding-hollow,1616,warrior,arms,48,20,28
Stormlørd,frostmourne,1615,warrior,arms,52,29,23
Timbermack,moon-guard,1615,warrior,arms,78,43,35
Ichirisw,tichondrius,1615,warrior,arms,47,23,24
Axellent,gilneas,1614,warrior,arms,70,44,26
Rittylord,frostmourne,1614,warrior,arms,68,37,31
Metalchileno,ragnaros,1614,warrior,arms,48,20,28
Willcharge,tichondrius,1614,warrior,arms,49,17,32
Myndon,area-52,1613,warrior,arms,37,27,10
Abswar,tichondrius,1613,warrior,arms,24,17,7
Pepétí,azralon,1613,warrior,arms,119,58,61
Indominate,tichondrius,1612,warrior,arms,98,43,55
Hofukumizuki,tichondrius,1612,warrior,arms,54,21,33
Shaõkahn,nemesis,1611,warrior,arms,46,23,23
Scrümp,illidan,1610,warrior,arms,79,44,35
Stickybladez,frostmourne,1610,warrior,arms,108,58,50
Ramzeé,kelthuzad,1609,warrior,arms,78,47,31
Thebigsmash,tichondrius,1609,warrior,arms,42,23,19
Nuccî,azralon,1608,warrior,arms,36,17,19
Warrgawd,illidan,1607,warrior,arms,59,32,27
Furydudz,tichondrius,1607,warrior,arms,42,21,21
Wartrue,tichondrius,1607,warrior,arms,156,71,85
Dokgö,tichondrius,1607,warrior,arms,60,27,33
Ottø,area-52,1606,warrior,arms,72,40,32
Bobu,area-52,1606,warrior,arms,52,28,24
Aventajadu,ragnaros,1606,warrior,arms,42,20,22
Brainhaze,tichondrius,1606,warrior,arms,48,21,27
Vanexx,tichondrius,1605,warrior,arms,37,22,15
Maraudertko,area-52,1605,warrior,arms,30,17,13
Mitigated,bleeding-hollow,1605,warrior,arms,42,22,20
Bìgpoppapump,tichondrius,1605,warrior,arms,72,36,36
Myxz,barthilas,1605,warrior,arms,120,59,61
Ethuil,azshara,1605,warrior,arms,65,29,36
Kakamallo,black-dragonflight,1604,warrior,arms,201,109,92
Blodreìna,hyjal,1604,warrior,arms,109,53,56
Sayyaf,moon-guard,1604,warrior,arms,57,20,37
Bleedx,bleeding-hollow,1603,warrior,arms,51,30,21
Yamadaflash,tichondrius,1603,warrior,arms,37,21,16
Zaràki,area-52,1603,warrior,arms,186,95,91
Mahoogler,hakkar,1603,warrior,arms,66,31,35
Malerick,illidan,1603,warrior,arms,63,27,36
Sheriff,eldrethalas,1600,warrior,arms,54,31,23
Ävdol,emerald-dream,1599,warrior,arms,42,20,22
Patwong,frostmourne,1597,warrior,arms,66,36,30
Raph,barthilas,1595,warrior,arms,36,20,16
Coollelex,proudmoore,1595,warrior,arms,50,25,25
Sayîon,zuljin,1594,warrior,arms,42,19,23
Rapcherawr,illidan,1593,warrior,arms,33,20,13
Faelash,stormrage,1592,warrior,arms,55,25,30
Blíding,ragnaros,1592,warrior,arms,57,22,35
Gromkhor,tichondrius,1590,warrior,arms,41,18,23
Meatbone,emerald-dream,1589,warrior,arms,84,48,36
Mistrpower,bleeding-hollow,1589,warrior,arms,78,44,34
Wutains,tichondrius,1589,warrior,arms,36,19,17
Cutgirl,quelthalas,1589,warrior,arms,44,19,25
Maddorlon,thrall,1588,warrior,arms,47,23,24
Dewbae,whisperwind,1586,warrior,arms,72,37,35
Homebody,uldaman,1585,warrior,arms,38,25,13
Hyperdevil,ragnaros,1585,warrior,arms,35,19,16
Kilgrah,emerald-dream,1585,warrior,arms,36,19,17
Sheetss,tichondrius,1585,warrior,arms,48,23,25
Dukà,hyjal,1584,warrior,arms,54,30,24
Destructör,nagrand,1584,warrior,arms,93,49,44
Tzumugi,ragnaros,1583,warrior,arms,243,124,119
Heylol,blackhand,1583,warrior,arms,48,19,29
Gannïcûs,drakkari,1582,warrior,arms,53,20,33
Rongor,drakkari,1580,warrior,arms,54,26,28
Traumaj,bleeding-hollow,1579,warrior,arms,103,57,46
Gbar,azralon,1578,warrior,arms,32,19,13
Drjuicce,tichondrius,1577,warrior,arms,24,17,7
Ragetodef,illidan,1577,warrior,arms,91,45,46
Därkzh,stormrage,1576,warrior,arms,30,20,10
Lootacris,illidan,1576,warrior,arms,55,27,28
Mokron,moon-guard,1576,warrior,arms,44,19,25
Juuz,frostmourne,1575,warrior,arms,114,56,58
Lunartime,sargeras,1575,warrior,arms,42,20,22
Ferozan,azralon,1575,warrior,arms,42,20,22
Sulze,tichondrius,1575,warrior,arms,177,83,94
Aumni,illidan,1574,warrior,arms,86,39,47
Darthbleezy,malygos,1573,warrior,arms,42,22,20
Sinbãd,sargeras,1573,warrior,arms,65,29,36
Marchdream,tichondrius,1572,warrior,arms,36,19,17
Danceylol,barthilas,1572,warrior,arms,48,19,29
Yarock,malganis,1571,warrior,arms,84,38,46
Armamortal,kelthuzad,1570,warrior,arms,161,84,77
Ÿüñí,tichondrius,1570,warrior,arms,42,19,23
Spartiguss,emerald-dream,1569,warrior,arms,35,18,17
Dotlom,wyrmrest-accord,1569,warrior,arms,112,55,57
Juicylumpia,moon-guard,1568,warrior,arms,48,31,17
Shadderaz,sargeras,1568,warrior,arms,30,18,12
PlayerRNKMRN,korgath,1567,warrior,arms,55,35,20
Johnnysmizle,kelthuzad,1567,warrior,arms,70,32,38
Riggragg,tichondrius,1565,warrior,arms,48,28,20
Orahard,illidan,1565,warrior,arms,176,86,90
Pigzig,nagrand,1564,warrior,arms,36,18,18
Hanadaddy,frostmourne,1564,warrior,arms,104,51,53
Mcluffin,proudmoore,1563,warrior,arms,42,26,16
Blaiize,ragnaros,1563,warrior,arms,48,18,30
Chogar,proudmoore,1562,warrior,arms,64,34,30
Chañ,tichondrius,1562,warrior,arms,36,19,17
Executie,duskwood,1562,warrior,arms,73,36,37
Sakutarou,lightbringer,1561,warrior,arms,196,93,103
Nerdstompêr,illidan,1561,warrior,arms,66,29,37
Oppressor,darkspear,1559,warrior,arms,65,33,32
Hônor,ragnaros,1558,warrior,arms,54,24,30
Ashantia,stormrage,1557,warrior,arms,61,33,28
Alator,gorgonnash,1556,warrior,arms,36,21,15
Monstersynde,nemesis,1556,warrior,arms,96,49,47
Firesx,tichondrius,1555,warrior,arms,36,20,16
Arctures,stormrage,1554,warrior,arms,72,45,27
Naejwar,ragnaros,1552,warrior,arms,164,85,79
Ghóstx,alleria,1550,warrior,arms,53,37,16
Wydstepwar,malganis,1550,warrior,arms,48,31,17
Krakatóa,kelthuzad,1550,warrior,arms,82,46,36
Titanzz,quelthalas,1550,warrior,arms,71,35,36
Xkickaxes,tichondrius,1550,warrior,arms,42,19,23
Rèckit,thrall,1550,warrior,arms,48,21,27
Itskel,stormreaver,1546,warrior,arms,44,23,21
Warriordanim,tichondrius,1545,warrior,arms,132,59,73
Abbastanza,tichondrius,1544,warrior,arms,51,18,33
Zyppz,sargeras,1543,warrior,arms,38,26,12
Xunxie,tichondrius,1543,warrior,arms,71,37,34
Fyruz,sargeras,1542,warrior,arms,74,41,33
Ginormous,rivendare,1542,warrior,arms,51,26,25
Know,anetheron,1542,warrior,arms,98,45,53
Wingedknight,malganis,1541,warrior,arms,98,47,51
Ohanaglad,illidan,1539,warrior,arms,96,51,45
Uhttercow,tichondrius,1539,warrior,arms,66,33,33
Slitt,azralon,1538,warrior,arms,72,39,33
Isarat,illidan,1535,warrior,arms,30,17,13
Larrylurker,proudmoore,1533,warrior,arms,107,53,54
Garrmash,hyjal,1533,warrior,arms,169,83,86
Hydrolisk,area-52,1533,warrior,arms,114,55,59
Rohta,kiljaeden,1533,warrior,arms,77,36,41
Torzzen,azralon,1532,warrior,arms,77,40,37
Nyle,zuljin,1532,warrior,arms,60,31,29
Yueren,tichondrius,1532,warrior,arms,36,16,20
Anticiðe,zuljin,1531,warrior,arms,24,16,8
Rokgral,tichondrius,1531,warrior,arms,56,29,27
Bottlecaps,shadowmoon,1530,warrior,arms,45,23,22
Kowboy,stormrage,1530,warrior,arms,102,52,50
Chillimus,tichondrius,1530,warrior,arms,48,23,25
Ratfang,zuljin,1528,warrior,arms,28,17,11
Shiv,illidan,1527,warrior,arms,93,46,47
Tkazo,tichondrius,1527,warrior,arms,35,17,18
Yiplaw,stormrage,1526,warrior,arms,30,16,14
Lehzera,frostmourne,1526,warrior,arms,44,20,24
Flynnstone,tichondrius,1524,warrior,arms,30,19,11
Chinamonk,tichondrius,1524,warrior,arms,101,49,52
Hannibalkng,zangarmarsh,1524,warrior,arms,52,20,32
Lionbuster,ragnaros,1523,warrior,arms,36,22,14
Magicalol,tichondrius,1523,warrior,arms,30,16,14
Stinkyw,tichondrius,1522,warrior,arms,37,21,16
Jrod,boulderfist,1522,warrior,arms,180,91,89
Kaÿip,tichondrius,1521,warrior,arms,30,16,14
Kimed,nordrassil,1520,warrior,arms,30,16,14
Unstàble,frostmourne,1520,warrior,arms,66,34,32
Spartacam,frostmourne,1520,warrior,arms,166,83,83
Flexìn,tichondrius,1520,warrior,arms,36,16,20
Elchacál,ragnaros,1520,warrior,arms,66,27,39
Randysnapper,zuljin,1519,warrior,arms,24,16,8
Ichigö,gundrak,1519,warrior,arms,51,25,26
Memorylane,proudmoore,1519,warrior,arms,36,16,20
Rukittenme,area-52,1519,warrior,arms,72,29,43
Powerbucks,tichondrius,1518,warrior,arms,32,17,15
Damiansuv,moon-guard,1516,warrior,arms,153,73,80
Jimjinjin,tichondrius,1515,warrior,arms,30,16,14
Rads,stormscale,1514,warrior,arms,69,39,30
Brayitann,illidan,1514,warrior,arms,49,27,22
Chupelo,tichondrius,1513,warrior,arms,24,18,6
Dtrumpo,moon-guard,1513,warrior,arms,52,27,25
Liltop,moon-guard,1512,warrior,arms,39,20,19
Luosifen,tichondrius,1511,warrior,arms,161,83,78
Línfert,stormrage,1511,warrior,arms,111,56,55
Tuvia,malganis,1511,warrior,arms,177,89,88
Raala,cenarius,1510,warrior,arms,45,31,14
Cathillex,eonar,1510,warrior,arms,24,16,8
Tríxman,moon-guard,1510,warrior,arms,104,60,44
Buntpunt,mannoroth,1510,warrior,arms,61,33,28
Gorez,ragnaros,1510,warrior,arms,36,18,18
Draganovich,aerie-peak,1509,warrior,arms,54,30,24
Ewenki,tichondrius,1509,warrior,arms,117,61,56
Aloregorey,malganis,1509,warrior,arms,84,38,46
Bozwar,tichondrius,1508,warrior,arms,48,25,23
Punknicanor,quelthalas,1508,warrior,arms,66,33,33
Flexeçute,moon-guard,1508,warrior,arms,66,30,36
Lyliumn,frostmourne,1508,warrior,arms,42,19,23
Geñeralguap,tichondrius,1507,warrior,arms,162,87,75
Machete,nemesis,1507,warrior,arms,76,40,36
Grumtak,azralon,1507,warrior,arms,35,18,17
Saleem,tichondrius,1507,warrior,arms,145,74,71
Dysensor,illidan,1506,warrior,arms,60,33,27
Nornogin,tichondrius,1505,warrior,arms,48,21,27
Koberos,queldorei,1504,warrior,arms,42,16,26
Wouili,zuljin,1503,warrior,arms,97,59,38
Theokos,dalaran,1503,warrior,arms,72,32,40
Calmaah,frostmourne,1502,warrior,arms,58,32,26
Skronkar,illidan,1501,warrior,arms,78,37,41
Michaelrossx,bloodhoof,1500,warrior,arms,174,85,89
Muskratz,tichondrius,1500,warrior,arms,66,32,34
Yawdamper,illidan,1499,warrior,arms,24,17,7
Swólepetrol,tichondrius,1499,warrior,arms,30,16,14
Metalwarr,illidan,1499,warrior,arms,47,23,24
Banhaezzi,tichondrius,1499,warrior,arms,124,60,64
Zalakan,malganis,1497,warrior,arms,24,16,8
Tcchmm,akama,1497,warrior,arms,64,28,36
Enilaw,proudmoore,1496,warrior,arms,62,36,26
Utgarde,stormrage,1496,warrior,arms,176,92,84
Ghianna,quelthalas,1496,warrior,arms,48,22,26
Danield,illidan,1496,warrior,arms,42,16,26
Flintish,moon-guard,1495,warrior,arms,48,30,18
Ralphy,lightnings-blade,1495,warrior,arms,88,48,40
Achillescool,tichondrius,1495,warrior,arms,54,25,29
Hoodlark,lightbringer,1495,warrior,arms,66,27,39
Gorenay,nemesis,1494,warrior,arms,36,17,19
Datneck,tichondrius,1493,warrior,arms,30,16,14
Horsekok,tichondrius,1492,warrior,arms,30,19,11
Aggorak,illidan,1492,warrior,arms,36,16,20
Brewstrike,dalaran,1491,warrior,arms,30,17,13
Morboo,illidan,1491,warrior,arms,30,16,14
Sáítámá,tichondrius,1491,warrior,arms,52,27,25
Torimzor,nemesis,1490,warrior,arms,126,69,57
Fraannky,windrunner,1490,warrior,arms,72,38,34
Roidraging,thunderlord,1490,warrior,arms,149,66,83
Garadiels,tichondrius,1490,warrior,arms,73,31,42
Sinsinatra,azralon,1489,warrior,arms,174,85,89
Rockstedy,area-52,1489,warrior,arms,68,31,37
Flavor,aegwynn,1489,warrior,arms,36,16,20
Ôxluck,ragnaros,1489,warrior,arms,74,27,47
Islik,stormrage,1488,warrior,arms,30,16,14
Taywar,sargeras,1488,warrior,arms,60,29,31
Dragvovar,thrall,1488,warrior,arms,42,16,26
Casablancas,azralon,1488,warrior,arms,42,16,26
Zänn,dalaran,1486,warrior,arms,60,38,22
Pelonna,drakkari,1486,warrior,arms,120,57,63
Painfulsin,tichondrius,1486,warrior,arms,42,19,23
Wmf,frostmourne,1486,warrior,arms,78,35,43
Soltrain,stormrage,1485,warrior,arms,44,21,23
Karnakk,thrall,1485,warrior,arms,41,16,25
Kénjar,tichondrius,1484,warrior,arms,24,16,8
Ogeezus,crushridge,1484,warrior,arms,36,17,19
Earlsiriuz,tichondrius,1483,warrior,arms,51,23,28
Dorianfrost,ravenholdt,1483,warrior,arms,54,20,34
Kolossux,ragnaros,1482,warrior,arms,66,35,31
Frankoiz,quelthalas,1482,warrior,arms,42,19,23
Gorgan,ragnaros,1481,warrior,arms,52,23,29
Visenyä,mannoroth,1481,warrior,arms,52,21,31
Kissmyaxê,tichondrius,1480,warrior,arms,57,24,33
Brutallicus,kelthuzad,1479,warrior,arms,33,17,16
Volstraya,frostmourne,1478,warrior,arms,36,18,18
Shortgoofy,sargeras,1477,warrior,arms,129,61,68
Crystaríum,stormrage,1477,warrior,arms,79,37,42
Alexitwo,ragnaros,1476,warrior,arms,48,29,19
Rainzy,stormrage,1476,warrior,arms,36,16,20
Weedow,proudmoore,1474,warrior,arms,29,16,13
Saîyanroyce,barthilas,1473,warrior,arms,137,69,68
Naughtytwat,tichondrius,1472,warrior,arms,183,90,93
Dann,ragnaros,1472,warrior,arms,84,39,45
Radagøn,drakkari,1472,warrior,arms,36,16,20
Lòrdnasher,tichondrius,1471,warrior,arms,53,29,24
Ygucheng,emerald-dream,1471,warrior,arms,49,25,24
Arthwarf,proudmoore,1470,warrior,arms,54,26,28
Bricksquad,mannoroth,1470,warrior,arms,39,18,21
Baul,area-52,1469,warrior,arms,59,31,28
Kolosal,tichondrius,1469,warrior,arms,33,16,17
Mardrex,korgath,1469,warrior,arms,36,16,20
Smokedaperc,illidan,1468,warrior,arms,84,44,40
Jeffo,amanthul,1468,warrior,arms,38,18,20
Thurman,spirestone,1467,warrior,arms,44,26,18
Unkultom,stormrage,1467,warrior,arms,57,30,27
Beaerboy,darkspear,1466,warrior,arms,96,43,53
Eggroll,emerald-dream,1465,warrior,arms,47,17,30
Gwendolynl,hyjal,1464,warrior,arms,55,29,26
Toughguts,saurfang,1464,warrior,arms,60,29,31
Armsprotfury,tichondrius,1463,warrior,arms,42,26,16
Frashes,darkspear,1463,warrior,arms,55,26,29
Bigdingus,frostwolf,1463,warrior,arms,60,28,32
Moonär,emerald-dream,1463,warrior,arms,60,27,33
Sertss,proudmoore,1462,warrior,arms,71,30,41
Golkän,goldrinn,1461,warrior,arms,66,34,32
Duroxzee,area-52,1460,warrior,arms,168,90,78
Slyith,shadow-council,1460,warrior,arms,77,38,39
Nabiouscx,malganis,1460,warrior,arms,101,47,54
Fatnfurious,dunemaul,1459,warrior,arms,77,40,37
Raves,quelthalas,1459,warrior,arms,60,22,38
Allgas,barthilas,1458,warrior,arms,77,46,31
Warlow,korgath,1458,warrior,arms,58,26,32
Mommysharky,illidan,1457,warrior,arms,36,26,10
Dathalidus,area-52,1457,warrior,arms,50,32,18
Creepi,sargeras,1457,warrior,arms,56,30,26
Legbreaker,tichondrius,1457,warrior,arms,58,29,29
Ihadnochoice,barthilas,1457,warrior,arms,166,80,86
Zeerohkool,malganis,1457,warrior,arms,68,31,37
Enzoh,zuljin,1457,warrior,arms,50,16,34
Bullmastic,deathwing,1456,warrior,arms,46,21,25
Pongk,tichondrius,1456,warrior,arms,57,17,40
Amaragos,tichondrius,1455,warrior,arms,62,37,25
Jotto,zuljin,1455,warrior,arms,36,18,18
Xaka,tichondrius,1455,warrior,arms,42,19,23
Hotdadparty,frostmourne,1455,warrior,arms,59,26,33
Zhânshen,tichondrius,1454,warrior,arms,48,24,24
Doves,tichondrius,1453,warrior,arms,33,16,17
Arot,bloodhoof,1453,warrior,arms,93,42,51
Mailløche,bleeding-hollow,1452,warrior,arms,60,32,28
Xenogears,boulderfist,1452,warrior,arms,96,51,45
Gwlade,sargeras,1452,warrior,arms,121,63,58
Biznizwar,sargeras,1450,warrior,arms,124,61,63
Dajva,ragnaros,1450,warrior,arms,36,16,20
Wellowarr,moon-guard,1448,warrior,arms,78,34,44
Dcashmoney,moon-guard,1448,warrior,arms,66,28,38
Balroge,illidan,1447,warrior,arms,48,22,26
Overswing,tichondrius,1446,warrior,arms,78,32,46
Rárict,moon-guard,1445,warrior,arms,46,26,20
Shawnemd,proudmoore,1445,warrior,arms,54,29,25
Furyass,bleeding-hollow,1442,warrior,arms,114,61,53
Ashbringera,proudmoore,1442,warrior,arms,120,57,63
Kréix,sargeras,1442,warrior,arms,59,27,32
Lionssong,bleeding-hollow,1442,warrior,arms,47,20,27
Riskydevil,azralon,1441,warrior,arms,40,23,17
Muertededios,quelthalas,1441,warrior,arms,123,62,61
Lisande,sargeras,1440,warrior,arms,70,40,30
Ðêad,area-52,1439,warrior,arms,24,15,9
Bigjbs,tichondrius,1439,warrior,arms,24,15,9
Crownzz,tichondrius,1439,warrior,arms,30,15,15
Rekatron,area-52,1439,warrior,arms,30,15,15
Darkfang,icecrown,1438,warrior,arms,48,26,22
Jichelei,tichondrius,1438,warrior,arms,72,35,37
Loosz,stormrage,1438,warrior,arms,36,15,21
Graelus,terenas,1437,warrior,arms,43,24,19
Slamix,area-52,1436,warrior,arms,63,33,30
Lsays,tichondrius,1435,warrior,arms,86,41,45
Nikon,bleeding-hollow,1435,warrior,arms,42,16,26
Vainamóinen,kelthuzad,1433,warrior,arms,24,15,9
Áres,malganis,1433,warrior,arms,178,95,83
Monowarx,frostmourne,1433,warrior,arms,46,22,24
Badguys,illidan,1431,warrior,arms,36,15,21
Krimgar,quelthalas,1430,warrior,arms,64,24,40
Naxxiki,wyrmrest-accord,1429,warrior,arms,42,25,17
Destroid,zuljin,1428,warrior,arms,24,15,9
Klouddraft,tichondrius,1428,warrior,arms,39,22,17
Shishokun,quelthalas,1428,warrior,arms,64,29,35
Shiiftybuga,frostmourne,1427,warrior,arms,50,27,23
Supremegalek,tichondrius,1427,warrior,arms,82,44,38
Karrok,zuluhed,1427,warrior,arms,192,90,102
Hulkbuster,ragnaros,1427,warrior,arms,42,18,24
Kadira,stormrage,1427,warrior,arms,90,37,53
Robodad,illidan,1425,warrior,arms,30,15,15
Thorado,nemesis,1425,warrior,arms,63,31,32
Joebo,thrall,1424,warrior,arms,18,15,3
Draugus,azralon,1424,warrior,arms,24,15,9
Dinogc,barthilas,1424,warrior,arms,32,17,15
Scrapx,malganis,1423,warrior,arms,66,33,33
Tergll,illidan,1423,warrior,arms,51,23,28
Cjz,tichondrius,1422,warrior,arms,42,25,17
Automator,proudmoore,1422,warrior,arms,36,15,21
Wapistun,thrall,1421,warrior,arms,36,19,17
Kralo,moon-guard,1421,warrior,arms,33,16,17
Zaexx,stormrage,1420,warrior,arms,41,22,19
Braxin,dalaran,1420,warrior,arms,66,34,32
Mahkrash,quelthalas,1420,warrior,arms,47,22,25
Sleazedog,kelthuzad,1420,warrior,arms,48,21,27
Waraze,tichondrius,1420,warrior,arms,42,17,25
Maywarro,ragnaros,1419,warrior,arms,36,19,17
Noyel,tichondrius,1419,warrior,arms,31,15,16
Kinzi,quelthalas,1419,warrior,arms,64,25,39
Dreadedbeef,area-52,1417,warrior,arms,24,15,9
Aaryn,caelestrasz,1415,warrior,arms,104,56,48
Ártorius,sargeras,1415,warrior,arms,36,17,19
Auzery,emerald-dream,1415,warrior,arms,36,15,21
Ukris,area-52,1414,warrior,arms,89,48,41
Kahuwuna,tichondrius,1414,warrior,arms,30,15,15
Scumrat,frostmourne,1414,warrior,arms,66,32,34
Claymation,tichondrius,1414,warrior,arms,42,15,27
Korboc,malganis,1413,warrior,arms,60,29,31
Slickpapi,area-52,1413,warrior,arms,93,44,49
Ëssex,tichondrius,1412,warrior,arms,71,32,39
Northhill,tichondrius,1411,warrior,arms,41,24,17
Aragorn,mannoroth,1410,warrior,arms,30,15,15
Radamäntthys,nemesis,1410,warrior,arms,75,29,46
Áustin,sargeras,1409,warrior,arms,24,15,9
Varith,sargeras,1409,warrior,arms,30,18,12
Asc,barthilas,1409,warrior,arms,99,55,44
Atróx,quelthalas,1409,warrior,arms,30,15,15
Chrosis,norgannon,1408,warrior,arms,42,18,24
Warthorns,malganis,1408,warrior,arms,49,17,32
Kannzox,quelthalas,1406,warrior,arms,79,40,39
Unitsven,barthilas,1406,warrior,arms,36,15,21
Solano,illidan,1405,warrior,arms,48,30,18
Byung,terenas,1405,warrior,arms,54,22,32
Broodthorne,tichondrius,1404,warrior,arms,30,15,15
Rhohan,ysera,1404,warrior,arms,77,38,39
Yummysushi,gorgonnash,1404,warrior,arms,76,31,45
Dúmßlòwn,tichondrius,1403,warrior,arms,138,66,72
Aloloco,ragnaros,1403,warrior,arms,66,30,36
Zareos,azralon,1403,warrior,arms,40,17,23
Barbatenaz,ragnaros,1403,warrior,arms,36,15,21
Aesom,wyrmrest-accord,1402,warrior,arms,115,63,52
Nightshauyia,kelthuzad,1401,warrior,arms,39,22,17
Aión,nemesis,1400,warrior,arms,24,17,7
Peeb,tichondrius,1399,warrior,arms,30,15,15
Yunnkel,ragnaros,1399,warrior,arms,81,37,44
Nagaboner,frostmourne,1398,warrior,arms,53,29,24
Tern,emerald-dream,1398,warrior,arms,76,39,37
Doomreaper,hellscream,1398,warrior,arms,41,21,20
Ikrad,quelthalas,1398,warrior,arms,84,42,42
Tenebrous,nemesis,1397,warrior,arms,48,20,28
Tdestroy,ragnaros,1396,warrior,arms,27,16,11
Rokó,illidan,1396,warrior,arms,72,34,38
Wesih,ragnaros,1396,warrior,arms,48,18,30
Peacemake,tichondrius,1395,warrior,arms,33,16,17
Disarmiea,cairne,1393,warrior,arms,69,31,38
Magnar,zuljin,1392,warrior,arms,42,25,17
Vanglorio,azralon,1392,warrior,arms,81,44,37
Mjorn,sargeras,1392,warrior,arms,58,28,30
Belldor,barthilas,1392,warrior,arms,66,23,43
Zaurka,sargeras,1391,warrior,arms,30,18,12
Bigster,malganis,1391,warrior,arms,30,16,14
Nicegirl,sargeras,1391,warrior,arms,69,36,33
Zeerohkool,tichondrius,1391,warrior,arms,102,46,56
Khargrok,ragnaros,1389,warrior,arms,30,15,15
Apallô,tichondrius,1388,warrior,arms,89,40,49
Gusbus,malganis,1387,warrior,arms,72,40,32
Saltyundies,tichondrius,1387,warrior,arms,117,54,63
Kilrosao,nordrassil,1386,warrior,arms,71,37,34
Iigotu,tichondrius,1386,warrior,arms,202,97,105
Momojojo,daggerspine,1385,warrior,arms,26,18,8
Morhgath,bonechewer,1385,warrior,arms,49,26,23
Yirko,quelthalas,1385,warrior,arms,74,31,43
Yolo,dunemaul,1384,warrior,arms,29,15,14
Lilmerman,laughing-skull,1384,warrior,arms,36,16,20
Themudcrab,frostmourne,1384,warrior,arms,175,77,98
Sludgthwaps,stormrage,1383,warrior,arms,59,29,30
Kanamechan,area-52,1383,warrior,arms,65,24,41
Tigo,khaz-modan,1382,warrior,arms,49,29,20
Holddapoop,area-52,1382,warrior,arms,36,19,17
Ghostss,tichondrius,1382,warrior,arms,67,29,38
Eîghtysîx,sargeras,1382,warrior,arms,100,43,57
Rivenz,moon-guard,1382,warrior,arms,57,20,37
Verain,thrall,1381,warrior,arms,36,17,19
Typhön,tichondrius,1380,warrior,arms,77,31,46
Theragar,kilrogg,1379,warrior,arms,30,18,12
Druckerz,lightnings-blade,1379,warrior,arms,42,15,27
Vyndronor,illidan,1377,warrior,arms,30,16,14
Brotu,nemesis,1376,warrior,arms,121,68,53
Brocky,malorne,1376,warrior,arms,362,171,191
Luckyw,draktharon,1375,warrior,arms,42,23,19
Beowúlf,burning-blade,1375,warrior,arms,41,16,25
Dolkal,tichondrius,1375,warrior,arms,57,21,36
Dubstoob,illidan,1372,warrior,arms,118,61,57
Rushour,quelthalas,1372,warrior,arms,32,15,17
Ðarkstar,zuljin,1370,warrior,arms,140,62,78
Powerhard,area-52,1368,warrior,arms,57,26,31
Tÿÿr,azralon,1367,warrior,arms,48,20,28
Dhaemom,azralon,1366,warrior,arms,133,69,64
Evilkorean,tichondrius,1366,warrior,arms,59,29,30
Ángron,ragnaros,1366,warrior,arms,62,29,33
Jalaskâ,azralon,1364,warrior,arms,40,21,19
Xampuu,ragnaros,1363,warrior,arms,34,20,14
Sevala,spinebreaker,1363,warrior,arms,58,32,26
Neozsmash,thrall,1362,warrior,arms,58,29,29
Chanchoswar,ragnaros,1362,warrior,arms,63,25,38
Qetimporta,quelthalas,1361,warrior,arms,54,30,24
Cheeriozz,thrall,1361,warrior,arms,42,21,21
Marvél,quelthalas,1360,warrior,arms,33,20,13
Mervyn,aegwynn,1360,warrior,arms,48,29,19
Warsaínt,area-52,1360,warrior,arms,65,31,34
Destoryhamer,illidan,1359,warrior,arms,66,33,33
Mortalstrike,chogall,1359,warrior,arms,34,16,18
Lègèndáry,dark-iron,1359,warrior,arms,48,21,27
Davidorco,drakkari,1358,warrior,arms,41,19,22
Tenchuu,azralon,1358,warrior,arms,99,43,56
Stufit,emerald-dream,1357,warrior,arms,28,17,11
Chawp,emerald-dream,1355,warrior,arms,41,23,18
Asgaurdius,thunderlord,1355,warrior,arms,30,15,15
Bùlk,barthilas,1355,warrior,arms,77,33,44
Lowlow,lightbringer,1354,warrior,arms,36,16,20
Perrin,burning-blade,1354,warrior,arms,35,15,20
Dropopen,tichondrius,1354,warrior,arms,48,15,33
Irix,tichondrius,1353,warrior,arms,86,44,42
Bagur,ragnaros,1352,warrior,arms,78,42,36
Browneyed,area-52,1352,warrior,arms,36,15,21
Nviv,proudmoore,1351,warrior,arms,90,40,50
Swordmasters,icecrown,1350,warrior,arms,42,18,24
Ooze,darkspear,1349,warrior,arms,61,33,28
Rampage,azralon,1349,warrior,arms,125,59,66
Jsolucky,thrall,1348,warrior,arms,36,15,21
Thegoochgoon,malorne,1347,warrior,arms,57,31,26
Dimus,area-52,1347,warrior,arms,36,15,21
Doomreaprr,hellscream,1346,warrior,arms,26,16,10
Rasgriz,moon-guard,1346,warrior,arms,43,20,23
ßaldbornë,stormrage,1344,warrior,arms,94,47,47
Tusktrollmon,illidan,1344,warrior,arms,77,37,40
Jeffe,khadgar,1344,warrior,arms,74,30,44
Notmagnusz,zuljin,1343,warrior,arms,30,14,16
Legday,stormrage,1343,warrior,arms,30,14,16
Wtssap,ragnaros,1342,warrior,arms,24,14,10
Storkos,moon-guard,1342,warrior,arms,101,53,48
Jellybomb,sargeras,1342,warrior,arms,138,65,73
Coolade,thunderhorn,1342,warrior,arms,64,28,36
Ddaÿ,tichondrius,1342,warrior,arms,36,14,22
Zzchocolate,illidan,1341,warrior,arms,24,14,10
Niudazhuang,tichondrius,1341,warrior,arms,76,43,33
Jikith,proudmoore,1341,warrior,arms,30,14,16
Machineofwar,zuluhed,1341,warrior,arms,126,58,68
Longzhan,tichondrius,1341,warrior,arms,36,14,22
Coisini,tichondrius,1340,warrior,arms,61,29,32
Juggerboo,frostmourne,1340,warrior,arms,43,19,24
Erple,eldrethalas,1340,warrior,arms,78,31,47
Sunamys,illidan,1340,warrior,arms,36,14,22
Gentlehugs,illidan,1340,warrior,arms,36,14,22
Tamagoshi,kiljaeden,1339,warrior,arms,54,29,25
Gáren,quelthalas,1338,warrior,arms,24,14,10
Nuvola,tichondrius,1338,warrior,arms,24,14,10
Kelidar,kaelthas,1338,warrior,arms,42,22,20
Gohrgroc,quelthalas,1337,warrior,arms,24,14,10
Okanos,tichondrius,1337,warrior,arms,30,14,16
Govosh,thrall,1336,warrior,arms,24,14,10
Swamis,stormreaver,1336,warrior,arms,36,19,17
Nosfuratuzod,frostmourne,1336,warrior,arms,36,19,17
Azog,bleeding-hollow,1336,warrior,arms,48,25,23
Viagraliker,tichondrius,1336,warrior,arms,44,19,25
Tehfury,area-52,1336,warrior,arms,36,14,22
Xenoblade,wildhammer,1335,warrior,arms,48,21,27
Xenowar,alleria,1335,warrior,arms,96,41,55
Dicedup,stormrage,1335,warrior,arms,36,14,22
Crowncrumpah,illidan,1334,warrior,arms,24,14,10
Rageinice,tichondrius,1334,warrior,arms,42,21,21
Purrava,tichondrius,1334,warrior,arms,30,14,16
Akj,sargeras,1334,warrior,arms,42,18,24
Ybo,illidan,1333,warrior,arms,63,39,24
Laint,wyrmrest-accord,1332,warrior,arms,126,65,61
Baix,frostmourne,1332,warrior,arms,51,26,25
Xufoxpikmin,gurubashi,1332,warrior,arms,94,41,53
Asgér,quelthalas,1332,warrior,arms,36,14,22
Aranacn,tichondrius,1331,warrior,arms,18,14,4
Dashballer,sargeras,1331,warrior,arms,24,14,10
Kappis,illidan,1331,warrior,arms,29,16,13
Varekai,frostmourne,1331,warrior,arms,62,32,30
Loothar,goldrinn,1331,warrior,arms,75,37,38
Fuknazum,gundrak,1331,warrior,arms,96,44,52
Lexxsteele,mugthol,1330,warrior,arms,24,14,10
Carken,kiljaeden,1330,warrior,arms,36,20,16
Gooshin,sargeras,1330,warrior,arms,37,19,18
Seukkang,tichondrius,1330,warrior,arms,30,14,16
Himer,tichondrius,1330,warrior,arms,30,14,16
Papaming,tichondrius,1330,warrior,arms,48,21,27
Nervoxztwo,ragnaros,1329,warrior,arms,66,33,33
Kilroywar,tichondrius,1329,warrior,arms,30,14,16
Ivanovh,quelthalas,1328,warrior,arms,159,82,77
Fixafflock,bleeding-hollow,1327,warrior,arms,24,14,10
Trapbois,tichondrius,1327,warrior,arms,24,14,10
Kalnor,dark-iron,1327,warrior,arms,50,26,24
Retros,kelthuzad,1327,warrior,arms,66,32,34
Ketasshi,kelthuzad,1327,warrior,arms,30,14,16
Deamonkiller,kelthuzad,1327,warrior,arms,79,36,43
Twistwarr,area-52,1326,warrior,arms,24,14,10
Soez,tichondrius,1325,warrior,arms,22,15,7
Aoste,tichondrius,1324,warrior,arms,31,16,15
Handain,malganis,1324,warrior,arms,30,14,16
Amputate,akama,1324,warrior,arms,42,14,28
Aparentlynot,shattered-hand,1323,warrior,arms,30,14,16
Dre,anubarak,1323,warrior,arms,30,14,16
Rockystyle,proudmoore,1321,warrior,arms,48,28,20
Dáinsleif,frostmourne,1321,warrior,arms,30,14,16
Rekem,malganis,1320,warrior,arms,60,27,33
Ønì,tichondrius,1319,warrior,arms,42,33,9
Macsen,zuljin,1319,warrior,arms,36,18,18
Edwiddin,frostmourne,1319,warrior,arms,38,15,23
Warthok,turalyon,1319,warrior,arms,36,14,22
Grimreáper,bleeding-hollow,1319,warrior,arms,42,14,28
Devildriver,malganis,1318,warrior,arms,24,14,10
Chargeback,zuljin,1318,warrior,arms,63,34,29
Arkayko,quelthalas,1318,warrior,arms,28,15,13
Zroz,ragnaros,1318,warrior,arms,54,28,26
Zaddybear,aerie-peak,1318,warrior,arms,30,14,16
Lujzika,stormreaver,1318,warrior,arms,39,17,22
Dennlss,quelthalas,1318,warrior,arms,36,14,22
Hiddensquidd,stormrage,1316,warrior,arms,27,19,8
Blokz,arthas,1316,warrior,arms,30,17,13
Orcaine,ursin,1315,warrior,arms,41,27,14
Banggo,frostmourne,1315,warrior,arms,30,17,13
Valder,akama,1315,warrior,arms,30,15,15
Ghostmourne,ragnaros,1314,warrior,arms,113,51,62
Vemue,tichondrius,1312,warrior,arms,142,69,73
Qtcrow,frostmourne,1310,warrior,arms,78,39,39
Fòntaine,shandris,1310,warrior,arms,30,15,15
Korsarro,frostmourne,1310,warrior,arms,80,37,43
Blackwulff,korgath,1310,warrior,arms,60,25,35
Doomtree,zuljin,1309,warrior,arms,18,14,4
Mickyplate,tichondrius,1307,warrior,arms,78,39,39
Swiftui,nemesis,1307,warrior,arms,60,26,34
Golîath,mannoroth,1307,warrior,arms,54,23,31
Aldérmach,zuljin,1306,warrior,arms,112,57,55
Velarrine,illidan,1306,warrior,arms,89,39,50
Blightscream,bleeding-hollow,1306,warrior,arms,88,36,52
Knghtofseven,nemesis,1305,warrior,arms,72,39,33
Tikkò,tichondrius,1305,warrior,arms,50,25,25
Raekor,tichondrius,1304,warrior,arms,42,25,17
Calynn,frostmourne,1304,warrior,arms,90,46,44
Brontok,darkspear,1304,warrior,arms,46,22,24
Benjiprice,sargeras,1303,warrior,arms,23,14,9
Qookymonster,zuljin,1303,warrior,arms,48,26,22
Killtarget,tichondrius,1303,warrior,arms,61,32,29
Silverkiller,drakkari,1302,warrior,arms,24,14,10
Emaree,thrall,1302,warrior,arms,55,28,27
Deadee,aerie-peak,1302,warrior,arms,100,48,52
Ludicrous,dreadmaul,1302,warrior,arms,85,36,49
Kittybang,quelthalas,1302,warrior,arms,54,19,35
Krazyguerra,bleeding-hollow,1301,warrior,arms,36,21,15
Donhoolio,illidan,1301,warrior,arms,24,14,10
Legolant,uther,1301,warrior,arms,30,14,16
Hopar,illidan,1299,warrior,arms,27,17,10
Pvpheart,tichondrius,1299,warrior,arms,47,27,20
Krostyx,ragnaros,1299,warrior,arms,72,40,32
Kitonic,proudmoore,1296,warrior,arms,29,18,11
Guitter,nazjatar,1296,warrior,arms,48,20,28
Bajheera,sargeras,1295,warrior,arms,23,14,9
Beeny,tichondrius,1295,warrior,arms,33,14,19
Iyamii,hyjal,1294,warrior,arms,29,16,13
Superpot,bleeding-hollow,1294,warrior,arms,48,22,26
Avoraçado,nemesis,1294,warrior,arms,61,22,39
Crú,stormrage,1293,warrior,arms,30,14,16
Kenshín,ragnaros,1291,warrior,arms,47,16,31
Noobslayr,wyrmrest-accord,1290,warrior,arms,30,18,12
Grimus,bleeding-hollow,1289,warrior,arms,43,21,22
Tasesino,quelthalas,1289,warrior,arms,34,16,18
Grumok,tichondrius,1289,warrior,arms,57,24,33
Hôdû,tichondrius,1286,warrior,arms,75,36,39
Dualip,tichondrius,1283,warrior,arms,75,38,37
Excaliburz,frostmourne,1283,warrior,arms,101,48,53
Mussashí,stormrage,1282,warrior,arms,50,31,19
Putong,tichondrius,1282,warrior,arms,41,23,18
Kagerou,ragnaros,1282,warrior,arms,62,28,34
Kuchikilla,borean-tundra,1279,warrior,arms,64,31,33
Rayks,tichondrius,1278,warrior,arms,42,22,20
Bfrenzy,dalaran,1278,warrior,arms,42,18,24
Drygen,tichondrius,1277,warrior,arms,24,15,9
Kourny,frostmourne,1276,warrior,arms,75,36,39
Rikuduo,quelthalas,1276,warrior,arms,54,20,34
Ragnarwar,azralon,1275,warrior,arms,40,21,19
Warsongwolf,tichondrius,1275,warrior,arms,32,14,18
Loucha,nagrand,1275,warrior,arms,63,26,37
Zuggarnaught,tichondrius,1274,warrior,arms,70,37,33
Warb,aggramar,1273,warrior,arms,48,21,27
Gtatewarr,azjolnerub,1272,warrior,arms,20,14,6
Arox,ghostlands,1272,warrior,arms,60,30,30
Warnick,illidan,1272,warrior,arms,54,25,29
Dëkm,quelthalas,1272,warrior,arms,41,18,23
Thebruce,nemesis,1271,warrior,arms,82,43,39
Cowtipin,illidan,1268,warrior,arms,34,14,20
Athin,azralon,1267,warrior,arms,29,14,15
Kantorowicz,goldrinn,1267,warrior,arms,54,24,30
Thorablade,barthilas,1266,warrior,arms,84,38,46
Spartaner,shadowsong,1265,warrior,arms,36,14,22
Datsongz,proudmoore,1264,warrior,arms,90,42,48
Timotheapple,stormrage,1264,warrior,arms,32,14,18
Krimmjðw,sargeras,1263,warrior,arms,36,14,22
Babyguns,tichondrius,1262,warrior,arms,66,29,37
ßloodshed,frostmourne,1261,warrior,arms,19,14,5
Helandas,moknathal,1261,warrior,arms,111,60,51
Laynarri,hyjal,1260,warrior,arms,60,28,32
Devilsbane,khaz-modan,1259,warrior,arms,48,22,26
Juff,hakkar,1258,warrior,arms,30,14,16
Aràthor,stormrage,1258,warrior,arms,66,30,36
Superdah,kiljaeden,1257,warrior,arms,60,26,34
Gritrog,thrall,1255,warrior,arms,38,27,11
Queterompo,ragnaros,1255,warrior,arms,66,36,30
Pangpou,tichondrius,1255,warrior,arms,96,49,47
Aleniá,tichondrius,1255,warrior,arms,79,37,42
Brynjah,azralon,1249,warrior,arms,90,40,50
Bersorcker,ragnaros,1249,warrior,arms,37,16,21
Lagzistance,area-52,1248,warrior,arms,24,13,11
Areaves,moon-guard,1247,warrior,arms,24,13,11
Wtbfriends,malganis,1247,warrior,arms,24,13,11
Scotteh,eredar,1247,warrior,arms,30,13,17
Ggtk,tichondrius,1247,warrior,arms,30,13,17
Xvett,drakkari,1246,warrior,arms,36,20,16
Callad,tichondrius,1246,warrior,arms,47,22,25
Schizogeist,malganis,1246,warrior,arms,40,18,22
Wrathena,khadgar,1246,warrior,arms,41,18,23
Rarefxck,tichondrius,1244,warrior,arms,30,13,17
Ironboar,proudmoore,1244,warrior,arms,30,13,17
Andorane,bleeding-hollow,1243,warrior,arms,24,13,11
Odrath,tichondrius,1243,warrior,arms,57,23,34
Flexinbooty,kelthuzad,1243,warrior,arms,36,13,23
Ystk,tichondrius,1242,warrior,arms,24,13,11
Wilric,ragnaros,1242,warrior,arms,30,13,17
Titanika,wyrmrest-accord,1242,warrior,arms,66,25,41
Greywo,tichondrius,1241,warrior,arms,34,19,15
Guerra,goldrinn,1241,warrior,arms,24,13,11
Ragedump,shadowsong,1241,warrior,arms,24,13,11
Blacksmiff,malganis,1240,warrior,arms,42,24,18
Grimjouw,sargeras,1240,warrior,arms,24,13,11
Methwitch,moon-guard,1240,warrior,arms,24,13,11
Radox,tichondrius,1240,warrior,arms,24,13,11
Chadblade,tichondrius,1240,warrior,arms,24,13,11
Qtxd,malganis,1240,warrior,arms,24,13,11
Jaminos,frostmourne,1240,warrior,arms,51,22,29
Ðhrâgøn,ragnaros,1239,warrior,arms,18,15,3
Mitigation,hyjal,1239,warrior,arms,34,15,19
Noitrak,azralon,1239,warrior,arms,33,14,19
Kiddoe,rivendare,1238,warrior,arms,66,31,35
Rimz,sargeras,1237,warrior,arms,27,14,13
Deathengine,area-52,1237,warrior,arms,29,14,15
Squeekzz,frostmane,1236,warrior,arms,50,24,26
Volkz,ragnaros,1236,warrior,arms,30,13,17
Winjerrywin,frostwolf,1235,warrior,arms,22,16,6
Hoodlord,tichondrius,1234,warrior,arms,54,24,30
Skumwarr,moon-guard,1234,warrior,arms,46,18,28
Märkdî,quelthalas,1233,warrior,arms,24,13,11
Crustyfella,stormrage,1233,warrior,arms,24,13,11
Standsonkegs,illidan,1233,warrior,arms,30,13,17
Pandaniela,area-52,1232,warrior,arms,30,18,12
Gale,kelthuzad,1232,warrior,arms,24,13,11
Goldbêrg,malganis,1232,warrior,arms,24,13,11
Wankcelot,kiljaeden,1231,warrior,arms,48,21,27
Joed,quelthalas,1230,warrior,arms,35,18,17
Gorash,gundrak,1230,warrior,arms,69,33,36
Fatty,mugthol,1229,warrior,arms,18,13,5
Konraad,amanthul,1229,warrior,arms,30,13,17
Awkagar,hyjal,1228,warrior,arms,23,13,10
Chilicezo,durotan,1228,warrior,arms,41,22,19
Dji,tichondrius,1228,warrior,arms,215,102,113
Ninefingers,madoran,1226,warrior,arms,24,13,11
Catastrophie,mugthol,1226,warrior,arms,36,14,22
Rägar,quelthalas,1224,warrior,arms,24,13,11
Tunchi,runetotem,1224,warrior,arms,90,47,43
Tommytimbo,destromath,1224,warrior,arms,31,13,18
Armorlancer,stormrage,1223,warrior,arms,24,13,11
Diamict,wyrmrest-accord,1221,warrior,arms,18,13,5
Daymiian,blackrock,1221,warrior,arms,30,13,17
Rekcd,sargeras,1217,warrior,arms,18,13,5
Urscrewed,frostmane,1217,warrior,arms,35,13,22
Hikikomori,goldrinn,1214,warrior,arms,41,20,21
Vâìn,tichondrius,1214,warrior,arms,34,15,19
Dippindabz,area-52,1213,warrior,arms,47,26,21
Gíal,ragnaros,1213,warrior,arms,58,22,36
Truongx,kiljaeden,1212,warrior,arms,24,14,10
Franc,kiljaeden,1212,warrior,arms,29,14,15
Ediict,illidan,1212,warrior,arms,29,13,16
Deomer,quelthalas,1211,warrior,arms,30,14,16
Geoorg,ragnaros,1209,warrior,arms,53,24,29
Flycosmos,tichondrius,1208,warrior,arms,44,22,22
Rageloading,amanthul,1208,warrior,arms,36,18,18
Baadomishram,ragnaros,1208,warrior,arms,30,14,16
Fkndog,tichondrius,1203,warrior,arms,60,28,32
Bifilar,frostmourne,1203,warrior,arms,30,14,16
Vapòr,frostmourne,1201,warrior,arms,24,14,10
Tenskj,proudmoore,1199,warrior,arms,27,14,13
Friendnoodle,frostmourne,1199,warrior,arms,59,28,31
Aclipse,nagrand,1197,warrior,arms,65,34,31
Nosetackle,area-52,1197,warrior,arms,58,29,29
Torkus,ragnaros,1197,warrior,arms,28,14,14
Sherway,quelthalas,1193,warrior,arms,191,94,97
Bazironbeard,ravencrest,1190,warrior,arms,17,13,4
Annaliyah,wyrmrest-accord,1190,warrior,arms,66,36,30
Areiden,sargeras,1190,warrior,arms,48,16,32
Groxxigore,chogall,1189,warrior,arms,48,24,24
Njjszn,thrall,1189,warrior,arms,138,68,70
Barricade,velen,1189,warrior,arms,107,48,59
Gohawn,hyjal,1186,warrior,arms,37,20,17
Âmânthul,alexstrasza,1186,warrior,arms,134,72,62
Lozakuran,tichondrius,1185,warrior,arms,30,14,16
Lazyclap,nagrand,1184,warrior,arms,35,18,17
Hadesz,nazjatar,1183,warrior,arms,71,34,37
Lícketysplít,ysondre,1182,warrior,arms,22,13,9
Cowbøycrytoo,azralon,1182,warrior,arms,88,46,42
Kannerhus,quelthalas,1182,warrior,arms,41,18,23
Aelrog,malganis,1180,warrior,arms,100,52,48
Tunasurprize,stormrage,1180,warrior,arms,27,13,14
Archonian,stormscale,1177,warrior,arms,34,21,13
Babybears,tichondrius,1177,warrior,arms,32,13,19
Orsex,ragnaros,1176,warrior,arms,26,13,13
Robotríp,illidan,1175,warrior,arms,42,18,24
Zarrock,emerald-dream,1174,warrior,arms,26,14,12
Süspicious,malfurion,1174,warrior,arms,35,14,21
Ãleister,stormrage,1174,warrior,arms,45,17,28
Tÿ,haomarush,1172,warrior,arms,25,14,11
Philbert,alexstrasza,1172,warrior,arms,39,21,18
Bigolpeen,sargeras,1172,warrior,arms,36,19,17
Droogust,tichondrius,1172,warrior,arms,30,15,15
Rebelzudo,azralon,1171,warrior,arms,30,18,12
Rauh,emerald-dream,1171,warrior,arms,22,13,9
Thedargz,trollbane,1170,warrior,arms,110,58,52
Medusaann,proudmoore,1166,warrior,arms,33,15,18
Adunken,ragnaros,1165,warrior,arms,30,17,13
Grömäash,ragnaros,1165,warrior,arms,32,13,19
Cocainiouz,dalaran,1164,warrior,arms,36,16,20
Daddymoist,moon-guard,1163,warrior,arms,54,24,30
Gongos,doomhammer,1161,warrior,arms,207,107,100
Mortilant,perenolde,1160,warrior,arms,75,34,41
Akunaswar,dalaran,1159,warrior,arms,65,27,38
Ambiss,azjolnerub,1157,warrior,arms,35,16,19
Xyazhiro,ragnaros,1156,warrior,arms,60,27,33
Elpish,ragnaros,1153,warrior,arms,54,25,29
Magnuszx,zuljin,1152,warrior,arms,18,12,6
Atomiclol,area-52,1151,warrior,arms,18,12,6
Wewladdie,malganis,1151,warrior,arms,18,12,6
Tokugawaieya,nemesis,1151,warrior,arms,24,12,12
Rogôsh,tichondrius,1151,warrior,arms,30,12,18
Baitson,hyjal,1151,warrior,arms,30,12,18
Hàru,illidan,1150,warrior,arms,18,12,6
Einnarr,tichondrius,1150,warrior,arms,19,12,7
Nexgenwar,destromath,1150,warrior,arms,24,12,12
Malakaimapk,korgath,1150,warrior,arms,24,12,12
Pocserwar,drakkari,1150,warrior,arms,24,12,12
Recktko,sargeras,1150,warrior,arms,33,13,20
Nyloras,illidan,1150,warrior,arms,34,13,21
Jarheadz,bleeding-hollow,1150,warrior,arms,35,12,23
Gordofofo,azralon,1149,warrior,arms,18,12,6
Scaredwarr,stormrage,1149,warrior,arms,45,24,21
Montibello,moon-guard,1149,warrior,arms,24,12,12
Arixos,frostmourne,1149,warrior,arms,24,12,12
Retrospex,black-dragonflight,1148,warrior,arms,24,12,12
Kamuwarr,azralon,1148,warrior,arms,24,12,12
Woth,deathwing,1148,warrior,arms,24,12,12
Suicider,stormrage,1148,warrior,arms,30,12,18
Vodkagoblin,sargeras,1147,warrior,arms,24,12,12
Misclickëd,dalaran,1147,warrior,arms,24,12,12
Marsoc,burning-legion,1147,warrior,arms,24,12,12
Virillius,wyrmrest-accord,1147,warrior,arms,28,13,15
Jianhung,tichondrius,1147,warrior,arms,30,12,18
Hektar,tichondrius,1146,warrior,arms,18,12,6
Stompyocouch,mugthol,1146,warrior,arms,21,13,8
Slivers,stormrage,1146,warrior,arms,24,13,11
Furryhorv,frostmourne,1146,warrior,arms,24,12,12
Boypartz,onyxia,1146,warrior,arms,36,12,24
Ragnarloðbró,tichondrius,1146,warrior,arms,36,12,24
Skittlesxo,bleeding-hollow,1144,warrior,arms,24,12,12
Ujumpijump,andorhal,1144,warrior,arms,60,22,38
Invared,stormrage,1143,warrior,arms,18,12,6
Vamtoro,illidan,1143,warrior,arms,22,13,9
Ginthril,magtheridon,1143,warrior,arms,37,12,25
Lucidx,malfurion,1142,warrior,arms,18,12,6
Nibbzy,sargeras,1142,warrior,arms,18,12,6
Sigfir,ragnaros,1142,warrior,arms,24,12,12
Realthiccbbw,tichondrius,1142,warrior,arms,24,12,12
Haldeer,shadow-council,1142,warrior,arms,24,12,12
Carnith,arthas,1142,warrior,arms,30,12,18
Yisunshin,azralon,1141,warrior,arms,24,12,12
Elmosmash,thrall,1141,warrior,arms,24,12,12
Hblock,barthilas,1140,warrior,arms,30,12,18
Brocc,tichondrius,1139,warrior,arms,24,12,12
Brownman,saurfang,1139,warrior,arms,30,12,18
Dreweth,altar-of-storms,1138,warrior,arms,18,12,6
Sloppyglucks,moon-guard,1138,warrior,arms,24,12,12
Selathiel,burning-blade,1138,warrior,arms,34,13,21
Warrimon,nemesis,1138,warrior,arms,36,12,24
Tappia,quelthalas,1138,warrior,arms,36,12,24
Dizgraceful,malganis,1137,warrior,arms,18,12,6
Soggynapkin,proudmoore,1136,warrior,arms,30,17,13
Zulgadark,ragnaros,1136,warrior,arms,39,15,24
Sudavis,alleria,1135,warrior,arms,29,20,9
Theregulator,area-52,1135,warrior,arms,58,29,29
Anotee,kelthuzad,1134,warrior,arms,93,48,45
Drahconian,aggramar,1134,warrior,arms,24,12,12
Shattering,fizzcrank,1134,warrior,arms,24,12,12
Demðnslayer,kelthuzad,1134,warrior,arms,54,24,30
Cecchino,zuluhed,1133,warrior,arms,24,12,12
Tripleblack,mugthol,1132,warrior,arms,18,12,6
Isildur,nerzhul,1132,warrior,arms,36,20,16
Bigsvit,trollbane,1131,warrior,arms,60,29,31
Spritez,malganis,1131,warrior,arms,70,27,43
Logi,alexstrasza,1130,warrior,arms,30,12,18
Stoul,illidan,1129,warrior,arms,24,18,6
Thelgrath,quelthalas,1129,warrior,arms,84,35,49
Lunks,kelthuzad,1128,warrior,arms,18,12,6
Dsz,nemesis,1128,warrior,arms,29,13,16
Yuccaleaptus,area-52,1128,warrior,arms,71,30,41
Bulletfodder,tichondrius,1127,warrior,arms,24,12,12
Jhave,ragnaros,1124,warrior,arms,32,13,19
Mfmuggz,thunderlord,1124,warrior,arms,35,14,21
Unbeatablezs,tichondrius,1123,warrior,arms,30,13,17
Slumdawgg,andorhal,1119,warrior,arms,59,32,27
Clovê,ragnaros,1118,warrior,arms,36,21,15
Småckin,frostmourne,1118,warrior,arms,24,13,11
Roughknuckle,kelthuzad,1118,warrior,arms,23,12,11
Tyránny,stormrage,1118,warrior,arms,35,12,23
Warrdawg,tichondrius,1117,warrior,arms,24,12,12
Rahtahtas,area-52,1116,warrior,arms,24,12,12
Bussundas,azralon,1116,warrior,arms,54,25,29
Thunderclapz,stormscale,1114,warrior,arms,24,12,12
Looffy,saurfang,1114,warrior,arms,30,12,18
Casteleiro,azralon,1112,warrior,arms,32,13,19
Alejandros,azgalor,1111,warrior,arms,23,12,11
Warriorlee,jubeithos,1111,warrior,arms,44,19,25
Târtàrûs,tichondrius,1108,warrior,arms,24,15,9
Garìk,moon-guard,1108,warrior,arms,51,17,34
Youtank,kiljaeden,1105,warrior,arms,72,33,39
Dvhwec,tichondrius,1105,warrior,arms,28,12,16
Odinsglory,mugthol,1105,warrior,arms,54,18,36
Ragebladë,tichondrius,1103,warrior,arms,48,28,20
Riga,tichondrius,1102,warrior,arms,48,24,24
Thebeastwar,area-52,1101,warrior,arms,36,19,17
Tipincider,perenolde,1100,warrior,arms,21,12,9
Raserei,moonrunner,1098,warrior,arms,75,35,40
Panzerian,area-52,1097,warrior,arms,37,14,23
Tyrantwolf,ragnaros,1097,warrior,arms,45,17,28
Theøcritus,korgath,1096,warrior,arms,42,25,17
Sugarpanties,moon-guard,1095,warrior,arms,57,20,37
Knocks,blackrock,1094,warrior,arms,21,13,8
Melankoma,sargeras,1094,warrior,arms,30,12,18
Arrogated,emerald-dream,1093,warrior,arms,90,44,46
Royye,blood-furnace,1088,warrior,arms,24,12,12
Bloodbath,kiljaeden,1086,warrior,arms,23,12,11
Bløødy,lethon,1084,warrior,arms,14,12,2
Kempachii,ragnaros,1083,warrior,arms,82,40,42
Aquannas,bloodscalp,1082,warrior,arms,24,14,10
Pingorosho,quelthalas,1082,warrior,arms,36,16,20
Malok,deathwing,1082,warrior,arms,57,20,37
Inunotaysho,quelthalas,1081,warrior,arms,30,12,18
Flexakute,malganis,1080,warrior,arms,20,12,8
Rockedanger,stormrage,1080,warrior,arms,26,15,11
Riuk,goldrinn,1080,warrior,arms,29,16,13
Raharon,chogall,1079,warrior,arms,52,20,32
Gorfin,spirestone,1077,warrior,arms,42,12,30
Purefury,whisperwind,1076,warrior,arms,93,41,52
Several,whisperwind,1073,warrior,arms,39,23,16
Ødïñ,sargeras,1071,warrior,arms,75,37,38
Mezi,tichondrius,1069,warrior,arms,23,12,11
Colosal,drakkari,1068,warrior,arms,21,14,7
Handkerchief,bleeding-hollow,1068,warrior,arms,25,12,13
Úmarth,azralon,1062,warrior,arms,48,21,27
Ugrundan,zuljin,1061,warrior,arms,48,21,27
Hagud,tichondrius,1061,warrior,arms,29,12,17
Imcute,senjin,1058,warrior,arms,60,21,39
Midorikwa,area-52,1056,warrior,arms,18,11,7
Evanx,sargeras,1056,warrior,arms,24,11,13
Jehocc,tichondrius,1056,warrior,arms,24,11,13
Wizcleavuh,area-52,1056,warrior,arms,24,11,13
Pkgd,tichondrius,1055,warrior,arms,12,11,1
Deathsteelw,zuljin,1055,warrior,arms,18,11,7
Dutchyy,frostmourne,1055,warrior,arms,18,11,7
Nerdstorm,tichondrius,1055,warrior,arms,18,11,7
Turtlestorm,tichondrius,1055,warrior,arms,18,11,7
Gladiator,azshara,1055,warrior,arms,18,11,7
Bûm,sargeras,1055,warrior,arms,18,11,7
Carriney,illidan,1055,warrior,arms,77,36,41
Duckyuwu,tichondrius,1055,warrior,arms,24,11,13
Mantrà,skullcrusher,1055,warrior,arms,24,11,13
Bigdad,whisperwind,1055,warrior,arms,24,11,13
Omnïslash,tichondrius,1055,warrior,arms,24,11,13
Wheyprotein,illidan,1055,warrior,arms,24,11,13
Feedzz,area-52,1055,warrior,arms,24,11,13
Laddèrx,area-52,1055,warrior,arms,24,11,13
Abomlnatlon,tichondrius,1055,warrior,arms,24,11,13
Tankomode,area-52,1055,warrior,arms,24,11,13
Chopped,wyrmrest-accord,1054,warrior,arms,18,11,7
Vooné,tichondrius,1054,warrior,arms,18,11,7
Exorbit,sargeras,1054,warrior,arms,18,11,7
Wurua,tichondrius,1054,warrior,arms,24,11,13
Wargasms,alterac-mountains,1054,warrior,arms,24,11,13
Skolltonxoxo,tichondrius,1054,warrior,arms,30,11,19
Wolfsrage,frostmourne,1054,warrior,arms,30,11,19
Ttl,dalaran,1053,warrior,arms,18,11,7
Orctiddy,emerald-dream,1053,warrior,arms,18,11,7
Haxzors,sargeras,1053,warrior,arms,24,11,13
Mavrus,malganis,1053,warrior,arms,24,11,13
Awm,wyrmrest-accord,1053,warrior,arms,24,11,13
Môrôdin,area-52,1053,warrior,arms,30,11,19
Karrosh,agamaggan,1052,warrior,arms,24,11,13
Theisius,tichondrius,1052,warrior,arms,27,11,16
Eternalwill,rexxar,1051,warrior,arms,18,11,7
Sharpen,terokkar,1051,warrior,arms,18,11,7
Drillbit,wyrmrest-accord,1051,warrior,arms,30,11,19
Boocawkeyy,illidan,1051,warrior,arms,30,11,19
Georgedubya,illidan,1051,warrior,arms,36,11,25
Thecolor,tichondrius,1050,warrior,arms,30,11,19
Myceliumlog,frostmourne,1049,warrior,arms,18,11,7
Týrodar,moon-guard,1049,warrior,arms,24,11,13
Gadderhammer,azgalor,1049,warrior,arms,42,17,25
Snewdawg,malganis,1048,warrior,arms,22,12,10
Rathty,shadowsong,1048,warrior,arms,24,11,13
Noktyn,haomarush,1048,warrior,arms,24,11,13
Kanekhy,ragnaros,1048,warrior,arms,24,11,13
Pum,bleeding-hollow,1048,warrior,arms,24,11,13
Genesisxp,barthilas,1048,warrior,arms,24,11,13
Kushhy,illidan,1048,warrior,arms,33,12,21
Bøgz,kelthuzad,1047,warrior,arms,18,11,7
Bouk,bloodscalp,1047,warrior,arms,18,11,7
Dwarfanage,tichondrius,1047,warrior,arms,28,12,16
Prunebery,area-52,1046,warrior,arms,30,16,14
Blaxst,gorgonnash,1046,warrior,arms,30,16,14
Nirax,burning-legion,1046,warrior,arms,26,11,15
Eiendira,proudmoore,1045,warrior,arms,30,11,19
Orphasmic,moon-guard,1044,warrior,arms,36,11,25
Homicideted,frostmourne,1043,warrior,arms,18,11,7
Brostormftw,shattered-halls,1043,warrior,arms,24,11,13
Yiffathon,wyrmrest-accord,1043,warrior,arms,24,11,13
Puertorc,ragnaros,1043,warrior,arms,30,12,18
Thedin,gorefiend,1043,warrior,arms,42,11,31
Bloodfx,darkspear,1042,warrior,arms,87,36,51
Creator,dalaran,1041,warrior,arms,24,11,13
Hunnam,illidan,1041,warrior,arms,30,11,19
Stolz,dragonmaw,1040,warrior,arms,24,11,13
Dylaiin,kelthuzad,1038,warrior,arms,30,11,19
Wrekkshop,tichondrius,1037,warrior,arms,27,13,14
Wrrx,frostmourne,1037,warrior,arms,24,11,13
Jamil,illidan,1037,warrior,arms,66,29,37
Bloodwish,stormrage,1036,warrior,arms,18,11,7
Møønnlight,quelthalas,1035,warrior,arms,35,11,24
Regthar,illidan,1034,warrior,arms,23,11,12
Indoondabeat,azgalor,1034,warrior,arms,32,15,17
Sllvrbck,tichondrius,1032,warrior,arms,22,12,10
Nobowar,tichondrius,1032,warrior,arms,24,11,13
Fûry,tichondrius,1032,warrior,arms,42,18,24
Potan,thrall,1030,warrior,arms,60,25,35
Märiä,ragnaros,1028,warrior,arms,52,27,25
Cronie,steamwheedle-cartel,1027,warrior,arms,36,16,20
Nøzerker,kelthuzad,1020,warrior,arms,26,12,14
Tyrantt,malganis,1019,warrior,arms,30,13,17
Guanyúu,tichondrius,1017,warrior,arms,23,11,12
Stygïàn,draenor,1016,warrior,arms,80,45,35
Galuf,malygos,1014,warrior,arms,18,11,7
Marcolatus,ragnaros,1012,warrior,arms,42,17,25
Tucô,skullcrusher,1010,warrior,arms,43,20,23
Psýchótic,tichondrius,1009,warrior,arms,23,11,12
Halis,illidan,1006,warrior,arms,21,13,8
Erdres,kelthuzad,1006,warrior,arms,21,11,10
Blackstamp,tichondrius,1006,warrior,arms,35,18,17
Hexenbæne,tichondrius,1006,warrior,arms,23,11,12
Danzohh,dalaran,1006,warrior,arms,27,11,16
Titanrage,tichondrius,1004,warrior,arms,21,11,10
Starplatinum,aerie-peak,1004,warrior,arms,32,11,21
Vicor,ragnaros,1003,warrior,arms,24,14,10
Gorepig,sargeras,1002,warrior,arms,29,11,18
Deathsmirk,illidan,1001,warrior,arms,49,25,24
Kreeper,farstriders,1001,warrior,arms,23,11,12
Irishhammer,malfurion,999,warrior,arms,29,11,18
Tribbally,silver-hand,998,warrior,arms,17,11,6
Goofyahwok,doomhammer,998,warrior,arms,33,12,21
Lokityr,tichondrius,996,warrior,arms,48,19,29
Altruiel,sargeras,995,warrior,arms,40,20,20
Joran,dathremar,995,warrior,arms,32,14,18
Estivador,kelthuzad,995,warrior,arms,32,12,20
Kyritto,azralon,994,warrior,arms,35,18,17
Orkuduro,azralon,993,warrior,arms,77,37,40
Tmhinfen,tichondrius,991,warrior,arms,16,11,5
Elsamok,ragnaros,991,warrior,arms,17,11,6
Szee,tichondrius,991,warrior,arms,17,11,6
Jragonmaster,borean-tundra,991,warrior,arms,36,13,23
Neekka,tichondrius,990,warrior,arms,28,12,16
Kalaxe,quelthalas,990,warrior,arms,36,11,25
Midge,proudmoore,988,warrior,arms,65,31,34
Hemone,frostmourne,986,warrior,arms,24,11,13
Huri,nemesis,985,warrior,arms,26,13,13
Skornnd,malganis,985,warrior,arms,26,11,15
Budzie,frostwolf,984,warrior,arms,22,11,11
Darkthok,drakkari,982,warrior,arms,34,15,19
Sneaknyoface,sargeras,982,warrior,arms,26,11,15
Southmariner,malganis,981,warrior,arms,24,13,11
Sudokubrain,tichondrius,974,warrior,arms,19,11,8
Axedeity,caelestrasz,974,warrior,arms,24,13,11
Djfredsd,tichondrius,972,warrior,arms,13,11,2
Nitechaos,thrall,972,warrior,arms,19,12,7
Sherrywalken,azralon,960,warrior,arms,12,10,2
Escanòr,malganis,960,warrior,arms,18,10,8
Adios,tichondrius,960,warrior,arms,18,10,8
Varrior,wyrmrest-accord,960,warrior,arms,18,10,8
Battousäi,kiljaeden,960,warrior,arms,18,10,8
Facefïster,malganis,960,warrior,arms,18,10,8
Szew,tichondrius,960,warrior,arms,18,10,8
Codyjones,illidan,960,warrior,arms,18,10,8
Sowavey,korgath,960,warrior,arms,18,10,8
ßdm,illidan,960,warrior,arms,24,10,14
Choppin,sargeras,960,warrior,arms,24,10,14
Wargázm,thrall,960,warrior,arms,24,10,14
Iløveaysla,azralon,960,warrior,arms,30,10,20
Cúdi,darkspear,959,warrior,arms,12,10,2
Tmjakeful,area-52,959,warrior,arms,18,10,8
Bamxz,sargeras,959,warrior,arms,18,10,8
Tantei,moon-guard,959,warrior,arms,18,10,8
Bigdumborc,tichondrius,959,warrior,arms,18,10,8
Scran,sargeras,959,warrior,arms,18,10,8
Kaìju,dragonmaw,959,warrior,arms,18,10,8
Drdelicious,tichondrius,959,warrior,arms,24,10,14
Jiszle,sargeras,959,warrior,arms,30,10,20
Elsee,drakkari,959,warrior,arms,42,10,32
Arrtorias,quelthalas,958,warrior,arms,12,10,2
Nickfurie,emerald-dream,958,warrior,arms,18,10,8
Icrìtmypants,dragonmaw,958,warrior,arms,18,10,8
Glacierrsz,sargeras,958,warrior,arms,18,10,8
Säbeër,ragnaros,958,warrior,arms,18,10,8
Macray,proudmoore,958,warrior,arms,18,10,8
Retrostorm,illidan,958,warrior,arms,18,10,8
Skollyd,tichondrius,958,warrior,arms,22,11,11
Ryank,bonechewer,958,warrior,arms,24,10,14
Icestormray,illidan,958,warrior,arms,24,10,14
Moozz,dreadmaul,958,warrior,arms,24,10,14
Maintarget,malganis,958,warrior,arms,29,10,19
Razakamx,tichondrius,957,warrior,arms,12,10,2
Vecira,moon-guard,957,warrior,arms,18,10,8
Sìkarío,illidan,957,warrior,arms,18,10,8
Whórm,kelthuzad,957,warrior,arms,18,10,8
Leapsalp,proudmoore,957,warrior,arms,18,10,8
Bryk,korgath,957,warrior,arms,18,10,8
Tooto,kelthuzad,957,warrior,arms,18,10,8
Bionikus,nemesis,957,warrior,arms,78,33,45
Pootybeef,daggerspine,957,warrior,arms,24,10,14
Aberwarr,illidan,956,warrior,arms,18,10,8
Carrito,perenolde,956,warrior,arms,29,16,13
Numb,moon-guard,956,warrior,arms,26,11,15
Torbajhorn,moon-guard,956,warrior,arms,24,10,14
Aisinbro,illidan,956,warrior,arms,24,10,14
Gerztok,aggramar,956,warrior,arms,24,10,14
Ermeji,ragnaros,956,warrior,arms,24,10,14
Warrbull,spirestone,956,warrior,arms,30,10,20
Vayper,illidan,954,warrior,arms,24,10,14
Starshattr,bleeding-hollow,954,warrior,arms,30,10,20
Coffeebottom,wyrmrest-accord,953,warrior,arms,18,10,8
Toky,malganis,952,warrior,arms,18,10,8
Makcumba,ragnaros,952,warrior,arms,18,10,8
Aaltara,barthilas,951,warrior,arms,18,10,8
Helaume,arathor,950,warrior,arms,18,10,8
Discopogo,nemesis,950,warrior,arms,24,10,14
Waabi,emerald-dream,949,warrior,arms,18,10,8
Thråsh,area-52,948,warrior,arms,42,18,24
Axharafuji,dalvengyr,947,warrior,arms,24,10,14
Digitalpsyko,hyjal,946,warrior,arms,18,10,8
Swiftynifty,area-52,946,warrior,arms,30,14,16
Iblowloads,illidan,942,warrior,arms,18,10,8
Meatdrps,frostmane,941,warrior,arms,26,11,15
Thing,gorgonnash,941,warrior,arms,24,10,14
Pumpuup,bleeding-hollow,941,warrior,arms,30,12,18
Vezixx,dragonmaw,939,warrior,arms,18,10,8
Dragmös,nemesis,937,warrior,arms,12,10,2
Brutallypwnd,tichondrius,936,warrior,arms,29,16,13
Mariò,area-52,934,warrior,arms,18,10,8
Tramplehaste,barthilas,931,warrior,arms,18,10,8
Lieutemajor,nemesis,931,warrior,arms,25,11,14
Sseobeon,tichondrius,928,warrior,arms,22,10,12
Pocketaxe,blackwater-raiders,927,warrior,arms,83,40,43
Gargameld,stormrage,925,warrior,arms,42,20,22
Warrshield,ragnaros,921,warrior,arms,28,10,18
Velliena,tichondrius,916,warrior,arms,32,11,21
Jindyn,boulderfist,912,warrior,arms,52,24,28
Skarkla,thrall,911,warrior,arms,29,10,19
Valde,stormrage,910,warrior,arms,21,10,11
Jägernaught,stormrage,910,warrior,arms,23,10,13
Kratosxx,quelthalas,909,warrior,arms,23,10,13
Tandiko,wyrmrest-accord,908,warrior,arms,17,10,7
Spitts,frostmourne,904,warrior,arms,21,10,11
Dissx,illidan,903,warrior,arms,21,11,10
Atrocithy,ragnaros,896,warrior,arms,16,10,6
Yagura,emerald-dream,896,warrior,arms,22,10,12
Girioo,thrall,895,warrior,arms,14,10,4
Krokgoldmane,drakkari,893,warrior,arms,36,17,19
Malathire,illidan,893,warrior,arms,22,10,12
Wallzar,sargeras,887,warrior,arms,20,10,10
Gulgosh,stormscale,879,warrior,arms,17,10,7
Orcbreaker,quelthalas,878,warrior,arms,26,10,16
Breyns,garrosh,875,warrior,arms,19,10,9
Sígmar,dreadmaul,869,warrior,arms,18,10,8
Moonyxx,frostmourne,864,warrior,arms,12,9,3
Youngmoneyd,illidan,864,warrior,arms,12,9,3
Dripgodx,malganis,864,warrior,arms,12,9,3
Dedgamesucks,darkspear,864,warrior,arms,12,9,3
Thuggyfresh,malganis,864,warrior,arms,12,9,3
Tigris,nesingwary,864,warrior,arms,12,9,3
Potero,ragnaros,864,warrior,arms,18,9,9
Gorek,illidan,864,warrior,arms,18,9,9
Moxxyy,tichondrius,864,warrior,arms,18,9,9
Ârmstrong,quelthalas,864,warrior,arms,18,9,9
Mlau,tichondrius,864,warrior,arms,18,9,9
Alchera,fizzcrank,864,warrior,arms,18,9,9
Stÿgian,blood-furnace,864,warrior,arms,18,9,9
Scoopdog,stormrage,864,warrior,arms,18,9,9
Warwagon,the-underbog,864,warrior,arms,18,9,9
Miniraccoon,tichondrius,864,warrior,arms,18,9,9
Oxia,quelthalas,864,warrior,arms,18,9,9
Warrmoose,tichondrius,864,warrior,arms,24,9,15
Sejac,moon-guard,864,warrior,arms,24,9,15
Kolossus,korgath,864,warrior,arms,24,9,15
Feiler,ragnaros,864,warrior,arms,24,9,15
Dustywx,area-52,864,warrior,arms,24,9,15
Reave,wyrmrest-accord,863,warrior,arms,12,9,3
Zaynafein,emerald-dream,863,warrior,arms,18,9,9
Nosoraki,thrall,863,warrior,arms,18,9,9
Suntore,malganis,863,warrior,arms,18,9,9
Chrom,illidan,863,warrior,arms,18,9,9
Odiseo,ragnaros,863,warrior,arms,18,9,9
Terneitor,ragnaros,863,warrior,arms,18,9,9
Bowlingball,darkspear,863,warrior,arms,18,9,9
Tâte,sargeras,863,warrior,arms,18,9,9
Illicitkillz,destromath,863,warrior,arms,18,9,9
Demonsláyer,illidan,863,warrior,arms,18,9,9
Erradic,sargeras,863,warrior,arms,18,9,9
Venecus,stormrage,863,warrior,arms,18,9,9
Erdnase,ragnaros,863,warrior,arms,18,9,9
Spincycle,khadgar,863,warrior,arms,21,9,12
Kelmor,thunderhorn,863,warrior,arms,24,9,15
Notoxzy,tichondrius,863,warrior,arms,24,9,15
Ðirtyboy,tichondrius,863,warrior,arms,24,9,15
Brokthard,ragnaros,863,warrior,arms,24,9,15
Wrecktang,tichondrius,863,warrior,arms,24,9,15
Abidis,tichondrius,863,warrior,arms,30,9,21
Kilrok,thunderlord,863,warrior,arms,30,9,21
Warwslayer,tichondrius,863,warrior,arms,30,9,21
Nyuk,tichondrius,862,warrior,arms,15,9,6
Caupølican,ragnaros,862,warrior,arms,18,9,9
Xargosh,magtheridon,862,warrior,arms,18,9,9
Cptstarship,sargeras,862,warrior,arms,18,9,9
Wargorin,bleeding-hollow,862,warrior,arms,18,9,9
Um,moon-guard,862,warrior,arms,18,9,9
Hazew,kelthuzad,862,warrior,arms,18,9,9
Xurc,gnomeregan,862,warrior,arms,24,9,15
Lögän,azralon,862,warrior,arms,24,9,15
Topmeoff,bleeding-hollow,862,warrior,arms,24,9,15
Wárriór,tichondrius,862,warrior,arms,24,9,15
Malvadin,stormrage,862,warrior,arms,30,9,21
Balakay,drenden,861,warrior,arms,12,9,3
Bananae,stormrage,861,warrior,arms,15,10,5
Jodoro,malfurion,861,warrior,arms,18,9,9
Overfury,azralon,861,warrior,arms,18,9,9
Kror,garona,861,warrior,arms,18,9,9
Rhagnael,malganis,861,warrior,arms,24,9,15
Gunnaoffxans,sargeras,860,warrior,arms,18,9,9
Durtmcsmash,stormrage,860,warrior,arms,18,9,9
Stormit,illidan,860,warrior,arms,19,9,10
Umogarmac,draktharon,860,warrior,arms,24,9,15
Marnan,quelthalas,860,warrior,arms,24,9,15
Layllassa,moon-guard,860,warrior,arms,24,9,15
Lokiilloo,drakkari,859,warrior,arms,15,10,5
Nishtana,quelthalas,859,warrior,arms,18,9,9
Vio,mannoroth,859,warrior,arms,18,9,9
Depthsii,lightbringer,859,warrior,arms,18,9,9
Deadhawk,wyrmrest-accord,859,warrior,arms,30,9,21
Arm,stormscale,859,warrior,arms,30,9,21
Tolette,quelthalas,858,warrior,arms,18,9,9
Féril,ragnaros,858,warrior,arms,18,9,9
Tinyguysmall,eredar,857,warrior,arms,22,11,11
Arthknight,ragnaros,857,warrior,arms,18,9,9
Kaimana,zuljin,857,warrior,arms,18,9,9
Kapalua,darkspear,857,warrior,arms,19,9,10
Joshums,warsong,857,warrior,arms,26,10,16
Karusuke,stormrage,857,warrior,arms,24,9,15
Éllenor,azralon,856,warrior,arms,18,9,9
Broxhar,ragnaros,856,warrior,arms,18,9,9
Eorik,stormrage,856,warrior,arms,36,9,27
Daytime,scilla,855,warrior,arms,18,9,9
Hkbdynamus,black-dragonflight,855,warrior,arms,24,9,15
Preschool,sargeras,854,warrior,arms,12,9,3
Hintofmint,tichondrius,854,warrior,arms,18,9,9
Sartin,boulderfist,854,warrior,arms,30,9,21
Garusok,thrall,853,warrior,arms,12,9,3
Asiyurekhans,borean-tundra,851,warrior,arms,12,9,3
Tsebaoth,quelthalas,851,warrior,arms,30,10,20
Jaimey,malganis,845,warrior,arms,23,9,14
Rainiki,stormrage,845,warrior,arms,24,9,15
Whiteclouds,blood-furnace,844,warrior,arms,42,17,25
Macdollibee,barthilas,834,warrior,arms,18,9,9
Battlestance,shadowsong,831,warrior,arms,23,9,14
Swamphell,barthilas,831,warrior,arms,31,9,22
Soulcalibur,zuljin,830,warrior,arms,23,9,14
Túrin,quelthalas,829,warrior,arms,28,9,19
Verigislena,moon-guard,827,warrior,arms,20,10,10
Ightdoex,zuljin,825,warrior,arms,14,10,4
Xwoyer,malganis,825,warrior,arms,22,11,11
Eskama,hyjal,823,warrior,arms,23,9,14
Hjoz,illidan,822,warrior,arms,16,9,7
Bargorengar,skullcrusher,814,warrior,arms,78,34,44
Paí,nemesis,808,warrior,arms,17,9,8
Gigazug,stormrage,799,warrior,arms,20,9,11
Rahj,saurfang,799,warrior,arms,20,9,11
Fatmân,tichondrius,798,warrior,arms,22,9,13
Zuljikan,illidan,798,warrior,arms,23,9,14
Murrdock,nesingwary,794,warrior,arms,14,9,5
Rhydonero,azralon,791,warrior,arms,17,9,8
Vandalizer,sargeras,788,warrior,arms,20,10,10
Hanzmat,illidan,768,warrior,arms,12,8,4
Åthos,illidan,768,warrior,arms,12,8,4
Dadslapper,illidan,768,warrior,arms,12,8,4
Executiepie,hyjal,768,warrior,arms,12,8,4
Zleam,area-52,768,warrior,arms,12,8,4
Janjannodie,tichondrius,768,warrior,arms,12,8,4
Traglos,ragnaros,768,warrior,arms,12,8,4
Slvrback,stormrage,768,warrior,arms,12,8,4
Ikitee,zuljin,768,warrior,arms,12,8,4
Spinspin,borean-tundra,768,warrior,arms,12,8,4
Msallsunday,nerzhul,768,warrior,arms,12,8,4
Chestbrook,icecrown,768,warrior,arms,12,8,4
Saucebussin,emerald-dream,768,warrior,arms,12,8,4
Smallbrainx,tichondrius,768,warrior,arms,12,8,4
Zdokk,sargeras,768,warrior,arms,12,8,4
Patékphilípe,area-52,768,warrior,arms,12,8,4
Hashwar,area-52,768,warrior,arms,12,8,4
Hugeflopper,malganis,768,warrior,arms,12,8,4
Gabv,shadowmoon,768,warrior,arms,12,8,4
Leunitas,shadow-council,768,warrior,arms,18,8,10
Cuddlechamp,barthilas,768,warrior,arms,18,8,10
Elkz,tichondrius,768,warrior,arms,18,8,10
Betterwar,zuljin,768,warrior,arms,18,8,10
Thulsan,emerald-dream,768,warrior,arms,18,8,10
Chronek,sargeras,768,warrior,arms,18,8,10
Toxxel,wyrmrest-accord,768,warrior,arms,18,8,10
Crysis,malorne,768,warrior,arms,18,8,10
Dreadtøøth,tichondrius,768,warrior,arms,18,8,10
Tádakatsu,sargeras,768,warrior,arms,18,8,10
Elitistx,bleeding-hollow,768,warrior,arms,18,8,10
Easylel,stormrage,768,warrior,arms,18,8,10
Gízzmo,tichondrius,768,warrior,arms,18,8,10
Wârtorn,darkspear,768,warrior,arms,18,8,10
Elky,area-52,768,warrior,arms,18,8,10
Dtitanzz,quelthalas,768,warrior,arms,18,8,10
Onecho,tichondrius,768,warrior,arms,18,8,10
Deadhate,sargeras,768,warrior,arms,18,8,10
Tuggernaut,khadgar,768,warrior,arms,18,8,10
Supermieo,illidan,768,warrior,arms,18,8,10
Dirkdallas,tichondrius,768,warrior,arms,24,8,16
Ochinching,tichondrius,768,warrior,arms,24,8,16
Bornne,doomhammer,768,warrior,arms,30,8,22
Blazingguard,stormrage,767,warrior,arms,12,8,4
Theestallion,kiljaeden,767,warrior,arms,12,8,4
Rúz,illidan,767,warrior,arms,12,8,4
Angrybulky,illidan,767,warrior,arms,12,8,4
Nãrax,area-52,767,warrior,arms,12,8,4
Letsgosmokes,stormrage,767,warrior,arms,12,8,4
Wantor,lightnings-blade,767,warrior,arms,12,8,4
Executefreak,illidan,767,warrior,arms,12,8,4
Silac,drenden,767,warrior,arms,12,8,4
Pigblind,azralon,767,warrior,arms,12,8,4
Kàkarot,illidan,767,warrior,arms,12,8,4
Underbite,area-52,767,warrior,arms,12,8,4
Domminux,darkspear,767,warrior,arms,12,8,4
Azziiqt,stormrage,767,warrior,arms,12,8,4
Skizoid,kiljaeden,767,warrior,arms,12,8,4
Kixxel,sargeras,767,warrior,arms,12,8,4
Akkar,gilneas,767,warrior,arms,12,8,4
Zédelívery,azralon,767,warrior,arms,16,9,7
Itskinggrizz,thrall,767,warrior,arms,16,9,7
Empriux,quelthalas,767,warrior,arms,18,8,10
Cevadix,azralon,767,warrior,arms,18,8,10
Drusillaa,deathwing,767,warrior,arms,18,8,10
Croxxs,aegwynn,767,warrior,arms,18,8,10
Nanor,zuljin,767,warrior,arms,18,8,10
Logsplitter,stormrage,767,warrior,arms,18,8,10
Onionion,stormrage,767,warrior,arms,18,8,10
Ihazlolstorm,area-52,767,warrior,arms,18,8,10
Pípe,nemesis,767,warrior,arms,18,8,10
Moarbrainz,mannoroth,767,warrior,arms,18,8,10
Cagrekk,wyrmrest-accord,767,warrior,arms,18,8,10
Æwarrìor,tichondrius,767,warrior,arms,18,8,10
Orgreshin,area-52,767,warrior,arms,21,9,12
Saskouach,stormrage,767,warrior,arms,20,8,12
Brawnforce,shadowsong,767,warrior,arms,24,8,16
Techanina,aerie-peak,767,warrior,arms,24,8,16
Warriorc,laughing-skull,766,warrior,arms,12,8,4
Jackhanma,kelthuzad,766,warrior,arms,12,8,4
Zhasi,bonechewer,766,warrior,arms,12,8,4
Diãbel,azralon,766,warrior,arms,12,8,4
Ragarok,jubeithos,766,warrior,arms,12,8,4
Hemmyroidz,tichondrius,766,warrior,arms,18,8,10
Sálieri,ragnaros,766,warrior,arms,18,8,10
Rineer,tichondrius,766,warrior,arms,18,8,10
Rapralph,barthilas,766,warrior,arms,18,8,10
Donnacha,garona,766,warrior,arms,18,8,10
Rezzett,wyrmrest-accord,766,warrior,arms,21,9,12
Beatmeat,frostmourne,766,warrior,arms,24,8,16
Modzilla,aerie-peak,766,warrior,arms,30,8,22
Malystik,ragnaros,765,warrior,arms,12,8,4
Percthirty,blackrock,765,warrior,arms,18,8,10
Ligerii,quelthalas,765,warrior,arms,18,8,10
Jijiyeya,tichondrius,765,warrior,arms,24,8,16
Loktarrogar,illidan,765,warrior,arms,24,8,16
Alexarchos,chogall,764,warrior,arms,18,8,10
Pangean,sargeras,764,warrior,arms,18,8,10
Plssaveme,ysera,764,warrior,arms,24,8,16
Enthria,illidan,763,warrior,arms,12,8,4
Stalecrouton,doomhammer,763,warrior,arms,12,8,4
Friends,azjolnerub,763,warrior,arms,18,8,10
Sygw,area-52,763,warrior,arms,24,8,16
Dieselsauce,stormscale,762,warrior,arms,12,8,4
Sweetdeé,zuljin,762,warrior,arms,18,8,10
Tarmer,moon-guard,762,warrior,arms,18,8,10
Revenn,greymane,761,warrior,arms,12,8,4
Hunchless,detheroc,761,warrior,arms,22,8,14
Vynfull,area-52,760,warrior,arms,18,8,10
Rágnárr,ragnaros,759,warrior,arms,18,8,10
Brrzrrkrr,twisting-nether,757,warrior,arms,12,8,4
Trapwar,malganis,755,warrior,arms,12,8,4
Tankdatt,frostmourne,755,warrior,arms,18,8,10
Fleshtuxedo,stormrage,752,warrior,arms,12,8,4
Evoltoad,illidan,751,warrior,arms,29,8,21
Gladiattor,tol-barad,749,warrior,arms,18,8,10
Ironwarr,hyjal,740,warrior,arms,23,8,15
Vetinari,nazjatar,735,warrior,arms,11,8,3
Outo,stormrage,735,warrior,arms,17,8,9
Casmier,tichondrius,734,warrior,arms,17,8,9
Brysontiller,frostmourne,734,warrior,arms,17,8,9
Gorakis,barthilas,733,warrior,arms,20,9,11
Mêlo,area-52,719,warrior,arms,17,8,9
Layoon,azralon,718,warrior,arms,17,8,9
Wreckthis,area-52,718,warrior,arms,17,8,9
Khâi,tichondrius,718,warrior,arms,21,8,13
Alemão,bleeding-hollow,713,warrior,arms,23,9,14
Fraccx,area-52,704,warrior,arms,16,8,8
Tomatogodx,sargeras,704,warrior,arms,16,8,8
Bluthammer,wyrmrest-accord,701,warrior,arms,20,8,12
Tabadigbick,bleeding-hollow,698,warrior,arms,17,8,9
Elfmonger,proudmoore,687,warrior,arms,13,8,5
Wreckerr,area-52,680,warrior,arms,20,10,10
Donivan,illidan,672,warrior,arms,12,7,5
Solocon,tichondrius,672,warrior,arms,12,7,5
Xdoombringer,area-52,672,warrior,arms,12,7,5
Grounyl,azralon,672,warrior,arms,12,7,5
Lilreese,tichondrius,672,warrior,arms,12,7,5
Papazugs,kelthuzad,672,warrior,arms,12,7,5
Giv,frostmourne,672,warrior,arms,12,7,5
Studdythejet,zuljin,672,warrior,arms,12,7,5
Faronstompz,sargeras,672,warrior,arms,12,7,5
Ryalaeth,moon-guard,672,warrior,arms,12,7,5
Jahrakál,thunderlord,672,warrior,arms,12,7,5
Vids,aegwynn,672,warrior,arms,12,7,5
Arsis,whisperwind,672,warrior,arms,12,7,5
Kevy,arygos,672,warrior,arms,12,7,5
Madmartiggan,tichondrius,672,warrior,arms,12,7,5
Turtleofhope,barthilas,672,warrior,arms,12,7,5
Jaysmom,tichondrius,672,warrior,arms,12,7,5
Havocsmash,tichondrius,672,warrior,arms,12,7,5
Roiboy,stormrage,672,warrior,arms,12,7,5
Jesbar,ragnaros,672,warrior,arms,12,7,5
Noelglz,quelthalas,672,warrior,arms,12,7,5
Mõgorrin,area-52,672,warrior,arms,12,7,5
Zekkenx,azjolnerub,672,warrior,arms,12,7,5
Okayge,proudmoore,672,warrior,arms,12,7,5
Salthouse,sargeras,672,warrior,arms,12,7,5
Gbrz,stormrage,672,warrior,arms,12,7,5
Madamemarie,stormrage,672,warrior,arms,12,7,5
Yrz,malganis,672,warrior,arms,12,7,5
Natating,terenas,672,warrior,arms,12,7,5
Cugij,frostmourne,672,warrior,arms,12,7,5
Turecw,illidan,672,warrior,arms,12,7,5
Magnusz,zuljin,672,warrior,arms,12,7,5
Bladebuster,stormrage,672,warrior,arms,12,7,5
Reichbeast,area-52,672,warrior,arms,12,7,5
Furìous,stormrage,672,warrior,arms,12,7,5
Slaughtér,tichondrius,672,warrior,arms,12,7,5
Dehumanized,greymane,672,warrior,arms,12,7,5
Heojae,tichondrius,672,warrior,arms,12,7,5
Bloodshêdz,stormrage,672,warrior,arms,12,7,5
Vxjohnson,proudmoore,672,warrior,arms,15,8,7
Imyourdaddy,chogall,672,warrior,arms,16,8,8
Warhji,malganis,672,warrior,arms,18,7,11
Zerosends,kelthuzad,672,warrior,arms,18,7,11
Rhynehardt,scilla,672,warrior,arms,18,7,11
Warfeno,malganis,672,warrior,arms,18,7,11
Ryänlord,mugthol,672,warrior,arms,18,7,11
Tasilia,tichondrius,672,warrior,arms,18,7,11
Jethrix,kelthuzad,672,warrior,arms,18,7,11
Käggai,khadgar,672,warrior,arms,18,7,11
Sayjaki,stormrage,672,warrior,arms,18,7,11
Pathelsonsus,stormrage,672,warrior,arms,18,7,11
Raxek,stormrage,672,warrior,arms,18,7,11
Yamzprime,stormrage,672,warrior,arms,18,7,11
Ivory,emerald-dream,672,warrior,arms,18,7,11
Bigbadbaka,thaurissan,672,warrior,arms,18,7,11
Goyqqw,illidan,672,warrior,arms,18,7,11
Thètrùth,duskwood,672,warrior,arms,18,7,11
Tbagg,area-52,672,warrior,arms,18,7,11
Galehna,ragnaros,672,warrior,arms,23,7,16
Festerclaws,wyrmrest-accord,672,warrior,arms,24,7,17
Farquahd,illidan,672,warrior,arms,24,7,17
Blazie,barthilas,671,warrior,arms,12,7,5
Gunnëy,malganis,671,warrior,arms,12,7,5
Glizzarms,dalaran,671,warrior,arms,12,7,5
Crnogorac,hakkar,671,warrior,arms,12,7,5
Furiousangel,area-52,671,warrior,arms,12,7,5
Jfordnever,area-52,671,warrior,arms,12,7,5
Dêsêcratê,frostmourne,671,warrior,arms,12,7,5
Orthopedic,tichondrius,671,warrior,arms,12,7,5
Ramborco,kelthuzad,671,warrior,arms,12,7,5
Jedeva,stormrage,671,warrior,arms,12,7,5
Seshømaru,quelthalas,671,warrior,arms,12,7,5
Irongummy,frostmourne,671,warrior,arms,12,7,5
Rhuktar,azralon,671,warrior,arms,12,7,5
Nehpets,akama,671,warrior,arms,12,7,5
Vodkalol,bleeding-hollow,671,warrior,arms,12,7,5
Lilboytroy,korgath,671,warrior,arms,12,7,5
Pipeman,blackhand,671,warrior,arms,12,7,5
Sneakyhand,draktharon,671,warrior,arms,12,7,5
Maddzspin,tichondrius,671,warrior,arms,12,7,5
Qtrpndwcheez,area-52,671,warrior,arms,12,7,5
Dunkindots,tichondrius,671,warrior,arms,12,7,5
Drekzul,azralon,671,warrior,arms,12,7,5
Girthstick,eredar,671,warrior,arms,12,7,5
Menestz,dreadmaul,671,warrior,arms,17,9,8
Paratech,thrall,671,warrior,arms,18,7,11
Chumbinhu,stormrage,671,warrior,arms,18,7,11
Kasheeka,spirestone,671,warrior,arms,18,7,11
Layøut,azralon,671,warrior,arms,18,7,11
Grazellor,khaz-modan,671,warrior,arms,18,7,11
Struka,drakkari,671,warrior,arms,18,7,11
Ironhide,malorne,671,warrior,arms,18,7,11
Violençe,malganis,671,warrior,arms,18,7,11
Rawlur,zuljin,671,warrior,arms,18,7,11
Stepzugger,illidan,671,warrior,arms,18,7,11
Elíte,kelthuzad,671,warrior,arms,18,7,11
Sako,amanthul,671,warrior,arms,18,7,11
Josephcrazy,tichondrius,671,warrior,arms,18,7,11
Pharan,malganis,671,warrior,arms,18,7,11
Danzael,quelthalas,671,warrior,arms,24,7,17
Draggo,tortheldrin,670,warrior,arms,12,7,5
Nraged,illidan,670,warrior,arms,12,7,5
Dizzygal,hyjal,670,warrior,arms,18,7,11
Swám,quelthalas,670,warrior,arms,18,7,11
Dhano,drakkari,670,warrior,arms,18,7,11
Amrap,dentarg,670,warrior,arms,18,7,11
Gìraffe,illidan,670,warrior,arms,18,7,11
Warraaxx,stonemaul,670,warrior,arms,18,7,11
Reidahn,zuljin,670,warrior,arms,24,7,17
Aersasi,tichondrius,669,warrior,arms,12,7,5
Deadhofe,azuremyst,669,warrior,arms,15,8,7
Harnor,garrosh,669,warrior,arms,18,7,11
Tämuros,thrall,669,warrior,arms,18,7,11
Teyliemond,amanthul,668,warrior,arms,12,7,5
Pandamoanman,moon-guard,668,warrior,arms,18,7,11
Yanïka,barthilas,667,warrior,arms,13,7,6
Rogkhan,tichondrius,667,warrior,arms,18,7,11
Kevasaurr,sargeras,667,warrior,arms,24,7,17
Borgee,tichondrius,666,warrior,arms,18,7,11
Terribletom,stormrage,665,warrior,arms,18,7,11
Nepharia,kirin-tor,664,warrior,arms,18,7,11
Tanatos,the-venture-co,664,warrior,arms,24,7,17
Jötunn,dalaran,663,warrior,arms,12,7,5
Dierdris,gnomeregan,659,warrior,arms,13,7,6
Tankadin,dragonmaw,659,warrior,arms,18,7,11
Parmizan,hydraxis,639,warrior,arms,16,7,9
Phoveros,sargeras,639,warrior,arms,17,7,10
Fewfingers,sargeras,638,warrior,arms,16,7,9
Twinxin,thrall,637,warrior,arms,17,7,10
Allenwalker,dreadmaul,623,warrior,arms,13,7,6
Fidel,blackrock,623,warrior,arms,23,7,16
Bigboycandy,malganis,621,warrior,arms,11,7,4
Xunaco,quelthalas,620,warrior,arms,26,7,19
Xandrak,barthilas,618,warrior,arms,11,7,4
Ålbedo,malganis,616,warrior,arms,23,8,15
Justfair,barthilas,607,warrior,arms,14,7,7
Pkrage,hellscream,606,warrior,arms,11,7,4
Exxic,zuljin,606,warrior,arms,14,7,7
Bullkathoss,bleeding-hollow,605,warrior,arms,22,7,15
Tyférious,tichondrius,602,warrior,arms,32,7,25
Mortalchop,tichondrius,592,warrior,arms,13,7,6
Dóminus,malfurion,576,warrior,arms,6,6,0
Baltusrol,hydraxis,576,warrior,arms,6,6,0
Elpresador,dragonmaw,576,warrior,arms,6,6,0
Stoneshield,senjin,576,warrior,arms,6,6,0
Bean,ragnaros,576,warrior,arms,6,6,0
Khalwar,ragnaros,576,warrior,arms,6,6,0
Slammshady,tichondrius,576,warrior,arms,9,7,2
Iskandr,amanthul,576,warrior,arms,9,7,2
Painremaìns,dunemaul,576,warrior,arms,12,6,6
Roflcombo,illidan,576,warrior,arms,12,6,6
Natalieftm,tichondrius,576,warrior,arms,12,6,6
Monkeystrike,barthilas,576,warrior,arms,12,6,6
Tàlent,thrall,576,warrior,arms,12,6,6
Luckychaos,bleeding-hollow,576,warrior,arms,12,6,6
Lotsay,tichondrius,576,warrior,arms,12,6,6
Bigbadaxe,sargeras,576,warrior,arms,12,6,6
Averagewar,frostwolf,576,warrior,arms,12,6,6
Geubsalx,tichondrius,576,warrior,arms,12,6,6
Atuey,area-52,576,warrior,arms,12,6,6
Benkenobi,khaz-modan,576,warrior,arms,12,6,6
Linios,tichondrius,576,warrior,arms,12,6,6
Blazight,dunemaul,576,warrior,arms,12,6,6
Aladarith,moon-guard,576,warrior,arms,12,6,6
Flidumpling,tichondrius,576,warrior,arms,12,6,6
Rexquando,barthilas,576,warrior,arms,12,6,6
Griftustle,moon-guard,576,warrior,arms,12,6,6
Malvicious,proudmoore,576,warrior,arms,12,6,6
Himurinha,nemesis,576,warrior,arms,12,6,6
Assamith,nemesis,576,warrior,arms,12,6,6
Biorhn,area-52,576,warrior,arms,12,6,6
Feedmetren,tichondrius,576,warrior,arms,12,6,6
Rargou,illidan,576,warrior,arms,12,6,6
Dreamwarr,tichondrius,576,warrior,arms,12,6,6
Kazabare,tichondrius,576,warrior,arms,12,6,6
Cassetto,icecrown,576,warrior,arms,12,6,6
Rembrand,blackhand,576,warrior,arms,12,6,6
Gladdz,moon-guard,576,warrior,arms,12,6,6
Fatpoos,barthilas,576,warrior,arms,12,6,6
Hololeave,tichondrius,576,warrior,arms,12,6,6
Zzode,tichondrius,576,warrior,arms,12,6,6
Zuans,azralon,576,warrior,arms,12,6,6
Luminiere,sargeras,576,warrior,arms,12,6,6
Toegap,illidan,576,warrior,arms,12,6,6
Lacorte,ragnaros,576,warrior,arms,12,6,6
Zizwe,proudmoore,576,warrior,arms,12,6,6
Sodarzok,thaurissan,576,warrior,arms,12,6,6
Musclecrowe,illidan,576,warrior,arms,12,6,6
Prìscìlla,stormrage,576,warrior,arms,12,6,6
Streetdog,stormrage,576,warrior,arms,12,6,6
Ratherfull,ragnaros,576,warrior,arms,12,6,6
Headsour,thunderhorn,576,warrior,arms,12,6,6
Hülkamanïa,sargeras,576,warrior,arms,12,6,6
Bamlin,sargeras,576,warrior,arms,12,6,6
Marîn,stormrage,576,warrior,arms,12,6,6
Róngor,ragnaros,576,warrior,arms,12,6,6
Unwarmas,ragnaros,576,warrior,arms,12,6,6
Auxthas,tichondrius,576,warrior,arms,12,6,6
Agresvnapkin,dalaran,576,warrior,arms,12,6,6
Fraxxure,proudmoore,576,warrior,arms,12,6,6
Jerebeloz,proudmoore,576,warrior,arms,12,6,6
Bonclay,nerzhul,576,warrior,arms,12,6,6
Maleap,moon-guard,576,warrior,arms,12,6,6
Areiana,stormrage,576,warrior,arms,12,6,6
Roitty,proudmoore,576,warrior,arms,12,6,6
Illmindofboo,tichondrius,576,warrior,arms,12,6,6
Fûry,barthilas,576,warrior,arms,12,6,6
Orkussw,illidan,576,warrior,arms,12,6,6
Houdinix,stormrage,576,warrior,arms,12,6,6
Inkurushio,suramar,576,warrior,arms,12,6,6
Aùstin,moon-guard,576,warrior,arms,12,6,6
Sunderstruck,boulderfist,576,warrior,arms,12,6,6
Arozay,illidan,576,warrior,arms,12,6,6
Bagginses,quelthalas,576,warrior,arms,12,6,6
Glourfindel,quelthalas,576,warrior,arms,12,6,6
Raahj,sargeras,576,warrior,arms,12,6,6
Truecarnage,emerald-dream,576,warrior,arms,12,6,6
Bailu,ragnaros,576,warrior,arms,12,6,6
Amortens,area-52,576,warrior,arms,12,6,6
Aliminar,zuluhed,576,warrior,arms,12,6,6
Invinciblé,tichondrius,576,warrior,arms,12,6,6
Musclehead,moon-guard,576,warrior,arms,12,6,6
Joesbàr,tichondrius,576,warrior,arms,12,6,6
Supersquish,moon-guard,576,warrior,arms,12,6,6
Stÿgían,kelthuzad,576,warrior,arms,12,6,6
Sigrik,moon-guard,576,warrior,arms,12,6,6
Jaybers,malganis,576,warrior,arms,12,6,6
Breaker,undermine,576,warrior,arms,12,6,6
Doucherocket,kelthuzad,576,warrior,arms,12,6,6
Adryina,zuljin,576,warrior,arms,12,6,6
Brahmo,kelthuzad,576,warrior,arms,13,6,7
Ganzism,tichondrius,576,warrior,arms,13,6,7
Aziz,kiljaeden,576,warrior,arms,13,6,7
Monardaid,uldum,576,warrior,arms,18,6,12
Rhorix,korialstrasz,576,warrior,arms,18,6,12
Májorrobot,area-52,576,warrior,arms,18,6,12
Sõnics,tichondrius,576,warrior,arms,18,6,12
Durres,tichondrius,576,warrior,arms,18,6,12
Cowboybeast,tanaris,576,warrior,arms,18,6,12
Cleavxy,sargeras,576,warrior,arms,18,6,12
Psilly,sargeras,576,warrior,arms,18,6,12
Baciless,illidan,576,warrior,arms,18,6,12
Toutie,tichondrius,576,warrior,arms,18,6,12
Ontull,emerald-dream,576,warrior,arms,18,6,12
Xgraves,sargeras,576,warrior,arms,18,6,12
Durko,whisperwind,576,warrior,arms,18,6,12
Eabywarrs,tichondrius,576,warrior,arms,18,6,12
Swìll,illidan,576,warrior,arms,18,6,12
Ronak,vashj,576,warrior,arms,18,6,12
Ezgamelol,azralon,576,warrior,arms,18,6,12
Nillor,emerald-dream,576,warrior,arms,18,6,12
Winso,blood-furnace,576,warrior,arms,18,6,12
Deathstrøke,illidan,576,warrior,arms,18,6,12
Kennäy,azralon,576,warrior,arms,18,6,12
Egoist,malganis,576,warrior,arms,18,6,12
Hariban,shuhalo,576,warrior,arms,18,6,12
Benw,dawnbringer,576,warrior,arms,18,6,12
Hugz,thrall,576,warrior,arms,18,6,12
Pushh,thrall,576,warrior,arms,18,6,12
Lieofa,tichondrius,576,warrior,arms,19,6,13
Omnismash,stormrage,576,warrior,arms,20,6,14
Contentious,moon-guard,576,warrior,arms,24,6,18
Odrak,ragnaros,576,warrior,arms,24,6,18
Shîzu,moon-guard,576,warrior,arms,24,6,18
Fenømenoide,ragnaros,575,warrior,arms,6,6,0
Bolx,archimonde,575,warrior,arms,12,6,6
Desul,tichondrius,575,warrior,arms,12,6,6
Croton,moon-guard,575,warrior,arms,12,6,6
Obstruktíon,tichondrius,575,warrior,arms,12,6,6
Uragiri,shadowsong,575,warrior,arms,12,6,6
Pandatrue,azralon,575,warrior,arms,12,6,6
Tenserr,kiljaeden,575,warrior,arms,12,6,6
Kurgos,quelthalas,575,warrior,arms,12,6,6
Weewarrior,wyrmrest-accord,575,warrior,arms,12,6,6
Balthazãr,quelthalas,575,warrior,arms,12,6,6
Gahii,barthilas,575,warrior,arms,12,6,6
Vioar,hyjal,575,warrior,arms,12,6,6
Bkdorbandit,illidan,575,warrior,arms,12,6,6
Teyrn,stormrage,575,warrior,arms,12,6,6
Ereborh,ragnaros,575,warrior,arms,12,6,6
Nospace,tichondrius,575,warrior,arms,12,6,6
Ragefested,tichondrius,575,warrior,arms,12,6,6
Xarlon,stormrage,575,warrior,arms,12,6,6
Redneckk,emerald-dream,575,warrior,arms,12,6,6
Thornakh,stormrage,575,warrior,arms,12,6,6
Maltrate,hyjal,575,warrior,arms,15,7,8
Bärdock,ragnaros,575,warrior,arms,16,7,9
Filthyrandy,proudmoore,575,warrior,arms,18,6,12
Hatedßyßlízz,area-52,575,warrior,arms,18,6,12
Kenroc,illidan,574,warrior,arms,12,6,6
Darkshrek,quelthalas,574,warrior,arms,12,6,6
Ådolf,sargeras,574,warrior,arms,15,7,8
Padalouh,kelthuzad,574,warrior,arms,18,6,12
Masami,moon-guard,574,warrior,arms,18,6,12
Locotto,ragnaros,574,warrior,arms,24,6,18
Dúmp,stormrage,573,warrior,arms,12,6,6
Logohn,wyrmrest-accord,573,warrior,arms,12,6,6
Môgwai,kelthuzad,573,warrior,arms,12,6,6
Rafaelwar,drakkari,573,warrior,arms,12,6,6
Bilmuuri,illidan,573,warrior,arms,18,6,12
Brosèph,sargeras,573,warrior,arms,18,6,12
Lololosda,quelthalas,572,warrior,arms,12,6,6
Faóra,moon-guard,572,warrior,arms,12,6,6
Bitiatus,scilla,572,warrior,arms,18,6,12
Tatsher,turalyon,571,warrior,arms,12,6,6
Conchalover,illidan,559,warrior,arms,17,6,11
Mindgoblin,smolderthorn,559,warrior,arms,17,6,11
Kastenz,frostmourne,559,warrior,arms,23,6,17
Ecopolis,azshara,544,warrior,arms,16,6,10
Ballzindeep,tichondrius,543,warrior,arms,8,7,1
Tastyskeet,illidan,543,warrior,arms,11,6,5
Tâlos,ysondre,543,warrior,arms,11,6,5
Uneasyw,tichondrius,543,warrior,arms,17,6,11
Randywar,tichondrius,528,warrior,arms,15,6,9
Ogpapabear,stormscale,528,warrior,arms,21,6,15
Beyblade,jubeithos,527,warrior,arms,11,6,5
Kzw,illidan,527,warrior,arms,11,6,5
Vikkz,frostmourne,527,warrior,arms,11,6,5
Warwik,stormscale,527,warrior,arms,17,6,11
Meadsweats,tichondrius,522,warrior,arms,17,10,7
Bersérk,area-52,522,warrior,arms,14,8,6
Tomcruz,bloodscalp,522,warrior,arms,16,7,9
Hrókr,kiljaeden,522,warrior,arms,19,8,11
Orz,sargeras,522,warrior,arms,25,7,18
Munchiesxqc,exodar,521,warrior,arms,21,7,14
Warrage,kiljaeden,519,warrior,arms,21,9,12
Illicitiri,sargeras,511,warrior,arms,10,6,4
Kvobash,area-52,511,warrior,arms,11,6,5
Ohjim,stormrage,511,warrior,arms,14,6,8
Jackjaeger,area-52,511,warrior,arms,16,6,10
Berzerc,stormrage,511,warrior,arms,18,6,12
Ripstorm,emerald-dream,510,warrior,arms,14,6,8
Ruiend,bonechewer,510,warrior,arms,14,6,8
Tyraelius,kiljaeden,510,warrior,arms,17,6,11
Lishajr,malganis,507,warrior,arms,8,6,2
Magarrior,shadowsong,495,warrior,arms,13,7,6
Vanlur,khaz-modan,480,warrior,arms,6,5,1
Millywhopz,thrall,480,warrior,arms,6,5,1
Ryü,khaz-modan,480,warrior,arms,6,5,1
Warronin,kaelthas,480,warrior,arms,6,5,1
Noor,tichondrius,480,warrior,arms,6,5,1
Roadglide,korgath,480,warrior,arms,6,5,1
Ghostblood,stormscale,480,warrior,arms,6,5,1
Jenkin,korgath,480,warrior,arms,6,5,1
Jackox,sargeras,480,warrior,arms,6,5,1
Noreaga,tichondrius,480,warrior,arms,6,5,1
Jarlaix,dragonmaw,480,warrior,arms,6,5,1
Biggesttoees,tichondrius,480,warrior,arms,6,5,1
Thombelina,malganis,480,warrior,arms,6,5,1
Saladin,gnomeregan,480,warrior,arms,6,5,1
Ousetadoidao,nemesis,480,warrior,arms,6,5,1
Xaenne,zuljin,480,warrior,arms,6,5,1
Khrull,khazgoroth,480,warrior,arms,6,5,1
Bootypound,sargeras,480,warrior,arms,6,5,1
Billythunda,tichondrius,480,warrior,arms,6,5,1
Onefourfifty,tichondrius,480,warrior,arms,6,5,1
Calmebigfeet,tichondrius,480,warrior,arms,6,5,1
Scozziee,barthilas,480,warrior,arms,6,5,1
Dukagã,tichondrius,480,warrior,arms,6,5,1
Hotshótz,kelthuzad,480,warrior,arms,6,5,1
Armsupx,tichondrius,480,warrior,arms,6,5,1
Grehk,sargeras,480,warrior,arms,6,5,1
Tinymo,archimonde,480,warrior,arms,6,5,1
Sparkye,gallywix,480,warrior,arms,6,5,1
Geàrbreaker,tichondrius,480,warrior,arms,6,5,1
Painqt,area-52,480,warrior,arms,6,5,1
Houk,frostmourne,480,warrior,arms,6,5,1
Rickywarx,illidan,480,warrior,arms,6,5,1
Tâlos,magtheridon,480,warrior,arms,6,5,1
Mongosyco,proudmoore,480,warrior,arms,6,5,1
Warpenguin,kelthuzad,480,warrior,arms,10,6,4
Whittyxc,tichondrius,480,warrior,arms,9,5,4
Excalibruh,frostmourne,480,warrior,arms,12,5,7
Mondëgo,stormrage,480,warrior,arms,12,5,7
Loveføx,stormrage,480,warrior,arms,12,5,7
Izârâk,frostmourne,480,warrior,arms,12,5,7
Lanco,kiljaeden,480,warrior,arms,12,5,7
Martydom,proudmoore,480,warrior,arms,12,5,7
Brøxigár,quelthalas,480,warrior,arms,12,5,7
Pandaxes,proudmoore,480,warrior,arms,12,5,7
Dillý,area-52,480,warrior,arms,12,5,7
Morphexo,quelthalas,480,warrior,arms,12,5,7
Karik,proudmoore,480,warrior,arms,12,5,7
Alëwar,quelthalas,480,warrior,arms,12,5,7
Sideon,frostmourne,480,warrior,arms,12,5,7
Greyknights,kiljaeden,480,warrior,arms,12,5,7
Ccmeharder,kiljaeden,480,warrior,arms,12,5,7
Kàli,kiljaeden,480,warrior,arms,12,5,7
Kaikah,aegwynn,480,warrior,arms,12,5,7
Peters,malfurion,480,warrior,arms,12,5,7
Maniel,greymane,480,warrior,arms,12,5,7
Beerstorm,stormrage,480,warrior,arms,12,5,7
Thalfor,emerald-dream,480,warrior,arms,12,5,7
Gonzwold,drenden,480,warrior,arms,12,5,7
Dalinare,area-52,480,warrior,arms,12,5,7
Spredforbred,area-52,480,warrior,arms,12,5,7
Ericthegreat,azuremyst,480,warrior,arms,12,5,7
Quinntis,anvilmar,480,warrior,arms,12,5,7
Etothed,stormrage,480,warrior,arms,12,5,7
Dynamiite,bleeding-hollow,480,warrior,arms,12,5,7
Ricksanches,shadowmoon,480,warrior,arms,12,5,7
Ximzhao,quelthalas,480,warrior,arms,12,5,7
Trén,hydraxis,480,warrior,arms,12,5,7
Blakeb,area-52,480,warrior,arms,12,5,7
Kriegsheer,bleeding-hollow,480,warrior,arms,12,5,7
Arcâdio,cairne,480,warrior,arms,12,5,7
Kð,zuljin,480,warrior,arms,12,5,7
Angertooth,tichondrius,480,warrior,arms,12,5,7
Fayttful,area-52,480,warrior,arms,12,5,7
Mustachelove,bleeding-hollow,480,warrior,arms,12,5,7
Taürok,azralon,480,warrior,arms,12,5,7
Bradockqt,azralon,480,warrior,arms,12,5,7
Cabi,frostmourne,480,warrior,arms,12,5,7
Gläedr,dalaran,480,warrior,arms,12,5,7
Shwip,tichondrius,480,warrior,arms,12,5,7
Coltronitis,kelthuzad,480,warrior,arms,12,5,7
Andrexion,moon-guard,480,warrior,arms,12,5,7
Toddlovesu,kelthuzad,480,warrior,arms,12,5,7
Zewl,barthilas,480,warrior,arms,12,5,7
Targos,frostwolf,480,warrior,arms,12,5,7
Huleo,tichondrius,480,warrior,arms,12,5,7
Slamoholic,turalyon,480,warrior,arms,12,5,7
Orcimonde,arthas,480,warrior,arms,12,5,7
Shrëkslovaki,tichondrius,480,warrior,arms,12,5,7
Téry,dalaran,480,warrior,arms,12,5,7
Wcb,sargeras,480,warrior,arms,12,5,7
Empyrius,exodar,480,warrior,arms,12,5,7
Igoon,dentarg,480,warrior,arms,12,5,7
Paulhëyman,sargeras,480,warrior,arms,12,5,7
Felorelea,moon-guard,480,warrior,arms,12,5,7
Fracked,sargeras,480,warrior,arms,12,5,7
Varenkä,drakkari,480,warrior,arms,12,5,7
Stattic,illidan,480,warrior,arms,12,5,7
Colnar,stormrage,480,warrior,arms,12,5,7
Mayshowgunmo,tichondrius,480,warrior,arms,12,5,7
Sylvanos,arthas,480,warrior,arms,12,5,7
Clamjammed,thrall,480,warrior,arms,12,5,7
Hemkcus,zuluhed,480,warrior,arms,12,5,7
Bladeblade,burning-blade,480,warrior,arms,12,5,7
Gävilar,sargeras,480,warrior,arms,12,5,7
Flëët,tichondrius,480,warrior,arms,12,5,7
Vexwar,bleeding-hollow,480,warrior,arms,12,5,7
Osannd,tichondrius,480,warrior,arms,12,5,7
Killimanjaro,aggramar,480,warrior,arms,12,5,7
Dondà,illidan,480,warrior,arms,12,5,7
Qwort,moon-guard,480,warrior,arms,12,5,7
Takenotez,sargeras,480,warrior,arms,12,5,7
Buffwar,tichondrius,480,warrior,arms,12,5,7
Slasherman,illidan,480,warrior,arms,12,5,7
Mirado,tichondrius,480,warrior,arms,12,5,7
Haowar,tichondrius,480,warrior,arms,12,5,7
Schoolbuhs,tichondrius,480,warrior,arms,12,5,7
Crushingnews,sargeras,480,warrior,arms,12,5,7
Sabers,mannoroth,480,warrior,arms,12,5,7
Baaltica,ragnaros,480,warrior,arms,12,5,7
Ahkimih,ragnaros,480,warrior,arms,12,5,7
Tepaste,ragnaros,480,warrior,arms,12,5,7
Brickhouse,tichondrius,480,warrior,arms,12,5,7
Biggiesmash,bleeding-hollow,480,warrior,arms,12,5,7
Rockadoodle,tichondrius,480,warrior,arms,15,6,9
Grandtank,veknilash,480,warrior,arms,15,6,9
Mág,burning-legion,480,warrior,arms,13,5,8
Siegfriéd,bleeding-hollow,480,warrior,arms,14,5,9
Tigershárk,tichondrius,480,warrior,arms,16,5,11
Huacai,tichondrius,480,warrior,arms,18,5,13
Cyllyzie,emerald-dream,480,warrior,arms,18,5,13
Essofeit,frostmourne,480,warrior,arms,18,5,13
Imprw,stormrage,480,warrior,arms,18,5,13
Tsathoggua,kiljaeden,480,warrior,arms,18,5,13
Eightydeuce,bonechewer,480,warrior,arms,18,5,13
Kkuzo,bleeding-hollow,480,warrior,arms,18,5,13
Bruttallis,frostmane,480,warrior,arms,18,5,13
Omlas,azralon,480,warrior,arms,18,5,13
Goaco,drakkari,480,warrior,arms,18,5,13
Aldathion,argent-dawn,480,warrior,arms,18,5,13
Tasërface,hakkar,480,warrior,arms,18,5,13
Shaynaynay,tichondrius,480,warrior,arms,18,5,13
Calto,tichondrius,480,warrior,arms,18,5,13
Crul,gurubashi,480,warrior,arms,19,5,14
Thunderbash,thrall,480,warrior,arms,24,5,19
Lorinzer,zuljin,480,warrior,arms,24,5,19
Asarg,emerald-dream,479,warrior,arms,6,5,1
Tanger,korgath,479,warrior,arms,6,5,1
Rinngo,proudmoore,479,warrior,arms,6,5,1
Carralee,azralon,479,warrior,arms,6,5,1
Arrozkonlech,proudmoore,479,warrior,arms,10,6,4
Loaksz,tichondrius,479,warrior,arms,12,5,7
Spàcetìme,stormrage,479,warrior,arms,12,5,7
Celt,uldum,479,warrior,arms,12,5,7
Dirtyrandy,zuluhed,479,warrior,arms,12,5,7
Alderr,frostmourne,479,warrior,arms,12,5,7
Qqmachine,tichondrius,479,warrior,arms,12,5,7
Têzeret,shadowmoon,479,warrior,arms,12,5,7
Rücküs,tichondrius,479,warrior,arms,12,5,7
Josiah,frostmourne,479,warrior,arms,12,5,7
Märx,barthilas,479,warrior,arms,12,5,7
Baloraj,barthilas,479,warrior,arms,12,5,7
Wondaimon,drakkari,479,warrior,arms,12,5,7
Azaeil,tanaris,479,warrior,arms,12,5,7
Buffalobob,bronzebeard,479,warrior,arms,12,5,7
Trufsoturi,bleeding-hollow,479,warrior,arms,12,5,7
Cueromodel,ragnaros,479,warrior,arms,12,5,7
Synestira,frostmourne,479,warrior,arms,12,5,7
Zeldrissx,quelthalas,479,warrior,arms,18,5,13
Helscreem,hyjal,479,warrior,arms,18,5,13
Flexecute,senjin,479,warrior,arms,18,5,13
Gorrthrax,area-52,479,warrior,arms,24,5,19
Arooy,azralon,478,warrior,arms,6,5,1
Wastenott,area-52,478,warrior,arms,6,5,1
Otyek,proudmoore,478,warrior,arms,12,5,7
Tmible,ragnaros,477,warrior,arms,6,5,1
Acanof,azjolnerub,474,warrior,arms,9,6,3
Inuyasha,korgath,473,warrior,arms,12,5,7
Lòvex,alterac-mountains,473,warrior,arms,12,5,7
Raktrazbirt,dalaran,472,warrior,arms,12,5,7
Danalle,area-52,448,warrior,arms,10,6,4
Thistleberry,aegwynn,447,warrior,arms,11,5,6
Notcoverage,tichondrius,447,warrior,arms,11,5,6
Dontkiteme,frostmourne,447,warrior,arms,17,5,12
Cyllå,frostmourne,446,warrior,arms,9,6,3
Jrodrick,nemesis,432,warrior,arms,9,6,3
Bingchilly,aegwynn,432,warrior,arms,9,6,3
Shotgunzx,tichondrius,432,warrior,arms,9,5,4
Señor,barthilas,432,warrior,arms,9,5,4
Warrgodlol,illidan,432,warrior,arms,15,5,10
Gurgak,illidan,431,warrior,arms,11,5,6
Llewellenar,stormrage,431,warrior,arms,11,5,6
Bloodbottle,darkspear,426,warrior,arms,14,7,7
Boombasta,shuhalo,426,warrior,arms,15,6,9
Machutron,quelthalas,415,warrior,arms,8,5,3
Yarocktoo,kelthuzad,415,warrior,arms,8,5,3
Crackersmack,stormrage,415,warrior,arms,11,6,5
Thano,kiljaeden,415,warrior,arms,10,5,5
Alzuga,quelthalas,415,warrior,arms,14,5,9
Gushyguts,tichondrius,399,warrior,arms,19,5,14
Egargiss,malygos,384,warrior,arms,6,4,2
Ragingboner,aggramar,384,warrior,arms,6,4,2
Dysazter,ravencrest,384,warrior,arms,6,4,2
Kimbö,quelthalas,384,warrior,arms,6,4,2
Bütch,stormrage,384,warrior,arms,6,4,2
Zarttorius,quelthalas,384,warrior,arms,6,4,2
Swaystko,sargeras,384,warrior,arms,6,4,2
Oddyseey,moon-guard,384,warrior,arms,6,4,2
Hamburgezo,quelthalas,384,warrior,arms,6,4,2
Daddydomtop,moon-guard,384,warrior,arms,6,4,2
Cogsbixby,aerie-peak,384,warrior,arms,6,4,2
Thottprot,blackhand,384,warrior,arms,6,4,2
Murrderrface,azgalor,384,warrior,arms,6,4,2
Hordrek,moon-guard,384,warrior,arms,6,4,2
Toungy,kelthuzad,384,warrior,arms,6,4,2
Styiex,ragnaros,384,warrior,arms,6,4,2
Boomtacular,moon-guard,384,warrior,arms,6,4,2
Jersucristö,quelthalas,384,warrior,arms,6,4,2
Amérus,moon-guard,384,warrior,arms,6,4,2
Warcheif,dentarg,384,warrior,arms,6,4,2
Larrythelob,kelthuzad,384,warrior,arms,6,4,2
Yivicus,sargeras,384,warrior,arms,6,4,2
Elbelgon,ragnaros,384,warrior,arms,6,4,2
Fancysin,malganis,384,warrior,arms,6,4,2
Míaguiulfo,ragnaros,384,warrior,arms,6,4,2
Swordfighter,moon-guard,384,warrior,arms,6,4,2
Varyanguard,quelthalas,384,warrior,arms,6,4,2
Flèx,stormrage,384,warrior,arms,6,4,2
Sygurd,drakkari,384,warrior,arms,6,4,2
Evencane,stormrage,384,warrior,arms,6,4,2
Raime,sargeras,384,warrior,arms,6,4,2
Irascible,stormrage,384,warrior,arms,6,4,2
Mommystrasza,kelthuzad,384,warrior,arms,6,4,2
Tickej,dragonmaw,384,warrior,arms,6,4,2
Martiallawl,skullcrusher,384,warrior,arms,6,4,2
Mfgodofwar,kelthuzad,384,warrior,arms,6,4,2
Pineapplezz,kelthuzad,384,warrior,arms,6,4,2
Hugewarrior,area-52,384,warrior,arms,6,4,2
Veedrin,ysera,384,warrior,arms,6,4,2
Thiccyb,area-52,384,warrior,arms,6,4,2
Ummso,nerzhul,384,warrior,arms,6,4,2
Gladìus,area-52,384,warrior,arms,6,4,2
Sonwar,azralon,384,warrior,arms,6,4,2
Brrazze,moon-guard,384,warrior,arms,6,4,2
Hamur,azralon,384,warrior,arms,6,4,2
Diesel,duskwood,384,warrior,arms,6,4,2
Hipower,lethon,384,warrior,arms,6,4,2
Ziggeraut,cenarion-circle,384,warrior,arms,6,4,2
Tsutsana,lightninghoof,384,warrior,arms,6,4,2
Fazeo,madoran,384,warrior,arms,6,4,2
Appolyonn,hyjal,384,warrior,arms,6,4,2
Gnasty,hyjal,384,warrior,arms,6,4,2
Jakslasfa,aegwynn,384,warrior,arms,6,4,2
Fulreck,tichondrius,384,warrior,arms,6,4,2
Pilgrimslays,tichondrius,384,warrior,arms,6,4,2
Suprslayer,spirestone,384,warrior,arms,6,4,2
Babyreap,frostmourne,384,warrior,arms,6,4,2
Gurneyhalec,proudmoore,384,warrior,arms,6,4,2
Jäÿ,proudmoore,384,warrior,arms,6,4,2
Alèx,tichondrius,384,warrior,arms,6,4,2
Wariorwang,tichondrius,384,warrior,arms,6,4,2
Killaen,thrall,384,warrior,arms,6,4,2
Airhood,frostmourne,384,warrior,arms,6,4,2
Vãryan,frostmourne,384,warrior,arms,6,4,2
Thornhardt,frostmourne,384,warrior,arms,6,4,2
Zhangye,tichondrius,384,warrior,arms,6,4,2
Aægekaz,proudmoore,384,warrior,arms,6,4,2
Blucollardad,bleeding-hollow,384,warrior,arms,6,4,2
Gílly,borean-tundra,384,warrior,arms,6,4,2
Rinima,tichondrius,384,warrior,arms,6,4,2
Cheshe,area-52,384,warrior,arms,6,4,2
Trevmo,bloodscalp,384,warrior,arms,6,4,2
Koalabear,shadow-council,384,warrior,arms,6,4,2
Dazfury,barthilas,384,warrior,arms,6,4,2
Rottlingberg,kelthuzad,384,warrior,arms,6,4,2
Bailo,dathremar,384,warrior,arms,6,4,2
Frakt,illidan,384,warrior,arms,6,4,2
Gangdan,sargeras,384,warrior,arms,6,4,2
Còlòssal,moknathal,384,warrior,arms,6,4,2
Bruisebanner,area-52,384,warrior,arms,6,4,2
Gamörä,illidan,384,warrior,arms,6,4,2
Odalp,tichondrius,384,warrior,arms,6,4,2
Krokü,area-52,384,warrior,arms,6,4,2
Sakuraya,tichondrius,384,warrior,arms,6,4,2
Slapywar,illidan,384,warrior,arms,6,4,2
Neon,wildhammer,384,warrior,arms,6,4,2
Yêawen,tichondrius,384,warrior,arms,6,4,2
Bajheeraz,tichondrius,384,warrior,arms,6,4,2
Kahn,andorhal,384,warrior,arms,6,4,2
Babamama,tichondrius,384,warrior,arms,6,4,2
Báhamut,area-52,384,warrior,arms,6,4,2
Mòrgo,agamaggan,384,warrior,arms,6,4,2
Braxxìnn,tichondrius,384,warrior,arms,6,4,2
Mortalhandx,tichondrius,384,warrior,arms,6,4,2
Swillzz,illidan,384,warrior,arms,6,4,2
Littlegengar,tichondrius,384,warrior,arms,6,4,2
Keffdog,laughing-skull,384,warrior,arms,6,4,2
Malgoth,illidan,384,warrior,arms,6,4,2
Bajheeraz,sargeras,384,warrior,arms,6,4,2
Greenishfox,illidan,384,warrior,arms,9,5,4
Kalisandra,undermine,384,warrior,arms,10,5,5
Ragnarlbrok,goldrinn,384,warrior,arms,10,5,5
Maxprotein,area-52,384,warrior,arms,8,4,4
Jubeithos,draktharon,384,warrior,arms,11,5,6
Ailes,hakkar,384,warrior,arms,11,4,7
Snack,stormreaver,384,warrior,arms,12,4,8
Filth,tichondrius,384,warrior,arms,12,4,8
Tonesman,tichondrius,384,warrior,arms,12,4,8
Ulfioff,whisperwind,384,warrior,arms,12,4,8
Mindgoblin,bleeding-hollow,384,warrior,arms,12,4,8
Bigboy,icecrown,384,warrior,arms,12,4,8
Rocketbom,tichondrius,384,warrior,arms,12,4,8
Brendan,llane,384,warrior,arms,12,4,8
Tappyc,tichondrius,384,warrior,arms,12,4,8
Iridikron,dalaran,384,warrior,arms,12,4,8
Fortchin,area-52,384,warrior,arms,12,4,8
Handikap,stormrage,384,warrior,arms,12,4,8
Franticlol,tichondrius,384,warrior,arms,12,4,8
Stoneball,kiljaeden,384,warrior,arms,12,4,8
Zugface,tichondrius,384,warrior,arms,12,4,8
Warriormikey,tichondrius,384,warrior,arms,12,4,8
Jaclksparrow,azralon,384,warrior,arms,12,4,8
Nänchobo,tichondrius,384,warrior,arms,12,4,8
Dámöuse,stormrage,384,warrior,arms,12,4,8
Gangaa,barthilas,384,warrior,arms,12,4,8
Izhansheni,illidan,384,warrior,arms,12,4,8
Dessindir,quelthalas,384,warrior,arms,12,4,8
Licona,wyrmrest-accord,384,warrior,arms,12,4,8
Flexyx,arthas,384,warrior,arms,12,4,8
Draiken,dalaran,384,warrior,arms,12,4,8
Çrusha,thrall,384,warrior,arms,12,4,8
Renclave,wyrmrest-accord,384,warrior,arms,12,4,8
Xårren,stormrage,384,warrior,arms,12,4,8
Hârambe,kiljaeden,384,warrior,arms,12,4,8
Heliza,ragnaros,384,warrior,arms,12,4,8
Gazah,skullcrusher,384,warrior,arms,12,4,8
Moseshrute,zuljin,384,warrior,arms,12,4,8
Burstmacro,garrosh,384,warrior,arms,12,4,8
Koraciá,illidan,384,warrior,arms,12,4,8
Jasonsdady,illidan,384,warrior,arms,12,4,8
Stewwar,wyrmrest-accord,384,warrior,arms,12,4,8
Mefus,wyrmrest-accord,384,warrior,arms,12,4,8
Grândmâ,zuljin,384,warrior,arms,12,4,8
Durango,duskwood,384,warrior,arms,12,4,8
Furyofrage,dalaran,384,warrior,arms,12,4,8
Dâvo,area-52,384,warrior,arms,12,4,8
Kenedy,moon-guard,384,warrior,arms,12,4,8
Lui,the-forgotten-coast,384,warrior,arms,12,4,8
Rexxous,hyjal,384,warrior,arms,12,4,8
Sandrine,fizzcrank,384,warrior,arms,12,4,8
Laokan,illidan,384,warrior,arms,12,4,8
Còsmico,trollbane,384,warrior,arms,12,4,8
Hameey,sargeras,384,warrior,arms,12,4,8
Drewpqawk,tichondrius,384,warrior,arms,12,4,8
Twoshoutz,stormrage,384,warrior,arms,12,4,8
Amaus,queldorei,384,warrior,arms,12,4,8
Fuller,kelthuzad,384,warrior,arms,12,4,8
Ballsy,fenris,384,warrior,arms,12,4,8
Joekenshield,stonemaul,384,warrior,arms,12,4,8
Exist,kaelthas,384,warrior,arms,12,4,8
Totenhammer,nathrezim,384,warrior,arms,12,4,8
Koei,illidan,384,warrior,arms,12,4,8
Ladderx,area-52,384,warrior,arms,12,4,8
Syllana,sargeras,384,warrior,arms,12,4,8
Lundyswung,silver-hand,384,warrior,arms,12,4,8
Fatherkelso,tichondrius,384,warrior,arms,12,4,8
Nginx,queldorei,384,warrior,arms,12,4,8
Cupper,tichondrius,384,warrior,arms,12,4,8
Turkin,proudmoore,384,warrior,arms,12,4,8
Warspartan,stormrage,384,warrior,arms,12,4,8
Redrumman,demon-soul,384,warrior,arms,12,4,8
Gfree,kiljaeden,384,warrior,arms,12,4,8
Naelynh,quelthalas,384,warrior,arms,12,4,8
Tinydingo,sargeras,384,warrior,arms,12,4,8
Doully,proudmoore,384,warrior,arms,12,4,8
Tsurik,malfurion,384,warrior,arms,12,4,8
Palumorw,deathwing,384,warrior,arms,12,4,8
Iden,vashj,384,warrior,arms,12,4,8
Steelfist,grizzly-hills,384,warrior,arms,12,4,8
Barrocops,kiljaeden,384,warrior,arms,12,4,8
Grullhamer,ragnaros,384,warrior,arms,12,4,8
Metalhit,tichondrius,384,warrior,arms,12,4,8
Narduk,emerald-dream,384,warrior,arms,12,4,8
Magmaheart,lightbringer,384,warrior,arms,12,4,8
Iargestpp,bleeding-hollow,384,warrior,arms,12,4,8
Angrybrog,malfurion,384,warrior,arms,12,4,8
Nxmabala,proudmoore,384,warrior,arms,12,4,8
Varkery,sargeras,384,warrior,arms,13,4,9
Kyres,moon-guard,384,warrior,arms,16,4,12
Gladicus,zuljin,384,warrior,arms,18,4,14
Noppô,tichondrius,384,warrior,arms,18,4,14
Vargoth,frostmourne,384,warrior,arms,18,4,14
Dulapamore,tichondrius,384,warrior,arms,18,4,14
Retiarius,tichondrius,384,warrior,arms,18,4,14
Cowsgomerr,tichondrius,384,warrior,arms,18,4,14
Asphyxiating,illidan,384,warrior,arms,18,4,14
Yerajmiel,proudmoore,383,warrior,arms,6,4,2
Yeit,tichondrius,383,warrior,arms,6,4,2
Tookbeki,tichondrius,383,warrior,arms,6,4,2
Shìromìzù,eredar,383,warrior,arms,6,4,2
Ezaxe,tichondrius,383,warrior,arms,6,4,2
Chisum,gnomeregan,383,warrior,arms,6,4,2
Baroque,darkspear,383,warrior,arms,12,4,8
Ajamu,aegwynn,383,warrior,arms,12,4,8
Shabus,moon-guard,383,warrior,arms,12,4,8
Spitbeard,kargath,383,warrior,arms,12,4,8
Christellà,dalaran,383,warrior,arms,18,4,14
Såmmÿ,moon-guard,379,warrior,arms,12,4,8
Lightstrikes,sargeras,379,warrior,arms,12,4,8
Dingoe,wyrmrest-accord,379,warrior,arms,12,4,8
Ayuko,greymane,367,warrior,arms,11,4,7
Loomine,illidan,367,warrior,arms,11,4,7
Warsins,bonechewer,367,warrior,arms,17,4,13
Tecnowar,quelthalas,352,warrior,arms,10,4,6
Bellonar,stormrage,351,warrior,arms,8,5,3
Raygé,malygos,351,warrior,arms,8,5,3
Thøros,moon-guard,351,warrior,arms,11,4,7
Förkz,ragnaros,351,warrior,arms,11,4,7
Vaetren,area-52,351,warrior,arms,11,4,7
Moostorm,darkspear,351,warrior,arms,11,4,7
Pachacutec,area-52,351,warrior,arms,14,5,9
Matasimio,drakkari,336,warrior,arms,9,4,5
Caynos,stormrage,335,warrior,arms,11,4,7
Toir,bladefist,335,warrior,arms,11,4,7
Ashrah,emerald-dream,330,warrior,arms,9,5,4
Nanaru,tichondrius,330,warrior,arms,17,6,11
Rubbers,thrall,330,warrior,arms,17,6,11
Macray,zuljin,330,warrior,arms,18,5,13
Machatlan,stormrage,324,warrior,arms,16,7,9
Lildumptruck,emerald-dream,320,warrior,arms,10,4,6
Painstake,illidan,320,warrior,arms,19,5,14
Toetoeto,darrowmere,319,warrior,arms,5,4,1
Bruze,hellscream,319,warrior,arms,8,4,4
Knewty,stormrage,319,warrior,arms,8,4,4
Cptdrako,alterac-mountains,319,warrior,arms,8,4,4
Rauwers,azralon,319,warrior,arms,8,4,4
Dadookibooty,area-52,319,warrior,arms,8,4,4
Armada,sargeras,319,warrior,arms,8,4,4
Kleavage,korgath,304,warrior,arms,13,4,9
Pezek,thrall,288,warrior,arms,6,3,3
Badboyjan,tichondrius,288,warrior,arms,6,3,3
Twoone,illidan,288,warrior,arms,6,3,3
Baye,kargath,288,warrior,arms,6,3,3
Trackhawk,moon-guard,288,warrior,arms,6,3,3
Philipjoo,illidan,288,warrior,arms,6,3,3
Spirìt,illidan,288,warrior,arms,6,3,3
Skullsplittr,illidan,288,warrior,arms,6,3,3
Helrise,sargeras,288,warrior,arms,6,3,3
Rockybâlboa,illidan,288,warrior,arms,6,3,3
Orkwar,tichondrius,288,warrior,arms,6,3,3
Trashman,frostwolf,288,warrior,arms,6,3,3
Êraser,tichondrius,288,warrior,arms,6,3,3
Swizzly,tichondrius,288,warrior,arms,6,3,3
Execute,kirin-tor,288,warrior,arms,6,3,3
Ushouldnome,tichondrius,288,warrior,arms,6,3,3
Ellx,sargeras,288,warrior,arms,6,3,3
Tommygunns,area-52,288,warrior,arms,6,3,3
Jabakas,tichondrius,288,warrior,arms,6,3,3
Bilboswagins,agamaggan,288,warrior,arms,6,3,3
Hitmypronoun,illidan,288,warrior,arms,6,3,3
Salveknight,ragnaros,288,warrior,arms,6,3,3
Larosfan,tichondrius,288,warrior,arms,6,3,3
Tnytank,burning-legion,288,warrior,arms,6,3,3
Seymourbot,illidan,288,warrior,arms,6,3,3
Shiromiya,tichondrius,288,warrior,arms,6,3,3
Solembuumm,illidan,288,warrior,arms,6,3,3
Cabelas,tichondrius,288,warrior,arms,6,3,3
Huffzo,tichondrius,288,warrior,arms,6,3,3
Nazakeen,tichondrius,288,warrior,arms,6,3,3
Cheekclapps,tichondrius,288,warrior,arms,6,3,3
Husyuzhi,tichondrius,288,warrior,arms,6,3,3
Pneumasmash,tichondrius,288,warrior,arms,6,3,3
Davien,tichondrius,288,warrior,arms,6,3,3
Éten,drakkari,288,warrior,arms,6,3,3
Thunderess,illidan,288,warrior,arms,6,3,3
Downblow,tichondrius,288,warrior,arms,6,3,3
Schlosh,laughing-skull,288,warrior,arms,6,3,3
Zåzriel,tichondrius,288,warrior,arms,6,3,3
Manbok,tichondrius,288,warrior,arms,6,3,3
Críxus,sargeras,288,warrior,arms,6,3,3
Warriorbod,area-52,288,warrior,arms,6,3,3
Endurefen,sargeras,288,warrior,arms,6,3,3
Scottpilgrim,illidan,288,warrior,arms,6,3,3
Outterspace,illidan,288,warrior,arms,6,3,3
Zugsok,thrall,288,warrior,arms,6,3,3
Kryptïç,moon-guard,288,warrior,arms,6,3,3
Herey,moon-guard,288,warrior,arms,6,3,3
Polox,ragnaros,288,warrior,arms,6,3,3
Geubsal,tichondrius,288,warrior,arms,6,3,3
Grapegush,bleeding-hollow,288,warrior,arms,6,3,3
Mandofl,ragnaros,288,warrior,arms,6,3,3
Hukzula,illidan,288,warrior,arms,6,3,3
Tothepain,thrall,288,warrior,arms,6,3,3
Soyu,tichondrius,288,warrior,arms,6,3,3
Faywarsong,area-52,288,warrior,arms,6,3,3
Thaedes,kelthuzad,288,warrior,arms,6,3,3
Akilosh,illidan,288,warrior,arms,6,3,3
Wulfgarn,frostwolf,288,warrior,arms,6,3,3
Jamajuicedx,thrall,288,warrior,arms,6,3,3
Fivewarrior,tichondrius,288,warrior,arms,6,3,3
Zemi,sargeras,288,warrior,arms,6,3,3
Axeslaps,illidan,288,warrior,arms,6,3,3
Drudw,moon-guard,288,warrior,arms,6,3,3
Bachyr,stormrage,288,warrior,arms,6,3,3
Fakktwo,blackhand,288,warrior,arms,6,3,3
Hanginaround,zuluhed,288,warrior,arms,6,3,3
Hesch,thunderlord,288,warrior,arms,6,3,3
Wqnmlgbd,tichondrius,288,warrior,arms,6,3,3
Ughh,bleeding-hollow,288,warrior,arms,6,3,3
Spartanfury,tichondrius,288,warrior,arms,6,3,3
Mesw,illidan,288,warrior,arms,6,3,3
Mcrîb,stormscale,288,warrior,arms,6,3,3
Az,malorne,288,warrior,arms,6,3,3
Nukehazard,bleeding-hollow,288,warrior,arms,6,3,3
Hateuu,tichondrius,288,warrior,arms,6,3,3
Wrèckingball,tichondrius,288,warrior,arms,6,3,3
Luckybrother,tichondrius,288,warrior,arms,6,3,3
Readytoflee,moon-guard,288,warrior,arms,6,3,3
Linjunfeng,tichondrius,288,warrior,arms,6,3,3
Topee,area-52,288,warrior,arms,6,3,3
Poppacd,stormrage,288,warrior,arms,6,3,3
Idarkshakra,illidan,288,warrior,arms,6,3,3
Vãnth,kelthuzad,288,warrior,arms,6,3,3
Rockhardt,tichondrius,288,warrior,arms,6,3,3
Humanlog,illidan,288,warrior,arms,6,3,3
Iwishiknew,kargath,288,warrior,arms,6,3,3
Ragemelon,icecrown,288,warrior,arms,6,3,3
Evôlutiôn,kelthuzad,288,warrior,arms,6,3,3
Robio,tichondrius,288,warrior,arms,6,3,3
Qutuz,illidan,288,warrior,arms,6,3,3
Kénblock,tichondrius,288,warrior,arms,6,3,3
Drugdilla,zuljin,288,warrior,arms,6,3,3
Udmwarrior,zuljin,288,warrior,arms,6,3,3
Mortaryon,malganis,288,warrior,arms,6,3,3
Evach,kelthuzad,288,warrior,arms,6,3,3
Dazuu,illidan,288,warrior,arms,6,3,3
Smashndspin,sargeras,288,warrior,arms,6,3,3
Zenmore,illidan,288,warrior,arms,6,3,3
Exiledwarz,area-52,288,warrior,arms,6,3,3
Ei,darrowmere,288,warrior,arms,6,3,3
Elessarr,moon-guard,288,warrior,arms,6,3,3
Dunsker,stormrage,288,warrior,arms,6,3,3
Bëowulf,malganis,288,warrior,arms,6,3,3
Azeryan,azralon,288,warrior,arms,6,3,3
Sweetmojito,vashj,288,warrior,arms,6,3,3
Duglug,malganis,288,warrior,arms,6,3,3
Saelaa,azralon,288,warrior,arms,6,3,3
Smash,frostmane,288,warrior,arms,6,3,3
Renning,malganis,288,warrior,arms,6,3,3
Faelzerá,azralon,288,warrior,arms,6,3,3
Tiitlefight,bleeding-hollow,288,warrior,arms,6,3,3
Drakr,ragnaros,288,warrior,arms,6,3,3
Allmotor,zuljin,288,warrior,arms,6,3,3
Jackanape,sargeras,288,warrior,arms,6,3,3
Cryptex,illidan,288,warrior,arms,6,3,3
Swifty,tichondrius,288,warrior,arms,6,3,3
Robostergler,tichondrius,288,warrior,arms,6,3,3
Tomcruizes,tichondrius,288,warrior,arms,6,3,3
Dublinn,llane,288,warrior,arms,6,3,3
Staticego,dalaran,288,warrior,arms,6,3,3
Rezorc,stormrage,288,warrior,arms,6,3,3
Gaydin,eldrethalas,288,warrior,arms,6,3,3
Marraneitor,quelthalas,288,warrior,arms,6,3,3
Daduké,stormrage,288,warrior,arms,6,3,3
Endstorm,proudmoore,288,warrior,arms,6,3,3
Ichigami,kelthuzad,288,warrior,arms,6,3,3
Batchat,frostmourne,288,warrior,arms,6,3,3
Warnuk,lightnings-blade,288,warrior,arms,6,3,3
Jerveen,quelthalas,288,warrior,arms,6,3,3
Jutank,sargeras,288,warrior,arms,6,3,3
Orryn,proudmoore,288,warrior,arms,6,3,3
Hopefulki,duskwood,288,warrior,arms,6,3,3
Magthor,warsong,288,warrior,arms,6,3,3
Corrum,shuhalo,288,warrior,arms,6,3,3
Osselan,moon-guard,288,warrior,arms,6,3,3
Fyle,stormrage,288,warrior,arms,6,3,3
Milbën,tichondrius,288,warrior,arms,6,3,3
Sambojüjü,stormrage,288,warrior,arms,6,3,3
Reishera,stormrage,288,warrior,arms,6,3,3
Daedrion,dalaran,288,warrior,arms,6,3,3
Glowstick,tichondrius,288,warrior,arms,6,3,3
Gypsypsycho,stormrage,288,warrior,arms,6,3,3
Zulataza,zuljin,288,warrior,arms,6,3,3
Uzy,proudmoore,288,warrior,arms,6,3,3
Pummels,area-52,288,warrior,arms,6,3,3
Imperiial,stormrage,288,warrior,arms,6,3,3
Kuntahkintah,tichondrius,288,warrior,arms,6,3,3
Assmut,stormrage,288,warrior,arms,6,3,3
Krïtzkreig,the-forgotten-coast,288,warrior,arms,6,3,3
Sweeped,darkspear,288,warrior,arms,6,3,3
Nitron,dawnbringer,288,warrior,arms,6,3,3
Exdilla,zuljin,288,warrior,arms,6,3,3
Retrô,uldum,288,warrior,arms,6,3,3
Staystrong,tichondrius,288,warrior,arms,6,3,3
Deadlypsycho,moonrunner,288,warrior,arms,6,3,3
Biggieswords,madoran,288,warrior,arms,6,3,3
Kroni,ragnaros,288,warrior,arms,6,3,3
Sauceslinga,frostmourne,288,warrior,arms,6,3,3
Leeth,azralon,288,warrior,arms,6,3,3
Rendron,frostmourne,288,warrior,arms,6,3,3
Zuiken,kiljaeden,288,warrior,arms,6,3,3
Aggor,trollbane,288,warrior,arms,6,3,3
Cbum,quelthalas,288,warrior,arms,6,3,3
Hìtchslap,tichondrius,288,warrior,arms,6,3,3
Clerond,tichondrius,288,warrior,arms,6,3,3
Buddhahood,tichondrius,288,warrior,arms,6,3,3
Noteko,tichondrius,288,warrior,arms,6,3,3
Scanlan,dalvengyr,288,warrior,arms,6,3,3
Caalypso,stormrage,288,warrior,arms,6,3,3
Moonsworn,moon-guard,288,warrior,arms,6,3,3
Valför,ysera,288,warrior,arms,6,3,3
Tharsìs,emerald-dream,288,warrior,arms,6,3,3
Grognäk,malganis,288,warrior,arms,6,3,3
Warreeper,area-52,288,warrior,arms,6,3,3
Mittyroar,khazgoroth,288,warrior,arms,6,3,3
Slamedi,frostmourne,288,warrior,arms,6,3,3
Swàgnáros,area-52,288,warrior,arms,6,3,3
Tread,mugthol,288,warrior,arms,6,3,3
Vinetic,kiljaeden,288,warrior,arms,6,3,3
Sunhands,emerald-dream,288,warrior,arms,6,3,3
Madhouse,tanaris,288,warrior,arms,6,3,3
Executing,emerald-dream,288,warrior,arms,6,3,3
Kushe,moon-guard,288,warrior,arms,6,3,3
Notawar,stormrage,288,warrior,arms,6,3,3
Temperament,area-52,288,warrior,arms,6,3,3
Vistacleave,maiev,288,warrior,arms,6,3,3
Kokurawr,burning-legion,288,warrior,arms,6,3,3
Poonoxo,gundrak,288,warrior,arms,6,3,3
Alejandrica,ragnaros,288,warrior,arms,6,3,3
Ghomory,quelthalas,288,warrior,arms,6,3,3
Telynne,frostmourne,288,warrior,arms,6,3,3
Aintou,aegwynn,288,warrior,arms,6,3,3
Tinylimbs,frostmourne,288,warrior,arms,6,3,3
Aalrua,moon-guard,288,warrior,arms,6,3,3
Targramu,emerald-dream,288,warrior,arms,6,3,3
Ðuffman,jubeithos,288,warrior,arms,6,3,3
Mikero,terenas,288,warrior,arms,6,3,3
Zibby,malganis,288,warrior,arms,6,3,3
Liltotey,frostmourne,288,warrior,arms,6,3,3
Benieswar,frostmourne,288,warrior,arms,6,3,3
Demetrïus,moon-guard,288,warrior,arms,6,3,3
Fregory,moon-guard,288,warrior,arms,6,3,3
Carborr,frostmourne,288,warrior,arms,6,3,3
Bigshett,sargeras,288,warrior,arms,6,3,3
Hungdiesel,area-52,288,warrior,arms,6,3,3
Leonidas,barthilas,288,warrior,arms,6,3,3
Rageslayer,area-52,288,warrior,arms,9,4,5
Metaphoric,stormrage,288,warrior,arms,9,4,5
Kwelve,proudmoore,288,warrior,arms,7,3,4
Ohdang,dark-iron,288,warrior,arms,8,3,5
Ennia,azralon,288,warrior,arms,9,3,6
Shewar,ragnaros,288,warrior,arms,9,3,6
Akil,ragnaros,288,warrior,arms,15,4,11
Basingsei,area-52,288,warrior,arms,12,3,9
Minnysota,area-52,288,warrior,arms,12,3,9
Scrubzwarr,barthilas,288,warrior,arms,12,3,9
Rahgnarson,kelthuzad,288,warrior,arms,12,3,9
Ichil,azshara,288,warrior,arms,12,3,9
Xdragonfirex,terenas,288,warrior,arms,12,3,9
Fupatwo,moon-guard,288,warrior,arms,12,3,9
Kintownhero,aegwynn,288,warrior,arms,12,3,9
Enulimen,daggerspine,288,warrior,arms,12,3,9
Smallraccoon,tichondrius,288,warrior,arms,12,3,9
Chardz,ragnaros,288,warrior,arms,12,3,9
Kregnar,gundrak,288,warrior,arms,12,3,9
Äisemberg,quelthalas,288,warrior,arms,12,3,9
Erzawälkër,quelthalas,288,warrior,arms,12,3,9
Legnar,malganis,288,warrior,arms,12,3,9
Porori,proudmoore,288,warrior,arms,12,3,9
Kero,malganis,288,warrior,arms,12,3,9
Amberlym,ragnaros,288,warrior,arms,12,3,9
Kigo,azralon,288,warrior,arms,12,3,9
Phargo,korgath,288,warrior,arms,12,3,9
Weepingdeath,burning-legion,288,warrior,arms,12,3,9
Kamigoroshi,crushridge,288,warrior,arms,12,3,9
Alliancerulz,darrowmere,288,warrior,arms,12,3,9
Fatalian,proudmoore,288,warrior,arms,12,3,9
Extremist,nagrand,288,warrior,arms,12,3,9
Neltar,nagrand,288,warrior,arms,12,3,9
Aræn,sargeras,288,warrior,arms,12,3,9
Greenmachine,twisting-nether,288,warrior,arms,12,3,9
Wxxz,tichondrius,288,warrior,arms,12,3,9
Guerreraa,ragnaros,288,warrior,arms,12,3,9
Doomr,tichondrius,288,warrior,arms,12,3,9
Durist,tichondrius,288,warrior,arms,12,3,9
Morgithia,suramar,288,warrior,arms,12,3,9
Wasabiz,tichondrius,288,warrior,arms,12,3,9
Vobiscum,drakkari,288,warrior,arms,12,3,9
Dablao,tichondrius,288,warrior,arms,12,3,9
Edmaghar,ragnaros,288,warrior,arms,12,3,9
Pretending,dalaran,288,warrior,arms,12,3,9
Ggéz,stormrage,288,warrior,arms,12,3,9
Valestrike,moon-guard,288,warrior,arms,12,3,9
Brütalize,wyrmrest-accord,288,warrior,arms,12,3,9
Sabini,nemesis,288,warrior,arms,12,3,9
Bjjorm,malganis,288,warrior,arms,12,3,9
Aztecvil,drakkari,288,warrior,arms,12,3,9
Mansin,tichondrius,288,warrior,arms,12,3,9
Hrl,tichondrius,288,warrior,arms,12,3,9
Kiillwar,smolderthorn,288,warrior,arms,12,3,9
Gnomas,destromath,288,warrior,arms,12,3,9
Rflexxo,tichondrius,288,warrior,arms,12,3,9
Eihn,quelthalas,288,warrior,arms,21,5,16
Slamspam,the-underbog,288,warrior,arms,13,3,10
Bornclueless,illidan,288,warrior,arms,15,3,12
Khallell,illidan,288,warrior,arms,18,3,15
Boardslide,proudmoore,288,warrior,arms,18,3,15
Macbride,blackrock,288,warrior,arms,24,3,21
Kì,moon-guard,287,warrior,arms,6,3,3
Yomaaln,blackrock,287,warrior,arms,6,3,3
Lilwarrior,blackrock,287,warrior,arms,6,3,3
Magtharas,dunemaul,287,warrior,arms,6,3,3
Smashthings,area-52,287,warrior,arms,6,3,3
Saintgeorge,thorium-brotherhood,287,warrior,arms,6,3,3
Brutekush,barthilas,287,warrior,arms,12,3,9
Leosax,drakthul,287,warrior,arms,12,3,9
Clayske,gurubashi,287,warrior,arms,12,3,9
Angryskeever,garona,287,warrior,arms,12,3,9
Borgosa,wyrmrest-accord,287,warrior,arms,18,3,15
Dazanor,moon-guard,271,warrior,arms,11,3,8
Nooy,blackrock,271,warrior,arms,17,3,14
Azindar,gilneas,256,warrior,arms,4,4,0
Thorsën,sargeras,256,warrior,arms,8,4,4
Nècroxious,hellscream,255,warrior,arms,11,3,8
Spicywagyu,tichondrius,255,warrior,arms,11,3,8
Omicripto,tichondrius,239,warrior,arms,5,3,2
Likearock,thrall,239,warrior,arms,5,3,2
ßlitzxkreig,tichondrius,239,warrior,arms,5,3,2
Jÿp,tichondrius,239,warrior,arms,5,3,2
Kalphok,tichondrius,239,warrior,arms,5,3,2
Jackedaniels,stormrage,239,warrior,arms,6,3,3
Nayaqt,tichondrius,223,warrior,arms,8,3,5
Benchpress,bleeding-hollow,223,warrior,arms,8,3,5
Condemnd,area-52,207,warrior,arms,8,3,5
Elyn,tichondrius,192,warrior,arms,4,3,1
Stickystorm,proudmoore,192,warrior,arms,4,3,1
Wonderjack,akama,192,warrior,arms,4,3,1
Corthíus,stormrage,192,warrior,arms,4,3,1
Berru,bleeding-hollow,192,warrior,arms,9,3,6
Cugino,tichondrius,192,warrior,arms,9,3,6
Primørdíal,tichondrius,192,warrior,arms,6,2,4
Lazarenthus,stormrage,192,warrior,arms,6,2,4
Raldoron,thrall,192,warrior,arms,6,2,4
Anabolicjim,frostmourne,192,warrior,arms,6,2,4
Nabii,tichondrius,192,warrior,arms,6,2,4
Kvnñ,frostmourne,192,warrior,arms,6,2,4
Mongofiera,quelthalas,192,warrior,arms,6,2,4
Glamen,alleria,192,warrior,arms,6,2,4
Nordrages,stormrage,192,warrior,arms,6,2,4
Àyo,frostmourne,192,warrior,arms,6,2,4
Yeèzy,stormrage,192,warrior,arms,6,2,4
Maxalyss,stormrage,192,warrior,arms,6,2,4
Snikkles,frostmourne,192,warrior,arms,6,2,4
Draenøk,tichondrius,192,warrior,arms,6,2,4
Tobiwan,ragnaros,192,warrior,arms,6,2,4
Åmowarr,illidan,192,warrior,arms,6,2,4
Bjorgsen,frostmourne,192,warrior,arms,6,2,4
Wooglinx,stormrage,192,warrior,arms,6,2,4
Lawyer,quelthalas,192,warrior,arms,6,2,4
Swingú,illidan,192,warrior,arms,6,2,4
Hamslamm,area-52,192,warrior,arms,6,2,4
Wakkawar,stormrage,192,warrior,arms,6,2,4
Rambð,illidan,192,warrior,arms,6,2,4
Hagger,quelthalas,192,warrior,arms,6,2,4
Ronipastrami,kelthuzad,192,warrior,arms,6,2,4
Chura,kiljaeden,192,warrior,arms,6,2,4
Uglycubano,quelthalas,192,warrior,arms,6,2,4
Vegr,queldorei,192,warrior,arms,6,2,4
Orcbum,kiljaeden,192,warrior,arms,6,2,4
Ponchetas,quelthalas,192,warrior,arms,6,2,4
Nerffrogues,stormrage,192,warrior,arms,6,2,4
Ðåddý,stormrage,192,warrior,arms,6,2,4
Bigdickgomez,frostmourne,192,warrior,arms,6,2,4
Nogèt,frostmourne,192,warrior,arms,6,2,4
Lhariza,stormrage,192,warrior,arms,6,2,4
Endlesskilla,destromath,192,warrior,arms,6,2,4
Mikejustice,kelthuzad,192,warrior,arms,6,2,4
Dahakawar,malganis,192,warrior,arms,6,2,4
Riggs,stonemaul,192,warrior,arms,6,2,4
Lgnasty,area-52,192,warrior,arms,6,2,4
Gtrain,barthilas,192,warrior,arms,6,2,4
Rudakoff,ragnaros,192,warrior,arms,6,2,4
Wl,ragnaros,192,warrior,arms,6,2,4
Bearlornan,frostmourne,192,warrior,arms,6,2,4
Xaviorn,illidan,192,warrior,arms,6,2,4
Kostikk,tichondrius,192,warrior,arms,6,2,4
Ggrone,ragnaros,192,warrior,arms,6,2,4
Hellabandz,bleeding-hollow,192,warrior,arms,6,2,4
Soldiër,proudmoore,192,warrior,arms,6,2,4
Zolotrollo,area-52,192,warrior,arms,6,2,4
Düde,whisperwind,192,warrior,arms,6,2,4
Warkaiser,ragnaros,192,warrior,arms,6,2,4
Guroku,tichondrius,192,warrior,arms,6,2,4
Smokinlean,chogall,192,warrior,arms,6,2,4
Berario,garrosh,192,warrior,arms,6,2,4
Kreits,drakkari,192,warrior,arms,6,2,4
Karlsabad,medivh,192,warrior,arms,6,2,4
Frankal,aegwynn,192,warrior,arms,6,2,4
Justicwar,area-52,192,warrior,arms,6,2,4
Elimination,tichondrius,192,warrior,arms,6,2,4
Pisagnòmos,quelthalas,192,warrior,arms,6,2,4
Superbest,tichondrius,192,warrior,arms,6,2,4
Drtbag,tichondrius,192,warrior,arms,6,2,4
Bbyzugga,kelthuzad,192,warrior,arms,6,2,4
Trouz,ragnaros,192,warrior,arms,6,2,4
Danskmand,tichondrius,192,warrior,arms,6,2,4
Stinkdog,khazgoroth,192,warrior,arms,6,2,4
Tüssèll,khazgoroth,192,warrior,arms,6,2,4
Xurug,zuljin,192,warrior,arms,6,2,4
Bennybrock,crushridge,192,warrior,arms,6,2,4
Tallix,smolderthorn,192,warrior,arms,6,2,4
Chapa,tichondrius,192,warrior,arms,6,2,4
Trigon,chromaggus,192,warrior,arms,6,2,4
Suavay,executus,192,warrior,arms,6,2,4
Befòx,tichondrius,192,warrior,arms,6,2,4
Akaínu,area-52,192,warrior,arms,6,2,4
Deldramor,proudmoore,192,warrior,arms,6,2,4
Kinaed,durotan,192,warrior,arms,6,2,4
Icebringer,frostmourne,192,warrior,arms,6,2,4
Orphenkaos,bleeding-hollow,192,warrior,arms,6,2,4
Bogii,area-52,192,warrior,arms,6,2,4
Swolthelas,tichondrius,192,warrior,arms,6,2,4
Stormbadge,tichondrius,192,warrior,arms,6,2,4
Shiestyzug,tichondrius,192,warrior,arms,6,2,4
Jírky,ragnaros,192,warrior,arms,6,2,4
Ningz,tichondrius,192,warrior,arms,6,2,4
Annubiis,tichondrius,192,warrior,arms,6,2,4
Hbbaboy,nagrand,192,warrior,arms,6,2,4
Sylvannlee,tichondrius,192,warrior,arms,6,2,4
Slamzftw,stormreaver,192,warrior,arms,6,2,4
Warmachined,grizzly-hills,192,warrior,arms,6,2,4
Sonicboom,whisperwind,192,warrior,arms,6,2,4
Braxxinn,tichondrius,192,warrior,arms,6,2,4
Esko,tichondrius,192,warrior,arms,6,2,4
Ahore,illidan,192,warrior,arms,6,2,4
Tansozzi,tichondrius,192,warrior,arms,6,2,4
Sypii,malganis,192,warrior,arms,6,2,4
Focalabbys,illidan,192,warrior,arms,6,2,4
Uldrath,hyjal,192,warrior,arms,6,2,4
Fabszord,nemesis,192,warrior,arms,6,2,4
Rendus,hyjal,192,warrior,arms,6,2,4
Deloum,tichondrius,192,warrior,arms,6,2,4
Tarkvs,ragnaros,192,warrior,arms,6,2,4
Kimuraa,hyjal,192,warrior,arms,6,2,4
Corazondleón,ragnaros,192,warrior,arms,6,2,4
Kratøz,tichondrius,192,warrior,arms,6,2,4
Laintimee,tichondrius,192,warrior,arms,6,2,4
Maudlewis,bladefist,192,warrior,arms,6,2,4
Agoge,stormrage,192,warrior,arms,6,2,4
Bradic,bladefist,192,warrior,arms,6,2,4
Dreadworld,bleeding-hollow,192,warrior,arms,6,2,4
Derr,tichondrius,192,warrior,arms,6,2,4
Kirikash,illidan,192,warrior,arms,6,2,4
Scrubwarrior,black-dragonflight,192,warrior,arms,6,2,4
Burstful,bleeding-hollow,192,warrior,arms,6,2,4
Aistine,alterac-mountains,192,warrior,arms,6,2,4
Squonks,kelthuzad,192,warrior,arms,6,2,4
Ignorebrain,tichondrius,192,warrior,arms,6,2,4
Trenbopanda,tichondrius,192,warrior,arms,6,2,4
Noblêsix,dalaran,192,warrior,arms,6,2,4
Kraff,tichondrius,192,warrior,arms,6,2,4
Papichoppyme,bleeding-hollow,192,warrior,arms,6,2,4
Helminth,kirin-tor,192,warrior,arms,6,2,4
Playbox,area-52,192,warrior,arms,6,2,4
Luchonamøm,ragnaros,192,warrior,arms,6,2,4
Titanwarr,malganis,192,warrior,arms,6,2,4
Nachobeef,illidan,192,warrior,arms,6,2,4
Eleenoor,drakkari,192,warrior,arms,6,2,4
Mixx,bleeding-hollow,192,warrior,arms,6,2,4
Gátzú,ragnaros,192,warrior,arms,6,2,4
Pippysmallz,tichondrius,192,warrior,arms,6,2,4
Crimsóñ,kelthuzad,192,warrior,arms,6,2,4
Taigola,aggramar,192,warrior,arms,6,2,4
Verwischen,zuljin,192,warrior,arms,6,2,4
Passionjar,bleeding-hollow,192,warrior,arms,6,2,4
Notsi,ragnaros,192,warrior,arms,6,2,4
Dalmor,stormrage,192,warrior,arms,6,2,4
Guanabacoa,area-52,192,warrior,arms,6,2,4
Negrolas,nemesis,192,warrior,arms,6,2,4
Airolol,tichondrius,192,warrior,arms,6,2,4
Uprisèn,illidan,192,warrior,arms,6,2,4
Iapologiz,illidan,192,warrior,arms,6,2,4
Rekitralph,tichondrius,192,warrior,arms,6,2,4
Meanface,malganis,192,warrior,arms,6,2,4
Drashka,ragnaros,192,warrior,arms,6,2,4
Jessicajinn,illidan,192,warrior,arms,6,2,4
Brenrainn,thrall,192,warrior,arms,6,2,4
Fùzzy,zuluhed,192,warrior,arms,6,2,4
Èxecutè,area-52,192,warrior,arms,6,2,4
Hawaiianko,guldan,192,warrior,arms,6,2,4
Pép,malganis,192,warrior,arms,6,2,4
Tanksbad,lightnings-blade,192,warrior,arms,6,2,4
Shrexecute,tichondrius,192,warrior,arms,6,2,4
Donni,kelthuzad,192,warrior,arms,6,2,4
Chuck,zangarmarsh,192,warrior,arms,6,2,4
Tinykong,zuljin,192,warrior,arms,6,2,4
Sosaalmigh,tichondrius,192,warrior,arms,6,2,4
Flexid,tichondrius,192,warrior,arms,6,2,4
Bloren,thrall,192,warrior,arms,6,2,4
Jakelope,proudmoore,192,warrior,arms,6,2,4
Annihilataur,blackhand,192,warrior,arms,6,2,4
Gigglamesh,muradin,192,warrior,arms,6,2,4
Enzothebaker,thrall,192,warrior,arms,6,2,4
Melancalli,thorium-brotherhood,192,warrior,arms,6,2,4
Dodiru,azralon,192,warrior,arms,6,2,4
Bonetotem,azralon,192,warrior,arms,6,2,4
Irondefense,thrall,192,warrior,arms,6,2,4
Hugezs,tichondrius,192,warrior,arms,6,2,4
Thresdan,emerald-dream,192,warrior,arms,6,2,4
Wonbin,moon-guard,192,warrior,arms,6,2,4
Mochigome,moon-guard,192,warrior,arms,6,2,4
Relaxnerdlol,antonidas,192,warrior,arms,6,2,4
Mahknut,moon-guard,192,warrior,arms,6,2,4
Åres,wyrmrest-accord,192,warrior,arms,6,2,4
Deseroth,sargeras,192,warrior,arms,6,2,4
Donpepe,sargeras,192,warrior,arms,6,2,4
Skalvi,moon-guard,192,warrior,arms,6,2,4
Moosoka,malorne,192,warrior,arms,6,2,4
Rassius,sargeras,192,warrior,arms,6,2,4
Rekshor,wyrmrest-accord,192,warrior,arms,6,2,4
Pollere,firetree,192,warrior,arms,6,2,4
Bigdickfever,sargeras,192,warrior,arms,6,2,4
Aavyrre,moon-guard,192,warrior,arms,6,2,4
Zerríck,moon-guard,192,warrior,arms,6,2,4
Tormite,spirestone,192,warrior,arms,6,2,4
Oðín,emerald-dream,192,warrior,arms,6,2,4
Valky,sargeras,192,warrior,arms,6,2,4
Ðíablø,tichondrius,192,warrior,arms,6,2,4
Oneeyewille,sargeras,192,warrior,arms,6,2,4
Racky,dragonmaw,192,warrior,arms,6,2,4
Smashyu,fenris,192,warrior,arms,6,2,4
Rí,moon-guard,192,warrior,arms,6,2,4
Daechoochoo,frostwolf,192,warrior,arms,6,2,4
Berserkchow,sargeras,192,warrior,arms,6,2,4
Jäëgër,moon-guard,192,warrior,arms,6,2,4
Eurthx,lightbringer,192,warrior,arms,6,2,4
Flakesskillz,darkspear,192,warrior,arms,6,2,4
Lopotron,sargeras,192,warrior,arms,6,2,4
Alppha,emerald-dream,192,warrior,arms,6,2,4
Zekken,blades-edge,192,warrior,arms,6,2,4
Angelsantos,sargeras,192,warrior,arms,6,2,4
Fugmaface,sargeras,192,warrior,arms,6,2,4
Flexo,moon-guard,192,warrior,arms,6,2,4
Gnizzmo,sargeras,192,warrior,arms,6,2,4
Sezariùs,darkspear,192,warrior,arms,6,2,4
Twobyfuor,sargeras,192,warrior,arms,6,2,4
Suhwoosh,bleeding-hollow,192,warrior,arms,10,3,7
Bondadoso,stormrage,192,warrior,arms,7,2,5
Rickyxp,aggramar,192,warrior,arms,7,2,5
Sinenrs,tichondrius,192,warrior,arms,8,2,6
Xavíerus,tichondrius,192,warrior,arms,9,2,7
Lokiullr,tichondrius,192,warrior,arms,11,2,9
Hiddensquids,laughing-skull,192,warrior,arms,11,2,9
Loveliuna,illidan,192,warrior,arms,12,2,10
Loktaromoose,frostmourne,192,warrior,arms,12,2,10
Kurzix,crushridge,192,warrior,arms,12,2,10
Twoironfist,azralon,192,warrior,arms,12,2,10
Containerbox,korgath,192,warrior,arms,12,2,10
Warhoofz,malganis,192,warrior,arms,12,2,10
Soultarius,sargeras,192,warrior,arms,12,2,10
Erwin,kiljaeden,192,warrior,arms,12,2,10
Rios,jubeithos,192,warrior,arms,12,2,10
Gornal,sargeras,192,warrior,arms,12,2,10
Aymadommy,illidan,192,warrior,arms,12,2,10
Rraw,demon-soul,192,warrior,arms,12,2,10
Bronkyaf,hyjal,192,warrior,arms,12,2,10
Léonwow,tichondrius,192,warrior,arms,12,2,10
Arthurston,tichondrius,192,warrior,arms,12,2,10
Råging,area-52,192,warrior,arms,12,2,10
Haruq,tichondrius,192,warrior,arms,12,2,10
Hellswine,barthilas,192,warrior,arms,12,2,10
Kaimera,echo-isles,192,warrior,arms,12,2,10
Item,nerzhul,192,warrior,arms,12,2,10
Lawlstørm,stormrage,192,warrior,arms,12,2,10
Gambii,moon-guard,192,warrior,arms,12,2,10
Hiness,tichondrius,192,warrior,arms,12,2,10
Schecterguy,area-52,192,warrior,arms,14,2,12
Fallensoul,nazjatar,192,warrior,arms,14,2,12
Humminity,quelthalas,192,warrior,arms,14,2,12
Hazell,gundrak,191,warrior,arms,6,2,4
Krátös,farstriders,191,warrior,arms,6,2,4
Edrelang,bronzebeard,191,warrior,arms,6,2,4
Rudiblade,dalaran,191,warrior,arms,6,2,4
Deathhit,barthilas,191,warrior,arms,6,2,4
Beepboop,malganis,191,warrior,arms,6,2,4
Blackkcow,zuljin,191,warrior,arms,6,2,4
Bunedau,azgalor,191,warrior,arms,12,2,10
Ybsorc,kelthuzad,160,warrior,arms,10,2,8
Wyerlyn,illidan,159,warrior,arms,5,2,3
Notoriousmmà,illidan,159,warrior,arms,5,2,3
Gontore,thrall,159,warrior,arms,5,2,3
Vapyr,moon-guard,159,warrior,arms,5,2,3
Swordblood,ragnaros,159,warrior,arms,5,2,3
Kellsbro,hyjal,159,warrior,arms,5,2,3
Eatscrayons,barthilas,159,warrior,arms,11,2,9
Czartacus,dalaran,144,warrior,arms,3,3,0
Strongtall,tichondrius,138,warrior,arms,12,3,9
Mnoga,azralon,138,warrior,arms,16,3,13
Rhok,elune,136,warrior,arms,10,5,5
Scottie,cairne,136,warrior,arms,7,3,4
Clarityw,illidan,128,warrior,arms,4,2,2
Nosors,kelthuzad,128,warrior,arms,4,2,2
Eatmyblade,wyrmrest-accord,128,warrior,arms,10,2,8
Berserko,gurubashi,112,warrior,arms,7,2,5
Syradar,ragnaros,112,warrior,arms,7,2,5
Seariphim,lothar,105,warrior,arms,9,4,5
Battosaì,bonechewer,96,warrior,arms,3,2,1
Ryuulion,proudmoore,96,warrior,arms,3,2,1
Azyxia,emerald-dream,96,warrior,arms,3,2,1
Ragemane,illidan,96,warrior,arms,3,2,1
Kevs,sargeras,96,warrior,arms,3,2,1
Arianarkw,sargeras,96,warrior,arms,3,2,1
Hergo,spirestone,96,warrior,arms,6,1,5
Arantx817800,illidan,96,warrior,arms,6,1,5
Sver,dalaran,96,warrior,arms,6,1,5
Ghaladir,area-52,96,warrior,arms,6,1,5
Wartrué,tichondrius,96,warrior,arms,6,1,5
Hazelbean,tichondrius,96,warrior,arms,6,1,5
Rahj,caelestrasz,96,warrior,arms,6,1,5
Rambovix,tichondrius,96,warrior,arms,6,1,5
Tfd,tichondrius,96,warrior,arms,6,1,5
Berawar,tichondrius,96,warrior,arms,6,1,5
Goywarr,illidan,96,warrior,arms,6,1,5
Ghostierip,illidan,96,warrior,arms,6,1,5
Wienertoes,tichondrius,96,warrior,arms,6,1,5
Timbajimba,silvermoon,96,warrior,arms,6,1,5
Rollz,amanthul,96,warrior,arms,6,1,5
Eightballerz,barthilas,96,warrior,arms,6,1,5
Jazz,frostwolf,96,warrior,arms,6,1,5
Broxar,area-52,96,warrior,arms,6,1,5
Smoogzz,tichondrius,96,warrior,arms,6,1,5
Kargan,thrall,96,warrior,arms,6,1,5
Bigwarrior,stonemaul,96,warrior,arms,6,1,5
Bhuppzz,barthilas,96,warrior,arms,6,1,5
Shöthetank,area-52,96,warrior,arms,6,1,5
Atomicboxer,tichondrius,96,warrior,arms,6,1,5
Jennatolls,boulderfist,96,warrior,arms,6,1,5
Wolurog,emerald-dream,96,warrior,arms,6,1,5
Tangö,barthilas,96,warrior,arms,6,1,5
Warrmachine,scarlet-crusade,96,warrior,arms,6,1,5
Nelfmoehawk,barthilas,96,warrior,arms,6,1,5
Regax,thrall,96,warrior,arms,6,1,5
Mahoneslice,thrall,96,warrior,arms,6,1,5
Warbomb,thrall,96,warrior,arms,6,1,5
Raokao,senjin,96,warrior,arms,6,1,5
Kåyotix,proudmoore,96,warrior,arms,6,1,5
Áres,spinebreaker,96,warrior,arms,6,1,5
Lifaen,zangarmarsh,96,warrior,arms,6,1,5
Facekilla,nordrassil,96,warrior,arms,6,1,5
Bobisyourmom,tichondrius,96,warrior,arms,6,1,5
Ñors,spinebreaker,96,warrior,arms,6,1,5
Erhue,sargeras,96,warrior,arms,6,1,5
Ohhgeekush,proudmoore,96,warrior,arms,6,1,5
Mauler,medivh,96,warrior,arms,6,1,5
Ogrimir,moon-guard,96,warrior,arms,6,1,5
Flexxinpapi,exodar,96,warrior,arms,6,1,5
Morlu,alleria,96,warrior,arms,6,1,5
Kevinersaa,frostmourne,96,warrior,arms,6,1,5
Augutra,moon-guard,96,warrior,arms,6,1,5
Mechagodzila,kiljaeden,96,warrior,arms,6,1,5
Mezw,tichondrius,96,warrior,arms,6,1,5
Wàrrðèémzý,frostmourne,96,warrior,arms,6,1,5
Soymong,frostmourne,96,warrior,arms,6,1,5
Bestgrunt,tichondrius,96,warrior,arms,6,1,5
Rasazghal,darrowmere,96,warrior,arms,6,1,5
Hadrum,turalyon,96,warrior,arms,6,1,5
Gizzmo,bonechewer,96,warrior,arms,6,1,5
Ammeh,draka,96,warrior,arms,6,1,5
Grosjambes,turalyon,96,warrior,arms,6,1,5
Heyzulnut,whisperwind,96,warrior,arms,6,1,5
Vhagaar,emerald-dream,96,warrior,arms,6,1,5
Blitzkrieegz,drakkari,96,warrior,arms,6,1,5
Xeno,steamwheedle-cartel,96,warrior,arms,6,1,5
Doriax,sentinels,96,warrior,arms,6,1,5
Draann,kirin-tor,96,warrior,arms,6,1,5
Geontage,drakkari,96,warrior,arms,6,1,5
Beenbag,aerie-peak,96,warrior,arms,6,1,5
Cindabotica,sargeras,96,warrior,arms,6,1,5
Jimhoffa,bonechewer,96,warrior,arms,6,1,5
Rage,tanaris,96,warrior,arms,6,1,5
Jimpepega,quelthalas,96,warrior,arms,6,1,5
Maxtavius,baelgun,96,warrior,arms,6,1,5
Kboyrage,sargeras,96,warrior,arms,6,1,5
Jiva,emerald-dream,96,warrior,arms,6,1,5
Meleth,darkspear,96,warrior,arms,6,1,5
Adav,arthas,96,warrior,arms,6,1,5
Dogmar,moon-guard,96,warrior,arms,6,1,5
Bootstraps,hyjal,96,warrior,arms,6,1,5
Bootysmelly,mannoroth,96,warrior,arms,6,1,5
Sneeze,kul-tiras,96,warrior,arms,6,1,5
Abaton,wyrmrest-accord,96,warrior,arms,6,1,5
Drdrip,shuhalo,96,warrior,arms,6,1,5
Klobnslob,mannoroth,96,warrior,arms,6,1,5
Skärz,azshara,96,warrior,arms,6,1,5
Beastro,rexxar,96,warrior,arms,6,1,5
Nerolanast,wyrmrest-accord,96,warrior,arms,6,1,5
Fréäkk,ragnaros,96,warrior,arms,6,1,5
Roxesc,area-52,96,warrior,arms,6,1,5
Cleaver,draka,96,warrior,arms,6,1,5
Gärroshh,ragnaros,96,warrior,arms,6,1,5
Vlix,korgath,96,warrior,arms,6,1,5
Gromhell,azralon,96,warrior,arms,6,1,5
Däger,ragnaros,96,warrior,arms,6,1,5
Sienge,tortheldrin,96,warrior,arms,6,1,5
Racsorr,ragnaros,96,warrior,arms,6,1,5
Droggo,cenarius,96,warrior,arms,6,1,5
Durseyturm,area-52,96,warrior,arms,6,1,5
Mikachero,ragnaros,96,warrior,arms,6,1,5
Zépileque,azralon,96,warrior,arms,6,1,5
Elodié,stormrage,96,warrior,arms,6,1,5
Silverdeadl,ragnaros,96,warrior,arms,6,1,5
Noctrelor,sargeras,96,warrior,arms,6,1,5
Nyaner,quelthalas,96,warrior,arms,6,1,5
Shagstrike,azralon,96,warrior,arms,6,1,5
Joetempest,azralon,96,warrior,arms,6,1,5
Aidenwr,area-52,96,warrior,arms,6,1,5
Xalë,tichondrius,96,warrior,arms,6,1,5
Neotico,quelthalas,96,warrior,arms,6,1,5
Uub,malganis,96,warrior,arms,6,1,5
Sosaw,moon-guard,96,warrior,arms,6,1,5
Nibones,malganis,96,warrior,arms,6,1,5
Weechubber,bleeding-hollow,96,warrior,arms,6,1,5
Selockclap,bleeding-hollow,96,warrior,arms,6,1,5
Flabergaster,skullcrusher,96,warrior,arms,6,1,5
Meytuglin,stormrage,96,warrior,arms,6,1,5
Damadar,malganis,96,warrior,arms,6,1,5
Codey,stormrage,96,warrior,arms,6,1,5
Faintswar,stormrage,96,warrior,arms,6,1,5
Betsisword,stormrage,96,warrior,arms,6,1,5
Dokoba,bleeding-hollow,96,warrior,arms,6,1,5
Darkromel,quelthalas,96,warrior,arms,6,1,5
Beatstickz,malganis,96,warrior,arms,6,1,5
Paralyzed,malganis,96,warrior,arms,6,1,5
Kado,zuluhed,96,warrior,arms,6,1,5
Alvitr,kelthuzad,96,warrior,arms,6,1,5
Skunkz,kelthuzad,96,warrior,arms,6,1,5
Deathislovê,moonrunner,96,warrior,arms,6,1,5
Striphex,trollbane,96,warrior,arms,6,1,5
Gordurin,akama,96,warrior,arms,6,1,5
Immortal,icecrown,96,warrior,arms,6,1,5
Kluster,kelthuzad,96,warrior,arms,6,1,5
Snippy,garona,96,warrior,arms,6,1,5
Notacop,malygos,96,warrior,arms,6,1,5
Draxxarlol,zuljin,96,warrior,arms,6,1,5
Zørg,bleeding-hollow,96,warrior,arms,6,1,5
Charcharbinx,zuljin,96,warrior,arms,6,1,5
Myc,zuljin,96,warrior,arms,6,1,5
Sweetlove,akama,96,warrior,arms,6,1,5
Äléx,frostmourne,96,warrior,arms,7,1,6
Sangettsu,stormrage,96,warrior,arms,8,1,7
Drdalidou,zuljin,96,warrior,arms,12,1,11
Berzerk,dentarg,96,warrior,arms,12,1,11
Integrâl,tichondrius,96,warrior,arms,12,1,11
Semyus,ragnaros,96,warrior,arms,12,1,11
Meelehard,zuljin,96,warrior,arms,12,1,11
Babyfelix,tichondrius,96,warrior,arms,12,1,11
Odyssey,vashj,96,warrior,arms,12,1,11
Cartou,stormscale,96,warrior,arms,12,1,11
Bushwook,emerald-dream,96,warrior,arms,12,1,11
Njalulfhild,korgath,96,warrior,arms,12,1,11
Wmuuzh,quelthalas,96,warrior,arms,12,1,11
Falkur,amanthul,96,warrior,arms,12,1,11
Drarn,norgannon,96,warrior,arms,12,1,11
Savagetko,illidan,79,warrior,arms,5,1,4
Naindejardin,sargeras,79,warrior,arms,5,1,4
Rokmok,frostmane,79,warrior,arms,5,1,4
Keringan,stormrage,79,warrior,arms,5,1,4
Psykd,arathor,79,warrior,arms,5,1,4
Roxon,hellscream,79,warrior,arms,5,1,4
Garrossh,thunderhorn,64,warrior,arms,4,1,3
Sniperbeer,sargeras,64,warrior,arms,4,1,3
Mverstappen,azralon,64,warrior,arms,4,1,3
Thewarrior,tichondrius,48,warrior,arms,3,1,2
Haveya,ghostlands,48,warrior,arms,3,1,2
Warriorba,tichondrius,48,warrior,arms,3,1,2
Critnectar,aggramar,48,warrior,arms,3,1,2
Rumka,draktharon,42,warrior,arms,6,2,4
Reignwolf,azralon,42,warrior,arms,7,2,5
Ghostkin,ragnaros,42,warrior,arms,7,2,5
Tatsuujin,sargeras,42,warrior,arms,8,2,6
Trôca,ragnaros,42,warrior,arms,8,2,6
Billy,area-52,31,warrior,arms,2,1,1
Mantiflash,stormrage,31,warrior,arms,2,1,1
Flandiz,sargeras,31,warrior,arms,2,1,1
Zachw,stormrage,16,warrior,arms,1,1,0
Shwutty,stormrage,16,warrior,arms,1,1,0
Goodidea,mannoroth,16,warrior,arms,1,1,0
Psyrush,area-52,16,warrior,arms,7,1,6
Americanbull,moon-guard,1455,warrior,protection,62,34,28
Percaderp,barthilas,1203,warrior,protection,27,15,12
Graventhal,tichondrius,1192,warrior,protection,53,25,28
Thororan,whisperwind,845,warrior,protection,27,10,17
Appolyonn,hyjal,838,warrior,protection,42,17,25
Logan,twisting-nether,681,warrior,protection,38,10,28
Mileigh,kelthuzad,668,warrior,protection,24,7,17
Ghostoffury,thrall,574,warrior,protection,12,6,6
Stophitingme,bloodscalp,469,warrior,protection,18,5,13
Ksubîî,frostmourne,448,warrior,protection,16,5,11
Dabdaddyy,dawnbringer,384,warrior,protection,6,4,2
Kidkolby,moon-guard,384,warrior,protection,12,4,8
Rhuk,drakkari,383,warrior,protection,12,4,8
Manthraxx,sargeras,288,warrior,protection,6,3,3
Chàrr,crushridge,288,warrior,protection,15,4,11
Toothnnailz,destromath,284,warrior,protection,12,3,9
Stowdace,bladefist,239,warrior,protection,5,3,2
Executespam,madoran,192,warrior,protection,6,2,4
Lagurtz,ragnaros,192,warrior,protection,6,2,4
Loonycity,arygos,192,warrior,protection,12,2,10
Littlefatman,terokkar,192,warrior,protection,12,2,10
Fearless,moon-guard,96,warrior,protection,6,1,5
Varith,sargeras,96,warrior,protection,12,1,11
Jindyn,boulderfist,95,warrior,protection,6,1,5
