name,realm,rating,cls,spec,play,win,lose
Phearbunny,bleeding-hollow,1547,deathknight,blood,114,59,55
Pagumon,moon-guard,1421,deathknight,blood,126,65,61
Warlôck,chogall,1399,deathknight,blood,36,19,17
Réndwarchièf,garrosh,1227,deathknight,blood,51,23,28
Tiumau,goldrinn,1121,deathknight,blood,66,30,36
Nbayoungboy,kiljaeden,1088,deathknight,blood,46,18,28
Corndead,area-52,1045,deathknight,blood,30,11,19
Tragül,sargeras,1042,deathknight,blood,42,20,22
Bloodbukkaky,bleeding-hollow,946,deathknight,blood,61,16,45
Valind,eredar,854,deathknight,blood,18,9,9
Kult,azralon,841,deathknight,blood,12,9,3
Insonne,dalaran,837,deathknight,blood,18,9,9
Yafa,bonechewer,795,deathknight,blood,36,14,22
Kayn,malganis,767,deathknight,blood,18,8,10
Jakeboyswag,shandris,767,deathknight,blood,24,8,16
He,echo-isles,668,deathknight,blood,12,7,5
Eremeir,moon-guard,576,deathknight,blood,12,6,6
Blasphemus,malganis,575,deathknight,blood,12,6,6
Kaîne,dalaran,480,deathknight,blood,12,5,7
Belfknightt,area-52,479,deathknight,blood,15,5,10
Humber,area-52,384,deathknight,blood,6,4,2
Tristam,area-52,384,deathknight,blood,6,4,2
Pride,ragnaros,384,deathknight,blood,12,4,8
ßläzë,baelgun,288,deathknight,blood,15,4,11
Kimbøslîce,area-52,288,deathknight,blood,12,3,9
Kaloesh,drenden,288,deathknight,blood,12,3,9
Aborblood,hyjal,286,deathknight,blood,12,3,9
Neroxzdvm,area-52,192,deathknight,blood,6,2,4
Cerbeefquake,wyrmrest-accord,192,deathknight,blood,12,2,10
Eteson,tichondrius,191,deathknight,blood,6,2,4
Unhølydøøm,misha,191,deathknight,blood,12,2,10
Cosmiclord,sargeras,191,deathknight,blood,18,2,16
Killteam,tichondrius,96,deathknight,blood,6,1,5
Cozzasad,barthilas,96,deathknight,blood,6,1,5
Gnargnarr,firetree,96,deathknight,blood,6,1,5
Wowattorney,tichondrius,96,deathknight,blood,6,1,5
Determinate,deathwing,96,deathknight,blood,6,1,5
Ðrift,azralon,96,deathknight,blood,6,1,5
Lunatick,darkspear,96,deathknight,blood,6,1,5
Boneherr,sargeras,96,deathknight,blood,6,1,5
Zerhistran,proudmoore,64,deathknight,blood,4,1,3
Hulmorr,bleeding-hollow,64,deathknight,blood,4,1,3
Partywaffles,illidan,2179,deathknight,unholy,288,149,139
Pwaff,illidan,2125,deathknight,unholy,89,45,44
Neroxz,area-52,2105,deathknight,unholy,83,43,40
Qipara,zuljin,2104,deathknight,unholy,163,87,76
Graphics,moon-guard,2104,deathknight,unholy,388,196,192
Níngjìng,tichondrius,2074,deathknight,unholy,84,43,41
Veilsidé,kelthuzad,2058,deathknight,unholy,294,152,142
Thorediks,stormrage,2049,deathknight,unholy,138,67,71
Spaidzz,malganis,2035,deathknight,unholy,252,125,127
Búddy,zuljin,2022,deathknight,unholy,100,49,51
Gutterboy,malganis,2018,deathknight,unholy,87,41,46
Flarkness,area-52,2010,deathknight,unholy,78,37,41
Renaming,area-52,1985,deathknight,unholy,99,51,48
Achílles,sargeras,1979,deathknight,unholy,175,85,90
Scriptløl,sargeras,1975,deathknight,unholy,138,66,72
Ningjinglol,tichondrius,1969,deathknight,unholy,72,40,32
Pookr,area-52,1959,deathknight,unholy,156,73,83
Roidboy,illidan,1954,deathknight,unholy,115,57,58
Darkdj,kelthuzad,1944,deathknight,unholy,127,62,65
Vineyard,area-52,1943,deathknight,unholy,299,149,150
Toxicwaste,malganis,1942,deathknight,unholy,82,39,43
Juelzjerk,tichondrius,1940,deathknight,unholy,151,80,71
Nixonxx,tichondrius,1933,deathknight,unholy,126,78,48
Ceomdae,tichondrius,1927,deathknight,unholy,72,34,38
Mårlbørø,tichondrius,1915,deathknight,unholy,41,21,20
Éternalnight,tichondrius,1913,deathknight,unholy,76,32,44
Zynyzter,malganis,1912,deathknight,unholy,72,41,31
Barakhenaku,illidan,1911,deathknight,unholy,63,33,30
Killinois,tichondrius,1910,deathknight,unholy,47,21,26
Thotiannaqt,area-52,1909,deathknight,unholy,100,51,49
Cardii,area-52,1908,deathknight,unholy,142,73,69
Geomdae,tichondrius,1901,deathknight,unholy,71,31,40
Barelyviable,tichondrius,1898,deathknight,unholy,72,32,40
Steamerboy,stormrage,1887,deathknight,unholy,60,28,32
Serwestley,stormrage,1884,deathknight,unholy,83,41,42
Malhandir,bleeding-hollow,1880,deathknight,unholy,41,23,18
Harókz,azralon,1877,deathknight,unholy,95,48,47
Keetor,tichondrius,1875,deathknight,unholy,48,32,16
Kilohotel,stormrage,1873,deathknight,unholy,42,25,17
Dkya,tichondrius,1871,deathknight,unholy,310,156,154
Ilceses,area-52,1870,deathknight,unholy,66,29,37
Catarïa,tichondrius,1869,deathknight,unholy,90,44,46
Iato,sargeras,1868,deathknight,unholy,60,39,21
Evilduck,ragnaros,1866,deathknight,unholy,90,51,39
Goonaa,tichondrius,1861,deathknight,unholy,66,33,33
Exaar,tichondrius,1861,deathknight,unholy,81,39,42
Cavaliers,ragnaros,1860,deathknight,unholy,66,32,34
Lattè,area-52,1859,deathknight,unholy,55,30,25
Pradas,area-52,1857,deathknight,unholy,184,92,92
Xiaodabaolol,tichondrius,1855,deathknight,unholy,66,32,34
Bloodbruh,blackrock,1854,deathknight,unholy,60,34,26
Brutos,thrall,1851,deathknight,unholy,104,56,48
Tduggylolz,tichondrius,1851,deathknight,unholy,60,26,34
Daoniancc,tichondrius,1850,deathknight,unholy,375,197,178
Morbiddesire,stormrage,1849,deathknight,unholy,87,49,38
Didri,quelthalas,1846,deathknight,unholy,72,34,38
Keomdae,tichondrius,1844,deathknight,unholy,65,32,33
Tokyotimxx,malganis,1842,deathknight,unholy,48,30,18
Cloüd,wyrmrest-accord,1841,deathknight,unholy,64,31,33
Bicepsüal,zuljin,1840,deathknight,unholy,36,28,8
Nevermore,hyjal,1840,deathknight,unholy,125,67,58
Bruceleedk,tichondrius,1839,deathknight,unholy,100,51,49
Siêgfriëd,ragnaros,1839,deathknight,unholy,72,33,39
Milleh,bleeding-hollow,1838,deathknight,unholy,78,35,43
Annoyed,wyrmrest-accord,1837,deathknight,unholy,119,64,55
Blackfyré,sargeras,1837,deathknight,unholy,62,32,30
Skippee,tichondrius,1837,deathknight,unholy,60,29,31
Aidsbenedict,malganis,1837,deathknight,unholy,126,59,67
Vigarst,azralon,1835,deathknight,unholy,60,30,30
Haldevarik,doomhammer,1834,deathknight,unholy,78,43,35
Dazarune,burning-blade,1832,deathknight,unholy,46,25,21
Orphanmakerx,area-52,1832,deathknight,unholy,123,60,63
Zerhistran,proudmoore,1831,deathknight,unholy,254,136,118
Goonà,tichondrius,1831,deathknight,unholy,63,29,34
Aurious,lightnings-blade,1830,deathknight,unholy,84,47,37
Kortingert,nagrand,1830,deathknight,unholy,59,33,26
Wøund,black-dragonflight,1830,deathknight,unholy,226,115,111
Drauguss,azralon,1830,deathknight,unholy,124,61,63
Sinell,kargath,1829,deathknight,unholy,186,101,85
Slîckhuman,spinebreaker,1829,deathknight,unholy,60,27,33
Anatøly,ragnaros,1827,deathknight,unholy,42,21,21
Soulhand,tichondrius,1826,deathknight,unholy,104,57,47
Arthez,frostmourne,1824,deathknight,unholy,72,38,34
Sadboy,grizzly-hills,1822,deathknight,unholy,65,27,38
Zerøimperial,quelthalas,1821,deathknight,unholy,209,111,98
Goldênboy,blades-edge,1820,deathknight,unholy,66,42,24
Altareon,ragnaros,1820,deathknight,unholy,150,79,71
Einherjiar,tichondrius,1820,deathknight,unholy,48,25,23
Volyant,frostmourne,1820,deathknight,unholy,60,30,30
Kciktep,tichondrius,1819,deathknight,unholy,36,19,17
Datnai,barthilas,1819,deathknight,unholy,54,25,29
Hrsb,tichondrius,1817,deathknight,unholy,124,68,56
Sussybakadk,sargeras,1817,deathknight,unholy,70,34,36
Skideroth,kelthuzad,1817,deathknight,unholy,60,28,32
Flizzycash,malganis,1816,deathknight,unholy,56,27,29
Õdin,area-52,1815,deathknight,unholy,203,103,100
Wowattorney,tichondrius,1815,deathknight,unholy,82,33,49
Poesoul,tichondrius,1812,deathknight,unholy,285,143,142
Ravindrannor,saurfang,1812,deathknight,unholy,65,32,33
Dahnga,frostmourne,1811,deathknight,unholy,54,32,22
Plagueflavor,tichondrius,1811,deathknight,unholy,306,152,154
Muspel,sargeras,1811,deathknight,unholy,65,32,33
Fatzilla,tichondrius,1811,deathknight,unholy,66,26,40
Darkcata,tichondrius,1810,deathknight,unholy,42,19,23
Warrcc,steamwheedle-cartel,1809,deathknight,unholy,48,24,24
Floreon,tichondrius,1808,deathknight,unholy,65,34,31
Infectik,tichondrius,1807,deathknight,unholy,59,35,24
Chillbaynê,the-scryers,1807,deathknight,unholy,119,62,57
Brocigar,tichondrius,1806,deathknight,unholy,84,43,41
Sagadk,hyjal,1806,deathknight,unholy,70,33,37
Necrôtic,area-52,1806,deathknight,unholy,76,35,41
Twindleroot,aggramar,1804,deathknight,unholy,77,45,32
Mûs,tichondrius,1804,deathknight,unholy,66,36,30
Asukka,tichondrius,1804,deathknight,unholy,78,32,46
Chimps,illidan,1803,deathknight,unholy,52,29,23
Kaeligh,ragnaros,1803,deathknight,unholy,66,29,37
Ziskon,illidan,1802,deathknight,unholy,100,53,47
Dtcfasd,tichondrius,1801,deathknight,unholy,32,20,12
Zìlêán,tichondrius,1800,deathknight,unholy,70,39,31
Starshopping,proudmoore,1800,deathknight,unholy,91,44,47
Azre,tichondrius,1800,deathknight,unholy,160,74,86
Avengering,tichondrius,1794,deathknight,unholy,75,40,35
Sithdog,blackrock,1794,deathknight,unholy,84,37,47
Ðomìnus,moon-guard,1792,deathknight,unholy,128,76,52
Bukum,zuljin,1792,deathknight,unholy,71,30,41
Muspellheim,azralon,1791,deathknight,unholy,54,29,25
Aerd,sargeras,1789,deathknight,unholy,343,172,171
Attack,grizzly-hills,1787,deathknight,unholy,60,28,32
Stankybreath,bleeding-hollow,1786,deathknight,unholy,76,37,39
Ddibb,tichondrius,1782,deathknight,unholy,63,30,33
Lighostx,tichondrius,1782,deathknight,unholy,117,54,63
Áethros,malganis,1778,deathknight,unholy,96,44,52
Loongdk,kiljaeden,1777,deathknight,unholy,195,102,93
Grimiz,tichondrius,1774,deathknight,unholy,145,71,74
Vad,skullcrusher,1771,deathknight,unholy,52,22,30
Jakeboyswag,shandris,1770,deathknight,unholy,155,77,78
Azhid,tichondrius,1769,deathknight,unholy,136,70,66
Demonboyjr,tichondrius,1766,deathknight,unholy,75,31,44
Apøçálýpsé,firetree,1765,deathknight,unholy,97,50,47
Doombeast,area-52,1760,deathknight,unholy,108,51,57
Lagérthâ,ragnaros,1756,deathknight,unholy,60,28,32
Ålastor,stormrage,1754,deathknight,unholy,63,35,28
Hwml,barthilas,1754,deathknight,unholy,141,76,65
Nabbiby,tichondrius,1753,deathknight,unholy,84,38,46
Linyive,malganis,1750,deathknight,unholy,54,30,24
Anhedonía,illidan,1749,deathknight,unholy,168,87,81
Cesaroo,aegwynn,1749,deathknight,unholy,130,64,66
Standalizer,gilneas,1745,deathknight,unholy,72,40,32
Deadsamurai,illidan,1745,deathknight,unholy,69,36,33
Ermanotruta,azralon,1744,deathknight,unholy,77,37,40
Carryme,quelthalas,1742,deathknight,unholy,92,45,47
Xibbas,illidan,1741,deathknight,unholy,48,27,21
Frozenkappa,hyjal,1737,deathknight,unholy,35,21,14
Nh,malganis,1737,deathknight,unholy,54,28,26
Teksurugi,korgath,1734,deathknight,unholy,60,32,28
Howdoulose,illidan,1732,deathknight,unholy,54,25,29
Zìlêáns,tichondrius,1730,deathknight,unholy,84,50,34
Infection,steamwheedle-cartel,1729,deathknight,unholy,42,20,22
Xebane,frostmourne,1727,deathknight,unholy,372,191,181
Hatrèd,quelthalas,1724,deathknight,unholy,71,36,35
Hhasaki,area-52,1722,deathknight,unholy,210,110,100
Properterps,bonechewer,1714,deathknight,unholy,140,78,62
Bellum,moon-guard,1713,deathknight,unholy,111,64,47
Lazarise,area-52,1713,deathknight,unholy,71,34,37
Tkyo,tichondrius,1712,deathknight,unholy,47,22,25
Brß,tichondrius,1711,deathknight,unholy,54,29,25
Bedstains,thunderlord,1708,deathknight,unholy,155,80,75
Nalz,drakkari,1705,deathknight,unholy,158,82,76
Bannedforevr,dalaran,1704,deathknight,unholy,59,26,33
Muscleface,moon-guard,1701,deathknight,unholy,80,45,35
Brandonsdk,tichondrius,1701,deathknight,unholy,164,78,86
Koda,thrall,1701,deathknight,unholy,77,36,41
Boneyards,bleeding-hollow,1701,deathknight,unholy,108,46,62
Justafkdk,gorefiend,1700,deathknight,unholy,84,43,41
Arroyo,borean-tundra,1700,deathknight,unholy,102,52,50
Kinkysgnome,tichondrius,1696,deathknight,unholy,131,61,70
Bbidd,tichondrius,1690,deathknight,unholy,30,18,12
Bigdekay,illidan,1687,deathknight,unholy,30,18,12
Mephostophel,sargeras,1687,deathknight,unholy,204,106,98
Khaíne,wyrmrest-accord,1687,deathknight,unholy,264,136,128
Bagul,azralon,1686,deathknight,unholy,48,23,25
Ayooplaguez,guldan,1684,deathknight,unholy,48,24,24
Azynks,azralon,1683,deathknight,unholy,117,55,62
Hanung,tichondrius,1681,deathknight,unholy,35,18,17
Onefire,illidan,1680,deathknight,unholy,59,29,30
Fakiez,kelthuzad,1679,deathknight,unholy,68,30,38
Krätos,zuljin,1677,deathknight,unholy,42,25,17
Dâki,blades-edge,1675,deathknight,unholy,114,63,51
Fasterjake,sargeras,1675,deathknight,unholy,122,67,55
Blacklabel,andorhal,1675,deathknight,unholy,72,31,41
Supblood,tichondrius,1673,deathknight,unholy,48,23,25
Noik,azralon,1673,deathknight,unholy,88,42,46
Giveretms,azralon,1672,deathknight,unholy,42,19,23
Ligmagooch,tichondrius,1671,deathknight,unholy,93,49,44
Cantmove,area-52,1669,deathknight,unholy,50,22,28
Dreadrend,sargeras,1668,deathknight,unholy,72,35,37
Malhandir,azgalor,1668,deathknight,unholy,54,20,34
Boofcigars,stormrage,1667,deathknight,unholy,39,25,14
Spacealien,malganis,1667,deathknight,unholy,60,32,28
Xhoul,sargeras,1666,deathknight,unholy,249,134,115
Darktone,tichondrius,1665,deathknight,unholy,35,18,17
Slty,tichondrius,1664,deathknight,unholy,42,18,24
Lichtborne,illidan,1662,deathknight,unholy,73,33,40
Nevmic,emerald-dream,1661,deathknight,unholy,184,88,96
Krargosh,quelthalas,1660,deathknight,unholy,185,96,89
Ståtìc,tichondrius,1659,deathknight,unholy,84,43,41
Imadkloldie,frostmourne,1659,deathknight,unholy,90,46,44
Dunduner,tichondrius,1657,deathknight,unholy,144,71,73
Bopalop,malganis,1657,deathknight,unholy,69,28,41
Kakarotó,azralon,1656,deathknight,unholy,65,37,28
Kjarnda,malganis,1653,deathknight,unholy,48,21,27
Skynyght,area-52,1652,deathknight,unholy,42,26,16
Pooseunpoose,velen,1652,deathknight,unholy,86,41,45
Jacklinn,ysondre,1651,deathknight,unholy,36,24,12
Ullísés,ragnaros,1651,deathknight,unholy,45,24,21
Kwolve,proudmoore,1651,deathknight,unholy,243,122,121
Jeremiahe,hyjal,1650,deathknight,unholy,90,49,41
Trumps,stormrage,1649,deathknight,unholy,48,27,21
Komplex,kelthuzad,1649,deathknight,unholy,76,40,36
Ludgan,stormrage,1649,deathknight,unholy,180,86,94
Falkorn,korgath,1648,deathknight,unholy,99,47,52
Justtaki,zuljin,1648,deathknight,unholy,48,20,28
Lickblood,sargeras,1646,deathknight,unholy,36,20,16
Deuter,quelthalas,1646,deathknight,unholy,243,125,118
Merados,quelthalas,1646,deathknight,unholy,79,30,49
Libitina,tichondrius,1645,deathknight,unholy,36,22,14
Tråuma,uther,1645,deathknight,unholy,48,25,23
Vexxan,thrall,1644,deathknight,unholy,41,23,18
Shadow,ragnaros,1643,deathknight,unholy,73,41,32
Galarick,area-52,1643,deathknight,unholy,41,22,19
Beanboyx,tichondrius,1642,deathknight,unholy,34,18,16
Boofcigars,sargeras,1642,deathknight,unholy,52,27,25
Kurnoth,barthilas,1641,deathknight,unholy,110,53,57
Tailm,ragnaros,1639,deathknight,unholy,36,20,16
Killìan,kelthuzad,1638,deathknight,unholy,54,25,29
Dkdanim,tichondrius,1637,deathknight,unholy,130,71,59
Vynox,frostmourne,1637,deathknight,unholy,56,27,29
Goonazz,tichondrius,1635,deathknight,unholy,54,38,16
Virulous,zuljin,1634,deathknight,unholy,47,26,21
Rycerzfrost,ragnaros,1634,deathknight,unholy,113,59,54
Grimmdreamer,stormrage,1634,deathknight,unholy,76,37,39
Azibar,moon-guard,1632,deathknight,unholy,47,24,23
Raps,frostmourne,1632,deathknight,unholy,56,23,33
Reizu,ragnaros,1631,deathknight,unholy,45,27,18
Lùcius,garrosh,1631,deathknight,unholy,154,82,72
Zedsdead,mannoroth,1630,deathknight,unholy,42,24,18
Zerochillz,sargeras,1628,deathknight,unholy,30,17,13
Kenishii,kiljaeden,1627,deathknight,unholy,48,30,18
Asastac,tichondrius,1627,deathknight,unholy,42,24,18
Landez,ragnaros,1627,deathknight,unholy,66,37,29
Elyxoxo,tichondrius,1627,deathknight,unholy,84,44,40
Littlekims,emerald-dream,1627,deathknight,unholy,46,24,22
Wastethis,sargeras,1626,deathknight,unholy,71,40,31
Banjingquan,tichondrius,1625,deathknight,unholy,88,53,35
Paratekdk,thrall,1625,deathknight,unholy,71,39,32
Megatroun,stormreaver,1625,deathknight,unholy,42,23,19
Bladê,tichondrius,1624,deathknight,unholy,61,26,35
Pettyk,tichondrius,1624,deathknight,unholy,42,17,25
Auniel,gorefiend,1622,deathknight,unholy,54,22,32
Puppykiss,perenolde,1622,deathknight,unholy,57,22,35
Fadedlight,zuljin,1621,deathknight,unholy,108,57,51
Billieeilish,sargeras,1621,deathknight,unholy,80,42,38
Asterend,proudmoore,1621,deathknight,unholy,52,23,29
Xraduky,dawnbringer,1620,deathknight,unholy,38,26,12
Raíndrop,tichondrius,1620,deathknight,unholy,150,81,69
Yubell,barthilas,1620,deathknight,unholy,353,176,177
Arcticc,area-52,1620,deathknight,unholy,54,24,30
Struggler,velen,1619,deathknight,unholy,60,34,26
Wheatasil,garona,1618,deathknight,unholy,70,36,34
Reapsouls,stormrage,1617,deathknight,unholy,42,30,12
Lichanis,bonechewer,1617,deathknight,unholy,102,50,52
Søad,quelthalas,1615,deathknight,unholy,135,72,63
Yamanji,wyrmrest-accord,1614,deathknight,unholy,110,61,49
Nøsfferatus,azralon,1613,deathknight,unholy,77,41,36
Kterrorblade,sargeras,1613,deathknight,unholy,180,92,88
Døømhøund,tichondrius,1612,deathknight,unholy,98,48,50
Rezøk,ragnaros,1612,deathknight,unholy,54,20,34
Alistra,frostmourne,1611,deathknight,unholy,42,20,22
Ðogmá,vashj,1610,deathknight,unholy,35,22,13
Mikoaa,bladefist,1610,deathknight,unholy,30,17,13
Regiknight,stormrage,1610,deathknight,unholy,239,135,104
Puppykisses,perenolde,1610,deathknight,unholy,101,45,56
Lichkong,dalaran,1609,deathknight,unholy,76,43,33
Aldebamuu,ragnaros,1609,deathknight,unholy,156,81,75
Lagmasterx,sargeras,1609,deathknight,unholy,42,20,22
Ousted,daggerspine,1608,deathknight,unholy,36,20,16
Lemuriön,nemesis,1607,deathknight,unholy,43,20,23
Bulí,barthilas,1607,deathknight,unholy,42,19,23
Gripd,area-52,1606,deathknight,unholy,48,26,22
Ultimatdeath,jubeithos,1606,deathknight,unholy,66,30,36
Ædolph,barthilas,1605,deathknight,unholy,30,17,13
Takeurcheeks,tichondrius,1605,deathknight,unholy,101,49,52
Ãstaroth,stormrage,1605,deathknight,unholy,48,22,26
Notorious,garrosh,1605,deathknight,unholy,42,18,24
Boofcigars,kelthuzad,1604,deathknight,unholy,77,41,36
Unholykevin,sargeras,1604,deathknight,unholy,42,21,21
Dominos,tichondrius,1604,deathknight,unholy,42,20,22
Idodamn,tichondrius,1603,deathknight,unholy,84,45,39
Wednesdæ,moon-guard,1603,deathknight,unholy,54,28,26
Wisdôm,frostmourne,1603,deathknight,unholy,59,30,29
Nymppho,kelthuzad,1603,deathknight,unholy,337,160,177
Kranaz,frostmourne,1603,deathknight,unholy,36,17,19
Malsedius,kelthuzad,1603,deathknight,unholy,87,36,51
Voncleaver,tichondrius,1603,deathknight,unholy,70,23,47
Gargoylepowa,nemesis,1602,deathknight,unholy,42,20,22
Nofoamlattes,thrall,1602,deathknight,unholy,42,19,23
Originalcimm,stormrage,1601,deathknight,unholy,66,28,38
Promotheseis,sargeras,1600,deathknight,unholy,66,41,25
Giznator,malganis,1598,deathknight,unholy,108,50,58
Ilikelydead,tichondrius,1592,deathknight,unholy,126,61,65
Wittlewanka,zuljin,1592,deathknight,unholy,112,51,61
Ulísés,ragnaros,1591,deathknight,unholy,58,20,38
Gripyourhoe,tichondrius,1589,deathknight,unholy,48,28,20
Earthican,bleeding-hollow,1589,deathknight,unholy,36,20,16
Eyir,thaurissan,1588,deathknight,unholy,104,50,54
Morrticia,malganis,1587,deathknight,unholy,55,35,20
Orkky,jubeithos,1587,deathknight,unholy,139,68,71
Onlyfunss,moon-guard,1584,deathknight,unholy,119,58,61
Fuzzknight,ravenholdt,1583,deathknight,unholy,54,27,27
Raahjx,sargeras,1582,deathknight,unholy,36,20,16
Toophus,sargeras,1581,deathknight,unholy,80,39,41
Jongro,tichondrius,1580,deathknight,unholy,42,25,17
Emopalli,tichondrius,1579,deathknight,unholy,152,77,75
Divinium,bleeding-hollow,1579,deathknight,unholy,42,18,24
Frostbite,the-venture-co,1577,deathknight,unholy,84,48,36
Orcsexual,azralon,1575,deathknight,unholy,42,20,22
Daethiel,demon-soul,1574,deathknight,unholy,77,36,41
Kaaizer,azralon,1572,deathknight,unholy,120,68,52
Fydedk,stormrage,1572,deathknight,unholy,90,44,46
Yikk,illidan,1569,deathknight,unholy,42,19,23
Evilbot,tichondrius,1564,deathknight,unholy,60,40,20
Grimnuts,thrall,1564,deathknight,unholy,92,49,43
Howlex,barthilas,1563,deathknight,unholy,48,24,24
Allianknight,windrunner,1561,deathknight,unholy,42,21,21
Axeldrion,tichondrius,1561,deathknight,unholy,58,27,31
Feej,malganis,1557,deathknight,unholy,36,21,15
Burbash,moon-guard,1555,deathknight,unholy,181,92,89
Drpepp,bleeding-hollow,1554,deathknight,unholy,161,85,76
Claudio,tichondrius,1554,deathknight,unholy,51,18,33
Jacklynn,ragnaros,1553,deathknight,unholy,30,19,11
Icytoast,tichondrius,1553,deathknight,unholy,42,19,23
Gottajuice,moonrunner,1551,deathknight,unholy,81,45,36
Siphilusxo,dalaran,1551,deathknight,unholy,36,20,16
Arc,maiev,1551,deathknight,unholy,93,39,54
Kalgor,illidan,1550,deathknight,unholy,138,71,67
Tuicca,frostmane,1550,deathknight,unholy,79,34,45
Obedient,firetree,1549,deathknight,unholy,132,76,56
Kuwarerubana,proudmoore,1549,deathknight,unholy,74,41,33
Drfauci,boulderfist,1544,deathknight,unholy,36,18,18
Läskö,area-52,1541,deathknight,unholy,67,39,28
Agohnim,moon-guard,1541,deathknight,unholy,55,29,26
Zzdk,thrall,1541,deathknight,unholy,57,27,30
Rixin,agamaggan,1538,deathknight,unholy,66,28,38
Deathwavez,cenarius,1537,deathknight,unholy,42,21,21
Rhors,nemesis,1536,deathknight,unholy,58,30,28
Pue,hyjal,1536,deathknight,unholy,36,17,19
Asheravon,moon-guard,1535,deathknight,unholy,330,160,170
Zukcho,tichondrius,1534,deathknight,unholy,48,19,29
Garht,azralon,1533,deathknight,unholy,40,22,18
Huuzzha,tichondrius,1533,deathknight,unholy,166,84,82
Althamon,tanaris,1533,deathknight,unholy,96,44,52
Chachio,kiljaeden,1532,deathknight,unholy,30,16,14
Telrenaur,proudmoore,1532,deathknight,unholy,72,35,37
Arktoz,tichondrius,1531,deathknight,unholy,30,16,14
Biefeile,tichondrius,1531,deathknight,unholy,46,21,25
Clearlol,bleeding-hollow,1531,deathknight,unholy,36,16,20
Eldavò,quelthalas,1530,deathknight,unholy,78,39,39
Dialysis,emerald-dream,1530,deathknight,unholy,137,68,69
Kindaholy,malganis,1528,deathknight,unholy,23,17,6
Deezwaz,draka,1526,deathknight,unholy,46,25,21
Kellydean,moon-guard,1524,deathknight,unholy,99,50,49
Deathbloss,illidan,1523,deathknight,unholy,32,17,15
Tigs,proudmoore,1522,deathknight,unholy,126,65,61
Urp,aggramar,1520,deathknight,unholy,39,17,22
Hooterzqt,tichondrius,1518,deathknight,unholy,106,47,59
Takeoverr,ragnaros,1515,deathknight,unholy,90,53,37
Deathzpeckt,tichondrius,1513,deathknight,unholy,36,17,19
Plagueghoul,wyrmrest-accord,1510,deathknight,unholy,149,80,69
Devillele,proudmoore,1509,deathknight,unholy,78,36,42
Sandrexx,tichondrius,1506,deathknight,unholy,46,22,24
Dexarax,norgannon,1505,deathknight,unholy,87,49,38
Urieen,gorefiend,1505,deathknight,unholy,77,43,34
Coldsleeps,saurfang,1503,deathknight,unholy,30,16,14
Neaz,moon-guard,1503,deathknight,unholy,30,16,14
Unfórgíven,arthas,1501,deathknight,unholy,48,17,31
Cammy,frostmourne,1500,deathknight,unholy,29,16,13
Degrease,bonechewer,1500,deathknight,unholy,61,28,33
Revvun,tichondrius,1499,deathknight,unholy,36,17,19
Abroham,arthas,1498,deathknight,unholy,59,30,29
Hooker,dragonmaw,1497,deathknight,unholy,61,35,26
Irreversible,zuljin,1497,deathknight,unholy,41,16,25
Stoicïsm,tichondrius,1496,deathknight,unholy,114,63,51
Naxn,tichondrius,1495,deathknight,unholy,54,25,29
Fugs,ghostlands,1494,deathknight,unholy,86,48,38
Buttrfingrz,cenarius,1494,deathknight,unholy,78,35,43
Zaluster,malganis,1491,deathknight,unholy,233,120,113
Apocxo,lightnings-blade,1491,deathknight,unholy,119,58,61
Zaxrree,malganis,1490,deathknight,unholy,66,39,27
Ghoulslasher,bleeding-hollow,1490,deathknight,unholy,62,28,34
Kcorides,tichondrius,1488,deathknight,unholy,49,28,21
Laxatives,tichondrius,1488,deathknight,unholy,45,19,26
Thenin,crushridge,1487,deathknight,unholy,54,32,22
Blackary,emerald-dream,1486,deathknight,unholy,47,30,17
Madmaxxy,barthilas,1484,deathknight,unholy,176,92,84
Typhøn,illidan,1484,deathknight,unholy,157,78,79
Akilol,tichondrius,1484,deathknight,unholy,36,16,20
Saighast,illidan,1482,deathknight,unholy,72,39,33
Unholyfish,malganis,1482,deathknight,unholy,145,75,70
Rhaeisxalnym,sargeras,1480,deathknight,unholy,160,79,81
Alexeous,wyrmrest-accord,1479,deathknight,unholy,178,94,84
Deadspellz,bleeding-hollow,1479,deathknight,unholy,58,17,41
Brounlyii,drakkari,1478,deathknight,unholy,54,35,19
Tiansama,ragnaros,1478,deathknight,unholy,30,18,12
Ellipsoro,onyxia,1478,deathknight,unholy,66,26,40
Nialich,kelthuzad,1476,deathknight,unholy,41,16,25
Holsey,moon-guard,1473,deathknight,unholy,48,26,22
Papalich,stormrage,1473,deathknight,unholy,198,94,104
Tracyminaj,tichondrius,1472,deathknight,unholy,78,37,41
Garù,ragnaros,1471,deathknight,unholy,62,33,29
Grayfoxx,twisting-nether,1469,deathknight,unholy,41,18,23
Brisblade,shattered-hand,1468,deathknight,unholy,54,29,25
Reinhartlol,sargeras,1468,deathknight,unholy,99,49,50
Joeyxdk,tichondrius,1467,deathknight,unholy,29,16,13
Tenóry,nemesis,1466,deathknight,unholy,102,49,53
Xlive,tichondrius,1466,deathknight,unholy,42,17,25
Câpîrota,nemesis,1465,deathknight,unholy,52,25,27
Böffa,dalaran,1465,deathknight,unholy,59,21,38
Rognarash,emerald-dream,1464,deathknight,unholy,48,25,23
Tronnie,kelthuzad,1464,deathknight,unholy,78,40,38
Dazerl,stormrage,1463,deathknight,unholy,54,27,27
Dóm,proudmoore,1463,deathknight,unholy,78,33,45
Catena,blood-furnace,1461,deathknight,unholy,83,35,48
Fallen,nazjatar,1460,deathknight,unholy,36,23,13
Vamplyz,kelthuzad,1460,deathknight,unholy,39,22,17
Darthsydius,azralon,1460,deathknight,unholy,51,26,25
Släke,azralon,1460,deathknight,unholy,166,81,85
Witdk,illidan,1460,deathknight,unholy,85,39,46
Mordumi,stormrage,1459,deathknight,unholy,61,26,35
Rk,blackhand,1457,deathknight,unholy,97,58,39
Jaxxftw,azralon,1457,deathknight,unholy,70,38,32
Grizzdk,blackrock,1457,deathknight,unholy,36,18,18
Aundethell,moon-guard,1453,deathknight,unholy,51,16,35
Wryu,malganis,1451,deathknight,unholy,47,27,20
Deathsatan,barthilas,1451,deathknight,unholy,90,50,40
Ams,moon-guard,1450,deathknight,unholy,60,32,28
Unholyreap,arthas,1449,deathknight,unholy,46,29,17
Allhejluya,illidan,1449,deathknight,unholy,199,101,98
Balboskina,shattered-hand,1448,deathknight,unholy,76,39,37
Dûsk,thunderlord,1442,deathknight,unholy,64,28,36
Risottonero,kelthuzad,1440,deathknight,unholy,203,103,100
Gerometal,ragnaros,1440,deathknight,unholy,42,18,24
Breadtruck,area-52,1440,deathknight,unholy,75,31,44
Dreadfang,the-venture-co,1438,deathknight,unholy,24,15,9
Corrpsse,tichondrius,1438,deathknight,unholy,157,81,76
Redbr,tichondrius,1437,deathknight,unholy,78,37,41
Flavorchops,kelthuzad,1437,deathknight,unholy,48,16,32
Paíín,illidan,1433,deathknight,unholy,78,39,39
Greenduck,malganis,1433,deathknight,unholy,30,15,15
Nokenoke,illidan,1433,deathknight,unholy,263,130,133
Unknowndk,kul-tiras,1433,deathknight,unholy,52,24,28
Demonnation,illidan,1433,deathknight,unholy,144,60,84
Exin,cenarion-circle,1432,deathknight,unholy,24,15,9
Moonjae,illidan,1432,deathknight,unholy,24,15,9
Cliffdk,kelthuzad,1431,deathknight,unholy,51,15,36
Chainsawmàn,tichondrius,1430,deathknight,unholy,98,50,48
Unrealzrotz,tichondrius,1429,deathknight,unholy,76,48,28
Happynaru,tichondrius,1427,deathknight,unholy,72,34,38
Nawis,quelthalas,1426,deathknight,unholy,41,19,22
Coffeebagel,bleeding-hollow,1426,deathknight,unholy,149,65,84
Clapt,kelthuzad,1425,deathknight,unholy,30,15,15
Lazenca,malganis,1424,deathknight,unholy,32,22,10
Mortarion,icecrown,1424,deathknight,unholy,190,91,99
Anexdk,korgath,1423,deathknight,unholy,24,15,9
Seiyokú,ragnaros,1422,deathknight,unholy,103,53,50
Jarah,destromath,1422,deathknight,unholy,54,25,29
Nightskull,malganis,1421,deathknight,unholy,48,23,25
Sannistus,ysera,1420,deathknight,unholy,97,43,54
Asana,illidan,1419,deathknight,unholy,53,24,29
Viràlyourz,bleeding-hollow,1418,deathknight,unholy,30,19,11
Sgtdead,thrall,1418,deathknight,unholy,63,35,28
Hornpipe,borean-tundra,1418,deathknight,unholy,126,61,65
Aradorn,azralon,1418,deathknight,unholy,191,90,101
Fellenn,stormrage,1417,deathknight,unholy,144,78,66
Yareyare,tichondrius,1417,deathknight,unholy,54,29,25
Pmpfrmdwntwn,stormrage,1417,deathknight,unholy,67,28,39
Deathofchaos,smolderthorn,1417,deathknight,unholy,65,25,40
Seranta,wyrmrest-accord,1417,deathknight,unholy,54,19,35
Rongkhun,proudmoore,1417,deathknight,unholy,48,15,33
Sniperlord,uldaman,1415,deathknight,unholy,90,51,39
Gêralt,darkspear,1414,deathknight,unholy,36,18,18
Subparatbest,chogall,1414,deathknight,unholy,30,15,15
Fanggrief,proudmoore,1414,deathknight,unholy,121,57,64
Knownkilla,hyjal,1413,deathknight,unholy,83,47,36
Bloodramen,dalaran,1413,deathknight,unholy,357,182,175
Ganancïa,nemesis,1412,deathknight,unholy,51,28,23
Deathpool,shadowmoon,1409,deathknight,unholy,54,19,35
Desen,arthas,1408,deathknight,unholy,39,15,24
Rimothedk,illidan,1407,deathknight,unholy,36,17,19
Dezmond,quelthalas,1404,deathknight,unholy,48,21,27
Arkhän,ragnaros,1404,deathknight,unholy,52,18,34
Hatreon,sargeras,1401,deathknight,unholy,30,20,10
Hipower,moon-guard,1401,deathknight,unholy,138,72,66
Sílthree,barthilas,1401,deathknight,unholy,42,17,25
Yadaddy,hydraxis,1400,deathknight,unholy,42,23,19
Ventuss,bleeding-hollow,1399,deathknight,unholy,60,31,29
Gankstagrip,anvilmar,1399,deathknight,unholy,108,52,56
Vazarus,darrowmere,1397,deathknight,unholy,66,30,36
Wndypefrcorn,sargeras,1394,deathknight,unholy,59,35,24
Ðaz,zuljin,1394,deathknight,unholy,48,26,22
Fzero,frostmourne,1392,deathknight,unholy,66,23,43
Paulpatine,tichondrius,1391,deathknight,unholy,60,22,38
Coolk,tichondrius,1389,deathknight,unholy,96,52,44
Starms,ragnaros,1388,deathknight,unholy,71,30,41
Sammåel,malganis,1387,deathknight,unholy,36,18,18
Xènia,exodar,1387,deathknight,unholy,34,16,18
Mehithee,kiljaeden,1387,deathknight,unholy,110,40,70
Wrothgarr,stormreaver,1386,deathknight,unholy,48,27,21
Frosstbeach,hyjal,1384,deathknight,unholy,59,25,34
Egirlgripper,area-52,1382,deathknight,unholy,30,15,15
Anonymousix,kelthuzad,1381,deathknight,unholy,41,21,20
Dkfenix,ragnaros,1380,deathknight,unholy,89,39,50
Silanvia,wyrmrest-accord,1377,deathknight,unholy,66,30,36
Mèrc,ragnaros,1376,deathknight,unholy,89,38,51
Any,the-venture-co,1376,deathknight,unholy,60,25,35
Sparklekitty,illidan,1374,deathknight,unholy,24,16,8
Greeasy,bleeding-hollow,1374,deathknight,unholy,41,23,18
Volcolm,kelthuzad,1373,deathknight,unholy,54,26,28
Feorlar,dalaran,1373,deathknight,unholy,42,19,23
Midway,drakkari,1372,deathknight,unholy,48,27,21
Flo,ghostlands,1371,deathknight,unholy,45,26,19
Pacedd,silvermoon,1370,deathknight,unholy,30,15,15
Zuly,moon-guard,1369,deathknight,unholy,113,54,59
Putrefactive,frostmourne,1368,deathknight,unholy,174,85,89
Earador,dalaran,1365,deathknight,unholy,61,30,31
Darkunral,stormrage,1365,deathknight,unholy,80,33,47
Zeban,area-52,1364,deathknight,unholy,84,40,44
Warstompgød,tichondrius,1364,deathknight,unholy,36,16,20
Waremoto,ragnaros,1361,deathknight,unholy,81,47,34
Dredrikbane,moon-guard,1361,deathknight,unholy,35,20,15
Necrósy,azralon,1360,deathknight,unholy,54,23,31
Cimitiere,stormrage,1360,deathknight,unholy,49,19,30
Krixia,ragnaros,1359,deathknight,unholy,52,25,27
Awzy,azralon,1358,deathknight,unholy,48,26,22
Hydree,bleeding-hollow,1358,deathknight,unholy,42,17,25
Luckyson,tichondrius,1357,deathknight,unholy,40,19,21
Dravoc,kelthuzad,1355,deathknight,unholy,66,26,40
Shélly,ragnaros,1354,deathknight,unholy,83,41,42
Unhøøly,nemesis,1351,deathknight,unholy,71,40,31
Humber,area-52,1350,deathknight,unholy,107,56,51
Bumbleton,blackrock,1349,deathknight,unholy,45,24,21
Seíver,ragnaros,1346,deathknight,unholy,29,15,14
Atrahazis,quelthalas,1343,deathknight,unholy,29,19,10
Dethcro,shandris,1343,deathknight,unholy,93,47,46
Deathwardenn,ghostlands,1343,deathknight,unholy,36,17,19
Shadowsdk,tichondrius,1342,deathknight,unholy,36,14,22
Vaizard,malganis,1341,deathknight,unholy,24,14,10
Afterdeath,frostmourne,1340,deathknight,unholy,42,19,23
Lücìfër,illidan,1340,deathknight,unholy,55,23,32
Koltíra,azralon,1339,deathknight,unholy,50,26,24
Tragdore,thrall,1339,deathknight,unholy,31,16,15
Golurun,tichondrius,1338,deathknight,unholy,31,19,12
Níce,tichondrius,1338,deathknight,unholy,36,14,22
Tötenkaiser,quelthalas,1337,deathknight,unholy,30,14,16
Monstrosìty,bleeding-hollow,1336,deathknight,unholy,18,14,4
Kkoduck,tichondrius,1336,deathknight,unholy,32,17,15
Cswildwind,aerie-peak,1336,deathknight,unholy,48,21,27
Oomak,bonechewer,1336,deathknight,unholy,36,14,22
Ântipaladin,arthas,1335,deathknight,unholy,46,19,27
Bhyrnam,ragnaros,1335,deathknight,unholy,42,14,28
Fiddleop,thrall,1333,deathknight,unholy,24,14,10
Mëgazørd,azralon,1333,deathknight,unholy,66,36,30
Beeftip,area-52,1333,deathknight,unholy,209,99,110
Scorpíøn,azralon,1332,deathknight,unholy,30,18,12
Negril,tichondrius,1332,deathknight,unholy,78,38,40
Gromhal,azralon,1331,deathknight,unholy,24,14,10
Erodin,moon-guard,1330,deathknight,unholy,30,14,16
Zxy,hyjal,1327,deathknight,unholy,23,17,6
Vynkys,shadow-council,1327,deathknight,unholy,59,33,26
Zifandel,tichondrius,1326,deathknight,unholy,30,14,16
Rekbari,sargeras,1325,deathknight,unholy,24,15,9
Ñovacaine,moon-guard,1325,deathknight,unholy,83,40,43
Menethiljr,boulderfist,1324,deathknight,unholy,30,14,16
Unholychillz,ghostlands,1324,deathknight,unholy,44,20,24
Kordrâk,quelthalas,1322,deathknight,unholy,41,20,21
Esquinência,azralon,1322,deathknight,unholy,36,17,19
Stangz,bonechewer,1322,deathknight,unholy,36,14,22
Asylïthcc,sargeras,1321,deathknight,unholy,60,34,26
Mords,area-52,1321,deathknight,unholy,30,14,16
Nappão,azralon,1321,deathknight,unholy,85,29,56
Darknessice,tichondrius,1320,deathknight,unholy,78,40,38
Zetarexia,area-52,1318,deathknight,unholy,61,27,34
Gilden,malfurion,1317,deathknight,unholy,80,34,46
Belegos,quelthalas,1314,deathknight,unholy,93,42,51
Demona,ragnaros,1312,deathknight,unholy,58,22,36
Maligned,uldum,1312,deathknight,unholy,49,18,31
Zevrynn,barthilas,1311,deathknight,unholy,36,18,18
Frðst,executus,1310,deathknight,unholy,24,14,10
Aretos,dreadmaul,1308,deathknight,unholy,56,27,29
Shhnitzle,stormrage,1305,deathknight,unholy,36,14,22
Gwiffhm,tichondrius,1304,deathknight,unholy,40,14,26
Rottenwiener,sargeras,1303,deathknight,unholy,35,22,13
Shezoe,drakkari,1302,deathknight,unholy,36,14,22
Darkàn,lightnings-blade,1301,deathknight,unholy,42,20,22
Arcainian,tichondrius,1300,deathknight,unholy,147,65,82
Deephideblue,proudmoore,1300,deathknight,unholy,43,14,29
Rhaenyrà,tichondrius,1299,deathknight,unholy,33,19,14
Killerundead,area-52,1299,deathknight,unholy,39,17,22
Kallgìn,emerald-dream,1299,deathknight,unholy,36,15,21
Skppee,tichondrius,1295,deathknight,unholy,27,14,13
Sabotdk,tichondrius,1291,deathknight,unholy,42,23,19
Unholycube,zuljin,1290,deathknight,unholy,35,14,21
Cripticknigt,spinebreaker,1289,deathknight,unholy,48,22,26
Muffinstomp,eredar,1288,deathknight,unholy,71,40,31
Bloodserfer,sargeras,1286,deathknight,unholy,54,25,29
Coldrhelx,quelthalas,1283,deathknight,unholy,60,21,39
Mainxx,stormrage,1282,deathknight,unholy,29,14,15
Sheipadinho,nemesis,1280,deathknight,unholy,51,34,17
Isaarid,proudmoore,1275,deathknight,unholy,34,20,14
Harlthas,ragnaros,1274,deathknight,unholy,30,17,13
Magipierrot,ragnaros,1274,deathknight,unholy,92,47,45
Ometecuhtli,kelthuzad,1273,deathknight,unholy,60,35,25
Kromgarath,stormrage,1271,deathknight,unholy,60,28,32
Genjírou,frostwolf,1269,deathknight,unholy,294,143,151
Tëte,quelthalas,1269,deathknight,unholy,35,14,21
Ahrímán,illidan,1263,deathknight,unholy,116,52,64
Déká,tichondrius,1261,deathknight,unholy,42,19,23
Nukydoe,azralon,1260,deathknight,unholy,42,19,23
Tonylin,tichondrius,1258,deathknight,unholy,32,14,18
Abruptdk,bonechewer,1254,deathknight,unholy,61,29,32
Leiry,darkspear,1253,deathknight,unholy,32,20,12
Xtador,quelthalas,1252,deathknight,unholy,29,15,14
Unleud,tichondrius,1251,deathknight,unholy,54,30,24
Shargan,tichondrius,1251,deathknight,unholy,90,46,44
Ownaron,moon-guard,1249,deathknight,unholy,45,24,21
Resumen,steamwheedle-cartel,1249,deathknight,unholy,32,15,17
Pugnation,uther,1247,deathknight,unholy,30,19,11
Shxtlørdx,stormrage,1247,deathknight,unholy,24,13,11
Clowngodx,illidan,1247,deathknight,unholy,24,13,11
Darktonelol,tichondrius,1247,deathknight,unholy,30,13,17
Artyboy,icecrown,1247,deathknight,unholy,30,13,17
Buldrokastee,tichondrius,1247,deathknight,unholy,36,13,23
Hotdk,thrall,1247,deathknight,unholy,36,13,23
Apoz,tichondrius,1246,deathknight,unholy,18,13,5
Bloodyloco,malganis,1246,deathknight,unholy,64,32,32
Metinchaff,shadowmoon,1245,deathknight,unholy,18,13,5
Daixks,proudmoore,1245,deathknight,unholy,42,22,20
Aisö,bleeding-hollow,1244,deathknight,unholy,36,13,23
Lovedaddy,frostmourne,1242,deathknight,unholy,30,13,17
Bubblesdk,whisperwind,1242,deathknight,unholy,66,27,39
Youngmoneyyd,illidan,1241,deathknight,unholy,18,13,5
Deliriioh,ragnaros,1241,deathknight,unholy,198,100,98
Deathstrikex,tichondrius,1240,deathknight,unholy,24,13,11
Omegaseven,gorgonnash,1240,deathknight,unholy,184,98,86
Frostyclaws,blackrock,1237,deathknight,unholy,24,13,11
Janco,runetotem,1236,deathknight,unholy,18,13,5
Lebrônjames,tichondrius,1236,deathknight,unholy,24,13,11
Quiet,darkspear,1236,deathknight,unholy,30,13,17
Neipum,stormrage,1234,deathknight,unholy,18,13,5
Voldrezhul,area-52,1234,deathknight,unholy,36,17,19
Rarum,bleeding-hollow,1233,deathknight,unholy,24,13,11
Hellzkknight,tichondrius,1231,deathknight,unholy,34,16,18
Latroz,gundrak,1231,deathknight,unholy,54,22,32
Treikorh,quelthalas,1230,deathknight,unholy,148,66,82
Deathdra,illidan,1229,deathknight,unholy,24,16,8
Soulhuntress,doomhammer,1227,deathknight,unholy,114,58,56
Dkjs,anetheron,1227,deathknight,unholy,42,17,25
Unhølydøøm,misha,1226,deathknight,unholy,78,39,39
Sokthr,proudmoore,1224,deathknight,unholy,38,17,21
Potatobob,dalaran,1222,deathknight,unholy,30,13,17
Gatrars,sargeras,1221,deathknight,unholy,84,39,45
Terracundo,quelthalas,1217,deathknight,unholy,30,17,13
Lockstocked,dathremar,1215,deathknight,unholy,31,18,13
Mazey,moon-guard,1209,deathknight,unholy,199,98,101
Nevarro,lightbringer,1209,deathknight,unholy,234,114,120
Heärt,bleeding-hollow,1208,deathknight,unholy,86,40,46
Lieyanyanwan,tichondrius,1207,deathknight,unholy,48,19,29
Frostbytez,barthilas,1204,deathknight,unholy,29,13,16
Enjal,stormrage,1203,deathknight,unholy,71,30,41
Deathafter,tichondrius,1202,deathknight,unholy,63,28,35
Tugs,nathrezim,1202,deathknight,unholy,36,16,20
Yosemithe,quelthalas,1201,deathknight,unholy,24,13,11
Lorð,malganis,1195,deathknight,unholy,48,24,24
Masochrist,baelgun,1192,deathknight,unholy,33,14,19
Möchi,ragnaros,1190,deathknight,unholy,75,36,39
Dkzote,quelthalas,1187,deathknight,unholy,66,23,43
Leviiathan,tichondrius,1185,deathknight,unholy,30,14,16
Toroandmoi,area-52,1184,deathknight,unholy,36,16,20
Edhral,ragnaros,1184,deathknight,unholy,36,16,20
Sne,dragonmaw,1180,deathknight,unholy,30,17,13
Byres,kelthuzad,1178,deathknight,unholy,28,13,15
Coffïnfeeder,dalaran,1178,deathknight,unholy,78,31,47
Darthblade,darkspear,1177,deathknight,unholy,66,43,23
Drowhd,nemesis,1177,deathknight,unholy,60,27,33
Deadwait,rivendare,1175,deathknight,unholy,22,13,9
Jhiv,tichondrius,1172,deathknight,unholy,28,14,14
Blightrish,icecrown,1172,deathknight,unholy,66,32,34
Thedarksoul,agamaggan,1172,deathknight,unholy,57,25,32
Volardan,trollbane,1171,deathknight,unholy,27,16,11
Hanmayuziro,tichondrius,1171,deathknight,unholy,23,13,10
Furcht,gundrak,1171,deathknight,unholy,26,13,13
Mmrhostage,kelthuzad,1165,deathknight,unholy,30,14,16
Jukpark,tichondrius,1158,deathknight,unholy,60,36,24
Umbranox,arthas,1158,deathknight,unholy,60,21,39
Zeeroo,moon-guard,1157,deathknight,unholy,52,25,27
Hobdk,malganis,1156,deathknight,unholy,33,13,20
Trüppen,area-52,1153,deathknight,unholy,58,31,27
Oql,tichondrius,1152,deathknight,unholy,24,12,12
Diviniumx,bleeding-hollow,1152,deathknight,unholy,27,13,14
Andeadx,tichondrius,1152,deathknight,unholy,30,12,18
Méthmonster,stormrage,1150,deathknight,unholy,39,23,16
Balakk,tichondrius,1150,deathknight,unholy,34,15,19
Nihlan,sargeras,1150,deathknight,unholy,30,12,18
Kryptikkyt,blackrock,1150,deathknight,unholy,30,12,18
Vesel,tichondrius,1149,deathknight,unholy,36,12,24
Bazzingaxd,hyjal,1148,deathknight,unholy,54,34,20
Exequias,zuljin,1148,deathknight,unholy,42,24,18
Azgaroth,dathremar,1148,deathknight,unholy,38,20,18
Migwel,emerald-dream,1147,deathknight,unholy,24,12,12
Zebastion,amanthul,1147,deathknight,unholy,36,15,21
Vaseline,zangarmarsh,1146,deathknight,unholy,113,58,55
Oldskul,sargeras,1146,deathknight,unholy,34,17,17
Dkbunny,thaurissan,1146,deathknight,unholy,24,12,12
Chalamander,tichondrius,1146,deathknight,unholy,24,12,12
Iamthedanger,aerie-peak,1145,deathknight,unholy,24,12,12
Kehin,azralon,1144,deathknight,unholy,70,29,41
Vaske,azjolnerub,1144,deathknight,unholy,61,25,36
Dravix,azshara,1143,deathknight,unholy,18,12,6
Fruitvender,kelthuzad,1143,deathknight,unholy,30,12,18
Trentus,illidan,1142,deathknight,unholy,72,36,36
Skeleton,lightnings-blade,1141,deathknight,unholy,33,13,20
Skellig,wyrmrest-accord,1137,deathknight,unholy,60,24,36
Deadlyforce,sargeras,1136,deathknight,unholy,18,12,6
Galaxrz,bonechewer,1136,deathknight,unholy,24,14,10
Noahmelo,nemesis,1136,deathknight,unholy,25,13,12
Araris,stormrage,1135,deathknight,unholy,36,12,24
Shinici,kelthuzad,1132,deathknight,unholy,24,12,12
Kel,stormreaver,1132,deathknight,unholy,35,12,23
Darktrinnity,nemesis,1130,deathknight,unholy,71,36,35
Deathsmog,quelthalas,1127,deathknight,unholy,37,22,15
Vampirecarti,tichondrius,1122,deathknight,unholy,38,18,20
Nicrack,malganis,1120,deathknight,unholy,24,13,11
Carecaa,azralon,1119,deathknight,unholy,44,19,25
Frostcleave,emerald-dream,1115,deathknight,unholy,24,16,8
Druncker,blackrock,1114,deathknight,unholy,53,20,33
Mordeo,bleeding-hollow,1114,deathknight,unholy,34,12,22
Pántera,darkspear,1113,deathknight,unholy,24,12,12
Mandrágor,quelthalas,1111,deathknight,unholy,52,20,32
Dankbro,tichondrius,1101,deathknight,unholy,36,15,21
Moxtexd,drakkari,1100,deathknight,unholy,30,21,9
Morghulas,moon-guard,1098,deathknight,unholy,30,12,18
Maripaula,ragnaros,1097,deathknight,unholy,35,14,21
Scaista,tichondrius,1095,deathknight,unholy,24,13,11
Polydeuces,queldorei,1091,deathknight,unholy,66,26,40
Mercysparx,thrall,1090,deathknight,unholy,120,57,63
Jinus,earthen-ring,1087,deathknight,unholy,30,14,16
Logann,azralon,1085,deathknight,unholy,28,13,15
Kanthrix,illidan,1084,deathknight,unholy,32,12,20
Fuzzyrump,eitrigg,1080,deathknight,unholy,36,21,15
Plaguebreak,darrowmere,1080,deathknight,unholy,84,48,36
Zillachilla,azshara,1079,deathknight,unholy,21,13,8
Honustustere,stormrage,1076,deathknight,unholy,29,12,17
Frostkane,stormrage,1071,deathknight,unholy,36,17,19
Froznorbs,tichondrius,1068,deathknight,unholy,26,13,13
Zaelize,sargeras,1065,deathknight,unholy,54,24,30
Zebirock,stormrage,1061,deathknight,unholy,36,12,24
Kayzark,tichondrius,1060,deathknight,unholy,54,30,24
Mordekaiseer,azralon,1057,deathknight,unholy,148,74,74
Ragsec,bleeding-hollow,1056,deathknight,unholy,18,11,7
Mossó,tichondrius,1056,deathknight,unholy,18,11,7
Neroxzdvm,area-52,1056,deathknight,unholy,30,11,19
Dreâmer,tichondrius,1056,deathknight,unholy,30,11,19
Cptsäveähöe,tichondrius,1056,deathknight,unholy,30,11,19
Vleryan,ragnaros,1055,deathknight,unholy,18,11,7
Darione,twisting-nether,1055,deathknight,unholy,30,11,19
Troyy,sargeras,1055,deathknight,unholy,30,11,19
Rytex,moon-guard,1055,deathknight,unholy,30,11,19
Saltank,frostmourne,1054,deathknight,unholy,18,11,7
Sommeliergg,stormrage,1053,deathknight,unholy,18,11,7
Xaldalas,kelthuzad,1053,deathknight,unholy,24,11,13
Nwnqt,frostmourne,1053,deathknight,unholy,27,12,15
Deathboost,stormrage,1053,deathknight,unholy,36,11,25
Polpop,zuljin,1051,deathknight,unholy,18,11,7
Acidirin,tichondrius,1049,deathknight,unholy,18,11,7
Draenor,shadowmoon,1049,deathknight,unholy,18,11,7
Runicblade,jaedenar,1048,deathknight,unholy,18,11,7
Salahzar,stormrage,1048,deathknight,unholy,24,11,13
Chad,ysondre,1048,deathknight,unholy,30,11,19
Rulord,wyrmrest-accord,1047,deathknight,unholy,24,11,13
Horîzon,sargeras,1047,deathknight,unholy,30,11,19
Atheion,the-underbog,1046,deathknight,unholy,24,11,13
Alphabro,zuluhed,1045,deathknight,unholy,54,26,28
Kreandria,dalaran,1045,deathknight,unholy,57,15,42
Lazta,azralon,1044,deathknight,unholy,40,17,23
Orphnoch,illidan,1043,deathknight,unholy,30,11,19
Arthureon,kelthuzad,1041,deathknight,unholy,38,14,24
Alayka,stormrage,1040,deathknight,unholy,24,11,13
Tandarilada,shadowmoon,1037,deathknight,unholy,54,28,26
Croaker,gurubashi,1035,deathknight,unholy,24,13,11
Gothywaifu,thunderhorn,1032,deathknight,unholy,24,11,13
Deathcometh,tichondrius,1027,deathknight,unholy,30,11,19
Jman,kaelthas,1026,deathknight,unholy,63,31,32
Annerito,area-52,1023,deathknight,unholy,29,11,18
Bloopdabloop,sargeras,1015,deathknight,unholy,55,31,24
Modok,malganis,1006,deathknight,unholy,17,11,6
Mëllowhypë,sargeras,1000,deathknight,unholy,44,17,27
Sübzerö,quelthalas,1000,deathknight,unholy,42,13,29
Raizzhít,ragnaros,989,deathknight,unholy,22,11,11
Dàndàn,lightbringer,983,deathknight,unholy,30,12,18
Shadowzombie,lethon,975,deathknight,unholy,28,11,17
Hansmclroy,trollbane,970,deathknight,unholy,24,14,10
Fendos,turalyon,963,deathknight,unholy,24,14,10
Delamuerte,ragnaros,962,deathknight,unholy,30,13,17
Wölf,durotan,960,deathknight,unholy,12,10,2
Bernaldino,illidan,960,deathknight,unholy,12,10,2
Ragrek,bleeding-hollow,960,deathknight,unholy,24,10,14
Rängi,caelestrasz,960,deathknight,unholy,78,26,52
Rxzo,frostmourne,960,deathknight,unholy,30,10,20
Immadkx,area-52,960,deathknight,unholy,30,10,20
Wolfsnight,frostmourne,960,deathknight,unholy,36,10,26
Aryêl,ragnaros,959,deathknight,unholy,18,10,8
Turbokitten,tichondrius,959,deathknight,unholy,18,10,8
Gurnok,barthilas,959,deathknight,unholy,18,10,8
Awshuks,illidan,959,deathknight,unholy,18,10,8
Distorted,emerald-dream,959,deathknight,unholy,24,10,14
Emarose,illidan,959,deathknight,unholy,24,10,14
Galaxyboom,tichondrius,958,deathknight,unholy,12,10,2
Khørne,area-52,958,deathknight,unholy,18,10,8
Ghouldruis,barthilas,958,deathknight,unholy,18,10,8
Polepounder,malganis,957,deathknight,unholy,12,10,2
Iðûnn,barthilas,957,deathknight,unholy,18,10,8
Aldoraenna,illidan,957,deathknight,unholy,24,10,14
Biukanon,ragnaros,956,deathknight,unholy,24,10,14
Arthyius,kiljaeden,956,deathknight,unholy,30,10,20
Gobaiakun,proudmoore,955,deathknight,unholy,18,10,8
Mëlødy,quelthalas,955,deathknight,unholy,18,10,8
Dreadcowpie,dalaran,955,deathknight,unholy,18,10,8
Bigdollars,eredar,954,deathknight,unholy,18,10,8
Noolore,firetree,952,deathknight,unholy,12,10,2
Sylneria,elune,952,deathknight,unholy,24,10,14
Hyondeath,tichondrius,952,deathknight,unholy,24,10,14
Attackondude,illidan,951,deathknight,unholy,18,10,8
Vërmilliøn,ragnaros,951,deathknight,unholy,24,10,14
Xijiñpiñg,hyjal,948,deathknight,unholy,24,10,14
Thaylenaar,eredar,947,deathknight,unholy,18,10,8
Bahtman,hakkar,946,deathknight,unholy,30,15,15
Niennahh,sargeras,946,deathknight,unholy,24,10,14
Ghorzul,thrall,945,deathknight,unholy,24,10,14
Morhtzen,moon-guard,944,deathknight,unholy,13,10,3
Cishei,quelthalas,939,deathknight,unholy,33,19,14
Hentaideath,kiljaeden,934,deathknight,unholy,24,10,14
Draxsos,quelthalas,931,deathknight,unholy,54,25,29
Digitalsammy,area-52,923,deathknight,unholy,29,10,19
Deathnorris,zuljin,919,deathknight,unholy,146,68,78
Soulfarm,tichondrius,908,deathknight,unholy,18,11,7
Jaydkx,tichondrius,906,deathknight,unholy,28,11,17
Càsshêrn,lightbringer,893,deathknight,unholy,14,10,4
Dragoroth,zuluhed,893,deathknight,unholy,31,15,16
Carmii,wyrmrest-accord,879,deathknight,unholy,25,10,15
Zareon,zuluhed,876,deathknight,unholy,24,12,12
Dandandor,muradin,876,deathknight,unholy,38,17,21
Nerfdklul,illidan,864,deathknight,unholy,12,9,3
Zakka,korgath,864,deathknight,unholy,18,9,9
Richiex,tichondrius,864,deathknight,unholy,18,9,9
Utthrity,ysera,864,deathknight,unholy,18,9,9
Sickly,arthas,864,deathknight,unholy,18,9,9
Skullash,stormrage,864,deathknight,unholy,18,9,9
Methyldk,frostmourne,864,deathknight,unholy,21,10,11
Shinukishin,stormrage,864,deathknight,unholy,24,9,15
Drneroxz,area-52,864,deathknight,unholy,24,9,15
Dill,madoran,864,deathknight,unholy,24,9,15
Fortissax,area-52,864,deathknight,unholy,30,9,21
Anaksunamooñ,sargeras,863,deathknight,unholy,18,9,9
Annubarak,malganis,863,deathknight,unholy,18,9,9
Bmminitian,illidan,863,deathknight,unholy,18,9,9
Azzandraza,wyrmrest-accord,863,deathknight,unholy,18,9,9
Kasteny,frostmourne,863,deathknight,unholy,18,9,9
Spurzilla,emerald-dream,863,deathknight,unholy,18,9,9
Valandiel,jubeithos,863,deathknight,unholy,18,9,9
Sbplaysdk,akama,863,deathknight,unholy,30,9,21
Vynlerran,skullcrusher,862,deathknight,unholy,18,9,9
Binicius,tichondrius,862,deathknight,unholy,18,9,9
Àrchøn,kelthuzad,862,deathknight,unholy,18,9,9
Killos,proudmoore,862,deathknight,unholy,18,9,9
Tharegorn,azralon,862,deathknight,unholy,18,9,9
Maiatsu,illidan,862,deathknight,unholy,18,9,9
Friezen,illidan,862,deathknight,unholy,18,9,9
Artous,stormrage,862,deathknight,unholy,36,9,27
Monglord,arthas,861,deathknight,unholy,18,9,9
Runeswanson,area-52,861,deathknight,unholy,18,9,9
Dmtdeaths,kelthuzad,861,deathknight,unholy,18,9,9
Exur,stormrage,861,deathknight,unholy,24,9,15
Cosanostrá,malganis,860,deathknight,unholy,12,9,3
Cadavr,tichondrius,860,deathknight,unholy,12,9,3
Rinthosaka,ragnaros,860,deathknight,unholy,18,9,9
Velyssiah,stormrage,860,deathknight,unholy,24,9,15
Smerknight,proudmoore,860,deathknight,unholy,24,9,15
Felerin,kiljaeden,859,deathknight,unholy,18,9,9
Ðerion,stormrage,859,deathknight,unholy,18,9,9
Sidbane,kalecgos,859,deathknight,unholy,19,9,10
Kaórii,stormrage,858,deathknight,unholy,30,9,21
Tinytanx,aerie-peak,856,deathknight,unholy,30,9,21
Kentolos,proudmoore,855,deathknight,unholy,12,9,3
Zathog,lightbringer,853,deathknight,unholy,30,9,21
Revendra,emerald-dream,852,deathknight,unholy,20,10,10
Ulyssess,jubeithos,851,deathknight,unholy,76,35,41
Pwnface,aerie-peak,851,deathknight,unholy,25,9,16
Ulerin,illidan,850,deathknight,unholy,18,9,9
Acerbus,mannoroth,846,deathknight,unholy,23,9,14
Plaza,thorium-brotherhood,844,deathknight,unholy,18,9,9
Maverax,executus,841,deathknight,unholy,24,10,14
Grimmtidings,dentarg,839,deathknight,unholy,42,17,25
Destruktion,uldaman,838,deathknight,unholy,12,9,3
Handler,nemesis,830,deathknight,unholy,20,10,10
Stygiansiix,draenor,822,deathknight,unholy,24,9,15
Vynjonc,drenden,820,deathknight,unholy,18,9,9
Alderma,zuljin,814,deathknight,unholy,29,10,19
Dreekon,bleeding-hollow,797,deathknight,unholy,30,15,15
Festers,burning-legion,794,deathknight,unholy,26,9,17
Wuhán,proudmoore,787,deathknight,unholy,38,9,29
Maalevolent,thunderlord,783,deathknight,unholy,25,9,16
Mesx,illidan,768,deathknight,unholy,12,8,4
Imrealgày,zuljin,768,deathknight,unholy,12,8,4
Vitad,tichondrius,768,deathknight,unholy,12,8,4
Liqùid,moon-guard,768,deathknight,unholy,12,8,4
Poderrosodk,azralon,768,deathknight,unholy,12,8,4
Jamjae,tichondrius,768,deathknight,unholy,12,8,4
Dendra,barthilas,768,deathknight,unholy,12,8,4
Dicromick,illidan,768,deathknight,unholy,15,9,6
Maltendis,malganis,768,deathknight,unholy,18,8,10
Sinnan,turalyon,768,deathknight,unholy,18,8,10
Slissy,hyjal,768,deathknight,unholy,18,8,10
Piratehookah,sargeras,768,deathknight,unholy,18,8,10
Longlnus,malganis,768,deathknight,unholy,24,8,16
Thraximundar,stormrage,768,deathknight,unholy,24,8,16
Novädk,ragnaros,768,deathknight,unholy,24,8,16
Loomoros,sargeras,768,deathknight,unholy,24,8,16
Darkathås,tichondrius,768,deathknight,unholy,24,8,16
Deathsloot,sargeras,767,deathknight,unholy,12,8,4
Ørcrist,area-52,767,deathknight,unholy,12,8,4
Akrylo,ragnaros,767,deathknight,unholy,12,8,4
Bojaçk,stormrage,767,deathknight,unholy,12,8,4
Darik,the-venture-co,767,deathknight,unholy,12,8,4
Trydeath,azralon,767,deathknight,unholy,13,8,5
Sujudk,emerald-dream,767,deathknight,unholy,18,8,10
Bloodygrip,bleeding-hollow,767,deathknight,unholy,18,8,10
Nattór,dalaran,767,deathknight,unholy,18,8,10
Fluffymoo,frostmourne,767,deathknight,unholy,18,8,10
Gorillagrip,sargeras,767,deathknight,unholy,18,8,10
Traitre,onyxia,767,deathknight,unholy,18,8,10
Apocalipsis,bleeding-hollow,767,deathknight,unholy,18,8,10
Hædës,area-52,767,deathknight,unholy,18,8,10
Zuckdk,illidan,767,deathknight,unholy,18,8,10
Skulm,emerald-dream,767,deathknight,unholy,20,8,12
Sicklecell,laughing-skull,767,deathknight,unholy,24,8,16
Sahaile,moon-guard,767,deathknight,unholy,30,8,22
Ðrëssa,azralon,766,deathknight,unholy,12,8,4
Redcancer,tichondrius,766,deathknight,unholy,12,8,4
Tragül,sargeras,766,deathknight,unholy,12,8,4
Raynorr,dawnbringer,766,deathknight,unholy,12,8,4
Olblueyes,hyjal,766,deathknight,unholy,18,8,10
Archaná,stormrage,766,deathknight,unholy,18,8,10
Hellhämmer,ragnaros,766,deathknight,unholy,18,8,10
Katakuri,azralon,766,deathknight,unholy,18,8,10
Riparonii,illidan,766,deathknight,unholy,21,8,13
Ltoblivious,thrall,766,deathknight,unholy,24,8,16
Shadowghast,saurfang,765,deathknight,unholy,12,8,4
Hildolfr,shattered-hand,765,deathknight,unholy,18,8,10
Bloodydebt,malganis,765,deathknight,unholy,18,8,10
Dalrin,emerald-dream,765,deathknight,unholy,24,8,16
Wickedknîght,kelthuzad,765,deathknight,unholy,24,8,16
Abadena,illidan,765,deathknight,unholy,27,8,19
Maggotmulch,zuljin,764,deathknight,unholy,30,8,22
Azombie,burning-blade,762,deathknight,unholy,18,8,10
Kowell,drakkari,762,deathknight,unholy,18,8,10
Primoverdino,azralon,762,deathknight,unholy,18,8,10
Spotsdk,hyjal,761,deathknight,unholy,18,8,10
Iamlrr,maelstrom,761,deathknight,unholy,24,8,16
Jojomcdeath,senjin,760,deathknight,unholy,18,8,10
Liltinktink,stormreaver,760,deathknight,unholy,18,8,10
Kaciann,dalaran,758,deathknight,unholy,12,8,4
Lepanda,skywall,758,deathknight,unholy,18,8,10
Rinngar,quelthalas,751,deathknight,unholy,14,8,6
Silvorus,moon-guard,735,deathknight,unholy,17,8,9
Poonen,area-52,735,deathknight,unholy,17,8,9
Starset,burning-legion,728,deathknight,unholy,24,9,15
Somethingdum,sargeras,703,deathknight,unholy,16,8,8
Lolcàtxo,tichondrius,703,deathknight,unholy,17,8,9
Ekirei,daggerspine,702,deathknight,unholy,11,8,3
Beforelunch,tichondrius,672,deathknight,unholy,12,7,5
Plag,bleeding-hollow,672,deathknight,unholy,12,7,5
Ripcrawford,proudmoore,672,deathknight,unholy,12,7,5
Cgg,tichondrius,672,deathknight,unholy,12,7,5
Donrhythmic,ysera,672,deathknight,unholy,12,7,5
Liverkick,zuljin,672,deathknight,unholy,12,7,5
Penguinlolx,sargeras,672,deathknight,unholy,12,7,5
Mcdeathturds,tichondrius,672,deathknight,unholy,12,7,5
Bkb,sargeras,672,deathknight,unholy,12,7,5
Karthayne,area-52,672,deathknight,unholy,12,7,5
Bukumo,zuljin,672,deathknight,unholy,12,7,5
Jbert,sargeras,672,deathknight,unholy,12,7,5
Inemia,wyrmrest-accord,672,deathknight,unholy,16,7,9
Kûri,runetotem,672,deathknight,unholy,18,7,11
Umbramane,tichondrius,672,deathknight,unholy,18,7,11
Dxssxe,tichondrius,672,deathknight,unholy,18,7,11
Meisterdeath,stormrage,672,deathknight,unholy,18,7,11
Mmaximus,darkspear,672,deathknight,unholy,18,7,11
Bellybuster,malganis,672,deathknight,unholy,18,7,11
Notiniquity,tichondrius,672,deathknight,unholy,18,7,11
Worgenracist,tichondrius,672,deathknight,unholy,18,7,11
Bryku,tichondrius,672,deathknight,unholy,18,7,11
Xarielle,tichondrius,672,deathknight,unholy,18,7,11
Mightyfails,frostmourne,672,deathknight,unholy,18,7,11
Ebolaxd,area-52,672,deathknight,unholy,18,7,11
Deathup,sargeras,672,deathknight,unholy,18,7,11
Zoomoth,illidan,672,deathknight,unholy,24,7,17
Zenan,area-52,672,deathknight,unholy,24,7,17
Xenocrates,illidan,672,deathknight,unholy,24,7,17
Ceedog,crushridge,672,deathknight,unholy,30,7,23
Gâbriel,cairne,671,deathknight,unholy,12,7,5
Samsoníte,illidan,671,deathknight,unholy,12,7,5
Sevexi,moon-guard,671,deathknight,unholy,12,7,5
Tiller,mannoroth,671,deathknight,unholy,12,7,5
Rihàn,drakkari,671,deathknight,unholy,12,7,5
Deatheey,area-52,671,deathknight,unholy,12,7,5
Fligdeath,llane,671,deathknight,unholy,12,7,5
Woahwtf,area-52,671,deathknight,unholy,18,7,11
Noitrox,azralon,671,deathknight,unholy,18,7,11
Mfknight,archimonde,671,deathknight,unholy,18,7,11
Kidek,proudmoore,671,deathknight,unholy,18,7,11
Deadlungs,area-52,671,deathknight,unholy,20,7,13
Demonstalker,boulderfist,671,deathknight,unholy,24,7,17
Kralos,khadgar,670,deathknight,unholy,12,7,5
Onslàught,sargeras,670,deathknight,unholy,12,7,5
Emberwarden,stormrage,670,deathknight,unholy,18,7,11
Adralin,sargeras,670,deathknight,unholy,18,7,11
Libramontes,ragnaros,670,deathknight,unholy,24,7,17
Irokthefrost,frostmourne,669,deathknight,unholy,12,7,5
Thaladius,emerald-dream,669,deathknight,unholy,18,7,11
Boneguard,stormrage,668,deathknight,unholy,18,7,11
Grtmisdirect,illidan,666,deathknight,unholy,21,8,13
Arthasnet,quelthalas,666,deathknight,unholy,24,7,17
Zëb,sargeras,665,deathknight,unholy,12,7,5
Thepanzer,elune,665,deathknight,unholy,12,7,5
Zàkgor,moon-guard,665,deathknight,unholy,12,7,5
Argar,crushridge,664,deathknight,unholy,12,7,5
Runíc,demon-soul,664,deathknight,unholy,18,7,11
Heldwynd,bonechewer,664,deathknight,unholy,24,7,17
Garshna,ragnaros,658,deathknight,unholy,12,7,5
Hadianton,stormrage,654,deathknight,unholy,15,8,7
Papparoach,ysera,641,deathknight,unholy,24,7,17
Dbg,frostmane,639,deathknight,unholy,11,7,4
Hardtoplaydk,chogall,639,deathknight,unholy,17,7,10
Tasila,tichondrius,622,deathknight,unholy,11,7,4
Ghostdeath,blackhand,622,deathknight,unholy,15,7,8
Bonalumë,azralon,620,deathknight,unholy,17,7,10
Soulkiti,blackwater-raiders,608,deathknight,unholy,16,7,9
Nekrosys,eitrigg,608,deathknight,unholy,22,7,15
Bingoez,frostmourne,607,deathknight,unholy,11,7,4
Arcänn,drenden,576,deathknight,unholy,6,6,0
Tyrsfaith,tichondrius,576,deathknight,unholy,12,6,6
Surkk,tichondrius,576,deathknight,unholy,12,6,6
Bøoth,area-52,576,deathknight,unholy,12,6,6
Delwrath,proudmoore,576,deathknight,unholy,12,6,6
Bébøp,malganis,576,deathknight,unholy,12,6,6
Zyzz,frostmourne,576,deathknight,unholy,12,6,6
Zeenki,ragnaros,576,deathknight,unholy,12,6,6
Palliote,frostmane,576,deathknight,unholy,12,6,6
Sweatynation,tichondrius,576,deathknight,unholy,12,6,6
Svlla,doomhammer,576,deathknight,unholy,12,6,6
Beby,wyrmrest-accord,576,deathknight,unholy,12,6,6
Cali,bladefist,576,deathknight,unholy,12,6,6
Chubingus,the-venture-co,576,deathknight,unholy,12,6,6
Salusx,area-52,576,deathknight,unholy,12,6,6
Bossdk,tichondrius,576,deathknight,unholy,12,6,6
Xhan,tichondrius,576,deathknight,unholy,12,6,6
Remõrse,moon-guard,576,deathknight,unholy,12,6,6
Sanezarro,bleeding-hollow,576,deathknight,unholy,12,6,6
Chainsharder,stormrage,576,deathknight,unholy,12,6,6
Nøzawkolypse,area-52,576,deathknight,unholy,12,6,6
Lilwayne,archimonde,576,deathknight,unholy,12,6,6
Mizzri,frostmourne,576,deathknight,unholy,12,6,6
Hickish,tichondrius,576,deathknight,unholy,12,6,6
Càvic,malganis,576,deathknight,unholy,12,6,6
Demonicrunes,windrunner,576,deathknight,unholy,12,6,6
Jonahdk,sargeras,576,deathknight,unholy,12,6,6
Saco,malganis,576,deathknight,unholy,12,6,6
Ridesatenspd,caelestrasz,576,deathknight,unholy,12,6,6
Raaizz,ragnaros,576,deathknight,unholy,12,6,6
Lainmortal,ragnaros,576,deathknight,unholy,18,6,12
Cirillan,bleeding-hollow,576,deathknight,unholy,18,6,12
Joystickwrld,silvermoon,576,deathknight,unholy,18,6,12
Nethaar,tichondrius,576,deathknight,unholy,18,6,12
Boltman,malganis,576,deathknight,unholy,18,6,12
Blackùla,tichondrius,576,deathknight,unholy,18,6,12
Poubelle,malganis,576,deathknight,unholy,18,6,12
Icycrazy,azralon,576,deathknight,unholy,18,6,12
Bøngripx,tichondrius,576,deathknight,unholy,18,6,12
Monesy,tichondrius,576,deathknight,unholy,24,6,18
Baldlord,tichondrius,576,deathknight,unholy,24,6,18
Conquest,drenden,576,deathknight,unholy,24,6,18
Granknight,azralon,576,deathknight,unholy,24,6,18
Abombinator,stormrage,575,deathknight,unholy,6,6,0
Christophe,skullcrusher,575,deathknight,unholy,12,6,6
Iceclaw,bleeding-hollow,575,deathknight,unholy,12,6,6
Åkatsukii,uther,575,deathknight,unholy,12,6,6
Agamoth,ragnaros,575,deathknight,unholy,12,6,6
Galthro,tichondrius,575,deathknight,unholy,12,6,6
Bnasty,arthas,575,deathknight,unholy,12,6,6
Sephirott,boulderfist,575,deathknight,unholy,12,6,6
Peteargryphn,illidan,575,deathknight,unholy,12,6,6
Ksoldier,illidan,575,deathknight,unholy,12,6,6
Isaiahstolt,area-52,575,deathknight,unholy,12,6,6
Corpsepetal,muradin,575,deathknight,unholy,18,6,12
Vicentão,tichondrius,574,deathknight,unholy,12,6,6
Hordbadia,garrosh,574,deathknight,unholy,12,6,6
Robacalzónes,ragnaros,574,deathknight,unholy,12,6,6
Fraänrisco,ragnaros,574,deathknight,unholy,18,6,12
Vapelounge,darkspear,574,deathknight,unholy,18,6,12
Juggérnaút,bonechewer,572,deathknight,unholy,12,6,6
Tormentsoul,ragnaros,572,deathknight,unholy,12,6,6
Waterboy,malganis,566,deathknight,unholy,12,6,6
Lowan,stormrage,566,deathknight,unholy,12,6,6
Droko,thunderlord,563,deathknight,unholy,21,7,14
Syzurp,barthilas,558,deathknight,unholy,13,7,6
Janoh,the-scryers,553,deathknight,unholy,23,6,17
Athropos,sargeras,543,deathknight,unholy,8,7,1
Caohiyan,tichondrius,542,deathknight,unholy,11,6,5
Herstôry,kelthuzad,527,deathknight,unholy,11,6,5
Gkdm,tichondrius,522,deathknight,unholy,21,8,13
Chës,tichondrius,522,deathknight,unholy,22,7,15
Abømination,zuljin,510,deathknight,unholy,20,6,14
Kalëndar,drakkari,503,deathknight,unholy,25,12,13
Bawlsauce,area-52,496,deathknight,unholy,13,6,7
Lastboyscout,silvermoon,480,deathknight,unholy,6,5,1
Wâggies,moon-guard,480,deathknight,unholy,6,5,1
Mopglad,tichondrius,480,deathknight,unholy,6,5,1
Andariel,ragnaros,480,deathknight,unholy,6,5,1
Devilwarship,daggerspine,480,deathknight,unholy,6,5,1
Depthknight,barthilas,480,deathknight,unholy,6,5,1
Solø,proudmoore,480,deathknight,unholy,6,5,1
Superzach,muradin,480,deathknight,unholy,6,5,1
Bànished,moon-guard,480,deathknight,unholy,7,5,2
Defaultz,turalyon,480,deathknight,unholy,12,5,7
Schreit,zuljin,480,deathknight,unholy,12,5,7
Andem,elune,480,deathknight,unholy,12,5,7
Cammykickbot,frostmourne,480,deathknight,unholy,12,5,7
Qberks,elune,480,deathknight,unholy,12,5,7
Lilpootie,tichondrius,480,deathknight,unholy,12,5,7
Initiative,moon-guard,480,deathknight,unholy,12,5,7
Deathpair,bleeding-hollow,480,deathknight,unholy,12,5,7
Gatitos,ragnaros,480,deathknight,unholy,12,5,7
Bot,icecrown,480,deathknight,unholy,12,5,7
Lîch,azralon,480,deathknight,unholy,12,5,7
Sindragosa,dragonmaw,480,deathknight,unholy,12,5,7
Coachclaudio,tichondrius,480,deathknight,unholy,12,5,7
Defekaite,kiljaeden,480,deathknight,unholy,12,5,7
Rayzuul,queldorei,480,deathknight,unholy,12,5,7
Wapman,bloodhoof,480,deathknight,unholy,12,5,7
Nordiin,stormrage,480,deathknight,unholy,12,5,7
Skotch,lightninghoof,480,deathknight,unholy,12,5,7
Serathai,tichondrius,480,deathknight,unholy,12,5,7
Deathlyvoid,sargeras,480,deathknight,unholy,12,5,7
Clovermoon,tichondrius,480,deathknight,unholy,12,5,7
Hemorrhoids,blackrock,480,deathknight,unholy,12,5,7
Ghrat,bleeding-hollow,480,deathknight,unholy,12,5,7
Zaratose,area-52,480,deathknight,unholy,12,5,7
Vläad,ragnaros,480,deathknight,unholy,12,5,7
Darkfög,sargeras,480,deathknight,unholy,12,5,7
Birnolan,proudmoore,480,deathknight,unholy,12,5,7
Xariuz,quelthalas,480,deathknight,unholy,12,5,7
Darkwraith,illidan,480,deathknight,unholy,12,5,7
Cosmicrune,turalyon,480,deathknight,unholy,12,5,7
Römney,stormrage,480,deathknight,unholy,12,5,7
Aoshië,area-52,480,deathknight,unholy,12,5,7
Akmy,illidan,480,deathknight,unholy,12,5,7
Pathæs,bleeding-hollow,480,deathknight,unholy,12,5,7
Raull,ragnaros,480,deathknight,unholy,12,5,7
Deadntaxes,thunderlord,480,deathknight,unholy,12,5,7
Drakkala,silvermoon,480,deathknight,unholy,12,5,7
Dreadwraith,malganis,480,deathknight,unholy,12,5,7
Darthkeefers,zuljin,480,deathknight,unholy,12,5,7
Gneanderthal,bloodscalp,480,deathknight,unholy,12,5,7
Laboön,stormrage,480,deathknight,unholy,12,5,7
Yeahgood,frostmourne,480,deathknight,unholy,12,5,7
Menethïl,quelthalas,480,deathknight,unholy,12,5,7
Swänsz,stormrage,480,deathknight,unholy,12,5,7
Gusabio,drakkari,480,deathknight,unholy,12,5,7
Maskofwintrs,zuljin,480,deathknight,unholy,18,5,13
Sevendeadly,frostmourne,480,deathknight,unholy,18,5,13
Gazco,frostmourne,480,deathknight,unholy,18,5,13
Nurglet,proudmoore,480,deathknight,unholy,18,5,13
Dkinaboxx,hyjal,480,deathknight,unholy,18,5,13
Sylèss,tichondrius,480,deathknight,unholy,18,5,13
Chainsadeath,stormrage,480,deathknight,unholy,18,5,13
Deathgimbo,hellscream,480,deathknight,unholy,18,5,13
Dementrius,zuljin,480,deathknight,unholy,25,5,20
Extremepvp,aegwynn,479,deathknight,unholy,6,5,1
Wolfsdeath,shattered-hand,479,deathknight,unholy,6,5,1
Valkzy,malganis,479,deathknight,unholy,6,5,1
Ahwooh,kelthuzad,479,deathknight,unholy,6,5,1
Mefistô,quelthalas,479,deathknight,unholy,10,6,4
Joelfromuber,stormrage,479,deathknight,unholy,12,5,7
Xadrisill,winterhoof,479,deathknight,unholy,12,5,7
Dijkstrap,tichondrius,479,deathknight,unholy,12,5,7
Borgin,emerald-dream,479,deathknight,unholy,12,5,7
Deathfearsme,kiljaeden,479,deathknight,unholy,12,5,7
Stemen,quelthalas,479,deathknight,unholy,12,5,7
Jessefur,undermine,479,deathknight,unholy,12,5,7
Kramy,barthilas,479,deathknight,unholy,12,5,7
Itired,tichondrius,479,deathknight,unholy,12,5,7
Caqw,akama,479,deathknight,unholy,12,5,7
Nekrofeelyak,kelthuzad,479,deathknight,unholy,12,5,7
Vorlakesh,boulderfist,479,deathknight,unholy,12,5,7
Amaethyst,kelthuzad,479,deathknight,unholy,12,5,7
Baracka,sargeras,479,deathknight,unholy,18,5,13
Futurism,shadowmoon,478,deathknight,unholy,6,5,1
Henritoxic,azralon,478,deathknight,unholy,10,7,3
Aborter,arthas,478,deathknight,unholy,12,5,7
Jonnii,area-52,477,deathknight,unholy,12,5,7
Yafa,bonechewer,474,deathknight,unholy,27,6,21
Headbustr,sargeras,473,deathknight,unholy,12,5,7
Fishtouching,illidan,463,deathknight,unholy,17,5,12
Megatrôn,malganis,463,deathknight,unholy,17,5,12
Faelmo,malganis,447,deathknight,unholy,11,5,6
Prettyliched,area-52,447,deathknight,unholy,11,5,6
Lenos,tichondrius,447,deathknight,unholy,11,5,6
Iloveenzley,tichondrius,447,deathknight,unholy,11,5,6
Fearfull,hyjal,447,deathknight,unholy,16,5,11
Sorry,ysera,432,deathknight,unholy,9,6,3
Furiel,mugthol,430,deathknight,unholy,9,6,3
Spôôn,aggramar,430,deathknight,unholy,11,5,6
Dtrayn,tichondrius,416,deathknight,unholy,10,5,5
Reighart,kiljaeden,415,deathknight,unholy,8,5,3
Testifier,illidan,415,deathknight,unholy,8,5,3
Higeki,area-52,415,deathknight,unholy,8,5,3
Shiminy,chogall,415,deathknight,unholy,10,5,5
Bosleigor,elune,400,deathknight,unholy,13,5,8
Frostology,echo-isles,399,deathknight,unholy,5,5,0
Sleezyfbaby,sargeras,384,deathknight,unholy,6,4,2
Frøstfinger,azralon,384,deathknight,unholy,6,4,2
Zèro,moonrunner,384,deathknight,unholy,6,4,2
Shargan,illidan,384,deathknight,unholy,6,4,2
Nbahooper,area-52,384,deathknight,unholy,6,4,2
Lxsol,illidan,384,deathknight,unholy,6,4,2
Whaleofwales,ysondre,384,deathknight,unholy,6,4,2
Vampygeizt,zuljin,384,deathknight,unholy,6,4,2
Cheliä,quelthalas,384,deathknight,unholy,6,4,2
Darkswar,barthilas,384,deathknight,unholy,6,4,2
Hiki,ragnaros,384,deathknight,unholy,6,4,2
Asthenophoba,bloodscalp,384,deathknight,unholy,6,4,2
Keator,tichondrius,384,deathknight,unholy,6,4,2
Futruth,khaz-modan,384,deathknight,unholy,6,4,2
Icecreamlife,chogall,384,deathknight,unholy,6,4,2
Chooksknight,tichondrius,384,deathknight,unholy,6,4,2
Zeathial,moon-guard,384,deathknight,unholy,6,4,2
Janaru,bloodscalp,384,deathknight,unholy,6,4,2
Chillbruh,garrosh,384,deathknight,unholy,6,4,2
Ragnarøs,stormrage,384,deathknight,unholy,6,4,2
Easyunholy,tichondrius,384,deathknight,unholy,6,4,2
Murphu,stormrage,384,deathknight,unholy,6,4,2
Assidik,dathremar,384,deathknight,unholy,6,4,2
Ðrift,azralon,384,deathknight,unholy,6,4,2
Tibocourtois,tichondrius,384,deathknight,unholy,6,4,2
Hlw,tichondrius,384,deathknight,unholy,6,4,2
Peacebringer,frostmourne,384,deathknight,unholy,6,4,2
Alzenth,quelthalas,384,deathknight,unholy,6,4,2
Koreandk,tichondrius,384,deathknight,unholy,6,4,2
Mistmoorex,stormscale,384,deathknight,unholy,6,4,2
Søldier,proudmoore,384,deathknight,unholy,6,4,2
Pleasecakes,blood-furnace,384,deathknight,unholy,9,5,4
Kárd,tichondrius,384,deathknight,unholy,12,4,8
Hounura,dathremar,384,deathknight,unholy,12,4,8
Sandooñ,tichondrius,384,deathknight,unholy,12,4,8
Almostdead,proudmoore,384,deathknight,unholy,12,4,8
Bealzabub,sargeras,384,deathknight,unholy,12,4,8
Ambagrips,frostmourne,384,deathknight,unholy,12,4,8
Shehanshah,area-52,384,deathknight,unholy,12,4,8
Noiksnow,azralon,384,deathknight,unholy,12,4,8
Deathscyythe,illidan,384,deathknight,unholy,12,4,8
Threehunned,frostmourne,384,deathknight,unholy,12,4,8
Wúhan,moon-guard,384,deathknight,unholy,12,4,8
Eightamdk,tichondrius,384,deathknight,unholy,12,4,8
Danteloki,proudmoore,384,deathknight,unholy,12,4,8
Sonoftwodads,thrall,384,deathknight,unholy,12,4,8
Dalka,laughing-skull,384,deathknight,unholy,12,4,8
Raakaa,ghostlands,384,deathknight,unholy,12,4,8
Çorn,sargeras,384,deathknight,unholy,12,4,8
Pharoahx,gurubashi,384,deathknight,unholy,12,4,8
Mardrank,stormrage,384,deathknight,unholy,12,4,8
Kìrìtó,malygos,384,deathknight,unholy,12,4,8
Grýmm,bonechewer,384,deathknight,unholy,12,4,8
Dkekk,illidan,384,deathknight,unholy,12,4,8
Cäin,dreadmaul,384,deathknight,unholy,12,4,8
Deathhimself,moonrunner,384,deathknight,unholy,12,4,8
Yeetmaster,area-52,384,deathknight,unholy,12,4,8
Tinylich,arthas,384,deathknight,unholy,12,4,8
Froztknight,anubarak,384,deathknight,unholy,12,4,8
Mournehowl,stormrage,384,deathknight,unholy,12,4,8
Cald,bonechewer,384,deathknight,unholy,12,4,8
Bjorstad,moon-guard,384,deathknight,unholy,12,4,8
Annuvyz,darkspear,384,deathknight,unholy,12,4,8
Coronä,malfurion,384,deathknight,unholy,12,4,8
Nolderosdk,nemesis,384,deathknight,unholy,12,4,8
Daellius,ragnaros,384,deathknight,unholy,12,4,8
Tyrien,frostmane,384,deathknight,unholy,12,4,8
Cokedrip,bleeding-hollow,384,deathknight,unholy,12,4,8
Wankekong,zuljin,384,deathknight,unholy,12,4,8
Capergrip,tichondrius,384,deathknight,unholy,12,4,8
Testamentxx,thunderlord,384,deathknight,unholy,12,4,8
Tirdinn,madoran,384,deathknight,unholy,12,4,8
Lho,caelestrasz,384,deathknight,unholy,18,4,14
Avengis,bleeding-hollow,384,deathknight,unholy,18,4,14
Golgothic,sargeras,384,deathknight,unholy,18,4,14
Keralius,stormrage,384,deathknight,unholy,18,4,14
Drzièglér,tichondrius,384,deathknight,unholy,18,4,14
Flazzul,kiljaeden,383,deathknight,unholy,6,4,2
Turbotoxic,illidan,383,deathknight,unholy,6,4,2
Hitsüyi,quelthalas,383,deathknight,unholy,11,6,5
Maligolde,nemesis,383,deathknight,unholy,12,4,8
Demher,ragnaros,383,deathknight,unholy,12,4,8
Plaguedoctor,moon-guard,383,deathknight,unholy,12,4,8
Optics,bleeding-hollow,383,deathknight,unholy,12,4,8
Ziona,archimonde,383,deathknight,unholy,18,4,14
Hobyrt,bleeding-hollow,382,deathknight,unholy,6,4,2
Jinxtar,wyrmrest-accord,382,deathknight,unholy,6,4,2
Eyedeas,emerald-dream,382,deathknight,unholy,12,4,8
Ghoulorama,illidan,380,deathknight,unholy,12,4,8
Brantodne,galakrond,379,deathknight,unholy,12,4,8
Atakan,burning-blade,367,deathknight,unholy,11,4,7
Gankhiss,emerald-dream,351,deathknight,unholy,11,4,7
Azupo,aerie-peak,351,deathknight,unholy,14,5,9
Zuum,kelthuzad,351,deathknight,unholy,17,4,13
Zygon,thrall,336,deathknight,unholy,9,4,5
Ahirek,quelthalas,320,deathknight,unholy,10,4,6
Ekaj,azuremyst,319,deathknight,unholy,5,4,1
Rodeon,azgalor,291,deathknight,unholy,13,5,8
Mts,thunderhorn,288,deathknight,unholy,6,3,3
Smokeyjoe,aegwynn,288,deathknight,unholy,6,3,3
Blitzcreig,sargeras,288,deathknight,unholy,6,3,3
Northwing,sargeras,288,deathknight,unholy,6,3,3
Mindflayers,area-52,288,deathknight,unholy,6,3,3
Trant,tichondrius,288,deathknight,unholy,6,3,3
Ego,blackrock,288,deathknight,unholy,6,3,3
Mýrrh,wyrmrest-accord,288,deathknight,unholy,6,3,3
Dlaron,ragnaros,288,deathknight,unholy,6,3,3
Lr,hyjal,288,deathknight,unholy,6,3,3
Matea,ragnaros,288,deathknight,unholy,6,3,3
Lafourche,sargeras,288,deathknight,unholy,6,3,3
Kossero,thunderlord,288,deathknight,unholy,6,3,3
Forgos,ragnaros,288,deathknight,unholy,6,3,3
Frostdest,kiljaeden,288,deathknight,unholy,6,3,3
Vcadk,ragnaros,288,deathknight,unholy,6,3,3
Plaguewar,thrall,288,deathknight,unholy,6,3,3
Indraz,jubeithos,288,deathknight,unholy,6,3,3
Scursy,tichondrius,288,deathknight,unholy,6,3,3
Marash,moon-guard,288,deathknight,unholy,6,3,3
Drippedout,illidan,288,deathknight,unholy,6,3,3
Mendoh,tichondrius,288,deathknight,unholy,6,3,3
Anderius,tichondrius,288,deathknight,unholy,6,3,3
Elrog,nemesis,288,deathknight,unholy,6,3,3
Viscerus,stormrage,288,deathknight,unholy,6,3,3
Disritmia,stormrage,288,deathknight,unholy,6,3,3
Jorich,ragnaros,288,deathknight,unholy,6,3,3
Adavynn,darkspear,288,deathknight,unholy,6,3,3
Vinaroth,kiljaeden,288,deathknight,unholy,6,3,3
Pizy,frostmourne,288,deathknight,unholy,6,3,3
Leinandk,illidan,288,deathknight,unholy,6,3,3
Frenzza,frostmourne,288,deathknight,unholy,6,3,3
Legendåryx,sargeras,288,deathknight,unholy,6,3,3
Chrønnøz,nemesis,288,deathknight,unholy,6,3,3
Petkick,tichondrius,288,deathknight,unholy,6,3,3
Nifftybear,tichondrius,288,deathknight,unholy,6,3,3
Ödens,dalaran,288,deathknight,unholy,6,3,3
Ariacy,sargeras,288,deathknight,unholy,6,3,3
Syringe,bloodhoof,288,deathknight,unholy,6,3,3
Céle,area-52,288,deathknight,unholy,6,3,3
Vexmaw,twisting-nether,288,deathknight,unholy,6,3,3
Krumpous,tichondrius,288,deathknight,unholy,6,3,3
Shookdnation,suramar,288,deathknight,unholy,6,3,3
Alivaron,lothar,288,deathknight,unholy,6,3,3
Mikeoxmaul,frostmourne,288,deathknight,unholy,6,3,3
Barricus,stonemaul,288,deathknight,unholy,6,3,3
Válak,stormrage,288,deathknight,unholy,6,3,3
Pepecoomer,frostmourne,288,deathknight,unholy,6,3,3
Ðecaying,area-52,288,deathknight,unholy,6,3,3
Feki,frostmourne,288,deathknight,unholy,6,3,3
Necrotictko,tichondrius,288,deathknight,unholy,6,3,3
Icefrost,ghostlands,288,deathknight,unholy,6,3,3
Dizzyswiftz,tichondrius,288,deathknight,unholy,6,3,3
Graciemacie,area-52,288,deathknight,unholy,6,3,3
Outbrèak,sargeras,288,deathknight,unholy,6,3,3
Nalec,tichondrius,288,deathknight,unholy,6,3,3
Martinnash,emerald-dream,288,deathknight,unholy,6,3,3
Chibalaloca,quelthalas,288,deathknight,unholy,6,3,3
Mawvac,quelthalas,288,deathknight,unholy,6,3,3
Llok,area-52,288,deathknight,unholy,6,3,3
Almatafh,azralon,288,deathknight,unholy,6,3,3
Rizzchimp,tichondrius,288,deathknight,unholy,6,3,3
Sherank,akama,288,deathknight,unholy,6,3,3
Xhín,bleeding-hollow,288,deathknight,unholy,6,3,3
Greizul,area-52,288,deathknight,unholy,6,3,3
Laeroth,zuluhed,288,deathknight,unholy,6,3,3
Redrox,tichondrius,288,deathknight,unholy,6,3,3
Xathrrid,stormrage,288,deathknight,unholy,6,3,3
Jerkin,area-52,288,deathknight,unholy,6,3,3
Malairia,area-52,288,deathknight,unholy,6,3,3
Micteca,moonrunner,288,deathknight,unholy,7,3,4
Oroborus,korgath,288,deathknight,unholy,8,3,5
Boomxic,shuhalo,288,deathknight,unholy,11,4,7
Boneherr,sargeras,288,deathknight,unholy,16,4,12
Chosenhero,stormrage,288,deathknight,unholy,12,3,9
Zerky,stormrage,288,deathknight,unholy,12,3,9
Torsophuk,stormrage,288,deathknight,unholy,12,3,9
Bloodemperor,malfurion,288,deathknight,unholy,12,3,9
Chosenrune,stormrage,288,deathknight,unholy,12,3,9
Kaspbrak,destromath,288,deathknight,unholy,12,3,9
Garonse,wyrmrest-accord,288,deathknight,unholy,12,3,9
Gersinhu,azralon,288,deathknight,unholy,12,3,9
Angerforge,illidan,288,deathknight,unholy,12,3,9
Coldmilk,wyrmrest-accord,288,deathknight,unholy,12,3,9
Morbo,proudmoore,288,deathknight,unholy,12,3,9
Emotionaldam,area-52,288,deathknight,unholy,12,3,9
Belfknightt,area-52,288,deathknight,unholy,12,3,9
Shmoe,auchindoun,288,deathknight,unholy,12,3,9
Danlorinis,moon-guard,288,deathknight,unholy,12,3,9
Mongomongo,malganis,288,deathknight,unholy,12,3,9
Inigomontana,moon-guard,288,deathknight,unholy,12,3,9
Techneeq,tichondrius,288,deathknight,unholy,12,3,9
Gigabone,tichondrius,288,deathknight,unholy,12,3,9
Rottenqunt,tichondrius,288,deathknight,unholy,12,3,9
Lolgriped,tichondrius,288,deathknight,unholy,12,3,9
Shmeckla,tichondrius,288,deathknight,unholy,12,3,9
Römulus,area-52,288,deathknight,unholy,12,3,9
Fokit,barthilas,288,deathknight,unholy,12,3,9
Bultek,sargeras,288,deathknight,unholy,12,3,9
Supermane,jubeithos,288,deathknight,unholy,12,3,9
Hynzst,barthilas,288,deathknight,unholy,12,3,9
Malthis,antonidas,288,deathknight,unholy,12,3,9
Coffeemilk,kiljaeden,288,deathknight,unholy,13,3,10
Deathsent,malganis,288,deathknight,unholy,18,3,15
Malovv,nemesis,287,deathknight,unholy,6,3,3
Deadmedic,quelthalas,287,deathknight,unholy,6,3,3
Chanskey,stormrage,287,deathknight,unholy,9,3,6
Zedknight,emerald-dream,287,deathknight,unholy,15,4,11
Morthul,tol-barad,287,deathknight,unholy,12,3,9
Kreachuer,lightbringer,287,deathknight,unholy,12,3,9
Trukutruu,drakkari,286,deathknight,unholy,6,3,3
Orthason,moon-guard,286,deathknight,unholy,6,3,3
Soulgrinder,earthen-ring,286,deathknight,unholy,6,3,3
Copy,suramar,271,deathknight,unholy,11,3,8
Milkdrugs,daggerspine,256,deathknight,unholy,10,3,7
Guffles,tichondrius,256,deathknight,unholy,16,3,13
Baskel,frostmane,255,deathknight,unholy,11,3,8
Cryodemic,illidan,240,deathknight,unholy,9,3,6
Deathrowe,blackhand,240,deathknight,unholy,9,3,6
Leoprime,area-52,239,deathknight,unholy,5,3,2
Dairboi,sargeras,239,deathknight,unholy,5,3,2
Originalsin,tichondrius,239,deathknight,unholy,11,3,8
Rompeimën,ragnaros,234,deathknight,unholy,11,6,5
Ðëthbringër,jubeithos,223,deathknight,unholy,14,3,11
Crypton,tichondrius,208,deathknight,unholy,13,3,10
Charabone,ragnaros,192,deathknight,unholy,4,3,1
Chunkdk,stormrage,192,deathknight,unholy,4,3,1
Socalaj,malorne,192,deathknight,unholy,6,2,4
Tèrok,stormrage,192,deathknight,unholy,6,2,4
Ohia,baelgun,192,deathknight,unholy,6,2,4
Disturbedtwo,azralon,192,deathknight,unholy,6,2,4
Eastcoast,azuremyst,192,deathknight,unholy,6,2,4
Junepí,stormrage,192,deathknight,unholy,6,2,4
Moonkhink,stormrage,192,deathknight,unholy,6,2,4
Zzed,azralon,192,deathknight,unholy,6,2,4
Doomdk,azralon,192,deathknight,unholy,6,2,4
Bogoraptor,emerald-dream,192,deathknight,unholy,6,2,4
Orcazmic,area-52,192,deathknight,unholy,6,2,4
Geliòn,quelthalas,192,deathknight,unholy,6,2,4
Rakelan,area-52,192,deathknight,unholy,6,2,4
Grimreminder,zuljin,192,deathknight,unholy,6,2,4
Otr,wyrmrest-accord,192,deathknight,unholy,6,2,4
Menalise,moon-guard,192,deathknight,unholy,6,2,4
Spaxz,illidan,192,deathknight,unholy,6,2,4
Balstan,tichondrius,192,deathknight,unholy,6,2,4
Corscadden,zuljin,192,deathknight,unholy,6,2,4
Kookx,tichondrius,192,deathknight,unholy,6,2,4
Blooddisease,frostmourne,192,deathknight,unholy,6,2,4
Mesx,tichondrius,192,deathknight,unholy,6,2,4
Dkb,drakthul,192,deathknight,unholy,6,2,4
Gooré,ragnaros,192,deathknight,unholy,6,2,4
Dkgrrick,bleeding-hollow,192,deathknight,unholy,6,2,4
Twocolors,gilneas,192,deathknight,unholy,6,2,4
Mistake,ragnaros,192,deathknight,unholy,6,2,4
Supfam,tichondrius,192,deathknight,unholy,6,2,4
Nightdaddyy,laughing-skull,192,deathknight,unholy,6,2,4
Chandsformer,tichondrius,192,deathknight,unholy,6,2,4
Orbo,elune,192,deathknight,unholy,6,2,4
Questíonable,arthas,192,deathknight,unholy,6,2,4
Teedk,drakthul,192,deathknight,unholy,6,2,4
Cailras,argent-dawn,192,deathknight,unholy,6,2,4
Benweth,dalaran,192,deathknight,unholy,6,2,4
Kangsewooks,tichondrius,192,deathknight,unholy,6,2,4
Boogers,cenarion-circle,192,deathknight,unholy,6,2,4
Daddyspankme,frostmane,192,deathknight,unholy,6,2,4
Dkdkdkdkdk,chromaggus,192,deathknight,unholy,6,2,4
Lubmuscle,illidan,192,deathknight,unholy,6,2,4
Fizzease,illidan,192,deathknight,unholy,6,2,4
Rockadeath,sargeras,192,deathknight,unholy,6,2,4
Lìlith,dreadmaul,192,deathknight,unholy,6,2,4
Mako,garithos,192,deathknight,unholy,6,2,4
Hastë,proudmoore,192,deathknight,unholy,6,2,4
Zilli,blackrock,192,deathknight,unholy,6,2,4
Berodox,malganis,192,deathknight,unholy,6,2,4
Uncoachablex,illidan,192,deathknight,unholy,6,2,4
Astaxstaria,bladefist,192,deathknight,unholy,6,2,4
Afkftwok,illidan,192,deathknight,unholy,6,2,4
Reizü,ragnaros,192,deathknight,unholy,6,2,4
Ralphpootawn,illidan,192,deathknight,unholy,6,2,4
Weedseagull,dragonmaw,192,deathknight,unholy,6,2,4
Saraphdk,area-52,192,deathknight,unholy,6,2,4
Válhállá,ragnaros,192,deathknight,unholy,6,2,4
Tbop,ragnaros,192,deathknight,unholy,6,2,4
Kniightdkk,kelthuzad,192,deathknight,unholy,6,2,4
Sieg,goldrinn,192,deathknight,unholy,6,2,4
Havasu,proudmoore,192,deathknight,unholy,6,2,4
Izanagidk,nemesis,192,deathknight,unholy,6,2,4
Dustknight,sargeras,192,deathknight,unholy,6,2,4
Mortorum,skullcrusher,192,deathknight,unholy,6,2,4
Zacharya,nemesis,192,deathknight,unholy,6,2,4
Kranaz,barthilas,192,deathknight,unholy,6,2,4
Fatmamma,ragnaros,192,deathknight,unholy,6,2,4
Onsslaught,sargeras,192,deathknight,unholy,6,2,4
Bealzabubb,sargeras,192,deathknight,unholy,6,2,4
Kmardk,area-52,192,deathknight,unholy,6,2,4
Vlladimir,kelthuzad,192,deathknight,unholy,6,2,4
Dhaarok,malganis,192,deathknight,unholy,6,2,4
Deathscythè,barthilas,192,deathknight,unholy,6,2,4
Semisoftbody,malganis,192,deathknight,unholy,6,2,4
Mythandour,shandris,192,deathknight,unholy,6,2,4
Tristam,area-52,192,deathknight,unholy,6,2,4
Geth,sargeras,192,deathknight,unholy,6,2,4
Superjessdk,area-52,192,deathknight,unholy,6,2,4
Pandauh,proudmoore,192,deathknight,unholy,6,2,4
Tanskeey,sargeras,192,deathknight,unholy,6,2,4
Wheybolic,quelthalas,192,deathknight,unholy,6,2,4
Ahmisu,tichondrius,192,deathknight,unholy,6,2,4
Lunatick,darkspear,192,deathknight,unholy,6,2,4
Lòthlòria,mannoroth,192,deathknight,unholy,8,2,6
Maliceborn,stormrage,192,deathknight,unholy,12,2,10
Cow,sargeras,192,deathknight,unholy,12,2,10
Mystery,wyrmrest-accord,192,deathknight,unholy,12,2,10
Ðìvíne,illidan,192,deathknight,unholy,12,2,10
Corzmaen,illidan,192,deathknight,unholy,12,2,10
Giraldus,stormrage,192,deathknight,unholy,12,2,10
Víní,azralon,192,deathknight,unholy,12,2,10
Stteve,proudmoore,192,deathknight,unholy,12,2,10
Chachea,kiljaeden,192,deathknight,unholy,12,2,10
Nubsz,zuljin,192,deathknight,unholy,12,2,10
Nightrose,skullcrusher,192,deathknight,unholy,12,2,10
Kzen,skullcrusher,192,deathknight,unholy,12,2,10
Scythê,barthilas,192,deathknight,unholy,12,2,10
Tacofoxlol,tichondrius,192,deathknight,unholy,12,2,10
Rykard,hyjal,192,deathknight,unholy,12,2,10
Zerodk,kelthuzad,192,deathknight,unholy,12,2,10
Ovulating,malganis,192,deathknight,unholy,12,2,10
Dixqt,deathwing,192,deathknight,unholy,12,2,10
Lunaxx,ragnaros,192,deathknight,unholy,12,2,10
Ðreak,azralon,192,deathknight,unholy,12,2,10
Dxn,nemesis,192,deathknight,unholy,18,2,16
Katiaany,quelthalas,192,deathknight,unholy,18,2,16
Larrisey,illidan,191,deathknight,unholy,6,2,4
Mormonpest,illidan,191,deathknight,unholy,6,2,4
Drdeathz,sargeras,191,deathknight,unholy,6,2,4
Kaýlea,azralon,191,deathknight,unholy,6,2,4
Malkiss,kirin-tor,191,deathknight,unholy,6,2,4
Glacíuss,ragnaros,138,deathknight,unholy,9,4,5
Patchi,area-52,138,deathknight,unholy,14,4,10
Plutonyus,stonemaul,128,deathknight,unholy,4,2,2
Caotix,bleeding-hollow,96,deathknight,unholy,3,2,1
Dethklòk,area-52,96,deathknight,unholy,6,1,5
Amö,emerald-dream,96,deathknight,unholy,6,1,5
Alexanderz,quelthalas,96,deathknight,unholy,6,1,5
Drip,whisperwind,96,deathknight,unholy,6,1,5
Zenin,emerald-dream,96,deathknight,unholy,6,1,5
Raicoron,zuljin,96,deathknight,unholy,6,1,5
Zalåel,area-52,96,deathknight,unholy,6,1,5
Calabrass,mannoroth,96,deathknight,unholy,6,1,5
Axiom,nemesis,96,deathknight,unholy,6,1,5
Dheyqu,quelthalas,96,deathknight,unholy,6,1,5
Azryull,perenolde,96,deathknight,unholy,6,1,5
Karmakulaz,wildhammer,96,deathknight,unholy,6,1,5
Stormsick,ragnaros,96,deathknight,unholy,6,1,5
Lazynome,azshara,96,deathknight,unholy,6,1,5
Apeirøn,quelthalas,96,deathknight,unholy,6,1,5
Ziedrich,sargeras,96,deathknight,unholy,6,1,5
Requísition,barthilas,96,deathknight,unholy,6,1,5
Dontbanmepls,zuljin,96,deathknight,unholy,6,1,5
ßlazedkush,kelthuzad,96,deathknight,unholy,6,1,5
Lichhbanne,doomhammer,96,deathknight,unholy,6,1,5
Tìtø,ragnaros,96,deathknight,unholy,6,1,5
Hunwild,emerald-dream,96,deathknight,unholy,6,1,5
Krw,stormrage,96,deathknight,unholy,6,1,5
Snipestrike,area-52,96,deathknight,unholy,6,1,5
Neofrank,drakkari,96,deathknight,unholy,6,1,5
Rgn,deathwing,96,deathknight,unholy,6,1,5
Sandolorian,area-52,96,deathknight,unholy,6,1,5
Terrethess,illidan,96,deathknight,unholy,6,1,5
Report,dathremar,96,deathknight,unholy,6,1,5
Testitickler,gurubashi,96,deathknight,unholy,6,1,5
Abake,illidan,96,deathknight,unholy,6,1,5
Tarone,zuljin,96,deathknight,unholy,6,1,5
Wacktony,illidan,96,deathknight,unholy,6,1,5
Gnargnarr,firetree,96,deathknight,unholy,6,1,5
Percy,thaurissan,96,deathknight,unholy,6,1,5
Dknightor,dalaran,96,deathknight,unholy,6,1,5
Plaguedoctor,thrall,96,deathknight,unholy,6,1,5
Andivh,hydraxis,96,deathknight,unholy,6,1,5
Vicedro,arthas,96,deathknight,unholy,6,1,5
Nachohands,laughing-skull,96,deathknight,unholy,6,1,5
Agrithomqt,frostmourne,96,deathknight,unholy,6,1,5
Heavic,skywall,96,deathknight,unholy,6,1,5
Apocalypsis,uldum,96,deathknight,unholy,6,1,5
Ishamaael,tichondrius,96,deathknight,unholy,6,1,5
Rotfang,elune,96,deathknight,unholy,6,1,5
Diviniums,bleeding-hollow,96,deathknight,unholy,6,1,5
Istery,thrall,96,deathknight,unholy,6,1,5
Grimorra,bleeding-hollow,96,deathknight,unholy,6,1,5
Sever,demon-soul,96,deathknight,unholy,6,1,5
Bealzabbub,sargeras,96,deathknight,unholy,6,1,5
Argy,zuljin,96,deathknight,unholy,6,1,5
Distrolldk,zuljin,96,deathknight,unholy,6,1,5
Dekadart,quelthalas,96,deathknight,unholy,6,1,5
Otarin,tichondrius,96,deathknight,unholy,6,1,5
Alayssia,darkspear,96,deathknight,unholy,6,1,5
Râzôr,korgath,96,deathknight,unholy,6,1,5
Fantabanana,azralon,96,deathknight,unholy,6,1,5
Poefather,tichondrius,96,deathknight,unholy,6,1,5
Veslemes,tichondrius,96,deathknight,unholy,6,1,5
Beedamoniv,tichondrius,96,deathknight,unholy,6,1,5
Hushima,lightbringer,96,deathknight,unholy,6,1,5
Vicesquad,tichondrius,96,deathknight,unholy,6,1,5
Warraxe,draka,96,deathknight,unholy,6,1,5
Bulltille,azralon,96,deathknight,unholy,6,1,5
Iluvbooty,blackrock,96,deathknight,unholy,6,1,5
Moldremover,frostmourne,96,deathknight,unholy,6,1,5
Bein,frostmourne,96,deathknight,unholy,6,1,5
Gröxxigor,azralon,96,deathknight,unholy,6,1,5
Perculës,sargeras,96,deathknight,unholy,7,1,6
Aqs,sargeras,96,deathknight,unholy,9,1,8
Wkxx,tichondrius,96,deathknight,unholy,12,1,11
Dípero,azralon,96,deathknight,unholy,12,1,11
Yorishomi,sargeras,96,deathknight,unholy,12,1,11
Skadattle,emerald-dream,96,deathknight,unholy,12,1,11
Klàssy,stormrage,96,deathknight,unholy,12,1,11
Blowout,barthilas,96,deathknight,unholy,12,1,11
Vinsval,tichondrius,96,deathknight,unholy,12,1,11
Xeroxoxo,khadgar,96,deathknight,unholy,12,1,11
Darnkiller,kelthuzad,96,deathknight,unholy,18,1,17
Funerall,azralon,95,deathknight,unholy,12,1,11
Explorer,kelthuzad,64,deathknight,unholy,4,1,3
Asfaq,frostmourne,63,deathknight,unholy,2,2,0
Deanz,stormrage,63,deathknight,unholy,2,2,0
Weebfiend,moon-guard,63,deathknight,unholy,8,2,6
Ayçe,proudmoore,58,deathknight,unholy,10,3,7
Spleem,stormrage,48,deathknight,unholy,3,1,2
Lördd,moon-guard,42,deathknight,unholy,11,3,8
Harrypottr,darrowmere,42,deathknight,unholy,8,2,6
Ryannë,azshara,42,deathknight,unholy,12,2,10
Doomstrike,azuremyst,16,deathknight,unholy,1,1,0
Pookr,area-52,2214,deathknight,frost,355,180,175
Yoinkzz,illidan,2167,deathknight,frost,113,58,55
Runtasticxz,tichondrius,1949,deathknight,frost,83,40,43
Sylèss,tichondrius,1945,deathknight,frost,120,64,56
Thânätos,nemesis,1935,deathknight,frost,108,54,54
Xelonith,sargeras,1901,deathknight,frost,54,30,24
Ksmc,tichondrius,1893,deathknight,frost,78,40,38
Axiomqt,tichondrius,1889,deathknight,frost,102,52,50
Raiekko,dalaran,1888,deathknight,frost,68,33,35
Duranteh,illidan,1881,deathknight,frost,60,32,28
Mikeycal,stormrage,1873,deathknight,frost,90,47,43
Venvicta,tichondrius,1850,deathknight,frost,44,31,13
Saco,malganis,1845,deathknight,frost,110,62,48
Mikepinkdk,illidan,1839,deathknight,frost,105,60,45
Fastapii,tichondrius,1838,deathknight,frost,47,27,20
Scareth,proudmoore,1823,deathknight,frost,46,27,19
Iccyhottie,stormrage,1823,deathknight,frost,322,170,152
Deaddubya,illidan,1815,deathknight,frost,63,40,23
Gràkk,illidan,1810,deathknight,frost,78,44,34
Gladiaturd,hellscream,1809,deathknight,frost,88,45,43
Dunduner,tichondrius,1803,deathknight,frost,36,23,13
Chillbaynê,the-scryers,1754,deathknight,frost,36,22,14
Grippygarý,illidan,1754,deathknight,frost,54,26,28
Unhappyvelic,tichondrius,1751,deathknight,frost,63,32,31
Fastapi,tichondrius,1737,deathknight,frost,90,41,49
Dkyeico,ragnaros,1735,deathknight,frost,96,46,50
Sober,destromath,1712,deathknight,frost,95,48,47
Devcoil,sargeras,1706,deathknight,frost,54,22,32
Kryptikkyt,blackrock,1694,deathknight,frost,24,18,6
Whytedk,illidan,1685,deathknight,frost,48,21,27
Skullash,stormrage,1676,deathknight,frost,54,33,21
Frosthana,illidan,1671,deathknight,frost,120,58,62
Jykupajr,proudmoore,1669,deathknight,frost,66,29,37
Remanent,tichondrius,1664,deathknight,frost,77,39,38
Crink,sargeras,1658,deathknight,frost,47,24,23
Onsslaught,sargeras,1658,deathknight,frost,48,18,30
Menalise,moon-guard,1650,deathknight,frost,42,22,20
Børeas,quelthalas,1645,deathknight,frost,96,43,53
Gkdm,tichondrius,1643,deathknight,frost,42,21,21
Tzepesci,hyjal,1626,deathknight,frost,58,26,32
Deathboost,stormrage,1617,deathknight,frost,81,35,46
Sinizster,kelthuzad,1615,deathknight,frost,31,18,13
Ebolaxd,area-52,1614,deathknight,frost,42,21,21
Rekktless,aerie-peak,1613,deathknight,frost,72,37,35
Legendåryx,sargeras,1609,deathknight,frost,42,28,14
Darkwraith,illidan,1606,deathknight,frost,72,39,33
Vãl,sargeras,1601,deathknight,frost,296,149,147
Blooddisease,frostmourne,1600,deathknight,frost,59,30,29
Dromidon,darkspear,1590,deathknight,frost,71,39,32
Percy,thaurissan,1589,deathknight,frost,271,131,140
Azhid,tichondrius,1574,deathknight,frost,30,19,11
Gordiie,stormrage,1570,deathknight,frost,98,55,43
Fußuky,quelthalas,1566,deathknight,frost,88,44,44
Worgenracist,tichondrius,1566,deathknight,frost,59,24,35
Zemzil,tichondrius,1557,deathknight,frost,74,34,40
Zenin,emerald-dream,1543,deathknight,frost,62,31,31
Grakth,quelthalas,1527,deathknight,frost,66,37,29
Imfrozone,stormrage,1527,deathknight,frost,65,31,34
Deadspellz,bleeding-hollow,1520,deathknight,frost,48,19,29
Uzgard,zuljin,1517,deathknight,frost,65,38,27
Xhín,bleeding-hollow,1506,deathknight,frost,30,16,14
Iriwa,tichondrius,1498,deathknight,frost,42,16,26
Report,dathremar,1494,deathknight,frost,75,38,37
Rembrandtdk,gorefiend,1481,deathknight,frost,99,52,47
Emanuels,quelthalas,1478,deathknight,frost,116,59,57
Trødz,tichondrius,1468,deathknight,frost,87,42,45
Plaw,kiljaeden,1467,deathknight,frost,29,16,13
Corrpsse,tichondrius,1467,deathknight,frost,129,67,62
Lho,caelestrasz,1465,deathknight,frost,107,54,53
Tangarang,dalaran,1457,deathknight,frost,92,45,47
Algeross,dalaran,1457,deathknight,frost,166,78,88
Jimmyjohnson,illidan,1453,deathknight,frost,107,58,49
Dekanok,korgath,1452,deathknight,frost,30,16,14
Vuldy,blackhand,1448,deathknight,frost,45,25,20
Jazh,tichondrius,1441,deathknight,frost,59,23,36
Freshzzk,azralon,1440,deathknight,frost,118,62,56
Umbramane,tichondrius,1438,deathknight,frost,39,19,20
Gkdl,tichondrius,1437,deathknight,frost,30,15,15
Iskandàr,ragnaros,1435,deathknight,frost,32,16,16
Rylas,destromath,1432,deathknight,frost,120,62,58
Vust,malganis,1427,deathknight,frost,48,25,23
Abrahams,tichondrius,1427,deathknight,frost,100,48,52
Deathzpeckt,tichondrius,1419,deathknight,frost,84,34,50
Icewalløw,darkspear,1417,deathknight,frost,24,15,9
Ðerion,stormrage,1414,deathknight,frost,140,62,78
Sandooñ,tichondrius,1402,deathknight,frost,150,75,75
Sécret,tichondrius,1394,deathknight,frost,36,21,15
Eldavò,quelthalas,1393,deathknight,frost,60,25,35
Biggil,tichondrius,1389,deathknight,frost,32,20,12
Dkbunny,thaurissan,1388,deathknight,frost,42,15,27
Shubertx,tichondrius,1385,deathknight,frost,48,21,27
Khalid,azgalor,1376,deathknight,frost,54,23,31
Clongeus,tichondrius,1374,deathknight,frost,54,25,29
Sinyay,tichondrius,1370,deathknight,frost,82,48,34
Theronguard,area-52,1370,deathknight,frost,60,28,32
Nevermor,malganis,1362,deathknight,frost,104,53,51
Ellipsoro,onyxia,1362,deathknight,frost,78,35,43
Gwab,stormrage,1354,deathknight,frost,48,20,28
Janzano,deathwing,1350,deathknight,frost,32,18,14
Eloton,daggerspine,1350,deathknight,frost,35,18,17
Thetalis,moon-guard,1346,deathknight,frost,78,38,40
Tekc,nemesis,1345,deathknight,frost,168,83,85
Clapdat,malganis,1335,deathknight,frost,114,56,58
Bizdale,frostmourne,1330,deathknight,frost,24,14,10
Ântipaladin,arthas,1328,deathknight,frost,36,19,17
Panthir,darkspear,1325,deathknight,frost,42,16,26
Kruspy,area-52,1324,deathknight,frost,53,27,26
Dontbanmepls,zuljin,1318,deathknight,frost,30,14,16
Demønnation,illidan,1312,deathknight,frost,44,21,23
Himanshu,emerald-dream,1310,deathknight,frost,69,33,36
Alexeous,wyrmrest-accord,1304,deathknight,frost,127,57,70
Bridenbrad,quelthalas,1299,deathknight,frost,27,17,10
Iceice,emerald-dream,1293,deathknight,frost,114,53,61
Lichborn,azralon,1293,deathknight,frost,71,30,41
Bossk,emerald-dream,1283,deathknight,frost,36,14,22
Spoon,sargeras,1282,deathknight,frost,118,60,58
Friggintough,tichondrius,1281,deathknight,frost,74,35,39
Sporkdk,illidan,1277,deathknight,frost,53,20,33
Estali,kelthuzad,1272,deathknight,frost,110,51,59
Abake,illidan,1267,deathknight,frost,62,30,32
Parksy,kelthuzad,1264,deathknight,frost,53,26,27
Alexanderz,quelthalas,1264,deathknight,frost,36,15,21
Lókhä,thrall,1262,deathknight,frost,30,14,16
Darketvam,illidan,1261,deathknight,frost,46,28,18
Mexe,ragnaros,1242,deathknight,frost,56,28,28
Bâttalion,illidan,1237,deathknight,frost,30,13,17
Rayden,frostmourne,1235,deathknight,frost,24,13,11
Yödä,barthilas,1235,deathknight,frost,36,14,22
Jackofblades,veknilash,1225,deathknight,frost,84,42,42
Ðëthbringër,jubeithos,1220,deathknight,frost,30,13,17
Soulfang,nemesis,1218,deathknight,frost,66,34,32
Darkdeviliv,darkspear,1214,deathknight,frost,59,29,30
Flins,nemesis,1212,deathknight,frost,487,244,243
Verhangnis,azjolnerub,1210,deathknight,frost,31,16,15
Zeró,wyrmrest-accord,1204,deathknight,frost,30,13,17
Seeyoudiebr,gallywix,1190,deathknight,frost,42,17,25
Zefdk,illidan,1186,deathknight,frost,48,27,21
Barrodir,tichondrius,1183,deathknight,frost,81,40,41
Lospollos,tichondrius,1181,deathknight,frost,60,23,37
Úndead,barthilas,1180,deathknight,frost,24,14,10
Darfik,sargeras,1177,deathknight,frost,120,65,55
Nocreed,illidan,1175,deathknight,frost,54,18,36
Dkptador,azralon,1174,deathknight,frost,166,81,85
Darkreígn,tichondrius,1171,deathknight,frost,71,33,38
Renathâ,ragnaros,1167,deathknight,frost,42,15,27
Jordankg,tanaris,1165,deathknight,frost,41,16,25
Lîch,azralon,1157,deathknight,frost,63,24,39
Tìtø,ragnaros,1151,deathknight,frost,24,12,12
Beliath,crushridge,1150,deathknight,frost,29,12,17
Lxsol,illidan,1149,deathknight,frost,18,12,6
Kodokuna,bleeding-hollow,1149,deathknight,frost,24,12,12
Dkapocalypse,azralon,1149,deathknight,frost,38,13,25
Tambaknight,nemesis,1146,deathknight,frost,44,15,29
Laumuelden,ragnaros,1143,deathknight,frost,48,17,31
Janco,runetotem,1141,deathknight,frost,24,12,12
Frostunholy,tichondrius,1140,deathknight,frost,24,12,12
Gripnpull,tichondrius,1137,deathknight,frost,24,12,12
Carecaa,azralon,1135,deathknight,frost,48,19,29
Hiki,ragnaros,1134,deathknight,frost,30,12,18
Kace,amanthul,1130,deathknight,frost,66,34,32
Tarknok,moon-guard,1123,deathknight,frost,24,12,12
Metaphysicsx,amanthul,1119,deathknight,frost,54,29,25
Achilleo,quelthalas,1115,deathknight,frost,24,12,12
Rohdey,madoran,1114,deathknight,frost,129,54,75
Pembadk,tichondrius,1110,deathknight,frost,33,14,19
Panddemonio,gallywix,1107,deathknight,frost,30,12,18
Jawyn,area-52,1096,deathknight,frost,30,12,18
Ârtas,uldum,1090,deathknight,frost,39,16,23
Moonnwater,frostmourne,1087,deathknight,frost,84,43,41
Dantte,stormscale,1080,deathknight,frost,59,31,28
Garryxz,quelthalas,1077,deathknight,frost,22,12,10
Ryugetzu,drakkari,1074,deathknight,frost,36,12,24
Griswold,windrunner,1069,deathknight,frost,34,18,16
Darkdevilvii,tichondrius,1069,deathknight,frost,66,33,33
Mawvac,quelthalas,1069,deathknight,frost,72,33,39
Wap,bloodhoof,1056,deathknight,frost,18,11,7
Zephyx,lightbringer,1056,deathknight,frost,18,11,7
Toxismall,zuljin,1056,deathknight,frost,24,11,13
Vigasick,azralon,1056,deathknight,frost,24,11,13
Ariacy,sargeras,1056,deathknight,frost,24,11,13
Mörrigham,stormrage,1055,deathknight,frost,18,11,7
Puppykisses,perenolde,1055,deathknight,frost,24,11,13
Bikfrostyboi,barthilas,1053,deathknight,frost,18,11,7
Jhonnsnow,frostmourne,1051,deathknight,frost,24,11,13
Ruggair,proudmoore,1051,deathknight,frost,24,11,13
Nalz,drakkari,1050,deathknight,frost,30,11,19
Dregdar,emerald-dream,1049,deathknight,frost,18,11,7
Ixiefin,sargeras,1048,deathknight,frost,18,13,5
Tightann,stormrage,1047,deathknight,frost,24,11,13
Malovv,nemesis,1042,deathknight,frost,18,12,6
Roarbane,muradin,1030,deathknight,frost,54,29,25
Sephirott,boulderfist,1029,deathknight,frost,41,20,21
Janoh,the-scryers,1021,deathknight,frost,44,19,25
Vanyor,wyrmrest-accord,1009,deathknight,frost,62,21,41
Zarathraz,ragnaros,1004,deathknight,frost,23,11,12
Eliagianluca,caelestrasz,1003,deathknight,frost,71,32,39
Icedmilk,zuluhed,996,deathknight,frost,30,16,14
ßlazedkush,kelthuzad,989,deathknight,frost,36,18,18
Tarone,zuljin,981,deathknight,frost,27,14,13
Vorlakesh,boulderfist,979,deathknight,frost,22,11,11
Sakaarr,bleeding-hollow,974,deathknight,frost,48,21,27
Khorvusfel,frostmourne,972,deathknight,frost,22,11,11
Whoopsies,sargeras,968,deathknight,frost,66,27,39
Skittsdk,thrall,966,deathknight,frost,24,12,12
Ciputra,blood-furnace,962,deathknight,frost,53,27,26
Stormitt,illidan,959,deathknight,frost,24,10,14
Tokyotimxx,malganis,958,deathknight,frost,18,10,8
Thetissuebox,emerald-dream,958,deathknight,frost,18,10,8
Frosqt,queldorei,957,deathknight,frost,12,10,2
Toothstick,stormrage,957,deathknight,frost,18,10,8
Amarlana,mannoroth,957,deathknight,frost,18,10,8
Serwestley,stormrage,956,deathknight,frost,18,10,8
Necrósy,azralon,955,deathknight,frost,18,10,8
Axylus,kelthuzad,953,deathknight,frost,18,10,8
Bullbanger,runetotem,953,deathknight,frost,42,22,20
Raegywn,blood-furnace,952,deathknight,frost,24,10,14
Larrisey,illidan,940,deathknight,frost,33,18,15
Kraige,tichondrius,933,deathknight,frost,30,10,20
Aztecka,illidan,915,deathknight,frost,36,18,18
Grimmr,tichondrius,912,deathknight,frost,23,10,13
Ðreak,azralon,907,deathknight,frost,23,10,13
Fokit,barthilas,897,deathknight,frost,58,28,30
Sandolorian,area-52,892,deathknight,frost,24,10,14
Kallugrax,kelthuzad,885,deathknight,frost,42,16,26
Onsllaught,stormrage,864,deathknight,frost,12,9,3
Lokitabeso,ragnaros,864,deathknight,frost,12,9,3
Wahpow,frostwolf,864,deathknight,frost,12,9,3
Lazenca,malganis,863,deathknight,frost,18,9,9
Garbage,sargeras,863,deathknight,frost,18,9,9
Zarakas,sargeras,863,deathknight,frost,24,9,15
Kekkijutsu,bleeding-hollow,862,deathknight,frost,12,9,3
Zivz,borean-tundra,862,deathknight,frost,12,9,3
Thesseo,quelthalas,862,deathknight,frost,18,9,9
Surcäfauces,ragnaros,862,deathknight,frost,21,10,11
Chicnchsteak,tichondrius,862,deathknight,frost,30,9,21
Jasmíne,vashj,861,deathknight,frost,12,9,3
Urieen,gorefiend,861,deathknight,frost,18,9,9
Sllice,aegwynn,858,deathknight,frost,24,9,15
Neowolf,azgalor,857,deathknight,frost,53,16,37
Helguarde,dragonblight,853,deathknight,frost,30,13,17
Madorderog,stormrage,846,deathknight,frost,40,18,22
Frrost,earthen-ring,845,deathknight,frost,25,10,15
Wartodeath,illidan,843,deathknight,frost,18,9,9
Dreekon,bleeding-hollow,842,deathknight,frost,22,12,10
Krowl,nagrand,834,deathknight,frost,18,9,9
Loverianed,aerie-peak,832,deathknight,frost,182,79,103
Pizzathehutt,nordrassil,832,deathknight,frost,24,9,15
Dèadpool,blackhand,828,deathknight,frost,18,9,9
Uncfester,onyxia,823,deathknight,frost,18,9,9
Ztrain,proudmoore,814,deathknight,frost,17,9,8
Ron,spirestone,811,deathknight,frost,17,9,8
Neofrank,drakkari,802,deathknight,frost,60,16,44
Xslaught,maiev,798,deathknight,frost,22,10,12
Incanis,moon-guard,782,deathknight,frost,19,9,10
Lokitaßesos,ragnaros,768,deathknight,frost,12,8,4
Lokítabesos,ragnaros,768,deathknight,frost,12,8,4
Shobiz,barthilas,768,deathknight,frost,12,8,4
Havince,drenden,768,deathknight,frost,12,8,4
Skidmarks,whisperwind,768,deathknight,frost,12,8,4
Denale,darkspear,768,deathknight,frost,18,8,10
Satisie,eitrigg,767,deathknight,frost,18,8,10
Kerigann,moon-guard,766,deathknight,frost,12,8,4
Acg,tichondrius,766,deathknight,frost,12,8,4
Artourias,wyrmrest-accord,766,deathknight,frost,12,8,4
Freemoney,wyrmrest-accord,766,deathknight,frost,12,8,4
Gypo,scilla,766,deathknight,frost,12,8,4
Deweybrown,smolderthorn,765,deathknight,frost,12,8,4
Dhrogar,moon-guard,762,deathknight,frost,12,8,4
Amauqsun,bleeding-hollow,762,deathknight,frost,18,8,10
Dyingwolf,ragnaros,761,deathknight,frost,18,8,10
Jyantdeck,area-52,760,deathknight,frost,13,8,5
Zarolden,tichondrius,759,deathknight,frost,24,8,16
Ryannë,azshara,759,deathknight,frost,37,8,29
Twicecursed,kelthuzad,758,deathknight,frost,18,8,10
Fexon,queldorei,758,deathknight,frost,33,10,23
Nagaizao,nemesis,757,deathknight,frost,18,8,10
Hansmclroy,trollbane,738,deathknight,frost,24,8,16
Monglord,arthas,733,deathknight,frost,27,9,18
Russkivolk,frostmourne,688,deathknight,frost,19,8,11
Dumbledore,deathwing,672,deathknight,frost,12,7,5
Brutos,thrall,672,deathknight,frost,12,7,5
Frøzèñintïmê,tichondrius,672,deathknight,frost,12,7,5
Footodor,bleeding-hollow,672,deathknight,frost,12,7,5
Bigfatdkk,illidan,672,deathknight,frost,12,7,5
Insanity,boulderfist,672,deathknight,frost,12,7,5
Anexdk,korgath,672,deathknight,frost,18,7,11
Chillpills,stormrage,672,deathknight,frost,18,7,11
Bersolgens,illidan,671,deathknight,frost,12,7,5
Pandauh,proudmoore,671,deathknight,frost,18,7,11
Mordekeiser,wyrmrest-accord,671,deathknight,frost,18,7,11
Khutuzun,tichondrius,671,deathknight,frost,18,7,11
Unintended,barthilas,671,deathknight,frost,24,7,17
Unholycube,zuljin,671,deathknight,frost,30,7,23
Thwap,sargeras,670,deathknight,frost,18,7,11
Zulomón,area-52,670,deathknight,frost,18,7,11
Fåîrÿdûst,skullcrusher,670,deathknight,frost,20,7,13
Elwoodblooz,stormrage,669,deathknight,frost,15,8,7
Alzenth,quelthalas,669,deathknight,frost,15,8,7
Winterstone,moon-guard,669,deathknight,frost,18,7,11
Rottenqunt,tichondrius,668,deathknight,frost,12,7,5
Helvegum,tichondrius,668,deathknight,frost,12,7,5
Caravante,azralon,668,deathknight,frost,18,7,11
Bigdkk,thaurissan,666,deathknight,frost,27,10,17
Cryptgore,moon-guard,665,deathknight,frost,18,7,11
Varrine,hyjal,659,deathknight,frost,12,7,5
Iiedown,stormrage,623,deathknight,frost,11,7,4
Dreadmoore,wyrmrest-accord,607,deathknight,frost,16,7,9
Lindrayëda,moon-guard,581,deathknight,frost,13,7,6
Dementrius,zuljin,576,deathknight,frost,12,6,6
Xangrim,emerald-dream,576,deathknight,frost,12,6,6
Rotfang,proudmoore,576,deathknight,frost,12,6,6
Otarin,tichondrius,576,deathknight,frost,12,6,6
Soulbone,wyrmrest-accord,576,deathknight,frost,12,6,6
Sparklekitty,illidan,576,deathknight,frost,12,6,6
Riglros,tichondrius,576,deathknight,frost,12,6,6
Darkxavros,stormrage,576,deathknight,frost,12,6,6
Arnagal,drakkari,576,deathknight,frost,12,6,6
Piratehookah,sargeras,576,deathknight,frost,12,6,6
Aldrey,bonechewer,576,deathknight,frost,12,6,6
Billclintonn,sargeras,576,deathknight,frost,12,6,6
Ironslaught,moon-guard,576,deathknight,frost,12,6,6
Rennoc,emerald-dream,576,deathknight,frost,12,6,6
Hunrune,emerald-dream,576,deathknight,frost,12,6,6
Dreadlight,moon-guard,576,deathknight,frost,12,6,6
Cozzasad,barthilas,576,deathknight,frost,12,6,6
Xhoul,sargeras,576,deathknight,frost,18,6,12
Crimsondk,stormrage,576,deathknight,frost,18,6,12
Chilivibes,boulderfist,576,deathknight,frost,18,6,12
Neaz,moon-guard,576,deathknight,frost,18,6,12
Whosurbobby,area-52,576,deathknight,frost,18,6,12
Dairboi,sargeras,576,deathknight,frost,18,6,12
Siouxsiie,nemesis,575,deathknight,frost,12,6,6
Astanddra,wyrmrest-accord,575,deathknight,frost,12,6,6
Flûffÿ,thrall,575,deathknight,frost,12,6,6
Tooe,darrowmere,575,deathknight,frost,12,6,6
Zamerz,malganis,575,deathknight,frost,12,6,6
Davenn,stormrage,575,deathknight,frost,12,6,6
Enobrah,proudmoore,575,deathknight,frost,24,6,18
Bootyclapztv,tichondrius,574,deathknight,frost,12,6,6
Nezareth,sargeras,574,deathknight,frost,12,6,6
Bloodbanne,darkspear,573,deathknight,frost,12,6,6
Ikaris,wildhammer,569,deathknight,frost,12,6,6
Cailras,argent-dawn,566,deathknight,frost,12,6,6
Ergoth,darkspear,564,deathknight,frost,30,6,24
Busynas,thrall,559,deathknight,frost,11,6,5
Vayk,bleeding-hollow,544,deathknight,frost,10,6,4
Werebuddy,lightnings-blade,528,deathknight,frost,15,6,9
Válhállá,ragnaros,523,deathknight,frost,17,6,11
Bellum,moon-guard,511,deathknight,frost,20,6,14
Kookx,tichondrius,489,deathknight,frost,13,6,7
Vett,antonidas,480,deathknight,frost,6,5,1
Necrôtic,area-52,480,deathknight,frost,6,5,1
Lokitaßeso,ragnaros,480,deathknight,frost,6,5,1
Sathanazz,ragnaros,480,deathknight,frost,6,5,1
Hyondeath,tichondrius,480,deathknight,frost,12,5,7
Rumblepuppy,hyjal,480,deathknight,frost,12,5,7
Deadbeards,zuluhed,480,deathknight,frost,12,5,7
Flashofdark,proudmoore,480,deathknight,frost,12,5,7
Satalas,tichondrius,480,deathknight,frost,12,5,7
Stevegates,tichondrius,480,deathknight,frost,12,5,7
Dknightkofwa,tichondrius,480,deathknight,frost,12,5,7
Bluex,silvermoon,480,deathknight,frost,12,5,7
Subparatbest,chogall,480,deathknight,frost,12,5,7
Biglimb,area-52,480,deathknight,frost,12,5,7
Sinistarz,area-52,480,deathknight,frost,12,5,7
Withered,area-52,480,deathknight,frost,12,5,7
Martinnash,emerald-dream,480,deathknight,frost,12,5,7
Deathrey,kargath,480,deathknight,frost,12,5,7
Frozenhawk,lothar,480,deathknight,frost,12,5,7
Drzièglér,tichondrius,480,deathknight,frost,18,5,13
Kelistros,moon-guard,480,deathknight,frost,18,5,13
Saighast,illidan,480,deathknight,frost,18,5,13
Bëlzëbü,stormrage,479,deathknight,frost,6,5,1
Bulltille,azralon,479,deathknight,frost,6,5,1
Moovement,illidan,479,deathknight,frost,6,5,1
Biotics,barthilas,479,deathknight,frost,12,5,7
Nalec,tichondrius,479,deathknight,frost,12,5,7
Jessaminne,nordrassil,479,deathknight,frost,24,5,19
Adjudicated,darkspear,477,deathknight,frost,12,5,7
Ðecimate,muradin,476,deathknight,frost,12,5,7
Rogoroth,stormrage,475,deathknight,frost,12,5,7
Killa,maiev,475,deathknight,frost,12,5,7
Frostyclaws,blackrock,447,deathknight,frost,17,5,12
Greeasy,bleeding-hollow,446,deathknight,frost,17,5,12
Bluemanikin,area-52,416,deathknight,frost,10,5,5
Drizzth,ragnaros,413,deathknight,frost,8,5,3
Khaíne,wyrmrest-accord,400,deathknight,frost,16,5,11
Dìs,frostmourne,399,deathknight,frost,5,5,0
Tontan,cairne,384,deathknight,frost,6,4,2
Gurrikhog,proudmoore,384,deathknight,frost,6,4,2
Sauranak,bleeding-hollow,384,deathknight,frost,6,4,2
Well,archimonde,384,deathknight,frost,6,4,2
Ärlo,frostmourne,384,deathknight,frost,6,4,2
Khazgrim,chogall,384,deathknight,frost,6,4,2
Orbo,elune,384,deathknight,frost,6,4,2
Cesarz,tichondrius,384,deathknight,frost,6,4,2
Aldebamuu,ragnaros,384,deathknight,frost,6,4,2
Beanboyx,tichondrius,384,deathknight,frost,6,4,2
Bigdooks,area-52,384,deathknight,frost,6,4,2
Tanjus,kelthuzad,384,deathknight,frost,6,4,2
Laxatives,tichondrius,384,deathknight,frost,6,4,2
Anatøly,ragnaros,384,deathknight,frost,6,4,2
Xnightmàre,wildhammer,384,deathknight,frost,6,4,2
Nabreus,ragnaros,384,deathknight,frost,6,4,2
Teakillah,zuljin,384,deathknight,frost,6,4,2
Riseup,area-52,384,deathknight,frost,6,4,2
Pyradine,amanthul,384,deathknight,frost,12,4,8
Thikness,tichondrius,384,deathknight,frost,12,4,8
Almostdead,proudmoore,384,deathknight,frost,12,4,8
Hooterzqt,tichondrius,384,deathknight,frost,12,4,8
Lichhbanne,doomhammer,384,deathknight,frost,12,4,8
Shmacmiller,stormrage,384,deathknight,frost,12,4,8
Deathrowe,blackhand,384,deathknight,frost,12,4,8
Noplug,area-52,384,deathknight,frost,12,4,8
Aradorn,azralon,384,deathknight,frost,12,4,8
Silanvia,wyrmrest-accord,384,deathknight,frost,12,4,8
Maxymillion,thrall,384,deathknight,frost,12,4,8
Zaddix,whisperwind,384,deathknight,frost,12,4,8
Bellybuster,malganis,384,deathknight,frost,12,4,8
Exiledknight,area-52,384,deathknight,frost,12,4,8
Nefarion,nathrezim,384,deathknight,frost,15,4,11
Ðaz,zuljin,384,deathknight,frost,18,4,14
Gerardkyx,drakkari,384,deathknight,frost,18,4,14
Wãrson,bleeding-hollow,383,deathknight,frost,6,4,2
Shinici,kelthuzad,383,deathknight,frost,9,5,4
Vithael,stormrage,383,deathknight,frost,12,4,8
Getmad,anvilmar,383,deathknight,frost,12,4,8
Adoran,turalyon,383,deathknight,frost,12,4,8
Sindragos,stormrage,382,deathknight,frost,12,4,8
Shioms,quelthalas,379,deathknight,frost,12,4,8
Deathvortex,nemesis,379,deathknight,frost,12,4,8
Brumaks,quelthalas,367,deathknight,frost,11,4,7
Oilasslover,illidan,361,deathknight,frost,15,6,9
Enjal,stormrage,352,deathknight,frost,10,4,6
Lokitakisses,ragnaros,351,deathknight,frost,11,4,7
Eltillible,ragnaros,336,deathknight,frost,15,4,11
Xaldeth,moon-guard,319,deathknight,frost,14,4,10
Bunghoolio,nerzhul,315,deathknight,frost,16,4,12
Gunga,skullcrusher,288,deathknight,frost,6,3,3
Störmrünner,kelthuzad,288,deathknight,frost,6,3,3
Tofurious,barthilas,288,deathknight,frost,6,3,3
Noobender,burning-blade,288,deathknight,frost,6,3,3
ßlacklìsted,kelthuzad,288,deathknight,frost,6,3,3
Dalka,laughing-skull,288,deathknight,frost,6,3,3
Trant,tichondrius,288,deathknight,frost,6,3,3
Clizforden,kelthuzad,288,deathknight,frost,6,3,3
Laboön,stormrage,288,deathknight,frost,6,3,3
Sorenbjerg,zuljin,288,deathknight,frost,6,3,3
Ghouldruis,barthilas,288,deathknight,frost,6,3,3
Zügzug,chogall,288,deathknight,frost,6,3,3
Supermane,jubeithos,288,deathknight,frost,6,3,3
Zygon,thrall,288,deathknight,frost,6,3,3
Yamanji,wyrmrest-accord,288,deathknight,frost,6,3,3
Gorsz,tichondrius,288,deathknight,frost,6,3,3
Jughéad,thrall,288,deathknight,frost,6,3,3
Drpepp,bleeding-hollow,288,deathknight,frost,6,3,3
Frostybones,guldan,288,deathknight,frost,6,3,3
Plaugedone,lightbringer,288,deathknight,frost,6,3,3
Egirlgripper,area-52,288,deathknight,frost,6,3,3
Atheion,the-underbog,288,deathknight,frost,6,3,3
Cgg,tichondrius,288,deathknight,frost,6,3,3
Alujin,arthas,288,deathknight,frost,6,3,3
Víní,azralon,288,deathknight,frost,6,3,3
Avantee,moon-guard,288,deathknight,frost,6,3,3
Millariel,stormrage,288,deathknight,frost,6,3,3
Démise,malganis,288,deathknight,frost,6,3,3
Iröñ,baelgun,288,deathknight,frost,6,3,3
Saraphdk,area-52,288,deathknight,frost,6,3,3
Kalevesicant,nesingwary,288,deathknight,frost,6,3,3
Doomdk,azralon,288,deathknight,frost,6,3,3
Infadelias,stormrage,288,deathknight,frost,6,3,3
Malthis,antonidas,288,deathknight,frost,6,3,3
Yungdooks,area-52,288,deathknight,frost,6,3,3
Fearfull,hyjal,288,deathknight,frost,10,4,6
Dkpeter,quelthalas,288,deathknight,frost,12,3,9
Deathscyythe,illidan,288,deathknight,frost,12,3,9
Flarkness,area-52,288,deathknight,frost,12,3,9
Nenó,illidan,288,deathknight,frost,12,3,9
Janus,illidan,288,deathknight,frost,12,3,9
Toxicant,zuljin,288,deathknight,frost,12,3,9
Freyjani,moon-guard,288,deathknight,frost,12,3,9
Biukanon,ragnaros,288,deathknight,frost,12,3,9
Paíín,illidan,288,deathknight,frost,12,3,9
Bloodmourne,barthilas,288,deathknight,frost,12,3,9
Kendøll,sargeras,288,deathknight,frost,12,3,9
Moyjô,aggramar,288,deathknight,frost,15,3,12
Kalahari,perenolde,288,deathknight,frost,18,3,15
Thebigknight,deathwing,287,deathknight,frost,6,3,3
Letum,lightbringer,287,deathknight,frost,6,3,3
Sinfulvoid,darkspear,287,deathknight,frost,6,3,3
Páthøgen,ravencrest,287,deathknight,frost,12,3,9
Dragoroth,zuluhed,286,deathknight,frost,6,3,3
Gnomey,area-52,255,deathknight,frost,8,4,4
Crukashongal,zuljin,240,deathknight,frost,9,4,5
Icycrazy,azralon,239,deathknight,frost,5,3,2
Hamze,stormrage,239,deathknight,frost,5,3,2
Unwantedgrab,sargeras,239,deathknight,frost,5,3,2
Rakutengirls,tichondrius,239,deathknight,frost,5,3,2
Onìì,aegwynn,234,deathknight,frost,10,5,5
Bbcobliterat,proudmoore,234,deathknight,frost,22,4,18
Dkswaag,malganis,192,deathknight,frost,6,2,4
Lichkong,dalaran,192,deathknight,frost,6,2,4
Ndz,quelthalas,192,deathknight,frost,6,2,4
Dahaaka,malganis,192,deathknight,frost,6,2,4
Arthureon,kelthuzad,192,deathknight,frost,6,2,4
Khørne,area-52,192,deathknight,frost,6,2,4
Deadlyforce,sargeras,192,deathknight,frost,6,2,4
Sayga,ragnaros,192,deathknight,frost,6,2,4
Hiverssalt,stormrage,192,deathknight,frost,6,2,4
Unholyreap,arthas,192,deathknight,frost,6,2,4
Froxe,sargeras,192,deathknight,frost,6,2,4
Chrønnøz,nemesis,192,deathknight,frost,6,2,4
Oldskul,sargeras,192,deathknight,frost,6,2,4
Envisage,kelthuzad,192,deathknight,frost,6,2,4
Alderollar,stormrage,192,deathknight,frost,6,2,4
Deathbringèr,tichondrius,192,deathknight,frost,6,2,4
Lazynome,azshara,192,deathknight,frost,6,2,4
Azibar,moon-guard,192,deathknight,frost,6,2,4
Frozenjuice,sargeras,192,deathknight,frost,6,2,4
Demise,stormrage,192,deathknight,frost,6,2,4
Crakdos,illidan,192,deathknight,frost,6,2,4
Inarius,caelestrasz,192,deathknight,frost,6,2,4
Nethaar,tichondrius,192,deathknight,frost,6,2,4
Rotfang,elune,192,deathknight,frost,6,2,4
Noik,azralon,192,deathknight,frost,6,2,4
Dego,tichondrius,192,deathknight,frost,6,2,4
Martufe,sargeras,192,deathknight,frost,6,2,4
Rulord,wyrmrest-accord,192,deathknight,frost,6,2,4
Oreodeath,sargeras,192,deathknight,frost,6,2,4
Yourunigrip,tichondrius,192,deathknight,frost,6,2,4
Fraýja,tichondrius,192,deathknight,frost,6,2,4
Edek,frostmourne,192,deathknight,frost,6,2,4
Hunwild,emerald-dream,192,deathknight,frost,6,2,4
Nebuchadnezz,darkspear,192,deathknight,frost,6,2,4
Hadeon,boulderfist,192,deathknight,frost,6,2,4
Kreyun,bleeding-hollow,192,deathknight,frost,6,2,4
Zëb,sargeras,192,deathknight,frost,6,2,4
Superlast,blackrock,192,deathknight,frost,6,2,4
Pofokut,bleeding-hollow,192,deathknight,frost,6,2,4
Soutennizase,azralon,192,deathknight,frost,6,2,4
Bonusman,sargeras,192,deathknight,frost,6,2,4
Sayâ,frostmane,192,deathknight,frost,6,2,4
Serberiss,barthilas,192,deathknight,frost,12,2,10
Kóssak,black-dragonflight,192,deathknight,frost,12,2,10
Appledog,ragnaros,192,deathknight,frost,12,2,10
Melyrc,quelthalas,192,deathknight,frost,12,2,10
Shadar,muradin,192,deathknight,frost,12,2,10
Lillylilly,bleeding-hollow,192,deathknight,frost,12,2,10
Selasia,malygos,192,deathknight,frost,12,2,10
Záiiko,quelthalas,192,deathknight,frost,12,2,10
Evangelina,antonidas,192,deathknight,frost,12,2,10
Xepherto,ragnaros,191,deathknight,frost,6,2,4
Deathmike,bonechewer,191,deathknight,frost,6,2,4
Edhral,ragnaros,191,deathknight,frost,6,2,4
Sübzerö,quelthalas,191,deathknight,frost,6,2,4
Ulyssess,jubeithos,191,deathknight,frost,6,2,4
Akmy,illidan,175,deathknight,frost,11,2,9
Nickolas,dalvengyr,159,deathknight,frost,5,2,3
Ryudeus,lothar,159,deathknight,frost,11,2,9
Telrenaur,proudmoore,96,deathknight,frost,3,2,1
Littlenisman,ragnaros,96,deathknight,frost,6,1,5
Icejagan,stormrage,96,deathknight,frost,6,1,5
Grimmosh,daggerspine,96,deathknight,frost,6,1,5
Lücìfër,illidan,96,deathknight,frost,6,1,5
Ophin,silver-hand,96,deathknight,frost,6,1,5
Siphilusxo,dalaran,96,deathknight,frost,6,1,5
Puppykiss,perenolde,96,deathknight,frost,6,1,5
Kakaih,azralon,96,deathknight,frost,6,1,5
Frostpanda,dalaran,96,deathknight,frost,6,1,5
Druath,proudmoore,96,deathknight,frost,6,1,5
Mako,garithos,96,deathknight,frost,6,1,5
Kireek,stormrage,96,deathknight,frost,6,1,5
Heboriç,stormrage,96,deathknight,frost,6,1,5
Inertìa,malganis,96,deathknight,frost,6,1,5
Ricedisease,emerald-dream,96,deathknight,frost,6,1,5
Denkot,stormrage,96,deathknight,frost,6,1,5
Necrotic,greymane,96,deathknight,frost,6,1,5
Hadianton,stormrage,96,deathknight,frost,6,1,5
Grimorra,bleeding-hollow,96,deathknight,frost,6,1,5
Krargosh,quelthalas,96,deathknight,frost,6,1,5
Gooré,ragnaros,96,deathknight,frost,6,1,5
Varraeda,stonemaul,96,deathknight,frost,6,1,5
Teksurugi,korgath,96,deathknight,frost,6,1,5
Vrolock,quelthalas,96,deathknight,frost,6,1,5
Grayfoxx,twisting-nether,96,deathknight,frost,6,1,5
Guffles,tichondrius,96,deathknight,frost,6,1,5
Xakri,kelthuzad,96,deathknight,frost,6,1,5
Cellebrok,bleeding-hollow,96,deathknight,frost,6,1,5
Bingoez,frostmourne,96,deathknight,frost,6,1,5
Icecreamlife,chogall,96,deathknight,frost,6,1,5
Koltíra,azralon,96,deathknight,frost,6,1,5
Bubblesdk,whisperwind,96,deathknight,frost,6,1,5
Davyjonescx,moon-guard,96,deathknight,frost,6,1,5
Dotted,tichondrius,96,deathknight,frost,6,1,5
Einherjiar,tichondrius,96,deathknight,frost,6,1,5
Owenjak,moon-guard,96,deathknight,frost,6,1,5
Mephostophel,sargeras,96,deathknight,frost,6,1,5
Cruzx,tichondrius,96,deathknight,frost,6,1,5
Ann,spirestone,96,deathknight,frost,6,1,5
Sindragosa,dragonmaw,96,deathknight,frost,6,1,5
Skadattle,emerald-dream,96,deathknight,frost,12,1,11
Xninjakiller,korgath,95,deathknight,frost,12,1,11
Magipierrot,ragnaros,64,deathknight,frost,4,1,3
Agasuko,ghostlands,48,deathknight,frost,3,1,2
Frøstbeard,hyjal,42,deathknight,frost,9,2,7
Twindleroot,aggramar,31,deathknight,frost,2,1,1
Philyaliora,moon-guard,31,deathknight,frost,2,1,1
Schwaffles,stormrage,31,deathknight,frost,2,1,1
Sharnathos,stormrage,16,deathknight,frost,1,1,0
Jerric,skullcrusher,16,deathknight,frost,7,1,6
Xiaosu,tichondrius,2270,demonhunter,havoc,710,356,354
Mvqdh,illidan,2212,demonhunter,havoc,77,46,31
Demoncouch,malganis,2191,demonhunter,havoc,102,54,48
Ehtend,malganis,2136,demonhunter,havoc,354,177,177
Seorae,tichondrius,2126,demonhunter,havoc,84,45,39
Lighost,tichondrius,2117,demonhunter,havoc,382,192,190
Sadgirlx,area-52,2114,demonhunter,havoc,96,48,48
Zetara,malganis,2112,demonhunter,havoc,137,78,59
Ehtend,sargeras,2106,demonhunter,havoc,78,42,36
Yaboiswift,stormrage,2104,demonhunter,havoc,60,34,26
Insomniaq,sargeras,2102,demonhunter,havoc,115,62,53
Kohî,sargeras,2102,demonhunter,havoc,79,39,40
Tendiës,tichondrius,2086,demonhunter,havoc,104,50,54
Dhcn,tichondrius,2073,demonhunter,havoc,64,35,29
Brbpetmycat,zuljin,2058,demonhunter,havoc,88,44,44
Fellhamer,malganis,2054,demonhunter,havoc,123,69,54
Nézuko,eldrethalas,2045,demonhunter,havoc,129,68,61
Medrathis,wyrmrest-accord,2042,demonhunter,havoc,60,34,26
Nasadh,tichondrius,2035,demonhunter,havoc,96,54,42
Badhábits,sargeras,2032,demonhunter,havoc,78,45,33
Calpoot,stormscale,2028,demonhunter,havoc,89,48,41
Glaivezx,stormreaver,2014,demonhunter,havoc,90,46,44
Reps,hydraxis,2011,demonhunter,havoc,126,70,56
Cyrøcryphä,quelthalas,2009,demonhunter,havoc,167,83,84
ßöb,aggramar,2004,demonhunter,havoc,102,55,47
Ordorll,area-52,1998,demonhunter,havoc,114,59,55
Lademon,tichondrius,1997,demonhunter,havoc,84,46,38
Xtickles,frostmourne,1992,demonhunter,havoc,154,79,75
Ìke,quelthalas,1979,demonhunter,havoc,121,64,57
Bløødyrøse,illidan,1978,demonhunter,havoc,66,40,26
Taegos,tichondrius,1970,demonhunter,havoc,617,301,316
Sleepyjoeb,illidan,1967,demonhunter,havoc,74,43,31
Bippy,durotan,1964,demonhunter,havoc,149,78,71
Felz,illidan,1964,demonhunter,havoc,95,48,47
Lifting,illidan,1960,demonhunter,havoc,84,40,44
Xxann,tichondrius,1955,demonhunter,havoc,61,30,31
Tømåtøgøðx,sargeras,1953,demonhunter,havoc,180,95,85
Frostchaos,ragnaros,1944,demonhunter,havoc,48,28,20
Sypï,malganis,1944,demonhunter,havoc,84,45,39
Bigbadmad,stormrage,1944,demonhunter,havoc,239,124,115
Boonchu,frostmourne,1935,demonhunter,havoc,86,45,41
Jøsem,ragnaros,1930,demonhunter,havoc,94,48,46
Mamazboy,area-52,1921,demonhunter,havoc,46,25,21
Blasphemus,illidan,1908,demonhunter,havoc,63,34,29
Cromega,malganis,1906,demonhunter,havoc,108,50,58
Oddblindguy,area-52,1903,demonhunter,havoc,42,30,12
Lemilion,wyrmrest-accord,1903,demonhunter,havoc,53,27,26
Maverzz,area-52,1902,demonhunter,havoc,65,35,30
Solit,illidan,1901,demonhunter,havoc,66,33,33
Askvivian,sargeras,1900,demonhunter,havoc,127,76,51
Zoenin,illidan,1900,demonhunter,havoc,144,73,71
Mèw,bleeding-hollow,1899,demonhunter,havoc,78,43,35
Terrorsong,tichondrius,1898,demonhunter,havoc,83,48,35
Boos,moon-guard,1893,demonhunter,havoc,172,84,88
Anihilum,zuljin,1891,demonhunter,havoc,99,64,35
Cerebro,stormrage,1890,demonhunter,havoc,54,31,23
Dangerspud,frostmourne,1885,demonhunter,havoc,102,48,54
Felluser,sargeras,1882,demonhunter,havoc,53,32,21
Stellitas,ragnaros,1881,demonhunter,havoc,72,38,34
Xch,aegwynn,1881,demonhunter,havoc,166,87,79
Dayvenie,area-52,1879,demonhunter,havoc,125,70,55
Rosinanta,malygos,1878,demonhunter,havoc,110,60,50
Junma,tichondrius,1874,demonhunter,havoc,84,47,37
Busting,tichondrius,1872,demonhunter,havoc,48,24,24
Mvqqdh,tichondrius,1872,demonhunter,havoc,42,20,22
Blode,tichondrius,1870,demonhunter,havoc,231,120,111
Nåxah,bleeding-hollow,1869,demonhunter,havoc,78,38,40
Amorielel,tichondrius,1867,demonhunter,havoc,50,23,27
Asdazanis,nemesis,1865,demonhunter,havoc,92,47,45
Doejah,stormrage,1865,demonhunter,havoc,80,40,40
Airmax,tichondrius,1864,demonhunter,havoc,84,44,40
Leothero,area-52,1863,demonhunter,havoc,54,28,26
Hatréd,quelthalas,1859,demonhunter,havoc,54,29,25
Lamorty,tichondrius,1859,demonhunter,havoc,150,73,77
Rlycoolclass,zuljin,1858,demonhunter,havoc,65,30,35
Dwilk,sargeras,1856,demonhunter,havoc,154,73,81
Azrethec,wyrmrest-accord,1855,demonhunter,havoc,108,62,46
Loadingdh,tichondrius,1854,demonhunter,havoc,47,20,27
Nb,silvermoon,1853,demonhunter,havoc,59,32,27
Ystkz,tichondrius,1852,demonhunter,havoc,213,110,103
Promitto,tichondrius,1851,demonhunter,havoc,101,49,52
Mizaru,moon-guard,1849,demonhunter,havoc,35,24,11
Flykzuwu,azralon,1848,demonhunter,havoc,89,53,36
Daía,ragnaros,1846,demonhunter,havoc,59,31,28
Joshallen,malganis,1846,demonhunter,havoc,141,73,68
Wowcoldcold,barthilas,1845,demonhunter,havoc,59,30,29
Griphunt,tichondrius,1840,demonhunter,havoc,222,115,107
Sacredtree,tichondrius,1839,demonhunter,havoc,116,65,51
Tiristra,cenarion-circle,1839,demonhunter,havoc,65,35,30
Ouru,area-52,1839,demonhunter,havoc,108,52,56
Ökìtycoón,proudmoore,1833,demonhunter,havoc,78,45,33
Bllackclover,zuljin,1831,demonhunter,havoc,59,34,25
Akurawrath,area-52,1830,demonhunter,havoc,120,84,36
Raiinier,sargeras,1830,demonhunter,havoc,78,48,30
Hasbeen,tichondrius,1830,demonhunter,havoc,39,23,16
Divide,tichondrius,1830,demonhunter,havoc,106,58,48
Soliit,illidan,1830,demonhunter,havoc,60,30,30
Pythongodx,azralon,1829,demonhunter,havoc,96,54,42
Brackmagik,barthilas,1828,demonhunter,havoc,36,27,9
Takagi,kirin-tor,1828,demonhunter,havoc,221,120,101
Càrnagex,tichondrius,1826,demonhunter,havoc,309,153,156
Devotio,emerald-dream,1825,demonhunter,havoc,102,60,42
Migey,thrall,1825,demonhunter,havoc,112,65,47
Vanarion,area-52,1825,demonhunter,havoc,84,36,48
Beerdash,area-52,1825,demonhunter,havoc,66,28,38
Chulakels,tichondrius,1824,demonhunter,havoc,75,45,30
Ninetalesx,sargeras,1823,demonhunter,havoc,81,48,33
Darkrai,area-52,1823,demonhunter,havoc,132,73,59
Nolabb,tichondrius,1822,demonhunter,havoc,128,72,56
Írís,blackrock,1820,demonhunter,havoc,124,75,49
Karonisam,dalaran,1820,demonhunter,havoc,61,32,29
Dannyolo,hyjal,1820,demonhunter,havoc,78,32,46
Mvpdh,area-52,1819,demonhunter,havoc,242,121,121
Failtimeboat,terenas,1817,demonhunter,havoc,60,34,26
Drachyn,darkspear,1817,demonhunter,havoc,71,34,37
Garbage,illidan,1816,demonhunter,havoc,84,44,40
Helenquinn,kelthuzad,1815,demonhunter,havoc,72,46,26
Mirriana,thunderlord,1815,demonhunter,havoc,98,52,46
Brotherz,tichondrius,1815,demonhunter,havoc,113,56,57
Skyez,moon-guard,1814,demonhunter,havoc,115,54,61
Nadlli,bleeding-hollow,1813,demonhunter,havoc,223,116,107
Kázeshini,frostmourne,1813,demonhunter,havoc,143,71,72
Rufio,nesingwary,1813,demonhunter,havoc,54,25,29
Coa,nazjatar,1812,demonhunter,havoc,100,54,46
Eldiablaso,malganis,1812,demonhunter,havoc,36,19,17
Lucifèr,uther,1812,demonhunter,havoc,59,28,31
Ferano,frostmourne,1811,demonhunter,havoc,211,109,102
Vowz,sargeras,1811,demonhunter,havoc,66,34,32
Tyskeram,bleeding-hollow,1810,demonhunter,havoc,81,47,34
Syrio,frostmourne,1809,demonhunter,havoc,236,129,107
Felswamp,zuljin,1809,demonhunter,havoc,126,65,61
Dãnishroll,illidan,1809,demonhunter,havoc,108,54,54
Bitcoingodx,tichondrius,1808,demonhunter,havoc,120,68,52
Feldarath,sargeras,1807,demonhunter,havoc,133,76,57
Fenomeno,tichondrius,1807,demonhunter,havoc,58,32,26
Fruitbatx,tichondrius,1807,demonhunter,havoc,138,68,70
Xcf,area-52,1807,demonhunter,havoc,48,22,26
Landorus,barthilas,1806,demonhunter,havoc,155,83,72
Raenorion,kelthuzad,1805,demonhunter,havoc,54,33,21
Dewkee,ghostlands,1805,demonhunter,havoc,42,24,18
Niuzimeile,illidan,1805,demonhunter,havoc,77,33,44
Smqkepvrpp,zuljin,1804,demonhunter,havoc,64,41,23
Fellenkellar,stormrage,1804,demonhunter,havoc,144,80,64
Shadë,stormrage,1802,demonhunter,havoc,60,31,29
Winsforgold,area-52,1801,demonhunter,havoc,86,47,39
Dhkyun,tichondrius,1801,demonhunter,havoc,54,29,25
Wompo,wyrmrest-accord,1801,demonhunter,havoc,36,19,17
Plumkin,kiljaeden,1800,demonhunter,havoc,54,32,22
Icecokelime,black-dragonflight,1800,demonhunter,havoc,38,20,18
Deathbladezx,tichondrius,1800,demonhunter,havoc,47,23,24
Tendies,tichondrius,1800,demonhunter,havoc,60,28,32
Juiced,thunderhorn,1799,demonhunter,havoc,95,50,45
Donaldjr,area-52,1798,demonhunter,havoc,69,42,27
Potspoon,tichondrius,1798,demonhunter,havoc,162,82,80
Basedmf,emerald-dream,1797,demonhunter,havoc,65,30,35
Chainsawz,zuljin,1796,demonhunter,havoc,80,35,45
Hogmandh,illidan,1794,demonhunter,havoc,54,27,27
Dawgzo,thunderhorn,1793,demonhunter,havoc,126,71,55
Andthrx,area-52,1791,demonhunter,havoc,260,130,130
Nuktukdh,moon-guard,1791,demonhunter,havoc,68,30,38
Nips,lightnings-blade,1790,demonhunter,havoc,66,43,23
Erasér,area-52,1786,demonhunter,havoc,48,26,22
Thundiir,area-52,1786,demonhunter,havoc,113,58,55
Madepp,tichondrius,1782,demonhunter,havoc,54,27,27
Dewk,ghostlands,1781,demonhunter,havoc,63,30,33
Aryapudding,tichondrius,1779,demonhunter,havoc,58,28,30
Deathsweep,tichondrius,1773,demonhunter,havoc,54,29,25
Demonsob,illidan,1772,demonhunter,havoc,59,22,37
Xøtourlife,malganis,1771,demonhunter,havoc,64,33,31
Nephxz,tichondrius,1771,demonhunter,havoc,54,26,28
Mevadow,bleeding-hollow,1768,demonhunter,havoc,126,57,69
Hueylucifer,ravencrest,1768,demonhunter,havoc,43,19,24
Bbteaa,frostmourne,1765,demonhunter,havoc,206,107,99
Zatharas,stormrage,1764,demonhunter,havoc,122,61,61
Beyondjerky,malganis,1763,demonhunter,havoc,40,23,17
Soyboycuck,emerald-dream,1760,demonhunter,havoc,42,21,21
Sucio,khaz-modan,1760,demonhunter,havoc,54,26,28
Tylersdh,illidan,1758,demonhunter,havoc,151,87,64
Ahsref,stormrage,1757,demonhunter,havoc,60,30,30
Ubetterun,azralon,1755,demonhunter,havoc,219,113,106
Antamoris,sargeras,1753,demonhunter,havoc,64,32,32
Saaldh,zuljin,1753,demonhunter,havoc,65,27,38
Purplekuush,bleeding-hollow,1752,demonhunter,havoc,84,44,40
Dhwhat,stormrage,1750,demonhunter,havoc,125,70,55
Gubydal,frostmourne,1750,demonhunter,havoc,53,29,24
Remh,bleeding-hollow,1749,demonhunter,havoc,272,140,132
Immortalsinz,dalaran,1747,demonhunter,havoc,112,48,64
Noobstaa,area-52,1745,demonhunter,havoc,48,34,14
Decoherence,sargeras,1745,demonhunter,havoc,54,33,21
Ðavid,firetree,1745,demonhunter,havoc,96,48,48
Oshinoko,area-52,1742,demonhunter,havoc,63,34,29
Lazydeamon,frostmourne,1740,demonhunter,havoc,60,26,34
Tundies,tichondrius,1738,demonhunter,havoc,48,25,23
Monfel,dalaran,1737,demonhunter,havoc,108,63,45
Furious,tichondrius,1737,demonhunter,havoc,48,23,25
Tichóndrius,tichondrius,1735,demonhunter,havoc,173,95,78
Hoochee,lightnings-blade,1735,demonhunter,havoc,73,39,34
Baka,grizzly-hills,1735,demonhunter,havoc,48,22,26
Firstsol,stormrage,1734,demonhunter,havoc,60,36,24
Wherwelandin,zuljin,1734,demonhunter,havoc,51,24,27
Xylëm,tichondrius,1734,demonhunter,havoc,60,25,35
Axalark,nemesis,1733,demonhunter,havoc,54,26,28
Cromosh,quelthalas,1733,demonhunter,havoc,90,38,52
Raahjxz,sargeras,1730,demonhunter,havoc,108,61,47
Felnipz,tichondrius,1729,demonhunter,havoc,67,39,28
Lilise,kiljaeden,1728,demonhunter,havoc,102,50,52
Azexion,malganis,1727,demonhunter,havoc,114,59,55
Okuzén,tichondrius,1723,demonhunter,havoc,29,21,8
Diequickly,tichondrius,1722,demonhunter,havoc,58,29,29
Croches,tichondrius,1721,demonhunter,havoc,36,18,18
Ðrogö,emerald-dream,1719,demonhunter,havoc,42,24,18
Fardyhole,illidan,1719,demonhunter,havoc,36,18,18
Sikarnix,stormrage,1719,demonhunter,havoc,84,38,46
Zcarfacee,frostmourne,1715,demonhunter,havoc,32,18,14
Ibdl,tichondrius,1714,demonhunter,havoc,30,18,12
Irisand,ragnaros,1714,demonhunter,havoc,83,40,43
Doeja,illidan,1713,demonhunter,havoc,30,18,12
Thehonor,tichondrius,1713,demonhunter,havoc,65,36,29
Obsidians,korgath,1709,demonhunter,havoc,89,51,38
Hundredeye,malganis,1709,demonhunter,havoc,64,31,33
Aetheris,bleeding-hollow,1709,demonhunter,havoc,78,34,44
Pokemibut,frostmourne,1708,demonhunter,havoc,36,18,18
Tenthslayer,frostmourne,1707,demonhunter,havoc,48,28,20
Harríson,tichondrius,1707,demonhunter,havoc,108,52,56
Scylus,tichondrius,1706,demonhunter,havoc,102,59,43
Sheldoncoop,emerald-dream,1706,demonhunter,havoc,36,18,18
Asheng,cairne,1706,demonhunter,havoc,63,30,33
Rôsè,tichondrius,1704,demonhunter,havoc,88,49,39
Dêspacito,tichondrius,1704,demonhunter,havoc,42,18,24
Xeylin,sargeras,1703,demonhunter,havoc,54,34,20
Gamernation,area-52,1703,demonhunter,havoc,57,29,28
Isev,illidan,1702,demonhunter,havoc,30,18,12
Wildh,stormrage,1702,demonhunter,havoc,78,41,37
Felgobbler,zuljin,1701,demonhunter,havoc,72,38,34
Ethhunter,proudmoore,1700,demonhunter,havoc,78,39,39
Nopohunter,burning-blade,1699,demonhunter,havoc,47,31,16
Dyllen,tichondrius,1698,demonhunter,havoc,194,104,90
Vendeem,moonrunner,1697,demonhunter,havoc,104,56,48
Johnconnor,tichondrius,1696,demonhunter,havoc,53,20,33
Chiesa,sargeras,1695,demonhunter,havoc,34,27,7
Busta,dethecus,1693,demonhunter,havoc,65,28,37
Munyanyô,moon-guard,1691,demonhunter,havoc,41,26,15
Tubaki,tichondrius,1691,demonhunter,havoc,35,19,16
Speedh,area-52,1691,demonhunter,havoc,36,18,18
Deaforalive,malganis,1690,demonhunter,havoc,96,54,42
Cöcainë,stormrage,1689,demonhunter,havoc,36,24,12
Idontfaced,area-52,1689,demonhunter,havoc,52,32,20
Souliz,tichondrius,1689,demonhunter,havoc,66,37,29
Sarÿnrae,malganis,1687,demonhunter,havoc,48,29,19
Kìed,kiljaeden,1687,demonhunter,havoc,48,24,24
Glaivediggar,barthilas,1686,demonhunter,havoc,178,86,92
Boatsnhoze,tichondrius,1686,demonhunter,havoc,50,21,29
Ídunno,kiljaeden,1685,demonhunter,havoc,54,26,28
Crittic,thrall,1685,demonhunter,havoc,102,44,58
Wickbeams,barthilas,1684,demonhunter,havoc,59,28,31
Blúr,tichondrius,1683,demonhunter,havoc,41,23,18
Praxx,veknilash,1682,demonhunter,havoc,48,23,25
Ihuntmufasa,tichondrius,1679,demonhunter,havoc,48,28,20
Demabrak,azralon,1677,demonhunter,havoc,53,25,28
Icrazedcruxl,gnomeregan,1676,demonhunter,havoc,54,27,27
Namaga,illidan,1675,demonhunter,havoc,60,41,19
Buddyyguy,illidan,1675,demonhunter,havoc,102,45,57
Folkmagic,proudmoore,1673,demonhunter,havoc,30,18,12
Yaety,tichondrius,1671,demonhunter,havoc,58,36,22
Dingowango,illidan,1671,demonhunter,havoc,66,33,33
Jcosta,tichondrius,1670,demonhunter,havoc,97,45,52
Mamadorx,azralon,1668,demonhunter,havoc,29,18,11
Bloodhunter,exodar,1668,demonhunter,havoc,92,53,39
Imaginedmg,illidan,1668,demonhunter,havoc,60,28,32
Gamgeum,tichondrius,1667,demonhunter,havoc,36,23,13
Hisso,nordrassil,1666,demonhunter,havoc,54,31,23
Vynthar,wyrmrest-accord,1666,demonhunter,havoc,183,92,91
Ravana,khaz-modan,1664,demonhunter,havoc,112,60,52
Taylordem,tichondrius,1662,demonhunter,havoc,42,23,19
Xanthalos,wyrmrest-accord,1661,demonhunter,havoc,161,78,83
Boagz,area-52,1660,demonhunter,havoc,84,48,36
Allidox,tichondrius,1660,demonhunter,havoc,54,26,28
Kioka,khaz-modan,1659,demonhunter,havoc,34,20,14
Churchpls,stormrage,1659,demonhunter,havoc,58,23,35
Dragonÿx,ragnaros,1658,demonhunter,havoc,157,83,74
Gtåte,azjolnerub,1658,demonhunter,havoc,66,23,43
Achemedåche,dalaran,1657,demonhunter,havoc,33,22,11
Joric,dalaran,1657,demonhunter,havoc,66,40,26
Ilìdarì,zuljin,1657,demonhunter,havoc,33,20,13
Deathlex,sargeras,1656,demonhunter,havoc,78,40,38
Torments,area-52,1655,demonhunter,havoc,60,34,26
Icantseelol,sargeras,1655,demonhunter,havoc,78,41,37
Çhan,tichondrius,1655,demonhunter,havoc,281,142,139
Getpoodon,sargeras,1655,demonhunter,havoc,36,18,18
Evaxaxx,tichondrius,1655,demonhunter,havoc,54,22,32
Sáìto,arthas,1654,demonhunter,havoc,30,19,11
Zikzlol,tichondrius,1654,demonhunter,havoc,44,21,23
Whysoospicy,wyrmrest-accord,1653,demonhunter,havoc,48,29,19
Baikudyn,darkspear,1651,demonhunter,havoc,30,19,11
Billmcawsom,proudmoore,1651,demonhunter,havoc,66,33,33
Ðaredevil,azralon,1650,demonhunter,havoc,36,22,14
Giselah,malganis,1650,demonhunter,havoc,48,22,26
Chîsäki,quelthalas,1649,demonhunter,havoc,75,40,35
Shadöw,emerald-dream,1649,demonhunter,havoc,45,22,23
Demonfused,illidan,1647,demonhunter,havoc,61,34,27
Vapegodxqt,aegwynn,1647,demonhunter,havoc,50,25,25
Skyfly,stormscale,1647,demonhunter,havoc,66,31,35
Shyisback,area-52,1645,demonhunter,havoc,138,77,61
Balancedtoon,tichondrius,1645,demonhunter,havoc,66,36,30
Ironsightsdh,dalaran,1645,demonhunter,havoc,89,47,42
Sarynrae,malganis,1644,demonhunter,havoc,52,24,28
Valerrias,area-52,1643,demonhunter,havoc,42,21,21
Entropics,tichondrius,1642,demonhunter,havoc,41,29,12
Junmà,tichondrius,1642,demonhunter,havoc,72,42,30
Alast,emerald-dream,1642,demonhunter,havoc,54,28,26
Rune,dathremar,1642,demonhunter,havoc,48,23,25
Flyudzhin,azgalor,1642,demonhunter,havoc,143,68,75
Biognosis,ragnaros,1642,demonhunter,havoc,102,46,56
Malthazaan,stormrage,1641,demonhunter,havoc,38,22,16
Demoncastx,tichondrius,1641,demonhunter,havoc,95,54,41
Jpdh,frostmourne,1641,demonhunter,havoc,80,44,36
Jelleh,frostmourne,1640,demonhunter,havoc,35,21,14
Demonhunter,kirin-tor,1639,demonhunter,havoc,102,53,49
Snózberry,illidan,1639,demonhunter,havoc,81,37,44
Xenore,emerald-dream,1638,demonhunter,havoc,71,31,40
Viio,proudmoore,1637,demonhunter,havoc,36,21,15
Flirtyscythe,illidan,1637,demonhunter,havoc,58,28,30
Randomdh,zuljin,1636,demonhunter,havoc,43,23,20
Jaauk,ragnaros,1636,demonhunter,havoc,58,25,33
Mewmewkitty,tichondrius,1635,demonhunter,havoc,34,18,16
Blurblurblur,frostmourne,1635,demonhunter,havoc,60,25,35
Synthwäve,area-52,1634,demonhunter,havoc,36,23,13
Killuaqt,frostmourne,1633,demonhunter,havoc,53,28,25
Hròðvitnir,quelthalas,1632,demonhunter,havoc,86,53,33
Bremdh,thrall,1632,demonhunter,havoc,44,25,19
Accidcleaves,sargeras,1632,demonhunter,havoc,48,26,22
Seraphïel,khaz-modan,1631,demonhunter,havoc,36,23,13
Cezkia,hyjal,1629,demonhunter,havoc,72,36,36
Iliillii,emerald-dream,1629,demonhunter,havoc,75,31,44
Trilidan,proudmoore,1627,demonhunter,havoc,37,21,16
Stefdh,tichondrius,1627,demonhunter,havoc,51,23,28
Felontis,sargeras,1627,demonhunter,havoc,48,21,27
Thelor,frostmourne,1626,demonhunter,havoc,48,28,20
Xday,tichondrius,1626,demonhunter,havoc,258,132,126
Sicknizzle,area-52,1626,demonhunter,havoc,126,63,63
Bloodgash,tichondrius,1625,demonhunter,havoc,30,17,13
Rekttx,area-52,1625,demonhunter,havoc,64,34,30
Doomtower,tichondrius,1624,demonhunter,havoc,135,70,65
Gymnast,thaurissan,1624,demonhunter,havoc,54,23,31
Calmbefore,tichondrius,1623,demonhunter,havoc,29,22,7
Cuper,tichondrius,1623,demonhunter,havoc,72,41,31
Perspirant,malganis,1623,demonhunter,havoc,41,23,18
Sivà,tichondrius,1622,demonhunter,havoc,69,35,34
Zeroheaven,stormrage,1621,demonhunter,havoc,48,19,29
Hehehaha,wyrmrest-accord,1620,demonhunter,havoc,30,20,10
Amanthx,tichondrius,1620,demonhunter,havoc,54,27,27
Danloesh,silver-hand,1619,demonhunter,havoc,42,22,20
Ktsoulhunter,azralon,1619,demonhunter,havoc,114,58,56
Ohanadh,ragnaros,1618,demonhunter,havoc,48,19,29
Larandaa,sargeras,1617,demonhunter,havoc,72,35,37
Zachfortnite,emerald-dream,1616,demonhunter,havoc,30,19,11
Fingersdh,malganis,1616,demonhunter,havoc,96,45,51
Draenkz,ragnaros,1616,demonhunter,havoc,58,19,39
Glaivia,bleeding-hollow,1615,demonhunter,havoc,36,17,19
Cococat,tichondrius,1615,demonhunter,havoc,80,30,50
Velana,tichondrius,1614,demonhunter,havoc,30,21,9
Ptsdh,bloodhoof,1614,demonhunter,havoc,78,43,35
Gumeasy,tichondrius,1614,demonhunter,havoc,42,19,23
Taszyn,blackrock,1613,demonhunter,havoc,92,51,41
Karmakula,tichondrius,1613,demonhunter,havoc,77,39,38
Neodin,tichondrius,1612,demonhunter,havoc,61,35,26
Anathørn,ragnaros,1612,demonhunter,havoc,42,23,19
Littlewolfie,illidan,1611,demonhunter,havoc,42,23,19
Azinoht,ragnaros,1611,demonhunter,havoc,198,94,104
Ossariss,moon-guard,1610,demonhunter,havoc,30,17,13
Mazakein,tichondrius,1610,demonhunter,havoc,66,37,29
Cots,stormrage,1610,demonhunter,havoc,148,82,66
Bitskii,kelthuzad,1610,demonhunter,havoc,47,21,26
Sadpepe,bleeding-hollow,1610,demonhunter,havoc,48,21,27
Nistrin,area-52,1609,demonhunter,havoc,72,40,32
Diablitaa,sargeras,1609,demonhunter,havoc,36,17,19
Crixxus,zuljin,1609,demonhunter,havoc,48,20,28
Henry,tichondrius,1608,demonhunter,havoc,165,95,70
Yiptaw,area-52,1608,demonhunter,havoc,55,29,26
Feníxx,ragnaros,1608,demonhunter,havoc,88,45,43
Omygaud,tichondrius,1607,demonhunter,havoc,48,32,16
Beastbringer,proudmoore,1607,demonhunter,havoc,147,86,61
Stellartv,tichondrius,1607,demonhunter,havoc,156,73,83
Turecdh,illidan,1607,demonhunter,havoc,56,19,37
Énchantress,thrall,1606,demonhunter,havoc,42,22,20
Zeane,tichondrius,1605,demonhunter,havoc,51,29,22
Abigëil,quelthalas,1605,demonhunter,havoc,56,31,25
Chäos,proudmoore,1605,demonhunter,havoc,108,48,60
Mavrush,malganis,1604,demonhunter,havoc,54,31,23
Pragma,thrall,1604,demonhunter,havoc,231,124,107
Tychondrius,earthen-ring,1603,demonhunter,havoc,202,107,95
Daymanhunter,bleeding-hollow,1603,demonhunter,havoc,103,53,50
Kaedri,burning-blade,1603,demonhunter,havoc,141,68,73
Sìlençe,illidan,1602,demonhunter,havoc,29,19,10
Shale,gilneas,1602,demonhunter,havoc,70,35,35
Ariodh,area-52,1602,demonhunter,havoc,36,17,19
Gjoat,tichondrius,1600,demonhunter,havoc,42,19,23
Sävage,zuljin,1599,demonhunter,havoc,37,22,15
Gesture,malganis,1599,demonhunter,havoc,166,91,75
Ruffolina,azralon,1599,demonhunter,havoc,187,97,90
Dadoftheyear,destromath,1598,demonhunter,havoc,72,41,31
Coaa,dalaran,1598,demonhunter,havoc,47,23,24
Arête,malganis,1595,demonhunter,havoc,67,31,36
Darkrasta,ragnaros,1594,demonhunter,havoc,102,47,55
Animepfp,shadowsong,1594,demonhunter,havoc,42,19,23
Rennae,zuljin,1593,demonhunter,havoc,41,18,23
Netherbane,azgalor,1592,demonhunter,havoc,96,44,52
Shadowmoonz,frostmourne,1591,demonhunter,havoc,47,23,24
Dhyzz,proudmoore,1590,demonhunter,havoc,43,25,18
Eugenyackle,bleeding-hollow,1589,demonhunter,havoc,54,38,16
Reito,ragnaros,1589,demonhunter,havoc,53,29,24
Nándÿ,tichondrius,1589,demonhunter,havoc,67,36,31
Malefisentt,firetree,1589,demonhunter,havoc,45,22,23
Jk,dreadmaul,1588,demonhunter,havoc,81,45,36
Wsickformula,gilneas,1588,demonhunter,havoc,119,66,53
Mood,stonemaul,1587,demonhunter,havoc,60,36,24
Watsinthebox,thrall,1586,demonhunter,havoc,30,20,10
Progenji,azralon,1585,demonhunter,havoc,36,21,15
Knuckifubuck,frostwolf,1582,demonhunter,havoc,142,77,65
Beniesdh,frostmourne,1581,demonhunter,havoc,36,20,16
Chinadh,tichondrius,1581,demonhunter,havoc,35,17,18
Supadupä,stormrage,1580,demonhunter,havoc,30,17,13
Nuggetx,lightnings-blade,1580,demonhunter,havoc,54,29,25
Kaelclaira,dalvengyr,1580,demonhunter,havoc,60,29,31
Ossivil,ragnaros,1580,demonhunter,havoc,132,62,70
Jaybeezy,balnazzar,1580,demonhunter,havoc,42,18,24
Phaintx,tichondrius,1579,demonhunter,havoc,60,29,31
Yuppx,tichondrius,1578,demonhunter,havoc,48,29,19
Mcspicyy,tichondrius,1578,demonhunter,havoc,42,22,20
Stochastic,ragnaros,1578,demonhunter,havoc,103,52,51
Corngodx,sargeras,1578,demonhunter,havoc,102,50,52
Hoonjojjyana,tichondrius,1578,demonhunter,havoc,46,20,26
Dammitbôbby,tichondrius,1577,demonhunter,havoc,121,66,55
Kssmee,korgath,1576,demonhunter,havoc,90,48,42
Sternhunt,khadgar,1575,demonhunter,havoc,66,33,33
Baalböski,tichondrius,1574,demonhunter,havoc,88,41,47
Brútalgore,area-52,1573,demonhunter,havoc,188,99,89
Sineex,illidan,1572,demonhunter,havoc,36,22,14
Diiecrux,bleeding-hollow,1571,demonhunter,havoc,36,20,16
Scoplyn,malfurion,1571,demonhunter,havoc,66,34,32
Poogzzig,tichondrius,1571,demonhunter,havoc,108,52,56
Fleetop,tichondrius,1570,demonhunter,havoc,66,37,29
Demonfarter,tichondrius,1570,demonhunter,havoc,120,61,59
Pubelice,draenor,1569,demonhunter,havoc,68,38,30
Narandra,malganis,1569,demonhunter,havoc,48,19,29
Kenmu,ragnaros,1566,demonhunter,havoc,74,32,42
Nichousha,tichondrius,1565,demonhunter,havoc,36,19,17
Vândel,kelthuzad,1565,demonhunter,havoc,84,37,47
Theprodigy,malganis,1565,demonhunter,havoc,96,42,54
Sheepone,tichondrius,1564,demonhunter,havoc,24,19,5
Luribel,tichondrius,1564,demonhunter,havoc,42,23,19
Warlasher,zuljin,1563,demonhunter,havoc,234,119,115
Taatted,emerald-dream,1562,demonhunter,havoc,36,18,18
Redkin,moon-guard,1561,demonhunter,havoc,80,45,35
Nomfries,malganis,1560,demonhunter,havoc,52,27,25
Wikkidd,thrall,1560,demonhunter,havoc,47,22,25
Imwhack,frostmane,1559,demonhunter,havoc,73,39,34
Çummins,malganis,1558,demonhunter,havoc,86,53,33
Dankhuntér,zuljin,1558,demonhunter,havoc,54,20,34
Subieshift,sargeras,1557,demonhunter,havoc,39,20,19
Darknezzl,ragnaros,1557,demonhunter,havoc,98,48,50
Nocturnale,ragnaros,1555,demonhunter,havoc,100,49,51
Gorillidan,kelthuzad,1553,demonhunter,havoc,30,18,12
Mustardtigër,bleeding-hollow,1553,demonhunter,havoc,29,17,12
Rytesx,moon-guard,1552,demonhunter,havoc,75,53,22
Kaelthys,nordrassil,1552,demonhunter,havoc,33,21,12
Knshy,azralon,1552,demonhunter,havoc,62,31,31
Devirador,ragnaros,1549,demonhunter,havoc,83,34,49
Dantesabyss,proudmoore,1548,demonhunter,havoc,48,22,26
Kuramou,area-52,1547,demonhunter,havoc,36,22,14
Bromosapien,tichondrius,1547,demonhunter,havoc,36,19,17
Needlepoint,illidan,1547,demonhunter,havoc,65,34,31
Magenie,korgath,1544,demonhunter,havoc,41,25,16
Dealer,frostmourne,1542,demonhunter,havoc,114,51,63
Karmadh,malganis,1539,demonhunter,havoc,42,21,21
Blackmvp,tichondrius,1537,demonhunter,havoc,24,17,7
Cäldo,tichondrius,1537,demonhunter,havoc,36,21,15
Jaysavage,eitrigg,1536,demonhunter,havoc,113,59,54
Furiel,quelthalas,1534,demonhunter,havoc,44,26,18
Nuredmyy,illidan,1534,demonhunter,havoc,48,27,21
Jhinskui,drakkari,1533,demonhunter,havoc,113,55,58
Doxdevil,tichondrius,1533,demonhunter,havoc,57,19,38
Thêdràïñgáñg,jubeithos,1530,demonhunter,havoc,30,16,14
Cavell,tichondrius,1529,demonhunter,havoc,30,16,14
Rôrônôâzôrô,stormrage,1529,demonhunter,havoc,59,30,29
Velravyn,moon-guard,1529,demonhunter,havoc,67,34,33
Surå,tichondrius,1529,demonhunter,havoc,106,49,57
Papaelf,thunderlord,1528,demonhunter,havoc,48,33,15
Coohiyan,tichondrius,1527,demonhunter,havoc,49,30,19
Khaito,illidan,1527,demonhunter,havoc,38,17,21
Dirtylatin,ragnaros,1526,demonhunter,havoc,54,31,23
Crayoz,tichondrius,1525,demonhunter,havoc,131,73,58
Emopidgeon,dalaran,1525,demonhunter,havoc,30,16,14
Bogdan,azjolnerub,1525,demonhunter,havoc,66,35,31
Mattdizzle,illidan,1524,demonhunter,havoc,24,17,7
Ilydos,emerald-dream,1523,demonhunter,havoc,118,61,57
Luminesce,tichondrius,1523,demonhunter,havoc,36,16,20
Raith,khazgoroth,1522,demonhunter,havoc,67,39,28
Chungîe,frostmourne,1522,demonhunter,havoc,54,26,28
Papazaraki,tichondrius,1521,demonhunter,havoc,42,23,19
Yqpro,tichondrius,1521,demonhunter,havoc,131,67,64
Wormli,moon-guard,1519,demonhunter,havoc,46,28,18
Noztak,area-52,1519,demonhunter,havoc,48,16,32
Hëll,spirestone,1518,demonhunter,havoc,24,16,8
Rêliç,sargeras,1516,demonhunter,havoc,30,18,12
Eyecandyxo,grizzly-hills,1514,demonhunter,havoc,79,43,36
Hàuntress,saurfang,1513,demonhunter,havoc,78,45,33
Sikäria,malganis,1513,demonhunter,havoc,48,27,21
Mileze,area-52,1513,demonhunter,havoc,96,39,57
Deadpixellz,illidan,1511,demonhunter,havoc,76,39,37
Vlääd,ragnaros,1511,demonhunter,havoc,174,87,87
Ylydary,ragnaros,1509,demonhunter,havoc,93,52,41
Gittgudd,area-52,1507,demonhunter,havoc,81,42,39
Xionas,moon-guard,1507,demonhunter,havoc,148,75,73
Radamanthysi,azralon,1506,demonhunter,havoc,90,56,34
Iluvboóty,blackrock,1505,demonhunter,havoc,42,17,25
Dirtbag,tichondrius,1503,demonhunter,havoc,30,16,14
Enfirok,duskwood,1501,demonhunter,havoc,300,153,147
Kakster,tichondrius,1500,demonhunter,havoc,84,49,35
Demodorn,frostmane,1499,demonhunter,havoc,30,19,11
Spasmodiic,illidan,1499,demonhunter,havoc,51,27,24
Macacøbrr,azralon,1498,demonhunter,havoc,76,37,39
Alli,bleeding-hollow,1494,demonhunter,havoc,69,39,30
Ralløszek,illidan,1494,demonhunter,havoc,48,26,22
Træt,emerald-dream,1494,demonhunter,havoc,83,42,41
Hemmerdainz,kelthuzad,1492,demonhunter,havoc,66,30,36
Scriptyscrip,dark-iron,1491,demonhunter,havoc,192,86,106
Croisoi,ragnaros,1490,demonhunter,havoc,78,38,40
Bigflopper,malganis,1489,demonhunter,havoc,84,42,42
Gazza,eldrethalas,1488,demonhunter,havoc,42,23,19
Îllîdàn,tichondrius,1488,demonhunter,havoc,45,22,23
Hellmetal,quelthalas,1488,demonhunter,havoc,36,17,19
Dashxo,tichondrius,1487,demonhunter,havoc,36,17,19
Dmonslayer,daggerspine,1487,demonhunter,havoc,60,23,37
Apõz,tichondrius,1486,demonhunter,havoc,30,16,14
Emeress,illidan,1486,demonhunter,havoc,57,26,31
Orgasmia,tichondrius,1486,demonhunter,havoc,106,32,74
Demontrue,tichondrius,1483,demonhunter,havoc,62,32,30
Kimjonguun,tichondrius,1481,demonhunter,havoc,32,22,10
Órph,sargeras,1481,demonhunter,havoc,48,26,22
Halleblurry,dalaran,1481,demonhunter,havoc,66,34,32
Häruun,quelthalas,1480,demonhunter,havoc,53,29,24
Aiapaec,wyrmrest-accord,1479,demonhunter,havoc,119,60,59
Wowomg,tichondrius,1477,demonhunter,havoc,36,20,16
Gaìjîn,barthilas,1477,demonhunter,havoc,144,77,67
Steeler,shandris,1475,demonhunter,havoc,42,18,24
Cocomeld,tichondrius,1474,demonhunter,havoc,24,16,8
Vegêta,malganis,1473,demonhunter,havoc,36,20,16
Nooksuh,bleeding-hollow,1473,demonhunter,havoc,29,16,13
Eazyrat,stormrage,1472,demonhunter,havoc,48,33,15
Businessmaam,malganis,1472,demonhunter,havoc,30,17,13
Vilal,dalaran,1469,demonhunter,havoc,32,24,8
Røllnautløw,aegwynn,1469,demonhunter,havoc,32,22,10
Kegu,stormrage,1469,demonhunter,havoc,54,20,34
Greent,stormrage,1468,demonhunter,havoc,60,39,21
Jiujitsuu,bleeding-hollow,1468,demonhunter,havoc,37,17,20
Gomesdhunter,azralon,1466,demonhunter,havoc,88,47,41
Sätyr,bleeding-hollow,1466,demonhunter,havoc,54,19,35
Bjj,bonechewer,1465,demonhunter,havoc,100,58,42
Exequion,ragnaros,1465,demonhunter,havoc,188,102,86
Zunfooki,stormrage,1464,demonhunter,havoc,30,17,13
Ðarkone,ragnaros,1464,demonhunter,havoc,42,17,25
Derelikte,shadowmoon,1462,demonhunter,havoc,34,20,14
Nepzz,stormrage,1461,demonhunter,havoc,78,44,34
Creãtuss,area-52,1461,demonhunter,havoc,72,36,36
Eery,tichondrius,1461,demonhunter,havoc,71,35,36
Doomtots,kelthuzad,1460,demonhunter,havoc,30,17,13
Mamif,korgath,1460,demonhunter,havoc,68,31,37
Hellnkeller,tichondrius,1459,demonhunter,havoc,36,16,20
Somethingstu,sargeras,1458,demonhunter,havoc,28,18,10
Bofxo,sargeras,1458,demonhunter,havoc,53,25,28
Gohamx,illidan,1457,demonhunter,havoc,110,54,56
Felseal,frostmourne,1456,demonhunter,havoc,53,34,19
Tyredris,kelthuzad,1456,demonhunter,havoc,50,27,23
Kushidari,tichondrius,1455,demonhunter,havoc,126,71,55
Nekrosdaeva,zuljin,1455,demonhunter,havoc,73,40,33
Telmordrin,azralon,1455,demonhunter,havoc,68,36,32
Mysteryastor,tichondrius,1455,demonhunter,havoc,48,22,26
Sciatic,area-52,1454,demonhunter,havoc,68,33,35
Wangasaurus,emerald-dream,1452,demonhunter,havoc,54,26,28
Metabeam,tichondrius,1451,demonhunter,havoc,54,34,20
Xillidan,area-52,1450,demonhunter,havoc,112,70,42
Sëlene,antonidas,1449,demonhunter,havoc,83,40,43
Wokeaf,malganis,1448,demonhunter,havoc,35,16,19
Bucx,barthilas,1445,demonhunter,havoc,60,36,24
Nicodine,tichondrius,1445,demonhunter,havoc,63,34,29
Ragiidh,tichondrius,1443,demonhunter,havoc,45,19,26
Netherbird,malganis,1442,demonhunter,havoc,24,16,8
Faphunter,illidan,1441,demonhunter,havoc,87,50,37
Gwendanzig,zangarmarsh,1440,demonhunter,havoc,72,37,35
Vellestia,argent-dawn,1440,demonhunter,havoc,71,31,40
Absinith,jubeithos,1439,demonhunter,havoc,46,29,17
Allyrian,sargeras,1439,demonhunter,havoc,174,93,81
Ragiixoxo,tichondrius,1438,demonhunter,havoc,24,15,9
Huntoneshot,bleeding-hollow,1438,demonhunter,havoc,55,29,26
Haades,proudmoore,1438,demonhunter,havoc,73,38,35
Molchamp,kelthuzad,1438,demonhunter,havoc,60,27,33
Feelmybush,barthilas,1438,demonhunter,havoc,72,29,43
Elidani,area-52,1437,demonhunter,havoc,66,31,35
Yåkuza,daggerspine,1436,demonhunter,havoc,164,79,85
Lravanal,quelthalas,1435,demonhunter,havoc,24,17,7
Fametrap,tichondrius,1435,demonhunter,havoc,24,15,9
ßlurr,moon-guard,1435,demonhunter,havoc,114,63,51
Genruis,area-52,1435,demonhunter,havoc,67,34,33
Broneill,blood-furnace,1435,demonhunter,havoc,60,27,33
Jfangio,moon-guard,1434,demonhunter,havoc,24,15,9
Derperhunter,kiljaeden,1434,demonhunter,havoc,66,33,33
Beastsburdun,zuljin,1433,demonhunter,havoc,24,15,9
Backtolumby,bleeding-hollow,1433,demonhunter,havoc,65,36,29
Kyuno,eitrigg,1431,demonhunter,havoc,48,22,26
Remuko,tichondrius,1430,demonhunter,havoc,30,15,15
Dridri,quelthalas,1430,demonhunter,havoc,44,21,23
Glaivez,korgath,1429,demonhunter,havoc,24,15,9
Unjusthunt,magtheridon,1429,demonhunter,havoc,30,15,15
Egirlhunter,echo-isles,1429,demonhunter,havoc,30,15,15
Qixoni,emerald-dream,1429,demonhunter,havoc,36,15,21
Trillidan,mugthol,1429,demonhunter,havoc,36,15,21
Chimpers,illidan,1429,demonhunter,havoc,42,15,27
Iim,tichondrius,1428,demonhunter,havoc,87,35,52
Lonelydusk,zangarmarsh,1427,demonhunter,havoc,54,28,26
Crankbaz,malganis,1426,demonhunter,havoc,24,15,9
Pigmah,malganis,1426,demonhunter,havoc,28,16,12
Rhadê,ragnaros,1426,demonhunter,havoc,30,16,14
Stalkdemon,azralon,1426,demonhunter,havoc,30,15,15
Goldsgym,boulderfist,1424,demonhunter,havoc,28,17,11
Sloôtybag,tichondrius,1424,demonhunter,havoc,42,21,21
Postodesaúde,azralon,1424,demonhunter,havoc,36,15,21
Superlative,area-52,1423,demonhunter,havoc,24,15,9
Alwaysin,zuljin,1423,demonhunter,havoc,26,16,10
Thebojanglz,frostmourne,1421,demonhunter,havoc,25,16,9
Italoo,ragnaros,1421,demonhunter,havoc,30,16,14
Nupx,frostmourne,1420,demonhunter,havoc,39,20,19
Anatema,illidan,1420,demonhunter,havoc,104,53,51
Moylecrumbs,stormrage,1420,demonhunter,havoc,102,50,52
Devastation,tichondrius,1420,demonhunter,havoc,72,34,38
Thgyjufdgh,smolderthorn,1420,demonhunter,havoc,50,23,27
Creamboi,stormrage,1419,demonhunter,havoc,34,19,15
Falachio,tichondrius,1419,demonhunter,havoc,129,66,63
Adhdh,haomarush,1418,demonhunter,havoc,24,15,9
Vespherie,moon-guard,1418,demonhunter,havoc,85,51,34
Viismoke,thaurissan,1418,demonhunter,havoc,48,28,20
Talyethsam,shadowsong,1418,demonhunter,havoc,32,16,16
Bezmon,silvermoon,1416,demonhunter,havoc,30,19,11
Layli,azralon,1416,demonhunter,havoc,48,30,18
Dèmonhuntèr,tichondrius,1415,demonhunter,havoc,134,64,70
Ikilldemonz,thrall,1415,demonhunter,havoc,42,19,23
Valka,emerald-dream,1414,demonhunter,havoc,112,59,53
Tharzadan,quelthalas,1414,demonhunter,havoc,63,33,30
Tickelfist,zuljin,1413,demonhunter,havoc,115,59,56
Varthalos,thrall,1412,demonhunter,havoc,96,54,42
Grizzop,sargeras,1411,demonhunter,havoc,102,50,52
Mavèrick,thrall,1411,demonhunter,havoc,63,29,34
Oxyoxy,illidan,1410,demonhunter,havoc,37,23,14
Colinn,illidan,1409,demonhunter,havoc,42,25,17
Mintjoa,tichondrius,1409,demonhunter,havoc,30,15,15
Bijix,area-52,1408,demonhunter,havoc,55,35,20
Cybertrax,tichondrius,1408,demonhunter,havoc,24,15,9
Salomesalvi,proudmoore,1405,demonhunter,havoc,36,24,12
Zigzagrat,sargeras,1404,demonhunter,havoc,30,15,15
Grumblepuppy,hyjal,1404,demonhunter,havoc,41,18,23
Narchis,malganis,1403,demonhunter,havoc,30,17,13
Zackfair,burning-legion,1403,demonhunter,havoc,123,60,63
Ralrdh,ragnaros,1402,demonhunter,havoc,54,30,24
Loreney,quelthalas,1402,demonhunter,havoc,120,55,65
Rem,stormrage,1401,demonhunter,havoc,75,42,33
Yodiegang,nazgrel,1400,demonhunter,havoc,24,15,9
Demonicfish,malganis,1400,demonhunter,havoc,72,40,32
Refractx,illidan,1400,demonhunter,havoc,83,45,38
Noxon,stormrage,1400,demonhunter,havoc,98,50,48
Ehrapist,kelthuzad,1399,demonhunter,havoc,30,16,14
Illusiondh,tichondrius,1398,demonhunter,havoc,99,58,41
Plasticbagel,frostmourne,1397,demonhunter,havoc,48,25,23
Phoébé,drakkari,1394,demonhunter,havoc,36,19,17
Softkyll,area-52,1394,demonhunter,havoc,369,191,178
Cherlas,blood-furnace,1393,demonhunter,havoc,99,52,47
Ranir,doomhammer,1393,demonhunter,havoc,72,32,40
Freyvin,emerald-dream,1392,demonhunter,havoc,78,35,43
Yaakee,tichondrius,1391,demonhunter,havoc,54,33,21
Hoein,eldrethalas,1390,demonhunter,havoc,137,76,61
Swarlee,kiljaeden,1389,demonhunter,havoc,89,49,40
Siksix,bleeding-hollow,1389,demonhunter,havoc,54,27,27
Maisus,illidan,1388,demonhunter,havoc,36,16,20
Dejay,thunderhorn,1386,demonhunter,havoc,54,33,21
Thunderray,ragnaros,1386,demonhunter,havoc,42,25,17
Kúrama,tichondrius,1385,demonhunter,havoc,78,46,32
Rolecheck,tichondrius,1385,demonhunter,havoc,50,25,25
Snaped,tichondrius,1384,demonhunter,havoc,42,28,14
Jackk,nordrassil,1384,demonhunter,havoc,41,21,20
Lostsoulzz,tichondrius,1383,demonhunter,havoc,45,28,17
Véñom,area-52,1383,demonhunter,havoc,60,18,42
Vegan,magtheridon,1382,demonhunter,havoc,48,29,19
Tøwers,aegwynn,1382,demonhunter,havoc,102,51,51
Allenqt,azralon,1381,demonhunter,havoc,42,22,20
Onií,bleeding-hollow,1379,demonhunter,havoc,35,17,18
Yukisyn,proudmoore,1376,demonhunter,havoc,114,61,53
Violegrace,area-52,1376,demonhunter,havoc,106,51,55
Blomi,stormrage,1376,demonhunter,havoc,48,21,27
Villumninati,tichondrius,1375,demonhunter,havoc,48,27,21
Catastrophis,tichondrius,1375,demonhunter,havoc,48,25,23
Omgshesocute,hyjal,1375,demonhunter,havoc,36,18,18
Kellox,ragnaros,1372,demonhunter,havoc,36,15,21
Petty,moon-guard,1371,demonhunter,havoc,48,28,20
Fugabag,thrall,1371,demonhunter,havoc,58,28,30
Erandrida,frostmourne,1370,demonhunter,havoc,39,16,23
Kazdh,sargeras,1367,demonhunter,havoc,48,25,23
Chaz,blood-furnace,1366,demonhunter,havoc,36,16,20
Jellous,rivendare,1366,demonhunter,havoc,42,17,25
Cresslina,tichondrius,1365,demonhunter,havoc,78,38,40
Xiaochicken,tichondrius,1365,demonhunter,havoc,61,29,32
Nubishe,jubeithos,1364,demonhunter,havoc,42,18,24
Methany,saurfang,1362,demonhunter,havoc,105,48,57
Ronkasprince,thunderlord,1361,demonhunter,havoc,92,41,51
Felbreak,stormrage,1358,demonhunter,havoc,72,35,37
Celestiel,cenarion-circle,1357,demonhunter,havoc,30,17,13
Kalmor,barthilas,1357,demonhunter,havoc,69,33,36
Mybus,tichondrius,1357,demonhunter,havoc,78,32,46
Foxdie,bonechewer,1356,demonhunter,havoc,96,47,49
Báléríón,area-52,1355,demonhunter,havoc,59,34,25
Muerdun,tichondrius,1355,demonhunter,havoc,36,20,16
Hornedelf,frostmourne,1355,demonhunter,havoc,41,22,19
Telrindyl,moon-guard,1352,demonhunter,havoc,120,68,52
Rizzaarrdd,tichondrius,1352,demonhunter,havoc,134,70,64
Metagoblin,tichondrius,1352,demonhunter,havoc,30,15,15
Xlash,malganis,1350,demonhunter,havoc,33,15,18
Krizo,frostmourne,1348,demonhunter,havoc,37,19,18
Duhan,tichondrius,1346,demonhunter,havoc,251,130,121
Rânkle,darkspear,1345,demonhunter,havoc,46,25,21
Imrealgez,wyrmrest-accord,1345,demonhunter,havoc,30,16,14
Exzyo,area-52,1344,demonhunter,havoc,18,14,4
Onewhoknox,mannoroth,1344,demonhunter,havoc,126,64,62
Soupwoup,moon-guard,1344,demonhunter,havoc,75,36,39
Ergzydh,frostmourne,1344,demonhunter,havoc,72,30,42
Aethrys,amanthul,1343,demonhunter,havoc,54,28,26
Kokushiibo,frostwolf,1342,demonhunter,havoc,24,14,10
Riskerdog,tichondrius,1342,demonhunter,havoc,30,14,16
Chromatïc,jubeithos,1342,demonhunter,havoc,78,34,44
Theflurry,tichondrius,1342,demonhunter,havoc,36,14,22
Beerbreak,area-52,1342,demonhunter,havoc,42,14,28
Çópê,sargeras,1340,demonhunter,havoc,24,14,10
Leesu,tichondrius,1340,demonhunter,havoc,24,14,10
Deviljane,illidan,1340,demonhunter,havoc,24,14,10
Skace,jubeithos,1340,demonhunter,havoc,108,57,51
Bobbyhill,nordrassil,1340,demonhunter,havoc,30,14,16
Demondubya,illidan,1339,demonhunter,havoc,28,15,13
Malviciouss,tichondrius,1339,demonhunter,havoc,84,40,44
Kellytgt,perenolde,1338,demonhunter,havoc,78,40,38
Xaneuma,nemesis,1335,demonhunter,havoc,24,14,10
Mudßutt,malganis,1335,demonhunter,havoc,36,14,22
Dakro,blackrock,1334,demonhunter,havoc,28,17,11
Ghótam,quelthalas,1334,demonhunter,havoc,30,15,15
Alganoth,malfurion,1332,demonhunter,havoc,79,40,39
Smilingbomb,tichondrius,1332,demonhunter,havoc,30,14,16
Melantharia,wyrmrest-accord,1331,demonhunter,havoc,30,14,16
Majnun,moon-guard,1330,demonhunter,havoc,65,30,35
Intensè,proudmoore,1330,demonhunter,havoc,36,15,21
Demonaco,tichondrius,1329,demonhunter,havoc,40,15,25
Soulsteall,tichondrius,1327,demonhunter,havoc,36,24,12
Xein,khazgoroth,1327,demonhunter,havoc,66,30,36
Mördredd,quelthalas,1327,demonhunter,havoc,40,16,24
Elevateztko,stormrage,1326,demonhunter,havoc,36,16,20
Kêrbydh,frostmourne,1325,demonhunter,havoc,36,22,14
Ðemonix,tichondrius,1325,demonhunter,havoc,42,14,28
Intensìve,illidan,1324,demonhunter,havoc,89,36,53
Creamin,thrall,1323,demonhunter,havoc,24,15,9
Verméil,tichondrius,1323,demonhunter,havoc,36,17,19
Akiirus,azralon,1322,demonhunter,havoc,30,15,15
Zévron,area-52,1322,demonhunter,havoc,54,26,28
Chaosfienddh,bleeding-hollow,1322,demonhunter,havoc,36,14,22
Hyjixer,stormrage,1321,demonhunter,havoc,36,14,22
Kitnix,proudmoore,1319,demonhunter,havoc,43,21,22
Margerie,bleeding-hollow,1319,demonhunter,havoc,43,21,22
Antaris,stonemaul,1319,demonhunter,havoc,30,14,16
Aleira,frostwolf,1318,demonhunter,havoc,58,32,26
Gigavlad,area-52,1317,demonhunter,havoc,30,14,16
Jotalejandro,quelthalas,1317,demonhunter,havoc,60,27,33
Kaelidan,kelthuzad,1316,demonhunter,havoc,111,58,53
Litzilla,thrall,1315,demonhunter,havoc,42,20,22
Nolights,area-52,1315,demonhunter,havoc,90,37,53
Sicklyslick,frostmourne,1313,demonhunter,havoc,25,15,10
Valdiran,duskwood,1312,demonhunter,havoc,71,30,41
Nurzal,malganis,1310,demonhunter,havoc,30,14,16
Nisea,malganis,1310,demonhunter,havoc,36,15,21
Sillyslayadk,moon-guard,1309,demonhunter,havoc,124,69,55
Thêpunisher,ragnaros,1309,demonhunter,havoc,124,61,63
Jibaiye,tichondrius,1309,demonhunter,havoc,30,14,16
Noctemdh,tichondrius,1309,demonhunter,havoc,69,29,40
Sashasilver,frostmourne,1308,demonhunter,havoc,33,15,18
Dömönic,illidan,1306,demonhunter,havoc,30,18,12
Ashtyr,emerald-dream,1306,demonhunter,havoc,28,16,12
Loadedtruck,frostmourne,1305,demonhunter,havoc,30,17,13
Vizionz,emerald-dream,1305,demonhunter,havoc,88,46,42
Aeonys,stormrage,1304,demonhunter,havoc,60,33,27
Tekkamanevil,tichondrius,1304,demonhunter,havoc,210,104,106
Powertaco,tichondrius,1304,demonhunter,havoc,67,31,36
Rosamune,kelthuzad,1304,demonhunter,havoc,47,18,29
Christensen,illidan,1303,demonhunter,havoc,90,50,40
Felshiv,azralon,1302,demonhunter,havoc,42,19,23
Darthmah,illidan,1300,demonhunter,havoc,42,25,17
Belial,haomarush,1299,demonhunter,havoc,54,28,26
Artemisleto,tichondrius,1299,demonhunter,havoc,42,19,23
Litan,ragnaros,1298,demonhunter,havoc,30,16,14
Halftruth,stormrage,1298,demonhunter,havoc,46,22,24
Nrpx,stormrage,1298,demonhunter,havoc,34,14,20
Thechaz,bleeding-hollow,1297,demonhunter,havoc,54,34,20
Spicywings,arthas,1297,demonhunter,havoc,60,30,30
Evros,tichondrius,1294,demonhunter,havoc,74,44,30
Revvup,tichondrius,1294,demonhunter,havoc,71,33,38
Alaron,wildhammer,1293,demonhunter,havoc,99,53,46
Naelaksa,tichondrius,1293,demonhunter,havoc,36,14,22
Thèflurry,tichondrius,1292,demonhunter,havoc,29,14,15
Silvs,illidan,1291,demonhunter,havoc,244,131,113
Mursiless,drenden,1290,demonhunter,havoc,24,15,9
Itachiix,sargeras,1289,demonhunter,havoc,36,23,13
Szei,tichondrius,1289,demonhunter,havoc,27,16,11
Chungg,laughing-skull,1287,demonhunter,havoc,30,15,15
Hawkowicz,tichondrius,1286,demonhunter,havoc,199,99,100
Amdusias,darkspear,1285,demonhunter,havoc,55,26,29
Diversityabc,bleeding-hollow,1285,demonhunter,havoc,98,44,54
Vaxs,moon-guard,1284,demonhunter,havoc,97,54,43
Durello,stormrage,1284,demonhunter,havoc,60,29,31
Siicknote,frostmourne,1284,demonhunter,havoc,29,14,15
Vwap,tichondrius,1284,demonhunter,havoc,29,14,15
Adryr,eredar,1283,demonhunter,havoc,46,27,19
Yedeme,tichondrius,1283,demonhunter,havoc,76,31,45
Killmongeer,tichondrius,1282,demonhunter,havoc,27,16,11
Facerollfel,tichondrius,1280,demonhunter,havoc,30,14,16
Onlypain,korgath,1280,demonhunter,havoc,50,22,28
Roughins,chogall,1278,demonhunter,havoc,51,28,23
Cleår,kelthuzad,1276,demonhunter,havoc,26,15,11
Sylenah,hyjal,1273,demonhunter,havoc,30,14,16
Revean,darkspear,1270,demonhunter,havoc,126,67,59
Whataboutbob,korgath,1268,demonhunter,havoc,36,14,22
Mortiria,dalaran,1267,demonhunter,havoc,67,30,37
Dakkemon,zuljin,1267,demonhunter,havoc,62,24,38
Tattedandfab,stormrage,1265,demonhunter,havoc,102,44,58
Yønkou,stormrage,1264,demonhunter,havoc,143,70,73
Fiziokratdh,ghostlands,1263,demonhunter,havoc,67,30,37
Devilspawnss,barthilas,1263,demonhunter,havoc,43,17,26
Skilla,frostmourne,1262,demonhunter,havoc,85,42,43
Wíkkihx,emerald-dream,1262,demonhunter,havoc,67,30,37
Howller,azralon,1261,demonhunter,havoc,39,18,21
Sekiro,illidan,1260,demonhunter,havoc,29,15,14
Eullz,skullcrusher,1257,demonhunter,havoc,31,14,17
Twodxoxo,kelthuzad,1256,demonhunter,havoc,24,14,10
Xà,sargeras,1256,demonhunter,havoc,36,14,22
Miroir,silvermoon,1250,demonhunter,havoc,125,58,67
Blinddh,bleeding-hollow,1249,demonhunter,havoc,32,14,18
Gosrend,durotan,1249,demonhunter,havoc,43,14,29
Mårth,caelestrasz,1248,demonhunter,havoc,48,25,23
Ilovenina,sargeras,1247,demonhunter,havoc,24,13,11
Gènji,tichondrius,1246,demonhunter,havoc,24,13,11
Raylêy,tichondrius,1246,demonhunter,havoc,24,13,11
Inkubuz,sargeras,1246,demonhunter,havoc,160,78,82
Kalikanzar,sargeras,1245,demonhunter,havoc,24,13,11
Demonthorne,illidan,1245,demonhunter,havoc,24,13,11
Demonlord,shattered-hand,1245,demonhunter,havoc,61,27,34
Rykidh,tichondrius,1245,demonhunter,havoc,30,13,17
Äòégämîñg,stormrage,1245,demonhunter,havoc,36,13,23
Alizqt,ragnaros,1244,demonhunter,havoc,24,13,11
Serb,chogall,1244,demonhunter,havoc,24,13,11
Kereses,bonechewer,1244,demonhunter,havoc,51,27,24
Mitsûri,quelthalas,1244,demonhunter,havoc,51,27,24
Hoguriders,tichondrius,1244,demonhunter,havoc,30,13,17
Baejuhyun,kiljaeden,1243,demonhunter,havoc,24,16,8
Odio,chromaggus,1243,demonhunter,havoc,24,13,11
Angelawhite,illidan,1243,demonhunter,havoc,42,20,22
Tomhenk,blackrock,1242,demonhunter,havoc,30,13,17
Decoi,tichondrius,1241,demonhunter,havoc,24,13,11
Nightwisty,azralon,1241,demonhunter,havoc,24,13,11
Kimochinchin,ragnaros,1241,demonhunter,havoc,24,13,11
Schrute,bonechewer,1241,demonhunter,havoc,36,15,21
Miltonpickle,tichondrius,1240,demonhunter,havoc,54,24,30
Cheriste,malganis,1240,demonhunter,havoc,32,14,18
Tydriedian,dalaran,1239,demonhunter,havoc,18,13,5
Missjotab,tichondrius,1239,demonhunter,havoc,24,13,11
Harû,tichondrius,1239,demonhunter,havoc,30,13,17
Zétta,area-52,1236,demonhunter,havoc,24,13,11
Thegudgud,stormrage,1236,demonhunter,havoc,24,13,11
Demonbane,moon-guard,1236,demonhunter,havoc,54,27,27
Láskó,area-52,1235,demonhunter,havoc,21,16,5
Diëgo,gallywix,1235,demonhunter,havoc,19,13,6
Strickdaddy,hyjal,1234,demonhunter,havoc,66,30,36
Maddummy,tichondrius,1234,demonhunter,havoc,30,13,17
Aflex,zuljin,1232,demonhunter,havoc,35,19,16
Mázoku,shuhalo,1232,demonhunter,havoc,32,15,17
Madblader,tichondrius,1232,demonhunter,havoc,30,13,17
Lixthing,ragnaros,1231,demonhunter,havoc,62,40,22
Sorrybadgas,illidan,1231,demonhunter,havoc,36,13,23
Chris,dreadmaul,1230,demonhunter,havoc,24,13,11
Narene,mannoroth,1230,demonhunter,havoc,51,22,29
Asmoday,warsong,1229,demonhunter,havoc,149,82,67
Inntty,barthilas,1229,demonhunter,havoc,76,38,38
Felraven,scarlet-crusade,1227,demonhunter,havoc,39,19,20
Hellrunner,magtheridon,1225,demonhunter,havoc,36,16,20
Superbug,quelthalas,1224,demonhunter,havoc,78,38,40
Trituone,ragnaros,1224,demonhunter,havoc,85,40,45
Rorac,ragnaros,1223,demonhunter,havoc,30,13,17
Pilyn,ragnaros,1222,demonhunter,havoc,110,54,56
Tezrian,earthen-ring,1221,demonhunter,havoc,24,13,11
Pokoloko,twisting-nether,1219,demonhunter,havoc,38,15,23
Raradane,illidan,1218,demonhunter,havoc,24,15,9
Shandras,dathremar,1218,demonhunter,havoc,24,13,11
Lachesix,tichondrius,1217,demonhunter,havoc,30,13,17
Devwillhuntu,barthilas,1216,demonhunter,havoc,80,42,38
Axyy,area-52,1215,demonhunter,havoc,24,14,10
Syrena,mugthol,1214,demonhunter,havoc,30,15,15
Keelin,ragnaros,1212,demonhunter,havoc,28,13,15
Joegamer,illidan,1211,demonhunter,havoc,36,17,19
Eraticdh,illidan,1211,demonhunter,havoc,30,13,17
Scarshine,frostmourne,1210,demonhunter,havoc,127,57,70
Pressinghunt,tichondrius,1209,demonhunter,havoc,23,13,10
Cursesoul,area-52,1206,demonhunter,havoc,60,31,29
Furxi,illidan,1206,demonhunter,havoc,63,28,35
Zématador,azralon,1205,demonhunter,havoc,112,57,55
Demonkratoz,ragnaros,1203,demonhunter,havoc,61,24,37
Pupupoo,tichondrius,1202,demonhunter,havoc,78,37,41
Hellspawnn,malganis,1200,demonhunter,havoc,44,24,20
Zetsuwaffles,area-52,1198,demonhunter,havoc,29,13,16
Etherëäl,stormrage,1194,demonhunter,havoc,53,32,21
Bastaghor,stormrage,1194,demonhunter,havoc,42,19,23
Fellight,bonechewer,1193,demonhunter,havoc,42,27,15
Kêydën,ragnaros,1193,demonhunter,havoc,46,27,19
Ixix,proudmoore,1192,demonhunter,havoc,62,30,32
Illidice,tichondrius,1189,demonhunter,havoc,30,13,17
Erazuz,stormrage,1188,demonhunter,havoc,30,13,17
Thelada,illidan,1187,demonhunter,havoc,33,16,17
Hævenlysinz,tichondrius,1186,demonhunter,havoc,42,15,27
Brunoqt,azralon,1185,demonhunter,havoc,29,13,16
Cyberpsycho,illidan,1184,demonhunter,havoc,30,14,16
Sleepyjobe,sargeras,1183,demonhunter,havoc,16,13,3
Tyrelara,durotan,1179,demonhunter,havoc,23,13,10
Falsewave,sargeras,1178,demonhunter,havoc,30,18,12
Glayve,emerald-dream,1178,demonhunter,havoc,85,41,44
Spamsamich,stormscale,1177,demonhunter,havoc,89,49,40
Tyindorin,gurubashi,1176,demonhunter,havoc,30,15,15
Neecro,frostmourne,1175,demonhunter,havoc,84,38,46
Aroncruel,area-52,1172,demonhunter,havoc,77,41,36
Saelila,emerald-dream,1172,demonhunter,havoc,30,13,17
Dyingslow,stormrage,1172,demonhunter,havoc,72,27,45
Buzzmezaddy,bleeding-hollow,1170,demonhunter,havoc,63,28,35
Ënky,ragnaros,1170,demonhunter,havoc,54,23,31
Gouge,hakkar,1167,demonhunter,havoc,55,30,25
Daiks,proudmoore,1166,demonhunter,havoc,48,22,26
Atsudadh,illidan,1166,demonhunter,havoc,36,13,23
Xxsozin,skullcrusher,1164,demonhunter,havoc,39,17,22
Sucubus,eredar,1161,demonhunter,havoc,48,26,22
Bzrp,stormrage,1161,demonhunter,havoc,46,24,22
Zoruv,quelthalas,1160,demonhunter,havoc,27,14,13
Twistéd,gorefiend,1158,demonhunter,havoc,24,14,10
Thedaz,frostmourne,1158,demonhunter,havoc,143,66,77
Hiddenblade,coilfang,1158,demonhunter,havoc,67,29,38
Larayedia,illidan,1156,demonhunter,havoc,24,17,7
Ozark,barthilas,1156,demonhunter,havoc,48,29,19
Xragii,kelthuzad,1152,demonhunter,havoc,24,12,12
Medusarri,frostmourne,1152,demonhunter,havoc,71,35,36
Lazygågå,zuljin,1151,demonhunter,havoc,18,12,6
Kolthis,tichondrius,1151,demonhunter,havoc,27,13,14
Adhdhdh,bloodhoof,1151,demonhunter,havoc,30,12,18
Insomdh,sargeras,1150,demonhunter,havoc,18,12,6
Painkiiller,kelthuzad,1150,demonhunter,havoc,58,32,26
Fasnk,tichondrius,1150,demonhunter,havoc,24,12,12
Nåx,bleeding-hollow,1150,demonhunter,havoc,24,12,12
Àku,area-52,1149,demonhunter,havoc,24,12,12
Elenamarth,kiljaeden,1149,demonhunter,havoc,72,31,41
Lovedem,area-52,1149,demonhunter,havoc,60,21,39
Devilkon,tichondrius,1148,demonhunter,havoc,18,12,6
Openhard,stormrage,1148,demonhunter,havoc,24,12,12
Imlikethat,gorefiend,1147,demonhunter,havoc,24,12,12
Demónio,tichondrius,1146,demonhunter,havoc,18,12,6
Luana,stormscale,1145,demonhunter,havoc,24,12,12
Aeezus,tichondrius,1145,demonhunter,havoc,30,12,18
Deemoogorgon,goldrinn,1144,demonhunter,havoc,18,12,6
Koodachicken,kul-tiras,1144,demonhunter,havoc,24,12,12
Orsova,area-52,1144,demonhunter,havoc,24,12,12
Aliniron,illidan,1143,demonhunter,havoc,32,19,13
Skinnrd,malganis,1142,demonhunter,havoc,24,12,12
Valàk,bleeding-hollow,1142,demonhunter,havoc,24,12,12
Vandeste,tichondrius,1142,demonhunter,havoc,30,12,18
Kagraxxis,stormrage,1141,demonhunter,havoc,21,13,8
Blazed,thrall,1141,demonhunter,havoc,136,66,70
Swoffordsr,tichondrius,1141,demonhunter,havoc,48,23,25
Magoroth,ragnaros,1139,demonhunter,havoc,30,20,10
Timeryus,ragnaros,1139,demonhunter,havoc,41,21,20
Irezumi,icecrown,1139,demonhunter,havoc,24,12,12
Torophz,azralon,1139,demonhunter,havoc,30,12,18
Fourbuttonsx,sargeras,1137,demonhunter,havoc,27,15,12
Këÿz,earthen-ring,1136,demonhunter,havoc,24,12,12
Vivas,tichondrius,1136,demonhunter,havoc,24,12,12
Endyr,area-52,1136,demonhunter,havoc,25,12,13
Ovèrrated,area-52,1134,demonhunter,havoc,90,40,50
Tayel,emerald-dream,1133,demonhunter,havoc,34,19,15
Dameon,wildhammer,1133,demonhunter,havoc,90,48,42
Keigna,tichondrius,1132,demonhunter,havoc,18,12,6
Worcraf,ragnaros,1132,demonhunter,havoc,38,16,22
Dandreb,draenor,1130,demonhunter,havoc,29,15,14
Diddlemethis,nagrand,1127,demonhunter,havoc,24,13,11
Jennesis,tichondrius,1126,demonhunter,havoc,78,36,42
Momysimpypoo,tichondrius,1125,demonhunter,havoc,18,12,6
Ibeatrix,malorne,1124,demonhunter,havoc,24,18,6
Flyingsky,tichondrius,1121,demonhunter,havoc,24,14,10
Elfofura,azralon,1121,demonhunter,havoc,76,30,46
Attritionx,sargeras,1118,demonhunter,havoc,23,13,10
Zizi,ghostlands,1117,demonhunter,havoc,62,33,29
Llrebelionll,stormrage,1113,demonhunter,havoc,18,12,6
Overwatch,gundrak,1112,demonhunter,havoc,27,15,12
Akalitethi,moon-guard,1110,demonhunter,havoc,48,17,31
Demonslaier,dragonblight,1109,demonhunter,havoc,38,20,18
Weedeaterr,arthas,1109,demonhunter,havoc,48,14,34
Dennfear,skullcrusher,1104,demonhunter,havoc,30,17,13
Jënesis,illidan,1104,demonhunter,havoc,92,44,48
Proserpinâ,bleeding-hollow,1103,demonhunter,havoc,60,23,37
Minar,tichondrius,1102,demonhunter,havoc,21,13,8
Annabow,moon-guard,1098,demonhunter,havoc,138,76,62
Lovekills,tichondrius,1098,demonhunter,havoc,24,12,12
Foodtruck,hellscream,1095,demonhunter,havoc,23,13,10
Imjustbad,malganis,1091,demonhunter,havoc,48,27,21
Bogged,emerald-dream,1091,demonhunter,havoc,27,12,15
Sätän,malganis,1089,demonhunter,havoc,24,13,11
Nemoj,hellscream,1088,demonhunter,havoc,30,18,12
Feltini,whisperwind,1085,demonhunter,havoc,23,12,11
Lilliåna,kiljaeden,1085,demonhunter,havoc,56,24,32
Kelmar,stormreaver,1084,demonhunter,havoc,32,12,20
Moxí,ragnaros,1082,demonhunter,havoc,36,19,17
Spicyblades,stormrage,1081,demonhunter,havoc,59,28,31
Xonu,sargeras,1077,demonhunter,havoc,22,12,10
Bhuppz,frostmourne,1076,demonhunter,havoc,22,12,10
Nixsa,area-52,1073,demonhunter,havoc,84,37,47
Dirtyvitus,gorefiend,1072,demonhunter,havoc,36,24,12
Kazadin,azralon,1072,demonhunter,havoc,76,33,43
Portgaes,ragnaros,1071,demonhunter,havoc,53,15,38
Esomet,stormrage,1070,demonhunter,havoc,27,15,12
Gravelot,quelthalas,1066,demonhunter,havoc,71,31,40
Skógarmaðr,garrosh,1060,demonhunter,havoc,38,19,19
Faalleen,quelthalas,1059,demonhunter,havoc,18,12,6
Syrine,veknilash,1059,demonhunter,havoc,72,41,31
Illadra,fizzcrank,1058,demonhunter,havoc,23,12,11
Shakah,dragonmaw,1056,demonhunter,havoc,18,11,7
Thegoph,bleeding-hollow,1056,demonhunter,havoc,24,11,13
Fiveiq,malganis,1055,demonhunter,havoc,18,11,7
Fëlla,tanaris,1055,demonhunter,havoc,18,11,7
Zztzz,illidan,1055,demonhunter,havoc,18,11,7
Qualitycaulk,tichondrius,1055,demonhunter,havoc,18,11,7
Feliodas,tichondrius,1055,demonhunter,havoc,24,11,13
Íllidan,stormrage,1055,demonhunter,havoc,24,11,13
Gogungho,tichondrius,1055,demonhunter,havoc,24,11,13
Ravack,stormrage,1054,demonhunter,havoc,18,11,7
Ariaxy,sargeras,1054,demonhunter,havoc,18,11,7
Thumôss,malganis,1054,demonhunter,havoc,18,11,7
Koverage,frostmourne,1054,demonhunter,havoc,18,11,7
Bümb,moon-guard,1054,demonhunter,havoc,24,11,13
Behemod,thrall,1054,demonhunter,havoc,24,11,13
Babahorns,dalaran,1054,demonhunter,havoc,30,11,19
Hávok,sargeras,1054,demonhunter,havoc,31,11,20
Agsakim,tichondrius,1053,demonhunter,havoc,18,11,7
Xavid,bleeding-hollow,1053,demonhunter,havoc,24,11,13
Cedicdh,illidan,1053,demonhunter,havoc,24,11,13
Thedee,emerald-dream,1053,demonhunter,havoc,30,11,19
Batorr,sargeras,1053,demonhunter,havoc,36,11,25
Trindh,thrall,1052,demonhunter,havoc,18,11,7
Tywín,illidan,1052,demonhunter,havoc,24,11,13
Shinitakunai,area-52,1052,demonhunter,havoc,30,11,19
Messenoire,area-52,1051,demonhunter,havoc,26,11,15
Loathy,tichondrius,1050,demonhunter,havoc,18,11,7
Sammyvicious,tichondrius,1049,demonhunter,havoc,16,12,4
Ønsen,tichondrius,1049,demonhunter,havoc,29,11,18
Zergedh,kiljaeden,1049,demonhunter,havoc,30,11,19
Vuse,moon-guard,1048,demonhunter,havoc,24,11,13
Covoth,bleeding-hollow,1048,demonhunter,havoc,27,12,15
Faster,tichondrius,1048,demonhunter,havoc,30,11,19
Winlegend,gallywix,1048,demonhunter,havoc,32,11,21
Ogmon,tichondrius,1047,demonhunter,havoc,18,11,7
Legäult,bleeding-hollow,1047,demonhunter,havoc,33,17,16
Hugehogger,boulderfist,1047,demonhunter,havoc,24,11,13
Madatya,black-dragonflight,1047,demonhunter,havoc,24,11,13
Cðnstantine,barthilas,1047,demonhunter,havoc,24,11,13
Callux,black-dragonflight,1047,demonhunter,havoc,30,11,19
Rewyle,magtheridon,1047,demonhunter,havoc,36,11,25
Midewdh,proudmoore,1046,demonhunter,havoc,24,11,13
Taters,gorefiend,1045,demonhunter,havoc,18,11,7
Jámès,area-52,1045,demonhunter,havoc,24,11,13
Throniren,stormrage,1044,demonhunter,havoc,24,11,13
Xanthee,drakkari,1043,demonhunter,havoc,81,41,40
Darkglaive,ragnaros,1042,demonhunter,havoc,24,11,13
Misfortune,bloodscalp,1042,demonhunter,havoc,72,32,40
Rickinmorty,lightnings-blade,1041,demonhunter,havoc,19,11,8
Misriah,sargeras,1039,demonhunter,havoc,30,11,19
Aedice,gurubashi,1038,demonhunter,havoc,24,11,13
Rauwèrs,azralon,1037,demonhunter,havoc,18,11,7
Ghostzface,sargeras,1037,demonhunter,havoc,73,37,36
Rhaast,executus,1035,demonhunter,havoc,79,35,44
Blckreaper,area-52,1032,demonhunter,havoc,24,11,13
Mindburn,shadowmoon,1031,demonhunter,havoc,29,19,10
Felbòy,korgath,1029,demonhunter,havoc,24,11,13
Hentaidemon,kiljaeden,1023,demonhunter,havoc,36,18,18
Darkweast,dalaran,1021,demonhunter,havoc,24,11,13
Veridax,quelthalas,1014,demonhunter,havoc,18,11,7
Pegásus,kiljaeden,1010,demonhunter,havoc,16,11,5
Eikichi,bleeding-hollow,1009,demonhunter,havoc,54,26,28
Chronicsmoke,blood-furnace,1008,demonhunter,havoc,36,16,20
Catfood,icecrown,1008,demonhunter,havoc,27,11,16
Chirõn,moonrunner,1007,demonhunter,havoc,23,11,12
Quinny,runetotem,1006,demonhunter,havoc,21,12,9
Seamenhunter,garrosh,1004,demonhunter,havoc,24,12,12
Blops,emerald-dream,1001,demonhunter,havoc,51,27,24
Sourlime,stormrage,1001,demonhunter,havoc,29,11,18
Cuint,barthilas,999,demonhunter,havoc,42,22,20
Midnightlord,tichondrius,996,demonhunter,havoc,24,16,8
Funspunk,nagrand,995,demonhunter,havoc,42,11,31
Atomicsorrow,tichondrius,991,demonhunter,havoc,22,11,11
Nécô,tichondrius,987,demonhunter,havoc,26,11,15
Lüky,malganis,986,demonhunter,havoc,22,11,11
Suhui,sargeras,983,demonhunter,havoc,29,11,18
Ethelric,frostmourne,982,demonhunter,havoc,83,30,53
Doomhead,burning-legion,981,demonhunter,havoc,24,15,9
Keeblerself,tichondrius,979,demonhunter,havoc,30,16,14
Dbljump,kiljaeden,979,demonhunter,havoc,32,11,21
Grûnt,sargeras,978,demonhunter,havoc,30,12,18
Andarïel,bleeding-hollow,977,demonhunter,havoc,25,12,13
Clorhídrico,quelthalas,975,demonhunter,havoc,98,48,50
Purpsquirter,stormscale,974,demonhunter,havoc,39,20,19
Jerrickah,skullcrusher,967,demonhunter,havoc,26,11,15
Cercius,dalaran,966,demonhunter,havoc,36,11,25
Vladdtepes,cairne,964,demonhunter,havoc,113,60,53
Hypetraindh,kelthuzad,960,demonhunter,havoc,12,10,2
Slayup,area-52,960,demonhunter,havoc,12,10,2
Doomsday,kargath,960,demonhunter,havoc,12,10,2
Noopstop,tichondrius,960,demonhunter,havoc,18,10,8
Lancee,zuljin,960,demonhunter,havoc,24,10,14
Roesh,amanthul,960,demonhunter,havoc,24,10,14
Ntts,tichondrius,960,demonhunter,havoc,24,10,14
Theownz,stormrage,959,demonhunter,havoc,18,10,8
Demonleap,proudmoore,959,demonhunter,havoc,18,10,8
Sourapple,barthilas,959,demonhunter,havoc,18,10,8
Lakedemon,sargeras,959,demonhunter,havoc,18,10,8
Myelvénlady,shattered-hand,959,demonhunter,havoc,18,10,8
Thrania,lothar,959,demonhunter,havoc,24,10,14
Misakidh,sargeras,959,demonhunter,havoc,24,10,14
Dhuck,nemesis,959,demonhunter,havoc,27,11,16
Khaodemus,kaelthas,958,demonhunter,havoc,12,10,2
Cyånan,bleeding-hollow,958,demonhunter,havoc,23,14,9
Çherrii,moon-guard,958,demonhunter,havoc,36,21,15
Planeinsky,malganis,958,demonhunter,havoc,18,10,8
Bronaanas,tichondrius,958,demonhunter,havoc,18,10,8
Nightshadeia,tichondrius,958,demonhunter,havoc,30,10,20
Krelious,barthilas,957,demonhunter,havoc,18,10,8
Mybraintiny,illidan,957,demonhunter,havoc,21,11,10
Randôm,kelthuzad,957,demonhunter,havoc,21,11,10
Giantryhard,tichondrius,957,demonhunter,havoc,24,10,14
Gilberte,stormrage,957,demonhunter,havoc,24,10,14
Vishì,thrall,957,demonhunter,havoc,30,10,20
Finelsite,area-52,956,demonhunter,havoc,18,10,8
Tangoh,burning-legion,955,demonhunter,havoc,18,10,8
Adycatt,illidan,955,demonhunter,havoc,18,10,8
Sorrenta,ragnaros,955,demonhunter,havoc,21,11,10
Jagidan,area-52,955,demonhunter,havoc,24,10,14
Khatary,ragnaros,954,demonhunter,havoc,24,10,14
Xibir,amanthul,953,demonhunter,havoc,24,10,14
Onigirix,area-52,953,demonhunter,havoc,27,11,16
Larnol,moon-guard,952,demonhunter,havoc,18,10,8
Nerco,bleeding-hollow,952,demonhunter,havoc,24,10,14
Vognum,quelthalas,951,demonhunter,havoc,21,11,10
Airaxx,moon-guard,949,demonhunter,havoc,21,11,10
Bukwheat,thunderhorn,949,demonhunter,havoc,84,41,43
Letzgobrandn,silvermoon,948,demonhunter,havoc,18,10,8
Kwoop,tichondrius,946,demonhunter,havoc,24,10,14
Halfprepared,kelthuzad,946,demonhunter,havoc,30,10,20
Demonizhe,thrall,944,demonhunter,havoc,43,22,21
Elurandre,moon-guard,944,demonhunter,havoc,23,10,13
Swansong,norgannon,944,demonhunter,havoc,30,13,17
Rissélys,thrall,942,demonhunter,havoc,36,20,16
Lingnafoxy,tichondrius,939,demonhunter,havoc,27,11,16
Deegsdh,sargeras,932,demonhunter,havoc,27,10,17
Clairconctla,spirestone,929,demonhunter,havoc,81,34,47
Gozer,korialstrasz,929,demonhunter,havoc,36,12,24
Lillidum,azralon,927,demonhunter,havoc,47,22,25
Demonshep,proudmoore,925,demonhunter,havoc,22,10,12
Frenchtoast,bonechewer,925,demonhunter,havoc,30,10,20
Allukya,azralon,924,demonhunter,havoc,17,10,7
Shawnchad,blood-furnace,923,demonhunter,havoc,181,90,91
Lanathir,kirin-tor,919,demonhunter,havoc,30,11,19
Troigh,thunderlord,912,demonhunter,havoc,60,29,31
Aleymar,tichondrius,909,demonhunter,havoc,24,12,12
Lory,eldrethalas,909,demonhunter,havoc,72,33,39
Kslicedevil,dalaran,909,demonhunter,havoc,72,31,41
Sitarok,drakkari,899,demonhunter,havoc,28,11,17
Falaszun,aegwynn,889,demonhunter,havoc,20,10,10
Tygerion,emerald-dream,885,demonhunter,havoc,22,10,12
Creta,frostmourne,882,demonhunter,havoc,24,13,11
Callmerebel,dragonblight,881,demonhunter,havoc,38,17,21
Ripchimmii,illidan,880,demonhunter,havoc,25,10,15
Andyhunter,emerald-dream,879,demonhunter,havoc,90,45,45
Blacktocki,barthilas,878,demonhunter,havoc,22,10,12
Äshês,blackhand,876,demonhunter,havoc,20,10,10
Mikiller,thrall,873,demonhunter,havoc,127,62,65
Lrianna,senjin,870,demonhunter,havoc,23,10,13
Riicardo,ragnaros,870,demonhunter,havoc,28,12,16
Faarkyou,barthilas,868,demonhunter,havoc,26,10,16
Plsbegood,area-52,864,demonhunter,havoc,12,9,3
Ravevê,area-52,864,demonhunter,havoc,12,9,3
Cynthadra,frostmourne,864,demonhunter,havoc,12,9,3
Banaphel,hellscream,864,demonhunter,havoc,12,9,3
Pennyx,barthilas,864,demonhunter,havoc,12,9,3
Dzdh,stormrage,864,demonhunter,havoc,18,9,9
Tarro,whisperwind,864,demonhunter,havoc,18,9,9
Benová,tichondrius,864,demonhunter,havoc,18,9,9
Bammski,tichondrius,864,demonhunter,havoc,18,9,9
Vandämn,barthilas,864,demonhunter,havoc,18,9,9
Emicruz,quelthalas,864,demonhunter,havoc,18,9,9
Artee,illidan,864,demonhunter,havoc,22,10,12
Gameoverz,tichondrius,864,demonhunter,havoc,21,9,12
Kronicz,frostmourne,864,demonhunter,havoc,24,9,15
Paypaldh,malganis,864,demonhunter,havoc,24,9,15
Noobender,malganis,864,demonhunter,havoc,30,9,21
Mcgurty,illidan,864,demonhunter,havoc,30,9,21
Ripidan,stormrage,864,demonhunter,havoc,30,9,21
Furíøus,tichondrius,863,demonhunter,havoc,12,9,3
Ottie,kelthuzad,863,demonhunter,havoc,12,9,3
Luthianna,amanthul,863,demonhunter,havoc,12,9,3
Rothdh,tichondrius,863,demonhunter,havoc,15,10,5
Llivid,area-52,863,demonhunter,havoc,18,9,9
Jiawen,barthilas,863,demonhunter,havoc,18,9,9
Lördvïngadør,azralon,863,demonhunter,havoc,18,9,9
Mondwin,kelthuzad,863,demonhunter,havoc,18,9,9
Orosz,bleeding-hollow,863,demonhunter,havoc,18,9,9
Dogcleave,area-52,863,demonhunter,havoc,18,9,9
Nismoos,daggerspine,863,demonhunter,havoc,18,9,9
Worldahmelee,illidan,863,demonhunter,havoc,18,9,9
Shaydh,frostmourne,863,demonhunter,havoc,18,9,9
Soñic,frostmourne,863,demonhunter,havoc,18,9,9
Checkmate,bleeding-hollow,863,demonhunter,havoc,24,9,15
Dragynfíst,malganis,863,demonhunter,havoc,30,9,21
Vareon,nesingwary,862,demonhunter,havoc,12,9,3
Trenbolognie,illidan,862,demonhunter,havoc,18,9,9
Lucipur,thrall,862,demonhunter,havoc,18,9,9
Rizzle,malganis,862,demonhunter,havoc,18,9,9
Dishdash,agamaggan,862,demonhunter,havoc,18,9,9
Vida,winterhoof,862,demonhunter,havoc,18,9,9
Moranah,tichondrius,862,demonhunter,havoc,18,9,9
Valeriya,frostmourne,862,demonhunter,havoc,24,9,15
Kickabout,deathwing,862,demonhunter,havoc,24,9,15
Felhunt,ragnaros,861,demonhunter,havoc,24,9,15
Psicxs,ragnaros,861,demonhunter,havoc,24,9,15
Frostidan,sargeras,861,demonhunter,havoc,24,9,15
Hellboss,dalaran,860,demonhunter,havoc,12,9,3
Zirrey,stormrage,860,demonhunter,havoc,18,9,9
Bodemön,stormrage,860,demonhunter,havoc,18,9,9
Unóhana,drakkari,860,demonhunter,havoc,18,9,9
Rèlentless,moon-guard,860,demonhunter,havoc,18,9,9
Successful,area-52,860,demonhunter,havoc,24,9,15
Alphmega,malganis,859,demonhunter,havoc,18,9,9
Smokahontas,eredar,859,demonhunter,havoc,18,9,9
Bigbubbaa,azgalor,859,demonhunter,havoc,24,9,15
Diizy,illidan,858,demonhunter,havoc,18,9,9
Itsskaa,illidan,858,demonhunter,havoc,24,9,15
Dartanyn,tichondrius,853,demonhunter,havoc,24,9,15
Drackista,stormrage,852,demonhunter,havoc,18,9,9
Tdmturbo,zuluhed,849,demonhunter,havoc,18,9,9
Sharinne,frostmourne,849,demonhunter,havoc,24,9,15
Jakodh,sargeras,848,demonhunter,havoc,18,9,9
Kellndore,emerald-dream,848,demonhunter,havoc,54,26,28
Aussiepleb,nagrand,846,demonhunter,havoc,87,37,50
Ryutt,illidan,845,demonhunter,havoc,18,9,9
Dalmandra,arthas,841,demonhunter,havoc,17,9,8
Syldaeya,silvermoon,838,demonhunter,havoc,22,11,11
Abusedchild,dalaran,837,demonhunter,havoc,36,16,20
Funky,draenor,832,demonhunter,havoc,36,18,18
Fckyouscott,illidan,830,demonhunter,havoc,14,10,4
Toteschatte,quelthalas,829,demonhunter,havoc,30,10,20
Necrødh,tichondrius,828,demonhunter,havoc,16,9,7
Amneshia,ragnaros,828,demonhunter,havoc,18,9,9
Romïna,quelthalas,827,demonhunter,havoc,24,10,14
Negraxo,ragnaros,818,demonhunter,havoc,29,9,20
Myname,aggramar,818,demonhunter,havoc,62,15,47
Chabashira,tichondrius,815,demonhunter,havoc,24,9,15
Cassiedemonh,tichondrius,815,demonhunter,havoc,27,10,17
Healinfubar,stormrage,814,demonhunter,havoc,15,10,5
Pariah,saurfang,813,demonhunter,havoc,17,9,8
Antistar,emerald-dream,799,demonhunter,havoc,26,9,17
Demonci,stormrage,795,demonhunter,havoc,20,11,9
Anaríel,quelthalas,788,demonhunter,havoc,30,9,21
Jellehx,frostmourne,784,demonhunter,havoc,13,9,4
Grolschen,proudmoore,784,demonhunter,havoc,42,16,26
Nasolar,illidan,783,demonhunter,havoc,17,9,8
Wut,nemesis,777,demonhunter,havoc,101,47,54
Rza,dreadmaul,774,demonhunter,havoc,28,11,17
Msbadass,demon-soul,773,demonhunter,havoc,25,9,16
Neshaan,stormreaver,770,demonhunter,havoc,48,24,24
Ðamageinc,emerald-dream,768,demonhunter,havoc,12,8,4
Revzxy,dalaran,768,demonhunter,havoc,12,8,4
Thickgary,illidan,768,demonhunter,havoc,12,8,4
Deuzz,arthas,768,demonhunter,havoc,12,8,4
Mesidan,illidan,768,demonhunter,havoc,12,8,4
Helltaker,blood-furnace,768,demonhunter,havoc,12,8,4
Surkkdh,tichondrius,768,demonhunter,havoc,12,8,4
Squaller,tichondrius,768,demonhunter,havoc,12,8,4
Dulcibella,tichondrius,768,demonhunter,havoc,12,8,4
Liarsenics,tichondrius,768,demonhunter,havoc,12,8,4
Humanitydh,sargeras,768,demonhunter,havoc,12,8,4
Thugonomicz,tichondrius,768,demonhunter,havoc,12,8,4
Doomanone,sargeras,768,demonhunter,havoc,12,8,4
Vàin,ragnaros,768,demonhunter,havoc,12,8,4
Ùnlucky,tichondrius,768,demonhunter,havoc,12,8,4
Cálýpsó,tichondrius,768,demonhunter,havoc,12,8,4
Kalachiquez,sargeras,768,demonhunter,havoc,12,8,4
Lxg,kelthuzad,768,demonhunter,havoc,12,8,4
Odemy,area-52,768,demonhunter,havoc,12,8,4
Hollowxo,tichondrius,768,demonhunter,havoc,12,8,4
Cegocruel,sargeras,768,demonhunter,havoc,13,8,5
Pub,the-scryers,768,demonhunter,havoc,15,9,6
Sero,malganis,768,demonhunter,havoc,18,8,10
Veilmaya,arthas,768,demonhunter,havoc,18,8,10
Everdh,barthilas,768,demonhunter,havoc,18,8,10
Gilarian,stormrage,768,demonhunter,havoc,18,8,10
Devssimpspec,sargeras,768,demonhunter,havoc,18,8,10
Fingól,ragnaros,768,demonhunter,havoc,18,8,10
Zuppashi,area-52,768,demonhunter,havoc,18,8,10
Neverblurx,kirin-tor,768,demonhunter,havoc,18,8,10
Doomantwo,sargeras,768,demonhunter,havoc,24,8,16
Bdwxxnmm,tichondrius,768,demonhunter,havoc,24,8,16
Xorothia,moon-guard,768,demonhunter,havoc,24,8,16
Fuujiin,tol-barad,768,demonhunter,havoc,24,8,16
Diemonic,drakkari,767,demonhunter,havoc,12,8,4
Blackblades,blackhand,767,demonhunter,havoc,12,8,4
Prazethesun,emerald-dream,767,demonhunter,havoc,12,8,4
Friel,magtheridon,767,demonhunter,havoc,12,8,4
Myspyhu,malganis,767,demonhunter,havoc,12,8,4
Zaelos,tichondrius,767,demonhunter,havoc,12,8,4
Badwurd,sargeras,767,demonhunter,havoc,12,8,4
Ziyàl,vashj,767,demonhunter,havoc,12,8,4
Hellrazer,area-52,767,demonhunter,havoc,12,8,4
Iyren,sargeras,767,demonhunter,havoc,12,8,4
Lethalblows,darkspear,767,demonhunter,havoc,15,9,6
Linedori,destromath,767,demonhunter,havoc,16,9,7
Devî,ragnaros,767,demonhunter,havoc,18,8,10
Demonqt,blackrock,767,demonhunter,havoc,18,8,10
Oddlysimple,korgath,767,demonhunter,havoc,18,8,10
Ozaiï,tichondrius,767,demonhunter,havoc,18,8,10
ßonècrushèr,tichondrius,767,demonhunter,havoc,18,8,10
Crtiicosdh,madoran,767,demonhunter,havoc,18,8,10
Feldumper,illidan,767,demonhunter,havoc,18,8,10
Xenosa,kiljaeden,767,demonhunter,havoc,18,8,10
Acclimate,aggramar,767,demonhunter,havoc,18,8,10
Eithelyrana,moon-guard,767,demonhunter,havoc,18,8,10
Dhfaceguy,agamaggan,767,demonhunter,havoc,18,8,10
Blurnomnom,bleeding-hollow,767,demonhunter,havoc,18,8,10
Hellrazer,azgalor,767,demonhunter,havoc,18,8,10
Chkclapper,kelthuzad,767,demonhunter,havoc,18,8,10
Kruptikos,tichondrius,767,demonhunter,havoc,18,8,10
Draagee,lothar,767,demonhunter,havoc,21,9,12
Zradda,zuljin,767,demonhunter,havoc,24,8,16
Andein,dalaran,766,demonhunter,havoc,12,8,4
Wólff,azralon,766,demonhunter,havoc,12,8,4
Thunderrbolt,illidan,766,demonhunter,havoc,12,8,4
Hyperaids,sargeras,766,demonhunter,havoc,18,8,10
Thalkituun,sargeras,766,demonhunter,havoc,18,8,10
Touchofchaos,dragonblight,766,demonhunter,havoc,18,8,10
Ezuna,proudmoore,766,demonhunter,havoc,18,8,10
Accipiter,ragnaros,766,demonhunter,havoc,24,8,16
Shadowdark,aggramar,766,demonhunter,havoc,24,8,16
Moorzans,malganis,765,demonhunter,havoc,12,8,4
Bholez,illidan,765,demonhunter,havoc,18,8,10
Detrox,ragnaros,765,demonhunter,havoc,18,8,10
Uchulu,quelthalas,765,demonhunter,havoc,24,8,16
Lû,arthas,765,demonhunter,havoc,24,8,16
Schishkabob,archimonde,764,demonhunter,havoc,18,8,10
Sodiaksd,quelthalas,762,demonhunter,havoc,18,8,10
Gentlesoap,blackrock,762,demonhunter,havoc,18,8,10
Ceried,moon-guard,761,demonhunter,havoc,19,9,10
Wargeneral,illidan,760,demonhunter,havoc,18,8,10
Breezoo,tichondrius,759,demonhunter,havoc,12,8,4
Akumahanta,aegwynn,759,demonhunter,havoc,12,8,4
Felbottom,tichondrius,759,demonhunter,havoc,14,8,6
Illhuntya,bonechewer,758,demonhunter,havoc,18,8,10
Suyu,ragnaros,758,demonhunter,havoc,21,8,13
Maydemon,ragnaros,757,demonhunter,havoc,30,8,22
Teethdaggers,wyrmrest-accord,756,demonhunter,havoc,12,8,4
Eksorcism,muradin,755,demonhunter,havoc,12,8,4
Rrochy,tichondrius,755,demonhunter,havoc,18,8,10
Covidneitor,drakkari,752,demonhunter,havoc,24,8,16
Bckzy,malygos,751,demonhunter,havoc,18,8,10
Sammblorqt,illidan,751,demonhunter,havoc,36,8,28
Menadori,madoran,748,demonhunter,havoc,18,8,10
Ottonashii,ragnaros,741,demonhunter,havoc,32,8,24
Leg,scilla,736,demonhunter,havoc,22,8,14
Elena,the-underbog,735,demonhunter,havoc,16,8,8
Ryoga,malganis,734,demonhunter,havoc,15,9,6
Wuya,thrall,734,demonhunter,havoc,22,8,14
Valeriann,thunderlord,721,demonhunter,havoc,22,11,11
Hiresol,emerald-dream,719,demonhunter,havoc,11,8,3
Sephmilli,azralon,713,demonhunter,havoc,27,9,18
Pupariuh,illidan,706,demonhunter,havoc,25,9,16
Rivent,dethecus,702,demonhunter,havoc,26,8,18
Memoryleaky,proudmoore,696,demonhunter,havoc,11,8,3
Verå,tichondrius,672,demonhunter,havoc,12,7,5
Zanoxis,tichondrius,672,demonhunter,havoc,12,7,5
Ocão,azralon,672,demonhunter,havoc,12,7,5
Danyohl,kelthuzad,672,demonhunter,havoc,12,7,5
Evelynee,illidan,672,demonhunter,havoc,12,7,5
Hydrocodeine,moon-guard,672,demonhunter,havoc,12,7,5
Smallsuper,azralon,672,demonhunter,havoc,12,7,5
Nichidah,illidan,672,demonhunter,havoc,12,7,5
Endofdaysx,tichondrius,672,demonhunter,havoc,12,7,5
Xenious,terokkar,672,demonhunter,havoc,12,7,5
Dæl,quelthalas,672,demonhunter,havoc,12,7,5
Solbiz,tichondrius,672,demonhunter,havoc,12,7,5
Warassassin,stormrage,672,demonhunter,havoc,12,7,5
Levail,wyrmrest-accord,672,demonhunter,havoc,12,7,5
Dimônio,stormrage,672,demonhunter,havoc,12,7,5
Dryback,illidan,672,demonhunter,havoc,12,7,5
Reddh,bleeding-hollow,672,demonhunter,havoc,12,7,5
Dabsfordayz,zuluhed,672,demonhunter,havoc,12,7,5
Stalaias,madoran,672,demonhunter,havoc,12,7,5
Slaarky,malganis,672,demonhunter,havoc,12,7,5
Vichopan,tichondrius,672,demonhunter,havoc,12,7,5
Deeploss,malganis,672,demonhunter,havoc,12,7,5
Uncledonnie,tanaris,672,demonhunter,havoc,12,7,5
Darthwhorë,frostmane,672,demonhunter,havoc,12,7,5
Nightcráwler,malganis,672,demonhunter,havoc,12,7,5
Bq,feathermoon,672,demonhunter,havoc,12,7,5
Igotdc,tichondrius,672,demonhunter,havoc,13,7,6
Flamehunter,durotan,672,demonhunter,havoc,13,7,6
Darkterrôr,sargeras,672,demonhunter,havoc,15,8,7
Phillswift,tichondrius,672,demonhunter,havoc,18,7,11
Vorlimornd,illidan,672,demonhunter,havoc,18,7,11
Foxfighter,thrall,672,demonhunter,havoc,18,7,11
Elchapotko,tichondrius,672,demonhunter,havoc,18,7,11
Machx,illidan,672,demonhunter,havoc,18,7,11
Emodan,moon-guard,672,demonhunter,havoc,18,7,11
Dgj,kelthuzad,672,demonhunter,havoc,18,7,11
Cheezitzz,tichondrius,672,demonhunter,havoc,18,7,11
Yasuo,moon-guard,672,demonhunter,havoc,18,7,11
Louferrigno,zuljin,672,demonhunter,havoc,18,7,11
Zózo,bleeding-hollow,672,demonhunter,havoc,18,7,11
Blanky,shadowmoon,672,demonhunter,havoc,18,7,11
Moistybreeze,frostmourne,672,demonhunter,havoc,18,7,11
Pantyogurt,frostmourne,672,demonhunter,havoc,18,7,11
Faceurdemons,frostmourne,672,demonhunter,havoc,18,7,11
Dumbledor,stonemaul,672,demonhunter,havoc,18,7,11
Boonchux,frostmourne,672,demonhunter,havoc,18,7,11
Demonchild,azralon,672,demonhunter,havoc,18,7,11
Dartro,tichondrius,672,demonhunter,havoc,20,7,13
Logixdh,tichondrius,672,demonhunter,havoc,30,7,23
Ellguindh,malganis,672,demonhunter,havoc,30,7,23
Fiebzz,queldorei,671,demonhunter,havoc,12,7,5
Wìnchester,durotan,671,demonhunter,havoc,12,7,5
Wheytoohigh,area-52,671,demonhunter,havoc,12,7,5
Cascadingeye,emerald-dream,671,demonhunter,havoc,12,7,5
Alycina,wyrmrest-accord,671,demonhunter,havoc,12,7,5
Jolty,stormrage,671,demonhunter,havoc,12,7,5
Wìtchblades,tichondrius,671,demonhunter,havoc,12,7,5
Relaxnerdss,bleeding-hollow,671,demonhunter,havoc,12,7,5
Moredread,sargeras,671,demonhunter,havoc,12,7,5
Mavrii,executus,671,demonhunter,havoc,12,7,5
Ivalerà,thrall,671,demonhunter,havoc,12,7,5
Seabisciut,silvermoon,671,demonhunter,havoc,12,7,5
Zarroe,stormrage,671,demonhunter,havoc,12,7,5
Dhameer,tichondrius,671,demonhunter,havoc,12,7,5
Stormville,illidan,671,demonhunter,havoc,12,7,5
Starianor,proudmoore,671,demonhunter,havoc,16,9,7
Furfur,undermine,671,demonhunter,havoc,16,7,9
Sreedhar,stormrage,671,demonhunter,havoc,18,7,11
Causinghavoc,dalaran,671,demonhunter,havoc,18,7,11
Haax,azralon,671,demonhunter,havoc,18,7,11
Älönë,thrall,671,demonhunter,havoc,18,7,11
Nicòrobin,dalaran,671,demonhunter,havoc,18,7,11
Sektõr,dalaran,671,demonhunter,havoc,18,7,11
Hyphonìc,area-52,671,demonhunter,havoc,18,7,11
Asamir,ragnaros,671,demonhunter,havoc,19,7,12
Veryaverage,kelthuzad,671,demonhunter,havoc,24,7,17
Ãstoreth,quelthalas,670,demonhunter,havoc,12,7,5
Renshear,cenarius,670,demonhunter,havoc,12,7,5
Shwagxnugz,area-52,670,demonhunter,havoc,12,7,5
Aphy,thunderhorn,670,demonhunter,havoc,18,7,11
Mattdaemun,korgath,670,demonhunter,havoc,18,7,11
Zanaiahs,sargeras,670,demonhunter,havoc,21,7,14
Claudija,frostmourne,669,demonhunter,havoc,12,7,5
Kylíejennêr,gilneas,669,demonhunter,havoc,12,7,5
Stepbroseph,kiljaeden,669,demonhunter,havoc,15,8,7
Spikehed,area-52,669,demonhunter,havoc,24,7,17
Denjii,malganis,669,demonhunter,havoc,24,7,17
Demonbanter,emerald-dream,668,demonhunter,havoc,15,8,7
Irìs,blood-furnace,668,demonhunter,havoc,24,7,17
Pimm,kelthuzad,667,demonhunter,havoc,12,7,5
Bgeames,area-52,667,demonhunter,havoc,12,7,5
Snòòp,uldaman,667,demonhunter,havoc,12,7,5
Haterad,bonechewer,667,demonhunter,havoc,24,7,17
Gretadumberg,area-52,666,demonhunter,havoc,12,7,5
Onoky,cairne,666,demonhunter,havoc,18,7,11
Rahgoul,garrosh,666,demonhunter,havoc,18,7,11
Sanllish,illidan,666,demonhunter,havoc,18,7,11
Endoshiva,icecrown,666,demonhunter,havoc,18,7,11
Genifer,norgannon,665,demonhunter,havoc,12,7,5
Pvpchump,malygos,665,demonhunter,havoc,18,7,11
Pradaboi,tichondrius,665,demonhunter,havoc,30,7,23
Turbochadbro,spirestone,663,demonhunter,havoc,15,8,7
Chohpz,silvermoon,662,demonhunter,havoc,19,8,11
Rhydonx,korgath,662,demonhunter,havoc,18,7,11
Whitexheart,illidan,661,demonhunter,havoc,12,7,5
Eckerstrom,tichondrius,659,demonhunter,havoc,12,7,5
Supremetaco,stormrage,659,demonhunter,havoc,12,7,5
Malrax,drakkari,658,demonhunter,havoc,18,7,11
Luzev,thrall,657,demonhunter,havoc,12,7,5
Veierax,azralon,656,demonhunter,havoc,18,7,11
Ripperxx,zuljin,653,demonhunter,havoc,18,7,11
Lëif,stormrage,652,demonhunter,havoc,18,7,11
Forzaken,darkspear,647,demonhunter,havoc,18,7,11
Gwîlym,area-52,644,demonhunter,havoc,14,9,5
Darkrais,sargeras,635,demonhunter,havoc,17,7,10
Bliqué,emerald-dream,633,demonhunter,havoc,17,7,10
Bigtitiemilk,tichondrius,623,demonhunter,havoc,11,7,4
Ïtzpåpåløtl,tichondrius,623,demonhunter,havoc,11,7,4
Gebblemon,aerie-peak,623,demonhunter,havoc,17,7,10
Hidan,velen,621,demonhunter,havoc,14,8,6
Triplex,moknathal,620,demonhunter,havoc,24,7,17
Highpower,area-52,618,demonhunter,havoc,26,9,17
Mqvdh,area-52,618,demonhunter,havoc,39,8,31
Galaxezz,bonechewer,612,demonhunter,havoc,15,8,7
Soure,azralon,607,demonhunter,havoc,20,7,13
Wualicho,ragnaros,603,demonhunter,havoc,24,8,16
Demonicway,stormrage,592,demonhunter,havoc,16,7,9
Runecaster,anvilmar,587,demonhunter,havoc,11,7,4
Ghostatlas,tichondrius,576,demonhunter,havoc,6,6,0
Solriel,malganis,576,demonhunter,havoc,12,6,6
Minhzie,moon-guard,576,demonhunter,havoc,12,6,6
Deathschosen,malganis,576,demonhunter,havoc,12,6,6
Aertillian,ragnaros,576,demonhunter,havoc,12,6,6
Venmora,argent-dawn,576,demonhunter,havoc,12,6,6
Felraiser,stormrage,576,demonhunter,havoc,12,6,6
Gameoverdh,tichondrius,576,demonhunter,havoc,12,6,6
Abadina,illidan,576,demonhunter,havoc,12,6,6
Discos,frostmourne,576,demonhunter,havoc,12,6,6
Yikari,stormrage,576,demonhunter,havoc,12,6,6
Slapxy,illidan,576,demonhunter,havoc,12,6,6
Fanc,sargeras,576,demonhunter,havoc,12,6,6
Audara,sargeras,576,demonhunter,havoc,12,6,6
Seya,tichondrius,576,demonhunter,havoc,12,6,6
Bossdh,zuljin,576,demonhunter,havoc,12,6,6
Evelynvc,illidan,576,demonhunter,havoc,12,6,6
Whatdagoof,tichondrius,576,demonhunter,havoc,12,6,6
Qvibes,tichondrius,576,demonhunter,havoc,12,6,6
Ânubîs,quelthalas,576,demonhunter,havoc,12,6,6
Soloqisthefu,blackrock,576,demonhunter,havoc,12,6,6
Gommademon,illidan,576,demonhunter,havoc,12,6,6
Nowaifai,tichondrius,576,demonhunter,havoc,12,6,6
Daggertooth,tichondrius,576,demonhunter,havoc,12,6,6
Carlosjr,stormrage,576,demonhunter,havoc,12,6,6
Twotrucks,kelthuzad,576,demonhunter,havoc,12,6,6
Hunttblacke,ragnaros,576,demonhunter,havoc,12,6,6
Teleai,kaelthas,576,demonhunter,havoc,12,6,6
Demontoid,azgalor,576,demonhunter,havoc,12,6,6
Morgoph,burning-legion,576,demonhunter,havoc,12,6,6
Weskerz,illidan,576,demonhunter,havoc,12,6,6
Pabloh,trollbane,576,demonhunter,havoc,12,6,6
Zyer,mannoroth,576,demonhunter,havoc,12,6,6
Shinigameez,proudmoore,576,demonhunter,havoc,12,6,6
Reenah,exodar,576,demonhunter,havoc,12,6,6
Merzinator,korgath,576,demonhunter,havoc,12,6,6
Chicletim,azralon,576,demonhunter,havoc,12,6,6
Thunderlor,malganis,576,demonhunter,havoc,12,6,6
Stets,emerald-dream,576,demonhunter,havoc,12,6,6
Manmilker,bleeding-hollow,576,demonhunter,havoc,12,6,6
Numrasiel,drakkari,576,demonhunter,havoc,12,6,6
Lettüceprey,sargeras,576,demonhunter,havoc,12,6,6
Metakigai,hyjal,576,demonhunter,havoc,12,6,6
Tomglaiven,hyjal,576,demonhunter,havoc,12,6,6
Niteclawla,illidan,576,demonhunter,havoc,12,6,6
Siqx,arthas,576,demonhunter,havoc,12,6,6
Kürosh,kalecgos,576,demonhunter,havoc,12,6,6
Grümb,earthen-ring,576,demonhunter,havoc,12,6,6
Trampstampz,darkspear,576,demonhunter,havoc,12,6,6
Basdminority,bleeding-hollow,576,demonhunter,havoc,12,6,6
Zenage,area-52,576,demonhunter,havoc,12,6,6
Ahsoka,arygos,576,demonhunter,havoc,15,7,8
Kelan,borean-tundra,576,demonhunter,havoc,18,6,12
Tresbotones,kelthuzad,576,demonhunter,havoc,18,6,12
Pikächú,stormrage,576,demonhunter,havoc,18,6,12
Kungfudh,illidan,576,demonhunter,havoc,18,6,12
Kålî,kiljaeden,576,demonhunter,havoc,18,6,12
Gayrio,sargeras,576,demonhunter,havoc,18,6,12
Mavrel,moon-guard,576,demonhunter,havoc,18,6,12
Xyntel,tichondrius,576,demonhunter,havoc,18,6,12
Vyrai,lightbringer,576,demonhunter,havoc,18,6,12
Sailtheskys,tichondrius,576,demonhunter,havoc,18,6,12
Zümanity,zangarmarsh,576,demonhunter,havoc,18,6,12
Kyndrellesa,illidan,576,demonhunter,havoc,18,6,12
Icanseeyou,aerie-peak,576,demonhunter,havoc,18,6,12
Abscarnage,ragnaros,576,demonhunter,havoc,18,6,12
Djkelly,tichondrius,576,demonhunter,havoc,24,6,18
Lysol,darrowmere,575,demonhunter,havoc,12,6,6
Eyesyk,bonechewer,575,demonhunter,havoc,12,6,6
Gurthbrookz,tichondrius,575,demonhunter,havoc,12,6,6
Cholula,korgath,575,demonhunter,havoc,12,6,6
Smoothtaco,azshara,575,demonhunter,havoc,12,6,6
Veladoria,malorne,575,demonhunter,havoc,12,6,6
Hootyeahbou,shattered-hand,575,demonhunter,havoc,12,6,6
Hottacos,stormrage,575,demonhunter,havoc,12,6,6
Deepde,tichondrius,575,demonhunter,havoc,12,6,6
Tugï,tichondrius,575,demonhunter,havoc,12,6,6
Liquidblaze,elune,575,demonhunter,havoc,12,6,6
ßatmañ,barthilas,575,demonhunter,havoc,18,6,12
Finnanutt,tichondrius,575,demonhunter,havoc,18,6,12
Jalet,azralon,575,demonhunter,havoc,18,6,12
Ýizl,ragnaros,575,demonhunter,havoc,18,6,12
Whezka,ragnaros,575,demonhunter,havoc,18,6,12
Salveya,stormrage,575,demonhunter,havoc,20,6,14
Toxicimpulse,aegwynn,574,demonhunter,havoc,12,6,6
Solorialorth,shadowsong,574,demonhunter,havoc,12,6,6
Touched,guldan,574,demonhunter,havoc,12,6,6
Casualdemon,emerald-dream,574,demonhunter,havoc,12,6,6
Haikal,proudmoore,574,demonhunter,havoc,12,6,6
Ðruh,kelthuzad,574,demonhunter,havoc,18,6,12
Kunitsuna,thunderlord,574,demonhunter,havoc,18,6,12
Trekt,blades-edge,574,demonhunter,havoc,18,6,12
Firesworn,zuljin,573,demonhunter,havoc,12,6,6
Kimchiman,tichondrius,573,demonhunter,havoc,16,7,9
Adayinthelif,proudmoore,573,demonhunter,havoc,18,6,12
Slaytan,darkspear,573,demonhunter,havoc,18,6,12
Eggandpotato,saurfang,571,demonhunter,havoc,12,6,6
Darckside,sargeras,571,demonhunter,havoc,12,6,6
Lanistus,bloodhoof,570,demonhunter,havoc,18,6,12
Rampyr,terokkar,569,demonhunter,havoc,12,6,6
Kreel,ghostlands,568,demonhunter,havoc,12,6,6
Thjoannys,illidan,567,demonhunter,havoc,12,6,6
Roderika,amanthul,566,demonhunter,havoc,12,6,6
Elpis,tanaris,565,demonhunter,havoc,14,6,8
Byzzel,barthilas,559,demonhunter,havoc,17,6,11
Thendoral,ragnaros,543,demonhunter,havoc,22,6,16
Junsa,darkspear,527,demonhunter,havoc,11,6,5
Pumppimp,stormrage,527,demonhunter,havoc,11,6,5
Shizune,boulderfist,525,demonhunter,havoc,11,6,5
Gulios,azralon,522,demonhunter,havoc,20,7,13
Fifteentolyf,illidan,520,demonhunter,havoc,11,6,5
Wickedlurker,sargeras,519,demonhunter,havoc,17,9,8
Tosilia,tichondrius,511,demonhunter,havoc,8,6,2
Xytonic,bleeding-hollow,511,demonhunter,havoc,11,6,5
Cloudzzy,illidan,511,demonhunter,havoc,14,6,8
Isedelica,area-52,510,demonhunter,havoc,11,6,5
Vessarin,madoran,510,demonhunter,havoc,20,6,14
Ryemortis,malganis,510,demonhunter,havoc,20,6,14
Ljevilin,gilneas,480,demonhunter,havoc,6,5,1
Twobuttonszz,tichondrius,480,demonhunter,havoc,6,5,1
Isabellaluna,illidan,480,demonhunter,havoc,6,5,1
Remix,draka,480,demonhunter,havoc,6,5,1
Plecoptera,wyrmrest-accord,480,demonhunter,havoc,6,5,1
Med,wyrmrest-accord,480,demonhunter,havoc,6,5,1
Ryntx,moon-guard,480,demonhunter,havoc,6,5,1
Pumpñdump,echo-isles,480,demonhunter,havoc,6,5,1
Damador,malganis,480,demonhunter,havoc,6,5,1
Tîtø,quelthalas,480,demonhunter,havoc,6,5,1
Kyndh,illidan,480,demonhunter,havoc,6,5,1
Kyndris,ghostlands,480,demonhunter,havoc,6,5,1
Lumh,quelthalas,480,demonhunter,havoc,6,5,1
Stunnashades,hellscream,480,demonhunter,havoc,6,5,1
Milfhuñter,sargeras,480,demonhunter,havoc,6,5,1
Twistedways,tichondrius,480,demonhunter,havoc,6,5,1
Pristager,tichondrius,480,demonhunter,havoc,6,5,1
Densewench,stormrage,480,demonhunter,havoc,12,5,7
Photuris,moon-guard,480,demonhunter,havoc,12,5,7
Wwdh,stormrage,480,demonhunter,havoc,12,5,7
Rizalo,frostmane,480,demonhunter,havoc,12,5,7
Muffjuice,emerald-dream,480,demonhunter,havoc,12,5,7
Untouchèd,bleeding-hollow,480,demonhunter,havoc,12,5,7
Bellysniffer,illidan,480,demonhunter,havoc,12,5,7
Delaían,drakkari,480,demonhunter,havoc,12,5,7
Illidam,arthas,480,demonhunter,havoc,12,5,7
Borekkarxqt,emerald-dream,480,demonhunter,havoc,12,5,7
Anthvedroth,area-52,480,demonhunter,havoc,12,5,7
Cosbied,area-52,480,demonhunter,havoc,12,5,7
Revzdh,illidan,480,demonhunter,havoc,12,5,7
Touchmeweird,area-52,480,demonhunter,havoc,12,5,7
Hyptonique,queldorei,480,demonhunter,havoc,12,5,7
Tyrele,drakkari,480,demonhunter,havoc,12,5,7
Onbloodfam,kelthuzad,480,demonhunter,havoc,12,5,7
Azuki,lightbringer,480,demonhunter,havoc,12,5,7
Lìttlê,runetotem,480,demonhunter,havoc,12,5,7
Zlr,bleeding-hollow,480,demonhunter,havoc,12,5,7
Domeemommy,moon-guard,480,demonhunter,havoc,12,5,7
Bátmañ,stormrage,480,demonhunter,havoc,12,5,7
Roughcut,blackrock,480,demonhunter,havoc,12,5,7
Chewyd,illidan,480,demonhunter,havoc,12,5,7
Goodrink,tichondrius,480,demonhunter,havoc,12,5,7
Waos,maelstrom,480,demonhunter,havoc,12,5,7
Dontplanahea,tichondrius,480,demonhunter,havoc,12,5,7
Slapxy,kelthuzad,480,demonhunter,havoc,12,5,7
Izruul,tichondrius,480,demonhunter,havoc,12,5,7
Feka,darkspear,480,demonhunter,havoc,12,5,7
Zarosong,illidan,480,demonhunter,havoc,12,5,7
Besoween,tichondrius,480,demonhunter,havoc,12,5,7
Slashdh,stormrage,480,demonhunter,havoc,12,5,7
Hippygamer,frostmourne,480,demonhunter,havoc,12,5,7
Zelfyrã,malganis,480,demonhunter,havoc,12,5,7
Axldh,tichondrius,480,demonhunter,havoc,12,5,7
Dhworm,azralon,480,demonhunter,havoc,12,5,7
Køugami,azralon,480,demonhunter,havoc,12,5,7
Doomanthree,sargeras,480,demonhunter,havoc,12,5,7
Laillwina,amanthul,480,demonhunter,havoc,12,5,7
Chandrian,gorefiend,480,demonhunter,havoc,12,5,7
Fabbris,stormrage,480,demonhunter,havoc,12,5,7
Wartornx,tichondrius,480,demonhunter,havoc,12,5,7
Harahmbae,moon-guard,480,demonhunter,havoc,12,5,7
Slumberz,tichondrius,480,demonhunter,havoc,12,5,7
Demondurk,illidan,480,demonhunter,havoc,12,5,7
Cabedh,tichondrius,480,demonhunter,havoc,12,5,7
Cupernacus,tichondrius,480,demonhunter,havoc,12,5,7
Obîtox,illidan,480,demonhunter,havoc,12,5,7
Billmurray,skullcrusher,480,demonhunter,havoc,12,5,7
Foozelol,thrall,480,demonhunter,havoc,12,5,7
Chupillidan,tichondrius,480,demonhunter,havoc,12,5,7
Finagel,destromath,480,demonhunter,havoc,12,5,7
Dheria,barthilas,480,demonhunter,havoc,12,5,7
Nazeiro,shadowsong,480,demonhunter,havoc,12,5,7
Drathothian,moon-guard,480,demonhunter,havoc,12,5,7
Uneasydh,tichondrius,480,demonhunter,havoc,12,5,7
Jarenjackson,area-52,480,demonhunter,havoc,12,5,7
Ahurock,ragnaros,480,demonhunter,havoc,12,5,7
Mjin,tichondrius,480,demonhunter,havoc,12,5,7
Khelt,dalaran,480,demonhunter,havoc,12,5,7
Sailtheskies,tichondrius,480,demonhunter,havoc,12,5,7
Xiaodudh,tichondrius,480,demonhunter,havoc,12,5,7
Efficacious,zuljin,480,demonhunter,havoc,15,6,9
Keairà,bleeding-hollow,480,demonhunter,havoc,14,5,9
Dàrk,zuljin,480,demonhunter,havoc,23,7,16
Dracxus,sargeras,480,demonhunter,havoc,18,5,13
Thedh,ragnaros,480,demonhunter,havoc,18,5,13
Soulrending,stormrage,480,demonhunter,havoc,18,5,13
Eyebeamtowin,stormrage,480,demonhunter,havoc,18,5,13
Blakhaurt,tichondrius,480,demonhunter,havoc,18,5,13
Imissgushing,area-52,480,demonhunter,havoc,18,5,13
Brokendh,ragnaros,480,demonhunter,havoc,18,5,13
Dèvistate,kelthuzad,480,demonhunter,havoc,18,5,13
Robvyn,tichondrius,480,demonhunter,havoc,18,5,13
Barael,tichondrius,480,demonhunter,havoc,18,5,13
Roozi,tichondrius,480,demonhunter,havoc,24,5,19
Jizzidan,blackhand,479,demonhunter,havoc,6,5,1
Pwnagextreme,area-52,479,demonhunter,havoc,6,5,1
Creaminbeavr,twisting-nether,479,demonhunter,havoc,10,6,4
Felmilk,demon-soul,479,demonhunter,havoc,12,5,7
Pocahotnes,stormrage,479,demonhunter,havoc,12,5,7
Denathrion,moon-guard,479,demonhunter,havoc,12,5,7
Elfdiablo,bonechewer,479,demonhunter,havoc,12,5,7
Fliar,black-dragonflight,479,demonhunter,havoc,12,5,7
Felvanora,amanthul,479,demonhunter,havoc,12,5,7
Terruz,arathor,479,demonhunter,havoc,12,5,7
Cantreborn,destromath,479,demonhunter,havoc,12,5,7
Epicfront,darkspear,479,demonhunter,havoc,12,5,7
Horndawgg,zuljin,479,demonhunter,havoc,12,5,7
ßoobiemiles,area-52,479,demonhunter,havoc,12,5,7
Ezymode,stormrage,479,demonhunter,havoc,12,5,7
Kattsparrow,stormrage,479,demonhunter,havoc,18,5,13
Idemonl,barthilas,479,demonhunter,havoc,18,5,13
Bonebtwo,area-52,479,demonhunter,havoc,18,5,13
Illidunk,tichondrius,479,demonhunter,havoc,18,5,13
Kritik,goldrinn,478,demonhunter,havoc,12,5,7
Cheernobyl,emerald-dream,478,demonhunter,havoc,18,5,13
Devc,stormrage,477,demonhunter,havoc,12,5,7
Zilham,tichondrius,477,demonhunter,havoc,19,5,14
Skydemond,tichondrius,475,demonhunter,havoc,18,5,13
Rouzk,ragnaros,474,demonhunter,havoc,12,5,7
Mentoes,tichondrius,473,demonhunter,havoc,12,5,7
Shadevon,wyrmrest-accord,448,demonhunter,havoc,10,5,5
Raum,elune,443,demonhunter,havoc,8,6,2
Bituhvic,stormrage,431,demonhunter,havoc,11,5,6
Roosterhead,azjolnerub,430,demonhunter,havoc,11,5,6
Annxyìng,tichondrius,426,demonhunter,havoc,14,6,8
Wheredyougo,proudmoore,416,demonhunter,havoc,10,5,5
Blinddude,sargeras,415,demonhunter,havoc,14,5,9
Bladezues,tichondrius,415,demonhunter,havoc,14,5,9
Teenis,malygos,412,demonhunter,havoc,14,5,9
Florks,area-52,400,demonhunter,havoc,7,5,2
Nèzúko,stormrage,384,demonhunter,havoc,6,4,2
Galgy,ragnaros,384,demonhunter,havoc,6,4,2
Doublepenn,tichondrius,384,demonhunter,havoc,6,4,2
Nihilist,kaelthas,384,demonhunter,havoc,6,4,2
Vyndrestan,dalaran,384,demonhunter,havoc,6,4,2
Vynrage,trollbane,384,demonhunter,havoc,6,4,2
Trilldh,illidan,384,demonhunter,havoc,6,4,2
Whudaz,tichondrius,384,demonhunter,havoc,6,4,2
Keepr,tichondrius,384,demonhunter,havoc,6,4,2
Yågåmist,dalaran,384,demonhunter,havoc,6,4,2
Dylle,tichondrius,384,demonhunter,havoc,6,4,2
Déörwine,quelthalas,384,demonhunter,havoc,6,4,2
Doomkaiser,aerie-peak,384,demonhunter,havoc,6,4,2
Epicfc,bleeding-hollow,384,demonhunter,havoc,6,4,2
Slyblitz,bleeding-hollow,384,demonhunter,havoc,6,4,2
Bopersdh,drakkari,384,demonhunter,havoc,6,4,2
Khaosx,ragnaros,384,demonhunter,havoc,6,4,2
Skeethunter,tichondrius,384,demonhunter,havoc,6,4,2
Deezhuntz,anvilmar,384,demonhunter,havoc,6,4,2
Unkiteable,malganis,384,demonhunter,havoc,6,4,2
Fov,crushridge,384,demonhunter,havoc,6,4,2
Elfro,kelthuzad,384,demonhunter,havoc,6,4,2
Fluoroh,frostmourne,384,demonhunter,havoc,6,4,2
Domoredamage,sargeras,384,demonhunter,havoc,6,4,2
Tragedydh,sargeras,384,demonhunter,havoc,6,4,2
Parabolicc,illidan,384,demonhunter,havoc,6,4,2
Abduragozik,stormrage,384,demonhunter,havoc,6,4,2
Tiriøsh,area-52,384,demonhunter,havoc,6,4,2
Hordesback,illidan,384,demonhunter,havoc,6,4,2
Lucaria,sargeras,384,demonhunter,havoc,6,4,2
Jinsha,emerald-dream,384,demonhunter,havoc,6,4,2
Cyphre,tichondrius,384,demonhunter,havoc,6,4,2
Bigdingding,area-52,384,demonhunter,havoc,6,4,2
Cwrld,area-52,384,demonhunter,havoc,6,4,2
Cesilette,frostmourne,384,demonhunter,havoc,6,4,2
Extínctíon,moon-guard,384,demonhunter,havoc,6,4,2
Darkah,icecrown,384,demonhunter,havoc,6,4,2
Wogarg,sargeras,384,demonhunter,havoc,6,4,2
Intrusive,kelthuzad,384,demonhunter,havoc,6,4,2
Fellsoulz,area-52,384,demonhunter,havoc,6,4,2
Monteego,stormrage,384,demonhunter,havoc,6,4,2
Rynus,tichondrius,384,demonhunter,havoc,6,4,2
Ultear,the-venture-co,384,demonhunter,havoc,6,4,2
Kasseater,stormrage,384,demonhunter,havoc,6,4,2
Krament,ragnaros,384,demonhunter,havoc,6,4,2
Jeeprcreeprs,sargeras,384,demonhunter,havoc,6,4,2
Dareassassin,tichondrius,384,demonhunter,havoc,6,4,2
Kormraven,moon-guard,384,demonhunter,havoc,6,4,2
Tyindron,exodar,384,demonhunter,havoc,6,4,2
Jizzy,shadowmoon,384,demonhunter,havoc,6,4,2
Verasu,kiljaeden,384,demonhunter,havoc,6,4,2
Ineptbb,frostmourne,384,demonhunter,havoc,6,4,2
Darkrëaper,azralon,384,demonhunter,havoc,6,4,2
Uncleruckus,bloodscalp,384,demonhunter,havoc,6,4,2
Savetar,thrall,384,demonhunter,havoc,6,4,2
Heygriffin,proudmoore,384,demonhunter,havoc,6,4,2
Kottàs,area-52,384,demonhunter,havoc,6,4,2
Gødzîllå,moon-guard,384,demonhunter,havoc,6,4,2
Servilletas,spirestone,384,demonhunter,havoc,6,4,2
Doras,kelthuzad,384,demonhunter,havoc,6,4,2
Abakkio,kelthuzad,384,demonhunter,havoc,6,4,2
Tußlur,kelthuzad,384,demonhunter,havoc,6,4,2
Tristanzx,sargeras,384,demonhunter,havoc,6,4,2
Kâirn,area-52,384,demonhunter,havoc,6,4,2
Bleaster,malganis,384,demonhunter,havoc,12,4,8
Adhdh,bloodhoof,384,demonhunter,havoc,12,4,8
Lìnc,sargeras,384,demonhunter,havoc,12,4,8
Vallar,bleeding-hollow,384,demonhunter,havoc,12,4,8
Blackclóver,drakkari,384,demonhunter,havoc,12,4,8
Mommafingers,illidan,384,demonhunter,havoc,12,4,8
Mikemyoffice,illidan,384,demonhunter,havoc,12,4,8
Zoomie,durotan,384,demonhunter,havoc,12,4,8
Zurg,wyrmrest-accord,384,demonhunter,havoc,12,4,8
Reapersauce,illidan,384,demonhunter,havoc,12,4,8
Zephim,area-52,384,demonhunter,havoc,12,4,8
Kelprii,emerald-dream,384,demonhunter,havoc,12,4,8
Heallscrean,drakkari,384,demonhunter,havoc,12,4,8
Ralphie,ysera,384,demonhunter,havoc,12,4,8
Separate,stormrage,384,demonhunter,havoc,12,4,8
Dystopik,area-52,384,demonhunter,havoc,12,4,8
Sinhful,darkspear,384,demonhunter,havoc,12,4,8
Dhtimes,ragnaros,384,demonhunter,havoc,12,4,8
Temporarý,bleeding-hollow,384,demonhunter,havoc,12,4,8
Fraxxured,proudmoore,384,demonhunter,havoc,12,4,8
Butterfinger,greymane,384,demonhunter,havoc,12,4,8
Sathsong,tichondrius,384,demonhunter,havoc,12,4,8
Bazul,tichondrius,384,demonhunter,havoc,12,4,8
Bättousai,kiljaeden,384,demonhunter,havoc,12,4,8
Anomander,khazgoroth,384,demonhunter,havoc,12,4,8
Inssurgent,nagrand,384,demonhunter,havoc,12,4,8
Ahernn,tichondrius,384,demonhunter,havoc,12,4,8
Ragastan,queldorei,384,demonhunter,havoc,12,4,8
Shallah,barthilas,384,demonhunter,havoc,12,4,8
Sawsin,illidan,384,demonhunter,havoc,12,4,8
Fenthras,thrall,384,demonhunter,havoc,12,4,8
Overcrisis,quelthalas,384,demonhunter,havoc,12,4,8
Noliaclap,sargeras,384,demonhunter,havoc,12,4,8
Thetim,kelthuzad,384,demonhunter,havoc,12,4,8
Contactfront,whisperwind,384,demonhunter,havoc,12,4,8
Baalzadreth,bleeding-hollow,384,demonhunter,havoc,12,4,8
Zzatmikaze,area-52,384,demonhunter,havoc,12,4,8
Namthar,quelthalas,384,demonhunter,havoc,12,4,8
Dhibjorf,destromath,384,demonhunter,havoc,12,4,8
Dkdakìng,thrall,384,demonhunter,havoc,12,4,8
Dhsoop,tichondrius,384,demonhunter,havoc,12,4,8
Zerotwox,thrall,384,demonhunter,havoc,12,4,8
Drîp,moon-guard,384,demonhunter,havoc,12,4,8
Weetbreadsux,illidan,384,demonhunter,havoc,12,4,8
Mëñâçë,tichondrius,384,demonhunter,havoc,13,4,9
Alphatoo,area-52,384,demonhunter,havoc,15,4,11
Noyan,tichondrius,384,demonhunter,havoc,17,4,13
Ravesx,illidan,384,demonhunter,havoc,18,4,14
Trystenn,nagrand,384,demonhunter,havoc,18,4,14
Roodblurz,zuljin,384,demonhunter,havoc,18,4,14
Felsa,wyrmrest-accord,384,demonhunter,havoc,18,4,14
Leonardovg,quelthalas,384,demonhunter,havoc,30,4,26
Severon,stormrage,383,demonhunter,havoc,6,4,2
Dämonjäger,dragonmaw,383,demonhunter,havoc,6,4,2
Handael,illidan,383,demonhunter,havoc,6,4,2
Demondrëad,lightbringer,383,demonhunter,havoc,9,5,4
Ahzalor,azralon,383,demonhunter,havoc,12,4,8
Deathslice,azgalor,383,demonhunter,havoc,12,4,8
Felieda,malfurion,383,demonhunter,havoc,12,4,8
Døffy,area-52,383,demonhunter,havoc,12,4,8
Qtee,cairne,383,demonhunter,havoc,12,4,8
Righton,black-dragonflight,383,demonhunter,havoc,12,4,8
Moongaria,greymane,383,demonhunter,havoc,12,4,8
Themurderer,area-52,383,demonhunter,havoc,12,4,8
Flearemedy,moon-guard,383,demonhunter,havoc,12,4,8
Rarespawnjon,tichondrius,383,demonhunter,havoc,12,4,8
Ayestar,tichondrius,383,demonhunter,havoc,12,4,8
Vellinaris,zuljin,383,demonhunter,havoc,12,4,8
Draktyl,bronzebeard,383,demonhunter,havoc,12,4,8
Ilitía,area-52,382,demonhunter,havoc,6,4,2
Xàsthur,darkspear,382,demonhunter,havoc,12,4,8
Xiin,cenarion-circle,382,demonhunter,havoc,12,4,8
Saladuoduo,illidan,382,demonhunter,havoc,12,4,8
Apaantuh,sargeras,382,demonhunter,havoc,12,4,8
Samirr,proudmoore,382,demonhunter,havoc,13,4,9
Anguloke,wyrmrest-accord,381,demonhunter,havoc,10,5,5
Agramun,ragnaros,381,demonhunter,havoc,12,4,8
Killercooter,area-52,381,demonhunter,havoc,12,4,8
Lúcy,malganis,367,demonhunter,havoc,11,4,7
Rustyanchor,malganis,367,demonhunter,havoc,17,4,13
Yogo,tichondrius,352,demonhunter,havoc,10,4,6
Polunochnaya,area-52,352,demonhunter,havoc,16,4,12
Selenerose,stormrage,351,demonhunter,havoc,8,5,3
Viølance,area-52,351,demonhunter,havoc,8,5,3
Findoratoqc,darrowmere,351,demonhunter,havoc,11,4,7
Xiruu,area-52,336,demonhunter,havoc,15,5,10
Unjust,darkspear,336,demonhunter,havoc,15,4,11
Deadlysin,dragonmaw,336,demonhunter,havoc,15,4,11
Fingerjamsx,area-52,335,demonhunter,havoc,11,4,7
Cherrycrüsh,sargeras,335,demonhunter,havoc,11,4,7
Lehvi,kiljaeden,335,demonhunter,havoc,11,4,7
Dearborn,frostmourne,330,demonhunter,havoc,16,5,11
Criyn,kelthuzad,330,demonhunter,havoc,17,5,12
Ivexia,blackrock,320,demonhunter,havoc,10,4,6
Acelolzz,illidan,320,demonhunter,havoc,10,4,6
Rákdos,illidan,319,demonhunter,havoc,8,4,4
Draxíus,tichondrius,304,demonhunter,havoc,7,4,3
Gibbz,wyrmrest-accord,304,demonhunter,havoc,11,5,6
Tenth,draka,288,demonhunter,havoc,6,3,3
Asukaxox,illidan,288,demonhunter,havoc,6,3,3
Onedigitiq,thrall,288,demonhunter,havoc,6,3,3
Kawaiiakitty,tichondrius,288,demonhunter,havoc,6,3,3
Sitchenn,stormrage,288,demonhunter,havoc,6,3,3
Nen,illidan,288,demonhunter,havoc,6,3,3
ßeelzëbub,icecrown,288,demonhunter,havoc,6,3,3
Stacheaction,sargeras,288,demonhunter,havoc,6,3,3
Xxân,tichondrius,288,demonhunter,havoc,6,3,3
Grevdawg,barthilas,288,demonhunter,havoc,6,3,3
Cäncèr,area-52,288,demonhunter,havoc,6,3,3
Illipo,illidan,288,demonhunter,havoc,6,3,3
Celestez,kelthuzad,288,demonhunter,havoc,6,3,3
Çreme,tichondrius,288,demonhunter,havoc,6,3,3
Âsmodeus,laughing-skull,288,demonhunter,havoc,6,3,3
Walluped,malganis,288,demonhunter,havoc,6,3,3
Warglaîve,illidan,288,demonhunter,havoc,6,3,3
Wingsofhavoc,darkspear,288,demonhunter,havoc,6,3,3
Fracxures,area-52,288,demonhunter,havoc,6,3,3
Treyydh,illidan,288,demonhunter,havoc,6,3,3
Meliodàs,ragnaros,288,demonhunter,havoc,6,3,3
Râkê,malganis,288,demonhunter,havoc,6,3,3
Quiksilverv,khazgoroth,288,demonhunter,havoc,6,3,3
Lyrndrial,wildhammer,288,demonhunter,havoc,6,3,3
Gilidar,terenas,288,demonhunter,havoc,6,3,3
Mèrlyn,sargeras,288,demonhunter,havoc,6,3,3
Blingtrön,malganis,288,demonhunter,havoc,6,3,3
Totheglaive,sargeras,288,demonhunter,havoc,6,3,3
Teufelhundn,tichondrius,288,demonhunter,havoc,6,3,3
Ziyutomioka,moon-guard,288,demonhunter,havoc,6,3,3
Gonpanchirow,moon-guard,288,demonhunter,havoc,6,3,3
Kamakhasi,bleeding-hollow,288,demonhunter,havoc,6,3,3
Sxzure,frostmourne,288,demonhunter,havoc,6,3,3
Aslowbust,tichondrius,288,demonhunter,havoc,6,3,3
Demønical,dalaran,288,demonhunter,havoc,6,3,3
Felform,area-52,288,demonhunter,havoc,6,3,3
Racktor,tichondrius,288,demonhunter,havoc,6,3,3
Bkeight,dalaran,288,demonhunter,havoc,6,3,3
Danthedh,illidan,288,demonhunter,havoc,6,3,3
Velerolas,area-52,288,demonhunter,havoc,6,3,3
Fferchu,ragnaros,288,demonhunter,havoc,6,3,3
Inphamy,chogall,288,demonhunter,havoc,6,3,3
Zeppelìn,stormrage,288,demonhunter,havoc,6,3,3
Aventear,wyrmrest-accord,288,demonhunter,havoc,6,3,3
Careestal,stormrage,288,demonhunter,havoc,6,3,3
Sofedon,kargath,288,demonhunter,havoc,6,3,3
Walk,kul-tiras,288,demonhunter,havoc,6,3,3
Singueta,stormrage,288,demonhunter,havoc,6,3,3
Noóve,area-52,288,demonhunter,havoc,6,3,3
Zaveen,kelthuzad,288,demonhunter,havoc,6,3,3
Neutrophilia,area-52,288,demonhunter,havoc,6,3,3
Tink,kilrogg,288,demonhunter,havoc,6,3,3
Safiyya,proudmoore,288,demonhunter,havoc,6,3,3
Dhunterkofwa,tichondrius,288,demonhunter,havoc,6,3,3
Slodeath,zuljin,288,demonhunter,havoc,6,3,3
Zïlly,blackrock,288,demonhunter,havoc,6,3,3
Arlequhin,ragnaros,288,demonhunter,havoc,6,3,3
Talsaris,drakthul,288,demonhunter,havoc,6,3,3
Shamock,aggramar,288,demonhunter,havoc,6,3,3
Inva,stormrage,288,demonhunter,havoc,6,3,3
Rhynóe,illidan,288,demonhunter,havoc,6,3,3
Dettlaff,sentinels,288,demonhunter,havoc,6,3,3
Songtwo,frostmourne,288,demonhunter,havoc,6,3,3
Namiisann,terenas,288,demonhunter,havoc,6,3,3
Treeüs,sargeras,288,demonhunter,havoc,6,3,3
Smokepurppx,zuljin,288,demonhunter,havoc,6,3,3
Krendron,malganis,288,demonhunter,havoc,6,3,3
Elgreezy,sargeras,288,demonhunter,havoc,6,3,3
Zalenn,whisperwind,288,demonhunter,havoc,6,3,3
Gnatman,skywall,288,demonhunter,havoc,6,3,3
Suddensky,sargeras,288,demonhunter,havoc,6,3,3
Riodh,area-52,288,demonhunter,havoc,6,3,3
Cantc,moon-guard,288,demonhunter,havoc,6,3,3
Shacco,bleeding-hollow,288,demonhunter,havoc,6,3,3
Imissher,dalaran,288,demonhunter,havoc,6,3,3
Cassadega,sargeras,288,demonhunter,havoc,6,3,3
Yunjiia,stormrage,288,demonhunter,havoc,6,3,3
Darkstein,nathrezim,288,demonhunter,havoc,6,3,3
Inpain,ysera,288,demonhunter,havoc,9,4,5
Eeresh,argent-dawn,288,demonhunter,havoc,11,4,7
Hisokafreecs,azralon,288,demonhunter,havoc,10,3,7
Félmoose,moon-guard,288,demonhunter,havoc,12,3,9
Occula,moon-guard,288,demonhunter,havoc,12,3,9
Çløûdïx,tichondrius,288,demonhunter,havoc,12,3,9
Itsplague,tichondrius,288,demonhunter,havoc,12,3,9
Mvrda,area-52,288,demonhunter,havoc,12,3,9
Katsuucurry,tichondrius,288,demonhunter,havoc,12,3,9
Kraky,nemesis,288,demonhunter,havoc,12,3,9
Daso,the-forgotten-coast,288,demonhunter,havoc,12,3,9
Denadiirx,area-52,288,demonhunter,havoc,12,3,9
Nayton,frostmourne,288,demonhunter,havoc,12,3,9
Atriax,kelthuzad,288,demonhunter,havoc,12,3,9
Albinohobo,emerald-dream,288,demonhunter,havoc,12,3,9
Shidz,frostmourne,288,demonhunter,havoc,12,3,9
Rasgon,azralon,288,demonhunter,havoc,12,3,9
Lawimmortal,tichondrius,288,demonhunter,havoc,12,3,9
Skrimpi,dalaran,288,demonhunter,havoc,12,3,9
Abrams,tichondrius,288,demonhunter,havoc,12,3,9
Wotlkdh,area-52,288,demonhunter,havoc,12,3,9
Elflerri,area-52,288,demonhunter,havoc,12,3,9
Dirtyd,dragonmaw,288,demonhunter,havoc,12,3,9
Nightsatan,stormrage,288,demonhunter,havoc,12,3,9
Felfloozy,illidan,288,demonhunter,havoc,12,3,9
Zudo,amanthul,288,demonhunter,havoc,12,3,9
Missbhavin,kelthuzad,288,demonhunter,havoc,12,3,9
Tentacruelzz,area-52,288,demonhunter,havoc,12,3,9
Demonichoov,thrall,288,demonhunter,havoc,12,3,9
Mirante,illidan,288,demonhunter,havoc,12,3,9
Klàus,quelthalas,288,demonhunter,havoc,12,3,9
Icanmove,area-52,288,demonhunter,havoc,12,3,9
Reflexin,tichondrius,288,demonhunter,havoc,12,3,9
Dmfeetpics,dalaran,288,demonhunter,havoc,12,3,9
Azziria,aerie-peak,288,demonhunter,havoc,12,3,9
Jxda,tichondrius,288,demonhunter,havoc,15,3,12
Hpmaxin,tichondrius,288,demonhunter,havoc,18,3,15
Vellassa,stormscale,288,demonhunter,havoc,18,3,15
Lavantora,tichondrius,288,demonhunter,havoc,23,3,20
Devilina,khadgar,287,demonhunter,havoc,6,3,3
Shar,jaedenar,287,demonhunter,havoc,6,3,3
Kratox,senjin,287,demonhunter,havoc,6,3,3
Haydet,stormrage,287,demonhunter,havoc,6,3,3
Illa,dunemaul,287,demonhunter,havoc,6,3,3
Holescrewer,tichondrius,287,demonhunter,havoc,6,3,3
Ariluci,destromath,287,demonhunter,havoc,6,3,3
Slixxk,sargeras,287,demonhunter,havoc,9,4,5
Villoria,kul-tiras,287,demonhunter,havoc,12,3,9
Dynastyblade,area-52,287,demonhunter,havoc,12,3,9
Lsnusnul,illidan,286,demonhunter,havoc,6,3,3
Psythe,undermine,286,demonhunter,havoc,12,3,9
Dannaris,maelstrom,285,demonhunter,havoc,12,3,9
Pekkora,illidan,284,demonhunter,havoc,12,3,9
Elrr,drakkari,255,demonhunter,havoc,11,3,8
Nikator,emerald-dream,255,demonhunter,havoc,11,3,8
Juantty,area-52,240,demonhunter,havoc,15,3,12
Hoppygofast,darkspear,239,demonhunter,havoc,5,3,2
Vickyvette,illidan,239,demonhunter,havoc,5,3,2
Azàzel,quelthalas,239,demonhunter,havoc,5,3,2
Divinehorse,tichondrius,234,demonhunter,havoc,10,5,5
Kryzthed,drakkari,233,demonhunter,havoc,13,4,9
Bushwacker,azralon,223,demonhunter,havoc,8,3,5
Phaeton,zuluhed,222,demonhunter,havoc,10,3,7
Onihunter,zangarmarsh,208,demonhunter,havoc,7,3,4
Cobra,quelthalas,208,demonhunter,havoc,7,3,4
Critxclutch,tichondrius,192,demonhunter,havoc,4,3,1
Syrendris,moon-guard,192,demonhunter,havoc,8,3,5
Thedhdream,frostmourne,192,demonhunter,havoc,9,3,6
Iøst,stormrage,192,demonhunter,havoc,6,2,4
Azshada,shadowmoon,192,demonhunter,havoc,6,2,4
Varaedra,stormreaver,192,demonhunter,havoc,6,2,4
Zethh,drakkari,192,demonhunter,havoc,6,2,4
Vyrthur,area-52,192,demonhunter,havoc,6,2,4
Gogiban,tichondrius,192,demonhunter,havoc,6,2,4
Zusi,frostmane,192,demonhunter,havoc,6,2,4
Lilyanie,stormrage,192,demonhunter,havoc,6,2,4
Bark,dalvengyr,192,demonhunter,havoc,6,2,4
Daracu,aerie-peak,192,demonhunter,havoc,6,2,4
Frino,steamwheedle-cartel,192,demonhunter,havoc,6,2,4
Serberius,stormrage,192,demonhunter,havoc,6,2,4
Riot,nazgrel,192,demonhunter,havoc,6,2,4
Imleu,stormrage,192,demonhunter,havoc,6,2,4
Sparklepunch,stormrage,192,demonhunter,havoc,6,2,4
Chamuki,greymane,192,demonhunter,havoc,6,2,4
Xannaa,illidan,192,demonhunter,havoc,6,2,4
Ratcnt,barthilas,192,demonhunter,havoc,6,2,4
Øxxy,azralon,192,demonhunter,havoc,6,2,4
Arandë,earthen-ring,192,demonhunter,havoc,6,2,4
Demonlee,jubeithos,192,demonhunter,havoc,6,2,4
Devilweef,whisperwind,192,demonhunter,havoc,6,2,4
Kzdh,illidan,192,demonhunter,havoc,6,2,4
Zach,muradin,192,demonhunter,havoc,6,2,4
Ragath,bonechewer,192,demonhunter,havoc,6,2,4
Impaledurgf,tichondrius,192,demonhunter,havoc,6,2,4
String,tanaris,192,demonhunter,havoc,6,2,4
Skol,andorhal,192,demonhunter,havoc,6,2,4
Swagidan,khaz-modan,192,demonhunter,havoc,6,2,4
Zarraessa,trollbane,192,demonhunter,havoc,6,2,4
Metha,kiljaeden,192,demonhunter,havoc,6,2,4
Showaitie,thrall,192,demonhunter,havoc,6,2,4
Moxy,kaelthas,192,demonhunter,havoc,6,2,4
Aleta,firetree,192,demonhunter,havoc,6,2,4
Blynx,destromath,192,demonhunter,havoc,6,2,4
Justinthomas,khaz-modan,192,demonhunter,havoc,6,2,4
Badalandabad,nemesis,192,demonhunter,havoc,6,2,4
Genobreaker,drenden,192,demonhunter,havoc,6,2,4
Rkakda,thunderlord,192,demonhunter,havoc,6,2,4
Lloxly,skullcrusher,192,demonhunter,havoc,6,2,4
Freddiedread,bladefist,192,demonhunter,havoc,6,2,4
Gyutaro,frostmourne,192,demonhunter,havoc,6,2,4
Naresaris,proudmoore,192,demonhunter,havoc,6,2,4
Clîzzy,tichondrius,192,demonhunter,havoc,6,2,4
Brokendh,frostmourne,192,demonhunter,havoc,6,2,4
Kayanson,azralon,192,demonhunter,havoc,6,2,4
Theenemesis,wildhammer,192,demonhunter,havoc,6,2,4
Krador,wyrmrest-accord,192,demonhunter,havoc,6,2,4
Kyndlia,wyrmrest-accord,192,demonhunter,havoc,6,2,4
Carlibeth,illidan,192,demonhunter,havoc,6,2,4
Downbadsimp,tichondrius,192,demonhunter,havoc,6,2,4
Sarithos,frostmourne,192,demonhunter,havoc,6,2,4
Daabsdh,thrall,192,demonhunter,havoc,6,2,4
Mäläk,zuluhed,192,demonhunter,havoc,6,2,4
Narilna,stormrage,192,demonhunter,havoc,6,2,4
Jadyne,frostmourne,192,demonhunter,havoc,6,2,4
Illidanmello,proudmoore,192,demonhunter,havoc,6,2,4
Renoshan,wyrmrest-accord,192,demonhunter,havoc,6,2,4
Kezzaku,frostmourne,192,demonhunter,havoc,6,2,4
Lustsama,ragnaros,192,demonhunter,havoc,6,2,4
Berquondh,tichondrius,192,demonhunter,havoc,6,2,4
Ramrodd,nazgrel,192,demonhunter,havoc,6,2,4
Xanthrodril,illidan,192,demonhunter,havoc,6,2,4
Heptabase,tichondrius,192,demonhunter,havoc,6,2,4
Annmílls,quelthalas,192,demonhunter,havoc,6,2,4
Cursedemon,vashj,192,demonhunter,havoc,6,2,4
Lilvetis,thrall,192,demonhunter,havoc,6,2,4
Righetto,barthilas,192,demonhunter,havoc,6,2,4
Illimare,tichondrius,192,demonhunter,havoc,6,2,4
Sendingit,vashj,192,demonhunter,havoc,6,2,4
Throtegoat,illidan,192,demonhunter,havoc,6,2,4
Badservice,frostwolf,192,demonhunter,havoc,6,2,4
Cocopapa,tichondrius,192,demonhunter,havoc,6,2,4
Lvqp,barthilas,192,demonhunter,havoc,6,2,4
Wïldside,tichondrius,192,demonhunter,havoc,6,2,4
Demonslayyer,saurfang,192,demonhunter,havoc,6,2,4
Cbt,grizzly-hills,192,demonhunter,havoc,6,2,4
Lookatdishoe,tichondrius,192,demonhunter,havoc,6,2,4
Trackamp,emerald-dream,192,demonhunter,havoc,6,2,4
Felbarrah,barthilas,192,demonhunter,havoc,6,2,4
Yhell,darkspear,192,demonhunter,havoc,6,2,4
Glaíve,anvilmar,192,demonhunter,havoc,6,2,4
Cirillas,illidan,192,demonhunter,havoc,6,2,4
Frøppy,illidan,192,demonhunter,havoc,6,2,4
Kraazi,thrall,192,demonhunter,havoc,6,2,4
Cordianx,area-52,192,demonhunter,havoc,6,2,4
Jozeez,emerald-dream,192,demonhunter,havoc,6,2,4
Vulgøre,illidan,192,demonhunter,havoc,6,2,4
Frøstdh,area-52,192,demonhunter,havoc,6,2,4
Lillidanss,the-forgotten-coast,192,demonhunter,havoc,6,2,4
Valerethis,steamwheedle-cartel,192,demonhunter,havoc,6,2,4
Ambitiòn,moon-guard,192,demonhunter,havoc,6,2,4
Dlone,sargeras,192,demonhunter,havoc,6,2,4
Ausä,ragnaros,192,demonhunter,havoc,6,2,4
Buhnana,stormscale,192,demonhunter,havoc,6,2,4
Subsfordubs,illidan,192,demonhunter,havoc,6,2,4
Sodí,moon-guard,192,demonhunter,havoc,6,2,4
Demonwaffle,draka,192,demonhunter,havoc,6,2,4
Gopump,area-52,192,demonhunter,havoc,6,2,4
Illdaira,windrunner,192,demonhunter,havoc,6,2,4
Texts,norgannon,192,demonhunter,havoc,6,2,4
Shadynãsty,drakthul,192,demonhunter,havoc,6,2,4
Hoagiedevil,moon-guard,192,demonhunter,havoc,6,2,4
Imagoon,sargeras,192,demonhunter,havoc,6,2,4
Leeröy,area-52,192,demonhunter,havoc,6,2,4
Shankszs,sargeras,192,demonhunter,havoc,6,2,4
Zeldris,duskwood,192,demonhunter,havoc,6,2,4
Cryolite,sargeras,192,demonhunter,havoc,6,2,4
Renatha,ragnaros,192,demonhunter,havoc,6,2,4
Slaymore,sargeras,192,demonhunter,havoc,6,2,4
Nhoxell,ragnaros,192,demonhunter,havoc,6,2,4
Koogleblitz,sargeras,192,demonhunter,havoc,6,2,4
Falan,drakthul,192,demonhunter,havoc,6,2,4
Rykko,borean-tundra,192,demonhunter,havoc,6,2,4
Arkynth,dalaran,192,demonhunter,havoc,6,2,4
Dirtydone,area-52,192,demonhunter,havoc,6,2,4
Thesituatíon,sargeras,192,demonhunter,havoc,6,2,4
Wreckforce,blades-edge,192,demonhunter,havoc,6,2,4
Hellishunter,illidan,192,demonhunter,havoc,6,2,4
Elaurenne,sargeras,192,demonhunter,havoc,6,2,4
Qlmm,stormrage,192,demonhunter,havoc,7,2,5
Politic,area-52,192,demonhunter,havoc,11,2,9
Âduka,illidan,192,demonhunter,havoc,12,2,10
Catastroz,ragnaros,192,demonhunter,havoc,12,2,10
Hollownight,area-52,192,demonhunter,havoc,12,2,10
Gyop,azralon,192,demonhunter,havoc,12,2,10
Asharian,wyrmrest-accord,192,demonhunter,havoc,12,2,10
Cidolem,area-52,192,demonhunter,havoc,12,2,10
Denel,laughing-skull,192,demonhunter,havoc,12,2,10
Chell,stormscale,192,demonhunter,havoc,12,2,10
Ôdh,area-52,192,demonhunter,havoc,12,2,10
Kushz,dalaran,192,demonhunter,havoc,12,2,10
Kyska,tichondrius,192,demonhunter,havoc,12,2,10
Boofdh,illidan,192,demonhunter,havoc,12,2,10
Smokinops,stormrage,192,demonhunter,havoc,12,2,10
Tempésts,tichondrius,192,demonhunter,havoc,12,2,10
Garfizzle,grizzly-hills,192,demonhunter,havoc,12,2,10
Cola,illidan,192,demonhunter,havoc,12,2,10
Reikune,tichondrius,192,demonhunter,havoc,12,2,10
Bazér,frostmourne,192,demonhunter,havoc,12,2,10
Ticó,stormrage,192,demonhunter,havoc,12,2,10
Lauriale,moon-guard,192,demonhunter,havoc,12,2,10
Halaena,moon-guard,192,demonhunter,havoc,12,2,10
Daeth,skullcrusher,192,demonhunter,havoc,12,2,10
Beastforlife,sargeras,192,demonhunter,havoc,12,2,10
Spacéphoenix,stormrage,192,demonhunter,havoc,12,2,10
Pholly,altar-of-storms,191,demonhunter,havoc,6,2,4
Nomakk,greymane,191,demonhunter,havoc,6,2,4
Yesnah,emerald-dream,191,demonhunter,havoc,7,2,5
Tarasam,burning-blade,191,demonhunter,havoc,12,2,10
Feilixx,moon-guard,190,demonhunter,havoc,12,2,10
Ferunye,stormrage,159,demonhunter,havoc,5,2,3
Crustorbust,tichondrius,159,demonhunter,havoc,5,2,3
Theweektwo,drakkari,159,demonhunter,havoc,11,2,9
Raycharlés,sargeras,138,demonhunter,havoc,6,3,3
Refused,nesingwary,138,demonhunter,havoc,11,4,7
Criolex,stormrage,138,demonhunter,havoc,9,3,6
Shanjara,sargeras,138,demonhunter,havoc,15,3,12
Zanecksbinge,skullcrusher,128,demonhunter,havoc,4,2,2
Xeil,zuljin,128,demonhunter,havoc,4,2,2
Xwingpilot,arthas,127,demonhunter,havoc,8,2,6
Bottleofbirb,tichondrius,127,demonhunter,havoc,8,2,6
Tättø,area-52,96,demonhunter,havoc,3,2,1
Litball,stormrage,96,demonhunter,havoc,3,2,1
Kümï,quelthalas,96,demonhunter,havoc,3,2,1
Icewings,tichondrius,96,demonhunter,havoc,3,2,1
Blaamy,magtheridon,96,demonhunter,havoc,3,2,1
Llörne,moon-guard,96,demonhunter,havoc,6,1,5
Treblig,nerzhul,96,demonhunter,havoc,6,1,5
Demønvil,onyxia,96,demonhunter,havoc,6,1,5
Mythundorn,burning-blade,96,demonhunter,havoc,6,1,5
Solcon,exodar,96,demonhunter,havoc,6,1,5
Painqtxo,area-52,96,demonhunter,havoc,6,1,5
Chris,nordrassil,96,demonhunter,havoc,6,1,5
Memslaw,tichondrius,96,demonhunter,havoc,6,1,5
Thêworld,azralon,96,demonhunter,havoc,6,1,5
Roat,malganis,96,demonhunter,havoc,6,1,5
Theysuffer,scilla,96,demonhunter,havoc,6,1,5
Mazïkeen,uther,96,demonhunter,havoc,6,1,5
Vaestl,zuljin,96,demonhunter,havoc,6,1,5
Xänäx,azralon,96,demonhunter,havoc,6,1,5
Siegfridemon,ragnaros,96,demonhunter,havoc,6,1,5
Phosphora,dalaran,96,demonhunter,havoc,6,1,5
Aithusadh,barthilas,96,demonhunter,havoc,6,1,5
Vëngêåncé,tichondrius,96,demonhunter,havoc,6,1,5
Wubloadz,bleeding-hollow,96,demonhunter,havoc,6,1,5
Hausecat,aegwynn,96,demonhunter,havoc,6,1,5
Snazzyy,kelthuzad,96,demonhunter,havoc,6,1,5
Lostpvp,blackrock,96,demonhunter,havoc,6,1,5
Skylinetime,sargeras,96,demonhunter,havoc,6,1,5
Pighe,tichondrius,96,demonhunter,havoc,6,1,5
Musewine,tichondrius,96,demonhunter,havoc,6,1,5
Gil,moonrunner,96,demonhunter,havoc,6,1,5
Glimpsê,tichondrius,96,demonhunter,havoc,6,1,5
Chad,anvilmar,96,demonhunter,havoc,6,1,5
Safikins,tichondrius,96,demonhunter,havoc,6,1,5
Suzuha,illidan,96,demonhunter,havoc,6,1,5
Glaivee,dalaran,96,demonhunter,havoc,6,1,5
Ðemonhunterx,frostmourne,96,demonhunter,havoc,6,1,5
Constantwood,sargeras,96,demonhunter,havoc,6,1,5
Slycerr,illidan,96,demonhunter,havoc,6,1,5
Anabolicbro,tichondrius,96,demonhunter,havoc,6,1,5
Nomedi,aggramar,96,demonhunter,havoc,6,1,5
Chakan,burning-legion,96,demonhunter,havoc,6,1,5
Reezi,sargeras,96,demonhunter,havoc,6,1,5
Demonfuji,proudmoore,96,demonhunter,havoc,6,1,5
Demonleàf,area-52,96,demonhunter,havoc,6,1,5
Akammy,proudmoore,96,demonhunter,havoc,6,1,5
Scarolol,malganis,96,demonhunter,havoc,6,1,5
Arkfall,proudmoore,96,demonhunter,havoc,6,1,5
Projectalice,malganis,96,demonhunter,havoc,6,1,5
Jekyldh,tichondrius,96,demonhunter,havoc,6,1,5
Varanidae,kelthuzad,96,demonhunter,havoc,6,1,5
Marxefel,ragnaros,96,demonhunter,havoc,6,1,5
Sado,proudmoore,96,demonhunter,havoc,6,1,5
Bensonlove,tichondrius,96,demonhunter,havoc,6,1,5
Elillidan,emerald-dream,96,demonhunter,havoc,6,1,5
Kurotoo,ragnaros,96,demonhunter,havoc,6,1,5
Brgkuma,sargeras,96,demonhunter,havoc,6,1,5
Terpenese,chogall,96,demonhunter,havoc,6,1,5
Eibizoudh,sargeras,96,demonhunter,havoc,6,1,5
Carrîôn,tichondrius,96,demonhunter,havoc,6,1,5
Lokydh,tichondrius,96,demonhunter,havoc,6,1,5
Dhrongor,drakkari,96,demonhunter,havoc,6,1,5
Felblood,saurfang,96,demonhunter,havoc,6,1,5
Esøteric,area-52,96,demonhunter,havoc,6,1,5
Jerry,emerald-dream,96,demonhunter,havoc,6,1,5
Vidêl,stormrage,96,demonhunter,havoc,6,1,5
Ulfhednarxz,illidan,96,demonhunter,havoc,6,1,5
Zaythan,quelthalas,96,demonhunter,havoc,6,1,5
Majindemon,dragonmaw,96,demonhunter,havoc,6,1,5
Clutch,spirestone,96,demonhunter,havoc,6,1,5
Lantherin,sargeras,96,demonhunter,havoc,11,1,10
Gnocchis,thrall,96,demonhunter,havoc,12,1,11
Pursephone,bonechewer,96,demonhunter,havoc,12,1,11
Moonsocks,proudmoore,96,demonhunter,havoc,12,1,11
Chirøn,darkspear,96,demonhunter,havoc,12,1,11
Ichigoo,arthas,96,demonhunter,havoc,12,1,11
Aríes,dreadmaul,94,demonhunter,havoc,4,3,1
Arlén,frostmourne,79,demonhunter,havoc,5,1,4
Fellchapo,illidan,79,demonhunter,havoc,5,1,4
Miskiiv,malganis,79,demonhunter,havoc,5,1,4
Demonbluntzz,tichondrius,79,demonhunter,havoc,11,1,10
Mcthiccyy,moon-guard,64,demonhunter,havoc,4,1,3
Blackpøwér,sargeras,64,demonhunter,havoc,5,1,4
Raptorjèsus,azjolnerub,48,demonhunter,havoc,3,1,2
Jizzidari,frostmourne,48,demonhunter,havoc,3,1,2
Quoates,dalaran,48,demonhunter,havoc,3,1,2
Aryía,stormrage,48,demonhunter,havoc,3,1,2
Lifefery,quelthalas,48,demonhunter,havoc,3,1,2
Xaryic,stormrage,42,demonhunter,havoc,16,5,11
Kersplack,tichondrius,42,demonhunter,havoc,14,3,11
Mavlck,azralon,42,demonhunter,havoc,10,2,8
Pooterjuice,shadowmoon,31,demonhunter,havoc,2,1,1
Bladeset,moonrunner,31,demonhunter,havoc,2,1,1
Lathazar,darkspear,16,demonhunter,havoc,1,1,0
Iwasright,stonemaul,1488,demonhunter,vengeance,72,35,37
Slippedinfel,tichondrius,1335,demonhunter,vengeance,47,22,25
Jersey,proudmoore,1091,demonhunter,vengeance,29,17,12
Agricornia,tichondrius,826,demonhunter,vengeance,18,9,9
Nights,greymane,566,demonhunter,vengeance,12,6,6
Kysaerix,stormrage,479,demonhunter,vengeance,18,5,13
Narilis,illidan,384,demonhunter,vengeance,6,4,2
Sinfulpariah,bladefist,288,demonhunter,vengeance,6,3,3
Ferano,frostmourne,288,demonhunter,vengeance,6,3,3
Irisand,ragnaros,288,demonhunter,vengeance,6,3,3
Çherrii,moon-guard,286,demonhunter,vengeance,6,3,3
Tilltheend,illidan,239,demonhunter,vengeance,5,3,2
Asderel,zuljin,192,demonhunter,vengeance,6,2,4
Meliødaz,ragnaros,192,demonhunter,vengeance,12,2,10
Shiningvenus,stormrage,192,demonhunter,vengeance,12,2,10
Dameon,wildhammer,191,demonhunter,vengeance,6,2,4
Daymanhunter,bleeding-hollow,96,demonhunter,vengeance,6,1,5
Foodtruck,hellscream,96,demonhunter,vengeance,6,1,5
Aleymar,tichondrius,96,demonhunter,vengeance,6,1,5
Nubishe,jubeithos,96,demonhunter,vengeance,6,1,5
Gentlesoap,blackrock,96,demonhunter,vengeance,6,1,5
Mooneh,emerald-dream,96,demonhunter,vengeance,6,1,5
Supersaiyan,sargeras,64,demonhunter,vengeance,4,1,3
Grovetenderx,tichondrius,2238,druid,restoration,86,53,33
Flóp,dalaran,2238,druid,restoration,90,53,37
Linful,tichondrius,2193,druid,restoration,251,131,120
Renner,zuljin,2192,druid,restoration,109,57,52
Garbagedruid,scilla,2177,druid,restoration,229,118,111
Angrygochux,tichondrius,2170,druid,restoration,154,84,70
Liangpibro,illidan,2149,druid,restoration,103,65,38
Kobaishome,tichondrius,2148,druid,restoration,119,70,49
Omkin,tichondrius,2137,druid,restoration,120,62,58
Couragé,ragnaros,2137,druid,restoration,153,78,75
Andrwceo,stormrage,2129,druid,restoration,78,48,30
Bemelerberg,sargeras,2117,druid,restoration,113,60,53
Bestrun,tichondrius,2116,druid,restoration,108,58,50
Iån,dalaran,2055,druid,restoration,47,28,19
Commercii,tichondrius,2043,druid,restoration,72,42,30
Vers,dathremar,2037,druid,restoration,90,43,47
Shaylyne,moonrunner,2026,druid,restoration,69,41,28
Dannycarry,tichondrius,2025,druid,restoration,59,32,27
Gotheelsx,illidan,2020,druid,restoration,208,103,105
Racialmotive,illidan,2017,druid,restoration,134,76,58
Szwlol,tichondrius,2011,druid,restoration,381,200,181
Guqingshuang,tichondrius,2004,druid,restoration,109,62,47
Bigtimers,illidan,2000,druid,restoration,70,37,33
Leafynymph,tichondrius,1998,druid,restoration,61,39,22
Hchls,tichondrius,1996,druid,restoration,152,77,75
Taiwanzz,tichondrius,1994,druid,restoration,79,40,39
Druuná,kiljaeden,1985,druid,restoration,191,98,93
Sanlunainiu,tichondrius,1976,druid,restoration,178,82,96
Lenya,bleeding-hollow,1975,druid,restoration,87,49,38
Davidqx,zuljin,1968,druid,restoration,120,68,52
Gotheels,illidan,1967,druid,restoration,47,32,15
Brenden,area-52,1958,druid,restoration,150,76,74
Creamyfresh,tichondrius,1957,druid,restoration,87,44,43
Lvse,tichondrius,1955,druid,restoration,84,53,31
Rbavny,tichondrius,1954,druid,restoration,42,25,17
Pornkkimi,tichondrius,1952,druid,restoration,48,29,19
Psam,emerald-dream,1948,druid,restoration,95,54,41
Mengniulol,tichondrius,1947,druid,restoration,179,100,79
Plorenz,zuljin,1945,druid,restoration,125,70,55
Sanitizer,tichondrius,1942,druid,restoration,72,41,31
Flowen,spinebreaker,1940,druid,restoration,78,39,39
Softpawz,kelthuzad,1937,druid,restoration,83,42,41
Rorae,tichondrius,1936,druid,restoration,179,88,91
Tizzyy,eredar,1921,druid,restoration,78,43,35
Taaienberg,sargeras,1919,druid,restoration,114,54,60
Disembles,illidan,1909,druid,restoration,78,40,38
Shiftýx,tichondrius,1905,druid,restoration,77,38,39
Bobd,proudmoore,1893,druid,restoration,60,32,28
Ymy,tichondrius,1892,druid,restoration,60,30,30
Dancesdru,area-52,1888,druid,restoration,36,20,16
Treenleaves,stormrage,1888,druid,restoration,493,260,233
Saxhouse,illidan,1881,druid,restoration,60,34,26
Nikdruidne,tichondrius,1881,druid,restoration,60,29,31
Darkenëd,dalaran,1880,druid,restoration,68,41,27
Aryawilliams,area-52,1880,druid,restoration,65,36,29
Wìms,malganis,1879,druid,restoration,72,38,34
Eddí,illidan,1872,druid,restoration,64,32,32
Bashthecat,tichondrius,1871,druid,restoration,59,39,20
Nersepha,gurubashi,1871,druid,restoration,54,26,28
Drøgbä,tichondrius,1870,druid,restoration,30,20,10
Xijinfing,tichondrius,1870,druid,restoration,42,25,17
Rindy,rexxar,1869,druid,restoration,72,37,35
Ksz,stormrage,1867,druid,restoration,42,25,17
Holydruid,tichondrius,1867,druid,restoration,83,43,40
Udoyu,barthilas,1865,druid,restoration,84,39,45
Represent,tichondrius,1864,druid,restoration,48,26,22
Corbind,arthas,1860,druid,restoration,280,148,132
Loudswords,barthilas,1858,druid,restoration,102,50,52
Lotiononmyd,illidan,1853,druid,restoration,220,118,102
Bexdru,area-52,1850,druid,restoration,284,151,133
Drudma,shadowmoon,1848,druid,restoration,161,90,71
Rèmix,bleeding-hollow,1847,druid,restoration,42,23,19
Qdeb,akama,1844,druid,restoration,48,27,21
Vesoween,tichondrius,1843,druid,restoration,55,37,18
Esque,stormrage,1842,druid,restoration,48,24,24
Tokesh,malganis,1840,druid,restoration,72,33,39
Washedgodx,mugthol,1839,druid,restoration,59,34,25
Mimidelol,tichondrius,1839,druid,restoration,66,36,30
Clameo,barthilas,1839,druid,restoration,102,48,54
Janzak,thrall,1837,druid,restoration,48,28,20
Gluesmoka,icecrown,1836,druid,restoration,54,31,23
Scätmän,ragnaros,1835,druid,restoration,54,35,19
Caipirinha,tichondrius,1834,druid,restoration,47,27,20
Reehz,stormrage,1834,druid,restoration,53,25,28
Blueclàssxx,akama,1831,druid,restoration,64,48,16
Soreze,kelthuzad,1831,druid,restoration,56,35,21
Ziegey,tichondrius,1829,druid,restoration,60,34,26
Spiritot,tichondrius,1829,druid,restoration,59,28,31
Bodytwisting,tichondrius,1828,druid,restoration,48,29,19
Floofi,kelthuzad,1828,druid,restoration,54,31,23
Pvpgold,illidan,1827,druid,restoration,71,39,32
Rerolldr,firetree,1826,druid,restoration,42,24,18
Germlol,sargeras,1825,druid,restoration,51,30,21
Heymeow,tichondrius,1825,druid,restoration,60,24,36
Naturae,spirestone,1823,druid,restoration,200,112,88
Brendenjr,area-52,1819,druid,restoration,45,32,13
Thasta,blackrock,1818,druid,restoration,140,78,62
Jegara,auchindoun,1818,druid,restoration,149,81,68
Badtree,tichondrius,1816,druid,restoration,104,63,41
Resto,crushridge,1816,druid,restoration,86,44,42
Maen,kelthuzad,1816,druid,restoration,82,39,43
Currants,lightbringer,1815,druid,restoration,138,64,74
Jbdontplay,sargeras,1812,druid,restoration,59,37,22
Oinkme,kiljaeden,1811,druid,restoration,90,42,48
Tunnaris,ragnaros,1811,druid,restoration,71,33,38
Kenái,nemesis,1810,druid,restoration,30,19,11
Hlchs,tichondrius,1810,druid,restoration,36,22,14
Corcovado,bleeding-hollow,1809,druid,restoration,66,31,35
Xgodhands,sargeras,1808,druid,restoration,30,22,8
Aljalladtv,bleeding-hollow,1805,druid,restoration,30,19,11
Yggdrasil,ravencrest,1805,druid,restoration,65,31,34
Kayorva,gurubashi,1804,druid,restoration,47,24,23
Playstyle,stormrage,1801,druid,restoration,49,25,24
Fruitberry,malganis,1801,druid,restoration,53,24,29
Nayko,sargeras,1801,druid,restoration,72,30,42
Ivý,shadowsong,1800,druid,restoration,41,28,13
Mengyu,tichondrius,1800,druid,restoration,64,41,23
Kobrah,twisting-nether,1800,druid,restoration,36,20,16
Geddoff,stormrage,1800,druid,restoration,135,64,71
Zyhsul,emerald-dream,1799,druid,restoration,173,94,79
Dannypimp,tichondrius,1795,druid,restoration,47,28,19
Reizzy,sargeras,1793,druid,restoration,72,35,37
Ekr,tichondrius,1779,druid,restoration,54,29,25
Pineappledûe,tichondrius,1774,druid,restoration,64,33,31
Jdown,dalaran,1772,druid,restoration,76,43,33
Kruisberg,sargeras,1769,druid,restoration,29,19,10
Leafowl,tichondrius,1767,druid,restoration,60,32,28
Kwd,stormrage,1766,druid,restoration,77,51,26
Anaps,frostmourne,1764,druid,restoration,120,66,54
Èmax,barthilas,1763,druid,restoration,55,36,19
Sùlyvahn,tichondrius,1761,druid,restoration,57,30,27
Tweeguy,malganis,1761,druid,restoration,78,33,45
Dsheeps,tichondrius,1760,druid,restoration,48,27,21
Ellystarry,stormrage,1758,druid,restoration,90,46,44
Moldragon,crushridge,1758,druid,restoration,48,24,24
Gloomster,tichondrius,1756,druid,restoration,64,37,27
Héisénbérg,sargeras,1755,druid,restoration,192,99,93
Kellogs,malganis,1752,druid,restoration,65,26,39
Flowdruid,tichondrius,1751,druid,restoration,51,26,25
Bigdockepoch,sargeras,1743,druid,restoration,35,21,14
Surefacts,dathremar,1738,druid,restoration,40,21,19
Gsex,nemesis,1738,druid,restoration,46,24,22
Branchmanagr,dark-iron,1736,druid,restoration,54,23,31
Gankstanerdz,tichondrius,1732,druid,restoration,178,85,93
Facegotrake,stormrage,1730,druid,restoration,114,64,50
Fattdiabetic,tichondrius,1726,druid,restoration,42,24,18
Wëndell,tichondrius,1720,druid,restoration,48,24,24
Zrobloom,stormrage,1720,druid,restoration,69,29,40
Dirtdog,uther,1719,druid,restoration,53,25,28
Lovenug,shadowsong,1715,druid,restoration,179,98,81
Légz,area-52,1714,druid,restoration,187,98,89
Airmeodaddy,barthilas,1714,druid,restoration,99,50,49
Bigmoran,tichondrius,1708,druid,restoration,54,24,30
Drjelly,tichondrius,1707,druid,restoration,76,32,44
Huaxià,tichondrius,1705,druid,restoration,209,114,95
Yungdoinkski,icecrown,1704,druid,restoration,28,19,9
Rdruid,zuluhed,1703,druid,restoration,34,24,10
Pizzatimex,zuluhed,1703,druid,restoration,120,61,59
Hideurkidz,tichondrius,1699,druid,restoration,39,23,16
Dmxx,kiljaeden,1696,druid,restoration,33,19,14
Thundercast,quelthalas,1694,druid,restoration,164,82,82
Stupidtree,antonidas,1693,druid,restoration,47,28,19
Sooey,wyrmrest-accord,1690,druid,restoration,85,51,34
Socialyst,area-52,1688,druid,restoration,35,21,14
Bramii,illidan,1686,druid,restoration,69,35,34
Ayalia,saurfang,1684,druid,restoration,48,25,23
Relbedo,sargeras,1681,druid,restoration,174,95,79
Cienza,proudmoore,1680,druid,restoration,264,136,128
Polyester,frostmourne,1679,druid,restoration,54,25,29
Poliage,moon-guard,1677,druid,restoration,230,117,113
Dabloleu,illidan,1675,druid,restoration,24,19,5
Roen,tichondrius,1672,druid,restoration,40,21,19
Boonsogan,tichondrius,1672,druid,restoration,36,18,18
Remus,hydraxis,1672,druid,restoration,66,31,35
Hxa,emerald-dream,1669,druid,restoration,64,31,33
Enrÿu,nemesis,1668,druid,restoration,42,21,21
Afkhottedyou,suramar,1667,druid,restoration,46,24,22
Arwëna,tichondrius,1663,druid,restoration,72,44,28
Chevy,onyxia,1663,druid,restoration,82,33,49
Treeofangels,nathrezim,1662,druid,restoration,36,22,14
Zblmystic,tichondrius,1662,druid,restoration,78,43,35
Legitonedge,zuljin,1662,druid,restoration,55,30,25
Tondrai,malganis,1659,druid,restoration,54,30,24
Jathel,area-52,1659,druid,restoration,42,22,20
Zoteqt,kelthuzad,1657,druid,restoration,48,25,23
Lubbeck,stormrage,1653,druid,restoration,157,87,70
Chimnie,malganis,1652,druid,restoration,45,27,18
Notpodruida,tichondrius,1649,druid,restoration,48,28,20
Druidstin,tichondrius,1649,druid,restoration,162,84,78
Dbk,suramar,1648,druid,restoration,170,102,68
Klamediya,illidan,1648,druid,restoration,53,21,32
Psyqobloom,dalaran,1647,druid,restoration,136,78,58
Widescreen,burning-blade,1647,druid,restoration,398,209,189
Defteras,illidan,1647,druid,restoration,42,21,21
Animalge,sargeras,1643,druid,restoration,60,25,35
Sixthsex,tichondrius,1642,druid,restoration,95,51,44
Dendrix,area-52,1641,druid,restoration,90,46,44
Gsëx,nemesis,1640,druid,restoration,47,22,25
Tayriel,area-52,1640,druid,restoration,57,26,31
Sosaformx,stormrage,1639,druid,restoration,47,21,26
Convokíng,kelthuzad,1639,druid,restoration,53,20,33
Images,kilrogg,1638,druid,restoration,54,37,17
Pkgdbts,tichondrius,1637,druid,restoration,47,22,25
Breaksilence,tichondrius,1636,druid,restoration,59,36,23
Birdfromtree,dalaran,1636,druid,restoration,48,26,22
Pootyleaf,daggerspine,1636,druid,restoration,60,28,32
Lifeboomer,ragnaros,1634,druid,restoration,79,48,31
Druinin,archimonde,1634,druid,restoration,122,59,63
Pekazay,illidan,1632,druid,restoration,79,41,38
Luckyslot,frostmourne,1631,druid,restoration,36,21,15
Moomooheal,moon-guard,1631,druid,restoration,237,124,113
Krevy,nazgrel,1631,druid,restoration,114,54,60
Durintor,nemesis,1630,druid,restoration,135,72,63
Dexlol,area-52,1629,druid,restoration,18,17,1
Pawsbutton,stormrage,1629,druid,restoration,30,20,10
Aiyouyou,tichondrius,1628,druid,restoration,219,123,96
Cheddy,tichondrius,1628,druid,restoration,77,43,34
Addiedru,zuljin,1627,druid,restoration,69,32,37
Kamisamalee,tichondrius,1626,druid,restoration,41,25,16
Viscentdd,illidan,1626,druid,restoration,36,17,19
Acdru,tichondrius,1624,druid,restoration,54,26,28
Venomgtz,laughing-skull,1623,druid,restoration,254,139,115
Sarrati,emerald-dream,1623,druid,restoration,182,98,84
Rapttors,zuljin,1623,druid,restoration,48,20,28
Riiccflaiir,stormrage,1622,druid,restoration,78,45,33
Wolfis,malganis,1622,druid,restoration,36,20,16
Cybeé,sargeras,1621,druid,restoration,48,19,29
Terkpla,ragnaros,1618,druid,restoration,118,64,54
Suublime,ragnaros,1618,druid,restoration,72,34,38
Tigerpaw,eonar,1618,druid,restoration,59,24,35
Lobsterdruid,area-52,1617,druid,restoration,36,21,15
Kaperij,sargeras,1617,druid,restoration,30,17,13
Asmitar,illidan,1616,druid,restoration,36,22,14
Muhu,frostmourne,1615,druid,restoration,60,35,25
Gødriç,tichondrius,1614,druid,restoration,221,112,109
Elyl,tichondrius,1614,druid,restoration,48,23,25
Dkfm,thrall,1613,druid,restoration,546,284,262
Gulperberg,sargeras,1612,druid,restoration,30,25,5
Soheezy,illidan,1612,druid,restoration,198,111,87
Drainean,sargeras,1611,druid,restoration,30,17,13
Hxm,tichondrius,1611,druid,restoration,35,17,18
Pigheaddru,tichondrius,1611,druid,restoration,54,22,32
Hideurchickn,tichondrius,1609,druid,restoration,36,23,13
Douwantoplay,tichondrius,1607,druid,restoration,60,32,28
Fhiziod,kelthuzad,1606,druid,restoration,74,44,30
Jathy,area-52,1606,druid,restoration,51,21,30
Kurrious,frostmourne,1605,druid,restoration,40,18,22
Kimdeokbae,tichondrius,1604,druid,restoration,30,22,8
Binionsolboy,illidan,1604,druid,restoration,36,18,18
Qidzerker,arathor,1602,druid,restoration,119,61,58
Minisavage,proudmoore,1601,druid,restoration,36,17,19
Yavannita,quelthalas,1600,druid,restoration,57,36,21
Hehaw,kelthuzad,1600,druid,restoration,152,87,65
Sanninx,barthilas,1600,druid,restoration,54,29,25
Opiumheals,sargeras,1598,druid,restoration,74,42,32
Manycyclones,zuluhed,1598,druid,restoration,60,32,28
Erral,malganis,1597,druid,restoration,57,26,31
Kaleaky,thrall,1595,druid,restoration,99,53,46
Elven,frostmourne,1594,druid,restoration,54,20,34
Kznels,tichondrius,1592,druid,restoration,43,27,16
Shìfty,emerald-dream,1589,druid,restoration,44,23,21
Imroot,tichondrius,1588,druid,restoration,54,32,22
Morphiq,tichondrius,1588,druid,restoration,147,78,69
Errane,eonar,1587,druid,restoration,199,110,89
Calmd,sargeras,1585,druid,restoration,30,21,9
Poscow,tichondrius,1583,druid,restoration,45,25,20
Shinjis,tichondrius,1582,druid,restoration,108,51,57
Silentbeer,frostmourne,1581,druid,restoration,218,112,106
Chutney,windrunner,1581,druid,restoration,46,21,25
Armorkits,area-52,1575,druid,restoration,33,17,16
Boomtastik,frostmourne,1574,druid,restoration,108,46,62
Møøncry,ragnaros,1571,druid,restoration,154,73,81
Woshiyigede,frostmourne,1571,druid,restoration,98,43,55
Nerfthedruid,blackrock,1569,druid,restoration,36,25,11
Gìtgoodtrash,frostmourne,1569,druid,restoration,82,41,41
Lauramavra,azralon,1568,druid,restoration,334,179,155
Sombér,eitrigg,1568,druid,restoration,72,24,48
Duragx,bleeding-hollow,1567,druid,restoration,100,62,38
Manzar,illidan,1566,druid,restoration,42,22,20
Moonpaws,frostmourne,1564,druid,restoration,36,22,14
Zyzzema,frostmourne,1559,druid,restoration,174,82,92
Staraborn,stormrage,1558,druid,restoration,409,217,192
Ojotasesina,ragnaros,1557,druid,restoration,48,22,26
Naturist,kelthuzad,1557,druid,restoration,53,19,34
Dumberdruid,frostmourne,1553,druid,restoration,36,20,16
Hayase,tichondrius,1551,druid,restoration,42,25,17
Gunnymad,tichondrius,1549,druid,restoration,36,21,15
Gonimydear,proudmoore,1549,druid,restoration,216,108,108
Meniscus,arthas,1549,druid,restoration,59,25,34
Druxe,zuljin,1546,druid,restoration,115,53,62
Rasgabuxoh,azralon,1545,druid,restoration,41,21,20
Bedlam,zuljin,1544,druid,restoration,60,25,35
Moonyy,emerald-dream,1542,druid,restoration,42,20,22
Leleoceo,azralon,1541,druid,restoration,30,19,11
Maplêleaf,moon-guard,1539,druid,restoration,414,216,198
Bruitzya,barthilas,1537,druid,restoration,45,30,15
Frydaze,tichondrius,1535,druid,restoration,54,26,28
Evokade,dalaran,1534,druid,restoration,42,28,14
Hravan,dentarg,1534,druid,restoration,49,26,23
Jrën,tichondrius,1533,druid,restoration,24,16,8
Nikotser,dreadmaul,1531,druid,restoration,39,18,21
Zhn,sargeras,1530,druid,restoration,35,21,14
Utterhots,bleeding-hollow,1530,druid,restoration,174,98,76
Rizzit,wyrmrest-accord,1530,druid,restoration,352,186,166
Ourse,frostmourne,1528,druid,restoration,35,23,12
Creamjr,tichondrius,1528,druid,restoration,30,16,14
Unis,tichondrius,1528,druid,restoration,37,19,18
Poscod,tichondrius,1528,druid,restoration,54,24,30
Spurzky,emerald-dream,1526,druid,restoration,46,26,20
Pilcosbie,stormrage,1526,druid,restoration,42,21,21
Mortqt,tichondrius,1524,druid,restoration,96,44,52
Swiftydel,frostmourne,1522,druid,restoration,109,61,48
Madowl,tichondrius,1522,druid,restoration,48,22,26
Seamandeman,sargeras,1520,druid,restoration,119,64,55
Classydruid,spinebreaker,1520,druid,restoration,295,152,143
Aberdare,tichondrius,1519,druid,restoration,141,78,63
Buffdisc,darkspear,1518,druid,restoration,18,16,2
Furrytorpedo,tichondrius,1518,druid,restoration,54,30,24
Oneinchclaw,malganis,1518,druid,restoration,176,96,80
Bfaboomy,stormrage,1517,druid,restoration,30,16,14
Lilbigcow,gnomeregan,1515,druid,restoration,176,77,99
Hotwolf,tichondrius,1510,druid,restoration,42,26,16
Icehulk,kelthuzad,1510,druid,restoration,30,16,14
Roachsan,tichondrius,1510,druid,restoration,103,54,49
Cndistance,tichondrius,1509,druid,restoration,83,42,41
Methyld,frostmourne,1508,druid,restoration,96,36,60
Cokernut,tichondrius,1507,druid,restoration,30,16,14
Sanitaizr,arthas,1506,druid,restoration,54,25,29
Empcassi,wyrmrest-accord,1505,druid,restoration,95,59,36
Baduret,dalaran,1505,druid,restoration,55,33,22
Lolomas,proudmoore,1501,druid,restoration,48,22,26
Redpigo,tichondrius,1497,druid,restoration,36,18,18
Junjunxi,tichondrius,1496,druid,restoration,36,26,10
Redo,zuluhed,1496,druid,restoration,30,16,14
Mxlasthope,stormrage,1495,druid,restoration,47,26,21
Overthink,daggerspine,1492,druid,restoration,24,16,8
Barecow,tichondrius,1491,druid,restoration,105,58,47
Akeven,illidan,1491,druid,restoration,68,31,37
Berzz,frostmourne,1487,druid,restoration,229,112,117
Dypx,tichondrius,1485,druid,restoration,172,85,87
Rowlex,moon-guard,1483,druid,restoration,22,17,5
Bodyluvlee,zuljin,1482,druid,restoration,80,44,36
Hotemz,dragonmaw,1481,druid,restoration,78,43,35
Knottywood,muradin,1481,druid,restoration,53,28,25
Stonemonkey,sargeras,1480,druid,restoration,85,38,47
Counsyl,silvermoon,1478,druid,restoration,30,18,12
Varmint,bleeding-hollow,1477,druid,restoration,88,52,36
Pëndulum,illidan,1477,druid,restoration,78,34,44
Zoeishyper,sargeras,1477,druid,restoration,47,18,29
Gizho,dark-iron,1476,druid,restoration,33,19,14
Meruemoo,tichondrius,1476,druid,restoration,374,186,188
Selling,moon-guard,1476,druid,restoration,60,27,33
Growl,jubeithos,1476,druid,restoration,48,19,29
Pancitas,quelthalas,1475,druid,restoration,108,57,51
Ojdidnt,bleeding-hollow,1474,druid,restoration,33,17,16
Sowo,sargeras,1474,druid,restoration,42,20,22
Rlzdruid,tichondrius,1474,druid,restoration,70,31,39
Lutein,tichondrius,1474,druid,restoration,77,31,46
Bobx,kelthuzad,1467,druid,restoration,66,26,40
Hdruid,tichondrius,1465,druid,restoration,160,79,81
Spuncone,frostmourne,1463,druid,restoration,42,24,18
Greylyth,moon-guard,1462,druid,restoration,66,33,33
Tandrood,tichondrius,1462,druid,restoration,54,24,30
Unpeelable,stormrage,1460,druid,restoration,24,16,8
Gokki,zuljin,1459,druid,restoration,40,25,15
Elliar,akama,1459,druid,restoration,78,38,40
Léaf,velen,1457,druid,restoration,74,40,34
Bitsandbobs,tichondrius,1457,druid,restoration,119,48,71
Faramar,sargeras,1456,druid,restoration,35,16,19
Fukwitmefamo,kelthuzad,1455,druid,restoration,64,36,28
Lothail,windrunner,1454,druid,restoration,30,19,11
Volktots,bleeding-hollow,1453,druid,restoration,102,55,47
Chaníng,frostmourne,1452,druid,restoration,36,18,18
Gypsysoul,barthilas,1450,druid,restoration,29,16,13
Busanmilk,tichondrius,1445,druid,restoration,60,29,31
Shapedance,sargeras,1445,druid,restoration,78,33,45
Weedmunchies,kelthuzad,1443,druid,restoration,48,23,25
Rikishi,executus,1441,druid,restoration,52,27,25
Druidnim,tichondrius,1441,druid,restoration,72,34,38
Fergsy,frostmourne,1440,druid,restoration,30,19,11
Larissaelar,tichondrius,1438,druid,restoration,18,15,3
Ÿozsh,azralon,1436,druid,restoration,58,36,22
Lusam,korialstrasz,1435,druid,restoration,40,23,17
Zaelos,proudmoore,1435,druid,restoration,60,23,37
Hoebaz,tichondrius,1434,druid,restoration,24,15,9
Rougaroux,andorhal,1434,druid,restoration,168,75,93
Arkenix,velen,1433,druid,restoration,42,21,21
Jonnygg,illidan,1433,druid,restoration,36,15,21
Clubroot,sargeras,1433,druid,restoration,48,19,29
Vuru,azralon,1432,druid,restoration,72,33,39
Vakimumu,anubarak,1429,druid,restoration,96,46,50
Sakpase,area-52,1428,druid,restoration,30,15,15
Grimo,illidan,1427,druid,restoration,38,23,15
Treelomilo,stormrage,1427,druid,restoration,85,49,36
Thornblade,stormrage,1427,druid,restoration,30,15,15
Strokingmyd,illidan,1427,druid,restoration,63,31,32
Spoogel,area-52,1426,druid,restoration,37,17,20
Hyne,emerald-dream,1425,druid,restoration,114,62,52
Bruujz,moon-guard,1424,druid,restoration,54,33,21
Blinxxy,bleeding-hollow,1423,druid,restoration,42,21,21
Nestaballo,illidan,1422,druid,restoration,136,74,62
Shirô,bleeding-hollow,1421,druid,restoration,115,59,56
Prevail,nazgrel,1420,druid,restoration,127,66,61
Saego,draktharon,1419,druid,restoration,30,18,12
Haymade,sargeras,1419,druid,restoration,84,40,44
Cakeinalake,bleeding-hollow,1417,druid,restoration,24,15,9
Lucked,tichondrius,1415,druid,restoration,24,15,9
Aristeus,kelthuzad,1414,druid,restoration,269,143,126
Komaner,frostmourne,1414,druid,restoration,48,21,27
Cinderellax,illidan,1412,druid,restoration,30,20,10
Kaerrort,sargeras,1412,druid,restoration,26,15,11
Hibernate,illidan,1411,druid,restoration,30,15,15
Tippsyy,frostmane,1411,druid,restoration,100,42,58
Brandonxerox,tichondrius,1410,druid,restoration,45,24,21
Verkara,stormrage,1410,druid,restoration,94,42,52
Eviltwín,frostmourne,1409,druid,restoration,42,22,20
Meepø,mugthol,1409,druid,restoration,115,60,55
Approx,tichondrius,1409,druid,restoration,145,68,77
Tickman,altar-of-storms,1409,druid,restoration,48,22,26
Cutely,tichondrius,1408,druid,restoration,171,84,87
Ozanji,wyrmrest-accord,1406,druid,restoration,30,17,13
Xhoz,tichondrius,1406,druid,restoration,213,113,100
Isiliar,nerzhul,1405,druid,restoration,66,35,31
Anotherstar,frostmourne,1403,druid,restoration,175,87,88
Twentyfour,laughing-skull,1402,druid,restoration,72,30,42
Gôdôfwow,tichondrius,1402,druid,restoration,77,31,46
Pÿe,bleeding-hollow,1401,druid,restoration,30,15,15
Biggucci,stonemaul,1399,druid,restoration,30,18,12
Kybecruz,stormrage,1399,druid,restoration,103,52,51
Ursiiday,sargeras,1399,druid,restoration,90,32,58
Astrosapien,moon-guard,1397,druid,restoration,42,27,15
Pouncing,sargeras,1397,druid,restoration,56,29,27
Bobobear,proudmoore,1397,druid,restoration,66,28,38
Cyclone,mugthol,1396,druid,restoration,24,19,5
Seizuressld,stormrage,1395,druid,restoration,81,46,35
Bridgerén,tichondrius,1395,druid,restoration,36,15,21
Fryy,balnazzar,1394,druid,restoration,36,17,19
Murkeÿ,frostmourne,1391,druid,restoration,24,15,9
Onblue,tichondrius,1391,druid,restoration,44,27,17
Lorern,eldrethalas,1390,druid,restoration,60,30,30
Lexut,ragnaros,1388,druid,restoration,36,16,20
Drchronic,boulderfist,1387,druid,restoration,59,32,27
Kroshape,stormrage,1385,druid,restoration,49,22,27
Darimmx,mannoroth,1384,druid,restoration,126,64,62
Nanniel,tichondrius,1383,druid,restoration,54,24,30
Mkat,illidan,1383,druid,restoration,48,19,29
Haful,emerald-dream,1382,druid,restoration,45,23,22
Icastsmells,tichondrius,1381,druid,restoration,57,36,21
Maviç,hyjal,1380,druid,restoration,287,147,140
Okiesmokied,proudmoore,1378,druid,restoration,30,17,13
Clarice,shattered-halls,1376,druid,restoration,42,17,25
Lostnsauce,tichondrius,1375,druid,restoration,72,30,42
Maaui,sargeras,1374,druid,restoration,48,24,24
Jimjab,stormreaver,1371,druid,restoration,66,39,27
Fioryxd,bleeding-hollow,1370,druid,restoration,47,26,21
Horymory,darkspear,1370,druid,restoration,216,109,107
Pollished,kelthuzad,1369,druid,restoration,89,50,39
Azshunara,moon-guard,1369,druid,restoration,84,43,41
Deamondruidz,kaelthas,1367,druid,restoration,78,31,47
Farmageddon,thunderhorn,1365,druid,restoration,58,33,25
Poutyface,sargeras,1364,druid,restoration,152,67,85
Vinnydruid,tichondrius,1364,druid,restoration,35,15,20
Rawrl,illidan,1363,druid,restoration,36,16,20
Edraen,zuljin,1362,druid,restoration,137,67,70
Daku,moknathal,1362,druid,restoration,64,31,33
Vondutch,tichondrius,1362,druid,restoration,60,24,36
Sorrinn,tichondrius,1361,druid,restoration,36,17,19
Skêet,tichondrius,1359,druid,restoration,49,28,21
Santiagowski,ragnaros,1359,druid,restoration,52,26,26
Shifftycent,trollbane,1359,druid,restoration,54,26,28
Amandi,magtheridon,1358,druid,restoration,42,23,19
Bloodshadez,tichondrius,1358,druid,restoration,38,20,18
Lorca,stormrage,1357,druid,restoration,60,35,25
Wythrim,quelthalas,1357,druid,restoration,30,17,13
Silit,tichondrius,1355,druid,restoration,78,41,37
Kergai,emerald-dream,1355,druid,restoration,102,53,49
Muatigorn,blackrock,1354,druid,restoration,50,25,25
Jungleakso,tichondrius,1354,druid,restoration,36,18,18
Duckyy,garithos,1354,druid,restoration,60,24,36
Bigrich,malorne,1352,druid,restoration,48,23,25
Oobuck,kilrogg,1350,druid,restoration,123,63,60
Kevarcen,dalaran,1350,druid,restoration,161,79,82
Heniuhojia,tichondrius,1348,druid,restoration,24,15,9
Malfurionis,tichondrius,1347,druid,restoration,42,17,25
Branu,hyjal,1347,druid,restoration,42,15,27
Corkybucek,frostmourne,1346,druid,restoration,56,32,24
Izzabelle,deathwing,1344,druid,restoration,31,17,14
Amanthw,tichondrius,1344,druid,restoration,77,34,43
Delody,tichondrius,1343,druid,restoration,38,23,15
Puzzlebox,illidan,1343,druid,restoration,24,14,10
Kimnim,tichondrius,1343,druid,restoration,108,57,51
Mandingodam,auchindoun,1341,druid,restoration,36,16,20
Cantmeldthis,zuljin,1340,druid,restoration,30,14,16
Bearthisnut,bonechewer,1340,druid,restoration,36,15,21
Bleedhoof,frostmourne,1340,druid,restoration,48,19,29
Hoeba,tichondrius,1339,druid,restoration,24,14,10
Redness,daggerspine,1339,druid,restoration,37,19,18
Groschats,area-52,1339,druid,restoration,42,14,28
Ripberg,chogall,1338,druid,restoration,30,14,16
Cznfik,area-52,1338,druid,restoration,78,32,46
Eraticdruid,illidan,1338,druid,restoration,42,16,26
Doglightning,illidan,1336,druid,restoration,25,15,10
Kronik,jubeithos,1336,druid,restoration,79,25,54
Beefyhealz,emerald-dream,1335,druid,restoration,91,56,35
Petmydeadcow,illidan,1335,druid,restoration,157,78,79
Vecuronium,tichondrius,1335,druid,restoration,30,14,16
Joopsy,tichondrius,1332,druid,restoration,269,141,128
Anchunlol,tichondrius,1332,druid,restoration,36,18,18
Mudpi,illidan,1332,druid,restoration,71,34,37
Turftiger,stormrage,1331,druid,restoration,30,16,14
Bukbukboom,thunderlord,1331,druid,restoration,35,16,19
Toslick,kelthuzad,1330,druid,restoration,183,98,85
Girthture,tichondrius,1330,druid,restoration,130,63,67
Dolwizz,tichondrius,1330,druid,restoration,126,54,72
Kritscawk,sargeras,1329,druid,restoration,60,33,27
Hynz,barthilas,1327,druid,restoration,36,15,21
Dunedaddy,silvermoon,1326,druid,restoration,48,27,21
Dokasaurus,lightbringer,1325,druid,restoration,36,17,19
Phåtkid,darkspear,1322,druid,restoration,48,24,24
Hippystick,tichondrius,1321,druid,restoration,52,24,28
Puntcounder,sargeras,1320,druid,restoration,40,21,19
Nxghtfall,tichondrius,1319,druid,restoration,122,65,57
Feraldudu,illidan,1319,druid,restoration,97,49,48
Undaunted,bloodhoof,1319,druid,restoration,30,14,16
Youngteezy,barthilas,1319,druid,restoration,142,53,89
Tîgerlily,proudmoore,1318,druid,restoration,42,16,26
Áçxpërt,jubeithos,1316,druid,restoration,24,14,10
Rwi,tichondrius,1316,druid,restoration,111,51,60
Controlyolo,stormrage,1314,druid,restoration,48,22,26
Zelyvia,moon-guard,1313,druid,restoration,24,14,10
Freehealjob,lightnings-blade,1313,druid,restoration,30,14,16
Gladelf,sargeras,1312,druid,restoration,282,141,141
Kzinti,zuluhed,1312,druid,restoration,30,14,16
Donnà,tichondrius,1310,druid,restoration,43,21,22
Adaralia,tichondrius,1310,druid,restoration,64,27,37
Ghirox,stormrage,1306,druid,restoration,54,26,28
Minokawa,kargath,1305,druid,restoration,44,23,21
Dgdruid,tichondrius,1305,druid,restoration,48,24,24
Benjixx,proudmoore,1305,druid,restoration,48,20,28
Dolanaar,stormrage,1304,druid,restoration,161,86,75
Reyvin,illidan,1304,druid,restoration,79,32,47
Gaawdx,illidan,1303,druid,restoration,54,25,29
Taufik,azralon,1301,druid,restoration,42,15,27
Needabandaid,arthas,1300,druid,restoration,54,26,28
Yoshí,emerald-dream,1299,druid,restoration,51,22,29
Purpleleaves,stormrage,1299,druid,restoration,119,51,68
Bigherbo,zuljin,1298,druid,restoration,187,98,89
Kittyboiz,illidan,1298,druid,restoration,72,37,35
Haohomie,tichondrius,1297,druid,restoration,59,31,28
Aaughh,sargeras,1297,druid,restoration,70,33,37
Lighthoof,mannoroth,1296,druid,restoration,30,17,13
Rooroo,ragnaros,1296,druid,restoration,28,15,13
Pronewb,frostmourne,1295,druid,restoration,24,18,6
Melbian,tichondrius,1295,druid,restoration,124,70,54
Entydruid,khazgoroth,1295,druid,restoration,34,19,15
Plagiarist,stormrage,1295,druid,restoration,44,20,24
Ohhshiift,tichondrius,1295,druid,restoration,33,14,19
Dankmids,hyjal,1294,druid,restoration,30,19,11
Elvishchamp,mugthol,1294,druid,restoration,35,17,18
Kuwä,proudmoore,1293,druid,restoration,274,135,139
Feutrine,zuljin,1292,druid,restoration,24,14,10
Caustìk,malganis,1291,druid,restoration,70,38,32
Haneulso,tichondrius,1290,druid,restoration,55,30,25
Standee,sargeras,1290,druid,restoration,48,18,30
Magicrock,moon-guard,1285,druid,restoration,42,23,19
Apoxi,arygos,1284,druid,restoration,42,24,18
Quss,tichondrius,1283,druid,restoration,25,15,10
Rígo,frostmourne,1282,druid,restoration,27,16,11
Ananan,burning-blade,1282,druid,restoration,101,49,52
Ravendar,moon-guard,1282,druid,restoration,89,39,50
Shallowcat,tichondrius,1281,druid,restoration,65,28,37
Däll,tichondrius,1280,druid,restoration,48,20,28
Chyx,stormreaver,1280,druid,restoration,50,20,30
Nogàrd,arygos,1279,druid,restoration,23,14,9
Birdie,dalvengyr,1279,druid,restoration,37,20,17
Morphios,barthilas,1279,druid,restoration,82,40,42
Naseebo,frostmourne,1279,druid,restoration,67,25,42
Zambyr,azralon,1278,druid,restoration,66,28,38
Rawbacon,blackrock,1278,druid,restoration,50,18,32
Whispurrz,tichondrius,1277,druid,restoration,391,200,191
Elendriss,quelthalas,1277,druid,restoration,85,42,43
Afonso,frostmourne,1276,druid,restoration,50,26,24
Wp,proudmoore,1275,druid,restoration,80,42,38
Odcerberus,azralon,1275,druid,restoration,42,21,21
Juuru,stormreaver,1272,druid,restoration,36,27,9
Thericebags,illidan,1272,druid,restoration,161,86,75
Darksteak,tichondrius,1272,druid,restoration,214,111,103
Tenhoteta,goldrinn,1272,druid,restoration,48,22,26
Jruids,stormrage,1272,druid,restoration,54,23,31
Hellahots,spinebreaker,1271,druid,restoration,29,18,11
Drazibaz,thrall,1271,druid,restoration,42,24,18
Sxlanderx,malganis,1271,druid,restoration,118,58,60
Diglit,malganis,1271,druid,restoration,70,28,42
Ephemere,emerald-dream,1268,druid,restoration,40,20,20
Lynncheeks,spirestone,1267,druid,restoration,77,44,33
Tallenzz,lightninghoof,1265,druid,restoration,96,53,43
Cleptoresto,dalaran,1265,druid,restoration,46,16,30
Elgatomarica,ragnaros,1264,druid,restoration,35,20,15
Shanê,proudmoore,1263,druid,restoration,61,31,30
Iambeefy,hyjal,1263,druid,restoration,233,116,117
Slév,frostmourne,1263,druid,restoration,35,17,18
Acexten,tichondrius,1262,druid,restoration,36,18,18
Thõrr,tichondrius,1262,druid,restoration,42,16,26
Aterra,ragnaros,1261,druid,restoration,92,44,48
Asaphelps,stormrage,1260,druid,restoration,28,14,14
Ceejaé,tichondrius,1259,druid,restoration,70,36,34
Nanate,sargeras,1259,druid,restoration,47,24,23
Vexcey,sargeras,1258,druid,restoration,29,16,13
Greenvibes,drakkari,1257,druid,restoration,77,42,35
Lindi,kelthuzad,1257,druid,restoration,78,42,36
Bovindickus,tichondrius,1257,druid,restoration,66,28,38
Kerrzo,frostmourne,1256,druid,restoration,36,17,19
Filthyclaws,stormrage,1256,druid,restoration,35,14,21
Crackheads,tichondrius,1255,druid,restoration,91,45,46
Travys,sargeras,1255,druid,restoration,42,20,22
Groõt,barthilas,1253,druid,restoration,177,82,95
Skotty,hyjal,1253,druid,restoration,66,30,36
Rockmeifucan,greymane,1253,druid,restoration,78,33,45
Chowyunfats,proudmoore,1251,druid,restoration,331,170,161
Katherine,moon-guard,1251,druid,restoration,132,62,70
Yakuho,proudmoore,1250,druid,restoration,32,20,12
Carlosd,tichondrius,1250,druid,restoration,58,33,25
Romcom,demon-soul,1250,druid,restoration,48,27,21
Jacknit,illidan,1250,druid,restoration,28,15,13
Airmíd,illidan,1250,druid,restoration,68,22,46
Saelyle,illidan,1248,druid,restoration,53,28,25
Skymund,tichondrius,1247,druid,restoration,50,26,24
Yaato,illidan,1247,druid,restoration,96,46,50
Ninzor,tichondrius,1247,druid,restoration,30,13,17
Cøkelol,zuljin,1246,druid,restoration,52,29,23
Jnzid,area-52,1244,druid,restoration,29,13,16
Hgoo,tichondrius,1244,druid,restoration,30,13,17
Bunrack,nerzhul,1243,druid,restoration,57,30,27
Krözjk,quelthalas,1243,druid,restoration,57,26,31
Fórmérfáttý,kelthuzad,1242,druid,restoration,18,13,5
Goosebümps,stormrage,1242,druid,restoration,24,13,11
Perilous,malygos,1242,druid,restoration,24,13,11
Sharkhotzlol,frostmourne,1242,druid,restoration,42,14,28
Kasannaommi,sargeras,1241,druid,restoration,96,49,47
Speaks,moon-guard,1240,druid,restoration,131,62,69
Kendoboos,moon-guard,1240,druid,restoration,72,32,40
Cuccii,sargeras,1240,druid,restoration,30,13,17
Socktad,illidan,1240,druid,restoration,36,13,23
Sarojna,malganis,1239,druid,restoration,18,13,5
Kustumsdog,tichondrius,1239,druid,restoration,24,13,11
Healingcute,tichondrius,1239,druid,restoration,131,70,61
Lazza,blackhand,1239,druid,restoration,28,14,14
Feldstarx,stormrage,1238,druid,restoration,24,13,11
Larc,frostwolf,1238,druid,restoration,76,39,37
Magzally,stormrage,1238,druid,restoration,30,13,17
Kyndel,kiljaeden,1237,druid,restoration,44,22,22
Amatxu,ragnaros,1237,druid,restoration,129,64,65
Galadrielcn,tichondrius,1235,druid,restoration,42,15,27
Lissette,thrall,1234,druid,restoration,24,13,11
Veganz,moon-guard,1233,druid,restoration,145,71,74
Svarne,kiljaeden,1232,druid,restoration,59,29,30
Shekelsnätch,area-52,1231,druid,restoration,42,21,21
Smilax,eonar,1231,druid,restoration,71,29,42
Mhdd,tichondrius,1230,druid,restoration,54,25,29
Slev,frostmourne,1229,druid,restoration,24,13,11
Rahaab,sargeras,1229,druid,restoration,38,13,25
Preachirr,lightbringer,1227,druid,restoration,18,13,5
Kupos,lightbringer,1227,druid,restoration,27,13,14
Bhagwan,area-52,1227,druid,restoration,48,18,30
Imakitty,aerie-peak,1226,druid,restoration,121,62,59
Carneluna,area-52,1226,druid,restoration,66,31,35
Suye,tichondrius,1226,druid,restoration,66,30,36
Xay,runetotem,1225,druid,restoration,36,20,16
Wildwhisper,moon-guard,1225,druid,restoration,96,50,46
Carllo,blackrock,1225,druid,restoration,48,23,25
Junglefists,frostmourne,1223,druid,restoration,162,81,81
Bumî,zuljin,1223,druid,restoration,30,13,17
Yellowstone,drakthul,1222,druid,restoration,42,23,19
Purrfact,frostmourne,1222,druid,restoration,30,13,17
Torofarmeon,quelthalas,1221,druid,restoration,57,32,25
Anothersalad,stormrage,1221,druid,restoration,66,32,34
Beladrexx,stormrage,1221,druid,restoration,54,21,33
Sneakysoren,kelthuzad,1219,druid,restoration,48,21,27
Druidkingdk,stormrage,1218,druid,restoration,29,18,11
Ännä,moon-guard,1217,druid,restoration,30,13,17
Malice,undermine,1215,druid,restoration,54,24,30
Mcriblet,illidan,1213,druid,restoration,46,23,23
Greemer,sargeras,1213,druid,restoration,39,18,21
Bunnyes,tichondrius,1212,druid,restoration,59,29,30
Gryel,area-52,1211,druid,restoration,235,122,113
Dalrei,jubeithos,1211,druid,restoration,30,13,17
Tworax,frostmourne,1210,druid,restoration,36,14,22
Ulfaren,frostmourne,1209,druid,restoration,24,15,9
Gossìpgoat,frostmourne,1209,druid,restoration,86,42,44
Pyrogenics,whisperwind,1209,druid,restoration,42,20,22
Trolbearpig,malganis,1208,druid,restoration,24,13,11
Beleraine,moon-guard,1208,druid,restoration,40,17,23
Zoeyx,tichondrius,1207,druid,restoration,61,36,25
Tìssuebox,malganis,1207,druid,restoration,75,32,43
Madsewerslvt,stormrage,1206,druid,restoration,161,77,84
Prudence,azralon,1205,druid,restoration,48,25,23
Tuskdaddie,sargeras,1204,druid,restoration,30,17,13
Bearuffinz,malganis,1204,druid,restoration,88,42,46
Blürry,area-52,1203,druid,restoration,42,13,29
Meôwmix,stormrage,1202,druid,restoration,24,13,11
Lizzelune,drakkari,1202,druid,restoration,88,42,46
Imrac,boulderfist,1202,druid,restoration,48,17,31
Cuddles,moon-guard,1201,druid,restoration,137,67,70
Driftwood,bonechewer,1201,druid,restoration,64,27,37
Razakka,stormrage,1201,druid,restoration,47,13,34
Bikacat,kelthuzad,1200,druid,restoration,24,13,11
Dankcentral,frostwolf,1198,druid,restoration,106,57,49
Dimzim,lightbringer,1198,druid,restoration,66,31,35
Panorämix,nemesis,1197,druid,restoration,18,13,5
Feanah,tichondrius,1197,druid,restoration,32,14,18
Nugren,thrall,1195,druid,restoration,50,22,28
Clawriander,barthilas,1192,druid,restoration,120,60,60
Sweetcorn,malganis,1192,druid,restoration,40,16,24
Jonculler,korgath,1190,druid,restoration,63,29,34
Guislstwo,azralon,1190,druid,restoration,52,22,30
Cheddastov,illidan,1189,druid,restoration,27,14,13
Knowgo,tichondrius,1188,druid,restoration,54,28,26
Longisland,quelthalas,1188,druid,restoration,84,38,46
Tarzzan,drakkari,1186,druid,restoration,24,18,6
Adarindre,aerie-peak,1185,druid,restoration,93,46,47
Alewild,quelthalas,1185,druid,restoration,54,26,28
Dainehoof,area-52,1185,druid,restoration,66,28,38
Panacaea,windrunner,1184,druid,restoration,48,27,21
Pawpurrazzi,moon-guard,1183,druid,restoration,17,13,4
Höneyfang,moon-guard,1183,druid,restoration,89,51,38
Hadoriss,kelthuzad,1183,druid,restoration,48,18,30
Edbtw,azralon,1182,druid,restoration,98,46,52
Frames,area-52,1181,druid,restoration,246,122,124
Worgbearpig,destromath,1180,druid,restoration,32,14,18
Valeñtine,dalaran,1179,druid,restoration,78,39,39
Julx,nordrassil,1178,druid,restoration,21,14,7
Lewïs,stormrage,1178,druid,restoration,144,79,65
Drexsabex,tichondrius,1176,druid,restoration,42,25,17
Deximus,wyrmrest-accord,1173,druid,restoration,24,13,11
Alastras,tichondrius,1173,druid,restoration,36,18,18
Hruke,illidan,1173,druid,restoration,42,17,25
Foxbear,garona,1172,druid,restoration,57,38,19
Schlotzsky,skullcrusher,1171,druid,restoration,69,37,32
Layala,sargeras,1171,druid,restoration,90,43,47
Mf,stormscale,1171,druid,restoration,30,14,16
Vantorsydmel,proudmoore,1167,druid,restoration,46,24,22
Chixao,tichondrius,1166,druid,restoration,23,13,10
Aramá,drakkari,1166,druid,restoration,43,21,22
Fortnitburgr,tichondrius,1165,druid,restoration,24,13,11
Matpd,norgannon,1165,druid,restoration,124,61,63
Elylaylalar,moon-guard,1165,druid,restoration,66,31,35
Yanga,malfurion,1163,druid,restoration,48,27,21
Sodury,tichondrius,1161,druid,restoration,178,99,79
Sarangzzang,tichondrius,1159,druid,restoration,37,22,15
Pachacamac,dragonmaw,1159,druid,restoration,36,21,15
Bäñgarang,tichondrius,1159,druid,restoration,78,41,37
Lenori,vashj,1159,druid,restoration,48,24,24
Smhyle,frostmourne,1158,druid,restoration,41,21,20
Kitiano,thunderlord,1158,druid,restoration,66,25,41
Crunchyleafs,thrall,1157,druid,restoration,23,18,5
Lünaä,quelthalas,1155,druid,restoration,71,47,24
Tardcakes,tichondrius,1155,druid,restoration,98,39,59
Jabawockdeez,area-52,1152,druid,restoration,36,22,14
Doah,kelthuzad,1152,druid,restoration,24,12,12
Hoedrufroza,tichondrius,1152,druid,restoration,24,12,12
Pekingcuckoo,illidan,1152,druid,restoration,24,12,12
Rekelberg,sargeras,1151,druid,restoration,18,12,6
Fanboy,magtheridon,1151,druid,restoration,18,12,6
Beecammy,frostmourne,1151,druid,restoration,54,31,23
Blackmoomba,kiljaeden,1150,druid,restoration,16,13,3
Tiggor,ghostlands,1150,druid,restoration,18,12,6
Ðruìd,gnomeregan,1150,druid,restoration,24,12,12
Iheartpvp,tichondrius,1150,druid,restoration,63,30,33
Nodab,tichondrius,1150,druid,restoration,30,12,18
Concordya,tichondrius,1149,druid,restoration,59,29,30
Mommymilkers,jubeithos,1149,druid,restoration,54,14,40
Æpex,lightnings-blade,1148,druid,restoration,30,16,14
Patada,sargeras,1148,druid,restoration,30,12,18
Dampchamp,illidan,1148,druid,restoration,36,12,24
Iloveweed,tichondrius,1147,druid,restoration,18,12,6
Saltyzz,tichondrius,1147,druid,restoration,36,19,17
Idoldeoz,quelthalas,1147,druid,restoration,36,18,18
Treebag,frostmane,1147,druid,restoration,24,12,12
Foxwit,jubeithos,1147,druid,restoration,24,12,12
Dchizzle,tichondrius,1147,druid,restoration,45,20,25
Kassyx,illidan,1147,druid,restoration,36,12,24
Waxedchest,emerald-dream,1146,druid,restoration,24,12,12
Fatshift,chogall,1145,druid,restoration,122,62,60
Sêxcavator,thrall,1145,druid,restoration,24,12,12
Lahsa,tichondrius,1145,druid,restoration,30,13,17
Skibbidy,boulderfist,1145,druid,restoration,33,14,19
Lunkz,tichondrius,1142,druid,restoration,278,132,146
Kiraval,stormrage,1142,druid,restoration,66,29,37
Tyrs,aggramar,1140,druid,restoration,35,15,20
Älef,ragnaros,1140,druid,restoration,54,23,31
Alphalemon,ragnaros,1139,druid,restoration,69,33,36
Wildbite,tichondrius,1138,druid,restoration,20,13,7
Adind,tanaris,1138,druid,restoration,60,32,28
Jijunss,tichondrius,1137,druid,restoration,23,13,10
Cear,proudmoore,1137,druid,restoration,45,16,29
Miyeonly,dalaran,1137,druid,restoration,36,12,24
Joya,stormrage,1136,druid,restoration,18,12,6
Dummedruid,illidan,1135,druid,restoration,36,12,24
Glenkair,lightnings-blade,1134,druid,restoration,36,17,19
Pumma,darkspear,1134,druid,restoration,28,13,15
Kagoz,darkspear,1134,druid,restoration,30,12,18
Uttress,kalecgos,1132,druid,restoration,30,14,16
Catlypso,tichondrius,1131,druid,restoration,72,43,29
Mithaelar,moon-guard,1130,druid,restoration,36,13,23
Ctarla,tichondrius,1128,druid,restoration,24,12,12
Tensuen,boulderfist,1128,druid,restoration,51,21,30
Duxz,tichondrius,1127,druid,restoration,23,13,10
Drudax,kelthuzad,1127,druid,restoration,24,12,12
Ateoate,stormscale,1127,druid,restoration,51,24,27
Soxyeon,tichondrius,1127,druid,restoration,53,23,30
Sneakydikns,tichondrius,1127,druid,restoration,36,12,24
Boomfire,thaurissan,1126,druid,restoration,18,12,6
Sloptoucher,barthilas,1126,druid,restoration,24,12,12
Meonk,frostmourne,1124,druid,restoration,57,27,30
Bubbashift,garona,1124,druid,restoration,60,25,35
Gentlesoapp,blackrock,1122,druid,restoration,48,26,22
Würzel,nemesis,1122,druid,restoration,93,45,48
Brotø,nemesis,1122,druid,restoration,72,33,39
Julyto,ragnaros,1120,druid,restoration,24,12,12
Hotkage,tichondrius,1120,druid,restoration,24,12,12
Hðthead,area-52,1118,druid,restoration,54,26,28
Naturemagic,malganis,1117,druid,restoration,51,27,24
Kastro,frostwolf,1117,druid,restoration,162,84,78
Kandyshop,gorefiend,1116,druid,restoration,30,22,8
Lawlz,aegwynn,1115,druid,restoration,120,67,53
Cipozento,azralon,1115,druid,restoration,91,43,48
Feralgodx,sargeras,1114,druid,restoration,23,12,11
Sinseir,stormscale,1114,druid,restoration,111,47,64
Fermata,aegwynn,1113,druid,restoration,28,15,13
Lopper,hyjal,1113,druid,restoration,24,12,12
Badferal,blackhand,1113,druid,restoration,55,25,30
Rockcow,tichondrius,1113,druid,restoration,48,20,28
Queiq,malganis,1112,druid,restoration,18,12,6
Yourka,uther,1112,druid,restoration,50,27,23
Mcy,nerzhul,1112,druid,restoration,25,13,12
Gorillagloo,area-52,1112,druid,restoration,97,43,54
Kuaite,azralon,1110,druid,restoration,72,25,47
Katdog,warsong,1109,druid,restoration,33,22,11
Löthnälar,ragnaros,1109,druid,restoration,48,24,24
Scoobyshiftz,frostmourne,1108,druid,restoration,30,22,8
Terokky,azralon,1107,druid,restoration,24,12,12
Müfasä,azralon,1106,druid,restoration,54,25,29
Maddoxi,stormrage,1106,druid,restoration,30,12,18
Sharinna,andorhal,1106,druid,restoration,38,14,24
Eredorn,darkspear,1105,druid,restoration,30,23,7
Apox,zuljin,1105,druid,restoration,34,13,21
Shroomkin,area-52,1104,druid,restoration,63,34,29
Furfu,illidan,1104,druid,restoration,74,33,41
Stupidranga,barthilas,1103,druid,restoration,54,19,35
Astralyte,kiljaeden,1099,druid,restoration,24,13,11
Carekoala,wyrmrest-accord,1098,druid,restoration,59,30,29
Idracnine,sargeras,1098,druid,restoration,26,13,13
Cannabull,echo-isles,1097,druid,restoration,33,17,16
Dobidas,tichondrius,1097,druid,restoration,125,63,62
Kymopexy,sargeras,1095,druid,restoration,41,14,27
Battiatus,malganis,1093,druid,restoration,42,19,23
Jabina,detheroc,1093,druid,restoration,54,16,38
Vacablancá,tichondrius,1091,druid,restoration,34,14,20
Barugaf,drakkari,1090,druid,restoration,49,28,21
Agranock,nazgrel,1089,druid,restoration,107,55,52
Kittne,hellscream,1089,druid,restoration,48,24,24
Vollzar,sargeras,1089,druid,restoration,68,23,45
Burdup,tichondrius,1088,druid,restoration,36,19,17
Ayadel,moon-guard,1086,druid,restoration,118,54,64
Berchwunden,ragnaros,1083,druid,restoration,58,27,31
Quan,illidan,1082,druid,restoration,48,20,28
Volgoro,thrall,1078,druid,restoration,60,25,35
Mydira,stormrage,1071,druid,restoration,54,30,24
Dehla,goldrinn,1071,druid,restoration,82,37,45
Quarantinia,arathor,1070,druid,restoration,49,28,21
Samerax,vashj,1070,druid,restoration,107,45,62
Slleep,tichondrius,1069,druid,restoration,54,28,26
Gimborion,stormrage,1066,druid,restoration,48,23,25
Nöches,quelthalas,1065,druid,restoration,32,12,20
Anasia,barthilas,1064,druid,restoration,81,43,38
Cratose,runetotem,1064,druid,restoration,53,24,29
Quaileggs,illidan,1064,druid,restoration,36,12,24
Aarandiel,borean-tundra,1063,druid,restoration,30,17,13
Lutzenberger,nemesis,1063,druid,restoration,53,23,30
Buffalobillz,lethon,1062,druid,restoration,40,25,15
Hallowbranch,moon-guard,1062,druid,restoration,44,17,27
Rëroll,zuljin,1059,druid,restoration,17,12,5
Spasmm,tichondrius,1059,druid,restoration,18,12,6
Samuelceo,area-52,1056,druid,restoration,12,11,1
Chinadruids,tichondrius,1056,druid,restoration,18,11,7
Fracxx,area-52,1056,druid,restoration,18,11,7
Whhm,burning-blade,1056,druid,restoration,24,11,13
Slurpi,barthilas,1056,druid,restoration,30,11,19
Mumblesd,emerald-dream,1055,druid,restoration,24,11,13
Suekeys,frostmourne,1055,druid,restoration,24,11,13
Momorabbitd,tichondrius,1055,druid,restoration,30,11,19
Qkskill,nemesis,1055,druid,restoration,42,11,31
Goodhealer,akama,1054,druid,restoration,42,26,16
Etaurne,drakkari,1054,druid,restoration,18,11,7
Krobz,bleeding-hollow,1054,druid,restoration,18,11,7
Jethelium,illidan,1054,druid,restoration,190,103,87
Qkdru,nemesis,1054,druid,restoration,30,11,19
Careless,destromath,1053,druid,restoration,66,27,39
Kitnip,proudmoore,1052,druid,restoration,24,16,8
Maeo,drenden,1052,druid,restoration,18,11,7
Israh,malygos,1052,druid,restoration,26,15,11
Yorch,stormrage,1052,druid,restoration,60,28,32
Deja,frostmourne,1052,druid,restoration,30,11,19
Marminalade,stormrage,1051,druid,restoration,18,11,7
Nastynancy,frostmourne,1051,druid,restoration,21,12,9
Solisuu,frostmane,1051,druid,restoration,30,11,19
Cres,moon-guard,1051,druid,restoration,42,11,31
Tigranesia,proudmoore,1050,druid,restoration,18,11,7
Acerolita,azralon,1050,druid,restoration,30,11,19
Phxburn,illidan,1050,druid,restoration,30,11,19
Catinthebox,illidan,1048,druid,restoration,18,11,7
Dinglebops,stormrage,1047,druid,restoration,28,15,13
Xzerhos,area-52,1047,druid,restoration,151,70,81
Fatherbanger,blackrock,1047,druid,restoration,24,11,13
Edorant,illidan,1047,druid,restoration,30,11,19
Yimii,stormrage,1046,druid,restoration,18,11,7
Zzizi,tichondrius,1046,druid,restoration,29,13,16
Zoll,kelthuzad,1046,druid,restoration,66,26,40
Dorzaku,ragnaros,1045,druid,restoration,47,27,20
Battlecát,stormscale,1045,druid,restoration,24,11,13
Zadayos,aerie-peak,1044,druid,restoration,30,16,14
Duducows,tichondrius,1044,druid,restoration,59,23,36
Druilicious,ghostlands,1043,druid,restoration,55,27,28
Libel,korgath,1042,druid,restoration,18,11,7
Realhötgirl,moon-guard,1042,druid,restoration,18,11,7
Gairen,the-venture-co,1042,druid,restoration,20,12,8
Twigleg,eonar,1042,druid,restoration,36,11,25
Feaveldin,moon-guard,1041,druid,restoration,18,11,7
Ahrilee,area-52,1040,druid,restoration,75,33,42
Sbc,anvilmar,1040,druid,restoration,48,15,33
Jimmycooks,tichondrius,1039,druid,restoration,18,11,7
Chopleaf,khadgar,1039,druid,restoration,180,92,88
Kanabat,drenden,1039,druid,restoration,24,11,13
Leoha,stormrage,1037,druid,restoration,24,15,9
Erû,ragnaros,1037,druid,restoration,18,11,7
Iiliith,moon-guard,1037,druid,restoration,24,11,13
Taydruid,stormrage,1037,druid,restoration,54,24,30
Ulfaar,frostmourne,1036,druid,restoration,18,11,7
Creasir,tichondrius,1035,druid,restoration,35,12,23
Bearkîng,stormrage,1034,druid,restoration,18,11,7
Duedad,gurubashi,1034,druid,restoration,39,22,17
Cowtox,moon-guard,1033,druid,restoration,190,90,100
Breezeys,tichondrius,1033,druid,restoration,35,16,19
Toxicshift,malganis,1033,druid,restoration,39,13,26
Beefcurtâins,aggramar,1032,druid,restoration,18,11,7
Bonemaul,bonechewer,1032,druid,restoration,42,22,20
Nohkotana,illidan,1032,druid,restoration,28,13,15
Jimooin,tichondrius,1032,druid,restoration,30,12,18
Bankinbäbe,illidan,1031,druid,restoration,98,53,45
Delicioso,wyrmrest-accord,1030,druid,restoration,33,21,12
Javoh,drakkari,1030,druid,restoration,25,13,12
Skaidi,quelthalas,1030,druid,restoration,42,21,21
Nytecrawler,bonechewer,1028,druid,restoration,18,11,7
Boofndergz,area-52,1027,druid,restoration,24,15,9
Minnysoda,area-52,1027,druid,restoration,24,12,12
Mayarí,sargeras,1027,druid,restoration,50,15,35
Seremap,frostmourne,1025,druid,restoration,48,29,19
Polymorphos,mugthol,1025,druid,restoration,30,14,16
Janaki,malygos,1024,druid,restoration,30,13,17
Azyx,stormrage,1023,druid,restoration,92,40,52
Imcop,tichondrius,1020,druid,restoration,18,11,7
Troply,ragnaros,1020,druid,restoration,20,12,8
Funnydruid,frostmourne,1020,druid,restoration,42,20,22
Xarressian,moon-guard,1019,druid,restoration,24,11,13
Sonrius,proudmoore,1017,druid,restoration,52,25,27
Irushbots,tichondrius,1016,druid,restoration,30,11,19
Pmsprone,tichondrius,1012,druid,restoration,84,40,44
Milkmoneymeo,illidan,1011,druid,restoration,29,11,18
Uwakka,hyjal,1009,druid,restoration,20,12,8
Sunneater,azuremyst,1009,druid,restoration,37,18,19
Rivetrix,azralon,1007,druid,restoration,103,49,54
Agnala,drakkari,1007,druid,restoration,99,35,64
Macdonah,tichondrius,1006,druid,restoration,66,33,33
Sorio,area-52,1005,druid,restoration,58,21,37
Keladria,bleeding-hollow,1002,druid,restoration,102,55,47
Chloroforms,khazgoroth,1001,druid,restoration,52,30,22
Guron,aegwynn,1001,druid,restoration,57,30,27
Yeahhots,frostmourne,1000,druid,restoration,15,12,3
Mainera,sargeras,1000,druid,restoration,26,12,14
Dhannar,proudmoore,999,druid,restoration,18,13,5
Habit,dragonmaw,998,druid,restoration,27,12,15
Kataless,sargeras,997,druid,restoration,125,66,59
Thicclesbean,tichondrius,996,druid,restoration,31,16,15
Phyllostomus,quelthalas,996,druid,restoration,36,15,21
Smorak,area-52,994,druid,restoration,14,12,2
Alfurr,tichondrius,994,druid,restoration,85,43,42
Illur,ragnaros,993,druid,restoration,34,13,21
Krossus,drakkari,993,druid,restoration,38,13,25
Hewozuoai,area-52,990,druid,restoration,35,11,24
Vallk,area-52,990,druid,restoration,40,11,29
Astharon,drakkari,989,druid,restoration,56,31,25
Marrana,altar-of-storms,989,druid,restoration,24,13,11
Ahylen,quelthalas,989,druid,restoration,53,22,31
Cpttspitty,kelthuzad,988,druid,restoration,36,14,22
Canche,arthas,986,druid,restoration,34,19,15
Feralgød,tichondrius,985,druid,restoration,30,11,19
Cowchicken,zuljin,982,druid,restoration,34,11,23
Nerfmesoon,sargeras,978,druid,restoration,22,11,11
Dwalk,moknathal,977,druid,restoration,109,53,56
Santicow,ragnaros,975,druid,restoration,20,11,9
Fionnbharr,ragnaros,974,druid,restoration,86,39,47
Bindudream,frostmane,973,druid,restoration,72,35,37
Locopewpew,malganis,969,druid,restoration,79,29,50
Seceru,proudmoore,968,druid,restoration,58,31,27
Boomshorts,blackrock,968,druid,restoration,29,14,15
Sunyatsen,quelthalas,967,druid,restoration,58,25,33
Jennafix,dathremar,966,druid,restoration,54,28,26
Tiufill,nemesis,965,druid,restoration,30,16,14
Vdubz,blackrock,965,druid,restoration,49,25,24
Wiggle,stormscale,962,druid,restoration,44,21,23
Vulgär,kiljaeden,961,druid,restoration,52,21,31
Solushun,sargeras,960,druid,restoration,12,10,2
Salzadruid,aggramar,960,druid,restoration,12,10,2
Baruc,illidan,960,druid,restoration,12,10,2
Aphroditezs,tichondrius,960,druid,restoration,18,10,8
Kurohîme,illidan,960,druid,restoration,18,10,8
Myovo,tichondrius,960,druid,restoration,18,10,8
Jiywa,lightbringer,960,druid,restoration,18,10,8
Smeekq,tichondrius,960,druid,restoration,24,10,14
Nhin,ghostlands,960,druid,restoration,24,10,14
Lindsanr,illidan,960,druid,restoration,30,10,20
Xiaoyi,tichondrius,959,druid,restoration,12,10,2
Slambeezy,emerald-dream,959,druid,restoration,18,10,8
Montage,illidan,959,druid,restoration,18,10,8
Ddi,frostmourne,959,druid,restoration,18,10,8
Garbagebutt,burning-legion,959,druid,restoration,18,10,8
Eldertroll,boulderfist,959,druid,restoration,18,10,8
Hoonjojjyanx,tichondrius,959,druid,restoration,18,10,8
Oblackbetty,illidan,959,druid,restoration,39,18,21
Treesh,kelthuzad,959,druid,restoration,26,10,16
Naturetazerr,sargeras,958,druid,restoration,18,10,8
Uggadruid,malganis,958,druid,restoration,18,10,8
Tlanquility,tichondrius,958,druid,restoration,18,10,8
Tigd,alleria,958,druid,restoration,18,10,8
Nachopuppet,kelthuzad,958,druid,restoration,51,21,30
Percocetxo,malganis,958,druid,restoration,30,10,20
Shrooming,frostmourne,958,druid,restoration,30,10,20
Tayokou,zuljin,957,druid,restoration,12,10,2
Dreamgaze,zuljin,957,druid,restoration,18,10,8
Simina,kargath,957,druid,restoration,18,10,8
Chenxguang,tichondrius,957,druid,restoration,42,22,20
Iheartmushu,mannoroth,957,druid,restoration,91,47,44
Ñoobdruid,tichondrius,956,druid,restoration,18,10,8
Cranbérry,sargeras,956,druid,restoration,18,10,8
Vêzpêr,kelthuzad,956,druid,restoration,24,10,14
Jessbearly,kiljaeden,954,druid,restoration,18,10,8
Rlie,quelthalas,954,druid,restoration,30,10,20
Uttress,tichondrius,953,druid,restoration,18,10,8
Joink,sargeras,952,druid,restoration,18,10,8
Wildartform,malganis,952,druid,restoration,23,12,11
Dietmilk,sargeras,952,druid,restoration,24,11,13
Bainnê,ragnaros,952,druid,restoration,48,11,37
Çura,tichondrius,951,druid,restoration,18,10,8
Erisya,moon-guard,951,druid,restoration,18,10,8
Wintarz,sargeras,951,druid,restoration,30,10,20
Feckzd,blackhand,950,druid,restoration,18,10,8
Honeymead,wyrmrest-accord,950,druid,restoration,65,36,29
Judar,barthilas,950,druid,restoration,24,10,14
Glenglooie,tichondrius,950,druid,restoration,30,10,20
Nightwater,stormrage,949,druid,restoration,21,10,11
Rhatir,stormrage,949,druid,restoration,138,61,77
Noonoo,frostwolf,949,druid,restoration,24,10,14
Alteraim,thrall,949,druid,restoration,30,10,20
Immabot,tichondrius,949,druid,restoration,36,10,26
Erykk,dalaran,948,druid,restoration,18,10,8
Hpcorrection,bleeding-hollow,946,druid,restoration,18,10,8
Moobees,arthas,946,druid,restoration,30,10,20
Ihideuseek,bloodscalp,944,druid,restoration,36,10,26
Xiaoddi,tichondrius,943,druid,restoration,17,10,7
Ryx,llane,943,druid,restoration,24,10,14
Muukair,ragnaros,943,druid,restoration,24,10,14
Fatjoints,tichondrius,943,druid,restoration,60,21,39
Maxobviously,stormrage,942,druid,restoration,18,10,8
Devilsparda,frostmane,942,druid,restoration,24,10,14
Cadekey,illidan,942,druid,restoration,42,13,29
Anïtra,illidan,942,druid,restoration,48,10,38
Kg,cenarion-circle,941,druid,restoration,28,13,15
Tyrantha,emerald-dream,941,druid,restoration,24,10,14
Shiftaholic,azgalor,940,druid,restoration,33,17,16
Modiboom,arthas,940,druid,restoration,60,22,38
Drucaicer,quelthalas,939,druid,restoration,71,38,33
Chupaone,dalaran,937,druid,restoration,66,27,39
Browolf,emerald-dream,934,druid,restoration,48,21,27
Katochi,area-52,929,druid,restoration,54,24,30
Blooddude,saurfang,927,druid,restoration,30,11,19
Killari,malganis,926,druid,restoration,30,15,15
Pathostos,dalaran,926,druid,restoration,104,43,61
Treewik,emerald-dream,925,druid,restoration,113,60,53
Movom,tichondrius,925,druid,restoration,23,10,13
Goenytz,quelthalas,925,druid,restoration,62,20,42
Blackdawgg,frostmourne,924,druid,restoration,71,26,45
Cloudbreaker,duskwood,923,druid,restoration,18,10,8
Chocoo,thaurissan,923,druid,restoration,20,11,9
Dyfurion,stormrage,922,druid,restoration,18,10,8
Breakthemm,bonechewer,922,druid,restoration,97,46,51
Mielo,illidan,922,druid,restoration,146,67,79
Bblloodd,magtheridon,921,druid,restoration,36,13,23
Fongoons,kelthuzad,919,druid,restoration,59,26,33
Bomme,zuljin,919,druid,restoration,52,21,31
Sangsan,tichondrius,917,druid,restoration,36,10,26
Marakar,nazjatar,917,druid,restoration,48,13,35
Kkrunkk,khadgar,916,druid,restoration,36,17,19
Fovoss,dalaran,914,druid,restoration,36,18,18
Lazypandas,silvermoon,914,druid,restoration,41,17,24
Aquesadilla,tichondrius,907,druid,restoration,108,36,72
Kenzié,doomhammer,906,druid,restoration,48,22,26
Gromdruid,azralon,905,druid,restoration,66,33,33
Boomsläng,ghostlands,905,druid,restoration,25,12,13
Diaks,proudmoore,900,druid,restoration,24,12,12
Bethemarble,sargeras,900,druid,restoration,47,20,27
Irishdoom,tichondrius,899,druid,restoration,20,11,9
Merawr,area-52,896,druid,restoration,22,10,12
Theboyz,zuljin,895,druid,restoration,36,15,21
Hentaiboom,kiljaeden,893,druid,restoration,36,16,20
Royjr,emerald-dream,892,druid,restoration,44,24,20
Duderdude,tichondrius,892,druid,restoration,45,22,23
Vengaul,amanthul,892,druid,restoration,24,10,14
Lâvazza,tichondrius,890,druid,restoration,28,10,18
Sliickrick,frostmourne,889,druid,restoration,30,10,20
Kawanishi,stormrage,884,druid,restoration,24,12,12
Treeoleo,stormrage,884,druid,restoration,36,16,20
Kittyz,wyrmrest-accord,881,druid,restoration,36,18,18
Midníght,drakkari,880,druid,restoration,34,18,16
Bunrÿl,thorium-brotherhood,874,druid,restoration,54,24,30
Augus,hyjal,870,druid,restoration,33,11,22
Theboy,dalaran,869,druid,restoration,48,15,33
Justforgame,sargeras,864,druid,restoration,12,9,3
Aiteezy,illidan,864,druid,restoration,12,9,3
Toonah,area-52,864,druid,restoration,12,9,3
Restokinaja,dreadmaul,864,druid,restoration,12,9,3
Duo,demon-soul,864,druid,restoration,12,9,3
Spikeleaf,tichondrius,864,druid,restoration,12,9,3
Bopplejr,tichondrius,864,druid,restoration,12,9,3
Jockrock,thunderhorn,864,druid,restoration,19,10,9
Ppbtw,illidan,864,druid,restoration,18,9,9
Bigblackcroc,kiljaeden,864,druid,restoration,18,9,9
Mmrborrower,icecrown,864,druid,restoration,18,9,9
Ppb,illidan,864,druid,restoration,18,9,9
Shwayshift,bleeding-hollow,864,druid,restoration,18,9,9
Admoney,sargeras,864,druid,restoration,18,9,9
Hellshifterr,tichondrius,864,druid,restoration,18,9,9
Ppbdru,tichondrius,864,druid,restoration,18,9,9
Razberriesz,stormrage,864,druid,restoration,18,9,9
Lackzx,malganis,864,druid,restoration,24,9,15
Persille,proudmoore,864,druid,restoration,24,9,15
Proness,garithos,863,druid,restoration,12,9,3
Ooh,stormreaver,863,druid,restoration,12,9,3
Naturenugget,tichondrius,863,druid,restoration,12,9,3
Ilovejuli,illidan,863,druid,restoration,12,9,3
Rejuvenation,kaelthas,863,druid,restoration,12,9,3
Dumpesito,frostmourne,863,druid,restoration,18,9,9
Tricklein,tichondrius,863,druid,restoration,18,9,9
Nyxlawl,azralon,863,druid,restoration,18,9,9
Canek,ghostlands,863,druid,restoration,18,9,9
Vernaar,laughing-skull,863,druid,restoration,18,9,9
Guss,mannoroth,863,druid,restoration,24,9,15
Opim,sargeras,863,druid,restoration,24,9,15
Washeddruid,area-52,863,druid,restoration,24,9,15
Mossin,sargeras,863,druid,restoration,24,9,15
Canitöuchit,tichondrius,863,druid,restoration,24,9,15
Tugginudders,illidan,863,druid,restoration,30,9,21
Pawsh,tichondrius,862,druid,restoration,12,9,3
Shuffleqlol,stormrage,862,druid,restoration,12,9,3
Jentzull,tichondrius,862,druid,restoration,12,9,3
Cenarius,frostmourne,862,druid,restoration,18,9,9
Spicyx,moon-guard,862,druid,restoration,18,9,9
Pawpa,daggerspine,862,druid,restoration,18,9,9
Truidy,proudmoore,862,druid,restoration,18,9,9
Elmez,thrall,862,druid,restoration,18,9,9
Phylex,frostmourne,862,druid,restoration,18,9,9
Imlordgumper,illidan,862,druid,restoration,24,9,15
Seyvyurtoo,black-dragonflight,861,druid,restoration,12,9,3
Dzone,tichondrius,861,druid,restoration,12,9,3
Alindrä,moon-guard,861,druid,restoration,18,9,9
Monkeyxo,kelthuzad,861,druid,restoration,18,9,9
Alsei,quelthalas,861,druid,restoration,40,18,22
Papichulo,hydraxis,861,druid,restoration,54,24,30
Starkraven,firetree,861,druid,restoration,26,10,16
Goodspeed,thrall,861,druid,restoration,42,11,31
Loganski,korialstrasz,860,druid,restoration,30,14,16
Topzet,azralon,860,druid,restoration,30,9,21
Stetile,azralon,859,druid,restoration,18,9,9
Feykurds,sargeras,859,druid,restoration,24,9,15
Ragotø,azralon,858,druid,restoration,24,9,15
Ilikan,ragnaros,857,druid,restoration,12,9,3
Thorfir,gorefiend,854,druid,restoration,24,10,14
Faroo,azralon,854,druid,restoration,24,9,15
Leify,area-52,853,druid,restoration,24,10,14
Onlypaws,azjolnerub,852,druid,restoration,24,9,15
Earwën,ragnaros,852,druid,restoration,24,9,15
Ddizz,cairne,850,druid,restoration,24,9,15
Ilikecake,bloodscalp,849,druid,restoration,24,10,14
Kvacco,kiljaeden,848,druid,restoration,24,9,15
Encosan,azralon,848,druid,restoration,30,9,21
Kanadae,thrall,846,druid,restoration,24,9,15
Keyli,frostwolf,845,druid,restoration,18,9,9
Érois,azralon,844,druid,restoration,18,9,9
Amazingtom,magtheridon,842,druid,restoration,27,12,15
Draycø,tichondrius,841,druid,restoration,18,9,9
Fronkysilva,illidan,838,druid,restoration,48,19,29
Dashíng,proudmoore,829,druid,restoration,40,17,23
Rhondarootsy,zuljin,829,druid,restoration,24,10,14
Uwupollo,ragnaros,829,druid,restoration,96,38,58
Menapaws,arygos,828,druid,restoration,15,9,6
Treetalker,drenden,827,druid,restoration,18,9,9
Guerrillera,khadgar,827,druid,restoration,142,62,80
Shalandrea,sargeras,824,druid,restoration,60,22,38
Trôll,mannoroth,818,druid,restoration,26,10,16
Dubya,illidan,809,druid,restoration,27,10,17
Uniquexia,tichondrius,808,druid,restoration,45,10,35
Onyayo,barthilas,807,druid,restoration,42,18,24
Tricknicgg,illidan,805,druid,restoration,26,10,16
Moolan,bleeding-hollow,804,druid,restoration,40,20,20
Elauria,stormreaver,804,druid,restoration,42,17,25
Atim,moon-guard,804,druid,restoration,96,28,68
Restogodx,alexstrasza,799,druid,restoration,16,9,7
Vulkur,illidan,799,druid,restoration,38,9,29
Treesonn,kelthuzad,792,druid,restoration,24,11,13
Cenariun,stormrage,790,druid,restoration,30,9,21
Tftworldcham,blackrock,783,druid,restoration,11,9,2
Judwen,grizzly-hills,779,druid,restoration,70,26,44
Redharp,proudmoore,776,druid,restoration,43,17,26
Stamynn,kelthuzad,772,druid,restoration,354,110,244
Ppm,illidan,768,druid,restoration,12,8,4
Bobxd,kelthuzad,768,druid,restoration,12,8,4
Albafic,illidan,768,druid,restoration,12,8,4
Chinadruides,tichondrius,768,druid,restoration,12,8,4
Polarîs,stormrage,768,druid,restoration,12,8,4
Xiaootong,tichondrius,768,druid,restoration,12,8,4
Leilani,eredar,768,druid,restoration,12,8,4
Cntomy,tichondrius,768,druid,restoration,12,8,4
Mkong,tichondrius,768,druid,restoration,18,8,10
Restobaby,tichondrius,768,druid,restoration,18,8,10
Lindsay,moonrunner,768,druid,restoration,18,8,10
Taledra,stormrage,768,druid,restoration,18,8,10
Nemoo,tichondrius,768,druid,restoration,18,8,10
Tyler,emerald-dream,768,druid,restoration,18,8,10
Înfamous,thrall,767,druid,restoration,12,8,4
Alend,alexstrasza,767,druid,restoration,12,8,4
Kismet,andorhal,767,druid,restoration,12,8,4
Ebyx,frostmourne,767,druid,restoration,12,8,4
Bringo,executus,767,druid,restoration,21,10,11
Lifebloomlol,area-52,767,druid,restoration,18,8,10
Thetakeout,tichondrius,767,druid,restoration,18,8,10
Junglez,shadowmoon,767,druid,restoration,18,8,10
Grubbs,terenas,767,druid,restoration,18,8,10
Kaboomy,moon-guard,767,druid,restoration,18,8,10
Steeples,illidan,767,druid,restoration,18,8,10
Hughcockman,tichondrius,766,druid,restoration,12,8,4
Ortalen,spirestone,766,druid,restoration,12,8,4
Purpyo,bleeding-hollow,766,druid,restoration,12,8,4
Crapster,boulderfist,766,druid,restoration,18,8,10
Bobochi,tichondrius,766,druid,restoration,18,8,10
Wildsïde,tichondrius,766,druid,restoration,18,8,10
Bumbleebee,azralon,766,druid,restoration,24,8,16
Kyrieirving,illidan,766,druid,restoration,24,8,16
Hedwíg,ragnaros,766,druid,restoration,24,8,16
Kellykapore,area-52,766,druid,restoration,81,20,61
Dmanrepus,sargeras,765,druid,restoration,12,8,4
Louisvuittón,area-52,765,druid,restoration,12,8,4
Imnotinhuman,tichondrius,765,druid,restoration,12,8,4
Giuseppee,hyjal,765,druid,restoration,12,8,4
Omelet,tichondrius,765,druid,restoration,18,8,10
Bosscjp,tichondrius,765,druid,restoration,18,8,10
Softgrizzly,auchindoun,765,druid,restoration,24,8,16
Guybranch,illidan,765,druid,restoration,24,8,16
Slee,eredar,764,druid,restoration,12,8,4
Leatherpig,proudmoore,764,druid,restoration,18,8,10
Aurajin,spinebreaker,764,druid,restoration,24,8,16
Polánd,area-52,763,druid,restoration,12,8,4
Studioghibli,bleeding-hollow,762,druid,restoration,12,8,4
Atalìa,moon-guard,762,druid,restoration,18,8,10
Dergmoo,moon-guard,762,druid,restoration,24,8,16
Blitzÿ,lothar,761,druid,restoration,12,8,4
Markóla,stormrage,761,druid,restoration,18,8,10
Wortsnom,tol-barad,760,druid,restoration,12,8,4
Tristanne,proudmoore,760,druid,restoration,12,8,4
Cosmes,suramar,759,druid,restoration,12,8,4
Rairven,stormrage,757,druid,restoration,42,8,34
Bussincheeks,tichondrius,755,druid,restoration,18,8,10
Xxuan,tichondrius,754,druid,restoration,68,18,50
Breakertime,illidan,753,druid,restoration,18,8,10
Salpicow,nagrand,752,druid,restoration,23,10,13
Hydruidponic,aegwynn,752,druid,restoration,27,9,18
Blazedorange,tichondrius,751,druid,restoration,17,8,9
Friarpuck,nerzhul,747,druid,restoration,12,8,4
Dytriax,ragnaros,746,druid,restoration,18,8,10
Nodeathz,sargeras,743,druid,restoration,27,10,17
Dragondruid,dawnbringer,742,druid,restoration,35,9,26
Nattog,area-52,736,druid,restoration,52,12,40
Ekj,tichondrius,735,druid,restoration,14,9,5
Akanx,tichondrius,735,druid,restoration,16,9,7
Kadry,ragnaros,733,druid,restoration,18,8,10
Aludra,tol-barad,725,druid,restoration,30,10,20
Kataoka,azralon,721,druid,restoration,23,11,12
Rdruidchump,the-forgotten-coast,719,druid,restoration,15,9,6
Ghostmonkey,hakkar,719,druid,restoration,23,8,15
Basulto,tichondrius,718,druid,restoration,23,8,15
Xîstance,barthilas,717,druid,restoration,23,8,15
Asclepïus,tichondrius,716,druid,restoration,17,8,9
Felinedreams,sargeras,714,druid,restoration,14,9,5
Whiskeyblues,ursin,706,druid,restoration,24,8,16
Itzreallyhim,kiljaeden,705,druid,restoration,27,9,18
Finntann,moon-guard,704,druid,restoration,24,8,16
Bigox,area-52,699,druid,restoration,118,46,72
Drexldrood,cenarius,697,druid,restoration,15,9,6
Zephiee,kelthuzad,692,druid,restoration,23,8,15
Finkledurp,dalaran,687,druid,restoration,19,8,11
Solbinn,nordrassil,683,druid,restoration,78,21,57
Teamwork,moon-guard,681,druid,restoration,20,10,10
Importedalc,zuljin,678,druid,restoration,36,8,28
Cuzzidr,tichondrius,672,druid,restoration,12,7,5
Carntko,sargeras,672,druid,restoration,12,7,5
Cameltail,kelthuzad,672,druid,restoration,12,7,5
Mymatejames,tichondrius,672,druid,restoration,12,7,5
Restokinaka,dreadmaul,672,druid,restoration,12,7,5
Shapelist,frostmourne,672,druid,restoration,12,7,5
Fresh,earthen-ring,672,druid,restoration,12,7,5
Skitzo,akama,672,druid,restoration,12,7,5
Fujimufu,bleeding-hollow,672,druid,restoration,12,7,5
Tmdogwater,sargeras,672,druid,restoration,12,7,5
Scuzzin,zuljin,672,druid,restoration,12,7,5
Sensations,moon-guard,672,druid,restoration,12,7,5
Esqueue,stormrage,672,druid,restoration,12,7,5
Cøsmiccow,illidan,672,druid,restoration,12,7,5
Crusch,shattered-halls,672,druid,restoration,12,7,5
Blacksimbá,area-52,672,druid,restoration,12,7,5
Motate,malganis,672,druid,restoration,12,7,5
Jurof,malganis,672,druid,restoration,12,7,5
Cyrea,dalaran,672,druid,restoration,12,7,5
Hmoobforshoz,wildhammer,672,druid,restoration,12,7,5
Evolved,darkspear,672,druid,restoration,12,7,5
Toketree,sargeras,672,druid,restoration,12,7,5
Bcktobasics,emerald-dream,672,druid,restoration,18,7,11
Greentoë,sargeras,672,druid,restoration,18,7,11
Dotsbots,barthilas,672,druid,restoration,18,7,11
Erogan,eitrigg,672,druid,restoration,18,7,11
Restokina,dreadmaul,672,druid,restoration,18,7,11
Calimei,bladefist,672,druid,restoration,18,7,11
Suekey,frostmourne,672,druid,restoration,18,7,11
Liloudadru,tichondrius,672,druid,restoration,18,7,11
Wùúkìí,bleeding-hollow,672,druid,restoration,24,7,17
Iâmkyle,darkspear,671,druid,restoration,12,7,5
Hugharection,illidan,671,druid,restoration,12,7,5
Jillferal,proudmoore,671,druid,restoration,12,7,5
Drop,shadow-council,671,druid,restoration,12,7,5
Sroyalbeast,sargeras,671,druid,restoration,12,7,5
Cryel,sargeras,671,druid,restoration,12,7,5
Vadeyr,illidan,671,druid,restoration,12,7,5
Lolth,turalyon,671,druid,restoration,12,7,5
Zthatchx,shadowmoon,671,druid,restoration,12,7,5
Ophiophagus,nemesis,671,druid,restoration,12,7,5
Lilgee,kelthuzad,671,druid,restoration,18,7,11
Phéônix,zuljin,671,druid,restoration,18,7,11
Boomchí,tichondrius,671,druid,restoration,18,7,11
Wildarumqt,tichondrius,671,druid,restoration,18,7,11
Kollective,sargeras,671,druid,restoration,18,7,11
Finn,spinebreaker,671,druid,restoration,18,7,11
Treebearman,thrall,671,druid,restoration,24,7,17
Greenbones,frostmane,670,druid,restoration,12,7,5
Queiq,kelthuzad,670,druid,restoration,12,7,5
Dionysus,mannoroth,670,druid,restoration,12,7,5
Scäpeqoat,sargeras,670,druid,restoration,12,7,5
Cshafty,illidan,670,druid,restoration,18,7,11
Flexxfurion,thrall,670,druid,restoration,18,7,11
Wreckked,sargeras,670,druid,restoration,18,7,11
Frave,dentarg,670,druid,restoration,24,7,17
Hotpocketz,kiljaeden,670,druid,restoration,28,8,20
Martymoo,bleeding-hollow,670,druid,restoration,30,7,23
Dipset,khadgar,670,druid,restoration,30,7,23
Notcovet,illidan,669,druid,restoration,12,7,5
Dylonomancer,tichondrius,669,druid,restoration,12,7,5
Nayelina,stormrage,669,druid,restoration,12,7,5
Fandren,ravencrest,669,druid,restoration,12,7,5
Zwind,nerzhul,669,druid,restoration,16,8,8
Razorclaws,stormscale,669,druid,restoration,18,7,11
Niensi,wyrmrest-accord,669,druid,restoration,18,7,11
Briallyn,tichondrius,669,druid,restoration,18,7,11
Maggiee,arthas,669,druid,restoration,24,7,17
Bloomcrue,moon-guard,668,druid,restoration,12,7,5
Migdrail,nemesis,668,druid,restoration,18,7,11
Shiftyy,nordrassil,668,druid,restoration,19,7,12
Mukay,stormrage,668,druid,restoration,24,7,17
Esyiix,tichondrius,668,druid,restoration,24,7,17
Mïms,area-52,667,druid,restoration,12,7,5
Givemejuice,tichondrius,667,druid,restoration,18,7,11
Flayde,barthilas,666,druid,restoration,12,7,5
Transpecies,kelthuzad,666,druid,restoration,12,7,5
Kobudo,frostwolf,666,druid,restoration,12,7,5
Phanah,the-forgotten-coast,665,druid,restoration,12,7,5
Darkstarfalz,bleeding-hollow,665,druid,restoration,12,7,5
Megumixd,illidan,665,druid,restoration,12,7,5
Swagbabe,sargeras,665,druid,restoration,18,7,11
Lacarne,tichondrius,665,druid,restoration,30,7,23
Bullshifftt,kelthuzad,664,druid,restoration,12,7,5
Anakum,azshara,664,druid,restoration,16,8,8
Happylilmoo,kiljaeden,664,druid,restoration,24,7,17
Somars,cenarius,663,druid,restoration,12,7,5
Madambuku,thrall,663,druid,restoration,12,7,5
Inblooms,blackhand,663,druid,restoration,18,7,11
Shilpá,stormrage,662,druid,restoration,18,7,11
Donutjelly,moknathal,661,druid,restoration,12,7,5
Oswalphis,moon-guard,660,druid,restoration,12,7,5
Xkcc,perenolde,660,druid,restoration,18,7,11
Snarl,blades-edge,657,druid,restoration,12,7,5
Ikova,frostmourne,650,druid,restoration,18,7,11
Gotdruid,sargeras,639,druid,restoration,14,8,6
Riddickd,malfurion,639,druid,restoration,14,8,6
Warmkitteh,kiljaeden,639,druid,restoration,17,7,10
Breathe,ysera,639,druid,restoration,28,7,21
Perems,bleeding-hollow,629,druid,restoration,24,7,17
Guavajuice,stormrage,624,druid,restoration,19,8,11
Wolfelord,sargeras,624,druid,restoration,21,7,14
Morpheous,emerald-dream,624,druid,restoration,31,7,24
Çuradora,tichondrius,617,druid,restoration,15,9,6
Midoriiro,dentarg,612,druid,restoration,25,8,17
Milkz,zuljin,607,druid,restoration,26,7,19
Tofumation,gorgonnash,606,druid,restoration,19,8,11
Ordono,emerald-dream,576,druid,restoration,6,6,0
Solipsism,barthilas,576,druid,restoration,6,6,0
Masan,burning-blade,576,druid,restoration,6,6,0
Pacetwo,area-52,576,druid,restoration,6,6,0
Nomilk,illidan,576,druid,restoration,12,6,6
Juicecarton,thrall,576,druid,restoration,12,6,6
Injections,kelthuzad,576,druid,restoration,12,6,6
Barqskin,malganis,576,druid,restoration,12,6,6
Bearys,area-52,576,druid,restoration,12,6,6
Krisdu,kelthuzad,576,druid,restoration,12,6,6
Larryjones,alleria,576,druid,restoration,12,6,6
Maèstus,thrall,576,druid,restoration,12,6,6
Mynameisfish,tichondrius,576,druid,restoration,12,6,6
Onlyforms,illidan,576,druid,restoration,12,6,6
Krunks,frostmourne,576,druid,restoration,12,6,6
Cloneandbone,nerzhul,576,druid,restoration,12,6,6
Dirtydrood,mugthol,576,druid,restoration,12,6,6
Bobblespook,stormrage,576,druid,restoration,12,6,6
Maolfurion,stormrage,576,druid,restoration,12,6,6
Xingyejingmi,tichondrius,576,druid,restoration,12,6,6
Torbock,zuljin,576,druid,restoration,12,6,6
Brëed,tichondrius,576,druid,restoration,12,6,6
Smeekqtwo,tichondrius,576,druid,restoration,12,6,6
Forèst,sargeras,576,druid,restoration,12,6,6
Afkifuthrow,ysera,576,druid,restoration,12,6,6
Sawajirii,tichondrius,576,druid,restoration,12,6,6
Floray,tichondrius,576,druid,restoration,12,6,6
Hecaf,drakkari,576,druid,restoration,12,6,6
Leomerchan,stormrage,576,druid,restoration,12,6,6
Connection,emerald-dream,576,druid,restoration,12,6,6
Gemo,tichondrius,576,druid,restoration,12,6,6
Fwaffle,bleeding-hollow,576,druid,restoration,12,6,6
Gizho,sargeras,576,druid,restoration,12,6,6
Daddypompum,tichondrius,576,druid,restoration,12,6,6
Naturenugget,sargeras,576,druid,restoration,12,6,6
Solushunx,sargeras,576,druid,restoration,12,6,6
Chinadruidss,tichondrius,576,druid,restoration,12,6,6
Zux,drakkari,576,druid,restoration,12,6,6
Restokin,dreadmaul,576,druid,restoration,15,7,8
Shiftydon,borean-tundra,576,druid,restoration,15,6,9
Hawtyforever,tichondrius,576,druid,restoration,18,6,12
Ephemêral,stormrage,576,druid,restoration,18,6,12
Sneakiez,tichondrius,576,druid,restoration,18,6,12
Axtin,stormreaver,576,druid,restoration,18,6,12
Fidelo,tichondrius,576,druid,restoration,18,6,12
Mâckdâddy,kul-tiras,576,druid,restoration,18,6,12
Bøo,frostmourne,576,druid,restoration,18,6,12
Noctorius,ragnaros,576,druid,restoration,18,6,12
Arútam,ragnaros,576,druid,restoration,18,6,12
Shinoßi,area-52,576,druid,restoration,24,6,18
Nerglet,aerie-peak,576,druid,restoration,24,6,18
Fyrleaf,lightnings-blade,576,druid,restoration,24,6,18
Hottietottie,laughing-skull,576,druid,restoration,24,6,18
Gønkh,quelthalas,575,druid,restoration,6,6,0
Arjác,jubeithos,575,druid,restoration,12,6,6
Miraval,area-52,575,druid,restoration,12,6,6
Nightnes,sargeras,575,druid,restoration,12,6,6
Kokushe,burning-legion,575,druid,restoration,12,6,6
Velauris,sargeras,575,druid,restoration,12,6,6
Flôkey,tichondrius,575,druid,restoration,12,6,6
Nrp,stormrage,575,druid,restoration,12,6,6
Seralyo,quelthalas,575,druid,restoration,12,6,6
Gosch,stormrage,575,druid,restoration,12,6,6
Clawandørder,tichondrius,575,druid,restoration,12,6,6
Spaceships,stormrage,575,druid,restoration,12,6,6
Ulfvur,nagrand,575,druid,restoration,12,6,6
Weltherion,guldan,575,druid,restoration,12,6,6
Bamfferal,tichondrius,575,druid,restoration,12,6,6
Jonoa,nagrand,575,druid,restoration,12,6,6
Bearlielegal,stormrage,575,druid,restoration,12,6,6
Keläia,quelthalas,575,druid,restoration,12,6,6
Skullchief,barthilas,575,druid,restoration,16,7,9
Sleepypaws,silvermoon,575,druid,restoration,18,6,12
Dýreðaguð,gurubashi,575,druid,restoration,18,6,12
Aligantor,thrall,575,druid,restoration,18,6,12
Treynî,tichondrius,575,druid,restoration,18,6,12
Elpako,ragnaros,574,druid,restoration,6,6,0
Carther,korgath,574,druid,restoration,12,6,6
Dibinha,azralon,574,druid,restoration,12,6,6
Throatslash,thrall,574,druid,restoration,12,6,6
Troky,drakkari,574,druid,restoration,12,6,6
Aranuir,emerald-dream,574,druid,restoration,18,6,12
Skishy,tichondrius,574,druid,restoration,18,6,12
Brisketmre,dalaran,574,druid,restoration,36,6,30
Lonewolfdrd,illidan,573,druid,restoration,6,6,0
Kallinia,tichondrius,573,druid,restoration,6,6,0
Quagsire,moon-guard,573,druid,restoration,18,6,12
Glandalf,illidan,573,druid,restoration,18,6,12
Vacagalo,azralon,572,druid,restoration,12,6,6
Modification,eonar,572,druid,restoration,12,6,6
Ahlekleklekk,azralon,572,druid,restoration,12,6,6
Erourk,azralon,572,druid,restoration,12,6,6
Juucifer,thrall,572,druid,restoration,12,6,6
Nightshiver,bleeding-hollow,572,druid,restoration,12,6,6
Guusx,bonechewer,572,druid,restoration,18,6,12
Marisska,stormrage,571,druid,restoration,12,6,6
Kupaloidzki,proudmoore,571,druid,restoration,12,6,6
Budsmoke,stormrage,571,druid,restoration,18,6,12
Mîløh,area-52,570,druid,restoration,12,6,6
Aokseer,azralon,570,druid,restoration,12,6,6
Nordway,alexstrasza,569,druid,restoration,12,6,6
Healbott,lightnings-blade,569,druid,restoration,12,6,6
Otixx,wyrmrest-accord,568,druid,restoration,18,6,12
Naachocheeze,tichondrius,566,druid,restoration,12,6,6
Lililililil,stormrage,552,druid,restoration,36,6,30
Istishiã,tichondrius,543,druid,restoration,14,7,7
Enyu,sargeras,542,druid,restoration,23,6,17
Cudbacrakhed,tichondrius,541,druid,restoration,20,7,13
Pahandan,bonechewer,528,druid,restoration,15,7,8
Isalien,kelthuzad,521,druid,restoration,21,7,14
Arthemisgodx,azralon,520,druid,restoration,17,10,7
Rakins,arthas,496,druid,restoration,13,6,7
Awkwarder,emerald-dream,494,druid,restoration,19,7,12
Windù,azralon,488,druid,restoration,16,9,7
Kascatm,area-52,480,druid,restoration,6,5,1
Genghisßong,mannoroth,480,druid,restoration,6,5,1
Jaspen,bleeding-hollow,480,druid,restoration,6,5,1
Diggsterz,area-52,480,druid,restoration,6,5,1
Flatdaddy,doomhammer,480,druid,restoration,6,5,1
Dëmoníc,ragnaros,480,druid,restoration,6,5,1
Roraex,tichondrius,480,druid,restoration,6,5,1
Treehealage,sargeras,480,druid,restoration,6,5,1
Sevend,tichondrius,480,druid,restoration,6,5,1
Naakx,tichondrius,480,druid,restoration,6,5,1
Buckmoon,area-52,480,druid,restoration,12,5,7
Randoms,perenolde,480,druid,restoration,12,5,7
Ashstarfall,barthilas,480,druid,restoration,12,5,7
Brocolli,sargeras,480,druid,restoration,12,5,7
Vêrâ,stormrage,480,druid,restoration,12,5,7
Stormjammer,proudmoore,480,druid,restoration,12,5,7
Furrari,baelgun,480,druid,restoration,12,5,7
Cheeseface,bleeding-hollow,480,druid,restoration,12,5,7
Skogsbruk,stormrage,480,druid,restoration,12,5,7
Greeneguy,thrall,480,druid,restoration,12,5,7
Tydruid,illidan,480,druid,restoration,12,5,7
Moonfannia,malganis,480,druid,restoration,12,5,7
Angryalyu,tichondrius,480,druid,restoration,12,5,7
Tranqz,moon-guard,480,druid,restoration,12,5,7
Whìtewölf,emerald-dream,480,druid,restoration,12,5,7
Lukass,tichondrius,480,druid,restoration,12,5,7
Stårrysky,illidan,480,druid,restoration,12,5,7
Pigdd,tichondrius,480,druid,restoration,12,5,7
Memoryleaks,proudmoore,480,druid,restoration,12,5,7
Jaydog,emerald-dream,480,druid,restoration,12,5,7
Teslabeam,illidan,480,druid,restoration,12,5,7
Stamookee,area-52,480,druid,restoration,12,5,7
Hotgoal,frostmourne,480,druid,restoration,12,5,7
Hotgoose,malganis,480,druid,restoration,12,5,7
Lookhowirun,emerald-dream,480,druid,restoration,12,5,7
Yevenbother,tichondrius,480,druid,restoration,12,5,7
Reconus,frostmourne,480,druid,restoration,12,5,7
Afrogx,dalaran,480,druid,restoration,12,5,7
Maxspeed,tichondrius,480,druid,restoration,12,5,7
Zemul,ragnaros,480,druid,restoration,12,5,7
Tygraz,alleria,480,druid,restoration,12,5,7
Shartah,zuljin,480,druid,restoration,12,5,7
Fastyhands,illidan,480,druid,restoration,12,5,7
Noah,altar-of-storms,480,druid,restoration,12,5,7
Hudada,emerald-dream,480,druid,restoration,12,5,7
Blàtté,zuljin,480,druid,restoration,12,5,7
Wizdùm,frostmourne,480,druid,restoration,13,5,8
Duckbillby,bleeding-hollow,480,druid,restoration,14,5,9
Djimbo,kelthuzad,480,druid,restoration,18,5,13
Guacisextraa,thrall,480,druid,restoration,18,5,13
Peakedinwod,sargeras,480,druid,restoration,18,5,13
Jungledíff,ragnaros,480,druid,restoration,18,5,13
Spacaa,kelthuzad,480,druid,restoration,24,5,19
Offthemeters,mannoroth,480,druid,restoration,24,5,19
Treezy,dalaran,480,druid,restoration,24,5,19
Hornmenow,frostmourne,480,druid,restoration,24,5,19
Brostoevski,khadgar,480,druid,restoration,24,5,19
Murrmerly,moon-guard,479,druid,restoration,6,5,1
Sønèca,azralon,479,druid,restoration,12,5,7
Jamona,cenarius,479,druid,restoration,12,5,7
Redfang,jaedenar,479,druid,restoration,12,5,7
Forest,frostmourne,479,druid,restoration,12,5,7
Jammi,skywall,479,druid,restoration,12,5,7
Mvqxd,tichondrius,479,druid,restoration,12,5,7
Murkkd,tichondrius,479,druid,restoration,12,5,7
Mînîboss,ragnaros,479,druid,restoration,12,5,7
Pingú,tichondrius,479,druid,restoration,14,5,9
Sharialawl,stormreaver,479,druid,restoration,18,5,13
Indicah,barthilas,479,druid,restoration,18,5,13
Olegoatjames,darkspear,478,druid,restoration,13,6,7
Rònaldò,drakthul,478,druid,restoration,12,5,7
Fastafboy,stormrage,478,druid,restoration,12,5,7
Bloodyhoofs,malganis,478,druid,restoration,12,5,7
Treemendous,tichondrius,478,druid,restoration,12,5,7
Beienus,ragnaros,478,druid,restoration,12,5,7
Natruid,sargeras,478,druid,restoration,12,5,7
Linbiba,area-52,478,druid,restoration,12,5,7
Jíbóia,azralon,478,druid,restoration,12,5,7
Scheppke,bleeding-hollow,477,druid,restoration,12,5,7
Fiddy,kelthuzad,477,druid,restoration,12,5,7
Beanslice,nazgrel,477,druid,restoration,18,5,13
Byahh,shuhalo,477,druid,restoration,18,5,13
Baha,azralon,477,druid,restoration,18,5,13
Wraiven,elune,477,druid,restoration,18,5,13
Swiftstrider,frostmourne,476,druid,restoration,10,6,4
Béren,alterac-mountains,476,druid,restoration,12,5,7
Kaldrago,detheroc,476,druid,restoration,12,5,7
Phlap,zuljin,476,druid,restoration,12,5,7
Ånxiety,skullcrusher,476,druid,restoration,12,5,7
Muphausa,area-52,475,druid,restoration,12,5,7
Apocalyptoe,proudmoore,474,druid,restoration,12,5,7
Finubar,emerald-dream,472,druid,restoration,12,5,7
Vuthryx,tichondrius,472,druid,restoration,18,5,13
Curador,aegwynn,471,druid,restoration,18,5,13
Bobruid,nagrand,469,druid,restoration,19,9,10
Maerk,aerie-peak,469,druid,restoration,18,5,13
Udroth,kelthuzad,468,druid,restoration,17,5,12
Metaldruid,tichondrius,463,druid,restoration,11,5,6
Druidkofwa,tichondrius,462,druid,restoration,11,5,6
Semangarbage,tichondrius,457,druid,restoration,15,8,7
Chopotron,ragnaros,447,druid,restoration,16,5,11
Fuzzie,icecrown,447,druid,restoration,16,5,11
Bigelbows,area-52,432,druid,restoration,15,6,9
Qij,eonar,431,druid,restoration,11,5,6
Gankstababy,tichondrius,426,druid,restoration,20,6,14
Indicahigh,moon-guard,424,druid,restoration,16,7,9
Persiancoco,area-52,422,druid,restoration,14,6,8
Oongadunga,tichondrius,415,druid,restoration,14,5,9
Luluid,tichondrius,399,druid,restoration,5,5,0
Peazoepico,tichondrius,384,druid,restoration,6,4,2
Crayolaa,barthilas,384,druid,restoration,6,4,2
Lushÿ,tichondrius,384,druid,restoration,6,4,2
Bambi,bleeding-hollow,384,druid,restoration,6,4,2
Clydruid,blackrock,384,druid,restoration,6,4,2
Shiftedonyou,blackrock,384,druid,restoration,6,4,2
Thetbones,tichondrius,384,druid,restoration,6,4,2
Deegawn,proudmoore,384,druid,restoration,6,4,2
Relikd,dawnbringer,384,druid,restoration,6,4,2
Gilysel,tichondrius,384,druid,restoration,6,4,2
Êhurricane,dalaran,384,druid,restoration,6,4,2
Koan,proudmoore,384,druid,restoration,6,4,2
Johnnybigg,barthilas,384,druid,restoration,6,4,2
Kushkilla,malganis,384,druid,restoration,6,4,2
Tigresa,perenolde,384,druid,restoration,6,4,2
Doomky,area-52,384,druid,restoration,6,4,2
Toastsdruid,tichondrius,384,druid,restoration,6,4,2
Lylek,azshara,384,druid,restoration,6,4,2
Outcastmango,thrall,384,druid,restoration,6,4,2
Metaindexqt,quelthalas,384,druid,restoration,6,4,2
Someshta,sargeras,384,druid,restoration,6,4,2
Clarityx,illidan,384,druid,restoration,6,4,2
Ckàíne,stormrage,384,druid,restoration,6,4,2
Music,magtheridon,384,druid,restoration,6,4,2
Zoddyboy,tichondrius,384,druid,restoration,6,4,2
Euwin,stormrage,384,druid,restoration,6,4,2
Dpumba,azralon,384,druid,restoration,6,4,2
Starshípx,tichondrius,384,druid,restoration,6,4,2
Hottie,kelthuzad,384,druid,restoration,6,4,2
Zbh,tichondrius,384,druid,restoration,6,4,2
Nbendtner,tichondrius,384,druid,restoration,6,4,2
Shroomdealer,kelthuzad,384,druid,restoration,6,4,2
Nøbuchi,kelthuzad,384,druid,restoration,6,4,2
Volayer,frostmourne,384,druid,restoration,6,4,2
Druidlstrudl,moon-guard,384,druid,restoration,6,4,2
Bandruid,tichondrius,384,druid,restoration,10,4,6
Zerocoolx,illidan,384,druid,restoration,15,5,10
Lillenan,illidan,384,druid,restoration,12,4,8
Narlie,malfurion,384,druid,restoration,12,4,8
Mastabtw,illidan,384,druid,restoration,12,4,8
Bopple,tichondrius,384,druid,restoration,12,4,8
Taysfriend,tichondrius,384,druid,restoration,12,4,8
Ebrìthil,hyjal,384,druid,restoration,12,4,8
Kinatsu,tichondrius,384,druid,restoration,12,4,8
Metaphysìcs,kelthuzad,384,druid,restoration,12,4,8
Mollytonasty,demon-soul,384,druid,restoration,12,4,8
Figsurine,sargeras,384,druid,restoration,12,4,8
Nocup,illidan,384,druid,restoration,12,4,8
Flompstomper,skullcrusher,384,druid,restoration,12,4,8
Ilmoonz,frostmane,384,druid,restoration,12,4,8
Thebutterboy,stormrage,384,druid,restoration,12,4,8
Ônlyyou,burning-legion,384,druid,restoration,12,4,8
Stamaximdru,lightbringer,384,druid,restoration,12,4,8
Hotrecki,kelthuzad,384,druid,restoration,12,4,8
Ganizote,ragnaros,384,druid,restoration,12,4,8
Chickenwings,ragnaros,384,druid,restoration,12,4,8
Shadru,bleeding-hollow,384,druid,restoration,12,4,8
Drstudmaster,skullcrusher,384,druid,restoration,12,4,8
Djdontlose,stormrage,384,druid,restoration,12,4,8
Catcat,dalaran,384,druid,restoration,12,4,8
Bigshred,tichondrius,384,druid,restoration,12,4,8
Flyshles,frostmourne,384,druid,restoration,12,4,8
Guurgul,bleeding-hollow,384,druid,restoration,12,4,8
Stephonxd,area-52,384,druid,restoration,12,4,8
Brittanychan,sargeras,384,druid,restoration,12,4,8
Py,stormscale,384,druid,restoration,12,4,8
Ursu,nemesis,384,druid,restoration,12,4,8
Delícíous,darkspear,384,druid,restoration,12,4,8
Mittns,arthas,384,druid,restoration,12,4,8
Tommyjimmy,andorhal,384,druid,restoration,12,4,8
Mé,arthas,384,druid,restoration,12,4,8
Spazer,darkspear,384,druid,restoration,12,4,8
Karlmalone,thunderlord,384,druid,restoration,12,4,8
Angercow,nordrassil,384,druid,restoration,12,4,8
Gathmog,boulderfist,384,druid,restoration,12,4,8
Ohioman,bleeding-hollow,384,druid,restoration,12,4,8
Science,arthas,384,druid,restoration,12,4,8
Awguseon,proudmoore,384,druid,restoration,12,4,8
Chiikawa,tichondrius,384,druid,restoration,12,4,8
Mastahskills,illidan,384,druid,restoration,12,4,8
Bumbally,illidan,384,druid,restoration,12,4,8
Moosesolini,chogall,384,druid,restoration,12,4,8
Allevii,sargeras,384,druid,restoration,12,4,8
Fartsicle,lightnings-blade,384,druid,restoration,12,4,8
Synthesïs,malganis,384,druid,restoration,12,4,8
Bwaccowi,sargeras,384,druid,restoration,12,4,8
Odenmu,ragnaros,384,druid,restoration,12,4,8
Harøs,stormrage,384,druid,restoration,13,4,9
Read,eredar,384,druid,restoration,21,5,16
Tarvosx,thrall,384,druid,restoration,18,4,14
Renlion,malganis,384,druid,restoration,18,4,14
Swagglefrag,zuljin,384,druid,restoration,18,4,14
Silasel,sargeras,384,druid,restoration,18,4,14
Ternkote,tichondrius,384,druid,restoration,21,4,17
Calleguard,terenas,383,druid,restoration,6,4,2
Bryle,kiljaeden,383,druid,restoration,6,4,2
Nightflow,emerald-dream,383,druid,restoration,12,4,8
Brazzar,kiljaeden,383,druid,restoration,12,4,8
Pahrump,stormrage,383,druid,restoration,12,4,8
Dadboody,sargeras,383,druid,restoration,12,4,8
Ssuka,tichondrius,383,druid,restoration,12,4,8
Norco,dentarg,383,druid,restoration,12,4,8
Jonnyutaa,emerald-dream,383,druid,restoration,12,4,8
Kurnon,shattered-hand,383,druid,restoration,12,4,8
Zelara,kilrogg,383,druid,restoration,12,4,8
Posmard,ragnaros,383,druid,restoration,12,4,8
Elanni,illidan,383,druid,restoration,12,4,8
Moonshire,boulderfist,383,druid,restoration,12,4,8
Hazbekbek,area-52,383,druid,restoration,12,4,8
Hajjima,blackrock,383,druid,restoration,12,4,8
Linklan,bleeding-hollow,383,druid,restoration,12,4,8
Chuckzilla,korgath,383,druid,restoration,12,4,8
Madmandan,moon-guard,383,druid,restoration,18,4,14
Lulerz,cenarius,383,druid,restoration,18,4,14
Rikey,thaurissan,383,druid,restoration,18,4,14
Morphiius,archimonde,383,druid,restoration,18,4,14
Beôrn,mugthol,382,druid,restoration,6,4,2
Solá,skywall,382,druid,restoration,12,4,8
Alcoolânio,stormrage,382,druid,restoration,12,4,8
Puzzlè,thrall,382,druid,restoration,12,4,8
Guojue,tichondrius,382,druid,restoration,12,4,8
Gardeni,emerald-dream,382,druid,restoration,12,4,8
Infestador,tichondrius,382,druid,restoration,12,4,8
Maldrake,quelthalas,381,druid,restoration,12,4,8
Ceria,hellscream,381,druid,restoration,12,4,8
Meowsz,malganis,381,druid,restoration,12,4,8
Certzu,moon-guard,381,druid,restoration,18,4,14
Bigbadcow,sargeras,380,druid,restoration,12,4,8
Metamooseowl,crushridge,379,druid,restoration,12,4,8
Yassi,earthen-ring,379,druid,restoration,12,4,8
Nüg,frostmourne,379,druid,restoration,14,4,10
Irumble,silver-hand,377,druid,restoration,17,4,13
Sertroz,sargeras,351,druid,restoration,11,4,7
Sndru,illidan,330,druid,restoration,12,5,7
Harûko,moon-guard,330,druid,restoration,30,5,25
Greythan,madoran,325,druid,restoration,42,5,37
Alleae,stormrage,319,druid,restoration,5,4,1
Fatloser,hyjal,319,druid,restoration,11,5,6
Ugress,whisperwind,302,druid,restoration,13,4,9
Lorandros,saurfang,288,druid,restoration,6,3,3
Mädnhairy,zuljin,288,druid,restoration,6,3,3
Istayfrawsty,darkspear,288,druid,restoration,6,3,3
Rukins,frostmourne,288,druid,restoration,6,3,3
Fungamezx,bleeding-hollow,288,druid,restoration,6,3,3
Anthria,illidan,288,druid,restoration,6,3,3
Zukrath,shadow-council,288,druid,restoration,6,3,3
Drunner,lothar,288,druid,restoration,6,3,3
Catahmine,thrall,288,druid,restoration,6,3,3
Xötic,stormrage,288,druid,restoration,6,3,3
Owaru,stormrage,288,druid,restoration,6,3,3
Asian,moon-guard,288,druid,restoration,6,3,3
Koratan,frostmourne,288,druid,restoration,6,3,3
Yllercia,quelthalas,288,druid,restoration,6,3,3
Kcazz,thorium-brotherhood,288,druid,restoration,6,3,3
Ateup,dawnbringer,288,druid,restoration,6,3,3
Emiyababmura,tichondrius,288,druid,restoration,6,3,3
Eryon,nemesis,288,druid,restoration,6,3,3
Lemonnz,illidan,288,druid,restoration,6,3,3
Tziv,area-52,288,druid,restoration,6,3,3
Idolizeme,skullcrusher,288,druid,restoration,6,3,3
Ðeepsixx,burning-legion,288,druid,restoration,6,3,3
Moex,illidan,288,druid,restoration,6,3,3
Creamsoda,frostmane,288,druid,restoration,6,3,3
Hotmuztard,sargeras,288,druid,restoration,6,3,3
Sevensword,tichondrius,288,druid,restoration,6,3,3
Bearforcetwo,lightbringer,288,druid,restoration,6,3,3
Muffiñ,moon-guard,288,druid,restoration,6,3,3
Stephenfurry,tichondrius,288,druid,restoration,6,3,3
Geno,cenarius,288,druid,restoration,6,3,3
Isunami,emerald-dream,288,druid,restoration,6,3,3
Sonicphantom,kelthuzad,288,druid,restoration,6,3,3
Wiskees,sargeras,288,druid,restoration,6,3,3
Seekamp,khazgoroth,288,druid,restoration,6,3,3
Anaho,korgath,288,druid,restoration,6,3,3
Curze,maiev,288,druid,restoration,6,3,3
Tronita,frostwolf,288,druid,restoration,6,3,3
Thenog,arthas,288,druid,restoration,6,3,3
Lotsoflovexo,illidan,288,druid,restoration,6,3,3
Mythicdruid,ragnaros,288,druid,restoration,6,3,3
Aidoh,kelthuzad,288,druid,restoration,6,3,3
Wâggles,moon-guard,288,druid,restoration,6,3,3
Hýovan,stormrage,288,druid,restoration,6,3,3
Teancookies,tichondrius,288,druid,restoration,6,3,3
Antonniel,azralon,288,druid,restoration,6,3,3
Menapaws,muradin,288,druid,restoration,6,3,3
Junglefevers,tichondrius,288,druid,restoration,6,3,3
Càlthar,sargeras,288,druid,restoration,6,3,3
Reptile,terenas,288,druid,restoration,6,3,3
Obsesséd,aggramar,288,druid,restoration,6,3,3
Bibliopole,tichondrius,288,druid,restoration,6,3,3
Hashdxm,tichondrius,288,druid,restoration,6,3,3
Panterarosa,ragnaros,288,druid,restoration,6,3,3
Vadroid,dalaran,288,druid,restoration,6,3,3
Ømí,quelthalas,288,druid,restoration,6,3,3
Lahgit,frostmourne,288,druid,restoration,6,3,3
Lðhnar,malganis,288,druid,restoration,6,3,3
Catdruid,the-forgotten-coast,288,druid,restoration,6,3,3
Imaoo,illidan,288,druid,restoration,6,3,3
Flatnose,agamaggan,288,druid,restoration,6,3,3
Cutefeetz,moon-guard,288,druid,restoration,6,3,3
Tarlis,khazgoroth,288,druid,restoration,6,3,3
Drmf,frostmourne,288,druid,restoration,6,3,3
Azaran,bleeding-hollow,288,druid,restoration,6,3,3
Zaddy,spinebreaker,288,druid,restoration,6,3,3
Spinach,moon-guard,288,druid,restoration,6,3,3
Nightz,icecrown,288,druid,restoration,6,3,3
Ayra,sargeras,288,druid,restoration,6,3,3
Veyx,malganis,288,druid,restoration,6,3,3
Realá,kelthuzad,288,druid,restoration,6,3,3
Gouzz,frostmourne,288,druid,restoration,6,3,3
Nokash,tichondrius,288,druid,restoration,6,3,3
Buffjungle,tichondrius,288,druid,restoration,6,3,3
Zxxzy,tichondrius,288,druid,restoration,8,3,5
Demitassie,wyrmrest-accord,288,druid,restoration,8,3,5
Overgrowth,zuljin,288,druid,restoration,9,3,6
Mysteec,bleeding-hollow,288,druid,restoration,11,3,8
Shadøwshifta,kelthuzad,288,druid,restoration,12,3,9
Anthren,garona,288,druid,restoration,12,3,9
Bearlínwall,sargeras,288,druid,restoration,12,3,9
Theømega,stormrage,288,druid,restoration,12,3,9
Møth,anvilmar,288,druid,restoration,12,3,9
Bigclapz,stormrage,288,druid,restoration,12,3,9
Bewear,zangarmarsh,288,druid,restoration,12,3,9
Solushuffle,sargeras,288,druid,restoration,12,3,9
Endworldx,tichondrius,288,druid,restoration,12,3,9
Biggié,bleeding-hollow,288,druid,restoration,12,3,9
Qdrui,tichondrius,288,druid,restoration,12,3,9
Wwkd,illidan,288,druid,restoration,12,3,9
Oflodor,azralon,288,druid,restoration,12,3,9
Theblind,korgath,288,druid,restoration,12,3,9
Madtreé,bleeding-hollow,288,druid,restoration,12,3,9
Concerneddog,malganis,288,druid,restoration,12,3,9
Veejae,stormreaver,288,druid,restoration,12,3,9
Noradn,malganis,288,druid,restoration,12,3,9
Raptormotoo,lothar,288,druid,restoration,12,3,9
Mattiu,area-52,288,druid,restoration,12,3,9
Borbys,sargeras,288,druid,restoration,12,3,9
Blacksimba,area-52,288,druid,restoration,12,3,9
Quadrivium,stormrage,288,druid,restoration,12,3,9
Nesterin,arathor,288,druid,restoration,12,3,9
Nuantar,nemesis,288,druid,restoration,12,3,9
Deyz,ysera,288,druid,restoration,12,3,9
Otckillaa,boulderfist,288,druid,restoration,12,3,9
Kanokoho,wyrmrest-accord,288,druid,restoration,12,3,9
Garrodan,aerie-peak,288,druid,restoration,12,3,9
Anthracnose,zuljin,288,druid,restoration,12,3,9
Monicaduan,frostmourne,288,druid,restoration,12,3,9
Soloqmenace,malganis,288,druid,restoration,12,3,9
Krispies,eredar,288,druid,restoration,12,3,9
Azngødz,tichondrius,288,druid,restoration,12,3,9
Thundyrcat,tichondrius,288,druid,restoration,18,3,15
Yuumura,stormrage,288,druid,restoration,18,3,15
Soloqleaver,tichondrius,288,druid,restoration,18,3,15
Friendly,wyrmrest-accord,288,druid,restoration,18,3,15
Giddeonv,draenor,288,druid,restoration,18,3,15
Killvious,kelthuzad,288,druid,restoration,24,3,21
Rádágast,nemesis,287,druid,restoration,6,3,3
Udala,durotan,287,druid,restoration,6,3,3
Nightseekers,grizzly-hills,287,druid,restoration,6,3,3
Glowstixz,tichondrius,287,druid,restoration,6,3,3
Joxor,nordrassil,287,druid,restoration,6,3,3
Harderplease,emerald-dream,287,druid,restoration,6,3,3
Ayakuya,veknilash,287,druid,restoration,6,3,3
Oldcktwist,garrosh,287,druid,restoration,6,3,3
Sefestria,senjin,287,druid,restoration,6,3,3
Temujin,shadow-council,287,druid,restoration,6,3,3
Moonfires,senjin,287,druid,restoration,6,3,3
Iamanoob,sargeras,287,druid,restoration,10,4,6
Atillah,stormscale,287,druid,restoration,12,3,9
Lêsly,thrall,287,druid,restoration,12,3,9
Druishcat,dark-iron,287,druid,restoration,12,3,9
Megara,dalaran,287,druid,restoration,12,3,9
Cieran,senjin,287,druid,restoration,18,3,15
Twoworldz,tichondrius,286,druid,restoration,6,3,3
Dcdc,malganis,286,druid,restoration,6,3,3
Bullshiftter,ursin,286,druid,restoration,6,3,3
Andraste,queldorei,286,druid,restoration,12,3,9
Taiyla,stormrage,286,druid,restoration,12,3,9
Fortunecat,illidan,286,druid,restoration,12,3,9
Cryptalas,tichondrius,286,druid,restoration,12,3,9
Moonbootz,proudmoore,285,druid,restoration,12,3,9
Sabari,area-52,285,druid,restoration,24,3,21
Brbcatsonfir,malganis,270,druid,restoration,28,4,24
Gloomy,andorhal,256,druid,restoration,10,3,7
Anastasyiar,illidan,256,druid,restoration,10,3,7
Mahjongg,stormrage,255,druid,restoration,14,4,10
Dotdmage,tichondrius,255,druid,restoration,11,3,8
Thrunirn,dalaran,254,druid,restoration,11,3,8
Benngotit,magtheridon,240,druid,restoration,9,3,6
Stive,nemesis,234,druid,restoration,6,4,2
Yoona,kiljaeden,234,druid,restoration,7,4,3
Restyblazed,sargeras,234,druid,restoration,8,4,4
Sïmba,andorhal,234,druid,restoration,9,4,5
Donaldsr,area-52,234,druid,restoration,9,4,5
Stormwood,moonrunner,234,druid,restoration,21,4,17
Stèvén,tichondrius,233,druid,restoration,13,4,9
Tyrannicool,proudmoore,224,druid,restoration,10,3,7
Aegys,medivh,224,druid,restoration,11,3,8
Gavdru,tichondrius,223,druid,restoration,8,3,5
Faentz,stormrage,192,druid,restoration,9,3,6
Katesw,tichondrius,192,druid,restoration,6,2,4
Gepardéx,ragnaros,192,druid,restoration,6,2,4
Ambassador,kelthuzad,192,druid,restoration,6,2,4
Hatricio,ragnaros,192,druid,restoration,6,2,4
Five,the-underbog,192,druid,restoration,6,2,4
Mcbeef,tichondrius,192,druid,restoration,6,2,4
Psycloned,magtheridon,192,druid,restoration,6,2,4
Relxlol,tichondrius,192,druid,restoration,6,2,4
Crazywoodowl,tichondrius,192,druid,restoration,6,2,4
Noonwalk,illidan,192,druid,restoration,6,2,4
Tagliatélle,emerald-dream,192,druid,restoration,6,2,4
Moolord,eonar,192,druid,restoration,6,2,4
Tynsley,malganis,192,druid,restoration,6,2,4
Marisco,malganis,192,druid,restoration,6,2,4
Spongedaddy,tichondrius,192,druid,restoration,6,2,4
Netflixnphil,sargeras,192,druid,restoration,6,2,4
Violyte,tichondrius,192,druid,restoration,6,2,4
Hawtzi,stormrage,192,druid,restoration,6,2,4
Hchhi,ragnaros,192,druid,restoration,6,2,4
Hotsoncrak,tichondrius,192,druid,restoration,6,2,4
Niquil,hyjal,192,druid,restoration,6,2,4
Nacur,bleeding-hollow,192,druid,restoration,6,2,4
Cultnelf,illidan,192,druid,restoration,6,2,4
Geycat,tichondrius,192,druid,restoration,6,2,4
Nogardfan,tichondrius,192,druid,restoration,6,2,4
Drulícinha,azralon,192,druid,restoration,6,2,4
Megasteak,lightninghoof,192,druid,restoration,6,2,4
Gorfrog,tichondrius,192,druid,restoration,6,2,4
Runningback,emerald-dream,192,druid,restoration,6,2,4
Tropikana,burning-legion,192,druid,restoration,6,2,4
Kornaz,guldan,192,druid,restoration,6,2,4
Bigtonkatruk,tichondrius,192,druid,restoration,6,2,4
Gêrm,stormrage,192,druid,restoration,6,2,4
Freemac,tichondrius,192,druid,restoration,6,2,4
Sidechonies,tichondrius,192,druid,restoration,6,2,4
Murpheey,sargeras,192,druid,restoration,6,2,4
Loved,stormrage,192,druid,restoration,6,2,4
Stratego,drenden,192,druid,restoration,6,2,4
Whiplash,deathwing,192,druid,restoration,6,2,4
Darinnia,lothar,192,druid,restoration,6,2,4
Hipityhopity,bleeding-hollow,192,druid,restoration,6,2,4
Feeoria,lothar,192,druid,restoration,6,2,4
Cushionmaker,tichondrius,192,druid,restoration,6,2,4
Shiftzy,thrall,192,druid,restoration,6,2,4
Sandiegoo,destromath,192,druid,restoration,6,2,4
Ellowei,earthen-ring,192,druid,restoration,6,2,4
Droody,earthen-ring,192,druid,restoration,6,2,4
Tadoo,tichondrius,192,druid,restoration,6,2,4
Snugglin,kelthuzad,192,druid,restoration,6,2,4
Kagekuma,bleeding-hollow,192,druid,restoration,6,2,4
Zils,bleeding-hollow,192,druid,restoration,6,2,4
Dustdruid,hakkar,192,druid,restoration,6,2,4
Fixn,tichondrius,192,druid,restoration,6,2,4
Epicbehr,kiljaeden,192,druid,restoration,6,2,4
Vaelstrasz,skullcrusher,192,druid,restoration,6,2,4
Cheesetouchy,illidan,192,druid,restoration,6,2,4
Nightwinter,area-52,192,druid,restoration,6,2,4
Bekroh,crushridge,192,druid,restoration,6,2,4
Chasmata,malganis,192,druid,restoration,6,2,4
Levincy,thrall,192,druid,restoration,6,2,4
Bomp,malganis,192,druid,restoration,6,2,4
Lilcocoxoxo,shadowmoon,192,druid,restoration,6,2,4
Ghostti,stormrage,192,druid,restoration,6,2,4
Firefireahh,sargeras,192,druid,restoration,6,2,4
Terminatore,kelthuzad,192,druid,restoration,6,2,4
Tatahe,zuljin,192,druid,restoration,6,2,4
Jackdr,tichondrius,192,druid,restoration,6,2,4
Hyperdryve,bonechewer,192,druid,restoration,6,2,4
Kaisuckslol,stormrage,192,druid,restoration,6,2,4
Akinetic,illidan,192,druid,restoration,6,2,4
Boundless,skullcrusher,192,druid,restoration,6,2,4
Bullbuddy,wyrmrest-accord,192,druid,restoration,6,2,4
Leafthief,whisperwind,192,druid,restoration,6,2,4
Koalla,frostmourne,192,druid,restoration,6,2,4
Kassius,alleria,192,druid,restoration,6,2,4
Clonkzy,area-52,192,druid,restoration,6,2,4
Loveflowers,nemesis,192,druid,restoration,6,2,4
Batshi,gorefiend,192,druid,restoration,6,2,4
Zaddychulo,area-52,192,druid,restoration,6,2,4
Gretatunberg,skywall,192,druid,restoration,6,2,4
Barkcheeks,area-52,192,druid,restoration,6,2,4
Sôlemn,barthilas,192,druid,restoration,6,2,4
Owlgz,barthilas,192,druid,restoration,6,2,4
Laesh,nemesis,192,druid,restoration,6,2,4
Simperella,dalaran,192,druid,restoration,13,3,10
Hotsx,frostmourne,192,druid,restoration,9,2,7
Sleepyheals,tichondrius,192,druid,restoration,14,3,11
Nakedllove,sargeras,192,druid,restoration,11,2,9
Gradiluth,proudmoore,192,druid,restoration,12,2,10
Fribbleog,korgath,192,druid,restoration,12,2,10
Lunmoon,thrall,192,druid,restoration,12,2,10
Fjv,laughing-skull,192,druid,restoration,12,2,10
Urhero,sargeras,192,druid,restoration,12,2,10
Chaarm,proudmoore,192,druid,restoration,12,2,10
Trèè,frostmane,192,druid,restoration,12,2,10
Pinchncheeks,bleeding-hollow,192,druid,restoration,12,2,10
Daesdaddy,sargeras,192,druid,restoration,12,2,10
Bboikha,quelthalas,192,druid,restoration,12,2,10
Grullandur,hakkar,192,druid,restoration,12,2,10
Moocka,ragnaros,192,druid,restoration,12,2,10
Crunchieroll,illidan,192,druid,restoration,12,2,10
Actioncat,emerald-dream,192,druid,restoration,12,2,10
Kittysnuggle,emerald-dream,192,druid,restoration,12,2,10
Glockenstien,proudmoore,192,druid,restoration,12,2,10
Wonderhood,quelthalas,192,druid,restoration,12,2,10
Goorybud,tichondrius,192,druid,restoration,12,2,10
Jayto,frostmourne,192,druid,restoration,12,2,10
Moonkay,tichondrius,192,druid,restoration,12,2,10
Batlex,thrall,192,druid,restoration,12,2,10
Iyrnae,zuljin,192,druid,restoration,12,2,10
Sírius,stormrage,192,druid,restoration,12,2,10
Kymolyia,sargeras,192,druid,restoration,12,2,10
Aelena,whisperwind,192,druid,restoration,12,2,10
Gahr,wyrmrest-accord,192,druid,restoration,12,2,10
Jaaodalari,azralon,192,druid,restoration,12,2,10
Dodozhou,illidan,192,druid,restoration,12,2,10
Cpksdru,tichondrius,192,druid,restoration,12,2,10
Bennedïct,tichondrius,192,druid,restoration,12,2,10
Rootslayer,tichondrius,192,druid,restoration,12,2,10
Devilzown,fenris,192,druid,restoration,18,2,16
Brutalhealz,aegwynn,192,druid,restoration,18,2,16
Irontree,dunemaul,192,druid,restoration,18,2,16
Çarpentree,sargeras,192,druid,restoration,18,2,16
Clonemunster,frostmourne,192,druid,restoration,18,2,16
Samesaras,darkspear,191,druid,restoration,6,2,4
Moonkinx,frostwolf,191,druid,restoration,6,2,4
Inbreds,jubeithos,191,druid,restoration,6,2,4
Flusky,moon-guard,191,druid,restoration,6,2,4
Naxanax,stormrage,191,druid,restoration,6,2,4
Äbÿss,tichondrius,191,druid,restoration,12,2,10
Daweed,zuluhed,191,druid,restoration,12,2,10
Calliecat,moon-guard,191,druid,restoration,12,2,10
Denyou,aggramar,191,druid,restoration,12,2,10
Ellarrya,moon-guard,191,druid,restoration,12,2,10
Grimshifta,kelthuzad,191,druid,restoration,12,2,10
Voodooshiftz,emerald-dream,191,druid,restoration,12,2,10
Wantto,moknathal,190,druid,restoration,12,2,10
Garritass,moon-guard,189,druid,restoration,29,2,27
Dreamwalk,stormrage,175,druid,restoration,17,3,14
Vzi,magtheridon,159,druid,restoration,5,2,3
Pvptactician,tichondrius,159,druid,restoration,11,4,7
Jeppcat,tichondrius,159,druid,restoration,14,3,11
Frenzymoon,zuljin,144,druid,restoration,3,3,0
Mimics,zuljin,144,druid,restoration,9,2,7
Vìdá,tichondrius,138,druid,restoration,8,3,5
Teddybëar,illidan,138,druid,restoration,9,3,6
Pokieoaks,zuljin,138,druid,restoration,10,3,7
Mojoforweeks,bleeding-hollow,138,druid,restoration,12,3,9
Galind,rexxar,128,druid,restoration,4,2,2
Alshari,proudmoore,128,druid,restoration,10,2,8
Hille,sargeras,127,druid,restoration,14,2,12
Crunkk,thunderlord,127,druid,restoration,14,2,12
Forestmaster,area-52,96,druid,restoration,8,2,6
Kzdubya,stormrage,96,druid,restoration,6,1,5
Leoho,tichondrius,96,druid,restoration,6,1,5
Zabartak,lightnings-blade,96,druid,restoration,6,1,5
Ðjx,stormrage,96,druid,restoration,6,1,5
Arthridas,wyrmrest-accord,96,druid,restoration,6,1,5
Nutless,illidan,96,druid,restoration,6,1,5
Natürëblÿät,illidan,96,druid,restoration,6,1,5
Beldiin,khazgoroth,96,druid,restoration,6,1,5
Robomexi,tichondrius,96,druid,restoration,6,1,5
Raìñ,tichondrius,96,druid,restoration,6,1,5
Djsummer,tichondrius,96,druid,restoration,6,1,5
Diligent,dathremar,96,druid,restoration,6,1,5
Kazamura,tichondrius,96,druid,restoration,6,1,5
Smitebacklol,tichondrius,96,druid,restoration,6,1,5
Feorb,azuremyst,96,druid,restoration,6,1,5
Thiccybear,darkspear,96,druid,restoration,6,1,5
Lokobah,wyrmrest-accord,96,druid,restoration,6,1,5
Botdruid,hyjal,96,druid,restoration,6,1,5
Krucífy,dark-iron,96,druid,restoration,6,1,5
Berserkr,lethon,96,druid,restoration,6,1,5
Kurzul,area-52,96,druid,restoration,6,1,5
Zeelán,emerald-dream,96,druid,restoration,6,1,5
Scorpitary,ysera,96,druid,restoration,6,1,5
Bùgga,malfurion,96,druid,restoration,6,1,5
Arienne,kelthuzad,96,druid,restoration,6,1,5
Baconsniper,illidan,96,druid,restoration,6,1,5
Boomtre,malganis,96,druid,restoration,6,1,5
Moonshocka,tichondrius,96,druid,restoration,6,1,5
Orakuru,barthilas,96,druid,restoration,6,1,5
Gruulnir,antonidas,96,druid,restoration,6,1,5
Kekepöp,illidan,96,druid,restoration,6,1,5
Chomperz,tichondrius,96,druid,restoration,6,1,5
Spatulas,malganis,96,druid,restoration,6,1,5
Shiftycent,tichondrius,96,druid,restoration,6,1,5
Atagoo,tichondrius,96,druid,restoration,6,1,5
Sinistuhd,tichondrius,96,druid,restoration,6,1,5
Rakroz,emerald-dream,96,druid,restoration,6,1,5
Sily,frostmourne,96,druid,restoration,6,1,5
Macfluff,emerald-dream,96,druid,restoration,6,1,5
Róce,stormrage,96,druid,restoration,6,1,5
Barrahjr,frostmourne,96,druid,restoration,6,1,5
Alagorn,zangarmarsh,96,druid,restoration,6,1,5
Kendra,barthilas,96,druid,restoration,6,1,5
Ryhighd,sargeras,96,druid,restoration,6,1,5
Kirato,ragnaros,96,druid,restoration,6,1,5
Dsoul,tichondrius,96,druid,restoration,6,1,5
Tyrander,tichondrius,96,druid,restoration,6,1,5
Rastakant,malganis,96,druid,restoration,6,1,5
Feralgo,tichondrius,96,druid,restoration,6,1,5
Cowboyydan,malganis,96,druid,restoration,6,1,5
Logyoh,tichondrius,96,druid,restoration,6,1,5
Moocowbear,illidan,96,druid,restoration,6,1,5
Nìck,the-scryers,96,druid,restoration,6,1,5
Rezl,sargeras,96,druid,restoration,6,1,5
Aimafengari,emerald-dream,96,druid,restoration,6,1,5
Animalstylee,tichondrius,96,druid,restoration,6,1,5
Samully,area-52,96,druid,restoration,6,1,5
Gúdru,zuljin,96,druid,restoration,6,1,5
Caminanube,quelthalas,96,druid,restoration,6,1,5
Skéla,emerald-dream,96,druid,restoration,6,1,5
Moonfart,zuljin,96,druid,restoration,6,1,5
Whitehaze,proudmoore,96,druid,restoration,6,1,5
Dedderita,bloodhoof,96,druid,restoration,6,1,5
Mamazbear,area-52,96,druid,restoration,6,1,5
Ttaure,ragnaros,96,druid,restoration,6,1,5
Aelvalus,goldrinn,96,druid,restoration,6,1,5
Peterdeleter,emerald-dream,96,druid,restoration,6,1,5
Hurbd,frostmourne,96,druid,restoration,6,1,5
Vikkileaks,aegwynn,96,druid,restoration,6,1,5
Moonkingx,ragnaros,96,druid,restoration,6,1,5
Wotermelon,moon-guard,96,druid,restoration,6,1,5
Ayla,gorefiend,96,druid,restoration,6,1,5
Fadingfast,frostmourne,96,druid,restoration,6,1,5
Framess,area-52,96,druid,restoration,6,1,5
Wrathmighty,frostmourne,96,druid,restoration,6,1,5
Irl,frostmane,96,druid,restoration,6,1,5
Sheeftah,illidan,96,druid,restoration,6,1,5
Uzheals,zuljin,96,druid,restoration,6,1,5
Suncintus,aggramar,96,druid,restoration,6,1,5
Hammyaki,area-52,96,druid,restoration,6,1,5
Juves,frostmourne,96,druid,restoration,6,1,5
Nyanncat,frostmourne,96,druid,restoration,7,1,6
Lirilith,shadowsong,96,druid,restoration,16,2,14
Ikita,illidan,96,druid,restoration,8,1,7
Taztoc,stormrage,96,druid,restoration,11,1,10
Shebleeder,aegwynn,96,druid,restoration,11,1,10
Foracus,sargeras,96,druid,restoration,11,1,10
Kopidruid,barthilas,96,druid,restoration,12,1,11
Florella,misha,96,druid,restoration,12,1,11
Framling,sargeras,96,druid,restoration,12,1,11
Morpheûs,bleeding-hollow,96,druid,restoration,12,1,11
Flörence,drakkari,96,druid,restoration,12,1,11
Bigjunk,boulderfist,96,druid,restoration,12,1,11
Idontmoo,area-52,96,druid,restoration,12,1,11
Adaeloth,hyjal,96,druid,restoration,12,1,11
Daxximus,area-52,96,druid,restoration,12,1,11
Whiteglade,moon-guard,96,druid,restoration,12,1,11
Adanos,moon-guard,96,druid,restoration,12,1,11
Tuurban,stormrage,96,druid,restoration,12,1,11
Kaeliah,stormrage,96,druid,restoration,12,1,11
Rebornwhisp,moon-guard,96,druid,restoration,12,1,11
Durkanis,maelstrom,96,druid,restoration,12,1,11
Morezby,frostmourne,96,druid,restoration,12,1,11
Moonessence,fenris,96,druid,restoration,12,1,11
Sinigang,duskwood,96,druid,restoration,12,1,11
Carboz,jubeithos,96,druid,restoration,12,1,11
Mofoogoo,laughing-skull,96,druid,restoration,13,1,12
Thorsèn,sargeras,96,druid,restoration,15,1,14
Grakzul,blood-furnace,95,druid,restoration,9,2,7
Herbalife,stormrage,95,druid,restoration,6,1,5
Huriel,blackrock,95,druid,restoration,6,1,5
Bbabbi,tichondrius,89,druid,restoration,5,3,2
Eliteshift,frostmourne,64,druid,restoration,4,1,3
Pownage,kelthuzad,64,druid,restoration,16,1,15
Bòmi,tichondrius,63,druid,restoration,2,2,0
Valrathsx,arthas,31,druid,restoration,2,1,1
Suwonhealer,tichondrius,31,druid,restoration,8,1,7
Neferpitou,fenris,16,druid,restoration,6,1,5
Landro,tichondrius,1373,druid,guardian,107,51,56
Kobebeef,malganis,1203,druid,guardian,30,13,17
Ashamang,emerald-dream,1135,druid,guardian,30,16,14
Ntseebxoxoxg,gurubashi,1127,druid,guardian,60,26,34
Haalls,gallywix,1110,druid,guardian,54,16,38
Ürsus,quelthalas,1106,druid,guardian,72,32,40
Yurius,kiljaeden,1102,druid,guardian,24,15,9
Theme,frostwolf,1089,druid,guardian,48,18,30
Crashägásm,proudmoore,1062,druid,guardian,30,15,15
Muphasax,ragnaros,992,druid,guardian,44,14,30
Kesagake,feathermoon,921,druid,guardian,18,10,8
Manasmi,frostmourne,916,druid,guardian,47,20,27
Firash,frostmourne,888,druid,guardian,21,11,10
Maraliss,shadowsong,863,druid,guardian,30,14,16
Gums,lightbringer,845,druid,guardian,89,28,61
Mordu,rivendare,838,druid,guardian,25,9,16
Inxert,tichondrius,792,druid,guardian,16,9,7
Gifteddream,zuljin,759,druid,guardian,24,9,15
Nerfmesoon,sargeras,734,druid,guardian,16,8,8
Dalidielor,dalaran,671,druid,guardian,18,7,11
Koan,proudmoore,671,druid,guardian,24,7,17
Jacinty,saurfang,670,druid,guardian,18,7,11
Multivar,burning-legion,669,druid,guardian,12,7,5
Agmukar,wyrmrest-accord,659,druid,guardian,12,7,5
Lycanthus,thrall,575,druid,guardian,12,6,6
Rektx,area-52,574,druid,guardian,12,6,6
Ishiftalot,bleeding-hollow,573,druid,guardian,15,7,8
Bjørnen,thrall,570,druid,guardian,12,6,6
Giddeonv,draenor,570,druid,guardian,12,6,6
Aìón,emerald-dream,566,druid,guardian,12,6,6
Caliwagon,dalaran,490,druid,guardian,13,6,7
Agaxaido,azgalor,480,druid,guardian,12,5,7
Ferio,moon-guard,480,druid,guardian,24,5,19
Chärmin,area-52,479,druid,guardian,12,5,7
Balanah,quelthalas,472,druid,guardian,15,6,9
Maen,kelthuzad,384,druid,guardian,6,4,2
Bigxworm,gurubashi,384,druid,guardian,12,4,8
Druidd,moonrunner,384,druid,guardian,12,4,8
Krylax,sargeras,384,druid,guardian,12,4,8
Bleedhoof,frostmourne,384,druid,guardian,12,4,8
Moistism,khazgoroth,384,druid,guardian,18,4,14
Wraithman,madoran,383,druid,guardian,6,4,2
Vennfox,illidan,383,druid,guardian,12,4,8
Tankbareass,aerie-peak,382,druid,guardian,18,4,14
Cléa,illidan,381,druid,guardian,12,4,8
Deutschland,whisperwind,288,druid,guardian,12,3,9
Read,boulderfist,288,druid,guardian,12,3,9
Jüggernäut,area-52,288,druid,guardian,12,3,9
Woozydruid,anetheron,288,druid,guardian,12,3,9
Manwool,illidan,288,druid,guardian,12,3,9
Cayinna,altar-of-storms,288,druid,guardian,12,3,9
Mavren,uldaman,286,druid,guardian,6,3,3
Classykitty,tichondrius,192,druid,guardian,4,3,1
Lilgushy,area-52,192,druid,guardian,6,2,4
Skrimshaw,burning-legion,192,druid,guardian,6,2,4
Spacex,amanthul,192,druid,guardian,6,2,4
Athious,moon-guard,192,druid,guardian,6,2,4
Mommyh,duskwood,192,druid,guardian,6,2,4
Avbox,proudmoore,192,druid,guardian,6,2,4
Battlecát,stormscale,192,druid,guardian,6,2,4
Fluff,gurubashi,192,druid,guardian,6,2,4
Widedually,aegwynn,191,druid,guardian,6,2,4
Eithelsa,frostmourne,191,druid,guardian,6,2,4
Meliódás,area-52,191,druid,guardian,18,2,16
Gornish,azralon,190,druid,guardian,12,2,10
Kushtiger,ragnaros,96,druid,guardian,6,1,5
Drur,zuljin,96,druid,guardian,6,1,5
Weezydende,area-52,96,druid,guardian,6,1,5
Malvolo,eredar,96,druid,guardian,6,1,5
Funkbear,black-dragonflight,96,druid,guardian,6,1,5
Vindecca,kelthuzad,96,druid,guardian,6,1,5
Moonshocka,tichondrius,96,druid,guardian,6,1,5
Gojen,stonemaul,96,druid,guardian,6,1,5
Aurno,queldorei,96,druid,guardian,6,1,5
Juicecarton,thrall,96,druid,guardian,6,1,5
Flenser,frostmane,96,druid,guardian,6,1,5
Sixfeetunder,shattered-halls,96,druid,guardian,6,1,5
Cawkaw,frostwolf,96,druid,guardian,6,1,5
Finntann,moon-guard,96,druid,guardian,6,1,5
Wintarz,sargeras,96,druid,guardian,6,1,5
Divax,proudmoore,96,druid,guardian,12,1,11
Woowis,stormrage,96,druid,guardian,12,1,11
Fulmerethine,emerald-dream,96,druid,guardian,12,1,11
Kylysea,dalaran,96,druid,guardian,12,1,11
Chathos,emerald-dream,96,druid,guardian,12,1,11
Vineclaw,emerald-dream,96,druid,guardian,12,1,11
Lakroz,zuljin,95,druid,guardian,6,1,5
Sitruk,uldum,63,druid,guardian,10,1,9
Ogdaugh,nagrand,48,druid,guardian,3,1,2
Bawbe,lightbringer,2286,druid,feral,107,61,46
Floppa,whisperwind,2243,druid,feral,102,56,46
Evildooer,stormrage,2203,druid,feral,84,46,38
Marvin,stormreaver,2201,druid,feral,94,49,45
Loser,stormrage,2155,druid,feral,87,46,41
Nyç,sargeras,2139,druid,feral,216,116,100
Auntsusie,stormrage,2128,druid,feral,95,61,34
Crunchyroll,sargeras,2126,druid,feral,168,91,77
Iinkinbio,alleria,2124,druid,feral,84,50,34
Bassy,whisperwind,2098,druid,feral,94,46,48
Angryalyu,tichondrius,2080,druid,feral,150,72,78
Formrage,jubeithos,2063,druid,feral,212,110,102
Boomboombom,tichondrius,2054,druid,feral,119,72,47
Jaguar,whisperwind,2050,druid,feral,69,40,29
Yüxy,sargeras,2048,druid,feral,174,85,89
Kynvi,moon-guard,2029,druid,feral,60,34,26
Henikbite,zuljin,2018,druid,feral,125,65,60
Amellies,quelthalas,2012,druid,feral,196,105,91
Duzis,tichondrius,2006,druid,feral,170,89,81
Boomboomboom,misha,1994,druid,feral,266,134,132
Floorz,bleeding-hollow,1978,druid,feral,93,45,48
Hypérion,dalaran,1977,druid,feral,83,41,42
Abstractf,sargeras,1973,druid,feral,86,50,36
Beomjun,tichondrius,1970,druid,feral,128,69,59
Babekisser,stormrage,1961,druid,feral,130,69,61
Vinjo,ragnaros,1955,druid,feral,90,42,48
Pdfilewatch,stormrage,1943,druid,feral,42,30,12
Trìckyz,tichondrius,1942,druid,feral,200,102,98
Feeg,sargeras,1937,druid,feral,65,33,32
Notapn,tichondrius,1926,druid,feral,96,54,42
Cliodhna,kelthuzad,1914,druid,feral,78,40,38
Chowxx,tichondrius,1910,druid,feral,96,45,51
Alleae,stormrage,1908,druid,feral,54,32,22
Cracked,vashj,1906,druid,feral,94,59,35
Skrambles,mugthol,1906,druid,feral,75,36,39
Samuel,ravencrest,1897,druid,feral,60,33,27
Nèffex,sargeras,1897,druid,feral,90,49,41
Floorz,firetree,1895,druid,feral,42,23,19
Ripbot,sargeras,1894,druid,feral,59,31,28
Duhfective,proudmoore,1887,druid,feral,65,33,32
Kittendev,tichondrius,1881,druid,feral,66,30,36
Porkonmyfork,frostmourne,1870,druid,feral,40,24,16
Astrozxy,sargeras,1860,druid,feral,42,23,19
Rwhatkr,tichondrius,1847,druid,feral,47,20,27
Sammy,scilla,1842,druid,feral,84,40,44
Lesliewj,proudmoore,1840,druid,feral,65,35,30
Tyxi,bleeding-hollow,1839,druid,feral,46,31,15
Hriiya,tichondrius,1838,druid,feral,101,46,55
Zuljor,sargeras,1836,druid,feral,54,34,20
Suedle,kelthuzad,1836,druid,feral,47,24,23
Vebee,frostmourne,1833,druid,feral,89,49,40
Darmari,quelthalas,1833,druid,feral,71,30,41
Yayue,tichondrius,1830,druid,feral,72,37,35
Kolbie,emerald-dream,1828,druid,feral,196,108,88
Bpdferal,stormrage,1828,druid,feral,180,99,81
Unfriendly,bleeding-hollow,1826,druid,feral,227,126,101
Russiaguy,area-52,1826,druid,feral,271,141,130
Icespicè,tichondrius,1825,druid,feral,96,46,50
Sappora,illidan,1824,druid,feral,178,92,86
Feignxd,emerald-dream,1823,druid,feral,60,43,17
Chrye,tichondrius,1820,druid,feral,69,35,34
Calikonger,spirestone,1819,druid,feral,48,23,25
Kakaroot,tichondrius,1813,druid,feral,153,78,75
Lemön,frostmourne,1812,druid,feral,66,34,32
Hugecat,tichondrius,1812,druid,feral,60,26,34
Stellar,steamwheedle-cartel,1811,druid,feral,138,66,72
Yukjr,stormrage,1810,druid,feral,149,71,78
Stêff,zuljin,1803,druid,feral,138,76,62
Fappywapple,kiljaeden,1803,druid,feral,144,68,76
Ryecoke,stormrage,1801,druid,feral,48,25,23
Tyx,bleeding-hollow,1793,druid,feral,74,33,41
Mocfernando,sargeras,1788,druid,feral,54,27,27
Killuf,quelthalas,1784,druid,feral,101,39,62
Meldzetzan,tichondrius,1782,druid,feral,31,20,11
Brewdock,boulderfist,1780,druid,feral,75,36,39
Ërebüs,emerald-dream,1774,druid,feral,59,24,35
Save,aerie-peak,1769,druid,feral,54,27,27
Tabbsy,frostmourne,1769,druid,feral,66,26,40
Fuqet,kelthuzad,1766,druid,feral,156,79,77
Proudfurryxo,dragonmaw,1765,druid,feral,50,27,23
Raincloud,mannoroth,1763,druid,feral,58,35,23
Yoruìchí,tichondrius,1759,druid,feral,36,23,13
Idiotferal,tortheldrin,1754,druid,feral,59,37,22
Porkloafed,illidan,1753,druid,feral,105,56,49
Djdontlose,stormrage,1752,druid,feral,78,45,33
Extic,sargeras,1752,druid,feral,78,45,33
Kobez,bleeding-hollow,1748,druid,feral,84,46,38
Mhdd,tichondrius,1739,druid,feral,66,38,28
Kakagroot,tichondrius,1739,druid,feral,36,20,16
Linkinbiox,alleria,1738,druid,feral,48,25,23
Tompunch,tichondrius,1726,druid,feral,91,46,45
Fangry,queldorei,1725,druid,feral,106,57,49
Ferar,frostmourne,1723,druid,feral,77,40,37
Akamu,nemesis,1715,druid,feral,60,24,36
Wildfire,nesingwary,1714,druid,feral,117,62,55
Fliip,barthilas,1711,druid,feral,53,27,26
Addymeow,drenden,1709,druid,feral,54,30,24
Thycamore,cenarius,1708,druid,feral,60,23,37
Oroskii,bleeding-hollow,1705,druid,feral,66,34,32
Brawleyx,tichondrius,1703,druid,feral,54,24,30
Nicó,darkspear,1701,druid,feral,129,62,67
Gabdruid,kiljaeden,1698,druid,feral,54,29,25
Cjæ,bleeding-hollow,1693,druid,feral,40,26,14
Turow,firetree,1690,druid,feral,53,25,28
Bobochan,tichondrius,1688,druid,feral,48,18,30
Loserceo,stormrage,1687,druid,feral,36,20,16
Flowkie,illidan,1684,druid,feral,140,70,70
Erykk,dalaran,1684,druid,feral,60,27,33
Nrp,stormrage,1684,druid,feral,108,44,64
Zwaski,thrall,1680,druid,feral,132,67,65
Nitetree,thrall,1679,druid,feral,60,31,29
Akanx,tichondrius,1677,druid,feral,36,21,15
Ivangamaz,area-52,1675,druid,feral,41,22,19
Blrr,sargeras,1674,druid,feral,120,56,64
Lycanthrøpe,moon-guard,1672,druid,feral,80,35,45
Bearlylegalz,kelthuzad,1671,druid,feral,48,23,25
Dewfuss,tichondrius,1669,druid,feral,54,31,23
Wowgamer,sargeras,1668,druid,feral,30,19,11
Tenavï,stormrage,1668,druid,feral,42,20,22
Yavà,tichondrius,1667,druid,feral,66,38,28
Redhotbean,tichondrius,1665,druid,feral,40,23,17
Yavann,tichondrius,1663,druid,feral,124,68,56
Anxietyburns,stormrage,1660,druid,feral,66,40,26
Feraly,malganis,1659,druid,feral,48,25,23
Plux,illidan,1658,druid,feral,162,88,74
Durwyn,sargeras,1654,druid,feral,207,100,107
Nobruh,sargeras,1653,druid,feral,120,60,60
Chasertv,tichondrius,1650,druid,feral,36,19,17
Zlegacy,anvilmar,1650,druid,feral,54,21,33
Rokaizu,dalaran,1649,druid,feral,65,30,35
Kyoski,moon-guard,1645,druid,feral,34,19,15
Kibbens,area-52,1643,druid,feral,196,98,98
Bhen,tichondrius,1643,druid,feral,42,19,23
Bigbite,tichondrius,1642,druid,feral,66,37,29
Nuadris,azralon,1638,druid,feral,173,87,86
Jihadibleeds,stormrage,1637,druid,feral,43,32,11
Xyphor,bladefist,1637,druid,feral,40,22,18
Atrumn,emerald-dream,1631,druid,feral,78,33,45
Ging,azralon,1630,druid,feral,30,17,13
Foxmeowz,blackwater-raiders,1627,druid,feral,36,20,16
Jazzxs,proudmoore,1627,druid,feral,36,18,18
Weedsmuggler,burning-legion,1626,druid,feral,284,149,135
Fendiy,barthilas,1625,druid,feral,84,49,35
Prille,tichondrius,1624,druid,feral,45,23,22
Off,ravencrest,1622,druid,feral,172,86,86
Phøënîx,tichondrius,1622,druid,feral,36,17,19
Csinii,bleeding-hollow,1621,druid,feral,54,22,32
Zyhsul,emerald-dream,1620,druid,feral,42,21,21
Lakunahof,ragnaros,1620,druid,feral,51,25,26
Bearoids,daggerspine,1619,druid,feral,60,35,25
Enya,stormreaver,1618,druid,feral,66,31,35
Hiddenfur,ragnaros,1617,druid,feral,36,19,17
Poosnickety,kelthuzad,1617,druid,feral,49,21,28
Ocêanus,sargeras,1616,druid,feral,25,21,4
Conker,frostmourne,1616,druid,feral,222,112,110
Jizzie,tichondrius,1615,druid,feral,108,64,44
Wøs,area-52,1615,druid,feral,98,50,48
Zirrie,stormrage,1614,druid,feral,68,36,32
Dustin,moon-guard,1614,druid,feral,116,61,55
Zenlonn,emerald-dream,1614,druid,feral,41,19,22
Clutchtime,sentinels,1610,druid,feral,46,21,25
Grizzlepaw,tichondrius,1608,druid,feral,168,90,78
Xanybarz,stormrage,1608,druid,feral,131,65,66
Ulcera,nemesis,1607,druid,feral,60,39,21
Kdrumania,tichondrius,1606,druid,feral,239,127,112
Chococrispis,quelthalas,1606,druid,feral,48,21,27
Fyrkax,sargeras,1603,druid,feral,30,19,11
Hapgood,archimonde,1602,druid,feral,42,17,25
Kittycudi,hyjal,1601,druid,feral,28,18,10
Prêdator,ragnaros,1601,druid,feral,161,88,73
Oldtomcat,moon-guard,1601,druid,feral,90,42,48
Feralgo,tichondrius,1600,druid,feral,36,17,19
Tysandra,sargeras,1600,druid,feral,42,17,25
Milkmoneymeo,illidan,1599,druid,feral,36,17,19
Irontree,dunemaul,1598,druid,feral,48,23,25
Jpegcollectr,tichondrius,1598,druid,feral,88,32,56
Dahmu,malygos,1590,druid,feral,197,103,94
Ursarius,skullcrusher,1590,druid,feral,53,25,28
Rank,nerzhul,1588,druid,feral,126,59,67
Amishal,stormrage,1588,druid,feral,78,33,45
Sïmba,andorhal,1588,druid,feral,77,31,46
Slanue,tichondrius,1585,druid,feral,76,33,43
Beastbaby,eldrethalas,1582,druid,feral,42,17,25
Shreds,kirin-tor,1581,druid,feral,55,19,36
Meanbear,stormrage,1577,druid,feral,54,27,27
Jaspurr,illidan,1574,druid,feral,60,33,27
Skyde,sargeras,1571,druid,feral,93,42,51
Nikola,dreadmaul,1566,druid,feral,63,30,33
Faelonk,frostmourne,1565,druid,feral,96,50,46
Luvgames,area-52,1559,druid,feral,100,49,51
Poppynoff,barthilas,1552,druid,feral,42,18,24
Darkosdruid,tichondrius,1551,druid,feral,30,18,12
Darkombra,frostmourne,1548,druid,feral,54,27,27
Goldferal,illidan,1545,druid,feral,48,31,17
Kaisuckslol,stormrage,1543,druid,feral,150,76,74
Houseboat,hellscream,1543,druid,feral,54,19,35
Franksuba,windrunner,1541,druid,feral,126,61,65
Rahxay,quelthalas,1539,druid,feral,71,32,39
Jonio,tichondrius,1539,druid,feral,71,30,41
Swindlestan,zuljin,1537,druid,feral,50,25,25
Swolareclips,eitrigg,1537,druid,feral,179,88,91
Surmise,tichondrius,1535,druid,feral,107,66,41
Mxdi,tichondrius,1535,druid,feral,36,19,17
Delorík,illidan,1534,druid,feral,66,32,34
Waggs,illidan,1532,druid,feral,36,16,20
Cawkaw,frostwolf,1528,druid,feral,122,62,60
Welshblack,tichondrius,1528,druid,feral,40,18,22
Galind,rexxar,1524,druid,feral,40,26,14
Barnedruid,stormreaver,1521,druid,feral,30,17,13
Senex,stormrage,1518,druid,feral,100,60,40
Dobromar,quelthalas,1517,druid,feral,64,34,30
Malfurionsto,moon-guard,1517,druid,feral,73,31,42
Theømega,stormrage,1516,druid,feral,32,18,14
Sugarbawls,area-52,1514,druid,feral,108,52,56
Cätwälk,gnomeregan,1511,druid,feral,36,16,20
Melez,kelthuzad,1509,druid,feral,205,104,101
Hellodan,proudmoore,1509,druid,feral,72,32,40
Kushtiger,ragnaros,1508,druid,feral,102,52,50
Sheeyts,tichondrius,1507,druid,feral,96,51,45
Gregondor,skullcrusher,1506,druid,feral,48,24,24
Koducck,tichondrius,1502,druid,feral,60,32,28
Wuby,tichondrius,1500,druid,feral,66,34,32
Tree,lothar,1497,druid,feral,48,29,19
Zazieraiel,moon-guard,1492,druid,feral,117,58,59
Sloom,zuljin,1488,druid,feral,59,29,30
Lunacore,illidan,1488,druid,feral,65,30,35
Ozex,crushridge,1487,druid,feral,76,33,43
Dimsump,zuljin,1483,druid,feral,48,16,32
Luluid,tichondrius,1481,druid,feral,65,30,35
Azrethyu,emerald-dream,1481,druid,feral,98,41,57
Nomnomnomn,chogall,1480,druid,feral,28,18,10
Csagan,spirestone,1478,druid,feral,60,31,29
Revcow,malganis,1477,druid,feral,48,24,24
Lucky,destromath,1474,druid,feral,198,90,108
Duckystryker,tichondrius,1470,druid,feral,54,21,33
Amanardra,wyrmrest-accord,1468,druid,feral,36,21,15
Shiftalk,nerzhul,1468,druid,feral,61,29,32
Dillywadz,tichondrius,1463,druid,feral,158,72,86
Zivak,azshara,1460,druid,feral,66,32,34
Hoffhoff,area-52,1458,druid,feral,36,22,14
Jurasico,ragnaros,1458,druid,feral,294,147,147
Pretzle,kelthuzad,1458,druid,feral,47,16,31
Yobibit,terenas,1456,druid,feral,42,17,25
Badferal,blackhand,1455,druid,feral,78,38,40
Erwelz,quelthalas,1455,druid,feral,41,19,22
Kwilli,tichondrius,1454,druid,feral,91,43,48
Bullcritzz,saurfang,1453,druid,feral,118,66,52
Hööper,illidan,1450,druid,feral,84,35,49
Prowli,tichondrius,1449,druid,feral,158,82,76
Bossdru,sargeras,1447,druid,feral,47,28,19
Roots,anubarak,1445,druid,feral,98,53,45
Kongquest,emerald-dream,1445,druid,feral,71,28,43
Chomperz,tichondrius,1442,druid,feral,85,45,40
Chambz,tichondrius,1441,druid,feral,127,68,59
Fastcat,moon-guard,1441,druid,feral,60,31,29
Freinnar,kiljaeden,1441,druid,feral,66,30,36
Jayp,thrall,1436,druid,feral,67,28,39
Soaring,moon-guard,1434,druid,feral,30,15,15
Mysubrogue,veknilash,1432,druid,feral,24,15,9
Käïïjü,tichondrius,1432,druid,feral,76,28,48
Aldr,tichondrius,1431,druid,feral,60,27,33
Feond,illidan,1430,druid,feral,94,49,45
Féralis,sargeras,1429,druid,feral,24,15,9
Bukybuky,tichondrius,1429,druid,feral,48,26,22
Azuredreams,bleeding-hollow,1429,druid,feral,56,28,28
Moonraker,caelestrasz,1427,druid,feral,83,44,39
Chitára,ragnaros,1427,druid,feral,166,86,80
Gnairda,sargeras,1426,druid,feral,198,104,94
Makonis,tichondrius,1424,druid,feral,36,20,16
Kaissara,nemesis,1420,druid,feral,32,17,15
Bobmarli,kiljaeden,1420,druid,feral,30,15,15
Oobuck,kilrogg,1415,druid,feral,54,29,25
Treespec,stormrage,1414,druid,feral,29,18,11
Ikkarus,nemesis,1414,druid,feral,121,60,61
Traxxo,tichondrius,1414,druid,feral,48,20,28
Gairen,the-venture-co,1413,druid,feral,48,25,23
Neetform,zuljin,1413,druid,feral,65,30,35
Silvshifter,frostmourne,1410,druid,feral,47,32,15
Muwudred,stormrage,1410,druid,feral,36,15,21
Clarice,shattered-halls,1409,druid,feral,24,15,9
Eletto,stormrage,1409,druid,feral,54,26,28
Oreganic,barthilas,1408,druid,feral,99,49,50
Vakimumu,anubarak,1407,druid,feral,68,33,35
Fugekî,zuljin,1405,druid,feral,71,39,32
Classydruid,spinebreaker,1404,druid,feral,102,47,55
Shïfty,tichondrius,1403,druid,feral,30,16,14
Shiftex,arthas,1403,druid,feral,138,68,70
Bênî,emerald-dream,1402,druid,feral,128,61,67
Frostelles,stormrage,1401,druid,feral,182,91,91
Flowke,illidan,1401,druid,feral,32,16,16
Boofings,sargeras,1400,druid,feral,34,19,15
Ðárk,ragnaros,1399,druid,feral,29,15,14
Aquahektik,malganis,1398,druid,feral,48,15,33
Gonjatusk,ravencrest,1397,druid,feral,54,30,24
Sweetxtooth,area-52,1397,druid,feral,92,48,44
Vaniedron,zuljin,1397,druid,feral,123,50,73
Clawin,frostmourne,1395,druid,feral,24,15,9
Duuj,illidan,1394,druid,feral,18,15,3
Hoppus,icecrown,1393,druid,feral,87,35,52
Wabbehkus,barthilas,1392,druid,feral,54,17,37
Chin,ysera,1391,druid,feral,23,15,8
Ytgamezoned,darkspear,1390,druid,feral,30,16,14
Oneinchclaw,malganis,1389,druid,feral,84,41,43
Lunarboy,tichondrius,1388,druid,feral,43,17,26
Treeweed,tichondrius,1386,druid,feral,81,42,39
Psychofeör,quelthalas,1386,druid,feral,100,49,51
Hjerim,quelthalas,1386,druid,feral,50,24,26
Snowfaerie,moon-guard,1380,druid,feral,374,195,179
Darkasto,nemesis,1380,druid,feral,44,18,26
Hroney,area-52,1379,druid,feral,54,22,32
Raynark,azralon,1377,druid,feral,36,16,20
Craak,tichondrius,1376,druid,feral,41,19,22
Tommyjimmy,andorhal,1375,druid,feral,48,24,24
Herbx,sargeras,1366,druid,feral,60,30,30
Canlexd,moon-guard,1364,druid,feral,103,48,55
Boll,akama,1361,druid,feral,34,15,19
Niwßor,azralon,1359,druid,feral,54,26,28
Kilohanno,alexstrasza,1356,druid,feral,42,19,23
Iamnature,dalaran,1355,druid,feral,67,30,37
Percefhone,azralon,1353,druid,feral,116,55,61
Fugg,frostmourne,1350,druid,feral,84,34,50
Darkdragoonz,barthilas,1344,druid,feral,43,20,23
Cntomy,tichondrius,1343,druid,feral,24,14,10
Azoth,hyjal,1342,druid,feral,24,14,10
Catzetzan,tichondrius,1342,druid,feral,30,14,16
Druidydruid,blackrock,1342,druid,feral,52,24,28
Threeo,burning-blade,1341,druid,feral,28,18,10
Malu,muradin,1341,druid,feral,58,33,25
Hadox,azralon,1339,druid,feral,148,73,75
Smeow,zuljin,1339,druid,feral,39,16,23
Samirgodx,tichondrius,1337,druid,feral,36,16,20
Riemannzeta,azgalor,1336,druid,feral,54,29,25
Swornenemy,mugthol,1336,druid,feral,87,45,42
Ribushe,stormrage,1336,druid,feral,60,27,33
Datkittydoe,kiljaeden,1334,druid,feral,55,26,29
Khyzan,illidan,1329,druid,feral,78,41,37
Naturestouch,tichondrius,1327,druid,feral,30,14,16
Freddiemerk,moon-guard,1326,druid,feral,36,21,15
Blut,stormrage,1326,druid,feral,300,142,158
Sharknado,haomarush,1326,druid,feral,30,14,16
Kotau,azralon,1325,druid,feral,78,51,27
Zuga,the-venture-co,1324,druid,feral,54,28,26
Senorcholo,malganis,1323,druid,feral,42,20,22
Pibily,sargeras,1323,druid,feral,48,15,33
Bullboy,frostmourne,1320,druid,feral,30,17,13
Bleedz,mugthol,1319,druid,feral,36,18,18
Tardcakes,tichondrius,1318,druid,feral,92,44,48
Kyrô,sargeras,1317,druid,feral,29,14,15
Bigthirty,area-52,1315,druid,feral,36,20,16
Toysruskyd,sargeras,1315,druid,feral,36,14,22
Isalien,stormrage,1313,druid,feral,62,33,29
Ninefeet,argent-dawn,1311,druid,feral,72,37,35
Soupyhooves,dalaran,1311,druid,feral,30,14,16
Fb,darkspear,1309,druid,feral,50,28,22
Jasminonmars,zuluhed,1305,druid,feral,65,36,29
Asteriel,stormrage,1305,druid,feral,52,25,27
Malthen,quelthalas,1304,druid,feral,78,38,40
Buhooki,tichondrius,1303,druid,feral,182,98,84
Hoofin,blackwing-lair,1303,druid,feral,96,39,57
Nyanncat,frostmourne,1302,druid,feral,30,14,16
Nojiling,quelthalas,1301,druid,feral,55,24,31
Bloodriot,wyrmrest-accord,1299,druid,feral,79,36,43
Amdruid,bloodhoof,1297,druid,feral,26,15,11
Raebies,dalaran,1297,druid,feral,99,53,46
Sahksi,lothar,1297,druid,feral,60,30,30
Mbarakaja,malganis,1297,druid,feral,149,70,79
Anessan,silvermoon,1296,druid,feral,44,23,21
Ðreadfang,tichondrius,1295,druid,feral,47,28,19
Gapingloli,tichondrius,1295,druid,feral,51,25,26
Riseagainst,ragnaros,1294,druid,feral,52,30,22
Queiq,malganis,1292,druid,feral,30,15,15
Panyot,kiljaeden,1291,druid,feral,66,33,33
Awarz,drakkari,1291,druid,feral,36,14,22
Servax,illidan,1290,druid,feral,30,14,16
Zelyvia,moon-guard,1283,druid,feral,48,23,25
Vintera,sargeras,1281,druid,feral,123,67,56
Erahar,illidan,1281,druid,feral,46,24,22
Dkkng,dalaran,1280,druid,feral,40,23,17
Barbary,tichondrius,1279,druid,feral,36,16,20
Cheshiire,moon-guard,1277,druid,feral,167,78,89
Flufball,whisperwind,1274,druid,feral,42,17,25
Súse,sargeras,1269,druid,feral,71,35,36
Gotroadrash,azuremyst,1268,druid,feral,23,14,9
Mariko,area-52,1268,druid,feral,71,33,38
Mooseknuccle,tichondrius,1262,druid,feral,43,21,22
Glockitty,tichondrius,1262,druid,feral,90,42,48
Dätto,thrall,1261,druid,feral,54,25,29
Feanah,tichondrius,1259,druid,feral,66,29,37
Rekrasaur,emerald-dream,1259,druid,feral,40,14,26
Freeonlyfns,stormrage,1255,druid,feral,38,16,22
Tenedoors,ragnaros,1249,druid,feral,115,45,70
Sporadiclive,sargeras,1247,druid,feral,30,13,17
Aahx,thrall,1245,druid,feral,129,69,60
Gorim,area-52,1245,druid,feral,72,34,38
Enchiladacat,stormrage,1243,druid,feral,24,13,11
Shmayba,malganis,1241,druid,feral,24,13,11
Kellydacat,azuremyst,1241,druid,feral,24,13,11
Pfheral,area-52,1240,druid,feral,30,13,17
Hektuk,barthilas,1235,druid,feral,34,19,15
Behrhart,stormrage,1234,druid,feral,24,16,8
Ourse,aegwynn,1234,druid,feral,89,52,37
Koochii,tichondrius,1234,druid,feral,27,14,13
Nightshift,dalvengyr,1233,druid,feral,24,13,11
Whitetigeris,tichondrius,1233,druid,feral,24,13,11
Pixyls,bleeding-hollow,1233,druid,feral,29,15,14
Beargodx,stormrage,1232,druid,feral,78,41,37
Kleanxx,tichondrius,1232,druid,feral,223,111,112
Hobbles,emerald-dream,1232,druid,feral,42,18,24
Wildwhisper,moon-guard,1232,druid,feral,36,13,23
Midnightmeat,tichondrius,1230,druid,feral,50,23,27
Duckieheit,sargeras,1229,druid,feral,34,15,19
Matpd,norgannon,1228,druid,feral,66,28,38
Haneulso,tichondrius,1228,druid,feral,45,17,28
Orthognathic,emerald-dream,1227,druid,feral,57,35,22
Bâgheera,sargeras,1225,druid,feral,61,25,36
Xanbàr,hyjal,1222,druid,feral,35,22,13
Twistach,quelthalas,1222,druid,feral,24,13,11
Beygatti,sargeras,1222,druid,feral,61,25,36
Zolíath,tichondrius,1221,druid,feral,36,13,23
Swappy,korgath,1220,druid,feral,69,31,38
Zelazia,area-52,1219,druid,feral,30,16,14
Udderchaos,dark-iron,1218,druid,feral,30,13,17
Berd,whisperwind,1215,druid,feral,40,20,20
Muidruid,thrall,1215,druid,feral,30,13,17
Midnitex,illidan,1214,druid,feral,37,16,21
Styli,tichondrius,1212,druid,feral,100,50,50
Pusswhisperr,bleeding-hollow,1210,druid,feral,42,15,27
Hermbott,proudmoore,1206,druid,feral,54,26,28
Dorio,quelthalas,1197,druid,feral,30,14,16
Spinach,moon-guard,1195,druid,feral,33,13,20
Saelyle,illidan,1194,druid,feral,70,29,41
Hctibrehtom,illidan,1193,druid,feral,24,20,4
Ðrengr,quelthalas,1193,druid,feral,36,20,16
Destrez,ragnaros,1188,druid,feral,27,13,14
Hupod,proudmoore,1181,druid,feral,64,32,32
Sansao,sargeras,1179,druid,feral,42,21,21
Ursuur,drakkari,1178,druid,feral,86,38,48
Bigmolii,quelthalas,1178,druid,feral,104,39,65
Empathz,emerald-dream,1173,druid,feral,35,13,22
Khione,dreadmaul,1172,druid,feral,68,38,30
Zurker,mannoroth,1170,druid,feral,57,25,32
Dehltax,stormrage,1169,druid,feral,54,29,25
Xdkittyrawr,tichondrius,1168,druid,feral,94,46,48
Zderhs,blackrock,1163,druid,feral,26,13,13
Stríðsmaður,area-52,1159,druid,feral,60,25,35
Scruffywolf,tichondrius,1157,druid,feral,155,67,88
Borybuilder,azralon,1153,druid,feral,52,22,30
Ishiftalot,bleeding-hollow,1153,druid,feral,63,26,37
Europecat,stormrage,1152,druid,feral,24,12,12
Sooey,wyrmrest-accord,1151,druid,feral,24,12,12
Flayx,frostmourne,1151,druid,feral,30,12,18
Kiwidru,frostmourne,1150,druid,feral,24,12,12
Manbeartree,malganis,1150,druid,feral,36,12,24
Getahfix,frostmourne,1149,druid,feral,24,12,12
Susruth,area-52,1149,druid,feral,30,12,18
Leight,whisperwind,1148,druid,feral,36,21,15
Yukcyducky,tichondrius,1148,druid,feral,114,48,66
Miviaris,alleria,1147,druid,feral,24,12,12
Concordya,tichondrius,1146,druid,feral,30,13,17
Doblun,nemesis,1146,druid,feral,36,12,24
Werebruin,bleeding-hollow,1145,druid,feral,79,40,39
Kittyboiz,illidan,1143,druid,feral,35,14,21
Anastasyiar,illidan,1142,druid,feral,30,12,18
Ÿùp,tichondrius,1141,druid,feral,18,12,6
Kaya,hyjal,1141,druid,feral,66,22,44
Bearjoo,kelthuzad,1140,druid,feral,30,13,17
Khaoticklaw,stormrage,1137,druid,feral,33,14,19
Daniin,azralon,1136,druid,feral,72,33,39
Aligantor,thrall,1134,druid,feral,18,12,6
Deadlykept,ragnaros,1134,druid,feral,36,18,18
Wwf,thrall,1130,druid,feral,83,31,52
Chëësëbürgër,illidan,1128,druid,feral,97,45,52
Cooln,bleeding-hollow,1123,druid,feral,24,15,9
Elunaya,illidan,1122,druid,feral,36,15,21
Tonoshapepai,azralon,1122,druid,feral,36,13,23
Nahtex,tichondrius,1121,druid,feral,30,12,18
Shahahrazad,queldorei,1118,druid,feral,36,12,24
Strikinina,azralon,1117,druid,feral,73,33,40
Eyzie,stormrage,1115,druid,feral,36,13,23
Vineclaw,emerald-dream,1114,druid,feral,36,14,22
Nätural,bloodhoof,1113,druid,feral,23,12,11
Ðementia,stormrage,1109,druid,feral,126,68,58
Daisyôreo,tichondrius,1104,druid,feral,58,30,28
Yobolsun,sargeras,1103,druid,feral,48,21,27
Azakana,sargeras,1094,druid,feral,23,12,11
Tastelikecat,kelthuzad,1093,druid,feral,45,17,28
Druski,lightbringer,1089,druid,feral,23,14,9
Kragma,zuluhed,1085,druid,feral,24,13,11
Bernoboy,kelthuzad,1079,druid,feral,30,16,14
Doubledówn,sargeras,1079,druid,feral,192,97,95
Critthisbruh,stormrage,1078,druid,feral,27,15,12
Kyrona,frostmourne,1078,druid,feral,42,22,20
Skrillin,thrall,1076,druid,feral,35,19,16
Trevvor,thrall,1070,druid,feral,36,12,24
Anarad,dalaran,1068,druid,feral,42,22,20
Pokémon,grizzly-hills,1064,druid,feral,33,15,18
Bifë,ragnaros,1063,druid,feral,36,12,24
Seraphim,lightnings-blade,1061,druid,feral,78,40,38
Mordrynn,veknilash,1059,druid,feral,62,32,30
Damnimal,caelestrasz,1058,druid,feral,22,13,9
Drdanknugs,laughing-skull,1057,druid,feral,54,16,38
Ohaa,sargeras,1056,druid,feral,12,11,1
Glenn,norgannon,1056,druid,feral,18,11,7
Birdy,proudmoore,1056,druid,feral,18,11,7
Switchform,kiljaeden,1056,druid,feral,18,11,7
Hatergodx,ravencrest,1056,druid,feral,24,11,13
Lelobull,ragnaros,1056,druid,feral,48,19,29
Dangersweg,frostmourne,1056,druid,feral,30,11,19
Dawsonxo,proudmoore,1055,druid,feral,24,11,13
Zoeishyper,sargeras,1055,druid,feral,24,11,13
Orekinya,area-52,1055,druid,feral,24,11,13
Kellydabear,azuremyst,1054,druid,feral,24,11,13
Bearlyviable,stormrage,1054,druid,feral,33,12,21
Myeow,illidan,1052,druid,feral,24,11,13
Teddybear,medivh,1052,druid,feral,101,44,57
Corv,drenden,1051,druid,feral,16,12,4
Bloodynine,cairne,1050,druid,feral,24,11,13
Looquitaa,ragnaros,1049,druid,feral,78,32,46
Nyla,nemesis,1048,druid,feral,12,11,1
Téddybéar,smolderthorn,1048,druid,feral,33,22,11
Vykarux,suramar,1048,druid,feral,24,11,13
Chernobiel,stormrage,1048,druid,feral,24,11,13
Yám,tichondrius,1048,druid,feral,30,11,19
Drbraino,sargeras,1046,druid,feral,24,11,13
Fieryferal,kargath,1046,druid,feral,42,12,30
Bananawaffle,proudmoore,1042,druid,feral,30,11,19
Dròódles,barthilas,1035,druid,feral,18,11,7
Jabiso,smolderthorn,1034,druid,feral,79,41,38
Oxvxo,senjin,1033,druid,feral,42,25,17
Dalinaìr,moon-guard,1033,druid,feral,24,13,11
Wildbeasts,proudmoore,1030,druid,feral,182,91,91
Meowzedon,sargeras,1029,druid,feral,24,11,13
Kayday,bloodscalp,1027,druid,feral,18,11,7
Greasemonkey,trollbane,1024,druid,feral,28,18,10
Gece,dalaran,1022,druid,feral,35,15,20
Screwdrivers,moon-guard,1022,druid,feral,29,11,18
Reallysauce,zuljin,1019,druid,feral,30,16,14
Liktak,perenolde,1018,druid,feral,30,11,19
Fennel,korgath,1017,druid,feral,23,11,12
Mojofoshobro,moonrunner,1017,druid,feral,72,29,43
Framko,quelthalas,1011,druid,feral,78,24,54
Lyndonww,frostmourne,1006,druid,feral,26,12,14
Sisilo,bonechewer,1005,druid,feral,115,52,63
Afrogx,dalaran,1001,druid,feral,24,11,13
Superwrath,khaz-modan,1000,druid,feral,23,11,12
Skufty,illidan,997,druid,feral,120,46,74
Ruzkit,illidan,996,druid,feral,30,14,16
Tt,akama,989,druid,feral,26,11,15
Aeonás,tichondrius,988,druid,feral,25,13,12
Catahmine,thrall,988,druid,feral,26,11,15
Ediiann,cenarius,986,druid,feral,24,11,13
Druidsling,mugthol,981,druid,feral,62,23,39
Brurion,dalaran,973,druid,feral,30,13,17
Dârkfang,moon-guard,972,druid,feral,24,13,11
Twigz,illidan,971,druid,feral,148,72,76
Tolldruid,chogall,967,druid,feral,30,15,15
Pawprika,tichondrius,961,druid,feral,72,32,40
Semveta,alleria,960,druid,feral,12,10,2
Sweetpurple,elune,960,druid,feral,18,10,8
Yukjr,tichondrius,960,druid,feral,24,10,14
Buffjungle,tichondrius,960,druid,feral,26,10,16
Juiceonlips,sargeras,959,druid,feral,18,10,8
Kekepöp,illidan,959,druid,feral,24,10,14
Yaboidakota,stormrage,959,druid,feral,24,10,14
Lïberty,ragnaros,958,druid,feral,12,10,2
Moonshady,zuljin,958,druid,feral,19,10,9
Nearkoo,tichondrius,958,druid,feral,24,10,14
Noet,ragnaros,957,druid,feral,18,10,8
Pavel,aerie-peak,957,druid,feral,59,18,41
Predatõr,malorne,956,druid,feral,35,17,18
Hashmall,ragnaros,956,druid,feral,30,10,20
Shiftingdean,sargeras,956,druid,feral,30,10,20
Hoargar,senjin,955,druid,feral,18,12,6
Munchausens,dalaran,955,druid,feral,24,10,14
Høruss,azralon,955,druid,feral,27,11,16
Pàntera,tichondrius,955,druid,feral,36,10,26
Moonbow,frostmourne,954,druid,feral,18,10,8
Yseraspawn,kelthuzad,954,druid,feral,30,10,20
Stalfrus,area-52,952,druid,feral,12,10,2
Thegrefgx,ragnaros,949,druid,feral,18,10,8
Xform,jubeithos,946,druid,feral,18,10,8
Bullshiftin,area-52,945,druid,feral,18,10,8
Nokther,muradin,941,druid,feral,48,13,35
Feraluwu,illidan,938,druid,feral,18,10,8
Lusk,blades-edge,937,druid,feral,70,32,38
Dinnerbone,echo-isles,926,druid,feral,24,10,14
Arntu,malganis,924,druid,feral,17,10,7
Soldadito,zuljin,924,druid,feral,27,12,15
Ekkoh,sargeras,921,druid,feral,29,10,19
Eglania,stormrage,920,druid,feral,42,22,20
Lacrarola,nemesis,916,druid,feral,17,10,7
Odesellena,moon-guard,913,druid,feral,48,23,25
Àspên,moon-guard,908,druid,feral,42,20,22
Blêêd,stormscale,904,druid,feral,13,12,1
Muggsy,scilla,893,druid,feral,14,10,4
Sjana,bleeding-hollow,893,druid,feral,36,17,19
Chiknsketti,bleeding-hollow,892,druid,feral,26,10,16
Koag,dalaran,891,druid,feral,29,13,16
Fanaror,frostmourne,887,druid,feral,56,28,28
Vácagada,ragnaros,885,druid,feral,30,10,20
Taurenaught,aegwynn,881,druid,feral,37,17,20
Syänn,thrall,879,druid,feral,24,10,14
Bigherbo,zuljin,872,druid,feral,26,11,15
Retzerbil,sargeras,864,druid,feral,12,9,3
Funkattack,tichondrius,864,druid,feral,18,9,9
Fuujinn,korgath,864,druid,feral,18,9,9
Jaegerbombx,sargeras,864,druid,feral,18,9,9
Unfunnyferal,kelthuzad,864,druid,feral,18,9,9
Faithxo,stormrage,864,druid,feral,24,9,15
Feorb,azuremyst,864,druid,feral,24,9,15
Parallax,shadowsong,863,druid,feral,18,9,9
Gz,icecrown,863,druid,feral,18,9,9
Féèd,stormrage,863,druid,feral,18,9,9
Thaherb,korgath,863,druid,feral,24,9,15
Purplecat,frostmourne,862,druid,feral,12,9,3
Lunchßox,emerald-dream,862,druid,feral,12,9,3
Morphes,suramar,862,druid,feral,18,9,9
Orizane,moon-guard,862,druid,feral,24,9,15
Mogleyz,stormreaver,862,druid,feral,26,9,17
Catten,barthilas,860,druid,feral,12,9,3
Cadburycop,malganis,860,druid,feral,33,10,23
Manlymanman,shandris,859,druid,feral,24,9,15
Shiftyounot,shattered-hand,859,druid,feral,30,9,21
Ruhgen,deathwing,858,druid,feral,26,10,16
Furryboyxd,saurfang,858,druid,feral,24,9,15
Jonoa,nagrand,858,druid,feral,24,9,15
Wuarlo,moon-guard,857,druid,feral,91,43,48
Rum,the-venture-co,857,druid,feral,36,14,22
Hótlife,fizzcrank,856,druid,feral,18,9,9
Maimsy,blackhand,855,druid,feral,18,9,9
Snugglin,kelthuzad,855,druid,feral,18,9,9
Wokoom,windrunner,855,druid,feral,54,20,34
Bigravioli,ragnaros,854,druid,feral,24,9,15
Mavren,uldaman,853,druid,feral,30,10,20
Capson,darkspear,851,druid,feral,36,12,24
Zauska,cenarion-circle,851,druid,feral,30,9,21
Drulicious,tichondrius,849,druid,feral,27,13,14
Sosd,kelthuzad,837,druid,feral,17,9,8
Mooncatbear,malganis,831,druid,feral,22,9,13
Fogboom,area-52,830,druid,feral,20,10,10
Dreamfyre,kiljaeden,828,druid,feral,29,9,20
Shartasm,anetheron,822,druid,feral,30,12,18
Tatiannaa,stormreaver,815,druid,feral,15,10,5
Feorelm,proudmoore,810,druid,feral,17,9,8
Weezydende,area-52,806,druid,feral,53,16,37
Nephdruid,stormrage,804,druid,feral,30,9,21
Ðjangø,goldrinn,801,druid,feral,17,9,8
Kuzigothigh,thunderhorn,795,druid,feral,53,27,26
Sweetnippies,elune,768,druid,feral,12,8,4
Batterydruid,silvermoon,768,druid,feral,12,8,4
Kattles,frostmourne,768,druid,feral,12,8,4
Griefs,emerald-dream,768,druid,feral,12,8,4
Tostaø,ragnaros,768,druid,feral,12,8,4
Jason,vashj,768,druid,feral,12,8,4
Anìmorph,sargeras,768,druid,feral,12,8,4
Thaddeusx,illidan,768,druid,feral,16,9,7
Bitenscratch,tichondrius,768,druid,feral,18,8,10
Owd,tichondrius,768,druid,feral,18,8,10
Whittlekitty,anetheron,768,druid,feral,18,8,10
Férállgødx,area-52,768,druid,feral,18,8,10
Salemgomeow,sargeras,768,druid,feral,18,8,10
Gouzz,frostmourne,768,druid,feral,24,8,16
Sylvaster,stormrage,768,druid,feral,24,8,16
Saltydru,illidan,768,druid,feral,24,8,16
Germainee,shandris,768,druid,feral,24,8,16
Pokeyouryolk,sargeras,767,druid,feral,12,8,4
Jentzull,tichondrius,767,druid,feral,12,8,4
Güar,area-52,767,druid,feral,12,8,4
Ostley,moon-guard,767,druid,feral,12,8,4
Nahelae,tichondrius,767,druid,feral,12,8,4
Kìttykat,stormrage,767,druid,feral,18,8,10
Mythienair,stormrage,767,druid,feral,18,8,10
Pergutory,frostmourne,767,druid,feral,18,8,10
Lazypaw,malganis,767,druid,feral,18,8,10
Zascat,malganis,767,druid,feral,18,8,10
Fullmoon,greymane,767,druid,feral,22,9,13
Kals,burning-blade,767,druid,feral,24,8,16
Bufusala,illidan,766,druid,feral,12,8,4
Jpnerazim,quelthalas,766,druid,feral,16,8,8
Angulus,darkspear,766,druid,feral,18,8,10
Grumalzi,moon-guard,766,druid,feral,24,8,16
Scratchh,darkspear,766,druid,feral,24,8,16
Notoriouzßig,sargeras,765,druid,feral,18,8,10
Deaddpool,ragnaros,764,druid,feral,12,8,4
Zimah,illidan,764,druid,feral,18,8,10
Davinchii,drakkari,764,druid,feral,18,8,10
Raknary,kelthuzad,764,druid,feral,30,8,22
Goorybud,tichondrius,762,druid,feral,12,8,4
Bebechat,area-52,762,druid,feral,12,8,4
Isleyy,tichondrius,760,druid,feral,18,8,10
Gamble,the-underbog,760,druid,feral,24,8,16
Darkemberrs,stormrage,757,druid,feral,36,8,28
Garuharken,skullcrusher,754,druid,feral,30,8,22
Flenser,frostmane,751,druid,feral,12,8,4
Mychi,ragnaros,748,druid,feral,20,9,11
Disdeus,bleeding-hollow,742,druid,feral,31,8,23
Nodraent,quelthalas,741,druid,feral,18,8,10
Snowlion,the-forgotten-coast,726,druid,feral,30,8,22
Ashmila,ragnaros,716,druid,feral,17,8,9
Notinsanity,proudmoore,714,druid,feral,20,9,11
Mazoak,sargeras,703,druid,feral,28,8,20
Byson,bleeding-hollow,702,druid,feral,17,8,9
Psynix,zuljin,688,druid,feral,19,8,11
Earlgrayl,kelthuzad,686,druid,feral,19,8,11
Shakedru,stormrage,684,druid,feral,19,8,11
Taiga,moon-guard,672,druid,feral,12,7,5
Primalxd,area-52,672,druid,feral,12,7,5
Dangerclaws,area-52,672,druid,feral,12,7,5
Zðzð,zuljin,672,druid,feral,12,7,5
Elyveen,proudmoore,672,druid,feral,12,7,5
Hypê,tichondrius,672,druid,feral,12,7,5
Isô,sargeras,672,druid,feral,12,7,5
Venomsecho,vashj,672,druid,feral,12,7,5
Austínd,sargeras,672,druid,feral,12,7,5
Scuffedx,tichondrius,672,druid,feral,12,7,5
Catculator,tichondrius,672,druid,feral,12,7,5
Krobz,bleeding-hollow,672,druid,feral,12,7,5
Shalaz,magtheridon,672,druid,feral,12,7,5
Kistormx,tichondrius,672,druid,feral,12,7,5
Dailydruid,illidan,672,druid,feral,12,7,5
Tnvï,stormrage,672,druid,feral,12,7,5
Druidman,mugthol,672,druid,feral,18,7,11
Anaru,sisters-of-elune,672,druid,feral,18,7,11
Psyraxus,moon-guard,672,druid,feral,18,7,11
Islayne,moon-guard,672,druid,feral,18,7,11
Selendis,tichondrius,672,druid,feral,18,7,11
Meowny,area-52,672,druid,feral,18,7,11
Muffbfloppn,zuljin,672,druid,feral,18,7,11
Ronin,arthas,672,druid,feral,18,7,11
Shiftage,frostmane,672,druid,feral,21,7,14
Drywatter,tichondrius,671,druid,feral,12,7,5
Meõw,tichondrius,671,druid,feral,12,7,5
Ardelix,emerald-dream,671,druid,feral,12,7,5
Happyhotter,proudmoore,671,druid,feral,12,7,5
Carboz,jubeithos,671,druid,feral,12,7,5
Pawsom,bleeding-hollow,671,druid,feral,12,7,5
Zalmo,area-52,671,druid,feral,15,8,7
Fürïous,tichondrius,671,druid,feral,15,8,7
Aladelryth,malfurion,671,druid,feral,18,7,11
Bearmuda,trollbane,671,druid,feral,18,7,11
Ruckiz,stormrage,671,druid,feral,18,7,11
Momoxchan,quelthalas,671,druid,feral,18,7,11
Zallo,korgath,671,druid,feral,18,7,11
Ännä,moon-guard,671,druid,feral,18,7,11
Corym,frostmourne,671,druid,feral,18,7,11
Wingus,smolderthorn,670,druid,feral,12,7,5
Chaace,proudmoore,670,druid,feral,12,7,5
Bocát,stormrage,669,druid,feral,12,7,5
Curainfeliz,nemesis,669,druid,feral,12,7,5
Redness,daggerspine,669,druid,feral,18,7,11
Nanassa,spinebreaker,669,druid,feral,18,7,11
Irontauren,drakkari,669,druid,feral,24,7,17
Berall,bleeding-hollow,668,druid,feral,12,7,5
Yokimo,amanthul,668,druid,feral,18,7,11
Zeldriss,arthas,668,druid,feral,19,7,12
Igneël,ragnaros,668,druid,feral,24,7,17
Jordiët,dalaran,667,druid,feral,12,7,5
Healorhell,azralon,660,druid,feral,40,7,33
Hyperlite,bonechewer,643,druid,feral,18,7,11
Injail,tichondrius,640,druid,feral,16,7,9
Chadwickx,illidan,639,druid,feral,11,7,4
Oldclive,frostmourne,637,druid,feral,17,7,10
Jeanz,bonechewer,632,druid,feral,19,9,10
Slapymilf,dentarg,623,druid,feral,11,7,4
Meowzetzan,tichondrius,623,druid,feral,11,7,4
Puzzykat,uldum,621,druid,feral,27,7,20
Gutzzu,area-52,619,druid,feral,15,7,8
Weedleaf,wyrmrest-accord,610,druid,feral,20,8,12
Beaker,uldum,605,druid,feral,11,7,4
Chucknöürish,dalaran,597,druid,feral,23,7,16
Hotmomlover,malganis,576,druid,feral,12,6,6
Bootayclappa,sargeras,576,druid,feral,12,6,6
Bables,tichondrius,576,druid,feral,12,6,6
Thontt,sargeras,576,druid,feral,12,6,6
Honoriodruid,nemesis,576,druid,feral,12,6,6
Wilddeity,tichondrius,576,druid,feral,12,6,6
Daniverse,sargeras,576,druid,feral,12,6,6
Ogversaucey,skullcrusher,576,druid,feral,12,6,6
Alyxsandr,dalaran,576,druid,feral,12,6,6
Hybridxo,kelthuzad,576,druid,feral,12,6,6
Grimtreeper,illidan,576,druid,feral,12,6,6
Zoehange,frostmourne,576,druid,feral,12,6,6
Parabear,area-52,576,druid,feral,12,6,6
Cíphenz,illidan,576,druid,feral,12,6,6
Lilrichdps,sargeras,576,druid,feral,12,6,6
Kurokyy,frostmourne,576,druid,feral,12,6,6
Trottystwin,emerald-dream,576,druid,feral,12,6,6
Nelfwaifú,area-52,576,druid,feral,12,6,6
Spaléxgu,azralon,576,druid,feral,12,6,6
Mommyshårk,tichondrius,576,druid,feral,12,6,6
Kittysnuggle,emerald-dream,576,druid,feral,15,7,8
Jinhova,stormrage,576,druid,feral,15,6,9
Rebrrth,antonidas,576,druid,feral,18,6,12
Mameseph,lightnings-blade,576,druid,feral,18,6,12
Emotionally,illidan,576,druid,feral,18,6,12
Gaday,malganis,576,druid,feral,18,6,12
Kobebeef,malganis,576,druid,feral,24,6,18
Clamchaddy,tichondrius,576,druid,feral,24,6,18
Zazishi,zuljin,575,druid,feral,6,6,0
Yesqt,dalaran,575,druid,feral,12,6,6
Omnilul,zuljin,575,druid,feral,12,6,6
Fireeloot,tichondrius,575,druid,feral,12,6,6
Wulfjack,emerald-dream,575,druid,feral,12,6,6
Amoru,moon-guard,575,druid,feral,12,6,6
Eliteshift,frostmourne,575,druid,feral,12,6,6
Chupaone,dalaran,575,druid,feral,12,6,6
Tyriall,darkspear,575,druid,feral,12,6,6
Austîn,moon-guard,575,druid,feral,12,6,6
Druishcat,dark-iron,575,druid,feral,12,6,6
Allenjunior,ragnaros,575,druid,feral,12,6,6
Ursoc,muradin,575,druid,feral,18,6,12
Pachacamac,dragonmaw,575,druid,feral,18,6,12
Gush,echo-isles,575,druid,feral,18,6,12
Thorñ,cenarius,575,druid,feral,18,6,12
Peppapig,mugthol,575,druid,feral,18,6,12
Andaror,azralon,575,druid,feral,24,6,18
Volbourn,amanthul,575,druid,feral,24,6,18
Beelzehog,whisperwind,574,druid,feral,12,6,6
Swánn,firetree,574,druid,feral,18,6,12
Imass,draka,573,druid,feral,18,6,12
Nikozho,sargeras,573,druid,feral,18,6,12
Udala,durotan,572,druid,feral,14,6,8
Drewiid,stormrage,571,druid,feral,18,6,12
Expells,nemesis,569,druid,feral,18,6,12
Rhaines,moon-guard,569,druid,feral,18,6,12
Oxentoes,sargeras,559,druid,feral,17,7,10
Bigdeeza,frostmourne,552,druid,feral,19,8,11
Dullbozer,thrall,543,druid,feral,11,6,5
Druidcyber,stormrage,543,druid,feral,16,6,10
Lémons,tichondrius,542,druid,feral,17,6,11
Wtfimacat,area-52,527,druid,feral,11,6,5
Fernés,proudmoore,526,druid,feral,11,6,5
Wierdosaur,azralon,524,druid,feral,15,6,9
Ripx,khadgar,522,druid,feral,16,7,9
Kajla,sargeras,521,druid,feral,22,7,15
Shadalor,frostmourne,512,druid,feral,16,6,10
Kittyperry,kelthuzad,512,druid,feral,16,6,10
Ashvir,wyrmrest-accord,511,druid,feral,11,6,5
Cokanebear,garrosh,511,druid,feral,14,6,8
Kilbys,nemesis,510,druid,feral,8,6,2
Iamatomic,illidan,509,druid,feral,20,6,14
Worgbearpig,destromath,496,druid,feral,13,6,7
Idiotdruid,ragnaros,480,druid,feral,6,5,1
Chrøniç,illidan,480,druid,feral,6,5,1
Gloomcat,illidan,480,druid,feral,6,5,1
Flompstomper,skullcrusher,480,druid,feral,6,5,1
Exxh,tichondrius,480,druid,feral,6,5,1
Nbnbnb,proudmoore,480,druid,feral,6,5,1
Elgatomarica,ragnaros,480,druid,feral,9,6,3
Choolah,area-52,480,druid,feral,12,5,7
Klypz,tichondrius,480,druid,feral,12,5,7
Shiftdeznutz,tichondrius,480,druid,feral,12,5,7
Topangâ,lightninghoof,480,druid,feral,12,5,7
Lurky,dalvengyr,480,druid,feral,12,5,7
Zeratull,cenarius,480,druid,feral,12,5,7
Softshirtxo,ragnaros,480,druid,feral,12,5,7
Cudlybear,bleeding-hollow,480,druid,feral,12,5,7
Lilrichdmg,sargeras,480,druid,feral,12,5,7
Crendorides,bleeding-hollow,480,druid,feral,12,5,7
Samuraicat,frostmourne,480,druid,feral,12,5,7
Bloodyugly,area-52,480,druid,feral,12,5,7
Gunnymad,tichondrius,480,druid,feral,12,5,7
Veryhighrn,area-52,480,druid,feral,12,5,7
Ezconvoke,sargeras,480,druid,feral,12,5,7
Ferallash,sargeras,480,druid,feral,12,5,7
Zululu,dalaran,480,druid,feral,12,5,7
Frenzyirl,darkspear,480,druid,feral,12,5,7
Wurow,firetree,480,druid,feral,12,5,7
Honeybeam,moon-guard,480,druid,feral,12,5,7
Marshanlynch,korgath,480,druid,feral,12,5,7
Loamie,proudmoore,480,druid,feral,12,5,7
Rairven,stormrage,480,druid,feral,12,5,7
Duckseasonn,sargeras,480,druid,feral,12,5,7
Cenarius,frostmourne,480,druid,feral,12,5,7
Karizikat,tichondrius,480,druid,feral,12,5,7
Ragingcloner,tichondrius,480,druid,feral,12,5,7
Frizzle,onyxia,480,druid,feral,12,5,7
Feralhearted,kelthuzad,480,druid,feral,12,5,7
Fredolay,tichondrius,480,druid,feral,13,5,8
Scorn,spirestone,480,druid,feral,13,5,8
Caelüm,area-52,480,druid,feral,18,5,13
Atreis,malganis,480,druid,feral,18,5,13
Purrcat,tichondrius,480,druid,feral,18,5,13
Lycanjungle,azralon,480,druid,feral,18,5,13
Maplêleaf,moon-guard,480,druid,feral,18,5,13
Bere,kul-tiras,480,druid,feral,18,5,13
Funfunfrank,aegwynn,480,druid,feral,18,5,13
Oneninesix,frostmourne,480,druid,feral,18,5,13
Mawnster,drenden,479,druid,feral,9,6,3
Icecrackin,bloodscalp,479,druid,feral,12,5,7
Moozdormu,stormrage,479,druid,feral,12,5,7
Hawthòrn,bloodscalp,479,druid,feral,12,5,7
Omnisyst,burning-blade,479,druid,feral,12,5,7
Calani,lightnings-blade,479,druid,feral,12,5,7
Tootiebootie,bleeding-hollow,479,druid,feral,12,5,7
Harrystun,hyjal,479,druid,feral,12,5,7
Nisheon,wyrmrest-accord,479,druid,feral,12,5,7
Balthøs,moon-guard,479,druid,feral,12,5,7
Animalcade,area-52,479,druid,feral,12,5,7
Elsancho,stormreaver,479,druid,feral,12,5,7
Ysemia,drakkari,479,druid,feral,14,5,9
Giatafix,whisperwind,479,druid,feral,18,5,13
Treepiss,tichondrius,479,druid,feral,18,5,13
Bigoldbear,moon-guard,479,druid,feral,24,5,19
Madador,bleeding-hollow,478,druid,feral,12,5,7
Ramso,skullcrusher,478,druid,feral,12,5,7
Fbombzz,kalecgos,477,druid,feral,12,5,7
Maaryjo,quelthalas,476,druid,feral,12,5,7
Slymar,darkspear,474,druid,feral,12,5,7
Feralhearted,tichondrius,463,druid,feral,17,5,12
Dababÿ,frostmourne,447,druid,feral,11,5,6
Kogti,malganis,446,druid,feral,10,6,4
Maplesyrup,moonrunner,431,druid,feral,11,5,6
Moonrg,stormrage,431,druid,feral,11,5,6
Bjohns,bleeding-hollow,426,druid,feral,21,6,15
Ninelivez,gorgonnash,426,druid,feral,22,6,16
Yunekai,stormrage,415,druid,feral,11,5,6
Vaelthunis,sargeras,400,druid,feral,13,5,8
Slackoth,dalaran,384,druid,feral,6,4,2
Torofarmeon,quelthalas,384,druid,feral,6,4,2
Beastkong,dalaran,384,druid,feral,6,4,2
Xrw,kelthuzad,384,druid,feral,6,4,2
Rouxel,emerald-dream,384,druid,feral,6,4,2
Srwow,elune,384,druid,feral,6,4,2
Sneekykitty,malygos,384,druid,feral,6,4,2
Reversflash,emerald-dream,384,druid,feral,6,4,2
Coolguyzack,stormscale,384,druid,feral,6,4,2
Pressuretd,frostmourne,384,druid,feral,6,4,2
Kaldiel,ysera,384,druid,feral,6,4,2
Cloneyourmom,sargeras,384,druid,feral,6,4,2
Nâturê,dalaran,384,druid,feral,6,4,2
Bearcathawk,sargeras,384,druid,feral,6,4,2
Metamorfis,malorne,384,druid,feral,6,4,2
Moondex,maelstrom,384,druid,feral,6,4,2
Extacy,ragnaros,384,druid,feral,6,4,2
Softkity,area-52,384,druid,feral,6,4,2
Woshiyigede,frostmourne,384,druid,feral,6,4,2
Cwonzocat,moon-guard,384,druid,feral,6,4,2
Zxtreme,tichondrius,384,druid,feral,6,4,2
Féràlgøðx,sargeras,384,druid,feral,6,4,2
Titiica,azralon,384,druid,feral,6,4,2
Cfab,tichondrius,384,druid,feral,6,4,2
Menapaws,muradin,384,druid,feral,6,4,2
Vecuronium,tichondrius,384,druid,feral,6,4,2
Acés,shattered-halls,384,druid,feral,6,4,2
Lharast,stormrage,384,druid,feral,6,4,2
Curet,lightbringer,384,druid,feral,6,4,2
Ñòpé,tichondrius,384,druid,feral,6,4,2
Zoomchicken,stormrage,384,druid,feral,6,4,2
Robomexi,tichondrius,384,druid,feral,6,4,2
Olhosdlua,azralon,384,druid,feral,6,4,2
Toiiz,malganis,384,druid,feral,9,4,5
Genuine,guldan,384,druid,feral,11,4,7
Sellîas,senjin,384,druid,feral,12,4,8
Quiziato,burning-legion,384,druid,feral,12,4,8
Moohok,bleeding-hollow,384,druid,feral,12,4,8
Plantdaddy,bladefist,384,druid,feral,12,4,8
Efflence,tichondrius,384,druid,feral,12,4,8
Alaillais,moon-guard,384,druid,feral,12,4,8
Kokujin,proudmoore,384,druid,feral,12,4,8
Gatona,stormrage,384,druid,feral,12,4,8
Yakir,kiljaeden,384,druid,feral,12,4,8
Riec,kiljaeden,384,druid,feral,12,4,8
Carnumoose,zuljin,384,druid,feral,12,4,8
Auxl,tichondrius,384,druid,feral,12,4,8
Sample,dark-iron,384,druid,feral,12,4,8
Strixferal,zuljin,384,druid,feral,12,4,8
Timthecatman,frostmourne,384,druid,feral,12,4,8
Onewitnature,nordrassil,384,druid,feral,12,4,8
Windded,area-52,384,druid,feral,12,4,8
Feralgød,tichondrius,384,druid,feral,12,4,8
Iamfynch,sargeras,384,druid,feral,12,4,8
Zzkitty,stormreaver,384,druid,feral,12,4,8
Bolthor,wyrmrest-accord,384,druid,feral,12,4,8
Gernichora,barthilas,384,druid,feral,12,4,8
Binjuicex,frostmourne,384,druid,feral,12,4,8
Yakuho,proudmoore,384,druid,feral,12,4,8
Pollykush,sargeras,384,druid,feral,12,4,8
Thalvannas,nazjatar,384,druid,feral,12,4,8
Actioncat,emerald-dream,384,druid,feral,12,4,8
Weeñor,tichondrius,384,druid,feral,12,4,8
Heìrophant,trollbane,384,druid,feral,12,4,8
Freshzk,azralon,384,druid,feral,12,4,8
Imnotinhuman,tichondrius,384,druid,feral,12,4,8
Rêàgøñ,tichondrius,384,druid,feral,12,4,8
Bomani,ragnaros,384,druid,feral,12,4,8
Hellabanx,tichondrius,384,druid,feral,12,4,8
Carlosd,tichondrius,384,druid,feral,12,4,8
Bënzy,frostmourne,384,druid,feral,12,4,8
Kollective,sargeras,384,druid,feral,12,4,8
Anzoô,illidan,384,druid,feral,12,4,8
Toetoetoete,darrowmere,384,druid,feral,12,4,8
Nickarc,illidan,384,druid,feral,12,4,8
Anniehall,stormrage,384,druid,feral,12,4,8
Acdru,tichondrius,384,druid,feral,12,4,8
Ferril,drenden,384,druid,feral,13,4,9
Naastir,medivh,384,druid,feral,14,4,10
Pereréka,azralon,384,druid,feral,14,4,10
Startalons,area-52,384,druid,feral,18,4,14
Apothe,emerald-dream,384,druid,feral,18,4,14
Moçamba,azralon,384,druid,feral,18,4,14
Ewok,vashj,384,druid,feral,18,4,14
Bronaarr,nordrassil,384,druid,feral,18,4,14
Riverthorne,moon-guard,384,druid,feral,18,4,14
Ráhilk,quelthalas,384,druid,feral,18,4,14
Nxndruid,tichondrius,384,druid,feral,18,4,14
Droodkat,feathermoon,384,druid,feral,24,4,20
Jamesbailey,sargeras,383,druid,feral,12,4,8
Pröfëct,ragnaros,383,druid,feral,12,4,8
Gotbleedz,illidan,383,druid,feral,12,4,8
Porrosman,quelthalas,383,druid,feral,12,4,8
Shoboski,quelthalas,383,druid,feral,12,4,8
Bramth,quelthalas,383,druid,feral,12,4,8
Mfgs,kelthuzad,383,druid,feral,12,4,8
Ruwkia,stormrage,383,druid,feral,12,4,8
Mogli,perenolde,383,druid,feral,30,4,26
Pochaso,cenarius,382,druid,feral,6,4,2
Cyder,thrall,382,druid,feral,10,5,5
Ssimbaa,area-52,382,druid,feral,12,4,8
Quaektem,bloodhoof,379,druid,feral,12,4,8
Zyila,garithos,367,druid,feral,11,4,7
Eightyhd,ravencrest,351,druid,feral,11,4,7
Gorlammi,illidan,351,druid,feral,11,4,7
Rainbowsix,sargeras,347,druid,feral,11,4,7
Moocka,ragnaros,336,druid,feral,9,4,5
Shyn,goldrinn,336,druid,feral,15,4,11
Yizhiyuren,aegwynn,330,druid,feral,15,6,9
Defku,quelthalas,330,druid,feral,28,6,22
Niocin,daggerspine,326,druid,feral,18,5,13
Itaiipava,azralon,288,druid,feral,6,3,3
Ahhpalu,tichondrius,288,druid,feral,6,3,3
Greemer,sargeras,288,druid,feral,6,3,3
Insatiablé,azralon,288,druid,feral,6,3,3
Balnara,cenarius,288,druid,feral,6,3,3
Octeviia,illidan,288,druid,feral,6,3,3
Feronnia,sargeras,288,druid,feral,6,3,3
Mcnerd,sargeras,288,druid,feral,6,3,3
Riddickd,malfurion,288,druid,feral,6,3,3
Tigriss,malganis,288,druid,feral,6,3,3
Frestydrul,stormrage,288,druid,feral,6,3,3
Posmard,ragnaros,288,druid,feral,6,3,3
Kardien,quelthalas,288,druid,feral,6,3,3
Dramon,tichondrius,288,druid,feral,6,3,3
Bleedinzqt,illidan,288,druid,feral,6,3,3
Floridaman,moonrunner,288,druid,feral,6,3,3
Steakjr,senjin,288,druid,feral,6,3,3
Tasselhoof,hyjal,288,druid,feral,6,3,3
Silit,tichondrius,288,druid,feral,6,3,3
Injeckx,tichondrius,288,druid,feral,6,3,3
Nichodameus,firetree,288,druid,feral,6,3,3
Donutdruid,illidan,288,druid,feral,6,3,3
Heretoleaf,tichondrius,288,druid,feral,6,3,3
Enti,sargeras,288,druid,feral,6,3,3
Rotclaws,stormrage,288,druid,feral,6,3,3
Rígél,ragnaros,288,druid,feral,6,3,3
Bigskeeve,sargeras,288,druid,feral,6,3,3
Purrfact,frostmourne,288,druid,feral,6,3,3
Opconvoke,illidan,288,druid,feral,6,3,3
Datlogan,tichondrius,288,druid,feral,6,3,3
Celetra,kiljaeden,288,druid,feral,6,3,3
Pansensual,archimonde,288,druid,feral,6,3,3
Jeperty,tichondrius,288,druid,feral,6,3,3
Robbas,stormrage,288,druid,feral,6,3,3
Arienne,kelthuzad,288,druid,feral,6,3,3
Bubbleshiftz,area-52,288,druid,feral,6,3,3
Øvernight,azralon,288,druid,feral,6,3,3
Thecolortwoo,tichondrius,288,druid,feral,6,3,3
Uag,emerald-dream,288,druid,feral,6,3,3
Cwísp,dalaran,288,druid,feral,6,3,3
Gâlaxy,sargeras,288,druid,feral,6,3,3
Natureswang,bleeding-hollow,288,druid,feral,6,3,3
Chopleaf,khadgar,288,druid,feral,6,3,3
Dairycream,skullcrusher,288,druid,feral,6,3,3
Pabag,chogall,288,druid,feral,6,3,3
Ysero,area-52,288,druid,feral,6,3,3
Svarun,jubeithos,288,druid,feral,6,3,3
Katatafish,azralon,288,druid,feral,6,3,3
Erbirus,proudmoore,288,druid,feral,6,3,3
Elythria,hellscream,288,druid,feral,6,3,3
Frrest,proudmoore,288,druid,feral,6,3,3
Lahgit,frostmourne,288,druid,feral,6,3,3
Jungledíff,ragnaros,288,druid,feral,6,3,3
Rootchan,azralon,288,druid,feral,6,3,3
Hyldru,stormrage,288,druid,feral,6,3,3
Owlcapwn,stormreaver,288,druid,feral,6,3,3
Fancyprance,dalaran,288,druid,feral,6,3,3
Hitchslaps,tichondrius,288,druid,feral,6,3,3
Sarenko,jubeithos,288,druid,feral,6,3,3
Vico,azralon,288,druid,feral,6,3,3
Blackmoose,lethon,288,druid,feral,6,3,3
Espoir,azuremyst,288,druid,feral,6,3,3
Taurenasarus,area-52,288,druid,feral,6,3,3
Kíttypunch,bleeding-hollow,288,druid,feral,6,3,3
Krishcat,azshara,288,druid,feral,6,3,3
Askmeaboutmy,shattered-halls,288,druid,feral,6,3,3
Benaveth,moon-guard,288,druid,feral,9,4,5
Zadayos,aerie-peak,288,druid,feral,9,3,6
Naebliss,arygos,288,druid,feral,12,3,9
Lilnippy,stormscale,288,druid,feral,12,3,9
Treezymeezy,proudmoore,288,druid,feral,12,3,9
Snoww,moonrunner,288,druid,feral,12,3,9
Oo,grizzly-hills,288,druid,feral,12,3,9
Tchallå,tichondrius,288,druid,feral,12,3,9
Näna,dalaran,288,druid,feral,12,3,9
Hídde,quelthalas,288,druid,feral,12,3,9
Zyrhek,quelthalas,288,druid,feral,12,3,9
Vorare,tichondrius,288,druid,feral,12,3,9
Solstice,frostmourne,288,druid,feral,12,3,9
Uniquex,zuljin,288,druid,feral,12,3,9
Haohomie,tichondrius,288,druid,feral,12,3,9
Rivetrix,azralon,288,druid,feral,12,3,9
Cattdog,tichondrius,288,druid,feral,12,3,9
Treeguard,emerald-dream,288,druid,feral,12,3,9
Xanjo,kiljaeden,288,druid,feral,12,3,9
Sosorry,blackhand,288,druid,feral,12,3,9
Flushi,nagrand,288,druid,feral,12,3,9
Lovemakitty,sargeras,288,druid,feral,12,3,9
Moobees,arthas,288,druid,feral,12,3,9
Nighetager,uther,288,druid,feral,12,3,9
Pawpaw,terenas,288,druid,feral,12,3,9
Zetlolc,tichondrius,288,druid,feral,12,3,9
Drailyo,ravenholdt,288,druid,feral,12,3,9
Neksir,ragnaros,288,druid,feral,12,3,9
Catorcow,aegwynn,288,druid,feral,13,3,10
Denaye,tichondrius,288,druid,feral,18,3,15
Mákeitnasty,tichondrius,288,druid,feral,18,3,15
Iamthewambo,bloodhoof,288,druid,feral,30,3,27
Extremeshift,dalaran,287,druid,feral,8,4,4
Masilan,kelthuzad,287,druid,feral,6,3,3
Twoworldz,tichondrius,287,druid,feral,6,3,3
Kurodash,tichondrius,287,druid,feral,6,3,3
Rawrii,nemesis,287,druid,feral,6,3,3
Nast,dreadmaul,287,druid,feral,12,3,9
Spartanlxl,zuljin,287,druid,feral,12,3,9
Zalledori,thrall,287,druid,feral,12,3,9
Schwiftea,skullcrusher,287,druid,feral,12,3,9
Absoles,agamaggan,287,druid,feral,12,3,9
Ethernal,burning-blade,287,druid,feral,18,3,15
Pleomorpher,quelthalas,286,druid,feral,6,3,3
Psychosis,kul-tiras,285,druid,feral,12,3,9
Wardruidkvn,stormreaver,285,druid,feral,12,3,9
Mightymërlin,stormrage,255,druid,feral,11,3,8
Punderful,stormrage,254,druid,feral,10,4,6
Trippykitty,tichondrius,240,druid,feral,9,3,6
Yámï,stormrage,239,druid,feral,5,3,2
Centimoose,area-52,234,druid,feral,7,4,3
Pél,tichondrius,223,druid,feral,8,3,5
Worldly,medivh,223,druid,feral,14,3,11
Puiltraxs,ragnaros,192,druid,feral,4,3,1
Feraldudu,illidan,192,druid,feral,4,3,1
Catmóm,tichondrius,192,druid,feral,6,2,4
Slimh,stormrage,192,druid,feral,6,2,4
Dreadonly,tichondrius,192,druid,feral,6,2,4
Taztoc,stormrage,192,druid,feral,6,2,4
Pwoons,tichondrius,192,druid,feral,6,2,4
Elmachina,tichondrius,192,druid,feral,6,2,4
Numbkin,stormrage,192,druid,feral,6,2,4
Tigerbalm,tichondrius,192,druid,feral,6,2,4
Asmondruud,tichondrius,192,druid,feral,6,2,4
Stolenrims,tichondrius,192,druid,feral,6,2,4
Lavanca,azralon,192,druid,feral,6,2,4
Omgapuddycat,stormrage,192,druid,feral,6,2,4
Samsaralol,tichondrius,192,druid,feral,6,2,4
Dankbite,doomhammer,192,druid,feral,6,2,4
Metaldruid,tichondrius,192,druid,feral,6,2,4
Teancookies,tichondrius,192,druid,feral,6,2,4
ßleepßloop,tichondrius,192,druid,feral,6,2,4
Evantheomni,tichondrius,192,druid,feral,6,2,4
Apace,stonemaul,192,druid,feral,6,2,4
Haegur,tichondrius,192,druid,feral,6,2,4
Basichoe,bleeding-hollow,192,druid,feral,6,2,4
Perlek,bleeding-hollow,192,druid,feral,6,2,4
Fødaødruida,azralon,192,druid,feral,6,2,4
Laymonath,elune,192,druid,feral,6,2,4
Driftwood,bonechewer,192,druid,feral,6,2,4
Prosperz,dalaran,192,druid,feral,6,2,4
Thalerosa,tichondrius,192,druid,feral,6,2,4
Majdomoterry,proudmoore,192,druid,feral,6,2,4
Estuvez,twisting-nether,192,druid,feral,6,2,4
Tauretari,tichondrius,192,druid,feral,6,2,4
Pusscat,illidan,192,druid,feral,6,2,4
Lemonnz,illidan,192,druid,feral,6,2,4
Rigotakz,illidan,192,druid,feral,6,2,4
Nabious,malganis,192,druid,feral,6,2,4
Sadsex,illidan,192,druid,feral,6,2,4
Robbieshift,emerald-dream,192,druid,feral,6,2,4
Fulmerethine,emerald-dream,192,druid,feral,6,2,4
Handolar,quelthalas,192,druid,feral,6,2,4
Hotsoncrak,tichondrius,192,druid,feral,6,2,4
Augus,hyjal,192,druid,feral,6,2,4
Bdsurges,illidan,192,druid,feral,6,2,4
Hehaw,kelthuzad,192,druid,feral,6,2,4
Kanadae,thrall,192,druid,feral,6,2,4
Apocalyptoe,proudmoore,192,druid,feral,6,2,4
Klawzy,thrall,192,druid,feral,6,2,4
Meaningfully,kelthuzad,192,druid,feral,6,2,4
Lóríen,thrall,192,druid,feral,6,2,4
Aethorax,hyjal,192,druid,feral,6,2,4
Theliono,lightnings-blade,192,druid,feral,6,2,4
Kikothecat,burning-blade,192,druid,feral,6,2,4
Aurajin,spinebreaker,192,druid,feral,6,2,4
Illr,laughing-skull,192,druid,feral,6,2,4
Vctrphs,nemesis,192,druid,feral,6,2,4
Anudi,whisperwind,192,druid,feral,6,2,4
Therooster,whisperwind,192,druid,feral,6,2,4
Ðjango,goldrinn,192,druid,feral,6,2,4
Milezy,area-52,192,druid,feral,6,2,4
Manwool,illidan,192,druid,feral,6,2,4
Buyadoge,area-52,192,druid,feral,6,2,4
Nyanyahoshi,proudmoore,192,druid,feral,6,2,4
Snupy,area-52,192,druid,feral,6,2,4
Aleksandér,ragnaros,192,druid,feral,6,2,4
Uphine,area-52,192,druid,feral,6,2,4
Varietypack,antonidas,192,druid,feral,6,2,4
Karpin,area-52,192,druid,feral,6,2,4
Timdillon,emerald-dream,192,druid,feral,6,2,4
Nakte,area-52,192,druid,feral,6,2,4
Keithmoonkin,area-52,192,druid,feral,6,2,4
Shinoßi,area-52,192,druid,feral,6,2,4
Kurakai,runetotem,192,druid,feral,6,2,4
Lilstuped,tichondrius,192,druid,feral,6,2,4
Yépp,sargeras,192,druid,feral,6,2,4
Kai,spirestone,192,druid,feral,6,2,4
Athious,moon-guard,192,druid,feral,6,2,4
Evolute,sargeras,192,druid,feral,6,2,4
Tilly,malorne,192,druid,feral,6,2,4
Barrah,barthilas,192,druid,feral,6,2,4
Vivinara,moon-guard,192,druid,feral,6,2,4
Geno,cenarius,192,druid,feral,6,2,4
Tedrithal,moon-guard,192,druid,feral,6,2,4
Eliaris,rivendare,192,druid,feral,6,2,4
Pawblems,sargeras,192,druid,feral,6,2,4
Touchmyroot,frostmourne,192,druid,feral,6,2,4
Hännibal,hydraxis,192,druid,feral,6,2,4
Loadie,frostmourne,192,druid,feral,6,2,4
Ikova,frostmourne,192,druid,feral,6,2,4
Theliverklng,sargeras,192,druid,feral,6,2,4
Bullbuddy,wyrmrest-accord,192,druid,feral,6,2,4
Sunmoons,hydraxis,192,druid,feral,6,2,4
Wreckked,sargeras,192,druid,feral,6,2,4
Pecopeco,sargeras,192,druid,feral,6,2,4
Katskratch,sargeras,192,druid,feral,6,2,4
Unclebolty,frostmourne,192,druid,feral,6,2,4
Rizzit,wyrmrest-accord,192,druid,feral,6,2,4
Envasions,emerald-dream,192,druid,feral,12,2,10
Àcid,stormreaver,192,druid,feral,12,2,10
Drabo,boulderfist,192,druid,feral,12,2,10
Èlunë,andorhal,192,druid,feral,12,2,10
Nerfdemo,kiljaeden,192,druid,feral,12,2,10
Moosesolini,chogall,192,druid,feral,12,2,10
Faroo,azralon,192,druid,feral,12,2,10
Seyala,moon-guard,192,druid,feral,12,2,10
Happyc,bleeding-hollow,192,druid,feral,12,2,10
Abene,tichondrius,192,druid,feral,12,2,10
Ymirgore,zuljin,192,druid,feral,12,2,10
Noktua,moon-guard,192,druid,feral,12,2,10
Feathersnow,moon-guard,192,druid,feral,12,2,10
Codieneme,blades-edge,192,druid,feral,12,2,10
Acórn,frostmourne,192,druid,feral,12,2,10
Pawz,windrunner,192,druid,feral,12,2,10
Chaurli,hyjal,192,druid,feral,12,2,10
Shadedmika,zuljin,192,druid,feral,12,2,10
Meudayr,crushridge,192,druid,feral,12,2,10
Jaydaprophet,azshara,192,druid,feral,12,2,10
Alagorn,zangarmarsh,192,druid,feral,18,2,16
Rorhenn,moon-guard,192,druid,feral,18,2,16
Boomanon,illidan,191,druid,feral,6,2,4
Importedalc,zuljin,191,druid,feral,12,2,10
Baanell,kiljaeden,191,druid,feral,12,2,10
Maxsonmaximo,sargeras,191,druid,feral,12,2,10
Liightbite,illidan,191,druid,feral,12,2,10
Blackcatvibe,sargeras,191,druid,feral,12,2,10
Scaryy,kelthuzad,160,druid,feral,10,2,8
Bowbaggins,bleeding-hollow,159,druid,feral,5,2,3
Jdoozie,bleeding-hollow,159,druid,feral,5,2,3
Kipsmiffly,darkspear,128,druid,feral,4,2,2
Änimorph,emerald-dream,127,druid,feral,4,2,2
Dobrman,sargeras,127,druid,feral,8,2,6
Feles,darkspear,96,druid,feral,3,2,1
Jumpjumpcat,tichondrius,96,druid,feral,3,2,1
Slep,tichondrius,96,druid,feral,6,1,5
Gamerdaddydd,tichondrius,96,druid,feral,6,1,5
Kî,thunderlord,96,druid,feral,6,1,5
Ciggy,maiev,96,druid,feral,6,1,5
Feralhefty,stormrage,96,druid,feral,6,1,5
Yungle,tichondrius,96,druid,feral,6,1,5
Raigor,azralon,96,druid,feral,6,1,5
Valdr,stormrage,96,druid,feral,6,1,5
Shisha,mannoroth,96,druid,feral,6,1,5
Terminated,tichondrius,96,druid,feral,6,1,5
Yeyee,darkspear,96,druid,feral,6,1,5
Kaldelar,emerald-dream,96,druid,feral,6,1,5
Remeta,tichondrius,96,druid,feral,6,1,5
Ottoro,azralon,96,druid,feral,6,1,5
Whiplash,deathwing,96,druid,feral,6,1,5
Gretatunberg,skywall,96,druid,feral,6,1,5
Aigo,azralon,96,druid,feral,6,1,5
Eurth,lightbringer,96,druid,feral,6,1,5
Tuskdaddie,sargeras,96,druid,feral,6,1,5
Shinova,darkspear,96,druid,feral,6,1,5
Thebigcat,deathwing,96,druid,feral,6,1,5
Yarmel,kaelthas,96,druid,feral,6,1,5
Scarymon,tichondrius,96,druid,feral,6,1,5
Lulerz,cenarius,96,druid,feral,6,1,5
Samedo,sargeras,96,druid,feral,6,1,5
Morizo,proudmoore,96,druid,feral,6,1,5
Jawsbee,emerald-dream,96,druid,feral,6,1,5
Roldanspet,sargeras,96,druid,feral,6,1,5
Deelark,skywall,96,druid,feral,6,1,5
Wreckingcrew,emerald-dream,96,druid,feral,6,1,5
Droupy,proudmoore,96,druid,feral,6,1,5
Gúdru,zuljin,96,druid,feral,6,1,5
Avorah,tichondrius,96,druid,feral,6,1,5
Doomkin,demon-soul,96,druid,feral,6,1,5
Lakroz,zuljin,96,druid,feral,6,1,5
Wodbisxpac,sargeras,96,druid,feral,6,1,5
Crazypaddy,dark-iron,96,druid,feral,6,1,5
Kagran,haomarush,96,druid,feral,6,1,5
Captclaws,tichondrius,96,druid,feral,6,1,5
Polyproof,emerald-dream,96,druid,feral,6,1,5
Kelylea,the-underbog,96,druid,feral,6,1,5
Noemofu,barthilas,96,druid,feral,6,1,5
Scizor,lightninghoof,96,druid,feral,6,1,5
Crowaar,moon-guard,96,druid,feral,6,1,5
Ghostboy,zuljin,96,druid,feral,6,1,5
Édzar,area-52,96,druid,feral,6,1,5
Lithrian,stormrage,96,druid,feral,6,1,5
Hynz,barthilas,96,druid,feral,6,1,5
Ticømia,stormrage,96,druid,feral,6,1,5
Harlisu,stormrage,96,druid,feral,6,1,5
Krawnk,zuljin,96,druid,feral,6,1,5
Sweetiefoxx,tichondrius,96,druid,feral,6,1,5
Fuzzwuzzyqt,tichondrius,96,druid,feral,6,1,5
Yuandi,tichondrius,96,druid,feral,6,1,5
Shréd,blades-edge,96,druid,feral,6,1,5
Ojira,moon-guard,96,druid,feral,6,1,5
Garcia,feathermoon,96,druid,feral,6,1,5
Battledruid,nagrand,96,druid,feral,6,1,5
Guy,drakthul,96,druid,feral,6,1,5
Ilikedôggy,saurfang,96,druid,feral,6,1,5
Laynahri,moon-guard,96,druid,feral,6,1,5
Shlümp,tichondrius,96,druid,feral,6,1,5
Frëýá,bleeding-hollow,96,druid,feral,6,1,5
Spacex,amanthul,96,druid,feral,6,1,5
Purpyo,bleeding-hollow,96,druid,feral,6,1,5
Alope,blades-edge,96,druid,feral,6,1,5
Ahnsuk,bleeding-hollow,96,druid,feral,6,1,5
Ärianagrande,stormrage,96,druid,feral,6,1,5
Symbiøsis,zuljin,96,druid,feral,6,1,5
Ban,chogall,96,druid,feral,6,1,5
Healthy,auchindoun,96,druid,feral,6,1,5
Vernaar,laughing-skull,96,druid,feral,6,1,5
Glorp,blackwater-raiders,96,druid,feral,6,1,5
Asaptom,frostmourne,96,druid,feral,6,1,5
Furricane,ysondre,96,druid,feral,6,1,5
Nyatarii,hakkar,96,druid,feral,6,1,5
Furrycon,ysera,96,druid,feral,6,1,5
Dotsgallore,garrosh,96,druid,feral,6,1,5
Droody,earthen-ring,96,druid,feral,6,1,5
Hasemilë,dalaran,96,druid,feral,6,1,5
Mootality,area-52,96,druid,feral,6,1,5
Shortskate,area-52,96,druid,feral,6,1,5
Naztekk,dalaran,96,druid,feral,6,1,5
Boundless,skullcrusher,96,druid,feral,6,1,5
Barnabie,black-dragonflight,96,druid,feral,6,1,5
Thonarian,vashj,96,druid,feral,6,1,5
Fortunecat,illidan,96,druid,feral,6,1,5
Nezrael,frostwolf,96,druid,feral,6,1,5
Bootzs,kelthuzad,96,druid,feral,6,1,5
Ashmíla,ragnaros,96,druid,feral,6,1,5
Arôn,stormreaver,96,druid,feral,6,1,5
Chumdrumrum,malganis,96,druid,feral,6,1,5
Dééz,illidan,96,druid,feral,6,1,5
Ballinthree,illidan,96,druid,feral,6,1,5
Tartin,dragonmaw,96,druid,feral,6,1,5
Colinferal,thrall,96,druid,feral,6,1,5
Spunj,frostmourne,96,druid,feral,6,1,5
Ausbie,garona,96,druid,feral,6,1,5
Swippy,blackhand,96,druid,feral,6,1,5
Byefren,darkspear,96,druid,feral,7,1,6
Kâtniss,quelthalas,96,druid,feral,8,1,7
Habras,alterac-mountains,96,druid,feral,12,1,11
Backlazsh,illidan,96,druid,feral,12,1,11
Ballsnack,zuljin,96,druid,feral,12,1,11
Lonewolfdrd,illidan,96,druid,feral,12,1,11
Owlcapwn,tichondrius,96,druid,feral,12,1,11
Donkeepunch,archimonde,96,druid,feral,12,1,11
Shawdoostorm,nemesis,96,druid,feral,12,1,11
Versipex,emerald-dream,96,druid,feral,12,1,11
Grovestalker,nemesis,96,druid,feral,12,1,11
Wonderclam,sargeras,96,druid,feral,18,1,17
Furiøsä,quelthalas,95,druid,feral,6,1,5
Skwidrific,crushridge,95,druid,feral,12,1,11
Gordisimo,sargeras,79,druid,feral,5,1,4
Gitsnshigles,frostmourne,79,druid,feral,5,1,4
Ebrìthil,hyjal,58,druid,feral,10,3,7
Chubakea,kiljaeden,48,druid,feral,3,1,2
Qouro,area-52,42,druid,feral,6,2,4
Shiftwork,korgath,42,druid,feral,10,2,8
Enderhero,illidan,42,druid,feral,14,2,12
Ânhur,tichondrius,42,druid,feral,17,2,15
Veloon,laughing-skull,41,druid,feral,8,3,5
Mooncow,dalaran,31,druid,feral,2,1,1
Wägÿü,tichondrius,31,druid,feral,2,1,1
Laryfsherman,tichondrius,2324,druid,balance,83,54,29
Aqulaíssaela,sargeras,2296,druid,balance,119,67,52
Supatease,tichondrius,2293,druid,balance,147,84,63
Hessenmèow,tichondrius,2279,druid,balance,102,57,45
Xijînping,tichondrius,2275,druid,balance,104,62,42
Jbz,balnazzar,2269,druid,balance,201,128,73
Sonicphantom,kelthuzad,2267,druid,balance,174,104,70
Owl,shadowsong,2261,druid,balance,120,69,51
Fredagn,illidan,2253,druid,balance,126,73,53
Soggykfc,illidan,2247,druid,balance,196,110,86
Solareclipse,tichondrius,2242,druid,balance,89,51,38
Catworm,sargeras,2211,druid,balance,130,80,50
Flapz,illidan,2210,druid,balance,119,61,58
Cti,tichondrius,2204,druid,balance,59,42,17
Theforeigner,arathor,2194,druid,balance,59,46,13
Gugukuaipao,tichondrius,2186,druid,balance,155,83,72
Flowerboï,azralon,2180,druid,balance,96,69,27
Bkqtpie,tichondrius,2176,druid,balance,106,59,47
Legionsucks,tanaris,2156,druid,balance,168,90,78
Impëria,quelthalas,2137,druid,balance,89,58,31
Altoberano,azralon,2136,druid,balance,95,53,42
Mewfasa,duskwood,2135,druid,balance,147,94,53
Jimmypop,malganis,2135,druid,balance,181,103,78
Houli,tichondrius,2134,druid,balance,96,50,46
Ratspot,stormrage,2133,druid,balance,66,43,23
Napes,tichondrius,2133,druid,balance,84,45,39
Smëagol,zuljin,2133,druid,balance,114,59,55
Nbadizzyboy,illidan,2130,druid,balance,53,43,10
Celtaberano,illidan,2129,druid,balance,96,62,34
Tanerno,illidan,2128,druid,balance,141,79,62
Peterßigßeam,malganis,2127,druid,balance,117,60,57
Elythria,hellscream,2125,druid,balance,48,42,6
Firefirelol,proudmoore,2125,druid,balance,131,65,66
Pisces,emerald-dream,2123,druid,balance,128,75,53
Gspx,dalaran,2123,druid,balance,66,35,31
Pushpop,frostmourne,2120,druid,balance,89,55,34
Kidcudi,dentarg,2119,druid,balance,251,128,123
Tranquilo,stormrage,2118,druid,balance,114,69,45
Riskies,tichondrius,2116,druid,balance,252,133,119
Brose,malganis,2115,druid,balance,66,43,23
Babekisser,stormrage,2115,druid,balance,317,178,139
Murkeÿ,frostmourne,2114,druid,balance,150,75,75
Fergh,tichondrius,2109,druid,balance,83,45,38
Spamclonewin,tichondrius,2107,druid,balance,177,106,71
Trusyrusty,stormrage,2107,druid,balance,151,83,68
Gritzxv,stormrage,2105,druid,balance,83,48,35
Sqwippyd,tichondrius,2102,druid,balance,78,49,29
Bigdiablo,frostmourne,2096,druid,balance,231,125,106
Wnxmomthicc,tichondrius,2094,druid,balance,54,35,19
Suen,tichondrius,2084,druid,balance,86,55,31
Biophilic,moon-guard,2083,druid,balance,159,83,76
Mortqt,tichondrius,2068,druid,balance,78,44,34
Vertderferk,tichondrius,2065,druid,balance,86,50,36
Treirus,sargeras,2064,druid,balance,142,96,46
Hayase,tichondrius,2063,druid,balance,132,77,55
Notes,sargeras,2062,druid,balance,158,76,82
Boomçhicken,tichondrius,2056,druid,balance,112,58,54
Sebastian,tichondrius,2054,druid,balance,83,52,31
Houlix,stormrage,2048,druid,balance,372,184,188
Dogwáter,tichondrius,2047,druid,balance,94,55,39
John,azralon,2040,druid,balance,168,84,84
Vengexd,sargeras,2031,druid,balance,55,38,17
Locose,black-dragonflight,2029,druid,balance,60,42,18
Kaid,malganis,2029,druid,balance,72,43,29
Soulz,quelthalas,2026,druid,balance,96,53,43
Ertuzi,tichondrius,2025,druid,balance,161,90,71
Etherêal,stormrage,2024,druid,balance,132,78,54
Megadruidx,stormrage,2022,druid,balance,81,55,26
Lgpepperoni,tichondrius,2020,druid,balance,54,47,7
Tygraz,alleria,2019,druid,balance,96,61,35
Compléx,tichondrius,2016,druid,balance,78,41,37
Boomkek,wyrmrest-accord,2014,druid,balance,62,40,22
Ztraws,tichondrius,2013,druid,balance,112,70,42
Hxzard,dalaran,2013,druid,balance,193,109,84
Xantastic,area-52,2013,druid,balance,96,45,51
Nokomanida,zuljin,2011,druid,balance,97,55,42
Starfail,illidan,2009,druid,balance,66,32,34
Tòmathy,tichondrius,2007,druid,balance,83,46,37
Lazygaga,zuljin,2004,druid,balance,170,89,81
Dízzen,bleeding-hollow,2003,druid,balance,108,62,46
Snöwghost,aerie-peak,2000,druid,balance,227,118,109
Bobthehefty,area-52,1999,druid,balance,64,38,26
Balancex,tichondrius,1999,druid,balance,138,65,73
Bables,tichondrius,1998,druid,balance,96,61,35
Akuladonfana,tichondrius,1996,druid,balance,30,26,4
Fhormations,area-52,1994,druid,balance,137,77,60
Thugrose,blackrock,1993,druid,balance,54,28,26
Lavlol,frostmourne,1992,druid,balance,394,205,189
Lazershartz,cenarion-circle,1992,druid,balance,72,36,36
Jaseyxxl,area-52,1989,druid,balance,58,41,17
Catculator,tichondrius,1989,druid,balance,130,80,50
Zneb,darkspear,1987,druid,balance,36,29,7
Omends,thrall,1987,druid,balance,128,68,60
Boyoboy,thrall,1985,druid,balance,42,29,13
Burninmoon,tichondrius,1982,druid,balance,87,51,36
Fracxx,area-52,1981,druid,balance,30,21,9
Cultnelf,illidan,1976,druid,balance,131,69,62
Uhnoheals,tichondrius,1974,druid,balance,68,41,27
Mõoõoõoõoõoõ,tichondrius,1973,druid,balance,81,43,38
Komacine,emerald-dream,1965,druid,balance,505,273,232
Feralgo,tichondrius,1960,druid,balance,69,43,26
Instar,tichondrius,1960,druid,balance,48,27,21
Lazersnewch,kelthuzad,1955,druid,balance,78,44,34
Geezbutt,tichondrius,1954,druid,balance,229,119,110
Byk,tichondrius,1952,druid,balance,108,62,46
Ezgamed,tichondrius,1950,druid,balance,69,46,23
Ballinthree,illidan,1947,druid,balance,60,43,17
Daspdruid,nagrand,1944,druid,balance,308,157,151
Basedcatx,tichondrius,1940,druid,balance,82,52,30
Murruk,darkspear,1936,druid,balance,159,86,73
Toughshift,zuljin,1936,druid,balance,66,28,38
Giantpanther,tichondrius,1932,druid,balance,132,76,56
Pønchø,quelthalas,1931,druid,balance,86,47,39
Wereocelot,firetree,1930,druid,balance,173,99,74
Lovemakitty,sargeras,1922,druid,balance,78,46,32
Davo,tichondrius,1920,druid,balance,148,91,57
Mcv,tichondrius,1917,druid,balance,72,41,31
Elyveen,proudmoore,1913,druid,balance,110,79,31
Herpadruid,illidan,1912,druid,balance,102,48,54
Treeheehee,frostmourne,1911,druid,balance,81,60,21
Acdru,tichondrius,1911,druid,balance,67,37,30
Chiikawa,tichondrius,1909,druid,balance,102,52,50
Dilondru,area-52,1906,druid,balance,117,70,47
Beefnudlsoup,tichondrius,1906,druid,balance,66,39,27
Alpine,eldrethalas,1904,druid,balance,66,45,21
Starbränd,azralon,1904,druid,balance,90,57,33
Vengex,sargeras,1904,druid,balance,48,30,18
Doomty,tichondrius,1904,druid,balance,90,53,37
Dorizio,illidan,1902,druid,balance,82,49,33
Fifty,ragnaros,1902,druid,balance,132,78,54
Pigdd,tichondrius,1900,druid,balance,40,27,13
Knotgiver,moon-guard,1899,druid,balance,52,31,21
Lakermagik,moknathal,1899,druid,balance,61,36,25
Johnieboy,azralon,1896,druid,balance,51,35,16
Jakob,arygos,1895,druid,balance,168,94,74
Oakwalker,moon-guard,1895,druid,balance,120,64,56
Halrath,sargeras,1891,druid,balance,36,20,16
Cousa,zuljin,1890,druid,balance,200,110,90
Hogd,illidan,1884,druid,balance,66,38,28
Druidstin,tichondrius,1883,druid,balance,66,33,33
Hefkerd,tichondrius,1881,druid,balance,30,20,10
Ethan,the-venture-co,1879,druid,balance,39,26,13
Jojo,ysera,1879,druid,balance,148,81,67
Jayelljaÿ,thrall,1874,druid,balance,141,83,58
Çørrúptíøñzx,tichondrius,1873,druid,balance,42,31,11
Purkins,barthilas,1872,druid,balance,47,30,17
Psychotycxd,tichondrius,1870,druid,balance,126,69,57
Çoach,tichondrius,1870,druid,balance,111,60,51
Owlyfans,frostmourne,1869,druid,balance,60,39,21
Crusch,shattered-halls,1869,druid,balance,36,23,13
Sadboy,moon-guard,1869,druid,balance,167,90,77
Fgsb,sargeras,1868,druid,balance,42,30,12
Ràjeesh,frostmourne,1867,druid,balance,46,31,15
Möshinòõb,proudmoore,1865,druid,balance,58,40,18
Sarvi,zuljin,1864,druid,balance,33,24,9
Astraldank,tichondrius,1863,druid,balance,166,90,76
Vuru,azralon,1862,druid,balance,47,32,15
Vernaar,laughing-skull,1862,druid,balance,114,61,53
Nickyü,ragnaros,1862,druid,balance,90,48,42
Djayolo,illidan,1861,druid,balance,66,46,20
Nåpes,frostmourne,1861,druid,balance,62,31,31
Fidgy,tichondrius,1858,druid,balance,36,29,7
Yevenbother,tichondrius,1858,druid,balance,42,27,15
Poliage,moon-guard,1858,druid,balance,155,89,66
Yepz,tichondrius,1858,druid,balance,117,60,57
Convokeopp,tichondrius,1856,druid,balance,149,78,71
Lilbeam,sargeras,1855,druid,balance,42,27,15
Ericzzdd,tichondrius,1854,druid,balance,60,44,16
Thundoon,tichondrius,1854,druid,balance,36,23,13
Daifuku,illidan,1854,druid,balance,54,32,22
Beamed,thrall,1852,druid,balance,36,27,9
Rizzit,wyrmrest-accord,1852,druid,balance,58,32,26
Angryjo,tichondrius,1850,druid,balance,64,38,26
Kyura,sargeras,1848,druid,balance,160,82,78
Swaggu,kelthuzad,1847,druid,balance,72,44,28
Deenut,sargeras,1847,druid,balance,66,40,26
Irooftrellen,chogall,1847,druid,balance,107,59,48
Foekinghobo,sargeras,1845,druid,balance,150,81,69
Idolizeme,skullcrusher,1845,druid,balance,59,30,29
Laser,bonechewer,1844,druid,balance,42,27,15
Judar,barthilas,1844,druid,balance,71,36,35
Johnnybeach,tichondrius,1842,druid,balance,49,34,15
Pils,nemesis,1841,druid,balance,154,94,60
Dreveron,bleeding-hollow,1840,druid,balance,72,36,36
Lazerbeamz,tichondrius,1837,druid,balance,126,69,57
Soar,destromath,1836,druid,balance,129,78,51
Gèb,dalaran,1835,druid,balance,116,71,45
Mverstapp,moon-guard,1835,druid,balance,54,28,26
Elunegoddess,tichondrius,1834,druid,balance,46,27,19
Formhub,malganis,1834,druid,balance,84,42,42
Exxh,tichondrius,1833,druid,balance,58,41,17
Moonflora,stormrage,1833,druid,balance,129,73,56
Girthybeam,sargeras,1833,druid,balance,62,32,30
Sawsaw,bleeding-hollow,1832,druid,balance,74,42,32
Animlcracker,emerald-dream,1831,druid,balance,96,63,33
Komaner,frostmourne,1831,druid,balance,66,32,34
Ilovediegoxo,kelthuzad,1830,druid,balance,48,32,16
Deloria,nemesis,1829,druid,balance,42,25,17
Dontnerfmore,queldorei,1829,druid,balance,66,31,35
Moozzash,azralon,1828,druid,balance,54,32,22
Chernovax,kelthuzad,1828,druid,balance,87,47,40
Bubalolz,quelthalas,1828,druid,balance,209,107,102
Equinøxx,malganis,1827,druid,balance,47,30,17
Evsn,tichondrius,1826,druid,balance,36,28,8
Goochies,aerie-peak,1826,druid,balance,59,35,24
Bcup,sargeras,1826,druid,balance,54,32,22
Lekick,tichondrius,1826,druid,balance,72,40,32
Oungan,illidan,1823,druid,balance,140,79,61
Ebrìthil,hyjal,1823,druid,balance,96,50,46
Clonemunster,frostmourne,1821,druid,balance,66,38,28
Ilovediego,stormrage,1820,druid,balance,42,27,15
Fleasy,wyrmrest-accord,1820,druid,balance,85,52,33
Lunalai,bloodhoof,1820,druid,balance,96,55,41
Kydro,sargeras,1820,druid,balance,80,44,36
Catpoop,frostmourne,1819,druid,balance,54,37,17
Sweatypapa,tichondrius,1819,druid,balance,126,82,44
Dipii,proudmoore,1818,druid,balance,30,22,8
Resorange,malganis,1818,druid,balance,48,29,19
Partylord,malganis,1818,druid,balance,144,81,63
Sueycide,tichondrius,1818,druid,balance,83,40,43
Dorlingus,tichondrius,1817,druid,balance,48,29,19
Rìniroo,area-52,1816,druid,balance,48,30,18
Tratean,tichondrius,1816,druid,balance,90,53,37
Xenny,chogall,1815,druid,balance,48,34,14
Form,bleeding-hollow,1815,druid,balance,96,57,39
Raïsin,moon-guard,1814,druid,balance,45,26,19
Jacusias,stormrage,1814,druid,balance,188,102,86
Bentøbøx,barthilas,1814,druid,balance,53,28,25
Thatboiscrew,tichondrius,1813,druid,balance,104,74,30
Haohomie,tichondrius,1813,druid,balance,78,52,26
Animatronixz,area-52,1813,druid,balance,66,34,32
Staystrongox,tichondrius,1812,druid,balance,82,51,31
Donutdruid,illidan,1812,druid,balance,88,54,34
Keylae,sargeras,1812,druid,balance,86,46,40
Moongodx,stormrage,1811,druid,balance,36,26,10
Kamero,tichondrius,1811,druid,balance,57,36,21
Souress,shadowsong,1811,druid,balance,66,40,26
Moonkay,tichondrius,1810,druid,balance,42,26,16
Surfingbird,tichondrius,1810,druid,balance,236,143,93
Likorit,azralon,1809,druid,balance,36,25,11
Tôpdadwôrld,sargeras,1809,druid,balance,30,19,11
Drcuy,ragnaros,1809,druid,balance,104,59,45
Seyala,moon-guard,1809,druid,balance,175,99,76
Kzinti,zuluhed,1809,druid,balance,113,60,53
Ternkote,tichondrius,1808,druid,balance,36,24,12
Smeow,zuljin,1808,druid,balance,146,82,64
Wiredxd,illidan,1807,druid,balance,44,28,16
Pào,tichondrius,1807,druid,balance,57,35,22
Seilah,lightbringer,1807,druid,balance,54,30,24
Sommerrays,kelthuzad,1807,druid,balance,90,47,43
Cattdog,tichondrius,1806,druid,balance,82,55,27
Dustydrx,area-52,1806,druid,balance,56,34,22
Zeromoon,frostmourne,1806,druid,balance,59,29,30
Harukai,azralon,1805,druid,balance,114,67,47
Boomsquanch,emerald-dream,1804,druid,balance,54,32,22
Bloomqt,tichondrius,1804,druid,balance,182,105,77
Starsucceed,illidan,1804,druid,balance,48,25,23
Xannê,tichondrius,1804,druid,balance,62,32,30
Panansy,stormrage,1804,druid,balance,300,153,147
Youngtree,tichondrius,1803,druid,balance,33,20,13
Itachi,dragonmaw,1803,druid,balance,65,38,27
Malfuria,tichondrius,1802,druid,balance,47,29,18
Mythleaf,ragnaros,1802,druid,balance,120,70,50
Enøsh,tichondrius,1802,druid,balance,102,52,50
Felny,malganis,1802,druid,balance,54,26,28
Buffjungle,tichondrius,1801,druid,balance,36,20,16
Gordzak,illidan,1801,druid,balance,212,113,99
Blazeikin,tichondrius,1801,druid,balance,75,39,36
Treelah,tichondrius,1800,druid,balance,48,29,19
Krahz,lightnings-blade,1800,druid,balance,415,219,196
Rikishi,executus,1798,druid,balance,60,32,28
Handhandb,tichondrius,1794,druid,balance,72,43,29
Chal,illidan,1791,druid,balance,53,32,21
Trollololkin,bleeding-hollow,1790,druid,balance,65,44,21
Hypefull,tichondrius,1790,druid,balance,48,23,25
Fungamezx,bleeding-hollow,1788,druid,balance,72,48,24
Striix,ragnaros,1788,druid,balance,48,23,25
Mittns,arthas,1787,druid,balance,42,26,16
Krispz,area-52,1785,druid,balance,89,47,42
Bunnykiss,tichondrius,1784,druid,balance,116,58,58
Gsd,sargeras,1782,druid,balance,89,52,37
Thottiie,hyjal,1782,druid,balance,66,38,28
Chanimal,tichondrius,1781,druid,balance,60,40,20
Drugdoer,tichondrius,1781,druid,balance,112,66,46
Destromz,zuljin,1780,druid,balance,36,24,12
Nasuu,bleeding-hollow,1780,druid,balance,125,76,49
Ataraxie,illidan,1780,druid,balance,78,47,31
Hydrahl,thrall,1779,druid,balance,78,44,34
Thrage,sargeras,1777,druid,balance,60,36,24
Lothail,windrunner,1777,druid,balance,95,52,43
Fal,bloodscalp,1773,druid,balance,45,27,18
Orollå,tichondrius,1771,druid,balance,50,29,21
Boomybro,thrall,1768,druid,balance,140,84,56
Davione,tichondrius,1767,druid,balance,64,37,27
Dooruid,tichondrius,1766,druid,balance,71,38,33
Olongjonsson,wyrmrest-accord,1766,druid,balance,36,19,17
Nxf,sargeras,1764,druid,balance,59,33,26
Lilkitty,tichondrius,1764,druid,balance,148,81,67
Bathrobe,bloodscalp,1762,druid,balance,48,26,22
Ailari,moon-guard,1761,druid,balance,91,52,39
Bukkwild,stormrage,1759,druid,balance,72,50,22
Líu,area-52,1757,druid,balance,102,63,39
Daddyshift,proudmoore,1756,druid,balance,68,39,29
Awguseon,proudmoore,1755,druid,balance,54,37,17
Cocainebeär,tichondrius,1755,druid,balance,77,39,38
Cynhawts,emerald-dream,1754,druid,balance,46,27,19
Sappyroots,area-52,1754,druid,balance,36,19,17
Gorgoncity,illidan,1753,druid,balance,34,19,15
Threk,spirestone,1750,druid,balance,113,64,49
Swayjizz,tichondrius,1750,druid,balance,114,64,50
Deviperdruid,frostmourne,1748,druid,balance,51,35,16
Jaxer,illidan,1747,druid,balance,129,77,52
Bunnyes,tichondrius,1747,druid,balance,54,29,25
Ottovonbird,tichondrius,1746,druid,balance,42,24,18
Halenson,illidan,1745,druid,balance,82,45,37
Mûû,tichondrius,1743,druid,balance,116,69,47
Ayla,gorefiend,1741,druid,balance,47,30,17
Sharialawl,stormreaver,1740,druid,balance,42,28,14
Asenna,moon-guard,1740,druid,balance,35,19,16
Bearyhallsjr,sargeras,1739,druid,balance,30,22,8
Animaldoctor,illidan,1737,druid,balance,69,48,21
Boome,blackrock,1737,druid,balance,168,94,74
Whoopz,blackrock,1737,druid,balance,42,20,22
Pizzaparties,tichondrius,1736,druid,balance,59,41,18
Metroboomy,magtheridon,1736,druid,balance,80,44,36
Kydralola,ragnaros,1735,druid,balance,36,21,15
Weckxa,sargeras,1735,druid,balance,274,140,134
Druidwhat,stormrage,1734,druid,balance,153,81,72
Zoteqt,kelthuzad,1734,druid,balance,259,133,126
Starz,arthas,1733,druid,balance,50,33,17
Ghaal,tichondrius,1732,druid,balance,108,67,41
Melloj,kelthuzad,1732,druid,balance,66,38,28
Foxhoundlol,tichondrius,1731,druid,balance,78,48,30
Jemima,auchindoun,1730,druid,balance,142,83,59
Glickbear,illidan,1730,druid,balance,72,40,32
Nyloke,kelthuzad,1729,druid,balance,66,44,22
Choosegoose,area-52,1729,druid,balance,44,29,15
Meowkit,blackrock,1729,druid,balance,54,35,19
Wasabilol,tichondrius,1729,druid,balance,136,78,58
Scene,frostmourne,1729,druid,balance,71,40,31
Dextructive,tichondrius,1729,druid,balance,124,60,64
Druidk,tichondrius,1729,druid,balance,90,43,47
Cobal,goldrinn,1727,druid,balance,419,216,203
Trapdoorboom,illidan,1726,druid,balance,96,51,45
Sodapooping,azjolnerub,1725,druid,balance,156,93,63
Stinkÿ,bleeding-hollow,1724,druid,balance,63,42,21
Tinkeress,stormrage,1724,druid,balance,145,85,60
Pipiwiwi,stormrage,1724,druid,balance,153,82,71
Pannaxx,tichondrius,1723,druid,balance,36,24,12
Brokenomega,area-52,1722,druid,balance,142,85,57
Naakx,tichondrius,1722,druid,balance,52,30,22
Bolthor,wyrmrest-accord,1721,druid,balance,108,58,50
Wecksox,area-52,1721,druid,balance,246,119,127
Wòót,stormreaver,1719,druid,balance,84,58,26
Sahksi,lothar,1719,druid,balance,68,36,32
Brainlessqt,tichondrius,1717,druid,balance,34,24,10
Boosted,bloodscalp,1717,druid,balance,42,27,15
Sym,zuljin,1716,druid,balance,30,19,11
Droodaphobé,sargeras,1714,druid,balance,59,34,25
Phurr,area-52,1714,druid,balance,60,34,26
Cjæ,bleeding-hollow,1713,druid,balance,24,18,6
Dànkness,frostwolf,1713,druid,balance,53,29,24
Zils,bleeding-hollow,1713,druid,balance,55,29,26
Frames,area-52,1712,druid,balance,89,45,44
Nophysique,zuljin,1709,druid,balance,112,62,50
Petruccius,nordrassil,1709,druid,balance,226,113,113
Faerie,kaelthas,1708,druid,balance,82,44,38
Slickitty,kelthuzad,1707,druid,balance,30,18,12
Hateshinai,sargeras,1705,druid,balance,24,18,6
Niroxic,frostmourne,1705,druid,balance,66,40,26
Swiftroots,tichondrius,1705,druid,balance,36,21,15
Yggdrasil,ravencrest,1705,druid,balance,54,29,25
Myex,illidan,1703,druid,balance,54,36,18
Mädnhairy,zuljin,1703,druid,balance,45,28,17
Maligoz,nemesis,1703,druid,balance,95,49,46
Rerob,aerie-peak,1702,druid,balance,50,26,24
Doomdawn,sargeras,1701,druid,balance,123,65,58
Comidru,tichondrius,1701,druid,balance,72,35,37
Coompie,frostmourne,1700,druid,balance,24,19,5
Delorík,illidan,1700,druid,balance,120,68,52
Smeepy,bleeding-hollow,1700,druid,balance,48,26,22
Binjuicex,frostmourne,1699,druid,balance,45,29,16
Fätål,ysera,1699,druid,balance,72,45,27
Chaossdruid,bleeding-hollow,1699,druid,balance,171,98,73
Koratan,frostmourne,1699,druid,balance,53,28,25
Themustafa,tichondrius,1698,druid,balance,48,31,17
Quelarre,velen,1698,druid,balance,100,58,42
Clarice,shattered-halls,1698,druid,balance,129,70,59
Muunragery,illidan,1698,druid,balance,48,25,23
Protagonist,zuluhed,1697,druid,balance,85,46,39
Fancynut,kiljaeden,1697,druid,balance,80,42,38
Tunaren,wyrmrest-accord,1696,druid,balance,42,21,21
Boomfold,tichondrius,1696,druid,balance,36,18,18
Chikinwing,illidan,1695,druid,balance,119,67,52
Raquelitá,ragnaros,1694,druid,balance,28,19,9
Muwudred,stormrage,1694,druid,balance,60,36,24
Chengxiaopao,tichondrius,1693,druid,balance,44,29,15
Glazinator,sargeras,1693,druid,balance,224,108,116
Cyclone,darkspear,1693,druid,balance,48,21,27
Sibby,barthilas,1691,druid,balance,90,48,42
Meatbender,frostmourne,1691,druid,balance,110,55,55
Boomybalboa,stormrage,1690,druid,balance,29,19,10
Moonrg,stormrage,1689,druid,balance,66,35,31
Reàsons,stormrage,1688,druid,balance,126,62,64
Cirranis,moon-guard,1687,druid,balance,117,68,49
Aule,frostmourne,1687,druid,balance,36,18,18
Realmehji,wyrmrest-accord,1686,druid,balance,36,28,8
Whodoüvoodoo,tichondrius,1686,druid,balance,30,21,9
Kogas,hyjal,1686,druid,balance,44,28,16
Spinach,moon-guard,1686,druid,balance,104,53,51
Ripkinztko,stormrage,1685,druid,balance,24,19,5
Aralix,zuljin,1684,druid,balance,184,101,83
Chickenwings,ragnaros,1683,druid,balance,42,27,15
Gwiffurry,tichondrius,1683,druid,balance,54,32,22
Taurenasarus,area-52,1683,druid,balance,51,30,21
Roofty,illidan,1681,druid,balance,34,22,12
Stepbro,malorne,1681,druid,balance,240,133,107
Cheezaygx,arthas,1680,druid,balance,30,18,12
Dárách,malganis,1680,druid,balance,147,82,65
Nurtures,sargeras,1680,druid,balance,60,33,27
Readt,malganis,1680,druid,balance,204,109,95
Justsidious,sargeras,1679,druid,balance,30,23,7
Finkledurp,dalaran,1679,druid,balance,41,23,18
Honeybeam,moon-guard,1679,druid,balance,72,36,36
Realistik,kelthuzad,1678,druid,balance,60,39,21
Ruthlessbro,sargeras,1677,druid,balance,85,45,40
Abomasnow,turalyon,1675,druid,balance,60,35,25
Cröòk,malganis,1675,druid,balance,48,24,24
Ànìmàl,stormrage,1674,druid,balance,36,27,9
Beamrooster,silvermoon,1672,druid,balance,50,33,17
Oobuck,kilrogg,1672,druid,balance,36,23,13
Pennytrate,barthilas,1672,druid,balance,110,60,50
Buckwhêât,illidan,1672,druid,balance,76,36,40
Mooseknukel,zuljin,1671,druid,balance,42,25,17
Frostig,tichondrius,1670,druid,balance,36,22,14
Lostnsauce,tichondrius,1669,druid,balance,60,43,17
Boiledfrogs,zuljin,1669,druid,balance,30,19,11
Softkiller,chogall,1669,druid,balance,72,44,28
Mastabtw,illidan,1669,druid,balance,42,20,22
Convoken,tichondrius,1668,druid,balance,52,29,23
Halensen,illidan,1668,druid,balance,47,23,24
Scurse,tichondrius,1667,druid,balance,114,60,54
Wallower,malganis,1667,druid,balance,54,24,30
Aethisra,moon-guard,1666,druid,balance,155,88,67
Yipëë,moon-guard,1666,druid,balance,64,34,30
Boattastic,terenas,1666,druid,balance,90,45,45
Ðøomkinz,azjolnerub,1665,druid,balance,48,33,15
Partybeast,malganis,1664,druid,balance,74,55,19
Gumbawl,sargeras,1662,druid,balance,36,22,14
Gallianö,frostmourne,1662,druid,balance,46,27,19
Byte,ragnaros,1662,druid,balance,35,18,17
Marutot,tichondrius,1660,druid,balance,42,30,12
Gokki,zuljin,1660,druid,balance,77,53,24
Spacedruidx,illidan,1659,druid,balance,91,49,42
Maxspeed,tichondrius,1657,druid,balance,30,20,10
Foafoa,illidan,1657,druid,balance,31,19,12
Verbz,arthas,1656,druid,balance,54,26,28
Entakkt,cenarius,1653,druid,balance,36,28,8
Yazmawma,tichondrius,1653,druid,balance,42,24,18
Aull,kelthuzad,1653,druid,balance,36,19,17
Roar,moon-guard,1652,druid,balance,45,31,14
Vergota,emerald-dream,1652,druid,balance,73,50,23
Loudpax,zuljin,1652,druid,balance,53,36,17
Renithen,trollbane,1652,druid,balance,42,28,14
Înfamous,thrall,1652,druid,balance,36,24,12
Starlyxo,malganis,1652,druid,balance,59,37,22
Chernlyssayo,stormrage,1652,druid,balance,50,30,20
Drmf,frostmourne,1652,druid,balance,42,25,17
Ashstarfall,barthilas,1651,druid,balance,36,26,10
Flapperz,sargeras,1651,druid,balance,92,45,47
Druentia,tichondrius,1650,druid,balance,30,20,10
Coldkill,burning-legion,1650,druid,balance,36,20,16
Lyshani,thrall,1650,druid,balance,106,58,48
Khryllx,tichondrius,1649,druid,balance,42,27,15
Starsiee,drakkari,1649,druid,balance,59,27,32
Rokk,baelgun,1648,druid,balance,122,73,49
Nokitty,tichondrius,1647,druid,balance,48,37,11
Yoglosmas,tichondrius,1647,druid,balance,48,32,16
Epicworld,stormrage,1647,druid,balance,156,92,64
Theboomkin,kelthuzad,1647,druid,balance,42,24,18
Ironsightsdr,dalaran,1645,druid,balance,51,29,22
Pankecito,ragnaros,1644,druid,balance,64,36,28
Hennydru,dalaran,1644,druid,balance,36,20,16
Midnitetoker,hyjal,1644,druid,balance,54,29,25
Josepha,tichondrius,1643,druid,balance,30,20,10
Wizdùm,frostmourne,1643,druid,balance,53,34,19
Buckbumble,frostmourne,1643,druid,balance,72,45,27
Convokeula,tichondrius,1643,druid,balance,132,76,56
Rayzer,bleeding-hollow,1643,druid,balance,126,70,56
Rezlur,tichondrius,1643,druid,balance,47,24,23
Masan,burning-blade,1642,druid,balance,36,23,13
Boomchickens,area-52,1642,druid,balance,60,33,27
Knoxdog,illidan,1641,druid,balance,51,32,19
Velyring,moon-guard,1641,druid,balance,79,46,33
Irl,frostmane,1641,druid,balance,41,23,18
Dcountts,area-52,1640,druid,balance,44,28,16
Grapeful,frostmourne,1640,druid,balance,66,37,29
Moanabluray,area-52,1640,druid,balance,48,21,27
Rumorxo,illidan,1639,druid,balance,30,18,12
Chøpstixs,bleeding-hollow,1639,druid,balance,48,28,20
Sigure,zuljin,1638,druid,balance,44,29,15
Killiamp,tichondrius,1636,druid,balance,41,27,14
Supafat,thrall,1636,druid,balance,31,20,11
Kïx,illidan,1636,druid,balance,38,23,15
Shibbith,nordrassil,1636,druid,balance,30,18,12
Thamoonsbak,aggramar,1635,druid,balance,35,18,17
Ehleven,tichondrius,1634,druid,balance,48,29,19
Dharmatra,quelthalas,1634,druid,balance,101,56,45
Showmanship,tichondrius,1634,druid,balance,146,78,68
Ahrilee,area-52,1634,druid,balance,90,47,43
Taylorshift,misha,1633,druid,balance,27,23,4
Lewïs,stormrage,1633,druid,balance,81,45,36
Johnnydrip,malganis,1633,druid,balance,36,19,17
Mayanardz,bleeding-hollow,1631,druid,balance,24,17,7
Trapkin,tichondrius,1631,druid,balance,167,101,66
Jokerdks,tichondrius,1631,druid,balance,38,22,16
Bearyhalls,sargeras,1630,druid,balance,24,17,7
Skeevz,darkspear,1630,druid,balance,74,38,36
Relaeh,andorhal,1629,druid,balance,36,19,17
Kekepöp,illidan,1628,druid,balance,36,25,11
Fìlø,bleeding-hollow,1628,druid,balance,243,136,107
Jimrobloxttv,emerald-dream,1627,druid,balance,36,24,12
Woog,moon-guard,1627,druid,balance,96,57,39
Oppose,akama,1627,druid,balance,65,37,28
Boomchí,tichondrius,1627,druid,balance,54,29,25
Dreamwalker,bleeding-hollow,1626,druid,balance,24,17,7
Ripdimebag,frostmourne,1626,druid,balance,58,37,21
Restorationz,tichondrius,1626,druid,balance,131,77,54
Scrubrat,moon-guard,1625,druid,balance,52,40,12
Scoon,aegwynn,1625,druid,balance,45,24,21
Ablackdruid,moon-guard,1624,druid,balance,35,21,14
Wattami,area-52,1623,druid,balance,30,18,12
Moonra,malganis,1623,druid,balance,66,38,28
Soonntkgo,ragnaros,1623,druid,balance,56,29,27
Bhboom,tichondrius,1623,druid,balance,54,23,31
Eseldra,area-52,1622,druid,balance,58,34,24
Harryhotter,blackrock,1622,druid,balance,109,54,55
Kickconvoke,sargeras,1621,druid,balance,66,39,27
Còyot,stormrage,1621,druid,balance,66,34,32
Padavore,wyrmrest-accord,1620,druid,balance,95,59,36
Moonsliced,kiljaeden,1620,druid,balance,54,33,21
Haymade,sargeras,1620,druid,balance,120,69,51
Doomkiñ,darkspear,1620,druid,balance,35,18,17
Kelagoat,kiljaeden,1620,druid,balance,54,26,28
Muffbfloppn,zuljin,1619,druid,balance,36,22,14
Cyclíze,sargeras,1619,druid,balance,42,25,17
Taszy,blackrock,1619,druid,balance,58,34,24
Contrololol,hyjal,1619,druid,balance,60,32,28
Gatø,area-52,1619,druid,balance,90,42,48
Cenariun,stormrage,1618,druid,balance,66,36,30
Wildslash,proudmoore,1617,druid,balance,75,37,38
Drufasa,tichondrius,1617,druid,balance,70,34,36
Foxwit,jubeithos,1616,druid,balance,40,22,18
Treeshift,tichondrius,1615,druid,balance,53,32,21
Héisénbérg,sargeras,1615,druid,balance,60,33,27
Starsurgeon,thrall,1615,druid,balance,155,85,70
Dudur,zuljin,1615,druid,balance,113,60,53
Furryswipe,proudmoore,1614,druid,balance,56,33,23
Polánd,area-52,1614,druid,balance,75,43,32
Yosuzume,thrall,1613,druid,balance,54,33,21
Seyedo,sargeras,1613,druid,balance,77,45,32
Schneidèr,quelthalas,1613,druid,balance,42,20,22
Targareyen,sargeras,1613,druid,balance,53,25,28
Auras,kelthuzad,1612,druid,balance,120,73,47
Duglas,illidan,1612,druid,balance,91,55,36
Yorkville,sargeras,1612,druid,balance,60,31,29
Ellguin,malganis,1611,druid,balance,60,44,16
Cócorosie,tichondrius,1611,druid,balance,36,26,10
Twcrazyk,tichondrius,1611,druid,balance,79,38,41
Lupintk,tichondrius,1610,druid,balance,96,57,39
Snugglin,kelthuzad,1610,druid,balance,66,33,33
Laradea,argent-dawn,1609,druid,balance,38,27,11
Pänzerkin,sargeras,1609,druid,balance,30,21,9
Fatsquid,tichondrius,1609,druid,balance,60,38,22
Alaillais,moon-guard,1609,druid,balance,48,28,20
Shafted,kelthuzad,1609,druid,balance,36,21,15
Canek,ghostlands,1609,druid,balance,107,62,45
Quaras,frostmourne,1609,druid,balance,241,129,112
Rikezz,black-dragonflight,1608,druid,balance,48,34,14
Tenhoteta,goldrinn,1608,druid,balance,48,25,23
Kittyboy,emerald-dream,1607,druid,balance,30,21,9
Kittiepurry,blackrock,1607,druid,balance,112,63,49
Swiftydel,frostmourne,1607,druid,balance,54,29,25
Flappyjacks,elune,1607,druid,balance,54,27,27
Boys,bleeding-hollow,1606,druid,balance,42,24,18
Galind,rexxar,1606,druid,balance,58,33,25
Rígél,ragnaros,1606,druid,balance,243,132,111
Signifies,tichondrius,1605,druid,balance,29,20,9
Braviel,stormrage,1605,druid,balance,54,32,22
Huggerino,stormrage,1605,druid,balance,88,52,36
Raddosaurus,area-52,1605,druid,balance,89,48,41
Baboongodx,frostmourne,1605,druid,balance,35,18,17
Tummycummy,thrall,1604,druid,balance,30,20,10
Yehaw,bloodhoof,1604,druid,balance,54,35,19
Shumarina,mannoroth,1604,druid,balance,48,29,19
Columpio,area-52,1604,druid,balance,42,23,19
Nehrudruid,area-52,1603,druid,balance,24,17,7
Dorobloom,sargeras,1603,druid,balance,54,36,18
Torrox,tichondrius,1603,druid,balance,244,131,113
Anchunlol,tichondrius,1603,druid,balance,36,19,17
Jentlegiant,tichondrius,1602,druid,balance,36,21,15
Mofan,tichondrius,1599,druid,balance,36,20,16
Kletys,azralon,1599,druid,balance,113,57,56
Sadsex,illidan,1598,druid,balance,107,63,44
Stellar,steamwheedle-cartel,1597,druid,balance,24,19,5
Dirtmaggot,barthilas,1597,druid,balance,31,21,10
Inuyasha,sargeras,1597,druid,balance,59,34,25
Infam,sargeras,1595,druid,balance,36,21,15
Odirtytshirt,malganis,1595,druid,balance,55,27,28
Dôcteurowl,zuljin,1595,druid,balance,119,55,64
Skurts,tichondrius,1594,druid,balance,39,25,14
Blackjésüs,kelthuzad,1594,druid,balance,153,86,67
Junaleska,lightbringer,1593,druid,balance,24,17,7
Drakemaster,aggramar,1593,druid,balance,30,20,10
Twinscroll,tichondrius,1593,druid,balance,107,68,39
Deed,korialstrasz,1593,druid,balance,34,19,15
Swappy,korgath,1593,druid,balance,112,62,50
Faelonk,frostmourne,1592,druid,balance,30,23,7
Charmandxr,hyjal,1592,druid,balance,59,31,28
Kittycleave,tichondrius,1591,druid,balance,30,20,10
Quefemme,kelthuzad,1590,druid,balance,41,23,18
Boompoizan,tichondrius,1590,druid,balance,81,45,36
Tyapet,area-52,1590,druid,balance,160,85,75
Brodda,sargeras,1590,druid,balance,202,105,97
Abn,sargeras,1588,druid,balance,36,22,14
Nodeathz,sargeras,1588,druid,balance,34,20,14
Ånðrømæðå,sargeras,1588,druid,balance,48,26,22
Skirts,area-52,1587,druid,balance,59,34,25
Flowérz,illidan,1586,druid,balance,42,24,18
Watchugonndo,tichondrius,1585,druid,balance,24,17,7
Korbö,zuljin,1585,druid,balance,30,18,12
Fastlife,drakkari,1585,druid,balance,42,22,20
Druizzy,illidan,1585,druid,balance,54,21,33
Zesto,nazjatar,1584,druid,balance,36,24,12
Qelthalas,sargeras,1584,druid,balance,246,134,112
Tereeke,moon-guard,1583,druid,balance,30,17,13
Bigherbo,zuljin,1582,druid,balance,78,43,35
Chedisdru,mugthol,1580,druid,balance,48,28,20
Shîfty,ysondre,1580,druid,balance,65,35,30
Trippyshift,hyjal,1580,druid,balance,60,30,30
Jeanz,bonechewer,1579,druid,balance,36,22,14
Druiddruid,daggerspine,1577,druid,balance,59,36,23
Jillferal,proudmoore,1577,druid,balance,102,57,45
Astrals,runetotem,1577,druid,balance,39,21,18
Kuaite,azralon,1577,druid,balance,70,34,36
Awazing,illidan,1576,druid,balance,65,30,35
Darach,boulderfist,1575,druid,balance,30,21,9
Xenöchrist,ragnaros,1575,druid,balance,104,65,39
Hefe,terenas,1575,druid,balance,36,21,15
Djsummer,tichondrius,1573,druid,balance,125,64,61
Sombrien,stormrage,1573,druid,balance,90,46,44
Nodadpullout,tichondrius,1572,druid,balance,51,25,26
Beretta,rexxar,1571,druid,balance,84,48,36
Offthezaza,tichondrius,1571,druid,balance,87,47,40
Greenseed,nagrand,1570,druid,balance,36,27,9
Saltydru,illidan,1570,druid,balance,44,25,19
Bugbugz,tichondrius,1570,druid,balance,36,18,18
Starsurgê,tichondrius,1569,druid,balance,66,42,24
Fondra,sargeras,1567,druid,balance,55,32,23
Âzn,tichondrius,1566,druid,balance,72,49,23
Atagoo,tichondrius,1566,druid,balance,198,103,95
Draide,dragonblight,1566,druid,balance,55,27,28
Venkin,gnomeregan,1566,druid,balance,96,47,49
Polvinhoo,azralon,1564,druid,balance,72,40,32
Groggs,frostwolf,1564,druid,balance,39,20,19
Swoopy,stormrage,1563,druid,balance,79,44,35
Slumpxaddy,illidan,1562,druid,balance,35,21,14
Xiaoshuaigê,illidan,1562,druid,balance,30,18,12
Wildbloom,draenor,1562,druid,balance,72,42,30
Soupbeandru,zuljin,1561,druid,balance,60,33,27
Kitinglol,alexstrasza,1560,druid,balance,68,35,33
Ocâ,cenarius,1558,druid,balance,60,36,24
Indicamicah,tichondrius,1558,druid,balance,66,36,30
Neytîrî,tichondrius,1554,druid,balance,101,55,46
Syclonez,stormrage,1554,druid,balance,42,21,21
Hasteley,khadgar,1554,druid,balance,71,34,37
Empriona,wildhammer,1553,druid,balance,31,18,13
Thespían,tichondrius,1553,druid,balance,369,193,176
Midoo,proudmoore,1553,druid,balance,48,25,23
Drdrulittle,darkspear,1553,druid,balance,78,40,38
Darkombra,frostmourne,1552,druid,balance,60,28,32
Starcastic,tichondrius,1548,druid,balance,120,63,57
Boõsty,bleeding-hollow,1548,druid,balance,58,29,29
Drognan,sargeras,1548,druid,balance,36,18,18
Zetii,emerald-dream,1547,druid,balance,84,48,36
Balanci,stormrage,1547,druid,balance,70,36,34
Blitzkreigtv,area-52,1546,druid,balance,60,32,28
Hitchslaps,tichondrius,1545,druid,balance,48,28,20
Hayop,illidan,1543,druid,balance,60,28,32
Hoagiecannon,moon-guard,1541,druid,balance,167,89,78
Montrá,stormrage,1541,druid,balance,131,62,69
Ihavehothots,kiljaeden,1540,druid,balance,38,26,12
Almarasta,azralon,1539,druid,balance,94,55,39
Zettka,tichondrius,1539,druid,balance,55,32,23
Kyndel,kiljaeden,1539,druid,balance,36,20,16
Donresantis,stormreaver,1539,druid,balance,90,46,44
Qs,rivendare,1539,druid,balance,89,39,50
November,wyrmrest-accord,1538,druid,balance,110,62,48
Beyondbeef,sargeras,1537,druid,balance,67,43,24
Hikoro,sargeras,1536,druid,balance,126,74,52
Skum,bloodscalp,1536,druid,balance,69,30,39
Velaana,tichondrius,1535,druid,balance,121,60,61
Tanawak,tichondrius,1535,druid,balance,65,29,36
Bippygucci,tichondrius,1534,druid,balance,30,17,13
Jgb,dalaran,1534,druid,balance,30,16,14
Slowreverb,silver-hand,1534,druid,balance,30,16,14
Maplêleaf,moon-guard,1534,druid,balance,223,113,110
Clense,tichondrius,1533,druid,balance,73,44,29
Fironous,nerzhul,1532,druid,balance,36,20,16
Withwind,dalaran,1530,druid,balance,30,16,14
Boomfire,thaurissan,1529,druid,balance,33,18,15
Sorh,stormrage,1529,druid,balance,33,18,15
Waiv,area-52,1529,druid,balance,30,16,14
Packinmeat,tichondrius,1529,druid,balance,30,16,14
Treetard,altar-of-storms,1529,druid,balance,72,36,36
Kg,cenarion-circle,1528,druid,balance,162,93,69
Brockolini,tichondrius,1528,druid,balance,82,44,38
Elliar,akama,1528,druid,balance,48,23,25
Rabbithomas,malygos,1525,druid,balance,24,16,8
Loraxx,bleeding-hollow,1524,druid,balance,24,16,8
Sweatydruidx,tichondrius,1523,druid,balance,24,16,8
Wakeenfiendx,sargeras,1522,druid,balance,24,16,8
Afpak,sargeras,1522,druid,balance,66,35,31
Wp,proudmoore,1521,druid,balance,37,26,11
Paddywhacked,tichondrius,1521,druid,balance,42,28,14
Thorothir,ragnaros,1520,druid,balance,110,62,48
Druidlolwtf,area-52,1520,druid,balance,108,52,56
Myeow,illidan,1520,druid,balance,74,35,39
Swooped,emerald-dream,1519,druid,balance,53,29,24
Gaawdx,illidan,1519,druid,balance,131,63,68
Adaptivv,sargeras,1518,druid,balance,30,21,9
Lowkie,llane,1518,druid,balance,68,34,34
Rogsdruid,sargeras,1518,druid,balance,73,32,41
Børing,sargeras,1517,druid,balance,81,44,37
Musha,tichondrius,1517,druid,balance,57,30,27
Hagatta,stormrage,1517,druid,balance,151,77,74
Skyde,sargeras,1517,druid,balance,36,17,19
Yorch,stormrage,1517,druid,balance,65,30,35
Faruu,tichondrius,1516,druid,balance,24,16,8
Ghostowl,thrall,1516,druid,balance,66,42,24
Groovyroom,tichondrius,1516,druid,balance,42,23,19
Pirira,quelthalas,1515,druid,balance,43,24,19
Stinky,bleeding-hollow,1515,druid,balance,30,16,14
Cfp,tichondrius,1515,druid,balance,64,31,33
Pëps,emerald-dream,1514,druid,balance,48,27,21
Lumala,drakkari,1514,druid,balance,48,27,21
Kittygoboom,kiljaeden,1514,druid,balance,78,35,43
Ganjácookies,stormrage,1513,druid,balance,40,26,14
Piping,thunderlord,1513,druid,balance,30,17,13
Cabek,malganis,1512,druid,balance,72,38,34
Pavati,bleeding-hollow,1511,druid,balance,49,29,20
Mk,caelestrasz,1511,druid,balance,30,17,13
Gossìpgoat,frostmourne,1511,druid,balance,38,21,17
Watchmecap,silvermoon,1510,druid,balance,30,22,8
Luke,ghostlands,1510,druid,balance,24,16,8
Zorn,lightnings-blade,1508,druid,balance,48,26,22
Hudalu,wyrmrest-accord,1508,druid,balance,42,22,20
Vyrrath,stormrage,1504,druid,balance,32,19,13
Shebleeder,aegwynn,1503,druid,balance,54,30,24
Bullquenepas,dalaran,1502,druid,balance,28,17,11
Jxrx,malganis,1501,druid,balance,24,16,8
Rootchan,azralon,1501,druid,balance,58,38,20
Swampduck,saurfang,1500,druid,balance,30,18,12
Enlil,the-underbog,1500,druid,balance,60,32,28
Nuubmurph,stormrage,1499,druid,balance,33,20,13
Nephdruid,stormrage,1499,druid,balance,98,57,41
Cottonpaw,sargeras,1499,druid,balance,281,153,128
Yuumura,stormrage,1499,druid,balance,139,74,65
Thatscute,moon-guard,1499,druid,balance,368,190,178
Kazamura,tichondrius,1499,druid,balance,88,38,50
Meowmixx,frostmane,1498,druid,balance,83,42,41
Dmtdruid,tichondrius,1497,druid,balance,41,21,20
Awkwarder,emerald-dream,1497,druid,balance,189,96,93
Clawriander,barthilas,1497,druid,balance,59,29,30
Clonexlt,wyrmrest-accord,1496,druid,balance,46,28,18
Swagdaddyjr,area-52,1496,druid,balance,42,24,18
Tak,garrosh,1496,druid,balance,36,17,19
Cyeq,blackrock,1494,druid,balance,289,149,140
Yoloboomkin,tichondrius,1494,druid,balance,46,23,23
Rashmi,kiljaeden,1494,druid,balance,36,18,18
Wildsïde,tichondrius,1490,druid,balance,48,28,20
Drunknoodles,stormrage,1489,druid,balance,35,20,15
Lharast,stormrage,1488,druid,balance,28,17,11
Deathkahn,lightninghoof,1487,druid,balance,90,49,41
Cdroo,burning-blade,1486,druid,balance,24,16,8
Boxtops,bleeding-hollow,1486,druid,balance,36,23,13
Bäñgarang,tichondrius,1484,druid,balance,100,54,46
Umadornahh,malganis,1484,druid,balance,54,28,26
Xevão,nemesis,1484,druid,balance,62,32,30
Milkman,mannoroth,1484,druid,balance,42,16,26
Völsüng,tichondrius,1483,druid,balance,48,27,21
Pawpurrazzi,darkspear,1482,druid,balance,53,27,26
Owlgz,barthilas,1482,druid,balance,36,18,18
Dreamkin,tichondrius,1481,druid,balance,84,43,41
Boostgu,illidan,1478,druid,balance,41,24,17
Gwub,illidan,1477,druid,balance,23,17,6
Fahnir,ragnaros,1477,druid,balance,72,40,32
Rakex,tichondrius,1477,druid,balance,104,50,54
Ryügähidëki,tichondrius,1476,druid,balance,61,32,29
Tickler,durotan,1476,druid,balance,36,17,19
Harlisu,stormrage,1475,druid,balance,26,17,9
Árès,frostmourne,1475,druid,balance,83,45,38
Jawnfurry,tichondrius,1475,druid,balance,60,29,31
Maimz,tichondrius,1474,druid,balance,103,60,43
Kuwä,proudmoore,1474,druid,balance,72,36,36
Gepardéx,ragnaros,1473,druid,balance,192,98,94
Gummoo,tichondrius,1472,druid,balance,48,33,15
Jaduss,thrall,1470,druid,balance,44,24,20
Monsin,illidan,1470,druid,balance,168,87,81
Surgingnews,sargeras,1470,druid,balance,48,21,27
Zukru,malganis,1469,druid,balance,54,32,22
Charnlok,thunderlord,1468,druid,balance,47,31,16
Dupaface,stormrage,1468,druid,balance,29,16,13
Suncintus,aggramar,1468,druid,balance,54,24,30
Skrimshaw,burning-legion,1467,druid,balance,83,44,39
Brettdadad,shandris,1465,druid,balance,36,23,13
Feralownage,malorne,1465,druid,balance,36,22,14
Moonfart,zuljin,1465,druid,balance,143,75,68
Lavanis,stormrage,1465,druid,balance,235,121,114
Hyperdryve,bonechewer,1464,druid,balance,54,30,24
Hosehead,malganis,1463,druid,balance,80,50,30
Scarymon,tichondrius,1463,druid,balance,79,45,34
Unclenya,barthilas,1463,druid,balance,72,32,40
Catahoula,lothar,1462,druid,balance,30,18,12
Naurrog,tichondrius,1461,druid,balance,66,42,24
Bruddahderpp,tichondrius,1460,druid,balance,42,28,14
Rajionu,kiljaeden,1460,druid,balance,30,20,10
Jruids,stormrage,1460,druid,balance,66,38,28
Zhinger,tichondrius,1460,druid,balance,79,39,40
Seyon,tichondrius,1459,druid,balance,33,17,16
Shiftyn,proudmoore,1457,druid,balance,30,22,8
Rizzdja,frostmourne,1456,druid,balance,24,16,8
Lãzy,tichondrius,1456,druid,balance,96,53,43
Jubeam,area-52,1456,druid,balance,36,19,17
Metal,jaedenar,1456,druid,balance,61,30,31
Bocephus,dark-iron,1455,druid,balance,36,20,16
Sunmoonkong,area-52,1455,druid,balance,46,24,22
Druuyid,jubeithos,1454,druid,balance,126,68,58
Ereshkïgal,stormrage,1454,druid,balance,79,42,37
Eyzie,stormrage,1454,druid,balance,80,39,41
Tahunne,tichondrius,1452,druid,balance,106,63,43
Aranuir,emerald-dream,1452,druid,balance,35,20,15
Atmospherè,tichondrius,1452,druid,balance,108,57,51
Queiq,kelthuzad,1452,druid,balance,42,22,20
Shiftybiznes,black-dragonflight,1451,druid,balance,28,17,11
Thunderhox,tichondrius,1451,druid,balance,67,36,31
Sammio,emerald-dream,1451,druid,balance,104,55,49
Stormmantlé,moon-guard,1451,druid,balance,35,18,17
Ayelune,stormrage,1450,druid,balance,54,30,24
Thetruetrue,sargeras,1450,druid,balance,72,33,39
Cerest,kaelthas,1448,druid,balance,34,21,13
Juicywap,proudmoore,1448,druid,balance,47,26,21
Druidlow,azralon,1448,druid,balance,79,41,38
Whiteseal,frostmourne,1447,druid,balance,49,31,18
Instanodle,proudmoore,1447,druid,balance,36,20,16
Windstag,korgath,1447,druid,balance,36,17,19
Yaboydave,stonemaul,1446,druid,balance,30,16,14
Fripp,stormrage,1446,druid,balance,54,28,26
Sileda,nemesis,1445,druid,balance,25,18,7
Isomer,kilrogg,1445,druid,balance,30,18,12
Rdruidchump,the-forgotten-coast,1445,druid,balance,32,19,13
Syntheris,kaelthas,1445,druid,balance,87,51,36
Bighomïe,emerald-dream,1445,druid,balance,48,27,21
Basulto,tichondrius,1445,druid,balance,108,57,51
Enrÿu,nemesis,1444,druid,balance,39,22,17
Clawandørder,tichondrius,1442,druid,balance,26,16,10
Redhotbean,tichondrius,1442,druid,balance,95,45,50
Lepolle,ragnaros,1441,druid,balance,31,21,10
Formmaster,malganis,1441,druid,balance,76,38,38
Mctree,cenarius,1440,druid,balance,120,72,48
Nicotinefien,sargeras,1439,druid,balance,24,15,9
Drubuzz,tichondrius,1439,druid,balance,102,56,46
Armorkits,area-52,1438,druid,balance,24,15,9
Markers,gorefiend,1438,druid,balance,24,15,9
Lunarbalance,veknilash,1438,druid,balance,99,44,55
Elvishrage,zuljin,1437,druid,balance,18,15,3
Roundtummy,area-52,1437,druid,balance,90,45,45
ßleepßloop,tichondrius,1436,druid,balance,33,22,11
Wombatform,malganis,1436,druid,balance,24,15,9
Softdog,stormrage,1436,druid,balance,70,38,32
Kellydacat,azuremyst,1435,druid,balance,18,15,3
Rouse,tichondrius,1435,druid,balance,36,27,9
Reconus,frostmourne,1435,druid,balance,24,15,9
Envoy,sargeras,1435,druid,balance,60,33,27
Chonkykitty,frostmourne,1434,druid,balance,36,23,13
Høt,thunderhorn,1434,druid,balance,28,17,11
Alliess,aerie-peak,1434,druid,balance,111,56,55
Moonowl,crushridge,1433,druid,balance,60,35,25
Falkond,tichondrius,1433,druid,balance,35,18,17
Squidwonk,sargeras,1433,druid,balance,48,23,25
Arealdruid,moon-guard,1433,druid,balance,42,18,24
Kallabaluwa,azralon,1433,druid,balance,59,25,34
Shapedance,sargeras,1431,druid,balance,35,16,19
Druiddreams,frostmourne,1430,druid,balance,30,23,7
Dontfloodit,tichondrius,1430,druid,balance,128,61,67
Catatonik,emerald-dream,1430,druid,balance,36,15,21
Ðjx,stormrage,1429,druid,balance,37,28,9
Ularda,bleeding-hollow,1428,druid,balance,48,28,20
Zuice,thrall,1427,druid,balance,79,39,40
Bearserk,rexxar,1427,druid,balance,78,36,42
Alecxeon,tichondrius,1426,druid,balance,72,40,32
Buyadoge,area-52,1426,druid,balance,40,18,22
Livilla,sargeras,1425,druid,balance,53,29,24
Therooster,whisperwind,1425,druid,balance,53,22,31
Nokash,tichondrius,1425,druid,balance,43,17,26
Squidrific,tichondrius,1424,druid,balance,71,47,24
Nebulose,moon-guard,1424,druid,balance,59,26,33
Jeezelouise,kelthuzad,1423,druid,balance,30,21,9
Mèowcenaary,chogall,1423,druid,balance,60,35,25
Genghisz,area-52,1422,druid,balance,95,47,48
Narthurs,ragnaros,1422,druid,balance,48,23,25
Meatcat,sargeras,1421,druid,balance,30,16,14
Yaboidakota,stormrage,1420,druid,balance,172,89,83
Knoxella,moon-guard,1419,druid,balance,146,78,68
Slipprypickl,archimonde,1419,druid,balance,36,16,20
Hornny,shattered-hand,1418,druid,balance,24,15,9
Solarcannon,shuhalo,1418,druid,balance,195,105,90
Seneshy,azralon,1417,druid,balance,36,26,10
Raximus,moon-guard,1417,druid,balance,84,42,42
Chakrabeam,kelthuzad,1417,druid,balance,48,22,26
Faroo,azralon,1416,druid,balance,40,24,16
Axiomisop,tichondrius,1416,druid,balance,59,35,24
Daddymaple,tichondrius,1416,druid,balance,60,29,31
Crocface,tichondrius,1415,druid,balance,66,38,28
Dbanned,nemesis,1414,druid,balance,102,48,54
Lightconvoke,norgannon,1413,druid,balance,38,19,19
Bambooty,veknilash,1413,druid,balance,30,15,15
Balverixqt,tichondrius,1413,druid,balance,42,20,22
Swapclone,sargeras,1413,druid,balance,60,20,40
Bluechew,bleeding-hollow,1412,druid,balance,32,18,14
Gullmock,quelthalas,1412,druid,balance,78,35,43
Jainzar,dreadmaul,1411,druid,balance,63,30,33
Alucardxd,ragnaros,1411,druid,balance,35,16,19
Seannybhoy,emerald-dream,1411,druid,balance,63,27,36
Wiiee,darkspear,1410,druid,balance,80,48,32
Dalsardirn,sargeras,1410,druid,balance,30,17,13
Snailbeam,shattered-hand,1410,druid,balance,48,20,28
Espoir,azuremyst,1409,druid,balance,24,15,9
Feroz,frostmourne,1409,druid,balance,24,15,9
Illilydan,tichondrius,1409,druid,balance,148,75,73
Coorvinus,stormrage,1409,druid,balance,36,18,18
Oo,grizzly-hills,1408,druid,balance,24,16,8
Diligent,dathremar,1408,druid,balance,30,15,15
Abzuri,kiljaeden,1408,druid,balance,36,17,19
Kawshuhn,bleeding-hollow,1407,druid,balance,90,51,39
Boombot,proudmoore,1407,druid,balance,32,17,15
Côheed,bleeding-hollow,1407,druid,balance,30,15,15
Schwenkyytv,sargeras,1407,druid,balance,30,15,15
Maviç,hyjal,1407,druid,balance,123,59,64
Ïny,emerald-dream,1404,druid,balance,30,15,15
Alwind,alleria,1404,druid,balance,117,57,60
Slyfoxx,stonemaul,1403,druid,balance,92,53,39
Vicorin,illidan,1402,druid,balance,30,17,13
Alshari,proudmoore,1402,druid,balance,72,39,33
Ghoouul,tichondrius,1402,druid,balance,47,21,26
Sallyshifts,area-52,1402,druid,balance,45,19,26
Apex,terenas,1401,druid,balance,36,17,19
Smokeytheelf,illidan,1400,druid,balance,36,22,14
Øutcast,malganis,1400,druid,balance,41,22,19
Timdillon,emerald-dream,1400,druid,balance,30,16,14
Moorgasmic,tichondrius,1400,druid,balance,51,23,28
Cudbacrakhed,tichondrius,1399,druid,balance,48,27,21
Nightstalkr,kelthuzad,1397,druid,balance,210,110,100
Justinheras,area-52,1396,druid,balance,100,55,45
Ulcera,nemesis,1396,druid,balance,33,17,16
Suist,moonrunner,1394,druid,balance,28,15,13
Haneulso,tichondrius,1393,druid,balance,267,138,129
Yseraspawn,kelthuzad,1392,druid,balance,42,21,21
Trickatreyy,kelthuzad,1392,druid,balance,43,21,22
Herbzlova,lightnings-blade,1392,druid,balance,102,49,53
Dkat,malganis,1390,druid,balance,82,45,37
Beastsworn,alexstrasza,1388,druid,balance,42,15,27
Daddyfresh,ursin,1387,druid,balance,36,20,16
Dahts,destromath,1383,druid,balance,36,24,12
Bigbeugs,frostmourne,1382,druid,balance,36,19,17
Driftwood,bonechewer,1381,druid,balance,53,30,23
Envasions,emerald-dream,1380,druid,balance,24,15,9
Shréd,blades-edge,1380,druid,balance,32,19,13
Capybara,nerzhul,1380,druid,balance,29,15,14
Notwhaaz,area-52,1379,druid,balance,42,15,27
Nanashi,tichondrius,1378,druid,balance,30,15,15
Nightshàdowz,barthilas,1377,druid,balance,30,16,14
Huskars,tichondrius,1375,druid,balance,48,26,22
Havôç,tichondrius,1375,druid,balance,42,16,26
Milksquirts,thrall,1374,druid,balance,140,71,69
Shemeus,malganis,1374,druid,balance,54,27,27
Barrahjr,frostmourne,1373,druid,balance,63,34,29
Starsaber,dalaran,1372,druid,balance,42,24,18
Trollsmind,tichondrius,1372,druid,balance,46,26,20
Indoee,mannoroth,1368,druid,balance,168,81,87
Asteriel,stormrage,1367,druid,balance,54,24,30
Airinsurgent,stormrage,1367,druid,balance,44,18,26
Binnchook,barthilas,1366,druid,balance,31,19,12
Prebark,sargeras,1366,druid,balance,27,16,11
Graffsworth,emerald-dream,1366,druid,balance,134,68,66
Skagakr,moon-guard,1366,druid,balance,131,65,66
Repanda,proudmoore,1366,druid,balance,130,63,67
Breynna,draenor,1364,druid,balance,47,24,23
Throatjelly,blackrock,1363,druid,balance,42,23,19
Leonardsby,tichondrius,1363,druid,balance,67,33,34
Liñk,sargeras,1363,druid,balance,35,17,18
Torrwin,area-52,1360,druid,balance,64,33,31
Mommyx,stormrage,1357,druid,balance,60,27,33
Nuppxx,frostmourne,1356,druid,balance,30,20,10
Styless,azjolnerub,1356,druid,balance,72,37,35
Katobe,tichondrius,1355,druid,balance,36,19,17
Prismo,ravencrest,1354,druid,balance,54,28,26
Sofereir,frostmourne,1353,druid,balance,167,81,86
Gitsnshigles,frostmourne,1352,druid,balance,43,23,20
Stärfäll,frostmourne,1351,druid,balance,24,17,7
Tahnu,deathwing,1350,druid,balance,23,15,8
Mythelian,icecrown,1348,druid,balance,60,34,26
Jonoa,nagrand,1348,druid,balance,108,61,47
Skêet,tichondrius,1348,druid,balance,54,21,33
Rudar,sargeras,1344,druid,balance,24,14,10
Jâykeup,lightbringer,1344,druid,balance,96,50,46
Ironbark,azuremyst,1344,druid,balance,33,15,18
Dekmdrui,quelthalas,1343,druid,balance,21,16,5
Omnigrind,frostmourne,1343,druid,balance,24,14,10
Ehloheim,stormrage,1342,druid,balance,24,14,10
Ascension,emerald-dream,1341,druid,balance,48,27,21
Flôkey,tichondrius,1341,druid,balance,48,25,23
Hamïlton,ragnaros,1341,druid,balance,49,23,26
Starfallgg,sargeras,1340,druid,balance,18,14,4
Starboy,garona,1340,druid,balance,24,14,10
Deegawn,proudmoore,1340,druid,balance,30,15,15
Rongrong,kargath,1339,druid,balance,24,14,10
Maulinyou,whisperwind,1339,druid,balance,36,20,16
Tanguanota,quelthalas,1339,druid,balance,114,55,59
Runhe,zuljin,1337,druid,balance,42,25,17
Kïte,drakkari,1337,druid,balance,31,15,16
Verelyris,nordrassil,1335,druid,balance,18,14,4
Saturday,frostmourne,1335,druid,balance,35,24,11
Audacities,bloodhoof,1335,druid,balance,58,30,28
Wondercat,illidan,1334,druid,balance,24,14,10
Mntra,emerald-dream,1334,druid,balance,24,14,10
Ligerbomb,bleeding-hollow,1334,druid,balance,24,14,10
Egotistic,tichondrius,1333,druid,balance,24,14,10
Jáguar,frostmourne,1333,druid,balance,48,27,21
Imnotinhuman,tichondrius,1333,druid,balance,41,22,19
Thecovid,illidan,1333,druid,balance,131,68,63
Droody,earthen-ring,1333,druid,balance,40,20,20
Yungterp,zuljin,1332,druid,balance,18,14,4
Eldenis,drakkari,1332,druid,balance,106,55,51
Calfurion,stormscale,1331,druid,balance,18,14,4
Deths,frostmourne,1331,druid,balance,36,22,14
Bâzinga,bleeding-hollow,1331,druid,balance,47,24,23
Jinglebells,kiljaeden,1330,druid,balance,36,23,13
Kahpooya,tichondrius,1330,druid,balance,24,14,10
Medibull,tichondrius,1330,druid,balance,24,14,10
Birdmandaddy,bleeding-hollow,1329,druid,balance,24,14,10
Koreanboom,tichondrius,1329,druid,balance,24,14,10
Zùnma,tichondrius,1328,druid,balance,24,14,10
Salvattor,stormrage,1327,druid,balance,44,30,14
Noteff,illidan,1327,druid,balance,36,22,14
Pecopeco,sargeras,1325,druid,balance,30,14,16
Renamebdsm,cenarius,1324,druid,balance,30,14,16
Kelrelyrare,kiljaeden,1324,druid,balance,30,14,16
Durdern,barthilas,1323,druid,balance,75,47,28
Datdruidrod,illidan,1322,druid,balance,108,56,52
Quincunx,tichondrius,1321,druid,balance,94,55,39
Moohok,bleeding-hollow,1321,druid,balance,33,14,19
Zèrkz,tichondrius,1320,druid,balance,146,76,70
Itchyrat,moon-guard,1319,druid,balance,30,15,15
Lucidkiaru,moon-guard,1317,druid,balance,37,19,18
Winekoolers,malganis,1317,druid,balance,54,27,27
Limikeen,bleeding-hollow,1316,druid,balance,42,18,24
Saeval,korgath,1314,druid,balance,93,47,46
Lavenderowl,arthas,1313,druid,balance,60,33,27
Rosalba,zuljin,1312,druid,balance,57,33,24
Alagoano,azralon,1311,druid,balance,86,57,29
Réko,sargeras,1311,druid,balance,46,26,20
Evilakali,tichondrius,1311,druid,balance,49,27,22
Ernest,goldrinn,1311,druid,balance,70,34,36
Theirs,tichondrius,1310,druid,balance,176,97,79
Stepdru,sargeras,1308,druid,balance,24,14,10
Fugginskoden,twisting-nether,1305,druid,balance,23,14,9
Duakx,malganis,1305,druid,balance,30,14,16
Vallk,area-52,1304,druid,balance,26,15,11
Deez,korgath,1304,druid,balance,56,23,33
Bdsurges,illidan,1303,druid,balance,21,15,6
Treemendous,nemesis,1303,druid,balance,30,14,16
Thiccyiff,frostmourne,1302,druid,balance,48,28,20
Annef,tichondrius,1302,druid,balance,44,21,23
Nucleardruid,khadgar,1302,druid,balance,36,17,19
Treezús,thrall,1300,druid,balance,64,32,32
Iceingdeath,dalaran,1300,druid,balance,36,18,18
Meekgrylls,frostmourne,1300,druid,balance,58,27,31
Dobrman,sargeras,1299,druid,balance,35,14,21
Mofoogoo,laughing-skull,1299,druid,balance,48,18,30
Jynxy,sargeras,1296,druid,balance,41,18,23
Smitenkiten,baelgun,1295,druid,balance,52,23,29
Pneumashift,tichondrius,1294,druid,balance,18,14,4
Slimeyjoe,moon-guard,1294,druid,balance,84,46,38
Regnier,burning-blade,1293,druid,balance,71,32,39
Finntröll,area-52,1292,druid,balance,40,18,22
Lükê,tichondrius,1292,druid,balance,39,14,25
Immortalwild,tichondrius,1290,druid,balance,140,72,68
Craftdruid,tichondrius,1288,druid,balance,60,34,26
Thickmoo,tichondrius,1288,druid,balance,93,43,50
Uuli,area-52,1287,druid,balance,24,16,8
Torhok,azralon,1287,druid,balance,30,17,13
Stupidranga,barthilas,1286,druid,balance,54,29,25
Minusdruid,dalaran,1286,druid,balance,117,57,60
Rocee,illidan,1285,druid,balance,48,27,21
Lokdu,area-52,1284,druid,balance,30,15,15
Upps,kelthuzad,1283,druid,balance,24,16,8
Yoshinorii,tichondrius,1283,druid,balance,36,15,21
Xodz,sargeras,1282,druid,balance,42,21,21
Töm,durotan,1282,druid,balance,84,30,54
Shivlary,stormrage,1280,druid,balance,75,44,31
Barrah,barthilas,1280,druid,balance,70,34,36
Kasparhauser,illidan,1280,druid,balance,36,14,22
Nimfaa,nemesis,1279,druid,balance,36,21,15
Druidoy,tichondrius,1279,druid,balance,36,21,15
Beal,azgalor,1279,druid,balance,93,41,52
Orkinetvx,frostmourne,1278,druid,balance,49,32,17
Sergat,stormreaver,1276,druid,balance,66,33,33
Floote,thrall,1274,druid,balance,85,40,45
Hanaak,illidan,1273,druid,balance,23,14,9
Zeanasfaratu,spinebreaker,1273,druid,balance,45,19,26
Softshirtxo,ragnaros,1271,druid,balance,24,14,10
Odweaven,thunderlord,1270,druid,balance,76,35,41
Jashyd,tichondrius,1269,druid,balance,33,22,11
Zalothianx,thrall,1269,druid,balance,28,14,14
Pooöòôp,kiljaeden,1268,druid,balance,47,27,20
Solaress,moon-guard,1268,druid,balance,48,23,25
Mercz,illidan,1267,druid,balance,48,29,19
Shiffterzz,tichondrius,1267,druid,balance,24,14,10
Sochin,nemesis,1267,druid,balance,90,49,41
Kyabe,ragnaros,1267,druid,balance,73,30,43
Goofyfoot,wyrmrest-accord,1266,druid,balance,76,40,36
Scoobyshiftz,frostmourne,1265,druid,balance,47,26,21
Lønewolf,sargeras,1265,druid,balance,77,38,39
Hootie,arygos,1263,druid,balance,45,19,26
Slingin,illidan,1263,druid,balance,48,20,28
Lavanca,azralon,1262,druid,balance,36,16,20
Spicydurid,tichondrius,1261,druid,balance,32,15,17
Mukay,stormrage,1261,druid,balance,40,15,25
Bouffecul,zuljin,1260,druid,balance,36,17,19
Muscelmilk,tichondrius,1258,druid,balance,51,25,26
Hugedumbcow,area-52,1257,druid,balance,65,37,28
Nicenature,gilneas,1257,druid,balance,28,14,14
Volddy,tichondrius,1255,druid,balance,53,32,21
Furu,bonechewer,1254,druid,balance,78,36,42
Fourthkind,illidan,1252,druid,balance,24,14,10
Pãl,quelthalas,1251,druid,balance,42,24,18
Stormaggedon,dalvengyr,1251,druid,balance,48,22,26
Barekat,emerald-dream,1249,druid,balance,34,18,16
Rigotakz,illidan,1249,druid,balance,51,24,27
Jssy,tichondrius,1248,druid,balance,24,13,11
Draden,moknathal,1248,druid,balance,30,15,15
Édzar,area-52,1248,druid,balance,77,38,39
Råstafart,tichondrius,1248,druid,balance,53,26,27
Imshiftastic,area-52,1248,druid,balance,88,43,45
Gatorskin,sargeras,1247,druid,balance,15,14,1
Atherra,sargeras,1247,druid,balance,90,50,40
Hugodruid,frostmourne,1247,druid,balance,24,13,11
Ssantirap,quelthalas,1247,druid,balance,30,13,17
Galeshift,stormrage,1246,druid,balance,18,13,5
Jaegerbombx,sargeras,1246,druid,balance,18,13,5
Lawlz,aegwynn,1246,druid,balance,51,28,23
Dirtdog,uther,1246,druid,balance,24,13,11
Daspd,tichondrius,1246,druid,balance,24,13,11
Veganmom,zuluhed,1246,druid,balance,24,13,11
Rslm,tichondrius,1246,druid,balance,43,21,22
Panqwa,thrall,1246,druid,balance,45,19,26
Xiaodlol,tichondrius,1245,druid,balance,18,13,5
Slowbleeds,blood-furnace,1245,druid,balance,18,13,5
Antiherø,sargeras,1245,druid,balance,18,13,5
Hucklebeary,terokkar,1245,druid,balance,50,23,27
Spudpatikins,barthilas,1243,druid,balance,30,14,16
Brawndiboom,stormrage,1243,druid,balance,83,36,47
Wrathmighty,frostmourne,1243,druid,balance,51,20,31
Bbkingschair,tichondrius,1241,druid,balance,18,13,5
Avishominem,magtheridon,1241,druid,balance,24,13,11
Pissoutside,frostmourne,1240,druid,balance,18,13,5
Nothanxx,dalaran,1240,druid,balance,18,13,5
Critthisbruh,stormrage,1240,druid,balance,85,46,39
Bigboðm,tichondrius,1239,druid,balance,48,24,24
Monicaduan,frostmourne,1239,druid,balance,38,19,19
Xornhxb,tichondrius,1238,druid,balance,18,13,5
Girthygramps,sargeras,1238,druid,balance,24,13,11
Erealana,tichondrius,1238,druid,balance,24,13,11
Haxzr,sargeras,1237,druid,balance,42,23,19
Guojue,tichondrius,1237,druid,balance,46,25,21
Hawkk,azralon,1237,druid,balance,56,26,30
Shuxz,sargeras,1235,druid,balance,60,32,28
Astrixx,frostmourne,1233,druid,balance,18,13,5
Miviaris,alleria,1233,druid,balance,30,13,17
Exillïs,frostmourne,1231,druid,balance,39,19,20
Tryrah,shattered-hand,1229,druid,balance,30,13,17
Basilix,moon-guard,1226,druid,balance,63,30,33
Vorare,tichondrius,1225,druid,balance,26,14,12
Guitarsolos,nagrand,1225,druid,balance,30,13,17
Zentabra,proudmoore,1225,druid,balance,42,18,24
Kuroshizen,tichondrius,1224,druid,balance,94,39,55
Ssïp,tichondrius,1223,druid,balance,31,14,17
Amanara,echo-isles,1223,druid,balance,83,36,47
Morphkow,sargeras,1222,druid,balance,69,36,33
Sunboy,tichondrius,1221,druid,balance,73,36,37
Partydip,stormrage,1221,druid,balance,30,13,17
Apoc,bleeding-hollow,1220,druid,balance,18,13,5
Mooing,azralon,1219,druid,balance,28,19,9
Acidmoon,tichondrius,1219,druid,balance,52,22,30
Pokémon,grizzly-hills,1218,druid,balance,24,13,11
Strallà,illidan,1217,druid,balance,96,49,47
Overfunk,ragnaros,1216,druid,balance,42,20,22
Flatnose,agamaggan,1216,druid,balance,30,13,17
Mutlèy,gundrak,1215,druid,balance,18,13,5
Vuginas,bleeding-hollow,1215,druid,balance,62,33,29
Worldbullguy,area-52,1215,druid,balance,36,16,20
Feralchild,emerald-dream,1214,druid,balance,54,28,26
Judgedruid,scilla,1213,druid,balance,36,22,14
Cimanin,malganis,1213,druid,balance,24,13,11
Crazystorm,ragnaros,1212,druid,balance,66,37,29
Lindzy,moon-guard,1210,druid,balance,78,43,35
Spawnolyonce,gorefiend,1210,druid,balance,34,14,20
Elpako,ragnaros,1208,druid,balance,54,23,31
Bayaba,tichondrius,1206,druid,balance,24,14,10
Bobedroods,bonechewer,1205,druid,balance,30,16,14
Lazerchicken,boulderfist,1204,druid,balance,30,13,17
Tankbareass,aerie-peak,1203,druid,balance,42,16,26
Huoxiaoying,tichondrius,1202,druid,balance,36,21,15
Mufaasa,boulderfist,1202,druid,balance,90,47,43
Pleasepime,stormrage,1202,druid,balance,84,35,49
Dweralin,nemesis,1202,druid,balance,46,16,30
Bobtail,moon-guard,1201,druid,balance,19,15,4
Drßoom,stormrage,1201,druid,balance,89,38,51
Firesun,quelthalas,1200,druid,balance,18,13,5
Thehooligan,stormrage,1200,druid,balance,75,41,34
Eintier,tichondrius,1200,druid,balance,35,19,16
Kudro,garithos,1197,druid,balance,78,35,43
Vaalser,frostmourne,1196,druid,balance,71,31,40
Chillcat,illidan,1194,druid,balance,18,14,4
Nolifer,sargeras,1192,druid,balance,30,17,13
Crashägásm,proudmoore,1190,druid,balance,67,30,37
Dampnr,tichondrius,1186,druid,balance,30,14,16
Floridajoe,blackrock,1184,druid,balance,83,48,35
Maxable,alleria,1184,druid,balance,27,14,13
Gazwazluz,lothar,1183,druid,balance,51,31,20
Cien,thrall,1182,druid,balance,117,53,64
Zelyvia,moon-guard,1181,druid,balance,31,14,17
Xvenusaur,bleeding-hollow,1179,druid,balance,24,16,8
Stringbeáns,tanaris,1179,druid,balance,42,21,21
Thorsèn,sargeras,1175,druid,balance,48,25,23
Nobullshift,icecrown,1171,druid,balance,50,27,23
Druisole,zuljin,1171,druid,balance,72,30,42
Vicvc,tichondrius,1169,druid,balance,60,30,30
Aberdare,tichondrius,1169,druid,balance,29,13,16
Trythis,tichondrius,1167,druid,balance,61,28,33
Blackmoons,thunderlord,1166,druid,balance,42,15,27
Alphakatt,area-52,1165,druid,balance,84,38,46
Dirtydot,ragnaros,1164,druid,balance,24,14,10
Ryxu,emerald-dream,1161,druid,balance,26,15,11
Simeron,silvermoon,1161,druid,balance,29,13,16
Lydariel,tichondrius,1159,druid,balance,36,23,13
Rahkaaga,kiljaeden,1158,druid,balance,36,21,15
Mihnt,sargeras,1158,druid,balance,40,14,26
Manglehornn,dalaran,1157,druid,balance,32,16,16
Kattel,blackrock,1157,druid,balance,75,37,38
Levincy,thrall,1156,druid,balance,60,33,27
Mambuz,tichondrius,1154,druid,balance,66,35,31
Dojacow,mannoroth,1154,druid,balance,34,16,18
Hllw,tichondrius,1152,druid,balance,24,12,12
Rougaroux,andorhal,1151,druid,balance,18,12,6
Katbriel,zuljin,1151,druid,balance,18,12,6
Ballnout,zuljin,1151,druid,balance,18,12,6
Scraww,tichondrius,1151,druid,balance,29,14,15
Suurik,blackhand,1151,druid,balance,28,13,15
Hootiepie,hyjal,1150,druid,balance,18,12,6
Mcy,nerzhul,1150,druid,balance,24,12,12
Buckeye,tichondrius,1150,druid,balance,24,12,12
Borrdru,arthas,1150,druid,balance,24,12,12
Zebyn,tichondrius,1149,druid,balance,18,12,6
Ralphrawr,barthilas,1149,druid,balance,24,12,12
Numbkin,stormrage,1149,druid,balance,30,12,18
Maserati,emerald-dream,1148,druid,balance,18,12,6
Uckin,bleeding-hollow,1148,druid,balance,24,12,12
Yoona,kiljaeden,1148,druid,balance,24,12,12
Exxosd,tichondrius,1146,druid,balance,18,12,6
Jocek,stormrage,1146,druid,balance,18,12,6
Coppersnout,moon-guard,1146,druid,balance,66,37,29
Sakurao,tichondrius,1146,druid,balance,24,12,12
Cthulhuqt,kelthuzad,1145,druid,balance,18,12,6
Roots,boulderfist,1144,druid,balance,30,13,17
Gravshift,zuljin,1143,druid,balance,18,12,6
Sjchicken,tichondrius,1143,druid,balance,24,12,12
Ganh,demon-soul,1142,druid,balance,24,14,10
Sìrfüzzy,proudmoore,1142,druid,balance,24,12,12
Mørphea,darkspear,1141,druid,balance,30,12,18
Redwallon,emerald-dream,1139,druid,balance,18,12,6
Radagaste,stormrage,1139,druid,balance,24,12,12
Serega,skywall,1138,druid,balance,24,12,12
Slep,tichondrius,1138,druid,balance,24,12,12
Leetpete,eitrigg,1138,druid,balance,24,12,12
Jawsbar,tichondrius,1138,druid,balance,30,12,18
Dodid,laughing-skull,1137,druid,balance,60,30,30
Ungreed,tichondrius,1136,druid,balance,18,12,6
Aozeh,kiljaeden,1136,druid,balance,18,12,6
Furrycringe,stormrage,1135,druid,balance,30,12,18
Sodapoopins,stormrage,1135,druid,balance,30,12,18
Hootyhoot,illidan,1133,druid,balance,18,12,6
Zoomchicken,stormrage,1132,druid,balance,18,12,6
Ðementia,stormrage,1131,druid,balance,36,12,24
Coggtron,uther,1130,druid,balance,24,16,8
Redbbull,tichondrius,1129,druid,balance,73,42,31
Meowfacebby,stormrage,1128,druid,balance,23,12,11
Aolus,kaelthas,1128,druid,balance,74,36,38
Treeteej,kelthuzad,1128,druid,balance,36,16,20
Lunapuma,stonemaul,1127,druid,balance,18,12,6
Iamatomic,illidan,1126,druid,balance,102,49,53
Kuthian,moon-guard,1126,druid,balance,39,17,22
Lacroix,wildhammer,1123,druid,balance,30,20,10
Dennyyd,illidan,1118,druid,balance,18,13,5
Burninmôön,tichondrius,1118,druid,balance,35,12,23
Toofast,lightninghoof,1114,druid,balance,18,12,6
Smashthatbox,illidan,1113,druid,balance,44,17,27
Seytu,sargeras,1112,druid,balance,26,13,13
Wïldmain,area-52,1111,druid,balance,20,13,7
Bwokhanji,proudmoore,1111,druid,balance,24,12,12
Naturlig,area-52,1109,druid,balance,24,13,11
Ilgalsard,frostmourne,1109,druid,balance,36,16,20
Pigmanbear,kelthuzad,1109,druid,balance,30,12,18
Gavalle,khaz-modan,1107,druid,balance,120,66,54
Nozgöth,quelthalas,1105,druid,balance,128,67,61
Desiration,area-52,1104,druid,balance,21,12,9
Ûñø,frostmourne,1101,druid,balance,42,24,18
Elsombrak,onyxia,1095,druid,balance,24,14,10
Krazykritz,illidan,1090,druid,balance,27,13,14
Kniitvekitta,jubeithos,1088,druid,balance,30,16,14
Moistcream,tichondrius,1087,druid,balance,21,12,9
Zeromeme,frostmourne,1086,druid,balance,20,12,8
Circadion,illidan,1084,druid,balance,59,23,36
Bethemarble,sargeras,1084,druid,balance,57,22,35
Møønscar,tichondrius,1081,druid,balance,70,29,41
Minxminx,moon-guard,1080,druid,balance,46,13,33
Dabomb,malorne,1077,druid,balance,23,12,11
Wyldthangz,stormrage,1077,druid,balance,26,12,14
Pilaufakka,zuljin,1074,druid,balance,36,19,17
Blckyoungsta,illidan,1073,druid,balance,18,13,5
Dumdumdugan,korgath,1068,druid,balance,131,61,70
Bluechicken,sargeras,1065,druid,balance,30,17,13
Klyadedfogud,trollbane,1063,druid,balance,41,22,19
Pandajerk,tichondrius,1061,druid,balance,36,17,19
Miggzii,draka,1061,druid,balance,45,19,26
Bulldog,runetotem,1057,druid,balance,18,12,6
Drdoomerkin,area-52,1056,druid,balance,12,11,1
Roccko,illidan,1056,druid,balance,18,11,7
Martians,laughing-skull,1056,druid,balance,18,11,7
Owlbearthing,sargeras,1056,druid,balance,78,29,49
Mastahskills,illidan,1055,druid,balance,18,11,7
Piment,tichondrius,1055,druid,balance,18,11,7
ßigfoot,darkspear,1055,druid,balance,18,11,7
Slys,frostmourne,1055,druid,balance,18,11,7
Docleave,tichondrius,1055,druid,balance,18,11,7
Smwise,tichondrius,1055,druid,balance,18,11,7
Ryannshiftz,proudmoore,1054,druid,balance,18,11,7
Atreis,malganis,1054,druid,balance,18,11,7
Cumvokinlol,sargeras,1054,druid,balance,18,11,7
Buffclyde,blackrock,1054,druid,balance,18,11,7
Ono,daggerspine,1054,druid,balance,18,11,7
Chococrispis,quelthalas,1054,druid,balance,18,11,7
Kimgurdian,tichondrius,1053,druid,balance,18,11,7
Johnnybigg,barthilas,1053,druid,balance,18,11,7
Jacinty,saurfang,1052,druid,balance,18,11,7
Stennz,tichondrius,1052,druid,balance,18,11,7
Fjblol,sargeras,1051,druid,balance,24,11,13
Milkshift,demon-soul,1051,druid,balance,24,11,13
Samsshifter,tichondrius,1050,druid,balance,24,11,13
Arnlu,malganis,1050,druid,balance,24,11,13
Msparker,illidan,1050,druid,balance,36,11,25
Bearyhalls,frostmourne,1049,druid,balance,21,13,8
Àbyss,moon-guard,1049,druid,balance,18,11,7
Roshaka,shadowmoon,1049,druid,balance,24,11,13
Ramannoodlr,tichondrius,1049,druid,balance,24,11,13
Trashytrash,bleeding-hollow,1049,druid,balance,30,11,19
Beastmanqq,kiljaeden,1048,druid,balance,18,11,7
Zhuaraksha,kelthuzad,1048,druid,balance,24,11,13
Fluff,gurubashi,1048,druid,balance,24,11,13
Siberian,lightnings-blade,1048,druid,balance,24,11,13
Nefnef,malganis,1048,druid,balance,24,11,13
Shavedtaco,azshara,1047,druid,balance,12,11,1
Sekzor,darkspear,1047,druid,balance,18,11,7
Wídëwínkër,thrall,1047,druid,balance,18,11,7
Chikenflu,tichondrius,1047,druid,balance,22,11,11
Mäya,jubeithos,1047,druid,balance,24,11,13
Karpin,area-52,1046,druid,balance,18,11,7
Catrene,mannoroth,1045,druid,balance,45,28,17
Coochi,sargeras,1044,druid,balance,18,11,7
Bluethebull,lothar,1044,druid,balance,30,11,19
Druihd,stormrage,1042,druid,balance,36,20,16
Andrés,azralon,1041,druid,balance,18,11,7
Nîghtcráwlér,tichondrius,1040,druid,balance,47,28,19
Justwade,tichondrius,1037,druid,balance,24,11,13
Jherrak,area-52,1035,druid,balance,18,11,7
Bearhug,dragonmaw,1034,druid,balance,18,11,7
Xoth,executus,1033,druid,balance,24,11,13
Aton,frostwolf,1031,druid,balance,18,11,7
Superhorsey,aggramar,1031,druid,balance,36,19,17
Schmeatbawls,illidan,1031,druid,balance,23,11,12
Balantina,tichondrius,1029,druid,balance,36,15,21
Muhana,runetotem,1028,druid,balance,24,11,13
Reeiyna,gallywix,1026,druid,balance,60,35,25
Tuggmyudder,area-52,1026,druid,balance,43,21,22
Thèbearjèw,tichondrius,1024,druid,balance,55,23,32
Malamew,antonidas,1016,druid,balance,18,12,6
Lumipawz,frostmourne,1014,druid,balance,19,12,7
Riprip,tichondrius,1012,druid,balance,27,12,15
Bloomsong,emerald-dream,1012,druid,balance,30,13,17
Araminka,drakkari,1011,druid,balance,12,11,1
Vapeculture,lightbringer,1004,druid,balance,54,31,23
Shifterx,illidan,1002,druid,balance,28,15,13
Arescarriess,shuhalo,1002,druid,balance,23,11,12
ßrian,stormscale,1002,druid,balance,24,11,13
Dustin,moon-guard,1000,druid,balance,22,12,10
Naturae,spirestone,990,druid,balance,14,11,3
Caminanube,quelthalas,989,druid,balance,30,13,17
Warberton,moon-guard,988,druid,balance,25,13,12
Smallrichard,bleeding-hollow,986,druid,balance,27,11,16
Amigomel,emerald-dream,985,druid,balance,23,11,12
Indy,rivendare,980,druid,balance,22,11,11
Spazz,firetree,975,druid,balance,17,11,6
Abzyplasm,sargeras,975,druid,balance,24,11,13
Sever,ysera,974,druid,balance,36,16,20
Cowel,tichondrius,969,druid,balance,25,11,14
Azevedoo,nemesis,961,druid,balance,43,13,30
Killy,nazjatar,960,druid,balance,12,10,2
Soahclleh,sargeras,960,druid,balance,12,10,2
Jubi,bleeding-hollow,960,druid,balance,12,10,2
Fäncy,sargeras,960,druid,balance,12,10,2
Ylanglang,sargeras,960,druid,balance,12,10,2
Beamerboy,bleeding-hollow,960,druid,balance,18,10,8
Sÿndru,illidan,960,druid,balance,18,10,8
Arenamasterx,stormscale,960,druid,balance,18,10,8
Roben,tichondrius,960,druid,balance,18,10,8
Bfaboomy,stormrage,960,druid,balance,24,10,14
Starfallz,illidan,960,druid,balance,24,10,14
Jshwills,sargeras,959,druid,balance,12,10,2
Hautheurel,illidan,959,druid,balance,12,10,2
Feaveldin,moon-guard,959,druid,balance,12,10,2
Rahwan,bleeding-hollow,959,druid,balance,12,10,2
Ephwürd,malganis,959,druid,balance,18,10,8
Jaz,jubeithos,959,druid,balance,18,10,8
Kohru,moon-guard,959,druid,balance,18,10,8
Sàbrè,darkspear,959,druid,balance,18,10,8
Credd,zuljin,959,druid,balance,18,10,8
Tankzsz,malganis,959,druid,balance,18,10,8
Poshspise,nathrezim,959,druid,balance,18,10,8
Hyzah,tichondrius,959,druid,balance,18,10,8
Skaie,ragnaros,959,druid,balance,18,10,8
Sill,illidan,959,druid,balance,18,10,8
Furor,eonar,959,druid,balance,24,10,14
Blàtté,zuljin,958,druid,balance,12,10,2
Furocious,shadowsong,958,druid,balance,12,10,2
Biggieclawz,tichondrius,958,druid,balance,12,10,2
Swiftboom,stormrage,958,druid,balance,18,10,8
Bumbleebee,azralon,958,druid,balance,18,10,8
Immortalowl,illidan,958,druid,balance,18,10,8
Psilo,kelthuzad,958,druid,balance,18,10,8
Tensuen,boulderfist,958,druid,balance,22,10,12
Kushidabs,tichondrius,958,druid,balance,34,11,23
Messyboom,illidan,957,druid,balance,12,10,2
Islayne,moon-guard,957,druid,balance,12,10,2
Fugg,frostmourne,957,druid,balance,18,10,8
Grymdruid,wyrmrest-accord,956,druid,balance,12,10,2
Nøzopium,kelthuzad,956,druid,balance,18,10,8
Drewpg,zuljin,955,druid,balance,18,10,8
Fixn,tichondrius,955,druid,balance,18,10,8
Giantmoobies,zuluhed,955,druid,balance,18,10,8
Druidmf,sargeras,955,druid,balance,18,10,8
Vashida,stormrage,955,druid,balance,24,10,14
Bozart,stormrage,954,druid,balance,18,10,8
Antagonist,burning-blade,954,druid,balance,18,10,8
Maldobear,stormrage,954,druid,balance,24,10,14
Dèrpin,thrall,954,druid,balance,33,11,22
Ardelorfin,kargath,953,druid,balance,18,10,8
Ridicules,cenarius,953,druid,balance,18,10,8
Santogrial,blood-furnace,953,druid,balance,46,25,21
Dethkight,area-52,953,druid,balance,22,11,11
Jal,khazgoroth,953,druid,balance,20,10,10
Wìtchdoctor,barthilas,953,druid,balance,24,10,14
Crunkk,thunderlord,952,druid,balance,18,10,8
Hadoriss,kelthuzad,952,druid,balance,24,10,14
Barecowbear,bleeding-hollow,951,druid,balance,24,10,14
Ohzú,ragnaros,950,druid,balance,18,10,8
Ðarkscar,laughing-skull,943,druid,balance,50,18,32
Skiouros,emerald-dream,943,druid,balance,36,10,26
Gidam,moon-guard,941,druid,balance,18,10,8
Soulhealer,quelthalas,940,druid,balance,18,10,8
Rakelan,tichondrius,937,druid,balance,146,75,71
Boatox,jubeithos,931,druid,balance,30,10,20
Psychoboomi,bleeding-hollow,927,druid,balance,24,13,11
Chrisclones,stormrage,925,druid,balance,29,10,19
Beleraine,moon-guard,915,druid,balance,23,10,13
Rennar,stormrage,911,druid,balance,17,10,7
Maular,jubeithos,911,druid,balance,34,10,24
Fancyprance,dalaran,910,druid,balance,29,10,19
Athious,moon-guard,909,druid,balance,29,13,16
Jokey,quelthalas,906,druid,balance,18,11,7
Sennur,kelthuzad,905,druid,balance,18,10,8
Aroxus,tichondrius,903,druid,balance,23,10,13
Tinyypuppyy,sargeras,903,druid,balance,36,12,24
Stretchhxd,tichondrius,900,druid,balance,21,10,11
Bellä,nazjatar,900,druid,balance,37,11,26
Meiling,spirestone,897,druid,balance,24,12,12
Wantto,moknathal,894,druid,balance,54,26,28
Weezydende,area-52,894,druid,balance,63,19,44
Campdoctor,azralon,890,druid,balance,20,10,10
Sneakichode,tichondrius,889,druid,balance,20,10,10
Nalarin,kaelthas,878,druid,balance,72,35,37
Redrocket,eldrethalas,876,druid,balance,19,10,9
Tinwhiskerz,bleeding-hollow,864,druid,balance,12,9,3
Erutan,malganis,864,druid,balance,12,9,3
Foxxyroxxy,malganis,864,druid,balance,12,9,3
Gerrt,bleeding-hollow,864,druid,balance,12,9,3
Hëllchaos,sargeras,864,druid,balance,12,9,3
Maen,kelthuzad,864,druid,balance,12,9,3
Hännibal,hydraxis,864,druid,balance,12,9,3
Mengniulol,tichondrius,864,druid,balance,12,9,3
Ðraoï,stormrage,864,druid,balance,12,9,3
Simperella,dalaran,864,druid,balance,12,9,3
Stargrazing,tichondrius,864,druid,balance,12,9,3
Toastsdruid,tichondrius,864,druid,balance,12,9,3
Mvpps,thrall,864,druid,balance,18,9,9
Kûramä,dalaran,864,druid,balance,18,9,9
Oatmeals,fizzcrank,864,druid,balance,18,9,9
Kittycatman,tichondrius,864,druid,balance,18,9,9
Zydea,stormrage,864,druid,balance,18,9,9
Gôdôfwow,tichondrius,864,druid,balance,18,9,9
Lunartiç,kelthuzad,864,druid,balance,18,9,9
Proudmom,barthilas,864,druid,balance,24,9,15
Lesbianitax,stormrage,863,druid,balance,12,9,3
Zmk,barthilas,863,druid,balance,12,9,3
Purrfessorx,proudmoore,863,druid,balance,12,9,3
Oldcreg,emerald-dream,863,druid,balance,12,9,3
Cerberus,tanaris,863,druid,balance,12,9,3
Jesterdru,area-52,863,druid,balance,12,9,3
Flamejacker,tichondrius,863,druid,balance,12,9,3
Hàchi,malganis,863,druid,balance,12,9,3
Gladdz,tichondrius,863,druid,balance,12,9,3
Flappyboí,proudmoore,863,druid,balance,15,10,5
Wyldfire,azjolnerub,863,druid,balance,18,9,9
Môônkîn,chogall,863,druid,balance,18,9,9
Petitjeremy,zuljin,863,druid,balance,18,9,9
Cösmic,anetheron,863,druid,balance,18,9,9
Nerzert,sargeras,863,druid,balance,18,9,9
Velaar,arthas,863,druid,balance,18,9,9
Starkraven,firetree,863,druid,balance,18,9,9
Supriix,moon-guard,863,druid,balance,18,9,9
Céléstial,azralon,863,druid,balance,18,9,9
Amookelia,tichondrius,863,druid,balance,18,9,9
Bullcritzz,saurfang,863,druid,balance,18,9,9
Furrysacks,sargeras,863,druid,balance,18,9,9
Doots,aegwynn,863,druid,balance,18,9,9
Galadriowl,dalaran,863,druid,balance,24,9,15
Dolwizz,tichondrius,863,druid,balance,24,9,15
Oreoshift,illidan,862,druid,balance,12,9,3
Rootslayer,tichondrius,862,druid,balance,12,9,3
Zugdruid,tichondrius,862,druid,balance,13,9,4
Elydaria,destromath,862,druid,balance,24,12,12
Muagor,tichondrius,862,druid,balance,18,9,9
Hallthrok,stormrage,862,druid,balance,18,9,9
Felløwship,nemesis,862,druid,balance,18,9,9
Vèrsusapp,thrall,862,druid,balance,18,9,9
Shack,alterac-mountains,862,druid,balance,18,9,9
Furrmissile,area-52,862,druid,balance,18,9,9
Tinkker,zuljin,861,druid,balance,12,9,3
Newclear,tichondrius,861,druid,balance,12,9,3
Actiad,stormrage,861,druid,balance,16,10,6
Atsiri,tichondrius,861,druid,balance,17,10,7
Thullian,stormrage,861,druid,balance,19,10,9
Starslicer,vashj,861,druid,balance,18,9,9
Goldentaint,tichondrius,861,druid,balance,24,9,15
Blizdontcuur,area-52,860,druid,balance,12,9,3
Sanleba,tichondrius,860,druid,balance,18,9,9
Soviclol,malganis,859,druid,balance,18,9,9
Goldzin,stormrage,859,druid,balance,21,10,11
Bestik,quelthalas,859,druid,balance,24,9,15
Moringo,azralon,858,druid,balance,12,9,3
Stormrrage,demon-soul,858,druid,balance,18,9,9
Amandi,magtheridon,858,druid,balance,24,9,15
Kamionero,drakkari,856,druid,balance,12,9,3
Twanheal,kiljaeden,856,druid,balance,12,9,3
Elatheris,stormrage,855,druid,balance,18,9,9
Dizzyshiftz,dalaran,852,druid,balance,30,9,21
Tmoby,emerald-dream,850,druid,balance,24,9,15
Sleek,illidan,850,druid,balance,24,9,15
Everglim,azralon,847,druid,balance,24,9,15
Dèmønblâckev,malganis,842,druid,balance,24,11,13
Bulldohz,tichondrius,837,druid,balance,18,9,9
Tyrana,bloodscalp,833,druid,balance,18,9,9
Starsfall,tichondrius,831,druid,balance,16,9,7
Nokther,muradin,830,druid,balance,28,9,19
Dankasauras,tichondrius,830,druid,balance,42,13,29
Taurenosorus,illidan,827,druid,balance,64,29,35
Chicknfingaz,tichondrius,802,druid,balance,16,10,6
Stetile,azralon,800,druid,balance,16,9,7
Jieter,malganis,799,druid,balance,14,9,5
Leeteracola,malganis,798,druid,balance,20,9,11
Meliódás,area-52,795,druid,balance,204,84,120
Grgcostanza,bleeding-hollow,793,druid,balance,14,9,5
Vyntrix,kelthuzad,792,druid,balance,20,9,11
Astroshift,emerald-dream,784,druid,balance,20,9,11
Haallanna,thunderlord,774,druid,balance,16,9,7
Elyiaida,emerald-dream,768,druid,balance,12,8,4
Cabrøn,illidan,768,druid,balance,12,8,4
Abelladañger,area-52,768,druid,balance,12,8,4
Mikelovin,nemesis,768,druid,balance,12,8,4
Clawyou,illidan,768,druid,balance,12,8,4
Aenari,anvilmar,768,druid,balance,12,8,4
Drakeowl,area-52,768,druid,balance,12,8,4
Yøpìèrre,zuljin,768,druid,balance,12,8,4
Bearlylegál,sargeras,768,druid,balance,12,8,4
Notports,tichondrius,768,druid,balance,12,8,4
Treesrlegal,area-52,768,druid,balance,12,8,4
Ryanspeed,mugthol,768,druid,balance,12,8,4
Moistism,tichondrius,768,druid,balance,12,8,4
Sñìp,zuljin,768,druid,balance,12,8,4
Argento,frostmourne,768,druid,balance,12,8,4
Thallid,hydraxis,768,druid,balance,12,8,4
Shînx,malganis,768,druid,balance,12,8,4
Catmoomoo,tichondrius,768,druid,balance,12,8,4
Jisoojwa,frostmourne,768,druid,balance,12,8,4
Løk,sargeras,768,druid,balance,12,8,4
Nothecia,sargeras,768,druid,balance,12,8,4
Oopygoopy,bleeding-hollow,768,druid,balance,12,8,4
Guuh,tichondrius,768,druid,balance,12,8,4
Azakai,sargeras,768,druid,balance,12,8,4
Eskimocowboy,sargeras,768,druid,balance,12,8,4
Nyzear,bleeding-hollow,768,druid,balance,12,8,4
Shiftytom,spirestone,768,druid,balance,12,8,4
Hootforce,spirestone,768,druid,balance,12,8,4
Laserxo,tichondrius,768,druid,balance,12,8,4
Wizkd,tichondrius,768,druid,balance,12,8,4
Ayyva,proudmoore,768,druid,balance,12,8,4
Meesterwolf,tichondrius,768,druid,balance,12,8,4
Aconcat,bleeding-hollow,768,druid,balance,12,8,4
Mådge,frostmourne,768,druid,balance,12,8,4
Shaney,zuljin,768,druid,balance,12,8,4
Moonlitgrove,silvermoon,768,druid,balance,12,8,4
Duckdie,moon-guard,768,druid,balance,12,8,4
Chayten,bleeding-hollow,768,druid,balance,12,8,4
Juhji,dalaran,768,druid,balance,12,8,4
Chickenbeam,tichondrius,768,druid,balance,17,8,9
Onsen,tichondrius,768,druid,balance,18,8,10
Dotdmage,tichondrius,768,druid,balance,18,8,10
Drop,shadow-council,767,druid,balance,10,9,1
Bearmäntle,ragnaros,767,druid,balance,12,8,4
Wizgarkin,area-52,767,druid,balance,12,8,4
Arellea,uther,767,druid,balance,12,8,4
Starbender,arygos,767,druid,balance,12,8,4
Arntu,malganis,767,druid,balance,12,8,4
Eøle,stormrage,767,druid,balance,12,8,4
Koluna,stormrage,767,druid,balance,12,8,4
Smokeheaters,dalaran,767,druid,balance,12,8,4
Rootyou,frostmourne,767,druid,balance,12,8,4
Notadopted,sargeras,767,druid,balance,12,8,4
Neurotoxins,tichondrius,767,druid,balance,12,8,4
Kimimàrø,illidan,767,druid,balance,12,8,4
Harddeenball,area-52,767,druid,balance,15,9,6
Gloomcat,illidan,767,druid,balance,18,8,10
Snw,sargeras,767,druid,balance,18,8,10
Ebonclaw,malganis,767,druid,balance,18,8,10
Tomletrain,zuljin,767,druid,balance,18,8,10
Ruckiz,stormrage,767,druid,balance,18,8,10
Aesthetical,frostmourne,767,druid,balance,18,8,10
Jiya,zuljin,767,druid,balance,18,8,10
Whiteglade,moon-guard,767,druid,balance,18,8,10
Khristine,spinebreaker,767,druid,balance,24,8,16
Onidudu,frostmourne,766,druid,balance,12,8,4
Volgoro,thrall,766,druid,balance,12,8,4
Melizaa,stormrage,766,druid,balance,12,8,4
Mornis,zuljin,766,druid,balance,12,8,4
Museafour,tichondrius,766,druid,balance,12,8,4
Shadowformer,kelthuzad,766,druid,balance,15,9,6
Cloyer,stormrage,766,druid,balance,18,8,10
Nxghtfall,tichondrius,766,druid,balance,18,8,10
Kastro,frostwolf,766,druid,balance,18,8,10
Jashrus,korgath,765,druid,balance,12,8,4
Whitekongg,blackhand,765,druid,balance,15,9,6
Sefestria,senjin,765,druid,balance,18,8,10
Tegrizelle,cenarion-circle,765,druid,balance,18,8,10
Motörcharge,bleeding-hollow,764,druid,balance,12,8,4
Kelylea,the-underbog,764,druid,balance,18,8,10
Crépes,bleeding-hollow,764,druid,balance,18,8,10
Architech,bleeding-hollow,764,druid,balance,24,8,16
Wabbehkus,barthilas,764,druid,balance,26,8,18
Eiel,undermine,763,druid,balance,12,8,4
Chewychips,malganis,763,druid,balance,12,8,4
Anttfj,mannoroth,763,druid,balance,18,8,10
Psnárf,area-52,763,druid,balance,18,8,10
Herbirove,frostmourne,762,druid,balance,12,8,4
Astromyles,tichondrius,762,druid,balance,25,8,17
Krustyora,khazgoroth,761,druid,balance,18,11,7
Baaksau,illidan,761,druid,balance,18,8,10
Freyaborn,sargeras,760,druid,balance,17,9,8
Jtogethendr,area-52,759,druid,balance,12,8,4
Boneheir,proudmoore,757,druid,balance,21,9,12
Seethert,quelthalas,751,druid,balance,12,8,4
Undeadshammy,tichondrius,736,druid,balance,16,9,7
Outclone,tichondrius,734,druid,balance,10,9,1
Tarukke,azralon,734,druid,balance,20,9,11
Outandy,quelthalas,727,druid,balance,17,8,9
Druz,spirestone,703,druid,balance,11,8,3
Iloveweed,tichondrius,703,druid,balance,11,8,3
Jukebóx,stormrage,701,druid,balance,20,8,12
Mooncry,wyrmrest-accord,700,druid,balance,26,9,17
Alaskanimal,illidan,696,druid,balance,16,8,8
Shiftness,nordrassil,679,druid,balance,11,8,3
Xioqt,chogall,672,druid,balance,12,7,5
Akiiragata,azralon,672,druid,balance,12,7,5
Pantec,eredar,672,druid,balance,12,7,5
Saltkin,frostmourne,672,druid,balance,12,7,5
Taysfriend,tichondrius,672,druid,balance,12,7,5
Bronnasaurus,tichondrius,672,druid,balance,12,7,5
Riptin,kelthuzad,672,druid,balance,12,7,5
Eizruk,tichondrius,672,druid,balance,12,7,5
Slickthick,sargeras,672,druid,balance,12,7,5
Omegablasted,tichondrius,672,druid,balance,12,7,5
Alteraim,thrall,672,druid,balance,12,7,5
Wascar,sargeras,672,druid,balance,12,7,5
Delayedxd,bleeding-hollow,672,druid,balance,12,7,5
Straitbeast,tichondrius,672,druid,balance,12,7,5
Flapping,illidan,672,druid,balance,12,7,5
Dsavart,stormrage,672,druid,balance,12,7,5
Blamkin,tichondrius,672,druid,balance,12,7,5
Notsofat,deathwing,672,druid,balance,12,7,5
Nutbutterpie,stormrage,672,druid,balance,12,7,5
Mar,misha,672,druid,balance,12,7,5
Zoonkin,tichondrius,672,druid,balance,12,7,5
Pepperpawz,emerald-dream,672,druid,balance,12,7,5
Covidcarrier,thrall,672,druid,balance,12,7,5
Nbnbnb,proudmoore,672,druid,balance,12,7,5
Wildllama,moon-guard,672,druid,balance,12,7,5
Qtkinzz,illidan,672,druid,balance,12,7,5
Fixxitfelix,sargeras,672,druid,balance,12,7,5
Kassadega,sargeras,672,druid,balance,12,7,5
Redscyclone,dalaran,672,druid,balance,12,7,5
Talinel,illidan,672,druid,balance,12,7,5
Stacker,malganis,672,druid,balance,12,7,5
Elithyra,area-52,672,druid,balance,12,7,5
Moonkiin,sargeras,672,druid,balance,12,7,5
Suedou,moon-guard,672,druid,balance,12,7,5
Donaldsr,area-52,672,druid,balance,12,7,5
Selvius,area-52,672,druid,balance,12,7,5
Floofi,kelthuzad,672,druid,balance,12,7,5
Boomypower,dalaran,672,druid,balance,12,7,5
Lalalu,frostmourne,672,druid,balance,15,8,7
Ogdöstitz,area-52,672,druid,balance,14,7,7
Alastras,tichondrius,672,druid,balance,18,7,11
Necromos,argent-dawn,672,druid,balance,18,7,11
Sunspot,tichondrius,672,druid,balance,18,7,11
Slaÿr,malganis,672,druid,balance,18,7,11
Ginunaga,tichondrius,672,druid,balance,18,7,11
Jalapenoz,wyrmrest-accord,672,druid,balance,18,7,11
Avbox,proudmoore,672,druid,balance,18,7,11
Purrfessor,proudmoore,672,druid,balance,18,7,11
Shrubzilla,area-52,672,druid,balance,24,7,17
Longstory,bonechewer,671,druid,balance,12,7,5
Bambam,frostwolf,671,druid,balance,12,7,5
Cashgame,malganis,671,druid,balance,12,7,5
Mommybod,stormrage,671,druid,balance,12,7,5
Bvó,stormrage,671,druid,balance,12,7,5
Juicedkin,tichondrius,671,druid,balance,12,7,5
Dgas,tichondrius,671,druid,balance,12,7,5
Cleppy,korgath,671,druid,balance,12,7,5
Iluvbae,bleeding-hollow,671,druid,balance,12,7,5
Dobidas,tichondrius,671,druid,balance,12,7,5
Trìckyz,tichondrius,671,druid,balance,12,7,5
Ripx,khadgar,671,druid,balance,12,7,5
Ayari,sargeras,671,druid,balance,12,7,5
Stickyleavz,sargeras,671,druid,balance,12,7,5
Feathergun,ragnaros,671,druid,balance,12,7,5
Tubemagnet,tichondrius,671,druid,balance,12,7,5
Jazzmaster,barthilas,671,druid,balance,12,7,5
Catalytic,frostmourne,671,druid,balance,15,8,7
Ioncannon,darrowmere,671,druid,balance,18,7,11
Starsurged,moon-guard,671,druid,balance,18,7,11
Barkcheeks,area-52,671,druid,balance,18,7,11
Oakmont,darkspear,671,druid,balance,18,7,11
Schnitter,thrall,671,druid,balance,18,7,11
Ichangeabull,bleeding-hollow,671,druid,balance,18,7,11
Ellysian,malganis,671,druid,balance,18,7,11
Dashio,lightnings-blade,671,druid,balance,18,7,11
Rabbismang,area-52,671,druid,balance,24,7,17
Budtender,moon-guard,670,druid,balance,12,7,5
Tabbo,uther,670,druid,balance,12,7,5
Traxxo,tichondrius,670,druid,balance,12,7,5
Oâk,farstriders,670,druid,balance,12,7,5
Chukksz,nerzhul,670,druid,balance,12,7,5
Brodinmmx,bleeding-hollow,670,druid,balance,18,7,11
Runestar,malganis,670,druid,balance,18,7,11
Joshuah,stormrage,670,druid,balance,18,7,11
Teziq,sargeras,670,druid,balance,18,7,11
Gilgorash,kiljaeden,670,druid,balance,24,7,17
Bruddanature,dawnbringer,670,druid,balance,24,7,17
Chillygraves,stormrage,670,druid,balance,24,7,17
Aviendiana,thrall,669,druid,balance,12,7,5
Eurotrance,frostmourne,669,druid,balance,12,7,5
Hpcorrection,bleeding-hollow,669,druid,balance,18,7,11
Flapjack,malganis,669,druid,balance,18,7,11
Onecalf,tichondrius,668,druid,balance,12,7,5
Rastafan,proudmoore,668,druid,balance,18,7,11
Wresty,frostmourne,667,druid,balance,12,7,5
Jackalman,tanaris,666,druid,balance,12,7,5
Krunge,frostwolf,665,druid,balance,12,7,5
Coqeh,frostwolf,664,druid,balance,12,7,5
Beammz,stormrage,664,druid,balance,15,8,7
Pao,nordrassil,664,druid,balance,18,7,11
Kångåwalafox,sargeras,663,druid,balance,12,7,5
Nazrelar,ragnaros,663,druid,balance,26,10,16
Edrielin,quelthalas,657,druid,balance,12,7,5
Bigolehoe,tichondrius,654,druid,balance,17,7,10
Veraciouss,sargeras,652,druid,balance,18,10,8
Dsoul,tichondrius,639,druid,balance,17,7,10
Spacéchicken,stormrage,638,druid,balance,10,8,2
Hancalimon,nemesis,634,druid,balance,26,8,18
Ilovebutter,illidan,624,druid,balance,9,8,1
Tumblr,terenas,624,druid,balance,9,7,2
Neurologist,tichondrius,623,druid,balance,11,7,4
Marakar,nazjatar,622,druid,balance,17,7,10
Gutanamo,stormrage,620,druid,balance,14,8,6
Chankletta,quelthalas,618,druid,balance,18,8,10
Lawnkin,dalaran,608,druid,balance,16,7,9
Murkdruid,frostmourne,607,druid,balance,14,7,7
Feldstarx,stormrage,607,druid,balance,14,7,7
Bleedsxd,tichondrius,606,druid,balance,14,7,7
Instinctuals,sargeras,606,druid,balance,14,7,7
Lunnæ,ragnaros,595,druid,balance,14,7,7
Razzldazzle,thrall,590,druid,balance,13,7,6
Fifthelement,tichondrius,587,druid,balance,11,8,3
Juìcedbro,illidan,576,druid,balance,6,6,0
Prev,arathor,576,druid,balance,6,6,0
Ory,illidan,576,druid,balance,6,6,0
Saltbae,velen,576,druid,balance,6,6,0
Boogietease,frostmourne,576,druid,balance,6,6,0
Nardwaur,tichondrius,576,druid,balance,6,6,0
Theshy,tanaris,576,druid,balance,6,6,0
Khayman,sargeras,576,druid,balance,6,6,0
Cattpiss,tichondrius,576,druid,balance,6,6,0
Starship,frostmourne,576,druid,balance,6,6,0
Animatronz,area-52,576,druid,balance,6,6,0
Dabshifter,tichondrius,576,druid,balance,6,6,0
Trynayeet,area-52,576,druid,balance,6,6,0
Claws,elune,576,druid,balance,6,6,0
Starsùrge,moon-guard,576,druid,balance,6,6,0
Shyn,goldrinn,576,druid,balance,12,6,6
Zgg,ragnaros,576,druid,balance,12,6,6
Jacknit,illidan,576,druid,balance,12,6,6
Tone,illidan,576,druid,balance,12,6,6
Juqzy,area-52,576,druid,balance,12,6,6
Scykin,stormrage,576,druid,balance,12,6,6
Jamuestus,illidan,576,druid,balance,12,6,6
Peteybears,stormrage,576,druid,balance,12,6,6
Kitem,tichondrius,576,druid,balance,12,6,6
Bamfferal,tichondrius,576,druid,balance,12,6,6
Amundruid,area-52,576,druid,balance,12,6,6
Drulicious,tichondrius,576,druid,balance,12,6,6
Treehard,malganis,576,druid,balance,12,6,6
Nerfdemo,kiljaeden,576,druid,balance,12,6,6
Zaaduu,tichondrius,576,druid,balance,12,6,6
Dalaverrunis,tichondrius,576,druid,balance,12,6,6
Cronosphere,stormrage,576,druid,balance,12,6,6
Mkong,tichondrius,576,druid,balance,12,6,6
Jonnytsunami,the-forgotten-coast,576,druid,balance,12,6,6
Natureww,sargeras,576,druid,balance,12,6,6
Maidah,malganis,576,druid,balance,12,6,6
Dazedru,stormrage,576,druid,balance,12,6,6
Chickenaeg,stormrage,576,druid,balance,12,6,6
Cowchicken,zuljin,576,druid,balance,12,6,6
Jaspen,bleeding-hollow,576,druid,balance,12,6,6
Polyproof,emerald-dream,576,druid,balance,12,6,6
Celetra,kiljaeden,576,druid,balance,12,6,6
Brocooli,tichondrius,576,druid,balance,12,6,6
Loadstar,burning-blade,576,druid,balance,12,6,6
Gâlaxy,sargeras,576,druid,balance,12,6,6
Fedidão,azralon,576,druid,balance,12,6,6
Moonkid,barthilas,576,druid,balance,12,6,6
Exiledruid,area-52,576,druid,balance,12,6,6
Sorrytofaded,tichondrius,576,druid,balance,12,6,6
Shwìftmend,area-52,576,druid,balance,12,6,6
Skydín,stormrage,576,druid,balance,12,6,6
Runforest,tichondrius,576,druid,balance,12,6,6
Tewdee,magtheridon,576,druid,balance,12,6,6
Grayfan,malganis,576,druid,balance,12,6,6
Expatcow,tichondrius,576,druid,balance,12,6,6
Toolboy,tichondrius,576,druid,balance,12,6,6
Jmackd,frostmourne,576,druid,balance,12,6,6
Pincho,hyjal,576,druid,balance,12,6,6
Ggae,tichondrius,576,druid,balance,12,6,6
Gigathicc,malganis,576,druid,balance,12,6,6
Icancarryyou,darkspear,576,druid,balance,12,6,6
Formz,nagrand,576,druid,balance,12,6,6
Tylërðûrðên,sargeras,576,druid,balance,12,6,6
Nýla,stormrage,576,druid,balance,12,6,6
Hellabandzup,drakthul,576,druid,balance,12,6,6
Còry,kiljaeden,576,druid,balance,12,6,6
Bar,stormrage,576,druid,balance,12,6,6
Cantheal,frostmourne,576,druid,balance,12,6,6
Iefts,stormrage,576,druid,balance,12,6,6
Nature,haomarush,576,druid,balance,12,6,6
Cukld,tichondrius,576,druid,balance,12,6,6
Slütcakes,tichondrius,576,druid,balance,12,6,6
Beomjun,tichondrius,576,druid,balance,12,6,6
Lolimatree,proudmoore,576,druid,balance,12,6,6
Notpodruida,tichondrius,576,druid,balance,13,6,7
Sample,dark-iron,576,druid,balance,18,6,12
Faletra,eitrigg,576,druid,balance,18,6,12
Doomky,area-52,576,druid,balance,18,6,12
Kujo,bloodhoof,576,druid,balance,18,6,12
Sooey,wyrmrest-accord,576,druid,balance,18,6,12
Longnus,stormrage,576,druid,balance,18,6,12
Droodad,mannoroth,576,druid,balance,18,6,12
Gåiâ,malganis,576,druid,balance,18,6,12
Drphilsmith,moon-guard,576,druid,balance,18,6,12
Rejufang,sargeras,575,druid,balance,6,6,0
Beamin,thunderlord,575,druid,balance,12,6,6
Guybranch,illidan,575,druid,balance,12,6,6
Chodkiewicz,echo-isles,575,druid,balance,12,6,6
Macpoulet,aggramar,575,druid,balance,12,6,6
Zieda,sisters-of-elune,575,druid,balance,12,6,6
Miçangak,azralon,575,druid,balance,12,6,6
Emolia,amanthul,575,druid,balance,12,6,6
Dibinha,azralon,575,druid,balance,12,6,6
Ebichu,fenris,575,druid,balance,12,6,6
Runarok,ragnaros,575,druid,balance,12,6,6
Tariksha,sargeras,575,druid,balance,12,6,6
Turnpike,exodar,575,druid,balance,12,6,6
Ahruan,stormrage,575,druid,balance,18,6,12
Tiju,wyrmrest-accord,575,druid,balance,18,6,12
Sokodruid,tichondrius,575,druid,balance,18,6,12
Einraedon,dalaran,575,druid,balance,18,6,12
Samelthios,proudmoore,575,druid,balance,20,6,14
Mirialia,alexstrasza,574,druid,balance,12,6,6
Painsbrook,thrall,574,druid,balance,12,6,6
Idontknowbro,bonechewer,574,druid,balance,12,6,6
Dradugun,hyjal,574,druid,balance,12,6,6
Quagsire,moon-guard,574,druid,balance,18,6,12
Xinnii,illidan,573,druid,balance,18,7,11
Shorthorn,mannoroth,571,druid,balance,12,6,6
Proñgs,tichondrius,566,druid,balance,12,6,6
Æpex,zuljin,544,druid,balance,10,6,4
Matock,malganis,543,druid,balance,11,6,5
Casaran,anetheron,543,druid,balance,11,6,5
Hchhi,ragnaros,543,druid,balance,14,7,7
Boufa,dentarg,527,druid,balance,9,7,2
Tzboo,stormrage,527,druid,balance,15,6,9
Guron,aegwynn,526,druid,balance,27,6,21
Imhealer,drakkari,522,druid,balance,17,8,9
Nyxlie,stormrage,512,druid,balance,10,6,4
Schlaankeyy,stormrage,512,druid,balance,16,6,10
Velais,exodar,512,druid,balance,22,6,16
Gemineye,stormrage,511,druid,balance,11,6,5
Istayfrawsty,darkspear,511,druid,balance,14,6,8
Tulkan,kelthuzad,508,druid,balance,15,7,8
Rank,nerzhul,496,druid,balance,13,6,7
Beestwithin,illidan,480,druid,balance,6,5,1
Solju,farstriders,480,druid,balance,6,5,1
Arwëna,tichondrius,480,druid,balance,6,5,1
Daroot,spinebreaker,480,druid,balance,6,5,1
Aoewynn,nerzhul,480,druid,balance,6,5,1
Smitebacklol,tichondrius,480,druid,balance,6,5,1
Ulfaar,frostmourne,480,druid,balance,6,5,1
Babybite,frostmourne,480,druid,balance,6,5,1
Joink,sargeras,480,druid,balance,6,5,1
Alindrä,moon-guard,480,druid,balance,6,5,1
Dtefy,ragnaros,480,druid,balance,6,5,1
Yurself,feathermoon,480,druid,balance,6,5,1
Iconicxz,malganis,480,druid,balance,6,5,1
Wassupfoo,area-52,480,druid,balance,6,5,1
Jokeclass,darkspear,480,druid,balance,6,5,1
Galadon,tichondrius,480,druid,balance,6,5,1
Biggié,bleeding-hollow,480,druid,balance,6,5,1
Prøspect,moon-guard,480,druid,balance,6,5,1
Chillaxin,gundrak,480,druid,balance,6,5,1
Rastakant,malganis,480,druid,balance,6,5,1
Swergz,tichondrius,480,druid,balance,6,5,1
Dojacat,tichondrius,480,druid,balance,6,5,1
Nephsis,kelthuzad,480,druid,balance,6,5,1
Rowdie,area-52,480,druid,balance,6,5,1
Azurehoof,earthen-ring,480,druid,balance,6,5,1
Horizøns,gorefiend,480,druid,balance,6,5,1
Tïgerpawz,stormrage,480,druid,balance,6,5,1
Fattdiabetic,tichondrius,480,druid,balance,6,5,1
Malafaïa,nemesis,480,druid,balance,6,5,1
Beamlord,frostmourne,480,druid,balance,6,5,1
Canuatemyrat,tichondrius,480,druid,balance,6,5,1
Guår,tichondrius,480,druid,balance,6,5,1
Yokux,thunderlord,480,druid,balance,6,5,1
Chikojuan,tichondrius,480,druid,balance,6,5,1
ßælot,quelthalas,480,druid,balance,6,5,1
Psychosocîal,kiljaeden,480,druid,balance,6,5,1
Ragiix,tichondrius,480,druid,balance,6,5,1
Megåtron,kelthuzad,480,druid,balance,6,5,1
Coramoor,mannoroth,480,druid,balance,6,5,1
Sandriuzs,nemesis,480,druid,balance,6,5,1
Mithroi,tichondrius,480,druid,balance,6,5,1
Hooffy,emerald-dream,480,druid,balance,6,5,1
Crazystarz,frostmourne,480,druid,balance,6,5,1
Atrocitÿ,tichondrius,480,druid,balance,11,5,6
Thebass,spinebreaker,480,druid,balance,12,5,7
Ragerag,trollbane,480,druid,balance,12,5,7
Intrinsiic,area-52,480,druid,balance,12,5,7
Havócdh,tichondrius,480,druid,balance,12,5,7
Zimah,illidan,480,druid,balance,12,5,7
Helpmeimbad,stormrage,480,druid,balance,12,5,7
Paintlicker,emerald-dream,480,druid,balance,12,5,7
Sodacream,illidan,480,druid,balance,12,5,7
Amarexf,stormrage,480,druid,balance,12,5,7
Psycloned,undermine,480,druid,balance,12,5,7
Trenboloone,area-52,480,druid,balance,12,5,7
Môistman,tichondrius,480,druid,balance,12,5,7
Stumphugger,tichondrius,480,druid,balance,12,5,7
Bearwithit,sargeras,480,druid,balance,12,5,7
Milkmoneymeo,illidan,480,druid,balance,12,5,7
Clubs,sargeras,480,druid,balance,12,5,7
Drufasä,sargeras,480,druid,balance,12,5,7
Akay,bonechewer,480,druid,balance,12,5,7
Deathprofit,thrall,480,druid,balance,12,5,7
Salanzô,bleeding-hollow,480,druid,balance,12,5,7
Bigtammy,moon-guard,480,druid,balance,12,5,7
Bigdaddyferg,illidan,480,druid,balance,12,5,7
Cynderellaa,proudmoore,480,druid,balance,12,5,7
Nöches,quelthalas,480,druid,balance,12,5,7
Zuga,the-venture-co,480,druid,balance,12,5,7
Sharkfighter,sargeras,480,druid,balance,12,5,7
Tugboat,saurfang,480,druid,balance,12,5,7
Cloninglol,darkspear,480,druid,balance,12,5,7
Hream,echo-isles,480,druid,balance,12,5,7
Uggadruid,malganis,480,druid,balance,12,5,7
Bubblybear,winterhoof,480,druid,balance,12,5,7
Saucyy,malganis,480,druid,balance,12,5,7
Beastin,queldorei,480,druid,balance,12,5,7
Ornaaga,blackrock,480,druid,balance,12,5,7
Toptrolls,illidan,480,druid,balance,12,5,7
Voelcan,tichondrius,480,druid,balance,12,5,7
Phatpat,illidan,480,druid,balance,12,5,7
Fakechower,stormreaver,480,druid,balance,12,5,7
Lickmypaws,sargeras,480,druid,balance,12,5,7
Ripter,moon-guard,480,druid,balance,12,5,7
Deergut,illidan,480,druid,balance,12,5,7
Lutze,frostmourne,480,druid,balance,12,5,7
Jujubeartank,darkspear,480,druid,balance,12,5,7
Redness,daggerspine,480,druid,balance,12,5,7
Trippykitty,tichondrius,480,druid,balance,12,5,7
Cassatopia,zuljin,480,druid,balance,12,5,7
Kumataku,emerald-dream,480,druid,balance,12,5,7
Kushkilla,malganis,480,druid,balance,12,5,7
Rokdx,barthilas,480,druid,balance,12,5,7
Mikoxarekt,area-52,480,druid,balance,12,5,7
Öomkinn,sargeras,480,druid,balance,12,5,7
Stratego,drenden,480,druid,balance,12,5,7
Coomlauncher,area-52,480,druid,balance,16,6,10
Verdagris,skullcrusher,480,druid,balance,18,5,13
Boomiè,tichondrius,480,druid,balance,18,5,13
Tuppyboom,barthilas,480,druid,balance,24,5,19
Bâgheera,sargeras,479,druid,balance,6,5,1
Wtfiisthis,tichondrius,479,druid,balance,6,5,1
Ðeepsixx,burning-legion,479,druid,balance,12,5,7
Angelbigbutt,borean-tundra,479,druid,balance,12,5,7
Raknary,kelthuzad,479,druid,balance,12,5,7
Damallis,anubarak,479,druid,balance,12,5,7
Palermo,aerie-peak,479,druid,balance,12,5,7
Smhyle,frostmourne,479,druid,balance,12,5,7
Cdrü,illidan,479,druid,balance,13,5,8
Edinhalfhorn,bonechewer,479,druid,balance,18,5,13
Loggoruk,illidan,479,druid,balance,18,5,13
Darkdragoonz,barthilas,479,druid,balance,18,5,13
Morphntime,blackrock,479,druid,balance,18,5,13
Sunneater,azuremyst,478,druid,balance,12,5,7
Nahlem,greymane,478,druid,balance,12,5,7
Mantis,the-underbog,478,druid,balance,12,5,7
Wardruidkvn,stormreaver,474,druid,balance,35,5,30
Boomtre,malganis,463,druid,balance,11,5,6
Twrixi,caelestrasz,463,druid,balance,17,5,12
Formgodx,malganis,448,druid,balance,16,5,11
Bearcathawk,sargeras,447,druid,balance,11,5,6
Kyuub,barthilas,446,druid,balance,11,5,6
Thunderwolf,malganis,432,druid,balance,9,6,3
Féralis,sargeras,431,druid,balance,11,5,6
Azshunara,moon-guard,431,druid,balance,11,5,6
Shiftzy,thrall,426,druid,balance,10,6,4
Krooksy,tichondrius,426,druid,balance,14,6,8
Shuja,wyrmrest-accord,426,druid,balance,15,6,9
Theriomorph,barthilas,424,druid,balance,28,6,22
Feond,illidan,416,druid,balance,10,5,5
Thebruiser,baelgun,415,druid,balance,14,5,9
Gigajuiced,proudmoore,400,druid,balance,7,5,2
Äbÿss,tichondrius,400,druid,balance,7,5,2
Altha,proudmoore,400,druid,balance,13,5,8
Lukass,tichondrius,384,druid,balance,6,4,2
Goncko,ragnaros,384,druid,balance,6,4,2
Tankyguy,ragnaros,384,druid,balance,6,4,2
Selfplay,barthilas,384,druid,balance,6,4,2
Tinishaker,ragnaros,384,druid,balance,6,4,2
Mmbessa,tichondrius,384,druid,balance,6,4,2
Trogshift,blackrock,384,druid,balance,6,4,2
Astralboom,stormrage,384,druid,balance,6,4,2
Sabretoóth,malganis,384,druid,balance,6,4,2
Matinee,tichondrius,384,druid,balance,6,4,2
Manbeartree,malganis,384,druid,balance,6,4,2
Ðrood,bleeding-hollow,384,druid,balance,6,4,2
Déi,malganis,384,druid,balance,6,4,2
Blams,stormrage,384,druid,balance,6,4,2
Boomkinbob,malganis,384,druid,balance,6,4,2
Nicklul,llane,384,druid,balance,6,4,2
Drmnheal,frostmourne,384,druid,balance,6,4,2
Lyingcat,mannoroth,384,druid,balance,6,4,2
Hbf,tichondrius,384,druid,balance,6,4,2
Kiddohhz,tichondrius,384,druid,balance,6,4,2
Spèèdy,illidan,384,druid,balance,6,4,2
Nevershiftx,kirin-tor,384,druid,balance,6,4,2
Tchalla,detheroc,384,druid,balance,6,4,2
Beastboyy,tichondrius,384,druid,balance,6,4,2
Socknsandals,tichondrius,384,druid,balance,6,4,2
Xanybarz,stormrage,384,druid,balance,6,4,2
Twostars,thrall,384,druid,balance,6,4,2
Asharä,mannoroth,384,druid,balance,6,4,2
Nahelae,tichondrius,384,druid,balance,6,4,2
Nightshift,dalvengyr,384,druid,balance,6,4,2
Sschakall,tol-barad,384,druid,balance,6,4,2
Whitehaze,proudmoore,384,druid,balance,6,4,2
Critkatbear,detheroc,384,druid,balance,6,4,2
Medsurgdruid,emerald-dream,384,druid,balance,6,4,2
Seekamp,khazgoroth,384,druid,balance,6,4,2
Dokasaurus,lightbringer,384,druid,balance,6,4,2
Fuzzytaco,stormrage,384,druid,balance,6,4,2
Kunigami,malganis,384,druid,balance,6,4,2
Germainee,shandris,384,druid,balance,6,4,2
Silvshifter,frostmourne,384,druid,balance,6,4,2
Bambozled,sargeras,384,druid,balance,6,4,2
Stormbeef,tichondrius,384,druid,balance,6,4,2
Cujjoh,tichondrius,384,druid,balance,6,4,2
Kornobluss,azralon,384,druid,balance,6,4,2
Küb,sargeras,384,druid,balance,6,4,2
Leefman,tichondrius,384,druid,balance,6,4,2
Grandsoleil,tichondrius,384,druid,balance,6,4,2
Shinazugawa,maiev,384,druid,balance,6,4,2
Mcdizzil,bloodscalp,384,druid,balance,6,4,2
Orgnalf,area-52,384,druid,balance,6,4,2
Givemethatcr,tichondrius,384,druid,balance,6,4,2
Söökie,tichondrius,384,druid,balance,6,4,2
Nidalie,frostmourne,384,druid,balance,6,4,2
Deelark,skywall,384,druid,balance,6,4,2
Lunchßox,emerald-dream,384,druid,balance,6,4,2
Zxve,stormrage,384,druid,balance,6,4,2
Korlstone,zuljin,384,druid,balance,6,4,2
Sethfurian,magtheridon,384,druid,balance,6,4,2
Joiczar,maelstrom,384,druid,balance,6,4,2
Bäyter,tichondrius,384,druid,balance,6,4,2
Kkamagwi,illidan,384,druid,balance,6,4,2
Mesteno,proudmoore,384,druid,balance,6,4,2
Gameisass,illidan,384,druid,balance,6,4,2
Oscillater,illidan,384,druid,balance,6,4,2
Duo,demon-soul,384,druid,balance,6,4,2
Gønkh,quelthalas,384,druid,balance,6,4,2
Qyuka,area-52,384,druid,balance,6,4,2
Sxc,frostmourne,384,druid,balance,6,4,2
Luvgames,area-52,384,druid,balance,6,4,2
Bäldir,dalaran,384,druid,balance,6,4,2
Somarythe,moon-guard,384,druid,balance,6,4,2
Kiwidru,frostmourne,384,druid,balance,6,4,2
Splintered,kelthuzad,384,druid,balance,6,4,2
Shroudyroudy,dalaran,384,druid,balance,6,4,2
Peterdeleter,emerald-dream,384,druid,balance,6,4,2
Jherdugo,durotan,384,druid,balance,6,4,2
Anamoorphicc,kelthuzad,384,druid,balance,6,4,2
Elonmuskirl,illidan,384,druid,balance,6,4,2
Domord,stormrage,384,druid,balance,6,4,2
Yoshí,emerald-dream,384,druid,balance,6,4,2
Hypernovax,tichondrius,384,druid,balance,10,5,5
Forest,frostmourne,384,druid,balance,10,5,5
Balancz,thrall,384,druid,balance,10,5,5
Erwelz,quelthalas,384,druid,balance,10,5,5
Stormclaw,elune,384,druid,balance,12,4,8
Donti,laughing-skull,384,druid,balance,12,4,8
Slottpocket,malganis,384,druid,balance,12,4,8
Omnipaw,kelthuzad,384,druid,balance,12,4,8
Aexs,kelthuzad,384,druid,balance,12,4,8
Menlove,area-52,384,druid,balance,12,4,8
Bowlpacka,malganis,384,druid,balance,12,4,8
Altius,drakkari,384,druid,balance,12,4,8
Lifeforcer,barthilas,384,druid,balance,12,4,8
Bigsmurph,illidan,384,druid,balance,12,4,8
Tasselhoof,hyjal,384,druid,balance,12,4,8
Blipshift,tichondrius,384,druid,balance,12,4,8
Shanadris,stormrage,384,druid,balance,12,4,8
Siöux,kelthuzad,384,druid,balance,12,4,8
Astería,sentinels,384,druid,balance,12,4,8
Alexserina,dalaran,384,druid,balance,12,4,8
Winmax,tichondrius,384,druid,balance,12,4,8
Darkangle,ysera,384,druid,balance,12,4,8
Zenowl,turalyon,384,druid,balance,12,4,8
Bignosecow,illidan,384,druid,balance,12,4,8
Toxyflex,tichondrius,384,druid,balance,12,4,8
Skylightt,illidan,384,druid,balance,12,4,8
Simo,kaelthas,384,druid,balance,12,4,8
Shinoßi,area-52,384,druid,balance,12,4,8
Veyrønn,stormrage,384,druid,balance,12,4,8
Sinistuhd,tichondrius,384,druid,balance,12,4,8
Lutein,tichondrius,384,druid,balance,12,4,8
Soreze,kelthuzad,384,druid,balance,12,4,8
Jakermans,area-52,384,druid,balance,12,4,8
Laycan,azralon,384,druid,balance,12,4,8
Dirtytiger,sargeras,384,druid,balance,12,4,8
Wintarz,sargeras,384,druid,balance,12,4,8
Amaryllis,the-underbog,384,druid,balance,12,4,8
Lilrichdps,sargeras,384,druid,balance,12,4,8
Greemer,sargeras,384,druid,balance,12,4,8
Cathelyana,tichondrius,384,druid,balance,16,5,11
ßullx,quelthalas,384,druid,balance,14,4,10
Spatulas,malganis,384,druid,balance,18,4,14
Katdog,warsong,384,druid,balance,18,4,14
Plopperoo,caelestrasz,384,druid,balance,18,4,14
Aessinawisp,frostmourne,383,druid,balance,6,4,2
Kukulkann,tichondrius,383,druid,balance,6,4,2
Chatdôux,zuljin,383,druid,balance,6,4,2
Balthøs,moon-guard,383,druid,balance,6,4,2
Papitank,drakkari,383,druid,balance,6,4,2
Samesaras,darkspear,383,druid,balance,6,4,2
Kornaz,guldan,383,druid,balance,6,4,2
Bitechew,frostmourne,383,druid,balance,6,4,2
Donokokiya,destromath,383,druid,balance,6,4,2
Thiccybear,darkspear,383,druid,balance,6,4,2
Xisloko,azralon,383,druid,balance,6,4,2
Scienttific,malganis,383,druid,balance,12,4,8
Ranchdußois,illidan,383,druid,balance,12,4,8
Tïcks,illidan,383,druid,balance,12,4,8
Skke,barthilas,383,druid,balance,12,4,8
Boomanon,illidan,382,druid,balance,6,4,2
Nukaboom,elune,382,druid,balance,6,4,2
Korduroi,malygos,380,druid,balance,12,4,8
Teladrizzle,dalaran,351,druid,balance,11,4,7
Rahdek,azgalor,330,druid,balance,7,5,2
Kimnim,tichondrius,330,druid,balance,9,6,3
Ihjx,sargeras,330,druid,balance,11,6,5
Yangrou,tichondrius,330,druid,balance,11,5,6
Telvannì,sargeras,330,druid,balance,12,5,7
Tugond,tichondrius,330,druid,balance,22,5,17
Mythianan,aggramar,328,druid,balance,10,7,3
Raquelíta,stormrage,319,druid,balance,5,4,1
Tehnklox,malorne,319,druid,balance,5,4,1
Riddickd,malfurion,288,druid,balance,11,6,5
Jayroneowo,frostmourne,288,druid,balance,6,3,3
Rhorr,frostmourne,288,druid,balance,6,3,3
Papacard,stormrage,288,druid,balance,6,3,3
Sypìí,stormrage,288,druid,balance,6,3,3
Bhíkkhu,stormrage,288,druid,balance,6,3,3
Çãñçèr,frostmourne,288,druid,balance,6,3,3
Ferar,frostmourne,288,druid,balance,6,3,3
Taztoc,stormrage,288,druid,balance,6,3,3
Pergutory,frostmourne,288,druid,balance,6,3,3
Kî,thunderlord,288,druid,balance,6,3,3
Deimos,jubeithos,288,druid,balance,6,3,3
Marcee,frostmourne,288,druid,balance,6,3,3
Sáwá,frostmourne,288,druid,balance,6,3,3
Haffö,gundrak,288,druid,balance,6,3,3
Celestialife,frostmourne,288,druid,balance,6,3,3
Alleae,stormrage,288,druid,balance,6,3,3
Rektx,area-52,288,druid,balance,6,3,3
Luuxia,tichondrius,288,druid,balance,6,3,3
Woopsie,malfurion,288,druid,balance,6,3,3
Sowo,sargeras,288,druid,balance,6,3,3
Druidma,aegwynn,288,druid,balance,6,3,3
Pawpa,daggerspine,288,druid,balance,6,3,3
Hallwanted,area-52,288,druid,balance,6,3,3
Ohsnapz,silvermoon,288,druid,balance,6,3,3
Azoth,hyjal,288,druid,balance,6,3,3
Artimedian,kiljaeden,288,druid,balance,6,3,3
Tokyotimxoxx,area-52,288,druid,balance,6,3,3
Jammi,skywall,288,druid,balance,6,3,3
Revitalize,shadowsong,288,druid,balance,6,3,3
Besto,moon-guard,288,druid,balance,6,3,3
Nidalie,zuljin,288,druid,balance,6,3,3
Ghostboy,zuljin,288,druid,balance,6,3,3
Haaha,area-52,288,druid,balance,6,3,3
Gorillavoke,tichondrius,288,druid,balance,6,3,3
Teribad,area-52,288,druid,balance,6,3,3
Icefang,tichondrius,288,druid,balance,6,3,3
Tanakoi,zuljin,288,druid,balance,6,3,3
Rykudruid,azuremyst,288,druid,balance,6,3,3
Thumpb,bronzebeard,288,druid,balance,6,3,3
Jabawockdeez,area-52,288,druid,balance,6,3,3
Ÿùp,tichondrius,288,druid,balance,6,3,3
Fengfeidruid,illidan,288,druid,balance,6,3,3
Vykarux,suramar,288,druid,balance,6,3,3
Shaftomatic,tichondrius,288,druid,balance,6,3,3
Voodoopipe,tichondrius,288,druid,balance,6,3,3
Iploopedyogf,bleeding-hollow,288,druid,balance,6,3,3
Dauncy,sargeras,288,druid,balance,6,3,3
Jerm,coilfang,288,druid,balance,6,3,3
Tsochickenn,bleeding-hollow,288,druid,balance,6,3,3
Superwrath,khaz-modan,288,druid,balance,6,3,3
Kaldelar,emerald-dream,288,druid,balance,6,3,3
Cbark,ravencrest,288,druid,balance,6,3,3
Beörne,sargeras,288,druid,balance,6,3,3
Spooser,proudmoore,288,druid,balance,6,3,3
Loren,gorefiend,288,druid,balance,6,3,3
Wuckfød,tichondrius,288,druid,balance,6,3,3
Leafthief,whisperwind,288,druid,balance,6,3,3
Alcorria,area-52,288,druid,balance,6,3,3
Akiza,sargeras,288,druid,balance,6,3,3
Shalaz,magtheridon,288,druid,balance,6,3,3
Guidoanchovz,thrall,288,druid,balance,6,3,3
Jpylm,ysera,288,druid,balance,6,3,3
Bridgerén,tichondrius,288,druid,balance,6,3,3
Eightozpatty,tichondrius,288,druid,balance,6,3,3
Boomkinks,moon-guard,288,druid,balance,6,3,3
Cutely,tichondrius,288,druid,balance,6,3,3
Ménd,thrall,288,druid,balance,6,3,3
Fauck,illidan,288,druid,balance,6,3,3
Silynce,tichondrius,288,druid,balance,6,3,3
Crotchlicker,bloodscalp,288,druid,balance,6,3,3
Rúdo,quelthalas,288,druid,balance,6,3,3
Yëeëeëeëehaw,illidan,288,druid,balance,6,3,3
Druidnim,tichondrius,288,druid,balance,6,3,3
Kalalana,illidan,288,druid,balance,6,3,3
Xiaoguai,tichondrius,288,druid,balance,6,3,3
Teddybëar,illidan,288,druid,balance,6,3,3
Delrin,garona,288,druid,balance,6,3,3
Bleedum,guldan,288,druid,balance,6,3,3
Pacmaynè,illidan,288,druid,balance,6,3,3
Sodah,tichondrius,288,druid,balance,6,3,3
Silkyroad,tichondrius,288,druid,balance,6,3,3
Targeted,sargeras,288,druid,balance,6,3,3
Bearys,area-52,288,druid,balance,6,3,3
Laazz,area-52,288,druid,balance,6,3,3
Icastsmells,tichondrius,288,druid,balance,6,3,3
Scudbomb,kelthuzad,288,druid,balance,6,3,3
Sylvanna,tichondrius,288,druid,balance,6,3,3
Levelboostx,tichondrius,288,druid,balance,6,3,3
Noheárt,kelthuzad,288,druid,balance,6,3,3
Endingitall,illidan,288,druid,balance,6,3,3
Däll,tichondrius,288,druid,balance,6,3,3
Healthycow,illidan,288,druid,balance,6,3,3
Jxred,illidan,288,druid,balance,6,3,3
Jyuaiai,tichondrius,288,druid,balance,6,3,3
Krittykitkat,chogall,288,druid,balance,9,4,5
Vawdka,proudmoore,288,druid,balance,9,4,5
Bigswaag,malganis,288,druid,balance,7,3,4
Xail,hyjal,288,druid,balance,8,3,5
Retsarehard,illidan,288,druid,balance,8,3,5
Wreckingcrew,emerald-dream,288,druid,balance,8,3,5
Kitsurumi,ragnaros,288,druid,balance,12,3,9
Hottiecake,bronzebeard,288,druid,balance,12,3,9
Tsaß,bleeding-hollow,288,druid,balance,12,3,9
Machinex,illidan,288,druid,balance,12,3,9
Feyrien,dalaran,288,druid,balance,12,3,9
Drchronic,boulderfist,288,druid,balance,12,3,9
Nintrus,nazjatar,288,druid,balance,12,3,9
Mulgorer,tichondrius,288,druid,balance,12,3,9
Evarene,vashj,288,druid,balance,12,3,9
Scythé,stormrage,288,druid,balance,12,3,9
Cêania,moon-guard,288,druid,balance,12,3,9
Alalletsa,destromath,288,druid,balance,12,3,9
Koan,proudmoore,288,druid,balance,12,3,9
Teyollocuani,sargeras,288,druid,balance,12,3,9
Boomybum,bleeding-hollow,288,druid,balance,12,3,9
Loathe,korialstrasz,288,druid,balance,12,3,9
Plye,korgath,288,druid,balance,12,3,9
Guusx,bonechewer,288,druid,balance,12,3,9
Xalstarrot,sargeras,288,druid,balance,12,3,9
Uezzon,tol-barad,288,druid,balance,12,3,9
Nightnes,sargeras,288,druid,balance,12,3,9
Meowzedon,sargeras,288,druid,balance,12,3,9
Davelombardo,tichondrius,288,druid,balance,12,3,9
Killersilent,quelthalas,288,druid,balance,18,3,15
Ravii,nemesis,287,druid,balance,6,3,3
Wweegyy,tichondrius,287,druid,balance,6,3,3
Johnee,barthilas,287,druid,balance,6,3,3
Guston,lightbringer,287,druid,balance,6,3,3
Dainerysz,proudmoore,286,druid,balance,6,3,3
Biig,stormreaver,275,druid,balance,11,9,2
Teeball,tichondrius,271,druid,balance,17,3,14
Clownprince,barthilas,256,druid,balance,10,3,7
Daltius,illidan,256,druid,balance,10,3,7
Vollzar,sargeras,255,druid,balance,11,3,8
Trahfnahrumn,moon-guard,240,druid,balance,9,3,6
Pixelface,frostmourne,239,druid,balance,5,3,2
Oddclaw,stormrage,239,druid,balance,5,3,2
Bigtoeess,tichondrius,239,druid,balance,5,3,2
Verielda,skullcrusher,239,druid,balance,5,3,2
Wintrader,zuljin,239,druid,balance,5,3,2
Corym,frostmourne,239,druid,balance,11,3,8
Dipdodge,illidan,224,druid,balance,10,3,7
Mclarenz,frostmourne,223,druid,balance,8,3,5
Variandruid,kelthuzad,223,druid,balance,8,3,5
Mkat,illidan,223,druid,balance,8,3,5
Jazzman,jubeithos,223,druid,balance,14,3,11
Eden,thrall,223,druid,balance,14,3,11
Flummoz,frostmourne,192,druid,balance,4,3,1
Niwßor,azralon,192,druid,balance,10,4,6
Zigh,azralon,192,druid,balance,6,2,4
Saìyori,area-52,192,druid,balance,6,2,4
Loodichriss,area-52,192,druid,balance,6,2,4
Lilgushy,area-52,192,druid,balance,6,2,4
Tansdruid,area-52,192,druid,balance,6,2,4
Flarkage,area-52,192,druid,balance,6,2,4
Crycloné,stormrage,192,druid,balance,6,2,4
Bubblebraìn,area-52,192,druid,balance,6,2,4
Hzu,kelthuzad,192,druid,balance,6,2,4
Sydneey,kelthuzad,192,druid,balance,6,2,4
Skig,stormreaver,192,druid,balance,6,2,4
Moonhorn,kelthuzad,192,druid,balance,6,2,4
Maélstrom,goldrinn,192,druid,balance,6,2,4
Aquaarius,nemesis,192,druid,balance,6,2,4
Alagorn,zangarmarsh,192,druid,balance,6,2,4
Arienne,kelthuzad,192,druid,balance,6,2,4
Mòónwhisper,moon-guard,192,druid,balance,6,2,4
Isunami,emerald-dream,192,druid,balance,6,2,4
Pleomorpher,quelthalas,192,druid,balance,6,2,4
Hagenws,azralon,192,druid,balance,6,2,4
Lilherb,azralon,192,druid,balance,6,2,4
Lindsanr,illidan,192,druid,balance,6,2,4
Aprendíz,azralon,192,druid,balance,6,2,4
Srbestias,quelthalas,192,druid,balance,6,2,4
Potus,illidan,192,druid,balance,6,2,4
Deadpoóll,area-52,192,druid,balance,6,2,4
Adonalsium,area-52,192,druid,balance,6,2,4
Malffurryan,draktharon,192,druid,balance,6,2,4
Jackdru,illidan,192,druid,balance,6,2,4
Lappz,malganis,192,druid,balance,6,2,4
Markóla,stormrage,192,druid,balance,6,2,4
Sweetcat,malganis,192,druid,balance,6,2,4
Spicyorange,dalaran,192,druid,balance,6,2,4
Jitlit,malganis,192,druid,balance,6,2,4
Hasemilë,dalaran,192,druid,balance,6,2,4
Slavenhausen,azralon,192,druid,balance,6,2,4
Luipu,elune,192,druid,balance,6,2,4
Mythicdruid,ragnaros,192,druid,balance,6,2,4
Laymonath,elune,192,druid,balance,6,2,4
Hawgs,bleeding-hollow,192,druid,balance,6,2,4
Guap,bleeding-hollow,192,druid,balance,6,2,4
Lùna,barthilas,192,druid,balance,6,2,4
Milkz,zuljin,192,druid,balance,6,2,4
Feorb,azuremyst,192,druid,balance,6,2,4
Wtfhommie,madoran,192,druid,balance,6,2,4
Mäûled,fizzcrank,192,druid,balance,6,2,4
Hoptimus,zuljin,192,druid,balance,6,2,4
Absentteeth,stormrage,192,druid,balance,6,2,4
Dedgame,malfurion,192,druid,balance,6,2,4
Hawtzi,stormrage,192,druid,balance,6,2,4
Criturpantz,garrosh,192,druid,balance,6,2,4
Empowers,garrosh,192,druid,balance,6,2,4
Octacer,malfurion,192,druid,balance,6,2,4
Wokker,mannoroth,192,druid,balance,6,2,4
Shredstitute,tichondrius,192,druid,balance,6,2,4
Bigboomy,sargeras,192,druid,balance,6,2,4
Katherine,moon-guard,192,druid,balance,6,2,4
Chèétøhz,moon-guard,192,druid,balance,6,2,4
Mosdu,tichondrius,192,druid,balance,6,2,4
Treezyn,sargeras,192,druid,balance,6,2,4
Enyu,sargeras,192,druid,balance,6,2,4
Tp,dragonblight,192,druid,balance,6,2,4
Glynistann,bladefist,192,druid,balance,6,2,4
Xay,runetotem,192,druid,balance,6,2,4
Bullwïnkle,uther,192,druid,balance,6,2,4
Blassen,sargeras,192,druid,balance,6,2,4
Neferpitou,fenris,192,druid,balance,6,2,4
Speaks,moon-guard,192,druid,balance,6,2,4
Lunarstone,tichondrius,192,druid,balance,6,2,4
Meowed,sargeras,192,druid,balance,6,2,4
Pawswap,tichondrius,192,druid,balance,6,2,4
Centauri,shandris,192,druid,balance,6,2,4
Stones,lightbringer,192,druid,balance,6,2,4
Boomtastik,frostmourne,192,druid,balance,6,2,4
Gulrahf,wyrmrest-accord,192,druid,balance,6,2,4
Phatê,nerzhul,192,druid,balance,6,2,4
Sloppysheila,sargeras,192,druid,balance,6,2,4
Baankai,frostmourne,192,druid,balance,6,2,4
Pepee,tichondrius,192,druid,balance,6,2,4
Explicít,sargeras,192,druid,balance,6,2,4
Totorostard,tichondrius,192,druid,balance,6,2,4
Artaniss,tichondrius,192,druid,balance,6,2,4
Linful,tichondrius,192,druid,balance,6,2,4
Thriaror,proudmoore,192,druid,balance,6,2,4
Satyrø,frostmourne,192,druid,balance,6,2,4
Injeckx,tichondrius,192,druid,balance,6,2,4
Bobobear,proudmoore,192,druid,balance,6,2,4
Glowstixz,tichondrius,192,druid,balance,6,2,4
Astroprof,bloodscalp,192,druid,balance,6,2,4
Malcavelli,tichondrius,192,druid,balance,6,2,4
Cbreezyy,tichondrius,192,druid,balance,6,2,4
Blackchina,tichondrius,192,druid,balance,6,2,4
Outofreach,tichondrius,192,druid,balance,6,2,4
Hellabanx,tichondrius,192,druid,balance,6,2,4
Bomme,zuljin,192,druid,balance,7,2,5
Kångåwålafox,sargeras,192,druid,balance,8,2,6
Panchuwuanky,sargeras,192,druid,balance,8,2,6
Thundyrcat,tichondrius,192,druid,balance,12,2,10
Papaland,tichondrius,192,druid,balance,12,2,10
Unhappystill,tichondrius,192,druid,balance,12,2,10
Murrmerly,moon-guard,192,druid,balance,12,2,10
Trisinz,perenolde,192,druid,balance,12,2,10
Shalkam,stormrage,192,druid,balance,12,2,10
Gholdris,moon-guard,192,druid,balance,12,2,10
Rakuath,zuljin,192,druid,balance,12,2,10
Skaidi,quelthalas,192,druid,balance,12,2,10
Alluminax,sargeras,192,druid,balance,12,2,10
Daydaygo,illidan,192,druid,balance,12,2,10
Visûcius,moon-guard,192,druid,balance,12,2,10
Pusscat,illidan,192,druid,balance,18,2,16
Thicchicken,emerald-dream,191,druid,balance,12,2,10
Moonkingx,ragnaros,159,druid,balance,5,2,3
Xylemcow,malganis,159,druid,balance,5,2,3
Formality,kalecgos,159,druid,balance,5,2,3
Sludgischonk,stormrage,159,druid,balance,5,2,3
Stealthhero,lightbringer,159,druid,balance,5,2,3
Irontree,dunemaul,159,druid,balance,5,2,3
Mayarí,sargeras,159,druid,balance,16,3,13
Ishalu,tichondrius,138,druid,balance,6,3,3
Appitrap,emerald-dream,137,druid,balance,19,3,16
Wiseoldman,jubeithos,136,druid,balance,8,3,5
Nightruffles,moon-guard,128,druid,balance,4,2,2
Hirtenweg,stormrage,127,druid,balance,14,2,12
Aeo,frostmourne,112,druid,balance,7,2,5
Highs,sargeras,112,druid,balance,7,2,5
Stradamus,sargeras,96,druid,balance,3,2,1
Moosesolini,chogall,96,druid,balance,3,2,1
Yøpièrre,bleeding-hollow,96,druid,balance,3,2,1
Ultracatx,tichondrius,96,druid,balance,6,1,5
Feralmain,illidan,96,druid,balance,6,1,5
Sneakydikns,tichondrius,96,druid,balance,6,1,5
Caponetonejr,steamwheedle-cartel,96,druid,balance,6,1,5
Aelena,whisperwind,96,druid,balance,6,1,5
Zazinium,illidan,96,druid,balance,6,1,5
Stalfrus,area-52,96,druid,balance,6,1,5
Keithmoonkin,area-52,96,druid,balance,6,1,5
Chalupà,illidan,96,druid,balance,6,1,5
Sheeftah,illidan,96,druid,balance,6,1,5
Sundae,khazgoroth,96,druid,balance,6,1,5
Edorant,illidan,96,druid,balance,6,1,5
Bullkkake,tichondrius,96,druid,balance,6,1,5
Oyweklefga,kelthuzad,96,druid,balance,6,1,5
Bpdferal,stormrage,96,druid,balance,6,1,5
Slackoth,dalaran,96,druid,balance,6,1,5
Faldrynn,sargeras,96,druid,balance,6,1,5
Chulogringo,tichondrius,96,druid,balance,6,1,5
Mirudru,stormrage,96,druid,balance,6,1,5
Scarn,nathrezim,96,druid,balance,6,1,5
Interfury,magtheridon,96,druid,balance,6,1,5
Watchlady,thunderhorn,96,druid,balance,6,1,5
Ggumy,tichondrius,96,druid,balance,6,1,5
Breedable,elune,96,druid,balance,6,1,5
Florgsgorgan,sargeras,96,druid,balance,6,1,5
Furryluvr,tichondrius,96,druid,balance,6,1,5
Sinapticc,proudmoore,96,druid,balance,6,1,5
Hurloon,demon-soul,96,druid,balance,6,1,5
Brucey,khadgar,96,druid,balance,6,1,5
Rennan,cenarius,96,druid,balance,6,1,5
Fioryxd,bleeding-hollow,96,druid,balance,6,1,5
Travys,sargeras,96,druid,balance,6,1,5
Torpina,malganis,96,druid,balance,6,1,5
Twentypeice,tichondrius,96,druid,balance,6,1,5
Klint,darkspear,96,druid,balance,6,1,5
Stinkycrotch,malganis,96,druid,balance,6,1,5
Invisakitty,demon-soul,96,druid,balance,6,1,5
Kipsmiffly,darkspear,96,druid,balance,6,1,5
Kirrel,frostmourne,96,druid,balance,6,1,5
Harambetwo,quelthalas,96,druid,balance,6,1,5
Zelø,zuljin,96,druid,balance,6,1,5
Thissaene,sargeras,96,druid,balance,6,1,5
Øvernight,azralon,96,druid,balance,6,1,5
Jorkalak,zuljin,96,druid,balance,6,1,5
Ravendawnn,tichondrius,96,druid,balance,6,1,5
Elivacheth,zuljin,96,druid,balance,6,1,5
Dendríta,ragnaros,96,druid,balance,6,1,5
Aeoc,barthilas,96,druid,balance,6,1,5
Anímorph,sargeras,96,druid,balance,6,1,5
Drilnos,hyjal,96,druid,balance,6,1,5
Walkdown,turalyon,96,druid,balance,6,1,5
Gaìjin,barthilas,96,druid,balance,6,1,5
Earthstalker,crushridge,96,druid,balance,6,1,5
Oldcktwist,garrosh,96,druid,balance,6,1,5
Omegabeast,frostmourne,96,druid,balance,6,1,5
Notdev,grizzly-hills,96,druid,balance,6,1,5
Youlived,aegwynn,96,druid,balance,6,1,5
Scatpanties,moon-guard,96,druid,balance,6,1,5
Shmooglite,emerald-dream,96,druid,balance,6,1,5
Goodhealer,akama,96,druid,balance,6,1,5
Selling,moon-guard,96,druid,balance,6,1,5
Bernwolf,moon-guard,96,druid,balance,6,1,5
Encosan,azralon,96,druid,balance,7,1,6
Simbaa,blades-edge,96,druid,balance,10,1,9
Grimmb,emerald-dream,96,druid,balance,12,1,11
Kängawalafox,frostmourne,96,druid,balance,12,1,11
Kodrän,stormrage,96,druid,balance,12,1,11
Ranokaliki,tichondrius,89,druid,balance,10,3,7
Gorfrog,tichondrius,84,druid,balance,13,6,7
Drewcarriesu,arthas,79,druid,balance,5,2,3
Lutzenberger,nemesis,79,druid,balance,5,1,4
Hydraulick,tichondrius,79,druid,balance,5,1,4
Zephiee,kelthuzad,79,druid,balance,5,1,4
Foggie,spirestone,79,druid,balance,5,1,4
Raahmirtah,illidan,79,druid,balance,5,1,4
Manalune,firetree,79,druid,balance,5,1,4
Doingo,destromath,79,druid,balance,11,1,10
Morpheûs,bleeding-hollow,64,druid,balance,4,1,3
Hughhefferr,illidan,63,druid,balance,2,2,0
Guarbird,tichondrius,48,druid,balance,3,1,2
Policë,skullcrusher,42,druid,balance,8,2,6
Tsubakihara,azralon,16,druid,balance,1,1,0
Garbagevoker,scilla,2242,evoker,preservation,192,99,93
Dracob,sargeras,2180,evoker,preservation,252,140,112
Sleepiihead,stormrage,2130,evoker,preservation,96,50,46
Meraxes,moonrunner,2124,evoker,preservation,131,64,67
Sleepiiheadx,stormrage,2112,evoker,preservation,114,63,51
Dragocula,tichondrius,2106,evoker,preservation,109,55,54
Sheepstealer,shuhalo,2104,evoker,preservation,133,69,64
Jakedrake,stormrage,2062,evoker,preservation,235,117,118
Mkabaka,tichondrius,2009,evoker,preservation,82,47,35
Idk,proudmoore,2004,evoker,preservation,66,34,32
Kallie,whisperwind,1997,evoker,preservation,515,257,258
Eskrizzle,thrall,1991,evoker,preservation,78,38,40
Storeypagoda,tichondrius,1983,evoker,preservation,155,80,75
Eyjes,stormrage,1979,evoker,preservation,187,98,89
Jdbthyr,malganis,1974,evoker,preservation,264,127,137
Walf,stormrage,1971,evoker,preservation,403,207,196
Lucardeht,illidan,1970,evoker,preservation,92,46,46
Healpumper,kelthuzad,1950,evoker,preservation,76,44,32
Kiry,emerald-dream,1934,evoker,preservation,114,54,60
Idrinkurine,tichondrius,1918,evoker,preservation,88,45,43
Ellafortnite,emerald-dream,1915,evoker,preservation,55,31,24
Didy,tichondrius,1913,evoker,preservation,370,184,186
Advancedonly,tichondrius,1912,evoker,preservation,54,26,28
Soô,tichondrius,1900,evoker,preservation,36,20,16
Sloane,dunemaul,1899,evoker,preservation,51,32,19
Dracthyrfang,elune,1895,evoker,preservation,250,122,128
Ravebae,frostmourne,1889,evoker,preservation,73,37,36
Bimbus,illidan,1887,evoker,preservation,154,85,69
Philmcracken,proudmoore,1883,evoker,preservation,34,24,10
Joc,khazgoroth,1881,evoker,preservation,83,49,34
Benym,tichondrius,1873,evoker,preservation,60,32,28
Lieferant,area-52,1867,evoker,preservation,48,25,23
Draconian,frostmourne,1866,evoker,preservation,76,36,40
Drupy,tichondrius,1860,evoker,preservation,60,31,29
Dragongunz,illidan,1853,evoker,preservation,48,21,27
Selkisaurus,area-52,1852,evoker,preservation,114,53,61
Dragonkok,stormrage,1848,evoker,preservation,48,28,20
Thnake,zuljin,1839,evoker,preservation,72,38,34
Driceses,area-52,1838,evoker,preservation,83,50,33
Dracadukez,illidan,1836,evoker,preservation,84,35,49
Ancalagøn,ragnaros,1833,evoker,preservation,70,35,35
Ojigi,sargeras,1833,evoker,preservation,69,28,41
Versezz,tichondrius,1829,evoker,preservation,42,28,14
Iba,tichondrius,1828,evoker,preservation,96,54,42
Draggin,barthilas,1828,evoker,preservation,48,24,24
Neskor,moon-guard,1827,evoker,preservation,101,58,43
Hamine,tichondrius,1825,evoker,preservation,113,52,61
Cenchii,proudmoore,1822,evoker,preservation,54,28,26
Voíd,sargeras,1814,evoker,preservation,45,29,16
Dragboy,stormrage,1812,evoker,preservation,187,107,80
Patzdormu,area-52,1812,evoker,preservation,73,32,41
Mngxaltx,ragnaros,1810,evoker,preservation,96,42,54
Zarref,sargeras,1809,evoker,preservation,48,26,22
Hlaargh,illidan,1809,evoker,preservation,60,31,29
Dragonclause,stormrage,1809,evoker,preservation,72,32,40
Aymadragon,sargeras,1807,evoker,preservation,68,38,30
Furegos,zuljin,1807,evoker,preservation,48,23,25
Lodekiim,malganis,1806,evoker,preservation,66,30,36
Usedbandage,sargeras,1805,evoker,preservation,271,144,127
Mcdonovan,stormrage,1805,evoker,preservation,81,36,45
Yoyke,tichondrius,1804,evoker,preservation,84,41,43
Révoked,magtheridon,1802,evoker,preservation,323,179,144
Velstrasza,stormrage,1802,evoker,preservation,54,29,25
Dragonchip,bleeding-hollow,1801,evoker,preservation,101,46,55
Obama,dragonmaw,1801,evoker,preservation,78,33,45
Novustrasza,lightbringer,1800,evoker,preservation,66,43,23
Petezra,ragnaros,1800,evoker,preservation,70,33,37
Áäøxgød,ravencrest,1799,evoker,preservation,136,64,72
Livesey,thunderhorn,1791,evoker,preservation,96,56,40
Dreamfuego,tichondrius,1791,evoker,preservation,60,25,35
Flybro,malganis,1787,evoker,preservation,30,19,11
Basedfurry,dalaran,1786,evoker,preservation,48,25,23
Dweamfuego,sargeras,1777,evoker,preservation,30,19,11
Drerick,illidan,1772,evoker,preservation,104,53,51
Evokethisdik,tichondrius,1768,evoker,preservation,43,25,18
Fatsu,executus,1768,evoker,preservation,54,24,30
Dragontrees,illidan,1765,evoker,preservation,54,28,26
Enderal,stormrage,1765,evoker,preservation,48,24,24
Ugg,stormrage,1756,evoker,preservation,171,76,95
Elimi,tichondrius,1748,evoker,preservation,36,22,14
Berquone,tichondrius,1747,evoker,preservation,72,31,41
Starkiller,stormrage,1745,evoker,preservation,60,37,23
Dunkinonem,black-dragonflight,1738,evoker,preservation,927,464,463
Phooby,sargeras,1736,evoker,preservation,72,37,35
Rosestrasza,silvermoon,1734,evoker,preservation,132,63,69
Stønemonkey,sargeras,1730,evoker,preservation,147,73,74
Thugzillah,tichondrius,1728,evoker,preservation,103,68,35
Wimsx,malganis,1727,evoker,preservation,125,65,60
Dracobys,area-52,1724,evoker,preservation,52,26,26
Dirtydragon,uther,1724,evoker,preservation,54,22,32
Kainalaz,moon-guard,1715,evoker,preservation,55,28,27
Basherm,moon-guard,1711,evoker,preservation,96,47,49
Lodedragon,tichondrius,1709,evoker,preservation,150,69,81
Twizzthyr,bleeding-hollow,1705,evoker,preservation,168,85,83
Moralies,area-52,1705,evoker,preservation,48,24,24
Benbm,proudmoore,1703,evoker,preservation,36,18,18
Deathdrake,jubeithos,1703,evoker,preservation,215,106,109
Chronoloop,tichondrius,1699,evoker,preservation,32,21,11
Siire,tichondrius,1697,evoker,preservation,36,19,17
Chañïng,frostmourne,1695,evoker,preservation,36,18,18
Redeyesblm,sargeras,1693,evoker,preservation,37,21,16
Schmitty,hellscream,1689,evoker,preservation,100,48,52
Flamedramon,bleeding-hollow,1689,evoker,preservation,247,117,130
Ancalagðn,quelthalas,1687,evoker,preservation,66,26,40
Mirandaxo,tichondrius,1684,evoker,preservation,161,73,88
Skyheal,ragnaros,1683,evoker,preservation,42,22,20
Yukiormi,sargeras,1677,evoker,preservation,36,18,18
Halcyonxz,tichondrius,1677,evoker,preservation,48,23,25
Seviant,tichondrius,1671,evoker,preservation,48,20,28
Got,burning-blade,1668,evoker,preservation,45,25,20
Dupastrasza,illidan,1664,evoker,preservation,60,25,35
Gharkul,frostmourne,1663,evoker,preservation,48,25,23
Tallcanman,kelthuzad,1660,evoker,preservation,42,20,22
Stinkler,stormscale,1659,evoker,preservation,126,63,63
Allevesh,shadow-council,1658,evoker,preservation,34,20,14
Vulkerr,stormrage,1657,evoker,preservation,122,67,55
Daegonz,lightbringer,1657,evoker,preservation,116,57,59
Cannotjump,tichondrius,1653,evoker,preservation,60,27,33
Flyboy,malganis,1649,evoker,preservation,42,23,19
Redseal,tichondrius,1648,evoker,preservation,110,52,58
Sandragon,ragnaros,1646,evoker,preservation,57,25,32
Domavem,tichondrius,1642,evoker,preservation,66,28,38
Sanninv,barthilas,1638,evoker,preservation,57,26,31
Cycircle,proudmoore,1637,evoker,preservation,41,23,18
Cokobra,haomarush,1636,evoker,preservation,36,21,15
Trákanon,mugthol,1634,evoker,preservation,67,37,30
Ðrac,bleeding-hollow,1633,evoker,preservation,53,30,23
Neocellx,frostwolf,1633,evoker,preservation,91,43,48
Modenzu,malganis,1629,evoker,preservation,66,33,33
Dripdrop,stormscale,1627,evoker,preservation,94,49,45
Junkstam,malganis,1627,evoker,preservation,75,34,41
Wingsoflyfe,frostmourne,1625,evoker,preservation,48,20,28
Pootylizard,daggerspine,1625,evoker,preservation,50,19,31
Dragonman,twisting-nether,1624,evoker,preservation,47,26,21
Yop,proudmoore,1624,evoker,preservation,108,45,63
Briggsybear,malganis,1622,evoker,preservation,82,48,34
Dragondikz,tichondrius,1622,evoker,preservation,48,25,23
Congodragon,frostmourne,1620,evoker,preservation,48,28,20
Dgevoker,tichondrius,1620,evoker,preservation,47,19,28
Lucidreamx,tichondrius,1618,evoker,preservation,73,39,34
Nyzara,emerald-dream,1618,evoker,preservation,180,92,88
Seeyn,tichondrius,1618,evoker,preservation,78,33,45
Grunkthyr,moon-guard,1614,evoker,preservation,47,25,22
Egglayer,tichondrius,1611,evoker,preservation,196,91,105
Leonilxd,tichondrius,1610,evoker,preservation,97,51,46
Bigdwagon,stormrage,1608,evoker,preservation,36,17,19
Triarcs,sargeras,1606,evoker,preservation,40,21,19
Dragisha,gnomeregan,1604,evoker,preservation,184,103,81
Emperör,quelthalas,1604,evoker,preservation,109,58,51
Deadlybx,bleeding-hollow,1603,evoker,preservation,70,32,38
Fxii,tichondrius,1602,evoker,preservation,101,53,48
Layugos,azralon,1601,evoker,preservation,35,20,15
Provokker,drakkari,1600,evoker,preservation,30,21,9
Purrlynn,tichondrius,1600,evoker,preservation,72,42,30
Jnitoscaly,tichondrius,1598,evoker,preservation,30,20,10
Judra,barthilas,1598,evoker,preservation,98,48,50
Zakaraki,bloodscalp,1597,evoker,preservation,171,99,72
Kwebab,tichondrius,1595,evoker,preservation,48,19,29
Chessyk,ragnaros,1594,evoker,preservation,53,33,20
Jimmydragon,blackhand,1585,evoker,preservation,72,31,41
Adragon,garithos,1585,evoker,preservation,77,30,47
Thinprivlege,area-52,1583,evoker,preservation,60,26,34
Trembulos,malganis,1582,evoker,preservation,78,41,37
Jacm,fizzcrank,1582,evoker,preservation,123,63,60
Vokr,area-52,1582,evoker,preservation,158,78,80
Unidragon,malganis,1581,evoker,preservation,54,22,32
Evokesyn,stormrage,1580,evoker,preservation,105,55,50
Kozaraler,stormrage,1579,evoker,preservation,60,38,22
Zenot,malganis,1575,evoker,preservation,46,34,12
Drakjar,nemesis,1569,evoker,preservation,72,34,38
Elcigala,ragnaros,1566,evoker,preservation,285,147,138
Hotblower,tichondrius,1565,evoker,preservation,61,22,39
Drepz,dalaran,1564,evoker,preservation,63,45,18
Linkinloatr,tichondrius,1563,evoker,preservation,54,23,31
Buttcrease,emerald-dream,1562,evoker,preservation,42,22,20
Møritz,stormrage,1562,evoker,preservation,86,40,46
Whethersmell,tichondrius,1559,evoker,preservation,194,90,104
Xboy,tichondrius,1556,evoker,preservation,49,23,26
Christína,tichondrius,1554,evoker,preservation,65,45,20
Azarke,rivendare,1554,evoker,preservation,42,20,22
Vhaegart,area-52,1553,evoker,preservation,141,66,75
Dougreen,azralon,1552,evoker,preservation,38,18,20
Shruikan,lightnings-blade,1552,evoker,preservation,42,19,23
Bigbaojian,tichondrius,1550,evoker,preservation,65,31,34
Spyrox,zuluhed,1549,evoker,preservation,54,32,22
Dracore,firetree,1549,evoker,preservation,215,112,103
Alitasbbq,malganis,1547,evoker,preservation,48,19,29
Ffaarrvv,illidan,1545,evoker,preservation,108,63,45
Ninereeds,malganis,1543,evoker,preservation,102,53,49
Whelpling,cenarion-circle,1541,evoker,preservation,24,19,5
Tonysaur,lethon,1537,evoker,preservation,30,19,11
Prettycooll,dathremar,1537,evoker,preservation,36,17,19
Kwitty,illidan,1535,evoker,preservation,48,27,21
Tinine,frostmourne,1535,evoker,preservation,133,65,68
Fláppÿbírd,bleeding-hollow,1533,evoker,preservation,24,16,8
Stinkybussy,mannoroth,1533,evoker,preservation,65,37,28
Corncrake,sargeras,1530,evoker,preservation,50,23,27
Jlucks,wyrmrest-accord,1529,evoker,preservation,172,94,78
Pauly,suramar,1525,evoker,preservation,100,53,47
Velocîraptor,bleeding-hollow,1524,evoker,preservation,92,53,39
Sineexe,illidan,1523,evoker,preservation,98,58,40
Transmogplz,tichondrius,1522,evoker,preservation,66,27,39
Nulldd,tichondrius,1521,evoker,preservation,59,21,38
Gobananas,sargeras,1520,evoker,preservation,29,17,12
Vormontis,azralon,1518,evoker,preservation,140,69,71
Thevochr,area-52,1514,evoker,preservation,42,27,15
Asschaps,area-52,1513,evoker,preservation,60,32,28
Dragonsteppz,aegwynn,1512,evoker,preservation,30,16,14
Mfka,dalaran,1512,evoker,preservation,83,39,44
Earthshatter,lightbringer,1510,evoker,preservation,166,91,75
Suffler,warsong,1509,evoker,preservation,267,139,128
Dragdezenutz,bleeding-hollow,1508,evoker,preservation,112,45,67
Veraxsys,wyrmrest-accord,1507,evoker,preservation,67,23,44
Miliolievo,azralon,1506,evoker,preservation,313,161,152
Waggon,moon-guard,1504,evoker,preservation,48,26,22
Cyndragosa,dalvengyr,1503,evoker,preservation,119,54,65
Youngyongdie,tichondrius,1499,evoker,preservation,52,25,27
Handeezol,malganis,1498,evoker,preservation,71,43,28
Kratheu,azralon,1494,evoker,preservation,53,26,27
Zullavoker,bleeding-hollow,1493,evoker,preservation,30,18,12
Beautylily,tichondrius,1492,evoker,preservation,311,172,139
Masondragon,darkspear,1492,evoker,preservation,36,16,20
Kaidagos,tichondrius,1491,evoker,preservation,60,32,28
Snuggleboo,malganis,1490,evoker,preservation,24,16,8
Emoker,magtheridon,1490,evoker,preservation,84,46,38
Dragoncods,velen,1488,evoker,preservation,48,26,22
Buttfinger,bladefist,1488,evoker,preservation,86,39,47
Hepzibah,kelthuzad,1488,evoker,preservation,53,23,30
Virtualcrush,sisters-of-elune,1486,evoker,preservation,94,49,45
Quickshootin,tichondrius,1486,evoker,preservation,355,171,184
Nfts,darkspear,1486,evoker,preservation,40,18,22
Skrimbles,tichondrius,1486,evoker,preservation,54,24,30
Nikholatrus,malganis,1483,evoker,preservation,106,52,54
Longaot,tichondrius,1482,evoker,preservation,96,56,40
Splendadaddy,kiljaeden,1482,evoker,preservation,30,16,14
Ajiz,mannoroth,1479,evoker,preservation,48,23,25
Darchomp,illidan,1478,evoker,preservation,42,17,25
Ralzital,auchindoun,1476,evoker,preservation,68,29,39
Yotus,illidan,1474,evoker,preservation,60,35,25
Diavai,area-52,1471,evoker,preservation,93,41,52
Qiblii,moon-guard,1470,evoker,preservation,48,24,24
Monavoker,bleeding-hollow,1466,evoker,preservation,36,20,16
Delivv,hyjal,1466,evoker,preservation,90,48,42
Ponnukii,tichondrius,1466,evoker,preservation,184,93,91
Runawayslave,frostmane,1466,evoker,preservation,233,110,123
Venjolly,wyrmrest-accord,1465,evoker,preservation,63,33,30
Madegood,tichondrius,1465,evoker,preservation,72,32,40
Setalet,zuljin,1465,evoker,preservation,47,19,28
Weagle,zuljin,1465,evoker,preservation,45,18,27
Bucket,wyrmrest-accord,1464,evoker,preservation,44,17,27
Necrathma,tichondrius,1461,evoker,preservation,169,84,85
Enazen,kiljaeden,1460,evoker,preservation,83,45,38
Bynaero,area-52,1460,evoker,preservation,42,16,26
Uneedawhip,zuljin,1457,evoker,preservation,36,19,17
Unknowndrago,kul-tiras,1457,evoker,preservation,36,18,18
Giratina,area-52,1457,evoker,preservation,108,53,55
Ycnpass,tichondrius,1456,evoker,preservation,158,89,69
Stableboy,bleeding-hollow,1455,evoker,preservation,54,27,27
Lalargata,azralon,1455,evoker,preservation,77,38,39
Eyolker,kelthuzad,1455,evoker,preservation,82,39,43
Cringilisk,kelthuzad,1454,evoker,preservation,126,82,44
Caredormu,frostmourne,1449,evoker,preservation,47,23,24
Suedeshoes,bleeding-hollow,1448,evoker,preservation,162,88,74
Evoskunk,kelthuzad,1448,evoker,preservation,48,24,24
Nyxtari,ragnaros,1447,evoker,preservation,108,57,51
Nazzadormu,tichondrius,1445,evoker,preservation,70,30,40
Squarter,kiljaeden,1443,evoker,preservation,60,34,26
Hageiz,tichondrius,1441,evoker,preservation,60,27,33
Ttvfòxyllamà,tichondrius,1439,evoker,preservation,30,15,15
Linguistic,tichondrius,1439,evoker,preservation,42,18,24
Xurota,proudmoore,1436,evoker,preservation,104,47,57
Usedaspirin,sargeras,1435,evoker,preservation,30,15,15
Aetherz,illidan,1434,evoker,preservation,36,15,21
Dragonmyass,tichondrius,1434,evoker,preservation,43,17,26
Kjerne,stormrage,1432,evoker,preservation,69,37,32
Slither,terenas,1432,evoker,preservation,212,111,101
Biggestbroie,frostmourne,1431,evoker,preservation,30,15,15
Dragonkink,sargeras,1429,evoker,preservation,61,32,29
Kymoxien,sargeras,1427,evoker,preservation,30,16,14
Sovietønion,tichondrius,1425,evoker,preservation,83,38,45
Macismighty,emerald-dream,1423,evoker,preservation,101,54,47
Nandrolona,sargeras,1423,evoker,preservation,30,15,15
Spyrodadrago,malganis,1423,evoker,preservation,113,50,63
Annum,moon-guard,1423,evoker,preservation,60,22,38
Nandrolona,malganis,1422,evoker,preservation,30,15,15
Dracndanuts,draenor,1422,evoker,preservation,43,19,24
Zka,nemesis,1421,evoker,preservation,55,28,27
Bendover,proudmoore,1420,evoker,preservation,42,22,20
Laggathaa,emerald-dream,1420,evoker,preservation,62,29,33
Dmt,ravencrest,1419,evoker,preservation,24,15,9
Epsilon,laughing-skull,1419,evoker,preservation,24,15,9
Slimez,malganis,1418,evoker,preservation,188,84,104
Evokeo,area-52,1417,evoker,preservation,30,15,15
Nazatra,wyrmrest-accord,1417,evoker,preservation,125,60,65
Zaedor,stormrage,1416,evoker,preservation,40,26,14
Kephii,eonar,1415,evoker,preservation,42,22,20
Nakyp,dalaran,1415,evoker,preservation,30,15,15
Meiron,azralon,1413,evoker,preservation,78,39,39
Garchamp,area-52,1412,evoker,preservation,48,20,28
Gannsito,emerald-dream,1411,evoker,preservation,36,20,16
Fusrodude,shuhalo,1411,evoker,preservation,98,53,45
Kcwt,illidan,1411,evoker,preservation,113,55,58
Vyndormu,moon-guard,1410,evoker,preservation,46,22,24
Tørched,icecrown,1409,evoker,preservation,30,17,13
Apollygos,malganis,1406,evoker,preservation,78,41,37
Kigglypuff,illidan,1406,evoker,preservation,36,15,21
Cyntheticdr,malganis,1404,evoker,preservation,54,30,24
Velzelya,zuljin,1404,evoker,preservation,60,27,33
Roogye,illidan,1403,evoker,preservation,96,49,47
Sía,drakkari,1402,evoker,preservation,66,39,27
Courtvoke,turalyon,1402,evoker,preservation,233,117,116
Kaldobar,stormrage,1401,evoker,preservation,24,15,9
Naykir,khazgoroth,1400,evoker,preservation,42,27,15
Anthyrsia,zuljin,1400,evoker,preservation,47,24,23
Coldspawn,nerzhul,1400,evoker,preservation,30,15,15
Thicscales,tichondrius,1400,evoker,preservation,76,36,40
Dylôn,tichondrius,1398,evoker,preservation,58,27,31
Masquemeto,illidan,1396,evoker,preservation,49,25,24
Ráigon,ragnaros,1394,evoker,preservation,142,64,78
Ultis,tichondrius,1392,evoker,preservation,420,217,203
Derazar,malganis,1391,evoker,preservation,288,128,160
Darthjarjar,bloodscalp,1390,evoker,preservation,285,144,141
Grousegamer,barthilas,1389,evoker,preservation,82,35,47
Jmir,tichondrius,1389,evoker,preservation,59,24,35
Eldenkingy,sargeras,1389,evoker,preservation,70,28,42
Voithyr,moon-guard,1382,evoker,preservation,241,110,131
Gogmagog,korgath,1381,evoker,preservation,95,43,52
Quesodillas,stormreaver,1379,evoker,preservation,60,25,35
Jamörant,tichondrius,1378,evoker,preservation,24,15,9
Santokki,tichondrius,1378,evoker,preservation,158,76,82
Tazarke,dawnbringer,1375,evoker,preservation,60,35,25
Flowsmoke,tichondrius,1375,evoker,preservation,78,40,38
Tigthyr,alleria,1375,evoker,preservation,30,15,15
Bigdrag,blackhand,1373,evoker,preservation,103,56,47
Mordrakhuul,chogall,1372,evoker,preservation,72,30,42
Dragonpel,azralon,1371,evoker,preservation,124,62,62
Chambea,kelthuzad,1370,evoker,preservation,77,40,37
Errier,tichondrius,1370,evoker,preservation,33,17,16
Cjin,tichondrius,1370,evoker,preservation,36,18,18
Healmeta,sargeras,1369,evoker,preservation,308,154,154
Vodkasauce,tichondrius,1369,evoker,preservation,30,15,15
Tzindelor,illidan,1364,evoker,preservation,60,27,33
Primshin,illidan,1363,evoker,preservation,117,59,58
Glizzurd,proudmoore,1363,evoker,preservation,309,154,155
Otsira,frostmourne,1359,evoker,preservation,60,37,23
Friedwings,wyrmrest-accord,1359,evoker,preservation,27,16,11
Greenscales,frostmourne,1358,evoker,preservation,105,43,62
Enalen,azjolnerub,1357,evoker,preservation,86,42,44
Misico,illidan,1355,evoker,preservation,78,46,32
Growthyy,malganis,1354,evoker,preservation,57,32,25
Thepplschamp,bloodhoof,1354,evoker,preservation,48,23,25
Gavstarz,frostmourne,1354,evoker,preservation,86,40,46
Cosmodrake,daggerspine,1352,evoker,preservation,54,24,30
Lifewing,bleeding-hollow,1352,evoker,preservation,67,25,42
Cynderrellaa,proudmoore,1351,evoker,preservation,164,81,83
Bomber,frostwolf,1351,evoker,preservation,34,16,18
Charbothyr,gorgonnash,1350,evoker,preservation,67,34,33
Tigdragon,proudmoore,1348,evoker,preservation,36,16,20
Biagi,proudmoore,1347,evoker,preservation,28,17,11
Kikokosta,tichondrius,1346,evoker,preservation,281,140,141
Garboker,area-52,1346,evoker,preservation,158,75,83
Salusx,proudmoore,1345,evoker,preservation,42,18,24
Sabledraco,stormrage,1344,evoker,preservation,18,14,4
Kîñggïgàçhäð,stormrage,1343,evoker,preservation,24,14,10
Feijiwang,aegwynn,1342,evoker,preservation,69,41,28
Boseijwho,emerald-dream,1342,evoker,preservation,66,36,30
Kalsit,emerald-dream,1341,evoker,preservation,64,30,34
Originull,tichondrius,1340,evoker,preservation,24,14,10
Deepbreather,sargeras,1338,evoker,preservation,30,18,12
Actïoncat,emerald-dream,1338,evoker,preservation,69,26,43
Fionyan,proudmoore,1337,evoker,preservation,36,14,22
Gumbåll,bleeding-hollow,1335,evoker,preservation,192,93,99
Altevoker,frostmourne,1334,evoker,preservation,89,51,38
Bryagh,executus,1334,evoker,preservation,54,28,26
Forsakentime,sargeras,1333,evoker,preservation,60,32,28
Dawitchvoker,illidan,1333,evoker,preservation,324,166,158
Caphe,nerzhul,1333,evoker,preservation,60,27,33
Chunkè,moon-guard,1332,evoker,preservation,69,29,40
Sylf,kiljaeden,1331,evoker,preservation,225,121,104
Neffiie,dalaran,1331,evoker,preservation,106,50,56
Léthée,zuljin,1331,evoker,preservation,30,14,16
Nuunos,tichondrius,1330,evoker,preservation,41,17,24
Mäverick,kelthuzad,1327,evoker,preservation,35,23,12
Radragão,azralon,1326,evoker,preservation,48,28,20
Kalikani,moon-guard,1326,evoker,preservation,99,45,54
Norvoker,area-52,1325,evoker,preservation,58,31,27
Sadeyes,dalaran,1323,evoker,preservation,113,62,51
Gloamdream,cenarius,1321,evoker,preservation,344,179,165
Dendywings,zuljin,1321,evoker,preservation,30,14,16
Xerroh,area-52,1320,evoker,preservation,94,46,48
Cadwaladr,frostmourne,1317,evoker,preservation,24,14,10
Dracniel,illidan,1316,evoker,preservation,69,38,31
Elurb,illidan,1316,evoker,preservation,66,30,36
Velaryonhero,arthas,1313,evoker,preservation,74,40,34
Nitalzith,area-52,1311,evoker,preservation,48,23,25
Solong,sargeras,1310,evoker,preservation,67,38,29
Inkdsy,detheroc,1310,evoker,preservation,30,16,14
Jazzdragon,tichondrius,1310,evoker,preservation,51,24,27
Verk,deathwing,1308,evoker,preservation,168,89,79
Shudo,moon-guard,1308,evoker,preservation,119,62,57
Whinks,zangarmarsh,1307,evoker,preservation,35,18,17
Saviorkai,barthilas,1306,evoker,preservation,22,15,7
Benjaminamin,stormrage,1306,evoker,preservation,30,20,10
Wangasaur,emerald-dream,1302,evoker,preservation,55,26,29
Matchamjölk,tichondrius,1302,evoker,preservation,53,23,30
Zmaj,jubeithos,1301,evoker,preservation,36,23,13
Fuoco,kiljaeden,1299,evoker,preservation,62,31,31
Hamanv,tichondrius,1299,evoker,preservation,60,29,31
Icthelestron,black-dragonflight,1297,evoker,preservation,44,30,14
Zendrov,skywall,1297,evoker,preservation,84,41,43
Lilacstrasza,moon-guard,1297,evoker,preservation,158,77,81
Wtsgoldpst,tichondrius,1295,evoker,preservation,26,16,10
Kraiz,frostmourne,1295,evoker,preservation,60,26,34
Oogiewoogie,doomhammer,1294,evoker,preservation,23,14,9
Frëëbîë,area-52,1294,evoker,preservation,42,21,21
Lizzardload,stormreaver,1294,evoker,preservation,83,37,46
Xmystique,area-52,1293,evoker,preservation,40,19,21
Straxolotl,frostmourne,1293,evoker,preservation,81,33,48
Crayonshinch,tichondrius,1291,evoker,preservation,30,15,15
Amnemís,tichondrius,1288,evoker,preservation,38,22,16
Hydrrax,dalaran,1288,evoker,preservation,255,126,129
Moiraine,frostwolf,1288,evoker,preservation,48,17,31
Gotbreath,dalaran,1287,evoker,preservation,90,46,44
Rynntynn,blood-furnace,1286,evoker,preservation,30,15,15
Nitalash,moon-guard,1286,evoker,preservation,29,14,15
Paladinex,tichondrius,1284,evoker,preservation,47,27,20
Thereptile,frostmourne,1284,evoker,preservation,90,41,49
Dragûn,stormrage,1279,evoker,preservation,30,16,14
Shellessturt,kelthuzad,1278,evoker,preservation,27,14,13
Hotdawgin,korgath,1278,evoker,preservation,124,57,67
Rayquazä,kelthuzad,1277,evoker,preservation,26,14,12
Feelzz,illidan,1275,evoker,preservation,43,22,21
Drgndeeznüts,tichondrius,1272,evoker,preservation,58,27,31
Vgt,nemesis,1270,evoker,preservation,152,70,82
Antirrhinum,zuljin,1268,evoker,preservation,48,32,16
Dragonfruits,lightbringer,1268,evoker,preservation,90,46,44
Selfhealzer,korgath,1268,evoker,preservation,92,43,49
Akavoker,sargeras,1267,evoker,preservation,62,21,41
Cronós,tichondrius,1266,evoker,preservation,90,38,52
Bassblasterr,dalaran,1265,evoker,preservation,24,14,10
Lickndragons,sargeras,1265,evoker,preservation,36,14,22
Ayavi,illidan,1255,evoker,preservation,40,23,17
Skailyx,zuljin,1254,evoker,preservation,30,14,16
Brantley,stormscale,1253,evoker,preservation,86,41,45
Agony,emerald-dream,1252,evoker,preservation,249,121,128
Xhamon,quelthalas,1251,evoker,preservation,98,49,49
Nicegirl,stormrage,1251,evoker,preservation,42,21,21
Terpsy,area-52,1250,evoker,preservation,23,16,7
Mãttyy,malganis,1250,evoker,preservation,42,23,19
Xazxander,tichondrius,1249,evoker,preservation,78,37,41
Stadman,illidan,1248,evoker,preservation,24,13,11
Aoibae,frostmourne,1248,evoker,preservation,126,57,69
Dreamvisage,silvermoon,1247,evoker,preservation,44,20,24
Mikoriivoker,tichondrius,1247,evoker,preservation,30,13,17
Wethotgarbee,tichondrius,1245,evoker,preservation,44,23,21
Darkscalyboi,dalaran,1245,evoker,preservation,54,25,29
Justbreathez,tichondrius,1245,evoker,preservation,35,13,22
Fibonac,frostmourne,1243,evoker,preservation,78,48,30
Miradrake,icecrown,1243,evoker,preservation,30,13,17
Thendroz,aerie-peak,1242,evoker,preservation,95,54,41
Valarakuu,illidan,1242,evoker,preservation,24,13,11
Raykwaza,tichondrius,1242,evoker,preservation,42,20,22
Rustty,bleeding-hollow,1242,evoker,preservation,89,37,52
Dansauce,sargeras,1241,evoker,preservation,56,30,26
Goonwing,frostmourne,1241,evoker,preservation,30,15,15
Lilithlittle,daggerspine,1241,evoker,preservation,247,121,126
Wildcard,shattered-hand,1241,evoker,preservation,35,16,19
Allaston,tichondrius,1240,evoker,preservation,45,28,17
Zandragosa,dalaran,1240,evoker,preservation,24,13,11
Riz,blackhand,1239,evoker,preservation,114,56,58
Rubellite,azralon,1238,evoker,preservation,71,36,35
Nerfmeplsaoa,area-52,1236,evoker,preservation,24,13,11
Zerath,frostmane,1236,evoker,preservation,30,13,17
Lavagurl,stormscale,1235,evoker,preservation,30,13,17
Xaxas,boulderfist,1234,evoker,preservation,30,13,17
Everglow,the-forgotten-coast,1233,evoker,preservation,48,26,22
Dragocser,drakkari,1233,evoker,preservation,30,13,17
Tinyvoker,area-52,1232,evoker,preservation,72,26,46
Irezfortips,tichondrius,1231,evoker,preservation,18,13,5
Astoragosa,moon-guard,1231,evoker,preservation,61,38,23
Verosria,area-52,1230,evoker,preservation,24,13,11
Shenlong,malganis,1230,evoker,preservation,116,59,57
Mythsvoker,barthilas,1229,evoker,preservation,61,33,28
Zippityzoom,barthilas,1229,evoker,preservation,59,30,29
Onornun,magtheridon,1229,evoker,preservation,66,32,34
Draxyrawr,area-52,1228,evoker,preservation,29,18,11
Macdrag,malganis,1228,evoker,preservation,24,13,11
Mastadragndz,illidan,1228,evoker,preservation,42,13,29
Kycaka,area-52,1228,evoker,preservation,46,14,32
Lévocatrice,hakkar,1225,evoker,preservation,64,31,33
Evokas,tichondrius,1224,evoker,preservation,252,128,124
Abelldragon,tichondrius,1224,evoker,preservation,34,17,17
Lebronjmz,kiljaeden,1224,evoker,preservation,127,58,69
Mëleys,ragnaros,1224,evoker,preservation,53,24,29
Scalesona,black-dragonflight,1222,evoker,preservation,31,14,17
Barneydragon,stormrage,1220,evoker,preservation,24,14,10
Milfwizard,tichondrius,1219,evoker,preservation,24,13,11
Dkvastate,tichondrius,1216,evoker,preservation,118,58,60
Dunkelzahn,gorgonnash,1214,evoker,preservation,30,15,15
Amniotic,hyjal,1212,evoker,preservation,54,31,23
Ysondrius,durotan,1212,evoker,preservation,48,26,22
Naszeebo,frostmourne,1212,evoker,preservation,54,24,30
Raptormoto,lothar,1211,evoker,preservation,32,14,18
Zindrozarath,area-52,1210,evoker,preservation,161,81,80
Deezdragon,stormrage,1209,evoker,preservation,47,24,23
Sanaz,stormreaver,1208,evoker,preservation,54,28,26
Balèrion,illidan,1207,evoker,preservation,60,33,27
Ghidorah,sentinels,1207,evoker,preservation,59,32,27
Gadiel,draka,1207,evoker,preservation,50,25,25
Weirdclassx,tichondrius,1207,evoker,preservation,47,23,24
Zinderal,thunderlord,1206,evoker,preservation,48,24,24
Buttstough,aerie-peak,1206,evoker,preservation,41,20,21
Frozanat,kelthuzad,1205,evoker,preservation,75,34,41
Döublepenn,tichondrius,1204,evoker,preservation,90,46,44
Deshandrov,bleeding-hollow,1203,evoker,preservation,24,13,11
Doogiehowser,azshara,1202,evoker,preservation,162,78,84
Dìnosaur,illidan,1201,evoker,preservation,36,18,18
Nêwt,darkspear,1201,evoker,preservation,238,115,123
Shook,baelgun,1200,evoker,preservation,202,102,100
Assassasin,bonechewer,1200,evoker,preservation,60,27,33
Partysnaxx,thrall,1199,evoker,preservation,72,35,37
Çhara,illidan,1198,evoker,preservation,126,65,61
Lamentation,area-52,1198,evoker,preservation,119,61,58
Rayvoker,elune,1198,evoker,preservation,54,27,27
Lazioo,frostmourne,1196,evoker,preservation,22,14,8
Maldormu,stormrage,1196,evoker,preservation,37,16,21
Karganos,darkspear,1195,evoker,preservation,48,27,21
Shênlong,sargeras,1193,evoker,preservation,54,22,32
Crowqt,frostmourne,1190,evoker,preservation,95,34,61
Careflight,barthilas,1188,evoker,preservation,66,39,27
Brôcôlînî,zuljin,1187,evoker,preservation,43,29,14
Bahamut,magtheridon,1186,evoker,preservation,60,25,35
Dmuzh,drakkari,1185,evoker,preservation,406,219,187
Shockragosa,chogall,1184,evoker,preservation,42,13,29
Wyldefire,senjin,1180,evoker,preservation,48,22,26
Hakuroyime,ragnaros,1179,evoker,preservation,36,21,15
Deralan,khaz-modan,1179,evoker,preservation,108,40,68
Yozhz,ragnaros,1177,evoker,preservation,53,25,28
Mungwings,area-52,1172,evoker,preservation,55,26,29
Scalyhoe,alterac-mountains,1171,evoker,preservation,36,13,23
Razerazenoth,tichondrius,1169,evoker,preservation,36,19,17
Dandera,stormrage,1169,evoker,preservation,106,50,56
Kaguax,tichondrius,1167,evoker,preservation,84,32,52
Worldx,illidan,1166,evoker,preservation,24,13,11
Lyingdragon,tichondrius,1166,evoker,preservation,60,26,34
Mazalagon,trollbane,1165,evoker,preservation,29,15,14
Detreshan,stormreaver,1163,evoker,preservation,164,87,77
Dragonsama,area-52,1163,evoker,preservation,30,13,17
Hlf,tichondrius,1162,evoker,preservation,44,24,20
Draginnuts,illidan,1162,evoker,preservation,53,25,28
Repairraptor,area-52,1159,evoker,preservation,81,37,44
Vermitor,sargeras,1155,evoker,preservation,24,13,11
Firebreather,quelthalas,1155,evoker,preservation,30,13,17
Skithyrix,bleeding-hollow,1153,evoker,preservation,68,32,36
Dzdv,stormrage,1151,evoker,preservation,18,12,6
Mikoribreath,moknathal,1151,evoker,preservation,18,12,6
Aspecto,area-52,1151,evoker,preservation,117,51,66
Flyingmooie,frostmourne,1151,evoker,preservation,30,12,18
Crsevencr,tichondrius,1150,evoker,preservation,18,12,6
Kilawatt,barthilas,1150,evoker,preservation,23,15,8
Djdavi,azralon,1150,evoker,preservation,132,77,55
Raundur,ragnaros,1150,evoker,preservation,24,12,12
Mysticenergy,tichondrius,1150,evoker,preservation,60,28,32
Venitsu,malganis,1150,evoker,preservation,30,12,18
Cycircle,tichondrius,1149,evoker,preservation,24,12,12
Smokeflare,frostmane,1149,evoker,preservation,24,12,12
Spyrotime,tichondrius,1149,evoker,preservation,33,12,21
Yessirs,shadow-council,1148,evoker,preservation,18,12,6
Emozoomer,malganis,1148,evoker,preservation,66,25,41
Faffytwo,illidan,1147,evoker,preservation,24,12,12
Héllfire,ghostlands,1147,evoker,preservation,54,25,29
Derkscale,stormrage,1146,evoker,preservation,36,17,19
Distortion,drakthul,1145,evoker,preservation,117,62,55
Riizo,malganis,1144,evoker,preservation,86,51,35
Xiwinnie,illidan,1144,evoker,preservation,36,14,22
Visserion,sargeras,1143,evoker,preservation,25,14,11
Readwise,tichondrius,1143,evoker,preservation,26,12,14
Badbill,moon-guard,1142,evoker,preservation,18,12,6
Satratren,moon-guard,1142,evoker,preservation,30,12,18
Zitasanazen,tichondrius,1141,evoker,preservation,299,153,146
Arcanasz,thrall,1137,evoker,preservation,24,12,12
Zackxo,moon-guard,1136,evoker,preservation,38,24,14
Vermax,akama,1133,evoker,preservation,45,17,28
Zascar,stormrage,1132,evoker,preservation,24,13,11
Rorie,farstriders,1131,evoker,preservation,30,14,16
Treadcinder,tichondrius,1130,evoker,preservation,30,14,16
Cindermint,mugthol,1130,evoker,preservation,38,17,21
Blay,elune,1130,evoker,preservation,36,15,21
Drokula,darkspear,1127,evoker,preservation,30,13,17
Draczod,proudmoore,1123,evoker,preservation,59,23,36
Saphfire,burning-legion,1122,evoker,preservation,24,16,8
Kathendrov,sargeras,1121,evoker,preservation,54,29,25
Caucasian,aegwynn,1121,evoker,preservation,88,35,53
Dzracona,gorefiend,1120,evoker,preservation,26,13,13
Cootietooter,icecrown,1120,evoker,preservation,36,16,20
Endroz,tichondrius,1119,evoker,preservation,24,12,12
Drathron,tichondrius,1118,evoker,preservation,28,13,15
Smaaugg,area-52,1117,evoker,preservation,18,12,6
Tryhard,wyrmrest-accord,1116,evoker,preservation,84,37,47
Prevoker,kirin-tor,1115,evoker,preservation,42,25,17
Kersava,frostmourne,1115,evoker,preservation,53,27,26
Darksmoke,spirestone,1112,evoker,preservation,24,12,12
Atpsuspect,nerzhul,1112,evoker,preservation,24,12,12
Drozul,stormrage,1112,evoker,preservation,42,14,28
Idingosa,moon-guard,1109,evoker,preservation,28,12,16
Thegrinchh,malganis,1107,evoker,preservation,93,45,48
Potfase,tichondrius,1106,evoker,preservation,66,28,38
Dragonwench,sargeras,1101,evoker,preservation,22,13,9
Geico,spinebreaker,1100,evoker,preservation,15,13,2
Droggerdrago,stormreaver,1100,evoker,preservation,24,14,10
Ilithiphobia,ghostlands,1100,evoker,preservation,38,16,22
Ashandshadow,area-52,1099,evoker,preservation,68,30,38
Daikis,proudmoore,1098,evoker,preservation,42,20,22
Saintpablox,illidan,1097,evoker,preservation,40,13,27
Krossbones,cenarion-circle,1096,evoker,preservation,80,47,33
Djornmustman,sargeras,1094,evoker,preservation,36,12,24
Rah,gurubashi,1093,evoker,preservation,47,28,19
Vyraethel,wyrmrest-accord,1093,evoker,preservation,51,27,24
Bayvoker,area-52,1093,evoker,preservation,56,29,27
Mesamune,bonechewer,1090,evoker,preservation,121,58,63
Abigaile,illidan,1088,evoker,preservation,24,17,7
Seiros,garrosh,1088,evoker,preservation,50,21,29
Mikkaelin,ragnaros,1086,evoker,preservation,67,31,36
Niraz,dalaran,1085,evoker,preservation,24,12,12
Emyhr,sargeras,1084,evoker,preservation,24,13,11
Drimare,quelthalas,1084,evoker,preservation,42,14,28
Draisin,zuljin,1083,evoker,preservation,24,13,11
Dragndeez,garrosh,1083,evoker,preservation,46,12,34
Setash,hyjal,1081,evoker,preservation,24,12,12
Clubmetro,boulderfist,1081,evoker,preservation,39,18,21
Lahfly,tichondrius,1079,evoker,preservation,54,33,21
Dragoreo,illidan,1078,evoker,preservation,47,20,27
Shenrøn,altar-of-storms,1076,evoker,preservation,50,28,22
Qiuhan,tichondrius,1076,evoker,preservation,48,23,25
Bronzus,ragnaros,1076,evoker,preservation,73,29,44
Lilithà,kelthuzad,1075,evoker,preservation,30,20,10
Stankywing,thrall,1075,evoker,preservation,34,17,17
Deàthwing,proudmoore,1074,evoker,preservation,53,16,37
Bobstrasz,tichondrius,1073,evoker,preservation,36,12,24
Unscaleable,illidan,1072,evoker,preservation,18,13,5
Bumbledragn,moon-guard,1071,evoker,preservation,37,23,14
Maxyz,khadgar,1071,evoker,preservation,42,13,29
Balmoze,tichondrius,1070,evoker,preservation,60,31,29
Dragonknght,tichondrius,1066,evoker,preservation,30,16,14
Draganoche,zuljin,1066,evoker,preservation,30,14,16
Kharizard,moon-guard,1065,evoker,preservation,33,12,21
Worldsdragon,area-52,1064,evoker,preservation,24,16,8
Shyyvana,malganis,1062,evoker,preservation,18,12,6
Sacrementus,tichondrius,1062,evoker,preservation,66,24,42
Fenalysten,cenarius,1060,evoker,preservation,113,49,64
Dragown,sargeras,1059,evoker,preservation,36,16,20
Tëssarion,quelthalas,1059,evoker,preservation,32,14,18
Binidragon,tichondrius,1055,evoker,preservation,12,11,1
Whelp,shadow-council,1055,evoker,preservation,18,11,7
Messyvok,illidan,1055,evoker,preservation,26,11,15
Unclelroh,kelthuzad,1054,evoker,preservation,24,11,13
Allaker,kargath,1054,evoker,preservation,40,17,23
Pnse,perenolde,1054,evoker,preservation,30,11,19
Dwagndeez,tichondrius,1054,evoker,preservation,30,11,19
Fenroth,kelthuzad,1052,evoker,preservation,24,11,13
Dragonfroot,darkspear,1052,evoker,preservation,24,11,13
Slippee,mugthol,1051,evoker,preservation,12,11,1
Imugee,sargeras,1051,evoker,preservation,24,11,13
Swanzea,sargeras,1049,evoker,preservation,18,11,7
Puraimaru,sargeras,1049,evoker,preservation,30,11,19
Vxfire,sargeras,1047,evoker,preservation,24,11,13
Chewykek,area-52,1047,evoker,preservation,24,11,13
Scalethorne,illidan,1047,evoker,preservation,24,11,13
Smögg,quelthalas,1046,evoker,preservation,42,19,23
Jinuva,tichondrius,1045,evoker,preservation,18,11,7
Draghyon,tichondrius,1044,evoker,preservation,42,11,31
Drittles,illidan,1043,evoker,preservation,62,28,34
Dragonarchy,draenor,1042,evoker,preservation,54,26,28
Uniqqe,tichondrius,1041,evoker,preservation,18,11,7
Dracoly,medivh,1041,evoker,preservation,24,12,12
Bobbydracthy,illidan,1041,evoker,preservation,24,11,13
Brovoker,darkspear,1039,evoker,preservation,24,11,13
Jorlozthyr,ragnaros,1039,evoker,preservation,36,12,24
Charadrius,zuljin,1038,evoker,preservation,41,23,18
Strawdormu,ragnaros,1037,evoker,preservation,18,11,7
Myxter,tichondrius,1035,evoker,preservation,49,25,24
Cripcuhz,tichondrius,1035,evoker,preservation,72,36,36
Carloxd,tichondrius,1035,evoker,preservation,34,12,22
Boomlvx,frostmourne,1034,evoker,preservation,24,11,13
Enzi,vashj,1033,evoker,preservation,24,11,13
Fránky,ragnaros,1033,evoker,preservation,71,31,40
Blankebr,gallywix,1032,evoker,preservation,36,24,12
Proevoker,illidan,1031,evoker,preservation,24,11,13
Skkuld,stormrage,1029,evoker,preservation,24,11,13
Evohrker,area-52,1028,evoker,preservation,24,11,13
Dracomedicus,frostmourne,1028,evoker,preservation,70,24,46
Degghurtni,area-52,1026,evoker,preservation,18,11,7
Mokkdala,blackrock,1026,evoker,preservation,40,12,28
Evoke,boulderfist,1025,evoker,preservation,28,12,16
Sïgrìd,tichondrius,1024,evoker,preservation,45,30,15
Sophdrac,illidan,1024,evoker,preservation,43,25,18
Karmakulax,wildhammer,1024,evoker,preservation,31,12,19
Trillis,eldrethalas,1023,evoker,preservation,36,23,13
Vandinus,stormrage,1023,evoker,preservation,50,23,27
Draconys,shattered-hand,1020,evoker,preservation,42,23,19
Adessa,lothar,1020,evoker,preservation,36,14,22
Ownlyfans,silvermoon,1018,evoker,preservation,24,12,12
Cunk,illidan,1018,evoker,preservation,24,11,13
Prahvlord,shuhalo,1018,evoker,preservation,60,26,34
Turukmakto,illidan,1017,evoker,preservation,29,14,15
Tarnuss,skullcrusher,1017,evoker,preservation,42,14,28
Eiselhuus,moon-guard,1015,evoker,preservation,59,21,38
Toothless,garithos,1014,evoker,preservation,30,17,13
Mightywings,skywall,1011,evoker,preservation,138,70,68
Ohffs,malganis,1011,evoker,preservation,30,14,16
Richviewrd,illidan,1010,evoker,preservation,42,22,20
Esq,sargeras,1007,evoker,preservation,17,11,6
Kaeszandrus,azralon,1007,evoker,preservation,64,29,35
Boomon,blades-edge,1006,evoker,preservation,42,21,21
Lightbeing,nazjatar,1001,evoker,preservation,48,29,19
Wheyvern,malganis,1000,evoker,preservation,93,41,52
Brahown,altar-of-storms,998,evoker,preservation,36,11,25
Bizzstrasza,shadowsong,992,evoker,preservation,64,28,36
Lawroadt,tichondrius,991,evoker,preservation,60,31,29
Gemis,anvilmar,991,evoker,preservation,55,25,30
Falsedaze,sargeras,990,evoker,preservation,43,20,23
Ozmayzin,proudmoore,990,evoker,preservation,69,30,39
Hover,vashj,989,evoker,preservation,27,13,14
Items,frostmourne,987,evoker,preservation,22,11,11
Vyreth,sargeras,987,evoker,preservation,81,38,43
Sensandors,tichondrius,987,evoker,preservation,26,11,15
Arazerazer,thrall,984,evoker,preservation,66,23,43
Arazarion,mugthol,979,evoker,preservation,30,17,13
Smaugett,zuljin,979,evoker,preservation,44,23,21
Kivoke,proudmoore,974,evoker,preservation,42,18,24
Curamil,azralon,973,evoker,preservation,26,11,15
Echoker,destromath,968,evoker,preservation,55,26,29
Milkspurt,tichondrius,962,evoker,preservation,52,23,29
Rubyzz,illidan,960,evoker,preservation,18,10,8
Goatkiller,lightbringer,960,evoker,preservation,18,10,8
Syraxiez,sargeras,960,evoker,preservation,18,10,8
Solryp,terokkar,960,evoker,preservation,149,72,77
Uncleìroh,tichondrius,960,evoker,preservation,24,10,14
Wamajam,area-52,960,evoker,preservation,24,10,14
Gaslightqt,tichondrius,960,evoker,preservation,25,10,15
Flyingkush,illidan,959,evoker,preservation,12,10,2
Baldpython,area-52,959,evoker,preservation,18,10,8
Dragoontekka,tichondrius,959,evoker,preservation,18,10,8
Abevv,bonechewer,959,evoker,preservation,18,10,8
Myspycanfly,malganis,958,evoker,preservation,12,10,2
Slrepeat,frostmourne,958,evoker,preservation,18,10,8
Puffthemagic,lightnings-blade,958,evoker,preservation,18,10,8
Truffleßutta,tichondrius,958,evoker,preservation,18,10,8
Dragonsand,area-52,958,evoker,preservation,62,30,32
Meepslol,kiljaeden,958,evoker,preservation,24,10,14
Drakthussey,illidan,957,evoker,preservation,18,10,8
Dokthyr,lightbringer,956,evoker,preservation,12,10,2
Erotheryx,gorgonnash,956,evoker,preservation,18,10,8
Goonguy,gnomeregan,955,evoker,preservation,12,10,2
Holdherhorn,area-52,955,evoker,preservation,18,10,8
Dragy,bonechewer,954,evoker,preservation,24,10,14
Hoverharder,stormrage,953,evoker,preservation,18,10,8
Istaybrutal,malganis,953,evoker,preservation,18,10,8
Soziin,skullcrusher,953,evoker,preservation,18,10,8
Grievaxion,ragnaros,953,evoker,preservation,24,10,14
Dragonblazer,illidan,952,evoker,preservation,18,10,8
Ayoitspav,malganis,952,evoker,preservation,25,11,14
Gemish,lethon,952,evoker,preservation,26,11,15
Chue,quelthalas,952,evoker,preservation,24,10,14
Rubyskye,tichondrius,950,evoker,preservation,18,10,8
Surasi,frostmourne,948,evoker,preservation,18,10,8
Frozonic,tichondrius,948,evoker,preservation,36,17,19
Razen,silvermoon,946,evoker,preservation,28,13,15
Tagritash,kelthuzad,946,evoker,preservation,24,10,14
Dracthyrius,thunderlord,941,evoker,preservation,18,12,6
Straightman,stormrage,940,evoker,preservation,68,32,36
Dracalis,thrall,939,evoker,preservation,58,30,28
Beerdragon,ragnaros,938,evoker,preservation,22,11,11
Zeldaryel,azralon,934,evoker,preservation,12,10,2
Gidury,tichondrius,934,evoker,preservation,96,44,52
Faethana,thrall,929,evoker,preservation,23,11,12
Azuril,wyrmrest-accord,929,evoker,preservation,90,29,61
Furygos,stormrage,927,evoker,preservation,23,10,13
Sheepdoll,icecrown,927,evoker,preservation,23,10,13
Rilex,kelthuzad,927,evoker,preservation,30,11,19
Dragonbro,spirestone,923,evoker,preservation,18,10,8
Tribunalis,stormrage,915,evoker,preservation,18,11,7
Lagartixa,kirin-tor,913,evoker,preservation,36,14,22
Justbreathe,sargeras,911,evoker,preservation,17,10,7
Kaelestian,ragnaros,910,evoker,preservation,36,18,18
Saintetoile,tichondrius,905,evoker,preservation,48,24,24
Aspects,dreadmaul,905,evoker,preservation,31,12,19
Badvoker,area-52,902,evoker,preservation,71,26,45
Cransvoker,illidan,902,evoker,preservation,30,10,20
Bandel,tichondrius,896,evoker,preservation,22,12,10
Kerlaan,illidan,895,evoker,preservation,18,10,8
Spitdafire,tichondrius,894,evoker,preservation,27,10,17
Medrathion,wyrmrest-accord,887,evoker,preservation,23,10,13
Drewskie,malganis,885,evoker,preservation,78,29,49
Dreezoo,tichondrius,881,evoker,preservation,62,33,29
Mugenyan,ragnaros,879,evoker,preservation,41,21,20
Pypokay,nemesis,877,evoker,preservation,48,17,31
Drakthuul,icecrown,869,evoker,preservation,70,32,38
Willowflight,illidan,867,evoker,preservation,50,23,27
Viserion,wildhammer,865,evoker,preservation,44,10,34
Toonahzy,area-52,864,evoker,preservation,12,9,3
Mikorivoker,illidan,864,evoker,preservation,12,9,3
Mewoker,sargeras,864,evoker,preservation,12,9,3
Calvoker,moon-guard,864,evoker,preservation,18,9,9
Yaaty,tichondrius,864,evoker,preservation,24,9,15
Fkndragon,proudmoore,864,evoker,preservation,30,9,21
Lizardfaith,tichondrius,863,evoker,preservation,12,9,3
Smnsevoker,emerald-dream,863,evoker,preservation,12,9,3
Wonderk,frostmourne,863,evoker,preservation,18,9,9
Tonymanitoba,whisperwind,863,evoker,preservation,18,9,9
Nuubvoker,stormrage,863,evoker,preservation,18,9,9
Tadhg,mugthol,863,evoker,preservation,30,12,18
Azngodz,tichondrius,863,evoker,preservation,24,9,15
Flaemer,thaurissan,862,evoker,preservation,12,9,3
Velocivraull,malganis,862,evoker,preservation,12,9,3
Xerithious,bleeding-hollow,862,evoker,preservation,18,9,9
Jesstrasza,quelthalas,862,evoker,preservation,96,42,54
Kakanjutan,azralon,861,evoker,preservation,16,10,6
Evvookkeerr,tichondrius,861,evoker,preservation,18,9,9
Gravityblast,tichondrius,861,evoker,preservation,24,9,15
Chewydragoon,kelthuzad,860,evoker,preservation,12,9,3
Binxyboy,garrosh,860,evoker,preservation,16,10,6
Arûmat,tichondrius,859,evoker,preservation,30,9,21
Glamorousbra,tichondrius,857,evoker,preservation,18,9,9
Aethrys,zuljin,856,evoker,preservation,12,9,3
Salakhar,drakkari,856,evoker,preservation,18,9,9
Bjason,tichondrius,855,evoker,preservation,18,9,9
Linabeauty,ragnaros,854,evoker,preservation,24,9,15
Dragonballer,trollbane,853,evoker,preservation,24,9,15
Garrgle,sargeras,850,evoker,preservation,18,9,9
Moxa,doomhammer,850,evoker,preservation,83,41,42
Moiraine,kargath,850,evoker,preservation,24,9,15
Hentaizilla,kiljaeden,850,evoker,preservation,55,19,36
Lickyertits,tichondrius,849,evoker,preservation,24,9,15
Lechonlechon,tichondrius,847,evoker,preservation,12,9,3
Orïon,azralon,845,evoker,preservation,24,9,15
Spliffdragon,sargeras,843,evoker,preservation,47,18,29
Drákô,ragnaros,841,evoker,preservation,30,9,21
Gdragons,tichondrius,838,evoker,preservation,22,11,11
Aurastella,frostwolf,837,evoker,preservation,24,9,15
Pinkponies,area-52,834,evoker,preservation,12,9,3
Lisatallie,moon-guard,834,evoker,preservation,18,9,9
Decyrion,bleeding-hollow,830,evoker,preservation,29,9,20
Sandrozeria,wyrmrest-accord,822,evoker,preservation,14,10,4
Dragginhealz,stormrage,821,evoker,preservation,120,56,64
Falastrasza,dalaran,821,evoker,preservation,23,9,14
Zaldraka,cairne,819,evoker,preservation,31,13,18
Yaaj,black-dragonflight,808,evoker,preservation,23,10,13
Risumon,uldum,802,evoker,preservation,156,60,96
Darkspyro,area-52,799,evoker,preservation,11,9,2
Icallthecops,tichondrius,798,evoker,preservation,16,9,7
Rockzocain,area-52,798,evoker,preservation,24,9,15
Lendren,sargeras,795,evoker,preservation,28,9,19
Scourgewing,wyrmrest-accord,795,evoker,preservation,30,9,21
Azuragon,illidan,793,evoker,preservation,71,23,48
Itsac,daggerspine,792,evoker,preservation,30,13,17
Drackaras,stormrage,790,evoker,preservation,18,9,9
Slyfur,burning-legion,786,evoker,preservation,18,9,9
Kaddyragon,mannoroth,768,evoker,preservation,12,8,4
Dracostayout,sargeras,768,evoker,preservation,12,8,4
Æsshayád,area-52,768,evoker,preservation,12,8,4
Rvrbzv,stormrage,768,evoker,preservation,12,8,4
Hasstle,tichondrius,768,evoker,preservation,12,8,4
Evokeondeez,stormrage,768,evoker,preservation,12,8,4
Babylons,area-52,768,evoker,preservation,18,8,10
Treysongz,area-52,768,evoker,preservation,18,8,10
Airschlong,tichondrius,768,evoker,preservation,18,8,10
Ryóng,tichondrius,768,evoker,preservation,18,8,10
Unclefarmer,illidan,768,evoker,preservation,18,8,10
Djvoker,zuljin,767,evoker,preservation,12,8,4
Dendedewd,sargeras,767,evoker,preservation,12,8,4
Fluffelss,moon-guard,767,evoker,preservation,12,8,4
Icecoldrink,suramar,767,evoker,preservation,12,8,4
Walloper,malganis,767,evoker,preservation,12,8,4
Baradad,frostmourne,767,evoker,preservation,12,8,4
Xiaolongmei,frostmourne,767,evoker,preservation,18,8,10
Liltj,tichondrius,767,evoker,preservation,18,8,10
Innervoker,tichondrius,767,evoker,preservation,18,8,10
Smurgma,frostmane,767,evoker,preservation,18,8,10
Dracritzzx,ragnaros,767,evoker,preservation,18,8,10
Shrimpshumai,malganis,767,evoker,preservation,18,8,10
Dracthott,thrall,767,evoker,preservation,18,8,10
Slèv,frostmourne,767,evoker,preservation,18,8,10
Nowon,tichondrius,767,evoker,preservation,24,8,16
Devilmanguy,bonechewer,767,evoker,preservation,24,8,16
Dracarus,crushridge,767,evoker,preservation,30,8,22
Talzindera,sargeras,766,evoker,preservation,18,8,10
Rewind,draka,766,evoker,preservation,18,8,10
Sunfyrion,sargeras,766,evoker,preservation,24,8,16
Shworm,bleeding-hollow,764,evoker,preservation,12,8,4
Snitx,stormrage,764,evoker,preservation,24,8,16
Neewhad,malganis,764,evoker,preservation,24,8,16
Nutsdragon,tichondrius,763,evoker,preservation,18,8,10
Wrathiøn,sargeras,763,evoker,preservation,24,8,16
Matsutake,kelthuzad,762,evoker,preservation,18,8,10
Dandroz,kelthuzad,761,evoker,preservation,18,8,10
Bitkoinz,tichondrius,760,evoker,preservation,24,8,16
Draehgor,hyjal,758,evoker,preservation,18,8,10
Crumbflaps,kelthuzad,758,evoker,preservation,24,8,16
Drabbot,thunderlord,755,evoker,preservation,12,8,4
Lervish,durotan,755,evoker,preservation,12,8,4
Gamesruined,area-52,753,evoker,preservation,19,8,11
Tooby,velen,751,evoker,preservation,12,8,4
Cinderoz,moon-guard,751,evoker,preservation,12,8,4
Drevoker,lightbringer,748,evoker,preservation,18,8,10
Criteria,burning-legion,748,evoker,preservation,18,8,10
Madvillin,stormrage,747,evoker,preservation,12,8,4
Chaosrebørn,bleeding-hollow,746,evoker,preservation,36,8,28
Shintrax,ragnaros,744,evoker,preservation,73,35,38
Durtyvoker,illidan,735,evoker,preservation,22,8,14
Butta,darkspear,734,evoker,preservation,17,8,9
Enuzan,dalaran,734,evoker,preservation,32,8,24
Polland,area-52,731,evoker,preservation,17,8,9
Enoch,chogall,727,evoker,preservation,27,10,17
Tailia,sargeras,718,evoker,preservation,23,8,15
Geicovoker,tichondrius,714,evoker,preservation,28,9,19
Scaleyboy,tichondrius,713,evoker,preservation,21,10,11
Shardsnorta,chogall,708,evoker,preservation,17,8,9
Kyrusic,tichondrius,705,evoker,preservation,27,11,16
Lunadragon,spinebreaker,704,evoker,preservation,16,8,8
Murozond,burning-blade,703,evoker,preservation,20,8,12
Kleptomancy,moon-guard,702,evoker,preservation,11,8,3
Kalswyrm,burning-blade,702,evoker,preservation,20,8,12
Wilbog,moon-guard,700,evoker,preservation,44,10,34
Letharrian,sargeras,698,evoker,preservation,12,10,2
Jsb,moon-guard,696,evoker,preservation,54,10,44
Orame,dalaran,685,evoker,preservation,25,8,17
Venlormi,moon-guard,675,evoker,preservation,46,15,31
Goursaud,malganis,672,evoker,preservation,12,7,5
Beatxqt,area-52,672,evoker,preservation,12,7,5
Whirlydirly,malganis,672,evoker,preservation,12,7,5
Vekke,illidan,672,evoker,preservation,12,7,5
Azurgos,proudmoore,672,evoker,preservation,12,7,5
Arnoeryan,ragnaros,672,evoker,preservation,12,7,5
Vroomby,area-52,672,evoker,preservation,12,7,5
Iantern,dalaran,672,evoker,preservation,12,7,5
Vroomby,sargeras,672,evoker,preservation,12,7,5
Suekeysaurus,frostmourne,672,evoker,preservation,12,7,5
Alithrya,illidan,672,evoker,preservation,12,7,5
Lilrandal,emerald-dream,672,evoker,preservation,12,7,5
Ruffee,frostmourne,672,evoker,preservation,12,7,5
Hypetwo,bleeding-hollow,672,evoker,preservation,12,7,5
Vrondiss,trollbane,672,evoker,preservation,12,7,5
Dragondubya,illidan,672,evoker,preservation,12,7,5
Clm,staghelm,672,evoker,preservation,12,7,5
Soyum,sargeras,672,evoker,preservation,18,7,11
Imwoker,illidan,672,evoker,preservation,18,7,11
Orncen,emerald-dream,672,evoker,preservation,18,7,11
Draikia,zuljin,672,evoker,preservation,18,7,11
Roastdrake,tichondrius,672,evoker,preservation,18,7,11
Golden,area-52,672,evoker,preservation,18,7,11
Toastsevoker,tichondrius,672,evoker,preservation,18,7,11
Draislyn,cenarion-circle,672,evoker,preservation,18,7,11
Evoketage,malganis,672,evoker,preservation,18,7,11
Iamg,stormscale,672,evoker,preservation,18,7,11
Datinysmaug,stormrage,672,evoker,preservation,21,7,14
Zalpx,sargeras,672,evoker,preservation,24,7,17
Hdyl,tichondrius,672,evoker,preservation,24,7,17
Kontaz,icecrown,672,evoker,preservation,24,7,17
Vertorgon,proudmoore,671,evoker,preservation,12,7,5
Flapthewap,illidan,671,evoker,preservation,12,7,5
Squablebox,kul-tiras,671,evoker,preservation,12,7,5
Doramifa,tichondrius,671,evoker,preservation,12,7,5
Vaxilia,sargeras,671,evoker,preservation,12,7,5
Forlornomens,area-52,671,evoker,preservation,12,7,5
Tyrøs,illidan,671,evoker,preservation,12,7,5
Mittnz,arthas,671,evoker,preservation,12,7,5
Kaidough,tichondrius,671,evoker,preservation,12,7,5
Spicypnuts,zuljin,671,evoker,preservation,12,7,5
Reskue,burning-legion,671,evoker,preservation,12,7,5
Toppedyouoff,thrall,671,evoker,preservation,15,7,8
Jigsz,illidan,671,evoker,preservation,18,7,11
Longxx,dalaran,671,evoker,preservation,18,7,11
Likelybaked,kiljaeden,671,evoker,preservation,18,7,11
Nunez,frostmourne,671,evoker,preservation,18,7,11
Trogdør,illidan,671,evoker,preservation,18,7,11
Tailup,sargeras,671,evoker,preservation,18,7,11
Bookkoo,burning-legion,671,evoker,preservation,24,7,17
Drøgon,sargeras,671,evoker,preservation,24,7,17
Lampizard,bonechewer,671,evoker,preservation,24,7,17
Nienze,wyrmrest-accord,670,evoker,preservation,12,7,5
Mad,aerie-peak,670,evoker,preservation,19,9,10
Zumanitÿ,zangarmarsh,670,evoker,preservation,18,7,11
Dshiznit,sargeras,670,evoker,preservation,24,7,17
Woozul,malganis,670,evoker,preservation,30,7,23
Deezyroller,sargeras,669,evoker,preservation,12,7,5
Auradraca,queldorei,669,evoker,preservation,13,7,6
Retcondragon,sargeras,669,evoker,preservation,18,7,11
Rhaènyra,sargeras,669,evoker,preservation,18,7,11
Tazalth,uther,668,evoker,preservation,18,7,11
Selden,boulderfist,668,evoker,preservation,18,7,11
Shartzypoo,thrall,668,evoker,preservation,24,7,17
Alexstrazaa,hyjal,667,evoker,preservation,12,7,5
Drizzydrag,jubeithos,667,evoker,preservation,18,7,11
Xdragon,lightbringer,667,evoker,preservation,18,7,11
Rainwalkers,illidan,666,evoker,preservation,12,7,5
Aceu,bloodhoof,665,evoker,preservation,12,7,5
Azulnova,tichondrius,665,evoker,preservation,18,7,11
Erso,hellscream,664,evoker,preservation,12,7,5
Acidbreath,tichondrius,661,evoker,preservation,18,7,11
Leralera,moon-guard,660,evoker,preservation,12,7,5
Mulutlaser,frostmourne,659,evoker,preservation,18,7,11
Densgone,aggramar,654,evoker,preservation,18,7,11
Yiptondabs,emerald-dream,650,evoker,preservation,29,7,22
Thenasath,sargeras,640,evoker,preservation,17,7,10
Wizkmushu,tichondrius,639,evoker,preservation,14,8,6
Ramas,burning-blade,638,evoker,preservation,32,8,24
Elderdragon,nerzhul,629,evoker,preservation,16,8,8
Kixxely,sargeras,623,evoker,preservation,12,8,4
Bootymágic,tichondrius,621,evoker,preservation,15,8,7
Tsuruda,illidan,618,evoker,preservation,21,8,13
Soukizilla,sargeras,608,evoker,preservation,16,7,9
Saxthyr,stormreaver,592,evoker,preservation,13,7,6
Ambadragon,frostmourne,591,evoker,preservation,11,7,4
Madzul,emerald-dream,590,evoker,preservation,13,7,6
Hwansu,tichondrius,576,evoker,preservation,6,6,0
Cheesedragon,tichondrius,576,evoker,preservation,6,6,0
Tatsurai,tichondrius,576,evoker,preservation,10,7,3
Jugemjugempe,icecrown,576,evoker,preservation,12,6,6
Diregon,kelthuzad,576,evoker,preservation,12,6,6
Thalzudormu,bleeding-hollow,576,evoker,preservation,12,6,6
Kwaz,kelthuzad,576,evoker,preservation,12,6,6
Localfemboy,area-52,576,evoker,preservation,12,6,6
Mushuffle,malygos,576,evoker,preservation,12,6,6
Ozvoker,area-52,576,evoker,preservation,12,6,6
Whitesnow,korgath,576,evoker,preservation,12,6,6
Dragondznuts,archimonde,576,evoker,preservation,12,6,6
Teëst,malganis,576,evoker,preservation,12,6,6
Thefish,tichondrius,576,evoker,preservation,12,6,6
Oldgeorge,tichondrius,576,evoker,preservation,12,6,6
Daylenx,thrall,576,evoker,preservation,12,6,6
Bad,nerzhul,576,evoker,preservation,12,6,6
Melvoker,tichondrius,576,evoker,preservation,12,6,6
Theyevokbuda,kelthuzad,576,evoker,preservation,12,6,6
Wtfhappen,tichondrius,576,evoker,preservation,12,6,6
Thegoone,bleeding-hollow,576,evoker,preservation,12,6,6
Bookwyrm,khadgar,576,evoker,preservation,12,6,6
Ccguzzlerx,tichondrius,576,evoker,preservation,12,6,6
Exrtj,stormrage,576,evoker,preservation,12,6,6
Teddydarg,tichondrius,576,evoker,preservation,14,6,8
Hicane,tichondrius,576,evoker,preservation,18,6,12
Alerale,thunderlord,576,evoker,preservation,18,6,12
Ablunxs,drakkari,576,evoker,preservation,18,6,12
Phanthyr,tichondrius,576,evoker,preservation,18,6,12
Westyvoker,arthas,576,evoker,preservation,18,6,12
Murphymonsta,stormscale,576,evoker,preservation,18,6,12
Dragonk,dragonblight,576,evoker,preservation,18,6,12
Jumpmaster,black-dragonflight,576,evoker,preservation,24,6,18
Ryloun,sargeras,576,evoker,preservation,24,6,18
Toodllesz,stormrage,575,evoker,preservation,6,6,0
Valeshkanyel,ragnaros,575,evoker,preservation,12,6,6
Karuikei,proudmoore,575,evoker,preservation,12,6,6
Tokeandvoke,haomarush,575,evoker,preservation,12,6,6
Ygnizem,ysera,575,evoker,preservation,12,6,6
Flameschosen,malganis,575,evoker,preservation,12,6,6
Dragonpaws,illidan,575,evoker,preservation,12,6,6
Nâpâlm,aggramar,575,evoker,preservation,12,6,6
Bhfflove,area-52,575,evoker,preservation,12,6,6
Valadrakth,tichondrius,575,evoker,preservation,12,6,6
Drakistraz,draenor,575,evoker,preservation,12,6,6
Magnito,thorium-brotherhood,575,evoker,preservation,12,6,6
Tekath,altar-of-storms,575,evoker,preservation,12,6,6
Shinryuu,warsong,575,evoker,preservation,12,6,6
Quetzaluma,tichondrius,575,evoker,preservation,14,6,8
Tanninim,sargeras,575,evoker,preservation,18,6,12
Naùghtygames,area-52,575,evoker,preservation,18,6,12
Sgtskip,blackrock,575,evoker,preservation,24,6,18
Kyloflight,thrall,575,evoker,preservation,24,6,18
Drippydragon,stormrage,574,evoker,preservation,12,6,6
Amun,frostwolf,574,evoker,preservation,12,6,6
Evalker,tichondrius,574,evoker,preservation,12,6,6
Cinderazerat,moon-guard,574,evoker,preservation,18,6,12
Karrykx,tichondrius,574,evoker,preservation,18,6,12
Azalana,thrall,574,evoker,preservation,24,6,18
Rzdrag,nemesis,574,evoker,preservation,36,6,30
Moraise,bonechewer,573,evoker,preservation,12,6,6
Ozsandlbs,tichondrius,573,evoker,preservation,12,6,6
Siquitraki,illidan,573,evoker,preservation,18,6,12
Zulidar,silvermoon,572,evoker,preservation,12,6,6
Banevoker,tichondrius,570,evoker,preservation,17,7,10
Lishalthen,frostmourne,569,evoker,preservation,12,6,6
Rhaeynes,moon-guard,568,evoker,preservation,12,6,6
Ankhalagor,ragnaros,567,evoker,preservation,12,6,6
Preservant,stormrage,567,evoker,preservation,12,6,6
Dragussy,illidan,548,evoker,preservation,28,10,18
Hecklinheals,hyjal,544,evoker,preservation,13,7,6
Hexavalent,tichondrius,542,evoker,preservation,11,6,5
Galrend,firetree,542,evoker,preservation,17,6,11
Dabdrake,illidan,539,evoker,preservation,14,7,7
Arazen,frostmourne,539,evoker,preservation,23,6,17
Fieros,area-52,527,evoker,preservation,13,6,7
Imperialist,proudmoore,522,evoker,preservation,29,7,22
Shenlòng,drakkari,521,evoker,preservation,15,7,8
Supernovax,illidan,512,evoker,preservation,16,6,10
Imaginedrgn,tichondrius,511,evoker,preservation,11,6,5
Nwo,shattered-hand,494,evoker,preservation,11,6,5
Brindletail,proudmoore,494,evoker,preservation,19,6,13
Arzaria,stormrage,480,evoker,preservation,6,5,1
Finnahorns,sargeras,480,evoker,preservation,6,5,1
Chinadragon,balnazzar,480,evoker,preservation,6,5,1
Timaeuz,malganis,480,evoker,preservation,6,5,1
Deathwingjr,illidan,480,evoker,preservation,6,5,1
Cutewing,tichondrius,480,evoker,preservation,12,5,7
Oldmandrake,mannoroth,480,evoker,preservation,12,5,7
Shazdrag,stormrage,480,evoker,preservation,12,5,7
Ezarra,tichondrius,480,evoker,preservation,12,5,7
Killaseabee,lightnings-blade,480,evoker,preservation,12,5,7
Spaceox,tichondrius,480,evoker,preservation,12,5,7
Spyroguts,thrall,480,evoker,preservation,12,5,7
Berylhwit,emerald-dream,480,evoker,preservation,12,5,7
Draktharl,tichondrius,480,evoker,preservation,12,5,7
Chronocolter,thunderhorn,480,evoker,preservation,12,5,7
Thedajjal,tichondrius,480,evoker,preservation,12,5,7
Pyraxes,thunderhorn,480,evoker,preservation,12,5,7
Cirroaltos,aerie-peak,480,evoker,preservation,12,5,7
Proust,grizzly-hills,480,evoker,preservation,12,5,7
Jejep,sargeras,480,evoker,preservation,12,5,7
Supernamv,sargeras,480,evoker,preservation,12,5,7
Jambiisauce,fenris,480,evoker,preservation,12,5,7
Evizzar,zuljin,480,evoker,preservation,12,5,7
Pinkoi,antonidas,480,evoker,preservation,12,5,7
Zealantis,area-52,480,evoker,preservation,12,5,7
Fazedd,tichondrius,480,evoker,preservation,12,5,7
Wydbro,kiljaeden,480,evoker,preservation,12,5,7
Minzur,illidan,480,evoker,preservation,21,6,15
Olindoe,tichondrius,480,evoker,preservation,18,5,13
Cruv,boulderfist,480,evoker,preservation,18,5,13
Gdragon,sargeras,480,evoker,preservation,18,5,13
Bronyflexy,sargeras,480,evoker,preservation,24,5,19
Selenian,area-52,480,evoker,preservation,24,5,19
Bvo,stormrage,479,evoker,preservation,6,5,1
Kratostrasz,moon-guard,479,evoker,preservation,12,5,7
Lazzarross,area-52,479,evoker,preservation,12,5,7
Dragonsoup,frostmourne,479,evoker,preservation,12,5,7
Flappeebird,area-52,479,evoker,preservation,12,5,7
Rezpmpdragon,tichondrius,479,evoker,preservation,12,5,7
Álln,sargeras,479,evoker,preservation,12,5,7
Dracdeez,dreadmaul,479,evoker,preservation,12,5,7
Drektar,the-scryers,479,evoker,preservation,12,5,7
Vaeghar,anvilmar,479,evoker,preservation,12,5,7
Wrathykos,thrall,479,evoker,preservation,12,5,7
Psyydragon,azralon,479,evoker,preservation,18,5,13
Lizardtrash,ragnaros,478,evoker,preservation,12,5,7
Melbu,thunderlord,478,evoker,preservation,12,5,7
Flymuch,illidan,478,evoker,preservation,18,5,13
Wetsponge,kelthuzad,477,evoker,preservation,12,5,7
Scaryðragon,akama,477,evoker,preservation,12,5,7
Korvold,zuluhed,477,evoker,preservation,12,5,7
Livemaximii,moon-guard,477,evoker,preservation,12,5,7
Dracorblaq,bleeding-hollow,476,evoker,preservation,12,5,7
Tazeneth,sargeras,476,evoker,preservation,12,5,7
Astaro,area-52,476,evoker,preservation,24,5,19
Interracial,stormscale,475,evoker,preservation,10,6,4
Ruination,lightnings-blade,463,evoker,preservation,17,5,12
Amoraz,tichondrius,460,evoker,preservation,23,5,18
Digna,thrall,448,evoker,preservation,16,5,11
Jcii,tichondrius,447,evoker,preservation,11,5,6
Drakonyx,mugthol,439,evoker,preservation,17,5,12
Meilokkttv,sargeras,432,evoker,preservation,13,5,8
Temporal,mannoroth,431,evoker,preservation,9,6,3
Gaserick,quelthalas,426,evoker,preservation,17,6,11
Tealik,frostmourne,416,evoker,preservation,16,5,11
Hutáo,tichondrius,415,evoker,preservation,20,5,15
Prøøf,kelthuzad,414,evoker,preservation,14,5,9
Monzydrake,emerald-dream,408,evoker,preservation,20,5,15
Mtndewboy,illidan,384,evoker,preservation,6,4,2
Jëthrø,illidan,384,evoker,preservation,6,4,2
Nøzmosis,area-52,384,evoker,preservation,6,4,2
Ctlajumma,frostmourne,384,evoker,preservation,6,4,2
Wickedwings,tichondrius,384,evoker,preservation,6,4,2
Blazedvoke,tichondrius,384,evoker,preservation,6,4,2
Velahesa,sargeras,384,evoker,preservation,6,4,2
Syneestra,nemesis,384,evoker,preservation,6,4,2
Dyvyne,demon-soul,384,evoker,preservation,6,4,2
Râïn,tichondrius,384,evoker,preservation,6,4,2
Docevoker,tichondrius,384,evoker,preservation,6,4,2
Tygor,arthas,384,evoker,preservation,6,4,2
Pramhedax,tichondrius,384,evoker,preservation,6,4,2
Blackdragôn,stormrage,384,evoker,preservation,6,4,2
Odmehbb,tichondrius,384,evoker,preservation,6,4,2
Murloc,shadowsong,384,evoker,preservation,6,4,2
Taegon,area-52,384,evoker,preservation,6,4,2
Atraxian,tichondrius,384,evoker,preservation,6,4,2
Mvpjs,medivh,384,evoker,preservation,8,4,4
Pensini,illidan,384,evoker,preservation,12,4,8
Shoestrings,tichondrius,384,evoker,preservation,12,4,8
Drawong,zuljin,384,evoker,preservation,12,4,8
Williamjong,tichondrius,384,evoker,preservation,12,4,8
Dragrenghost,illidan,384,evoker,preservation,12,4,8
Bryágh,wyrmrest-accord,384,evoker,preservation,12,4,8
Yujirohanma,frostmourne,384,evoker,preservation,12,4,8
Dragonslut,kiljaeden,384,evoker,preservation,12,4,8
Donresantis,tichondrius,384,evoker,preservation,12,4,8
Blazedvoker,tichondrius,384,evoker,preservation,12,4,8
Raphdragon,stormrage,384,evoker,preservation,12,4,8
Khalio,hyjal,384,evoker,preservation,12,4,8
Heidibibe,tichondrius,384,evoker,preservation,12,4,8
Dragwyn,senjin,384,evoker,preservation,12,4,8
Slaymedaddy,proudmoore,384,evoker,preservation,12,4,8
Mignificent,sargeras,384,evoker,preservation,12,4,8
Rawrexp,emerald-dream,384,evoker,preservation,12,4,8
Crumbsock,thrall,384,evoker,preservation,12,4,8
Livebate,tichondrius,384,evoker,preservation,12,4,8
Oldui,frostmourne,384,evoker,preservation,12,4,8
Dracynmana,perenolde,384,evoker,preservation,12,4,8
Flipturn,illidan,384,evoker,preservation,12,4,8
Samostrasza,illidan,384,evoker,preservation,12,4,8
Imadargin,malganis,384,evoker,preservation,12,4,8
Vanyalus,uldum,384,evoker,preservation,12,4,8
Razenset,draktharon,384,evoker,preservation,12,4,8
Gójira,jubeithos,384,evoker,preservation,12,4,8
Hollowscale,emerald-dream,384,evoker,preservation,12,4,8
Boppled,tichondrius,384,evoker,preservation,12,4,8
Zandet,thunderlord,384,evoker,preservation,12,4,8
Sekidrac,ragnaros,384,evoker,preservation,12,4,8
Oatmealneil,bleeding-hollow,384,evoker,preservation,16,4,12
Clawbear,kiljaeden,384,evoker,preservation,18,4,14
Upsdriver,dentarg,384,evoker,preservation,18,4,14
Tidehunter,chogall,384,evoker,preservation,18,4,14
Trensetra,sargeras,384,evoker,preservation,18,4,14
Hammylee,firetree,384,evoker,preservation,24,4,20
Drakkar,elune,384,evoker,preservation,30,4,26
Quesovoke,eldrethalas,383,evoker,preservation,12,4,8
Freeblaze,blackhand,383,evoker,preservation,12,4,8
Razhion,arathor,383,evoker,preservation,12,4,8
Lunearia,stormrage,383,evoker,preservation,12,4,8
Dombi,moon-guard,383,evoker,preservation,12,4,8
Tihkal,spinebreaker,383,evoker,preservation,12,4,8
Sylvee,bleeding-hollow,383,evoker,preservation,13,4,9
Kyldarr,garithos,382,evoker,preservation,6,4,2
Uwuspit,tichondrius,382,evoker,preservation,12,4,8
Bigtoots,illidan,382,evoker,preservation,12,4,8
Enlighteni,area-52,382,evoker,preservation,12,4,8
Stroker,boulderfist,381,evoker,preservation,12,4,8
Danatreseth,moon-guard,380,evoker,preservation,12,4,8
Galaxiz,bonechewer,377,evoker,preservation,18,4,14
Ragendragon,hellscream,377,evoker,preservation,18,4,14
Daddyrp,tichondrius,372,evoker,preservation,26,9,17
Nyxstrasza,moknathal,366,evoker,preservation,11,4,7
Snailor,eldrethalas,351,evoker,preservation,10,4,6
Annazara,stormrage,336,evoker,preservation,9,4,5
Zathasar,tichondrius,333,evoker,preservation,28,4,24
Rápturé,tichondrius,330,evoker,preservation,16,7,9
Corlys,thunderhorn,330,evoker,preservation,17,5,12
Zaraller,tichondrius,329,evoker,preservation,9,5,4
Homiedraconi,nordrassil,329,evoker,preservation,12,5,7
Jolynne,illidan,320,evoker,preservation,14,4,10
Ccms,area-52,319,evoker,preservation,5,4,1
Vlysage,dark-iron,319,evoker,preservation,5,4,1
Lantur,perenolde,319,evoker,preservation,16,4,12
Polyrhythmic,ysera,304,evoker,preservation,7,4,3
Knowragretz,tichondrius,288,evoker,preservation,6,3,3
Dalechance,tichondrius,288,evoker,preservation,6,3,3
Thendetra,mannoroth,288,evoker,preservation,6,3,3
Spyrä,moon-guard,288,evoker,preservation,6,3,3
Redhorn,frostmourne,288,evoker,preservation,6,3,3
Jakburnon,stormrage,288,evoker,preservation,6,3,3
Rangä,caelestrasz,288,evoker,preservation,6,3,3
Gvoker,nemesis,288,evoker,preservation,6,3,3
Vokefuu,illidan,288,evoker,preservation,6,3,3
Hopefire,zuljin,288,evoker,preservation,6,3,3
Dragqueenx,hyjal,288,evoker,preservation,6,3,3
Dimpulse,zuljin,288,evoker,preservation,6,3,3
Tamagotchî,quelthalas,288,evoker,preservation,6,3,3
Lìthium,frostmourne,288,evoker,preservation,6,3,3
Flexlong,tichondrius,288,evoker,preservation,6,3,3
Jokko,moon-guard,288,evoker,preservation,6,3,3
Hakyou,tichondrius,288,evoker,preservation,6,3,3
Swagdriver,moon-guard,288,evoker,preservation,6,3,3
Paradïsso,tichondrius,288,evoker,preservation,6,3,3
Bigtitsdrag,illidan,288,evoker,preservation,6,3,3
Tournament,hakkar,288,evoker,preservation,6,3,3
Dracoon,madoran,288,evoker,preservation,6,3,3
Simplerules,zuljin,288,evoker,preservation,6,3,3
Draseew,drakkari,288,evoker,preservation,6,3,3
Æg,zuljin,288,evoker,preservation,6,3,3
Dragonwagon,kelthuzad,288,evoker,preservation,6,3,3
Powerfulman,drakthul,288,evoker,preservation,6,3,3
Setren,antonidas,288,evoker,preservation,6,3,3
Kheeleesi,illidan,288,evoker,preservation,6,3,3
Beelzeyob,illidan,288,evoker,preservation,6,3,3
Dragonleaves,sargeras,288,evoker,preservation,6,3,3
Dragonberry,tichondrius,288,evoker,preservation,6,3,3
Cambodian,whisperwind,288,evoker,preservation,6,3,3
Drogôn,cairne,288,evoker,preservation,6,3,3
Flapandclap,nerzhul,288,evoker,preservation,6,3,3
Zenazen,sargeras,288,evoker,preservation,6,3,3
Ðçßñÿåæéîùøð,tichondrius,288,evoker,preservation,6,3,3
Iggyytv,area-52,288,evoker,preservation,6,3,3
Predacious,draktharon,288,evoker,preservation,6,3,3
Razdargon,kiljaeden,288,evoker,preservation,6,3,3
Kñuj,illidan,288,evoker,preservation,6,3,3
Drakush,tichondrius,288,evoker,preservation,6,3,3
Chawp,tichondrius,288,evoker,preservation,6,3,3
Lirøu,azralon,288,evoker,preservation,6,3,3
Javoc,drakkari,288,evoker,preservation,6,3,3
Kreutzhauser,tichondrius,288,evoker,preservation,6,3,3
Shalanoth,proudmoore,288,evoker,preservation,6,3,3
Raxdragon,sargeras,288,evoker,preservation,6,3,3
Vygrax,nerzhul,288,evoker,preservation,6,3,3
Cônflicted,emerald-dream,288,evoker,preservation,6,3,3
Shenròn,kelthuzad,288,evoker,preservation,9,4,5
Aethyrious,moon-guard,288,evoker,preservation,12,3,9
Reflexd,malganis,288,evoker,preservation,12,3,9
Fugginuhh,proudmoore,288,evoker,preservation,12,3,9
Zulyia,moon-guard,288,evoker,preservation,12,3,9
Scyyterr,azralon,288,evoker,preservation,12,3,9
Ryuzaki,zuluhed,288,evoker,preservation,12,3,9
Dragonbabu,area-52,288,evoker,preservation,12,3,9
Galfiore,malganis,288,evoker,preservation,12,3,9
Raegon,wyrmrest-accord,288,evoker,preservation,12,3,9
Cøømbuya,sargeras,288,evoker,preservation,12,3,9
Discussion,area-52,288,evoker,preservation,12,3,9
Dwacawys,zuljin,288,evoker,preservation,12,3,9
Stormdagger,proudmoore,288,evoker,preservation,12,3,9
Teldormu,drenden,288,evoker,preservation,12,3,9
Tyrannicull,sargeras,288,evoker,preservation,12,3,9
Alevoker,ragnaros,288,evoker,preservation,12,3,9
Drazongas,cenarius,288,evoker,preservation,12,3,9
Ahahaa,frostmourne,288,evoker,preservation,12,3,9
Ðrízzy,area-52,288,evoker,preservation,12,3,9
Specscaly,hyjal,288,evoker,preservation,12,3,9
Hel,stormrage,288,evoker,preservation,12,3,9
Deathgos,stormscale,288,evoker,preservation,12,3,9
Snáckbóx,alexstrasza,288,evoker,preservation,12,3,9
Alysraa,moon-guard,288,evoker,preservation,12,3,9
Phosphothel,moon-guard,288,evoker,preservation,12,3,9
Explosives,blades-edge,288,evoker,preservation,12,3,9
Jammstraza,skywall,288,evoker,preservation,12,3,9
Fuzzievoker,tichondrius,288,evoker,preservation,12,3,9
Vulpyre,ragnaros,288,evoker,preservation,12,3,9
Vandornomu,illidan,288,evoker,preservation,12,3,9
Tefari,dalaran,288,evoker,preservation,12,3,9
Simmnyxia,area-52,288,evoker,preservation,12,3,9
Mouthgorawr,tichondrius,288,evoker,preservation,13,3,10
Wapowthion,blades-edge,288,evoker,preservation,18,3,15
Windchaser,kelthuzad,288,evoker,preservation,18,3,15
Rogir,zuljin,288,evoker,preservation,18,3,15
Arkaan,malganis,288,evoker,preservation,18,3,15
Rizzanomics,zuljin,287,evoker,preservation,8,4,4
Killerdragon,darkspear,287,evoker,preservation,6,3,3
Supereragon,area-52,287,evoker,preservation,6,3,3
Retroo,dark-iron,287,evoker,preservation,6,3,3
Arcaenae,moon-guard,287,evoker,preservation,6,3,3
Notvez,bleeding-hollow,287,evoker,preservation,6,3,3
Deralizrd,tichondrius,287,evoker,preservation,6,3,3
Drakier,kelthuzad,287,evoker,preservation,6,3,3
Tazen,bleeding-hollow,287,evoker,preservation,12,3,9
Draktarion,ragnaros,287,evoker,preservation,12,3,9
Kalestrasza,nathrezim,287,evoker,preservation,12,3,9
Chenrong,sargeras,287,evoker,preservation,12,3,9
Bilbodragons,stormreaver,287,evoker,preservation,12,3,9
Toothlesz,draka,287,evoker,preservation,18,3,15
Kalistro,quelthalas,286,evoker,preservation,6,3,3
Sodre,illidan,285,evoker,preservation,24,3,21
Gibvoke,icecrown,271,evoker,preservation,11,3,8
Blargan,area-52,271,evoker,preservation,17,3,14
Uskrait,tichondrius,255,evoker,preservation,14,4,10
Stíckyj,tichondrius,255,evoker,preservation,11,3,8
Slashprovoke,frostmourne,239,evoker,preservation,5,3,2
Dragontamz,the-forgotten-coast,239,evoker,preservation,5,3,2
Setrazen,illidan,234,evoker,preservation,9,4,5
Saenys,ragnaros,234,evoker,preservation,16,4,12
Avastra,blackrock,233,evoker,preservation,9,5,4
Tugmapvpean,kelthuzad,208,evoker,preservation,7,3,4
Zindrath,emerald-dream,192,evoker,preservation,6,2,4
Tóòthless,senjin,192,evoker,preservation,6,2,4
Emopidgey,dalaran,192,evoker,preservation,6,2,4
Daemon,terokkar,192,evoker,preservation,6,2,4
Topg,boulderfist,192,evoker,preservation,6,2,4
Nil,malganis,192,evoker,preservation,6,2,4
Jep,emerald-dream,192,evoker,preservation,6,2,4
Sketchybum,tichondrius,192,evoker,preservation,6,2,4
Ignicion,quelthalas,192,evoker,preservation,6,2,4
Ewoked,tichondrius,192,evoker,preservation,6,2,4
Alzuresh,illidan,192,evoker,preservation,6,2,4
Kaaer,emerald-dream,192,evoker,preservation,6,2,4
Raelennis,ragnaros,192,evoker,preservation,6,2,4
Wse,illidan,192,evoker,preservation,6,2,4
Jessefurr,undermine,192,evoker,preservation,6,2,4
Stickvoker,sargeras,192,evoker,preservation,6,2,4
Conorvokes,tichondrius,192,evoker,preservation,6,2,4
Custipiu,azralon,192,evoker,preservation,6,2,4
Invdkill,azralon,192,evoker,preservation,6,2,4
Froky,stormrage,192,evoker,preservation,6,2,4
Johka,tichondrius,192,evoker,preservation,6,2,4
Syfen,burning-blade,192,evoker,preservation,6,2,4
Dscim,zuljin,192,evoker,preservation,6,2,4
Drugdoer,illidan,192,evoker,preservation,6,2,4
Lexazule,bleeding-hollow,192,evoker,preservation,6,2,4
Koopa,malygos,192,evoker,preservation,6,2,4
Ndr,proudmoore,192,evoker,preservation,6,2,4
Flappyboy,bleeding-hollow,192,evoker,preservation,6,2,4
Alexevoker,tichondrius,192,evoker,preservation,6,2,4
Carrnedge,area-52,192,evoker,preservation,6,2,4
Dragonsand,stormrage,192,evoker,preservation,6,2,4
Dröhkar,ragnaros,192,evoker,preservation,6,2,4
Drakhaz,azralon,192,evoker,preservation,6,2,4
Dwagonwage,zuljin,192,evoker,preservation,6,2,4
Racovoker,zuljin,192,evoker,preservation,6,2,4
Exiztx,tichondrius,192,evoker,preservation,6,2,4
Lëåf,area-52,192,evoker,preservation,6,2,4
Salamandra,malganis,192,evoker,preservation,6,2,4
Kildormu,tichondrius,192,evoker,preservation,6,2,4
Nite,lothar,192,evoker,preservation,6,2,4
Baðìka,area-52,192,evoker,preservation,6,2,4
Hochelaga,arthas,192,evoker,preservation,6,2,4
Echowrath,tichondrius,192,evoker,preservation,6,2,4
Asterfoor,stormrage,192,evoker,preservation,6,2,4
Bloodydragon,firetree,192,evoker,preservation,6,2,4
Todorokî,frostmourne,192,evoker,preservation,6,2,4
Ineptqt,frostmourne,192,evoker,preservation,6,2,4
Wonyoungx,frostmourne,192,evoker,preservation,6,2,4
Blazor,sisters-of-elune,192,evoker,preservation,6,2,4
Kalrid,sargeras,192,evoker,preservation,6,2,4
Preserveluke,moon-guard,192,evoker,preservation,6,2,4
Evokesaint,wyrmrest-accord,192,evoker,preservation,6,2,4
Drapary,dathremar,192,evoker,preservation,6,2,4
Melchior,suramar,192,evoker,preservation,6,2,4
Ashgaar,sargeras,192,evoker,preservation,6,2,4
Raphd,sargeras,192,evoker,preservation,12,2,10
Huanglong,sargeras,192,evoker,preservation,12,2,10
Toyatoki,stormrage,192,evoker,preservation,12,2,10
Luxxa,bloodhoof,192,evoker,preservation,12,2,10
Ceraxxes,tichondrius,192,evoker,preservation,12,2,10
Pandavoke,kelthuzad,192,evoker,preservation,12,2,10
Contractor,emerald-dream,192,evoker,preservation,12,2,10
Archoni,kelthuzad,192,evoker,preservation,12,2,10
Timecøp,zuljin,192,evoker,preservation,12,2,10
Tightp,malganis,192,evoker,preservation,12,2,10
Shellybelly,shadowmoon,192,evoker,preservation,12,2,10
Slizards,area-52,192,evoker,preservation,12,2,10
Drakthyrmonk,hyjal,192,evoker,preservation,12,2,10
Takasaki,dalaran,192,evoker,preservation,12,2,10
Olesmokey,tichondrius,192,evoker,preservation,12,2,10
Olawd,azshara,192,evoker,preservation,12,2,10
Moop,spinebreaker,192,evoker,preservation,12,2,10
Nøøvè,area-52,192,evoker,preservation,12,2,10
Drachenatem,skywall,192,evoker,preservation,15,2,13
Dadydafather,sargeras,192,evoker,preservation,24,2,22
Draxitar,blackrock,191,evoker,preservation,6,2,4
Lacost,area-52,191,evoker,preservation,6,2,4
Valethal,ragnaros,191,evoker,preservation,6,2,4
Spyrð,emerald-dream,191,evoker,preservation,6,2,4
Shtableboy,illidan,191,evoker,preservation,12,2,10
Shadowyasuke,area-52,191,evoker,preservation,12,2,10
Evooern,frostmourne,175,evoker,preservation,11,2,9
Solekstraza,stormrage,160,evoker,preservation,10,3,7
Devokerkofwa,tichondrius,159,evoker,preservation,5,2,3
Jetthryx,emerald-dream,159,evoker,preservation,11,2,9
Dragonbush,sargeras,138,evoker,preservation,10,3,7
Scalendar,frostmourne,138,evoker,preservation,11,3,8
Shíkyo,stormrage,138,evoker,preservation,20,3,17
Winghoof,kiljaeden,128,evoker,preservation,10,2,8
Dragoondeez,bleeding-hollow,96,evoker,preservation,3,2,1
Hutterbut,malganis,96,evoker,preservation,3,2,1
Beanflickher,tichondrius,96,evoker,preservation,6,1,5
Deviantart,emerald-dream,96,evoker,preservation,6,1,5
Ohmylanta,stormrage,96,evoker,preservation,6,1,5
Pyrepeanut,tichondrius,96,evoker,preservation,6,1,5
Myjewelshurt,stormrage,96,evoker,preservation,6,1,5
Vvhip,tichondrius,96,evoker,preservation,6,1,5
Tobee,stormrage,96,evoker,preservation,6,1,5
Csodragon,sargeras,96,evoker,preservation,6,1,5
Daraz,tichondrius,96,evoker,preservation,6,1,5
Rekkcah,bloodscalp,96,evoker,preservation,6,1,5
Spyroh,crushridge,96,evoker,preservation,6,1,5
Henryvoker,moknathal,96,evoker,preservation,6,1,5
Rojothyr,tichondrius,96,evoker,preservation,6,1,5
Chrisbenoitx,illidan,96,evoker,preservation,6,1,5
Ripdumpster,bonechewer,96,evoker,preservation,6,1,5
Newclassop,emerald-dream,96,evoker,preservation,6,1,5
Acvoker,tichondrius,96,evoker,preservation,6,1,5
Dragondoh,frostmourne,96,evoker,preservation,6,1,5
Gamerwords,barthilas,96,evoker,preservation,6,1,5
Sobuker,wyrmrest-accord,96,evoker,preservation,6,1,5
Iamthêt,sargeras,96,evoker,preservation,6,1,5
Etereosthel,ragnaros,96,evoker,preservation,6,1,5
Azurflame,tichondrius,96,evoker,preservation,6,1,5
Talleraz,zuljin,96,evoker,preservation,6,1,5
Daymanx,zuljin,96,evoker,preservation,6,1,5
Patrdorasz,zuljin,96,evoker,preservation,6,1,5
Nivekk,zuljin,96,evoker,preservation,6,1,5
Xampusaurio,ragnaros,96,evoker,preservation,6,1,5
Nändy,tichondrius,96,evoker,preservation,6,1,5
Hausebat,moon-guard,96,evoker,preservation,6,1,5
Atreign,blackwing-lair,96,evoker,preservation,6,1,5
Omars,sargeras,96,evoker,preservation,6,1,5
Caelïn,malganis,96,evoker,preservation,6,1,5
Neroker,malganis,96,evoker,preservation,6,1,5
Ðräco,quelthalas,96,evoker,preservation,6,1,5
Dragostephen,nazjatar,96,evoker,preservation,6,1,5
Tyson,frostmane,96,evoker,preservation,6,1,5
Hardstuckirl,tichondrius,96,evoker,preservation,6,1,5
Trrxx,tichondrius,96,evoker,preservation,6,1,5
Rdrako,emerald-dream,96,evoker,preservation,6,1,5
Dragnips,bleeding-hollow,96,evoker,preservation,6,1,5
Ambium,dunemaul,96,evoker,preservation,6,1,5
Backuphealer,bleeding-hollow,96,evoker,preservation,6,1,5
Vermax,spirestone,96,evoker,preservation,6,1,5
Azgrodragon,stonemaul,96,evoker,preservation,6,1,5
Khaosdragona,proudmoore,96,evoker,preservation,6,1,5
Simarity,thrall,96,evoker,preservation,6,1,5
Tasdarallar,frostmourne,96,evoker,preservation,6,1,5
Keedrori,thrall,96,evoker,preservation,6,1,5
Saînt,thrall,96,evoker,preservation,6,1,5
Banjee,hellscream,96,evoker,preservation,6,1,5
Poatis,illidan,96,evoker,preservation,6,1,5
Mookthyr,area-52,96,evoker,preservation,6,1,5
Ashafi,area-52,96,evoker,preservation,6,1,5
Jeeyell,malganis,96,evoker,preservation,12,1,11
Dakotakek,illidan,96,evoker,preservation,12,1,11
Holyshiip,tichondrius,96,evoker,preservation,12,1,11
Eragon,feathermoon,96,evoker,preservation,12,1,11
Nelphemuer,wyrmrest-accord,96,evoker,preservation,12,1,11
Morkite,moon-guard,96,evoker,preservation,12,1,11
Seamanstorm,area-52,96,evoker,preservation,12,1,11
Shimshine,destromath,96,evoker,preservation,12,1,11
Rhale,whisperwind,96,evoker,preservation,12,1,11
Draghone,illidan,96,evoker,preservation,12,1,11
Khorvin,proudmoore,96,evoker,preservation,12,1,11
Derath,maelstrom,96,evoker,preservation,12,1,11
Sashvoker,illidan,96,evoker,preservation,12,1,11
Exilence,alleria,96,evoker,preservation,17,1,16
Zenetar,area-52,96,evoker,preservation,18,1,17
Sochen,kelthuzad,95,evoker,preservation,6,1,5
Blowmiê,area-52,79,evoker,preservation,5,1,4
Dragcules,thrall,42,evoker,preservation,11,2,9
Zagze,stormrage,42,evoker,preservation,15,2,13
Tenyeen,moonrunner,31,evoker,preservation,2,1,1
Luøzheng,drakkari,16,evoker,preservation,1,1,0
Sëverus,moon-guard,9,evoker,preservation,8,5,3
Thiqc,zuluhed,9,evoker,preservation,9,3,6
Nikthevoker,tichondrius,2207,evoker,devastation,176,96,80
Caedalade,spirestone,2180,evoker,devastation,123,70,53
Nikthevoker,area-52,2166,evoker,devastation,201,103,98
Ocdgamer,malganis,2158,evoker,devastation,121,62,59
Crappysmellz,tichondrius,2157,evoker,devastation,85,48,37
Whilefalse,stormrage,2125,evoker,devastation,95,48,47
Lizzimcguire,zuljin,2118,evoker,devastation,90,60,30
Dametra,proudmoore,2100,evoker,devastation,108,62,46
Chun,malganis,2096,evoker,devastation,54,32,22
Shamblewing,arthas,2094,evoker,devastation,89,44,45
Breathalizer,sargeras,2080,evoker,devastation,114,65,49
Caedalade,proudmoore,2056,evoker,devastation,348,174,174
Artemad,moon-guard,2048,evoker,devastation,108,64,44
Eastwubz,norgannon,2035,evoker,devastation,202,106,96
Rothvoker,tichondrius,2033,evoker,devastation,121,70,51
Frequevoker,tichondrius,2020,evoker,devastation,65,30,35
Somyr,area-52,2008,evoker,devastation,186,97,89
Kinndyvoker,sargeras,2003,evoker,devastation,65,34,31
Katadrak,area-52,1974,evoker,devastation,54,32,22
Evokemedaddy,bleeding-hollow,1974,evoker,devastation,161,83,78
Juicyjom,staghelm,1972,evoker,devastation,66,36,30
Meltharian,frostmourne,1966,evoker,devastation,134,75,59
Drogu,kelthuzad,1964,evoker,devastation,48,29,19
Hutaothighs,illidan,1937,evoker,devastation,130,67,63
Saryuja,thunderhorn,1927,evoker,devastation,64,42,22
Dzrn,moon-guard,1922,evoker,devastation,144,72,72
Wazgon,emerald-dream,1915,evoker,devastation,260,126,134
Rõÿ,area-52,1903,evoker,devastation,42,25,17
Ayavi,illidan,1890,evoker,devastation,96,61,35
Trogdør,illidan,1887,evoker,devastation,159,79,80
Quadude,illidan,1886,evoker,devastation,221,109,112
Gôdzevoker,area-52,1879,evoker,devastation,129,73,56
Arzaria,stormrage,1878,evoker,devastation,164,90,74
Seldantria,dalaran,1875,evoker,devastation,71,36,35
Azazél,borean-tundra,1868,evoker,devastation,257,136,121
Anachronormu,mannoroth,1864,evoker,devastation,101,56,45
Bigdrag,blackhand,1864,evoker,devastation,239,124,115
Krashbandico,zangarmarsh,1863,evoker,devastation,61,30,31
Mtndewboy,illidan,1856,evoker,devastation,126,67,59
Thrawn,arygos,1855,evoker,devastation,59,37,22
Strepo,proudmoore,1851,evoker,devastation,66,34,32
Royquaza,illidan,1850,evoker,devastation,60,33,27
Wheezee,emerald-dream,1850,evoker,devastation,46,25,21
Coltist,elune,1848,evoker,devastation,42,29,13
Rescued,wyrmrest-accord,1848,evoker,devastation,54,31,23
Azradormu,zuljin,1847,evoker,devastation,198,94,104
Tatsurai,tichondrius,1845,evoker,devastation,43,24,19
Fores,tichondrius,1845,evoker,devastation,127,65,62
Eshen,ragnaros,1843,evoker,devastation,298,158,140
Koalaman,area-52,1843,evoker,devastation,324,164,160
Draxarys,tichondrius,1841,evoker,devastation,315,155,160
Plep,wyrmrest-accord,1836,evoker,devastation,51,30,21
Laneva,moon-guard,1835,evoker,devastation,128,86,42
Venarys,dalaran,1826,evoker,devastation,42,30,12
Raxdragon,sargeras,1826,evoker,devastation,36,22,14
Srb,chogall,1824,evoker,devastation,113,63,50
Mcglizzy,stormrage,1824,evoker,devastation,167,92,75
Krúnsh,ragnaros,1823,evoker,devastation,191,104,87
Xxkimura,tichondrius,1820,evoker,devastation,292,152,140
Mushugon,wyrmrest-accord,1819,evoker,devastation,71,44,27
Zoomi,whisperwind,1819,evoker,devastation,35,20,15
Komodolong,tichondrius,1819,evoker,devastation,53,26,27
Azvanced,sargeras,1818,evoker,devastation,48,31,17
Beatdownbill,sargeras,1818,evoker,devastation,194,101,93
Evokes,moon-guard,1818,evoker,devastation,80,41,39
Kyloflight,thrall,1817,evoker,devastation,50,33,17
Nørbert,frostmourne,1815,evoker,devastation,54,32,22
Dracaryz,blackhand,1814,evoker,devastation,60,35,25
Puf,magtheridon,1814,evoker,devastation,346,185,161
Gridskully,quelthalas,1814,evoker,devastation,81,38,43
Teriarch,stormrage,1813,evoker,devastation,39,23,16
Drakori,azralon,1812,evoker,devastation,80,49,31
Milkymike,uldum,1811,evoker,devastation,72,44,28
Gojirastraza,stormrage,1810,evoker,devastation,53,32,21
Gwaelii,tichondrius,1809,evoker,devastation,105,62,43
Pykan,skullcrusher,1809,evoker,devastation,47,24,23
Ragedizzle,twisting-nether,1808,evoker,devastation,91,49,42
Mil,lightnings-blade,1808,evoker,devastation,69,37,32
Geicovoker,tichondrius,1806,evoker,devastation,52,30,22
Tazriak,tichondrius,1803,evoker,devastation,83,52,31
Thordak,drakkari,1801,evoker,devastation,72,40,32
Fractalz,alterac-mountains,1800,evoker,devastation,169,92,77
Airgordan,area-52,1796,evoker,devastation,83,39,44
Ethalem,thrall,1790,evoker,devastation,301,162,139
Obsidianimp,sargeras,1785,evoker,devastation,54,24,30
Bugberry,illidan,1784,evoker,devastation,102,51,51
Yrue,moon-guard,1779,evoker,devastation,36,19,17
Mfquietus,illidan,1773,evoker,devastation,84,49,35
Jwoker,malganis,1771,evoker,devastation,48,19,29
Fizzlevoker,malganis,1767,evoker,devastation,59,29,30
Drgua,tichondrius,1754,evoker,devastation,60,30,30
Dilon,area-52,1750,evoker,devastation,72,41,31
Vhagarius,tichondrius,1745,evoker,devastation,112,58,54
Juicylizard,stormrage,1744,evoker,devastation,242,124,118
Emiriss,thrall,1744,evoker,devastation,88,45,43
Flapples,stormrage,1743,evoker,devastation,96,53,43
Draxarys,area-52,1742,evoker,devastation,260,129,131
Blowmiê,area-52,1736,evoker,devastation,164,88,76
Theredmenace,barthilas,1734,evoker,devastation,41,26,15
Cowboyydann,malganis,1733,evoker,devastation,29,19,10
Stickvoker,sargeras,1733,evoker,devastation,66,40,26
Golden,area-52,1733,evoker,devastation,46,24,22
Rá,drenden,1728,evoker,devastation,84,37,47
Zenasatral,sargeras,1726,evoker,devastation,37,27,10
Derite,bonechewer,1723,evoker,devastation,40,29,11
Axiomoixa,tichondrius,1722,evoker,devastation,42,23,19
Millagosa,stormrage,1720,evoker,devastation,60,32,28
Nunez,frostmourne,1713,evoker,devastation,41,22,19
Betasoldier,kelthuzad,1708,evoker,devastation,95,56,39
Æthyr,anubarak,1707,evoker,devastation,36,26,10
Evokez,barthilas,1705,evoker,devastation,42,31,11
Ðeepßreath,sargeras,1703,evoker,devastation,66,35,31
Flippyflappy,zuljin,1702,evoker,devastation,45,29,16
Zlyrax,moon-guard,1695,evoker,devastation,30,18,12
Wonyoungx,frostmourne,1694,evoker,devastation,79,39,40
Tagzy,tichondrius,1693,evoker,devastation,105,64,41
Jase,gilneas,1691,evoker,devastation,74,45,29
Nändy,tichondrius,1689,evoker,devastation,48,28,20
Oldxdrake,sargeras,1689,evoker,devastation,156,77,79
Qbgosa,malganis,1686,evoker,devastation,48,27,21
Cløud,hellscream,1684,evoker,devastation,24,18,6
Dragonborn,malganis,1684,evoker,devastation,33,20,13
Dracthael,stormrage,1683,evoker,devastation,116,62,54
Djvoker,zuljin,1681,evoker,devastation,62,32,30
Darkwingz,icecrown,1680,evoker,devastation,44,25,19
Caelïn,malganis,1680,evoker,devastation,204,108,96
Izzythelizzy,tichondrius,1679,evoker,devastation,174,93,81
Eszel,thunderlord,1679,evoker,devastation,184,98,86
Catvoker,area-52,1678,evoker,devastation,114,58,56
Alekoslol,area-52,1677,evoker,devastation,46,27,19
Dooklord,shuhalo,1676,evoker,devastation,84,36,48
Shoestrings,tichondrius,1675,evoker,devastation,108,51,57
Nazaral,mannoroth,1674,evoker,devastation,84,45,39
Lukamagik,boulderfist,1673,evoker,devastation,42,22,20
Spyrodadrago,malganis,1672,evoker,devastation,72,40,32
Garlicbreth,stormrage,1671,evoker,devastation,76,40,36
Swolegarian,emerald-dream,1670,evoker,devastation,89,45,44
Bucket,wyrmrest-accord,1665,evoker,devastation,48,24,24
Shalander,proudmoore,1664,evoker,devastation,159,87,72
Zenithria,thrall,1664,evoker,devastation,148,78,70
Scaleychad,zuljin,1656,evoker,devastation,65,31,34
Balrôg,malganis,1656,evoker,devastation,63,29,34
Dovàhkin,moon-guard,1655,evoker,devastation,66,35,31
Courtvoke,turalyon,1653,evoker,devastation,64,36,28
Mindme,tichondrius,1652,evoker,devastation,53,30,23
Haramcad,tichondrius,1652,evoker,devastation,165,89,76
Whethersmell,tichondrius,1650,evoker,devastation,63,40,23
Wingdeadly,tichondrius,1650,evoker,devastation,66,35,31
Raller,malganis,1649,evoker,devastation,30,18,12
Ycnpass,tichondrius,1649,evoker,devastation,42,22,20
Nykhel,tichondrius,1648,evoker,devastation,42,21,21
Mlboa,frostmourne,1647,evoker,devastation,36,20,16
Koralia,moon-guard,1647,evoker,devastation,42,18,24
Deralan,khaz-modan,1645,evoker,devastation,36,20,16
Vizora,moon-guard,1645,evoker,devastation,154,81,73
Zindraco,thrall,1645,evoker,devastation,48,23,25
Psynister,illidan,1644,evoker,devastation,168,76,92
Rotscale,proudmoore,1643,evoker,devastation,36,22,14
Hmong,proudmoore,1643,evoker,devastation,48,20,28
Erizcdraa,tichondrius,1642,evoker,devastation,46,26,20
Blackdragôn,stormrage,1641,evoker,devastation,43,22,21
Epollyon,sargeras,1639,evoker,devastation,42,25,17
Dwagonwage,zuljin,1633,evoker,devastation,90,42,48
Zeranthal,moon-guard,1632,evoker,devastation,32,21,11
Averithel,moon-guard,1630,evoker,devastation,35,23,12
Voithyr,moon-guard,1630,evoker,devastation,128,71,57
Burnyxia,zuljin,1628,evoker,devastation,48,23,25
Quickshootin,tichondrius,1628,evoker,devastation,65,28,37
Aentharion,argent-dawn,1627,evoker,devastation,41,22,19
Rizzanomics,zuljin,1626,evoker,devastation,76,32,44
Evòker,tichondrius,1625,evoker,devastation,54,28,26
Galakrønd,illidan,1624,evoker,devastation,116,63,53
Bhanethyr,illidan,1624,evoker,devastation,36,17,19
Draislyn,cenarion-circle,1622,evoker,devastation,36,23,13
Hochenblume,proudmoore,1621,evoker,devastation,77,40,37
Sofyon,dalaran,1621,evoker,devastation,64,31,33
Mmrglmrglmr,stormrage,1620,evoker,devastation,65,37,28
Naverdr,tichondrius,1619,evoker,devastation,54,30,24
Quadarius,tichondrius,1617,evoker,devastation,147,82,65
Lorb,icecrown,1616,evoker,devastation,170,94,76
Kozukimomo,area-52,1616,evoker,devastation,125,63,62
Lïzzy,tichondrius,1614,evoker,devastation,34,23,11
Lizardik,lightnings-blade,1614,evoker,devastation,44,26,18
Eternabeam,gilneas,1614,evoker,devastation,89,45,44
Smoochies,emerald-dream,1614,evoker,devastation,72,36,36
Zyzzy,icecrown,1613,evoker,devastation,80,48,32
Embarasi,moon-guard,1613,evoker,devastation,60,36,24
Ruination,lightnings-blade,1613,evoker,devastation,42,24,18
Shortdargon,zuljin,1613,evoker,devastation,48,25,23
Jòrmungandr,moon-guard,1613,evoker,devastation,56,24,32
Endoveire,tichondrius,1613,evoker,devastation,54,23,31
Âvalon,zuljin,1611,evoker,devastation,24,17,7
Pewpowdragon,malganis,1609,evoker,devastation,40,24,16
Bréáth,tichondrius,1608,evoker,devastation,48,33,15
Youdig,nazjatar,1608,evoker,devastation,42,24,18
Onysable,stormrage,1608,evoker,devastation,42,21,21
Akajills,tichondrius,1607,evoker,devastation,124,70,54
Pewnee,eonar,1607,evoker,devastation,83,40,43
Madjeckyl,dalaran,1606,evoker,devastation,42,21,21
Xhamon,quelthalas,1606,evoker,devastation,208,100,108
Eshaybruh,barthilas,1605,evoker,devastation,34,20,14
Dracomalfoyy,caelestrasz,1605,evoker,devastation,33,18,15
Xplode,area-52,1605,evoker,devastation,206,108,98
Dubskis,area-52,1603,evoker,devastation,122,63,59
Jereico,stonemaul,1603,evoker,devastation,78,39,39
Bently,bloodhoof,1603,evoker,devastation,48,21,27
Marccuss,bleeding-hollow,1601,evoker,devastation,24,17,7
Børedom,burning-legion,1601,evoker,devastation,54,36,18
Ryuback,sargeras,1601,evoker,devastation,42,26,16
Spicyrooster,area-52,1601,evoker,devastation,44,24,20
Xhaal,tichondrius,1601,evoker,devastation,168,83,85
Rengöku,skullcrusher,1600,evoker,devastation,54,27,27
Imugee,sargeras,1598,evoker,devastation,54,27,27
Kazooie,zuljin,1598,evoker,devastation,36,17,19
Talent,deathwing,1597,evoker,devastation,30,17,13
Juooun,tichondrius,1597,evoker,devastation,77,35,42
Likelydevo,tichondrius,1596,evoker,devastation,24,19,5
Potfase,tichondrius,1596,evoker,devastation,50,23,27
Bombs,shattered-hand,1594,evoker,devastation,150,78,72
Ackreshanaz,nagrand,1594,evoker,devastation,36,17,19
Batwig,tichondrius,1590,evoker,devastation,71,39,32
Cottoncandy,stormrage,1587,evoker,devastation,36,17,19
Mcflý,sargeras,1586,evoker,devastation,42,30,12
Linguistic,tichondrius,1585,evoker,devastation,54,29,25
Devilmanguy,bonechewer,1585,evoker,devastation,102,51,51
Terraxkhan,quelthalas,1585,evoker,devastation,66,29,37
Mayhemvoker,rexxar,1584,evoker,devastation,54,32,22
Rinstraza,thrall,1584,evoker,devastation,161,81,80
Arkeryte,moon-guard,1583,evoker,devastation,150,74,76
Flysokan,tichondrius,1582,evoker,devastation,63,32,31
Puffthemagic,lightnings-blade,1582,evoker,devastation,42,20,22
Algonir,wyrmrest-accord,1581,evoker,devastation,30,17,13
Zona,moon-guard,1580,evoker,devastation,65,31,34
Superscales,zuljin,1579,evoker,devastation,31,19,12
Kalisee,skullcrusher,1579,evoker,devastation,85,46,39
Envisioned,kelthuzad,1572,evoker,devastation,36,19,17
Aarax,tichondrius,1570,evoker,devastation,89,45,44
Ævoker,tichondrius,1569,evoker,devastation,111,54,57
Hoodwings,stormrage,1561,evoker,devastation,91,53,38
Rðsè,tichondrius,1558,evoker,devastation,162,76,86
Hotdragon,zuljin,1557,evoker,devastation,84,47,37
Gangbânk,tichondrius,1555,evoker,devastation,71,34,37
Karox,moon-guard,1552,evoker,devastation,143,71,72
Dractheseus,tichondrius,1551,evoker,devastation,36,18,18
Drussyboy,illidan,1550,evoker,devastation,88,47,41
Bryiona,proudmoore,1550,evoker,devastation,81,40,41
Curtis,shadowmoon,1545,evoker,devastation,130,73,57
Daydrac,thrall,1544,evoker,devastation,50,26,24
Sintholo,sargeras,1544,evoker,devastation,104,52,52
Kinto,stormrage,1544,evoker,devastation,42,17,25
Agheel,firetree,1543,evoker,devastation,44,23,21
Breezemordus,zuljin,1540,evoker,devastation,45,24,21
Growthyy,malganis,1539,evoker,devastation,30,18,12
Yakkin,kelthuzad,1538,evoker,devastation,38,21,17
Dragnmÿballs,blackrock,1536,evoker,devastation,34,20,14
Emoker,magtheridon,1535,evoker,devastation,54,31,23
Rhÿu,quelthalas,1534,evoker,devastation,95,51,44
Trákanon,mugthol,1534,evoker,devastation,75,40,35
Deathwingtwo,sargeras,1533,evoker,devastation,61,34,27
Hydrogenbomb,sargeras,1530,evoker,devastation,86,47,39
Drachenatem,skywall,1529,evoker,devastation,42,24,18
Soory,coilfang,1529,evoker,devastation,36,19,17
Nxnevo,tichondrius,1529,evoker,devastation,36,19,17
You,deathwing,1528,evoker,devastation,42,24,18
Chànge,lothar,1527,evoker,devastation,71,36,35
Zandrov,greymane,1526,evoker,devastation,51,29,22
Meleyx,saurfang,1526,evoker,devastation,66,33,33
Nishalethen,moon-guard,1517,evoker,devastation,74,35,39
Bumbaclot,illidan,1516,evoker,devastation,31,16,15
Vikings,madoran,1516,evoker,devastation,35,18,17
Dragontales,stormrage,1515,evoker,devastation,119,63,56
Netreset,illidan,1515,evoker,devastation,49,23,26
Jurokiel,sargeras,1514,evoker,devastation,167,92,75
Olesmokey,tichondrius,1513,evoker,devastation,86,45,41
Mustardtiger,malorne,1512,evoker,devastation,103,56,47
Fairstrider,tichondrius,1512,evoker,devastation,60,26,34
Cmdragonbalz,sargeras,1511,evoker,devastation,60,33,27
Galrend,firetree,1511,evoker,devastation,78,41,37
Baigels,thrall,1510,evoker,devastation,36,18,18
Zartolas,moon-guard,1510,evoker,devastation,124,60,64
Polyrhythmic,ysera,1510,evoker,devastation,79,38,41
Meepslol,kiljaeden,1506,evoker,devastation,27,17,10
Topg,boulderfist,1505,evoker,devastation,39,23,16
Deewey,sargeras,1504,evoker,devastation,50,30,20
Tinine,frostmourne,1503,evoker,devastation,60,33,27
Mythsvoker,barthilas,1503,evoker,devastation,37,18,19
Bryágh,wyrmrest-accord,1502,evoker,devastation,165,85,80
Atreign,blackwing-lair,1499,evoker,devastation,55,22,33
Tezzyl,kiljaeden,1498,evoker,devastation,30,16,14
Tealetaz,area-52,1495,evoker,devastation,49,32,17
Famousdr,stormrage,1495,evoker,devastation,50,26,24
Dunkinonem,black-dragonflight,1494,evoker,devastation,42,25,17
Kylidon,garrosh,1494,evoker,devastation,53,28,25
Kozara,trollbane,1494,evoker,devastation,35,17,18
Ùwüdragon,tichondrius,1490,evoker,devastation,118,71,47
Erling,duskwood,1490,evoker,devastation,84,46,38
Jgdragon,sargeras,1489,evoker,devastation,36,18,18
Taeloc,frostmourne,1488,evoker,devastation,36,16,20
Dimatis,ragnaros,1488,evoker,devastation,42,17,25
Dragonkings,tichondrius,1487,evoker,devastation,129,56,73
Xaeradroz,area-52,1486,evoker,devastation,78,41,37
Qfyre,frostmourne,1480,evoker,devastation,57,34,23
Bellerion,proudmoore,1480,evoker,devastation,54,26,28
Drayongari,tichondrius,1479,evoker,devastation,60,29,31
Rangel,tol-barad,1479,evoker,devastation,45,21,24
Phlegython,eredar,1478,evoker,devastation,42,21,21
Encouraçado,stormrage,1477,evoker,devastation,71,37,34
Jowtzprev,ragnaros,1476,evoker,devastation,66,35,31
Dragonvore,moon-guard,1475,evoker,devastation,23,17,6
Elurb,illidan,1475,evoker,devastation,50,30,20
Narissian,wyrmrest-accord,1473,evoker,devastation,114,58,56
Dreamtalons,area-52,1465,evoker,devastation,48,28,20
Abaddragon,dalaran,1461,evoker,devastation,53,21,32
Puffthemagiq,mugthol,1460,evoker,devastation,54,30,24
Evoqz,stormrage,1459,evoker,devastation,36,22,14
Dekux,elune,1459,evoker,devastation,36,16,20
Grapthar,korgath,1456,evoker,devastation,108,57,51
Unseenzblack,tichondrius,1453,evoker,devastation,30,19,11
Kjerne,stormrage,1452,evoker,devastation,41,27,14
Dragontrees,illidan,1450,evoker,devastation,36,19,17
Amlug,illidan,1450,evoker,devastation,88,38,50
Ýüp,tichondrius,1448,evoker,devastation,34,21,13
Devdjinn,tichondrius,1447,evoker,devastation,234,121,113
Drflame,quelthalas,1446,evoker,devastation,47,27,20
Midi,boulderfist,1446,evoker,devastation,42,21,21
Lilfootmommy,emerald-dream,1446,evoker,devastation,36,16,20
Valentis,bleeding-hollow,1441,evoker,devastation,96,52,44
Bloodwings,tichondrius,1441,evoker,devastation,48,23,25
Serthius,darkspear,1439,evoker,devastation,24,17,7
Peef,tichondrius,1439,evoker,devastation,24,15,9
Veserion,azralon,1439,evoker,devastation,96,54,42
Salakhar,drakkari,1438,evoker,devastation,38,24,14
Kheeleesi,illidan,1438,evoker,devastation,113,55,58
Monkeydrake,tichondrius,1438,evoker,devastation,72,31,41
Drakoris,malganis,1436,evoker,devastation,146,79,67
Chinesedragn,tichondrius,1436,evoker,devastation,100,51,49
Daesired,moon-guard,1436,evoker,devastation,42,18,24
Desiinger,tichondrius,1435,evoker,devastation,54,29,25
Zalzin,agamaggan,1435,evoker,devastation,92,48,44
Vexosza,moon-guard,1434,evoker,devastation,30,16,14
Tabebuya,illidan,1432,evoker,devastation,63,25,38
Favoredson,area-52,1431,evoker,devastation,54,29,25
Joopydrake,tichondrius,1431,evoker,devastation,30,15,15
Dracthyrius,thunderlord,1430,evoker,devastation,30,16,14
Razistzegrlz,illidan,1430,evoker,devastation,36,15,21
Valthenax,frostmourne,1430,evoker,devastation,94,39,55
Brounno,area-52,1429,evoker,devastation,76,49,27
Brendormu,moon-guard,1428,evoker,devastation,39,15,24
Iamluck,kiljaeden,1425,evoker,devastation,34,16,18
Neith,aerie-peak,1425,evoker,devastation,47,18,29
Ragnagos,area-52,1424,evoker,devastation,24,15,9
Dylawn,illidan,1424,evoker,devastation,54,31,23
Dragonbic,illidan,1423,evoker,devastation,36,16,20
Trenash,illidan,1418,evoker,devastation,76,32,44
Nethenezoth,auchindoun,1414,evoker,devastation,30,15,15
Dragondis,thrall,1412,evoker,devastation,64,30,34
Talanoth,skullcrusher,1408,evoker,devastation,57,34,23
Setash,kiljaeden,1407,evoker,devastation,72,39,33
Toastragosa,cenarius,1406,evoker,devastation,149,66,83
Thechadwasgr,bleeding-hollow,1403,evoker,devastation,62,31,31
Dragoom,saurfang,1402,evoker,devastation,36,20,16
Firkrag,bleeding-hollow,1402,evoker,devastation,60,28,32
Jarzilla,illidan,1401,evoker,devastation,24,15,9
Spicy,mannoroth,1400,evoker,devastation,40,22,18
Valkalas,moon-guard,1400,evoker,devastation,63,30,33
Tasoly,stormrage,1400,evoker,devastation,65,26,39
Dillss,tichondrius,1397,evoker,devastation,66,31,35
Rodgoesinya,blackrock,1392,evoker,devastation,54,30,24
Blittlle,bleeding-hollow,1391,evoker,devastation,66,39,27
Prevocker,sargeras,1387,evoker,devastation,85,37,48
Zendrov,skywall,1386,evoker,devastation,79,41,38
Dailon,stormreaver,1385,evoker,devastation,57,26,31
Tyrvin,kiljaeden,1382,evoker,devastation,145,72,73
Tinà,tichondrius,1377,evoker,devastation,48,27,21
Howtew,jubeithos,1377,evoker,devastation,72,37,35
Madashy,durotan,1377,evoker,devastation,71,34,37
Ashenoth,antonidas,1376,evoker,devastation,42,23,19
Devonstation,zuljin,1372,evoker,devastation,48,25,23
Zeetash,illidan,1372,evoker,devastation,78,30,48
Zayllaerth,illidan,1371,evoker,devastation,86,45,41
Malygoz,frostmourne,1370,evoker,devastation,60,24,36
Monyz,emerald-dream,1369,evoker,devastation,80,50,30
Kosstro,thunderlord,1366,evoker,devastation,58,35,23
Bvo,stormrage,1364,evoker,devastation,77,41,36
Gutterskank,illidan,1362,evoker,devastation,35,22,13
Navaji,tichondrius,1362,evoker,devastation,55,30,25
Leapofagony,zuljin,1362,evoker,devastation,33,15,18
Evokedx,area-52,1361,evoker,devastation,42,21,21
Sidrasza,norgannon,1360,evoker,devastation,73,40,33
Cròk,quelthalas,1360,evoker,devastation,33,15,18
Ezarke,madoran,1359,evoker,devastation,35,17,18
Thendroz,moon-guard,1357,evoker,devastation,30,18,12
Valyrik,illidan,1356,evoker,devastation,110,54,56
Lexgrossman,kelthuzad,1353,evoker,devastation,98,50,48
Kêristrasza,wyrmrest-accord,1352,evoker,devastation,54,27,27
Hugehorns,jubeithos,1349,evoker,devastation,24,15,9
Klownfiesta,thrall,1344,evoker,devastation,123,69,54
Trazana,wyrmrest-accord,1344,evoker,devastation,29,16,13
Ironscale,dalaran,1344,evoker,devastation,36,19,17
Aydetal,eonar,1343,evoker,devastation,42,20,22
Grendalevo,tichondrius,1341,evoker,devastation,69,34,35
Dragoness,azralon,1341,evoker,devastation,71,29,42
Ilovepolpot,tichondrius,1340,evoker,devastation,18,14,4
Kazrekan,moon-guard,1339,evoker,devastation,30,14,16
Yuukee,thrall,1338,evoker,devastation,43,23,20
Puffthemagik,doomhammer,1337,evoker,devastation,190,89,101
Drêki,bleeding-hollow,1334,evoker,devastation,90,38,52
Dîego,azralon,1333,evoker,devastation,40,24,16
Rial,frostmourne,1331,evoker,devastation,30,14,16
Acoldwall,illidan,1328,evoker,devastation,24,15,9
Yiserion,sargeras,1328,evoker,devastation,187,100,87
Koralia,wyrmrest-accord,1328,evoker,devastation,30,14,16
Evokjoe,tortheldrin,1327,evoker,devastation,64,33,31
Vaelikai,korgath,1326,evoker,devastation,18,14,4
Zlandicaar,area-52,1325,evoker,devastation,84,40,44
Derazar,malganis,1323,evoker,devastation,42,25,17
Satanasx,illidan,1323,evoker,devastation,48,20,28
Dovå,moon-guard,1322,evoker,devastation,32,16,16
Narthraxion,destromath,1321,evoker,devastation,105,54,51
Wackthyr,frostmourne,1320,evoker,devastation,36,18,18
Emikothyr,thrall,1319,evoker,devastation,74,41,33
Tekath,altar-of-storms,1317,evoker,devastation,56,26,30
Ggcthulhu,area-52,1316,evoker,devastation,24,14,10
Craterearth,moon-guard,1316,evoker,devastation,73,31,42
Dragneel,wyrmrest-accord,1316,evoker,devastation,62,25,37
Drahconne,illidan,1312,evoker,devastation,76,40,36
Jabbawockeëz,drakkari,1310,evoker,devastation,97,51,46
Skooby,drenden,1309,evoker,devastation,30,16,14
Targaryenz,malganis,1306,evoker,devastation,54,28,26
Galakraas,proudmoore,1306,evoker,devastation,93,46,47
Notvez,bleeding-hollow,1305,evoker,devastation,43,18,25
Raghnard,illidan,1303,evoker,devastation,70,37,33
Senven,blackhand,1303,evoker,devastation,48,21,27
Skykeeper,quelthalas,1300,evoker,devastation,130,67,63
Alligatorz,sargeras,1300,evoker,devastation,54,27,27
Drogan,demon-soul,1299,evoker,devastation,104,59,45
Zlolykcir,malganis,1299,evoker,devastation,89,48,41
Midnights,scarlet-crusade,1296,evoker,devastation,89,52,37
Vahaerys,stormrage,1296,evoker,devastation,48,21,27
Evokinator,zuljin,1295,evoker,devastation,24,14,10
Dvrk,frostmourne,1295,evoker,devastation,53,25,28
Slitherin,dalaran,1294,evoker,devastation,60,28,32
Panicnodisco,zuljin,1292,evoker,devastation,23,14,9
Darazen,scarlet-crusade,1290,evoker,devastation,36,17,19
Sylnathaire,wyrmrest-accord,1288,evoker,devastation,104,49,55
Obeahfire,tichondrius,1288,evoker,devastation,64,24,40
Wrecketz,tichondrius,1284,evoker,devastation,100,53,47
Vokeero,ysera,1284,evoker,devastation,72,36,36
Friedsalmon,azshara,1284,evoker,devastation,29,14,15
Layothyr,stormrage,1281,evoker,devastation,30,18,12
Aktas,illidan,1280,evoker,devastation,40,19,21
Cheaterz,area-52,1279,evoker,devastation,42,27,15
Benares,zuljin,1279,evoker,devastation,91,43,48
Vlåd,tichondrius,1279,evoker,devastation,42,19,23
Sylverion,thrall,1277,evoker,devastation,70,35,35
Zorashal,kiljaeden,1276,evoker,devastation,52,31,21
Nið,moon-guard,1274,evoker,devastation,28,14,14
Tralanoth,destromath,1270,evoker,devastation,30,16,14
Døvahkiin,sargeras,1260,evoker,devastation,29,14,15
Skizle,destromath,1259,evoker,devastation,35,16,19
Nathenezital,frostmourne,1255,evoker,devastation,39,21,18
Itwasntthis,tichondrius,1254,evoker,devastation,123,61,62
Nephrites,area-52,1252,evoker,devastation,34,15,19
Draginnutz,dunemaul,1252,evoker,devastation,36,15,21
Nathx,drakkari,1251,evoker,devastation,48,31,17
Crogosa,quelthalas,1251,evoker,devastation,36,14,22
Dragonair,spinebreaker,1250,evoker,devastation,33,16,17
Êsh,lightbringer,1249,evoker,devastation,24,14,10
Ezgamedeez,tichondrius,1247,evoker,devastation,24,13,11
Aoxila,proudmoore,1247,evoker,devastation,239,114,125
Marknormand,area-52,1246,evoker,devastation,24,13,11
Shanegillis,emerald-dream,1244,evoker,devastation,18,13,5
Cmiygl,proudmoore,1243,evoker,devastation,18,13,5
Sindraxx,stormrage,1242,evoker,devastation,57,30,27
Seranis,sargeras,1242,evoker,devastation,36,13,23
Skykeeper,dalaran,1241,evoker,devastation,30,16,14
Dracfire,saurfang,1239,evoker,devastation,24,13,11
Loganvkr,illidan,1237,evoker,devastation,36,18,18
Azorian,vashj,1236,evoker,devastation,36,21,15
Longxx,dalaran,1235,evoker,devastation,24,13,11
Xm,emerald-dream,1235,evoker,devastation,31,14,17
Billynobob,tichondrius,1235,evoker,devastation,30,13,17
Bigbadfred,tichondrius,1234,evoker,devastation,24,13,11
Nuttutted,emerald-dream,1232,evoker,devastation,24,13,11
Taamyr,wyrmrest-accord,1230,evoker,devastation,126,69,57
Dkvastate,tichondrius,1229,evoker,devastation,36,26,10
Riyad,emerald-dream,1229,evoker,devastation,58,28,30
Snowdragon,azralon,1226,evoker,devastation,53,28,25
Dingermun,bleeding-hollow,1225,evoker,devastation,20,15,5
Momonosuke,fizzcrank,1225,evoker,devastation,36,20,16
Valakaztower,area-52,1225,evoker,devastation,36,19,17
Chimo,laughing-skull,1225,evoker,devastation,30,14,16
Dracthul,tichondrius,1222,evoker,devastation,42,22,20
Puffsmoke,korgath,1220,evoker,devastation,24,13,11
Emsli,moon-guard,1218,evoker,devastation,24,14,10
Fáffy,kelthuzad,1218,evoker,devastation,42,15,27
Kèrby,frostmourne,1213,evoker,devastation,30,15,15
Jugzxs,frostmourne,1213,evoker,devastation,36,14,22
Atrocion,wyrmrest-accord,1209,evoker,devastation,94,50,44
Raygos,nemesis,1207,evoker,devastation,68,27,41
Trenot,draenor,1202,evoker,devastation,42,21,21
Aelvina,moon-guard,1201,evoker,devastation,30,13,17
Tattleslug,illidan,1199,evoker,devastation,30,15,15
Vahvan,sargeras,1197,evoker,devastation,54,21,33
Clarkeboi,barthilas,1196,evoker,devastation,40,21,19
Ejokerxx,tichondrius,1193,evoker,devastation,24,14,10
Dragkon,azuremyst,1193,evoker,devastation,66,28,38
Tealandrov,zuljin,1193,evoker,devastation,50,16,34
Bumbledragn,moon-guard,1192,evoker,devastation,110,53,57
Culture,khazgoroth,1191,evoker,devastation,21,13,8
Dracky,deathwing,1190,evoker,devastation,17,13,4
Paean,moon-guard,1183,evoker,devastation,32,18,14
Nazanazar,wyrmrest-accord,1181,evoker,devastation,128,60,68
Evooern,frostmourne,1181,evoker,devastation,84,39,45
Huanglong,sargeras,1180,evoker,devastation,30,16,14
Xampusaurio,ragnaros,1178,evoker,devastation,24,13,11
Kaikisen,malganis,1178,evoker,devastation,41,19,22
Climax,stormrage,1177,evoker,devastation,28,13,15
Vaayu,moon-guard,1176,evoker,devastation,24,13,11
Sethelys,tichondrius,1176,evoker,devastation,26,13,13
Deàthwing,proudmoore,1175,evoker,devastation,181,82,99
Loginplease,frostmourne,1171,evoker,devastation,86,40,46
Midyr,nemesis,1169,evoker,devastation,48,28,20
Teritwo,stormrage,1166,evoker,devastation,28,13,15
Dragonpete,whisperwind,1161,evoker,devastation,48,23,25
Drakhaz,azralon,1156,evoker,devastation,22,13,9
Visron,stormrage,1153,evoker,devastation,65,41,24
Asham,azralon,1152,evoker,devastation,63,36,27
Tërminus,quelthalas,1151,evoker,devastation,18,12,6
Devokerx,emerald-dream,1151,evoker,devastation,18,12,6
Shwaydbz,zuljin,1151,evoker,devastation,24,12,12
Drsgme,dentarg,1150,evoker,devastation,24,12,12
Skylizard,illidan,1147,evoker,devastation,24,12,12
Zervis,arthas,1147,evoker,devastation,30,12,18
Draconicus,bonechewer,1146,evoker,devastation,166,79,87
Thalyxia,azralon,1146,evoker,devastation,30,13,17
Nessumsar,azralon,1145,evoker,devastation,24,12,12
Drozul,stormrage,1145,evoker,devastation,30,12,18
Ilovequiet,proudmoore,1142,evoker,devastation,24,12,12
Skeedaddle,zuljin,1140,evoker,devastation,30,15,15
Dragoceleste,ragnaros,1140,evoker,devastation,54,26,28
Dinnkyion,dalaran,1138,evoker,devastation,24,12,12
Stretonaught,dalaran,1137,evoker,devastation,33,15,18
Slimyreptile,sargeras,1134,evoker,devastation,69,31,38
Dragonbranch,area-52,1133,evoker,devastation,24,12,12
Lorathyr,lothar,1128,evoker,devastation,24,12,12
Enuzan,dalaran,1128,evoker,devastation,89,41,48
Duamutef,wyrmrest-accord,1127,evoker,devastation,28,16,12
Archion,azgalor,1127,evoker,devastation,35,13,22
Fortwonty,thrall,1120,evoker,devastation,24,14,10
Pyrepapi,thrall,1115,evoker,devastation,32,13,19
Bhalaria,ragnaros,1113,evoker,devastation,69,25,44
Paycussy,sargeras,1110,evoker,devastation,18,12,6
Drakonyx,mugthol,1107,evoker,devastation,56,22,34
Zitasanazen,tichondrius,1107,evoker,devastation,64,25,39
Tïtäm,area-52,1106,evoker,devastation,26,13,13
Drögón,stormrage,1100,evoker,devastation,42,27,15
Crymor,lethon,1099,evoker,devastation,30,16,14
Madelines,tichondrius,1097,evoker,devastation,24,13,11
Ezath,zuljin,1089,evoker,devastation,56,29,27
Zhannecgos,moon-guard,1087,evoker,devastation,28,12,16
Byäkuyá,azralon,1085,evoker,devastation,113,57,56
Rayomcquen,garrosh,1080,evoker,devastation,29,16,13
Blazor,sisters-of-elune,1076,evoker,devastation,35,14,21
Tiamaat,black-dragonflight,1073,evoker,devastation,28,12,16
Bähamut,proudmoore,1072,evoker,devastation,41,16,25
Gamerwords,barthilas,1070,evoker,devastation,30,13,17
Durijus,tichondrius,1069,evoker,devastation,35,14,21
Aratre,daggerspine,1066,evoker,devastation,108,55,53
Ðarkwyrm,laughing-skull,1062,evoker,devastation,42,22,20
Dracopium,tichondrius,1061,evoker,devastation,36,20,16
Cunk,illidan,1056,evoker,devastation,35,24,11
Thenderazen,sargeras,1056,evoker,devastation,81,46,35
Devokèr,tichondrius,1056,evoker,devastation,24,11,13
Talzindera,sargeras,1055,evoker,devastation,21,12,9
Jwas,tichondrius,1055,evoker,devastation,24,11,13
Hydroponicsz,bloodscalp,1055,evoker,devastation,24,11,13
Kiry,emerald-dream,1055,evoker,devastation,24,11,13
Taylordra,tichondrius,1055,evoker,devastation,24,11,13
Dracnovae,emerald-dream,1055,evoker,devastation,35,14,21
Kubus,emerald-dream,1054,evoker,devastation,18,11,7
Gypgo,ragnaros,1054,evoker,devastation,18,11,7
Tepaku,thrall,1054,evoker,devastation,18,11,7
Yousurper,thunderlord,1054,evoker,devastation,27,14,13
Hlnv,aegwynn,1053,evoker,devastation,18,11,7
Eìdolon,sargeras,1049,evoker,devastation,18,11,7
Dragostephen,nazjatar,1049,evoker,devastation,24,11,13
Zirath,emerald-dream,1045,evoker,devastation,24,11,13
Sübjugador,azralon,1042,evoker,devastation,30,20,10
Flygor,quelthalas,1041,evoker,devastation,78,30,48
Fpbafome,azralon,1038,evoker,devastation,42,13,29
Bhristopher,wildhammer,1035,evoker,devastation,12,11,1
Brunswichk,azralon,1033,evoker,devastation,24,11,13
Lostplanet,drakkari,1030,evoker,devastation,42,13,29
Byssrak,borean-tundra,1029,evoker,devastation,18,11,7
Warhammerxx,tichondrius,1027,evoker,devastation,84,33,51
Zippityzoom,barthilas,1026,evoker,devastation,43,18,25
Razorwing,azgalor,1019,evoker,devastation,24,13,11
Kaidô,illidan,1008,evoker,devastation,16,12,4
Dracothyst,tichondrius,1007,evoker,devastation,29,15,14
Jgxv,dalaran,1007,evoker,devastation,23,11,12
Dragonbreaf,emerald-dream,1004,evoker,devastation,17,11,6
Alnuin,stormrage,1004,evoker,devastation,102,42,60
Danzick,sargeras,1003,evoker,devastation,24,11,13
Toyatoki,stormrage,1000,evoker,devastation,47,20,27
Stolesom,emerald-dream,994,evoker,devastation,65,32,33
Azulagos,sargeras,992,evoker,devastation,22,14,8
Sixjobs,area-52,990,evoker,devastation,29,11,18
Evokatoke,proudmoore,989,evoker,devastation,37,16,21
Acnøløgia,azralon,988,evoker,devastation,36,12,24
Neofarian,lightbringer,986,evoker,devastation,20,11,9
Dragongrim,silvermoon,986,evoker,devastation,30,14,16
Popgoesurmom,tichondrius,981,evoker,devastation,24,13,11
Pisslizard,stormrage,980,evoker,devastation,28,11,17
Drapybaras,bleeding-hollow,963,evoker,devastation,54,26,28
Miradrake,icecrown,960,evoker,devastation,12,10,2
Iantern,dalaran,960,evoker,devastation,18,10,8
Rizzlordx,bleeding-hollow,960,evoker,devastation,24,10,14
Tjofscales,stormrage,960,evoker,devastation,24,10,14
Moreleth,stormrage,959,evoker,devastation,18,10,8
Nasdanot,zuljin,959,evoker,devastation,18,10,8
Chime,dalaran,959,evoker,devastation,18,10,8
Hausebat,moon-guard,959,evoker,devastation,18,10,8
Xeerus,stormreaver,959,evoker,devastation,18,10,8
Basiliskgodx,tichondrius,959,evoker,devastation,18,10,8
Runescape,altar-of-storms,959,evoker,devastation,24,10,14
Grafixx,sargeras,958,evoker,devastation,15,11,4
Ryhu,sargeras,958,evoker,devastation,18,10,8
Vokezuì,sargeras,958,evoker,devastation,30,10,20
Jormungandre,wyrmrest-accord,957,evoker,devastation,18,10,8
Dragocser,drakkari,957,evoker,devastation,18,10,8
Galaxiz,bonechewer,957,evoker,devastation,24,12,12
Oatmealneil,bleeding-hollow,955,evoker,devastation,24,10,14
Sinepbreath,bleeding-hollow,954,evoker,devastation,18,10,8
Finvoker,kalecgos,953,evoker,devastation,18,10,8
Liekki,illidan,953,evoker,devastation,24,10,14
Ecksdoom,sargeras,952,evoker,devastation,18,10,8
Wizadsa,amanthul,951,evoker,devastation,12,10,2
Takhysis,frostmourne,949,evoker,devastation,24,10,14
Fìg,wyrmrest-accord,948,evoker,devastation,18,10,8
Jorlozthyr,ragnaros,948,evoker,devastation,24,10,14
Aegontargary,azralon,945,evoker,devastation,27,11,16
Maximiliam,ragnaros,944,evoker,devastation,34,18,16
Herikas,tichondrius,943,evoker,devastation,80,39,41
Prolyfe,blood-furnace,942,evoker,devastation,15,11,4
Toephotos,tichondrius,937,evoker,devastation,23,10,13
Dethendrov,moon-guard,936,evoker,devastation,18,10,8
Escanorr,ghostlands,936,evoker,devastation,20,11,9
Ciana,black-dragonflight,936,evoker,devastation,50,26,24
Báalboski,tichondrius,935,evoker,devastation,18,10,8
Hicane,tichondrius,935,evoker,devastation,29,10,19
Ryùtt,illidan,933,evoker,devastation,18,10,8
Battledragon,illidan,918,evoker,devastation,18,10,8
Fukhur,ragnaros,917,evoker,devastation,24,11,13
Galgaldr,tichondrius,914,evoker,devastation,30,12,18
Ezdrake,drakkari,900,evoker,devastation,36,11,25
Arath,zangarmarsh,898,evoker,devastation,42,22,20
Alextroxo,stormrage,888,evoker,devastation,17,10,7
Tireoz,frostmourne,866,evoker,devastation,48,12,36
Kiserys,suramar,864,evoker,devastation,12,9,3
Áspect,aegwynn,864,evoker,devastation,12,9,3
Gobananas,sargeras,864,evoker,devastation,12,9,3
Oracle,duskwood,864,evoker,devastation,12,9,3
Kaldesun,ragnaros,864,evoker,devastation,12,9,3
Orncen,emerald-dream,864,evoker,devastation,16,10,6
Todorøki,hyjal,864,evoker,devastation,18,9,9
Thnake,zuljin,864,evoker,devastation,18,9,9
Erokx,kelthuzad,864,evoker,devastation,18,9,9
Brakkarion,wyrmrest-accord,864,evoker,devastation,18,9,9
Creachy,kiljaeden,864,evoker,devastation,18,9,9
Nyranblood,zuljin,864,evoker,devastation,42,18,24
Raikori,ragnaros,863,evoker,devastation,12,9,3
Weedi,tichondrius,863,evoker,devastation,12,9,3
Novi,kaelthas,863,evoker,devastation,12,9,3
Dragbod,korgath,863,evoker,devastation,18,9,9
Missjenny,korgath,863,evoker,devastation,18,9,9
Dâpper,queldorei,863,evoker,devastation,18,9,9
Wse,illidan,863,evoker,devastation,18,9,9
Thyatera,ragnaros,863,evoker,devastation,18,9,9
Lardicønn,thrall,863,evoker,devastation,18,9,9
Siatrend,moon-guard,863,evoker,devastation,18,9,9
Misik,frostwolf,863,evoker,devastation,18,9,9
Nelthendros,moon-guard,863,evoker,devastation,18,9,9
Drazgarth,azshara,863,evoker,devastation,18,9,9
Naraxus,thrall,863,evoker,devastation,18,9,9
Dragonsteppz,aegwynn,863,evoker,devastation,18,9,9
Gharscales,tichondrius,863,evoker,devastation,24,9,15
Dracthyrwa,azralon,862,evoker,devastation,12,9,3
Demidas,emerald-dream,862,evoker,devastation,13,9,4
Serathrine,smolderthorn,862,evoker,devastation,18,9,9
Disugaiza,tichondrius,861,evoker,devastation,12,9,3
Sía,drakkari,861,evoker,devastation,12,9,3
Nasath,arthas,861,evoker,devastation,18,9,9
Teanie,tichondrius,861,evoker,devastation,18,9,9
Gôdswrath,tichondrius,861,evoker,devastation,18,9,9
Toxicspyro,frostmourne,861,evoker,devastation,24,9,15
Karaxes,gorefiend,861,evoker,devastation,24,9,15
Krokuzan,ragnaros,860,evoker,devastation,18,9,9
Doombreath,ragnaros,859,evoker,devastation,18,9,9
Keedrori,thrall,859,evoker,devastation,19,9,10
Aoibae,frostmourne,859,evoker,devastation,24,9,15
Atpsuspect,nerzhul,858,evoker,devastation,18,9,9
Granolajin,ragnaros,857,evoker,devastation,24,9,15
Azuria,lothar,855,evoker,devastation,12,9,3
Furyíon,stormrage,855,evoker,devastation,12,9,3
Acnølogia,stormrage,855,evoker,devastation,18,9,9
Makiabelico,terenas,855,evoker,devastation,30,9,21
Edivian,ragnaros,849,evoker,devastation,19,10,9
Stormstryke,queldorei,848,evoker,devastation,41,10,31
Azafs,azralon,847,evoker,devastation,26,10,16
Rasec,moon-guard,843,evoker,devastation,20,9,11
Mewclaw,tol-barad,841,evoker,devastation,12,9,3
Rikfreedom,ragnaros,836,evoker,devastation,42,19,23
Stylez,anetheron,830,evoker,devastation,42,19,23
Dreampunk,tichondrius,784,evoker,devastation,13,9,4
Rawrrxd,blackrock,768,evoker,devastation,12,8,4
Frequentlee,illidan,768,evoker,devastation,12,8,4
Jenovi,tichondrius,768,evoker,devastation,12,8,4
Saînt,thrall,768,evoker,devastation,12,8,4
Latria,malganis,768,evoker,devastation,12,8,4
Toastsevoker,tichondrius,768,evoker,devastation,15,9,6
Dragonfarts,frostmourne,768,evoker,devastation,18,8,10
Crosis,azralon,768,evoker,devastation,18,8,10
Grievaxion,ragnaros,767,evoker,devastation,12,8,4
Gooliath,madoran,767,evoker,devastation,12,8,4
Evokemon,hyjal,767,evoker,devastation,12,8,4
Dragginballz,twisting-nether,767,evoker,devastation,12,8,4
Vermax,akama,767,evoker,devastation,18,8,10
Rïvé,tichondrius,767,evoker,devastation,24,8,16
Arokh,frostmourne,767,evoker,devastation,30,8,22
Dragonballer,trollbane,766,evoker,devastation,18,8,10
Ghostfable,emerald-dream,766,evoker,devastation,18,8,10
Dawitchvoker,illidan,766,evoker,devastation,18,8,10
Glideoure,stonemaul,766,evoker,devastation,24,8,16
Dracthylian,ragnaros,765,evoker,devastation,12,8,4
Aaztra,whisperwind,765,evoker,devastation,12,8,4
Skrillerv,frostmourne,765,evoker,devastation,18,8,10
Muppetgronk,frostmourne,765,evoker,devastation,24,8,16
Quêtzal,akama,764,evoker,devastation,12,8,4
Riz,blackhand,764,evoker,devastation,18,8,10
Gyirzkaag,illidan,764,evoker,devastation,18,8,10
Historius,proudmoore,763,evoker,devastation,18,8,10
Davidfesago,quelthalas,762,evoker,devastation,18,8,10
Redeyés,area-52,761,evoker,devastation,12,8,4
Zenithgar,aerie-peak,761,evoker,devastation,12,8,4
Tessedract,bleeding-hollow,761,evoker,devastation,12,8,4
Roksanda,azralon,761,evoker,devastation,24,8,16
Seletgos,quelthalas,761,evoker,devastation,24,8,16
Detraa,illidan,754,evoker,devastation,12,8,4
Pouncer,proudmoore,754,evoker,devastation,48,18,30
Daigrefn,echo-isles,751,evoker,devastation,18,8,10
Reptyle,emerald-dream,743,evoker,devastation,24,8,16
Liefarion,barthilas,734,evoker,devastation,22,8,14
Littleripper,tichondrius,724,evoker,devastation,18,8,10
Onornun,magtheridon,718,evoker,devastation,17,8,9
Ammar,drakkari,716,evoker,devastation,17,8,9
Ryü,silver-hand,704,evoker,devastation,16,8,8
Drøgon,sargeras,703,evoker,devastation,20,8,12
Zhyrouvion,stormrage,699,evoker,devastation,17,8,9
Torakk,ravencrest,687,evoker,devastation,13,8,5
Spryo,illidan,672,evoker,devastation,12,7,5
Lizardgodtko,tichondrius,672,evoker,devastation,12,7,5
Lacadabeef,tichondrius,672,evoker,devastation,12,7,5
Dragzun,tichondrius,672,evoker,devastation,12,7,5
Chewbigred,vashj,672,evoker,devastation,12,7,5
Dragonherb,zuljin,672,evoker,devastation,12,7,5
Dinohgos,area-52,672,evoker,devastation,12,7,5
Evook,tichondrius,672,evoker,devastation,12,7,5
Shambly,kelthuzad,672,evoker,devastation,12,7,5
Dudeofdragon,illidan,672,evoker,devastation,12,7,5
Rearcalzone,illidan,672,evoker,devastation,12,7,5
Vokr,area-52,672,evoker,devastation,12,7,5
Emberlyn,sargeras,672,evoker,devastation,12,7,5
Spikeyboi,eonar,672,evoker,devastation,12,7,5
Nysian,wyrmrest-accord,672,evoker,devastation,12,7,5
Écaille,dalaran,672,evoker,devastation,15,8,7
Deathstaind,tichondrius,672,evoker,devastation,16,8,8
Dragonstonks,moon-guard,672,evoker,devastation,18,7,11
Sådge,frostmourne,672,evoker,devastation,18,7,11
Dragonshani,thrall,672,evoker,devastation,18,7,11
Müshü,icecrown,672,evoker,devastation,18,7,11
Emopidgey,dalaran,672,evoker,devastation,18,7,11
Dragonballzx,kelthuzad,672,evoker,devastation,24,7,17
Whiegrath,azralon,671,evoker,devastation,12,7,5
Wekinball,tichondrius,671,evoker,devastation,12,7,5
Boseijwho,emerald-dream,671,evoker,devastation,12,7,5
Xeretas,bleeding-hollow,671,evoker,devastation,12,7,5
Glaurungr,ragnaros,671,evoker,devastation,12,7,5
Pågemaster,moon-guard,671,evoker,devastation,12,7,5
Archalygos,moon-guard,671,evoker,devastation,12,7,5
Garchamp,area-52,671,evoker,devastation,15,8,7
Phatë,nerzhul,671,evoker,devastation,18,7,11
Sizzlebird,darkspear,671,evoker,devastation,18,7,11
Ackrenoth,emerald-dream,671,evoker,devastation,18,7,11
Hemipenes,tichondrius,671,evoker,devastation,18,7,11
Doomn,moon-guard,671,evoker,devastation,18,7,11
Subject,kelthuzad,671,evoker,devastation,18,7,11
Kluath,daggerspine,671,evoker,devastation,18,7,11
Tikkaratika,nemesis,671,evoker,devastation,18,7,11
Brothererik,hydraxis,671,evoker,devastation,18,7,11
Saristrasza,moon-guard,671,evoker,devastation,18,7,11
Drageyman,tichondrius,671,evoker,devastation,24,7,17
Setchagos,emerald-dream,670,evoker,devastation,12,7,5
Gulvoke,shattered-hand,670,evoker,devastation,12,7,5
Beastlysoul,tichondrius,670,evoker,devastation,12,7,5
Draecion,tichondrius,670,evoker,devastation,18,7,11
Nikeze,kiljaeden,670,evoker,devastation,18,7,11
Lamperr,illidan,670,evoker,devastation,54,10,44
Pläid,azuremyst,668,evoker,devastation,12,7,5
Sleepeasy,blackrock,667,evoker,devastation,18,7,11
Mmanigoldo,quelthalas,667,evoker,devastation,18,7,11
Evilsquirel,area-52,666,evoker,devastation,12,7,5
Movoker,tichondrius,655,evoker,devastation,15,8,7
Bàkèd,illidan,655,evoker,devastation,17,7,10
Henscale,malganis,639,evoker,devastation,11,7,4
Krefugee,tichondrius,637,evoker,devastation,17,7,10
Drahkoo,azralon,623,evoker,devastation,15,7,8
Yellowker,thrall,576,evoker,devastation,6,6,0
Zérai,quelthalas,576,evoker,devastation,6,6,0
Fuecoco,proudmoore,576,evoker,devastation,6,6,0
Shanaynayae,area-52,576,evoker,devastation,12,6,6
Vysenía,moon-guard,576,evoker,devastation,12,6,6
Xurota,proudmoore,576,evoker,devastation,12,6,6
Dafiya,thrall,576,evoker,devastation,12,6,6
Actïoncat,emerald-dream,576,evoker,devastation,12,6,6
Alucardragon,turalyon,576,evoker,devastation,12,6,6
Glizard,firetree,576,evoker,devastation,12,6,6
Yujirohanma,frostmourne,576,evoker,devastation,12,6,6
Uncleìroh,tichondrius,576,evoker,devastation,12,6,6
Nemenyah,emerald-dream,576,evoker,devastation,12,6,6
Dragonage,stormrage,576,evoker,devastation,12,6,6
Iamtrash,daggerspine,576,evoker,devastation,12,6,6
Joyburn,tichondrius,576,evoker,devastation,12,6,6
Bigdvoker,jubeithos,576,evoker,devastation,12,6,6
Medusaan,tichondrius,576,evoker,devastation,12,6,6
Wingjob,tichondrius,576,evoker,devastation,12,6,6
Volksdragen,sargeras,576,evoker,devastation,12,6,6
Comepancito,quelthalas,576,evoker,devastation,12,6,6
Pÿthön,sargeras,576,evoker,devastation,12,6,6
Sathregos,emerald-dream,576,evoker,devastation,12,6,6
Lazarust,tichondrius,576,evoker,devastation,12,6,6
Chadizard,tichondrius,576,evoker,devastation,12,6,6
Daethwang,moon-guard,576,evoker,devastation,12,6,6
Dragønbørne,blackrock,576,evoker,devastation,12,6,6
Dragordito,drakkari,576,evoker,devastation,12,6,6
Shrikethyr,chogall,576,evoker,devastation,12,6,6
Deneryus,illidan,576,evoker,devastation,12,6,6
Borpia,malganis,576,evoker,devastation,12,6,6
Dukä,dalaran,576,evoker,devastation,15,7,8
Chaosrebørn,bleeding-hollow,576,evoker,devastation,18,6,12
Koopa,malygos,576,evoker,devastation,18,6,12
Syvernius,khazgoroth,576,evoker,devastation,18,6,12
Saxthyr,stormreaver,576,evoker,devastation,24,6,18
Zeldir,ragnaros,575,evoker,devastation,6,6,0
Dimpulse,zuljin,575,evoker,devastation,12,6,6
Cøømbuya,sargeras,575,evoker,devastation,12,6,6
Lòrdope,illidan,575,evoker,devastation,12,6,6
Setasdan,illidan,575,evoker,devastation,12,6,6
Amaryliss,kelthuzad,575,evoker,devastation,12,6,6
Swagondragon,illidan,575,evoker,devastation,12,6,6
Drãco,area-52,575,evoker,devastation,12,6,6
Dumbodragon,bleeding-hollow,575,evoker,devastation,12,6,6
Avastri,moon-guard,575,evoker,devastation,12,6,6
Avithori,borean-tundra,575,evoker,devastation,12,6,6
Koriaz,ragnaros,575,evoker,devastation,12,6,6
Altri,lightnings-blade,575,evoker,devastation,12,6,6
Sevariel,frostmane,575,evoker,devastation,12,6,6
Vrtra,lightbringer,575,evoker,devastation,12,6,6
Rykuvokr,azuremyst,575,evoker,devastation,12,6,6
Tylexstranza,malganis,575,evoker,devastation,12,6,6
Kazecgos,zuljin,575,evoker,devastation,12,6,6
Taxfraudchad,sargeras,575,evoker,devastation,13,6,7
Hopefire,zuljin,575,evoker,devastation,18,6,12
Cinderelluh,area-52,575,evoker,devastation,18,6,12
Alragos,ragnaros,575,evoker,devastation,18,6,12
Lindrak,azralon,575,evoker,devastation,18,6,12
Bazelgos,moon-guard,575,evoker,devastation,24,6,18
Vermáx,caelestrasz,574,evoker,devastation,12,6,6
Spyrofnir,stormrage,574,evoker,devastation,18,6,12
Carloxd,tichondrius,574,evoker,devastation,24,6,18
Deathb,chromaggus,573,evoker,devastation,12,6,6
Syndue,malganis,573,evoker,devastation,12,6,6
Silvèrr,tichondrius,573,evoker,devastation,12,6,6
Noodleslut,stormrage,573,evoker,devastation,12,6,6
Azuril,wyrmrest-accord,572,evoker,devastation,12,6,6
Fafnirr,draenor,572,evoker,devastation,26,6,20
Dragopnik,tichondrius,568,evoker,devastation,18,9,9
Lightaurae,thunderlord,556,evoker,devastation,30,6,24
Pzyko,ragnaros,551,evoker,devastation,17,6,11
Zindrozarath,area-52,544,evoker,devastation,10,6,4
Vyserion,turalyon,543,evoker,devastation,8,7,1
Boadie,kilrogg,542,evoker,devastation,24,7,17
Adorablexo,stormrage,527,evoker,devastation,11,6,5
Zovaan,emerald-dream,526,evoker,devastation,11,6,5
Kodeser,alleria,522,evoker,devastation,15,6,9
Arnoeryan,ragnaros,512,evoker,devastation,16,6,10
Carrnedge,area-52,511,evoker,devastation,11,6,5
Nathrach,wyrmrest-accord,506,evoker,devastation,8,6,2
Copevoker,black-dragonflight,480,evoker,devastation,6,5,1
Schmitty,hellscream,480,evoker,devastation,6,5,1
Solidusz,thrall,480,evoker,devastation,6,5,1
Cheeriosvokr,tichondrius,480,evoker,devastation,6,5,1
Kensar,drakkari,480,evoker,devastation,6,5,1
Khalt,quelthalas,480,evoker,devastation,6,5,1
Kharibdis,kul-tiras,480,evoker,devastation,6,5,1
Vellony,kelthuzad,480,evoker,devastation,6,5,1
Drakedrift,malganis,480,evoker,devastation,6,5,1
Dragonhyde,stormrage,480,evoker,devastation,12,5,7
Dhcb,tichondrius,480,evoker,devastation,12,5,7
Deezdragon,stormrage,480,evoker,devastation,12,5,7
Amplicon,stormrage,480,evoker,devastation,12,5,7
Nardleberry,wyrmrest-accord,480,evoker,devastation,12,5,7
Demikass,azralon,480,evoker,devastation,12,5,7
Valkhar,illidan,480,evoker,devastation,12,5,7
Rebuk,area-52,480,evoker,devastation,12,5,7
Trillvoker,illidan,480,evoker,devastation,12,5,7
Saìntgeorge,sargeras,480,evoker,devastation,12,5,7
Vallath,zuljin,480,evoker,devastation,12,5,7
Purplerocket,illidan,480,evoker,devastation,12,5,7
Moltqt,tichondrius,480,evoker,devastation,12,5,7
Stælthßømbèr,baelgun,480,evoker,devastation,12,5,7
Asatrat,greymane,480,evoker,devastation,12,5,7
Cerisoromis,stormrage,480,evoker,devastation,12,5,7
Jevoker,area-52,480,evoker,devastation,12,5,7
Draehgor,hyjal,480,evoker,devastation,12,5,7
Galakrond,black-dragonflight,480,evoker,devastation,12,5,7
Darkscale,haomarush,480,evoker,devastation,12,5,7
Saintpablox,illidan,480,evoker,devastation,12,5,7
Ventiev,tichondrius,480,evoker,devastation,12,5,7
Ackresh,executus,480,evoker,devastation,12,5,7
Dratonos,stormrage,480,evoker,devastation,12,5,7
Eyedxl,magtheridon,480,evoker,devastation,12,5,7
Faahrad,azralon,480,evoker,devastation,12,5,7
Abath,quelthalas,480,evoker,devastation,14,5,9
Nyldra,area-52,480,evoker,devastation,14,5,9
Velahesa,sargeras,480,evoker,devastation,24,5,19
Müshu,duskwood,479,evoker,devastation,12,5,7
Dedderion,zuljin,479,evoker,devastation,12,5,7
Lightbeing,nazjatar,479,evoker,devastation,12,5,7
Scalesun,azralon,479,evoker,devastation,12,5,7
Mattykanish,illidan,479,evoker,devastation,12,5,7
Dracoi,illidan,479,evoker,devastation,12,5,7
Zerodorez,zuljin,479,evoker,devastation,12,5,7
Windylyrics,drakkari,479,evoker,devastation,18,5,13
Adraell,illidan,478,evoker,devastation,13,6,7
Niratrenn,area-52,478,evoker,devastation,12,5,7
Nazervis,silver-hand,478,evoker,devastation,18,5,13
Dracosofi,quelthalas,478,evoker,devastation,18,5,13
Sandrov,kaelthas,477,evoker,devastation,12,5,7
Saraphrodite,hakkar,477,evoker,devastation,12,5,7
Althenot,emerald-dream,477,evoker,devastation,12,5,7
Surezilla,malganis,477,evoker,devastation,24,5,19
Odorf,duskwood,474,evoker,devastation,12,5,7
Sammalone,burning-blade,474,evoker,devastation,12,5,7
Shennron,darkspear,447,evoker,devastation,11,5,6
Zzae,tichondrius,432,evoker,devastation,15,5,10
Dazei,quelthalas,431,evoker,devastation,15,5,10
Xfemboyqt,area-52,426,evoker,devastation,19,7,12
Lifcleal,moon-guard,415,evoker,devastation,14,5,9
Biscotti,illidan,384,evoker,devastation,6,4,2
Dragonaria,illidan,384,evoker,devastation,6,4,2
Awexstwaza,bleeding-hollow,384,evoker,devastation,6,4,2
Dragonchip,bleeding-hollow,384,evoker,devastation,6,4,2
Mushú,archimonde,384,evoker,devastation,6,4,2
Atraxian,tichondrius,384,evoker,devastation,6,4,2
Dragonsbgay,stormrage,384,evoker,devastation,6,4,2
Zorlstisza,moon-guard,384,evoker,devastation,6,4,2
Opsmybad,ragnaros,384,evoker,devastation,6,4,2
Docevoker,tichondrius,384,evoker,devastation,6,4,2
Machaflux,winterhoof,384,evoker,devastation,6,4,2
Jammstraza,skywall,384,evoker,devastation,6,4,2
Shenròn,kelthuzad,384,evoker,devastation,6,4,2
Walmartshoes,tichondrius,384,evoker,devastation,6,4,2
Shënrøn,tichondrius,384,evoker,devastation,6,4,2
Kaidoxuchihv,ragnaros,384,evoker,devastation,6,4,2
Whinks,zangarmarsh,384,evoker,devastation,6,4,2
Deathraux,tichondrius,384,evoker,devastation,6,4,2
Foxstrazagos,hellscream,384,evoker,devastation,6,4,2
Konne,tichondrius,384,evoker,devastation,6,4,2
Seaserpent,kelthuzad,384,evoker,devastation,6,4,2
Vuldon,area-52,384,evoker,devastation,6,4,2
Kusarí,moon-guard,384,evoker,devastation,6,4,2
Bmbo,illidan,384,evoker,devastation,6,4,2
Draisin,zuljin,384,evoker,devastation,6,4,2
Daemon,detheroc,384,evoker,devastation,6,4,2
Testzvoker,dalaran,384,evoker,devastation,6,4,2
Skazz,emerald-dream,384,evoker,devastation,6,4,2
Korvold,zuluhed,384,evoker,devastation,6,4,2
Solazari,tichondrius,384,evoker,devastation,6,4,2
Bodytypetwo,area-52,384,evoker,devastation,6,4,2
Shenrõn,malganis,384,evoker,devastation,15,5,10
Trazer,malfurion,384,evoker,devastation,12,4,8
Nosrej,hyjal,384,evoker,devastation,12,4,8
Cuarta,drakkari,384,evoker,devastation,12,4,8
Kcwt,illidan,384,evoker,devastation,12,4,8
Nitalzith,area-52,384,evoker,devastation,12,4,8
Idiotlizard,stormrage,384,evoker,devastation,12,4,8
Kurulol,ragnaros,384,evoker,devastation,12,4,8
Usulamili,stormrage,384,evoker,devastation,12,4,8
Magnito,thorium-brotherhood,384,evoker,devastation,12,4,8
Baddrakthyr,moon-guard,384,evoker,devastation,12,4,8
Uhlive,area-52,384,evoker,devastation,12,4,8
Devåståtion,tichondrius,384,evoker,devastation,12,4,8
Kendrac,wyrmrest-accord,384,evoker,devastation,12,4,8
Smackthyr,thrall,384,evoker,devastation,12,4,8
Kodeserath,hakkar,384,evoker,devastation,12,4,8
Dracconic,sargeras,384,evoker,devastation,12,4,8
Arkevo,tichondrius,384,evoker,devastation,12,4,8
Butta,darkspear,384,evoker,devastation,12,4,8
Bigsquirt,proudmoore,384,evoker,devastation,12,4,8
Blay,elune,384,evoker,devastation,12,4,8
Smacktoch,sargeras,384,evoker,devastation,12,4,8
Munichho,spirestone,384,evoker,devastation,18,4,14
Dadydafather,sargeras,384,evoker,devastation,30,4,26
Deralizrd,tichondrius,383,evoker,devastation,6,4,2
Dinossauro,stormrage,383,evoker,devastation,6,4,2
Rysonda,tichondrius,383,evoker,devastation,6,4,2
Bagelsaurus,tichondrius,383,evoker,devastation,12,4,8
Zaland,whisperwind,383,evoker,devastation,12,4,8
Odaa,moon-guard,383,evoker,devastation,12,4,8
Jabberwockie,zuljin,383,evoker,devastation,12,4,8
Broconian,zuljin,383,evoker,devastation,12,4,8
Shenrøn,altar-of-storms,383,evoker,devastation,12,4,8
Abodie,dalaran,383,evoker,devastation,12,4,8
Gorby,tichondrius,383,evoker,devastation,12,4,8
Gunship,moon-guard,383,evoker,devastation,12,4,8
Mynameisjohn,hakkar,382,evoker,devastation,6,4,2
Äpollo,frostmourne,382,evoker,devastation,12,4,8
Dracalis,thrall,381,evoker,devastation,12,4,8
Forte,terokkar,381,evoker,devastation,18,4,14
Fearmybreath,stormrage,370,evoker,devastation,22,7,15
Goongdi,tichondrius,351,evoker,devastation,11,4,7
Vermicri,zuljin,351,evoker,devastation,11,4,7
Serazenoth,area-52,336,evoker,devastation,9,4,5
Acindor,stormrage,335,evoker,devastation,11,4,7
Heizdrag,area-52,335,evoker,devastation,11,4,7
Ackrs,tichondrius,335,evoker,devastation,11,4,7
Draygaar,stormrage,330,evoker,devastation,15,5,10
Baarss,tichondrius,288,evoker,devastation,6,3,3
Blackrend,illidan,288,evoker,devastation,6,3,3
Drackthyria,quelthalas,288,evoker,devastation,6,3,3
Holdherhorn,area-52,288,evoker,devastation,6,3,3
Skeye,malganis,288,evoker,devastation,6,3,3
Hausebat,aegwynn,288,evoker,devastation,6,3,3
Ráigon,ragnaros,288,evoker,devastation,6,3,3
Yeda,barthilas,288,evoker,devastation,6,3,3
Ceraxes,stormscale,288,evoker,devastation,6,3,3
Lëåf,area-52,288,evoker,devastation,6,3,3
Theomarz,nagrand,288,evoker,devastation,6,3,3
Ripdumpster,bonechewer,288,evoker,devastation,6,3,3
Baddrake,moon-guard,288,evoker,devastation,6,3,3
Sovant,sargeras,288,evoker,devastation,6,3,3
Dreamfyrexi,thrall,288,evoker,devastation,6,3,3
Avasd,area-52,288,evoker,devastation,6,3,3
Yousmokemids,frostwolf,288,evoker,devastation,6,3,3
Royagon,draktharon,288,evoker,devastation,6,3,3
Djvokey,area-52,288,evoker,devastation,6,3,3
Kettor,kelthuzad,288,evoker,devastation,6,3,3
Shenronda,moon-guard,288,evoker,devastation,6,3,3
Soupywings,illidan,288,evoker,devastation,6,3,3
Toenailstew,zuljin,288,evoker,devastation,6,3,3
Burningwoe,tichondrius,288,evoker,devastation,6,3,3
Koyra,illidan,288,evoker,devastation,6,3,3
Sardonyx,dragonmaw,288,evoker,devastation,6,3,3
Wickedwings,tichondrius,288,evoker,devastation,6,3,3
Baeltas,blackrock,288,evoker,devastation,6,3,3
Unisex,ragnaros,288,evoker,devastation,6,3,3
Draggoh,bleeding-hollow,288,evoker,devastation,6,3,3
Magicev,tichondrius,288,evoker,devastation,6,3,3
Ecoera,tichondrius,288,evoker,devastation,6,3,3
Brokenscales,nerzhul,288,evoker,devastation,6,3,3
Zarazerath,tichondrius,288,evoker,devastation,6,3,3
Jakarn,moon-guard,288,evoker,devastation,6,3,3
Zindrath,emerald-dream,288,evoker,devastation,6,3,3
Stewvoker,wyrmrest-accord,288,evoker,devastation,6,3,3
Derkscale,stormrage,288,evoker,devastation,6,3,3
Damo,skullcrusher,288,evoker,devastation,6,3,3
Varandir,frostmane,288,evoker,devastation,6,3,3
Dragonpel,azralon,288,evoker,devastation,6,3,3
Breathkillsu,emerald-dream,288,evoker,devastation,6,3,3
Scyyterr,azralon,288,evoker,devastation,6,3,3
Crankxz,malganis,288,evoker,devastation,6,3,3
Lamdyn,wyrmrest-accord,288,evoker,devastation,6,3,3
Kaeszandrus,azralon,288,evoker,devastation,6,3,3
Devastateme,frostmourne,288,evoker,devastation,6,3,3
Koderalth,azralon,288,evoker,devastation,6,3,3
Straykitty,moon-guard,288,evoker,devastation,6,3,3
Kulrainor,drakkari,288,evoker,devastation,6,3,3
Spyro,nazgrel,288,evoker,devastation,6,3,3
Aomend,stormrage,288,evoker,devastation,6,3,3
Skydragonlol,tichondrius,288,evoker,devastation,7,3,4
Drakthaer,tichondrius,288,evoker,devastation,7,3,4
Viverion,dalaran,288,evoker,devastation,10,4,6
Taegon,area-52,288,evoker,devastation,10,4,6
Grem,muradin,288,evoker,devastation,8,3,5
Vandinus,stormrage,288,evoker,devastation,8,3,5
Berylhwit,emerald-dream,288,evoker,devastation,11,3,8
Marâjade,proudmoore,288,evoker,devastation,12,3,9
Inferna,ysera,288,evoker,devastation,12,3,9
Zafirina,proudmoore,288,evoker,devastation,12,3,9
Murtharion,stormrage,288,evoker,devastation,12,3,9
Freddragon,illidan,288,evoker,devastation,12,3,9
Karmísh,quelthalas,288,evoker,devastation,12,3,9
Draconis,onyxia,288,evoker,devastation,12,3,9
Praac,illidan,288,evoker,devastation,12,3,9
Lizardlee,stormrage,288,evoker,devastation,12,3,9
Spyspyro,emerald-dream,288,evoker,devastation,12,3,9
Healmeta,sargeras,288,evoker,devastation,12,3,9
Talonsong,wyrmrest-accord,288,evoker,devastation,12,3,9
Chriszilla,tichondrius,288,evoker,devastation,12,3,9
Bjarne,hyjal,288,evoker,devastation,12,3,9
Enserio,stormrage,288,evoker,devastation,12,3,9
Dragndesnuts,scilla,288,evoker,devastation,18,3,15
Vaegahr,tichondrius,287,evoker,devastation,6,3,3
Zeralzin,aerie-peak,287,evoker,devastation,6,3,3
Shaletresh,thrall,287,evoker,devastation,12,3,9
Myvrth,windrunner,287,evoker,devastation,12,3,9
Kilnarx,uldaman,286,evoker,devastation,6,3,3
Brontez,malganis,286,evoker,devastation,6,3,3
Ghorin,akama,240,evoker,devastation,9,3,6
Draconiss,bonechewer,239,evoker,devastation,5,3,2
Evoque,sargeras,239,evoker,devastation,15,3,12
Reombarth,nemesis,234,evoker,devastation,12,6,6
Trrxx,tichondrius,224,evoker,devastation,10,3,7
Spectaclaw,crushridge,223,evoker,devastation,8,3,5
Wydbro,kiljaeden,192,evoker,devastation,6,2,4
Siatren,shadowmoon,192,evoker,devastation,6,2,4
Dixb,illidan,192,evoker,devastation,6,2,4
Acade,tichondrius,192,evoker,devastation,6,2,4
Vermithõr,ragnaros,192,evoker,devastation,6,2,4
Goreriders,area-52,192,evoker,devastation,6,2,4
Puffed,frostmourne,192,evoker,devastation,6,2,4
Lanati,veknilash,192,evoker,devastation,6,2,4
Mâne,ragnaros,192,evoker,devastation,6,2,4
Zuberion,wyrmrest-accord,192,evoker,devastation,6,2,4
Yalena,illidan,192,evoker,devastation,6,2,4
Vapegodx,proudmoore,192,evoker,devastation,6,2,4
Nyaraoorun,uther,192,evoker,devastation,6,2,4
Ilithiphobia,ghostlands,192,evoker,devastation,6,2,4
Horusnight,drakkari,192,evoker,devastation,6,2,4
Aralzit,tichondrius,192,evoker,devastation,6,2,4
Shädòwçäsper,kilrogg,192,evoker,devastation,6,2,4
Tasdaral,tichondrius,192,evoker,devastation,6,2,4
Hoodoo,dark-iron,192,evoker,devastation,6,2,4
Zattanik,ragnaros,192,evoker,devastation,6,2,4
Mikaeza,tichondrius,192,evoker,devastation,6,2,4
Xazxander,tichondrius,192,evoker,devastation,6,2,4
Magikarpchan,ragnaros,192,evoker,devastation,6,2,4
Dragonsand,area-52,192,evoker,devastation,6,2,4
Umbrathel,tichondrius,192,evoker,devastation,6,2,4
Ryüh,azralon,192,evoker,devastation,6,2,4
Daikon,kaelthas,192,evoker,devastation,6,2,4
Weirdclassx,tichondrius,192,evoker,devastation,6,2,4
Pyrepeanut,tichondrius,192,evoker,devastation,6,2,4
Tiyeal,thrall,192,evoker,devastation,6,2,4
Olawd,azshara,192,evoker,devastation,6,2,4
Slydawg,amanthul,192,evoker,devastation,6,2,4
Daebruk,ragnaros,192,evoker,devastation,6,2,4
Slyinx,area-52,192,evoker,devastation,6,2,4
Draketyr,area-52,192,evoker,devastation,6,2,4
Kaaer,emerald-dream,192,evoker,devastation,6,2,4
Desdinova,tortheldrin,192,evoker,devastation,6,2,4
Daraz,tichondrius,192,evoker,devastation,6,2,4
Racovoker,zuljin,192,evoker,devastation,6,2,4
Dokthyr,lightbringer,192,evoker,devastation,6,2,4
Genderboy,tichondrius,192,evoker,devastation,6,2,4
Paindragon,tol-barad,192,evoker,devastation,6,2,4
Kazervish,wyrmrest-accord,192,evoker,devastation,6,2,4
Joesount,frostmourne,192,evoker,devastation,6,2,4
Kímbah,emerald-dream,192,evoker,devastation,6,2,4
Swamper,emerald-dream,192,evoker,devastation,6,2,4
Eggvoker,area-52,192,evoker,devastation,6,2,4
Daemon,terokkar,192,evoker,devastation,6,2,4
Grawlix,stormreaver,192,evoker,devastation,6,2,4
Ralzital,auchindoun,192,evoker,devastation,6,2,4
Scalendar,frostmourne,192,evoker,devastation,6,2,4
Hiroshim,stormrage,192,evoker,devastation,6,2,4
Frozanat,kelthuzad,192,evoker,devastation,6,2,4
Álln,sargeras,192,evoker,devastation,6,2,4
Critqueenx,destromath,192,evoker,devastation,6,2,4
Nitalash,moon-guard,192,evoker,devastation,6,2,4
Dragboy,stormrage,192,evoker,devastation,6,2,4
Dracorblaq,bleeding-hollow,192,evoker,devastation,6,2,4
Doldorrii,terenas,192,evoker,devastation,6,2,4
Hellasketchy,sargeras,192,evoker,devastation,6,2,4
Lillbigd,bleeding-hollow,192,evoker,devastation,6,2,4
Moorozond,zuljin,192,evoker,devastation,6,2,4
Parachutes,kelthuzad,192,evoker,devastation,6,2,4
Noxidian,moon-guard,192,evoker,devastation,6,2,4
Rezoth,malganis,192,evoker,devastation,6,2,4
Selocky,bleeding-hollow,192,evoker,devastation,6,2,4
Guavomango,moon-guard,192,evoker,devastation,6,2,4
Theyevokbuda,kelthuzad,192,evoker,devastation,6,2,4
Analogies,stormrage,192,evoker,devastation,6,2,4
Pocketgiga,stormrage,192,evoker,devastation,6,2,4
Cyromancerr,illidan,192,evoker,devastation,8,2,6
Blueblack,proudmoore,192,evoker,devastation,12,2,10
Chillistraza,tichondrius,192,evoker,devastation,12,2,10
Dragonbornhd,tichondrius,192,evoker,devastation,12,2,10
Detralan,draka,192,evoker,devastation,12,2,10
Bitormu,scilla,192,evoker,devastation,12,2,10
Valkarie,arygos,192,evoker,devastation,12,2,10
Ragtharion,tichondrius,192,evoker,devastation,12,2,10
Niraller,tichondrius,192,evoker,devastation,12,2,10
Kuthar,barthilas,192,evoker,devastation,12,2,10
Sørrøw,blades-edge,192,evoker,devastation,18,2,16
Tevvez,moon-guard,159,evoker,devastation,5,2,3
Skaylee,illidan,144,evoker,devastation,9,2,7
Deshalth,dalaran,138,evoker,devastation,11,5,6
Platypus,tichondrius,138,evoker,devastation,11,4,7
Deathflamee,emerald-dream,138,evoker,devastation,12,3,9
Eleechee,magtheridon,128,evoker,devastation,4,2,2
Vïtmercon,frostmourne,128,evoker,devastation,4,2,2
Shunkagosa,frostmourne,128,evoker,devastation,4,2,2
Booniejimbob,illidan,128,evoker,devastation,4,2,2
Vormontis,azralon,112,evoker,devastation,7,2,5
Gavstarz,frostmourne,96,evoker,devastation,3,2,1
Tugmapvpean,kelthuzad,96,evoker,devastation,3,2,1
Warchad,stormrage,96,evoker,devastation,6,1,5
Ackonstraza,frostmourne,96,evoker,devastation,6,1,5
Asui,senjin,96,evoker,devastation,6,1,5
Ojigi,sargeras,96,evoker,devastation,6,1,5
Drakkar,elune,96,evoker,devastation,6,1,5
Skithyrix,bleeding-hollow,96,evoker,devastation,6,1,5
Nuppsy,frostmourne,96,evoker,devastation,6,1,5
Selfhealzer,korgath,96,evoker,devastation,6,1,5
Luceryz,drakkari,96,evoker,devastation,6,1,5
Ocd,stormrage,96,evoker,devastation,6,1,5
Erathiss,wyrmrest-accord,96,evoker,devastation,6,1,5
Batterypowa,frostmourne,96,evoker,devastation,6,1,5
Kazadon,icecrown,96,evoker,devastation,6,1,5
Bløssom,malganis,96,evoker,devastation,6,1,5
Trogs,emerald-dream,96,evoker,devastation,6,1,5
Demobreath,sargeras,96,evoker,devastation,6,1,5
Repd,sargeras,96,evoker,devastation,6,1,5
Charrio,illidan,96,evoker,devastation,6,1,5
Zinderaz,runetotem,96,evoker,devastation,6,1,5
Myjewelshurt,stormrage,96,evoker,devastation,6,1,5
Handb,tichondrius,96,evoker,devastation,6,1,5
Zealagon,ragnaros,96,evoker,devastation,6,1,5
Proust,grizzly-hills,96,evoker,devastation,6,1,5
Leralan,illidan,96,evoker,devastation,6,1,5
Modenzu,malganis,96,evoker,devastation,6,1,5
Sneekysnekz,tichondrius,96,evoker,devastation,6,1,5
Ðrac,bleeding-hollow,96,evoker,devastation,6,1,5
Fígment,tichondrius,96,evoker,devastation,6,1,5
Chocamocos,area-52,96,evoker,devastation,6,1,5
Shintrax,ragnaros,96,evoker,devastation,6,1,5
Rojothyr,tichondrius,96,evoker,devastation,6,1,5
Happyevoker,tichondrius,96,evoker,devastation,6,1,5
Lucià,thrall,96,evoker,devastation,6,1,5
Sigroux,area-52,96,evoker,devastation,6,1,5
Donormi,moon-guard,96,evoker,devastation,12,1,11
Ysondrius,durotan,96,evoker,devastation,12,1,11
Carnosaur,lightbringer,96,evoker,devastation,12,1,11
Bigwurrm,illidan,96,evoker,devastation,12,1,11
Icedmochaa,thrall,96,evoker,devastation,12,1,11
Colloc,tichondrius,96,evoker,devastation,12,1,11
Rathend,lothar,96,evoker,devastation,12,1,11
Embeka,illidan,95,evoker,devastation,6,1,5
Coped,stormrage,79,evoker,devastation,5,1,4
Nwo,shattered-hand,64,evoker,devastation,4,1,3
Starkiller,stormrage,64,evoker,devastation,4,1,3
Alkden,azralon,63,evoker,devastation,2,2,0
Nyxtari,ragnaros,48,evoker,devastation,3,1,2
Charlestrasz,hyjal,42,evoker,devastation,11,3,8
Ytq,tichondrius,42,evoker,devastation,10,2,8
Remisha,emerald-dream,2136,hunter,marksmanship,82,44,38
Darkshady,tichondrius,2108,hunter,marksmanship,84,44,40
Chadsmanship,kelthuzad,2103,hunter,marksmanship,98,47,51
Dobarantu,tichondrius,2044,hunter,marksmanship,175,90,85
Rendel,drakkari,2035,hunter,marksmanship,201,102,99
Abolick,area-52,2022,hunter,marksmanship,130,68,62
Imvalence,area-52,2003,hunter,marksmanship,124,59,65
Fuknhunter,kiljaeden,1905,hunter,marksmanship,110,56,54
Wmsgs,tichondrius,1888,hunter,marksmanship,109,57,52
Banshee,frostmourne,1886,hunter,marksmanship,40,24,16
Rakan,spinebreaker,1884,hunter,marksmanship,54,33,21
Bøl,ragnaros,1882,hunter,marksmanship,30,20,10
Hokutox,tichondrius,1870,hunter,marksmanship,68,31,37
Drupert,tichondrius,1869,hunter,marksmanship,36,20,16
Blackjesu,blackrock,1868,hunter,marksmanship,72,33,39
Zumago,tichondrius,1867,hunter,marksmanship,111,59,52
Kensho,illidan,1864,hunter,marksmanship,77,45,32
Hrafn,illidan,1859,hunter,marksmanship,60,31,29
Babyhydra,frostmourne,1858,hunter,marksmanship,65,32,33
Preze,moon-guard,1852,hunter,marksmanship,63,37,26
Squawkers,sargeras,1848,hunter,marksmanship,78,43,35
Astolenis,quelthalas,1847,hunter,marksmanship,60,29,31
Moonwind,tichondrius,1836,hunter,marksmanship,65,31,34
Takeiya,zuljin,1830,hunter,marksmanship,59,30,29
Globalcake,illidan,1828,hunter,marksmanship,180,91,89
Hâwkêyê,thrall,1827,hunter,marksmanship,48,22,26
Iconvoked,sargeras,1816,hunter,marksmanship,214,110,104
Ingrutamig,tichondrius,1814,hunter,marksmanship,66,32,34
Colada,malganis,1813,hunter,marksmanship,72,34,38
Bosshunter,tichondrius,1810,hunter,marksmanship,86,43,43
Nishinos,tichondrius,1808,hunter,marksmanship,183,88,95
Kristemis,thrall,1806,hunter,marksmanship,57,30,27
Renaître,tichondrius,1806,hunter,marksmanship,126,58,68
Tánsøxøxø,tichondrius,1805,hunter,marksmanship,60,30,30
Czeroenjoyer,malganis,1803,hunter,marksmanship,66,33,33
Lely,tichondrius,1800,hunter,marksmanship,72,38,34
Trapordíe,tichondrius,1800,hunter,marksmanship,42,21,21
Supersaiyan,antonidas,1797,hunter,marksmanship,60,28,32
Comebacks,ragnaros,1789,hunter,marksmanship,64,34,30
Drasen,deathwing,1778,hunter,marksmanship,48,27,21
Khasu,ragnaros,1767,hunter,marksmanship,42,21,21
Hagadinn,frostmourne,1765,hunter,marksmanship,48,21,27
Landon,lightnings-blade,1759,hunter,marksmanship,42,24,18
Alyywn,tichondrius,1758,hunter,marksmanship,143,70,73
Dynith,sargeras,1756,hunter,marksmanship,39,21,18
Undeadroach,tichondrius,1747,hunter,marksmanship,119,55,64
Notnick,tichondrius,1747,hunter,marksmanship,84,37,47
Shatterwax,area-52,1744,hunter,marksmanship,48,24,24
Mapp,tichondrius,1736,hunter,marksmanship,30,20,10
Overgnome,ragnaros,1736,hunter,marksmanship,66,32,34
Deutêr,quelthalas,1734,hunter,marksmanship,78,39,39
Boquiinha,stormrage,1732,hunter,marksmanship,114,57,57
Trapstar,aggramar,1729,hunter,marksmanship,74,43,31
Maximos,lightnings-blade,1720,hunter,marksmanship,150,75,75
Dudemanyeah,skullcrusher,1720,hunter,marksmanship,66,26,40
Primalus,tichondrius,1717,hunter,marksmanship,36,18,18
Ladderpolice,tichondrius,1716,hunter,marksmanship,91,49,42
Kkoduckk,tichondrius,1715,hunter,marksmanship,30,19,11
Gohan,jubeithos,1713,hunter,marksmanship,39,22,17
Dolcece,tichondrius,1713,hunter,marksmanship,48,24,24
Nãmki,tichondrius,1710,hunter,marksmanship,48,32,16
Stormjin,arthas,1703,hunter,marksmanship,60,32,28
Quickitty,proudmoore,1703,hunter,marksmanship,148,73,75
Heädshöt,malorne,1699,hunter,marksmanship,78,38,40
Brewster,burning-legion,1692,hunter,marksmanship,42,22,20
Doves,wyrmrest-accord,1685,hunter,marksmanship,66,38,28
Onemoreshot,bleeding-hollow,1678,hunter,marksmanship,212,105,107
Killatrap,malganis,1677,hunter,marksmanship,42,23,19
Dracõ,proudmoore,1674,hunter,marksmanship,128,67,61
Ekzoo,tichondrius,1672,hunter,marksmanship,34,21,13
Petattack,barthilas,1668,hunter,marksmanship,42,20,22
Tassili,illidan,1666,hunter,marksmanship,60,23,37
Vitekz,illidan,1665,hunter,marksmanship,36,25,11
Aueria,kiljaeden,1664,hunter,marksmanship,66,29,37
Mhd,stormrage,1661,hunter,marksmanship,59,23,36
Drivebymac,tichondrius,1660,hunter,marksmanship,90,47,43
Tren,blackrock,1657,hunter,marksmanship,41,21,20
Milae,frostmourne,1652,hunter,marksmanship,54,24,30
Huntkiller,tichondrius,1651,hunter,marksmanship,40,29,11
Gotchã,area-52,1650,hunter,marksmanship,42,27,15
Yønkøu,azralon,1647,hunter,marksmanship,68,31,37
Valdra,aegwynn,1646,hunter,marksmanship,36,23,13
Aymas,sargeras,1646,hunter,marksmanship,125,65,60
Beldhur,archimonde,1641,hunter,marksmanship,53,23,30
Barelyknower,area-52,1639,hunter,marksmanship,90,44,46
Wildder,area-52,1637,hunter,marksmanship,62,35,27
Learn,sargeras,1635,hunter,marksmanship,54,31,23
Surprisemfkr,emerald-dream,1635,hunter,marksmanship,78,39,39
Venerer,tichondrius,1630,hunter,marksmanship,43,22,21
Blaðe,kelthuzad,1629,hunter,marksmanship,206,95,111
Bigpie,daggerspine,1628,hunter,marksmanship,59,37,22
Neverhunter,azralon,1628,hunter,marksmanship,41,22,19
Taylormadae,frostmourne,1627,hunter,marksmanship,66,37,29
Elfymcelf,arthas,1626,hunter,marksmanship,102,52,50
Shawtytraps,tichondrius,1626,hunter,marksmanship,155,64,91
Arjunå,sargeras,1621,hunter,marksmanship,101,56,45
Easynightjr,bleeding-hollow,1620,hunter,marksmanship,225,117,108
Xcw,stormrage,1619,hunter,marksmanship,60,28,32
Alansho,tichondrius,1618,hunter,marksmanship,53,20,33
Tânsøxøxø,tichondrius,1617,hunter,marksmanship,30,17,13
Latesummer,tichondrius,1616,hunter,marksmanship,48,25,23
Blungo,azralon,1616,hunter,marksmanship,95,45,50
Johaylon,sargeras,1616,hunter,marksmanship,42,19,23
Bwaa,illidan,1614,hunter,marksmanship,119,62,57
Dezertpower,sargeras,1613,hunter,marksmanship,36,20,16
Junglejam,elune,1613,hunter,marksmanship,70,34,36
Slantedshot,coilfang,1613,hunter,marksmanship,90,36,54
Darance,sargeras,1612,hunter,marksmanship,40,22,18
Snìpershot,sargeras,1612,hunter,marksmanship,61,33,28
Shotashot,area-52,1612,hunter,marksmanship,36,17,19
Hhappy,tichondrius,1612,hunter,marksmanship,66,27,39
Headshoot,tichondrius,1611,hunter,marksmanship,65,35,30
Toxarch,aggramar,1610,hunter,marksmanship,66,28,38
Tommychong,shandris,1609,hunter,marksmanship,64,31,33
Arrowslol,stormrage,1608,hunter,marksmanship,60,32,28
Simbagrove,dalaran,1605,hunter,marksmanship,42,19,23
Evaelfi,illidan,1605,hunter,marksmanship,40,17,23
Tropic,proudmoore,1605,hunter,marksmanship,80,31,49
Hyyz,proudmoore,1604,hunter,marksmanship,36,22,14
Timmee,bleeding-hollow,1603,hunter,marksmanship,40,24,16
Spunky,zuluhed,1597,hunter,marksmanship,48,23,25
Deadshöt,bleeding-hollow,1597,hunter,marksmanship,59,26,33
Gor,hyjal,1594,hunter,marksmanship,53,25,28
Shootipie,hyjal,1593,hunter,marksmanship,28,20,8
Itsgma,shandris,1591,hunter,marksmanship,36,21,15
Tyrmaakk,emerald-dream,1581,hunter,marksmanship,46,25,21
Freezetrap,proudmoore,1579,hunter,marksmanship,33,20,13
Orber,stormrage,1579,hunter,marksmanship,36,20,16
Mambothehunt,stormrage,1579,hunter,marksmanship,66,36,30
Thebweh,ragnaros,1578,hunter,marksmanship,53,24,29
Dienasty,zuljin,1577,hunter,marksmanship,36,23,13
Wìkkihx,emerald-dream,1577,hunter,marksmanship,59,31,28
Undien,area-52,1576,hunter,marksmanship,42,22,20
Markymarc,tichondrius,1575,hunter,marksmanship,41,17,24
Flämma,azralon,1573,hunter,marksmanship,90,40,50
Huntonthic,korgath,1571,hunter,marksmanship,68,34,34
Hämhunter,stormrage,1569,hunter,marksmanship,60,38,22
Hmh,burning-legion,1569,hunter,marksmanship,269,135,134
Stimpblimp,jubeithos,1563,hunter,marksmanship,48,19,29
Ssdslol,bleeding-hollow,1561,hunter,marksmanship,145,86,59
Onemøreshot,bleeding-hollow,1561,hunter,marksmanship,108,54,54
Crounzz,sargeras,1558,hunter,marksmanship,51,23,28
Jubiscleudo,azralon,1557,hunter,marksmanship,103,46,57
Rampagez,tichondrius,1555,hunter,marksmanship,36,19,17
Ryukuzen,tichondrius,1551,hunter,marksmanship,48,20,28
Bacchantress,tichondrius,1550,hunter,marksmanship,42,21,21
Mukbangbj,terenas,1546,hunter,marksmanship,76,40,36
Luchadoris,malganis,1544,hunter,marksmanship,72,36,36
Kimghak,tichondrius,1544,hunter,marksmanship,67,30,37
Rubinaldo,azralon,1543,hunter,marksmanship,36,18,18
Biubiubiubiu,proudmoore,1540,hunter,marksmanship,54,32,22
Skybourne,nemesis,1539,hunter,marksmanship,108,63,45
Swagprince,skullcrusher,1537,hunter,marksmanship,58,34,24
Zasnar,malganis,1537,hunter,marksmanship,36,19,17
Artemyzz,tichondrius,1537,hunter,marksmanship,48,22,26
Huntncheekz,kelthuzad,1534,hunter,marksmanship,76,38,38
Metalgear,icecrown,1533,hunter,marksmanship,66,34,32
Kusz,bleeding-hollow,1533,hunter,marksmanship,77,38,39
Hitts,barthilas,1532,hunter,marksmanship,59,30,29
Odin,goldrinn,1531,hunter,marksmanship,157,75,82
Smokabombom,eredar,1530,hunter,marksmanship,34,18,16
Zugbrained,illidan,1529,hunter,marksmanship,48,26,22
Papiskrill,staghelm,1526,hunter,marksmanship,97,44,53
Dykbuht,area-52,1523,hunter,marksmanship,48,25,23
Dummorogh,stormrage,1522,hunter,marksmanship,120,55,65
Wockqt,kiljaeden,1522,hunter,marksmanship,49,21,28
Guacmec,tichondrius,1521,hunter,marksmanship,48,28,20
Richmond,lightnings-blade,1521,hunter,marksmanship,66,30,36
Unravel,tichondrius,1520,hunter,marksmanship,99,55,44
Deliond,moon-guard,1520,hunter,marksmanship,210,108,102
Gretress,azralon,1520,hunter,marksmanship,66,28,38
Grands,tortheldrin,1519,hunter,marksmanship,54,26,28
Lsily,tichondrius,1519,hunter,marksmanship,36,16,20
Maia,frostwolf,1518,hunter,marksmanship,66,30,36
Bowflexen,illidan,1518,hunter,marksmanship,42,19,23
Balaria,tichondrius,1515,hunter,marksmanship,35,19,16
Insanedabz,tichondrius,1515,hunter,marksmanship,72,35,37
Gnomorecum,kiljaeden,1514,hunter,marksmanship,99,58,41
Bowreckage,malganis,1514,hunter,marksmanship,74,41,33
Legeye,malganis,1514,hunter,marksmanship,54,26,28
Fatehunter,bleeding-hollow,1511,hunter,marksmanship,44,17,27
Mehontar,area-52,1509,hunter,marksmanship,42,20,22
Plopslopper,frostmourne,1508,hunter,marksmanship,60,31,29
Sagadegêmeos,stormrage,1508,hunter,marksmanship,91,35,56
Lokuhzmarcus,goldrinn,1507,hunter,marksmanship,66,39,27
Lilbang,thrall,1507,hunter,marksmanship,75,34,41
Boggartt,ragnaros,1507,hunter,marksmanship,58,26,32
Shotsphodays,sargeras,1506,hunter,marksmanship,90,45,45
Lostfaith,tichondrius,1504,hunter,marksmanship,66,36,30
Rïve,tichondrius,1504,hunter,marksmanship,36,17,19
Adive,drakkari,1503,hunter,marksmanship,91,43,48
Marshen,zuljin,1503,hunter,marksmanship,36,17,19
Saloran,akama,1502,hunter,marksmanship,102,55,47
Tup,guldan,1499,hunter,marksmanship,51,28,23
Amyrkvothe,ragnaros,1499,hunter,marksmanship,60,25,35
Lixniqua,tichondrius,1498,hunter,marksmanship,75,38,37
Bertimus,sargeras,1498,hunter,marksmanship,42,17,25
Tråppin,sargeras,1495,hunter,marksmanship,51,27,24
Papacohen,stormrage,1495,hunter,marksmanship,45,22,23
Swayshunt,area-52,1495,hunter,marksmanship,46,22,24
Lildex,demon-soul,1494,hunter,marksmanship,30,18,12
Föcker,emerald-dream,1492,hunter,marksmanship,25,19,6
Stfd,illidan,1490,hunter,marksmanship,24,17,7
Esler,quelthalas,1490,hunter,marksmanship,54,28,26
Ocromiun,illidan,1490,hunter,marksmanship,57,19,38
Larree,kelthuzad,1489,hunter,marksmanship,30,21,9
Ðaybreâker,tichondrius,1489,hunter,marksmanship,49,29,20
Yozsh,azralon,1485,hunter,marksmanship,47,32,15
Pâl,quelthalas,1481,hunter,marksmanship,42,21,21
Rudekeef,illidan,1478,hunter,marksmanship,36,17,19
Boomphaque,ravencrest,1476,hunter,marksmanship,132,63,69
Metalstorm,draenor,1476,hunter,marksmanship,41,19,22
Booyakah,hyjal,1475,hunter,marksmanship,36,19,17
Windrein,ysondre,1475,hunter,marksmanship,48,20,28
Barrohunt,tichondrius,1473,hunter,marksmanship,49,31,18
Somethinggo,tichondrius,1472,hunter,marksmanship,161,77,84
Artois,tichondrius,1471,hunter,marksmanship,40,18,22
Scourgesurge,kiljaeden,1470,hunter,marksmanship,42,21,21
Cloudzbow,moon-guard,1470,hunter,marksmanship,40,18,22
Kekkww,hyjal,1469,hunter,marksmanship,54,26,28
Killshøtß,tichondrius,1466,hunter,marksmanship,54,25,29
Infinitý,zuljin,1465,hunter,marksmanship,59,27,32
Hötdôg,kiljaeden,1464,hunter,marksmanship,48,23,25
Lowlore,moon-guard,1463,hunter,marksmanship,96,52,44
Pwnagraphic,barthilas,1463,hunter,marksmanship,82,36,46
Shadowhokage,zuljin,1461,hunter,marksmanship,56,30,26
Zeenuts,sargeras,1461,hunter,marksmanship,47,24,23
Renzô,sargeras,1459,hunter,marksmanship,88,51,37
Angelickon,tichondrius,1459,hunter,marksmanship,62,29,33
Bomomatic,zuljin,1457,hunter,marksmanship,42,24,18
Valimhir,tichondrius,1457,hunter,marksmanship,57,25,32
Tòxophilite,tichondrius,1456,hunter,marksmanship,74,28,46
Nelosi,shadowmoon,1455,hunter,marksmanship,54,25,29
Cyrsmen,ragnaros,1454,hunter,marksmanship,81,37,44
Finaqua,sargeras,1452,hunter,marksmanship,38,17,21
Grayføxx,twisting-nether,1451,hunter,marksmanship,60,34,26
Rockenrique,nemesis,1451,hunter,marksmanship,60,28,32
Pkn,chogall,1450,hunter,marksmanship,60,27,33
Tóri,emerald-dream,1445,hunter,marksmanship,47,25,22
Hemathios,drakkari,1442,hunter,marksmanship,50,21,29
Rumzi,thrall,1441,hunter,marksmanship,102,57,45
Backpedalftw,darrowmere,1440,hunter,marksmanship,42,16,26
Katebishop,nemesis,1438,hunter,marksmanship,28,18,10
Jotosalsa,blackrock,1438,hunter,marksmanship,60,30,30
Stupidgodx,tichondrius,1437,hunter,marksmanship,48,25,23
Klitz,lightninghoof,1436,hunter,marksmanship,30,18,12
Pokcmvmxckm,senjin,1433,hunter,marksmanship,66,35,31
Bootywhop,dalaran,1433,hunter,marksmanship,30,15,15
Hunterlist,frostmourne,1433,hunter,marksmanship,36,15,21
Allondra,proudmoore,1432,hunter,marksmanship,30,17,13
Baixiaochu,area-52,1432,hunter,marksmanship,105,47,58
Crazyeasy,azshara,1431,hunter,marksmanship,30,15,15
Lewanker,zuljin,1429,hunter,marksmanship,42,23,19
Vibøra,stormrage,1429,hunter,marksmanship,126,56,70
Mèseeks,bleeding-hollow,1427,hunter,marksmanship,60,34,26
Sï,anubarak,1425,hunter,marksmanship,42,19,23
Cholohippie,blackrock,1424,hunter,marksmanship,55,30,25
Vonkrieg,tichondrius,1424,hunter,marksmanship,42,15,27
Chï,zuljin,1422,hunter,marksmanship,162,81,81
Sleepyjoee,dalaran,1421,hunter,marksmanship,54,31,23
Rorijii,tichondrius,1421,hunter,marksmanship,54,23,31
Leucis,cenarius,1420,hunter,marksmanship,18,15,3
Soljer,kiljaeden,1417,hunter,marksmanship,66,28,38
Longshánks,stormrage,1416,hunter,marksmanship,30,15,15
Cheetah,tichondrius,1415,hunter,marksmanship,30,15,15
Boombob,sargeras,1415,hunter,marksmanship,59,27,32
Shøtii,tichondrius,1414,hunter,marksmanship,40,21,19
Hoboh,illidan,1414,hunter,marksmanship,117,58,59
Vivaswan,tichondrius,1413,hunter,marksmanship,42,15,27
Elendïr,tichondrius,1411,hunter,marksmanship,60,33,27
Aimz,zuluhed,1411,hunter,marksmanship,73,29,44
Feov,tichondrius,1410,hunter,marksmanship,24,15,9
Vergillx,ragnaros,1409,hunter,marksmanship,74,45,29
Toowizeë,barthilas,1409,hunter,marksmanship,59,27,32
Klannis,quelthalas,1409,hunter,marksmanship,42,19,23
Berkhof,tichondrius,1409,hunter,marksmanship,56,24,32
Xcisiion,nagrand,1408,hunter,marksmanship,173,86,87
Shootybooty,arygos,1407,hunter,marksmanship,42,15,27
Lîvy,aerie-peak,1406,hunter,marksmanship,54,25,29
Joshmckin,area-52,1406,hunter,marksmanship,116,53,63
Mariaassjx,ragnaros,1406,hunter,marksmanship,102,46,56
Javoj,drakkari,1405,hunter,marksmanship,30,15,15
Automatic,illidan,1405,hunter,marksmanship,63,29,34
Voidmarksman,whisperwind,1404,hunter,marksmanship,49,30,19
Péppérmínt,korgath,1403,hunter,marksmanship,62,32,30
Madsniper,thunderlord,1403,hunter,marksmanship,72,37,35
Grànd,tortheldrin,1402,hunter,marksmanship,35,17,18
Déadshot,thaurissan,1402,hunter,marksmanship,42,17,25
Dsizzle,tichondrius,1400,hunter,marksmanship,44,18,26
Audioannie,thrall,1395,hunter,marksmanship,36,18,18
Jeezyxxii,shadowmoon,1395,hunter,marksmanship,86,40,46
Nirika,moon-guard,1395,hunter,marksmanship,69,31,38
Ashx,khazgoroth,1392,hunter,marksmanship,30,15,15
Bodaki,proudmoore,1391,hunter,marksmanship,36,16,20
Häydn,emerald-dream,1390,hunter,marksmanship,40,22,18
Insulin,moonrunner,1390,hunter,marksmanship,36,17,19
Littledougie,boulderfist,1388,hunter,marksmanship,90,47,43
ßeãst,bladefist,1387,hunter,marksmanship,24,16,8
Mù,frostmourne,1385,hunter,marksmanship,30,15,15
Slayou,uldum,1383,hunter,marksmanship,69,37,32
Lederniertra,gorefiend,1382,hunter,marksmanship,278,139,139
Fuzzypjs,stormrage,1382,hunter,marksmanship,39,17,22
Dnicee,stormrage,1380,hunter,marksmanship,42,30,12
Tobroken,perenolde,1380,hunter,marksmanship,51,25,26
Dreygar,dawnbringer,1379,hunter,marksmanship,36,15,21
Gq,garona,1379,hunter,marksmanship,77,32,45
Spacelandz,emerald-dream,1374,hunter,marksmanship,30,19,11
Dominate,frostmourne,1374,hunter,marksmanship,48,23,25
Hunsak,ragnaros,1373,hunter,marksmanship,30,20,10
Húntingarrow,area-52,1373,hunter,marksmanship,72,36,36
Precísion,malganis,1372,hunter,marksmanship,35,18,17
Leshwi,ragnaros,1370,hunter,marksmanship,47,23,24
Lookøut,moon-guard,1370,hunter,marksmanship,86,38,48
Malebolick,ragnaros,1367,hunter,marksmanship,65,27,38
Lukhas,moon-guard,1367,hunter,marksmanship,60,24,36
Murderville,illidan,1366,hunter,marksmanship,54,27,27
Chokemescara,stormrage,1364,hunter,marksmanship,36,16,20
Worewolf,lightninghoof,1363,hunter,marksmanship,50,22,28
Jumaanji,gurubashi,1362,hunter,marksmanship,70,36,34
Amonerhunter,bleeding-hollow,1362,hunter,marksmanship,54,23,31
Skelyeelegno,perenolde,1361,hunter,marksmanship,30,17,13
Gorîlla,sargeras,1361,hunter,marksmanship,96,46,50
Staticarrow,norgannon,1361,hunter,marksmanship,126,60,66
Lotatinyfish,malganis,1360,hunter,marksmanship,54,32,22
Glittergun,sargeras,1360,hunter,marksmanship,41,19,22
Kronicbeast,bleeding-hollow,1360,hunter,marksmanship,96,42,54
Phojuansixx,ghostlands,1359,hunter,marksmanship,50,28,22
Trapshawty,darkspear,1359,hunter,marksmanship,54,19,35
Chîll,frostmourne,1358,hunter,marksmanship,32,15,17
Bowinc,greymane,1357,hunter,marksmanship,24,15,9
Pleyadez,drakkari,1356,hunter,marksmanship,42,24,18
Condorexe,illidan,1356,hunter,marksmanship,90,39,51
Ghudi,moon-guard,1354,hunter,marksmanship,39,21,18
Gothew,turalyon,1353,hunter,marksmanship,66,37,29
Picaubica,kiljaeden,1353,hunter,marksmanship,53,24,29
Acelol,proudmoore,1351,hunter,marksmanship,223,116,107
Watchmanjoe,grizzly-hills,1350,hunter,marksmanship,54,30,24
Kolosaltraps,tichondrius,1349,hunter,marksmanship,33,16,17
Kyukon,illidan,1345,hunter,marksmanship,36,18,18
Diisdik,tichondrius,1344,hunter,marksmanship,51,23,28
Mizhu,ragnaros,1343,hunter,marksmanship,70,38,32
Hurstt,kelthuzad,1341,hunter,marksmanship,56,27,29
Fartingshot,proudmoore,1339,hunter,marksmanship,89,41,48
Toniic,moon-guard,1337,hunter,marksmanship,54,33,21
Dexteros,ragnaros,1337,hunter,marksmanship,66,33,33
Wìllòw,khazgoroth,1337,hunter,marksmanship,48,18,30
Misakilr,sargeras,1336,hunter,marksmanship,18,14,4
Unclepez,barthilas,1336,hunter,marksmanship,18,14,4
Orgpopeyes,illidan,1336,hunter,marksmanship,24,14,10
Dvei,silvermoon,1336,hunter,marksmanship,57,25,32
Cashhapp,zuljin,1335,hunter,marksmanship,201,100,101
Cablok,moon-guard,1335,hunter,marksmanship,30,14,16
Photos,moon-guard,1334,hunter,marksmanship,20,14,6
Boradin,lightbringer,1333,hunter,marksmanship,24,18,6
Thaden,akama,1332,hunter,marksmanship,65,34,31
Blackhuntr,garona,1331,hunter,marksmanship,264,135,129
Booffmeister,area-52,1329,hunter,marksmanship,30,14,16
Dathunterr,azralon,1329,hunter,marksmanship,95,44,51
Moktarg,archimonde,1328,hunter,marksmanship,53,23,30
Sindain,bloodscalp,1327,hunter,marksmanship,36,20,16
Tonnyfab,ragnaros,1326,hunter,marksmanship,34,19,15
Bigolhippy,frostmourne,1326,hunter,marksmanship,36,18,18
Uwuessy,illidan,1325,hunter,marksmanship,72,32,40
Bojob,azgalor,1324,hunter,marksmanship,63,34,29
Azaz,khaz-modan,1324,hunter,marksmanship,59,27,32
Softhunter,tichondrius,1324,hunter,marksmanship,36,14,22
Murza,korgath,1323,hunter,marksmanship,24,15,9
Xhartanis,magtheridon,1323,hunter,marksmanship,63,31,32
Purpurkle,area-52,1322,hunter,marksmanship,60,31,29
Kä,blackhand,1321,hunter,marksmanship,66,28,38
Ärtémisa,quelthalas,1320,hunter,marksmanship,41,22,19
Tristiae,stormrage,1319,hunter,marksmanship,67,36,31
Swolfp,tichondrius,1319,hunter,marksmanship,58,23,35
Ilina,malorne,1317,hunter,marksmanship,24,14,10
Benme,illidan,1317,hunter,marksmanship,251,116,135
Dogezandalar,illidan,1317,hunter,marksmanship,40,18,22
Explosief,area-52,1315,hunter,marksmanship,60,30,30
Chuvug,quelthalas,1315,hunter,marksmanship,30,14,16
Shooterzz,illidan,1314,hunter,marksmanship,24,16,8
Zaheerz,sargeras,1312,hunter,marksmanship,36,16,20
Smoothbrain,khadgar,1309,hunter,marksmanship,64,25,39
Thirià,garona,1306,hunter,marksmanship,18,14,4
Rekshot,amanthul,1306,hunter,marksmanship,150,73,77
Grimcask,ragnaros,1305,hunter,marksmanship,33,15,18
Wolverhino,thrall,1304,hunter,marksmanship,48,21,27
Akomata,emerald-dream,1303,hunter,marksmanship,42,21,21
Albe,azralon,1303,hunter,marksmanship,76,37,39
Cocobread,stormreaver,1303,hunter,marksmanship,48,21,27
Balun,sargeras,1303,hunter,marksmanship,66,28,38
Oattes,daggerspine,1303,hunter,marksmanship,34,14,20
Revo,darkspear,1301,hunter,marksmanship,30,14,16
Snewboy,malganis,1299,hunter,marksmanship,24,14,10
Celph,moon-guard,1299,hunter,marksmanship,48,20,28
Cullowhee,proudmoore,1299,hunter,marksmanship,35,14,21
Gunther,korgath,1296,hunter,marksmanship,30,14,16
Ahegoface,frostmourne,1295,hunter,marksmanship,60,21,39
Mensrea,illidan,1294,hunter,marksmanship,47,30,17
Hukkx,kalecgos,1294,hunter,marksmanship,56,24,32
Urtthel,stormrage,1293,hunter,marksmanship,28,17,11
Krattøs,bleeding-hollow,1293,hunter,marksmanship,34,16,18
Itryharder,stormrage,1289,hunter,marksmanship,30,18,12
Glediator,tichondrius,1288,hunter,marksmanship,112,51,61
Duruainn,zuljin,1286,hunter,marksmanship,88,42,46
Ricas,malganis,1285,hunter,marksmanship,104,46,58
Kalibah,azralon,1285,hunter,marksmanship,81,30,51
Leeshaarrow,moon-guard,1284,hunter,marksmanship,36,17,19
Juhyeon,tichondrius,1284,hunter,marksmanship,46,17,29
Ripmytoast,chogall,1281,hunter,marksmanship,187,101,86
Kìkìjiki,emerald-dream,1281,hunter,marksmanship,30,16,14
Gromtheponch,area-52,1280,hunter,marksmanship,43,22,21
Braxigarr,area-52,1280,hunter,marksmanship,229,108,121
Vipermaster,azralon,1278,hunter,marksmanship,52,28,24
Rawrzy,sargeras,1278,hunter,marksmanship,29,14,15
Jenniekim,mugthol,1277,hunter,marksmanship,25,16,9
Tîpz,stormrage,1275,hunter,marksmanship,29,17,12
Clutchxx,tichondrius,1275,hunter,marksmanship,24,14,10
Sniperarmy,dalaran,1274,hunter,marksmanship,103,52,51
Spiketurtle,queldorei,1274,hunter,marksmanship,54,27,27
Darylovejr,destromath,1274,hunter,marksmanship,38,16,22
Microshotz,windrunner,1273,hunter,marksmanship,24,15,9
Doug,illidan,1273,hunter,marksmanship,24,14,10
Targetreaper,proudmoore,1273,hunter,marksmanship,90,44,46
Nights,nemesis,1271,hunter,marksmanship,24,15,9
Hunimi,elune,1270,hunter,marksmanship,38,16,22
Escolhido,azralon,1269,hunter,marksmanship,71,36,35
Kritsu,tichondrius,1266,hunter,marksmanship,53,28,25
Spyhunter,malganis,1266,hunter,marksmanship,67,28,39
Xephert,ragnaros,1265,hunter,marksmanship,48,22,26
Birgite,stormrage,1265,hunter,marksmanship,54,21,33
Cloudbuck,aegwynn,1262,hunter,marksmanship,58,22,36
Deathhshott,area-52,1260,hunter,marksmanship,35,20,15
Brokenstars,illidan,1254,hunter,marksmanship,72,35,37
Ongorn,lightninghoof,1254,hunter,marksmanship,48,23,25
Shuweet,moon-guard,1254,hunter,marksmanship,42,16,26
Jerybery,gundrak,1253,hunter,marksmanship,29,18,11
Igopew,firetree,1253,hunter,marksmanship,36,16,20
Snaafu,duskwood,1252,hunter,marksmanship,42,17,25
Ragnarlobkk,ragnaros,1251,hunter,marksmanship,107,54,53
Infamousorc,chogall,1251,hunter,marksmanship,82,36,46
Solomine,jubeithos,1251,hunter,marksmanship,36,15,21
Rattrap,proudmoore,1250,hunter,marksmanship,41,18,23
Eilleath,zuljin,1249,hunter,marksmanship,24,15,9
Gstring,kelthuzad,1248,hunter,marksmanship,157,71,86
Ëzy,frostmourne,1246,hunter,marksmanship,66,36,30
Zota,frostmourne,1245,hunter,marksmanship,24,13,11
Hoeswannafuk,stormrage,1243,hunter,marksmanship,24,13,11
Hogshanks,moon-guard,1242,hunter,marksmanship,24,13,11
Seenobody,stormrage,1242,hunter,marksmanship,106,54,52
Loth,illidan,1239,hunter,marksmanship,28,15,13
Lafleche,kiljaeden,1239,hunter,marksmanship,29,15,14
Critaclyzm,moon-guard,1238,hunter,marksmanship,49,22,27
Islachan,ragnaros,1238,hunter,marksmanship,30,13,17
Imineore,stormrage,1238,hunter,marksmanship,36,15,21
Sootgarbage,sargeras,1235,hunter,marksmanship,18,13,5
Pokeyourbutt,hydraxis,1235,hunter,marksmanship,24,13,11
Wincolt,stormrage,1235,hunter,marksmanship,30,13,17
Tonichype,tichondrius,1235,hunter,marksmanship,30,13,17
Aqurandris,moon-guard,1234,hunter,marksmanship,18,13,5
Killz,skullcrusher,1234,hunter,marksmanship,44,21,23
Drillklinton,tichondrius,1234,hunter,marksmanship,47,20,27
Lolknocked,alexstrasza,1233,hunter,marksmanship,27,14,13
Amsalja,tichondrius,1232,hunter,marksmanship,54,28,26
Chikkynuggy,destromath,1228,hunter,marksmanship,33,14,19
Mlzj,tichondrius,1225,hunter,marksmanship,24,13,11
Idiiot,sargeras,1223,hunter,marksmanship,68,33,35
Huntmeplz,proudmoore,1221,hunter,marksmanship,30,14,16
Stoopkid,dunemaul,1219,hunter,marksmanship,24,13,11
Netorip,azralon,1219,hunter,marksmanship,39,17,22
Drjingajanga,zuluhed,1218,hunter,marksmanship,39,16,23
Caylix,sargeras,1216,hunter,marksmanship,36,14,22
Sukr,korgath,1215,hunter,marksmanship,98,37,61
Bärney,frostmourne,1214,hunter,marksmanship,24,13,11
Give,draktharon,1214,hunter,marksmanship,33,14,19
Tandope,sargeras,1213,hunter,marksmanship,35,13,22
Malkuri,medivh,1213,hunter,marksmanship,35,13,22
Puresport,hyjal,1212,hunter,marksmanship,24,13,11
Hyü,hyjal,1211,hunter,marksmanship,30,13,17
Coolwhip,demon-soul,1209,hunter,marksmanship,46,22,24
Calî,stormscale,1209,hunter,marksmanship,36,17,19
Äce,khazgoroth,1208,hunter,marksmanship,30,13,17
Rocroc,gurubashi,1205,hunter,marksmanship,72,33,39
Volga,haomarush,1204,hunter,marksmanship,58,29,29
Augus,eredar,1202,hunter,marksmanship,41,15,26
Kalgorn,emerald-dream,1200,hunter,marksmanship,30,13,17
Bowtech,kelthuzad,1198,hunter,marksmanship,37,17,20
Wwing,frostwolf,1197,hunter,marksmanship,316,161,155
Vinranya,sargeras,1194,hunter,marksmanship,75,34,41
Lightweight,kelthuzad,1194,hunter,marksmanship,59,26,33
Moonet,amanthul,1192,hunter,marksmanship,29,16,13
Chaðs,amanthul,1190,hunter,marksmanship,39,21,18
Moüserat,moon-guard,1190,hunter,marksmanship,138,68,70
Kayzia,lightninghoof,1190,hunter,marksmanship,29,13,16
Valieev,black-dragonflight,1188,hunter,marksmanship,42,25,17
Ilovehippos,laughing-skull,1188,hunter,marksmanship,145,67,78
Forthethrill,area-52,1187,hunter,marksmanship,45,24,21
Oopsurtrappd,darkspear,1186,hunter,marksmanship,29,16,13
Juicyjams,moon-guard,1186,hunter,marksmanship,24,13,11
Lavaun,eredar,1185,hunter,marksmanship,36,17,19
Trikshot,magtheridon,1183,hunter,marksmanship,30,15,15
Hokutoxx,tichondrius,1182,hunter,marksmanship,32,13,19
Myrfes,ragnaros,1182,hunter,marksmanship,58,21,37
Zock,lothar,1181,hunter,marksmanship,158,76,82
Ramdy,quelthalas,1180,hunter,marksmanship,30,14,16
Fova,wyrmrest-accord,1179,hunter,marksmanship,19,14,5
Doubletappz,stormreaver,1178,hunter,marksmanship,36,15,21
Chïnchïlla,zuljin,1176,hunter,marksmanship,27,14,13
Silverweaver,illidan,1174,hunter,marksmanship,30,15,15
Ellishunter,frostmourne,1174,hunter,marksmanship,64,23,41
Taynen,azralon,1173,hunter,marksmanship,29,13,16
Tweak,ysera,1172,hunter,marksmanship,24,13,11
Guarambare,ragnaros,1172,hunter,marksmanship,39,15,24
Mathund,gurubashi,1171,hunter,marksmanship,173,83,90
Aftërlyfe,tichondrius,1170,hunter,marksmanship,29,14,15
Foxhe,hyjal,1167,hunter,marksmanship,54,29,25
Patmypet,terenas,1167,hunter,marksmanship,30,14,16
Mezmore,thrall,1167,hunter,marksmanship,54,24,30
Jordanhunter,frostmourne,1167,hunter,marksmanship,35,14,21
Papiquezo,nagrand,1165,hunter,marksmanship,27,14,13
Clemenlemon,illidan,1162,hunter,marksmanship,36,19,17
Richihunt,ragnaros,1161,hunter,marksmanship,44,16,28
Mídnîght,azralon,1161,hunter,marksmanship,39,14,25
Loathin,stormrage,1160,hunter,marksmanship,18,13,5
Miscreant,kelthuzad,1160,hunter,marksmanship,32,13,19
Cu,frostmourne,1159,hunter,marksmanship,19,13,6
Sóny,area-52,1158,hunter,marksmanship,26,15,11
Whatsleft,area-52,1155,hunter,marksmanship,34,17,17
Enuk,nagrand,1155,hunter,marksmanship,109,51,58
Tiofil,goldrinn,1154,hunter,marksmanship,42,23,19
Rhaygon,arthas,1154,hunter,marksmanship,57,20,37
Llachiip,zuljin,1153,hunter,marksmanship,29,14,15
Chetta,ragnaros,1153,hunter,marksmanship,71,29,42
Huntdawgg,illidan,1153,hunter,marksmanship,57,16,41
Buckethole,doomhammer,1152,hunter,marksmanship,60,28,32
Huataran,stormrage,1151,hunter,marksmanship,18,12,6
Negãn,tichondrius,1151,hunter,marksmanship,24,12,12
Sunnimuffens,deathwing,1150,hunter,marksmanship,53,25,28
Summerrain,illidan,1149,hunter,marksmanship,18,12,6
Floozyfairy,daggerspine,1149,hunter,marksmanship,65,32,33
Zuuvuya,nemesis,1149,hunter,marksmanship,56,20,36
Nes,azuremyst,1148,hunter,marksmanship,24,12,12
Dsnowy,emerald-dream,1146,hunter,marksmanship,24,12,12
Topshotx,tichondrius,1145,hunter,marksmanship,18,12,6
Bullseated,nemesis,1145,hunter,marksmanship,24,12,12
Sugarboyy,darkspear,1145,hunter,marksmanship,39,19,20
Lilnatty,area-52,1143,hunter,marksmanship,33,13,20
Desolater,bleeding-hollow,1143,hunter,marksmanship,36,12,24
Brapdaddy,lightbringer,1142,hunter,marksmanship,30,12,18
Inability,emerald-dream,1142,hunter,marksmanship,30,12,18
Chainmaster,misha,1141,hunter,marksmanship,121,57,64
Zachhunter,frostmourne,1141,hunter,marksmanship,54,20,34
Òriòn,tichondrius,1141,hunter,marksmanship,36,12,24
Zgabriel,azralon,1140,hunter,marksmanship,24,12,12
Tenlbbow,illidan,1137,hunter,marksmanship,24,12,12
Thundershots,tichondrius,1136,hunter,marksmanship,80,35,45
Drewshot,sargeras,1134,hunter,marksmanship,18,12,6
Nemmises,proudmoore,1134,hunter,marksmanship,24,12,12
Mwprimus,darkspear,1134,hunter,marksmanship,25,12,13
Vhan,azralon,1133,hunter,marksmanship,44,19,25
Oqqo,tichondrius,1132,hunter,marksmanship,51,21,30
Jarloo,madoran,1129,hunter,marksmanship,35,19,16
Bumpf,malganis,1129,hunter,marksmanship,30,14,16
Táká,quelthalas,1129,hunter,marksmanship,30,13,17
Dandogg,tichondrius,1129,hunter,marksmanship,30,12,18
Zøkøtrøkø,ragnaros,1128,hunter,marksmanship,39,17,22
Abloodelf,zuljin,1128,hunter,marksmanship,30,12,18
Minzuki,drakkari,1127,hunter,marksmanship,30,13,17
Clockwörk,sargeras,1125,hunter,marksmanship,21,13,8
Martlz,tichondrius,1125,hunter,marksmanship,24,12,12
Amanazàra,tichondrius,1123,hunter,marksmanship,84,41,43
Udietofast,illidan,1123,hunter,marksmanship,136,61,75
Dest,azralon,1121,hunter,marksmanship,30,12,18
Pikochon,illidan,1121,hunter,marksmanship,77,30,47
Seyd,barthilas,1121,hunter,marksmanship,36,13,23
Kanaká,moon-guard,1120,hunter,marksmanship,42,23,19
Emeri,winterhoof,1119,hunter,marksmanship,60,31,29
Linedalina,wyrmrest-accord,1119,hunter,marksmanship,30,14,16
Bowdown,moon-guard,1118,hunter,marksmanship,60,30,30
Starkmeister,stormrage,1118,hunter,marksmanship,30,12,18
Onekz,ragnaros,1115,hunter,marksmanship,65,24,41
Ackzar,ragnaros,1114,hunter,marksmanship,88,44,44
Wixyy,aegwynn,1114,hunter,marksmanship,58,23,35
Redskul,azralon,1113,hunter,marksmanship,36,19,17
Yaboismokey,aerie-peak,1112,hunter,marksmanship,35,15,20
Grimbleneep,emerald-dream,1111,hunter,marksmanship,40,16,24
Ligmubhole,queldorei,1110,hunter,marksmanship,24,13,11
Trìggered,dark-iron,1109,hunter,marksmanship,48,24,24
Deadlyattack,barthilas,1108,hunter,marksmanship,24,12,12
Repotro,drakkari,1108,hunter,marksmanship,42,14,28
Aoolfs,stormrage,1107,hunter,marksmanship,72,32,40
Raneldar,proudmoore,1107,hunter,marksmanship,167,70,97
Halibut,quelthalas,1106,hunter,marksmanship,47,25,22
Rykár,kiljaeden,1106,hunter,marksmanship,24,12,12
Ryhew,emerald-dream,1106,hunter,marksmanship,36,15,21
Benryats,area-52,1105,hunter,marksmanship,42,16,26
Huuntard,proudmoore,1104,hunter,marksmanship,29,12,17
Kánnah,ragnaros,1101,hunter,marksmanship,150,77,73
Flacidhunter,kelthuzad,1101,hunter,marksmanship,36,16,20
Týrak,illidan,1100,hunter,marksmanship,24,12,12
Apaweclover,stormrage,1100,hunter,marksmanship,277,136,141
Bentrick,altar-of-storms,1097,hunter,marksmanship,33,18,15
Tanephar,proudmoore,1097,hunter,marksmanship,30,13,17
Zombified,moon-guard,1094,hunter,marksmanship,23,12,11
Killincrew,scilla,1093,hunter,marksmanship,50,23,27
Returners,emerald-dream,1091,hunter,marksmanship,54,30,24
Veranir,nemesis,1091,hunter,marksmanship,98,49,49
Mikeangel,hydraxis,1091,hunter,marksmanship,27,12,15
Malo,dragonmaw,1090,hunter,marksmanship,30,16,14
Bluecoral,frostmourne,1088,hunter,marksmanship,129,56,73
Angelacross,azralon,1087,hunter,marksmanship,54,26,28
Deathwynd,malfurion,1085,hunter,marksmanship,24,13,11
Alindra,zuluhed,1085,hunter,marksmanship,78,32,46
Maxwel,sargeras,1082,hunter,marksmanship,175,86,89
Ud,eldrethalas,1081,hunter,marksmanship,17,12,5
Lezzbow,tichondrius,1081,hunter,marksmanship,61,32,29
Zarely,frostmourne,1081,hunter,marksmanship,41,20,21
Bemaa,frostmourne,1079,hunter,marksmanship,48,23,25
Ramblin,ragnaros,1077,hunter,marksmanship,30,15,15
Madogite,azralon,1075,hunter,marksmanship,84,48,36
Aïmïng,tichondrius,1074,hunter,marksmanship,42,14,28
Cßo,tichondrius,1073,hunter,marksmanship,96,43,53
Pewpow,barthilas,1072,hunter,marksmanship,60,28,32
Mynnokyr,gallywix,1070,hunter,marksmanship,59,28,31
Towness,kelthuzad,1067,hunter,marksmanship,48,23,25
Thoopered,korgath,1062,hunter,marksmanship,65,33,32
Baldor,stormrage,1062,hunter,marksmanship,72,31,41
Obsol,hyjal,1062,hunter,marksmanship,37,12,25
Thunter,kiljaeden,1060,hunter,marksmanship,24,14,10
Piloks,gallywix,1058,hunter,marksmanship,50,24,26
Imperatrix,emerald-dream,1058,hunter,marksmanship,72,25,47
Gvjellybeans,tichondrius,1056,hunter,marksmanship,18,11,7
Runsfromcops,sargeras,1056,hunter,marksmanship,18,11,7
Lexodream,bleeding-hollow,1056,hunter,marksmanship,18,11,7
Ryutiz,fizzcrank,1056,hunter,marksmanship,30,11,19
Shayelin,frostmourne,1055,hunter,marksmanship,18,11,7
Thornshadow,steamwheedle-cartel,1055,hunter,marksmanship,24,12,12
Daytrade,stormrage,1055,hunter,marksmanship,42,20,22
Seyu,tichondrius,1055,hunter,marksmanship,24,11,13
Eratichunt,illidan,1055,hunter,marksmanship,30,11,19
Redzic,tichondrius,1054,hunter,marksmanship,18,11,7
Tharlor,aegwynn,1054,hunter,marksmanship,30,11,19
Inktray,durotan,1054,hunter,marksmanship,30,11,19
Ezx,moon-guard,1053,hunter,marksmanship,18,11,7
Enty,khazgoroth,1053,hunter,marksmanship,18,11,7
Àlëxx,aegwynn,1053,hunter,marksmanship,54,21,33
Kazzanval,sargeras,1052,hunter,marksmanship,30,15,15
Falconex,azralon,1052,hunter,marksmanship,24,11,13
Kimbaa,tichondrius,1052,hunter,marksmanship,24,11,13
Dougv,stormrage,1052,hunter,marksmanship,24,11,13
Guntrïx,stormrage,1052,hunter,marksmanship,36,11,25
Callenna,zuljin,1051,hunter,marksmanship,18,11,7
Scubby,anetheron,1050,hunter,marksmanship,18,11,7
Blimpbooty,stormrage,1050,hunter,marksmanship,24,11,13
Mensita,quelthalas,1049,hunter,marksmanship,30,11,19
Exotichunter,the-underbog,1047,hunter,marksmanship,24,11,13
Vansatih,azralon,1047,hunter,marksmanship,66,27,39
Jakal,blackwater-raiders,1046,hunter,marksmanship,24,11,13
Ladright,altar-of-storms,1046,hunter,marksmanship,24,11,13
Lowk,stonemaul,1045,hunter,marksmanship,36,21,15
Fëanora,quelthalas,1044,hunter,marksmanship,24,11,13
Porkerr,black-dragonflight,1040,hunter,marksmanship,48,25,23
Corruptid,moon-guard,1039,hunter,marksmanship,18,11,7
Ansone,nazjatar,1039,hunter,marksmanship,24,11,13
Tazent,moon-guard,1039,hunter,marksmanship,24,11,13
Minihunter,onyxia,1039,hunter,marksmanship,36,16,20
Deadalot,dalaran,1038,hunter,marksmanship,18,11,7
Yoimiya,thunderlord,1036,hunter,marksmanship,41,18,23
Iililillilii,tichondrius,1035,hunter,marksmanship,34,14,20
Sartros,drakkari,1034,hunter,marksmanship,19,13,6
Huntnfizzle,dethecus,1031,hunter,marksmanship,18,11,7
Vendortrash,aggramar,1029,hunter,marksmanship,24,12,12
Derenit,ragnaros,1028,hunter,marksmanship,48,17,31
Delukzin,azralon,1028,hunter,marksmanship,38,13,25
Silenciozzo,azralon,1026,hunter,marksmanship,42,17,25
Soulbutter,malganis,1023,hunter,marksmanship,18,11,7
Konar,nemesis,1018,hunter,marksmanship,78,34,44
Shukucingjr,illidan,1015,hunter,marksmanship,39,23,16
Secure,doomhammer,1015,hunter,marksmanship,66,30,36
Kødran,stormrage,1013,hunter,marksmanship,54,26,28
Jzander,ragnaros,1010,hunter,marksmanship,20,13,7
Thyraza,proudmoore,1010,hunter,marksmanship,24,11,13
Kuramax,senjin,1009,hunter,marksmanship,95,43,52
Triggaplease,jubeithos,1008,hunter,marksmanship,67,37,30
Killerxzxz,stormrage,1007,hunter,marksmanship,24,13,11
Salsa,hakkar,1005,hunter,marksmanship,107,39,68
Brenri,boulderfist,1003,hunter,marksmanship,30,15,15
Zengrin,quelthalas,1003,hunter,marksmanship,23,11,12
Koonorc,dalaran,998,hunter,marksmanship,46,22,24
Sitaelh,quelthalas,994,hunter,marksmanship,48,23,25
Balgair,hakkar,991,hunter,marksmanship,46,24,22
Scottcrume,area-52,990,hunter,marksmanship,72,33,39
Nelay,ragnaros,988,hunter,marksmanship,23,11,12
Ritler,frostmourne,987,hunter,marksmanship,21,11,10
Øparin,azralon,986,hunter,marksmanship,22,14,8
Sumom,darrowmere,984,hunter,marksmanship,178,82,96
Kalinor,cenarius,984,hunter,marksmanship,60,27,33
Àbyss,shandris,982,hunter,marksmanship,48,18,30
Yadír,quelthalas,978,hunter,marksmanship,126,56,70
Galaxxis,bonechewer,974,hunter,marksmanship,51,26,25
Iiwii,burning-legion,969,hunter,marksmanship,19,11,8
Tiidkloul,illidan,968,hunter,marksmanship,18,12,6
Reanivan,kiljaeden,968,hunter,marksmanship,66,24,42
Silhouettes,barthilas,967,hunter,marksmanship,45,21,24
Djpwnz,bladefist,967,hunter,marksmanship,54,18,36
Broking,azralon,966,hunter,marksmanship,56,22,34
Fleshfair,kiljaeden,965,hunter,marksmanship,45,21,24
Scoundrella,sargeras,963,hunter,marksmanship,78,37,41
Tungles,tichondrius,963,hunter,marksmanship,35,11,24
Adjusted,frostmourne,960,hunter,marksmanship,12,10,2
Hanabanana,wyrmrest-accord,960,hunter,marksmanship,12,10,2
Goonsh,tichondrius,960,hunter,marksmanship,18,10,8
Nainit,sargeras,960,hunter,marksmanship,18,10,8
Kagaramar,hellscream,960,hunter,marksmanship,21,11,10
Taumelz,sargeras,960,hunter,marksmanship,24,10,14
Sylvaa,tichondrius,960,hunter,marksmanship,30,10,20
Throre,bleeding-hollow,959,hunter,marksmanship,18,10,8
Gnometoprace,illidan,959,hunter,marksmanship,24,10,14
Nelandris,tichondrius,959,hunter,marksmanship,72,28,44
Hunghang,frostmourne,959,hunter,marksmanship,30,10,20
Ñðñdêsçrípt,frostmourne,959,hunter,marksmanship,30,10,20
Austelos,moon-guard,958,hunter,marksmanship,18,10,8
Shotfromhell,sargeras,958,hunter,marksmanship,27,10,17
Searobot,kelthuzad,957,hunter,marksmanship,18,10,8
Lanarhoades,firetree,957,hunter,marksmanship,18,10,8
Chasseür,quelthalas,957,hunter,marksmanship,18,10,8
Snipezone,kelthuzad,957,hunter,marksmanship,24,10,14
Thunderox,tichondrius,957,hunter,marksmanship,36,11,25
Starsworn,moon-guard,956,hunter,marksmanship,18,10,8
Freshko,kiljaeden,956,hunter,marksmanship,18,10,8
Aewyn,malganis,956,hunter,marksmanship,24,10,14
Døubletap,gundrak,956,hunter,marksmanship,24,10,14
Zulorion,the-forgotten-coast,956,hunter,marksmanship,24,10,14
Dartháne,moon-guard,956,hunter,marksmanship,29,11,18
Arcticwôlf,ragnaros,956,hunter,marksmanship,30,10,20
Sparemeok,illidan,955,hunter,marksmanship,18,10,8
Goatshots,lightninghoof,955,hunter,marksmanship,24,10,14
Hawkeyë,ragnaros,954,hunter,marksmanship,18,10,8
Gunshow,wyrmrest-accord,954,hunter,marksmanship,24,10,14
Daymanaahh,malfurion,954,hunter,marksmanship,24,10,14
Xaveco,gallywix,954,hunter,marksmanship,58,23,35
Twist,burning-legion,953,hunter,marksmanship,12,10,2
Damadar,tichondrius,953,hunter,marksmanship,24,10,14
Valane,ragnaros,953,hunter,marksmanship,30,10,20
Getnukedbud,emerald-dream,952,hunter,marksmanship,18,10,8
Ragar,korialstrasz,952,hunter,marksmanship,24,10,14
Jahir,tichondrius,952,hunter,marksmanship,30,10,20
Verdao,stormrage,952,hunter,marksmanship,30,10,20
Tinsho,drakkari,951,hunter,marksmanship,21,11,10
Mailmann,skywall,948,hunter,marksmanship,18,12,6
Kidofdeath,borean-tundra,947,hunter,marksmanship,18,10,8
Vanhe,quelthalas,947,hunter,marksmanship,18,10,8
Katnie,azralon,947,hunter,marksmanship,52,25,27
Momomomo,draka,947,hunter,marksmanship,24,10,14
Milktoker,tichondrius,947,hunter,marksmanship,24,10,14
Globlauncher,tichondrius,946,hunter,marksmanship,18,10,8
Adbéélitø,ragnaros,944,hunter,marksmanship,78,39,39
Alorick,ragnaros,944,hunter,marksmanship,30,10,20
Mirãbel,drakkari,944,hunter,marksmanship,48,14,34
Arshuntica,blackrock,940,hunter,marksmanship,42,23,19
Viciosa,bleeding-hollow,937,hunter,marksmanship,72,39,33
Lazygnome,azshara,934,hunter,marksmanship,23,11,12
Nachtcloverr,stormrage,931,hunter,marksmanship,63,27,36
Jamzlol,frostmourne,930,hunter,marksmanship,23,14,9
Franzkafka,azralon,930,hunter,marksmanship,72,34,38
Heapstack,stormrage,930,hunter,marksmanship,30,12,18
Caraméla,stormrage,927,hunter,marksmanship,22,10,12
Sungold,dathremar,926,hunter,marksmanship,14,11,3
Ontarget,cairne,926,hunter,marksmanship,81,37,44
Torturekilla,bleeding-hollow,922,hunter,marksmanship,75,34,41
Wael,perenolde,920,hunter,marksmanship,29,10,19
Yamanashi,black-dragonflight,914,hunter,marksmanship,120,59,61
Lauannÿ,gallywix,914,hunter,marksmanship,147,68,79
Styles,thaurissan,907,hunter,marksmanship,54,22,32
Brenogam,azralon,906,hunter,marksmanship,37,19,18
Blaws,tichondrius,906,hunter,marksmanship,27,10,17
Onehitrip,illidan,904,hunter,marksmanship,90,38,52
Fourtwents,stormrage,901,hunter,marksmanship,25,10,15
Flechá,illidan,900,hunter,marksmanship,17,10,7
Cazadorelite,tichondrius,900,hunter,marksmanship,59,16,43
Huntercotoco,azralon,896,hunter,marksmanship,48,25,23
Bont,jubeithos,893,hunter,marksmanship,17,10,7
Fourkayiv,azgalor,889,hunter,marksmanship,41,18,23
Typh,saurfang,888,hunter,marksmanship,23,10,13
Murozz,malganis,884,hunter,marksmanship,37,18,19
Ashaelyn,wyrmrest-accord,884,hunter,marksmanship,26,10,16
Motommotto,deathwing,883,hunter,marksmanship,24,12,12
Alleessa,goldrinn,883,hunter,marksmanship,54,21,33
Jetlinx,thrall,881,hunter,marksmanship,21,12,9
Desolateone,nazgrel,880,hunter,marksmanship,50,24,26
Nightwatch,kelthuzad,877,hunter,marksmanship,18,10,8
Jvmr,azralon,877,hunter,marksmanship,56,27,29
Rödrigö,azralon,876,hunter,marksmanship,30,14,16
Dairoxd,drakkari,875,hunter,marksmanship,47,21,26
Thaendra,moon-guard,865,hunter,marksmanship,23,11,12
Karazuba,ragnaros,865,hunter,marksmanship,89,33,56
Saltard,frostmourne,864,hunter,marksmanship,12,9,3
Zulla,bleeding-hollow,864,hunter,marksmanship,12,9,3
Ashx,nemesis,864,hunter,marksmanship,18,9,9
Ðurostar,area-52,864,hunter,marksmanship,18,9,9
Rangêr,frostmourne,864,hunter,marksmanship,18,9,9
Deletedyou,tichondrius,864,hunter,marksmanship,18,9,9
Keenz,frostmourne,864,hunter,marksmanship,24,9,15
Singletap,barthilas,864,hunter,marksmanship,24,9,15
Trapkeithx,frostmourne,864,hunter,marksmanship,24,9,15
Scareder,malganis,864,hunter,marksmanship,24,9,15
Xonios,frostwolf,864,hunter,marksmanship,24,9,15
Sharpknife,dreadmaul,864,hunter,marksmanship,24,9,15
Drãgenox,quelthalas,864,hunter,marksmanship,24,9,15
Tetz,kelthuzad,864,hunter,marksmanship,30,9,21
Demolitions,kelthuzad,864,hunter,marksmanship,30,9,21
Rambot,bleeding-hollow,863,hunter,marksmanship,12,9,3
Ggtooeasy,thrall,863,hunter,marksmanship,19,11,8
Telånnas,illidan,863,hunter,marksmanship,18,9,9
Ohifren,proudmoore,863,hunter,marksmanship,18,9,9
Dôntlosmebro,stormrage,863,hunter,marksmanship,18,9,9
Ultrasj,malfurion,863,hunter,marksmanship,18,9,9
Torrthack,area-52,863,hunter,marksmanship,18,9,9
Dayanier,ragnaros,863,hunter,marksmanship,18,9,9
Nosmoke,kargath,863,hunter,marksmanship,24,9,15
Candytoxic,quelthalas,863,hunter,marksmanship,24,9,15
Ojmo,arthas,863,hunter,marksmanship,24,9,15
Airpodpro,emerald-dream,862,hunter,marksmanship,12,9,3
Fangs,arthas,862,hunter,marksmanship,12,9,3
Bigvudu,illidan,862,hunter,marksmanship,18,9,9
Syrach,area-52,862,hunter,marksmanship,18,9,9
Diertz,area-52,862,hunter,marksmanship,24,9,15
Varrinda,wyrmrest-accord,862,hunter,marksmanship,24,9,15
Insgesicht,proudmoore,862,hunter,marksmanship,24,9,15
Systane,mugthol,861,hunter,marksmanship,12,9,3
Feltz,moon-guard,861,hunter,marksmanship,18,9,9
Jagwaar,malganis,861,hunter,marksmanship,24,9,15
Zarkul,tichondrius,861,hunter,marksmanship,24,9,15
Snipastyle,twisting-nether,861,hunter,marksmanship,30,9,21
Twistedtawl,area-52,860,hunter,marksmanship,18,9,9
Junka,bleeding-hollow,860,hunter,marksmanship,18,9,9
Illt,blackrock,860,hunter,marksmanship,18,9,9
Tekkerz,tichondrius,860,hunter,marksmanship,19,9,10
Jackrandall,frostmourne,860,hunter,marksmanship,24,9,15
Kaeuljua,tichondrius,860,hunter,marksmanship,24,9,15
Lánárhóádés,tichondrius,860,hunter,marksmanship,24,9,15
Kluetus,sargeras,859,hunter,marksmanship,12,9,3
Smokezy,barthilas,859,hunter,marksmanship,18,9,9
Loyalrely,tichondrius,859,hunter,marksmanship,18,9,9
Arzant,quelthalas,858,hunter,marksmanship,12,9,3
Wolftracer,sargeras,858,hunter,marksmanship,18,9,9
Coldhunger,uldum,857,hunter,marksmanship,12,9,3
Wøllver,azralon,857,hunter,marksmanship,18,9,9
Ëz,ragnaros,857,hunter,marksmanship,18,9,9
Lahyanhou,azjolnerub,857,hunter,marksmanship,24,9,15
Lws,ragnaros,856,hunter,marksmanship,12,9,3
Hobbës,kelthuzad,856,hunter,marksmanship,18,9,9
Lameshot,dalaran,856,hunter,marksmanship,24,9,15
Panborikat,thaurissan,855,hunter,marksmanship,36,16,20
Herroo,thrall,855,hunter,marksmanship,30,9,21
Azx,tichondrius,851,hunter,marksmanship,18,9,9
Lyssavirhus,azralon,850,hunter,marksmanship,18,9,9
Avindal,greymane,850,hunter,marksmanship,18,9,9
Westbrooke,illidan,850,hunter,marksmanship,24,9,15
Ues,shuhalo,847,hunter,marksmanship,19,9,10
Hideonpet,barthilas,845,hunter,marksmanship,23,9,14
Zettl,eredar,841,hunter,marksmanship,148,65,83
Arbeis,area-52,841,hunter,marksmanship,42,11,31
Zievieda,hellscream,840,hunter,marksmanship,35,15,20
Ramblinon,bloodhoof,840,hunter,marksmanship,30,11,19
Apochuntz,greymane,839,hunter,marksmanship,24,11,13
Zelanst,illidan,838,hunter,marksmanship,18,9,9
Oorudun,hellscream,838,hunter,marksmanship,59,26,33
Euphylesz,garrosh,836,hunter,marksmanship,22,9,13
Vaelanor,destromath,831,hunter,marksmanship,24,11,13
Squarë,ragnaros,831,hunter,marksmanship,23,9,14
Cio,fizzcrank,831,hunter,marksmanship,24,9,15
Mawlotov,barthilas,829,hunter,marksmanship,29,9,20
Baruz,tichondrius,827,hunter,marksmanship,28,9,19
Póra,stormrage,826,hunter,marksmanship,29,11,18
Muggzzy,malygos,824,hunter,marksmanship,18,9,9
Deejwithabow,frostmourne,815,hunter,marksmanship,18,9,9
Déadlyshot,tichondrius,814,hunter,marksmanship,89,39,50
Skyloss,illidan,811,hunter,marksmanship,48,15,33
Iamtotoro,area-52,809,hunter,marksmanship,28,9,19
Snäpträp,stormrage,807,hunter,marksmanship,15,9,6
Diacachimbaa,ragnaros,807,hunter,marksmanship,21,9,12
Hoarf,nemesis,799,hunter,marksmanship,14,9,5
Ifeignalot,stormscale,799,hunter,marksmanship,16,9,7
Ciils,sargeras,798,hunter,marksmanship,22,9,13
Kazug,destromath,797,hunter,marksmanship,24,10,14
Fian,lightnings-blade,797,hunter,marksmanship,22,9,13
Qúin,frostmourne,797,hunter,marksmanship,29,10,19
Ganeva,sargeras,776,hunter,marksmanship,64,24,40
Getkited,tichondrius,773,hunter,marksmanship,22,10,12
Wij,turalyon,770,hunter,marksmanship,36,12,24
Tamsynn,stormreaver,769,hunter,marksmanship,54,15,39
Shotpig,proudmoore,768,hunter,marksmanship,12,8,4
Ragshunt,stormrage,768,hunter,marksmanship,12,8,4
Entrapment,stormrage,768,hunter,marksmanship,12,8,4
Songhammer,tichondrius,768,hunter,marksmanship,18,8,10
Achillez,bleeding-hollow,768,hunter,marksmanship,18,8,10
Roidbum,barthilas,768,hunter,marksmanship,22,8,14
Woeisyou,stormrage,768,hunter,marksmanship,24,8,16
Soul,sargeras,768,hunter,marksmanship,24,8,16
Civvo,dalaran,768,hunter,marksmanship,24,8,16
Bonquiesha,area-52,768,hunter,marksmanship,24,8,16
Wolfmilkers,illidan,767,hunter,marksmanship,12,8,4
Cimotsw,stormrage,767,hunter,marksmanship,12,8,4
Hunterll,tichondrius,767,hunter,marksmanship,12,8,4
Huntnmaster,thrall,767,hunter,marksmanship,12,8,4
Melkmane,emerald-dream,767,hunter,marksmanship,12,8,4
Arttemiss,zangarmarsh,767,hunter,marksmanship,12,8,4
Handlez,gundrak,767,hunter,marksmanship,12,8,4
Highershot,azralon,767,hunter,marksmanship,12,8,4
Harlory,moon-guard,767,hunter,marksmanship,12,8,4
Fhodhaz,nemesis,767,hunter,marksmanship,12,8,4
Suyesh,tichondrius,767,hunter,marksmanship,12,8,4
Côckblocked,tichondrius,767,hunter,marksmanship,12,8,4
Connovar,nemesis,767,hunter,marksmanship,12,8,4
Spiderham,tichondrius,767,hunter,marksmanship,12,8,4
Wike,hyjal,767,hunter,marksmanship,15,9,6
Vileplumè,stormrage,767,hunter,marksmanship,18,8,10
Xtina,drakkari,767,hunter,marksmanship,18,8,10
Ravanskull,burning-blade,767,hunter,marksmanship,18,8,10
Runethkape,kelthuzad,767,hunter,marksmanship,18,8,10
Rickshaw,frostmourne,767,hunter,marksmanship,18,8,10
Fjdominador,azralon,767,hunter,marksmanship,18,8,10
Siebee,tichondrius,767,hunter,marksmanship,18,8,10
Yory,tol-barad,767,hunter,marksmanship,18,8,10
Waqz,tichondrius,767,hunter,marksmanship,18,8,10
Clo,illidan,767,hunter,marksmanship,18,8,10
Cufless,proudmoore,767,hunter,marksmanship,18,8,10
Thejessiah,tichondrius,767,hunter,marksmanship,18,8,10
Zensuox,barthilas,767,hunter,marksmanship,18,8,10
Tarah,lightbringer,767,hunter,marksmanship,24,8,16
Rizzbow,dalvengyr,767,hunter,marksmanship,24,8,16
Saltz,tichondrius,766,hunter,marksmanship,12,8,4
Mööky,frostmourne,766,hunter,marksmanship,12,8,4
Trochillidae,dragonmaw,766,hunter,marksmanship,18,8,10
Deathspot,thrall,766,hunter,marksmanship,18,8,10
Zèd,azralon,766,hunter,marksmanship,18,8,10
Queldana,drakkari,766,hunter,marksmanship,18,8,10
Blackbrute,nathrezim,766,hunter,marksmanship,18,8,10
Uc,khadgar,766,hunter,marksmanship,18,8,10
Noeffort,frostmourne,766,hunter,marksmanship,18,8,10
Torvauk,bleeding-hollow,766,hunter,marksmanship,18,8,10
Raiku,aggramar,766,hunter,marksmanship,18,8,10
Zindula,malganis,766,hunter,marksmanship,19,8,11
Tonyhunter,nemesis,766,hunter,marksmanship,24,8,16
Kaelhim,warsong,766,hunter,marksmanship,24,8,16
Basticus,blackwater-raiders,765,hunter,marksmanship,12,8,4
Evilslaug,tichondrius,765,hunter,marksmanship,14,8,6
Brosk,drakthul,765,hunter,marksmanship,18,8,10
Ididntdoit,blackhand,765,hunter,marksmanship,24,8,16
Youngpo,thunderlord,765,hunter,marksmanship,24,8,16
Kòng,quelthalas,765,hunter,marksmanship,24,8,16
Skillkiting,area-52,765,hunter,marksmanship,24,8,16
Daahm,malganis,765,hunter,marksmanship,25,8,17
Bionix,sargeras,764,hunter,marksmanship,18,8,10
Myciri,proudmoore,764,hunter,marksmanship,18,8,10
Gramaverde,kelthuzad,763,hunter,marksmanship,24,8,16
Kluako,stormreaver,762,hunter,marksmanship,12,8,4
Thisguÿ,arthas,762,hunter,marksmanship,18,8,10
Sorid,medivh,761,hunter,marksmanship,12,8,4
Emptypokcets,shattered-hand,761,hunter,marksmanship,24,8,16
Enonoa,thunderlord,760,hunter,marksmanship,12,8,4
Cruelhuntres,tichondrius,759,hunter,marksmanship,36,8,28
Porta,zuljin,757,hunter,marksmanship,16,9,7
Staudt,emerald-dream,757,hunter,marksmanship,18,8,10
Aeclpysis,dark-iron,754,hunter,marksmanship,18,10,8
Huntercry,ragnaros,751,hunter,marksmanship,12,8,4
Niceshotboi,azgalor,751,hunter,marksmanship,24,8,16
Lynnì,khadgar,750,hunter,marksmanship,18,8,10
Darkmaximus,echo-isles,750,hunter,marksmanship,24,8,16
Xshadowdemon,korgath,749,hunter,marksmanship,12,8,4
Aksalaz,area-52,749,hunter,marksmanship,17,8,9
Belieli,ragnaros,740,hunter,marksmanship,22,8,14
Mackin,maelstrom,740,hunter,marksmanship,24,8,16
Lennfear,frostmourne,739,hunter,marksmanship,24,8,16
Tkrenshaw,proudmoore,735,hunter,marksmanship,11,8,3
Setepalms,azralon,718,hunter,marksmanship,17,8,9
Mayohater,sargeras,714,hunter,marksmanship,33,9,24
Huntersuck,burning-blade,703,hunter,marksmanship,11,8,3
Andalora,malganis,703,hunter,marksmanship,11,8,3
Dainsleif,perenolde,703,hunter,marksmanship,16,8,8
Dasvydanya,illidan,702,hunter,marksmanship,19,9,10
Glokrag,ysera,702,hunter,marksmanship,20,8,12
Sylanthia,sargeras,701,hunter,marksmanship,14,8,6
Fizzleshot,malganis,699,hunter,marksmanship,18,8,10
Jonsnow,lightnings-blade,693,hunter,marksmanship,21,8,13
Felkrozzul,kalecgos,672,hunter,marksmanship,9,8,1
Mörgoth,quelthalas,672,hunter,marksmanship,12,7,5
Hyrus,shadowmoon,672,hunter,marksmanship,12,7,5
Mms,frostmourne,672,hunter,marksmanship,12,7,5
Relapse,dreadmaul,672,hunter,marksmanship,12,7,5
Ehnub,stormrage,672,hunter,marksmanship,12,7,5
Luoshi,proudmoore,672,hunter,marksmanship,12,7,5
Raktama,proudmoore,672,hunter,marksmanship,12,7,5
Winotah,barthilas,672,hunter,marksmanship,12,7,5
Topgronk,tichondrius,672,hunter,marksmanship,12,7,5
Kaznik,ragnaros,672,hunter,marksmanship,12,7,5
Keboks,alleria,672,hunter,marksmanship,12,7,5
Kookh,area-52,672,hunter,marksmanship,12,7,5
Kaptincrunch,skywall,672,hunter,marksmanship,12,7,5
Goosejuicer,emerald-dream,672,hunter,marksmanship,12,7,5
Shotmaster,tichondrius,672,hunter,marksmanship,12,7,5
Bárd,tichondrius,672,hunter,marksmanship,12,7,5
Mochaxd,stormrage,672,hunter,marksmanship,14,7,7
Segfault,korgath,672,hunter,marksmanship,16,7,9
Tirrill,malganis,672,hunter,marksmanship,18,7,11
Trappah,stormrage,672,hunter,marksmanship,18,7,11
Lökeii,area-52,672,hunter,marksmanship,18,7,11
Ping,tol-barad,672,hunter,marksmanship,18,7,11
Focusfire,khazgoroth,672,hunter,marksmanship,18,7,11
Phatshiet,anvilmar,672,hunter,marksmanship,18,7,11
Mochigelato,kelthuzad,672,hunter,marksmanship,18,7,11
Clawdio,ragnaros,672,hunter,marksmanship,18,7,11
Jimryl,illidan,672,hunter,marksmanship,18,7,11
Womdalekk,azralon,672,hunter,marksmanship,18,7,11
Bombanodos,kelthuzad,672,hunter,marksmanship,18,7,11
Bigkolache,zuljin,672,hunter,marksmanship,24,7,17
Datbigbowdoe,illidan,672,hunter,marksmanship,24,7,17
Bigzane,darkspear,672,hunter,marksmanship,24,7,17
Kneecrippler,proudmoore,671,hunter,marksmanship,12,7,5
Vatits,dalaran,671,hunter,marksmanship,12,7,5
Sunyourmom,proudmoore,671,hunter,marksmanship,12,7,5
Halford,tol-barad,671,hunter,marksmanship,12,7,5
Texploto,area-52,671,hunter,marksmanship,12,7,5
Geraldson,proudmoore,671,hunter,marksmanship,12,7,5
Hannover,ragnaros,671,hunter,marksmanship,12,7,5
Ethne,garithos,671,hunter,marksmanship,12,7,5
Foxyevermew,tichondrius,671,hunter,marksmanship,12,7,5
Xhare,stormrage,671,hunter,marksmanship,12,7,5
Ocui,ragnaros,671,hunter,marksmanship,12,7,5
Neoxbow,wyrmrest-accord,671,hunter,marksmanship,12,7,5
Zelonas,emerald-dream,671,hunter,marksmanship,12,7,5
Zhions,ragnaros,671,hunter,marksmanship,12,7,5
Zhetsu,cenarius,671,hunter,marksmanship,18,7,11
Bstic,quelthalas,671,hunter,marksmanship,18,7,11
Kalizra,quelthalas,671,hunter,marksmanship,18,7,11
Löbo,quelthalas,671,hunter,marksmanship,18,7,11
Toesgoes,thrall,671,hunter,marksmanship,18,7,11
Sáns,sargeras,671,hunter,marksmanship,18,7,11
Atallstalker,sargeras,671,hunter,marksmanship,18,7,11
Bowsbéforhos,stormrage,671,hunter,marksmanship,18,7,11
Navagee,tichondrius,671,hunter,marksmanship,18,7,11
Schbaltz,tichondrius,671,hunter,marksmanship,18,7,11
Murderone,undermine,671,hunter,marksmanship,18,7,11
Såvagehunter,malganis,671,hunter,marksmanship,18,7,11
Lyricly,lightbringer,671,hunter,marksmanship,18,7,11
Feignmilf,tichondrius,671,hunter,marksmanship,18,7,11
Temara,icecrown,671,hunter,marksmanship,24,7,17
Joogeenda,kaelthas,670,hunter,marksmanship,12,7,5
Untermench,tichondrius,670,hunter,marksmanship,12,7,5
Kìngjaybroni,sargeras,670,hunter,marksmanship,12,7,5
Gemky,ragnaros,670,hunter,marksmanship,19,8,11
Cócaine,tichondrius,670,hunter,marksmanship,19,8,11
Ownshot,kiljaeden,670,hunter,marksmanship,18,7,11
Wolfyyxx,stormrage,670,hunter,marksmanship,18,7,11
Nellond,malganis,670,hunter,marksmanship,18,7,11
Gagau,stormrage,670,hunter,marksmanship,18,7,11
Bartolomeu,kirin-tor,669,hunter,marksmanship,12,7,5
Johnwayne,alterac-mountains,669,hunter,marksmanship,22,8,14
Lionnheart,wyrmrest-accord,668,hunter,marksmanship,12,7,5
Lilzoomer,barthilas,668,hunter,marksmanship,12,7,5
Niteynite,duskwood,668,hunter,marksmanship,12,7,5
Roboputa,quelthalas,667,hunter,marksmanship,18,7,11
Gundolf,kargath,667,hunter,marksmanship,18,7,11
Mulnaaj,zuljin,666,hunter,marksmanship,24,7,17
Mahty,stormrage,665,hunter,marksmanship,12,7,5
Blåckhat,frostmourne,665,hunter,marksmanship,36,7,29
Bowzo,emerald-dream,663,hunter,marksmanship,18,7,11
Steelfeather,hellscream,662,hunter,marksmanship,12,7,5
Jxoxex,wildhammer,662,hunter,marksmanship,18,7,11
Lulaladraun,azralon,662,hunter,marksmanship,24,7,17
Mayhunter,ragnaros,651,hunter,marksmanship,19,8,11
Cassîdy,quelthalas,651,hunter,marksmanship,24,7,17
Righthole,area-52,640,hunter,marksmanship,22,7,15
Äzrael,elune,638,hunter,marksmanship,24,7,17
Goldenblade,shadowmoon,624,hunter,marksmanship,21,7,14
Atraksis,thrall,623,hunter,marksmanship,11,7,4
Grukar,tichondrius,623,hunter,marksmanship,17,7,10
Remak,barthilas,620,hunter,marksmanship,15,7,8
Muerteaterry,ragnaros,618,hunter,marksmanship,18,8,10
Mesiauzx,stormrage,618,hunter,marksmanship,22,9,13
Maveraxx,executus,616,hunter,marksmanship,21,7,14
Kushminion,zuljin,607,hunter,marksmanship,14,9,5
Ròllinafatty,dark-iron,607,hunter,marksmanship,14,7,7
Krossx,thrall,591,hunter,marksmanship,12,7,5
Rednivrap,kelthuzad,576,hunter,marksmanship,6,6,0
Skullcracker,azralon,576,hunter,marksmanship,12,6,6
Ysoseriusg,area-52,576,hunter,marksmanship,12,6,6
Aurzwraek,proudmoore,576,hunter,marksmanship,12,6,6
Groomme,area-52,576,hunter,marksmanship,12,6,6
Vårelse,sargeras,576,hunter,marksmanship,12,6,6
Nerfmeplezz,area-52,576,hunter,marksmanship,12,6,6
Gugubird,proudmoore,576,hunter,marksmanship,12,6,6
Arenthius,lothar,576,hunter,marksmanship,12,6,6
Aoti,nerzhul,576,hunter,marksmanship,12,6,6
Talanar,ragnaros,576,hunter,marksmanship,12,6,6
Xohzabu,wyrmrest-accord,576,hunter,marksmanship,12,6,6
Klepa,illidan,576,hunter,marksmanship,12,6,6
Juwannaaim,lethon,576,hunter,marksmanship,12,6,6
Kangar,senjin,576,hunter,marksmanship,12,6,6
Warblez,spinebreaker,576,hunter,marksmanship,12,6,6
Jpynovisa,moon-guard,576,hunter,marksmanship,12,6,6
Ticey,frostmourne,576,hunter,marksmanship,12,6,6
Donotrunaway,ragnaros,576,hunter,marksmanship,12,6,6
Ssds,sargeras,576,hunter,marksmanship,12,6,6
Vigero,proudmoore,576,hunter,marksmanship,12,6,6
Gritzix,frostmourne,576,hunter,marksmanship,12,6,6
Elmozz,thrall,576,hunter,marksmanship,12,6,6
Kyudo,moon-guard,576,hunter,marksmanship,12,6,6
Spanerd,moon-guard,576,hunter,marksmanship,12,6,6
Huntkillerx,illidan,576,hunter,marksmanship,12,6,6
Nightgecko,elune,576,hunter,marksmanship,12,6,6
Laurenx,illidan,576,hunter,marksmanship,12,6,6
Grimdrakk,zuljin,576,hunter,marksmanship,12,6,6
Cubecrawler,skullcrusher,576,hunter,marksmanship,12,6,6
Êlautismo,wyrmrest-accord,576,hunter,marksmanship,12,6,6
Ishootpeople,illidan,576,hunter,marksmanship,12,6,6
Dranel,nordrassil,576,hunter,marksmanship,12,6,6
Rockehm,frostmourne,576,hunter,marksmanship,12,6,6
Pulso,illidan,576,hunter,marksmanship,12,6,6
Mdizzly,zuljin,576,hunter,marksmanship,12,6,6
Cù,frostmourne,576,hunter,marksmanship,12,6,6
Zaamsa,ragnaros,576,hunter,marksmanship,12,6,6
Küngen,zuljin,576,hunter,marksmanship,12,6,6
Birbwatcher,moon-guard,576,hunter,marksmanship,12,6,6
Skum,tichondrius,576,hunter,marksmanship,12,6,6
Xernen,thrall,576,hunter,marksmanship,12,6,6
Trapwiz,firetree,576,hunter,marksmanship,12,6,6
Kynigi,bleeding-hollow,576,hunter,marksmanship,12,6,6
Vicecheney,illidan,576,hunter,marksmanship,12,6,6
Pandaslayr,garrosh,576,hunter,marksmanship,12,6,6
Viralshot,tichondrius,576,hunter,marksmanship,12,6,6
Tokez,moon-guard,576,hunter,marksmanship,14,6,8
Lightbullet,kelthuzad,576,hunter,marksmanship,18,6,12
Shcrimps,proudmoore,576,hunter,marksmanship,18,6,12
Aaggros,sargeras,576,hunter,marksmanship,18,6,12
Najmoira,area-52,576,hunter,marksmanship,24,6,18
Jônathan,tichondrius,576,hunter,marksmanship,24,6,18
Kazes,stormrage,575,hunter,marksmanship,12,6,6
Cerrundan,icecrown,575,hunter,marksmanship,12,6,6
Silentzkill,tichondrius,575,hunter,marksmanship,12,6,6
Chipsncheese,korgath,575,hunter,marksmanship,12,6,6
Alinûs,stormrage,575,hunter,marksmanship,12,6,6
Chapushoot,ragnaros,575,hunter,marksmanship,12,6,6
Projectilez,sargeras,575,hunter,marksmanship,12,6,6
Wârhunt,frostmourne,575,hunter,marksmanship,12,6,6
Tajo,sargeras,575,hunter,marksmanship,12,6,6
Littlespike,queldorei,575,hunter,marksmanship,12,6,6
Taphh,moon-guard,575,hunter,marksmanship,12,6,6
Lagginwaggin,azgalor,575,hunter,marksmanship,12,6,6
Thehunturd,dalaran,575,hunter,marksmanship,12,6,6
Sylvaethas,lightninghoof,575,hunter,marksmanship,12,6,6
Cobrag,tichondrius,575,hunter,marksmanship,12,6,6
Badharexx,perenolde,575,hunter,marksmanship,12,6,6
Aragörnn,azralon,575,hunter,marksmanship,12,6,6
Gresga,dalaran,575,hunter,marksmanship,12,6,6
Onlyfeìgns,frostmourne,575,hunter,marksmanship,12,6,6
Muckenfoose,frostmourne,575,hunter,marksmanship,12,6,6
Dirtbagchaz,illidan,575,hunter,marksmanship,12,6,6
Smashfacehnt,tichondrius,575,hunter,marksmanship,18,6,12
Tazmaniak,gorefiend,575,hunter,marksmanship,18,6,12
Zugineer,tichondrius,575,hunter,marksmanship,18,6,12
Arbclimbs,frostmane,575,hunter,marksmanship,18,6,12
Zeddunn,stormrage,574,hunter,marksmanship,12,6,6
Marcusrarnis,zuljin,574,hunter,marksmanship,12,6,6
Hildihunt,stormrage,574,hunter,marksmanship,12,6,6
Folgadoo,azralon,574,hunter,marksmanship,18,6,12
Bigmommah,durotan,574,hunter,marksmanship,24,6,18
Bunb,area-52,574,hunter,marksmanship,24,6,18
Galfhord,ragnaros,574,hunter,marksmanship,24,6,18
Arïya,azralon,573,hunter,marksmanship,12,6,6
Recebaa,barthilas,572,hunter,marksmanship,12,6,6
Jogoran,thunderlord,571,hunter,marksmanship,12,6,6
Strelyatil,trollbane,571,hunter,marksmanship,18,6,12
Zandrá,drakkari,570,hunter,marksmanship,12,6,6
Drâgônâr,stormrage,570,hunter,marksmanship,18,6,12
Beastmodeqt,blood-furnace,566,hunter,marksmanship,18,6,12
Nickhell,azralon,565,hunter,marksmanship,12,6,6
Axtlas,moonrunner,565,hunter,marksmanship,12,6,6
Ikkare,dalaran,565,hunter,marksmanship,12,6,6
Weirdjeff,alexstrasza,565,hunter,marksmanship,12,6,6
Neef,mannoroth,564,hunter,marksmanship,24,6,18
Ratspit,chogall,557,hunter,marksmanship,17,6,11
Erudraugdin,quelthalas,545,hunter,marksmanship,24,6,18
Elchavo,malganis,543,hunter,marksmanship,11,6,5
Cloveth,wyrmrest-accord,543,hunter,marksmanship,11,6,5
Gymli,destromath,543,hunter,marksmanship,11,6,5
Stephkurryz,tichondrius,543,hunter,marksmanship,14,7,7
Päinal,area-52,528,hunter,marksmanship,9,6,3
Déadshøt,blackhand,527,hunter,marksmanship,17,6,11
Jaydemo,thunderhorn,527,hunter,marksmanship,17,6,11
Xtremesnipez,frostmourne,522,hunter,marksmanship,15,9,6
Ayrelial,tichondrius,522,hunter,marksmanship,13,7,6
Remixjy,burning-blade,522,hunter,marksmanship,16,7,9
Cns,tichondrius,521,hunter,marksmanship,20,7,13
Braddocky,azralon,518,hunter,marksmanship,15,7,8
Greyk,moon-guard,511,hunter,marksmanship,11,6,5
Pogcheddar,tichondrius,511,hunter,marksmanship,14,6,8
Tracershot,malganis,511,hunter,marksmanship,14,6,8
Cplski,kelthuzad,511,hunter,marksmanship,16,6,10
Stepbroski,moon-guard,510,hunter,marksmanship,14,6,8
Brainzz,emerald-dream,509,hunter,marksmanship,16,7,9
Brody,eitrigg,508,hunter,marksmanship,16,6,10
Kimchishotxo,tichondrius,480,hunter,marksmanship,6,5,1
Rhunakk,emerald-dream,480,hunter,marksmanship,6,5,1
Brienz,tichondrius,480,hunter,marksmanship,6,5,1
Zmghost,nathrezim,480,hunter,marksmanship,6,5,1
Thrandrial,smolderthorn,480,hunter,marksmanship,6,5,1
Martminas,stormrage,480,hunter,marksmanship,6,5,1
Shootandloot,zuljin,480,hunter,marksmanship,6,5,1
Johhnweed,ragnaros,480,hunter,marksmanship,6,5,1
Qthunterr,dalaran,480,hunter,marksmanship,6,5,1
Knerf,silvermoon,480,hunter,marksmanship,6,5,1
Chickenzzack,tichondrius,480,hunter,marksmanship,6,5,1
Drup,dalaran,480,hunter,marksmanship,6,5,1
Arimkal,area-52,480,hunter,marksmanship,6,5,1
Taije,arthas,480,hunter,marksmanship,6,5,1
Thekilla,ragnaros,480,hunter,marksmanship,6,5,1
Bendotexe,stormrage,480,hunter,marksmanship,6,5,1
Raevon,kelthuzad,480,hunter,marksmanship,9,6,3
Idtrapthat,nordrassil,480,hunter,marksmanship,9,5,4
Stingyshot,thrall,480,hunter,marksmanship,12,5,7
Bullzeyê,kelthuzad,480,hunter,marksmanship,12,5,7
Duckpow,frostmourne,480,hunter,marksmanship,12,5,7
Partÿ,tichondrius,480,hunter,marksmanship,12,5,7
Baehydra,frostmourne,480,hunter,marksmanship,12,5,7
Xísa,proudmoore,480,hunter,marksmanship,12,5,7
Soloshuffle,kelthuzad,480,hunter,marksmanship,12,5,7
Kattarry,moon-guard,480,hunter,marksmanship,12,5,7
Mickyluvin,emerald-dream,480,hunter,marksmanship,12,5,7
Trapshootjk,area-52,480,hunter,marksmanship,12,5,7
Lilbowbigdam,emerald-dream,480,hunter,marksmanship,12,5,7
Snoplow,illidan,480,hunter,marksmanship,12,5,7
Snipedown,bonechewer,480,hunter,marksmanship,12,5,7
Cotoyo,sargeras,480,hunter,marksmanship,12,5,7
Ellissniper,frostmourne,480,hunter,marksmanship,12,5,7
Bowjoby,kelthuzad,480,hunter,marksmanship,12,5,7
Lagshots,kelthuzad,480,hunter,marksmanship,12,5,7
Lìlleth,thrall,480,hunter,marksmanship,12,5,7
Qqshot,emerald-dream,480,hunter,marksmanship,12,5,7
Jaywuz,tichondrius,480,hunter,marksmanship,12,5,7
Scruffiebear,deathwing,480,hunter,marksmanship,12,5,7
Smokabonbon,eredar,480,hunter,marksmanship,12,5,7
Arraza,ragnaros,480,hunter,marksmanship,12,5,7
Årcter,alexstrasza,480,hunter,marksmanship,12,5,7
Hawkeyees,ragnaros,480,hunter,marksmanship,12,5,7
Volarsomar,shattered-hand,480,hunter,marksmanship,12,5,7
Josyv,quelthalas,480,hunter,marksmanship,12,5,7
Slobon,tichondrius,480,hunter,marksmanship,12,5,7
Snipeudead,sargeras,480,hunter,marksmanship,12,5,7
Lorgor,eonar,480,hunter,marksmanship,12,5,7
Furrhunter,tichondrius,480,hunter,marksmanship,12,5,7
Eldotbrod,quelthalas,480,hunter,marksmanship,12,5,7
Lianm,stormrage,480,hunter,marksmanship,12,5,7
Connora,stormrage,480,hunter,marksmanship,12,5,7
Humiliation,mugthol,480,hunter,marksmanship,12,5,7
Orì,stormrage,480,hunter,marksmanship,12,5,7
Splosiv,stormrage,480,hunter,marksmanship,12,5,7
Shooked,area-52,480,hunter,marksmanship,12,5,7
Hunt,the-underbog,480,hunter,marksmanship,12,5,7
Aloa,nagrand,480,hunter,marksmanship,12,5,7
Davidbowey,bonechewer,480,hunter,marksmanship,12,5,7
Thewïld,tichondrius,480,hunter,marksmanship,12,5,7
Trænquility,tichondrius,480,hunter,marksmanship,12,5,7
Íkíte,zuljin,480,hunter,marksmanship,12,5,7
Skedd,wyrmrest-accord,480,hunter,marksmanship,12,5,7
Raeyy,area-52,480,hunter,marksmanship,12,5,7
Kankuro,proudmoore,480,hunter,marksmanship,12,5,7
Teaks,aggramar,480,hunter,marksmanship,12,5,7
Boomheadshot,blood-furnace,480,hunter,marksmanship,12,5,7
Omniquiver,sargeras,480,hunter,marksmanship,12,5,7
Valro,hyjal,480,hunter,marksmanship,12,5,7
Reys,bonechewer,480,hunter,marksmanship,15,6,9
Regretful,kelthuzad,480,hunter,marksmanship,13,5,8
Velinieron,norgannon,480,hunter,marksmanship,14,5,9
Ikiteforfood,zuljin,480,hunter,marksmanship,18,5,13
Vanir,stormscale,480,hunter,marksmanship,18,5,13
Absinther,emerald-dream,480,hunter,marksmanship,18,5,13
Msghunter,sargeras,480,hunter,marksmanship,18,5,13
Blickys,area-52,480,hunter,marksmanship,18,5,13
Eurekasl,ragnaros,480,hunter,marksmanship,18,5,13
Stupid,arthas,480,hunter,marksmanship,18,5,13
Shootybootìe,tichondrius,480,hunter,marksmanship,18,5,13
Keelif,arthas,480,hunter,marksmanship,18,5,13
Mohz,kiljaeden,480,hunter,marksmanship,18,5,13
Ownyoufast,darkspear,480,hunter,marksmanship,24,5,19
Ritrune,anvilmar,479,hunter,marksmanship,6,5,1
Hishamo,aggramar,479,hunter,marksmanship,6,5,1
Runimurder,zuljin,479,hunter,marksmanship,6,5,1
Voujin,ragnaros,479,hunter,marksmanship,12,5,7
Rykbad,area-52,479,hunter,marksmanship,12,5,7
Ohhsnaapp,blood-furnace,479,hunter,marksmanship,12,5,7
Globalhunter,emerald-dream,479,hunter,marksmanship,12,5,7
Zaghoward,fenris,479,hunter,marksmanship,12,5,7
Jazeath,tichondrius,479,hunter,marksmanship,12,5,7
Pilk,daggerspine,479,hunter,marksmanship,12,5,7
Peitowyn,illidan,479,hunter,marksmanship,12,5,7
Pathius,uldaman,479,hunter,marksmanship,12,5,7
Keyva,moon-guard,479,hunter,marksmanship,12,5,7
Logonman,rexxar,479,hunter,marksmanship,12,5,7
Alluminant,gilneas,479,hunter,marksmanship,12,5,7
Banhunter,tichondrius,479,hunter,marksmanship,12,5,7
Blurrí,area-52,479,hunter,marksmanship,12,5,7
Hunchback,emerald-dream,479,hunter,marksmanship,12,5,7
Diur,ragnaros,479,hunter,marksmanship,15,5,10
Kiteftw,tichondrius,479,hunter,marksmanship,21,6,15
Johar,nerzhul,479,hunter,marksmanship,18,5,13
Enzym,archimonde,479,hunter,marksmanship,18,5,13
Pucky,quelthalas,479,hunter,marksmanship,18,5,13
Ensnare,wyrmrest-accord,478,hunter,marksmanship,12,5,7
Drakkoniss,spinebreaker,478,hunter,marksmanship,12,5,7
Ozzoty,tol-barad,478,hunter,marksmanship,12,5,7
Damnnicebutt,borean-tundra,478,hunter,marksmanship,20,7,13
Nobelscarlet,wildhammer,477,hunter,marksmanship,12,5,7
Tularac,sentinels,477,hunter,marksmanship,12,5,7
Survival,dentarg,477,hunter,marksmanship,12,5,7
Puttry,stormrage,476,hunter,marksmanship,12,5,7
Akbu,azralon,476,hunter,marksmanship,12,5,7
Àrsha,gallywix,475,hunter,marksmanship,12,5,7
Nubberton,sargeras,473,hunter,marksmanship,16,8,8
Lanney,firetree,473,hunter,marksmanship,12,5,7
Hartman,frostwolf,473,hunter,marksmanship,18,5,13
Mazkeen,bonechewer,472,hunter,marksmanship,12,5,7
Butimbutters,bleeding-hollow,467,hunter,marksmanship,23,8,15
Raun,anvilmar,453,hunter,marksmanship,17,5,12
Againzt,tichondrius,447,hunter,marksmanship,12,6,6
Keedub,stormrage,447,hunter,marksmanship,11,5,6
Diavál,area-52,447,hunter,marksmanship,11,5,6
Ryonel,moon-guard,447,hunter,marksmanship,17,5,12
Mukeru,stormrage,432,hunter,marksmanship,9,5,4
Jud,thunderlord,432,hunter,marksmanship,21,5,16
Wook,hyjal,431,hunter,marksmanship,11,5,6
Irontoast,kelthuzad,431,hunter,marksmanship,11,5,6
Noriee,destromath,431,hunter,marksmanship,15,5,10
Ozarks,kiljaeden,426,hunter,marksmanship,17,6,11
Onlyphanz,darkspear,415,hunter,marksmanship,8,5,3
Rektarrow,area-52,384,hunter,marksmanship,6,4,2
Nyxus,tichondrius,384,hunter,marksmanship,6,4,2
Blamethenaga,sargeras,384,hunter,marksmanship,6,4,2
Llhopital,ragnaros,384,hunter,marksmanship,6,4,2
Zendarae,tichondrius,384,hunter,marksmanship,6,4,2
Sylos,moon-guard,384,hunter,marksmanship,6,4,2
Folf,turalyon,384,hunter,marksmanship,6,4,2
Tdarknet,quelthalas,384,hunter,marksmanship,6,4,2
Hitemup,bleeding-hollow,384,hunter,marksmanship,6,4,2
Nenenhunt,ragnaros,384,hunter,marksmanship,6,4,2
Shímmér,barthilas,384,hunter,marksmanship,6,4,2
Moyria,quelthalas,384,hunter,marksmanship,6,4,2
Swish,burning-legion,384,hunter,marksmanship,6,4,2
Illine,azralon,384,hunter,marksmanship,6,4,2
Beefcow,barthilas,384,hunter,marksmanship,6,4,2
Maidán,azralon,384,hunter,marksmanship,6,4,2
Emilysamuels,tichondrius,384,hunter,marksmanship,6,4,2
Arteene,illidan,384,hunter,marksmanship,6,4,2
Beatnass,cairne,384,hunter,marksmanship,6,4,2
Frîck,bleeding-hollow,384,hunter,marksmanship,6,4,2
Aimbôt,frostmourne,384,hunter,marksmanship,6,4,2
Malcab,tichondrius,384,hunter,marksmanship,6,4,2
Jojojobo,tichondrius,384,hunter,marksmanship,6,4,2
Wellerman,firetree,384,hunter,marksmanship,6,4,2
Shootyzenth,kiljaeden,384,hunter,marksmanship,6,4,2
Jaganshot,tol-barad,384,hunter,marksmanship,6,4,2
Karimysac,aggramar,384,hunter,marksmanship,6,4,2
Goonlmao,hyjal,384,hunter,marksmanship,6,4,2
Venj,proudmoore,384,hunter,marksmanship,6,4,2
Zenkhi,quelthalas,384,hunter,marksmanship,6,4,2
Shootbert,malganis,384,hunter,marksmanship,6,4,2
Croift,stormrage,384,hunter,marksmanship,6,4,2
Cashisabeast,zuljin,384,hunter,marksmanship,6,4,2
Yamamasofat,proudmoore,384,hunter,marksmanship,6,4,2
Gunstorms,dalaran,384,hunter,marksmanship,6,4,2
Valtolimor,moon-guard,384,hunter,marksmanship,6,4,2
Cornstalk,area-52,384,hunter,marksmanship,6,4,2
Infatuatedx,moon-guard,384,hunter,marksmanship,6,4,2
Krissiz,drakkari,384,hunter,marksmanship,6,4,2
Goldensour,malganis,384,hunter,marksmanship,6,4,2
Subdue,tichondrius,384,hunter,marksmanship,6,4,2
Oromís,dalaran,384,hunter,marksmanship,6,4,2
Elmerfuddx,terokkar,384,hunter,marksmanship,6,4,2
Hyjix,stormrage,384,hunter,marksmanship,6,4,2
Swoljashotxp,area-52,384,hunter,marksmanship,6,4,2
Gogey,area-52,384,hunter,marksmanship,6,4,2
Junmuxiao,ragnaros,384,hunter,marksmanship,6,4,2
Silvertokay,ragnaros,384,hunter,marksmanship,6,4,2
Cerakkaya,tichondrius,384,hunter,marksmanship,6,4,2
Archetype,bladefist,384,hunter,marksmanship,6,4,2
Déwi,tichondrius,384,hunter,marksmanship,6,4,2
Anecko,zuljin,384,hunter,marksmanship,6,4,2
Huumpoutine,burning-blade,384,hunter,marksmanship,6,4,2
Raposo,nemesis,384,hunter,marksmanship,6,4,2
Malthiz,antonidas,384,hunter,marksmanship,8,4,4
Baydog,moon-guard,384,hunter,marksmanship,11,4,7
Xeriife,stormrage,384,hunter,marksmanship,12,4,8
Gotrap,saurfang,384,hunter,marksmanship,12,4,8
Sucontheze,kelthuzad,384,hunter,marksmanship,12,4,8
Robobop,stormrage,384,hunter,marksmanship,12,4,8
Karev,area-52,384,hunter,marksmanship,12,4,8
Artemisagro,greymane,384,hunter,marksmanship,12,4,8
Bigclamz,dragonmaw,384,hunter,marksmanship,12,4,8
Kanati,dunemaul,384,hunter,marksmanship,12,4,8
Ohimissyou,emerald-dream,384,hunter,marksmanship,12,4,8
Kyler,draka,384,hunter,marksmanship,12,4,8
Percision,bonechewer,384,hunter,marksmanship,12,4,8
Shottz,blackhand,384,hunter,marksmanship,12,4,8
Bacigalupo,medivh,384,hunter,marksmanship,12,4,8
Ganzilla,aerie-peak,384,hunter,marksmanship,12,4,8
Dmasterbiter,zuljin,384,hunter,marksmanship,12,4,8
Altte,proudmoore,384,hunter,marksmanship,12,4,8
Emérr,drakkari,384,hunter,marksmanship,12,4,8
Mabaku,tichondrius,384,hunter,marksmanship,12,4,8
Junglar,eitrigg,384,hunter,marksmanship,12,4,8
Ningiiwose,garona,384,hunter,marksmanship,12,4,8
Saralli,thrall,384,hunter,marksmanship,12,4,8
Ezpzx,sargeras,384,hunter,marksmanship,12,4,8
Aaron,jubeithos,384,hunter,marksmanship,12,4,8
Bunryl,thorium-brotherhood,384,hunter,marksmanship,12,4,8
Gstygodx,frostmourne,384,hunter,marksmanship,12,4,8
Joton,tichondrius,384,hunter,marksmanship,12,4,8
Lithality,tichondrius,384,hunter,marksmanship,12,4,8
Hywhan,stormrage,384,hunter,marksmanship,12,4,8
Zipzyup,tichondrius,384,hunter,marksmanship,12,4,8
Lilbic,bleeding-hollow,384,hunter,marksmanship,12,4,8
Vion,mannoroth,384,hunter,marksmanship,12,4,8
Limpnoodle,nerzhul,384,hunter,marksmanship,12,4,8
Specops,illidan,384,hunter,marksmanship,12,4,8
Revö,area-52,384,hunter,marksmanship,12,4,8
Trippyhunter,akama,384,hunter,marksmanship,12,4,8
Aquastasia,aegwynn,384,hunter,marksmanship,12,4,8
Ðao,nazjatar,384,hunter,marksmanship,12,4,8
Sogeki,kelthuzad,384,hunter,marksmanship,12,4,8
Patroclo,azralon,384,hunter,marksmanship,12,4,8
Crackshotzz,illidan,384,hunter,marksmanship,12,4,8
Resonatorrob,illidan,384,hunter,marksmanship,12,4,8
Rumnaheim,nemesis,384,hunter,marksmanship,12,4,8
Sylvanâs,bleeding-hollow,384,hunter,marksmanship,12,4,8
Kumari,lothar,384,hunter,marksmanship,12,4,8
Whatalexa,tichondrius,384,hunter,marksmanship,12,4,8
Hunterjahvek,area-52,384,hunter,marksmanship,12,4,8
Sabo,nemesis,384,hunter,marksmanship,12,4,8
Missnevamiss,skullcrusher,384,hunter,marksmanship,12,4,8
Ðïanä,azralon,384,hunter,marksmanship,12,4,8
Vélos,illidan,384,hunter,marksmanship,12,4,8
Frankyy,frostmourne,384,hunter,marksmanship,12,4,8
Hordworld,tichondrius,384,hunter,marksmanship,12,4,8
Braindeadorc,illidan,384,hunter,marksmanship,12,4,8
Crimsonmm,ragnaros,384,hunter,marksmanship,12,4,8
Tsubakï,ragnaros,384,hunter,marksmanship,12,4,8
Brotag,aggramar,384,hunter,marksmanship,12,4,8
Enchantras,jaedenar,384,hunter,marksmanship,12,4,8
Taurenseason,sargeras,384,hunter,marksmanship,12,4,8
Dropflag,stormrage,384,hunter,marksmanship,12,4,8
Skillvanas,stormrage,384,hunter,marksmanship,12,4,8
Bleedwolf,tichondrius,384,hunter,marksmanship,12,4,8
Samsin,sargeras,384,hunter,marksmanship,12,4,8
Gotskill,lethon,384,hunter,marksmanship,18,4,14
Peashooter,sargeras,384,hunter,marksmanship,19,4,15
Dathronin,chogall,383,hunter,marksmanship,6,4,2
Meriah,bleeding-hollow,383,hunter,marksmanship,6,4,2
Essya,frostmourne,383,hunter,marksmanship,6,4,2
Balanguxa,azralon,383,hunter,marksmanship,6,4,2
Comtambisuon,frostmourne,383,hunter,marksmanship,6,4,2
Aridan,area-52,383,hunter,marksmanship,12,4,8
Shootingjaem,tichondrius,383,hunter,marksmanship,12,4,8
Zérõ,area-52,383,hunter,marksmanship,12,4,8
Rottinghood,hyjal,383,hunter,marksmanship,12,4,8
Minibrö,tichondrius,383,hunter,marksmanship,12,4,8
Juanita,laughing-skull,383,hunter,marksmanship,12,4,8
Shootymcshot,vashj,383,hunter,marksmanship,12,4,8
Fermra,dunemaul,383,hunter,marksmanship,12,4,8
Zenwrath,illidan,383,hunter,marksmanship,12,4,8
Cornbreadfed,gorgonnash,383,hunter,marksmanship,12,4,8
Ytsejammer,eonar,383,hunter,marksmanship,12,4,8
Lanamatt,azralon,383,hunter,marksmanship,12,4,8
Nevon,azralon,383,hunter,marksmanship,18,4,14
Hunternao,nemesis,383,hunter,marksmanship,18,4,14
Rzan,fenris,382,hunter,marksmanship,6,4,2
Oohuntsoo,emerald-dream,382,hunter,marksmanship,6,4,2
Eaudelune,vashj,382,hunter,marksmanship,12,4,8
Lovek,ragnaros,382,hunter,marksmanship,12,4,8
Skatenos,tortheldrin,381,hunter,marksmanship,12,4,8
Twofeathers,wyrmrest-accord,381,hunter,marksmanship,12,4,8
Goofyfingers,illidan,380,hunter,marksmanship,18,4,14
Venessie,moon-guard,379,hunter,marksmanship,12,4,8
Arighthunt,frostmourne,367,hunter,marksmanship,17,4,13
Roseandra,stormrage,366,hunter,marksmanship,17,4,13
Hyesik,tichondrius,362,hunter,marksmanship,21,7,14
Pérséús,ragnaros,351,hunter,marksmanship,12,5,7
Tarkovs,area-52,351,hunter,marksmanship,11,4,7
Bloodarrow,tichondrius,351,hunter,marksmanship,11,4,7
Rnger,aerie-peak,350,hunter,marksmanship,12,5,7
Trappxy,sargeras,336,hunter,marksmanship,9,4,5
Tafer,quelthalas,336,hunter,marksmanship,9,4,5
Brorc,kul-tiras,335,hunter,marksmanship,11,4,7
Zucarita,tichondrius,330,hunter,marksmanship,9,5,4
Nubcaks,nerzhul,330,hunter,marksmanship,21,5,16
Misogynistaf,tichondrius,319,hunter,marksmanship,5,4,1
Stupïd,tichondrius,319,hunter,marksmanship,5,4,1
Aimian,frostmourne,319,hunter,marksmanship,8,4,4
Ðeathßyarrøw,bloodscalp,319,hunter,marksmanship,10,4,6
Streetcrime,stormrage,304,hunter,marksmanship,7,4,3
Dahunterguy,illidan,304,hunter,marksmanship,7,4,3
Peña,trollbane,304,hunter,marksmanship,13,4,9
Dagre,the-forgotten-coast,304,hunter,marksmanship,13,4,9
Tìnker,stormrage,288,hunter,marksmanship,6,3,3
Quondo,boulderfist,288,hunter,marksmanship,6,3,3
Deathshoôt,suramar,288,hunter,marksmanship,6,3,3
Plastera,zuljin,288,hunter,marksmanship,6,3,3
Wannakill,stormrage,288,hunter,marksmanship,6,3,3
Zym,the-forgotten-coast,288,hunter,marksmanship,6,3,3
Azairxd,tichondrius,288,hunter,marksmanship,6,3,3
Halosucks,sargeras,288,hunter,marksmanship,6,3,3
Canadïan,stormrage,288,hunter,marksmanship,6,3,3
Mtuanwm,tichondrius,288,hunter,marksmanship,6,3,3
Vinksy,sargeras,288,hunter,marksmanship,6,3,3
Darforner,shandris,288,hunter,marksmanship,6,3,3
Stupedhunter,tichondrius,288,hunter,marksmanship,6,3,3
Zzackchicken,tichondrius,288,hunter,marksmanship,6,3,3
Tugh,maiev,288,hunter,marksmanship,6,3,3
Vashra,stormrage,288,hunter,marksmanship,6,3,3
Triggamikê,tichondrius,288,hunter,marksmanship,6,3,3
Daggétt,zuljin,288,hunter,marksmanship,6,3,3
Getgaped,bronzebeard,288,hunter,marksmanship,6,3,3
Rockendude,sargeras,288,hunter,marksmanship,6,3,3
Kaitoo,tichondrius,288,hunter,marksmanship,6,3,3
Rplover,malganis,288,hunter,marksmanship,6,3,3
Starsabov,emerald-dream,288,hunter,marksmanship,6,3,3
Bamfhunt,darkspear,288,hunter,marksmanship,6,3,3
Krelas,eldrethalas,288,hunter,marksmanship,6,3,3
Guncontrol,malganis,288,hunter,marksmanship,6,3,3
Playnogames,moon-guard,288,hunter,marksmanship,6,3,3
Mikey,exodar,288,hunter,marksmanship,6,3,3
Brumbuh,tichondrius,288,hunter,marksmanship,6,3,3
Sylvãnâs,tichondrius,288,hunter,marksmanship,6,3,3
Rivs,detheroc,288,hunter,marksmanship,6,3,3
Keliara,dunemaul,288,hunter,marksmanship,6,3,3
Cyboreg,stormrage,288,hunter,marksmanship,6,3,3
Casadora,dark-iron,288,hunter,marksmanship,6,3,3
Perfectcrit,area-52,288,hunter,marksmanship,6,3,3
Candîce,moon-guard,288,hunter,marksmanship,6,3,3
Eatmybow,nemesis,288,hunter,marksmanship,6,3,3
Waldrom,arathor,288,hunter,marksmanship,6,3,3
Eforas,ragnaros,288,hunter,marksmanship,6,3,3
Petmychode,illidan,288,hunter,marksmanship,6,3,3
Iresa,bleeding-hollow,288,hunter,marksmanship,6,3,3
Niche,jaedenar,288,hunter,marksmanship,6,3,3
Boxpatrol,ravencrest,288,hunter,marksmanship,6,3,3
Sosaho,sargeras,288,hunter,marksmanship,6,3,3
Deepbowjob,sargeras,288,hunter,marksmanship,6,3,3
Kallindo,sargeras,288,hunter,marksmanship,6,3,3
Ropivacaine,illidan,288,hunter,marksmanship,6,3,3
Racoon,spinebreaker,288,hunter,marksmanship,6,3,3
Wasteyou,tichondrius,288,hunter,marksmanship,6,3,3
Huerfyta,quelthalas,288,hunter,marksmanship,6,3,3
Physical,destromath,288,hunter,marksmanship,6,3,3
Innerhunt,aegwynn,288,hunter,marksmanship,6,3,3
Exabyssus,bleeding-hollow,288,hunter,marksmanship,6,3,3
Kong,tichondrius,288,hunter,marksmanship,6,3,3
Internade,frostmourne,288,hunter,marksmanship,6,3,3
Maxifier,tichondrius,288,hunter,marksmanship,6,3,3
Odratnuh,bleeding-hollow,288,hunter,marksmanship,6,3,3
Kansolly,tichondrius,288,hunter,marksmanship,6,3,3
Clait,frostmourne,288,hunter,marksmanship,6,3,3
Jackohun,quelthalas,288,hunter,marksmanship,6,3,3
Adowsol,kiljaeden,288,hunter,marksmanship,6,3,3
Wonshawt,tichondrius,288,hunter,marksmanship,6,3,3
Sereom,frostmourne,288,hunter,marksmanship,6,3,3
Chootembro,thunderlord,288,hunter,marksmanship,6,3,3
Airchick,frostmourne,288,hunter,marksmanship,6,3,3
Kormas,illidan,288,hunter,marksmanship,6,3,3
Iapsux,bleeding-hollow,288,hunter,marksmanship,6,3,3
Weegnomie,wyrmrest-accord,288,hunter,marksmanship,6,3,3
Zestia,tichondrius,288,hunter,marksmanship,6,3,3
Auset,aegwynn,288,hunter,marksmanship,6,3,3
Alliestrasza,azralon,288,hunter,marksmanship,6,3,3
Krane,alleria,288,hunter,marksmanship,6,3,3
Bloodyman,korgath,288,hunter,marksmanship,6,3,3
Rhovanni,ragnaros,288,hunter,marksmanship,6,3,3
Luckynoodlle,frostmourne,288,hunter,marksmanship,6,3,3
Laer,archimonde,288,hunter,marksmanship,6,3,3
Fruitenveg,frostmourne,288,hunter,marksmanship,6,3,3
Blakespace,area-52,288,hunter,marksmanship,6,3,3
Kargathx,ragnaros,288,hunter,marksmanship,6,3,3
Zeonas,tichondrius,288,hunter,marksmanship,6,3,3
Sufferiñg,doomhammer,288,hunter,marksmanship,6,3,3
Buzzkiller,sargeras,288,hunter,marksmanship,6,3,3
Kogger,frostmourne,288,hunter,marksmanship,6,3,3
Madjango,illidan,288,hunter,marksmanship,6,3,3
Graid,azralon,288,hunter,marksmanship,6,3,3
Bernelli,kelthuzad,288,hunter,marksmanship,6,3,3
Inked,frostmourne,288,hunter,marksmanship,6,3,3
Saphling,emerald-dream,288,hunter,marksmanship,6,3,3
Maximuhm,vashj,288,hunter,marksmanship,6,3,3
Bacin,tichondrius,288,hunter,marksmanship,6,3,3
Antily,kelthuzad,288,hunter,marksmanship,6,3,3
Iannieht,illidan,288,hunter,marksmanship,6,3,3
Thugbeast,tichondrius,288,hunter,marksmanship,6,3,3
Cloakedninja,illidan,288,hunter,marksmanship,6,3,3
Strudelshot,tichondrius,288,hunter,marksmanship,6,3,3
Arithrawn,area-52,288,hunter,marksmanship,6,3,3
Silvershot,emerald-dream,288,hunter,marksmanship,6,3,3
Gorhound,tichondrius,288,hunter,marksmanship,6,3,3
Sabanna,proudmoore,288,hunter,marksmanship,6,3,3
Tzoop,tichondrius,288,hunter,marksmanship,6,3,3
Amazoness,tichondrius,288,hunter,marksmanship,6,3,3
Carot,dalaran,288,hunter,marksmanship,6,3,3
Ÿöskë,tichondrius,288,hunter,marksmanship,6,3,3
Hitstickk,tichondrius,288,hunter,marksmanship,6,3,3
Yeaheh,area-52,288,hunter,marksmanship,6,3,3
Baoßun,thrall,288,hunter,marksmanship,6,3,3
Arröws,area-52,288,hunter,marksmanship,6,3,3
Traphouse,blackrock,288,hunter,marksmanship,6,3,3
Chimpx,moon-guard,288,hunter,marksmanship,6,3,3
Battleon,dalaran,288,hunter,marksmanship,6,3,3
Tichong,tichondrius,288,hunter,marksmanship,6,3,3
Muffhuntér,blackrock,288,hunter,marksmanship,6,3,3
Razer,anvilmar,288,hunter,marksmanship,9,4,5
Xpyroshot,area-52,288,hunter,marksmanship,9,4,5
Royshot,stormrage,288,hunter,marksmanship,7,3,4
Mojopojo,tichondrius,288,hunter,marksmanship,12,4,8
Snigskytte,dreadmaul,288,hunter,marksmanship,11,3,8
Konungr,zuljin,288,hunter,marksmanship,11,3,8
Prpl,sargeras,288,hunter,marksmanship,15,4,11
Surfbum,lightbringer,288,hunter,marksmanship,12,3,9
Princssdaizy,zuljin,288,hunter,marksmanship,12,3,9
Samloomis,ursin,288,hunter,marksmanship,12,3,9
Drysst,tichondrius,288,hunter,marksmanship,12,3,9
Ouchiies,barthilas,288,hunter,marksmanship,12,3,9
Quackattack,arthas,288,hunter,marksmanship,12,3,9
Davidböwie,stormreaver,288,hunter,marksmanship,12,3,9
Beastcraft,emerald-dream,288,hunter,marksmanship,12,3,9
Boltflux,nemesis,288,hunter,marksmanship,12,3,9
Zeedii,dalaran,288,hunter,marksmanship,12,3,9
Angelicarrow,area-52,288,hunter,marksmanship,12,3,9
Strixx,emerald-dream,288,hunter,marksmanship,12,3,9
Oua,queldorei,288,hunter,marksmanship,12,3,9
Sparkco,area-52,288,hunter,marksmanship,12,3,9
Xsparkys,kargath,288,hunter,marksmanship,12,3,9
Lesley,illidan,288,hunter,marksmanship,12,3,9
Skywrecker,bleeding-hollow,288,hunter,marksmanship,12,3,9
Hatara,quelthalas,288,hunter,marksmanship,12,3,9
Blarck,shattered-halls,288,hunter,marksmanship,12,3,9
Shablagoosh,zuljin,288,hunter,marksmanship,12,3,9
Heloran,maelstrom,288,hunter,marksmanship,12,3,9
Gustavitch,executus,288,hunter,marksmanship,12,3,9
Shifted,quelthalas,288,hunter,marksmanship,12,3,9
Hefty,azuremyst,288,hunter,marksmanship,12,3,9
Tmd,thrall,288,hunter,marksmanship,12,3,9
Duaalipaa,malganis,288,hunter,marksmanship,12,3,9
Sliperysaly,tichondrius,288,hunter,marksmanship,12,3,9
Durbìn,sargeras,288,hunter,marksmanship,12,3,9
Aerefix,frostmourne,288,hunter,marksmanship,12,3,9
Blaisian,frostmourne,288,hunter,marksmanship,12,3,9
Wadadly,malganis,288,hunter,marksmanship,12,3,9
Uro,illidan,288,hunter,marksmanship,12,3,9
Tastysauce,wyrmrest-accord,288,hunter,marksmanship,12,3,9
Alyzza,sargeras,288,hunter,marksmanship,12,3,9
Sásori,area-52,288,hunter,marksmanship,12,3,9
Exiun,sargeras,288,hunter,marksmanship,12,3,9
Lumbygoblin,illidan,288,hunter,marksmanship,13,3,10
Zarknoth,cenarius,288,hunter,marksmanship,18,3,15
Jgodsslayer,tichondrius,288,hunter,marksmanship,18,3,15
Cerébro,illidan,288,hunter,marksmanship,24,3,21
Ghazzghkuull,ragnaros,287,hunter,marksmanship,6,3,3
Kahunå,area-52,287,hunter,marksmanship,6,3,3
Talonwind,tanaris,287,hunter,marksmanship,6,3,3
Downtimes,illidan,287,hunter,marksmanship,6,3,3
Lapelada,ragnaros,287,hunter,marksmanship,6,3,3
Multicereal,quelthalas,287,hunter,marksmanship,6,3,3
Braindeadly,malganis,287,hunter,marksmanship,6,3,3
Tarbabies,mannoroth,287,hunter,marksmanship,12,3,9
Bumbow,tichondrius,287,hunter,marksmanship,12,3,9
Dragonlandy,stormrage,287,hunter,marksmanship,12,3,9
Darthwillie,cenarius,287,hunter,marksmanship,12,3,9
Allready,stormrage,287,hunter,marksmanship,12,3,9
Divinee,undermine,287,hunter,marksmanship,12,3,9
Slayemz,barthilas,287,hunter,marksmanship,12,3,9
Josthar,thrall,287,hunter,marksmanship,24,3,21
Irishnia,bleeding-hollow,286,hunter,marksmanship,6,3,3
Lorelåii,tichondrius,286,hunter,marksmanship,6,3,3
Purplebeaver,gorgonnash,286,hunter,marksmanship,12,3,9
Dashing,magtheridon,271,hunter,marksmanship,11,3,8
Mythman,area-52,255,hunter,marksmanship,14,4,10
Jamesmcgill,tichondrius,255,hunter,marksmanship,11,3,8
Tanneritez,bleeding-hollow,240,hunter,marksmanship,17,3,14
Yukiqtpie,barthilas,239,hunter,marksmanship,5,3,2
Evilmoe,zuluhed,239,hunter,marksmanship,5,3,2
Glôck,dalaran,239,hunter,marksmanship,11,3,8
Knowtraps,area-52,234,hunter,marksmanship,7,4,3
Druskritag,moon-guard,234,hunter,marksmanship,10,4,6
Demongirl,arathor,231,hunter,marksmanship,25,4,21
Almighty,trollbane,229,hunter,marksmanship,29,6,23
Noscoped,wildhammer,224,hunter,marksmanship,16,3,13
Downworlder,darkspear,223,hunter,marksmanship,8,3,5
Andrømeda,frostmourne,208,hunter,marksmanship,7,3,4
Lamb,undermine,202,hunter,marksmanship,11,4,7
Farverr,area-52,192,hunter,marksmanship,4,3,1
Traitorously,daggerspine,192,hunter,marksmanship,9,3,6
Blowedazchit,bonechewer,192,hunter,marksmanship,6,2,4
Hfn,stormrage,192,hunter,marksmanship,6,2,4
Alssong,tichondrius,192,hunter,marksmanship,6,2,4
Døctørmälitø,tichondrius,192,hunter,marksmanship,6,2,4
Fkurrules,frostmourne,192,hunter,marksmanship,6,2,4
Bôdon,illidan,192,hunter,marksmanship,6,2,4
Pichsolika,frostmourne,192,hunter,marksmanship,6,2,4
Firskin,frostmourne,192,hunter,marksmanship,6,2,4
Yortrox,ragnaros,192,hunter,marksmanship,6,2,4
Magvez,tichondrius,192,hunter,marksmanship,6,2,4
Gokissmywolf,moknathal,192,hunter,marksmanship,6,2,4
Noisetrader,illidan,192,hunter,marksmanship,6,2,4
Mordriva,azjolnerub,192,hunter,marksmanship,6,2,4
Jebote,frostmourne,192,hunter,marksmanship,6,2,4
Petmydog,aegwynn,192,hunter,marksmanship,6,2,4
Penelòpe,wyrmrest-accord,192,hunter,marksmanship,6,2,4
Camorcaist,stormrage,192,hunter,marksmanship,6,2,4
Anilora,wyrmrest-accord,192,hunter,marksmanship,6,2,4
Cefla,illidan,192,hunter,marksmanship,6,2,4
Tyraelias,kaelthas,192,hunter,marksmanship,6,2,4
Valcyoneus,dragonmaw,192,hunter,marksmanship,6,2,4
Léfty,nagrand,192,hunter,marksmanship,6,2,4
Whitemàne,dalaran,192,hunter,marksmanship,6,2,4
Huntugz,frostmourne,192,hunter,marksmanship,6,2,4
Huntgar,earthen-ring,192,hunter,marksmanship,6,2,4
Wartoz,dragonblight,192,hunter,marksmanship,6,2,4
Bowzørx,tichondrius,192,hunter,marksmanship,6,2,4
Fleshfeast,tichondrius,192,hunter,marksmanship,6,2,4
Ïkite,zuljin,192,hunter,marksmanship,6,2,4
Valdevenator,illidan,192,hunter,marksmanship,6,2,4
Haki,gallywix,192,hunter,marksmanship,6,2,4
Peppancini,wyrmrest-accord,192,hunter,marksmanship,6,2,4
Hárd,illidan,192,hunter,marksmanship,6,2,4
Lycanthropei,illidan,192,hunter,marksmanship,6,2,4
Warsh,anubarak,192,hunter,marksmanship,6,2,4
Ctrlaltdel,gundrak,192,hunter,marksmanship,6,2,4
Jaigo,stormrage,192,hunter,marksmanship,6,2,4
Shoccka,thrall,192,hunter,marksmanship,6,2,4
Nord,draka,192,hunter,marksmanship,6,2,4
Mtq,thrall,192,hunter,marksmanship,6,2,4
Crownchild,illidan,192,hunter,marksmanship,6,2,4
Voodoohunter,blood-furnace,192,hunter,marksmanship,6,2,4
Justhunter,moknathal,192,hunter,marksmanship,6,2,4
Lulafourdedo,stormrage,192,hunter,marksmanship,6,2,4
Glockin,zuljin,192,hunter,marksmanship,6,2,4
Aridias,mannoroth,192,hunter,marksmanship,6,2,4
Faldran,earthen-ring,192,hunter,marksmanship,6,2,4
Nixuis,stormrage,192,hunter,marksmanship,6,2,4
Holytrap,destromath,192,hunter,marksmanship,6,2,4
Salvatiel,stormrage,192,hunter,marksmanship,6,2,4
Tus,tichondrius,192,hunter,marksmanship,6,2,4
Áppóló,spinebreaker,192,hunter,marksmanship,6,2,4
Dikbender,tichondrius,192,hunter,marksmanship,6,2,4
Ezari,zuljin,192,hunter,marksmanship,6,2,4
Vitae,shattered-halls,192,hunter,marksmanship,6,2,4
Rëxx,moon-guard,192,hunter,marksmanship,6,2,4
Ilîiìîìiilil,bleeding-hollow,192,hunter,marksmanship,6,2,4
Angrypepe,bleeding-hollow,192,hunter,marksmanship,6,2,4
Actimetohunt,gundrak,192,hunter,marksmanship,6,2,4
Sleazyrider,azuremyst,192,hunter,marksmanship,6,2,4
Huntingyou,destromath,192,hunter,marksmanship,6,2,4
Lukara,darkspear,192,hunter,marksmanship,6,2,4
Jathriel,zuljin,192,hunter,marksmanship,6,2,4
Théw,tichondrius,192,hunter,marksmanship,6,2,4
Huntbodom,drakkari,192,hunter,marksmanship,6,2,4
Dreezzy,bleeding-hollow,192,hunter,marksmanship,6,2,4
Arantir,drakkari,192,hunter,marksmanship,6,2,4
Kïwwï,tichondrius,192,hunter,marksmanship,6,2,4
Happyhunting,sargeras,192,hunter,marksmanship,6,2,4
Xuxoo,nemesis,192,hunter,marksmanship,6,2,4
Latherel,bleeding-hollow,192,hunter,marksmanship,6,2,4
Kanta,bleeding-hollow,192,hunter,marksmanship,6,2,4
Saveawp,stormrage,192,hunter,marksmanship,6,2,4
Defacegg,illidan,192,hunter,marksmanship,6,2,4
Zeaks,emerald-dream,192,hunter,marksmanship,6,2,4
Namøscä,nemesis,192,hunter,marksmanship,6,2,4
Ramchi,burning-blade,192,hunter,marksmanship,6,2,4
Leaf,chromaggus,192,hunter,marksmanship,6,2,4
Angelfern,sargeras,192,hunter,marksmanship,6,2,4
Knator,area-52,192,hunter,marksmanship,6,2,4
Illweedx,kiljaeden,192,hunter,marksmanship,6,2,4
Geldyn,stormreaver,192,hunter,marksmanship,6,2,4
Arbos,ragnaros,192,hunter,marksmanship,6,2,4
Yembohi,queldorei,192,hunter,marksmanship,6,2,4
Muscletooth,moon-guard,192,hunter,marksmanship,6,2,4
Yonzo,area-52,192,hunter,marksmanship,6,2,4
Bloodrainia,ravencrest,192,hunter,marksmanship,6,2,4
Erebor,malganis,192,hunter,marksmanship,6,2,4
Inurah,malganis,192,hunter,marksmanship,6,2,4
Aimi,twisting-nether,192,hunter,marksmanship,6,2,4
Kreaytion,sargeras,192,hunter,marksmanship,6,2,4
Desdee,icecrown,192,hunter,marksmanship,6,2,4
Sobala,azralon,192,hunter,marksmanship,6,2,4
Amptx,tichondrius,192,hunter,marksmanship,6,2,4
Isitrng,aggramar,192,hunter,marksmanship,6,2,4
Pumpydumpy,malganis,192,hunter,marksmanship,6,2,4
Nughunter,area-52,192,hunter,marksmanship,6,2,4
Blury,tichondrius,192,hunter,marksmanship,6,2,4
Ayrana,tichondrius,192,hunter,marksmanship,6,2,4
Zhona,moon-guard,192,hunter,marksmanship,6,2,4
Àngèl,malganis,192,hunter,marksmanship,6,2,4
Regerts,sargeras,192,hunter,marksmanship,6,2,4
Córnell,tichondrius,192,hunter,marksmanship,6,2,4
Ðevil,ragnaros,192,hunter,marksmanship,6,2,4
Geeshot,area-52,192,hunter,marksmanship,6,2,4
Sergunter,area-52,192,hunter,marksmanship,6,2,4
Tuanorz,proudmoore,192,hunter,marksmanship,6,2,4
Percival,firetree,192,hunter,marksmanship,6,2,4
Lemmiewînkzz,sargeras,192,hunter,marksmanship,6,2,4
Zackmorris,kelthuzad,192,hunter,marksmanship,6,2,4
Commonbuck,area-52,192,hunter,marksmanship,6,2,4
Hideontrap,malganis,192,hunter,marksmanship,6,2,4
Symz,ragnaros,192,hunter,marksmanship,6,2,4
Ðecarlis,azralon,192,hunter,marksmanship,6,2,4
Thiccshawts,moon-guard,192,hunter,marksmanship,6,2,4
Kahtniss,quelthalas,192,hunter,marksmanship,6,2,4
Cazaaires,quelthalas,192,hunter,marksmanship,6,2,4
Fizzleegear,area-52,192,hunter,marksmanship,6,2,4
Terapista,area-52,192,hunter,marksmanship,6,2,4
Skolzero,azralon,192,hunter,marksmanship,6,2,4
Xxunderoath,frostwolf,192,hunter,marksmanship,6,2,4
Sinsix,akama,192,hunter,marksmanship,6,2,4
Doopers,kiljaeden,192,hunter,marksmanship,6,2,4
Thugio,sargeras,192,hunter,marksmanship,6,2,4
Gangstashot,burning-legion,192,hunter,marksmanship,6,2,4
Gadorim,kelthuzad,192,hunter,marksmanship,6,2,4
Cuchulláin,area-52,192,hunter,marksmanship,6,2,4
Rolandschitt,area-52,192,hunter,marksmanship,6,2,4
Stormwardenx,turalyon,192,hunter,marksmanship,6,2,4
Bendoon,sargeras,192,hunter,marksmanship,6,2,4
Brindlë,kelthuzad,192,hunter,marksmanship,11,3,8
Kîra,stormrage,192,hunter,marksmanship,16,3,13
Gunnpowder,malganis,192,hunter,marksmanship,12,2,10
Warrioress,illidan,192,hunter,marksmanship,12,2,10
Hunterish,area-52,192,hunter,marksmanship,12,2,10
Stïinck,azralon,192,hunter,marksmanship,12,2,10
Xulag,tichondrius,192,hunter,marksmanship,12,2,10
Jahvekhunter,area-52,192,hunter,marksmanship,12,2,10
Dojaqat,frostmourne,192,hunter,marksmanship,12,2,10
Sharpzy,jubeithos,192,hunter,marksmanship,12,2,10
Warpedshots,malganis,192,hunter,marksmanship,12,2,10
Littleagu,proudmoore,192,hunter,marksmanship,12,2,10
Killdred,bonechewer,192,hunter,marksmanship,12,2,10
Larts,fenris,192,hunter,marksmanship,12,2,10
Jmonger,runetotem,192,hunter,marksmanship,12,2,10
Hatros,stormrage,192,hunter,marksmanship,12,2,10
Otirrub,deathwing,192,hunter,marksmanship,12,2,10
Zumythriel,stormrage,192,hunter,marksmanship,12,2,10
Seekem,destromath,192,hunter,marksmanship,12,2,10
Luvtits,bonechewer,192,hunter,marksmanship,12,2,10
Sevitham,dalaran,192,hunter,marksmanship,12,2,10
Shafttrapper,queldorei,192,hunter,marksmanship,12,2,10
Eaglesx,skullcrusher,192,hunter,marksmanship,12,2,10
Findbind,altar-of-storms,192,hunter,marksmanship,12,2,10
Luffzy,barthilas,192,hunter,marksmanship,12,2,10
Chinchompas,bleeding-hollow,192,hunter,marksmanship,18,2,16
Griffox,frostwolf,191,hunter,marksmanship,4,3,1
Vaerromar,thunderlord,191,hunter,marksmanship,6,2,4
Rorrnus,blackwing-lair,191,hunter,marksmanship,6,2,4
Blindshotz,moon-guard,191,hunter,marksmanship,6,2,4
Sylviannas,frostmourne,191,hunter,marksmanship,6,2,4
Donchy,proudmoore,191,hunter,marksmanship,6,2,4
Dorg,azjolnerub,191,hunter,marksmanship,6,2,4
Wörg,elune,191,hunter,marksmanship,6,2,4
Actaeom,area-52,191,hunter,marksmanship,12,2,10
Ragehunter,scilla,191,hunter,marksmanship,12,2,10
ßonßon,stormrage,160,hunter,marksmanship,10,2,8
Hunntard,veknilash,159,hunter,marksmanship,5,2,3
Dropitëns,nemesis,159,hunter,marksmanship,5,2,3
Gonnujo,ragnaros,159,hunter,marksmanship,5,2,3
Mhyalî,moon-guard,159,hunter,marksmanship,5,2,3
Amorial,barthilas,159,hunter,marksmanship,5,2,3
Clintbartun,shadowsong,159,hunter,marksmanship,5,2,3
Thesloott,azshara,159,hunter,marksmanship,5,2,3
Dusle,azralon,138,hunter,marksmanship,8,3,5
Darthski,drenden,138,hunter,marksmanship,12,4,8
Pvrisxoxo,frostmourne,138,hunter,marksmanship,9,3,6
Huntersaul,dalvengyr,138,hunter,marksmanship,11,3,8
Tinylegzz,illidan,138,hunter,marksmanship,14,3,11
Winstônwolf,spinebreaker,138,hunter,marksmanship,19,4,15
Plsnobanmee,frostmourne,137,hunter,marksmanship,9,5,4
Swm,nazjatar,128,hunter,marksmanship,4,2,2
Yarthax,illidan,128,hunter,marksmanship,4,2,2
Mookvader,illidan,128,hunter,marksmanship,4,2,2
Lúthiel,azralon,127,hunter,marksmanship,8,2,6
Ïmprîsôñ,dalaran,96,hunter,marksmanship,3,2,1
Cesz,ragnaros,96,hunter,marksmanship,3,2,1
Shootr,darkspear,96,hunter,marksmanship,3,2,1
Bensonlmn,tichondrius,96,hunter,marksmanship,9,2,7
Htcrazykofwa,tichondrius,96,hunter,marksmanship,6,1,5
Slaughterr,kelthuzad,96,hunter,marksmanship,6,1,5
Ruvathir,wyrmrest-accord,96,hunter,marksmanship,6,1,5
Arawnz,emerald-dream,96,hunter,marksmanship,6,1,5
Coppersnout,wyrmrest-accord,96,hunter,marksmanship,6,1,5
Zirstorm,altar-of-storms,96,hunter,marksmanship,6,1,5
Zünma,tichondrius,96,hunter,marksmanship,6,1,5
Siimmplicitz,area-52,96,hunter,marksmanship,6,1,5
Rämbow,frostmourne,96,hunter,marksmanship,6,1,5
Legoretzlas,durotan,96,hunter,marksmanship,6,1,5
Blaptz,wyrmrest-accord,96,hunter,marksmanship,6,1,5
Hyena,kelthuzad,96,hunter,marksmanship,6,1,5
Samanta,blood-furnace,96,hunter,marksmanship,6,1,5
Jaidev,nemesis,96,hunter,marksmanship,6,1,5
Crazyshot,drakkari,96,hunter,marksmanship,6,1,5
Boongtokes,illidan,96,hunter,marksmanship,6,1,5
Gabitoqt,gallywix,96,hunter,marksmanship,6,1,5
Desarus,archimonde,96,hunter,marksmanship,6,1,5
Garkia,hyjal,96,hunter,marksmanship,6,1,5
Nightfall,azshara,96,hunter,marksmanship,6,1,5
Jumeog,stormscale,96,hunter,marksmanship,6,1,5
Exitwoundz,hyjal,96,hunter,marksmanship,6,1,5
Insönnia,azralon,96,hunter,marksmanship,6,1,5
Elaestel,moon-guard,96,hunter,marksmanship,6,1,5
Brutalhit,bonechewer,96,hunter,marksmanship,6,1,5
Autaila,thunderlord,96,hunter,marksmanship,6,1,5
Lemmetrap,illidan,96,hunter,marksmanship,6,1,5
Ashner,illidan,96,hunter,marksmanship,6,1,5
Seizedhunt,frostmourne,96,hunter,marksmanship,6,1,5
Fritzy,nazjatar,96,hunter,marksmanship,6,1,5
Hopsmatei,azralon,96,hunter,marksmanship,6,1,5
Cocobage,destromath,96,hunter,marksmanship,6,1,5
Laudion,quelthalas,96,hunter,marksmanship,6,1,5
Feignqt,illidan,96,hunter,marksmanship,6,1,5
Kkurama,area-52,96,hunter,marksmanship,6,1,5
Anndaria,tichondrius,96,hunter,marksmanship,6,1,5
Narukín,tichondrius,96,hunter,marksmanship,6,1,5
Ethùg,area-52,96,hunter,marksmanship,6,1,5
Dalzar,darkspear,96,hunter,marksmanship,6,1,5
Sarutovy,kelthuzad,96,hunter,marksmanship,6,1,5
Konflako,quelthalas,96,hunter,marksmanship,6,1,5
Shortbow,nordrassil,96,hunter,marksmanship,6,1,5
Shootdogg,mannoroth,96,hunter,marksmanship,6,1,5
Nodar,quelthalas,96,hunter,marksmanship,6,1,5
Fingamyquill,tichondrius,96,hunter,marksmanship,6,1,5
Saeculorum,azralon,96,hunter,marksmanship,6,1,5
Puppyghoul,malganis,96,hunter,marksmanship,6,1,5
Vilguz,illidan,96,hunter,marksmanship,6,1,5
Elknut,sargeras,96,hunter,marksmanship,6,1,5
Kiatus,nesingwary,96,hunter,marksmanship,6,1,5
Romro,norgannon,96,hunter,marksmanship,6,1,5
Bowbaggins,stormrage,96,hunter,marksmanship,6,1,5
Longshott,azralon,96,hunter,marksmanship,6,1,5
Hovahdo,proudmoore,96,hunter,marksmanship,6,1,5
Brändöncody,stormrage,96,hunter,marksmanship,6,1,5
Fawn,moon-guard,96,hunter,marksmanship,6,1,5
Rensv,frostmourne,96,hunter,marksmanship,6,1,5
Smackadoodlé,illidan,96,hunter,marksmanship,6,1,5
Darkarcher,hyjal,96,hunter,marksmanship,6,1,5
Arrowenn,zuljin,96,hunter,marksmanship,6,1,5
Solderboi,tichondrius,96,hunter,marksmanship,6,1,5
Hyora,tichondrius,96,hunter,marksmanship,6,1,5
Minnervva,malganis,96,hunter,marksmanship,6,1,5
Lailyann,sargeras,96,hunter,marksmanship,6,1,5
Clacktar,wyrmrest-accord,96,hunter,marksmanship,6,1,5
Savageshot,daggerspine,96,hunter,marksmanship,6,1,5
Wolfmastera,zuljin,96,hunter,marksmanship,6,1,5
Artilleria,quelthalas,96,hunter,marksmanship,6,1,5
Arin,suramar,96,hunter,marksmanship,6,1,5
Ikiteforgold,zuljin,96,hunter,marksmanship,6,1,5
Necroshotz,kul-tiras,96,hunter,marksmanship,6,1,5
Faceshots,tichondrius,96,hunter,marksmanship,6,1,5
Gunwalk,azjolnerub,96,hunter,marksmanship,6,1,5
Qua,perenolde,96,hunter,marksmanship,6,1,5
Maquire,tichondrius,96,hunter,marksmanship,6,1,5
Allerios,alleria,96,hunter,marksmanship,6,1,5
Staytrill,tichondrius,96,hunter,marksmanship,6,1,5
Cowboytroy,exodar,96,hunter,marksmanship,6,1,5
Hellcry,khadgar,96,hunter,marksmanship,6,1,5
Wínchester,stormrage,96,hunter,marksmanship,6,1,5
Wellfaír,area-52,96,hunter,marksmanship,6,1,5
Barginmeal,undermine,96,hunter,marksmanship,6,1,5
Lostkníght,ragnaros,96,hunter,marksmanship,6,1,5
Evemae,sargeras,96,hunter,marksmanship,6,1,5
Poizon,gorefiend,96,hunter,marksmanship,6,1,5
Shootermgavn,frostmourne,96,hunter,marksmanship,6,1,5
Luthairian,sargeras,96,hunter,marksmanship,6,1,5
Panchovill,ragnaros,96,hunter,marksmanship,6,1,5
Traxêx,nemesis,96,hunter,marksmanship,6,1,5
Pinheira,nemesis,96,hunter,marksmanship,6,1,5
Nikolov,proudmoore,96,hunter,marksmanship,6,1,5
Citizen,dragonmaw,96,hunter,marksmanship,6,1,5
Dogtagluke,stormrage,96,hunter,marksmanship,6,1,5
Terezhunt,tichondrius,96,hunter,marksmanship,6,1,5
Ruhak,windrunner,96,hunter,marksmanship,6,1,5
Naturan,drakkari,96,hunter,marksmanship,6,1,5
Zral,dragonmaw,96,hunter,marksmanship,6,1,5
Biehuixin,tichondrius,96,hunter,marksmanship,6,1,5
Prozerpine,tichondrius,96,hunter,marksmanship,6,1,5
Clydebarro,sargeras,96,hunter,marksmanship,6,1,5
Nickaz,frostmourne,96,hunter,marksmanship,8,1,7
Missedshot,frostmourne,96,hunter,marksmanship,12,1,11
Kofan,darkspear,96,hunter,marksmanship,12,1,11
Lawyernickk,thrall,96,hunter,marksmanship,12,1,11
Hawneyduo,skullcrusher,96,hunter,marksmanship,12,1,11
Jacobsladder,illidan,96,hunter,marksmanship,12,1,11
Tarapandas,kilrogg,96,hunter,marksmanship,12,1,11
Gorthmog,daggerspine,96,hunter,marksmanship,12,1,11
Bophadeaz,sargeras,96,hunter,marksmanship,12,1,11
Xalmoinmybow,illidan,96,hunter,marksmanship,12,1,11
Elanor,feathermoon,96,hunter,marksmanship,18,1,17
Strixis,blood-furnace,95,hunter,marksmanship,6,1,5
Trionias,malfurion,79,hunter,marksmanship,5,1,4
Bownappetite,bleeding-hollow,79,hunter,marksmanship,5,1,4
Setbackhunt,illidan,79,hunter,marksmanship,5,1,4
Huntsmate,tichondrius,64,hunter,marksmanship,4,1,3
Coffetaum,illidan,64,hunter,marksmanship,4,1,3
Raymose,tichondrius,64,hunter,marksmanship,4,1,3
Creatuuree,zuljin,64,hunter,marksmanship,4,1,3
Nyloc,dalvengyr,64,hunter,marksmanship,4,1,3
Archemp,stormrage,64,hunter,marksmanship,4,1,3
Boyarsky,area-52,48,hunter,marksmanship,3,1,2
Killarth,quelthalas,48,hunter,marksmanship,3,1,2
Ahncheolsoo,tichondrius,42,hunter,marksmanship,11,2,9
Lovedietdew,borean-tundra,42,hunter,marksmanship,15,2,13
Dapoosyx,tichondrius,31,hunter,marksmanship,2,1,1
Suntail,dalaran,2208,hunter,survival,111,58,53
Saiiph,bleeding-hollow,2169,hunter,survival,144,74,70
Cëb,stormrage,2157,hunter,survival,168,84,84
Disciple,darkspear,2152,hunter,survival,74,43,31
Buffmm,kelthuzad,2130,hunter,survival,90,46,44
Cndavyjones,akama,2130,hunter,survival,138,68,70
Hotmuscleman,tichondrius,2127,hunter,survival,74,45,29
Malukaca,azralon,2121,hunter,survival,137,69,68
Capncams,emerald-dream,2120,hunter,survival,130,68,62
Missedmytrap,draenor,2109,hunter,survival,71,44,27
Cadencex,stormrage,2101,hunter,survival,141,71,70
Kansolly,tichondrius,2091,hunter,survival,111,59,52
Aimbotmir,zuljin,2083,hunter,survival,86,40,46
Bonquiesha,area-52,2074,hunter,survival,49,34,15
Pridefulz,stormrage,2062,hunter,survival,170,85,85
Gloomy,dark-iron,2054,hunter,survival,54,41,13
Ferex,tichondrius,2048,hunter,survival,69,42,27
Legoelass,emerald-dream,2040,hunter,survival,191,105,86
Djtraphouse,stormrage,2013,hunter,survival,132,67,65
Kubu,emerald-dream,2012,hunter,survival,133,83,50
Ungrella,malganis,2001,hunter,survival,81,44,37
Wmsgs,tichondrius,1998,hunter,survival,201,99,102
Töxic,dalaran,1996,hunter,survival,73,43,30
Dijhoni,moon-guard,1996,hunter,survival,137,72,65
Survchris,bleeding-hollow,1994,hunter,survival,79,44,35
Noimnotokay,tichondrius,1992,hunter,survival,113,57,56
Pathofsexile,tichondrius,1989,hunter,survival,224,119,105
Maxiam,frostmourne,1989,hunter,survival,71,37,34
Nearly,wyrmrest-accord,1987,hunter,survival,79,40,39
Queríde,emerald-dream,1982,hunter,survival,71,50,21
Veyronnx,stormrage,1980,hunter,survival,108,62,46
Budika,ragnaros,1973,hunter,survival,42,30,12
Dyucol,tichondrius,1971,hunter,survival,172,98,74
Hamslapper,shattered-hand,1971,hunter,survival,135,66,69
Bicmex,sargeras,1970,hunter,survival,42,29,13
Xyzv,tichondrius,1965,hunter,survival,81,41,40
Coggenda,sargeras,1964,hunter,survival,264,145,119
Hwslol,tichondrius,1964,hunter,survival,154,84,70
Pokìmane,tichondrius,1961,hunter,survival,98,62,36
Galavant,frostmourne,1960,hunter,survival,98,52,46
Lèkïnhø,azralon,1953,hunter,survival,84,42,42
Aurelx,tichondrius,1950,hunter,survival,48,32,16
Koupon,tichondrius,1949,hunter,survival,131,65,66
Briggsx,sargeras,1948,hunter,survival,54,29,25
Endsnear,stormrage,1944,hunter,survival,126,61,65
Sikhunt,frostmourne,1939,hunter,survival,60,35,25
Ynoit,sargeras,1939,hunter,survival,94,49,45
Robotwo,illidan,1937,hunter,survival,54,36,18
Neverturtlex,tichondrius,1929,hunter,survival,42,24,18
Anisphia,tichondrius,1928,hunter,survival,281,150,131
Foxyhood,ragnaros,1927,hunter,survival,143,76,67
Dirtysoap,sargeras,1918,hunter,survival,66,32,34
Dwx,bleeding-hollow,1915,hunter,survival,84,44,40
Leonilc,tichondrius,1907,hunter,survival,78,36,42
Queride,area-52,1902,hunter,survival,66,31,35
Fictìon,kelthuzad,1895,hunter,survival,58,32,26
Stinkyfob,barthilas,1890,hunter,survival,72,41,31
Møéÿsgïrîxø,tichondrius,1888,hunter,survival,31,20,11
Otii,tichondrius,1880,hunter,survival,172,82,90
Drasen,deathwing,1874,hunter,survival,54,30,24
Bergy,thrall,1873,hunter,survival,54,30,24
Kzmo,gnomeregan,1870,hunter,survival,30,23,7
Chimeralol,area-52,1869,hunter,survival,126,79,47
Nishinos,tichondrius,1868,hunter,survival,297,152,145
Notnunca,tichondrius,1865,hunter,survival,66,34,32
Jalinhabbei,azralon,1862,hunter,survival,53,28,25
Dirtysoap,tichondrius,1861,hunter,survival,63,31,32
Saltstream,tichondrius,1860,hunter,survival,114,53,61
Gvoo,tichondrius,1858,hunter,survival,36,28,8
Covlol,illidan,1857,hunter,survival,42,21,21
Runecrossbow,barthilas,1855,hunter,survival,162,79,83
Destrumz,zuljin,1855,hunter,survival,66,31,35
Tyjes,stormrage,1851,hunter,survival,75,41,34
Chiline,frostmourne,1849,hunter,survival,54,29,25
Truckrsaurus,tichondrius,1849,hunter,survival,105,56,49
Ikiteforfood,zuljin,1847,hunter,survival,32,20,12
Kelarcia,moon-guard,1846,hunter,survival,65,29,36
Cadenxr,bleeding-hollow,1844,hunter,survival,38,25,13
Pylorih,area-52,1842,hunter,survival,51,35,16
Neonjz,ragnaros,1841,hunter,survival,66,31,35
Raef,azralon,1838,hunter,survival,72,38,34
Ordius,azralon,1837,hunter,survival,60,33,27
Ssds,sargeras,1834,hunter,survival,42,26,16
Foxwalk,nemesis,1834,hunter,survival,70,33,37
Mørødox,sargeras,1832,hunter,survival,30,23,7
Fizzleegear,area-52,1831,hunter,survival,189,92,97
Exhausted,blackrock,1829,hunter,survival,90,38,52
Sobit,tichondrius,1827,hunter,survival,36,23,13
Goonsh,tichondrius,1826,hunter,survival,48,32,16
Mlemily,stormrage,1826,hunter,survival,47,31,16
Éshen,illidan,1826,hunter,survival,101,53,48
Effyh,emerald-dream,1825,hunter,survival,176,89,87
Aaggros,sargeras,1825,hunter,survival,42,20,22
Bjornwald,thrall,1824,hunter,survival,410,214,196
Angrybow,ragnaros,1821,hunter,survival,36,25,11
Misogynistaf,tichondrius,1821,hunter,survival,40,22,18
Thoromel,wyrmrest-accord,1820,hunter,survival,66,33,33
Shootin,frostmourne,1817,hunter,survival,60,34,26
Pivott,wyrmrest-accord,1817,hunter,survival,307,167,140
Alphaqt,dethecus,1816,hunter,survival,48,27,21
Savagerko,illidan,1816,hunter,survival,75,42,33
Concur,frostmourne,1816,hunter,survival,132,69,63
Kisuke,khaz-modan,1815,hunter,survival,54,34,20
Trapula,tichondrius,1814,hunter,survival,84,46,38
Terapista,area-52,1813,hunter,survival,90,45,45
Leaku,illidan,1810,hunter,survival,64,41,23
Axezul,tichondrius,1810,hunter,survival,78,45,33
Emart,bloodhoof,1810,hunter,survival,69,32,37
Percival,firetree,1809,hunter,survival,48,25,23
Joón,moon-guard,1808,hunter,survival,43,26,17
Jagaerz,emerald-dream,1808,hunter,survival,42,23,19
Krømatik,tichondrius,1807,hunter,survival,42,23,19
Adjusted,frostmourne,1802,hunter,survival,36,21,15
Ratonh,ragnaros,1801,hunter,survival,156,88,68
Huntmon,nemesis,1800,hunter,survival,48,31,17
Gabiña,tichondrius,1800,hunter,survival,311,154,157
Jîñßæçhïñæ,sargeras,1800,hunter,survival,66,29,37
Moroally,sargeras,1799,hunter,survival,42,25,17
Kensho,illidan,1798,hunter,survival,73,33,40
Carnidon,area-52,1796,hunter,survival,193,97,96
Caiodluffy,malganis,1791,hunter,survival,78,41,37
Hibyexo,illidan,1788,hunter,survival,42,27,15
Lawyerpbj,tichondrius,1788,hunter,survival,42,21,21
Skàdii,tichondrius,1778,hunter,survival,115,63,52
Lenacraft,frostmourne,1776,hunter,survival,54,31,23
Buffnac,tichondrius,1775,hunter,survival,54,25,29
Sniffler,barthilas,1772,hunter,survival,42,19,23
Acres,emerald-dream,1765,hunter,survival,66,32,34
Sylvanne,sargeras,1762,hunter,survival,57,28,29
Douggigadome,illidan,1761,hunter,survival,36,21,15
Pathed,azralon,1761,hunter,survival,54,31,23
Woriath,quelthalas,1761,hunter,survival,96,50,46
Finito,bladefist,1760,hunter,survival,279,136,143
Kimchishotxo,tichondrius,1756,hunter,survival,41,22,19
Sensator,barthilas,1753,hunter,survival,58,33,25
Vlf,tichondrius,1753,hunter,survival,60,30,30
Ingridaniela,aegwynn,1749,hunter,survival,36,25,11
Henroyer,quelthalas,1733,hunter,survival,48,30,18
Envoltorio,ragnaros,1732,hunter,survival,54,30,24
Svhunt,frostmourne,1727,hunter,survival,37,21,16
Peppancini,wyrmrest-accord,1725,hunter,survival,53,34,19
Vigon,stormrage,1725,hunter,survival,111,62,49
Wvwvwvwvwvww,stormrage,1721,hunter,survival,42,24,18
Buttercocoa,kelthuzad,1712,hunter,survival,36,18,18
Stevemonday,stormrage,1711,hunter,survival,96,53,43
Focús,laughing-skull,1711,hunter,survival,90,42,48
Henhøuse,illidan,1710,hunter,survival,54,25,29
Yeahimsad,tichondrius,1709,hunter,survival,24,18,6
Limpingspoon,kelthuzad,1709,hunter,survival,144,83,61
Garfieldbb,tichondrius,1709,hunter,survival,48,24,24
Soyos,sargeras,1707,hunter,survival,116,64,52
Sartel,tichondrius,1706,hunter,survival,190,93,97
Názzul,area-52,1705,hunter,survival,30,18,12
Partz,darkspear,1702,hunter,survival,56,35,21
Poston,ragnaros,1701,hunter,survival,111,55,56
Javlinz,thrall,1701,hunter,survival,44,20,24
Trevyx,aegwynn,1700,hunter,survival,66,39,27
Scytsbow,illidan,1700,hunter,survival,48,26,22
Samcro,rivendare,1700,hunter,survival,65,33,32
Toxarch,aggramar,1698,hunter,survival,48,26,22
Yip,moon-guard,1698,hunter,survival,39,20,19
Spinze,stormrage,1697,hunter,survival,35,23,12
Xtralitê,tichondrius,1696,hunter,survival,50,38,12
Bbaronsamedi,darkspear,1693,hunter,survival,51,27,24
Plainrain,tichondrius,1691,hunter,survival,36,23,13
Gnarwallz,stormrage,1691,hunter,survival,60,32,28
Saelym,arthas,1690,hunter,survival,36,18,18
Táká,quelthalas,1689,hunter,survival,60,38,22
Knewbee,emerald-dream,1689,hunter,survival,69,37,32
Noxtis,kiljaeden,1689,hunter,survival,36,18,18
Arrów,duskwood,1688,hunter,survival,36,18,18
Boogiemas,akama,1686,hunter,survival,30,20,10
Zêrø,moon-guard,1685,hunter,survival,30,20,10
Budgetben,stormrage,1682,hunter,survival,33,19,14
Blåker,bleeding-hollow,1682,hunter,survival,96,49,47
Nussyo,tichondrius,1679,hunter,survival,54,26,28
Grandpopjim,illidan,1678,hunter,survival,36,20,16
Snowynightt,proudmoore,1678,hunter,survival,174,86,88
Mambothehunt,stormrage,1677,hunter,survival,60,25,35
Róckzero,quelthalas,1675,hunter,survival,181,89,92
Shablagoosh,zuljin,1672,hunter,survival,45,23,22
Arsk,ragnaros,1670,hunter,survival,45,19,26
Dju,stormrage,1665,hunter,survival,60,27,33
Interleukin,frostwolf,1664,hunter,survival,244,132,112
Crypy,illidan,1664,hunter,survival,48,24,24
Trapgodxo,moon-guard,1658,hunter,survival,27,19,8
Fleche,aggramar,1658,hunter,survival,30,20,10
Wingclippin,stormrage,1656,hunter,survival,36,22,14
Viólenc,tichondrius,1654,hunter,survival,48,25,23
Reeiko,ragnaros,1653,hunter,survival,42,25,17
Ganemdar,sargeras,1653,hunter,survival,57,22,35
Frêäkk,ragnaros,1649,hunter,survival,39,21,18
Ajacs,zuljin,1647,hunter,survival,35,24,11
Undien,area-52,1647,hunter,survival,60,35,25
Yolloswag,tichondrius,1645,hunter,survival,126,69,57
Survïvalïst,bleeding-hollow,1643,hunter,survival,35,21,14
Krøww,azralon,1642,hunter,survival,39,22,17
Clawdio,ragnaros,1641,hunter,survival,114,60,54
Krouno,ragnaros,1641,hunter,survival,48,25,23
Ryukotsu,tichondrius,1641,hunter,survival,49,24,25
Bendotexe,stormrage,1638,hunter,survival,36,21,15
Iyne,stormrage,1635,hunter,survival,36,23,13
Asarden,jubeithos,1635,hunter,survival,78,44,34
Downer,antonidas,1635,hunter,survival,71,38,33
Huntardadoo,nemesis,1634,hunter,survival,45,23,22
Covloltrap,illidan,1633,hunter,survival,24,21,3
Vhelkan,senjin,1632,hunter,survival,42,26,16
Nimeer,tichondrius,1632,hunter,survival,82,45,37
Moartraps,zuljin,1631,hunter,survival,42,24,18
Nightarrows,area-52,1626,hunter,survival,41,24,17
Fälke,stormrage,1626,hunter,survival,42,23,19
Hazzeth,thrall,1625,hunter,survival,30,19,11
Glockin,zuljin,1625,hunter,survival,30,17,13
Bigbillx,tichondrius,1623,hunter,survival,30,17,13
Shakeasaurus,sargeras,1622,hunter,survival,42,20,22
Viòlenc,tichondrius,1621,hunter,survival,41,24,17
Skyland,tichondrius,1621,hunter,survival,60,32,28
Dazarrow,burning-blade,1621,hunter,survival,47,20,27
Køjo,emerald-dream,1620,hunter,survival,50,31,19
Mxabyycc,tichondrius,1619,hunter,survival,60,33,27
Shinhyez,tichondrius,1618,hunter,survival,42,21,21
Awârz,drakkari,1615,hunter,survival,44,27,17
Cuddlestomp,magtheridon,1614,hunter,survival,46,24,22
Kaitoo,tichondrius,1613,hunter,survival,59,32,27
Huntingjutsu,kelthuzad,1612,hunter,survival,53,34,19
Xenonviper,bleeding-hollow,1612,hunter,survival,114,59,55
Blackdevil,magtheridon,1612,hunter,survival,54,25,29
Mmx,whisperwind,1611,hunter,survival,67,40,27
Swordshot,moon-guard,1611,hunter,survival,109,55,54
Uhm,laughing-skull,1610,hunter,survival,106,59,47
Fkurrules,frostmourne,1608,hunter,survival,109,59,50
Haemøphilus,area-52,1606,hunter,survival,36,21,15
Killshøtß,tichondrius,1604,hunter,survival,102,51,51
Tøkÿöghøül,agamaggan,1603,hunter,survival,30,19,11
Nicochan,senjin,1603,hunter,survival,76,34,42
Schurk,illidan,1602,hunter,survival,120,64,56
Adobo,garona,1600,hunter,survival,30,21,9
Zakorai,thrall,1600,hunter,survival,146,85,61
Imapacifist,barthilas,1600,hunter,survival,69,37,32
Nandorius,proudmoore,1599,hunter,survival,78,38,40
Rojpube,frostmourne,1596,hunter,survival,35,17,18
Apokryph,stormrage,1595,hunter,survival,94,65,29
Mckim,tichondrius,1595,hunter,survival,47,23,24
Kukulkan,haomarush,1592,hunter,survival,132,71,61
Arcobaleno,tichondrius,1592,hunter,survival,36,19,17
Keelif,arthas,1588,hunter,survival,29,17,12
Stylebende,tichondrius,1588,hunter,survival,42,22,20
Noxickk,sargeras,1587,hunter,survival,30,19,11
Squeakerx,sargeras,1585,hunter,survival,29,19,10
Liekis,darkspear,1585,hunter,survival,66,27,39
Wildoldman,stormrage,1583,hunter,survival,24,17,7
Jésús,dalaran,1581,hunter,survival,33,17,16
Wharble,illidan,1578,hunter,survival,60,35,25
Arazian,stormrage,1578,hunter,survival,52,29,23
Cybella,darkspear,1578,hunter,survival,53,26,27
Xtina,drakkari,1577,hunter,survival,71,40,31
Randël,nemesis,1576,hunter,survival,77,43,34
Helïos,drakkari,1576,hunter,survival,54,29,25
Hrywnn,azralon,1573,hunter,survival,236,125,111
Bigiesmalls,moon-guard,1572,hunter,survival,54,28,26
Titanaxis,tichondrius,1572,hunter,survival,266,136,130
Lovethabeans,zangarmarsh,1571,hunter,survival,59,35,24
Xebbec,sargeras,1571,hunter,survival,80,43,37
Drifting,bleeding-hollow,1569,hunter,survival,66,37,29
Warhog,wyrmrest-accord,1568,hunter,survival,67,35,32
Dirtypolee,bleeding-hollow,1568,hunter,survival,46,24,22
Fabfilter,tichondrius,1564,hunter,survival,40,21,19
Pedropete,barthilas,1564,hunter,survival,42,17,25
Vinnieone,kiljaeden,1561,hunter,survival,30,20,10
Ryohlin,sargeras,1561,hunter,survival,54,32,22
Mckennagrace,tichondrius,1558,hunter,survival,54,29,25
Huntranger,malganis,1555,hunter,survival,53,28,25
Réxon,quelthalas,1555,hunter,survival,117,53,64
Ripsurvival,area-52,1554,hunter,survival,46,27,19
Aheefeog,proudmoore,1553,hunter,survival,39,23,16
Lfg,bleeding-hollow,1553,hunter,survival,53,31,22
Kimbaa,tichondrius,1553,hunter,survival,83,41,42
Huntasaurus,saurfang,1553,hunter,survival,66,32,34
Hildebald,moon-guard,1549,hunter,survival,64,37,27
Shooting,sargeras,1548,hunter,survival,111,59,52
Demtings,dark-iron,1545,hunter,survival,50,21,29
Equilibrium,tol-barad,1544,hunter,survival,147,76,71
Prv,stormrage,1542,hunter,survival,36,23,13
Dephobius,azralon,1540,hunter,survival,71,37,34
Legalt,tichondrius,1539,hunter,survival,80,42,38
Violénc,tichondrius,1538,hunter,survival,46,18,28
Lyler,tichondrius,1535,hunter,survival,57,32,25
Opsi,ragnaros,1535,hunter,survival,58,27,31
Trapdaddyx,thrall,1534,hunter,survival,24,16,8
Darkvicious,area-52,1532,hunter,survival,53,27,26
Viiu,sargeras,1528,hunter,survival,24,16,8
Arrowmatic,frostmourne,1527,hunter,survival,24,16,8
Exh,tichondrius,1527,hunter,survival,107,52,55
Holbrook,greymane,1526,hunter,survival,35,21,14
Berenal,moon-guard,1525,hunter,survival,162,77,85
Sativ,moknathal,1524,hunter,survival,54,27,27
Offensive,dragonmaw,1522,hunter,survival,49,28,21
Dorkins,azralon,1521,hunter,survival,75,35,40
Meowtard,kaelthas,1520,hunter,survival,66,31,35
Rhyzen,drenden,1519,hunter,survival,30,18,12
Dooper,malfurion,1518,hunter,survival,99,47,52
Brewster,burning-legion,1517,hunter,survival,30,16,14
Ifoxs,bleeding-hollow,1517,hunter,survival,30,16,14
Ronnïn,proudmoore,1517,hunter,survival,42,21,21
Lilgayjared,kelthuzad,1513,hunter,survival,64,39,25
Trap,vashj,1512,hunter,survival,36,21,15
Ceejaee,tichondrius,1511,hunter,survival,66,31,35
Mateko,amanthul,1510,hunter,survival,74,35,39
Ajira,stormrage,1504,hunter,survival,63,34,29
Jubulba,frostwolf,1502,hunter,survival,24,16,8
Kurnos,hyjal,1500,hunter,survival,46,27,19
Spromix,ragnaros,1500,hunter,survival,42,23,19
Pfizershot,tichondrius,1496,hunter,survival,54,28,26
Fâmôûs,tichondrius,1495,hunter,survival,36,19,17
Tharoks,tichondrius,1495,hunter,survival,60,30,30
Gilæd,kelthuzad,1493,hunter,survival,41,21,20
Nigthunt,quelthalas,1491,hunter,survival,69,39,30
Dogwoöd,emerald-dream,1488,hunter,survival,30,16,14
Met,dentarg,1488,hunter,survival,56,26,30
Fuzzypjs,stormrage,1486,hunter,survival,53,34,19
Kekkww,hyjal,1486,hunter,survival,40,17,23
Trumpmerica,illidan,1486,hunter,survival,58,20,38
Woeisyou,stormrage,1484,hunter,survival,48,23,25
Darkèlfo,azralon,1483,hunter,survival,64,39,25
Crongar,magtheridon,1480,hunter,survival,36,18,18
Bambii,fizzcrank,1479,hunter,survival,63,32,31
Fangtreason,sargeras,1478,hunter,survival,42,22,20
Rooman,ragnaros,1477,hunter,survival,48,24,24
Triplethreat,bleeding-hollow,1475,hunter,survival,98,52,46
Elmoon,zuljin,1474,hunter,survival,36,18,18
Civvo,dalaran,1472,hunter,survival,81,42,39
Rúdrá,area-52,1468,hunter,survival,145,76,69
Eliandriss,quelthalas,1468,hunter,survival,70,33,37
Liñcoln,sargeras,1467,hunter,survival,34,18,16
Altarare,ragnaros,1467,hunter,survival,279,135,144
Gadorim,kelthuzad,1465,hunter,survival,133,63,70
Alby,deathwing,1459,hunter,survival,67,33,34
Kaawhii,stormrage,1457,hunter,survival,24,18,6
Kyoü,drakkari,1457,hunter,survival,64,41,23
Dversive,nagrand,1452,hunter,survival,33,18,15
Shadeckz,stormrage,1451,hunter,survival,80,36,44
Volkr,bleeding-hollow,1450,hunter,survival,102,51,51
Iol,blades-edge,1448,hunter,survival,67,31,36
Platonium,stormrage,1445,hunter,survival,44,27,17
Darkarrow,hyjal,1443,hunter,survival,67,38,29
Fallacies,moon-guard,1443,hunter,survival,206,107,99
Shtealo,ragnaros,1443,hunter,survival,60,31,29
Mayamia,ragnaros,1442,hunter,survival,60,28,32
Core,gorefiend,1442,hunter,survival,45,21,24
Seanpennis,barthilas,1437,hunter,survival,24,15,9
Soukken,ragnaros,1437,hunter,survival,36,18,18
Yiyixx,tichondrius,1437,hunter,survival,30,15,15
Petrà,tichondrius,1436,hunter,survival,30,15,15
Rimjobranger,bleeding-hollow,1433,hunter,survival,48,23,25
Jarhar,nesingwary,1432,hunter,survival,96,44,52
Toozz,frostmourne,1431,hunter,survival,24,15,9
Rayuwa,azralon,1431,hunter,survival,140,70,70
Violenc,tichondrius,1428,hunter,survival,30,15,15
That,tichondrius,1428,hunter,survival,46,20,26
Daxar,ragnaros,1428,hunter,survival,42,18,24
Raiku,aggramar,1427,hunter,survival,42,20,22
Quepop,demon-soul,1426,hunter,survival,48,28,20
Ivansotes,quelthalas,1426,hunter,survival,45,22,23
Dudemanyeah,black-dragonflight,1426,hunter,survival,112,54,58
Kula,haomarush,1424,hunter,survival,52,24,28
Ophois,lightbringer,1424,hunter,survival,50,19,31
Shytshot,dalaran,1423,hunter,survival,67,34,33
Rvn,kelthuzad,1422,hunter,survival,30,15,15
Grizzlydeath,stormrage,1421,hunter,survival,54,33,21
Henesis,sargeras,1421,hunter,survival,54,28,26
Anaebody,stormrage,1420,hunter,survival,24,16,8
Soulwarden,haomarush,1417,hunter,survival,36,17,19
Exxonerous,sargeras,1414,hunter,survival,72,37,35
Krimzus,hyjal,1414,hunter,survival,71,35,36
Audiofly,tichondrius,1413,hunter,survival,115,63,52
Hankjr,thunderlord,1410,hunter,survival,167,94,73
Tejodite,thrall,1407,hunter,survival,42,20,22
Weedhoof,barthilas,1406,hunter,survival,66,36,30
Evilfury,tichondrius,1406,hunter,survival,184,90,94
Sukr,korgath,1406,hunter,survival,122,59,63
Jawbreakër,tichondrius,1405,hunter,survival,56,27,29
Ogamì,aegwynn,1404,hunter,survival,46,28,18
Aniraza,ragnaros,1404,hunter,survival,33,18,15
Htniss,tichondrius,1401,hunter,survival,60,28,32
Hunterdemond,ragnaros,1397,hunter,survival,101,49,52
Animityx,illidan,1396,hunter,survival,45,23,22
Kenjipoo,tichondrius,1395,hunter,survival,30,15,15
Gildthorn,frostmourne,1394,hunter,survival,60,31,29
Azx,tichondrius,1389,hunter,survival,60,25,35
Hawkethorn,moon-guard,1388,hunter,survival,92,42,50
Zänich,tichondrius,1387,hunter,survival,36,18,18
Sufutih,proudmoore,1385,hunter,survival,47,21,26
Toross,stormscale,1379,hunter,survival,73,29,44
Bolognã,tichondrius,1378,hunter,survival,29,15,14
Vilguz,illidan,1378,hunter,survival,83,39,44
Kelx,azralon,1372,hunter,survival,36,17,19
Figurinet,sargeras,1369,hunter,survival,30,19,11
Killconfirm,sargeras,1369,hunter,survival,59,24,35
Xuxoo,nemesis,1368,hunter,survival,30,16,14
Fìebs,queldorei,1368,hunter,survival,53,25,28
Pokeahuntasz,frostmourne,1367,hunter,survival,42,24,18
Pdg,ragnaros,1365,hunter,survival,66,35,31
Navagee,tichondrius,1364,hunter,survival,47,25,22
Vanthel,ragnaros,1363,hunter,survival,85,43,42
Gichiwalrus,emerald-dream,1362,hunter,survival,72,40,32
Thalrae,quelthalas,1361,hunter,survival,60,29,31
Tuohnosaj,sargeras,1358,hunter,survival,126,57,69
Wetpeach,frostmourne,1357,hunter,survival,58,29,29
Gunka,illidan,1349,hunter,survival,35,17,18
Lavo,borean-tundra,1348,hunter,survival,37,16,21
Xfo,bleeding-hollow,1346,hunter,survival,42,25,17
Lamerpvp,tichondrius,1343,hunter,survival,18,14,4
Darkshady,tichondrius,1343,hunter,survival,24,14,10
Zizzo,eonar,1343,hunter,survival,48,23,25
Ickstab,illidan,1342,hunter,survival,18,14,4
Tumerok,barthilas,1342,hunter,survival,24,14,10
Adroi,tichondrius,1341,hunter,survival,36,14,22
Champjones,senjin,1339,hunter,survival,24,14,10
Riivali,quelthalas,1338,hunter,survival,66,32,34
Jollycraze,spirestone,1337,hunter,survival,18,14,4
Stepzback,malganis,1337,hunter,survival,24,14,10
Anêmos,ragnaros,1337,hunter,survival,24,14,10
Rirand,dalaran,1336,hunter,survival,59,27,32
Crissy,crushridge,1335,hunter,survival,58,31,27
Jyñ,malganis,1335,hunter,survival,36,15,21
Åpe,illidan,1334,hunter,survival,24,14,10
Clinteastwoo,ragnaros,1334,hunter,survival,30,14,16
Noguns,tichondrius,1333,hunter,survival,30,14,16
Bowzørx,tichondrius,1331,hunter,survival,30,14,16
Bigsexi,kiljaeden,1329,hunter,survival,62,27,35
Inheart,khazgoroth,1326,hunter,survival,66,28,38
Viró,sargeras,1325,hunter,survival,27,15,12
Pablita,drakkari,1322,hunter,survival,24,15,9
Freebeë,area-52,1320,hunter,survival,30,14,16
Taiberianrex,khazgoroth,1317,hunter,survival,48,28,20
Buggyhuntz,stormrage,1317,hunter,survival,42,16,26
Bangerzx,stormrage,1315,hunter,survival,30,18,12
Carnosynn,sargeras,1315,hunter,survival,24,14,10
Cocobread,stormreaver,1315,hunter,survival,102,43,59
Nippoc,aerie-peak,1314,hunter,survival,18,14,4
Chiad,kargath,1313,hunter,survival,36,22,14
Vhan,azralon,1313,hunter,survival,136,71,65
Ryonel,moon-guard,1313,hunter,survival,167,81,86
Luckboy,tichondrius,1311,hunter,survival,173,85,88
Éygon,sargeras,1311,hunter,survival,39,17,22
Mypeach,frostmourne,1310,hunter,survival,66,33,33
Draban,stormrage,1305,hunter,survival,30,14,16
Snoopinator,malganis,1305,hunter,survival,42,15,27
Zorht,ragnaros,1301,hunter,survival,206,103,103
Bredys,quelthalas,1295,hunter,survival,42,15,27
Cvelian,tichondrius,1293,hunter,survival,60,23,37
Rykbad,area-52,1292,hunter,survival,49,28,21
Hovahdo,proudmoore,1287,hunter,survival,35,14,21
Rogaldornn,thrall,1280,hunter,survival,47,23,24
Lashga,wyrmrest-accord,1279,hunter,survival,45,17,28
Vongard,wyrmrest-accord,1277,hunter,survival,52,24,28
Orgpopeyes,illidan,1275,hunter,survival,37,15,22
Wrathofexwif,proudmoore,1273,hunter,survival,30,16,14
Nanotorque,moon-guard,1273,hunter,survival,84,44,40
Dreebizz,gorefiend,1272,hunter,survival,91,41,50
Lorethor,kaelthas,1270,hunter,survival,36,15,21
Gxswow,tichondrius,1268,hunter,survival,66,30,36
Seratoninx,malganis,1267,hunter,survival,29,14,15
Ghuntcassh,quelthalas,1262,hunter,survival,30,18,12
Félíx,ragnaros,1258,hunter,survival,44,18,26
Fancyox,frostmourne,1247,hunter,survival,18,13,5
Honorola,twisting-nether,1247,hunter,survival,18,13,5
Tinsho,drakkari,1247,hunter,survival,66,34,32
Duckpow,frostmourne,1247,hunter,survival,60,24,36
Hawkem,illidan,1246,hunter,survival,24,13,11
Maran,chogall,1245,hunter,survival,18,13,5
Bicflop,azralon,1241,hunter,survival,18,13,5
Vindication,ysera,1240,hunter,survival,24,13,11
Ganderion,sargeras,1240,hunter,survival,27,14,13
Madhuntter,azralon,1239,hunter,survival,24,13,11
Nowê,azralon,1239,hunter,survival,36,15,21
Ariädne,sargeras,1239,hunter,survival,72,27,45
Søapbubble,tichondrius,1236,hunter,survival,18,13,5
Bubblesh,whisperwind,1234,hunter,survival,36,18,18
Ropivacaine,illidan,1232,hunter,survival,30,13,17
Sealteamrick,frostmourne,1231,hunter,survival,30,15,15
Nucleosome,stormrage,1219,hunter,survival,24,13,11
Natsai,illidan,1217,hunter,survival,45,19,26
Skriill,tichondrius,1211,hunter,survival,60,26,34
Diebleeding,ragnaros,1210,hunter,survival,29,13,16
Laurett,ragnaros,1208,hunter,survival,24,13,11
Cufless,proudmoore,1204,hunter,survival,36,13,23
Arkeryn,azralon,1203,hunter,survival,18,13,5
Firesail,kelthuzad,1199,hunter,survival,79,36,43
Wartoz,dragonblight,1190,hunter,survival,59,40,19
Rensv,frostmourne,1190,hunter,survival,56,30,26
Rairin,tichondrius,1190,hunter,survival,47,20,27
Extremis,emerald-dream,1185,hunter,survival,106,47,59
Wìllòw,khazgoroth,1174,hunter,survival,42,14,28
Spitballa,emerald-dream,1170,hunter,survival,35,14,21
Allahakbar,ragnaros,1169,hunter,survival,36,15,21
Gruì,malganis,1168,hunter,survival,26,13,13
Kukulkán,muradin,1164,hunter,survival,28,13,15
Travail,illidan,1163,hunter,survival,24,17,7
Trapordie,stormrage,1162,hunter,survival,30,13,17
Banai,the-underbog,1161,hunter,survival,67,26,41
Daymanaahh,malfurion,1159,hunter,survival,56,24,32
Mokuraak,emerald-dream,1154,hunter,survival,42,20,22
Gigabigly,wyrmrest-accord,1152,hunter,survival,18,12,6
Yøske,tichondrius,1152,hunter,survival,18,12,6
Wingclipt,stormrage,1151,hunter,survival,29,12,17
Drunknachos,bleeding-hollow,1150,hunter,survival,24,12,12
Broskina,stormrage,1150,hunter,survival,24,12,12
Laralodge,stormrage,1150,hunter,survival,78,32,46
Crimsoncoast,tichondrius,1149,hunter,survival,18,12,6
Barnbougle,sargeras,1149,hunter,survival,24,12,12
Imbrokenlol,kiljaeden,1148,hunter,survival,30,12,18
Giraffetrap,zuljin,1147,hunter,survival,18,12,6
Expskippy,darkspear,1146,hunter,survival,55,34,21
Kaiholeo,tichondrius,1143,hunter,survival,18,12,6
Leftty,illidan,1140,hunter,survival,30,12,18
Arcos,emerald-dream,1138,hunter,survival,18,12,6
Xitara,stormrage,1137,hunter,survival,24,12,12
Chopsley,feathermoon,1136,hunter,survival,71,30,41
Joeexotíc,moknathal,1132,hunter,survival,24,12,12
Vansatih,azralon,1126,hunter,survival,125,68,57
Ligerjin,ragnaros,1122,hunter,survival,30,12,18
Eastera,tichondrius,1119,hunter,survival,68,30,38
Rayhuntard,tichondrius,1115,hunter,survival,23,12,11
Superiorkill,arathor,1113,hunter,survival,31,13,18
Chicall,kalecgos,1096,hunter,survival,31,13,18
Eskii,moon-guard,1079,hunter,survival,18,12,6
Lesseneth,aegwynn,1072,hunter,survival,48,20,28
Zhafiro,drakkari,1067,hunter,survival,36,21,15
Arucedd,frostmourne,1064,hunter,survival,69,40,29
Kaïmsael,kelthuzad,1064,hunter,survival,125,69,56
Summerdope,aggramar,1056,hunter,survival,18,11,7
Scythedom,tichondrius,1056,hunter,survival,18,11,7
Cptx,kelthuzad,1056,hunter,survival,18,11,7
Anooß,tichondrius,1056,hunter,survival,21,12,9
Lovevv,frostmourne,1055,hunter,survival,18,11,7
Ïkite,zuljin,1055,hunter,survival,18,11,7
Nevertraps,frostmourne,1055,hunter,survival,18,11,7
Maxlol,stormrage,1055,hunter,survival,24,11,13
Plsbepatient,wyrmrest-accord,1054,hunter,survival,18,11,7
Reignwolf,nemesis,1053,hunter,survival,18,11,7
Sagadegêmeos,stormrage,1053,hunter,survival,18,11,7
Jaw,hakkar,1053,hunter,survival,18,11,7
Petmychode,illidan,1053,hunter,survival,18,11,7
Sarvaxagar,tichondrius,1052,hunter,survival,24,11,13
Thoriden,amanthul,1051,hunter,survival,54,14,40
Syff,korgath,1050,hunter,survival,30,11,19
Sarqis,lightbringer,1044,hunter,survival,24,11,13
Panm,runetotem,1034,hunter,survival,27,12,15
Eithelleta,frostmourne,1034,hunter,survival,104,43,61
Akigga,arthas,1033,hunter,survival,18,11,7
Triggers,ghostlands,1033,hunter,survival,30,11,19
Kalgorn,emerald-dream,1030,hunter,survival,28,13,15
Fisthammer,frostmane,1018,hunter,survival,30,16,14
Wkx,tichondrius,1017,hunter,survival,26,12,14
Jaykwan,boulderfist,1016,hunter,survival,23,11,12
Rukkora,deathwing,1009,hunter,survival,66,30,36
Prêd,malganis,990,hunter,survival,22,11,11
Luangg,tichondrius,989,hunter,survival,20,11,9
Lucarcher,stormrage,988,hunter,survival,17,11,6
Thrandrial,smolderthorn,985,hunter,survival,20,11,9
Tempistworg,greymane,982,hunter,survival,87,44,43
Hellrayserr,azralon,970,hunter,survival,24,11,13
Virindi,barthilas,960,hunter,survival,12,10,2
Sbgrv,dalaran,960,hunter,survival,18,10,8
Covlolzz,illidan,960,hunter,survival,24,10,14
Corpo,area-52,960,hunter,survival,24,10,14
Zipzyo,tichondrius,960,hunter,survival,24,10,14
Snipin,ragnaros,960,hunter,survival,30,10,20
Kêdokî,sargeras,959,hunter,survival,12,10,2
Rickybobby,warsong,959,hunter,survival,18,10,8
Egurl,firetree,959,hunter,survival,18,10,8
Zizilio,kelthuzad,959,hunter,survival,18,10,8
Tyleraq,area-52,959,hunter,survival,18,10,8
Piñg,tichondrius,959,hunter,survival,18,10,8
Narakara,stormreaver,959,hunter,survival,21,11,10
Venoc,bleeding-hollow,959,hunter,survival,24,10,14
Jerusa,illidan,958,hunter,survival,18,10,8
Kimchimaster,tichondrius,958,hunter,survival,26,10,16
Fanikita,azralon,957,hunter,survival,15,11,4
Rockehm,frostmourne,957,hunter,survival,18,10,8
Deejwithabow,frostmourne,957,hunter,survival,18,10,8
Wouow,tichondrius,957,hunter,survival,18,10,8
Genesiz,sargeras,957,hunter,survival,24,10,14
Daréz,blackrock,956,hunter,survival,16,11,5
Vietnrg,doomhammer,954,hunter,survival,24,10,14
Grayrat,trollbane,947,hunter,survival,18,10,8
Loochlin,sargeras,946,hunter,survival,27,10,17
Syvarris,medivh,943,hunter,survival,17,10,7
Amarox,zuljin,938,hunter,survival,23,11,12
Khaoskills,thunderlord,926,hunter,survival,49,26,23
Gelter,stormrage,924,hunter,survival,23,10,13
Sitalces,ragnaros,895,hunter,survival,36,18,18
Crapshot,daggerspine,885,hunter,survival,33,10,23
Turkshot,area-52,875,hunter,survival,25,10,15
Jaywaz,tichondrius,864,hunter,survival,12,9,3
Unicom,malganis,864,hunter,survival,12,9,3
Puffcopeak,illidan,864,hunter,survival,12,9,3
Hunterguyy,tichondrius,864,hunter,survival,12,9,3
Weedzy,tichondrius,864,hunter,survival,12,9,3
Tigglyjits,tichondrius,864,hunter,survival,12,9,3
Yná,nemesis,864,hunter,survival,12,9,3
Alansho,tichondrius,864,hunter,survival,18,9,9
Desari,thunderhorn,864,hunter,survival,18,9,9
Scottmeyers,proudmoore,864,hunter,survival,24,9,15
Sharkzooka,illidan,864,hunter,survival,24,9,15
Kaldrool,frostmourne,864,hunter,survival,24,9,15
Daspx,nagrand,863,hunter,survival,18,9,9
Riram,stormrage,863,hunter,survival,18,9,9
Arigon,frostmane,863,hunter,survival,18,9,9
Twodoobies,ghostlands,863,hunter,survival,18,9,9
Serpantsting,moon-guard,863,hunter,survival,18,9,9
Landscape,kiljaeden,863,hunter,survival,24,9,15
Lovoo,sargeras,862,hunter,survival,12,9,3
Keenai,moon-guard,862,hunter,survival,12,9,3
Contrack,zuljin,862,hunter,survival,19,10,9
Lasagnadaddy,maiev,862,hunter,survival,18,9,9
Huntardxo,moon-guard,862,hunter,survival,18,9,9
Deerhunt,black-dragonflight,862,hunter,survival,18,9,9
Vulkru,azralon,862,hunter,survival,18,9,9
Chootyboi,bronzebeard,862,hunter,survival,18,9,9
Nøzhaha,area-52,861,hunter,survival,18,9,9
Packlead,sargeras,861,hunter,survival,18,9,9
Ashtron,trollbane,860,hunter,survival,24,9,15
Junglepaw,moon-guard,860,hunter,survival,24,9,15
Zotahunterx,ragnaros,859,hunter,survival,24,9,15
Mabaku,tichondrius,858,hunter,survival,12,9,3
Turquesaa,wyrmrest-accord,856,hunter,survival,18,9,9
Obsididan,aerie-peak,855,hunter,survival,24,9,15
Prettysure,nesingwary,851,hunter,survival,25,12,13
Vizkha,azralon,847,hunter,survival,18,9,9
Lisbboax,stormrage,844,hunter,survival,27,11,16
Shukucingjr,illidan,842,hunter,survival,18,9,9
Blaymorrd,senjin,839,hunter,survival,18,9,9
Defiance,rexxar,831,hunter,survival,16,9,7
Gairkill,area-52,831,hunter,survival,98,50,48
Ðfac,moon-guard,768,hunter,survival,12,8,4
Shootypie,hyjal,768,hunter,survival,12,8,4
Elccid,tichondrius,768,hunter,survival,12,8,4
Kanta,bleeding-hollow,768,hunter,survival,12,8,4
Eain,wyrmrest-accord,768,hunter,survival,12,8,4
Árröw,arygos,768,hunter,survival,12,8,4
Fiftyyddash,tichondrius,768,hunter,survival,12,8,4
Gondolin,andorhal,768,hunter,survival,12,8,4
Trappah,stormrage,768,hunter,survival,12,8,4
Iizerd,illidan,768,hunter,survival,12,8,4
Fineye,illidan,768,hunter,survival,14,8,6
Madival,ragnaros,768,hunter,survival,18,8,10
Igotloud,illidan,768,hunter,survival,18,8,10
Goromi,tichondrius,768,hunter,survival,18,8,10
Nautílus,ragnaros,768,hunter,survival,18,8,10
Drupert,tichondrius,768,hunter,survival,18,8,10
Diddycombe,stormrage,768,hunter,survival,18,8,10
Michaeljfox,area-52,768,hunter,survival,18,8,10
Kuzar,thrall,768,hunter,survival,18,8,10
Kimssis,tichondrius,768,hunter,survival,18,8,10
Eref,sargeras,768,hunter,survival,24,8,16
Sniperælite,korgath,768,hunter,survival,24,8,16
Nervousness,draka,767,hunter,survival,12,8,4
Brissy,sargeras,767,hunter,survival,18,8,10
Trixster,lethon,767,hunter,survival,18,8,10
Slimshadie,kiljaeden,767,hunter,survival,18,8,10
Rummaker,mugthol,767,hunter,survival,18,8,10
Zouzu,area-52,767,hunter,survival,18,8,10
Bruzit,tol-barad,767,hunter,survival,18,8,10
Yesthyra,sargeras,767,hunter,survival,18,8,10
Korasaya,area-52,767,hunter,survival,18,8,10
Wakkå,mugthol,767,hunter,survival,21,9,12
Mmchode,zuljin,767,hunter,survival,24,8,16
Soberish,bleeding-hollow,767,hunter,survival,24,8,16
Zyzzmirin,illidan,767,hunter,survival,24,8,16
Bowowner,aggramar,767,hunter,survival,30,8,22
Chokemescara,stormrage,767,hunter,survival,30,8,22
Najmoira,area-52,766,hunter,survival,12,8,4
Kraslin,bleeding-hollow,766,hunter,survival,12,8,4
Greyh,madoran,766,hunter,survival,12,8,4
Hunfor,anubarak,766,hunter,survival,18,8,10
Cynya,wyrmrest-accord,766,hunter,survival,18,8,10
Segulah,dalaran,766,hunter,survival,18,8,10
Ariran,illidan,766,hunter,survival,18,8,10
Stoleurgurl,sargeras,766,hunter,survival,24,8,16
Jathriel,zuljin,765,hunter,survival,18,8,10
Lohse,emerald-dream,765,hunter,survival,18,8,10
Sterge,maiev,764,hunter,survival,18,8,10
Haumer,wyrmrest-accord,763,hunter,survival,12,8,4
Emiri,dalaran,763,hunter,survival,24,8,16
Querosushi,ragnaros,760,hunter,survival,18,8,10
Kaelgrog,kiljaeden,754,hunter,survival,24,8,16
Gaahl,aggramar,735,hunter,survival,14,9,5
Iraxium,illidan,735,hunter,survival,14,9,5
Thesniperx,sargeras,719,hunter,survival,21,8,13
Thrakgor,wyrmrest-accord,713,hunter,survival,23,10,13
Acidhunt,tichondrius,703,hunter,survival,28,8,20
Kanekki,ragnaros,688,hunter,survival,13,8,5
Joree,medivh,672,hunter,survival,12,7,5
Equalizér,sargeras,672,hunter,survival,12,7,5
Ozzsimp,stormrage,672,hunter,survival,12,7,5
Mattyhuntz,tichondrius,672,hunter,survival,12,7,5
Jamesön,sargeras,672,hunter,survival,12,7,5
Magvez,tichondrius,672,hunter,survival,12,7,5
Endxworld,tichondrius,672,hunter,survival,12,7,5
Antø,tichondrius,672,hunter,survival,12,7,5
Huntbay,destromath,672,hunter,survival,12,7,5
Vânillaice,stormrage,672,hunter,survival,12,7,5
Tsuka,eldrethalas,672,hunter,survival,12,7,5
Trenbolone,frostmourne,672,hunter,survival,12,7,5
Oronir,frostmourne,672,hunter,survival,12,7,5
Negligent,sargeras,672,hunter,survival,12,7,5
Arraza,ragnaros,672,hunter,survival,12,7,5
Dumshot,zuljin,672,hunter,survival,12,7,5
Ayjay,zuljin,672,hunter,survival,12,7,5
Glediator,tichondrius,672,hunter,survival,12,7,5
Irishredd,undermine,672,hunter,survival,12,7,5
Trapirl,tichondrius,672,hunter,survival,12,7,5
Fannypacks,dragonmaw,672,hunter,survival,12,7,5
Pfheign,area-52,672,hunter,survival,12,7,5
Onécare,bleeding-hollow,672,hunter,survival,12,7,5
Greyhollow,sargeras,672,hunter,survival,15,8,7
Bombbot,zuljin,672,hunter,survival,18,7,11
Oattes,daggerspine,672,hunter,survival,18,7,11
Porrainga,auchindoun,672,hunter,survival,18,7,11
Meowimadog,spinebreaker,672,hunter,survival,18,7,11
Ziaxel,bleeding-hollow,671,hunter,survival,12,7,5
Jigua,stormrage,671,hunter,survival,12,7,5
Otternaught,tichondrius,671,hunter,survival,12,7,5
Mav,dragonmaw,671,hunter,survival,12,7,5
Genocell,thunderlord,671,hunter,survival,12,7,5
Zackèse,area-52,671,hunter,survival,18,7,11
Gaezangsu,tichondrius,671,hunter,survival,24,7,17
Killswitches,dragonmaw,670,hunter,survival,12,7,5
Joskyia,drenden,669,hunter,survival,12,7,5
Hatespark,bonechewer,667,hunter,survival,12,7,5
Imraghorn,sargeras,655,hunter,survival,17,7,10
Illustrus,bleeding-hollow,639,hunter,survival,11,7,4
Catboikilla,altar-of-storms,639,hunter,survival,17,7,10
Cagooggo,moon-guard,638,hunter,survival,16,7,9
Rotthem,ragnaros,638,hunter,survival,20,8,12
Trappin,malganis,623,hunter,survival,11,7,4
Lartrius,bleeding-hollow,621,hunter,survival,15,8,7
Arrebol,tichondrius,608,hunter,survival,16,7,9
Primez,sargeras,607,hunter,survival,11,7,4
Austelos,moon-guard,607,hunter,survival,11,7,4
Odynsraven,stormrage,605,hunter,survival,11,7,4
Ðevil,ragnaros,576,hunter,survival,6,6,0
Drees,nerzhul,576,hunter,survival,6,6,0
Garkia,hyjal,576,hunter,survival,6,6,0
Ÿöskë,tichondrius,576,hunter,survival,6,6,0
Ivanjackenov,illidan,576,hunter,survival,10,7,3
Nijicon,frostmourne,576,hunter,survival,12,6,6
Amhavgun,tichondrius,576,hunter,survival,12,6,6
Mctrapturds,tichondrius,576,hunter,survival,12,6,6
Zugfeito,nemesis,576,hunter,survival,12,6,6
Nedad,tichondrius,576,hunter,survival,12,6,6
Yoske,tichondrius,576,hunter,survival,12,6,6
Wezkerh,ragnaros,576,hunter,survival,12,6,6
Mythfive,stormrage,576,hunter,survival,12,6,6
Walterwhite,trollbane,576,hunter,survival,12,6,6
Araqíel,aegwynn,576,hunter,survival,12,6,6
Tazsic,mannoroth,576,hunter,survival,12,6,6
Traponomics,stormrage,576,hunter,survival,12,6,6
Fíction,kelthuzad,576,hunter,survival,12,6,6
Cosmodome,daggerspine,576,hunter,survival,12,6,6
Tenzën,drakkari,576,hunter,survival,12,6,6
Zerark,kelthuzad,576,hunter,survival,13,6,7
Jaggeroi,thrall,576,hunter,survival,16,7,9
Lahinch,darkspear,576,hunter,survival,21,7,14
Pilesofpoop,sargeras,576,hunter,survival,18,6,12
Chetvi,uldum,576,hunter,survival,18,6,12
Kowabungy,tichondrius,576,hunter,survival,18,6,12
Xochiquetzal,jubeithos,575,hunter,survival,6,6,0
Dfnhdft,stormrage,575,hunter,survival,12,6,6
Zepplin,medivh,575,hunter,survival,12,6,6
Xeiana,proudmoore,575,hunter,survival,12,6,6
Týrak,illidan,575,hunter,survival,12,6,6
Jerza,emerald-dream,575,hunter,survival,12,6,6
Dgs,nemesis,575,hunter,survival,12,6,6
Bôwbafett,sargeras,575,hunter,survival,12,6,6
Blizhunt,thunderlord,575,hunter,survival,18,6,12
Vortann,proudmoore,575,hunter,survival,18,6,12
Kerion,emerald-dream,575,hunter,survival,18,6,12
Berzxd,stormrage,573,hunter,survival,12,6,6
Bushytails,illidan,573,hunter,survival,18,6,12
Aiyanafox,moon-guard,572,hunter,survival,24,6,18
Mookvader,illidan,562,hunter,survival,24,10,14
Alpacxpress,stormrage,544,hunter,survival,16,6,10
Tyrokk,barthilas,543,hunter,survival,18,6,12
Dräkö,tichondrius,527,hunter,survival,15,7,8
Ceezrh,sargeras,527,hunter,survival,15,7,8
Kovoth,darkspear,526,hunter,survival,15,6,9
Showtheio,azralon,522,hunter,survival,16,7,9
Lawafla,area-52,521,hunter,survival,14,7,7
Raeshots,area-52,518,hunter,survival,21,8,13
Pxry,drenden,511,hunter,survival,11,6,5
Therealpafo,tichondrius,507,hunter,survival,20,6,14
Grimbrew,garona,480,hunter,survival,6,5,1
Selenis,khadgar,480,hunter,survival,6,5,1
Wwangman,tichondrius,480,hunter,survival,6,5,1
Poorapple,tichondrius,480,hunter,survival,6,5,1
Tmzsteezy,tichondrius,480,hunter,survival,6,5,1
Ewife,illidan,480,hunter,survival,6,5,1
Narukín,tichondrius,480,hunter,survival,6,5,1
Gufanyaun,tichondrius,480,hunter,survival,6,5,1
Nearsight,proudmoore,480,hunter,survival,6,5,1
Jonah,sargeras,480,hunter,survival,6,5,1
Jäger,zuljin,480,hunter,survival,6,5,1
Minnsc,tichondrius,480,hunter,survival,6,5,1
Toyshoota,stormrage,480,hunter,survival,9,6,3
Casadega,sargeras,480,hunter,survival,10,6,4
Redhøød,moon-guard,480,hunter,survival,12,5,7
Cuervostreet,ragnaros,480,hunter,survival,12,5,7
Mìtáng,moon-guard,480,hunter,survival,12,5,7
Jumpkick,azralon,480,hunter,survival,12,5,7
Minxed,sargeras,480,hunter,survival,12,5,7
Bastÿ,area-52,480,hunter,survival,12,5,7
Veluci,tichondrius,480,hunter,survival,12,5,7
Myrfes,ragnaros,480,hunter,survival,12,5,7
Tezlekhan,haomarush,480,hunter,survival,12,5,7
Thiccita,tichondrius,480,hunter,survival,12,5,7
Bowjoby,kelthuzad,480,hunter,survival,12,5,7
Downrange,stonemaul,480,hunter,survival,12,5,7
Giorvannar,ragnaros,480,hunter,survival,12,5,7
Drysst,tichondrius,480,hunter,survival,12,5,7
Droj,stormrage,480,hunter,survival,12,5,7
Cefirhok,ragnaros,480,hunter,survival,12,5,7
Luckione,destromath,480,hunter,survival,12,5,7
Firskin,frostmourne,480,hunter,survival,12,5,7
Shootnoscore,vashj,480,hunter,survival,15,6,9
Dartoo,ragnaros,480,hunter,survival,18,5,13
Ärtémisa,quelthalas,480,hunter,survival,18,5,13
Phasm,ravencrest,479,hunter,survival,6,5,1
Mcgoob,tichondrius,479,hunter,survival,12,5,7
Alfaan,moon-guard,479,hunter,survival,12,5,7
Mirdous,moon-guard,479,hunter,survival,12,5,7
Villainshunt,stormrage,479,hunter,survival,12,5,7
Belvhar,skullcrusher,479,hunter,survival,12,5,7
Ghannha,wyrmrest-accord,479,hunter,survival,12,5,7
Pastelitoz,tichondrius,479,hunter,survival,21,6,15
Calvarîam,korgath,479,hunter,survival,18,5,13
Légölás,tichondrius,463,hunter,survival,17,5,12
Faniquitinha,stormrage,431,hunter,survival,13,6,7
Crumpit,moon-guard,426,hunter,survival,22,6,16
Flowolf,tichondrius,416,hunter,survival,10,5,5
Cinnybunz,malganis,415,hunter,survival,16,6,10
Rinehart,dalaran,415,hunter,survival,14,5,9
Siëgward,quelthalas,384,hunter,survival,6,4,2
Bigpets,azralon,384,hunter,survival,6,4,2
Pulso,illidan,384,hunter,survival,6,4,2
Vegâ,ursin,384,hunter,survival,6,4,2
Malkuri,medivh,384,hunter,survival,6,4,2
Kapukapu,illidan,384,hunter,survival,6,4,2
Virgim,kelthuzad,384,hunter,survival,6,4,2
Litchi,illidan,384,hunter,survival,6,4,2
Ehhee,twisting-nether,384,hunter,survival,6,4,2
Chasseür,quelthalas,384,hunter,survival,6,4,2
Surprisemfkr,emerald-dream,384,hunter,survival,6,4,2
Trapful,illidan,384,hunter,survival,6,4,2
Ethxx,emerald-dream,384,hunter,survival,6,4,2
Nastoid,area-52,384,hunter,survival,6,4,2
Rankonee,area-52,384,hunter,survival,6,4,2
Scrubmastery,emerald-dream,384,hunter,survival,6,4,2
Swagprince,skullcrusher,384,hunter,survival,6,4,2
Hunterlolxd,altar-of-storms,384,hunter,survival,6,4,2
Ofthedeath,ragnaros,384,hunter,survival,6,4,2
Ikitefordmt,zuljin,384,hunter,survival,6,4,2
Failtrap,ragnaros,384,hunter,survival,6,4,2
Æßç,ragnaros,384,hunter,survival,6,4,2
Boomseed,nagrand,384,hunter,survival,6,4,2
Aurelqt,tichondrius,384,hunter,survival,6,4,2
Bendoon,sargeras,384,hunter,survival,6,4,2
Wapnonymous,mugthol,384,hunter,survival,6,4,2
Pumpkinovo,tichondrius,384,hunter,survival,6,4,2
Mihall,tichondrius,384,hunter,survival,6,4,2
Gaymonbarnet,sargeras,384,hunter,survival,6,4,2
Thalyxion,moon-guard,384,hunter,survival,6,4,2
Petstun,moon-guard,384,hunter,survival,6,4,2
Ratherbully,tichondrius,384,hunter,survival,6,4,2
Volbz,barthilas,384,hunter,survival,6,4,2
Pouncedgg,sargeras,384,hunter,survival,6,4,2
Junglefever,skywall,384,hunter,survival,6,4,2
Suyesh,tichondrius,384,hunter,survival,6,4,2
ßløømtøðèáth,shadow-council,384,hunter,survival,6,4,2
Elcap,tichondrius,384,hunter,survival,6,4,2
Mameikilled,saurfang,384,hunter,survival,6,4,2
Thefanbus,tichondrius,384,hunter,survival,6,4,2
Hyena,kelthuzad,384,hunter,survival,9,5,4
Wolfsorgorr,area-52,384,hunter,survival,12,4,8
Vogtfog,tichondrius,384,hunter,survival,12,4,8
Sybernetik,tichondrius,384,hunter,survival,12,4,8
Newcomb,tichondrius,384,hunter,survival,12,4,8
Kissmylin,tichondrius,384,hunter,survival,12,4,8
Ælij,tichondrius,384,hunter,survival,12,4,8
Stupidgodx,tichondrius,384,hunter,survival,12,4,8
Gluegobbler,spinebreaker,384,hunter,survival,12,4,8
Oatmeallover,stormrage,384,hunter,survival,12,4,8
Golorn,malganis,384,hunter,survival,12,4,8
Àngèl,malganis,384,hunter,survival,12,4,8
Goonlmao,hyjal,384,hunter,survival,12,4,8
Gunicks,illidan,384,hunter,survival,12,4,8
Camfeed,illidan,384,hunter,survival,12,4,8
Braindeadorc,illidan,384,hunter,survival,12,4,8
Malikyr,moon-guard,384,hunter,survival,12,4,8
Aeht,illidan,384,hunter,survival,12,4,8
Ganash,gallywix,384,hunter,survival,12,4,8
Troglav,drakkari,384,hunter,survival,12,4,8
Fâpple,stormrage,384,hunter,survival,12,4,8
Eforas,ragnaros,384,hunter,survival,12,4,8
Zerkie,area-52,384,hunter,survival,12,4,8
Keenz,frostmourne,384,hunter,survival,12,4,8
Axxax,azralon,384,hunter,survival,12,4,8
Wolfsok,norgannon,384,hunter,survival,12,4,8
Bearbarryls,azralon,384,hunter,survival,12,4,8
Cakeislife,kelthuzad,384,hunter,survival,18,4,14
Tydee,nagrand,383,hunter,survival,18,4,14
Yory,tol-barad,362,hunter,survival,12,6,6
Sliturthroat,barthilas,336,hunter,survival,9,4,5
Adamariss,stormrage,319,hunter,survival,16,4,12
Skolfongoun,malfurion,318,hunter,survival,14,4,10
Dangerrangér,area-52,304,hunter,survival,7,4,3
Illshot,tichondrius,304,hunter,survival,13,4,9
Hendlie,frostmourne,288,hunter,survival,6,3,3
Mistrj,frostmourne,288,hunter,survival,6,3,3
Adonai,stormrage,288,hunter,survival,6,3,3
Badseedz,kargath,288,hunter,survival,6,3,3
Rustyspork,muradin,288,hunter,survival,6,3,3
Musculate,firetree,288,hunter,survival,6,3,3
Fearna,destromath,288,hunter,survival,6,3,3
Shootdogg,mannoroth,288,hunter,survival,6,3,3
Banshers,stormrage,288,hunter,survival,6,3,3
Bherskrograx,burning-legion,288,hunter,survival,6,3,3
Hazzersk,ragnaros,288,hunter,survival,6,3,3
Furipoon,stormrage,288,hunter,survival,6,3,3
Loogan,sargeras,288,hunter,survival,6,3,3
Pridefulzjr,stormrage,288,hunter,survival,6,3,3
Cantantie,tichondrius,288,hunter,survival,6,3,3
Fancyxo,frostmourne,288,hunter,survival,6,3,3
Slowdamage,ragnaros,288,hunter,survival,6,3,3
Pewpewboi,malganis,288,hunter,survival,6,3,3
Makeastinky,malfurion,288,hunter,survival,6,3,3
Hackerman,tichondrius,288,hunter,survival,6,3,3
Duune,wyrmrest-accord,288,hunter,survival,6,3,3
Petkd,frostmourne,288,hunter,survival,6,3,3
Guncontrol,malganis,288,hunter,survival,6,3,3
Griefs,malganis,288,hunter,survival,6,3,3
Dirtymongrel,barthilas,288,hunter,survival,6,3,3
Yoppa,zuljin,288,hunter,survival,6,3,3
Draevinz,stormrage,288,hunter,survival,6,3,3
Pistolon,quelthalas,288,hunter,survival,6,3,3
Embaçado,bleeding-hollow,288,hunter,survival,6,3,3
Zà,sargeras,288,hunter,survival,6,3,3
Samsin,sargeras,288,hunter,survival,6,3,3
Seiber,quelthalas,288,hunter,survival,6,3,3
Slowhunterr,tichondrius,288,hunter,survival,6,3,3
Moistbooger,emerald-dream,288,hunter,survival,6,3,3
Wooftoof,frostmourne,288,hunter,survival,6,3,3
Slaughterr,kelthuzad,288,hunter,survival,6,3,3
Lowlore,moon-guard,288,hunter,survival,6,3,3
Fjdominador,azralon,288,hunter,survival,6,3,3
Tawok,moon-guard,288,hunter,survival,6,3,3
Soul,sargeras,288,hunter,survival,6,3,3
Goodtimez,sargeras,288,hunter,survival,6,3,3
Vaz,haomarush,288,hunter,survival,6,3,3
Whitemàne,dalaran,288,hunter,survival,6,3,3
Pvx,darkspear,288,hunter,survival,6,3,3
Spårrow,alleria,288,hunter,survival,6,3,3
Gorgrokk,area-52,288,hunter,survival,6,3,3
Littlechooch,illidan,288,hunter,survival,6,3,3
Ünitedi,nemesis,288,hunter,survival,6,3,3
Rûff,azralon,288,hunter,survival,6,3,3
Trapmasterx,tichondrius,288,hunter,survival,6,3,3
Lemmetrap,illidan,288,hunter,survival,6,3,3
Calidian,moon-guard,288,hunter,survival,6,3,3
Nitroguy,moknathal,288,hunter,survival,6,3,3
Bakalan,dalaran,288,hunter,survival,16,4,12
Lixniqua,tichondrius,288,hunter,survival,12,3,9
Kalibah,azralon,288,hunter,survival,12,3,9
Pooshot,kelthuzad,288,hunter,survival,12,3,9
Hawkéns,moon-guard,288,hunter,survival,12,3,9
Runecbow,eonar,288,hunter,survival,12,3,9
Gutshott,tichondrius,288,hunter,survival,12,3,9
Wildhùnt,tichondrius,288,hunter,survival,12,3,9
Krispyflayz,sargeras,288,hunter,survival,12,3,9
Kharñe,tichondrius,288,hunter,survival,12,3,9
Waylòn,moon-guard,287,hunter,survival,12,3,9
Ynoit,illidan,271,hunter,survival,11,3,8
Mokaonly,wildhammer,256,hunter,survival,8,4,4
Crèpes,bleeding-hollow,239,hunter,survival,5,3,2
Böuntyhuntêr,area-52,239,hunter,survival,5,3,2
Yogurtti,zuljin,239,hunter,survival,5,3,2
Frostwulff,tichondrius,239,hunter,survival,5,3,2
Onehitrip,illidan,233,hunter,survival,8,4,4
Moscato,cenarion-circle,232,hunter,survival,14,4,10
Cumman,sargeras,208,hunter,survival,7,3,4
Rifomen,illidan,192,hunter,survival,9,3,6
Gugucachorro,azralon,192,hunter,survival,6,2,4
Shaftgravy,area-52,192,hunter,survival,6,2,4
Razzldazzlbb,thrall,192,hunter,survival,6,2,4
Heãdhunter,area-52,192,hunter,survival,6,2,4
Machunt,lightbringer,192,hunter,survival,6,2,4
Splewsh,area-52,192,hunter,survival,6,2,4
Clampula,sargeras,192,hunter,survival,6,2,4
Sharpster,zuljin,192,hunter,survival,6,2,4
Dikkins,windrunner,192,hunter,survival,6,2,4
Gaim,dalaran,192,hunter,survival,6,2,4
Achilles,twisting-nether,192,hunter,survival,6,2,4
Kharvaash,onyxia,192,hunter,survival,6,2,4
Rimbar,ysera,192,hunter,survival,6,2,4
Gunudown,haomarush,192,hunter,survival,6,2,4
Gobygobbs,magtheridon,192,hunter,survival,6,2,4
Zellor,wyrmrest-accord,192,hunter,survival,6,2,4
Zirstorm,altar-of-storms,192,hunter,survival,6,2,4
Quiveringboy,chogall,192,hunter,survival,6,2,4
Finol,azralon,192,hunter,survival,6,2,4
Pint,madoran,192,hunter,survival,6,2,4
Sebastian,blackhand,192,hunter,survival,6,2,4
Harosh,azralon,192,hunter,survival,6,2,4
Cernos,malganis,192,hunter,survival,6,2,4
Zèd,azralon,192,hunter,survival,6,2,4
ßn,zuljin,192,hunter,survival,6,2,4
Araghrn,draktharon,192,hunter,survival,6,2,4
Spizsnipes,malganis,192,hunter,survival,6,2,4
Harposmash,trollbane,192,hunter,survival,6,2,4
Gswag,malganis,192,hunter,survival,6,2,4
Blackjesu,blackrock,192,hunter,survival,6,2,4
Comebacks,ragnaros,192,hunter,survival,6,2,4
Xoxono,frostmourne,192,hunter,survival,6,2,4
Shïndow,ragnaros,192,hunter,survival,6,2,4
Pedropete,frostmourne,192,hunter,survival,6,2,4
Kravern,ragnaros,192,hunter,survival,6,2,4
Thazen,sargeras,192,hunter,survival,6,2,4
Rainzs,stormrage,192,hunter,survival,6,2,4
Femboyfatale,stormrage,192,hunter,survival,6,2,4
Nahzah,stormrage,192,hunter,survival,6,2,4
Cio,fizzcrank,192,hunter,survival,6,2,4
Tréèstump,tichondrius,192,hunter,survival,6,2,4
Eclipsie,aerie-peak,192,hunter,survival,6,2,4
Trígger,azshara,192,hunter,survival,6,2,4
Gaea,korgath,192,hunter,survival,6,2,4
Ishotmydog,malganis,192,hunter,survival,6,2,4
Sunchea,arygos,192,hunter,survival,6,2,4
Bboo,bonechewer,192,hunter,survival,6,2,4
Gomrog,gurubashi,192,hunter,survival,6,2,4
Théw,tichondrius,192,hunter,survival,6,2,4
Qua,perenolde,192,hunter,survival,6,2,4
Durko,frostmourne,192,hunter,survival,6,2,4
Toruhagakure,tichondrius,192,hunter,survival,6,2,4
Dobuu,tichondrius,192,hunter,survival,6,2,4
Eekbarbadrkl,frostmourne,192,hunter,survival,6,2,4
Freshko,kiljaeden,192,hunter,survival,6,2,4
Mukbangbj,terenas,192,hunter,survival,6,2,4
Woobinman,tichondrius,192,hunter,survival,6,2,4
Slipox,sargeras,192,hunter,survival,6,2,4
Côckblocked,tichondrius,192,hunter,survival,6,2,4
Giovasper,sargeras,192,hunter,survival,6,2,4
Lenyuecf,proudmoore,192,hunter,survival,6,2,4
Traptations,sargeras,192,hunter,survival,6,2,4
Nelandris,tichondrius,192,hunter,survival,6,2,4
Viio,sargeras,192,hunter,survival,6,2,4
Tagsy,quelthalas,192,hunter,survival,12,2,10
Naturan,drakkari,192,hunter,survival,12,2,10
Raythør,area-52,192,hunter,survival,12,2,10
Linova,stormrage,192,hunter,survival,12,2,10
Yukisong,bleeding-hollow,192,hunter,survival,12,2,10
Zhona,moon-guard,192,hunter,survival,12,2,10
Skrìms,tichondrius,192,hunter,survival,12,2,10
Twom,area-52,138,hunter,survival,8,3,5
Ohnahra,kiljaeden,138,hunter,survival,9,3,6
Xradû,dawnbringer,138,hunter,survival,9,3,6
Morganson,moon-guard,138,hunter,survival,22,4,18
Bránn,quelthalas,128,hunter,survival,4,2,2
Drunkbunny,tichondrius,121,hunter,survival,16,5,11
Fenrock,cenarius,96,hunter,survival,3,2,1
Whitecake,area-52,96,hunter,survival,3,2,1
Berkhof,tichondrius,96,hunter,survival,6,1,5
Feorbxl,proudmoore,96,hunter,survival,6,1,5
Bloodarrow,tichondrius,96,hunter,survival,6,1,5
Ezpzx,sargeras,96,hunter,survival,6,1,5
Jîlt,aerie-peak,96,hunter,survival,6,1,5
Shottz,aerie-peak,96,hunter,survival,6,1,5
Caliente,tichondrius,96,hunter,survival,6,1,5
Alorick,ragnaros,96,hunter,survival,6,1,5
Symz,ragnaros,96,hunter,survival,6,1,5
Survbot,malganis,96,hunter,survival,6,1,5
Taofang,emerald-dream,96,hunter,survival,6,1,5
Terrabytés,kelthuzad,96,hunter,survival,6,1,5
Weegnomie,wyrmrest-accord,96,hunter,survival,6,1,5
Pinktrexx,darkspear,96,hunter,survival,6,1,5
Ergen,zuluhed,96,hunter,survival,6,1,5
Dusle,azralon,96,hunter,survival,6,1,5
Lance,darrowmere,96,hunter,survival,6,1,5
Fearlesarrow,suramar,96,hunter,survival,6,1,5
Nevertraps,tichondrius,96,hunter,survival,6,1,5
Legosshi,darrowmere,96,hunter,survival,6,1,5
Sobala,azralon,96,hunter,survival,6,1,5
Kölhberg,azralon,96,hunter,survival,6,1,5
Kdik,azralon,96,hunter,survival,6,1,5
Skybourne,nemesis,96,hunter,survival,6,1,5
Lammy,bleeding-hollow,96,hunter,survival,6,1,5
Feignqt,illidan,96,hunter,survival,6,1,5
Floorislava,durotan,96,hunter,survival,6,1,5
Hironna,proudmoore,96,hunter,survival,6,1,5
Shuweet,moon-guard,96,hunter,survival,6,1,5
Elroyjetson,arthas,96,hunter,survival,6,1,5
Esser,mannoroth,96,hunter,survival,6,1,5
Killerxzxz,stormrage,96,hunter,survival,6,1,5
Critz,undermine,96,hunter,survival,6,1,5
Purpmang,bleeding-hollow,96,hunter,survival,12,1,11
Montakka,illidan,79,hunter,survival,5,1,4
Vortex,arthas,63,hunter,survival,2,2,0
Tayeal,thrall,31,hunter,survival,2,1,1
Longshánks,stormrage,16,hunter,survival,1,1,0
Hurrican,kaelthas,16,hunter,survival,1,1,0
Saiiph,bleeding-hollow,2274,hunter,beastmastery,136,76,60
Sphericsnow,shuhalo,2210,hunter,beastmastery,95,51,44
Studiosx,tichondrius,2186,hunter,beastmastery,106,56,50
Missedmytrap,agamaggan,2149,hunter,beastmastery,80,46,34
Zujo,emerald-dream,2134,hunter,beastmastery,173,89,84
Ucl,tichondrius,2125,hunter,beastmastery,90,45,45
Eref,sargeras,2116,hunter,beastmastery,78,42,36
Wmsgs,tichondrius,2116,hunter,beastmastery,129,64,65
Traptations,sargeras,2114,hunter,beastmastery,90,43,47
Warpath,ursin,2113,hunter,beastmastery,138,76,62
Pãrzival,tichondrius,2100,hunter,beastmastery,66,35,31
Maiyev,quelthalas,2074,hunter,beastmastery,95,52,43
Fish,darkspear,2070,hunter,beastmastery,90,45,45
Hfn,stormrage,2058,hunter,beastmastery,70,37,33
Manyu,tichondrius,2035,hunter,beastmastery,69,34,35
Orber,stormrage,2028,hunter,beastmastery,290,153,137
Hazzersk,ragnaros,2023,hunter,beastmastery,161,78,83
Perawantua,frostmourne,2002,hunter,beastmastery,73,43,30
Outz,anvilmar,1998,hunter,beastmastery,419,211,208
Pokìmane,tichondrius,1997,hunter,beastmastery,200,109,91
Antø,tichondrius,1997,hunter,beastmastery,135,66,69
Genom,tichondrius,1996,hunter,beastmastery,342,175,167
Cannondale,tichondrius,1993,hunter,beastmastery,42,21,21
Trapful,illidan,1992,hunter,beastmastery,96,49,47
Øverdose,ragnaros,1989,hunter,beastmastery,60,31,29
Beastmunster,frostmourne,1984,hunter,beastmastery,72,34,38
Pikabow,tichondrius,1968,hunter,beastmastery,57,31,26
Arcobaleno,tichondrius,1952,hunter,beastmastery,89,44,45
Trapandclap,tichondrius,1950,hunter,beastmastery,119,57,62
Arsk,ragnaros,1934,hunter,beastmastery,136,70,66
Diegoshotz,zuljin,1934,hunter,beastmastery,70,36,34
Blackathena,tichondrius,1933,hunter,beastmastery,162,83,79
Vëëv,proudmoore,1926,hunter,beastmastery,107,55,52
Headshotzplz,tichondrius,1924,hunter,beastmastery,71,39,32
Axlee,tichondrius,1919,hunter,beastmastery,308,151,157
Lenacraft,frostmourne,1917,hunter,beastmastery,66,41,25
Wodhunterxdd,sargeras,1915,hunter,beastmastery,70,34,36
Benay,emerald-dream,1904,hunter,beastmastery,84,49,35
Trappxy,sargeras,1902,hunter,beastmastery,108,55,53
Zeddead,magtheridon,1901,hunter,beastmastery,184,94,90
Nflmaster,malganis,1893,hunter,beastmastery,66,35,31
Veevx,proudmoore,1890,hunter,beastmastery,77,50,27
Kyló,sargeras,1888,hunter,beastmastery,66,34,32
Nyxus,tichondrius,1887,hunter,beastmastery,125,63,62
Kensho,illidan,1887,hunter,beastmastery,202,100,102
Lamerpvp,tichondrius,1885,hunter,beastmastery,50,31,19
Nerfthepet,blackrock,1879,hunter,beastmastery,75,49,26
Carlitocool,tichondrius,1877,hunter,beastmastery,36,28,8
Mugiwara,frostwolf,1877,hunter,beastmastery,42,25,17
Argryta,azralon,1872,hunter,beastmastery,47,22,25
Graar,tichondrius,1871,hunter,beastmastery,48,25,23
Taterballs,illidan,1871,hunter,beastmastery,84,43,41
Notvn,illidan,1869,hunter,beastmastery,53,29,24
Ciany,elune,1869,hunter,beastmastery,119,64,55
Twopumphunt,tichondrius,1868,hunter,beastmastery,36,23,13
Lilstinstin,tichondrius,1867,hunter,beastmastery,42,23,19
Dekestei,bleeding-hollow,1867,hunter,beastmastery,65,27,38
Kenshaunter,azralon,1864,hunter,beastmastery,71,31,40
Starkhaven,firetree,1863,hunter,beastmastery,74,46,28
Somethinggo,tichondrius,1863,hunter,beastmastery,212,105,107
Hogx,sargeras,1862,hunter,beastmastery,72,32,40
Mhter,tichondrius,1861,hunter,beastmastery,79,38,41
Nelay,ragnaros,1857,hunter,beastmastery,106,59,47
Quietqt,ragnaros,1857,hunter,beastmastery,117,63,54
Faniquitinha,stormrage,1854,hunter,beastmastery,54,25,29
Ñotorious,frostmane,1852,hunter,beastmastery,53,27,26
Easonl,tichondrius,1852,hunter,beastmastery,175,81,94
Cashisabeast,zuljin,1851,hunter,beastmastery,46,25,21
Nutellacrepe,kelthuzad,1851,hunter,beastmastery,206,104,102
Koridelse,nemesis,1850,hunter,beastmastery,138,68,70
Infinit,onyxia,1848,hunter,beastmastery,112,54,58
Nollzey,frostmourne,1847,hunter,beastmastery,45,22,23
Tânsøxøxø,tichondrius,1847,hunter,beastmastery,54,22,32
Wickyz,malganis,1846,hunter,beastmastery,42,24,18
Bolanite,illidan,1846,hunter,beastmastery,48,27,21
Bogen,nemesis,1846,hunter,beastmastery,82,44,38
Nalasdottirh,moon-guard,1845,hunter,beastmastery,84,51,33
Skysmile,tichondrius,1845,hunter,beastmastery,60,34,26
Karumä,thrall,1845,hunter,beastmastery,66,31,35
Inktray,durotan,1844,hunter,beastmastery,37,22,15
Zugbrained,illidan,1843,hunter,beastmastery,190,99,91
Ðeatheater,tichondrius,1843,hunter,beastmastery,41,21,20
Aqq,moon-guard,1842,hunter,beastmastery,98,58,40
Monffbe,tichondrius,1842,hunter,beastmastery,60,28,32
Swang,kiljaeden,1841,hunter,beastmastery,67,34,33
Sarutobi,black-dragonflight,1840,hunter,beastmastery,72,31,41
Auwstin,tichondrius,1837,hunter,beastmastery,55,31,24
Ashenga,cairne,1837,hunter,beastmastery,223,116,107
Lenalena,tichondrius,1836,hunter,beastmastery,107,58,49
Bowrockobama,illidan,1836,hunter,beastmastery,75,40,35
Ârtæmïs,stormrage,1835,hunter,beastmastery,48,24,24
Mørodox,sargeras,1834,hunter,beastmastery,54,24,30
Rëxx,moon-guard,1833,hunter,beastmastery,103,62,41
Hollymarie,nazjatar,1832,hunter,beastmastery,48,31,17
Absinther,emerald-dream,1829,hunter,beastmastery,66,41,25
Lkw,tichondrius,1829,hunter,beastmastery,80,37,43
Dju,stormrage,1828,hunter,beastmastery,95,51,44
Playnogames,moon-guard,1828,hunter,beastmastery,42,21,21
Oromia,proudmoore,1828,hunter,beastmastery,60,29,31
Vox,tichondrius,1827,hunter,beastmastery,46,30,16
Tyleraq,area-52,1827,hunter,beastmastery,41,24,17
Petmanx,tichondrius,1826,hunter,beastmastery,144,81,63
Zå,dalaran,1826,hunter,beastmastery,93,50,43
Sxra,area-52,1826,hunter,beastmastery,70,37,33
Negãn,tichondrius,1826,hunter,beastmastery,80,41,39
Flanzo,illidan,1825,hunter,beastmastery,59,32,27
Sosaho,sargeras,1825,hunter,beastmastery,41,21,20
Sniperælite,korgath,1824,hunter,beastmastery,55,32,23
Phatshiet,anvilmar,1823,hunter,beastmastery,50,31,19
Jeffersan,illidan,1823,hunter,beastmastery,149,72,77
Zumago,tichondrius,1823,hunter,beastmastery,118,54,64
Trap,demon-soul,1822,hunter,beastmastery,54,28,26
Zefbaby,quelthalas,1822,hunter,beastmastery,66,31,35
Tyreu,tichondrius,1820,hunter,beastmastery,59,30,29
Torolol,tichondrius,1819,hunter,beastmastery,126,73,53
Grimrokk,malganis,1819,hunter,beastmastery,78,40,38
Phayzd,sargeras,1818,hunter,beastmastery,66,34,32
Scuffedshots,tichondrius,1817,hunter,beastmastery,74,43,31
Lrnb,tichondrius,1817,hunter,beastmastery,56,32,24
Yucca,drenden,1816,hunter,beastmastery,42,23,19
Çute,moon-guard,1815,hunter,beastmastery,60,39,21
Flitt,zuljin,1815,hunter,beastmastery,36,19,17
Audeline,tichondrius,1815,hunter,beastmastery,69,33,36
Gumbro,malganis,1814,hunter,beastmastery,138,82,56
Comebacks,ragnaros,1814,hunter,beastmastery,72,41,31
Goonsh,tichondrius,1813,hunter,beastmastery,40,25,15
Asukaw,barthilas,1813,hunter,beastmastery,57,28,29
Mythxplosive,ragnaros,1813,hunter,beastmastery,73,32,41
Drektorath,bleeding-hollow,1812,hunter,beastmastery,66,34,32
Wodhunterxdd,tichondrius,1811,hunter,beastmastery,32,23,9
Logjohn,frostmourne,1811,hunter,beastmastery,40,20,20
Kybelís,dalaran,1810,hunter,beastmastery,110,61,49
Hogd,sargeras,1810,hunter,beastmastery,54,26,28
Robinhooz,illidan,1807,hunter,beastmastery,187,102,85
Wilmaßallfit,malganis,1807,hunter,beastmastery,65,29,36
Nishinos,tichondrius,1806,hunter,beastmastery,72,35,37
Lilprimary,tichondrius,1806,hunter,beastmastery,48,23,25
Sobewan,staghelm,1805,hunter,beastmastery,92,42,50
Kytan,shadowmoon,1804,hunter,beastmastery,168,82,86
Bustyredhead,kelthuzad,1804,hunter,beastmastery,95,42,53
Shot,shuhalo,1802,hunter,beastmastery,30,24,6
Kabalaku,moon-guard,1802,hunter,beastmastery,130,72,58
Warcher,azralon,1802,hunter,beastmastery,60,32,28
Hg,illidan,1800,hunter,beastmastery,38,25,13
Kangarookyle,illidan,1800,hunter,beastmastery,96,58,38
Shafttrapper,queldorei,1800,hunter,beastmastery,119,64,55
Funkyjunk,arthas,1800,hunter,beastmastery,72,35,37
Turtlegirl,tichondrius,1797,hunter,beastmastery,76,35,41
Songhammer,tichondrius,1793,hunter,beastmastery,100,55,45
Austelos,moon-guard,1793,hunter,beastmastery,95,52,43
Mikey,exodar,1789,hunter,beastmastery,204,116,88
Cuchulláin,area-52,1787,hunter,beastmastery,138,73,65
Skywvlker,illidan,1787,hunter,beastmastery,88,41,47
Sñïpêr,tichondrius,1784,hunter,beastmastery,53,29,24
Survchris,bleeding-hollow,1784,hunter,beastmastery,100,45,55
Pathofsexile,tichondrius,1783,hunter,beastmastery,93,43,50
Xgoh,sargeras,1782,hunter,beastmastery,42,22,20
Mukbangbj,terenas,1780,hunter,beastmastery,114,65,49
Junglefever,skywall,1778,hunter,beastmastery,46,26,20
Hunterphil,hyjal,1777,hunter,beastmastery,66,39,27
Edarkness,gurubashi,1776,hunter,beastmastery,176,84,92
Mckim,tichondrius,1775,hunter,beastmastery,48,28,20
Dayquillx,illidan,1775,hunter,beastmastery,42,21,21
Tyrokk,barthilas,1774,hunter,beastmastery,78,39,39
Livelovelaff,tichondrius,1773,hunter,beastmastery,54,28,26
Savagerko,illidan,1770,hunter,beastmastery,63,29,34
Asynic,blades-edge,1768,hunter,beastmastery,113,59,54
Tytonic,bleeding-hollow,1765,hunter,beastmastery,54,28,26
Vonkrieg,tichondrius,1764,hunter,beastmastery,41,25,16
Perffect,sargeras,1763,hunter,beastmastery,57,24,33
Tracershot,malganis,1758,hunter,beastmastery,101,58,43
Survivalists,kelthuzad,1752,hunter,beastmastery,36,24,12
Datbigbowdoe,illidan,1752,hunter,beastmastery,36,23,13
Mhters,tichondrius,1752,hunter,beastmastery,48,26,22
Tembaktytyd,barthilas,1751,hunter,beastmastery,49,24,25
Fockewulf,dragonmaw,1750,hunter,beastmastery,90,40,50
Airpodpro,emerald-dream,1747,hunter,beastmastery,36,21,15
Esstark,bleeding-hollow,1743,hunter,beastmastery,48,20,28
Madbéê,tichondrius,1741,hunter,beastmastery,41,19,22
Puffcopeak,illidan,1740,hunter,beastmastery,66,39,27
Fxsb,tichondrius,1739,hunter,beastmastery,158,74,84
Deathtomyfoe,sargeras,1735,hunter,beastmastery,54,21,33
Pineapplees,tichondrius,1733,hunter,beastmastery,54,29,25
Åspect,aegwynn,1732,hunter,beastmastery,53,28,25
Dahmer,greymane,1732,hunter,beastmastery,62,29,33
Melov,frostmourne,1730,hunter,beastmastery,64,30,34
Kidao,emerald-dream,1729,hunter,beastmastery,54,30,24
Liarael,illidan,1728,hunter,beastmastery,136,64,72
Squawkers,sargeras,1727,hunter,beastmastery,36,22,14
Xonios,frostwolf,1727,hunter,beastmastery,90,46,44
Sniper,area-52,1725,hunter,beastmastery,182,90,92
Dragonspider,zuljin,1724,hunter,beastmastery,30,21,9
Krunkz,frostmourne,1724,hunter,beastmastery,53,33,20
Ðfac,moon-guard,1724,hunter,beastmastery,84,42,42
Reparcero,quelthalas,1723,hunter,beastmastery,42,20,22
Bootydoo,illidan,1721,hunter,beastmastery,130,67,63
Chrisp,bloodhoof,1721,hunter,beastmastery,48,23,25
Kenpachie,jubeithos,1716,hunter,beastmastery,35,23,12
Kenji,sargeras,1716,hunter,beastmastery,80,40,40
Twixzorz,boulderfist,1716,hunter,beastmastery,60,28,32
Lucki,blades-edge,1715,hunter,beastmastery,60,34,26
Acres,emerald-dream,1714,hunter,beastmastery,27,19,8
Warrccjr,steamwheedle-cartel,1714,hunter,beastmastery,47,21,26
Ryûkø,quelthalas,1712,hunter,beastmastery,84,41,43
Fanikita,azralon,1712,hunter,beastmastery,75,31,44
Laoai,tichondrius,1711,hunter,beastmastery,37,23,14
Revalay,emerald-dream,1711,hunter,beastmastery,54,32,22
Edelyysa,arthas,1711,hunter,beastmastery,180,89,91
Squeekin,sargeras,1709,hunter,beastmastery,33,26,7
Shablagoosh,zuljin,1706,hunter,beastmastery,37,25,12
Sbplayshunt,akama,1706,hunter,beastmastery,48,19,29
Xorian,frostmourne,1705,hunter,beastmastery,36,18,18
Pkkfantasy,archimonde,1704,hunter,beastmastery,82,44,38
Saintpablo,mannoroth,1702,hunter,beastmastery,54,29,25
Hyjax,darkspear,1701,hunter,beastmastery,43,26,17
Snowmnz,tichondrius,1701,hunter,beastmastery,53,30,23
Raymose,tichondrius,1701,hunter,beastmastery,64,30,34
Killshøtß,tichondrius,1701,hunter,beastmastery,65,30,35
Fatalshots,bonechewer,1699,hunter,beastmastery,42,24,18
Pepepls,proudmoore,1699,hunter,beastmastery,72,38,34
Wodunaz,stormrage,1698,hunter,beastmastery,71,45,26
Geeshot,area-52,1698,hunter,beastmastery,66,27,39
Urukah,gallywix,1697,hunter,beastmastery,40,19,21
Sambucca,daggerspine,1696,hunter,beastmastery,54,26,28
Bowreckage,malganis,1695,hunter,beastmastery,251,121,130
Mojopojo,tichondrius,1694,hunter,beastmastery,61,35,26
Jfkd,sargeras,1694,hunter,beastmastery,52,21,31
Spídër,maiev,1692,hunter,beastmastery,62,31,31
Nobito,quelthalas,1691,hunter,beastmastery,153,82,71
Bicas,emerald-dream,1689,hunter,beastmastery,72,37,35
Shadowfangs,tichondrius,1689,hunter,beastmastery,66,31,35
Hxnry,barthilas,1686,hunter,beastmastery,30,18,12
Cresselia,drakkari,1686,hunter,beastmastery,53,29,24
Fabbs,frostmourne,1686,hunter,beastmastery,52,26,26
Dirtymongrel,barthilas,1685,hunter,beastmastery,96,49,47
Illweedx,kiljaeden,1684,hunter,beastmastery,125,56,69
Lilskill,lightnings-blade,1682,hunter,beastmastery,30,18,12
Ipickmynose,tichondrius,1681,hunter,beastmastery,71,41,30
Kapukapu,illidan,1679,hunter,beastmastery,30,18,12
Darylovejr,destromath,1679,hunter,beastmastery,36,19,17
Flor,boulderfist,1679,hunter,beastmastery,38,20,18
Silverbite,garona,1678,hunter,beastmastery,92,51,41
Shootnskoot,icecrown,1677,hunter,beastmastery,30,20,10
Shootiepie,hyjal,1677,hunter,beastmastery,30,19,11
Coopshot,darkspear,1675,hunter,beastmastery,69,40,29
Saiiphz,bleeding-hollow,1675,hunter,beastmastery,40,22,18
Tuân,azgalor,1674,hunter,beastmastery,36,23,13
Alaurys,moon-guard,1674,hunter,beastmastery,35,18,17
Scythedom,tichondrius,1673,hunter,beastmastery,48,23,25
Spizsnipes,malganis,1672,hunter,beastmastery,66,30,36
Facerolled,area-52,1671,hunter,beastmastery,93,54,39
Xionos,wyrmrest-accord,1671,hunter,beastmastery,144,75,69
Sissleto,tichondrius,1667,hunter,beastmastery,347,172,175
Koalahunter,area-52,1667,hunter,beastmastery,76,31,45
Mortalz,barthilas,1663,hunter,beastmastery,208,108,100
Hokutoxx,tichondrius,1663,hunter,beastmastery,61,25,36
Yughii,stormrage,1662,hunter,beastmastery,42,20,22
Pinêapplê,bleeding-hollow,1661,hunter,beastmastery,36,23,13
Thtswap,moon-guard,1661,hunter,beastmastery,48,30,18
Showtheio,azralon,1660,hunter,beastmastery,41,22,19
Whoshotu,tichondrius,1660,hunter,beastmastery,53,27,26
Sasorï,nemesis,1659,hunter,beastmastery,30,19,11
Dj,arygos,1658,hunter,beastmastery,36,21,15
Dpdóugh,illidan,1658,hunter,beastmastery,112,59,53
Illsugoi,frostwolf,1657,hunter,beastmastery,141,70,71
Showmakerc,proudmoore,1656,hunter,beastmastery,77,35,42
Shyck,ragnaros,1655,hunter,beastmastery,59,31,28
Casperonni,illidan,1654,hunter,beastmastery,120,64,56
Gufanyaun,tichondrius,1654,hunter,beastmastery,34,18,16
Smullik,wyrmrest-accord,1654,hunter,beastmastery,114,51,63
Thezeus,barthilas,1654,hunter,beastmastery,47,20,27
Crounzz,sargeras,1654,hunter,beastmastery,72,28,44
Terpa,nemesis,1653,hunter,beastmastery,184,96,88
Rndx,sargeras,1653,hunter,beastmastery,46,20,26
Sylviai,hyjal,1652,hunter,beastmastery,77,40,37
Kwinoah,zuljin,1652,hunter,beastmastery,174,84,90
Teddybowschi,sargeras,1650,hunter,beastmastery,35,18,17
Odb,kelthuzad,1650,hunter,beastmastery,48,20,28
Mojopotato,stormrage,1649,hunter,beastmastery,77,37,40
Ñðñdêsçrípt,frostmourne,1648,hunter,beastmastery,109,59,50
Eastwood,tichondrius,1648,hunter,beastmastery,92,41,51
Rcman,tichondrius,1647,hunter,beastmastery,54,41,13
Cw,gorefiend,1647,hunter,beastmastery,48,25,23
Camhaanes,area-52,1646,hunter,beastmastery,119,67,52
Zemphoths,eredar,1645,hunter,beastmastery,93,41,52
Urzoth,tichondrius,1644,hunter,beastmastery,54,35,19
Trapordíe,tichondrius,1644,hunter,beastmastery,42,23,19
Mauklindaufe,fenris,1644,hunter,beastmastery,85,43,42
Mlemily,stormrage,1643,hunter,beastmastery,63,36,27
Cachín,ragnaros,1642,hunter,beastmastery,54,26,28
Icecaffemoca,tichondrius,1641,hunter,beastmastery,56,25,31
Kaelhim,warsong,1638,hunter,beastmastery,28,20,8
Andalora,malganis,1638,hunter,beastmastery,67,30,37
Publicpooper,tichondrius,1637,hunter,beastmastery,36,21,15
Energiser,stormrage,1637,hunter,beastmastery,58,29,29
Mmeep,illidan,1636,hunter,beastmastery,58,30,28
Mcclintock,executus,1636,hunter,beastmastery,41,21,20
Massacration,area-52,1636,hunter,beastmastery,51,22,29
Drakarth,khazgoroth,1635,hunter,beastmastery,47,22,25
Kushaddict,lightnings-blade,1634,hunter,beastmastery,208,97,111
Kahll,azralon,1634,hunter,beastmastery,54,24,30
Plastera,zuljin,1634,hunter,beastmastery,52,23,29
Montano,area-52,1633,hunter,beastmastery,32,22,10
Svsnipe,tichondrius,1633,hunter,beastmastery,61,35,26
Beastkets,area-52,1632,hunter,beastmastery,60,31,29
Airhunt,thrall,1632,hunter,beastmastery,42,19,23
Damadar,tichondrius,1632,hunter,beastmastery,42,19,23
Thebush,dragonmaw,1629,hunter,beastmastery,84,48,36
Axxll,tichondrius,1629,hunter,beastmastery,55,25,30
Cocoapuffs,cenarius,1627,hunter,beastmastery,36,17,19
Onemoreshot,bleeding-hollow,1626,hunter,beastmastery,84,44,40
Layloww,thrall,1626,hunter,beastmastery,36,18,18
Reachme,moon-guard,1624,hunter,beastmastery,36,17,19
Urukkz,goldrinn,1624,hunter,beastmastery,48,21,27
Liadrelle,proudmoore,1624,hunter,beastmastery,57,24,33
Whitecake,area-52,1623,hunter,beastmastery,40,25,15
Grimbrew,garona,1623,hunter,beastmastery,41,24,17
Shootsb,tichondrius,1623,hunter,beastmastery,58,24,34
Zakalla,malganis,1622,hunter,beastmastery,62,33,29
Trickshotss,illidan,1621,hunter,beastmastery,106,63,43
Metrallon,black-dragonflight,1621,hunter,beastmastery,53,29,24
Sonichunterr,illidan,1620,hunter,beastmastery,76,46,30
Brokiînn,aegwynn,1619,hunter,beastmastery,129,67,62
Rürü,illidan,1618,hunter,beastmastery,40,21,19
Darkoshuntar,tichondrius,1617,hunter,beastmastery,30,17,13
Montakka,illidan,1617,hunter,beastmastery,54,28,26
Oblivîon,illidan,1616,hunter,beastmastery,59,38,21
Phiyuh,stormrage,1616,hunter,beastmastery,72,42,30
Huntinpuss,tichondrius,1616,hunter,beastmastery,32,18,14
Telånnas,illidan,1616,hunter,beastmastery,42,21,21
Skytrooper,boulderfist,1616,hunter,beastmastery,59,26,33
Nooche,bleeding-hollow,1615,hunter,beastmastery,36,22,14
Monatre,fizzcrank,1615,hunter,beastmastery,51,22,29
Unloaded,illidan,1614,hunter,beastmastery,51,32,19
Wøden,draka,1614,hunter,beastmastery,72,38,34
Legoflaiz,drakkari,1614,hunter,beastmastery,48,23,25
Apøllö,kilrogg,1614,hunter,beastmastery,262,123,139
Pillarington,tichondrius,1613,hunter,beastmastery,52,32,20
Ecl,azralon,1613,hunter,beastmastery,48,27,21
Bamfhunt,darkspear,1612,hunter,beastmastery,99,52,47
Thamie,tichondrius,1610,hunter,beastmastery,24,17,7
Vanasir,moon-guard,1610,hunter,beastmastery,47,24,23
Mambothehunt,stormrage,1610,hunter,beastmastery,89,42,47
Lark,emerald-dream,1609,hunter,beastmastery,33,18,15
Kaizong,hyjal,1609,hunter,beastmastery,41,22,19
Asurvivor,suramar,1609,hunter,beastmastery,190,98,92
Mournebow,tichondrius,1608,hunter,beastmastery,279,151,128
Statistic,black-dragonflight,1608,hunter,beastmastery,59,30,29
Bertimus,sargeras,1608,hunter,beastmastery,132,61,71
Recklaw,frostmourne,1607,hunter,beastmastery,36,21,15
Parnicyon,frostmourne,1607,hunter,beastmastery,209,109,100
Focusfire,khazgoroth,1607,hunter,beastmastery,66,32,34
Mordriva,azjolnerub,1607,hunter,beastmastery,53,25,28
Feignmilf,tichondrius,1606,hunter,beastmastery,84,51,33
Shootnoscore,vashj,1606,hunter,beastmastery,83,46,37
Elad,tichondrius,1606,hunter,beastmastery,102,55,47
Foxqt,emerald-dream,1606,hunter,beastmastery,38,20,18
Teneightt,tichondrius,1606,hunter,beastmastery,68,34,34
Nodougaelark,dalaran,1606,hunter,beastmastery,48,20,28
Mvpwonder,frostmourne,1606,hunter,beastmastery,54,22,32
Legacyhunter,nazgrel,1605,hunter,beastmastery,30,17,13
Légölás,tichondrius,1603,hunter,beastmastery,84,47,37
Dreygar,dawnbringer,1603,hunter,beastmastery,129,66,63
Jillypoo,azralon,1602,hunter,beastmastery,30,21,9
Scattertrap,ragnaros,1601,hunter,beastmastery,30,20,10
Bettallana,tichondrius,1601,hunter,beastmastery,30,17,13
Axis,mugthol,1601,hunter,beastmastery,85,45,40
Aazua,frostmourne,1601,hunter,beastmastery,45,22,23
Snewfly,tichondrius,1600,hunter,beastmastery,54,36,18
Getrekt,azralon,1600,hunter,beastmastery,78,38,40
Goongarg,frostmourne,1600,hunter,beastmastery,36,17,19
Fernn,illidan,1599,hunter,beastmastery,170,79,91
Razor,destromath,1598,hunter,beastmastery,82,38,44
Vanero,eonar,1598,hunter,beastmastery,48,22,26
Lexandr,tichondrius,1597,hunter,beastmastery,120,65,55
Beasting,moon-guard,1596,hunter,beastmastery,54,29,25
Hillside,frostmourne,1595,hunter,beastmastery,89,45,44
Morbow,proudmoore,1593,hunter,beastmastery,82,46,36
Consanguin,sargeras,1590,hunter,beastmastery,42,24,18
Grindal,drakkari,1590,hunter,beastmastery,54,25,29
Merkidy,illidan,1588,hunter,beastmastery,35,20,15
Häm,dalaran,1588,hunter,beastmastery,148,79,69
Killwill,illidan,1587,hunter,beastmastery,54,28,26
Assbow,kiljaeden,1586,hunter,beastmastery,115,52,63
Hofftimus,tichondrius,1585,hunter,beastmastery,82,53,29
Sashagreen,frostmourne,1585,hunter,beastmastery,83,43,40
Toxarch,aggramar,1585,hunter,beastmastery,78,39,39
Lissavi,tichondrius,1581,hunter,beastmastery,42,21,21
Kniightjayyx,kelthuzad,1581,hunter,beastmastery,114,51,63
Stonehard,mugthol,1581,hunter,beastmastery,42,17,25
Chaw,nathrezim,1579,hunter,beastmastery,196,103,93
Bloodymalik,tichondrius,1578,hunter,beastmastery,42,18,24
Reloadz,shattered-hand,1577,hunter,beastmastery,52,29,23
Zyzzmirin,illidan,1577,hunter,beastmastery,78,35,43
Overshot,tichondrius,1577,hunter,beastmastery,72,31,41
Zakrogg,tichondrius,1576,hunter,beastmastery,59,28,31
Squishasf,tichondrius,1575,hunter,beastmastery,30,18,12
Elieliloa,quelthalas,1573,hunter,beastmastery,60,29,31
Squeeb,frostmourne,1572,hunter,beastmastery,62,30,32
Zennifi,bleeding-hollow,1570,hunter,beastmastery,97,49,48
Snipin,ragnaros,1570,hunter,beastmastery,48,18,30
Phindo,agamaggan,1569,hunter,beastmastery,36,20,16
Kopula,illidan,1569,hunter,beastmastery,55,30,25
Robnhunt,tichondrius,1568,hunter,beastmastery,36,18,18
Rektarrow,area-52,1568,hunter,beastmastery,47,23,24
Skeetslinger,illidan,1568,hunter,beastmastery,45,18,27
Ddänz,kiljaeden,1568,hunter,beastmastery,72,28,44
Petkd,frostmourne,1566,hunter,beastmastery,48,27,21
Tinyted,nathrezim,1566,hunter,beastmastery,84,43,41
Morganson,moon-guard,1566,hunter,beastmastery,222,113,109
Bubbzar,frostmourne,1564,hunter,beastmastery,54,29,25
Njörðr,eldrethalas,1564,hunter,beastmastery,42,20,22
Yandralen,kiljaeden,1563,hunter,beastmastery,117,63,54
Uzpak,tichondrius,1561,hunter,beastmastery,77,44,33
Ahuamax,tichondrius,1559,hunter,beastmastery,82,47,35
Lasix,burning-blade,1559,hunter,beastmastery,107,52,55
Lele,stormrage,1556,hunter,beastmastery,67,38,29
Lemmetrap,illidan,1554,hunter,beastmastery,41,22,19
Keboks,alleria,1551,hunter,beastmastery,33,18,15
Reay,frostmourne,1551,hunter,beastmastery,36,19,17
Khaydarin,sargeras,1551,hunter,beastmastery,48,21,27
Kolyanis,stormrage,1550,hunter,beastmastery,95,52,43
Partz,darkspear,1549,hunter,beastmastery,36,20,16
Readtitle,malganis,1546,hunter,beastmastery,60,35,25
Gernon,frostmourne,1546,hunter,beastmastery,39,20,19
Despairius,moon-guard,1543,hunter,beastmastery,44,25,19
Deirrë,saurfang,1543,hunter,beastmastery,191,103,88
Outfazed,tichondrius,1541,hunter,beastmastery,105,57,48
Ungoliánt,cairne,1541,hunter,beastmastery,54,28,26
Dôntlosmebro,stormrage,1540,hunter,beastmastery,66,37,29
Varka,area-52,1539,hunter,beastmastery,36,20,16
Cerébro,illidan,1538,hunter,beastmastery,78,31,47
Laurenx,illidan,1537,hunter,beastmastery,33,20,13
Somethinglit,sargeras,1537,hunter,beastmastery,75,38,37
Runforthehil,barthilas,1537,hunter,beastmastery,60,30,30
Mms,frostmourne,1532,hunter,beastmastery,30,18,12
Freebeë,area-52,1531,hunter,beastmastery,85,49,36
Biehuixin,tichondrius,1531,hunter,beastmastery,74,34,40
Tsuro,area-52,1530,hunter,beastmastery,59,30,29
Buggyhuntz,stormrage,1529,hunter,beastmastery,55,33,22
Cyrsmen,ragnaros,1529,hunter,beastmastery,234,116,118
Teaks,aggramar,1527,hunter,beastmastery,30,16,14
Breezekeeper,area-52,1527,hunter,beastmastery,78,40,38
Shadowtensai,stormrage,1527,hunter,beastmastery,78,34,44
Sindragostra,tichondrius,1526,hunter,beastmastery,123,62,61
Robitur,sargeras,1526,hunter,beastmastery,36,17,19
Tus,tichondrius,1526,hunter,beastmastery,36,16,20
Exitwoundz,hyjal,1524,hunter,beastmastery,59,29,30
Broydiesnipe,illidan,1523,hunter,beastmastery,24,16,8
Ullr,gurubashi,1522,hunter,beastmastery,76,28,48
Thoridhal,quelthalas,1521,hunter,beastmastery,36,20,16
Lindsang,illidan,1520,hunter,beastmastery,60,31,29
Bonnèy,zuljin,1518,hunter,beastmastery,49,32,17
Barbed,blackrock,1518,hunter,beastmastery,36,16,20
Clinteastwoo,ragnaros,1517,hunter,beastmastery,48,16,32
Hazzeth,thrall,1516,hunter,beastmastery,30,21,9
Nitroxl,illidan,1516,hunter,beastmastery,66,34,32
Bigolekack,tichondrius,1516,hunter,beastmastery,54,27,27
Balldik,bleeding-hollow,1516,hunter,beastmastery,42,20,22
Whatfoxsay,tichondrius,1513,hunter,beastmastery,54,26,28
Yager,kalecgos,1512,hunter,beastmastery,52,26,26
Dorkins,azralon,1511,hunter,beastmastery,44,25,19
Askelon,firetree,1511,hunter,beastmastery,45,22,23
Gamestopceo,tichondrius,1511,hunter,beastmastery,84,41,43
Hobbingtons,thunderlord,1510,hunter,beastmastery,36,19,17
Kript,dragonmaw,1510,hunter,beastmastery,385,186,199
Yugno,wildhammer,1509,hunter,beastmastery,36,19,17
Kaliaraan,bleeding-hollow,1509,hunter,beastmastery,82,43,39
Internade,frostmourne,1509,hunter,beastmastery,54,25,29
Myladyy,zuljin,1509,hunter,beastmastery,71,30,41
Pingaamarela,nemesis,1508,hunter,beastmastery,198,106,92
Qlbl,tichondrius,1508,hunter,beastmastery,57,27,30
Sanchode,tichondrius,1508,hunter,beastmastery,48,20,28
Datadyne,stormrage,1507,hunter,beastmastery,18,16,2
Velhokoira,illidan,1507,hunter,beastmastery,54,31,23
Diavál,area-52,1507,hunter,beastmastery,46,26,20
Sereom,frostmourne,1505,hunter,beastmastery,131,74,57
Volbz,barthilas,1505,hunter,beastmastery,36,16,20
Yeaheh,area-52,1504,hunter,beastmastery,30,18,12
Emilysamuels,tichondrius,1503,hunter,beastmastery,24,16,8
Pankyrangs,kelthuzad,1503,hunter,beastmastery,48,24,24
Fkkroglash,barthilas,1501,hunter,beastmastery,42,23,19
Chrest,sargeras,1500,hunter,beastmastery,76,39,37
Irøneye,sargeras,1499,hunter,beastmastery,55,20,35
Entrapment,emerald-dream,1498,hunter,beastmastery,41,22,19
Folf,turalyon,1497,hunter,beastmastery,78,34,44
Sartel,tichondrius,1495,hunter,beastmastery,30,17,13
Shockwave,velen,1495,hunter,beastmastery,236,120,116
Ramchi,burning-blade,1494,hunter,beastmastery,61,33,28
Xuorias,area-52,1494,hunter,beastmastery,47,24,23
Kaboomza,tichondrius,1493,hunter,beastmastery,36,19,17
Zünma,tichondrius,1492,hunter,beastmastery,30,16,14
Punjisticks,tichondrius,1492,hunter,beastmastery,110,53,57
Finalshot,barthilas,1491,hunter,beastmastery,39,18,21
Pavlovik,ragnaros,1491,hunter,beastmastery,60,25,35
Anastasia,gorgonnash,1490,hunter,beastmastery,66,36,30
Oceandoom,tichondrius,1489,hunter,beastmastery,146,78,68
Limcross,drakkari,1489,hunter,beastmastery,56,28,28
Setepalms,azralon,1489,hunter,beastmastery,38,18,20
Wredd,nemesis,1488,hunter,beastmastery,35,20,15
Borudin,stormrage,1488,hunter,beastmastery,215,104,111
Scirfreez,ragnaros,1487,hunter,beastmastery,66,30,36
Laras,blades-edge,1484,hunter,beastmastery,36,22,14
Chizhi,tichondrius,1484,hunter,beastmastery,90,45,45
Midgetsniper,thrall,1481,hunter,beastmastery,32,17,15
Chowyunfatss,proudmoore,1481,hunter,beastmastery,112,53,59
Selhort,quelthalas,1481,hunter,beastmastery,84,36,48
Rengarok,emerald-dream,1480,hunter,beastmastery,44,23,21
Grànd,tortheldrin,1480,hunter,beastmastery,66,33,33
Angdre,tichondrius,1480,hunter,beastmastery,36,18,18
Shedowhunter,azralon,1479,hunter,beastmastery,36,23,13
Junmuxiao,ragnaros,1478,hunter,beastmastery,124,61,63
Scourgesurge,kiljaeden,1478,hunter,beastmastery,145,71,74
Spitballa,emerald-dream,1478,hunter,beastmastery,60,28,32
Josyv,quelthalas,1477,hunter,beastmastery,36,21,15
Garzb,area-52,1476,hunter,beastmastery,42,22,20
Aguntur,ragnaros,1474,hunter,beastmastery,99,59,40
Loktarnum,illidan,1474,hunter,beastmastery,52,23,29
Narus,whisperwind,1472,hunter,beastmastery,126,72,54
Virolac,tichondrius,1469,hunter,beastmastery,32,16,16
Caetomon,kiljaeden,1467,hunter,beastmastery,29,18,11
Zaetor,ragnaros,1466,hunter,beastmastery,78,43,35
Hughneutron,kirin-tor,1466,hunter,beastmastery,249,136,113
Tacos,kelthuzad,1465,hunter,beastmastery,36,22,14
Sootgarbage,sargeras,1464,hunter,beastmastery,72,42,30
Lunarlunar,khadgar,1464,hunter,beastmastery,48,20,28
Xpyro,azralon,1462,hunter,beastmastery,72,36,36
ßoness,area-52,1460,hunter,beastmastery,92,38,54
Danncer,alexstrasza,1459,hunter,beastmastery,102,56,46
Bootylickin,tichondrius,1459,hunter,beastmastery,36,17,19
Pheijaumn,azralon,1458,hunter,beastmastery,55,32,23
Ehnó,illidan,1458,hunter,beastmastery,39,19,20
Mikly,ragnaros,1457,hunter,beastmastery,44,18,26
Jaysuper,zuljin,1457,hunter,beastmastery,66,25,41
Fifie,azgalor,1455,hunter,beastmastery,55,28,27
Wolfarms,area-52,1455,hunter,beastmastery,87,42,45
Earlzmoade,bleeding-hollow,1454,hunter,beastmastery,42,21,21
Hongnael,tichondrius,1452,hunter,beastmastery,36,17,19
Sax,stormreaver,1452,hunter,beastmastery,36,16,20
Fusbowdah,bleeding-hollow,1451,hunter,beastmastery,64,29,35
Salvatiel,stormrage,1447,hunter,beastmastery,36,21,15
Stalkstride,destromath,1447,hunter,beastmastery,78,36,42
Jacss,azralon,1446,hunter,beastmastery,30,17,13
Bronke,azralon,1446,hunter,beastmastery,67,30,37
Jugi,wyrmrest-accord,1444,hunter,beastmastery,60,30,30
Gorgoon,sargeras,1444,hunter,beastmastery,42,21,21
Kouandjio,area-52,1444,hunter,beastmastery,36,18,18
Limpnoodle,nerzhul,1443,hunter,beastmastery,170,83,87
Sabanna,proudmoore,1442,hunter,beastmastery,36,20,16
Zanahoria,stormscale,1442,hunter,beastmastery,43,19,24
Daarrk,thrall,1441,hunter,beastmastery,82,39,43
Akoshi,illidan,1440,hunter,beastmastery,30,16,14
Dontmissz,tichondrius,1439,hunter,beastmastery,59,32,27
Gennaro,ragnaros,1439,hunter,beastmastery,30,15,15
Lashga,wyrmrest-accord,1439,hunter,beastmastery,47,22,25
Yná,azralon,1438,hunter,beastmastery,24,15,9
Critterz,gorgonnash,1438,hunter,beastmastery,71,32,39
Bigclamz,dragonmaw,1437,hunter,beastmastery,45,25,20
Bliv,tichondrius,1436,hunter,beastmastery,18,15,3
Aristæos,kelthuzad,1436,hunter,beastmastery,77,40,37
Sungoro,tichondrius,1436,hunter,beastmastery,78,35,43
Squírtle,ragnaros,1436,hunter,beastmastery,36,15,21
Sarahbeara,moonrunner,1435,hunter,beastmastery,24,15,9
Alexxspewpew,ragnaros,1434,hunter,beastmastery,29,15,14
Seatback,arathor,1432,hunter,beastmastery,76,33,43
Kkoner,illidan,1431,hunter,beastmastery,24,15,9
Cyboreg,stormrage,1431,hunter,beastmastery,53,30,23
Seljzs,zuljin,1430,hunter,beastmastery,24,15,9
Cigâro,thrall,1429,hunter,beastmastery,165,84,81
Prierhunt,frostmourne,1429,hunter,beastmastery,36,15,21
Droneshot,tichondrius,1428,hunter,beastmastery,36,24,12
Zarova,moon-guard,1428,hunter,beastmastery,24,15,9
Dabondweebs,dalaran,1428,hunter,beastmastery,36,20,16
Snypêr,tichondrius,1428,hunter,beastmastery,48,21,27
Lilbic,bleeding-hollow,1427,hunter,beastmastery,33,22,11
Iyne,stormrage,1427,hunter,beastmastery,36,15,21
Munyshotz,tichondrius,1426,hunter,beastmastery,104,59,45
Yaisk,tichondrius,1426,hunter,beastmastery,74,38,36
Kleankilla,malganis,1425,hunter,beastmastery,50,27,23
Taelen,aegwynn,1424,hunter,beastmastery,50,26,24
Szone,tichondrius,1424,hunter,beastmastery,124,59,65
Syldris,proudmoore,1423,hunter,beastmastery,24,15,9
Handicrap,tichondrius,1423,hunter,beastmastery,44,26,18
Huntard,stormrage,1423,hunter,beastmastery,36,15,21
Kellsier,nordrassil,1422,hunter,beastmastery,30,15,15
Keknine,gnomeregan,1421,hunter,beastmastery,92,44,48
Boomseed,nagrand,1420,hunter,beastmastery,34,16,18
Kerandas,stormrage,1419,hunter,beastmastery,29,16,13
Mukeru,stormrage,1418,hunter,beastmastery,24,15,9
Araghrn,draktharon,1417,hunter,beastmastery,111,54,57
Celarla,tichondrius,1416,hunter,beastmastery,27,16,11
Gannidema,illidan,1416,hunter,beastmastery,30,17,13
Eldlichi,proudmoore,1416,hunter,beastmastery,48,20,28
Belime,korgath,1415,hunter,beastmastery,96,53,43
Horcnbeans,bleeding-hollow,1415,hunter,beastmastery,203,99,104
Javoz,drakkari,1415,hunter,beastmastery,42,18,24
Terminatôr,malganis,1415,hunter,beastmastery,36,15,21
Drunkhunter,malygos,1414,hunter,beastmastery,24,15,9
Legolasbow,tichondrius,1414,hunter,beastmastery,58,30,28
Wrècked,kiljaeden,1413,hunter,beastmastery,42,19,23
Puppe,sargeras,1412,hunter,beastmastery,52,25,27
Existential,moon-guard,1412,hunter,beastmastery,59,27,32
Turbows,proudmoore,1412,hunter,beastmastery,48,20,28
Mopgodxqt,nemesis,1410,hunter,beastmastery,48,19,29
Shangowar,darrowmere,1409,hunter,beastmastery,24,15,9
Zombified,moon-guard,1409,hunter,beastmastery,50,23,27
Hobbléfoot,proudmoore,1409,hunter,beastmastery,36,15,21
Drig,korgath,1409,hunter,beastmastery,47,19,28
Boomsprocket,khazgoroth,1407,hunter,beastmastery,26,19,7
Dlabio,emerald-dream,1405,hunter,beastmastery,102,50,52
Sioul,bleeding-hollow,1403,hunter,beastmastery,30,15,15
Sharpster,zuljin,1403,hunter,beastmastery,85,41,44
Ruffini,tichondrius,1403,hunter,beastmastery,42,18,24
Sliturthroat,barthilas,1402,hunter,beastmastery,50,20,30
Floopze,burning-legion,1399,hunter,beastmastery,30,16,14
Thralzun,dunemaul,1398,hunter,beastmastery,43,22,21
Luckshot,destromath,1398,hunter,beastmastery,60,27,33
Overshot,barthilas,1397,hunter,beastmastery,24,16,8
Jyttrg,tichondrius,1396,hunter,beastmastery,65,34,31
Elyssandrá,thrall,1396,hunter,beastmastery,107,52,55
Spèedbump,stormrage,1394,hunter,beastmastery,81,40,41
Petmayo,tichondrius,1393,hunter,beastmastery,30,19,11
Dinaoce,frostmourne,1393,hunter,beastmastery,78,39,39
Huntncheekz,kelthuzad,1393,hunter,beastmastery,30,15,15
Grumnz,thrall,1393,hunter,beastmastery,30,15,15
Unrealpewpew,lightbringer,1393,hunter,beastmastery,108,48,60
Timmee,bleeding-hollow,1392,hunter,beastmastery,36,15,21
Liillilliil,tichondrius,1391,hunter,beastmastery,31,16,15
Paganfinn,tichondrius,1391,hunter,beastmastery,66,29,37
Fuzzypjs,stormrage,1390,hunter,beastmastery,42,24,18
Rycksanches,quelthalas,1390,hunter,beastmastery,73,35,38
Tentoontrey,emerald-dream,1390,hunter,beastmastery,42,20,22
Jesselos,stormrage,1390,hunter,beastmastery,54,25,29
Sülivan,zuljin,1388,hunter,beastmastery,55,29,26
Recha,emerald-dream,1388,hunter,beastmastery,42,21,21
Genx,frostmane,1387,hunter,beastmastery,89,44,45
Fleetfox,tichondrius,1385,hunter,beastmastery,115,57,58
Alwaysblazed,hyjal,1383,hunter,beastmastery,36,17,19
Revbubs,darkspear,1382,hunter,beastmastery,60,30,30
Darthski,drenden,1382,hunter,beastmastery,62,29,33
Tearsofnoobs,tichondrius,1381,hunter,beastmastery,33,16,17
Meowimadog,spinebreaker,1380,hunter,beastmastery,36,23,13
Viperstng,area-52,1380,hunter,beastmastery,70,40,30
Lastanar,amanthul,1376,hunter,beastmastery,122,65,57
Killshotqq,tichondrius,1375,hunter,beastmastery,40,18,22
Fruitenveg,frostmourne,1374,hunter,beastmastery,36,18,18
ßutter,thunderlord,1374,hunter,beastmastery,171,80,91
Gejagt,sargeras,1373,hunter,beastmastery,43,23,20
Tearsofrogue,tichondrius,1373,hunter,beastmastery,30,16,14
Lilpoots,warsong,1373,hunter,beastmastery,71,33,38
Chrise,darkspear,1371,hunter,beastmastery,24,18,6
Kleivar,alleria,1370,hunter,beastmastery,30,15,15
Therooth,bleeding-hollow,1369,hunter,beastmastery,53,31,22
Phaction,tichondrius,1369,hunter,beastmastery,60,26,34
Jangle,mannoroth,1368,hunter,beastmastery,34,19,15
Léfty,burning-blade,1368,hunter,beastmastery,55,21,34
Stonëdpimp,moon-guard,1366,hunter,beastmastery,24,15,9
Voodoohunter,blood-furnace,1366,hunter,beastmastery,47,25,22
Wulfgeng,azgalor,1366,hunter,beastmastery,100,51,49
Bubbz,bloodscalp,1365,hunter,beastmastery,126,67,59
Femonemos,nemesis,1364,hunter,beastmastery,55,29,26
Terrygross,sargeras,1364,hunter,beastmastery,36,15,21
Yembohi,queldorei,1363,hunter,beastmastery,24,15,9
Eightbeers,bleeding-hollow,1363,hunter,beastmastery,80,43,37
Stfd,illidan,1363,hunter,beastmastery,38,15,23
Aggargh,baelgun,1362,hunter,beastmastery,51,28,23
Boward,illidan,1362,hunter,beastmastery,67,36,31
Blackspit,ragnaros,1362,hunter,beastmastery,65,34,31
Ogkhalifa,tichondrius,1362,hunter,beastmastery,59,26,33
Moistlegs,proudmoore,1360,hunter,beastmastery,36,16,20
Wook,hyjal,1359,hunter,beastmastery,35,17,18
Ryukuzen,tichondrius,1359,hunter,beastmastery,35,15,20
Shlandy,frostmourne,1356,hunter,beastmastery,32,18,14
Oblíviion,stormrage,1356,hunter,beastmastery,62,33,29
Reallybroke,stormrage,1355,hunter,beastmastery,33,16,17
Kronc,dethecus,1355,hunter,beastmastery,40,16,24
Deadlyarrows,ragnaros,1354,hunter,beastmastery,78,35,43
Saintshaka,drakkari,1353,hunter,beastmastery,23,15,8
Tokendaily,sargeras,1353,hunter,beastmastery,72,40,32
Nephewblasty,nagrand,1353,hunter,beastmastery,36,18,18
Xcisiion,nagrand,1353,hunter,beastmastery,69,31,38
Cinamong,blackrock,1347,hunter,beastmastery,30,15,15
Pokérap,dalaran,1347,hunter,beastmastery,42,17,25
Djfortnité,tichondrius,1343,hunter,beastmastery,24,14,10
Huntmon,nemesis,1343,hunter,beastmastery,30,14,16
Wildlifezoo,tichondrius,1343,hunter,beastmastery,30,14,16
Willdey,frostmourne,1343,hunter,beastmastery,36,14,22
Kronas,laughing-skull,1342,hunter,beastmastery,47,24,23
Pressbro,tichondrius,1342,hunter,beastmastery,30,14,16
Lilien,khazgoroth,1341,hunter,beastmastery,30,18,12
Bingdat,area-52,1341,hunter,beastmastery,88,45,43
Choclit,scilla,1341,hunter,beastmastery,42,14,28
Devised,proudmoore,1340,hunter,beastmastery,29,16,13
Burtone,aegwynn,1340,hunter,beastmastery,40,19,21
Kârân,tichondrius,1340,hunter,beastmastery,79,36,43
Cantcatchtin,tichondrius,1339,hunter,beastmastery,30,14,16
Oatmeallover,stormrage,1339,hunter,beastmastery,30,14,16
Clydebarro,sargeras,1339,hunter,beastmastery,30,14,16
Peterming,tichondrius,1339,hunter,beastmastery,108,49,59
Euclase,bleeding-hollow,1338,hunter,beastmastery,46,23,23
Aiollus,stormreaver,1338,hunter,beastmastery,30,14,16
Pvrisxoxo,frostmourne,1337,hunter,beastmastery,31,15,16
Bro,malorne,1337,hunter,beastmastery,96,45,51
Ordius,azralon,1337,hunter,beastmastery,36,14,22
Crownchild,illidan,1336,hunter,beastmastery,24,14,10
Muffkick,illidan,1336,hunter,beastmastery,27,15,12
Soulreaperts,ragnaros,1336,hunter,beastmastery,40,21,19
Skulgor,zuljin,1336,hunter,beastmastery,66,34,32
Psychiatry,bonechewer,1336,hunter,beastmastery,70,35,35
Azx,tichondrius,1336,hunter,beastmastery,42,19,23
Stel,tichondrius,1335,hunter,beastmastery,33,17,16
Roostersauce,durotan,1335,hunter,beastmastery,36,18,18
Norcklow,ragnaros,1335,hunter,beastmastery,64,31,33
Selljzs,zuljin,1333,hunter,beastmastery,24,14,10
Highdroe,tichondrius,1333,hunter,beastmastery,90,50,40
Óriion,zuljin,1331,hunter,beastmastery,30,15,15
Daken,ysera,1330,hunter,beastmastery,24,14,10
Vurlo,tichondrius,1330,hunter,beastmastery,24,14,10
Argent,altar-of-storms,1330,hunter,beastmastery,42,23,19
Khels,stormreaver,1330,hunter,beastmastery,28,15,13
Jjack,muradin,1330,hunter,beastmastery,96,45,51
Gïzmo,malganis,1329,hunter,beastmastery,36,20,16
Eggbertx,frostmourne,1329,hunter,beastmastery,30,15,15
Luprikus,maelstrom,1328,hunter,beastmastery,29,14,15
Frostyarrow,moon-guard,1325,hunter,beastmastery,55,28,27
Bulleitrye,illidan,1325,hunter,beastmastery,58,28,30
Fallenfates,stormrage,1324,hunter,beastmastery,84,41,43
Jetzy,illidan,1324,hunter,beastmastery,95,46,49
Hitts,kelthuzad,1323,hunter,beastmastery,31,17,14
Bowna,stormscale,1323,hunter,beastmastery,54,20,34
Fusionrpg,quelthalas,1320,hunter,beastmastery,30,17,13
Jesticles,zuljin,1320,hunter,beastmastery,60,30,30
Sáns,sargeras,1320,hunter,beastmastery,30,14,16
Tergls,illidan,1319,hunter,beastmastery,91,41,50
Cottonshots,dalaran,1318,hunter,beastmastery,107,49,58
Redwolf,moon-guard,1317,hunter,beastmastery,42,20,22
Doug,illidan,1317,hunter,beastmastery,30,14,16
Nøtsurê,llane,1317,hunter,beastmastery,66,25,41
Youngteflon,bonechewer,1314,hunter,beastmastery,30,15,15
Velkhan,sargeras,1314,hunter,beastmastery,30,14,16
Xeminis,area-52,1314,hunter,beastmastery,30,14,16
Peiching,proudmoore,1314,hunter,beastmastery,36,15,21
Hoboh,illidan,1310,hunter,beastmastery,66,32,34
Huntmeplz,proudmoore,1309,hunter,beastmastery,35,17,18
Ellarise,stormrage,1308,hunter,beastmastery,36,22,14
Rocchettâ,kirin-tor,1308,hunter,beastmastery,24,14,10
Lizymcguire,malganis,1308,hunter,beastmastery,42,23,19
Varthurg,ragnaros,1308,hunter,beastmastery,30,15,15
Fames,shuhalo,1308,hunter,beastmastery,73,30,43
Pooterdrip,shadowmoon,1307,hunter,beastmastery,30,14,16
Vruul,sargeras,1306,hunter,beastmastery,82,38,44
Kamikazey,tichondrius,1304,hunter,beastmastery,36,18,18
Bluebow,tichondrius,1302,hunter,beastmastery,96,46,50
Radat,stormscale,1301,hunter,beastmastery,25,17,8
Bacatran,darkspear,1301,hunter,beastmastery,58,32,26
Sunchea,arygos,1300,hunter,beastmastery,30,14,16
Eglon,bleeding-hollow,1299,hunter,beastmastery,24,16,8
Henski,wyrmrest-accord,1299,hunter,beastmastery,36,18,18
Zzsocrateszz,dragonmaw,1295,hunter,beastmastery,128,64,64
Bagodonuts,malganis,1295,hunter,beastmastery,35,17,18
Piu,illidan,1295,hunter,beastmastery,60,28,32
Taxest,illidan,1294,hunter,beastmastery,29,14,15
Jacobsladder,illidan,1293,hunter,beastmastery,113,51,62
Dabznblunts,twisting-nether,1292,hunter,beastmastery,36,15,21
Artemisa,warsong,1291,hunter,beastmastery,84,34,50
Darksector,nemesis,1290,hunter,beastmastery,41,14,27
Mitulla,wyrmrest-accord,1289,hunter,beastmastery,56,27,29
Wogolas,barthilas,1288,hunter,beastmastery,30,16,14
Huukend,azjolnerub,1286,hunter,beastmastery,54,27,27
Vaettai,barthilas,1286,hunter,beastmastery,72,32,40
Shorÿuken,tichondrius,1285,hunter,beastmastery,45,15,30
Orcbeast,illidan,1280,hunter,beastmastery,68,27,41
Peppiee,tichondrius,1279,hunter,beastmastery,23,14,9
Thiccphat,sargeras,1277,hunter,beastmastery,23,14,9
Bowflëx,zuljin,1277,hunter,beastmastery,48,23,25
Sleepywrld,area-52,1275,hunter,beastmastery,29,14,15
Conizle,sargeras,1275,hunter,beastmastery,30,14,16
Haiume,nemesis,1273,hunter,beastmastery,42,17,25
Shootaids,illidan,1272,hunter,beastmastery,56,31,25
Blury,tichondrius,1272,hunter,beastmastery,59,32,27
Scaredcrow,azshara,1272,hunter,beastmastery,40,14,26
Snipershot,blackrock,1271,hunter,beastmastery,42,19,23
Iar,tichondrius,1270,hunter,beastmastery,30,18,12
Ascer,gurubashi,1270,hunter,beastmastery,110,55,55
Balsagoth,azralon,1270,hunter,beastmastery,42,19,23
Glediator,tichondrius,1269,hunter,beastmastery,45,21,24
Trapz,hellscream,1267,hunter,beastmastery,96,48,48
Rnger,aerie-peak,1267,hunter,beastmastery,61,28,33
Starsworn,moon-guard,1266,hunter,beastmastery,78,38,40
Gigawrench,darkspear,1265,hunter,beastmastery,24,16,8
Airtight,area-52,1265,hunter,beastmastery,59,26,33
Böuntyhuntêr,area-52,1263,hunter,beastmastery,72,35,37
Hugehuntard,frostmane,1263,hunter,beastmastery,77,28,49
Shekiro,illidan,1261,hunter,beastmastery,61,27,34
Itsdoom,sargeras,1259,hunter,beastmastery,60,37,23
Saltz,tichondrius,1259,hunter,beastmastery,27,15,12
Bobbysmurica,cenarion-circle,1257,hunter,beastmastery,66,30,36
Trianthel,azralon,1255,hunter,beastmastery,24,15,9
Socrato,tichondrius,1252,hunter,beastmastery,43,21,22
Dunkam,quelthalas,1252,hunter,beastmastery,72,34,38
Ownyoufast,darkspear,1251,hunter,beastmastery,54,23,31
Exotichunter,the-underbog,1250,hunter,beastmastery,64,26,38
Danion,aerie-peak,1249,hunter,beastmastery,64,27,37
Vesity,tichondrius,1248,hunter,beastmastery,63,29,34
Karev,area-52,1248,hunter,beastmastery,36,16,20
Lfghunter,frostmourne,1247,hunter,beastmastery,24,13,11
Jawnhunterii,tichondrius,1247,hunter,beastmastery,24,13,11
Ztyer,stormrage,1247,hunter,beastmastery,24,13,11
Frankabingle,area-52,1247,hunter,beastmastery,30,13,17
Wastdpenguin,area-52,1247,hunter,beastmastery,30,13,17
Slowhunterr,tichondrius,1247,hunter,beastmastery,36,13,23
Refinedx,sargeras,1246,hunter,beastmastery,18,13,5
Sotsöl,ragnaros,1246,hunter,beastmastery,24,13,11
Sylriynn,moon-guard,1246,hunter,beastmastery,59,29,30
Thiccit,illidan,1246,hunter,beastmastery,54,26,28
Gabulmenina,nemesis,1245,hunter,beastmastery,24,13,11
Òrìòn,tichondrius,1245,hunter,beastmastery,51,20,31
Reeload,tichondrius,1244,hunter,beastmastery,24,13,11
Shotmieye,thunderhorn,1244,hunter,beastmastery,60,30,30
Maquire,tichondrius,1244,hunter,beastmastery,36,17,19
Digitizoid,tichondrius,1244,hunter,beastmastery,30,13,17
Craftarrow,tichondrius,1243,hunter,beastmastery,41,21,20
Alitharia,nerzhul,1243,hunter,beastmastery,189,84,105
Guapshot,stormreaver,1242,hunter,beastmastery,41,16,25
Heparinqt,area-52,1242,hunter,beastmastery,36,13,23
Missedtrap,tichondrius,1241,hunter,beastmastery,24,13,11
Bighuntz,bleeding-hollow,1241,hunter,beastmastery,36,13,23
Gunbladez,burning-blade,1240,hunter,beastmastery,27,13,14
Angrypepe,bleeding-hollow,1240,hunter,beastmastery,30,13,17
Vayesa,stormscale,1240,hunter,beastmastery,39,16,23
Deepcarver,tichondrius,1240,hunter,beastmastery,41,16,25
Wadadly,malganis,1239,hunter,beastmastery,144,69,75
Chrønic,khadgar,1238,hunter,beastmastery,30,16,14
Ioioi,tichondrius,1238,hunter,beastmastery,34,16,18
Fistbirtdor,illidan,1237,hunter,beastmastery,30,13,17
Nebulahaze,stormrage,1236,hunter,beastmastery,56,27,29
Timogen,illidan,1236,hunter,beastmastery,36,16,20
Nogaro,nemesis,1235,hunter,beastmastery,42,20,22
Artilleria,quelthalas,1235,hunter,beastmastery,54,25,29
Yesterday,draka,1234,hunter,beastmastery,30,13,17
Hynathios,azralon,1233,hunter,beastmastery,30,13,17
Honeygold,tichondrius,1233,hunter,beastmastery,51,19,32
Wârhunt,frostmourne,1232,hunter,beastmastery,78,41,37
Rbtz,illidan,1231,hunter,beastmastery,17,13,4
Xtop,draktharon,1231,hunter,beastmastery,23,15,8
Accuzationzx,tichondrius,1231,hunter,beastmastery,24,13,11
Tanarin,bleeding-hollow,1230,hunter,beastmastery,30,13,17
Blanar,quelthalas,1230,hunter,beastmastery,42,13,29
Tiraa,kelthuzad,1228,hunter,beastmastery,48,19,29
Laudion,quelthalas,1227,hunter,beastmastery,18,13,5
Luoca,shuhalo,1227,hunter,beastmastery,24,13,11
Skywrecker,bleeding-hollow,1226,hunter,beastmastery,24,13,11
Warwonka,magtheridon,1226,hunter,beastmastery,50,23,27
Smallsouljah,demon-soul,1226,hunter,beastmastery,39,17,22
Hovahdo,proudmoore,1224,hunter,beastmastery,23,13,10
Urimiel,daggerspine,1223,hunter,beastmastery,36,16,20
Xxty,stormrage,1221,hunter,beastmastery,24,13,11
Mithrandiel,blood-furnace,1221,hunter,beastmastery,97,49,48
Bromance,kaelthas,1221,hunter,beastmastery,36,18,18
Crumpit,moon-guard,1220,hunter,beastmastery,51,17,34
Grands,tortheldrin,1219,hunter,beastmastery,29,14,15
Havymetal,andorhal,1219,hunter,beastmastery,48,20,28
Machiko,gorefiend,1218,hunter,beastmastery,30,13,17
Anaiset,hyjal,1217,hunter,beastmastery,24,13,11
Mazziy,zangarmarsh,1217,hunter,beastmastery,36,15,21
Xxo,frostmourne,1215,hunter,beastmastery,34,13,21
Loathin,stormrage,1213,hunter,beastmastery,33,21,12
Frxyza,stormrage,1211,hunter,beastmastery,24,13,11
Zullypewpew,stormrage,1207,hunter,beastmastery,28,19,9
Alexbm,amanthul,1207,hunter,beastmastery,51,28,23
Hairyhype,malganis,1207,hunter,beastmastery,48,22,26
Rogshunt,sargeras,1207,hunter,beastmastery,29,13,16
Dayneryz,quelthalas,1206,hunter,beastmastery,99,46,53
Omegalulzxd,kelthuzad,1206,hunter,beastmastery,111,49,62
Ydaine,alexstrasza,1206,hunter,beastmastery,75,33,42
Neymoxi,icecrown,1205,hunter,beastmastery,48,26,22
Iffy,dentarg,1203,hunter,beastmastery,30,17,13
Ryøkø,nemesis,1202,hunter,beastmastery,23,14,9
Winchestyr,lightbringer,1201,hunter,beastmastery,30,14,16
Leannon,stormrage,1200,hunter,beastmastery,35,19,16
Tmac,winterhoof,1198,hunter,beastmastery,53,28,25
Rypunzul,proudmoore,1196,hunter,beastmastery,24,13,11
Alaranel,kiljaeden,1190,hunter,beastmastery,68,29,39
Gaktog,area-52,1189,hunter,beastmastery,27,13,14
Vord,frostmourne,1189,hunter,beastmastery,30,13,17
Dracð,malganis,1187,hunter,beastmastery,42,24,18
Chetta,ragnaros,1187,hunter,beastmastery,66,28,38
Kaxer,illidan,1182,hunter,beastmastery,65,33,32
Desydn,draenor,1180,hunter,beastmastery,155,77,78
Shneedle,illidan,1180,hunter,beastmastery,54,22,32
Thetrickyone,area-52,1180,hunter,beastmastery,52,20,32
Poonbaddy,kiljaeden,1179,hunter,beastmastery,35,13,22
Aztrappin,illidan,1177,hunter,beastmastery,63,24,39
Brendie,thrall,1176,hunter,beastmastery,286,143,143
Fixnoone,moon-guard,1176,hunter,beastmastery,38,18,20
Warsh,anubarak,1173,hunter,beastmastery,34,19,15
Foffy,darkspear,1172,hunter,beastmastery,30,16,14
Trailbreaker,trollbane,1169,hunter,beastmastery,93,50,43
Håwkeye,hyjal,1169,hunter,beastmastery,139,74,65
Riivali,quelthalas,1169,hunter,beastmastery,87,40,47
Kathoey,wyrmrest-accord,1166,hunter,beastmastery,65,26,39
Elfinballz,khadgar,1164,hunter,beastmastery,36,18,18
Pikochon,illidan,1164,hunter,beastmastery,51,22,29
Jezoo,frostmourne,1163,hunter,beastmastery,42,18,24
Thiccshawts,moon-guard,1162,hunter,beastmastery,24,13,11
Frenzyfire,whisperwind,1162,hunter,beastmastery,45,19,26
Londen,tichondrius,1160,hunter,beastmastery,36,18,18
Minkô,tichondrius,1159,hunter,beastmastery,30,13,17
Totorostarh,tichondrius,1158,hunter,beastmastery,33,13,20
Therealgam,the-underbog,1155,hunter,beastmastery,30,15,15
Arucedd,frostmourne,1154,hunter,beastmastery,74,32,42
Lustblitz,illidan,1152,hunter,beastmastery,18,12,6
Shinhyez,tichondrius,1152,hunter,beastmastery,24,12,12
Malvnfresh,tichondrius,1152,hunter,beastmastery,24,12,12
Tyrec,proudmoore,1152,hunter,beastmastery,30,12,18
Rthr,kiljaeden,1151,hunter,beastmastery,18,12,6
Survenant,zuljin,1151,hunter,beastmastery,24,12,12
Awps,sargeras,1150,hunter,beastmastery,18,12,6
Shrian,illidan,1150,hunter,beastmastery,25,12,13
Tageh,malganis,1149,hunter,beastmastery,18,12,6
Thuperduper,tichondrius,1149,hunter,beastmastery,18,12,6
Kroozeh,illidan,1149,hunter,beastmastery,24,12,12
Tosila,tichondrius,1149,hunter,beastmastery,30,12,18
Ddukgue,tichondrius,1149,hunter,beastmastery,30,12,18
Berreydingle,norgannon,1148,hunter,beastmastery,24,12,12
Funnk,tichondrius,1148,hunter,beastmastery,24,12,12
Phatniss,tichondrius,1148,hunter,beastmastery,30,12,18
Elfo,kelthuzad,1147,hunter,beastmastery,18,12,6
Suetyic,tichondrius,1147,hunter,beastmastery,24,12,12
Mangosteen,illidan,1147,hunter,beastmastery,33,13,20
Cuteorcgirl,sargeras,1145,hunter,beastmastery,38,15,23
Ragnarlobkk,ragnaros,1144,hunter,beastmastery,148,71,77
Souperman,malganis,1144,hunter,beastmastery,30,12,18
Cotó,stormrage,1142,hunter,beastmastery,24,12,12
Dooper,malfurion,1141,hunter,beastmastery,30,12,18
Gratmuk,ragnaros,1139,hunter,beastmastery,30,12,18
Hatteras,drakthul,1139,hunter,beastmastery,50,16,34
Dyz,ragnaros,1137,hunter,beastmastery,28,13,15
Daréz,blackrock,1136,hunter,beastmastery,31,14,17
Traxêx,nemesis,1136,hunter,beastmastery,30,13,17
Calypso,chromaggus,1133,hunter,beastmastery,24,12,12
Blimpbooty,stormrage,1130,hunter,beastmastery,41,20,21
Wildfirefly,whisperwind,1130,hunter,beastmastery,56,26,30
Revö,area-52,1129,hunter,beastmastery,30,12,18
Blankshot,doomhammer,1128,hunter,beastmastery,76,39,37
Juicedhunter,tichondrius,1128,hunter,beastmastery,24,12,12
Baconzola,dalaran,1127,hunter,beastmastery,18,12,6
Camperbill,borean-tundra,1127,hunter,beastmastery,25,14,11
Huñté,stormrage,1127,hunter,beastmastery,24,12,12
Kälec,quelthalas,1127,hunter,beastmastery,66,32,34
Neverhunter,azralon,1127,hunter,beastmastery,30,13,17
Xarmozao,nemesis,1127,hunter,beastmastery,39,14,25
Bepee,auchindoun,1126,hunter,beastmastery,98,52,46
Lieolaste,area-52,1126,hunter,beastmastery,35,17,18
Drexzo,tichondrius,1125,hunter,beastmastery,24,12,12
Traps,deathwing,1123,hunter,beastmastery,30,12,18
Qpoc,tichondrius,1120,hunter,beastmastery,44,20,24
Skpro,tichondrius,1118,hunter,beastmastery,42,13,29
Mvpbunny,tichondrius,1117,hunter,beastmastery,46,21,25
Vegamax,illidan,1115,hunter,beastmastery,30,17,13
Rhonishot,tichondrius,1115,hunter,beastmastery,61,24,37
Brandough,detheroc,1111,hunter,beastmastery,21,12,9
Brokenstars,illidan,1108,hunter,beastmastery,146,70,76
Ukamau,ragnaros,1105,hunter,beastmastery,30,17,13
Soccratees,shattered-hand,1102,hunter,beastmastery,17,12,5
Berelai,area-52,1102,hunter,beastmastery,30,12,18
Trono,korgath,1102,hunter,beastmastery,30,12,18
Topshunter,sargeras,1100,hunter,beastmastery,93,49,44
Despise,frostmourne,1098,hunter,beastmastery,27,12,15
Massivattack,skullcrusher,1096,hunter,beastmastery,30,12,18
Shmurda,duskwood,1095,hunter,beastmastery,100,40,60
Strelyatil,trollbane,1092,hunter,beastmastery,36,20,16
Valintine,the-scryers,1090,hunter,beastmastery,23,12,11
Funwell,dalaran,1090,hunter,beastmastery,29,14,15
Chickenadobo,maelstrom,1088,hunter,beastmastery,30,16,14
Zalyssavara,aerie-peak,1085,hunter,beastmastery,27,12,15
Pewpew,gallywix,1082,hunter,beastmastery,35,14,21
Onihanzo,thrall,1078,hunter,beastmastery,31,13,18
Eithelleta,frostmourne,1078,hunter,beastmastery,48,18,30
Firesail,kelthuzad,1076,hunter,beastmastery,20,12,8
Snoozee,emerald-dream,1074,hunter,beastmastery,32,12,20
Buyaga,stormreaver,1073,hunter,beastmastery,72,37,35
Myrfes,ragnaros,1073,hunter,beastmastery,54,19,35
Kinete,proudmoore,1072,hunter,beastmastery,25,13,12
Brendenhunt,area-52,1071,hunter,beastmastery,17,12,5
Jackcoügh,frostmourne,1069,hunter,beastmastery,31,12,19
Jayken,gnomeregan,1067,hunter,beastmastery,28,12,16
Dadhatesme,stormrage,1066,hunter,beastmastery,27,12,15
Nightfal,emerald-dream,1064,hunter,beastmastery,75,28,47
Mouthymerc,zuljin,1063,hunter,beastmastery,35,12,23
Splosiv,stormrage,1056,hunter,beastmastery,18,11,7
Trapinc,sargeras,1056,hunter,beastmastery,18,11,7
Hog,darkspear,1056,hunter,beastmastery,18,11,7
Jawnhunter,tichondrius,1056,hunter,beastmastery,24,11,13
Prêd,malganis,1056,hunter,beastmastery,27,12,15
Unicom,malganis,1056,hunter,beastmastery,30,11,19
Jellyleg,bleeding-hollow,1055,hunter,beastmastery,18,11,7
Ryutiz,fizzcrank,1055,hunter,beastmastery,18,11,7
Undeadroach,tichondrius,1055,hunter,beastmastery,24,11,13
Tashio,aerie-peak,1055,hunter,beastmastery,24,11,13
Emmihunt,tichondrius,1055,hunter,beastmastery,24,11,13
Raven,sargeras,1055,hunter,beastmastery,28,12,16
Toozz,frostmourne,1055,hunter,beastmastery,30,11,19
Puns,stormreaver,1054,hunter,beastmastery,18,11,7
Ispamtraps,emerald-dream,1054,hunter,beastmastery,18,11,7
Houdan,frostmourne,1054,hunter,beastmastery,22,11,11
Kelgar,the-scryers,1054,hunter,beastmastery,30,14,16
Morenarösa,nemesis,1053,hunter,beastmastery,54,22,32
Hitx,tichondrius,1052,hunter,beastmastery,18,11,7
Sagadegêmeos,stormrage,1052,hunter,beastmastery,30,11,19
Sylpheous,bleeding-hollow,1052,hunter,beastmastery,36,11,25
Cummis,skullcrusher,1051,hunter,beastmastery,18,11,7
Ezari,zuljin,1051,hunter,beastmastery,27,12,15
Mav,dragonmaw,1051,hunter,beastmastery,26,11,15
Hohohohahah,gallywix,1051,hunter,beastmastery,30,11,19
Booffmeister,area-52,1050,hunter,beastmastery,24,11,13
Regivaness,nemesis,1049,hunter,beastmastery,24,11,13
Memënto,barthilas,1049,hunter,beastmastery,30,11,19
Gølin,aerie-peak,1049,hunter,beastmastery,30,11,19
Freeside,emerald-dream,1048,hunter,beastmastery,18,11,7
Wingclipped,kelthuzad,1048,hunter,beastmastery,18,11,7
Computer,darkspear,1048,hunter,beastmastery,24,11,13
ßaelon,malganis,1047,hunter,beastmastery,12,11,1
Flacidpasta,sargeras,1047,hunter,beastmastery,18,11,7
Kynagidas,korgath,1047,hunter,beastmastery,24,11,13
Grimhuntz,frostmourne,1047,hunter,beastmastery,24,11,13
Quigfoot,area-52,1047,hunter,beastmastery,87,36,51
Cilnolm,moon-guard,1045,hunter,beastmastery,24,11,13
Gandson,fizzcrank,1045,hunter,beastmastery,29,12,17
Riukyv,ragnaros,1045,hunter,beastmastery,30,11,19
Braii,blood-furnace,1042,hunter,beastmastery,42,18,24
Jijiyoyo,tichondrius,1041,hunter,beastmastery,41,13,28
Zooker,tichondrius,1039,hunter,beastmastery,29,11,18
Frenzygirl,azralon,1036,hunter,beastmastery,18,11,7
Harÿn,nemesis,1036,hunter,beastmastery,24,11,13
More,khadgar,1035,hunter,beastmastery,30,11,19
Vicluvv,stormrage,1034,hunter,beastmastery,23,11,12
Huntercry,ragnaros,1026,hunter,beastmastery,18,11,7
Wrekkthal,illidan,1023,hunter,beastmastery,41,16,25
Elisen,frostmourne,1021,hunter,beastmastery,42,13,29
Bolbathefett,shadowsong,1020,hunter,beastmastery,30,11,19
Taedulos,azralon,1019,hunter,beastmastery,36,19,17
Hetaya,haomarush,1019,hunter,beastmastery,137,60,77
Dragonman,grizzly-hills,1019,hunter,beastmastery,48,15,33
Oldmatador,azralon,1018,hunter,beastmastery,48,21,27
Zpax,area-52,1010,hunter,beastmastery,18,11,7
Jônathan,tichondrius,1010,hunter,beastmastery,18,11,7
Caytano,quelthalas,1010,hunter,beastmastery,30,17,13
Erik,nemesis,1009,hunter,beastmastery,165,79,86
Killerronald,ragnaros,1009,hunter,beastmastery,24,11,13
Fwun,nerzhul,1008,hunter,beastmastery,18,12,6
Hunterjim,tichondrius,1005,hunter,beastmastery,26,12,14
Namikawa,stormrage,1005,hunter,beastmastery,24,11,13
Rairin,tichondrius,1004,hunter,beastmastery,65,33,32
Antihero,norgannon,1001,hunter,beastmastery,20,12,8
Eddyholiday,tichondrius,1001,hunter,beastmastery,26,13,13
Leandrox,quelthalas,1001,hunter,beastmastery,23,11,12
Catharsis,quelthalas,1001,hunter,beastmastery,24,11,13
Shikago,wyrmrest-accord,1001,hunter,beastmastery,31,12,19
Falesta,sargeras,999,hunter,beastmastery,28,12,16
Flexxbow,thrall,994,hunter,beastmastery,23,13,10
Robobrain,area-52,993,hunter,beastmastery,23,11,12
Speirs,tichondrius,993,hunter,beastmastery,60,27,33
Trassic,emerald-dream,990,hunter,beastmastery,23,11,12
Cocstrong,darrowmere,988,hunter,beastmastery,60,31,29
Robingear,baelgun,983,hunter,beastmastery,195,94,101
Ruthgarth,akama,983,hunter,beastmastery,30,13,17
Puhpsy,azralon,981,hunter,beastmastery,72,37,35
Barabulk,wyrmrest-accord,981,hunter,beastmastery,24,12,12
Arrowae,sargeras,981,hunter,beastmastery,56,24,32
Faldran,earthen-ring,977,hunter,beastmastery,112,46,66
Gammaraven,dalaran,968,hunter,beastmastery,19,11,8
Skillvanas,stormrage,965,hunter,beastmastery,25,11,14
Raikuu,skullcrusher,964,hunter,beastmastery,66,34,32
Ahhpash,tichondrius,960,hunter,beastmastery,16,11,5
Csantana,sargeras,960,hunter,beastmastery,18,10,8
Dualp,tichondrius,960,hunter,beastmastery,18,10,8
Worsthunt,tichondrius,960,hunter,beastmastery,18,10,8
Pumplum,kiljaeden,960,hunter,beastmastery,18,10,8
Killaseason,akama,960,hunter,beastmastery,18,10,8
Sniperfx,lightbringer,960,hunter,beastmastery,18,10,8
Gööber,hyjal,960,hunter,beastmastery,18,10,8
Spekgäwd,emerald-dream,960,hunter,beastmastery,18,10,8
Wovow,tichondrius,960,hunter,beastmastery,18,10,8
Xbee,shattered-halls,960,hunter,beastmastery,18,10,8
Fishxxo,frostmourne,960,hunter,beastmastery,24,10,14
Focús,laughing-skull,960,hunter,beastmastery,24,10,14
Justforfunxx,tichondrius,960,hunter,beastmastery,30,10,20
Rosebullets,bleeding-hollow,959,hunter,beastmastery,18,10,8
Tmnarcanttv,tichondrius,959,hunter,beastmastery,18,10,8
Bigkolache,zuljin,959,hunter,beastmastery,18,10,8
Arrowsgobrr,norgannon,959,hunter,beastmastery,18,10,8
Geregaux,sargeras,959,hunter,beastmastery,18,10,8
Evolushun,kiljaeden,959,hunter,beastmastery,21,11,10
Vigon,stormrage,959,hunter,beastmastery,24,10,14
Tangoda,tichondrius,959,hunter,beastmastery,24,10,14
Yangthekhunt,tichondrius,959,hunter,beastmastery,24,10,14
Orgpopeyes,illidan,959,hunter,beastmastery,24,10,14
Huntfaceguy,agamaggan,959,hunter,beastmastery,24,10,14
Leyliann,quelthalas,959,hunter,beastmastery,27,11,16
Kimbaa,tichondrius,959,hunter,beastmastery,30,10,20
Yolloswag,tichondrius,959,hunter,beastmastery,36,10,26
Motegi,illidan,959,hunter,beastmastery,36,10,26
Bunsglazing,illidan,958,hunter,beastmastery,18,10,8
Smoothbrainz,blackrock,958,hunter,beastmastery,18,10,8
Aquabat,wildhammer,958,hunter,beastmastery,18,10,8
Quickfyre,stormrage,958,hunter,beastmastery,18,10,8
Tazer,area-52,958,hunter,beastmastery,24,10,14
Chunco,ragnaros,958,hunter,beastmastery,24,10,14
Marexx,tichondrius,958,hunter,beastmastery,24,10,14
Khattab,tichondrius,958,hunter,beastmastery,24,10,14
Pafäcïle,tichondrius,958,hunter,beastmastery,24,10,14
Behavior,nemesis,957,hunter,beastmastery,18,10,8
Wabí,tichondrius,957,hunter,beastmastery,18,10,8
Xua,frostmourne,957,hunter,beastmastery,18,10,8
Imthaböss,nazjatar,957,hunter,beastmastery,23,10,13
Xuv,illidan,957,hunter,beastmastery,24,10,14
Sumom,darrowmere,957,hunter,beastmastery,44,18,26
Littledougie,boulderfist,957,hunter,beastmastery,30,10,20
Kaiholeo,tichondrius,957,hunter,beastmastery,30,10,20
Bowjobe,tichondrius,955,hunter,beastmastery,24,10,14
Hyena,kelthuzad,955,hunter,beastmastery,24,10,14
Chimpx,moon-guard,955,hunter,beastmastery,24,10,14
Hartman,frostwolf,954,hunter,beastmastery,18,10,8
Trim,tichondrius,954,hunter,beastmastery,18,10,8
Murdaugh,icecrown,954,hunter,beastmastery,18,10,8
Coppersnout,wyrmrest-accord,954,hunter,beastmastery,24,10,14
Rezkiin,tichondrius,953,hunter,beastmastery,18,10,8
Jendell,area-52,952,hunter,beastmastery,18,10,8
Huntertimes,ragnaros,951,hunter,beastmastery,12,10,2
Steelaeon,moon-guard,951,hunter,beastmastery,24,10,14
Easypoacher,tichondrius,948,hunter,beastmastery,18,10,8
Flacidhunter,kelthuzad,948,hunter,beastmastery,24,10,14
ßaeløn,malganis,947,hunter,beastmastery,15,11,4
Bittitan,frostmourne,947,hunter,beastmastery,18,10,8
Leaii,thrall,944,hunter,beastmastery,43,24,19
Oddangel,azuremyst,944,hunter,beastmastery,24,10,14
Erovianoria,silver-hand,943,hunter,beastmastery,63,31,32
Jagër,dalaran,940,hunter,beastmastery,15,11,4
Noitrag,azralon,937,hunter,beastmastery,17,10,7
Malthiz,antonidas,934,hunter,beastmastery,38,17,21
Salurian,destromath,930,hunter,beastmastery,40,15,25
Shootyurshot,stormrage,927,hunter,beastmastery,20,11,9
Finol,azralon,926,hunter,beastmastery,14,11,3
Hunbatz,dalaran,923,hunter,beastmastery,31,16,15
Ashantii,hakkar,919,hunter,beastmastery,24,10,14
Maveraxx,executus,916,hunter,beastmastery,42,15,27
Çhexmix,kiljaeden,910,hunter,beastmastery,15,10,5
Rachetbutt,tichondrius,910,hunter,beastmastery,17,10,7
Actehón,ragnaros,909,hunter,beastmastery,36,18,18
Beolwolf,darkspear,907,hunter,beastmastery,17,10,7
Coyner,tichondrius,907,hunter,beastmastery,21,10,11
Capnjack,hyjal,906,hunter,beastmastery,33,10,23
Wael,perenolde,905,hunter,beastmastery,17,10,7
Glizzys,cairne,904,hunter,beastmastery,29,12,17
Cernos,malganis,902,hunter,beastmastery,23,10,13
Twatshót,burning-legion,898,hunter,beastmastery,28,13,15
Ketulirantle,azralon,891,hunter,beastmastery,46,13,33
Boww,sargeras,890,hunter,beastmastery,20,10,10
Foh,kelthuzad,888,hunter,beastmastery,17,10,7
Killmachine,sargeras,886,hunter,beastmastery,22,10,12
Rotokrim,emerald-dream,882,hunter,beastmastery,184,87,97
Petattack,barthilas,864,hunter,beastmastery,12,9,3
Slipox,sargeras,864,hunter,beastmastery,12,9,3
Bmhuntlol,illidan,864,hunter,beastmastery,12,9,3
Lilperc,zuljin,864,hunter,beastmastery,12,9,3
Lubze,bleeding-hollow,864,hunter,beastmastery,12,9,3
Elaisse,uther,864,hunter,beastmastery,12,9,3
Phetch,bleeding-hollow,864,hunter,beastmastery,12,9,3
Huntations,sargeras,864,hunter,beastmastery,12,9,3
Bmobepip,malganis,864,hunter,beastmastery,12,9,3
Naestrá,bleeding-hollow,864,hunter,beastmastery,12,9,3
Fereni,emerald-dream,864,hunter,beastmastery,16,10,6
Clütch,darkspear,864,hunter,beastmastery,18,9,9
Actioh,stormrage,864,hunter,beastmastery,18,9,9
Elenin,tichondrius,864,hunter,beastmastery,18,9,9
Lilsynchfyb,sargeras,864,hunter,beastmastery,18,9,9
Chouklak,zuljin,864,hunter,beastmastery,18,9,9
Liennä,stormrage,864,hunter,beastmastery,18,9,9
Yatyegatchun,illidan,864,hunter,beastmastery,18,9,9
Hagadinn,frostmourne,864,hunter,beastmastery,18,9,9
Airlol,tichondrius,864,hunter,beastmastery,18,9,9
Zizilio,kelthuzad,864,hunter,beastmastery,18,9,9
Xbloody,tichondrius,864,hunter,beastmastery,18,9,9
Alenkras,stormrage,864,hunter,beastmastery,18,9,9
Déwi,tichondrius,864,hunter,beastmastery,18,9,9
Deutêr,quelthalas,864,hunter,beastmastery,18,9,9
Arteene,illidan,864,hunter,beastmastery,24,9,15
Dirtyytroll,area-52,864,hunter,beastmastery,24,9,15
Balrröt,malganis,864,hunter,beastmastery,24,9,15
Scurvypete,perenolde,864,hunter,beastmastery,24,9,15
Kaitoo,tichondrius,864,hunter,beastmastery,24,9,15
Katiepie,frostmourne,864,hunter,beastmastery,30,9,21
Saynice,warsong,863,hunter,beastmastery,12,9,3
Noisetrader,illidan,863,hunter,beastmastery,12,9,3
Twoshotzz,darkspear,863,hunter,beastmastery,15,10,5
Reic,kiljaeden,863,hunter,beastmastery,15,10,5
Berkhof,tichondrius,863,hunter,beastmastery,18,9,9
Slap,shattered-hand,863,hunter,beastmastery,18,9,9
Nikronos,quelthalas,863,hunter,beastmastery,18,9,9
Luçkyan,tichondrius,863,hunter,beastmastery,18,9,9
Drezzial,illidan,863,hunter,beastmastery,18,9,9
Brorc,kul-tiras,863,hunter,beastmastery,18,9,9
Jockitch,wildhammer,863,hunter,beastmastery,18,9,9
Beabalm,dalaran,863,hunter,beastmastery,18,9,9
Snowjin,stormrage,863,hunter,beastmastery,18,9,9
Dbrickashaw,proudmoore,863,hunter,beastmastery,18,9,9
Jamzlol,frostmourne,863,hunter,beastmastery,18,9,9
Burguir,ragnaros,863,hunter,beastmastery,18,9,9
Ellzuk,tichondrius,863,hunter,beastmastery,18,9,9
Xernen,thrall,863,hunter,beastmastery,18,9,9
Drivebyjuju,dentarg,863,hunter,beastmastery,18,9,9
Aredbull,jubeithos,863,hunter,beastmastery,18,9,9
Wellerman,firetree,863,hunter,beastmastery,18,9,9
Hendó,korgath,863,hunter,beastmastery,18,9,9
Viral,grizzly-hills,863,hunter,beastmastery,18,9,9
Tethro,zuljin,863,hunter,beastmastery,18,9,9
Tarah,lightbringer,863,hunter,beastmastery,24,9,15
Junglepaw,moon-guard,863,hunter,beastmastery,24,9,15
Nubberton,sargeras,863,hunter,beastmastery,24,9,15
Bleedwish,tichondrius,863,hunter,beastmastery,31,9,22
Seáhawk,kiljaeden,862,hunter,beastmastery,12,9,3
Loriandel,proudmoore,862,hunter,beastmastery,14,9,5
Qúin,frostmourne,862,hunter,beastmastery,18,9,9
Strongene,aegwynn,862,hunter,beastmastery,18,9,9
Toross,stormscale,862,hunter,beastmastery,18,9,9
Hawkeye,boulderfist,862,hunter,beastmastery,24,9,15
Korasaurus,tichondrius,861,hunter,beastmastery,12,9,3
Arrowbadoors,azralon,861,hunter,beastmastery,18,9,9
Trápngap,barthilas,861,hunter,beastmastery,24,9,15
Ogbrooks,tichondrius,861,hunter,beastmastery,24,9,15
Alikay,ragnaros,861,hunter,beastmastery,24,9,15
Hrodvitnir,quelthalas,861,hunter,beastmastery,24,9,15
Jahir,tichondrius,860,hunter,beastmastery,18,9,9
Blockeyhunt,tichondrius,860,hunter,beastmastery,18,9,9
Shdwhntrclub,wyrmrest-accord,860,hunter,beastmastery,24,9,15
Byrdh,zuljin,860,hunter,beastmastery,27,10,17
Goinghuntin,frostmourne,859,hunter,beastmastery,18,9,9
Trionias,malfurion,859,hunter,beastmastery,30,9,21
Xeriife,stormrage,858,hunter,beastmastery,19,9,10
Soulshots,malganis,858,hunter,beastmastery,30,9,21
Chuphunts,tichondrius,857,hunter,beastmastery,12,9,3
Nikå,ragnaros,857,hunter,beastmastery,24,9,15
Vexxør,bleeding-hollow,856,hunter,beastmastery,18,9,9
Kalekros,tichondrius,856,hunter,beastmastery,30,9,21
Galerius,illidan,855,hunter,beastmastery,36,9,27
Sagittarion,malfurion,854,hunter,beastmastery,19,10,9
Shiztec,malganis,854,hunter,beastmastery,24,9,15
Lanadari,trollbane,853,hunter,beastmastery,12,9,3
ßloodmain,tichondrius,852,hunter,beastmastery,24,9,15
Hunterdps,gurubashi,851,hunter,beastmastery,18,9,9
Zhanzu,quelthalas,851,hunter,beastmastery,24,9,15
Survival,dentarg,851,hunter,beastmastery,24,9,15
Euamomilfs,azralon,850,hunter,beastmastery,18,9,9
Nalsa,tichondrius,847,hunter,beastmastery,17,9,8
Johnwïck,moon-guard,847,hunter,beastmastery,30,9,21
Doombug,lethon,846,hunter,beastmastery,18,9,9
Dakirell,drakkari,846,hunter,beastmastery,24,9,15
Eggsquatch,emerald-dream,844,hunter,beastmastery,12,9,3
Dikkins,windrunner,844,hunter,beastmastery,17,9,8
Skullgrain,eitrigg,844,hunter,beastmastery,23,9,14
Alby,daggerspine,843,hunter,beastmastery,23,9,14
Anya,proudmoore,839,hunter,beastmastery,47,20,27
Larthas,greymane,835,hunter,beastmastery,18,9,9
Seenobody,stormrage,834,hunter,beastmastery,41,9,32
Noahxkhalel,azralon,832,hunter,beastmastery,29,9,20
Hikkupz,tichondrius,831,hunter,beastmastery,23,9,14
Flamenco,arthas,830,hunter,beastmastery,17,9,8
Spunky,zuluhed,830,hunter,beastmastery,17,9,8
Moash,spinebreaker,830,hunter,beastmastery,17,9,8
Vastiks,dalaran,829,hunter,beastmastery,26,9,17
Tupirani,azralon,828,hunter,beastmastery,16,9,7
Acotas,blades-edge,828,hunter,beastmastery,36,16,20
Coletrickle,chogall,822,hunter,beastmastery,32,10,22
Falsifier,ragnaros,815,hunter,beastmastery,21,9,12
Rawspits,kiljaeden,814,hunter,beastmastery,29,9,20
Fhodhaz,nemesis,813,hunter,beastmastery,17,9,8
Vyalaris,emerald-dream,813,hunter,beastmastery,21,9,12
Drimhuzzah,velen,809,hunter,beastmastery,17,9,8
Bagurgur,tichondrius,799,hunter,beastmastery,16,9,7
Jonyvi,stormrage,798,hunter,beastmastery,19,10,9
Owoonisan,illidan,794,hunter,beastmastery,22,9,13
Chippendales,illidan,768,hunter,beastmastery,12,8,4
Ogstrutt,zuljin,768,hunter,beastmastery,12,8,4
Petizoql,ragnaros,768,hunter,beastmastery,12,8,4
Newcomb,sargeras,768,hunter,beastmastery,12,8,4
Kite,dathremar,768,hunter,beastmastery,12,8,4
Jsrhuntz,sargeras,768,hunter,beastmastery,12,8,4
Kolotak,kelthuzad,768,hunter,beastmastery,12,8,4
Paraxh,tichondrius,768,hunter,beastmastery,12,8,4
Huntsey,frostmourne,768,hunter,beastmastery,12,8,4
Flub,shadow-council,768,hunter,beastmastery,12,8,4
Bowzørx,tichondrius,768,hunter,beastmastery,12,8,4
Priapismxh,stormrage,768,hunter,beastmastery,12,8,4
Valtierd,illidan,768,hunter,beastmastery,12,8,4
Mavrik,sargeras,768,hunter,beastmastery,12,8,4
Meshunt,tichondrius,768,hunter,beastmastery,12,8,4
Deinaito,bleeding-hollow,768,hunter,beastmastery,12,8,4
Zute,sargeras,768,hunter,beastmastery,12,8,4
Disper,hyjal,768,hunter,beastmastery,12,8,4
Jboogie,malganis,768,hunter,beastmastery,18,8,10
Seongnam,tichondrius,768,hunter,beastmastery,18,8,10
Rethum,tichondrius,768,hunter,beastmastery,18,8,10
Wolfzburg,moon-guard,768,hunter,beastmastery,18,8,10
Seeq,illidan,768,hunter,beastmastery,18,8,10
Heädshöt,malorne,768,hunter,beastmastery,18,8,10
Gotrap,saurfang,768,hunter,beastmastery,18,8,10
Mastasnipa,illidan,768,hunter,beastmastery,18,8,10
Oblitus,zuljin,768,hunter,beastmastery,18,8,10
Teammatescba,tichondrius,768,hunter,beastmastery,18,8,10
Oblio,silvermoon,768,hunter,beastmastery,18,8,10
Tigglyjits,tichondrius,768,hunter,beastmastery,18,8,10
Barosan,illidan,768,hunter,beastmastery,18,8,10
Yonzo,area-52,768,hunter,beastmastery,18,8,10
Katherìnelol,tichondrius,768,hunter,beastmastery,21,9,12
Misakilr,illidan,768,hunter,beastmastery,19,8,11
Peregrin,burning-legion,768,hunter,beastmastery,24,8,16
Kolosaltraps,tichondrius,768,hunter,beastmastery,24,8,16
Aamoody,bloodhoof,768,hunter,beastmastery,24,8,16
Remièl,frostmourne,767,hunter,beastmastery,12,8,4
Keldrek,wyrmrest-accord,767,hunter,beastmastery,12,8,4
Hackerman,tichondrius,767,hunter,beastmastery,12,8,4
Torva,firetree,767,hunter,beastmastery,12,8,4
Probo,aegwynn,767,hunter,beastmastery,12,8,4
Cxnt,saurfang,767,hunter,beastmastery,15,9,6
Eatmybow,nemesis,767,hunter,beastmastery,16,9,7
Nimbioth,proudmoore,767,hunter,beastmastery,18,8,10
Jímmycorn,sargeras,767,hunter,beastmastery,18,8,10
Iamreek,sargeras,767,hunter,beastmastery,18,8,10
Gerathorn,sargeras,767,hunter,beastmastery,18,8,10
Picapaul,stormrage,767,hunter,beastmastery,18,8,10
Vindication,ysera,767,hunter,beastmastery,18,8,10
Raphgun,stormrage,767,hunter,beastmastery,18,8,10
Bowjingles,blackrock,767,hunter,beastmastery,18,8,10
Thehunturd,dalaran,767,hunter,beastmastery,18,8,10
Flîp,daggerspine,767,hunter,beastmastery,18,8,10
Covfefeqt,illidan,767,hunter,beastmastery,18,8,10
Zephanno,sargeras,767,hunter,beastmastery,18,8,10
Brickgrimes,illidan,767,hunter,beastmastery,19,8,11
Lûrtz,aegwynn,767,hunter,beastmastery,21,8,13
Snipingmilfs,zuluhed,766,hunter,beastmastery,12,8,4
Hideontrap,malganis,766,hunter,beastmastery,18,8,10
Katsumito,sargeras,766,hunter,beastmastery,18,8,10
Atheranni,azralon,766,hunter,beastmastery,18,8,10
Föcker,emerald-dream,766,hunter,beastmastery,18,8,10
Jaboe,thrall,766,hunter,beastmastery,18,8,10
Ghostone,sargeras,766,hunter,beastmastery,18,8,10
Thirtyeight,blades-edge,766,hunter,beastmastery,18,8,10
Tirocertobr,azralon,766,hunter,beastmastery,18,8,10
Satours,quelthalas,766,hunter,beastmastery,18,8,10
Thugio,sargeras,766,hunter,beastmastery,24,8,16
Ivix,sargeras,765,hunter,beastmastery,12,8,4
Calbone,stormrage,765,hunter,beastmastery,12,8,4
Queldana,drakkari,765,hunter,beastmastery,18,8,10
Hunt,akama,765,hunter,beastmastery,24,8,16
Franzosisch,stormrage,764,hunter,beastmastery,12,8,4
Grøøves,dalaran,763,hunter,beastmastery,18,8,10
Skarioth,azralon,763,hunter,beastmastery,18,8,10
Speshylponi,smolderthorn,763,hunter,beastmastery,18,8,10
Dodirty,laughing-skull,763,hunter,beastmastery,24,8,16
Liightnight,illidan,762,hunter,beastmastery,12,8,4
Tookoid,sargeras,762,hunter,beastmastery,12,8,4
Jayker,illidan,762,hunter,beastmastery,12,8,4
Halberick,quelthalas,762,hunter,beastmastery,12,8,4
Shamtus,bladefist,762,hunter,beastmastery,12,8,4
Kluetus,sargeras,762,hunter,beastmastery,18,8,10
Stillkrow,sargeras,762,hunter,beastmastery,18,8,10
Élmérfudd,tichondrius,762,hunter,beastmastery,24,8,16
Lhax,stormrage,762,hunter,beastmastery,30,8,22
Riccolonamek,veknilash,761,hunter,beastmastery,12,8,4
Galadrieel,magtheridon,761,hunter,beastmastery,28,9,19
Derringer,the-scryers,760,hunter,beastmastery,18,8,10
Bakharnabi,azralon,760,hunter,beastmastery,18,8,10
Àléç,mannoroth,760,hunter,beastmastery,18,8,10
Ophiela,shuhalo,759,hunter,beastmastery,36,8,28
Eeremm,drakkari,758,hunter,beastmastery,12,8,4
Drpenatrator,barthilas,755,hunter,beastmastery,18,8,10
Bblsallday,illidan,754,hunter,beastmastery,12,8,4
Androki,stormrage,752,hunter,beastmastery,12,8,4
Krispyflayz,sargeras,751,hunter,beastmastery,17,8,9
Raevenah,dalaran,747,hunter,beastmastery,12,8,4
Luxyminx,moon-guard,747,hunter,beastmastery,23,8,15
Stimpblimp,jubeithos,736,hunter,beastmastery,16,8,8
Relaxnerd,antonidas,735,hunter,beastmastery,17,8,9
Cabel,ragnaros,735,hunter,beastmastery,17,8,9
Tekkys,barthilas,734,hunter,beastmastery,17,8,9
Hawkkeye,thunderlord,734,hunter,beastmastery,23,8,15
Vendortrash,aggramar,733,hunter,beastmastery,17,8,9
Wkg,azgalor,728,hunter,beastmastery,41,19,22
Kathelvia,area-52,727,hunter,beastmastery,26,9,17
Eksd,sargeras,719,hunter,beastmastery,11,8,3
Timberex,drenden,715,hunter,beastmastery,15,8,7
Kysii,burning-blade,714,hunter,beastmastery,21,8,13
Cloxygen,moon-guard,713,hunter,beastmastery,22,9,13
Popster,cenarius,704,hunter,beastmastery,16,8,8
Petpenguin,kelthuzad,703,hunter,beastmastery,11,8,3
Yozomoto,nordrassil,703,hunter,beastmastery,14,8,6
Oppshot,kul-tiras,703,hunter,beastmastery,19,8,11
Jinchuriki,shadow-council,703,hunter,beastmastery,28,8,20
Qua,perenolde,702,hunter,beastmastery,17,8,9
Ijii,tichondrius,700,hunter,beastmastery,20,8,12
Mexishots,tichondrius,688,hunter,beastmastery,13,8,5
Hollowhunt,sentinels,672,hunter,beastmastery,12,7,5
Mehontar,area-52,672,hunter,beastmastery,12,7,5
Jxbupx,tichondrius,672,hunter,beastmastery,12,7,5
Downor,malganis,672,hunter,beastmastery,12,7,5
Drwíggles,smolderthorn,672,hunter,beastmastery,12,7,5
Jsr,tichondrius,672,hunter,beastmastery,12,7,5
Crimsoncoast,tichondrius,672,hunter,beastmastery,12,7,5
Alfentanil,thrall,672,hunter,beastmastery,12,7,5
Barainto,tichondrius,672,hunter,beastmastery,12,7,5
Hunatar,stormrage,672,hunter,beastmastery,12,7,5
Skippyh,zuluhed,672,hunter,beastmastery,12,7,5
Sakedji,area-52,672,hunter,beastmastery,12,7,5
Tusxx,tichondrius,672,hunter,beastmastery,12,7,5
Handmemygun,aggramar,672,hunter,beastmastery,12,7,5
Buzzkilla,mannoroth,672,hunter,beastmastery,12,7,5
Sensator,barthilas,672,hunter,beastmastery,12,7,5
Küky,ragnaros,672,hunter,beastmastery,12,7,5
Artames,tichondrius,672,hunter,beastmastery,12,7,5
Buffhunt,tichondrius,672,hunter,beastmastery,12,7,5
Ajukeo,tichondrius,672,hunter,beastmastery,12,7,5
Interer,proudmoore,672,hunter,beastmastery,12,7,5
Kuzar,thrall,672,hunter,beastmastery,12,7,5
Cinnybunz,malganis,672,hunter,beastmastery,12,7,5
Mylaqt,malganis,672,hunter,beastmastery,12,7,5
Pmø,sargeras,672,hunter,beastmastery,12,7,5
Grannygatya,tichondrius,672,hunter,beastmastery,12,7,5
Kaikunoshiri,tichondrius,672,hunter,beastmastery,12,7,5
Gun,shadowsong,672,hunter,beastmastery,12,7,5
Yolotraps,thrall,672,hunter,beastmastery,12,7,5
Buliss,wyrmrest-accord,672,hunter,beastmastery,12,7,5
Dadedehuyeah,illidan,672,hunter,beastmastery,12,7,5
Litchi,illidan,672,hunter,beastmastery,12,7,5
Xerosa,emerald-dream,672,hunter,beastmastery,12,7,5
Mauiies,sargeras,672,hunter,beastmastery,12,7,5
Akirarika,wyrmrest-accord,672,hunter,beastmastery,12,7,5
Gentledream,dalaran,672,hunter,beastmastery,12,7,5
Cumman,sargeras,672,hunter,beastmastery,12,7,5
Shaytime,proudmoore,672,hunter,beastmastery,16,8,8
Szeh,tichondrius,672,hunter,beastmastery,14,7,7
Greenmamba,thrall,672,hunter,beastmastery,18,7,11
Antares,dalaran,672,hunter,beastmastery,18,7,11
Ðevil,ragnaros,672,hunter,beastmastery,18,7,11
Joerogan,hydraxis,672,hunter,beastmastery,18,7,11
Nashi,burning-blade,672,hunter,beastmastery,18,7,11
Sensitivthug,sargeras,672,hunter,beastmastery,18,7,11
Dreagneal,ragnaros,672,hunter,beastmastery,18,7,11
Msghunter,sargeras,672,hunter,beastmastery,18,7,11
Moralidawn,illidan,672,hunter,beastmastery,18,7,11
Mostmanly,tichondrius,672,hunter,beastmastery,18,7,11
Aethernovae,area-52,672,hunter,beastmastery,18,7,11
Deuzebuk,azralon,672,hunter,beastmastery,18,7,11
Hyperíon,draenor,672,hunter,beastmastery,18,7,11
Velaknahtou,illidan,672,hunter,beastmastery,18,7,11
Clowntown,illidan,672,hunter,beastmastery,18,7,11
Sèasons,tichondrius,672,hunter,beastmastery,21,7,14
Trycaza,ragnaros,672,hunter,beastmastery,24,7,17
Sunsinfour,proudmoore,672,hunter,beastmastery,24,7,17
Titanaxis,tichondrius,672,hunter,beastmastery,24,7,17
Desoh,kelthuzad,672,hunter,beastmastery,24,7,17
Kango,azgalor,672,hunter,beastmastery,30,7,23
Lavo,borean-tundra,671,hunter,beastmastery,12,7,5
Anniefuchsia,stormrage,671,hunter,beastmastery,12,7,5
Exploits,stormrage,671,hunter,beastmastery,12,7,5
Thanthion,spirestone,671,hunter,beastmastery,12,7,5
Winzip,whisperwind,671,hunter,beastmastery,12,7,5
Mannypew,kelthuzad,671,hunter,beastmastery,12,7,5
Tremobbin,kelthuzad,671,hunter,beastmastery,12,7,5
Kupupor,area-52,671,hunter,beastmastery,12,7,5
Scruffiebear,deathwing,671,hunter,beastmastery,12,7,5
Scrubmastery,emerald-dream,671,hunter,beastmastery,12,7,5
Spunkked,tichondrius,671,hunter,beastmastery,12,7,5
Ziêg,eonar,671,hunter,beastmastery,12,7,5
Melinda,kilrogg,671,hunter,beastmastery,12,7,5
Terezhunt,tichondrius,671,hunter,beastmastery,12,7,5
Beardedeagle,tichondrius,671,hunter,beastmastery,15,8,7
Heylenny,area-52,671,hunter,beastmastery,18,7,11
Dontkillpet,shandris,671,hunter,beastmastery,18,7,11
Jagare,tichondrius,671,hunter,beastmastery,18,7,11
Nj,kiljaeden,671,hunter,beastmastery,18,7,11
Mooséhunt,wyrmrest-accord,671,hunter,beastmastery,18,7,11
Threethirty,thrall,671,hunter,beastmastery,18,7,11
Amortiz,illidan,671,hunter,beastmastery,18,7,11
Genowin,sargeras,671,hunter,beastmastery,18,7,11
Ratfood,tichondrius,671,hunter,beastmastery,23,7,16
Yanzz,spinebreaker,670,hunter,beastmastery,12,7,5
Topgun,laughing-skull,670,hunter,beastmastery,12,7,5
Madness,zuljin,670,hunter,beastmastery,12,7,5
Enigmer,area-52,670,hunter,beastmastery,12,7,5
Macabre,scilla,670,hunter,beastmastery,18,7,11
Fawn,moon-guard,670,hunter,beastmastery,18,7,11
Spaeth,borean-tundra,670,hunter,beastmastery,24,7,17
Vicarnam,uldum,669,hunter,beastmastery,12,7,5
Neurosurgery,azralon,669,hunter,beastmastery,18,7,11
Rinasonline,sargeras,669,hunter,beastmastery,18,7,11
Fynnigan,shandris,669,hunter,beastmastery,18,7,11
Oneshotman,hydraxis,668,hunter,beastmastery,12,7,5
Oldmanmacd,tichondrius,667,hunter,beastmastery,12,7,5
Bosslord,wyrmrest-accord,667,hunter,beastmastery,12,7,5
Terusa,ragnaros,667,hunter,beastmastery,24,7,17
Arielma,illidan,667,hunter,beastmastery,30,7,23
Badboyzcry,deathwing,666,hunter,beastmastery,12,7,5
Strafenshoot,darkspear,666,hunter,beastmastery,12,7,5
Olelf,chogall,666,hunter,beastmastery,12,7,5
Jashak,windrunner,665,hunter,beastmastery,12,7,5
Rikitiki,bleeding-hollow,663,hunter,beastmastery,18,7,11
Eastera,tichondrius,663,hunter,beastmastery,27,8,19
Isagypsy,ragnaros,662,hunter,beastmastery,18,7,11
Cbramatacera,drakkari,661,hunter,beastmastery,12,7,5
Theprovider,burning-blade,659,hunter,beastmastery,12,7,5
Benryats,area-52,657,hunter,beastmastery,21,8,13
Legendhunter,quelthalas,655,hunter,beastmastery,12,8,4
Lyduc,barthilas,655,hunter,beastmastery,17,7,10
Wuzi,echo-isles,653,hunter,beastmastery,18,7,11
Linszsz,nemesis,648,hunter,beastmastery,23,9,14
Cuddle,arathor,637,hunter,beastmastery,17,7,10
Árescarries,shuhalo,623,hunter,beastmastery,15,7,8
Ashx,nemesis,623,hunter,beastmastery,17,7,10
Xhítt,sargeras,623,hunter,beastmastery,17,7,10
Lelreisw,goldrinn,622,hunter,beastmastery,21,7,14
Ôhunter,sentinels,618,hunter,beastmastery,17,8,9
Snapyaf,area-52,618,hunter,beastmastery,22,8,14
Tribë,emerald-dream,607,hunter,beastmastery,11,7,4
Supdawg,aggramar,607,hunter,beastmastery,17,7,10
Shootdogg,mannoroth,607,hunter,beastmastery,20,7,13
Lulafourdedo,stormrage,606,hunter,beastmastery,9,7,2
Drisilla,stormrage,606,hunter,beastmastery,11,7,4
Shanghunt,cenarius,604,hunter,beastmastery,14,7,7
Oshosiwar,ragnaros,588,hunter,beastmastery,21,7,14
Rekkis,area-52,576,hunter,beastmastery,6,6,0
Igotapvpness,tichondrius,576,hunter,beastmastery,6,6,0
Gassmask,area-52,576,hunter,beastmastery,6,6,0
Jjaro,area-52,576,hunter,beastmastery,6,6,0
Mavmavmavmav,illidan,576,hunter,beastmastery,6,6,0
Píps,maelstrom,576,hunter,beastmastery,6,6,0
Taurask,tichondrius,576,hunter,beastmastery,12,6,6
Wongy,tichondrius,576,hunter,beastmastery,12,6,6
Nampa,stormrage,576,hunter,beastmastery,12,6,6
Ahncheolsoo,tichondrius,576,hunter,beastmastery,12,6,6
Fma,stormrage,576,hunter,beastmastery,12,6,6
Nytefell,skullcrusher,576,hunter,beastmastery,12,6,6
Chriscal,zuljin,576,hunter,beastmastery,12,6,6
Dd,frostmourne,576,hunter,beastmastery,12,6,6
Ziraiel,tichondrius,576,hunter,beastmastery,12,6,6
Cubixer,zuljin,576,hunter,beastmastery,12,6,6
Boybawang,area-52,576,hunter,beastmastery,12,6,6
Gilv,frostmourne,576,hunter,beastmastery,12,6,6
Kyoü,drakkari,576,hunter,beastmastery,12,6,6
Shøz,wyrmrest-accord,576,hunter,beastmastery,12,6,6
Alochol,vashj,576,hunter,beastmastery,12,6,6
Deidada,ragnaros,576,hunter,beastmastery,12,6,6
Hunterpk,lightbringer,576,hunter,beastmastery,12,6,6
Makag,illidan,576,hunter,beastmastery,12,6,6
Teaa,dalaran,576,hunter,beastmastery,12,6,6
Trapgodtina,bleeding-hollow,576,hunter,beastmastery,12,6,6
Jwzz,tichondrius,576,hunter,beastmastery,12,6,6
Schvitz,darkspear,576,hunter,beastmastery,12,6,6
Thugbus,frostmourne,576,hunter,beastmastery,12,6,6
Rockoutt,emerald-dream,576,hunter,beastmastery,12,6,6
Darksniper,proudmoore,576,hunter,beastmastery,12,6,6
Peacemaker,dunemaul,576,hunter,beastmastery,12,6,6
Raadun,terokkar,576,hunter,beastmastery,12,6,6
Retaâáàäãart,tichondrius,576,hunter,beastmastery,12,6,6
Zookeepah,tichondrius,576,hunter,beastmastery,12,6,6
Hurato,stormrage,576,hunter,beastmastery,12,6,6
Spottedoger,burning-legion,576,hunter,beastmastery,12,6,6
Supernamh,sargeras,576,hunter,beastmastery,12,6,6
Evilblammo,thorium-brotherhood,576,hunter,beastmastery,12,6,6
Daylilycoast,emerald-dream,576,hunter,beastmastery,12,6,6
Jonah,sargeras,576,hunter,beastmastery,12,6,6
Zertkal,undermine,576,hunter,beastmastery,12,6,6
Skyfel,aggramar,576,hunter,beastmastery,12,6,6
Noblesaïnt,tichondrius,576,hunter,beastmastery,12,6,6
Raerdun,bonechewer,576,hunter,beastmastery,12,6,6
Itch,moon-guard,576,hunter,beastmastery,12,6,6
Harmfulwang,emerald-dream,576,hunter,beastmastery,12,6,6
Balboa,tortheldrin,576,hunter,beastmastery,12,6,6
Invisabootz,hyjal,576,hunter,beastmastery,12,6,6
Mcfibers,malganis,576,hunter,beastmastery,12,6,6
Séptimo,illidan,576,hunter,beastmastery,12,6,6
Jalinhabbei,azralon,576,hunter,beastmastery,12,6,6
Kånade,ragnaros,576,hunter,beastmastery,12,6,6
Leadblaster,gorefiend,576,hunter,beastmastery,12,6,6
Orqism,tichondrius,576,hunter,beastmastery,12,6,6
Khanittus,area-52,576,hunter,beastmastery,12,6,6
Gravshot,zuljin,576,hunter,beastmastery,12,6,6
Drdill,gorefiend,576,hunter,beastmastery,12,6,6
Wopper,moon-guard,576,hunter,beastmastery,12,6,6
Himmihyme,illidan,576,hunter,beastmastery,12,6,6
Toniic,moon-guard,576,hunter,beastmastery,12,6,6
Sumpunter,barthilas,576,hunter,beastmastery,12,6,6
Aduurant,quelthalas,576,hunter,beastmastery,12,6,6
Oidhunter,barthilas,576,hunter,beastmastery,12,6,6
Wapnonymous,mugthol,576,hunter,beastmastery,12,6,6
Zigum,dalaran,576,hunter,beastmastery,12,6,6
Arrebol,tichondrius,576,hunter,beastmastery,12,6,6
Zeedii,dalaran,576,hunter,beastmastery,12,6,6
Rhovanni,ragnaros,576,hunter,beastmastery,15,7,8
Arraza,ragnaros,576,hunter,beastmastery,16,7,9
Mørødox,sargeras,576,hunter,beastmastery,18,6,12
Thorssman,illidan,576,hunter,beastmastery,18,6,12
Larrydog,fizzcrank,576,hunter,beastmastery,18,6,12
Ljai,gilneas,576,hunter,beastmastery,18,6,12
Virgim,kelthuzad,576,hunter,beastmastery,18,6,12
Kanta,bleeding-hollow,576,hunter,beastmastery,18,6,12
Pieman,azuremyst,576,hunter,beastmastery,18,6,12
Møoo,ragnaros,576,hunter,beastmastery,18,6,12
Ærês,ysondre,576,hunter,beastmastery,20,6,14
Beastbaal,sargeras,576,hunter,beastmastery,24,6,18
Sniffler,barthilas,576,hunter,beastmastery,24,6,18
Wdb,tichondrius,575,hunter,beastmastery,12,6,6
Recoyl,proudmoore,575,hunter,beastmastery,12,6,6
Gwarnar,stormrage,575,hunter,beastmastery,12,6,6
Chinoiti,bleeding-hollow,575,hunter,beastmastery,12,6,6
Fireshots,tichondrius,575,hunter,beastmastery,12,6,6
Mindbreaker,illidan,575,hunter,beastmastery,12,6,6
Ventura,emerald-dream,575,hunter,beastmastery,12,6,6
Eastwake,stormrage,575,hunter,beastmastery,12,6,6
Hollee,turalyon,575,hunter,beastmastery,12,6,6
Aoife,zuljin,575,hunter,beastmastery,12,6,6
Asuryakha,darkspear,575,hunter,beastmastery,12,6,6
Brenoob,azralon,575,hunter,beastmastery,12,6,6
Míbu,lightbringer,575,hunter,beastmastery,12,6,6
Ontop,draka,575,hunter,beastmastery,12,6,6
Rankhor,darkspear,575,hunter,beastmastery,12,6,6
Longshott,azralon,575,hunter,beastmastery,12,6,6
Ovî,area-52,575,hunter,beastmastery,12,6,6
Yobby,area-52,575,hunter,beastmastery,12,6,6
Horsegirl,chogall,575,hunter,beastmastery,12,6,6
Orangegummy,frostmourne,575,hunter,beastmastery,15,7,8
Boradin,lightbringer,575,hunter,beastmastery,18,6,12
Aliciaomg,andorhal,575,hunter,beastmastery,18,6,12
Camorcaist,stormrage,575,hunter,beastmastery,18,6,12
Logandawgfan,thunderlord,575,hunter,beastmastery,18,6,12
Tozier,destromath,575,hunter,beastmastery,18,6,12
Bagofsnit,frostmourne,575,hunter,beastmastery,18,6,12
Fiddich,shattered-hand,574,hunter,beastmastery,12,6,6
Nekrongar,agamaggan,574,hunter,beastmastery,12,6,6
Arcticuz,aegwynn,574,hunter,beastmastery,12,6,6
Kalibah,azralon,574,hunter,beastmastery,18,6,12
Sapphie,frostmourne,574,hunter,beastmastery,24,6,18
Flooring,illidan,573,hunter,beastmastery,12,6,6
Barberreggie,barthilas,573,hunter,beastmastery,30,6,24
Dethh,dunemaul,572,hunter,beastmastery,12,6,6
Pewpewd,tichondrius,572,hunter,beastmastery,12,6,6
Høød,aggramar,571,hunter,beastmastery,12,6,6
Cousinlarry,kaelthas,571,hunter,beastmastery,12,6,6
Katmang,frostmourne,571,hunter,beastmastery,18,6,12
Lanamatt,azralon,569,hunter,beastmastery,12,6,6
Kargathx,ragnaros,569,hunter,beastmastery,20,8,12
Kenhay,wyrmrest-accord,569,hunter,beastmastery,18,6,12
Pureguava,gorefiend,567,hunter,beastmastery,18,6,12
Bluehead,emerald-dream,566,hunter,beastmastery,12,6,6
Parâsite,kelthuzad,559,hunter,beastmastery,23,6,17
Gerpshot,darrowmere,557,hunter,beastmastery,18,7,11
Jîa,tichondrius,544,hunter,beastmastery,16,6,10
Ullria,frostmourne,544,hunter,beastmastery,16,6,10
Triggamikê,tichondrius,543,hunter,beastmastery,8,7,1
Habanero,anetheron,543,hunter,beastmastery,14,7,7
Boopuh,illidan,543,hunter,beastmastery,14,7,7
Tezlekhan,haomarush,543,hunter,beastmastery,17,6,11
Viserysll,azralon,542,hunter,beastmastery,11,6,5
Trycen,bleeding-hollow,527,hunter,beastmastery,11,6,5
Memorypet,proudmoore,527,hunter,beastmastery,15,6,9
Pikepounder,tichondrius,527,hunter,beastmastery,15,6,9
Yatolo,barthilas,526,hunter,beastmastery,15,6,9
Oromme,ragnaros,526,hunter,beastmastery,20,7,13
Porkrager,doomhammer,522,hunter,beastmastery,14,7,7
Iililillilii,tichondrius,522,hunter,beastmastery,20,7,13
Mïsërý,tichondrius,522,hunter,beastmastery,21,7,14
Beastcraft,emerald-dream,521,hunter,beastmastery,21,7,14
Bugsßunny,sargeras,521,hunter,beastmastery,22,7,15
Fiury,hyjal,519,hunter,beastmastery,15,6,9
Ataxyus,area-52,512,hunter,beastmastery,10,6,4
Pigmaster,tichondrius,511,hunter,beastmastery,14,6,8
Bowjobs,stormscale,511,hunter,beastmastery,14,6,8
Aluminumfoil,kelthuzad,510,hunter,beastmastery,11,6,5
Zock,lothar,494,hunter,beastmastery,19,6,13
Nsjp,darkspear,480,hunter,beastmastery,6,5,1
Cyrads,darkspear,480,hunter,beastmastery,6,5,1
Glacierr,emerald-dream,480,hunter,beastmastery,6,5,1
Luys,illidan,480,hunter,beastmastery,6,5,1
Añtø,tichondrius,480,hunter,beastmastery,6,5,1
Devilborne,tichondrius,480,hunter,beastmastery,6,5,1
Sinon,stormrage,480,hunter,beastmastery,6,5,1
Linkolnn,sargeras,480,hunter,beastmastery,6,5,1
Arthäsxd,azralon,480,hunter,beastmastery,6,5,1
Brokensnipez,area-52,480,hunter,beastmastery,6,5,1
Tukki,quelthalas,480,hunter,beastmastery,6,5,1
Bluez,tichondrius,480,hunter,beastmastery,6,5,1
Dankshunt,arthas,480,hunter,beastmastery,6,5,1
Moistbooger,emerald-dream,480,hunter,beastmastery,6,5,1
Yajr,black-dragonflight,480,hunter,beastmastery,6,5,1
Jareeth,bleeding-hollow,480,hunter,beastmastery,6,5,1
Traptrinket,sargeras,480,hunter,beastmastery,6,5,1
Oeoeoeoeoeoe,alterac-mountains,480,hunter,beastmastery,6,5,1
Tèrrabite,sargeras,480,hunter,beastmastery,6,5,1
Kkoduckk,tichondrius,480,hunter,beastmastery,6,5,1
Chimeralol,area-52,480,hunter,beastmastery,6,5,1
Zansnipes,dalaran,480,hunter,beastmastery,6,5,1
Slêv,frostmourne,480,hunter,beastmastery,6,5,1
Nokda,tichondrius,480,hunter,beastmastery,6,5,1
Plsnobanmee,frostmourne,480,hunter,beastmastery,6,5,1
Megahuntard,bleeding-hollow,480,hunter,beastmastery,6,5,1
Arleesta,thrall,480,hunter,beastmastery,6,5,1
Follard,stormrage,480,hunter,beastmastery,6,5,1
Vynloresh,thrall,480,hunter,beastmastery,6,5,1
Cojáx,dalaran,480,hunter,beastmastery,6,5,1
Goodwillhunt,tichondrius,480,hunter,beastmastery,6,5,1
Clawdio,ragnaros,480,hunter,beastmastery,6,5,1
Hukkx,kalecgos,480,hunter,beastmastery,6,5,1
Victorcrumb,tichondrius,480,hunter,beastmastery,6,5,1
Airoh,gorefiend,480,hunter,beastmastery,10,6,4
Pàstor,azralon,480,hunter,beastmastery,12,5,7
Valeous,azjolnerub,480,hunter,beastmastery,12,5,7
Feladorn,silver-hand,480,hunter,beastmastery,12,5,7
Affections,darkspear,480,hunter,beastmastery,12,5,7
Fallacies,moon-guard,480,hunter,beastmastery,12,5,7
Hitcompleted,moon-guard,480,hunter,beastmastery,12,5,7
Skitso,illidan,480,hunter,beastmastery,12,5,7
Loranoh,illidan,480,hunter,beastmastery,12,5,7
Chipsncheese,korgath,480,hunter,beastmastery,12,5,7
Chernovax,altar-of-storms,480,hunter,beastmastery,12,5,7
Mcbacon,illidan,480,hunter,beastmastery,12,5,7
Taphh,moon-guard,480,hunter,beastmastery,12,5,7
Exabyssus,bleeding-hollow,480,hunter,beastmastery,12,5,7
Satàn,thrall,480,hunter,beastmastery,12,5,7
Tureckk,illidan,480,hunter,beastmastery,12,5,7
Smexyhunter,moon-guard,480,hunter,beastmastery,12,5,7
Imperatrix,emerald-dream,480,hunter,beastmastery,12,5,7
Ariais,zangarmarsh,480,hunter,beastmastery,12,5,7
Cowahunt,illidan,480,hunter,beastmastery,12,5,7
Squiik,wildhammer,480,hunter,beastmastery,12,5,7
Mylfhunter,azralon,480,hunter,beastmastery,12,5,7
Toontot,sargeras,480,hunter,beastmastery,12,5,7
Bowzza,area-52,480,hunter,beastmastery,12,5,7
Xavííer,tichondrius,480,hunter,beastmastery,12,5,7
Backa,jubeithos,480,hunter,beastmastery,12,5,7
Grizmin,sargeras,480,hunter,beastmastery,12,5,7
Powerstrokes,sargeras,480,hunter,beastmastery,12,5,7
Sunflwerdawn,emerald-dream,480,hunter,beastmastery,12,5,7
Michaeljfox,area-52,480,hunter,beastmastery,12,5,7
Hellbow,ragnaros,480,hunter,beastmastery,12,5,7
Kansolly,tichondrius,480,hunter,beastmastery,12,5,7
Alssong,tichondrius,480,hunter,beastmastery,12,5,7
Zinelun,quelthalas,480,hunter,beastmastery,12,5,7
Kaloh,daggerspine,480,hunter,beastmastery,12,5,7
Deklin,malganis,480,hunter,beastmastery,12,5,7
Hendlie,frostmourne,480,hunter,beastmastery,12,5,7
Abloodelf,zuljin,480,hunter,beastmastery,12,5,7
Thejw,firetree,480,hunter,beastmastery,12,5,7
Banai,the-underbog,480,hunter,beastmastery,12,5,7
Thoraky,stormrage,480,hunter,beastmastery,12,5,7
Åî,tichondrius,480,hunter,beastmastery,12,5,7
Taskete,ragnaros,480,hunter,beastmastery,12,5,7
Kurmojo,hyjal,480,hunter,beastmastery,12,5,7
Pichsolika,frostmourne,480,hunter,beastmastery,12,5,7
Silveraero,ghostlands,480,hunter,beastmastery,12,5,7
Wønky,stormrage,480,hunter,beastmastery,12,5,7
Twoshotz,stormrage,480,hunter,beastmastery,12,5,7
Ferex,tichondrius,480,hunter,beastmastery,12,5,7
Ghostdâwg,stormrage,480,hunter,beastmastery,12,5,7
Powdersoak,area-52,480,hunter,beastmastery,12,5,7
Sinvat,tichondrius,480,hunter,beastmastery,12,5,7
Drakku,zuljin,480,hunter,beastmastery,12,5,7
Tarkovs,area-52,480,hunter,beastmastery,12,5,7
Gorillafart,spirestone,480,hunter,beastmastery,12,5,7
Køk,agamaggan,480,hunter,beastmastery,12,5,7
Àthenaa,malygos,480,hunter,beastmastery,12,5,7
Gonnujo,ragnaros,480,hunter,beastmastery,12,5,7
Llachiip,zuljin,480,hunter,beastmastery,16,6,10
Bøl,ragnaros,480,hunter,beastmastery,16,5,11
Chetxs,bleeding-hollow,480,hunter,beastmastery,18,5,13
Snoogen,illidan,480,hunter,beastmastery,18,5,13
Mingsomnia,kiljaeden,480,hunter,beastmastery,18,5,13
Semiautmatic,thrall,480,hunter,beastmastery,18,5,13
Blockbusters,sargeras,480,hunter,beastmastery,18,5,13
Amoreiene,stormrage,480,hunter,beastmastery,18,5,13
Cophunter,tichondrius,480,hunter,beastmastery,18,5,13
Panzerfäust,zuljin,480,hunter,beastmastery,18,5,13
Sizzimus,area-52,479,hunter,beastmastery,6,5,1
Riverjumper,ghostlands,479,hunter,beastmastery,6,5,1
Segulah,dalaran,479,hunter,beastmastery,6,5,1
Mafghine,malganis,479,hunter,beastmastery,6,5,1
Apolex,velen,479,hunter,beastmastery,12,5,7
Ashevan,stormrage,479,hunter,beastmastery,12,5,7
Deadlyattack,barthilas,479,hunter,beastmastery,12,5,7
Shoya,nerzhul,479,hunter,beastmastery,12,5,7
Pickshot,boulderfist,479,hunter,beastmastery,12,5,7
Kairoke,azralon,479,hunter,beastmastery,12,5,7
Equipmunk,arthas,479,hunter,beastmastery,12,5,7
Chosan,sargeras,479,hunter,beastmastery,12,5,7
Livershot,zuljin,479,hunter,beastmastery,12,5,7
Dwarfpecker,hydraxis,479,hunter,beastmastery,12,5,7
Mecatrón,quelthalas,479,hunter,beastmastery,12,5,7
Holyhunnter,proudmoore,479,hunter,beastmastery,12,5,7
Simoro,malganis,479,hunter,beastmastery,14,5,9
Trushôtz,tichondrius,479,hunter,beastmastery,17,5,12
Boomup,tichondrius,479,hunter,beastmastery,21,6,15
Morngrimm,area-52,479,hunter,beastmastery,18,5,13
Smider,magtheridon,479,hunter,beastmastery,18,5,13
Auset,aegwynn,479,hunter,beastmastery,18,5,13
Starkmeister,stormrage,479,hunter,beastmastery,18,5,13
Zarrockk,emerald-dream,478,hunter,beastmastery,12,5,7
Waagg,ragnaros,478,hunter,beastmastery,12,5,7
Fiznits,nerzhul,478,hunter,beastmastery,18,5,13
Titchi,azralon,478,hunter,beastmastery,18,5,13
Haltheron,azshara,477,hunter,beastmastery,12,5,7
Slowbear,kiljaeden,477,hunter,beastmastery,12,5,7
Feralhuntard,muradin,477,hunter,beastmastery,12,5,7
Braindeadly,malganis,476,hunter,beastmastery,12,5,7
Syphiel,moon-guard,476,hunter,beastmastery,12,5,7
Gilonate,tichondrius,476,hunter,beastmastery,36,5,31
Ogma,mugthol,475,hunter,beastmastery,12,5,7
Mehtcurious,ragnaros,470,hunter,beastmastery,18,5,13
Redrum,turalyon,448,hunter,beastmastery,10,5,5
Revenantz,stormrage,447,hunter,beastmastery,11,5,6
Degenape,bleeding-hollow,447,hunter,beastmastery,11,5,6
Verzatyle,frostwolf,447,hunter,beastmastery,11,5,6
Travisshot,tichondrius,447,hunter,beastmastery,11,5,6
Gunther,korgath,447,hunter,beastmastery,11,5,6
Vuur,korialstrasz,447,hunter,beastmastery,19,6,13
Rástakhan,ragnaros,431,hunter,beastmastery,11,5,6
Hazzlôk,cairne,426,hunter,beastmastery,20,7,13
Ripmytoast,chogall,424,hunter,beastmastery,16,7,9
Verse,aggramar,415,hunter,beastmastery,12,6,6
Malgar,zuljin,415,hunter,beastmastery,11,5,6
Kaiso,chogall,415,hunter,beastmastery,14,5,9
Missionfiggs,malganis,415,hunter,beastmastery,14,5,9
Resonators,tichondrius,400,hunter,beastmastery,13,5,8
Silvershot,emerald-dream,384,hunter,beastmastery,6,4,2
Skytah,darkspear,384,hunter,beastmastery,6,4,2
Dexh,frostmourne,384,hunter,beastmastery,6,4,2
Deddita,zuljin,384,hunter,beastmastery,6,4,2
Redzic,tichondrius,384,hunter,beastmastery,6,4,2
Damatic,area-52,384,hunter,beastmastery,6,4,2
Fizzpow,blackrock,384,hunter,beastmastery,6,4,2
Sindshai,onyxia,384,hunter,beastmastery,6,4,2
Celdiirn,dragonmaw,384,hunter,beastmastery,6,4,2
Zubo,tichondrius,384,hunter,beastmastery,6,4,2
Jerso,zuljin,384,hunter,beastmastery,6,4,2
Malcab,tichondrius,384,hunter,beastmastery,6,4,2
Jerusa,illidan,384,hunter,beastmastery,6,4,2
Deshiie,proudmoore,384,hunter,beastmastery,6,4,2
Anisphia,tichondrius,384,hunter,beastmastery,6,4,2
Chichi,korgath,384,hunter,beastmastery,6,4,2
Yosra,frostmourne,384,hunter,beastmastery,6,4,2
Bênton,tichondrius,384,hunter,beastmastery,6,4,2
Ragerab,trollbane,384,hunter,beastmastery,6,4,2
Skað,lightbringer,384,hunter,beastmastery,6,4,2
Eazyaimz,thrall,384,hunter,beastmastery,6,4,2
Putos,zuljin,384,hunter,beastmastery,6,4,2
Valeine,barthilas,384,hunter,beastmastery,6,4,2
Zarnick,frostwolf,384,hunter,beastmastery,6,4,2
Stallwart,bronzebeard,384,hunter,beastmastery,6,4,2
Tezcâtlipocâ,sargeras,384,hunter,beastmastery,6,4,2
Markymarc,tichondrius,384,hunter,beastmastery,6,4,2
Bowfox,area-52,384,hunter,beastmastery,6,4,2
Scytsbow,illidan,384,hunter,beastmastery,6,4,2
Drinktodrown,moon-guard,384,hunter,beastmastery,6,4,2
Shotgunpain,nazjatar,384,hunter,beastmastery,6,4,2
Krazykilla,spirestone,384,hunter,beastmastery,6,4,2
Kong,tichondrius,384,hunter,beastmastery,6,4,2
Chikkynuggy,destromath,384,hunter,beastmastery,6,4,2
Hygogg,area-52,384,hunter,beastmastery,6,4,2
Bufluu,bleeding-hollow,384,hunter,beastmastery,6,4,2
Bodangel,galakrond,384,hunter,beastmastery,6,4,2
Ithanna,quelthalas,384,hunter,beastmastery,6,4,2
Dcousins,tichondrius,384,hunter,beastmastery,6,4,2
Shiki,icecrown,384,hunter,beastmastery,6,4,2
Hyyz,proudmoore,384,hunter,beastmastery,6,4,2
Sôuleater,moon-guard,384,hunter,beastmastery,6,4,2
Lowlore,moon-guard,384,hunter,beastmastery,6,4,2
Hunterquim,stormrage,384,hunter,beastmastery,6,4,2
Vanquisher,trollbane,384,hunter,beastmastery,6,4,2
Chokemescara,stormrage,384,hunter,beastmastery,6,4,2
Tìrra,stormrage,384,hunter,beastmastery,6,4,2
Reilerhunt,stormrage,384,hunter,beastmastery,6,4,2
Naxhunter,stormrage,384,hunter,beastmastery,6,4,2
Infatuatedx,moon-guard,384,hunter,beastmastery,6,4,2
Chutput,dalaran,384,hunter,beastmastery,9,5,4
Nakyash,ragnaros,384,hunter,beastmastery,9,5,4
Jeonghun,tichondrius,384,hunter,beastmastery,9,5,4
Anteróz,tichondrius,384,hunter,beastmastery,9,4,5
Withoutraps,quelthalas,384,hunter,beastmastery,12,4,8
Zøro,malganis,384,hunter,beastmastery,12,4,8
Bangerzx,stormrage,384,hunter,beastmastery,12,4,8
Tigerswood,sargeras,384,hunter,beastmastery,12,4,8
Dubbledee,malganis,384,hunter,beastmastery,12,4,8
Alkynabm,kelthuzad,384,hunter,beastmastery,12,4,8
Arcuz,quelthalas,384,hunter,beastmastery,12,4,8
Zeront,garona,384,hunter,beastmastery,12,4,8
Knarlin,uldum,384,hunter,beastmastery,12,4,8
Pirateninja,illidan,384,hunter,beastmastery,12,4,8
Largetender,illidan,384,hunter,beastmastery,12,4,8
Sydina,malganis,384,hunter,beastmastery,12,4,8
Wannakill,stormrage,384,hunter,beastmastery,12,4,8
Øutpläyed,quelthalas,384,hunter,beastmastery,12,4,8
Throwadox,malganis,384,hunter,beastmastery,12,4,8
Shaevie,lothar,384,hunter,beastmastery,12,4,8
Dopeykingdom,illidan,384,hunter,beastmastery,12,4,8
Saharä,illidan,384,hunter,beastmastery,12,4,8
Cndavyjones,akama,384,hunter,beastmastery,12,4,8
Vandescar,illidan,384,hunter,beastmastery,12,4,8
Noxura,illidan,384,hunter,beastmastery,12,4,8
Kharvaash,onyxia,384,hunter,beastmastery,12,4,8
Moùrningwood,stormrage,384,hunter,beastmastery,12,4,8
Cluhaywood,zuljin,384,hunter,beastmastery,12,4,8
Grumaku,area-52,384,hunter,beastmastery,12,4,8
Shatterwax,area-52,384,hunter,beastmastery,12,4,8
Killatrap,malganis,384,hunter,beastmastery,12,4,8
Gaydin,zuljin,384,hunter,beastmastery,12,4,8
Oztroza,grizzly-hills,384,hunter,beastmastery,12,4,8
Dampteeth,sargeras,384,hunter,beastmastery,12,4,8
Päinal,area-52,384,hunter,beastmastery,12,4,8
Bowsauce,khadgar,384,hunter,beastmastery,12,4,8
Elywen,alexstrasza,384,hunter,beastmastery,12,4,8
Kok,andorhal,384,hunter,beastmastery,12,4,8
Deahtgab,ragnaros,384,hunter,beastmastery,12,4,8
Rhyzen,drenden,384,hunter,beastmastery,12,4,8
Gandury,tichondrius,384,hunter,beastmastery,12,4,8
Valrosan,stormrage,384,hunter,beastmastery,12,4,8
Doves,wyrmrest-accord,384,hunter,beastmastery,12,4,8
Bówjòb,nordrassil,384,hunter,beastmastery,12,4,8
Ælij,tichondrius,384,hunter,beastmastery,12,4,8
Vencc,tichondrius,384,hunter,beastmastery,12,4,8
Seanpaì,tichondrius,384,hunter,beastmastery,12,4,8
Bazanguita,tichondrius,384,hunter,beastmastery,12,4,8
Grimshot,boulderfist,384,hunter,beastmastery,12,4,8
Inetpub,stormrage,384,hunter,beastmastery,12,4,8
Dangerclam,barthilas,384,hunter,beastmastery,12,4,8
Calev,frostmourne,384,hunter,beastmastery,12,4,8
Miansi,tichondrius,384,hunter,beastmastery,12,4,8
Softhunter,tichondrius,384,hunter,beastmastery,12,4,8
Mídnîght,azralon,384,hunter,beastmastery,12,4,8
Graatata,shandris,384,hunter,beastmastery,12,4,8
Lookoutt,tichondrius,384,hunter,beastmastery,12,4,8
Coggter,uther,384,hunter,beastmastery,12,4,8
Skycaptaín,lightbringer,384,hunter,beastmastery,12,4,8
Devastavi,proudmoore,384,hunter,beastmastery,12,4,8
Zothus,azralon,384,hunter,beastmastery,12,4,8
Twopawshunta,tichondrius,384,hunter,beastmastery,12,4,8
Coolbeanz,boulderfist,384,hunter,beastmastery,12,4,8
Deatharrow,azuremyst,384,hunter,beastmastery,12,4,8
Whaling,tichondrius,384,hunter,beastmastery,12,4,8
Zylen,tichondrius,384,hunter,beastmastery,12,4,8
Zoëx,amanthul,384,hunter,beastmastery,12,4,8
Fydehunt,stormrage,384,hunter,beastmastery,14,4,10
Atheos,gallywix,384,hunter,beastmastery,18,4,14
Gugubird,proudmoore,384,hunter,beastmastery,18,4,14
Löö,arthas,384,hunter,beastmastery,23,4,19
Volga,haomarush,383,hunter,beastmastery,6,4,2
Gichiwalrus,emerald-dream,383,hunter,beastmastery,6,4,2
Ganaja,laughing-skull,383,hunter,beastmastery,6,4,2
Bboo,bonechewer,383,hunter,beastmastery,6,4,2
Mortia,thunderlord,383,hunter,beastmastery,12,4,8
Böwjøb,illidan,383,hunter,beastmastery,12,4,8
Patcherson,kargath,383,hunter,beastmastery,12,4,8
Lamper,emerald-dream,383,hunter,beastmastery,12,4,8
Paulayork,drakthul,383,hunter,beastmastery,12,4,8
Tarakii,moon-guard,383,hunter,beastmastery,12,4,8
Gals,saurfang,383,hunter,beastmastery,12,4,8
Purna,moon-guard,383,hunter,beastmastery,12,4,8
Defacecilth,dalaran,383,hunter,beastmastery,12,4,8
Beatnyou,tichondrius,383,hunter,beastmastery,12,4,8
Lazygnome,azshara,383,hunter,beastmastery,12,4,8
Slutnamedjim,zuljin,383,hunter,beastmastery,12,4,8
Foakus,zuljin,383,hunter,beastmastery,13,4,9
Etb,bleeding-hollow,382,hunter,beastmastery,12,4,8
Ire,kelthuzad,367,hunter,beastmastery,11,4,7
Mondlicht,tichondrius,367,hunter,beastmastery,11,4,7
Sylaris,arathor,366,hunter,beastmastery,11,4,7
Clinkz,chogall,351,hunter,beastmastery,11,4,7
Kemper,dragonmaw,351,hunter,beastmastery,11,4,7
Vínçent,blood-furnace,351,hunter,beastmastery,17,4,13
Sadarrow,frostmourne,334,hunter,beastmastery,11,4,7
Drakarÿs,drakkari,326,hunter,beastmastery,18,5,13
Rachael,veknilash,319,hunter,beastmastery,8,4,4
Khillin,destromath,319,hunter,beastmastery,8,4,4
Punkrockguy,illidan,319,hunter,beastmastery,14,4,10
Huntli,elune,304,hunter,beastmastery,7,4,3
Georgigeo,turalyon,288,hunter,beastmastery,6,3,3
Tibineids,stormrage,288,hunter,beastmastery,6,3,3
Wiittig,hyjal,288,hunter,beastmastery,6,3,3
Emart,bloodhoof,288,hunter,beastmastery,6,3,3
Mynds,stormrage,288,hunter,beastmastery,6,3,3
Moyria,quelthalas,288,hunter,beastmastery,6,3,3
Fakerz,stormrage,288,hunter,beastmastery,6,3,3
Kalhistra,stormrage,288,hunter,beastmastery,6,3,3
Yoyoletsgo,malganis,288,hunter,beastmastery,6,3,3
Cloudbuck,aegwynn,288,hunter,beastmastery,6,3,3
Beastmodex,quelthalas,288,hunter,beastmastery,6,3,3
Vinksy,sargeras,288,hunter,beastmastery,6,3,3
Trickshot,hakkar,288,hunter,beastmastery,6,3,3
Latrampoza,quelthalas,288,hunter,beastmastery,6,3,3
Jungling,kelthuzad,288,hunter,beastmastery,6,3,3
Terrabytés,kelthuzad,288,hunter,beastmastery,6,3,3
Archetype,bladefist,288,hunter,beastmastery,6,3,3
Talksic,bladefist,288,hunter,beastmastery,6,3,3
Gudlukk,stormrage,288,hunter,beastmastery,6,3,3
Enonoa,thunderlord,288,hunter,beastmastery,6,3,3
Markieemark,tichondrius,288,hunter,beastmastery,6,3,3
Gupples,frostwolf,288,hunter,beastmastery,6,3,3
Limpingspoon,kelthuzad,288,hunter,beastmastery,6,3,3
Raainha,stormrage,288,hunter,beastmastery,6,3,3
Shallaiya,stormrage,288,hunter,beastmastery,6,3,3
Tonysting,sargeras,288,hunter,beastmastery,6,3,3
Lelantos,stonemaul,288,hunter,beastmastery,6,3,3
Prasanna,kelthuzad,288,hunter,beastmastery,6,3,3
Arrazyne,jubeithos,288,hunter,beastmastery,6,3,3
Yousokook,frostmourne,288,hunter,beastmastery,6,3,3
Britannian,moon-guard,288,hunter,beastmastery,6,3,3
Tuanorz,proudmoore,288,hunter,beastmastery,6,3,3
Cablok,moon-guard,288,hunter,beastmastery,6,3,3
Goraku,dalaran,288,hunter,beastmastery,6,3,3
Arrowenn,zuljin,288,hunter,beastmastery,6,3,3
Trailed,dalaran,288,hunter,beastmastery,6,3,3
Shikay,frostmourne,288,hunter,beastmastery,6,3,3
Anatric,illidan,288,hunter,beastmastery,6,3,3
Nightstålkër,moon-guard,288,hunter,beastmastery,6,3,3
Rakhesh,quelthalas,288,hunter,beastmastery,6,3,3
Elroyjetson,arthas,288,hunter,beastmastery,6,3,3
Skulltøn,area-52,288,hunter,beastmastery,6,3,3
Crinkx,arthas,288,hunter,beastmastery,6,3,3
Quepop,demon-soul,288,hunter,beastmastery,6,3,3
Norgalys,proudmoore,288,hunter,beastmastery,6,3,3
Coachs,tichondrius,288,hunter,beastmastery,6,3,3
Hannes,boulderfist,288,hunter,beastmastery,6,3,3
Longbeau,gnomeregan,288,hunter,beastmastery,6,3,3
Schumann,ursin,288,hunter,beastmastery,6,3,3
Mogradme,shadowsong,288,hunter,beastmastery,6,3,3
Sibbleiv,boulderfist,288,hunter,beastmastery,6,3,3
Scolhunter,scarlet-crusade,288,hunter,beastmastery,6,3,3
Skarsnick,draenor,288,hunter,beastmastery,6,3,3
Díllý,area-52,288,hunter,beastmastery,6,3,3
Cefla,illidan,288,hunter,beastmastery,6,3,3
Ironova,illidan,288,hunter,beastmastery,6,3,3
Blastinnagas,tichondrius,288,hunter,beastmastery,6,3,3
Tetzuo,illidan,288,hunter,beastmastery,6,3,3
Makeastinky,malfurion,288,hunter,beastmastery,6,3,3
Viavii,barthilas,288,hunter,beastmastery,6,3,3
Gnurfgun,proudmoore,288,hunter,beastmastery,6,3,3
Wrâge,senjin,288,hunter,beastmastery,6,3,3
Vivaswan,tichondrius,288,hunter,beastmastery,6,3,3
Ocxhunter,nemesis,288,hunter,beastmastery,6,3,3
Çrimson,frostmourne,288,hunter,beastmastery,6,3,3
Tulipbee,moon-guard,288,hunter,beastmastery,6,3,3
Nopez,tichondrius,288,hunter,beastmastery,6,3,3
Guacmec,tichondrius,288,hunter,beastmastery,6,3,3
Ogkataro,tichondrius,288,hunter,beastmastery,6,3,3
Trixex,darkspear,288,hunter,beastmastery,6,3,3
Mackabeagden,illidan,288,hunter,beastmastery,6,3,3
Doubletappz,stormreaver,288,hunter,beastmastery,6,3,3
Braxigarr,area-52,288,hunter,beastmastery,6,3,3
Adapted,proudmoore,288,hunter,beastmastery,6,3,3
Firskin,frostmourne,288,hunter,beastmastery,6,3,3
Vikshen,illidan,288,hunter,beastmastery,6,3,3
Realzanderr,antonidas,288,hunter,beastmastery,6,3,3
Archicur,darkspear,288,hunter,beastmastery,6,3,3
Soberish,bleeding-hollow,288,hunter,beastmastery,6,3,3
Nyloc,dalvengyr,288,hunter,beastmastery,6,3,3
Aldurion,wyrmrest-accord,288,hunter,beastmastery,6,3,3
Popshotz,khazgoroth,288,hunter,beastmastery,6,3,3
Djpopshot,thrall,288,hunter,beastmastery,6,3,3
Harosh,azralon,288,hunter,beastmastery,6,3,3
Illine,azralon,288,hunter,beastmastery,6,3,3
Redthedeer,warsong,288,hunter,beastmastery,6,3,3
Chadbowsman,tichondrius,288,hunter,beastmastery,6,3,3
Venj,proudmoore,288,hunter,beastmastery,6,3,3
Dranel,nordrassil,288,hunter,beastmastery,6,3,3
Perfectcrit,area-52,288,hunter,beastmastery,6,3,3
Vipermaster,azralon,288,hunter,beastmastery,6,3,3
Pewpewbang,muradin,288,hunter,beastmastery,6,3,3
Billcsbyswtr,sargeras,288,hunter,beastmastery,6,3,3
Bmsurvmm,tichondrius,288,hunter,beastmastery,6,3,3
Grimpossible,sargeras,288,hunter,beastmastery,6,3,3
Wanshöt,tichondrius,288,hunter,beastmastery,6,3,3
Moroallytwo,sargeras,288,hunter,beastmastery,6,3,3
Heãdhunter,area-52,288,hunter,beastmastery,6,3,3
Comtambisuon,frostmourne,288,hunter,beastmastery,6,3,3
Nexxa,muradin,288,hunter,beastmastery,6,3,3
Siimmplicitz,area-52,288,hunter,beastmastery,6,3,3
Barrohunt,tichondrius,288,hunter,beastmastery,6,3,3
Grayføxx,twisting-nether,288,hunter,beastmastery,6,3,3
Legendshot,area-52,288,hunter,beastmastery,6,3,3
Hahahahahaha,frostmourne,288,hunter,beastmastery,6,3,3
Toxicbowjobs,tichondrius,288,hunter,beastmastery,6,3,3
Rolandschitt,area-52,288,hunter,beastmastery,6,3,3
Shallwe,frostmourne,288,hunter,beastmastery,6,3,3
Hordworld,tichondrius,288,hunter,beastmastery,6,3,3
Wrectitralph,sargeras,288,hunter,beastmastery,6,3,3
Shootin,frostmourne,288,hunter,beastmastery,6,3,3
Miraclez,nerzhul,288,hunter,beastmastery,6,3,3
Zeroday,emerald-dream,288,hunter,beastmastery,6,3,3
Atlacatl,tichondrius,288,hunter,beastmastery,6,3,3
Santiiadonai,quelthalas,288,hunter,beastmastery,6,3,3
Naksha,area-52,288,hunter,beastmastery,6,3,3
Saucypapi,kiljaeden,288,hunter,beastmastery,6,3,3
Onahai,tichondrius,288,hunter,beastmastery,6,3,3
Mulnaaj,zuljin,288,hunter,beastmastery,6,3,3
Ballistik,area-52,288,hunter,beastmastery,6,3,3
Lyler,tichondrius,288,hunter,beastmastery,6,3,3
Añto,tichondrius,288,hunter,beastmastery,6,3,3
Herroo,thrall,288,hunter,beastmastery,6,3,3
Kahoykeso,frostmourne,288,hunter,beastmastery,6,3,3
Bigun,emerald-dream,288,hunter,beastmastery,13,5,8
Wargodthor,blades-edge,288,hunter,beastmastery,12,3,9
Worewolf,lightninghoof,288,hunter,beastmastery,12,3,9
Boyarsky,area-52,288,hunter,beastmastery,12,3,9
Rice,veknilash,288,hunter,beastmastery,12,3,9
Autismo,garithos,288,hunter,beastmastery,12,3,9
Zhona,moon-guard,288,hunter,beastmastery,12,3,9
Fosberry,sargeras,288,hunter,beastmastery,12,3,9
Dieplox,thunderhorn,288,hunter,beastmastery,12,3,9
Inurah,malganis,288,hunter,beastmastery,12,3,9
Rooman,ragnaros,288,hunter,beastmastery,12,3,9
Wave,kelthuzad,288,hunter,beastmastery,12,3,9
Dsizzle,tichondrius,288,hunter,beastmastery,12,3,9
Ryanderanged,wyrmrest-accord,288,hunter,beastmastery,12,3,9
Thunderbúll,tichondrius,288,hunter,beastmastery,12,3,9
Ratbasterrd,darkspear,288,hunter,beastmastery,12,3,9
Zaydenm,sargeras,288,hunter,beastmastery,12,3,9
Icculus,norgannon,288,hunter,beastmastery,12,3,9
Jgalth,chogall,288,hunter,beastmastery,12,3,9
Thiande,zuljin,288,hunter,beastmastery,12,3,9
Mahdy,ragnaros,288,hunter,beastmastery,12,3,9
Legacee,shattered-hand,288,hunter,beastmastery,12,3,9
Leggodex,caelestrasz,288,hunter,beastmastery,12,3,9
Reecerkoz,nagrand,288,hunter,beastmastery,12,3,9
Tanrith,dark-iron,288,hunter,beastmastery,12,3,9
Simyra,moon-guard,288,hunter,beastmastery,12,3,9
Kharthorin,moon-guard,288,hunter,beastmastery,12,3,9
Ruckq,stormrage,288,hunter,beastmastery,12,3,9
Delanooch,rexxar,288,hunter,beastmastery,12,3,9
Spurtzki,emerald-dream,288,hunter,beastmastery,12,3,9
Brewster,burning-legion,288,hunter,beastmastery,12,3,9
Prowd,staghelm,288,hunter,beastmastery,12,3,9
Gunwalk,azjolnerub,288,hunter,beastmastery,12,3,9
Iboofprofen,illidan,288,hunter,beastmastery,12,3,9
Grlzzlyadams,norgannon,288,hunter,beastmastery,12,3,9
Dragon,stormscale,288,hunter,beastmastery,12,3,9
Digsites,emerald-dream,288,hunter,beastmastery,12,3,9
Acturius,jubeithos,288,hunter,beastmastery,12,3,9
Neríne,drakkari,288,hunter,beastmastery,12,3,9
Natnat,sargeras,288,hunter,beastmastery,12,3,9
Yiyixx,tichondrius,288,hunter,beastmastery,18,3,15
Fiercetamer,azuremyst,288,hunter,beastmastery,18,3,15
Kresnik,azralon,288,hunter,beastmastery,18,3,15
Rhaygon,arthas,288,hunter,beastmastery,18,3,15
Bëcäüsë,proudmoore,288,hunter,beastmastery,18,3,15
Mphunter,azralon,288,hunter,beastmastery,24,3,21
Wolftracer,sargeras,287,hunter,beastmastery,6,3,3
Ledan,lightnings-blade,287,hunter,beastmastery,6,3,3
Dagganet,thrall,287,hunter,beastmastery,6,3,3
Euroniimus,ragnaros,287,hunter,beastmastery,6,3,3
Luzyfer,quelthalas,287,hunter,beastmastery,6,3,3
Qwazy,zuljin,287,hunter,beastmastery,6,3,3
Frenchhtoast,sargeras,287,hunter,beastmastery,12,3,9
Snaken,the-forgotten-coast,287,hunter,beastmastery,12,3,9
Broseth,saurfang,287,hunter,beastmastery,12,3,9
Drwu,stormrage,287,hunter,beastmastery,12,3,9
Xereck,emerald-dream,287,hunter,beastmastery,12,3,9
Arin,suramar,287,hunter,beastmastery,12,3,9
Khaldru,drakkari,286,hunter,beastmastery,6,3,3
Shelbyy,tichondrius,286,hunter,beastmastery,16,4,12
Morasongg,area-52,286,hunter,beastmastery,12,3,9
Darkally,blades-edge,285,hunter,beastmastery,18,3,15
Smokiiganja,proudmoore,256,hunter,beastmastery,10,3,7
Starkills,galakrond,256,hunter,beastmastery,10,3,7
Bulszeye,azgalor,255,hunter,beastmastery,8,4,4
Pokeyourbutt,hydraxis,240,hunter,beastmastery,15,3,12
Vicecheney,illidan,239,hunter,beastmastery,5,3,2
Diisdik,tichondrius,239,hunter,beastmastery,5,3,2
Léfty,nagrand,239,hunter,beastmastery,11,3,8
Djcummyfeet,stormrage,234,hunter,beastmastery,17,6,11
Feralcat,nazjatar,208,hunter,beastmastery,13,3,10
Fistbèk,bleeding-hollow,201,hunter,beastmastery,17,5,12
Fancyxo,frostmourne,192,hunter,beastmastery,6,2,4
Flawwless,eredar,192,hunter,beastmastery,6,2,4
Dreadrahl,deathwing,192,hunter,beastmastery,6,2,4
Critaclyzm,moon-guard,192,hunter,beastmastery,6,2,4
Fáelin,proudmoore,192,hunter,beastmastery,6,2,4
Sebastian,blackhand,192,hunter,beastmastery,6,2,4
Csadark,nemesis,192,hunter,beastmastery,6,2,4
Pudgihunt,proudmoore,192,hunter,beastmastery,6,2,4
Chømp,tichondrius,192,hunter,beastmastery,6,2,4
Monstroow,nemesis,192,hunter,beastmastery,6,2,4
Illrannevian,garrosh,192,hunter,beastmastery,6,2,4
Cufless,proudmoore,192,hunter,beastmastery,6,2,4
Lilaeth,khadgar,192,hunter,beastmastery,6,2,4
Strikerfirst,area-52,192,hunter,beastmastery,6,2,4
Neverwipes,frostmourne,192,hunter,beastmastery,6,2,4
Impërïum,zuljin,192,hunter,beastmastery,6,2,4
Juicyfruit,bleeding-hollow,192,hunter,beastmastery,6,2,4
Checkhunter,frostwolf,192,hunter,beastmastery,6,2,4
Jagwaar,malganis,192,hunter,beastmastery,6,2,4
Chaseurnoir,exodar,192,hunter,beastmastery,6,2,4
Powerful,aerie-peak,192,hunter,beastmastery,6,2,4
Twocranes,tichondrius,192,hunter,beastmastery,6,2,4
Gruì,malganis,192,hunter,beastmastery,6,2,4
Elmozz,thrall,192,hunter,beastmastery,6,2,4
Rúdrá,area-52,192,hunter,beastmastery,6,2,4
Johnnybee,demon-soul,192,hunter,beastmastery,6,2,4
Honeyhunt,thrall,192,hunter,beastmastery,6,2,4
Blakespace,area-52,192,hunter,beastmastery,6,2,4
Hectorbuñue,quelthalas,192,hunter,beastmastery,6,2,4
Skillhunter,tichondrius,192,hunter,beastmastery,6,2,4
Bambii,fizzcrank,192,hunter,beastmastery,6,2,4
Shootermgavn,frostmourne,192,hunter,beastmastery,6,2,4
Jojojobo,tichondrius,192,hunter,beastmastery,6,2,4
Nahzah,stormrage,192,hunter,beastmastery,6,2,4
Castíèl,thrall,192,hunter,beastmastery,6,2,4
Hüh,area-52,192,hunter,beastmastery,6,2,4
Hötdôg,kiljaeden,192,hunter,beastmastery,6,2,4
Spoojshot,frostmourne,192,hunter,beastmastery,6,2,4
Hìrcine,nesingwary,192,hunter,beastmastery,6,2,4
Hunata,crushridge,192,hunter,beastmastery,6,2,4
Revengexyz,zuljin,192,hunter,beastmastery,6,2,4
Art,guldan,192,hunter,beastmastery,6,2,4
Nubcaks,nerzhul,192,hunter,beastmastery,6,2,4
Jackrandall,frostmourne,192,hunter,beastmastery,6,2,4
Dreiya,quelthalas,192,hunter,beastmastery,6,2,4
Warplaquee,zuljin,192,hunter,beastmastery,6,2,4
Ikiteforfood,zuljin,192,hunter,beastmastery,6,2,4
Slanderous,korgath,192,hunter,beastmastery,6,2,4
Greasyboi,tichondrius,192,hunter,beastmastery,6,2,4
Resonatorrob,illidan,192,hunter,beastmastery,6,2,4
ßoo,darkspear,192,hunter,beastmastery,6,2,4
Nevon,azralon,192,hunter,beastmastery,6,2,4
Bluntcrushed,area-52,192,hunter,beastmastery,6,2,4
Mojito,frostmourne,192,hunter,beastmastery,6,2,4
Fjdominador,azralon,192,hunter,beastmastery,6,2,4
Sukr,korgath,192,hunter,beastmastery,6,2,4
Xeneye,tichondrius,192,hunter,beastmastery,6,2,4
Harrowin,area-52,192,hunter,beastmastery,6,2,4
Camfeed,illidan,192,hunter,beastmastery,6,2,4
Swettx,bleeding-hollow,192,hunter,beastmastery,6,2,4
Monffbc,tichondrius,192,hunter,beastmastery,6,2,4
Zarknoth,cenarius,192,hunter,beastmastery,6,2,4
Rämbow,frostmourne,192,hunter,beastmastery,6,2,4
Autoshotxprt,frostmourne,192,hunter,beastmastery,6,2,4
Dradran,kelthuzad,192,hunter,beastmastery,6,2,4
Estilingada,azralon,192,hunter,beastmastery,6,2,4
Forsaken,bleeding-hollow,192,hunter,beastmastery,6,2,4
Shådé,stormrage,192,hunter,beastmastery,6,2,4
Farva,tanaris,192,hunter,beastmastery,6,2,4
Ellishunter,frostmourne,192,hunter,beastmastery,6,2,4
Ussy,area-52,192,hunter,beastmastery,6,2,4
Titzyø,area-52,192,hunter,beastmastery,6,2,4
Islapuwitaro,azjolnerub,192,hunter,beastmastery,6,2,4
Slimezy,tichondrius,192,hunter,beastmastery,6,2,4
Wayer,tichondrius,192,hunter,beastmastery,6,2,4
Wooftoof,frostmourne,192,hunter,beastmastery,6,2,4
Rostter,azralon,192,hunter,beastmastery,6,2,4
Momodasi,illidan,192,hunter,beastmastery,6,2,4
Bloodstark,dreadmaul,192,hunter,beastmastery,6,2,4
Fova,wyrmrest-accord,192,hunter,beastmastery,6,2,4
Kudzue,illidan,192,hunter,beastmastery,6,2,4
Zellor,wyrmrest-accord,192,hunter,beastmastery,6,2,4
Søapbubble,tichondrius,192,hunter,beastmastery,6,2,4
Klepty,stormrage,192,hunter,beastmastery,6,2,4
Caligar,tichondrius,192,hunter,beastmastery,6,2,4
Halaruka,area-52,192,hunter,beastmastery,6,2,4
Blickymon,wyrmrest-accord,192,hunter,beastmastery,6,2,4
Iapsux,bleeding-hollow,192,hunter,beastmastery,6,2,4
Singer,lothar,192,hunter,beastmastery,6,2,4
Sogékíng,illidan,192,hunter,beastmastery,6,2,4
Boquiinha,stormrage,192,hunter,beastmastery,6,2,4
Totolol,trollbane,192,hunter,beastmastery,6,2,4
Vanpeltz,illidan,192,hunter,beastmastery,6,2,4
Shootr,darkspear,192,hunter,beastmastery,6,2,4
Varianhunter,kelthuzad,192,hunter,beastmastery,6,2,4
Jbahh,hyjal,192,hunter,beastmastery,6,2,4
Shrapnelx,ragnaros,192,hunter,beastmastery,6,2,4
Öops,hyjal,192,hunter,beastmastery,6,2,4
Expskippy,darkspear,192,hunter,beastmastery,6,2,4
Garble,darkspear,192,hunter,beastmastery,6,2,4
Crawl,auchindoun,192,hunter,beastmastery,6,2,4
Barrelsofrum,illidan,192,hunter,beastmastery,6,2,4
Obsol,hyjal,192,hunter,beastmastery,6,2,4
Skolzero,azralon,192,hunter,beastmastery,6,2,4
Magvez,tichondrius,192,hunter,beastmastery,6,2,4
Bernice,darrowmere,192,hunter,beastmastery,6,2,4
Quintonius,stormrage,192,hunter,beastmastery,6,2,4
Moonraven,laughing-skull,192,hunter,beastmastery,6,2,4
Gohan,jubeithos,192,hunter,beastmastery,6,2,4
Nfo,lightbringer,192,hunter,beastmastery,6,2,4
Nenenhunt,ragnaros,192,hunter,beastmastery,6,2,4
Taintz,altar-of-storms,192,hunter,beastmastery,6,2,4
Etarie,malganis,192,hunter,beastmastery,6,2,4
Sahjana,lothar,192,hunter,beastmastery,6,2,4
Menaceqq,stormrage,192,hunter,beastmastery,6,2,4
Dnicee,stormrage,192,hunter,beastmastery,6,2,4
Tichong,tichondrius,192,hunter,beastmastery,6,2,4
Sylvãnâs,tichondrius,192,hunter,beastmastery,6,2,4
Vyndiln,tichondrius,192,hunter,beastmastery,6,2,4
Presleyjane,tichondrius,192,hunter,beastmastery,6,2,4
Krissiz,drakkari,192,hunter,beastmastery,6,2,4
Munrrack,ragnaros,192,hunter,beastmastery,6,2,4
Kaptincrunch,skywall,192,hunter,beastmastery,6,2,4
Survbot,malganis,192,hunter,beastmastery,6,2,4
Saveawp,stormrage,192,hunter,beastmastery,6,2,4
Royshot,stormrage,192,hunter,beastmastery,6,2,4
Sativ,moknathal,192,hunter,beastmastery,6,2,4
Verzoz,illidan,192,hunter,beastmastery,6,2,4
Frìtz,barthilas,192,hunter,beastmastery,6,2,4
Greyk,moon-guard,192,hunter,beastmastery,6,2,4
Diacachimbaa,ragnaros,192,hunter,beastmastery,6,2,4
Phife,emerald-dream,192,hunter,beastmastery,6,2,4
Madsniper,thunderlord,192,hunter,beastmastery,6,2,4
Quinnshot,tichondrius,192,hunter,beastmastery,6,2,4
Slobon,tichondrius,192,hunter,beastmastery,6,2,4
Purpreynolds,tichondrius,192,hunter,beastmastery,6,2,4
Rsttlegore,stormscale,192,hunter,beastmastery,6,2,4
Nanotorque,moon-guard,192,hunter,beastmastery,6,2,4
Nixuis,stormrage,192,hunter,beastmastery,6,2,4
Elivivia,tichondrius,192,hunter,beastmastery,6,2,4
Hitstickk,tichondrius,192,hunter,beastmastery,6,2,4
Ivanjackenov,illidan,192,hunter,beastmastery,6,2,4
Spicycheezit,malganis,192,hunter,beastmastery,6,2,4
Berrydanish,tichondrius,192,hunter,beastmastery,6,2,4
Viracha,stormrage,192,hunter,beastmastery,6,2,4
Antwonziezz,tichondrius,192,hunter,beastmastery,6,2,4
Newcomb,tichondrius,192,hunter,beastmastery,6,2,4
Jämmëdclïp,emerald-dream,192,hunter,beastmastery,6,2,4
Zoopdapoop,dalaran,192,hunter,beastmastery,6,2,4
Hedshot,kelthuzad,192,hunter,beastmastery,6,2,4
Solderboi,tichondrius,192,hunter,beastmastery,6,2,4
Pfheign,area-52,192,hunter,beastmastery,6,2,4
Mennis,archimonde,192,hunter,beastmastery,6,2,4
Thazen,sargeras,192,hunter,beastmastery,6,2,4
Ganderion,sargeras,192,hunter,beastmastery,6,2,4
Averely,skywall,192,hunter,beastmastery,6,2,4
Bombashotz,sargeras,192,hunter,beastmastery,6,2,4
Luiiguii,quelthalas,192,hunter,beastmastery,6,2,4
Izanägi,sargeras,192,hunter,beastmastery,6,2,4
Aaggros,sargeras,192,hunter,beastmastery,6,2,4
Romro,norgannon,192,hunter,beastmastery,6,2,4
Equalizér,sargeras,192,hunter,beastmastery,6,2,4
Notoffended,sargeras,192,hunter,beastmastery,6,2,4
Budget,emerald-dream,192,hunter,beastmastery,6,2,4
Zeenuts,sargeras,192,hunter,beastmastery,6,2,4
Letsmakebaby,sargeras,192,hunter,beastmastery,6,2,4
Kzxh,illidan,192,hunter,beastmastery,6,2,4
Dynith,sargeras,192,hunter,beastmastery,6,2,4
Kekorator,illidan,192,hunter,beastmastery,11,3,8
Seratoninx,malganis,192,hunter,beastmastery,9,2,7
Gunnpowder,malganis,192,hunter,beastmastery,12,2,10
Mygun,deathwing,192,hunter,beastmastery,12,2,10
Alexañdra,proudmoore,192,hunter,beastmastery,12,2,10
Tánsøxøxø,tichondrius,192,hunter,beastmastery,12,2,10
Thundis,hellscream,192,hunter,beastmastery,12,2,10
Meetdmonster,illidan,192,hunter,beastmastery,12,2,10
Arrowzpeckt,tichondrius,192,hunter,beastmastery,12,2,10
Carloslaun,drakkari,192,hunter,beastmastery,12,2,10
Miannmar,proudmoore,192,hunter,beastmastery,12,2,10
Hughboner,illidan,192,hunter,beastmastery,12,2,10
Pakale,amanthul,192,hunter,beastmastery,12,2,10
Khabul,area-52,192,hunter,beastmastery,12,2,10
Ãmi,moon-guard,192,hunter,beastmastery,12,2,10
Thyladaern,kiljaeden,192,hunter,beastmastery,12,2,10
Bjj,eonar,192,hunter,beastmastery,12,2,10
Tjota,azralon,192,hunter,beastmastery,12,2,10
Ahmunra,zuljin,192,hunter,beastmastery,12,2,10
Floozy,frostmane,192,hunter,beastmastery,12,2,10
Aeriladin,moon-guard,192,hunter,beastmastery,12,2,10
Sojun,jaedenar,192,hunter,beastmastery,14,2,12
Moapax,azralon,191,hunter,beastmastery,6,2,4
Tuvasa,blood-furnace,191,hunter,beastmastery,6,2,4
Recebaa,barthilas,191,hunter,beastmastery,6,2,4
Aiilton,gallywix,191,hunter,beastmastery,6,2,4
Ninoryzen,illidan,191,hunter,beastmastery,6,2,4
Stoneforged,ragnaros,191,hunter,beastmastery,6,2,4
Kolarius,emerald-dream,191,hunter,beastmastery,6,2,4
Kangarang,khazgoroth,191,hunter,beastmastery,12,2,10
Enrage,queldorei,191,hunter,beastmastery,12,2,10
Maximum,tichondrius,159,hunter,beastmastery,5,2,3
Helikaon,deathwing,159,hunter,beastmastery,5,2,3
Skrìms,tichondrius,159,hunter,beastmastery,5,2,3
Stèlla,frostmourne,159,hunter,beastmastery,5,2,3
Twentyyfour,akama,144,hunter,beastmastery,3,3,0
Piess,thrall,144,hunter,beastmastery,9,2,7
Luckione,destromath,144,hunter,beastmastery,9,2,7
Bountybud,kiljaeden,138,hunter,beastmastery,10,3,7
Arrawn,illidan,128,hunter,beastmastery,4,2,2
Beastmastr,garrosh,128,hunter,beastmastery,4,2,2
Piñg,tichondrius,128,hunter,beastmastery,4,2,2
Josharoni,sargeras,127,hunter,beastmastery,8,2,6
Laviè,tichondrius,112,hunter,beastmastery,4,3,1
Odratnuh,bleeding-hollow,96,hunter,beastmastery,6,1,5
Bertiebott,zuljin,96,hunter,beastmastery,6,1,5
Ferrettss,bleeding-hollow,96,hunter,beastmastery,6,1,5
Singletap,barthilas,96,hunter,beastmastery,6,1,5
Carot,dalaran,96,hunter,beastmastery,6,1,5
Jiawoweixin,illidan,96,hunter,beastmastery,6,1,5
Henhøuse,illidan,96,hunter,beastmastery,6,1,5
Jootuber,barthilas,96,hunter,beastmastery,6,1,5
Varag,amanthul,96,hunter,beastmastery,6,1,5
Boido,ghostlands,96,hunter,beastmastery,6,1,5
Oldmandave,stormrage,96,hunter,beastmastery,6,1,5
Sõulhunter,frostmourne,96,hunter,beastmastery,6,1,5
Tybierious,illidan,96,hunter,beastmastery,6,1,5
Jabbar,bleeding-hollow,96,hunter,beastmastery,6,1,5
Chîll,frostmourne,96,hunter,beastmastery,6,1,5
Shoccka,thrall,96,hunter,beastmastery,6,1,5
Shadeckz,stormrage,96,hunter,beastmastery,6,1,5
Muckenfoose,frostmourne,96,hunter,beastmastery,6,1,5
Ilîiìîìiilil,bleeding-hollow,96,hunter,beastmastery,6,1,5
Laer,archimonde,96,hunter,beastmastery,6,1,5
Wamion,zuljin,96,hunter,beastmastery,6,1,5
Bellaphonte,stormrage,96,hunter,beastmastery,6,1,5
Bosshunt,whisperwind,96,hunter,beastmastery,6,1,5
Physical,destromath,96,hunter,beastmastery,6,1,5
Nachtcloverr,stormrage,96,hunter,beastmastery,6,1,5
Remak,barthilas,96,hunter,beastmastery,6,1,5
Abundalacaca,sargeras,96,hunter,beastmastery,6,1,5
Nearsightedd,area-52,96,hunter,beastmastery,6,1,5
Beefcow,barthilas,96,hunter,beastmastery,6,1,5
Slipperyqt,frostmourne,96,hunter,beastmastery,6,1,5
Appä,lightnings-blade,96,hunter,beastmastery,6,1,5
Roseandra,stormrage,96,hunter,beastmastery,6,1,5
Blåckhat,frostmourne,96,hunter,beastmastery,6,1,5
Allgasnocap,kelthuzad,96,hunter,beastmastery,6,1,5
Fadingtrapz,jubeithos,96,hunter,beastmastery,6,1,5
Arthanyz,quelthalas,96,hunter,beastmastery,6,1,5
Bithiáh,quelthalas,96,hunter,beastmastery,6,1,5
Taumelz,sargeras,96,hunter,beastmastery,6,1,5
Hieke,nemesis,96,hunter,beastmastery,6,1,5
Marksmanpain,malganis,96,hunter,beastmastery,6,1,5
Justin,agamaggan,96,hunter,beastmastery,6,1,5
Warpedshots,malganis,96,hunter,beastmastery,6,1,5
Matahunt,blackwing-lair,96,hunter,beastmastery,6,1,5
Fourkayiv,azgalor,96,hunter,beastmastery,6,1,5
Locket,maelstrom,96,hunter,beastmastery,6,1,5
Trolljinyou,thrall,96,hunter,beastmastery,6,1,5
Opsi,ragnaros,96,hunter,beastmastery,6,1,5
Richihunt,ragnaros,96,hunter,beastmastery,6,1,5
Jägermeistër,twisting-nether,96,hunter,beastmastery,6,1,5
Naariko,aggramar,96,hunter,beastmastery,6,1,5
Birggitte,the-venture-co,96,hunter,beastmastery,6,1,5
Cynasia,maelstrom,96,hunter,beastmastery,6,1,5
Predatðr,frostmourne,96,hunter,beastmastery,6,1,5
Xcopel,azralon,96,hunter,beastmastery,6,1,5
Xclaw,llane,96,hunter,beastmastery,6,1,5
Sobala,azralon,96,hunter,beastmastery,6,1,5
Cocobread,stormreaver,96,hunter,beastmastery,6,1,5
Wixyy,aegwynn,96,hunter,beastmastery,6,1,5
Dusle,azralon,96,hunter,beastmastery,6,1,5
Brokenfoot,bonechewer,96,hunter,beastmastery,6,1,5
Bigpie,daggerspine,96,hunter,beastmastery,6,1,5
Grullandàr,hakkar,96,hunter,beastmastery,6,1,5
Brody,eitrigg,96,hunter,beastmastery,6,1,5
Panm,runetotem,96,hunter,beastmastery,6,1,5
Taurenseason,sargeras,96,hunter,beastmastery,6,1,5
Alsomike,tichondrius,96,hunter,beastmastery,6,1,5
Analtraps,tichondrius,96,hunter,beastmastery,6,1,5
Teddyboy,proudmoore,96,hunter,beastmastery,6,1,5
Audiofly,tichondrius,96,hunter,beastmastery,6,1,5
Slideby,tichondrius,96,hunter,beastmastery,6,1,5
Rexxiga,kiljaeden,96,hunter,beastmastery,6,1,5
Slimetime,tichondrius,96,hunter,beastmastery,6,1,5
Deletedyou,tichondrius,96,hunter,beastmastery,6,1,5
Derekscrow,tichondrius,96,hunter,beastmastery,6,1,5
Espaada,tichondrius,96,hunter,beastmastery,6,1,5
Sóggybóxers,tichondrius,96,hunter,beastmastery,6,1,5
Murk,spirestone,96,hunter,beastmastery,6,1,5
Globlauncher,tichondrius,96,hunter,beastmastery,6,1,5
Mtuanwm,tichondrius,96,hunter,beastmastery,6,1,5
Percival,firetree,96,hunter,beastmastery,6,1,5
Ballinpotato,tichondrius,96,hunter,beastmastery,6,1,5
Huntardness,moon-guard,96,hunter,beastmastery,6,1,5
Tiirra,sargeras,96,hunter,beastmastery,6,1,5
Båttousai,kiljaeden,96,hunter,beastmastery,6,1,5
Robious,tichondrius,96,hunter,beastmastery,6,1,5
Darkhunterr,tichondrius,96,hunter,beastmastery,6,1,5
Jarless,hydraxis,96,hunter,beastmastery,6,1,5
Ophois,lightbringer,96,hunter,beastmastery,6,1,5
Gulan,draka,96,hunter,beastmastery,6,1,5
Pampas,darkspear,96,hunter,beastmastery,6,1,5
Uncann,boulderfist,96,hunter,beastmastery,6,1,5
Penelòpe,wyrmrest-accord,96,hunter,beastmastery,6,1,5
Bendotexe,stormrage,96,hunter,beastmastery,7,1,6
Colchagua,quelthalas,96,hunter,beastmastery,8,1,7
Nakar,darkspear,96,hunter,beastmastery,10,1,9
Ferdphin,dalaran,96,hunter,beastmastery,12,1,11
Tinsho,drakkari,96,hunter,beastmastery,12,1,11
Tstormzz,stormrage,96,hunter,beastmastery,12,1,11
Blackstaur,illidan,96,hunter,beastmastery,12,1,11
Rekows,stormrage,96,hunter,beastmastery,12,1,11
Lorishblood,blackrock,96,hunter,beastmastery,12,1,11
Divineseraph,dentarg,96,hunter,beastmastery,12,1,11
Bee,shattered-halls,96,hunter,beastmastery,12,1,11
Sylvanãs,ragnaros,96,hunter,beastmastery,12,1,11
Twistedx,tichondrius,96,hunter,beastmastery,12,1,11
Ñordombra,quelthalas,96,hunter,beastmastery,12,1,11
Tydee,nagrand,96,hunter,beastmastery,12,1,11
Caletten,destromath,96,hunter,beastmastery,12,1,11
Baehydra,frostmourne,96,hunter,beastmastery,12,1,11
Newdanni,barthilas,95,hunter,beastmastery,18,1,17
Ssobit,tichondrius,79,hunter,beastmastery,5,1,4
Kölhberg,azralon,64,hunter,beastmastery,10,1,9
Aceventurapð,area-52,48,hunter,beastmastery,3,1,2
Yory,tol-barad,48,hunter,beastmastery,3,1,2
Wonshawt,tichondrius,48,hunter,beastmastery,3,1,2
Dwrhunt,ragnaros,48,hunter,beastmastery,3,1,2
Jumeog,stormscale,42,hunter,beastmastery,7,2,5
Bowjoblul,stormrage,42,hunter,beastmastery,9,2,7
Timesteal,tichondrius,31,hunter,beastmastery,2,1,1
Gasslight,area-52,31,hunter,beastmastery,2,1,1
Voladren,moon-guard,31,hunter,beastmastery,2,1,1
Dirkberkeley,moon-guard,16,hunter,beastmastery,1,1,0
Juicemage,tichondrius,2243,mage,arcane,107,58,49
Numbing,sargeras,2233,mage,arcane,100,54,46
Cvark,sargeras,2223,mage,arcane,88,51,37
Ktp,tichondrius,2208,mage,arcane,95,59,36
Oneschool,sargeras,2174,mage,arcane,78,45,33
Venruki,tichondrius,2137,mage,arcane,78,44,34
Junglejape,tichondrius,1967,mage,arcane,54,35,19
Arcanemagek,tichondrius,1907,mage,arcane,48,32,16
Whiterice,zuljin,1879,mage,arcane,50,31,19
Birdfather,tichondrius,1861,mage,arcane,48,33,15
Elfmage,tichondrius,1855,mage,arcane,36,25,11
Hocusjokus,frostmourne,1851,mage,arcane,47,31,16
Snortmeth,area-52,1841,mage,arcane,90,58,32
Bíscuít,illidan,1836,mage,arcane,145,78,67
Delibro,tichondrius,1834,mage,arcane,94,52,42
Spellstéal,tichondrius,1828,mage,arcane,41,25,16
Vampìrelolz,tichondrius,1809,mage,arcane,48,26,22
Ezchallenger,undermine,1782,mage,arcane,102,47,55
Bambambilly,kelthuzad,1777,mage,arcane,156,79,77
Sestren,zuljin,1774,mage,arcane,103,51,52
Edgkey,illidan,1771,mage,arcane,103,54,49
Shwaysted,burning-blade,1766,mage,arcane,60,35,25
Mokelovin,sargeras,1763,mage,arcane,65,33,32
Esien,tichondrius,1758,mage,arcane,126,61,65
Arçanemage,tichondrius,1745,mage,arcane,42,20,22
Aosin,wyrmrest-accord,1738,mage,arcane,42,30,12
Rhythmdog,tichondrius,1738,mage,arcane,87,45,42
Maegwynah,jaedenar,1726,mage,arcane,52,27,25
Tbkz,amanthul,1725,mage,arcane,54,25,29
Bananappeal,kelthuzad,1717,mage,arcane,52,26,26
Lmaginedying,illidan,1715,mage,arcane,30,24,6
Dawitchery,illidan,1712,mage,arcane,52,23,29
Magnesiium,illidan,1711,mage,arcane,48,28,20
Zps,illidan,1706,mage,arcane,72,40,32
Badboykilla,dentarg,1704,mage,arcane,39,33,6
Melkdud,wyrmrest-accord,1703,mage,arcane,30,18,12
Mageboy,bonechewer,1699,mage,arcane,67,33,34
Unguided,moon-guard,1696,mage,arcane,36,21,15
Arianark,sargeras,1679,mage,arcane,105,62,43
Spart,runetotem,1676,mage,arcane,45,20,25
Clutchy,gorefiend,1672,mage,arcane,42,29,13
Nyj,tichondrius,1668,mage,arcane,65,36,29
Zhanna,nazjatar,1668,mage,arcane,152,80,72
Ilovejwoanna,kiljaeden,1665,mage,arcane,48,26,22
Exterminatüs,tichondrius,1653,mage,arcane,87,44,43
Höövalt,illidan,1641,mage,arcane,30,20,10
Spitemage,tichondrius,1638,mage,arcane,109,52,57
Hallat,archimonde,1631,mage,arcane,389,188,201
Spellsteål,malganis,1627,mage,arcane,53,31,22
Magecombe,thrall,1617,mage,arcane,30,17,13
Dbox,stormscale,1615,mage,arcane,93,53,40
Dmgperseç,tichondrius,1612,mage,arcane,30,20,10
Proximalol,tichondrius,1610,mage,arcane,36,20,16
Snoogma,illidan,1609,mage,arcane,42,20,22
Ject,ragnaros,1606,mage,arcane,155,84,71
Wïzarduous,mannoroth,1605,mage,arcane,60,33,27
Hööva,illidan,1604,mage,arcane,30,17,13
Primearcanis,tol-barad,1601,mage,arcane,48,22,26
Höövaltx,illidan,1600,mage,arcane,36,19,17
Failedwizard,frostmourne,1600,mage,arcane,58,25,33
Sky,lightnings-blade,1599,mage,arcane,119,64,55
Felsparkles,area-52,1589,mage,arcane,54,30,24
Mairgik,proudmoore,1589,mage,arcane,36,19,17
Waisted,kelthuzad,1573,mage,arcane,45,25,20
Xialing,tichondrius,1570,mage,arcane,63,32,31
Tbh,malganis,1555,mage,arcane,62,29,33
Lucidaze,daggerspine,1551,mage,arcane,184,93,91
Balencii,kiljaeden,1548,mage,arcane,36,20,16
Clernlol,emerald-dream,1548,mage,arcane,60,27,33
Étel,nemesis,1539,mage,arcane,39,19,20
Enthy,frostmourne,1529,mage,arcane,36,18,18
Alode,moon-guard,1526,mage,arcane,60,36,24
Prosperoh,burning-legion,1526,mage,arcane,48,25,23
Agoniey,illidan,1525,mage,arcane,138,69,69
Vênsêr,emerald-dream,1523,mage,arcane,36,17,19
Cyphen,proudmoore,1500,mage,arcane,30,16,14
Toknsmoke,tichondrius,1497,mage,arcane,41,23,18
Perrc,area-52,1488,mage,arcane,180,89,91
Beerbelly,tichondrius,1486,mage,arcane,77,45,32
Hustle,frostmourne,1483,mage,arcane,102,53,49
Mävra,emerald-dream,1482,mage,arcane,30,18,12
Thewizârd,stormrage,1480,mage,arcane,334,181,153
Maplemage,akama,1480,mage,arcane,183,96,87
Hennimage,sargeras,1468,mage,arcane,241,132,109
Missile,frostmourne,1454,mage,arcane,36,17,19
Hoçuspoçus,moon-guard,1448,mage,arcane,89,43,46
Swàn,stormrage,1444,mage,arcane,42,23,19
Ligmmah,stormrage,1440,mage,arcane,69,39,30
Caseyjelly,tichondrius,1436,mage,arcane,36,20,16
Sáron,quelthalas,1431,mage,arcane,78,41,37
Parapio,tichondrius,1426,mage,arcane,38,20,18
Wretchy,ragnaros,1412,mage,arcane,67,34,33
Allýria,stormrage,1395,mage,arcane,42,18,24
Söngs,goldrinn,1387,mage,arcane,24,15,9
Frozonnee,aggramar,1379,mage,arcane,24,15,9
Wizzyx,illidan,1373,mage,arcane,40,21,19
Castarcane,nordrassil,1370,mage,arcane,36,17,19
Pufs,stormrage,1369,mage,arcane,41,20,21
Kickpollyplx,lothar,1368,mage,arcane,71,45,26
Lünå,onyxia,1366,mage,arcane,60,35,25
Avandal,proudmoore,1362,mage,arcane,71,29,42
Raazzamage,moon-guard,1360,mage,arcane,81,44,37
Somariais,illidan,1355,mage,arcane,90,43,47
Astrojrue,sargeras,1353,mage,arcane,41,21,20
Melkra,tichondrius,1348,mage,arcane,66,36,30
Xtymhxy,tichondrius,1343,mage,arcane,18,14,4
Szrp,stormrage,1336,mage,arcane,57,27,30
Blaxmagic,stormrage,1333,mage,arcane,78,34,44
Måndias,tichondrius,1328,mage,arcane,34,18,16
Themagicman,whisperwind,1324,mage,arcane,42,17,25
Zayth,silvermoon,1315,mage,arcane,45,24,21
Coôler,illidan,1313,mage,arcane,39,16,23
Zukoprince,azralon,1312,mage,arcane,24,14,10
Linkolni,azralon,1312,mage,arcane,111,59,52
Ruzam,area-52,1303,mage,arcane,186,91,95
Draell,drakkari,1301,mage,arcane,54,30,24
Véyda,emerald-dream,1300,mage,arcane,60,30,30
Airbnb,area-52,1299,mage,arcane,46,26,20
Valrendor,nazjatar,1298,mage,arcane,96,54,42
Gin,nemesis,1296,mage,arcane,48,24,24
Chezzmasterx,misha,1289,mage,arcane,69,34,35
Gryd,area-52,1283,mage,arcane,112,62,50
Chelseâ,emerald-dream,1281,mage,arcane,59,28,31
Zulugara,barthilas,1277,mage,arcane,40,18,22
Fruitdealerr,tichondrius,1266,mage,arcane,54,29,25
Jedamere,proudmoore,1260,mage,arcane,48,23,25
Oharvestero,illidan,1258,mage,arcane,55,27,28
Strêss,kelthuzad,1255,mage,arcane,123,60,63
Antifreezex,tichondrius,1253,mage,arcane,76,43,33
Sorankim,tichondrius,1248,mage,arcane,24,13,11
Nightsaber,blackrock,1247,mage,arcane,18,13,5
Gessin,area-52,1245,mage,arcane,100,50,50
Velvetlurker,sargeras,1243,mage,arcane,30,13,17
Unlike,sargeras,1235,mage,arcane,71,29,42
Edisia,moon-guard,1231,mage,arcane,24,13,11
Magicos,frostmourne,1229,mage,arcane,24,13,11
Myrondor,tichondrius,1227,mage,arcane,24,13,11
Smoks,stormrage,1223,mage,arcane,50,25,25
Nedrin,nemesis,1216,mage,arcane,96,46,50
Kevymarts,tichondrius,1210,mage,arcane,36,14,22
Cokézero,frostmourne,1200,mage,arcane,55,30,25
Skywalkerino,azralon,1194,mage,arcane,151,76,75
Dereliction,nagrand,1185,mage,arcane,102,52,50
Softbody,barthilas,1179,mage,arcane,86,40,46
Freehoñgkong,tichondrius,1177,mage,arcane,42,20,22
Privilege,dragonmaw,1174,mage,arcane,41,20,21
Greenwise,illidan,1170,mage,arcane,54,28,26
Yonzho,area-52,1160,mage,arcane,20,13,7
Fearhades,drakkari,1159,mage,arcane,24,13,11
Sceledrus,quelthalas,1158,mage,arcane,42,21,21
Nekrobear,nemesis,1150,mage,arcane,36,16,20
Frozorfs,tichondrius,1141,mage,arcane,36,14,22
Wasami,tichondrius,1140,mage,arcane,24,12,12
Buffmages,malfurion,1135,mage,arcane,18,12,6
Firehawk,azralon,1133,mage,arcane,24,15,9
Billzeye,dalaran,1128,mage,arcane,24,12,12
Numaïr,kiljaeden,1128,mage,arcane,30,14,16
Nunezz,mannoroth,1123,mage,arcane,54,27,27
Badwoman,tichondrius,1111,mage,arcane,36,13,23
Kaiokenxten,bleeding-hollow,1102,mage,arcane,29,12,17
Celciius,stormrage,1098,mage,arcane,56,18,38
Oyagi,moon-guard,1097,mage,arcane,89,42,47
Klausgc,sargeras,1084,mage,arcane,20,12,8
Overratedxd,moon-guard,1084,mage,arcane,24,12,12
Xakura,dragonmaw,1084,mage,arcane,29,14,15
Chëryl,proudmoore,1061,mage,arcane,240,111,129
Randalf,dragonmaw,1056,mage,arcane,24,15,9
Flaux,sargeras,1055,mage,arcane,18,11,7
Tommagic,tichondrius,1055,mage,arcane,30,11,19
Glaciated,the-forgotten-coast,1053,mage,arcane,24,11,13
Shmage,dragonmaw,1050,mage,arcane,24,11,13
Oogleymoogly,zuljin,1040,mage,arcane,24,11,13
Cassanara,moon-guard,1032,mage,arcane,36,13,23
Thetodd,emerald-dream,1017,mage,arcane,24,16,8
Kittikk,tichondrius,1005,mage,arcane,119,53,66
Maiddan,azralon,1000,mage,arcane,26,12,14
Döömsage,hydraxis,999,mage,arcane,23,11,12
Kyrumage,illidan,998,mage,arcane,34,15,19
Knotyouagain,emerald-dream,996,mage,arcane,54,31,23
Casarenarrus,staghelm,985,mage,arcane,24,13,11
Raeign,frostmourne,972,mage,arcane,141,67,74
Mixler,feathermoon,970,mage,arcane,65,32,33
Windwìtch,quelthalas,960,mage,arcane,18,10,8
Jazzgroyper,sargeras,960,mage,arcane,24,10,14
Lightsoran,tichondrius,960,mage,arcane,24,10,14
Gachaguy,bleeding-hollow,960,mage,arcane,30,10,20
Buyßitcoin,sargeras,959,mage,arcane,18,10,8
Icydubya,illidan,958,mage,arcane,12,10,2
Zerathremar,proudmoore,958,mage,arcane,18,10,8
Alùcârd,tichondrius,958,mage,arcane,18,10,8
Eruilúvatar,nerzhul,956,mage,arcane,30,17,13
Haze,hyjal,955,mage,arcane,18,10,8
Firèballin,tichondrius,955,mage,arcane,24,10,14
Tagere,moon-guard,954,mage,arcane,24,10,14
Orderlight,alexstrasza,954,mage,arcane,24,10,14
Gusmaged,stormrage,953,mage,arcane,16,11,5
Wizfajita,malganis,951,mage,arcane,24,10,14
Tessar,moon-guard,951,mage,arcane,24,10,14
Sksteve,rexxar,948,mage,arcane,30,10,20
Wøogles,sargeras,946,mage,arcane,24,10,14
Harmful,frostmourne,944,mage,arcane,21,10,11
Morkleen,korgath,943,mage,arcane,30,10,20
Shadows,exodar,934,mage,arcane,24,10,14
Mahe,andorhal,928,mage,arcane,56,20,36
Akagamix,sargeras,924,mage,arcane,36,17,19
Dietdeww,borean-tundra,913,mage,arcane,18,10,8
Khierlana,hellscream,910,mage,arcane,90,38,52
Tsarevich,fizzcrank,907,mage,arcane,72,29,43
Mastablastar,windrunner,899,mage,arcane,23,10,13
Baskal,area-52,886,mage,arcane,28,10,18
Littlefun,tichondrius,878,mage,arcane,11,10,1
Søkø,tichondrius,868,mage,arcane,30,11,19
Viôlentj,area-52,863,mage,arcane,12,9,3
Arcalìte,illidan,863,mage,arcane,15,10,5
Pandazed,proudmoore,863,mage,arcane,18,9,9
Harshx,bleeding-hollow,863,mage,arcane,18,9,9
Moond,drakkari,858,mage,arcane,18,9,9
Mageyoulooks,kelthuzad,856,mage,arcane,24,9,15
Magicå,area-52,845,mage,arcane,12,9,3
Waef,quelthalas,838,mage,arcane,18,9,9
Instataterz,eonar,833,mage,arcane,29,9,20
Sherian,queldorei,832,mage,arcane,18,9,9
Jackson,altar-of-storms,809,mage,arcane,60,17,43
Fredcouples,tichondrius,803,mage,arcane,19,10,9
Kirayu,gilneas,798,mage,arcane,16,9,7
Unmix,tichondrius,794,mage,arcane,20,9,11
Lewpithy,area-52,768,mage,arcane,12,8,4
Cinnamon,boulderfist,768,mage,arcane,12,8,4
Eludin,aegwynn,768,mage,arcane,18,8,10
Hynzie,barthilas,768,mage,arcane,18,8,10
Jööz,deathwing,768,mage,arcane,18,8,10
Arcanatos,emerald-dream,767,mage,arcane,12,8,4
Crøwgawd,tichondrius,767,mage,arcane,12,8,4
Watchmepog,tichondrius,767,mage,arcane,12,8,4
Azeroth,boulderfist,767,mage,arcane,13,8,5
Fakebusiness,area-52,767,mage,arcane,18,8,10
Fasttwitch,kiljaeden,767,mage,arcane,24,8,16
Delana,darkspear,766,mage,arcane,24,8,16
Boredmoomoo,thunderlord,765,mage,arcane,12,8,4
Gimani,tichondrius,765,mage,arcane,18,8,10
Archtype,azralon,764,mage,arcane,24,8,16
Simongof,tichondrius,763,mage,arcane,24,8,16
Iseltwald,proudmoore,761,mage,arcane,12,8,4
Christensen,stormrage,761,mage,arcane,18,8,10
Xplozion,lightninghoof,749,mage,arcane,19,10,9
Aycc,tichondrius,735,mage,arcane,17,8,9
Ebah,tichondrius,734,mage,arcane,20,9,11
Perkaset,turalyon,703,mage,arcane,17,8,9
Drainbamage,coilfang,689,mage,arcane,124,35,89
Noescaping,illidan,687,mage,arcane,19,8,11
Sazza,tichondrius,672,mage,arcane,12,7,5
Poggywoggy,frostmourne,672,mage,arcane,12,7,5
Feorbxx,proudmoore,672,mage,arcane,12,7,5
Frostituty,kiljaeden,672,mage,arcane,12,7,5
Rof,sargeras,672,mage,arcane,12,7,5
Lavaera,illidan,672,mage,arcane,12,7,5
Vixen,boulderfist,672,mage,arcane,12,7,5
Umpire,boulderfist,672,mage,arcane,12,7,5
Valériemeow,tichondrius,672,mage,arcane,18,7,11
Garrieto,sargeras,671,mage,arcane,12,7,5
Zezima,spirestone,671,mage,arcane,12,7,5
Mershon,tichondrius,671,mage,arcane,12,7,5
Murr,boulderfist,671,mage,arcane,12,7,5
Ankidar,quelthalas,671,mage,arcane,18,7,11
Austere,boulderfist,670,mage,arcane,12,7,5
Warthormage,stormrage,670,mage,arcane,12,7,5
Derkrìeger,turalyon,670,mage,arcane,18,7,11
Zimzum,bladefist,666,mage,arcane,12,7,5
Cubanarox,gallywix,661,mage,arcane,24,7,17
Brazcane,skullcrusher,655,mage,arcane,17,7,10
Karamzov,zuljin,652,mage,arcane,24,7,17
Arcanochillz,ghostlands,621,mage,arcane,21,8,13
Uhh,blackrock,607,mage,arcane,14,7,7
Moogician,aerie-peak,592,mage,arcane,13,7,6
Asalumm,quelthalas,589,mage,arcane,19,8,11
Fryry,dalaran,576,mage,arcane,12,6,6
Aeghis,stormrage,576,mage,arcane,12,6,6
Astroner,frostmourne,576,mage,arcane,12,6,6
Onibeef,duskwood,576,mage,arcane,12,6,6
Rebornganegg,tichondrius,576,mage,arcane,12,6,6
Icecreamboy,tichondrius,576,mage,arcane,12,6,6
Afasge,illidan,576,mage,arcane,12,6,6
Biscobush,turalyon,576,mage,arcane,15,7,8
Fuchsia,boulderfist,576,mage,arcane,18,6,12
Eimm,stormrage,576,mage,arcane,18,6,12
Nazmagus,hydraxis,576,mage,arcane,18,6,12
Cicciozi,sargeras,576,mage,arcane,24,6,18
Snâred,aggramar,575,mage,arcane,6,6,0
Nachtt,sargeras,575,mage,arcane,12,6,6
Kârén,aggramar,575,mage,arcane,12,6,6
Furrblock,tichondrius,575,mage,arcane,18,6,12
Lacouet,lightnings-blade,575,mage,arcane,24,6,18
Saladguy,thrall,574,mage,arcane,18,6,12
Ispell,tichondrius,573,mage,arcane,24,6,18
Enfuegoe,tichondrius,571,mage,arcane,12,6,6
Francious,echo-isles,566,mage,arcane,12,6,6
Belven,proudmoore,559,mage,arcane,17,6,11
Vires,kelthuzad,543,mage,arcane,11,6,5
Skillsbro,arthas,480,mage,arcane,6,5,1
Enveas,illidan,480,mage,arcane,6,5,1
Zeró,frostmourne,480,mage,arcane,6,5,1
Wauzcrol,quelthalas,480,mage,arcane,12,5,7
Fatso,boulderfist,480,mage,arcane,12,5,7
Maxtorgar,quelthalas,480,mage,arcane,12,5,7
Hansol,farstriders,480,mage,arcane,12,5,7
Diamondx,ragnaros,480,mage,arcane,12,5,7
Dagreatone,malganis,480,mage,arcane,12,5,7
Rebdoomer,skullcrusher,480,mage,arcane,12,5,7
Lúpìn,zuljin,480,mage,arcane,12,5,7
Markage,stormrage,480,mage,arcane,12,5,7
Shäräpova,zuljin,480,mage,arcane,12,5,7
Lorlene,frostmourne,480,mage,arcane,12,5,7
Inmylife,tichondrius,480,mage,arcane,15,6,9
Hogdog,illidan,480,mage,arcane,18,5,13
Sweetypie,fenris,479,mage,arcane,12,5,7
Corsten,aerie-peak,479,mage,arcane,12,5,7
Mandrakë,nemesis,478,mage,arcane,12,5,7
Shocknawes,illidan,478,mage,arcane,15,5,10
Humpadumplin,wyrmrest-accord,478,mage,arcane,24,5,19
Merlon,dalaran,476,mage,arcane,12,5,7
Culours,stormrage,472,mage,arcane,12,5,7
Combusty,sargeras,447,mage,arcane,14,6,8
Squishymage,moon-guard,446,mage,arcane,17,5,12
Tubby,boulderfist,431,mage,arcane,11,5,6
Larouse,quelthalas,415,mage,arcane,8,5,3
Cømbust,frostmourne,384,mage,arcane,6,4,2
Meroki,anetheron,384,mage,arcane,6,4,2
Skoals,thrall,384,mage,arcane,6,4,2
Chilléd,tichondrius,384,mage,arcane,6,4,2
Hasteboy,kelthuzad,384,mage,arcane,6,4,2
Tuggernaug,malganis,384,mage,arcane,6,4,2
Wanming,tichondrius,384,mage,arcane,6,4,2
Olympicz,kelthuzad,384,mage,arcane,6,4,2
Riddickl,malfurion,384,mage,arcane,6,4,2
Shawarms,tichondrius,384,mage,arcane,6,4,2
Imbusting,kiljaeden,384,mage,arcane,6,4,2
Rositajonez,terenas,384,mage,arcane,6,4,2
Gelokay,tichondrius,384,mage,arcane,6,4,2
Gandwàrf,moon-guard,384,mage,arcane,6,4,2
Jordèb,sargeras,384,mage,arcane,6,4,2
Myzzl,kelthuzad,384,mage,arcane,6,4,2
Dogmagetw,tichondrius,384,mage,arcane,6,4,2
Kynjji,azshara,384,mage,arcane,6,4,2
Pwnstarx,proudmoore,384,mage,arcane,12,4,8
Granmago,azralon,384,mage,arcane,12,4,8
Bigbuttangel,borean-tundra,384,mage,arcane,12,4,8
Muskinite,maiev,384,mage,arcane,12,4,8
Sukaretto,illidan,384,mage,arcane,12,4,8
Khaldyn,tichondrius,384,mage,arcane,12,4,8
Scxut,tichondrius,384,mage,arcane,12,4,8
Gobbstoppers,dalaran,384,mage,arcane,12,4,8
Forestella,tichondrius,384,mage,arcane,12,4,8
Nesomage,destromath,384,mage,arcane,12,4,8
Hogslop,saurfang,384,mage,arcane,12,4,8
Frostecho,moon-guard,384,mage,arcane,12,4,8
Biotic,kiljaeden,384,mage,arcane,12,4,8
Seaon,malganis,383,mage,arcane,6,4,2
Hànk,tichondrius,383,mage,arcane,6,4,2
Skoffla,executus,383,mage,arcane,6,4,2
Raxxor,muradin,383,mage,arcane,6,4,2
Sènding,sargeras,383,mage,arcane,18,4,14
Preckwinkle,moon-guard,382,mage,arcane,12,4,8
Dchee,nerzhul,381,mage,arcane,12,4,8
Keepinitnoob,tichondrius,351,mage,arcane,8,5,3
Ærtai,black-dragonflight,304,mage,arcane,7,4,3
Grarg,stormrage,301,mage,arcane,13,4,9
Jizzlez,tichondrius,288,mage,arcane,6,3,3
Annalee,ragnaros,288,mage,arcane,6,3,3
Watchmesleep,tichondrius,288,mage,arcane,6,3,3
Natzue,sargeras,288,mage,arcane,6,3,3
Xythros,stormrage,288,mage,arcane,6,3,3
Fennix,ragnaros,288,mage,arcane,6,3,3
Zerodium,sargeras,288,mage,arcane,6,3,3
Yaya,kargath,288,mage,arcane,6,3,3
Ksauce,twisting-nether,288,mage,arcane,6,3,3
Rotaco,illidan,288,mage,arcane,6,3,3
Koro,tichondrius,288,mage,arcane,6,3,3
Bigmunkee,the-venture-co,288,mage,arcane,6,3,3
Bobbyyx,sargeras,288,mage,arcane,6,3,3
Kev,sentinels,288,mage,arcane,6,3,3
Smãlls,sargeras,288,mage,arcane,6,3,3
Madpoondog,frostmourne,288,mage,arcane,6,3,3
Adrazell,sargeras,288,mage,arcane,6,3,3
Xzude,korgath,288,mage,arcane,6,3,3
Neverbroke,illidan,288,mage,arcane,6,3,3
Triuneward,tichondrius,288,mage,arcane,6,3,3
Kogin,thrall,288,mage,arcane,6,3,3
Kasius,kelthuzad,288,mage,arcane,6,3,3
Crøwgxd,tichondrius,288,mage,arcane,6,3,3
Zakume,stormrage,288,mage,arcane,6,3,3
Unknownblast,kul-tiras,288,mage,arcane,6,3,3
Arkanons,azralon,288,mage,arcane,12,5,7
Levalol,aggramar,288,mage,arcane,10,4,6
Heflash,azralon,288,mage,arcane,12,3,9
Skittels,azshara,288,mage,arcane,12,3,9
Elux,whisperwind,288,mage,arcane,12,3,9
Matmagic,drakkari,288,mage,arcane,13,3,10
Compactor,emerald-dream,288,mage,arcane,18,3,15
Calcaster,aegwynn,287,mage,arcane,6,3,3
Kryptekk,area-52,287,mage,arcane,6,3,3
Hýdro,ghostlands,287,mage,arcane,6,3,3
Ìgnìtìöñ,whisperwind,287,mage,arcane,12,3,9
Shinneex,ragnaros,287,mage,arcane,12,3,9
Ottsca,emerald-dream,286,mage,arcane,6,3,3
Prosperoo,aerie-peak,286,mage,arcane,6,3,3
Arcanin,thunderlord,285,mage,arcane,12,3,9
Sausage,boulderfist,276,mage,arcane,16,6,10
Etyx,tichondrius,239,mage,arcane,5,3,2
Pay,nordrassil,223,mage,arcane,9,3,6
Røcco,azralon,192,mage,arcane,4,3,1
Xpez,stormrage,192,mage,arcane,6,2,4
Maguín,tichondrius,192,mage,arcane,6,2,4
Blastgodx,stormrage,192,mage,arcane,6,2,4
Sðsa,stormrage,192,mage,arcane,6,2,4
Blinkmind,stormrage,192,mage,arcane,6,2,4
Akunimon,ragnaros,192,mage,arcane,6,2,4
Shareholder,stormrage,192,mage,arcane,6,2,4
Fakelovè,area-52,192,mage,arcane,6,2,4
Wayferz,illidan,192,mage,arcane,6,2,4
Duffs,hyjal,192,mage,arcane,6,2,4
Aenomaus,stormrage,192,mage,arcane,6,2,4
Vensyr,stormrage,192,mage,arcane,6,2,4
Highafrn,area-52,192,mage,arcane,6,2,4
Suicune,area-52,192,mage,arcane,6,2,4
Ferdabombs,tichondrius,192,mage,arcane,6,2,4
Lilfruitsnac,illidan,192,mage,arcane,6,2,4
Ichor,blackhand,192,mage,arcane,6,2,4
Arcp,illidan,192,mage,arcane,6,2,4
Sheepshot,dentarg,192,mage,arcane,6,2,4
Tarmiel,quelthalas,192,mage,arcane,6,2,4
Icebish,skullcrusher,192,mage,arcane,6,2,4
Opiumlord,tichondrius,192,mage,arcane,6,2,4
Mymaage,andorhal,192,mage,arcane,6,2,4
Emden,khadgar,192,mage,arcane,6,2,4
Alìv,tichondrius,192,mage,arcane,6,2,4
Magekofwa,tichondrius,192,mage,arcane,6,2,4
Yellowfevrz,thrall,192,mage,arcane,6,2,4
Pullmefingy,illidan,192,mage,arcane,6,2,4
Chinkins,illidan,192,mage,arcane,6,2,4
Xannymancan,tichondrius,192,mage,arcane,6,2,4
Burna,amanthul,192,mage,arcane,6,2,4
Caimil,echo-isles,192,mage,arcane,6,2,4
Slowmobius,tichondrius,192,mage,arcane,6,2,4
Vengx,tichondrius,192,mage,arcane,6,2,4
Shimmerpoly,sargeras,192,mage,arcane,6,2,4
Xunalatu,frostmourne,192,mage,arcane,6,2,4
Umber,dreadmaul,192,mage,arcane,6,2,4
Crinkit,frostmourne,192,mage,arcane,6,2,4
Rahahm,altar-of-storms,192,mage,arcane,12,2,10
Barbarabush,hellscream,192,mage,arcane,12,2,10
Amoredis,the-venture-co,192,mage,arcane,12,2,10
Gatka,quelthalas,192,mage,arcane,12,2,10
Mcshwackin,area-52,192,mage,arcane,12,2,10
Lifeinaday,proudmoore,191,mage,arcane,6,2,4
Nevswrld,stormrage,191,mage,arcane,24,2,22
Vengefuly,tichondrius,138,mage,arcane,6,3,3
Milfmaster,aerie-peak,138,mage,arcane,8,3,5
Respektwaman,tichondrius,128,mage,arcane,4,2,2
Pyropie,frostmourne,96,mage,arcane,3,2,1
Purpledrank,nagrand,96,mage,arcane,9,2,7
Magicious,tichondrius,96,mage,arcane,6,1,5
Telkham,tichondrius,96,mage,arcane,6,1,5
Quinnfreeze,boulderfist,96,mage,arcane,6,1,5
Flomin,tichondrius,96,mage,arcane,6,1,5
Pollybot,tichondrius,96,mage,arcane,6,1,5
Trippy,senjin,96,mage,arcane,6,1,5
Singheart,tichondrius,96,mage,arcane,6,1,5
Mageki,ragnaros,96,mage,arcane,6,1,5
Sula,muradin,96,mage,arcane,6,1,5
Ignit,stormrage,96,mage,arcane,6,1,5
Coldrin,tichondrius,96,mage,arcane,6,1,5
Smôl,emerald-dream,96,mage,arcane,6,1,5
Xlordpagan,sargeras,96,mage,arcane,6,1,5
Hvnlyfathr,stormrage,96,mage,arcane,6,1,5
Sabrita,proudmoore,96,mage,arcane,6,1,5
Krazsus,tichondrius,96,mage,arcane,6,1,5
Harquillen,dathremar,96,mage,arcane,6,1,5
Octané,illidan,96,mage,arcane,6,1,5
Darthez,darkspear,96,mage,arcane,6,1,5
Copperfield,dreadmaul,96,mage,arcane,6,1,5
Hhavok,scarlet-crusade,96,mage,arcane,6,1,5
Nazztwren,bleeding-hollow,96,mage,arcane,6,1,5
Helloimazu,gilneas,96,mage,arcane,6,1,5
Genozyde,elune,96,mage,arcane,6,1,5
Needmyvape,moon-guard,96,mage,arcane,6,1,5
Omnislasher,terenas,96,mage,arcane,6,1,5
Burrbon,area-52,96,mage,arcane,6,1,5
Illúmi,moon-guard,96,mage,arcane,6,1,5
Gôøglëlòl,nemesis,96,mage,arcane,6,1,5
Noyade,illidan,96,mage,arcane,6,1,5
Elemenopi,thrall,96,mage,arcane,6,1,5
Greaterbust,tichondrius,96,mage,arcane,12,1,11
Nikittomage,echo-isles,96,mage,arcane,12,1,11
Sahaquiel,tichondrius,96,mage,arcane,12,1,11
Kralien,dalaran,95,mage,arcane,6,1,5
Poofnpass,malorne,95,mage,arcane,6,1,5
Scribe,anvilmar,79,mage,arcane,5,1,4
Pyroeuphoria,dark-iron,79,mage,arcane,5,1,4
Frostmaul,dreadmaul,79,mage,arcane,11,1,10
Frostybihh,bonechewer,42,mage,arcane,9,2,7
Sol,shandris,2180,mage,fire,90,46,44
Vcamus,tichondrius,2159,mage,fire,122,66,56
Setback,illidan,2122,mage,fire,138,69,69
Hansol,farstriders,2120,mage,fire,84,42,42
Ranj,tichondrius,2110,mage,fire,103,51,52
Horoba,sargeras,2107,mage,fire,305,154,151
Setbackx,illidan,2105,mage,fire,96,47,49
Valériemeow,tichondrius,2097,mage,fire,115,57,58
Asetback,illidan,2081,mage,fire,156,78,78
Benisp,stormrage,2070,mage,fire,98,56,42
Kyphosis,illidan,2054,mage,fire,113,68,45
Talibandzx,sargeras,2042,mage,fire,159,77,82
Bigfirebat,tichondrius,2024,mage,fire,191,98,93
Kasperkar,illidan,2022,mage,fire,293,149,144
Taylorlol,tichondrius,2019,mage,fire,141,67,74
Adjudicatory,tichondrius,2003,mage,fire,69,34,35
Undeadmerlin,zuljin,1985,mage,fire,72,39,33
Purpscurp,illidan,1980,mage,fire,159,91,68
Xiaoxiaochu,tichondrius,1973,mage,fire,205,119,86
Vcamusorz,tichondrius,1970,mage,fire,166,87,79
Sorcerous,bloodhoof,1965,mage,fire,181,108,73
Udmx,zuljin,1959,mage,fire,91,54,37
Aeghis,stormrage,1958,mage,fire,48,26,22
Getmaged,bleeding-hollow,1943,mage,fire,64,40,24
Dáddyshark,sargeras,1941,mage,fire,187,90,97
Háté,ragnaros,1931,mage,fire,217,106,111
Gohonn,emerald-dream,1924,mage,fire,183,100,83
Peachygamer,stormscale,1921,mage,fire,198,99,99
Starxen,tichondrius,1915,mage,fire,54,31,23
Poundcakezx,tichondrius,1905,mage,fire,54,28,26
Sorankim,tichondrius,1893,mage,fire,54,30,24
Vazlgs,tichondrius,1872,mage,fire,78,44,34
Rmxd,malganis,1870,mage,fire,102,54,48
Nightsaber,blackrock,1869,mage,fire,42,26,16
Notini,azralon,1862,mage,fire,149,74,75
Ròÿ,area-52,1861,mage,fire,72,37,35
Opisop,kelthuzad,1858,mage,fire,60,32,28
Fixrexbaxlls,tichondrius,1852,mage,fire,84,47,37
Sunskim,tichondrius,1851,mage,fire,76,37,39
Creaystar,area-52,1843,mage,fire,268,139,129
Degen,laughing-skull,1842,mage,fire,46,31,15
Ksmackm,illidan,1842,mage,fire,65,34,31
Wanming,tichondrius,1831,mage,fire,78,44,34
Pinkmagetko,tichondrius,1830,mage,fire,48,26,22
Vampìrelolz,tichondrius,1828,mage,fire,47,25,22
Csx,turalyon,1826,mage,fire,132,73,59
Cinnablast,darkspear,1824,mage,fire,26,20,6
Yorgøs,ragnaros,1824,mage,fire,90,49,41
Fwooshinator,malganis,1823,mage,fire,71,56,15
Epod,illidan,1823,mage,fire,78,36,42
Dmgdaddy,zuljin,1822,mage,fire,42,20,22
Såni,tichondrius,1819,mage,fire,67,39,28
Téhflip,tichondrius,1818,mage,fire,60,37,23
Kraxos,stormrage,1814,mage,fire,108,62,46
Yaya,kargath,1811,mage,fire,105,51,54
Wiredcc,illidan,1805,mage,fire,30,20,10
Daddymayhem,proudmoore,1800,mage,fire,138,71,67
Juju,tichondrius,1796,mage,fire,75,44,31
Alenikus,blackhand,1791,mage,fire,143,77,66
Zoryack,azralon,1784,mage,fire,174,89,85
Kindle,malorne,1773,mage,fire,80,47,33
Icetomeetyu,bleeding-hollow,1773,mage,fire,191,95,96
Snoogma,illidan,1772,mage,fire,41,30,11
Charkoalzz,moon-guard,1771,mage,fire,71,34,37
Volkazar,sargeras,1766,mage,fire,39,21,18
Käxs,ragnaros,1762,mage,fire,42,21,21
Aigam,hyjal,1740,mage,fire,30,22,8
Deepgodsz,azralon,1738,mage,fire,51,28,23
Gelußabadook,kelthuzad,1733,mage,fire,36,24,12
Dexpy,tichondrius,1732,mage,fire,43,26,17
Farragan,ragnaros,1732,mage,fire,48,21,27
Mana,shuhalo,1730,mage,fire,45,32,13
Ogfresh,area-52,1725,mage,fire,88,54,34
Stergenutfr,tichondrius,1720,mage,fire,42,27,15
Englavian,frostmane,1709,mage,fire,54,28,26
Snaregodx,area-52,1707,mage,fire,30,21,9
Wizarts,ragnaros,1704,mage,fire,78,34,44
Mângo,frostmourne,1699,mage,fire,24,18,6
Highms,stormrage,1699,mage,fire,60,30,30
Muztaccio,tichondrius,1697,mage,fire,77,43,34
Likebutter,tichondrius,1695,mage,fire,30,22,8
Younghehe,tichondrius,1692,mage,fire,148,77,71
Myrondor,tichondrius,1691,mage,fire,106,60,46
Benjamming,ragnaros,1687,mage,fire,48,30,18
Dagreatone,malganis,1687,mage,fire,46,24,22
Banquetmeal,emerald-dream,1686,mage,fire,42,27,15
Thxo,hyjal,1683,mage,fire,123,61,62
Salvick,emerald-dream,1676,mage,fire,52,27,25
Nickioxox,tichondrius,1674,mage,fire,24,18,6
Bighot,tichondrius,1673,mage,fire,90,53,37
Ligmmah,stormrage,1670,mage,fire,78,45,33
Dropdeadlol,bonechewer,1669,mage,fire,96,55,41
Bigdjohnson,dalaran,1668,mage,fire,72,34,38
Ööf,emerald-dream,1667,mage,fire,72,33,39
Asap,frostmourne,1666,mage,fire,48,26,22
Wotl,tichondrius,1665,mage,fire,225,118,107
Blockjkdead,frostmourne,1663,mage,fire,32,21,11
Frostymart,arthas,1663,mage,fire,36,23,13
Anuub,kelthuzad,1657,mage,fire,60,38,22
Magibe,thrall,1652,mage,fire,36,24,12
Itshug,area-52,1652,mage,fire,53,27,26
Lycheeoolong,frostmourne,1649,mage,fire,38,22,16
Lolololololo,kelthuzad,1647,mage,fire,234,123,111
Affewxd,lothar,1646,mage,fire,96,56,40
Chainpoly,area-52,1639,mage,fire,43,29,14
Pootysmooch,sargeras,1639,mage,fire,54,33,21
Biscobush,turalyon,1636,mage,fire,42,27,15
Oi,frostwolf,1636,mage,fire,75,48,27
Chionê,velen,1634,mage,fire,30,18,12
Rockoe,tichondrius,1630,mage,fire,76,44,32
Trippy,senjin,1630,mage,fire,60,30,30
Ârcano,ragnaros,1628,mage,fire,53,29,24
Murcury,tichondrius,1627,mage,fire,291,151,140
Mudohir,stormrage,1627,mage,fire,58,29,29
Johnpopi,malganis,1626,mage,fire,24,17,7
Worldonfire,ragnaros,1626,mage,fire,201,107,94
Enthy,frostmourne,1623,mage,fire,60,30,30
Bigpøppapump,tichondrius,1622,mage,fire,42,19,23
Tweydey,tichondrius,1621,mage,fire,30,17,13
Blinkaway,ragnaros,1617,mage,fire,42,23,19
Darmora,kelthuzad,1615,mage,fire,24,17,7
Torched,stormreaver,1613,mage,fire,102,51,51
Iblïs,kelthuzad,1612,mage,fire,24,17,7
Nazmagus,hydraxis,1612,mage,fire,125,72,53
Domotricks,illidan,1612,mage,fire,59,33,26
Gigatuts,stormrage,1612,mage,fire,61,31,30
Formi,frostmourne,1611,mage,fire,88,41,47
Eazzybaby,eredar,1610,mage,fire,540,283,257
Yeetcannøn,illidan,1606,mage,fire,48,26,22
Albbano,tichondrius,1605,mage,fire,30,21,9
Sïthfù,tichondrius,1605,mage,fire,42,27,15
Zarkanis,tichondrius,1604,mage,fire,49,25,24
Elysõna,area-52,1602,mage,fire,126,71,55
Mushys,stormrage,1601,mage,fire,35,22,13
Grynthwzrd,stormrage,1601,mage,fire,60,37,23
Jardz,area-52,1597,mage,fire,42,21,21
Sakurai,tichondrius,1593,mage,fire,48,28,20
Tuniepop,sargeras,1592,mage,fire,94,45,49
Xs,stormrage,1591,mage,fire,138,78,60
Velvetlurker,tichondrius,1588,mage,fire,30,17,13
Chumpp,tichondrius,1586,mage,fire,30,21,9
Choccookies,illidan,1584,mage,fire,32,18,14
FleasyA8713E,wyrmrest-accord,1584,mage,fire,57,30,27
Zoobiz,tichondrius,1583,mage,fire,36,21,15
Pzaz,moon-guard,1582,mage,fire,50,30,20
Sandylove,zuljin,1582,mage,fire,36,17,19
Magekylex,proudmoore,1579,mage,fire,111,66,45
Hpthewizard,deathwing,1579,mage,fire,89,52,37
Iceward,frostmourne,1579,mage,fire,66,30,36
Engage,garrosh,1578,mage,fire,48,29,19
Wqnmlgbdy,tichondrius,1575,mage,fire,36,19,17
Varroc,quelthalas,1574,mage,fire,250,119,131
Garbagemage,barthilas,1572,mage,fire,78,41,37
Absentbrain,stormrage,1570,mage,fire,30,17,13
Firewreckage,malganis,1566,mage,fire,68,31,37
Xanthan,runetotem,1563,mage,fire,57,35,22
Ufree,tichondrius,1562,mage,fire,29,17,12
Djpolymorph,stormrage,1560,mage,fire,108,60,48
Kev,sentinels,1559,mage,fire,108,58,50
Marrioo,tichondrius,1556,mage,fire,60,31,29
Hööva,illidan,1553,mage,fire,95,53,42
Polypolypoly,kiljaeden,1550,mage,fire,28,19,9
Wickymorph,barthilas,1549,mage,fire,53,25,28
Jenezis,area-52,1547,mage,fire,41,17,24
Leonr,tichondrius,1546,mage,fire,92,56,36
Trolson,sargeras,1546,mage,fire,54,26,28
Ferdabombs,tichondrius,1544,mage,fire,124,70,54
Yooyar,barthilas,1543,mage,fire,191,95,96
Kevymarts,tichondrius,1541,mage,fire,54,33,21
Imannoyingha,darkspear,1539,mage,fire,77,41,36
Diewnuts,zuljin,1538,mage,fire,96,53,43
Squantanimo,shadowmoon,1537,mage,fire,87,43,44
Xoese,illidan,1531,mage,fire,132,61,71
Fruitdealerr,tichondrius,1530,mage,fire,66,35,31
Coôler,illidan,1530,mage,fire,175,90,85
Teetems,sargeras,1530,mage,fire,116,59,57
Fifthelëment,emerald-dream,1529,mage,fire,119,65,54
Mageonthc,korgath,1528,mage,fire,41,24,17
Ultrá,stormscale,1528,mage,fire,84,49,35
Bajaoreily,zangarmarsh,1528,mage,fire,42,19,23
Orionmage,frostmourne,1525,mage,fire,39,18,21
Willzada,azralon,1523,mage,fire,69,34,35
Magicmaghar,area-52,1521,mage,fire,60,31,29
Dreadparadox,bleeding-hollow,1521,mage,fire,64,31,33
Sparklepoof,tichondrius,1519,mage,fire,47,26,21
Crazytime,tichondrius,1519,mage,fire,42,23,19
Squishymage,frostmourne,1515,mage,fire,37,19,18
Gadgítte,moon-guard,1514,mage,fire,30,18,12
Sabrita,proudmoore,1513,mage,fire,42,19,23
Lilbabyx,stormrage,1509,mage,fire,116,60,56
Mager,dentarg,1508,mage,fire,62,40,22
Coneofkony,bleeding-hollow,1503,mage,fire,36,23,13
Marfaz,ravencrest,1500,mage,fire,72,33,39
Pòlly,illidan,1495,mage,fire,42,25,17
Juul,emerald-dream,1492,mage,fire,126,62,64
Pyroshima,barthilas,1492,mage,fire,101,49,52
Beerandmagic,zuljin,1487,mage,fire,30,16,14
Coolhandz,tichondrius,1487,mage,fire,47,24,23
Dârkus,sargeras,1487,mage,fire,122,60,62
Smallbrainz,emerald-dream,1485,mage,fire,84,47,37
Fookz,malganis,1484,mage,fire,66,34,32
Øzmage,area-52,1482,mage,fire,27,18,9
Skryte,mannoroth,1473,mage,fire,64,33,31
Jojomage,thrall,1473,mage,fire,138,71,67
Chickenspank,stormrage,1473,mage,fire,36,18,18
Jööz,deathwing,1470,mage,fire,81,40,41
Anàrchy,emerald-dream,1469,mage,fire,51,29,22
Hannahaa,area-52,1468,mage,fire,57,32,25
Connorq,stormrage,1467,mage,fire,62,35,27
Audacy,sargeras,1461,mage,fire,150,72,78
Frostpimp,anubarak,1460,mage,fire,60,22,38
Syntacks,lightnings-blade,1459,mage,fire,42,25,17
Pyroflinger,stormrage,1459,mage,fire,131,67,64
Singheart,tichondrius,1457,mage,fire,162,80,82
Toastedoats,hyjal,1456,mage,fire,97,51,46
Aerligar,area-52,1455,mage,fire,36,20,16
Mariomario,tichondrius,1455,mage,fire,84,46,38
Frogbum,fizzcrank,1454,mage,fire,34,19,15
Bettybonk,cenarius,1449,mage,fire,42,20,22
Grymorum,ragnaros,1448,mage,fire,42,18,24
Mirimida,ragnaros,1443,mage,fire,195,104,91
Firèballin,tichondrius,1441,mage,fire,31,17,14
Gasolína,stormrage,1436,mage,fire,84,48,36
Swaglo,illidan,1435,mage,fire,40,18,22
Grandpapi,arthas,1433,mage,fire,35,20,15
Sorgannon,malganis,1432,mage,fire,94,50,44
Fredcouples,tichondrius,1425,mage,fire,30,17,13
Streetember,nemesis,1424,mage,fire,84,36,48
Snanth,black-dragonflight,1420,mage,fire,51,29,22
Tigang,frostmourne,1418,mage,fire,29,17,12
Skoffla,executus,1411,mage,fire,48,25,23
Eekzlol,illidan,1409,mage,fire,30,16,14
Zstyle,frostmourne,1406,mage,fire,67,39,28
Snuurf,ragnaros,1406,mage,fire,60,31,29
Ålmøst,tichondrius,1405,mage,fire,65,36,29
Fakewarlockk,illidan,1403,mage,fire,30,16,14
Marajaade,tichondrius,1403,mage,fire,80,38,42
Mayumî,moon-guard,1401,mage,fire,34,18,16
Coldcaster,mugthol,1399,mage,fire,80,45,35
Whiteyx,saurfang,1399,mage,fire,52,29,23
Cumbus,stormrage,1399,mage,fire,42,15,27
Ruzam,area-52,1394,mage,fire,66,31,35
Jundead,dalaran,1393,mage,fire,79,46,33
Sydrol,area-52,1392,mage,fire,143,74,69
Jizzlez,tichondrius,1392,mage,fire,48,23,25
Purpledrank,nagrand,1385,mage,fire,85,39,46
Leaso,tichondrius,1384,mage,fire,45,22,23
Tamarolfrost,illidan,1382,mage,fire,55,29,26
Wïzarduous,mannoroth,1380,mage,fire,72,38,34
Ingrumatig,tichondrius,1376,mage,fire,42,18,24
Aliive,tichondrius,1375,mage,fire,30,16,14
Eatnu,tichondrius,1374,mage,fire,36,16,20
Amge,uldum,1373,mage,fire,26,15,11
Wzrdxz,tichondrius,1370,mage,fire,36,17,19
Melkra,tichondrius,1366,mage,fire,70,35,35
Waffles,ravencrest,1363,mage,fire,80,40,40
Garungar,antonidas,1361,mage,fire,24,15,9
Coltrip,azralon,1359,mage,fire,83,38,45
Elwyn,dunemaul,1358,mage,fire,60,29,31
Lilmj,kelthuzad,1355,mage,fire,43,19,24
Magiaguarra,ragnaros,1353,mage,fire,36,17,19
Wakkaflame,stormrage,1348,mage,fire,78,33,45
Prinseza,quelthalas,1345,mage,fire,55,27,28
Badaszbich,tichondrius,1344,mage,fire,36,20,16
Hempy,mannoroth,1344,mage,fire,55,24,31
Sikeyzlol,bleeding-hollow,1343,mage,fire,24,14,10
Papita,mugthol,1342,mage,fire,18,14,4
Alzagen,ragnaros,1342,mage,fire,80,42,38
Kraftfull,azralon,1338,mage,fire,19,15,4
Subscribe,malganis,1336,mage,fire,48,22,26
Dearasian,ragnaros,1335,mage,fire,60,32,28
Búrsting,kelthuzad,1334,mage,fire,31,16,15
Adrazell,sargeras,1333,mage,fire,42,21,21
Sahala,frostmourne,1333,mage,fire,60,25,35
Gødvana,frostmourne,1329,mage,fire,51,28,23
Gôøglëlòl,nemesis,1321,mage,fire,30,14,16
Nukeit,azgalor,1320,mage,fire,42,20,22
Coldrin,tichondrius,1320,mage,fire,58,27,31
Carnelius,bleeding-hollow,1319,mage,fire,75,39,36
Magination,frostmourne,1313,mage,fire,48,22,26
Quizzard,blackrock,1310,mage,fire,28,15,13
Snoü,proudmoore,1309,mage,fire,42,14,28
Raisonmage,tichondrius,1308,mage,fire,60,25,35
Raynark,nemesis,1307,mage,fire,30,18,12
Cymbalta,azralon,1306,mage,fire,47,31,16
Jjijuns,tichondrius,1302,mage,fire,40,18,22
Abzy,sargeras,1294,mage,fire,72,36,36
Rudeswizard,area-52,1291,mage,fire,73,32,41
Flame,arthas,1288,mage,fire,48,23,25
Morbøl,tichondrius,1282,mage,fire,29,17,12
Hypernova,vashj,1277,mage,fire,41,19,22
Akephálos,drakkari,1273,mage,fire,23,14,9
Helcarwen,area-52,1261,mage,fire,60,30,30
Adronicus,tichondrius,1259,mage,fire,66,33,33
Licklix,tichondrius,1258,mage,fire,46,27,19
Zulugara,barthilas,1258,mage,fire,36,19,17
Rizzlerx,stormrage,1257,mage,fire,17,14,3
Absolutepowa,bleeding-hollow,1255,mage,fire,26,14,12
Dorkski,bleeding-hollow,1253,mage,fire,181,86,95
Reddfire,proudmoore,1253,mage,fire,42,15,27
Lorlene,frostmourne,1252,mage,fire,54,27,27
Supermajor,frostmourne,1249,mage,fire,43,19,24
Babysharky,uther,1249,mage,fire,34,14,20
Glaucus,illidan,1247,mage,fire,18,13,5
Gominsi,tichondrius,1247,mage,fire,18,13,5
Leakyboots,illidan,1247,mage,fire,24,13,11
Chapelrat,sargeras,1247,mage,fire,24,13,11
Hüz,frostmourne,1244,mage,fire,18,13,5
Kronicblast,bleeding-hollow,1240,mage,fire,63,26,37
Gualter,nemesis,1239,mage,fire,36,15,21
Christjan,tichondrius,1237,mage,fire,229,117,112
Feogato,proudmoore,1237,mage,fire,60,29,31
Sky,lightnings-blade,1237,mage,fire,30,13,17
Polymedaddi,tichondrius,1236,mage,fire,36,13,23
Blinksz,korgath,1235,mage,fire,30,13,17
Politeness,tichondrius,1233,mage,fire,24,13,11
Mongomike,stormrage,1233,mage,fire,69,30,39
Christensen,stormrage,1231,mage,fire,30,17,13
Slumpgodd,frostmourne,1230,mage,fire,30,13,17
Dragonie,nordrassil,1224,mage,fire,45,23,22
Smigui,azralon,1223,mage,fire,164,76,88
Psycles,dragonmaw,1223,mage,fire,54,21,33
Arrcadia,darkspear,1221,mage,fire,36,13,23
Zinnos,tichondrius,1218,mage,fire,30,13,17
Archtype,azralon,1217,mage,fire,18,13,5
Vanairel,emerald-dream,1216,mage,fire,30,18,12
Genthruz,ragnaros,1215,mage,fire,48,22,26
Fíery,blades-edge,1211,mage,fire,90,42,48
Putridìty,thrall,1210,mage,fire,30,16,14
Halfsquad,malfurion,1208,mage,fire,24,13,11
Pyrotactics,sargeras,1205,mage,fire,46,17,29
Hadlly,tichondrius,1197,mage,fire,23,13,10
Mageolisious,kelthuzad,1197,mage,fire,46,21,25
Hositonet,malganis,1188,mage,fire,78,40,38
Sorrenton,sargeras,1186,mage,fire,41,23,18
Burist,illidan,1185,mage,fire,38,19,19
Esfire,frostmourne,1185,mage,fire,48,23,25
Vamkari,ragnaros,1178,mage,fire,42,23,19
Zonmague,drakkari,1177,mage,fire,36,17,19
Othokk,tichondrius,1170,mage,fire,48,21,27
Iguanodon,proudmoore,1159,mage,fire,56,29,27
Gradmage,proudmoore,1156,mage,fire,50,20,30
Maxvila,kelthuzad,1152,mage,fire,18,12,6
Jazzgroyper,sargeras,1151,mage,fire,18,12,6
Technique,tichondrius,1151,mage,fire,18,12,6
Kjuuler,moon-guard,1151,mage,fire,24,12,12
Freaknastyxo,stormrage,1150,mage,fire,18,12,6
Mágos,stormrage,1150,mage,fire,18,12,6
Rhykx,malganis,1149,mage,fire,18,12,6
Balmunc,proudmoore,1147,mage,fire,18,12,6
Aulle,whisperwind,1146,mage,fire,18,12,6
Sheepxyz,thrall,1146,mage,fire,24,12,12
Jonboym,illidan,1141,mage,fire,24,12,12
Fleët,tichondrius,1139,mage,fire,18,12,6
Jnxzx,sargeras,1138,mage,fire,18,12,6
Nachtt,sargeras,1136,mage,fire,24,12,12
Usirfail,bleeding-hollow,1133,mage,fire,30,12,18
Gnarwallx,stormrage,1132,mage,fire,30,12,18
Trevihl,malganis,1131,mage,fire,32,16,16
Priyel,hyjal,1130,mage,fire,30,15,15
Xzilence,aerie-peak,1118,mage,fire,30,12,18
Sánzunokawa,quelthalas,1109,mage,fire,27,16,11
Isendra,bleeding-hollow,1105,mage,fire,23,12,11
Noescaping,illidan,1102,mage,fire,24,12,12
Pyromaster,emerald-dream,1101,mage,fire,24,13,11
Saladguy,thrall,1101,mage,fire,48,17,31
Wawakun,ragnaros,1098,mage,fire,42,19,23
Gempette,tichondrius,1095,mage,fire,23,12,11
Wazzerd,moon-guard,1093,mage,fire,27,12,15
Frogpapi,illidan,1086,mage,fire,64,31,33
Guccilaflur,proudmoore,1082,mage,fire,27,12,15
Crnomage,area-52,1081,mage,fire,23,12,11
Pikoda,azralon,1066,mage,fire,28,12,16
Coldblooded,zuljin,1061,mage,fire,47,16,31
Lmaginedying,illidan,1056,mage,fire,18,11,7
Lightsoran,tichondrius,1055,mage,fire,18,11,7
Flaux,sargeras,1055,mage,fire,18,11,7
Piratecaster,kargath,1054,mage,fire,18,11,7
Dbox,stormscale,1054,mage,fire,18,11,7
Alorae,wyrmrest-accord,1054,mage,fire,18,11,7
Marxeflamer,ragnaros,1054,mage,fire,24,11,13
Lavarain,illidan,1054,mage,fire,27,11,16
Avicci,shattered-halls,1054,mage,fire,30,11,19
Joobi,sargeras,1053,mage,fire,24,11,13
Majjix,illidan,1051,mage,fire,18,11,7
Cinns,moon-guard,1051,mage,fire,24,11,13
Radakos,emerald-dream,1050,mage,fire,24,11,13
Kiz,zuljin,1050,mage,fire,24,11,13
Orianne,windrunner,1049,mage,fire,27,19,8
Aphazia,kiljaeden,1049,mage,fire,42,20,22
Magalí,nemesis,1049,mage,fire,78,33,45
Harlloo,the-underbog,1049,mage,fire,30,11,19
Kryptekk,area-52,1048,mage,fire,24,11,13
Pyroeuphoria,dark-iron,1044,mage,fire,32,13,19
Erlendr,moon-guard,1041,mage,fire,44,22,22
Scmage,exodar,1040,mage,fire,30,11,19
Freez,garona,1037,mage,fire,27,12,15
Daggoe,nazjatar,1032,mage,fire,24,11,13
Palruki,tichondrius,1030,mage,fire,23,11,12
Sasghengis,frostmourne,1029,mage,fire,66,33,33
Søkø,tichondrius,1021,mage,fire,38,18,20
Asönia,illidan,1020,mage,fire,30,11,19
Pyrepad,moon-guard,1015,mage,fire,24,11,13
Ops,frostmourne,1009,mage,fire,117,62,55
Hotjazzfarts,sargeras,1003,mage,fire,61,35,26
Minerves,tichondrius,1001,mage,fire,28,13,15
Theodosa,frostmourne,988,mage,fire,18,11,7
Hýdro,ghostlands,978,mage,fire,42,23,19
Shashyta,drakkari,974,mage,fire,66,18,48
Endmepls,ysera,965,mage,fire,96,40,56
Deathlist,frostmourne,960,mage,fire,12,10,2
Loopsyliu,stormrage,960,mage,fire,12,10,2
Tupactopus,tichondrius,960,mage,fire,18,10,8
Xythros,stormrage,960,mage,fire,18,10,8
Pollybot,tichondrius,959,mage,fire,12,10,2
Bis,aggramar,959,mage,fire,18,10,8
Astanadora,tichondrius,959,mage,fire,18,10,8
Squidio,stormrage,959,mage,fire,18,10,8
Vîgïl,feathermoon,959,mage,fire,18,10,8
Mokelovin,sargeras,959,mage,fire,18,10,8
Fantabulous,korgath,958,mage,fire,18,10,8
Zakume,stormrage,958,mage,fire,18,10,8
Pyrod,tichondrius,958,mage,fire,24,10,14
Preceptør,azralon,957,mage,fire,24,10,14
Osh,malorne,957,mage,fire,24,10,14
Alunarassra,tichondrius,956,mage,fire,24,10,14
Dårks,area-52,955,mage,fire,24,10,14
Ripburn,stormrage,953,mage,fire,47,20,27
Etyx,tichondrius,953,mage,fire,30,10,20
Flavaflame,mugthol,952,mage,fire,18,10,8
Clapsyou,illidan,951,mage,fire,24,10,14
Zukoprince,azralon,950,mage,fire,12,10,2
Zancro,ragnaros,948,mage,fire,24,10,14
Brànd,antonidas,947,mage,fire,18,11,7
Abstractgoat,tichondrius,946,mage,fire,30,15,15
Trollsita,thrall,945,mage,fire,18,10,8
Rammers,coilfang,935,mage,fire,12,10,2
Senegau,azralon,932,mage,fire,57,27,30
Boptimus,moonrunner,930,mage,fire,18,10,8
Coldarei,nagrand,928,mage,fire,27,12,15
Xxnova,moon-guard,927,mage,fire,30,11,19
Ispell,tichondrius,924,mage,fire,101,41,60
Bàttlemage,nagrand,922,mage,fire,42,22,20
Bloomper,stormrage,914,mage,fire,42,11,31
Dojacute,frostmourne,910,mage,fire,17,10,7
Alywgard,sargeras,894,mage,fire,22,10,12
Beji,frostmourne,894,mage,fire,38,17,21
Béssie,area-52,891,mage,fire,62,30,32
Alaramaria,sargeras,886,mage,fire,18,10,8
Jaysaucetv,tichondrius,878,mage,fire,19,10,9
Tungstentoes,shuhalo,875,mage,fire,21,12,9
Nakana,area-52,875,mage,fire,52,25,27
Strêss,kelthuzad,870,mage,fire,22,12,10
Tribes,dalaran,864,mage,fire,12,9,3
Itizar,frostmourne,864,mage,fire,12,9,3
Amage,drakthul,864,mage,fire,18,9,9
Ñïz,bleeding-hollow,864,mage,fire,18,9,9
Trés,ragnaros,863,mage,fire,12,9,3
Fullsheep,emerald-dream,863,mage,fire,12,9,3
Muhfin,tichondrius,863,mage,fire,18,9,9
Minverces,tichondrius,863,mage,fire,18,9,9
Gtown,kelthuzad,863,mage,fire,18,9,9
Dabsx,moon-guard,863,mage,fire,18,9,9
Ddouble,tichondrius,863,mage,fire,18,9,9
Hittheshower,tichondrius,863,mage,fire,18,9,9
Quikcast,archimonde,863,mage,fire,24,9,15
Shimmerpoly,sargeras,863,mage,fire,24,9,15
Avócadó,malganis,863,mage,fire,24,9,15
Desfunz,mugthol,862,mage,fire,18,9,9
Unknownblast,kul-tiras,862,mage,fire,26,9,17
Garion,moon-guard,860,mage,fire,20,9,11
Fryry,dalaran,860,mage,fire,24,9,15
Magja,bloodhoof,859,mage,fire,18,9,9
Baelthezer,moon-guard,858,mage,fire,21,12,9
Product,mugthol,858,mage,fire,18,9,9
Gadalka,frostmourne,857,mage,fire,18,9,9
Dánó,lightbringer,843,mage,fire,62,26,36
Umber,dreadmaul,829,mage,fire,17,9,8
Midewmage,proudmoore,829,mage,fire,23,9,14
Zniper,emerald-dream,823,mage,fire,24,9,15
Sossmage,jaedenar,815,mage,fire,15,9,6
Ljaie,lightbringer,813,mage,fire,17,9,8
Vengefuly,tichondrius,809,mage,fire,20,11,9
Phantose,sargeras,808,mage,fire,22,10,12
Zendrix,bonechewer,806,mage,fire,30,9,21
Arcanemain,kargath,799,mage,fire,42,18,24
Drewann,draenor,799,mage,fire,22,9,13
Certifried,emerald-dream,797,mage,fire,20,9,11
Alàh,stormscale,795,mage,fire,22,9,13
Almondcocoa,tichondrius,768,mage,fire,12,8,4
Keepv,tichondrius,768,mage,fire,12,8,4
Rendézvous,tichondrius,768,mage,fire,12,8,4
Pherixsw,stormrage,768,mage,fire,12,8,4
Porthúb,illidan,768,mage,fire,12,8,4
Dandrix,sargeras,768,mage,fire,12,8,4
Voljezus,jubeithos,768,mage,fire,12,8,4
Sahlokinn,stormrage,768,mage,fire,18,8,10
Original,ysera,768,mage,fire,18,8,10
Castana,tichondrius,768,mage,fire,18,8,10
Sunstry,tichondrius,768,mage,fire,18,8,10
Hexed,kiljaeden,767,mage,fire,12,8,4
Zajebisty,aegwynn,767,mage,fire,12,8,4
Kawailenard,tichondrius,767,mage,fire,12,8,4
Yugedamn,nazjatar,767,mage,fire,12,8,4
Laradria,kiljaeden,767,mage,fire,18,8,10
Snowday,nerzhul,767,mage,fire,18,8,10
Preplex,thrall,767,mage,fire,18,8,10
Shmoked,kelthuzad,767,mage,fire,18,8,10
Mccorkle,azshara,767,mage,fire,21,9,12
Wayferz,illidan,767,mage,fire,24,8,16
Siayo,stormscale,767,mage,fire,30,8,22
Ashenlad,moon-guard,766,mage,fire,18,8,10
Zafel,tichondrius,766,mage,fire,18,8,10
Magicmaster,quelthalas,765,mage,fire,24,8,16
Tarmiel,quelthalas,765,mage,fire,24,8,16
Wetguuch,area-52,763,mage,fire,18,8,10
Spellbrker,stormrage,763,mage,fire,24,8,16
Marrika,amanthul,762,mage,fire,18,8,10
Bennyhana,frostwolf,761,mage,fire,12,8,4
Dayv,azshara,760,mage,fire,30,8,22
Isoicast,moon-guard,759,mage,fire,22,11,11
Noyade,illidan,758,mage,fire,18,8,10
Pyromidget,khazgoroth,756,mage,fire,18,8,10
Ashex,moon-guard,750,mage,fire,24,9,15
Yasmani,drakkari,738,mage,fire,28,11,17
Pyrlos,terokkar,738,mage,fire,24,9,15
Dìus,malganis,719,mage,fire,17,8,9
Letitgoo,azralon,715,mage,fire,25,9,16
Flippendicus,stormrage,697,mage,fire,36,9,27
Vakina,tichondrius,690,mage,fire,27,8,19
Shmagee,azralon,684,mage,fire,13,8,5
Silimage,area-52,672,mage,fire,12,7,5
Refreshments,bleeding-hollow,672,mage,fire,12,7,5
Frankkie,mugthol,672,mage,fire,12,7,5
Sos,kelthuzad,672,mage,fire,12,7,5
Wînx,barthilas,672,mage,fire,12,7,5
Vamplol,tichondrius,672,mage,fire,12,7,5
Coldkite,tichondrius,672,mage,fire,12,7,5
Nattylites,emerald-dream,672,mage,fire,12,7,5
Belven,proudmoore,672,mage,fire,12,7,5
Wienerjeff,area-52,672,mage,fire,12,7,5
Warpfactor,malganis,672,mage,fire,12,7,5
Tuggernaug,malganis,672,mage,fire,12,7,5
Osirax,frostmane,672,mage,fire,12,7,5
Tbh,malganis,672,mage,fire,12,7,5
Vastlord,stormrage,672,mage,fire,18,7,11
Sogood,tanaris,672,mage,fire,18,7,11
Strumms,tichondrius,672,mage,fire,18,7,11
Allhitz,ragnaros,671,mage,fire,12,7,5
Keileon,tichondrius,671,mage,fire,12,7,5
Lucidaze,daggerspine,671,mage,fire,12,7,5
Ásune,moon-guard,671,mage,fire,12,7,5
Shírley,tichondrius,671,mage,fire,12,7,5
Blastfire,stormrage,671,mage,fire,12,7,5
Mymrmage,mannoroth,671,mage,fire,12,7,5
Maressara,sargeras,671,mage,fire,18,7,11
Dreaming,draktharon,670,mage,fire,12,7,5
Brutalatops,terenas,670,mage,fire,12,7,5
Icepond,proudmoore,670,mage,fire,12,7,5
Gribbets,stormrage,670,mage,fire,18,8,10
Fanshen,tichondrius,670,mage,fire,17,7,10
Ddeuuk,tichondrius,670,mage,fire,18,7,11
Tmo,mannoroth,670,mage,fire,24,7,17
Novice,barthilas,667,mage,fire,18,7,11
Baelzharon,hellscream,667,mage,fire,18,7,11
Rageymagey,azshara,665,mage,fire,24,7,17
Vonfrmdao,illidan,624,mage,fire,15,8,7
Tmharp,tichondrius,623,mage,fire,15,8,7
Proximalol,tichondrius,607,mage,fire,11,7,4
Slipqt,tichondrius,607,mage,fire,22,7,15
Chumleyson,eonar,606,mage,fire,14,7,7
Mômö,argent-dawn,606,mage,fire,22,7,15
Mzr,proudmoore,576,mage,fire,6,6,0
Strdelmaker,tichondrius,576,mage,fire,6,6,0
Tearsfórgód,kelthuzad,576,mage,fire,12,6,6
Eludin,aegwynn,576,mage,fire,12,6,6
Juniel,bleeding-hollow,576,mage,fire,12,6,6
Mageboy,bonechewer,576,mage,fire,12,6,6
Magicmidget,malganis,576,mage,fire,12,6,6
Magicmichel,malganis,576,mage,fire,12,6,6
Toteypotter,frostmourne,576,mage,fire,12,6,6
Catchmage,bleeding-hollow,576,mage,fire,12,6,6
Orangemilk,hyjal,576,mage,fire,12,6,6
Frostboy,borean-tundra,576,mage,fire,12,6,6
Omagawd,tichondrius,576,mage,fire,12,6,6
Bøfa,tichondrius,576,mage,fire,12,6,6
Myfamilygpie,nazgrel,576,mage,fire,12,6,6
Gnitraf,malganis,576,mage,fire,12,6,6
Ghili,tichondrius,576,mage,fire,12,6,6
Yupmage,tichondrius,576,mage,fire,12,6,6
Rhoadies,malfurion,576,mage,fire,12,6,6
Enchantress,wyrmrest-accord,576,mage,fire,12,6,6
Wakamage,area-52,576,mage,fire,12,6,6
Darkisfrosty,tichondrius,576,mage,fire,12,6,6
Kylar,icecrown,576,mage,fire,12,6,6
Cuterthanyou,sargeras,576,mage,fire,12,6,6
Stratokvn,ragnaros,576,mage,fire,12,6,6
Kaylemage,tichondrius,576,mage,fire,12,6,6
Jajaragnaros,bleeding-hollow,576,mage,fire,12,6,6
Fullsénd,tichondrius,576,mage,fire,12,6,6
Thalanar,barthilas,576,mage,fire,12,6,6
Plutón,tichondrius,576,mage,fire,12,6,6
Crøwgxd,tichondrius,576,mage,fire,12,6,6
Herzthroh,stormrage,576,mage,fire,12,6,6
Sourpatchkds,emerald-dream,576,mage,fire,12,6,6
Neät,frostmourne,576,mage,fire,13,6,7
Aangx,stormrage,576,mage,fire,16,7,9
Linkolni,azralon,576,mage,fire,18,6,12
Stimml,blood-furnace,576,mage,fire,18,6,12
Shivamode,thrall,576,mage,fire,18,6,12
Pecs,kiljaeden,576,mage,fire,18,6,12
Choccoeu,illidan,576,mage,fire,20,6,14
Insightæ,frostmourne,575,mage,fire,10,7,3
Ellywizzle,tichondrius,575,mage,fire,12,6,6
Minuswizard,dalaran,575,mage,fire,12,6,6
Tigerzinho,stormrage,575,mage,fire,12,6,6
Faxandu,tichondrius,575,mage,fire,18,6,12
Astroblasty,tichondrius,575,mage,fire,18,6,12
Eraticmage,illidan,575,mage,fire,24,6,18
Calínico,quelthalas,575,mage,fire,24,6,18
Pellemus,malganis,574,mage,fire,12,6,6
Spellpowa,khaz-modan,574,mage,fire,12,6,6
Calcaster,aegwynn,573,mage,fire,18,6,12
Xannymancan,tichondrius,573,mage,fire,30,6,24
Dedlyspells,dalaran,572,mage,fire,12,6,6
Navira,feathermoon,572,mage,fire,12,6,6
Trepid,illidan,565,mage,fire,18,6,12
Shotö,skullcrusher,558,mage,fire,23,6,17
Thragè,sargeras,543,mage,fire,11,6,5
Glacier,firetree,543,mage,fire,11,6,5
Magicke,azgalor,542,mage,fire,22,6,16
Chiatsup,tichondrius,528,mage,fire,9,7,2
Nuzzle,boulderfist,521,mage,fire,15,7,8
Ghostrr,tichondrius,511,mage,fire,8,6,2
Uhh,blackrock,511,mage,fire,16,6,10
Jaywazz,tichondrius,496,mage,fire,7,6,1
Slavic,sargeras,480,mage,fire,6,5,1
Porthub,boulderfist,480,mage,fire,6,5,1
Cubanmage,drakkari,480,mage,fire,6,5,1
Stickylol,tichondrius,480,mage,fire,6,5,1
Shaabby,shadowmoon,480,mage,fire,6,5,1
Maxmie,sargeras,480,mage,fire,6,5,1
Youezdawg,tichondrius,480,mage,fire,6,5,1
Ject,ragnaros,480,mage,fire,6,5,1
Zaiyge,bleeding-hollow,480,mage,fire,6,5,1
Hocusjokus,frostmourne,480,mage,fire,6,5,1
Weedzerd,illidan,480,mage,fire,12,5,7
Numbing,sargeras,480,mage,fire,12,5,7
Dbsheep,kul-tiras,480,mage,fire,12,5,7
Imhotboi,illidan,480,mage,fire,12,5,7
Icestory,tichondrius,480,mage,fire,12,5,7
Kushjointz,tichondrius,480,mage,fire,12,5,7
Bxgs,tichondrius,480,mage,fire,12,5,7
Jikario,zuljin,480,mage,fire,12,5,7
Kyriê,darkspear,480,mage,fire,12,5,7
Rmpisgay,tichondrius,480,mage,fire,12,5,7
Cnumlab,proudmoore,480,mage,fire,12,5,7
Maxtorgar,quelthalas,480,mage,fire,12,5,7
Espyy,area-52,480,mage,fire,12,5,7
Baida,kelthuzad,480,mage,fire,12,5,7
Dawonie,frostmourne,480,mage,fire,12,5,7
Pugsmugg,icecrown,480,mage,fire,12,5,7
Entomas,quelthalas,480,mage,fire,12,5,7
Honeydutchss,black-dragonflight,480,mage,fire,12,5,7
Lambsalsa,tichondrius,480,mage,fire,12,5,7
Kqlyy,tichondrius,480,mage,fire,12,5,7
Littlemunkee,the-venture-co,480,mage,fire,12,5,7
Triuneward,tichondrius,480,mage,fire,12,5,7
Zerosaspect,thrall,480,mage,fire,12,5,7
Valodrin,tichondrius,480,mage,fire,12,5,7
Arishasis,tichondrius,480,mage,fire,12,5,7
ßutteryßoner,area-52,480,mage,fire,12,5,7
Chadicewayne,tichondrius,480,mage,fire,12,5,7
Skillcap,nagrand,480,mage,fire,12,5,7
Diamondx,ragnaros,480,mage,fire,12,5,7
Marther,whisperwind,480,mage,fire,12,5,7
Magicalbuns,illidan,480,mage,fire,12,5,7
Covín,malganis,480,mage,fire,12,5,7
Defaultx,turalyon,480,mage,fire,12,5,7
Rennifer,malganis,480,mage,fire,15,6,9
Aapple,tichondrius,480,mage,fire,17,5,12
Tunax,tichondrius,480,mage,fire,18,5,13
Mageyoulooks,kelthuzad,480,mage,fire,18,5,13
Burstyboi,frostmourne,479,mage,fire,9,6,3
Xunalatu,frostmourne,479,mage,fire,12,5,7
Ghostblaze,blackhand,479,mage,fire,12,5,7
Shadowgalaxy,arthas,479,mage,fire,12,5,7
Mescudi,bonechewer,479,mage,fire,12,5,7
Finanahs,sargeras,479,mage,fire,12,5,7
Chuky,terokkar,479,mage,fire,12,5,7
Apolarus,bonechewer,478,mage,fire,12,5,7
Infusion,ysondre,477,mage,fire,12,5,7
Gwenage,tichondrius,472,mage,fire,12,5,7
Normethy,illidan,447,mage,fire,11,5,6
Prepcook,dalaran,447,mage,fire,11,5,6
Roastbeefxd,tichondrius,447,mage,fire,11,5,6
Icewrld,nemesis,447,mage,fire,14,6,8
Jazen,quelthalas,432,mage,fire,15,6,9
Myelvenlady,proudmoore,431,mage,fire,11,5,6
Eromir,dawnbringer,416,mage,fire,10,5,5
Molassess,illidan,400,mage,fire,13,5,8
Eanur,azralon,400,mage,fire,19,5,14
Brbsheepingx,illidan,384,mage,fire,6,4,2
Octané,illidan,384,mage,fire,6,4,2
Xgrave,sargeras,384,mage,fire,6,4,2
Sifr,tichondrius,384,mage,fire,6,4,2
Cruelhabbits,tichondrius,384,mage,fire,6,4,2
Mysticlotus,doomhammer,384,mage,fire,6,4,2
Floatyz,tichondrius,384,mage,fire,6,4,2
Enveas,illidan,384,mage,fire,6,4,2
Wolfgangs,thrall,384,mage,fire,6,4,2
Poonfarmer,zangarmarsh,384,mage,fire,6,4,2
Animatronic,nordrassil,384,mage,fire,6,4,2
Extremeways,tichondrius,384,mage,fire,6,4,2
Mithràndìr,tichondrius,384,mage,fire,6,4,2
Terarosa,tichondrius,384,mage,fire,6,4,2
Fmpenjoyerx,illidan,384,mage,fire,6,4,2
Codeine,darkspear,384,mage,fire,6,4,2
Haze,hyjal,384,mage,fire,6,4,2
Dersão,azralon,384,mage,fire,6,4,2
Cømbust,frostmourne,384,mage,fire,6,4,2
Playtimex,proudmoore,384,mage,fire,6,4,2
Crøwgawd,tichondrius,384,mage,fire,6,4,2
Zaxrie,malganis,384,mage,fire,6,4,2
Koadic,zuljin,384,mage,fire,6,4,2
Frozonnee,aggramar,384,mage,fire,6,4,2
Bonyobo,stormrage,384,mage,fire,6,4,2
Tafa,stormrage,384,mage,fire,6,4,2
Gíldrin,proudmoore,384,mage,fire,6,4,2
Zokorzik,area-52,384,mage,fire,6,4,2
Cottonmage,malganis,384,mage,fire,6,4,2
Pyröz,kelthuzad,384,mage,fire,6,4,2
Ferchu,emerald-dream,384,mage,fire,6,4,2
Fïtz,quelthalas,384,mage,fire,6,4,2
Playsfrost,skullcrusher,384,mage,fire,6,4,2
Mxdeez,tichondrius,384,mage,fire,9,5,4
Dytonie,moon-guard,384,mage,fire,9,4,5
Spookydookie,dark-iron,384,mage,fire,12,4,8
Magicshroomy,frostmourne,384,mage,fire,12,4,8
Sarahbeth,khadgar,384,mage,fire,12,4,8
Riencë,tol-barad,384,mage,fire,12,4,8
Felsparkles,area-52,384,mage,fire,12,4,8
Percivaltp,scarlet-crusade,384,mage,fire,12,4,8
Aquralina,moon-guard,384,mage,fire,12,4,8
Tìnkerspell,stormrage,384,mage,fire,12,4,8
Aeg,stormrage,384,mage,fire,12,4,8
Elfmage,tichondrius,384,mage,fire,12,4,8
Pòpsmóke,tichondrius,384,mage,fire,12,4,8
Thiio,tichondrius,384,mage,fire,12,4,8
Pigdancel,tichondrius,384,mage,fire,12,4,8
Galsola,bronzebeard,384,mage,fire,12,4,8
Arialla,mannoroth,384,mage,fire,12,4,8
Annhubis,quelthalas,384,mage,fire,12,4,8
Moghedi,emerald-dream,384,mage,fire,12,4,8
Hogslop,saurfang,384,mage,fire,12,4,8
Dasanimomo,sargeras,384,mage,fire,12,4,8
Kinrow,stormrage,384,mage,fire,12,4,8
Missingxx,silvermoon,384,mage,fire,12,4,8
Araski,malganis,384,mage,fire,12,4,8
Uwuwhatnow,tichondrius,384,mage,fire,12,4,8
Cam,kul-tiras,384,mage,fire,12,4,8
Cacaushow,stormrage,384,mage,fire,12,4,8
Udó,proudmoore,384,mage,fire,12,4,8
Ejzok,dreadmaul,384,mage,fire,12,4,8
Djp,tichondrius,384,mage,fire,12,4,8
Droppinbombs,draka,384,mage,fire,12,4,8
Neferpitøu,tichondrius,383,mage,fire,6,4,2
Paires,azralon,383,mage,fire,6,4,2
Drewzz,tichondrius,383,mage,fire,8,4,4
Chuggin,emerald-dream,383,mage,fire,15,5,10
Hockisonz,moon-guard,383,mage,fire,12,4,8
Soulwiper,illidan,383,mage,fire,17,5,12
Caldian,wyrmrest-accord,383,mage,fire,18,4,14
Smoney,icecrown,383,mage,fire,18,4,14
Kopke,ragnaros,381,mage,fire,13,4,9
Hollfz,nemesis,367,mage,fire,11,4,7
Vixm,stormrage,352,mage,fire,10,5,5
Wabï,tichondrius,330,mage,fire,15,5,10
Elemenopi,thrall,304,mage,fire,14,4,10
Timme,ravencrest,288,mage,fire,6,3,3
Kuther,draenor,288,mage,fire,6,3,3
Bombr,sargeras,288,mage,fire,6,3,3
Mntaindew,bleeding-hollow,288,mage,fire,6,3,3
Urbadxd,llane,288,mage,fire,6,3,3
Buffmages,malfurion,288,mage,fire,6,3,3
Sølár,ragnaros,288,mage,fire,6,3,3
Kassekx,area-52,288,mage,fire,6,3,3
Vyzo,stormrage,288,mage,fire,6,3,3
Sðsa,stormrage,288,mage,fire,6,3,3
Sikamikanico,kiljaeden,288,mage,fire,6,3,3
Polyenjoyerx,ysera,288,mage,fire,6,3,3
Thecorruptor,malorne,288,mage,fire,6,3,3
Cristábel,stormrage,288,mage,fire,6,3,3
Kyliec,tichondrius,288,mage,fire,6,3,3
Dicmojo,area-52,288,mage,fire,6,3,3
Polyburst,darkspear,288,mage,fire,6,3,3
Jimmyhendrix,wildhammer,288,mage,fire,6,3,3
Spindarella,dreadmaul,288,mage,fire,6,3,3
Bhalec,kelthuzad,288,mage,fire,6,3,3
Slinkyslink,area-52,288,mage,fire,6,3,3
Lunatti,frostmourne,288,mage,fire,6,3,3
Skw,sargeras,288,mage,fire,6,3,3
Botoslàp,dragonmaw,288,mage,fire,6,3,3
Ancientmagik,area-52,288,mage,fire,6,3,3
Xtymhxy,tichondrius,288,mage,fire,6,3,3
Kandyperreo,ragnaros,288,mage,fire,6,3,3
Azuriex,tichondrius,288,mage,fire,6,3,3
Easyfreeze,sargeras,288,mage,fire,6,3,3
Gåndalf,ragnaros,288,mage,fire,6,3,3
Taevy,tichondrius,288,mage,fire,6,3,3
Mindthegap,tichondrius,288,mage,fire,6,3,3
Yòkai,tichondrius,288,mage,fire,6,3,3
Ave,anetheron,288,mage,fire,6,3,3
Síra,firetree,288,mage,fire,6,3,3
Whyze,malganis,288,mage,fire,6,3,3
Gandrich,drakkari,288,mage,fire,6,3,3
Mugiara,azralon,288,mage,fire,6,3,3
Boorster,illidan,288,mage,fire,6,3,3
Globglob,tichondrius,288,mage,fire,6,3,3
Frostkage,tichondrius,288,mage,fire,6,3,3
Svips,illidan,288,mage,fire,6,3,3
Rích,tichondrius,288,mage,fire,6,3,3
Lampert,tichondrius,288,mage,fire,6,3,3
Chez,tichondrius,288,mage,fire,6,3,3
Bergan,sargeras,288,mage,fire,6,3,3
Zuhbo,moon-guard,288,mage,fire,6,3,3
Needloog,sargeras,288,mage,fire,6,3,3
Zenzoh,azuremyst,288,mage,fire,6,3,3
Blinkinghobo,sargeras,288,mage,fire,6,3,3
Hunchojack,tichondrius,288,mage,fire,6,3,3
Slapmesilly,destromath,288,mage,fire,6,3,3
Craigsdad,tichondrius,288,mage,fire,6,3,3
Zerathremar,proudmoore,288,mage,fire,6,3,3
Hasteboy,kelthuzad,288,mage,fire,6,3,3
Chilléd,tichondrius,288,mage,fire,6,3,3
Tráshmage,zuljin,288,mage,fire,6,3,3
Rhunón,dalaran,288,mage,fire,6,3,3
Pollylol,proudmoore,288,mage,fire,6,3,3
Gö,tichondrius,288,mage,fire,6,3,3
Angryßirdz,kelthuzad,288,mage,fire,6,3,3
Emvepee,sargeras,288,mage,fire,6,3,3
Rikko,gundrak,288,mage,fire,15,4,11
Chanko,bleeding-hollow,288,mage,fire,12,3,9
Fatalexo,tichondrius,288,mage,fire,12,3,9
Danggurl,tichondrius,288,mage,fire,12,3,9
Chale,tichondrius,288,mage,fire,12,3,9
Zogo,bleeding-hollow,288,mage,fire,12,3,9
Keionti,dalaran,288,mage,fire,12,3,9
Mendittorosa,tichondrius,288,mage,fire,12,3,9
Skynhet,ragnaros,288,mage,fire,12,3,9
Turbogeo,shuhalo,288,mage,fire,12,3,9
Magichands,darkspear,288,mage,fire,12,3,9
Nilla,hyjal,288,mage,fire,12,3,9
Funkeoto,thrall,288,mage,fire,12,3,9
Orkinekek,frostmourne,288,mage,fire,12,3,9
Twizz,haomarush,288,mage,fire,12,3,9
Chelseâ,emerald-dream,288,mage,fire,18,3,15
Xroz,barthilas,288,mage,fire,18,3,15
Gnomegeddons,dalaran,288,mage,fire,24,3,21
Harlen,quelthalas,287,mage,fire,6,3,3
Seaon,malganis,287,mage,fire,6,3,3
Shutouchi,frostwolf,287,mage,fire,6,3,3
Frostyii,stonemaul,287,mage,fire,6,3,3
Nushala,stonemaul,287,mage,fire,11,3,8
Zipacna,antonidas,286,mage,fire,12,3,9
Mageymeows,dalaran,285,mage,fire,12,3,9
Kittikk,tichondrius,284,mage,fire,18,3,15
Nesomage,destromath,256,mage,fire,10,3,7
Rossanopolis,tichondrius,255,mage,fire,17,3,14
Nephalem,moknathal,240,mage,fire,9,3,6
Orderlight,alexstrasza,239,mage,fire,5,3,2
Genozyde,elune,239,mage,fire,5,3,2
Qohoo,frostmourne,239,mage,fire,5,3,2
Xiangfe,emerald-dream,239,mage,fire,5,3,2
Fizario,barthilas,239,mage,fire,5,3,2
Feenìx,tichondrius,234,mage,fire,6,4,2
Flomin,tichondrius,234,mage,fire,16,6,10
Magicdro,scilla,224,mage,fire,10,3,7
Mcdfries,tichondrius,208,mage,fire,7,3,4
Coldgirl,malganis,192,mage,fire,11,4,7
Coldnuke,stormrage,192,mage,fire,6,2,4
Hugostiglets,dreadmaul,192,mage,fire,6,2,4
Jinglehz,frostmourne,192,mage,fire,6,2,4
Burna,amanthul,192,mage,fire,6,2,4
Copperfield,dreadmaul,192,mage,fire,6,2,4
Friézá,stormrage,192,mage,fire,6,2,4
Trízín,frostmourne,192,mage,fire,6,2,4
Swàn,stormrage,192,mage,fire,6,2,4
Kaboodlz,stormrage,192,mage,fire,6,2,4
Remana,anvilmar,192,mage,fire,6,2,4
Karameltart,barthilas,192,mage,fire,6,2,4
Massivepoo,barthilas,192,mage,fire,6,2,4
Parruka,warsong,192,mage,fire,6,2,4
Faeylyn,stormrage,192,mage,fire,6,2,4
Pipeguzzler,zuljin,192,mage,fire,6,2,4
Shäräpova,zuljin,192,mage,fire,6,2,4
Randommagi,area-52,192,mage,fire,6,2,4
Gódsfather,kelthuzad,192,mage,fire,6,2,4
Laf,frostmourne,192,mage,fire,6,2,4
Shardgodx,kelthuzad,192,mage,fire,6,2,4
Briklyx,zuljin,192,mage,fire,6,2,4
Toroy,wyrmrest-accord,192,mage,fire,6,2,4
Ignitex,bleeding-hollow,192,mage,fire,6,2,4
Pendrake,sargeras,192,mage,fire,6,2,4
Juicemage,tichondrius,192,mage,fire,6,2,4
Keii,bleeding-hollow,192,mage,fire,6,2,4
Grisherina,quelthalas,192,mage,fire,6,2,4
Starguy,terenas,192,mage,fire,6,2,4
Onehitter,tichondrius,192,mage,fire,6,2,4
Privilege,dragonmaw,192,mage,fire,6,2,4
Hellfireice,kiljaeden,192,mage,fire,6,2,4
Melkdud,wyrmrest-accord,192,mage,fire,6,2,4
Avandal,proudmoore,192,mage,fire,6,2,4
Natzue,sargeras,192,mage,fire,6,2,4
Cradic,tichondrius,192,mage,fire,6,2,4
Kymowiz,sargeras,192,mage,fire,6,2,4
Högnues,tichondrius,192,mage,fire,6,2,4
Mävra,emerald-dream,192,mage,fire,6,2,4
Herpsgungetu,maiev,192,mage,fire,6,2,4
Ogpdk,sargeras,192,mage,fire,6,2,4
Missile,frostmourne,192,mage,fire,6,2,4
Gotya,tichondrius,192,mage,fire,6,2,4
Zuqo,sargeras,192,mage,fire,6,2,4
Rbn,tichondrius,192,mage,fire,6,2,4
Maddoggs,tichondrius,192,mage,fire,6,2,4
Dustychill,illidan,192,mage,fire,6,2,4
Bojackal,illidan,192,mage,fire,6,2,4
Berrur,azralon,192,mage,fire,6,2,4
Naimi,malganis,192,mage,fire,6,2,4
Trebbiano,illidan,192,mage,fire,6,2,4
Roggitman,emerald-dream,192,mage,fire,6,2,4
Nerff,sargeras,192,mage,fire,6,2,4
Tannbone,illidan,192,mage,fire,6,2,4
Likelyhard,tichondrius,192,mage,fire,6,2,4
Wetworx,illidan,192,mage,fire,6,2,4
Notria,illidan,192,mage,fire,6,2,4
Burrbon,area-52,192,mage,fire,6,2,4
Yellowfevrz,thrall,192,mage,fire,6,2,4
Josephaqil,tichondrius,192,mage,fire,6,2,4
Chillstep,dark-iron,192,mage,fire,6,2,4
Elmozezos,thrall,192,mage,fire,6,2,4
Dîarrhea,sargeras,192,mage,fire,6,2,4
Telkham,tichondrius,192,mage,fire,6,2,4
Iludron,aegwynn,192,mage,fire,6,2,4
Dohnutt,tichondrius,192,mage,fire,6,2,4
Ðfuego,azralon,192,mage,fire,6,2,4
Elhechizero,quelthalas,192,mage,fire,6,2,4
Variex,tichondrius,192,mage,fire,6,2,4
Clickhard,suramar,192,mage,fire,6,2,4
Khelzter,area-52,192,mage,fire,6,2,4
Erîol,ragnaros,192,mage,fire,6,2,4
Shesy,sargeras,192,mage,fire,6,2,4
Thedodgex,sargeras,192,mage,fire,6,2,4
Magifish,malganis,192,mage,fire,6,2,4
Zënith,quelthalas,192,mage,fire,6,2,4
Killemz,dragonmaw,192,mage,fire,6,2,4
Gunzz,aegwynn,192,mage,fire,6,2,4
Yonzho,area-52,192,mage,fire,6,2,4
Quickwizard,tichondrius,192,mage,fire,6,2,4
Emìlia,malygos,192,mage,fire,6,2,4
Alïce,kelthuzad,192,mage,fire,6,2,4
Wauzcrol,quelthalas,192,mage,fire,6,2,4
Itension,tichondrius,192,mage,fire,6,2,4
Lilmager,tichondrius,192,mage,fire,6,2,4
Aquafiona,garona,192,mage,fire,6,2,4
Magiër,tichondrius,192,mage,fire,6,2,4
Arianark,sargeras,192,mage,fire,6,2,4
Zerii,aggramar,192,mage,fire,6,2,4
Stooki,tichondrius,192,mage,fire,6,2,4
Abrácadaver,frostwolf,192,mage,fire,10,3,7
Flamiohotman,illidan,192,mage,fire,7,2,5
Arnx,tichondrius,192,mage,fire,11,2,9
Lauroca,azralon,192,mage,fire,12,2,10
Granmago,azralon,192,mage,fire,12,2,10
Skatas,barthilas,192,mage,fire,12,2,10
Saydar,stormrage,192,mage,fire,12,2,10
Driel,illidan,192,mage,fire,12,2,10
Bic,darrowmere,192,mage,fire,12,2,10
Abruaa,area-52,192,mage,fire,12,2,10
Firehawk,azralon,192,mage,fire,12,2,10
Ëfc,nemesis,192,mage,fire,12,2,10
Itslilme,gurubashi,191,mage,fire,6,2,4
Magemajor,uldum,191,mage,fire,12,2,10
Prosperoo,aerie-peak,191,mage,fire,12,2,10
Neroclover,ysera,191,mage,fire,24,2,22
Madalon,nemesis,160,mage,fire,10,2,8
Zezima,spirestone,159,mage,fire,5,2,3
Razaklov,tichondrius,159,mage,fire,5,2,3
Kindlin,frostmourne,159,mage,fire,5,2,3
Fingerblaste,malganis,138,mage,fire,16,3,13
Ratfather,the-forgotten-coast,128,mage,fire,4,2,2
Yeweiliang,tichondrius,128,mage,fire,4,2,2
Dwayniewayni,tichondrius,128,mage,fire,4,2,2
Supremeboxer,tichondrius,127,mage,fire,8,2,6
Neltar,dalaran,112,mage,fire,7,2,5
Haliax,bronzebeard,96,mage,fire,3,2,1
Lv,stormscale,96,mage,fire,6,1,5
Trojay,malganis,96,mage,fire,6,1,5
Purpkush,zuljin,96,mage,fire,6,1,5
Bbaxter,stormrage,96,mage,fire,6,1,5
Litiria,burning-blade,96,mage,fire,6,1,5
Memnor,amanthul,96,mage,fire,6,1,5
Magicmooman,thunderlord,96,mage,fire,6,1,5
Prosperoh,burning-legion,96,mage,fire,6,1,5
Tisao,bronzebeard,96,mage,fire,6,1,5
Jazco,tichondrius,96,mage,fire,6,1,5
Blinkmind,stormrage,96,mage,fire,6,1,5
Iamsol,area-52,96,mage,fire,6,1,5
Rieltar,barthilas,96,mage,fire,6,1,5
Nomidian,area-52,96,mage,fire,6,1,5
Édika,area-52,96,mage,fire,6,1,5
Ignit,stormrage,96,mage,fire,6,1,5
Tabuta,ravenholdt,96,mage,fire,6,1,5
Clutchy,gorefiend,96,mage,fire,6,1,5
Firemids,thrall,96,mage,fire,6,1,5
Jarethleon,ragnaros,96,mage,fire,6,1,5
Ross,deathwing,96,mage,fire,6,1,5
Jaçkjaçk,moon-guard,96,mage,fire,6,1,5
Arkuran,proudmoore,96,mage,fire,6,1,5
Clickersz,sargeras,96,mage,fire,6,1,5
Bdmxd,stormrage,96,mage,fire,6,1,5
Dâzk,sargeras,96,mage,fire,6,1,5
Firehazard,tichondrius,96,mage,fire,6,1,5
Bigmêan,boulderfist,96,mage,fire,6,1,5
Ssmurfett,dalaran,96,mage,fire,6,1,5
Pyrophobia,mannoroth,96,mage,fire,6,1,5
Hyndoriann,azgalor,96,mage,fire,6,1,5
Aimedint,sargeras,96,mage,fire,6,1,5
Tonydippin,illidan,96,mage,fire,6,1,5
Merreda,sargeras,96,mage,fire,6,1,5
Warmweather,nagrand,96,mage,fire,6,1,5
Dildope,frostmourne,96,mage,fire,6,1,5
Gnomoguapo,altar-of-storms,96,mage,fire,6,1,5
Gurion,bleeding-hollow,96,mage,fire,6,1,5
Hèrò,barthilas,96,mage,fire,6,1,5
Sny,bleeding-hollow,96,mage,fire,6,1,5
Nazztwren,bleeding-hollow,96,mage,fire,6,1,5
Truewinter,tichondrius,96,mage,fire,6,1,5
Pyromaniac,stormscale,96,mage,fire,6,1,5
Wíntersun,frostmourne,96,mage,fire,6,1,5
Fireblast,stormscale,96,mage,fire,6,1,5
Muted,frostmourne,96,mage,fire,6,1,5
Miapolyafoo,stormrage,96,mage,fire,6,1,5
Rolypolyman,tichondrius,96,mage,fire,6,1,5
Brayni,wyrmrest-accord,96,mage,fire,6,1,5
Auraelius,tichondrius,96,mage,fire,6,1,5
Phrana,tichondrius,96,mage,fire,6,1,5
Couto,tichondrius,96,mage,fire,6,1,5
Somnuss,barthilas,96,mage,fire,7,1,6
Allesanda,sargeras,96,mage,fire,12,1,11
Duhquarius,warsong,96,mage,fire,12,1,11
Zuroz,dathremar,96,mage,fire,12,1,11
Dezax,malfurion,96,mage,fire,12,1,11
Mideon,whisperwind,95,mage,fire,6,1,5
Doomguyx,korgath,95,mage,fire,14,1,13
Cînderellas,proudmoore,84,mage,fire,14,5,9
Noquemacuuh,ragnaros,79,mage,fire,5,1,4
Kibazn,sisters-of-elune,79,mage,fire,5,1,4
Jaked,frostmourne,79,mage,fire,5,1,4
Savanali,kelthuzad,79,mage,fire,5,1,4
Jarvase,mugthol,79,mage,fire,5,1,4
Skerei,azralon,48,mage,fire,3,1,2
Redeyez,arthas,48,mage,fire,9,1,8
Juicemage,tichondrius,2203,mage,frost,168,90,78
Hogdog,illidan,2105,mage,frost,90,47,43
Stonedmonkeý,tichondrius,2103,mage,frost,149,75,74
Juicechanel,tichondrius,2071,mage,frost,70,38,32
Cremgotrockd,blackrock,2061,mage,frost,113,62,51
Lawuera,quelthalas,2011,mage,frost,96,48,48
Zlint,quelthalas,2007,mage,frost,115,59,56
Easyfreeze,sargeras,1996,mage,frost,48,27,21
Cunzhang,tichondrius,1989,mage,frost,78,39,39
Backjing,tichondrius,1969,mage,frost,87,42,45
Hogmantwo,illidan,1965,mage,frost,66,36,30
Ghostrr,tichondrius,1963,mage,frost,190,97,93
Factszxy,area-52,1934,mage,frost,59,41,18
Frostitutex,illidan,1911,mage,frost,73,38,35
Douyuweifa,tichondrius,1911,mage,frost,65,31,34
Elkiador,area-52,1909,mage,frost,30,21,9
Bamx,stormrage,1900,mage,frost,72,39,33
Grumpyòlfart,tichondrius,1898,mage,frost,132,67,65
Vazlgs,tichondrius,1896,mage,frost,82,47,35
Miilky,tichondrius,1893,mage,frost,66,33,33
Flaux,sargeras,1892,mage,frost,88,50,38
Ams,aerie-peak,1890,mage,frost,60,33,27
Smuky,stormrage,1888,mage,frost,155,75,80
Zerodium,sargeras,1887,mage,frost,107,54,53
Snaregodx,area-52,1885,mage,frost,59,31,28
Kassmage,skullcrusher,1884,mage,frost,150,71,79
Faynet,dalaran,1882,mage,frost,158,84,74
Politeness,tichondrius,1873,mage,frost,42,20,22
Chrisxo,azuremyst,1866,mage,frost,48,27,21
Tupactopus,tichondrius,1861,mage,frost,54,27,27
Stöpwatch,hyjal,1859,mage,frost,66,43,23
Theydeadx,illidan,1858,mage,frost,47,31,16
Pigdancell,tichondrius,1858,mage,frost,60,25,35
Corgim,thrall,1857,mage,frost,65,33,32
Sheepard,sargeras,1856,mage,frost,36,25,11
Fròzt,ragnaros,1854,mage,frost,96,43,53
Mcdfries,tichondrius,1853,mage,frost,60,32,28
Hunchojack,tichondrius,1852,mage,frost,66,27,39
Xanthilia,chogall,1849,mage,frost,96,49,47
Valériemeow,tichondrius,1847,mage,frost,184,86,98
Chunzhangfs,tichondrius,1843,mage,frost,46,23,23
Hideongp,barthilas,1842,mage,frost,108,54,54
Maebalim,tichondrius,1835,mage,frost,48,27,21
Evilnuts,quelthalas,1832,mage,frost,61,34,27
Dahp,thrall,1831,mage,frost,47,23,24
Micfiyah,thrall,1827,mage,frost,66,41,25
Vague,tichondrius,1824,mage,frost,80,42,38
Gelokay,tichondrius,1821,mage,frost,42,25,17
Joe,llane,1821,mage,frost,195,95,100
Srinshi,sargeras,1820,mage,frost,160,80,80
Miketao,tichondrius,1820,mage,frost,67,31,36
Headbake,malganis,1820,mage,frost,66,30,36
Evilear,andorhal,1819,mage,frost,66,33,33
Chez,tichondrius,1818,mage,frost,30,19,11
Cømbust,frostmourne,1816,mage,frost,72,50,22
Theetwotime,area-52,1814,mage,frost,148,77,71
Quippy,kiljaeden,1813,mage,frost,309,156,153
Leakyboots,illidan,1812,mage,frost,47,25,22
Ribot,sargeras,1812,mage,frost,60,28,32
Tris,malganis,1807,mage,frost,63,32,31
Swagbased,tichondrius,1807,mage,frost,60,29,31
Koozay,kelthuzad,1805,mage,frost,65,38,27
Dace,tichondrius,1804,mage,frost,53,29,24
Maegwynah,stormrage,1804,mage,frost,66,29,37
Aapple,tichondrius,1803,mage,frost,60,32,28
Instincts,uldum,1796,mage,frost,42,25,17
Ligmmah,stormrage,1792,mage,frost,110,61,49
Yellowfevrz,thrall,1791,mage,frost,42,19,23
Laserface,bleeding-hollow,1789,mage,frost,72,42,30
Lantx,tichondrius,1789,mage,frost,80,43,37
Koro,tichondrius,1784,mage,frost,133,68,65
Drewdy,stormreaver,1783,mage,frost,30,19,11
Valtessa,stormrage,1781,mage,frost,54,32,22
Endymiòn,tichondrius,1780,mage,frost,48,24,24
Sheepgodx,malganis,1779,mage,frost,35,20,15
Kleinz,quelthalas,1776,mage,frost,91,54,37
Golfirl,doomhammer,1774,mage,frost,54,24,30
Tjofmajik,stormrage,1771,mage,frost,54,28,26
Sestren,zuljin,1766,mage,frost,54,25,29
Kissradiox,tichondrius,1763,mage,frost,138,65,73
Dtbmar,misha,1762,mage,frost,94,43,51
Dorsia,jaedenar,1760,mage,frost,76,49,27
Rhythmdog,tichondrius,1758,mage,frost,60,25,35
Gôøglëlòl,nemesis,1755,mage,frost,271,139,132
Frikabust,stormrage,1747,mage,frost,65,39,26
Stealing,barthilas,1746,mage,frost,59,30,29
Mokelovin,sargeras,1744,mage,frost,47,30,17
Lemmiwïnks,area-52,1744,mage,frost,44,27,17
Téfy,ragnaros,1744,mage,frost,59,34,25
Riddickl,malfurion,1738,mage,frost,102,50,52
Kazimìr,tichondrius,1735,mage,frost,30,19,11
Tofusmell,illidan,1735,mage,frost,54,31,23
Bravden,area-52,1735,mage,frost,72,40,32
Kymowiz,sargeras,1731,mage,frost,54,26,28
Pitball,area-52,1730,mage,frost,139,70,69
Ingcho,tichondrius,1730,mage,frost,72,32,40
Castana,tichondrius,1729,mage,frost,116,54,62
Blinkbow,tichondrius,1724,mage,frost,161,80,81
Feener,stormreaver,1722,mage,frost,42,19,23
Illumià,illidan,1719,mage,frost,26,20,6
Atra,spinebreaker,1717,mage,frost,60,29,31
Traelol,blades-edge,1715,mage,frost,114,58,56
Sifr,tichondrius,1713,mage,frost,36,18,18
Covil,tichondrius,1710,mage,frost,114,54,60
Zhangxiaowu,tichondrius,1706,mage,frost,56,37,19
Jerawokee,undermine,1706,mage,frost,97,44,53
Isellstuff,thrall,1704,mage,frost,78,40,38
Luckysir,illidan,1704,mage,frost,42,21,21
Xuxä,stormrage,1701,mage,frost,68,36,32
Polyenjoyerx,ysera,1701,mage,frost,106,55,51
Rizke,tichondrius,1701,mage,frost,35,18,17
Zssy,tichondrius,1693,mage,frost,65,43,22
Chinye,tichondrius,1691,mage,frost,68,32,36
Fromcanadaqc,stormrage,1689,mage,frost,41,24,17
Zinnos,tichondrius,1684,mage,frost,214,105,109
Pichorrá,quelthalas,1683,mage,frost,86,49,37
Persia,illidan,1683,mage,frost,53,24,29
Blinkmind,stormrage,1682,mage,frost,54,26,28
Sabrita,proudmoore,1680,mage,frost,98,50,48
Perrc,area-52,1680,mage,frost,206,100,106
Jtizzlè,tichondrius,1679,mage,frost,59,33,26
Deallus,tichondrius,1677,mage,frost,82,40,42
Cayoux,darkspear,1676,mage,frost,30,18,12
Alurion,moon-guard,1673,mage,frost,32,21,11
Factsx,area-52,1669,mage,frost,42,22,20
Bmuafgfe,tichondrius,1668,mage,frost,36,22,14
Tommagic,tichondrius,1666,mage,frost,40,23,17
Praestigium,barthilas,1665,mage,frost,98,54,44
Marrioo,tichondrius,1663,mage,frost,54,26,28
Stimml,blood-furnace,1662,mage,frost,66,38,28
Arcayne,tichondrius,1662,mage,frost,127,69,58
Tatertots,bladefist,1658,mage,frost,47,18,29
Bambambilly,kelthuzad,1655,mage,frost,75,35,40
Bemaster,area-52,1654,mage,frost,50,33,17
Minverces,tichondrius,1653,mage,frost,40,23,17
Arcánè,velen,1652,mage,frost,29,19,10
Dve,frostmourne,1651,mage,frost,84,51,33
Entm,burning-blade,1651,mage,frost,42,22,20
Kassody,kelthuzad,1650,mage,frost,36,22,14
Seeu,tichondrius,1649,mage,frost,60,21,39
Hüz,frostmourne,1648,mage,frost,62,41,21
Yeweiliang,tichondrius,1648,mage,frost,486,242,244
Luxør,aegwynn,1647,mage,frost,30,18,12
Zorexx,area-52,1643,mage,frost,61,30,31
Juniel,bleeding-hollow,1643,mage,frost,46,22,24
Sheepshot,dentarg,1641,mage,frost,48,24,24
Glaciated,the-forgotten-coast,1641,mage,frost,86,42,44
Sorankim,tichondrius,1641,mage,frost,43,18,25
Horrendum,azralon,1639,mage,frost,42,24,18
Qcomberoo,frostmane,1637,mage,frost,45,22,23
Gûmbÿ,illidan,1636,mage,frost,36,28,8
Charmed,black-dragonflight,1635,mage,frost,86,45,41
Venachi,emerald-dream,1633,mage,frost,146,83,63
Mayumî,moon-guard,1632,mage,frost,42,21,21
Lambsalsa,tichondrius,1631,mage,frost,42,18,24
Gnitraf,malganis,1630,mage,frost,48,27,21
Fawcett,khazgoroth,1629,mage,frost,102,53,49
Thatlejund,tichondrius,1628,mage,frost,97,52,45
Scarablast,bleeding-hollow,1628,mage,frost,73,35,38
Magecombe,thrall,1626,mage,frost,67,33,34
Zezima,spirestone,1625,mage,frost,36,23,13
Elyandria,proudmoore,1625,mage,frost,42,23,19
Xialing,tichondrius,1625,mage,frost,35,18,17
Animatronic,moon-guard,1622,mage,frost,261,131,130
Erykk,mugthol,1622,mage,frost,63,22,41
Kouks,tichondrius,1621,mage,frost,35,21,14
Harmõny,tichondrius,1621,mage,frost,31,18,13
Fgnb,sargeras,1620,mage,frost,60,32,28
Mashii,kiljaeden,1620,mage,frost,36,17,19
Triuneward,tichondrius,1619,mage,frost,42,22,20
Yulian,tichondrius,1618,mage,frost,127,75,52
Neverblockx,kirin-tor,1618,mage,frost,30,17,13
Savanali,kelthuzad,1616,mage,frost,63,33,30
Aycc,tichondrius,1616,mage,frost,52,27,25
Hotrunner,sargeras,1615,mage,frost,211,108,103
Gwyn,nemesis,1614,mage,frost,54,29,25
Kabrax,nerzhul,1613,mage,frost,48,22,26
Whosdismage,illidan,1608,mage,frost,36,22,14
Soulberg,emerald-dream,1606,mage,frost,107,53,54
Squidio,stormrage,1605,mage,frost,130,72,58
Terarosa,tichondrius,1605,mage,frost,66,34,32
Jaked,frostmourne,1604,mage,frost,62,27,35
Sheepu,bladefist,1603,mage,frost,112,64,48
Snoogensftw,tichondrius,1602,mage,frost,36,17,19
Preceptør,azralon,1601,mage,frost,61,33,28
Umber,dreadmaul,1600,mage,frost,222,113,109
Aramire,drakkari,1597,mage,frost,45,23,22
Trippy,senjin,1595,mage,frost,38,19,19
Frostpimp,anubarak,1594,mage,frost,62,27,35
Flâvor,illidan,1593,mage,frost,54,29,25
Littlejay,kelthuzad,1591,mage,frost,42,19,23
Enflame,tichondrius,1583,mage,frost,66,42,24
Mageonthcc,korgath,1583,mage,frost,98,49,49
Orderlight,alexstrasza,1582,mage,frost,144,68,76
Baleiabranca,stormrage,1580,mage,frost,195,91,104
Axecap,tichondrius,1578,mage,frost,72,38,34
Pocsermage,drakkari,1577,mage,frost,40,18,22
Bibi,ragnaros,1575,mage,frost,57,26,31
Alùcârd,tichondrius,1572,mage,frost,64,34,30
Tonystonerz,lightnings-blade,1570,mage,frost,36,20,16
Lorlene,frostmourne,1570,mage,frost,199,92,107
Crithappy,baelgun,1568,mage,frost,48,26,22
Dexd,laughing-skull,1567,mage,frost,72,38,34
Fizario,barthilas,1567,mage,frost,95,47,48
Frizbee,sargeras,1567,mage,frost,39,19,20
Nickioxox,tichondrius,1567,mage,frost,41,17,24
Hermanmiller,tichondrius,1561,mage,frost,118,65,53
Burrstful,destromath,1561,mage,frost,59,26,33
Marisadaze,tichondrius,1558,mage,frost,74,32,42
Affewxd,lothar,1557,mage,frost,126,65,61
Qsc,barthilas,1555,mage,frost,213,107,106
Deverror,frostmourne,1555,mage,frost,216,104,112
Fracxure,area-52,1554,mage,frost,47,21,26
Deathrøll,moon-guard,1552,mage,frost,84,48,36
Kabonkle,drakthul,1545,mage,frost,68,32,36
Maxtorgar,quelthalas,1545,mage,frost,48,17,31
Couto,tichondrius,1544,mage,frost,59,26,33
Moyuu,proudmoore,1541,mage,frost,343,172,171
Mkudos,ragnaros,1540,mage,frost,119,63,56
Nairmage,tichondrius,1540,mage,frost,38,20,18
Snôz,illidan,1539,mage,frost,72,32,40
Omnislasher,terenas,1537,mage,frost,145,70,75
Lilpolyx,illidan,1537,mage,frost,36,17,19
Priyel,hyjal,1536,mage,frost,68,35,33
Daydreamz,lightnings-blade,1535,mage,frost,77,32,45
Kyphosis,illidan,1533,mage,frost,31,16,15
Chrislongtv,tichondrius,1533,mage,frost,678,339,339
Biglance,frostmourne,1533,mage,frost,36,17,19
Frostqt,area-52,1532,mage,frost,132,71,61
Froshar,ragnaros,1532,mage,frost,60,29,31
Pigdancel,tichondrius,1531,mage,frost,36,16,20
Icyspring,tichondrius,1530,mage,frost,24,16,8
Yorgøs,ragnaros,1530,mage,frost,30,16,14
Mcfry,illidan,1528,mage,frost,70,40,30
Pëpz,emerald-dream,1527,mage,frost,42,17,25
Slipqt,tichondrius,1519,mage,frost,77,38,39
Aosin,wyrmrest-accord,1519,mage,frost,36,17,19
Janchi,moon-guard,1518,mage,frost,119,52,67
Ehcos,stormrage,1517,mage,frost,90,42,48
Floofies,moon-guard,1516,mage,frost,133,65,68
Fakebusiness,area-52,1515,mage,frost,198,102,96
Dillor,tichondrius,1511,mage,frost,195,99,96
Icestory,tichondrius,1511,mage,frost,138,56,82
Kandyperreo,ragnaros,1510,mage,frost,70,35,35
Paü,illidan,1509,mage,frost,117,55,62
Unseën,area-52,1508,mage,frost,36,18,18
Warmweather,nagrand,1508,mage,frost,54,25,29
Swaxi,illidan,1506,mage,frost,30,16,14
Trebbiano,illidan,1503,mage,frost,163,85,78
Playsfrost,skullcrusher,1501,mage,frost,106,62,44
Tuçhi,tichondrius,1501,mage,frost,48,27,21
Khadberry,aerie-peak,1501,mage,frost,71,34,37
Sáron,quelthalas,1499,mage,frost,69,37,32
Yourefat,emerald-dream,1497,mage,frost,96,60,36
Tylers,moon-guard,1496,mage,frost,48,28,20
Noescaping,illidan,1494,mage,frost,53,24,29
Kazmir,area-52,1494,mage,frost,41,16,25
Vornz,sargeras,1493,mage,frost,102,51,51
Galacticslug,tichondrius,1491,mage,frost,54,30,24
Burritsacold,bleeding-hollow,1491,mage,frost,54,26,28
Megladon,tichondrius,1489,mage,frost,65,40,25
Arcaneshally,area-52,1489,mage,frost,42,20,22
Datazonfire,illidan,1488,mage,frost,36,22,14
Spurski,emerald-dream,1487,mage,frost,27,17,10
Maagin,zuljin,1487,mage,frost,182,95,87
Genswift,thrall,1486,mage,frost,60,27,33
Song,sargeras,1485,mage,frost,83,42,41
Supergun,tichondrius,1485,mage,frost,45,21,24
Emetah,ysera,1485,mage,frost,60,27,33
Icegiants,tichondrius,1484,mage,frost,65,35,30
Betrian,quelthalas,1482,mage,frost,72,33,39
Pibb,rivendare,1480,mage,frost,48,25,23
Léstat,quelthalas,1479,mage,frost,36,21,15
Magneto,blood-furnace,1479,mage,frost,36,17,19
Cubanmage,drakkari,1477,mage,frost,42,19,23
Fbd,bloodscalp,1473,mage,frost,30,16,14
Toaststrudel,tichondrius,1472,mage,frost,105,49,56
Ado,zuluhed,1471,mage,frost,114,59,55
Snowmassive,illidan,1471,mage,frost,42,20,22
Agoniey,illidan,1471,mage,frost,66,26,40
Kylar,icecrown,1470,mage,frost,66,32,34
Bruxelejolie,twisting-nether,1468,mage,frost,24,16,8
Vecna,tichondrius,1468,mage,frost,109,52,57
Fròzen,moon-guard,1466,mage,frost,80,39,41
Wíntersun,frostmourne,1465,mage,frost,342,173,169
Osh,malorne,1464,mage,frost,56,27,29
Enterthevoid,proudmoore,1463,mage,frost,36,21,15
Tynka,drakkari,1463,mage,frost,30,16,14
Jikario,zuljin,1463,mage,frost,42,21,21
Magetherian,frostmourne,1463,mage,frost,96,46,50
Revised,sargeras,1462,mage,frost,94,52,42
Hugostiglets,dreadmaul,1462,mage,frost,146,71,75
Gualter,nemesis,1460,mage,frost,147,84,63
Zeshilol,stormrage,1460,mage,frost,51,21,30
Fakewarlockk,illidan,1459,mage,frost,100,54,46
Ruzam,area-52,1456,mage,frost,113,60,53
Deadsayru,drakkari,1456,mage,frost,52,27,25
Corruptionz,nemesis,1455,mage,frost,72,36,36
Syntacks,lightnings-blade,1454,mage,frost,324,157,167
Tifrodo,azralon,1452,mage,frost,70,39,31
Üman,bleeding-hollow,1451,mage,frost,30,17,13
Coôler,illidan,1451,mage,frost,160,90,70
Kfortyone,kiljaeden,1450,mage,frost,30,16,14
Meer,stonemaul,1448,mage,frost,72,44,28
Scrúmp,tichondrius,1448,mage,frost,66,33,33
Nereidan,drakkari,1448,mage,frost,62,29,33
Myxzz,barthilas,1447,mage,frost,380,192,188
Minerves,tichondrius,1446,mage,frost,42,20,22
Roseofsharon,tichondrius,1446,mage,frost,42,18,24
Wolfgangvn,stormrage,1446,mage,frost,48,20,28
Bettybonk,cenarius,1441,mage,frost,59,26,33
Aloredron,illidan,1440,mage,frost,53,27,26
Pvpbilly,tichondrius,1439,mage,frost,24,15,9
Zirkur,mannoroth,1437,mage,frost,56,26,30
Forged,tichondrius,1436,mage,frost,60,25,35
Siayo,stormscale,1433,mage,frost,46,24,22
Cumbustyomom,illidan,1433,mage,frost,30,15,15
Getsheepedon,boulderfist,1433,mage,frost,54,22,32
Sesshomaru,emerald-dream,1433,mage,frost,51,18,33
Ddeuuk,tichondrius,1431,mage,frost,59,27,32
Mmine,tichondrius,1430,mage,frost,30,15,15
Vendizzle,malganis,1429,mage,frost,59,27,32
Crøwgxd,tichondrius,1428,mage,frost,24,15,9
Erîol,ragnaros,1428,mage,frost,200,99,101
Osnapmage,malganis,1428,mage,frost,276,136,140
Babyspise,nathrezim,1425,mage,frost,24,15,9
Respectx,nemesis,1425,mage,frost,76,34,42
Trolson,sargeras,1425,mage,frost,102,45,57
Fireguard,azralon,1424,mage,frost,30,16,14
Renoria,norgannon,1424,mage,frost,30,15,15
Linhny,tichondrius,1421,mage,frost,111,59,52
Raisonmage,tichondrius,1421,mage,frost,54,28,26
Garbagemage,barthilas,1421,mage,frost,30,15,15
Choxiy,illidan,1419,mage,frost,36,15,21
Guyza,frostmourne,1418,mage,frost,143,66,77
Lachawr,stormrage,1414,mage,frost,214,109,105
Tossdztosdoz,tichondrius,1414,mage,frost,30,15,15
Biofreze,malganis,1414,mage,frost,60,26,34
Gazzuu,ragnaros,1413,mage,frost,42,22,20
Creatïne,stormrage,1413,mage,frost,151,76,75
Kitenic,proudmoore,1412,mage,frost,71,37,34
Ciaooh,tichondrius,1408,mage,frost,93,43,50
Canva,barthilas,1406,mage,frost,41,25,16
Throatdemon,hakkar,1405,mage,frost,48,25,23
Odaravla,proudmoore,1405,mage,frost,108,51,57
Nate,black-dragonflight,1404,mage,frost,128,65,63
Nargine,tichondrius,1403,mage,frost,30,15,15
Gunzup,lightnings-blade,1403,mage,frost,30,15,15
Pizzatest,area-52,1402,mage,frost,52,19,33
Gasolína,stormrage,1401,mage,frost,100,47,53
Koulder,zuljin,1400,mage,frost,62,35,27
Archewing,azjolnerub,1399,mage,frost,42,16,26
Därkmägician,tichondrius,1398,mage,frost,44,24,20
Rossanopolis,tichondrius,1397,mage,frost,59,30,29
Frussy,blood-furnace,1395,mage,frost,114,57,57
Arckayne,zuljin,1395,mage,frost,82,31,51
Starscreamm,ragnaros,1394,mage,frost,40,23,17
Azhim,tichondrius,1394,mage,frost,54,25,29
Clm,lightnings-blade,1393,mage,frost,137,68,69
Crymachine,garrosh,1391,mage,frost,33,17,16
Boejanglz,frostmourne,1390,mage,frost,28,17,11
Kahili,stormrage,1390,mage,frost,77,35,42
Chadyus,illidan,1390,mage,frost,42,17,25
Affinitty,zuljin,1389,mage,frost,48,27,21
Zzyuh,proudmoore,1389,mage,frost,52,25,27
Mclanda,frostmourne,1388,mage,frost,116,55,61
Wienerjeff,area-52,1385,mage,frost,47,28,19
Maguín,tichondrius,1384,mage,frost,30,15,15
Epifeni,blackrock,1383,mage,frost,55,24,31
Magicbunny,andorhal,1382,mage,frost,213,109,104
Ultrá,stormscale,1379,mage,frost,33,16,17
Mëlkart,ragnaros,1377,mage,frost,72,36,36
Zoidy,bleeding-hollow,1377,mage,frost,35,15,20
Lightsoran,tichondrius,1375,mage,frost,17,15,2
Kh,stormrage,1374,mage,frost,99,50,49
Cheesebuns,proudmoore,1373,mage,frost,74,32,42
Wojnova,zuljin,1372,mage,frost,24,15,9
Lilkyrie,senjin,1372,mage,frost,60,25,35
Hhappier,tichondrius,1371,mage,frost,65,32,33
Harrypothead,senjin,1370,mage,frost,35,24,11
Tagere,moon-guard,1370,mage,frost,80,38,42
Nhinsanity,ghostlands,1369,mage,frost,27,17,10
Rrite,tichondrius,1366,mage,frost,29,15,14
Dazby,tichondrius,1363,mage,frost,35,17,18
Magicmooman,thunderlord,1359,mage,frost,63,30,33
Kevymarts,tichondrius,1358,mage,frost,54,31,23
Starkp,ragnaros,1357,mage,frost,177,86,91
Tentaçao,stormrage,1352,mage,frost,68,34,34
Iladiin,malganis,1350,mage,frost,52,26,26
Asparagoose,stormrage,1347,mage,frost,29,15,14
Radiku,blood-furnace,1347,mage,frost,31,16,15
Freez,garona,1346,mage,frost,40,18,22
Anarista,wyrmrest-accord,1345,mage,frost,24,15,9
Aqcamus,illidan,1344,mage,frost,23,15,8
Vampìrelolz,tichondrius,1344,mage,frost,24,14,10
Mâsterkush,tichondrius,1343,mage,frost,46,23,23
Cryogeniks,illidan,1343,mage,frost,30,14,16
Frøstdrægöñ,illidan,1341,mage,frost,18,14,4
Mageyoulooks,kelthuzad,1340,mage,frost,36,17,19
Shatturd,sargeras,1339,mage,frost,78,31,47
Messiaah,tichondrius,1339,mage,frost,36,14,22
Plainblaine,illidan,1337,mage,frost,98,47,51
Krabby,malganis,1337,mage,frost,66,26,40
Clownspocket,tichondrius,1336,mage,frost,83,46,37
Pivnert,boulderfist,1336,mage,frost,30,14,16
Luckysix,illidan,1336,mage,frost,36,14,22
Safu,bleeding-hollow,1335,mage,frost,120,63,57
Milambehr,elune,1335,mage,frost,54,28,26
Nicemangoes,proudmoore,1335,mage,frost,30,15,15
Hammed,dalaran,1334,mage,frost,68,32,36
Aherom,ragnaros,1333,mage,frost,51,30,21
Safety,stormreaver,1330,mage,frost,146,77,69
Rích,tichondrius,1330,mage,frost,126,56,70
Juul,emerald-dream,1328,mage,frost,237,109,128
Zaddyx,whisperwind,1326,mage,frost,30,14,16
Selless,zuljin,1325,mage,frost,66,33,33
Valtaira,wyrmrest-accord,1322,mage,frost,148,81,67
Hirune,ragnaros,1322,mage,frost,70,25,45
Eriktherod,maelstrom,1321,mage,frost,36,15,21
Tarmiel,quelthalas,1319,mage,frost,54,28,26
Skillcap,nagrand,1315,mage,frost,30,16,14
Andorlin,barthilas,1315,mage,frost,47,22,25
Aarne,thrall,1315,mage,frost,36,16,20
Elegantbroth,illidan,1312,mage,frost,30,14,16
Phergo,ragnaros,1311,mage,frost,36,14,22
Ragemage,borean-tundra,1311,mage,frost,59,20,39
Plunks,bleeding-hollow,1310,mage,frost,80,30,50
Mntaindew,bleeding-hollow,1309,mage,frost,35,14,21
Shäräpova,zuljin,1308,mage,frost,36,20,16
Frøzzen,quelthalas,1307,mage,frost,147,67,80
Vorass,kelthuzad,1305,mage,frost,42,18,24
Tyning,blood-furnace,1304,mage,frost,54,27,27
Abracadaver,greymane,1302,mage,frost,64,36,28
Xárdas,quelthalas,1302,mage,frost,107,56,51
Soia,ragnaros,1302,mage,frost,143,72,71
Rahzac,dalaran,1302,mage,frost,62,29,33
Tessar,moon-guard,1300,mage,frost,100,43,57
Samaë,zuljin,1300,mage,frost,35,15,20
Haruká,ragnaros,1300,mage,frost,45,15,30
Paidemago,azralon,1299,mage,frost,65,40,25
Frostítute,alterac-mountains,1299,mage,frost,60,28,32
Eskimoan,frostmourne,1298,mage,frost,42,15,27
Jugobomb,madoran,1295,mage,frost,46,25,21
Frostitutå,eonar,1293,mage,frost,118,54,64
Hotpeachpie,zuljin,1290,mage,frost,85,44,41
Gralnur,kelthuzad,1286,mage,frost,32,15,17
Rastafarix,ragnaros,1285,mage,frost,47,21,26
Cìfel,quelthalas,1281,mage,frost,31,18,13
Dohnutt,tichondrius,1281,mage,frost,53,25,28
Dumblexgamer,ragnaros,1281,mage,frost,72,33,39
Ràmdas,hyjal,1278,mage,frost,60,30,30
Derpmanjr,area-52,1277,mage,frost,60,39,21
Skynhet,ragnaros,1277,mage,frost,36,16,20
Cyberstar,proudmoore,1276,mage,frost,41,21,20
Thergon,kul-tiras,1275,mage,frost,38,19,19
Showtíme,spirestone,1273,mage,frost,24,16,8
Kryliak,ragnaros,1273,mage,frost,60,33,27
Discoinferno,kelthuzad,1273,mage,frost,45,22,23
Somethinglos,sargeras,1273,mage,frost,106,47,59
Cheapsects,drakthul,1272,mage,frost,32,17,15
Unleáshed,moonrunner,1272,mage,frost,135,68,67
Feogato,proudmoore,1271,mage,frost,153,76,77
Quietusllil,gurubashi,1269,mage,frost,102,60,42
Ignit,stormrage,1269,mage,frost,34,17,17
Luckysi,illidan,1268,mage,frost,38,15,23
Vengefuly,tichondrius,1264,mage,frost,34,17,17
Bossmage,tichondrius,1263,mage,frost,37,15,22
Missingxx,silvermoon,1261,mage,frost,53,26,27
Whyammage,dalaran,1260,mage,frost,77,46,31
Satív,moknathal,1258,mage,frost,42,25,17
Drfrostie,anvilmar,1257,mage,frost,26,14,12
Guji,area-52,1255,mage,frost,55,26,29
Alìv,tichondrius,1254,mage,frost,190,85,105
Comaner,frostmourne,1253,mage,frost,28,14,14
Degenhours,illidan,1253,mage,frost,51,25,26
Numz,sargeras,1252,mage,frost,148,67,81
Baemers,tichondrius,1252,mage,frost,36,14,22
Hýdramist,sargeras,1246,mage,frost,24,13,11
Mângo,frostmourne,1243,mage,frost,24,13,11
Lucyphilis,stormrage,1243,mage,frost,86,43,43
Kromeus,illidan,1243,mage,frost,48,23,25
Peetufo,whisperwind,1243,mage,frost,41,17,24
Låvazza,tichondrius,1242,mage,frost,24,13,11
Ðontßlink,illidan,1240,mage,frost,24,13,11
Vênsêr,emerald-dream,1240,mage,frost,30,13,17
Merkkinz,thrall,1239,mage,frost,65,31,34
Mageyoulooks,shattered-hand,1238,mage,frost,30,15,15
Agniih,azralon,1236,mage,frost,72,34,38
ßlitzkreig,area-52,1235,mage,frost,24,18,6
Tyrecgosa,tichondrius,1235,mage,frost,66,35,31
Kevdra,kelthuzad,1233,mage,frost,72,32,40
Hykkup,frostmourne,1232,mage,frost,24,13,11
Phoenixic,frostmourne,1232,mage,frost,191,84,107
Magifish,malganis,1231,mage,frost,62,35,27
Rankryman,quelthalas,1231,mage,frost,58,29,29
Magicginger,barthilas,1231,mage,frost,52,23,29
Frostzadan,quelthalas,1228,mage,frost,56,23,33
Mageosaurusx,tichondrius,1228,mage,frost,36,13,23
Arcaninez,bleeding-hollow,1224,mage,frost,24,13,11
Sturmrevenge,lightnings-blade,1224,mage,frost,137,70,67
Samuoa,tichondrius,1223,mage,frost,41,21,20
Gsr,nerzhul,1222,mage,frost,46,19,27
Jobar,malganis,1221,mage,frost,24,13,11
Jagmag,area-52,1219,mage,frost,18,14,4
Jejihev,drakkari,1219,mage,frost,35,17,18
Makén,illidan,1218,mage,frost,48,32,16
Maac,nemesis,1216,mage,frost,29,14,15
Fíebs,queldorei,1209,mage,frost,36,19,17
Åquå,area-52,1208,mage,frost,33,18,15
Phantombila,azralon,1207,mage,frost,39,14,25
Djp,tichondrius,1206,mage,frost,43,25,18
Iceehott,kargath,1206,mage,frost,73,38,35
Akagamix,sargeras,1205,mage,frost,47,20,27
Gunzz,aegwynn,1202,mage,frost,48,21,27
Ejzok,dreadmaul,1201,mage,frost,202,89,113
Acarilla,stormrage,1199,mage,frost,54,20,34
Saski,nathrezim,1196,mage,frost,30,16,14
Palruki,tichondrius,1193,mage,frost,60,22,38
Kyll,moon-guard,1192,mage,frost,30,13,17
Highafrn,area-52,1191,mage,frost,30,14,16
Valrendor,nazjatar,1191,mage,frost,79,36,43
Juxmcmage,kiljaeden,1189,mage,frost,60,20,40
Dooie,sargeras,1188,mage,frost,28,19,9
Canassa,azralon,1183,mage,frost,131,66,65
Sîmply,zuljin,1183,mage,frost,42,13,29
Maigoddess,proudmoore,1180,mage,frost,71,29,42
Twinklestars,sargeras,1179,mage,frost,72,40,32
Numaïr,kiljaeden,1179,mage,frost,68,27,41
Featherboo,stormrage,1178,mage,frost,35,16,19
Chade,dunemaul,1178,mage,frost,53,22,31
Icebboxx,tichondrius,1176,mage,frost,36,21,15
Daddyplease,bleeding-hollow,1176,mage,frost,42,20,22
Gatka,quelthalas,1171,mage,frost,334,162,172
Layolis,area-52,1170,mage,frost,92,46,46
Pendrake,sargeras,1170,mage,frost,34,13,21
Giovannie,zuluhed,1169,mage,frost,54,25,29
Darkrukia,tichondrius,1168,mage,frost,63,32,31
Cocmagic,kelthuzad,1167,mage,frost,33,15,18
Aquariusmoon,bonechewer,1166,mage,frost,60,31,29
Toesuckerlol,tichondrius,1164,mage,frost,33,16,17
Yamitenshi,dalaran,1162,mage,frost,68,24,44
Bubbleblower,hakkar,1161,mage,frost,30,15,15
Devlux,area-52,1158,mage,frost,104,50,54
Khaldyn,tichondrius,1156,mage,frost,132,65,67
Defarefa,frostmourne,1156,mage,frost,150,71,79
Floopse,agamaggan,1153,mage,frost,18,13,5
Cavit,wyrmrest-accord,1153,mage,frost,63,29,34
Bçøløñápûðgé,illidan,1152,mage,frost,18,12,6
Xtymhxy,tichondrius,1152,mage,frost,24,12,12
Iceward,frostmourne,1151,mage,frost,18,12,6
Czq,tichondrius,1150,mage,frost,18,12,6
Damage,skullcrusher,1150,mage,frost,31,13,18
Rbn,tichondrius,1148,mage,frost,33,13,20
Magewara,area-52,1147,mage,frost,18,12,6
Snipymagus,shattered-hand,1146,mage,frost,27,13,14
Crizzpy,tichondrius,1146,mage,frost,48,22,26
Alatria,frostmourne,1146,mage,frost,66,24,42
Pyroshima,barthilas,1145,mage,frost,40,13,27
Corrmic,winterhoof,1144,mage,frost,72,36,36
Peakd,bleeding-hollow,1144,mage,frost,30,12,18
Yungice,hyjal,1144,mage,frost,36,14,22
Frenk,moon-guard,1143,mage,frost,42,15,27
Vasthrash,bleeding-hollow,1142,mage,frost,78,33,45
Diixynormus,illidan,1141,mage,frost,30,17,13
Tsuchek,tichondrius,1139,mage,frost,24,12,12
Hiiamtay,azralon,1138,mage,frost,26,14,12
Boldwarp,dalaran,1138,mage,frost,29,14,15
Thatotherguy,lightnings-blade,1137,mage,frost,22,13,9
Sahir,thaurissan,1135,mage,frost,48,20,28
Twirkin,proudmoore,1131,mage,frost,42,22,20
Littlebeth,azjolnerub,1127,mage,frost,89,46,43
Fatum,ragnaros,1124,mage,frost,32,14,18
Elwyn,dunemaul,1123,mage,frost,27,13,14
Evierix,illidan,1123,mage,frost,88,42,46
Nazneen,elune,1122,mage,frost,73,31,42
Icelordd,ragnaros,1121,mage,frost,30,14,16
Coldfrønt,moon-guard,1120,mage,frost,48,21,27
Deadmarley,blackhand,1116,mage,frost,36,19,17
Dannyyoo,blackrock,1116,mage,frost,23,12,11
Bellåtrîx,quelthalas,1115,mage,frost,18,12,6
Icybanter,emerald-dream,1115,mage,frost,53,22,31
Who,emerald-dream,1113,mage,frost,58,27,31
Menacë,tichondrius,1112,mage,frost,30,12,18
Sølem,frostmourne,1112,mage,frost,42,16,26
Osda,azralon,1111,mage,frost,36,19,17
Levitaine,bleeding-hollow,1110,mage,frost,38,19,19
Ibalyn,khazgoroth,1109,mage,frost,101,49,52
Castingmommy,moon-guard,1108,mage,frost,73,37,36
Rekonx,tichondrius,1107,mage,frost,91,41,50
Granmago,azralon,1106,mage,frost,30,12,18
Skdonkay,nerzhul,1102,mage,frost,89,45,44
Hollerin,whisperwind,1098,mage,frost,18,12,6
Memnor,amanthul,1098,mage,frost,24,12,12
Gelile,tichondrius,1097,mage,frost,59,28,31
Magedango,bleeding-hollow,1095,mage,frost,35,14,21
Azzurn,doomhammer,1090,mage,frost,24,13,11
Esun,moon-guard,1088,mage,frost,36,17,19
Drumzter,ragnaros,1085,mage,frost,41,21,20
Ralzarek,zuluhed,1085,mage,frost,30,15,15
Raxxor,muradin,1085,mage,frost,30,12,18
Helcarwen,area-52,1081,mage,frost,31,13,18
Blancnoir,tichondrius,1081,mage,frost,39,16,23
Magekingz,shattered-halls,1080,mage,frost,54,27,27
Wickednoob,malganis,1080,mage,frost,132,62,70
Mageeoh,bleeding-hollow,1072,mage,frost,47,15,32
Leets,mugthol,1070,mage,frost,18,12,6
Gryd,area-52,1070,mage,frost,88,43,45
Travarra,terenas,1069,mage,frost,60,19,41
Mageolisious,kelthuzad,1063,mage,frost,30,12,18
Bootnet,drakkari,1063,mage,frost,54,16,38
Copperfield,dreadmaul,1060,mage,frost,122,50,72
Lildabpen,tichondrius,1057,mage,frost,86,34,52
Dealzy,malganis,1056,mage,frost,18,11,7
Saydar,stormrage,1056,mage,frost,36,11,25
Redhell,dalaran,1055,mage,frost,18,11,7
Zacx,area-52,1055,mage,frost,24,11,13
Gadogear,draka,1054,mage,frost,30,11,19
Doubledown,kiljaeden,1053,mage,frost,18,11,7
Corucia,echo-isles,1053,mage,frost,256,121,135
Xannymancan,tichondrius,1052,mage,frost,60,23,37
Walrusxo,kelthuzad,1052,mage,frost,30,11,19
Arcranium,icecrown,1051,mage,frost,18,11,7
Coldshouldér,nerzhul,1051,mage,frost,24,11,13
Auralyn,wyrmrest-accord,1051,mage,frost,25,11,14
Zuqo,sargeras,1050,mage,frost,18,11,7
Mirmaduck,wyrmrest-accord,1049,mage,frost,18,11,7
Klinkr,illidan,1049,mage,frost,30,11,19
Ggtoasted,thrall,1048,mage,frost,18,11,7
Annalee,ragnaros,1048,mage,frost,24,11,13
Médüsa,moon-guard,1047,mage,frost,18,11,7
Moistcream,bloodscalp,1047,mage,frost,22,12,10
Zehlks,garrosh,1047,mage,frost,30,13,17
Zibbo,ragnaros,1046,mage,frost,18,11,7
Ceadruk,darkspear,1046,mage,frost,30,14,16
Skywalkerino,azralon,1045,mage,frost,24,11,13
Mindthegap,tichondrius,1044,mage,frost,57,30,27
Keahiláni,area-52,1043,mage,frost,27,13,14
Vyninovan,aggramar,1043,mage,frost,24,11,13
Magicke,azgalor,1042,mage,frost,23,14,9
Gradivous,emerald-dream,1042,mage,frost,88,39,49
Iacceptvenmo,tichondrius,1041,mage,frost,18,11,7
Jorzan,kelthuzad,1041,mage,frost,24,11,13
Ispell,tichondrius,1040,mage,frost,30,20,10
Devoh,dunemaul,1040,mage,frost,20,11,9
Remana,anvilmar,1039,mage,frost,24,11,13
Limeade,ursin,1038,mage,frost,24,11,13
Xoxmage,frostmourne,1037,mage,frost,66,35,31
Khrixa,illidan,1036,mage,frost,114,55,59
Arkoz,tichondrius,1035,mage,frost,24,14,10
Starguy,laughing-skull,1034,mage,frost,37,14,23
Trentos,illidan,1033,mage,frost,54,29,25
Briélla,area-52,1032,mage,frost,54,26,28
Smáckington,tichondrius,1032,mage,frost,118,53,65
Pugsmugg,icecrown,1032,mage,frost,49,13,36
Sluagh,terenas,1031,mage,frost,52,24,28
Brashen,stormrage,1030,mage,frost,55,27,28
Niscra,nemesis,1026,mage,frost,40,12,28
Wowenjoyer,area-52,1025,mage,frost,91,42,49
Sciona,suramar,1025,mage,frost,141,62,79
Raáiden,stormrage,1024,mage,frost,42,18,24
Drbloodmuscl,black-dragonflight,1020,mage,frost,36,15,21
Codexzero,bleeding-hollow,1017,mage,frost,66,29,37
Trollsita,thrall,1013,mage,frost,18,11,7
Voidera,wyrmrest-accord,1012,mage,frost,36,11,25
Sènding,sargeras,1010,mage,frost,42,11,31
Oopsyourapig,darkspear,1007,mage,frost,48,17,31
Rizzbot,sargeras,1005,mage,frost,75,27,48
Pizzle,perenolde,1004,mage,frost,58,27,31
Neacel,tichondrius,1004,mage,frost,24,11,13
Vynruki,area-52,1003,mage,frost,30,15,15
Jaymage,agamaggan,994,mage,frost,37,13,24
Vantus,tichondrius,993,mage,frost,32,17,15
Worknlurk,malganis,992,mage,frost,24,12,12
Kannim,sargeras,992,mage,frost,66,27,39
Megapasta,illidan,989,mage,frost,23,11,12
Superoirity,trollbane,988,mage,frost,48,24,24
Prometheus,crushridge,986,mage,frost,52,27,25
Jayfunk,sargeras,984,mage,frost,23,11,12
Bound,emerald-dream,983,mage,frost,23,11,12
Bòóyah,muradin,980,mage,frost,40,21,19
Grudel,archimonde,979,mage,frost,41,21,20
Hékate,moon-guard,979,mage,frost,48,12,36
Iesca,ragnaros,978,mage,frost,23,12,11
Bigpinkies,korgath,976,mage,frost,42,16,26
Thaldarian,emerald-dream,975,mage,frost,31,12,19
Dejavuh,dalaran,972,mage,frost,54,25,29
Rephlex,tichondrius,970,mage,frost,19,11,8
Dieselonfire,the-venture-co,967,mage,frost,56,29,27
Crankweigth,rivendare,965,mage,frost,84,40,44
Édika,area-52,963,mage,frost,30,11,19
Torthie,burning-blade,960,mage,frost,12,10,2
Bigsplosions,kiljaeden,960,mage,frost,15,11,4
Tainx,frostmourne,960,mage,frost,18,10,8
Thefridge,shadowmoon,960,mage,frost,18,10,8
Kygores,tichondrius,960,mage,frost,18,10,8
Hadlly,tichondrius,960,mage,frost,18,10,8
Legendkiller,bleeding-hollow,959,mage,frost,18,10,8
Finnancy,stormrage,959,mage,frost,18,10,8
Arillius,malganis,959,mage,frost,18,10,8
Nukedat,proudmoore,959,mage,frost,18,10,8
Ntys,frostmourne,959,mage,frost,18,10,8
Shimmerpoly,sargeras,959,mage,frost,24,10,14
Bigmêan,boulderfist,958,mage,frost,18,10,8
Aluce,frostmourne,958,mage,frost,18,10,8
Fineous,kalecgos,958,mage,frost,24,10,14
Hylord,tichondrius,957,mage,frost,18,10,8
Zunyu,tichondrius,957,mage,frost,18,10,8
Aurumpaleas,moon-guard,956,mage,frost,24,11,13
Shephard,nemesis,956,mage,frost,24,10,14
Solusek,garona,955,mage,frost,18,10,8
Nethros,stormrage,954,mage,frost,15,11,4
Trízín,frostmourne,954,mage,frost,18,10,8
Nnenna,bonechewer,952,mage,frost,18,10,8
Moonfhang,azralon,952,mage,frost,257,120,137
Unmix,tichondrius,952,mage,frost,24,10,14
Imoen,zangarmarsh,951,mage,frost,36,15,21
Zedroçk,shadowmoon,951,mage,frost,24,10,14
Nksbluedeath,area-52,949,mage,frost,18,10,8
Keelaron,proudmoore,949,mage,frost,24,10,14
Rasmin,greymane,948,mage,frost,40,22,18
Shírley,tichondrius,948,mage,frost,30,10,20
Redeyez,arthas,947,mage,frost,137,65,72
Misfyre,malganis,946,mage,frost,28,11,17
Hhavok,scarlet-crusade,944,mage,frost,36,10,26
Onlyfansme,dalaran,939,mage,frost,18,10,8
Gaduri,tichondrius,938,mage,frost,23,11,12
Bôsco,bleeding-hollow,936,mage,frost,20,11,9
Diegoneally,bleeding-hollow,936,mage,frost,63,26,37
Angerfrost,khazgoroth,935,mage,frost,48,23,25
Mystics,dawnbringer,935,mage,frost,110,44,66
Hasty,emerald-dream,927,mage,frost,29,10,19
Ärià,sargeras,926,mage,frost,18,10,8
Maldine,tol-barad,926,mage,frost,18,10,8
Trollings,azralon,925,mage,frost,63,30,33
Fireace,emerald-dream,922,mage,frost,17,10,7
Drpeppor,blades-edge,922,mage,frost,18,10,8
Fireblast,stormscale,922,mage,frost,41,16,25
Brynach,trollbane,913,mage,frost,42,20,22
Cawyro,caelestrasz,913,mage,frost,47,22,25
Mongera,bonechewer,909,mage,frost,50,25,25
Moesel,emerald-dream,908,mage,frost,15,11,4
Hambürglar,garrosh,907,mage,frost,24,12,12
Leocius,daggerspine,906,mage,frost,23,10,13
Marschubas,drakthul,905,mage,frost,83,37,46
Mugiara,azralon,897,mage,frost,21,10,11
Critique,malorne,894,mage,frost,54,27,27
Lillbean,thunderlord,894,mage,frost,25,11,14
Mageboy,bonechewer,894,mage,frost,29,10,19
Puvö,tichondrius,889,mage,frost,26,10,16
Tristania,archimonde,888,mage,frost,107,54,53
Scár,blackrock,873,mage,frost,20,10,10
Luxfumante,azralon,869,mage,frost,24,12,12
Mideon,whisperwind,865,mage,frost,43,20,23
Nasgeth,darkspear,864,mage,frost,12,9,3
Blurrs,illidan,864,mage,frost,12,9,3
Kaylemage,tichondrius,864,mage,frost,12,9,3
Furisheep,stormrage,864,mage,frost,12,9,3
Rositajonez,terenas,864,mage,frost,12,9,3
Nalabb,illidan,864,mage,frost,12,9,3
Zlint,ragnaros,864,mage,frost,12,9,3
Benzos,eitrigg,864,mage,frost,12,9,3
Hyoonsfeet,stormrage,864,mage,frost,18,9,9
Fromcanada,eitrigg,864,mage,frost,18,9,9
Weathersmell,tichondrius,864,mage,frost,18,9,9
Skoals,thrall,864,mage,frost,29,10,19
Blinkbotx,proudmoore,863,mage,frost,18,9,9
Lastiari,wyrmrest-accord,863,mage,frost,18,9,9
Jottami,azralon,863,mage,frost,18,9,9
Juanmánce,quelthalas,863,mage,frost,20,9,11
Soukidiot,sargeras,863,mage,frost,24,9,15
Benjamming,ragnaros,863,mage,frost,24,9,15
Blinkharder,stormrage,863,mage,frost,24,9,15
Wolfsmind,frostmourne,863,mage,frost,30,9,21
Jodebabss,dalaran,862,mage,frost,18,9,9
Cryyo,queldorei,862,mage,frost,18,9,9
Boredomkïlls,burning-legion,862,mage,frost,18,9,9
Youngwiz,arthas,862,mage,frost,18,9,9
Faire,stonemaul,862,mage,frost,18,9,9
Åøe,tichondrius,862,mage,frost,18,9,9
Neomage,elune,862,mage,frost,22,9,13
Tunax,tichondrius,862,mage,frost,24,9,15
FleasyA8713E,wyrmrest-accord,862,mage,frost,24,9,15
Skizzlés,bleeding-hollow,861,mage,frost,18,9,9
Shenme,moon-guard,861,mage,frost,20,9,11
Fruza,emerald-dream,860,mage,frost,16,10,6
Zaxrie,malganis,860,mage,frost,18,9,9
Pantsbeard,illidan,859,mage,frost,30,9,21
Vallet,ragnaros,858,mage,frost,12,9,3
Cuoreforte,moon-guard,858,mage,frost,24,9,15
Cùrtiñ,tichondrius,858,mage,frost,30,9,21
Telios,azralon,857,mage,frost,16,10,6
Cransmage,illidan,856,mage,frost,18,9,9
Kaboozles,area-52,853,mage,frost,24,9,15
Soya,sargeras,852,mage,frost,24,9,15
Naoz,ragnaros,851,mage,frost,18,9,9
Rkbj,korgath,851,mage,frost,31,9,22
Zabaione,stormrage,847,mage,frost,28,10,18
Avers,frostwolf,844,mage,frost,24,9,15
Bandagris,garrosh,840,mage,frost,21,10,11
Rathrizar,emerald-dream,840,mage,frost,30,13,17
Jarethleon,ragnaros,837,mage,frost,21,11,10
Nezarrek,sargeras,835,mage,frost,18,9,9
Âürõrâ,firetree,834,mage,frost,24,9,15
Taylorrain,arthas,829,mage,frost,36,14,22
Craftin,sargeras,827,mage,frost,18,9,9
Itoncruxy,tichondrius,825,mage,frost,69,30,39
Assasix,tichondrius,810,mage,frost,36,12,24
Airgumbo,illidan,796,mage,frost,14,9,5
Zionist,earthen-ring,796,mage,frost,14,9,5
Frightmare,sargeras,768,mage,frost,12,8,4
Pandazed,stormscale,768,mage,frost,12,8,4
Eyesofrage,tichondrius,768,mage,frost,12,8,4
Dearyuanmage,tichondrius,768,mage,frost,12,8,4
Arrokoth,malganis,768,mage,frost,12,8,4
Justmoss,sargeras,768,mage,frost,12,8,4
Edm,proudmoore,768,mage,frost,12,8,4
Nefm,frostmourne,768,mage,frost,12,8,4
Brandonlol,area-52,768,mage,frost,12,8,4
Wiztopher,frostmourne,768,mage,frost,12,8,4
Zstyle,frostmourne,768,mage,frost,18,8,10
Georgian,malfurion,768,mage,frost,18,8,10
Blinkinghobo,sargeras,768,mage,frost,18,8,10
Yeetcannøn,illidan,768,mage,frost,18,8,10
Mcdude,kiljaeden,768,mage,frost,18,8,10
Magibe,thrall,768,mage,frost,18,8,10
Dead,nemesis,768,mage,frost,18,8,10
Lycheeoolong,frostmourne,768,mage,frost,18,8,10
Magnificaxd,area-52,768,mage,frost,24,8,16
Nôtôrious,thrall,767,mage,frost,12,8,4
Vonte,elune,767,mage,frost,12,8,4
Mempool,darkspear,767,mage,frost,12,8,4
Magicmaster,quelthalas,767,mage,frost,12,8,4
Crvarla,tichondrius,767,mage,frost,12,8,4
Seeumaybe,proudmoore,767,mage,frost,12,8,4
Bigdjohnson,dalaran,767,mage,frost,12,8,4
Frosttwoop,moon-guard,767,mage,frost,12,8,4
Songnineone,tichondrius,767,mage,frost,12,8,4
Maauie,sargeras,767,mage,frost,16,8,8
Staytrill,stormreaver,767,mage,frost,18,8,10
Vamplol,tichondrius,767,mage,frost,18,8,10
Numb,trollbane,767,mage,frost,18,8,10
Jayma,moon-guard,767,mage,frost,18,8,10
Keiiox,ragnaros,767,mage,frost,18,8,10
Qtqq,malganis,767,mage,frost,18,8,10
Linsz,nemesis,767,mage,frost,18,8,10
Wickymorph,barthilas,767,mage,frost,18,8,10
Drdocx,frostmourne,767,mage,frost,18,8,10
Badboykilla,dentarg,767,mage,frost,21,9,12
Gardes,tichondrius,767,mage,frost,24,8,16
Teloiv,malganis,766,mage,frost,12,8,4
Mägï,tichondrius,766,mage,frost,12,8,4
Stinker,nazjatar,766,mage,frost,18,8,10
Barcilas,proudmoore,766,mage,frost,24,8,16
Moonpie,frostmane,765,mage,frost,12,8,4
Moonwater,vashj,765,mage,frost,18,8,10
Rmprmp,tichondrius,764,mage,frost,18,8,10
Nynalith,area-52,764,mage,frost,18,8,10
Snowjôb,illidan,764,mage,frost,24,8,16
Marvelcuck,sargeras,763,mage,frost,12,8,4
Syndra,korialstrasz,763,mage,frost,24,8,16
Frigginbeast,shattered-halls,762,mage,frost,19,8,11
Ashklabam,azralon,761,mage,frost,12,8,4
Ràisens,stormscale,755,mage,frost,12,8,4
Scmage,exodar,755,mage,frost,18,8,10
Queimabixo,azralon,755,mage,frost,18,8,10
Icepickk,blackwater-raiders,752,mage,frost,12,8,4
Ratrider,dreadmaul,752,mage,frost,12,8,4
Hoecakez,tichondrius,749,mage,frost,17,9,8
Artruis,detheroc,748,mage,frost,12,8,4
Bandmaid,emerald-dream,736,mage,frost,16,9,7
Cowwboydan,malganis,735,mage,frost,14,9,5
Phalkore,dalaran,735,mage,frost,16,8,8
Omegablink,sargeras,734,mage,frost,17,8,9
Letitgoo,azralon,733,mage,frost,34,17,17
Silverstrza,gnomeregan,726,mage,frost,18,8,10
Homodilf,blackrock,726,mage,frost,24,9,15
Heca,tichondrius,719,mage,frost,11,8,3
Stankfreezer,thrall,719,mage,frost,11,8,3
Ìgnìtìöñ,whisperwind,718,mage,frost,21,8,13
Triambukh,grizzly-hills,712,mage,frost,25,10,15
Scarlin,proudmoore,703,mage,frost,11,8,3
Lünâliä,bleeding-hollow,686,mage,frost,14,8,6
Proximalol,tichondrius,672,mage,frost,12,7,5
Stinkyblinky,bleeding-hollow,672,mage,frost,12,7,5
Sylendron,area-52,672,mage,frost,12,7,5
Ankidar,quelthalas,672,mage,frost,12,7,5
Neovim,stormrage,672,mage,frost,12,7,5
Kujousara,stormrage,672,mage,frost,12,7,5
Mushys,stormrage,672,mage,frost,12,7,5
Elfvis,deathwing,672,mage,frost,12,7,5
Kogin,thrall,672,mage,frost,12,7,5
Kahve,dalaran,672,mage,frost,12,7,5
Crnomage,area-52,672,mage,frost,12,7,5
Tibbit,kelthuzad,672,mage,frost,12,7,5
Playtimex,proudmoore,672,mage,frost,12,7,5
Reptär,demon-soul,672,mage,frost,12,7,5
Bigchilly,malganis,672,mage,frost,12,7,5
Cädemäddox,stormrage,672,mage,frost,12,7,5
Toteypotter,frostmourne,672,mage,frost,12,7,5
Fakewizard,frostmane,672,mage,frost,12,7,5
Brobo,chogall,672,mage,frost,12,7,5
Versacejay,sargeras,672,mage,frost,12,7,5
Emvepee,sargeras,672,mage,frost,12,7,5
Myfamilygpie,nazgrel,672,mage,frost,12,7,5
Matchstickk,tichondrius,672,mage,frost,15,8,7
Lillb,bleeding-hollow,672,mage,frost,18,7,11
Licklix,tichondrius,672,mage,frost,18,7,11
Privilege,burning-legion,672,mage,frost,18,7,11
Converseqt,stormrage,672,mage,frost,18,7,11
Xàr,ragnaros,672,mage,frost,18,7,11
Arynnwyll,chogall,672,mage,frost,18,7,11
Parapio,tichondrius,672,mage,frost,18,7,11
Riverb,bleeding-hollow,672,mage,frost,18,7,11
Fortemage,tichondrius,672,mage,frost,24,7,17
Ranidos,area-52,671,mage,frost,12,7,5
Tokiaro,tortheldrin,671,mage,frost,12,7,5
Burist,illidan,671,mage,frost,12,7,5
Dairian,whisperwind,671,mage,frost,12,7,5
Blinksz,korgath,671,mage,frost,12,7,5
Nihilitý,malganis,671,mage,frost,12,7,5
Hermiønie,quelthalas,671,mage,frost,12,7,5
Athenaswrath,sargeras,671,mage,frost,12,7,5
Khaziiong,scilla,671,mage,frost,12,7,5
Rekys,black-dragonflight,671,mage,frost,12,7,5
Snoogma,illidan,671,mage,frost,12,7,5
Msspelld,turalyon,671,mage,frost,14,7,7
Nickygift,tichondrius,671,mage,frost,18,7,11
Elemenopi,thrall,671,mage,frost,18,7,11
Tendies,blackwater-raiders,671,mage,frost,18,7,11
Kasparhausar,garithos,671,mage,frost,18,7,11
Oharvestero,illidan,671,mage,frost,18,7,11
Optic,chogall,671,mage,frost,18,7,11
Arendelle,kiljaeden,671,mage,frost,18,7,11
Shãy,area-52,671,mage,frost,18,7,11
Ranje,kiljaeden,670,mage,frost,12,7,5
Perfectpink,bleeding-hollow,670,mage,frost,12,7,5
Tchass,skullcrusher,670,mage,frost,12,7,5
Kidfurry,wyrmrest-accord,670,mage,frost,12,7,5
Plasmah,saurfang,670,mage,frost,12,7,5
Aulie,burning-blade,670,mage,frost,12,7,5
Sparklmotion,cenarius,670,mage,frost,18,7,11
Putosucio,nordrassil,670,mage,frost,18,7,11
Akhilá,stormrage,670,mage,frost,18,7,11
Syura,ragnaros,670,mage,frost,18,7,11
Cäelüm,area-52,670,mage,frost,24,7,17
Criticalness,illidan,669,mage,frost,12,7,5
Banída,stormrage,669,mage,frost,12,7,5
Zould,alleria,669,mage,frost,12,7,5
Havôc,malorne,669,mage,frost,12,7,5
Zalatirix,bleeding-hollow,669,mage,frost,12,7,5
Scorgasm,thrall,669,mage,frost,12,7,5
Shinneex,ragnaros,669,mage,frost,18,7,11
Dchee,nerzhul,669,mage,frost,18,7,11
Trincando,azralon,669,mage,frost,24,7,17
Xarmog,tichondrius,668,mage,frost,24,7,17
Nohealani,dragonmaw,667,mage,frost,15,8,7
Aumar,shandris,665,mage,frost,9,8,1
Evieril,tichondrius,665,mage,frost,12,7,5
Dánó,lightbringer,663,mage,frost,24,7,17
Tigoditties,emerald-dream,662,mage,frost,12,7,5
Deadlysok,barthilas,660,mage,frost,12,7,5
Landard,exodar,659,mage,frost,12,7,5
Magemochi,dalaran,658,mage,frost,12,7,5
Slaash,barthilas,639,mage,frost,14,8,6
Grausum,tichondrius,638,mage,frost,16,7,9
Magusia,emerald-dream,638,mage,frost,17,7,10
Shaynna,tichondrius,624,mage,frost,15,7,8
Leeandroo,quelthalas,623,mage,frost,17,7,10
Ghostblaze,blackhand,621,mage,frost,15,8,7
Krip,boulderfist,608,mage,frost,16,7,9
Ghili,tichondrius,607,mage,frost,11,7,4
Ghrámz,stormrage,607,mage,frost,16,7,9
Ineedashave,shandris,606,mage,frost,20,7,13
Skywarp,blackhand,606,mage,frost,25,7,18
Parruka,warsong,605,mage,frost,26,7,19
Iceqube,drenden,576,mage,frost,6,6,0
Galiax,illidan,576,mage,frost,12,6,6
Vritus,emerald-dream,576,mage,frost,12,6,6
Manadart,quelthalas,576,mage,frost,12,6,6
Magidius,stormrage,576,mage,frost,12,6,6
Wetsocks,alexstrasza,576,mage,frost,12,6,6
Mägë,kirin-tor,576,mage,frost,12,6,6
Johncxvii,sargeras,576,mage,frost,12,6,6
Decady,stormrage,576,mage,frost,12,6,6
Suicune,area-52,576,mage,frost,12,6,6
Celia,area-52,576,mage,frost,12,6,6
Phuzadd,tichondrius,576,mage,frost,12,6,6
Arittamordio,sargeras,576,mage,frost,12,6,6
Vamage,goldrinn,576,mage,frost,12,6,6
Pollylol,proudmoore,576,mage,frost,12,6,6
Winstonchill,zuljin,576,mage,frost,12,6,6
Moogician,aerie-peak,576,mage,frost,12,6,6
Illblink,lightninghoof,576,mage,frost,12,6,6
Ingrumatig,tichondrius,576,mage,frost,12,6,6
Saymenre,tichondrius,576,mage,frost,12,6,6
Dezz,gilneas,576,mage,frost,12,6,6
Angelsarebad,illidan,576,mage,frost,12,6,6
Magemagick,mannoroth,576,mage,frost,12,6,6
Alludèd,illidan,576,mage,frost,12,6,6
Lemonicee,sargeras,576,mage,frost,12,6,6
Bustercraft,kelthuzad,576,mage,frost,18,6,12
Snowybunny,emerald-dream,576,mage,frost,18,6,12
Krazemagi,stormrage,576,mage,frost,18,6,12
Fromcanada,tichondrius,576,mage,frost,18,6,12
Fatalexo,tichondrius,576,mage,frost,18,6,12
Polymorphlol,queldorei,576,mage,frost,24,6,18
Twiztidwitch,burning-legion,576,mage,frost,24,6,18
Bloodpumper,thrall,575,mage,frost,12,6,6
Cosï,ragnaros,575,mage,frost,12,6,6
Casual,arthas,575,mage,frost,12,6,6
Tundraga,malganis,575,mage,frost,12,6,6
Bootygoats,emerald-dream,575,mage,frost,12,6,6
Vocaris,stormrage,575,mage,frost,12,6,6
Baultery,moon-guard,575,mage,frost,12,6,6
Kickpollyplx,lothar,575,mage,frost,12,6,6
Lisaerys,dalaran,575,mage,frost,12,6,6
Smoney,icecrown,575,mage,frost,12,6,6
Dinklord,azuremyst,575,mage,frost,12,6,6
Oogabooga,lethon,575,mage,frost,12,6,6
Rieltar,barthilas,575,mage,frost,18,6,12
Lucidgaze,bonechewer,575,mage,frost,18,6,12
Fabled,stonemaul,575,mage,frost,18,6,12
Snowyj,khaz-modan,575,mage,frost,19,6,13
Millions,jubeithos,575,mage,frost,24,6,18
Irrandina,moon-guard,574,mage,frost,12,6,6
Kalzak,hyjal,574,mage,frost,12,6,6
Kaël,area-52,574,mage,frost,12,6,6
Icetooseeyou,barthilas,574,mage,frost,12,6,6
Lincepotter,quelthalas,574,mage,frost,18,6,12
Tonepedo,zuljin,574,mage,frost,18,6,12
Bartholomew,lothar,574,mage,frost,18,6,12
Harmful,frostmourne,574,mage,frost,18,6,12
Srloko,azralon,574,mage,frost,24,6,18
Josemayer,nemesis,573,mage,frost,12,6,6
Sohotritenow,malganis,573,mage,frost,18,6,12
Litiria,burning-blade,573,mage,frost,18,6,12
Crimpster,illidan,573,mage,frost,24,6,18
Sodrezinn,illidan,571,mage,frost,12,6,6
Monstermage,madoran,571,mage,frost,18,6,12
Eatmyfritter,stonemaul,570,mage,frost,12,6,6
Freyia,mugthol,569,mage,frost,18,6,12
Meliam,tichondrius,557,mage,frost,29,6,23
Casualboy,skullcrusher,527,mage,frost,11,6,5
Ozwauld,emerald-dream,526,mage,frost,11,6,5
Pyromager,thrall,526,mage,frost,11,6,5
Jooss,quelthalas,521,mage,frost,18,7,11
Pidge,aggramar,519,mage,frost,22,6,16
Tatersmaccs,sargeras,517,mage,frost,20,7,13
Emieralol,tichondrius,512,mage,frost,10,6,4
Ereblink,proudmoore,511,mage,frost,11,6,5
Frostytoez,firetree,511,mage,frost,14,6,8
Korisaurus,tichondrius,496,mage,frost,13,6,7
Hansol,farstriders,480,mage,frost,6,5,1
Truemagician,tichondrius,480,mage,frost,6,5,1
Fatamericanx,area-52,480,mage,frost,6,5,1
Elwynnforest,sargeras,480,mage,frost,6,5,1
Buffmages,malfurion,480,mage,frost,6,5,1
Dasanimomo,sargeras,480,mage,frost,6,5,1
Melkdud,wyrmrest-accord,480,mage,frost,6,5,1
Pkf,tichondrius,480,mage,frost,6,5,1
Jooblee,illidan,480,mage,frost,6,5,1
Fromcanadaqc,zuljin,480,mage,frost,6,5,1
Roggitman,emerald-dream,480,mage,frost,6,5,1
Magerat,icecrown,480,mage,frost,6,5,1
Flavaflame,mugthol,480,mage,frost,6,5,1
Jarvase,mugthol,480,mage,frost,10,6,4
Veritas,wildhammer,480,mage,frost,10,6,4
Zime,moon-guard,480,mage,frost,12,5,7
Legendary,deathwing,480,mage,frost,12,5,7
Gadwick,alexstrasza,480,mage,frost,12,5,7
Tëy,zuljin,480,mage,frost,12,5,7
Cinns,moon-guard,480,mage,frost,12,5,7
Polymurph,terenas,480,mage,frost,12,5,7
Foodfish,bleeding-hollow,480,mage,frost,12,5,7
Starguy,terenas,480,mage,frost,12,5,7
Vires,kelthuzad,480,mage,frost,12,5,7
Freezerburnz,illidan,480,mage,frost,12,5,7
Lewpithy,area-52,480,mage,frost,12,5,7
Combustya,khazgoroth,480,mage,frost,12,5,7
Kayenri,area-52,480,mage,frost,12,5,7
Emppty,tichondrius,480,mage,frost,12,5,7
Adronicus,tichondrius,480,mage,frost,12,5,7
Razkall,shattered-hand,480,mage,frost,12,5,7
Hustle,frostmourne,480,mage,frost,12,5,7
Iceyhott,bloodhoof,480,mage,frost,12,5,7
Emelian,barthilas,480,mage,frost,12,5,7
Icetomeetyu,bleeding-hollow,480,mage,frost,12,5,7
Doodledew,bleeding-hollow,480,mage,frost,12,5,7
Triknology,dalaran,480,mage,frost,12,5,7
Houndoôm,hyjal,480,mage,frost,12,5,7
Siobhána,moon-guard,480,mage,frost,12,5,7
Pyrod,tichondrius,480,mage,frost,12,5,7
Maelista,tichondrius,480,mage,frost,12,5,7
Harlloo,the-underbog,480,mage,frost,12,5,7
Isömetrics,tichondrius,480,mage,frost,12,5,7
Nunezz,mannoroth,480,mage,frost,12,5,7
Mcshwackin,area-52,480,mage,frost,12,5,7
Qordix,tichondrius,480,mage,frost,12,5,7
Coolbuts,area-52,480,mage,frost,18,5,13
Dreddpool,barthilas,480,mage,frost,18,5,13
Kutulu,aerie-peak,480,mage,frost,18,5,13
Icebish,skullcrusher,480,mage,frost,18,5,13
Artty,velen,480,mage,frost,18,5,13
Mikwam,proudmoore,479,mage,frost,6,5,1
Piixxiie,sargeras,479,mage,frost,6,5,1
Diabølcangel,malganis,479,mage,frost,12,5,7
Cezax,frostmourne,479,mage,frost,12,5,7
Inumano,laughing-skull,479,mage,frost,12,5,7
Odinzz,azralon,479,mage,frost,12,5,7
Loa,hydraxis,479,mage,frost,12,5,7
Dimmershnitz,draka,479,mage,frost,12,5,7
Brokser,quelthalas,479,mage,frost,12,5,7
Icesickle,barthilas,479,mage,frost,12,5,7
Phazora,suramar,479,mage,frost,12,5,7
Raynark,nemesis,479,mage,frost,12,5,7
Grimreefer,trollbane,479,mage,frost,12,5,7
Dwazam,lothar,479,mage,frost,12,5,7
Kpoppin,stormrage,479,mage,frost,12,5,7
Paintsicle,thunderlord,479,mage,frost,12,5,7
Hugadoug,zuljin,479,mage,frost,24,5,19
Asthar,ursin,479,mage,frost,24,5,19
Suprido,illidan,478,mage,frost,15,6,9
Babbushka,thrall,478,mage,frost,18,5,13
Magodelphi,azralon,477,mage,frost,6,5,1
Ehduh,onyxia,477,mage,frost,12,5,7
Rawrxd,kiljaeden,477,mage,frost,12,5,7
Colddevil,hyjal,476,mage,frost,19,5,14
Spazzticblur,frostwolf,473,mage,frost,12,5,7
Claddagh,kelthuzad,473,mage,frost,12,5,7
Polyblart,hyjal,446,mage,frost,10,6,4
Barkäi,ragnaros,432,mage,frost,15,5,10
Cerisium,kiljaeden,431,mage,frost,11,5,6
Summey,tichondrius,431,mage,frost,11,5,6
Aggrosheep,tichondrius,416,mage,frost,10,5,5
Quinnfreeze,boulderfist,414,mage,frost,11,5,6
Powder,lightninghoof,400,mage,frost,15,7,8
Mèduså,tichondrius,384,mage,frost,6,4,2
Myrondor,tichondrius,384,mage,frost,6,4,2
Danbì,ragnaros,384,mage,frost,6,4,2
Fromcanadaqc,tichondrius,384,mage,frost,6,4,2
Frobo,mannoroth,384,mage,frost,6,4,2
Çhíllßrõ,tichondrius,384,mage,frost,6,4,2
Cewchí,tichondrius,384,mage,frost,6,4,2
Finnese,medivh,384,mage,frost,6,4,2
Frostkage,tichondrius,384,mage,frost,6,4,2
Poonfarmer,zangarmarsh,384,mage,frost,6,4,2
Neverbroke,illidan,384,mage,frost,6,4,2
Hocusjokus,frostmourne,384,mage,frost,6,4,2
Balencii,kiljaeden,384,mage,frost,6,4,2
Pew,dathremar,384,mage,frost,6,4,2
Unlike,sargeras,384,mage,frost,6,4,2
Udmx,zuljin,384,mage,frost,6,4,2
Frostedtips,hakkar,384,mage,frost,6,4,2
Lohkey,darkspear,384,mage,frost,6,4,2
Voiddude,proudmoore,384,mage,frost,6,4,2
Kälis,zuljin,384,mage,frost,6,4,2
Schwab,warsong,384,mage,frost,6,4,2
Jamesper,tichondrius,384,mage,frost,6,4,2
Sydne,ysera,384,mage,frost,6,4,2
Azraël,zuljin,384,mage,frost,6,4,2
Turbobones,tichondrius,384,mage,frost,6,4,2
Arkane,barthilas,384,mage,frost,6,4,2
Marfaz,ravencrest,384,mage,frost,6,4,2
Belven,proudmoore,384,mage,frost,6,4,2
Pzaz,moon-guard,384,mage,frost,6,4,2
Froznpizza,zuljin,384,mage,frost,6,4,2
Zolix,malganis,384,mage,frost,6,4,2
Dashdoor,stormrage,384,mage,frost,6,4,2
Variex,tichondrius,384,mage,frost,6,4,2
Zokorzik,area-52,384,mage,frost,6,4,2
Legelance,malganis,384,mage,frost,6,4,2
Lampert,tichondrius,384,mage,frost,6,4,2
Gai,lightnings-blade,384,mage,frost,6,4,2
Polymedaddi,tichondrius,384,mage,frost,6,4,2
Zgodspeedz,stormrage,384,mage,frost,6,4,2
Frðstítutè,tichondrius,384,mage,frost,6,4,2
Vixm,stormrage,384,mage,frost,6,4,2
Ratfather,the-forgotten-coast,384,mage,frost,6,4,2
Aigam,hyjal,384,mage,frost,6,4,2
Gnomoguapo,altar-of-storms,384,mage,frost,6,4,2
Expozed,icecrown,384,mage,frost,6,4,2
Nexttmage,area-52,384,mage,frost,12,4,8
Slurpey,moon-guard,384,mage,frost,12,4,8
Percivaltp,scarlet-crusade,384,mage,frost,12,4,8
Slot,kirin-tor,384,mage,frost,12,4,8
Meduka,proudmoore,384,mage,frost,12,4,8
Badaszbich,tichondrius,384,mage,frost,12,4,8
Novokaine,area-52,384,mage,frost,12,4,8
Timêrmórk,kalecgos,384,mage,frost,12,4,8
Fishfood,bleeding-hollow,384,mage,frost,12,4,8
Yeuxbleus,tichondrius,384,mage,frost,12,4,8
Bluedustfart,illidan,384,mage,frost,12,4,8
Oneminute,tichondrius,384,mage,frost,12,4,8
Caseyjelly,tichondrius,384,mage,frost,12,4,8
Wuzzo,tichondrius,384,mage,frost,12,4,8
Splocke,azralon,384,mage,frost,12,4,8
Coldcaster,mugthol,384,mage,frost,12,4,8
Horizons,moon-guard,384,mage,frost,12,4,8
Darthez,darkspear,384,mage,frost,12,4,8
Hemm,nemesis,384,mage,frost,12,4,8
Natashaeb,wyrmrest-accord,384,mage,frost,12,4,8
Xenagozs,antonidas,384,mage,frost,12,4,8
Yippmagus,area-52,384,mage,frost,12,4,8
Aangx,stormrage,384,mage,frost,12,4,8
Perkaset,turalyon,384,mage,frost,12,4,8
Îùx,stormrage,384,mage,frost,12,4,8
Arcanatos,emerald-dream,384,mage,frost,12,4,8
Gemaicy,sargeras,384,mage,frost,12,4,8
Dallamar,frostwolf,384,mage,frost,12,4,8
Stefan,malganis,384,mage,frost,12,4,8
Themageguy,eitrigg,384,mage,frost,12,4,8
Fantabulous,korgath,384,mage,frost,14,4,10
Astería,ragnaros,384,mage,frost,14,4,10
Snanth,black-dragonflight,384,mage,frost,18,4,14
Fullmetal,jaedenar,384,mage,frost,18,4,14
Rolypolyman,tichondrius,384,mage,frost,24,4,20
Billionnaire,tichondrius,383,mage,frost,6,4,2
Robinesque,moon-guard,383,mage,frost,12,4,8
Cynafox,moon-guard,383,mage,frost,12,4,8
Surrsly,tortheldrin,383,mage,frost,12,4,8
Undersky,tichondrius,383,mage,frost,12,4,8
Abstractgoat,tichondrius,383,mage,frost,12,4,8
Skazzbomb,nerzhul,383,mage,frost,12,4,8
Preckwinkle,moon-guard,383,mage,frost,14,4,10
Kuni,ghostlands,382,mage,frost,12,4,8
Brezman,tichondrius,382,mage,frost,12,4,8
Georgez,ragnaros,382,mage,frost,20,4,16
Zoninsasseo,tichondrius,381,mage,frost,12,4,8
Killerflaco,drakkari,381,mage,frost,24,4,20
Eirwan,illidan,379,mage,frost,12,4,8
Alfaflux,nemesis,366,mage,frost,17,4,13
Eanur,azralon,352,mage,frost,16,4,12
Lirahmi,quelthalas,351,mage,frost,17,4,13
Freezeup,area-52,349,mage,frost,14,7,7
Titsncoke,proudmoore,336,mage,frost,9,4,5
Jizzlez,tichondrius,335,mage,frost,11,4,7
Coldrin,tichondrius,330,mage,frost,15,5,10
Devkek,area-52,330,mage,frost,22,7,15
Icëblöck,ysera,329,mage,frost,6,5,1
Lezafort,area-52,320,mage,frost,16,4,12
Crøwgawd,tichondrius,304,mage,frost,7,4,3
Frostyßamf,kiljaeden,288,mage,frost,6,3,3
Illúmi,moon-guard,288,mage,frost,6,3,3
Kqlyy,tichondrius,288,mage,frost,6,3,3
Cruxx,ragnaros,288,mage,frost,6,3,3
Killemz,dragonmaw,288,mage,frost,6,3,3
Léras,stormrage,288,mage,frost,6,3,3
Baybespice,malganis,288,mage,frost,6,3,3
Nofoodforu,thrall,288,mage,frost,6,3,3
Tessarìon,tichondrius,288,mage,frost,6,3,3
Felsparkles,area-52,288,mage,frost,6,3,3
Shiryu,thrall,288,mage,frost,6,3,3
Feldt,korgath,288,mage,frost,6,3,3
Betaduck,bleeding-hollow,288,mage,frost,6,3,3
Bønemage,azralon,288,mage,frost,6,3,3
Benisp,stormrage,288,mage,frost,6,3,3
Índís,ragnaros,288,mage,frost,6,3,3
Morti,sargeras,288,mage,frost,6,3,3
Hýdro,ghostlands,288,mage,frost,6,3,3
Simpleorz,tichondrius,288,mage,frost,6,3,3
Lunchfirst,tichondrius,288,mage,frost,6,3,3
Abruaa,area-52,288,mage,frost,6,3,3
Murcury,tichondrius,288,mage,frost,6,3,3
Chriglol,black-dragonflight,288,mage,frost,6,3,3
Captncold,area-52,288,mage,frost,6,3,3
Blâzer,nazjatar,288,mage,frost,6,3,3
Clerene,area-52,288,mage,frost,6,3,3
Honchó,velen,288,mage,frost,6,3,3
Kryptekk,area-52,288,mage,frost,6,3,3
Undeadmerlin,zuljin,288,mage,frost,6,3,3
Jaklinburton,stormrage,288,mage,frost,6,3,3
Fredcouples,tichondrius,288,mage,frost,6,3,3
Dotznsheep,zuljin,288,mage,frost,6,3,3
Zukoprince,azralon,288,mage,frost,6,3,3
Címegripe,stormrage,288,mage,frost,6,3,3
Whøîsýoû,kelthuzad,288,mage,frost,6,3,3
Gpie,jubeithos,288,mage,frost,6,3,3
Wabï,tichondrius,288,mage,frost,6,3,3
Urbadxd,llane,288,mage,frost,6,3,3
Tasarion,mannoroth,288,mage,frost,6,3,3
Krililin,stormrage,288,mage,frost,6,3,3
Ariezx,kelthuzad,288,mage,frost,6,3,3
Mäz,malorne,288,mage,frost,6,3,3
Midmage,tichondrius,288,mage,frost,6,3,3
Natallyn,stormrage,288,mage,frost,6,3,3
Grawmp,thunderlord,288,mage,frost,6,3,3
Isuikido,nemesis,288,mage,frost,6,3,3
Pyroseraph,bleeding-hollow,288,mage,frost,6,3,3
Ellywizzle,tichondrius,288,mage,frost,6,3,3
Lilsake,sargeras,288,mage,frost,6,3,3
Gadalka,frostmourne,288,mage,frost,6,3,3
Coneofkony,bleeding-hollow,288,mage,frost,6,3,3
Murderlin,tichondrius,288,mage,frost,6,3,3
Atwyxn,illidan,288,mage,frost,6,3,3
Diminisher,agamaggan,288,mage,frost,6,3,3
Nalla,nerzhul,288,mage,frost,6,3,3
Dersão,azralon,288,mage,frost,6,3,3
Dragonie,nordrassil,288,mage,frost,6,3,3
Dìus,malganis,288,mage,frost,6,3,3
Quinnc,tichondrius,288,mage,frost,6,3,3
Gobstpper,nagrand,288,mage,frost,6,3,3
Coldkite,tichondrius,288,mage,frost,6,3,3
Aurumium,illidan,288,mage,frost,6,3,3
Packaged,emerald-dream,288,mage,frost,6,3,3
Personah,darkspear,288,mage,frost,6,3,3
Toastmg,tichondrius,288,mage,frost,6,3,3
Oomoo,malganis,288,mage,frost,6,3,3
Eraticmage,illidan,288,mage,frost,6,3,3
Whatthesheep,sargeras,288,mage,frost,6,3,3
Magicianqt,tichondrius,288,mage,frost,6,3,3
Orangemilk,hyjal,288,mage,frost,6,3,3
Centrika,emerald-dream,288,mage,frost,6,3,3
Combusty,sargeras,288,mage,frost,6,3,3
Cbm,dalaran,288,mage,frost,6,3,3
Frostytits,spirestone,288,mage,frost,6,3,3
Trozkov,dalaran,288,mage,frost,6,3,3
Botoslàp,dragonmaw,288,mage,frost,6,3,3
Icecreamboy,tichondrius,288,mage,frost,6,3,3
Thxo,hyjal,288,mage,frost,6,3,3
Dcup,quelthalas,288,mage,frost,6,3,3
Faeylyn,stormrage,288,mage,frost,9,4,5
Etyx,tichondrius,288,mage,frost,10,4,6
Rabeiro,tichondrius,288,mage,frost,12,3,9
Worldonfire,ragnaros,288,mage,frost,12,3,9
Linadeslayer,chogall,288,mage,frost,12,3,9
Littleguzto,garrosh,288,mage,frost,12,3,9
Argyron,fizzcrank,288,mage,frost,12,3,9
Hozlu,kiljaeden,288,mage,frost,12,3,9
Grynthwzrd,stormrage,288,mage,frost,12,3,9
Calcaster,aegwynn,288,mage,frost,12,3,9
Castermuffin,stormrage,288,mage,frost,12,3,9
Stormfrieza,tichondrius,288,mage,frost,12,3,9
Fingeredx,zuljin,288,mage,frost,12,3,9
Draell,drakkari,288,mage,frost,12,3,9
Ezchallenger,undermine,288,mage,frost,12,3,9
Steefers,arygos,288,mage,frost,12,3,9
Bootyclapper,shadowmoon,288,mage,frost,12,3,9
Nøzotica,kelthuzad,288,mage,frost,12,3,9
Albbano,tichondrius,288,mage,frost,12,3,9
Maagão,azralon,288,mage,frost,12,3,9
Hqscoltt,azralon,288,mage,frost,12,3,9
Kaïdis,nemesis,288,mage,frost,12,3,9
Aderia,gorefiend,288,mage,frost,12,3,9
Vyyp,echo-isles,288,mage,frost,12,3,9
Technique,tichondrius,288,mage,frost,12,3,9
Failzy,darkspear,288,mage,frost,12,3,9
Houdiinii,illidan,288,mage,frost,12,3,9
Anuub,kelthuzad,288,mage,frost,12,3,9
Sukaretto,illidan,288,mage,frost,12,3,9
Jimmygibbler,illidan,288,mage,frost,12,3,9
Frostcakes,quelthalas,288,mage,frost,12,3,9
Gattmage,illidan,288,mage,frost,12,3,9
Radakos,emerald-dream,288,mage,frost,12,3,9
Tamarolfrost,illidan,288,mage,frost,12,3,9
Tracemaker,emerald-dream,288,mage,frost,18,3,15
Exonerate,mannoroth,288,mage,frost,18,3,15
Wawakun,ragnaros,287,mage,frost,6,3,3
Gufi,drakkari,287,mage,frost,6,3,3
Clausolas,ragnaros,287,mage,frost,6,3,3
Applemage,ragnaros,287,mage,frost,6,3,3
Magotom,ragnaros,287,mage,frost,6,3,3
Pyromaster,emerald-dream,287,mage,frost,6,3,3
Cölossus,gorefiend,287,mage,frost,6,3,3
Shimotama,malganis,287,mage,frost,6,3,3
Icehero,tichondrius,287,mage,frost,6,3,3
Merlinaa,ragnaros,287,mage,frost,10,3,7
Taevy,tichondrius,256,mage,frost,10,3,7
Chuekona,ragnaros,256,mage,frost,10,3,7
Magemoney,area-52,239,mage,frost,5,3,2
Unydae,frostmourne,239,mage,frost,5,3,2
Drewann,draenor,239,mage,frost,5,3,2
Arielak,kelthuzad,239,mage,frost,5,3,2
Cheyz,onyxia,239,mage,frost,5,3,2
Itsoveryo,jubeithos,239,mage,frost,11,3,8
Kizran,frostmourne,239,mage,frost,11,3,8
Gtown,kelthuzad,234,mage,frost,11,4,7
Skerei,azralon,234,mage,frost,19,4,15
Brôcolîni,zuljin,233,mage,frost,11,4,7
Ophian,shattered-hand,222,mage,frost,8,3,5
Rayricefan,blood-furnace,192,mage,frost,4,3,1
Onioneyes,area-52,192,mage,frost,4,3,1
Shahnazz,darkspear,192,mage,frost,8,3,5
Gradmage,proudmoore,192,mage,frost,6,2,4
Muskybiggie,bleeding-hollow,192,mage,frost,6,2,4
Weedzird,thrall,192,mage,frost,6,2,4
Xü,stormrage,192,mage,frost,6,2,4
Slymage,illidan,192,mage,frost,6,2,4
Duwapkaine,sargeras,192,mage,frost,6,2,4
Quesomancer,illidan,192,mage,frost,6,2,4
Shivamode,thrall,192,mage,frost,6,2,4
Elvin,frostmourne,192,mage,frost,6,2,4
Roarly,stonemaul,192,mage,frost,6,2,4
Undeadmager,nerzhul,192,mage,frost,6,2,4
Wïzarduous,mannoroth,192,mage,frost,6,2,4
Ryusuke,thrall,192,mage,frost,6,2,4
Getmaged,bleeding-hollow,192,mage,frost,6,2,4
Biillionaire,frostmourne,192,mage,frost,6,2,4
Lilbabyx,stormrage,192,mage,frost,6,2,4
Uhh,blackrock,192,mage,frost,6,2,4
Sparqablink,tichondrius,192,mage,frost,6,2,4
Mager,dentarg,192,mage,frost,6,2,4
Halimage,zuljin,192,mage,frost,6,2,4
Vailor,whisperwind,192,mage,frost,6,2,4
Massivepoo,barthilas,192,mage,frost,6,2,4
Kammany,thrall,192,mage,frost,6,2,4
Afknz,frostmourne,192,mage,frost,6,2,4
Bluishhue,thrall,192,mage,frost,6,2,4
Arkuran,proudmoore,192,mage,frost,6,2,4
Cantblocklul,baelgun,192,mage,frost,6,2,4
Tanedos,tichondrius,192,mage,frost,6,2,4
Gattî,tichondrius,192,mage,frost,6,2,4
Gusmaged,stormrage,192,mage,frost,6,2,4
Iguanodon,proudmoore,192,mage,frost,6,2,4
Jurgers,tichondrius,192,mage,frost,6,2,4
Raidem,dalaran,192,mage,frost,6,2,4
Westii,illidan,192,mage,frost,6,2,4
Karameltart,barthilas,192,mage,frost,6,2,4
Duhquarius,warsong,192,mage,frost,6,2,4
Blînxx,bleeding-hollow,192,mage,frost,6,2,4
Aeroclouda,stormrage,192,mage,frost,6,2,4
Avicci,shattered-halls,192,mage,frost,6,2,4
Khaosflare,stormrage,192,mage,frost,6,2,4
Indignatio,arthas,192,mage,frost,6,2,4
Earff,kiljaeden,192,mage,frost,6,2,4
Herzthroh,stormrage,192,mage,frost,6,2,4
Magegpt,illidan,192,mage,frost,6,2,4
Korky,dalvengyr,192,mage,frost,6,2,4
Drewzz,tichondrius,192,mage,frost,6,2,4
Magickus,korgath,192,mage,frost,6,2,4
Choctøp,frostmourne,192,mage,frost,6,2,4
Echoz,frostmourne,192,mage,frost,6,2,4
Vortex,fenris,192,mage,frost,6,2,4
Viccluvin,stormrage,192,mage,frost,6,2,4
Fleët,tichondrius,192,mage,frost,6,2,4
Kzm,illidan,192,mage,frost,6,2,4
Stìnkfîst,tichondrius,192,mage,frost,6,2,4
Makius,area-52,192,mage,frost,6,2,4
Airsickjet,kiljaeden,192,mage,frost,6,2,4
Cradic,tichondrius,192,mage,frost,6,2,4
Whiteyx,saurfang,192,mage,frost,6,2,4
Wanming,tichondrius,192,mage,frost,6,2,4
Jainamommy,emerald-dream,192,mage,frost,6,2,4
Kevinfan,area-52,192,mage,frost,6,2,4
Fïtz,quelthalas,192,mage,frost,6,2,4
Thebrain,twisting-nether,192,mage,frost,6,2,4
Ess,tichondrius,192,mage,frost,6,2,4
Mageethot,moon-guard,192,mage,frost,6,2,4
Firehawk,azralon,192,mage,frost,6,2,4
Smók,ragnaros,192,mage,frost,6,2,4
Sahaquiel,tichondrius,192,mage,frost,6,2,4
Rapidmage,malganis,192,mage,frost,6,2,4
Magika,area-52,192,mage,frost,6,2,4
Anyahs,tichondrius,192,mage,frost,6,2,4
Elhechizero,quelthalas,192,mage,frost,6,2,4
Crazytime,tichondrius,192,mage,frost,6,2,4
Kârén,aggramar,192,mage,frost,6,2,4
Pyröz,kelthuzad,192,mage,frost,6,2,4
Strêss,kelthuzad,192,mage,frost,6,2,4
Wyss,azralon,192,mage,frost,6,2,4
Ayci,velen,192,mage,frost,6,2,4
Magiaguarra,ragnaros,192,mage,frost,6,2,4
Nachtt,sargeras,192,mage,frost,6,2,4
Cottonmage,malganis,192,mage,frost,6,2,4
Audacy,sargeras,192,mage,frost,6,2,4
Xar,guldan,192,mage,frost,6,2,4
Sophrates,burning-blade,192,mage,frost,6,2,4
Maxvila,kelthuzad,192,mage,frost,6,2,4
Urmagesty,daggerspine,192,mage,frost,6,2,4
Chelseâ,emerald-dream,192,mage,frost,6,2,4
Vallfire,malganis,192,mage,frost,6,2,4
Myzzl,kelthuzad,192,mage,frost,6,2,4
Clickhard,suramar,192,mage,frost,9,2,7
Mendittorosa,tichondrius,192,mage,frost,12,2,10
Alode,moon-guard,192,mage,frost,12,2,10
Dashonthany,arthas,192,mage,frost,12,2,10
Joare,area-52,192,mage,frost,12,2,10
Ironwolft,tichondrius,192,mage,frost,12,2,10
Hositonet,malganis,192,mage,frost,12,2,10
Kinrow,stormrage,192,mage,frost,12,2,10
Lemmepoly,illidan,192,mage,frost,12,2,10
Excentral,tichondrius,192,mage,frost,12,2,10
Rán,spirestone,192,mage,frost,12,2,10
Shwack,boulderfist,192,mage,frost,12,2,10
Eretik,ragnaros,192,mage,frost,12,2,10
Zerg,fenris,192,mage,frost,12,2,10
Zyzzmirin,barthilas,192,mage,frost,12,2,10
Èvilmage,blackrock,192,mage,frost,12,2,10
Mônstâ,thrall,192,mage,frost,12,2,10
Boxslinger,illidan,192,mage,frost,12,2,10
Molassess,illidan,192,mage,frost,12,2,10
Adxion,quelthalas,192,mage,frost,12,2,10
Dylanpickles,darkspear,192,mage,frost,12,2,10
Wqnmlgbdy,tichondrius,192,mage,frost,18,2,16
Kahldyn,stormrage,191,mage,frost,4,3,1
Pândàfæçé,ghostlands,191,mage,frost,4,3,1
Bittérs,tichondrius,191,mage,frost,6,2,4
Alladen,anubarak,191,mage,frost,6,2,4
Blync,emerald-dream,191,mage,frost,6,2,4
Stillborn,lethon,191,mage,frost,6,2,4
Hense,stormrage,191,mage,frost,6,2,4
Renthalar,area-52,191,mage,frost,18,2,16
Cheapped,emerald-dream,175,mage,frost,6,3,3
Spellsurg,malganis,175,mage,frost,11,2,9
Blakus,tichondrius,159,mage,frost,6,3,3
Frosteddiks,shattered-halls,159,mage,frost,5,2,3
Wizzyx,illidan,159,mage,frost,5,2,3
Csx,turalyon,144,mage,frost,3,3,0
Noyade,illidan,144,mage,frost,9,2,7
Erudit,tichondrius,144,mage,frost,15,2,13
Shardgodx,kelthuzad,138,mage,frost,8,4,4
Idamnedu,crushridge,128,mage,frost,4,2,2
Firèballin,tichondrius,128,mage,frost,4,2,2
Máximus,illidan,128,mage,frost,4,2,2
Goingmassive,frostmourne,127,mage,frost,4,2,2
Proviet,frostmourne,127,mage,frost,8,2,6
Thebraveonee,frostmourne,126,mage,frost,8,2,6
Sillycole,emerald-dream,96,mage,frost,3,2,1
Thôrsena,ursin,96,mage,frost,3,2,1
Quickwizard,tichondrius,96,mage,frost,6,1,5
Ricter,hyjal,96,mage,frost,6,1,5
Ogfresh,area-52,96,mage,frost,6,1,5
Geekm,frostmourne,96,mage,frost,6,1,5
Tmi,darkspear,96,mage,frost,6,1,5
Trevihl,malganis,96,mage,frost,6,1,5
Gnòmêrcy,kelthuzad,96,mage,frost,6,1,5
Freezze,malganis,96,mage,frost,6,1,5
Mastacombust,illidan,96,mage,frost,6,1,5
Mïzzfreeze,haomarush,96,mage,frost,6,1,5
Professor,khadgar,96,mage,frost,6,1,5
Ëfc,nemesis,96,mage,frost,6,1,5
Yeonmok,tichondrius,96,mage,frost,6,1,5
Kaoz,emerald-dream,96,mage,frost,6,1,5
Neverworks,tichondrius,96,mage,frost,6,1,5
Furrblock,tichondrius,96,mage,frost,6,1,5
Soulbite,barthilas,96,mage,frost,6,1,5
Fadedfire,area-52,96,mage,frost,6,1,5
Truewinter,tichondrius,96,mage,frost,6,1,5
Åpollous,frostmourne,96,mage,frost,6,1,5
Sky,lightnings-blade,96,mage,frost,6,1,5
Fookz,malganis,96,mage,frost,6,1,5
Kattyy,drakkari,96,mage,frost,6,1,5
Kbola,tichondrius,96,mage,frost,6,1,5
Oring,tichondrius,96,mage,frost,6,1,5
Pirne,executus,96,mage,frost,6,1,5
Aerodynamiq,area-52,96,mage,frost,6,1,5
Ñõxx,sargeras,96,mage,frost,6,1,5
Scarrgon,wyrmrest-accord,96,mage,frost,6,1,5
Twizzlerz,executus,96,mage,frost,6,1,5
Daêgon,area-52,96,mage,frost,6,1,5
Pikoda,azralon,96,mage,frost,6,1,5
Dathoe,laughing-skull,96,mage,frost,6,1,5
Heztus,area-52,96,mage,frost,6,1,5
Muskinite,maiev,96,mage,frost,6,1,5
Pyrofrost,stonemaul,96,mage,frost,6,1,5
Oab,proudmoore,96,mage,frost,6,1,5
Naviator,tichondrius,96,mage,frost,6,1,5
Braelynn,frostwolf,96,mage,frost,6,1,5
Ârcano,ragnaros,96,mage,frost,6,1,5
Thewizârd,stormrage,96,mage,frost,6,1,5
Magicdro,scilla,96,mage,frost,6,1,5
Magicmom,wyrmrest-accord,96,mage,frost,6,1,5
Beerandmagic,zuljin,96,mage,frost,6,1,5
Gíldrin,proudmoore,96,mage,frost,6,1,5
Thiccness,hydraxis,96,mage,frost,6,1,5
Ichirou,stormrage,96,mage,frost,6,1,5
Coolhandz,tichondrius,96,mage,frost,6,1,5
Michaelbust,tichondrius,96,mage,frost,6,1,5
Damadness,kiljaeden,96,mage,frost,6,1,5
Loopsyliu,stormrage,96,mage,frost,6,1,5
Pblastdatass,stormrage,96,mage,frost,6,1,5
Absentbrain,stormrage,96,mage,frost,6,1,5
Hruine,chogall,96,mage,frost,6,1,5
Adrazell,sargeras,96,mage,frost,6,1,5
Majx,eldrethalas,96,mage,frost,6,1,5
Themose,sargeras,96,mage,frost,6,1,5
Taladas,suramar,96,mage,frost,12,1,11
Pyrophobia,mannoroth,96,mage,frost,12,1,11
Carmile,azralon,96,mage,frost,12,1,11
Bøndu,zuljin,96,mage,frost,12,1,11
Vensyr,stormrage,96,mage,frost,12,1,11
Tema,daggerspine,96,mage,frost,12,1,11
Jmanpk,stormrage,96,mage,frost,12,1,11
Badiatorr,alterac-mountains,96,mage,frost,12,1,11
Ldc,kelthuzad,96,mage,frost,12,1,11
Zei,bleeding-hollow,96,mage,frost,12,1,11
Voxbluvine,hakkar,96,mage,frost,18,1,17
Icemaker,destromath,95,mage,frost,18,1,17
Notria,illidan,79,mage,frost,5,1,4
Huaerfei,thunderlord,79,mage,frost,5,1,4
Ventiarcana,area-52,79,mage,frost,5,1,4
Buckybever,illidan,79,mage,frost,11,1,10
Frostybihh,bonechewer,64,mage,frost,4,1,3
Unclekyle,skullcrusher,48,mage,frost,3,1,2
Lv,stormscale,48,mage,frost,9,1,8
Jiblemynippl,illidan,42,mage,frost,7,2,5
Kushjointz,tichondrius,42,mage,frost,11,3,8
Fizzlepops,kiljaeden,31,mage,frost,2,1,1
Dãnwun,tichondrius,2284,monk,mistweaver,102,63,39
Sharkpiggie,illidan,2283,monk,mistweaver,102,66,36
Akkiraa,sargeras,2283,monk,mistweaver,95,60,35
Meepmonk,tichondrius,2283,monk,mistweaver,102,64,38
Dannycarey,tichondrius,2278,monk,mistweaver,78,55,23
Garbagemonk,scilla,2277,monk,mistweaver,191,120,71
Woezx,stormreaver,2264,monk,mistweaver,68,47,21
Mysticallx,sargeras,2259,monk,mistweaver,84,53,31
Linlol,tichondrius,2257,monk,mistweaver,478,278,200
Akkiira,sargeras,2229,monk,mistweaver,114,64,50
Raddxd,illidan,2227,monk,mistweaver,95,64,31
Mãsterpõ,tichondrius,2227,monk,mistweaver,313,170,143
Weavied,sargeras,2215,monk,mistweaver,156,84,72
Stinkycok,tichondrius,2214,monk,mistweaver,84,54,30
Zenjj,thorium-brotherhood,2211,monk,mistweaver,170,99,71
Sharkpiglet,illidan,2201,monk,mistweaver,156,97,59
Boogstyle,malganis,2201,monk,mistweaver,142,81,61
Jep,tichondrius,2190,monk,mistweaver,144,91,53
Vaen,kelthuzad,2173,monk,mistweaver,102,61,41
Pragma,kiljaeden,2168,monk,mistweaver,84,53,31
Ðrägønéyèz,malygos,2168,monk,mistweaver,211,119,92
Cool,crushridge,2167,monk,mistweaver,126,75,51
Dowsk,tichondrius,2162,monk,mistweaver,105,63,42
Idiotgriefer,tichondrius,2160,monk,mistweaver,78,48,30
Emoeres,kelthuzad,2151,monk,mistweaver,104,55,49
Flarks,area-52,2151,monk,mistweaver,155,80,75
Moonym,nagrand,2144,monk,mistweaver,80,48,32
Oblivæon,tichondrius,2143,monk,mistweaver,72,45,27
Sloppyroppy,tichondrius,2143,monk,mistweaver,107,62,45
Oliveirarr,tichondrius,2143,monk,mistweaver,174,95,79
Dro,khadgar,2141,monk,mistweaver,66,39,27
Vramonk,area-52,2141,monk,mistweaver,115,64,51
Moremoretea,tichondrius,2140,monk,mistweaver,87,53,34
Illify,tichondrius,2139,monk,mistweaver,66,52,14
Cuteballs,tichondrius,2138,monk,mistweaver,81,50,31
Oldmanswirl,mugthol,2137,monk,mistweaver,90,54,36
Crunchyrollx,tichondrius,2135,monk,mistweaver,66,49,17
Xeus,darkspear,2133,monk,mistweaver,60,38,22
Jetnoob,sargeras,2132,monk,mistweaver,120,66,54
Parodies,illidan,2131,monk,mistweaver,103,53,50
Nfm,cairne,2130,monk,mistweaver,215,123,92
Woggitie,jubeithos,2129,monk,mistweaver,68,45,23
Igriefidiots,tichondrius,2129,monk,mistweaver,71,40,31
Ringofpeace,sargeras,2128,monk,mistweaver,60,40,20
Griefgodx,tichondrius,2127,monk,mistweaver,88,49,39
Wheatsli,malganis,2126,monk,mistweaver,138,81,57
Taichí,tichondrius,2123,monk,mistweaver,207,111,96
Canghaigg,tichondrius,2122,monk,mistweaver,150,94,56
Timermørk,kalecgos,2122,monk,mistweaver,139,86,53
Purgenm,tichondrius,2122,monk,mistweaver,90,52,38
Slunka,tichondrius,2121,monk,mistweaver,72,42,30
Hernameplz,proudmoore,2120,monk,mistweaver,153,82,71
Secdog,tichondrius,2118,monk,mistweaver,84,44,40
Yogapantsx,nerzhul,2116,monk,mistweaver,80,44,36
Kicub,emerald-dream,2115,monk,mistweaver,84,44,40
Itzokinlol,malganis,2113,monk,mistweaver,114,70,44
Firewatches,emerald-dream,2113,monk,mistweaver,72,42,30
Tekuto,tichondrius,2112,monk,mistweaver,174,109,65
Moldboy,area-52,2112,monk,mistweaver,75,45,30
Nezly,sargeras,2112,monk,mistweaver,138,71,67
Sintifissti,sargeras,2111,monk,mistweaver,62,41,21
Wolf,shattered-hand,2111,monk,mistweaver,60,36,24
Ccain,stormrage,2111,monk,mistweaver,145,78,67
Yangroumo,tichondrius,2110,monk,mistweaver,131,78,53
Gsdfjskpx,sargeras,2107,monk,mistweaver,306,165,141
Gameníne,tichondrius,2103,monk,mistweaver,72,42,30
Millé,frostmourne,2102,monk,mistweaver,84,52,32
Waggìes,moon-guard,2101,monk,mistweaver,83,50,33
Melonmuncher,duskwood,2101,monk,mistweaver,135,79,56
Heywhatsup,emerald-dream,2097,monk,mistweaver,102,50,52
Vaemonka,stormrage,2091,monk,mistweaver,219,127,92
Proghouse,illidan,2089,monk,mistweaver,90,47,43
Canghaimonk,tichondrius,2082,monk,mistweaver,166,87,79
Elvenmonk,frostmane,2080,monk,mistweaver,72,44,28
Hydroz,dethecus,2080,monk,mistweaver,101,56,45
Natalié,caelestrasz,2079,monk,mistweaver,96,58,38
Furiousfrank,stormrage,2079,monk,mistweaver,108,64,44
Drracaryss,sargeras,2060,monk,mistweaver,203,125,78
Strugglebus,sargeras,2056,monk,mistweaver,42,31,11
Glqjkglbfgdl,zuljin,2053,monk,mistweaver,156,86,70
Pandacottoca,azralon,2048,monk,mistweaver,108,73,35
Huaren,tichondrius,2048,monk,mistweaver,137,78,59
Breadweaver,malganis,2046,monk,mistweaver,96,47,49
Wagfu,moon-guard,2045,monk,mistweaver,70,40,30
Zuhak,tichondrius,2043,monk,mistweaver,96,54,42
Thèwy,tichondrius,2041,monk,mistweaver,71,45,26
Praggers,proudmoore,2039,monk,mistweaver,151,77,74
Chimme,skywall,2036,monk,mistweaver,72,48,24
Friendshipx,emerald-dream,2034,monk,mistweaver,42,33,9
Morzmyth,nemesis,2034,monk,mistweaver,220,115,105
Neuron,spirestone,2033,monk,mistweaver,56,30,26
Nohandslost,blackrock,2033,monk,mistweaver,206,103,103
Réðçräñé,sargeras,2031,monk,mistweaver,54,36,18
Fizzlefarmer,moon-guard,2031,monk,mistweaver,89,54,35
Brazfu,skullcrusher,2031,monk,mistweaver,153,89,64
Físterxd,bleeding-hollow,2030,monk,mistweaver,318,173,145
Babyfaceqt,skullcrusher,2027,monk,mistweaver,195,104,91
Xdfu,stormrage,2025,monk,mistweaver,137,84,53
Gogumamonk,tichondrius,2023,monk,mistweaver,114,55,59
Zhoku,tichondrius,2020,monk,mistweaver,58,34,24
Originull,darkspear,2020,monk,mistweaver,107,58,49
Chadweave,moon-guard,2019,monk,mistweaver,441,234,207
Triixxy,thrall,2018,monk,mistweaver,101,64,37
Lodbork,tichondrius,2016,monk,mistweaver,198,114,84
Drdabz,illidan,2012,monk,mistweaver,90,46,44
Mcoos,tichondrius,2011,monk,mistweaver,186,112,74
Punchgodx,greymane,2010,monk,mistweaver,78,46,32
Bungfist,stormrage,2006,monk,mistweaver,41,29,12
Kris,llane,2004,monk,mistweaver,95,55,40
Jakethegreat,moknathal,2004,monk,mistweaver,217,124,93
Voidstate,stormrage,2001,monk,mistweaver,131,71,60
Leetcoder,tichondrius,2000,monk,mistweaver,195,120,75
Sypìì,stormrage,2000,monk,mistweaver,120,64,56
Àvríam,stormrage,1999,monk,mistweaver,113,54,59
Danarolls,spirestone,1998,monk,mistweaver,95,46,49
Sqmw,tichondrius,1996,monk,mistweaver,54,34,20
Orbgodx,darkspear,1996,monk,mistweaver,66,39,27
Taeeun,tichondrius,1994,monk,mistweaver,57,38,19
Quitw,tichondrius,1994,monk,mistweaver,73,40,33
Tyrfan,sargeras,1994,monk,mistweaver,154,84,70
Ezqueue,area-52,1992,monk,mistweaver,36,27,9
Bhoredom,kiljaeden,1992,monk,mistweaver,146,80,66
Sevymonk,stormrage,1990,monk,mistweaver,102,62,40
Thet,sargeras,1989,monk,mistweaver,177,90,87
Wingchungus,sargeras,1987,monk,mistweaver,42,30,12
Jiwå,terenas,1985,monk,mistweaver,648,328,320
Nesoween,tichondrius,1979,monk,mistweaver,110,65,45
Nuriva,tichondrius,1977,monk,mistweaver,88,62,26
Vinnyd,tichondrius,1976,monk,mistweaver,39,27,12
Benneroy,moon-guard,1976,monk,mistweaver,36,24,12
Nilox,sargeras,1976,monk,mistweaver,174,96,78
Meepmonk,kilrogg,1975,monk,mistweaver,51,27,24
Kaylux,stormrage,1974,monk,mistweaver,60,36,24
Martiálfarts,malganis,1973,monk,mistweaver,42,30,12
Xcrispy,scilla,1969,monk,mistweaver,67,43,24
Liltuna,icecrown,1968,monk,mistweaver,42,26,16
Heha,tichondrius,1966,monk,mistweaver,346,176,170
Assez,tichondrius,1966,monk,mistweaver,74,37,37
Actualcrime,tichondrius,1965,monk,mistweaver,60,33,27
Zaqqari,wyrmrest-accord,1965,monk,mistweaver,96,51,45
Qup,lightbringer,1963,monk,mistweaver,132,88,44
Venfuki,tichondrius,1963,monk,mistweaver,60,35,25
Hawainpunch,stormscale,1961,monk,mistweaver,90,53,37
Shlunks,illidan,1960,monk,mistweaver,267,155,112
Carzzy,sargeras,1957,monk,mistweaver,88,51,37
Wetchickennz,tichondrius,1955,monk,mistweaver,148,84,64
Speedcapped,area-52,1954,monk,mistweaver,138,67,71
Hafezassad,illidan,1954,monk,mistweaver,48,23,25
Qtmonk,emerald-dream,1950,monk,mistweaver,159,93,66
Vongg,tichondrius,1950,monk,mistweaver,66,36,30
Zamist,sargeras,1949,monk,mistweaver,84,52,32
Nakedidiot,kelthuzad,1948,monk,mistweaver,120,67,53
Ekn,tichondrius,1945,monk,mistweaver,66,45,21
Poscom,tichondrius,1944,monk,mistweaver,155,104,51
Gabîmaru,area-52,1944,monk,mistweaver,192,114,78
Lmhs,tichondrius,1942,monk,mistweaver,60,36,24
Grif,nazjatar,1942,monk,mistweaver,207,108,99
Yasysy,tichondrius,1938,monk,mistweaver,42,25,17
Discurzed,barthilas,1938,monk,mistweaver,193,111,82
Akiramenaide,tichondrius,1936,monk,mistweaver,64,44,20
Swurvex,bleeding-hollow,1935,monk,mistweaver,78,36,42
Ilovekok,sargeras,1933,monk,mistweaver,84,64,20
Xzeer,illidan,1933,monk,mistweaver,53,36,17
Beez,balnazzar,1931,monk,mistweaver,69,35,34
Zeçe,tichondrius,1930,monk,mistweaver,42,26,16
Stepfistz,aegwynn,1930,monk,mistweaver,154,90,64
Crypomunkz,malganis,1929,monk,mistweaver,53,32,21
Mixon,archimonde,1927,monk,mistweaver,36,25,11
Pandacottoco,azralon,1924,monk,mistweaver,78,44,34
Brews,black-dragonflight,1924,monk,mistweaver,121,65,56
Imdabes,velen,1923,monk,mistweaver,72,39,33
Postmark,tichondrius,1922,monk,mistweaver,60,34,26
Confa,ragnaros,1922,monk,mistweaver,262,131,131
Vethosis,illidan,1921,monk,mistweaver,43,27,16
Esqu,sargeras,1920,monk,mistweaver,42,26,16
Ònó,quelthalas,1919,monk,mistweaver,67,39,28
Brewsome,bloodhoof,1919,monk,mistweaver,82,43,39
Soprà,zuljin,1914,monk,mistweaver,63,39,24
Itsbald,bleeding-hollow,1913,monk,mistweaver,90,57,33
Kansú,ragnaros,1913,monk,mistweaver,100,53,47
Abellmonk,tichondrius,1910,monk,mistweaver,203,117,86
Paperfist,stormrage,1906,monk,mistweaver,126,87,39
Basedbuck,dalaran,1904,monk,mistweaver,36,23,13
Keshir,sargeras,1903,monk,mistweaver,111,71,40
Lexxbtw,thrall,1903,monk,mistweaver,148,84,64
Sillyguy,stormrage,1901,monk,mistweaver,107,69,38
Aegea,illidan,1901,monk,mistweaver,67,37,30
Cardrik,thrall,1901,monk,mistweaver,149,79,70
Youstop,stormrage,1900,monk,mistweaver,96,61,35
Xhangtu,thrall,1900,monk,mistweaver,190,120,70
Toyotasupra,emerald-dream,1898,monk,mistweaver,72,46,26
Canadá,bleeding-hollow,1896,monk,mistweaver,60,41,19
Rokkon,sargeras,1896,monk,mistweaver,106,59,47
Watersheep,darkspear,1896,monk,mistweaver,72,38,34
Worldhopperx,area-52,1894,monk,mistweaver,89,57,32
Sniffinsteak,laughing-skull,1892,monk,mistweaver,42,33,9
Kristië,stormrage,1891,monk,mistweaver,42,30,12
Monktease,tichondrius,1890,monk,mistweaver,96,50,46
Michæ,ragnaros,1888,monk,mistweaver,267,146,121
Suamw,tichondrius,1888,monk,mistweaver,115,55,60
Wrxx,kelthuzad,1886,monk,mistweaver,352,174,178
Zengriff,ysondre,1885,monk,mistweaver,72,44,28
Poppinbrews,thrall,1880,monk,mistweaver,46,27,19
Fenriranger,tichondrius,1878,monk,mistweaver,172,105,67
Suhjoon,bleeding-hollow,1878,monk,mistweaver,160,80,80
Toozmania,stormrage,1876,monk,mistweaver,52,31,21
Okchat,emerald-dream,1876,monk,mistweaver,216,125,91
Gentleuncle,tichondrius,1874,monk,mistweaver,143,83,60
Liteup,smolderthorn,1874,monk,mistweaver,456,231,225
Sifu,bleeding-hollow,1873,monk,mistweaver,59,36,23
Søpra,zuljin,1872,monk,mistweaver,138,81,57
Spicyx,kiljaeden,1871,monk,mistweaver,30,24,6
Spook,kalecgos,1871,monk,mistweaver,67,44,23
Robocto,area-52,1869,monk,mistweaver,102,61,41
Shùù,tichondrius,1866,monk,mistweaver,65,37,28
Dalillama,stormreaver,1865,monk,mistweaver,48,31,17
Logtich,moon-guard,1864,monk,mistweaver,78,42,36
Ileffsinll,illidan,1863,monk,mistweaver,113,64,49
Dancah,eitrigg,1861,monk,mistweaver,41,22,19
Papermade,barthilas,1860,monk,mistweaver,48,26,22
Cmonktwo,turalyon,1858,monk,mistweaver,54,31,23
Sevenmonk,tichondrius,1857,monk,mistweaver,54,36,18
Tokol,tichondrius,1857,monk,mistweaver,168,90,78
Wpola,tichondrius,1856,monk,mistweaver,48,31,17
Cmonk,turalyon,1856,monk,mistweaver,40,24,16
Threefanandy,kelthuzad,1855,monk,mistweaver,36,23,13
Milkshayx,kiljaeden,1855,monk,mistweaver,42,25,17
Cbrewfeaver,malganis,1855,monk,mistweaver,54,31,23
Piilsburry,sargeras,1855,monk,mistweaver,48,26,22
Timbomist,kelthuzad,1855,monk,mistweaver,97,52,45
Bengotitboi,magtheridon,1853,monk,mistweaver,42,24,18
Shad,frostmourne,1853,monk,mistweaver,102,58,44
Zdeg,tichondrius,1852,monk,mistweaver,51,28,23
Senseipwnda,stormrage,1851,monk,mistweaver,77,46,31
Fluval,moon-guard,1850,monk,mistweaver,71,47,24
Velzarria,zuljin,1849,monk,mistweaver,60,36,24
Damogen,spinebreaker,1849,monk,mistweaver,54,28,26
Elesm,area-52,1849,monk,mistweaver,108,48,60
Zipmw,tichondrius,1848,monk,mistweaver,66,36,30
Moushindeiru,sargeras,1846,monk,mistweaver,78,58,20
Proxy,ragnaros,1846,monk,mistweaver,46,31,15
Tonyboloney,tichondrius,1845,monk,mistweaver,42,25,17
Wizlee,tichondrius,1845,monk,mistweaver,60,34,26
Dampdampdamp,tichondrius,1844,monk,mistweaver,24,20,4
Fîstweave,emerald-dream,1844,monk,mistweaver,77,45,32
Snuggubae,moon-guard,1844,monk,mistweaver,204,111,93
Yujiro,draktharon,1843,monk,mistweaver,36,23,13
Dwánesan,tichondrius,1843,monk,mistweaver,72,44,28
Crabfest,zuljin,1843,monk,mistweaver,60,35,25
Wombglazer,dalaran,1841,monk,mistweaver,34,26,8
Xinergy,illidan,1840,monk,mistweaver,98,65,33
Youngsìnatra,muradin,1840,monk,mistweaver,42,26,16
Stonemists,ragnaros,1840,monk,mistweaver,71,43,28
Fingies,whisperwind,1838,monk,mistweaver,60,36,24
Caffeinated,barthilas,1838,monk,mistweaver,274,135,139
Nabunaga,illidan,1837,monk,mistweaver,42,34,8
Hinåta,thrall,1837,monk,mistweaver,40,26,14
Baychiz,sargeras,1837,monk,mistweaver,42,25,17
Irraeine,malganis,1836,monk,mistweaver,48,31,17
Itspoils,illidan,1835,monk,mistweaver,73,53,20
Veejaex,stormreaver,1835,monk,mistweaver,39,27,12
Zarenki,tichondrius,1835,monk,mistweaver,73,33,40
Supbro,hyjal,1834,monk,mistweaver,36,23,13
Spacebar,ysondre,1834,monk,mistweaver,54,31,23
Monjimen,ragnaros,1834,monk,mistweaver,408,216,192
Blackoutmonk,stormreaver,1833,monk,mistweaver,131,80,51
Harkwind,azralon,1833,monk,mistweaver,187,108,79
Guarantee,tichondrius,1832,monk,mistweaver,182,102,80
Cmonkey,turalyon,1831,monk,mistweaver,48,31,17
Fistër,area-52,1830,monk,mistweaver,72,43,29
Ichiros,cenarion-circle,1830,monk,mistweaver,390,219,171
Zuhakmw,tichondrius,1830,monk,mistweaver,142,66,76
Aviee,illidan,1830,monk,mistweaver,180,83,97
Chonmist,darkspear,1829,monk,mistweaver,92,60,32
Drunkenfist,chogall,1829,monk,mistweaver,71,32,39
Takugava,illidan,1828,monk,mistweaver,96,66,30
Qxt,tichondrius,1828,monk,mistweaver,76,44,32
Turbokíll,proudmoore,1828,monk,mistweaver,54,30,24
Jtea,malganis,1827,monk,mistweaver,29,20,9
Baoma,tichondrius,1827,monk,mistweaver,95,55,40
Monklike,illidan,1827,monk,mistweaver,60,30,30
Bootÿmagic,tichondrius,1826,monk,mistweaver,150,94,56
Wigglygiggly,mannoroth,1826,monk,mistweaver,113,64,49
Macrobrewski,tichondrius,1825,monk,mistweaver,41,32,9
Jackouse,frostmourne,1824,monk,mistweaver,50,31,19
Onepunçhman,stormreaver,1824,monk,mistweaver,250,141,109
Hugdealer,warsong,1823,monk,mistweaver,80,47,33
Patfu,area-52,1823,monk,mistweaver,57,32,25
Gtmdyjs,illidan,1822,monk,mistweaver,29,20,9
Jojostar,shadowsong,1822,monk,mistweaver,54,32,22
Zenchi,kelthuzad,1821,monk,mistweaver,36,26,10
Vynchi,area-52,1821,monk,mistweaver,97,67,30
Tazi,chromaggus,1821,monk,mistweaver,84,50,34
Mackiechan,kelthuzad,1821,monk,mistweaver,134,77,57
Voltio,frostmane,1820,monk,mistweaver,103,68,35
Chaddington,malorne,1820,monk,mistweaver,48,30,18
Barelroll,proudmoore,1819,monk,mistweaver,122,83,39
Monknutt,tichondrius,1819,monk,mistweaver,56,32,24
Ilovefrogs,stormrage,1819,monk,mistweaver,60,30,30
Fatnugly,sargeras,1818,monk,mistweaver,62,39,23
Djkungfu,thrall,1818,monk,mistweaver,180,107,73
Malibrew,proudmoore,1817,monk,mistweaver,42,29,13
Deathsteel,emerald-dream,1817,monk,mistweaver,41,25,16
Fistinator,blackrock,1817,monk,mistweaver,120,71,49
Toxicbeans,tichondrius,1817,monk,mistweaver,100,58,42
Rektral,ragnaros,1817,monk,mistweaver,127,73,54
Ándi,barthilas,1817,monk,mistweaver,53,28,25
Bubblepony,illidan,1817,monk,mistweaver,313,164,149
Chaihard,sargeras,1816,monk,mistweaver,45,25,20
Yobeel,tichondrius,1816,monk,mistweaver,54,23,31
Iovegõd,tichondrius,1815,monk,mistweaver,163,99,64
Xhilong,quelthalas,1815,monk,mistweaver,48,28,20
Zilph,malganis,1815,monk,mistweaver,66,36,30
Mð,vashj,1815,monk,mistweaver,229,119,110
Decompress,illidan,1814,monk,mistweaver,99,60,39
Phunkymonkey,mannoroth,1814,monk,mistweaver,90,50,40
Adop,dark-iron,1813,monk,mistweaver,130,79,51
Miley,lethon,1812,monk,mistweaver,36,23,13
Hyori,saurfang,1812,monk,mistweaver,54,29,25
Intra,exodar,1812,monk,mistweaver,150,79,71
Soö,tichondrius,1812,monk,mistweaver,66,34,32
Evilfantum,illidan,1811,monk,mistweaver,42,32,10
Battlecruise,tichondrius,1811,monk,mistweaver,36,24,12
Gnappyy,tichondrius,1811,monk,mistweaver,41,25,16
Mistpump,tichondrius,1811,monk,mistweaver,48,26,22
Oppsimop,frostmourne,1811,monk,mistweaver,114,61,53
Tirionx,area-52,1810,monk,mistweaver,227,130,97
Vernki,laughing-skull,1809,monk,mistweaver,77,48,29
Mavvi,tichondrius,1809,monk,mistweaver,170,88,82
Cangry,area-52,1809,monk,mistweaver,60,31,29
Epî,tichondrius,1809,monk,mistweaver,312,155,157
Shadmw,barthilas,1808,monk,mistweaver,42,30,12
Phattea,thrall,1808,monk,mistweaver,48,31,17
Jiskweaver,sargeras,1808,monk,mistweaver,36,22,14
Enfold,stormrage,1808,monk,mistweaver,48,26,22
Yokuu,thunderlord,1808,monk,mistweaver,54,29,25
Jaja,kiljaeden,1807,monk,mistweaver,48,28,20
Abeldra,moon-guard,1807,monk,mistweaver,82,42,40
Sayflight,tichondrius,1807,monk,mistweaver,72,31,41
Itdreams,illidan,1806,monk,mistweaver,42,25,17
Taekwonscro,proudmoore,1806,monk,mistweaver,60,33,27
Timed,shuhalo,1806,monk,mistweaver,49,26,23
Shiinobi,area-52,1806,monk,mistweaver,140,74,66
Astrino,zuljin,1805,monk,mistweaver,42,29,13
Chimaekrush,tichondrius,1805,monk,mistweaver,36,24,12
Crispeel,tichondrius,1805,monk,mistweaver,54,33,21
Briàr,area-52,1805,monk,mistweaver,48,27,21
Strongmandan,twisting-nether,1805,monk,mistweaver,42,23,19
Onlyfansx,ragnaros,1805,monk,mistweaver,256,139,117
Cenfu,malganis,1805,monk,mistweaver,72,29,43
Alphamist,thrall,1804,monk,mistweaver,36,23,13
Proventos,azralon,1804,monk,mistweaver,483,256,227
Imdabes,destromath,1804,monk,mistweaver,87,38,49
Vrieden,illidan,1804,monk,mistweaver,99,42,57
Bickli,tichondrius,1803,monk,mistweaver,57,32,25
Celerein,illidan,1803,monk,mistweaver,118,61,57
Gabaan,azralon,1803,monk,mistweaver,54,27,27
Zundor,ghostlands,1802,monk,mistweaver,32,25,7
Nefazzto,ragnaros,1802,monk,mistweaver,30,19,11
Udderpunch,barthilas,1802,monk,mistweaver,83,51,32
Zenno,darkspear,1802,monk,mistweaver,51,31,20
Kungfoocious,tichondrius,1802,monk,mistweaver,57,33,24
Zeroskil,thrall,1802,monk,mistweaver,66,38,28
Ojarax,bleeding-hollow,1802,monk,mistweaver,60,34,26
ßullsack,barthilas,1802,monk,mistweaver,108,57,51
Mixflo,bleeding-hollow,1802,monk,mistweaver,39,20,19
Wootzhu,zuljin,1802,monk,mistweaver,122,62,60
Séthrogèn,tichondrius,1801,monk,mistweaver,47,30,17
Mistweave,aerie-peak,1801,monk,mistweaver,54,34,20
Vanmonk,eonar,1801,monk,mistweaver,54,33,21
Squalicorax,area-52,1801,monk,mistweaver,47,24,23
Jiucho,dalaran,1800,monk,mistweaver,35,23,12
Exuperjun,emerald-dream,1800,monk,mistweaver,46,26,20
Mekawa,gurubashi,1799,monk,mistweaver,40,26,14
Tiptea,stormrage,1799,monk,mistweaver,42,23,19
Femalejam,darkspear,1798,monk,mistweaver,66,40,26
Toonington,sargeras,1797,monk,mistweaver,57,39,18
Karatechawp,bleeding-hollow,1795,monk,mistweaver,64,44,20
Swoleypoley,tichondrius,1794,monk,mistweaver,54,29,25
Senritsuh,drakkari,1793,monk,mistweaver,42,25,17
Cromulent,saurfang,1792,monk,mistweaver,134,70,64
Zukki,zuljin,1791,monk,mistweaver,166,87,79
Valhira,kiljaeden,1787,monk,mistweaver,78,45,33
Greenbrews,area-52,1787,monk,mistweaver,246,133,113
Roypoker,illidan,1785,monk,mistweaver,48,34,14
Rexfiend,tichondrius,1782,monk,mistweaver,24,19,5
Triarcs,area-52,1781,monk,mistweaver,36,24,12
Hepp,stormrage,1781,monk,mistweaver,54,35,19
Dræmwalker,malygos,1781,monk,mistweaver,735,367,368
Suppfastlol,nemesis,1780,monk,mistweaver,114,65,49
Ttvchickchau,tichondrius,1779,monk,mistweaver,125,75,50
Chiang,chogall,1778,monk,mistweaver,71,54,17
Coomweaver,stormrage,1778,monk,mistweaver,42,22,20
Lgee,kelthuzad,1774,monk,mistweaver,30,19,11
Khungfeu,area-52,1774,monk,mistweaver,60,35,25
Qarmax,azralon,1772,monk,mistweaver,41,23,18
Copula,illidan,1770,monk,mistweaver,296,150,146
Integrity,durotan,1769,monk,mistweaver,250,134,116
Chikid,barthilas,1768,monk,mistweaver,54,35,19
Trackstarx,area-52,1767,monk,mistweaver,30,25,5
Daito,jubeithos,1767,monk,mistweaver,110,62,48
Cyrøwø,ragnaros,1765,monk,mistweaver,36,27,9
Iknwmyname,proudmoore,1764,monk,mistweaver,29,23,6
Roogymw,emerald-dream,1764,monk,mistweaver,94,54,40
Misthealz,black-dragonflight,1763,monk,mistweaver,125,77,48
Onecoolmonk,tichondrius,1762,monk,mistweaver,68,43,25
Iightning,dentarg,1762,monk,mistweaver,66,40,26
Jayvex,illidan,1762,monk,mistweaver,72,37,35
Kelstrike,sargeras,1760,monk,mistweaver,42,26,16
Beerflow,stormrage,1760,monk,mistweaver,118,61,57
Izolatedrin,tichondrius,1757,monk,mistweaver,23,19,4
Zoltwo,sargeras,1757,monk,mistweaver,136,82,54
Bouncymoo,frostmourne,1756,monk,mistweaver,36,21,15
Whatdaheal,darkspear,1756,monk,mistweaver,72,31,41
Mikamonk,illidan,1755,monk,mistweaver,81,48,33
Monkeymonk,eonar,1755,monk,mistweaver,36,19,17
Rîce,burning-blade,1754,monk,mistweaver,42,29,13
Rokk,rivendare,1754,monk,mistweaver,78,44,34
Mymissteak,darkspear,1753,monk,mistweaver,105,66,39
Grabbitz,kelthuzad,1751,monk,mistweaver,42,27,15
Pichau,zuljin,1751,monk,mistweaver,57,35,22
Bouncycheeks,frostmourne,1751,monk,mistweaver,90,50,40
Lovehate,zuljin,1751,monk,mistweaver,77,39,38
Spinharder,stormrage,1750,monk,mistweaver,65,38,27
Ensaymada,frostmourne,1750,monk,mistweaver,138,71,67
Ahlanna,malganis,1748,monk,mistweaver,29,19,10
Monkeyhealz,tichondrius,1748,monk,mistweaver,185,105,80
Callmekoldi,dalaran,1748,monk,mistweaver,93,52,41
Motogp,tichondrius,1748,monk,mistweaver,176,87,89
Nerf,malganis,1747,monk,mistweaver,29,19,10
Gamesuxlol,the-underbog,1747,monk,mistweaver,96,55,41
Tippity,stormrage,1746,monk,mistweaver,37,24,13
Boomtac,moon-guard,1746,monk,mistweaver,104,60,44
Gramazen,tichondrius,1746,monk,mistweaver,72,39,33
Mêlon,tichondrius,1745,monk,mistweaver,30,22,8
Bebuu,proudmoore,1744,monk,mistweaver,65,44,21
Chérudim,malganis,1744,monk,mistweaver,36,22,14
Grublord,stormrage,1744,monk,mistweaver,53,27,26
Mxf,tichondrius,1743,monk,mistweaver,36,23,13
Cystweaver,dalaran,1743,monk,mistweaver,71,45,26
Mistpowaz,stormrage,1742,monk,mistweaver,143,84,59
Baittor,proudmoore,1741,monk,mistweaver,62,39,23
Tyforprecog,kelthuzad,1739,monk,mistweaver,54,33,21
Yepcocc,lightbringer,1739,monk,mistweaver,41,24,17
Ellesig,ragnaros,1739,monk,mistweaver,250,129,121
Bobbytheorc,tichondrius,1738,monk,mistweaver,35,21,14
Vamplyyz,kelthuzad,1737,monk,mistweaver,60,30,30
Pandatrainer,drakkari,1736,monk,mistweaver,36,23,13
Bubear,stormreaver,1735,monk,mistweaver,36,23,13
Mistqt,illidan,1735,monk,mistweaver,48,28,20
Gujunpyó,sargeras,1734,monk,mistweaver,90,56,34
Antriai,icecrown,1734,monk,mistweaver,60,26,34
Monkney,tichondrius,1733,monk,mistweaver,106,71,35
Sleeks,bonechewer,1733,monk,mistweaver,114,64,50
Ricearolli,area-52,1731,monk,mistweaver,36,26,10
Lasagnacàt,moon-guard,1731,monk,mistweaver,180,105,75
Zenblazer,illidan,1731,monk,mistweaver,43,22,21
Moonhealsyou,moon-guard,1730,monk,mistweaver,100,65,35
Nevercranex,kirin-tor,1730,monk,mistweaver,42,26,16
Monke,onyxia,1730,monk,mistweaver,54,31,23
Gummycat,bonechewer,1729,monk,mistweaver,204,107,97
Fistofchanny,tichondrius,1725,monk,mistweaver,104,57,47
Ajizzaÿ,saurfang,1725,monk,mistweaver,92,46,46
Pp,icecrown,1724,monk,mistweaver,43,38,5
Flavier,illidan,1724,monk,mistweaver,48,25,23
Smoovhoov,kiljaeden,1723,monk,mistweaver,30,19,11
Canadien,silver-hand,1723,monk,mistweaver,30,18,12
Cloq,kelthuzad,1723,monk,mistweaver,71,38,33
Smallboots,area-52,1722,monk,mistweaver,30,24,6
Steelcase,frostmourne,1722,monk,mistweaver,47,26,21
Kênpächi,rexxar,1722,monk,mistweaver,57,29,28
Igaku,windrunner,1721,monk,mistweaver,54,33,21
Kawali,thrall,1721,monk,mistweaver,96,53,43
Ðescubra,stormrage,1721,monk,mistweaver,80,44,36
Xblingtron,malganis,1721,monk,mistweaver,65,27,38
Rizzdriver,moon-guard,1719,monk,mistweaver,66,41,25
Calvana,tichondrius,1719,monk,mistweaver,143,63,80
Sixesm,dalaran,1717,monk,mistweaver,48,25,23
Joonbug,moonrunner,1715,monk,mistweaver,83,47,36
Xtramist,tichondrius,1713,monk,mistweaver,48,24,24
Alexìn,sargeras,1712,monk,mistweaver,79,50,29
Inalambrico,quelthalas,1712,monk,mistweaver,36,22,14
Hansul,tichondrius,1711,monk,mistweaver,111,51,60
Buhmonk,thrall,1710,monk,mistweaver,60,34,26
Zuen,ragnaros,1710,monk,mistweaver,230,117,113
Noremaç,frostmourne,1709,monk,mistweaver,36,21,15
Gauche,arygos,1709,monk,mistweaver,168,88,80
Trezzic,aegwynn,1709,monk,mistweaver,49,25,24
Betasquadxd,bleeding-hollow,1707,monk,mistweaver,43,25,18
Gundamfish,tichondrius,1707,monk,mistweaver,42,22,20
Meâghân,bladefist,1705,monk,mistweaver,27,19,8
Knuqz,stormrage,1705,monk,mistweaver,36,18,18
Monkyou,area-52,1705,monk,mistweaver,72,35,37
Røllitup,illidan,1704,monk,mistweaver,54,34,20
Yamatoqt,frostmourne,1704,monk,mistweaver,60,35,25
Omihli,sargeras,1704,monk,mistweaver,48,28,20
Whaes,thrall,1704,monk,mistweaver,36,21,15
Bloodyxmonk,firetree,1704,monk,mistweaver,55,31,24
Spot,kelthuzad,1704,monk,mistweaver,48,24,24
Kynalla,thunderlord,1703,monk,mistweaver,30,18,12
Manggi,tichondrius,1702,monk,mistweaver,169,98,71
Sparksgamer,ragnaros,1701,monk,mistweaver,36,18,18
Badonkadonk,kiljaeden,1701,monk,mistweaver,66,27,39
Starçandy,tichondrius,1699,monk,mistweaver,120,62,58
Manicata,tichondrius,1698,monk,mistweaver,207,121,86
Goldenfoot,tichondrius,1698,monk,mistweaver,150,79,71
Mexii,hellscream,1697,monk,mistweaver,247,119,128
Krömbopulos,magtheridon,1696,monk,mistweaver,36,24,12
Zawlp,sargeras,1693,monk,mistweaver,62,37,25
Gellindra,malganis,1692,monk,mistweaver,30,22,8
Nevershower,malganis,1692,monk,mistweaver,30,22,8
Velenious,tichondrius,1692,monk,mistweaver,125,75,50
Jaige,illidan,1692,monk,mistweaver,30,18,12
Florla,illidan,1692,monk,mistweaver,46,24,22
Anandamayi,emerald-dream,1691,monk,mistweaver,48,27,21
Linsey,frostmourne,1691,monk,mistweaver,36,20,16
Jiubak,dalaran,1691,monk,mistweaver,48,26,22
Teewin,area-52,1690,monk,mistweaver,89,61,28
Jinker,malganis,1690,monk,mistweaver,53,33,20
Healmart,bloodhoof,1690,monk,mistweaver,30,18,12
Mariabaraks,darkspear,1690,monk,mistweaver,102,56,46
Seokdenam,tichondrius,1689,monk,mistweaver,99,56,43
Carlyjepsen,shadowmoon,1688,monk,mistweaver,133,70,63
Bromonster,zuljin,1687,monk,mistweaver,36,18,18
Cohenn,tichondrius,1686,monk,mistweaver,24,18,6
Botweaver,proudmoore,1686,monk,mistweaver,80,45,35
Spencere,hyjal,1686,monk,mistweaver,84,44,40
Unclety,tichondrius,1685,monk,mistweaver,42,24,18
Alekun,quelthalas,1685,monk,mistweaver,174,91,83
Alternatives,sargeras,1684,monk,mistweaver,24,18,6
Ropturttlê,tichondrius,1684,monk,mistweaver,36,24,12
Tazermw,sargeras,1684,monk,mistweaver,68,41,27
Hogarg,emerald-dream,1684,monk,mistweaver,36,21,15
Doomstroller,aegwynn,1684,monk,mistweaver,177,91,86
Azurro,jubeithos,1683,monk,mistweaver,36,24,12
Versachi,stormreaver,1683,monk,mistweaver,111,62,49
Cherep,kiljaeden,1683,monk,mistweaver,111,59,52
Vïolët,moon-guard,1682,monk,mistweaver,213,124,89
Aráshicage,malganis,1681,monk,mistweaver,48,29,19
Chopschtichs,kiljaeden,1680,monk,mistweaver,75,47,28
Fisetèrr,kelthuzad,1680,monk,mistweaver,59,35,24
Ninetrigrams,illidan,1680,monk,mistweaver,56,33,23
Hoofweaver,proudmoore,1680,monk,mistweaver,60,25,35
Todnerey,sargeras,1679,monk,mistweaver,77,52,25
Lazeekick,sargeras,1679,monk,mistweaver,48,23,25
Dwãrf,tichondrius,1678,monk,mistweaver,36,25,11
Thraging,sargeras,1678,monk,mistweaver,54,29,25
Maicuta,thrall,1675,monk,mistweaver,42,26,16
Muzzye,frostmourne,1675,monk,mistweaver,298,171,127
Zenox,rexxar,1675,monk,mistweaver,90,46,44
Brewy,bloodhoof,1674,monk,mistweaver,24,19,5
Phlexz,jubeithos,1674,monk,mistweaver,30,22,8
Sickdrip,magtheridon,1674,monk,mistweaver,42,23,19
Aiswalle,illidan,1673,monk,mistweaver,39,22,17
Dryungpwnz,zuljin,1673,monk,mistweaver,248,139,109
Drunkentoker,illidan,1673,monk,mistweaver,48,26,22
Yeji,altar-of-storms,1673,monk,mistweaver,145,69,76
Greenstar,bleeding-hollow,1672,monk,mistweaver,247,128,119
Tezcatyo,malganis,1671,monk,mistweaver,54,32,22
Stonymcblaze,malganis,1671,monk,mistweaver,48,28,20
Djuice,tichondrius,1670,monk,mistweaver,42,25,17
Fisticufs,bleeding-hollow,1670,monk,mistweaver,42,23,19
Phtarded,stormreaver,1670,monk,mistweaver,140,70,70
Quitschi,tichondrius,1669,monk,mistweaver,42,26,16
Yulfee,kelthuzad,1669,monk,mistweaver,39,22,17
Lýøp,illidan,1668,monk,mistweaver,48,29,19
Ïtächï,illidan,1668,monk,mistweaver,66,27,39
Garg,malganis,1666,monk,mistweaver,30,22,8
Loudpäck,dalaran,1666,monk,mistweaver,41,26,15
Noneedlokita,illidan,1666,monk,mistweaver,42,26,16
Nahr,tichondrius,1666,monk,mistweaver,39,22,17
Nugskis,dalaran,1666,monk,mistweaver,263,135,128
Twoshero,tichondrius,1665,monk,mistweaver,34,22,12
Mememories,tichondrius,1665,monk,mistweaver,74,46,28
Jamerino,jubeithos,1665,monk,mistweaver,210,119,91
Raymond,malganis,1664,monk,mistweaver,58,37,21
Winfred,bleeding-hollow,1663,monk,mistweaver,54,36,18
Mistastep,tichondrius,1663,monk,mistweaver,168,88,80
Blasê,frostmourne,1662,monk,mistweaver,36,22,14
Crypslegacy,tichondrius,1662,monk,mistweaver,208,108,100
Gomon,terenas,1661,monk,mistweaver,29,20,9
Èmacs,barthilas,1661,monk,mistweaver,35,24,11
Coldridge,bleeding-hollow,1661,monk,mistweaver,42,20,22
Jeskâi,tichondrius,1660,monk,mistweaver,45,26,19
Chessyx,ragnaros,1660,monk,mistweaver,42,20,22
Rectus,proudmoore,1659,monk,mistweaver,30,22,8
Dupaweaver,stormrage,1659,monk,mistweaver,59,26,33
Fistwrapped,bleeding-hollow,1658,monk,mistweaver,42,27,15
Cheetosnmilk,malganis,1658,monk,mistweaver,35,20,15
Lu,nesingwary,1657,monk,mistweaver,30,19,11
Serikko,frostmourne,1657,monk,mistweaver,44,26,18
Vybe,frostmourne,1656,monk,mistweaver,69,48,21
Sóntix,sargeras,1656,monk,mistweaver,71,38,33
Cööked,illidan,1656,monk,mistweaver,63,33,30
Damndaniel,hyjal,1656,monk,mistweaver,214,107,107
Greenrice,thrall,1655,monk,mistweaver,52,33,19
Lilsloptop,moon-guard,1655,monk,mistweaver,161,96,65
Alocxo,drakkari,1654,monk,mistweaver,34,24,10
Trojanz,malganis,1654,monk,mistweaver,36,20,16
Zachxd,onyxia,1653,monk,mistweaver,42,26,16
Repbrew,sargeras,1653,monk,mistweaver,63,33,30
Groundways,sargeras,1653,monk,mistweaver,65,31,34
Raígon,ragnaros,1652,monk,mistweaver,36,20,16
Molochko,area-52,1651,monk,mistweaver,26,20,6
Pai,sargeras,1651,monk,mistweaver,36,22,14
Gnetic,nemesis,1651,monk,mistweaver,92,51,41
Tonytornado,proudmoore,1651,monk,mistweaver,84,40,44
Lartridia,malganis,1650,monk,mistweaver,45,27,18
Toastsmonk,tichondrius,1649,monk,mistweaver,38,24,14
Rexzilla,tichondrius,1648,monk,mistweaver,36,25,11
Ccop,kelthuzad,1647,monk,mistweaver,36,25,11
Notblakexo,tichondrius,1647,monk,mistweaver,35,19,16
Donnieyen,area-52,1647,monk,mistweaver,72,37,35
Ashamah,bleeding-hollow,1644,monk,mistweaver,30,22,8
Miillkz,zuljin,1644,monk,mistweaver,47,25,22
Ragemore,emerald-dream,1643,monk,mistweaver,37,23,14
Ahnlev,ragnaros,1643,monk,mistweaver,116,66,50
Mistweaverxo,malganis,1643,monk,mistweaver,128,70,58
Ææøææôææôææô,illidan,1642,monk,mistweaver,138,88,50
Misooyom,moon-guard,1641,monk,mistweaver,54,35,19
Swiftm,thrall,1641,monk,mistweaver,321,179,142
Tenoseven,area-52,1640,monk,mistweaver,21,19,2
Centalink,barthilas,1640,monk,mistweaver,56,38,18
Rhorkfist,frostmourne,1640,monk,mistweaver,43,23,20
Julipz,tichondrius,1640,monk,mistweaver,36,19,17
Djux,zuljin,1639,monk,mistweaver,30,20,10
Senseii,dathremar,1639,monk,mistweaver,66,43,23
Brewjitsu,tichondrius,1639,monk,mistweaver,42,23,19
Kharazim,skullcrusher,1639,monk,mistweaver,108,47,61
Pandareng,tichondrius,1638,monk,mistweaver,32,20,12
Floka,bleeding-hollow,1638,monk,mistweaver,36,22,14
Rañga,caelestrasz,1638,monk,mistweaver,77,45,32
Pandaiax,area-52,1638,monk,mistweaver,65,36,29
Grizzm,sargeras,1637,monk,mistweaver,78,48,30
Genjen,bleeding-hollow,1637,monk,mistweaver,46,26,20
Liké,tichondrius,1636,monk,mistweaver,54,32,22
Bradyfour,moon-guard,1636,monk,mistweaver,137,74,63
Samzo,barthilas,1636,monk,mistweaver,51,27,24
Paralee,tichondrius,1635,monk,mistweaver,48,34,14
Ropgobbler,muradin,1634,monk,mistweaver,30,18,12
Caibiws,tichondrius,1634,monk,mistweaver,50,27,23
Sixsticks,tichondrius,1633,monk,mistweaver,70,37,33
Gooncave,stormrage,1633,monk,mistweaver,86,41,45
Ermac,kiljaeden,1632,monk,mistweaver,47,32,15
Minaffection,tichondrius,1632,monk,mistweaver,36,19,17
Avm,azralon,1632,monk,mistweaver,60,31,29
Misswalk,ragnaros,1632,monk,mistweaver,45,20,25
Chongal,whisperwind,1631,monk,mistweaver,42,24,18
Bossmonk,tichondrius,1631,monk,mistweaver,140,78,62
Sodamint,sargeras,1631,monk,mistweaver,60,31,29
Dragonwhirl,stormrage,1630,monk,mistweaver,95,54,41
Cranekicks,moon-guard,1630,monk,mistweaver,269,148,121
Roloyolo,illidan,1630,monk,mistweaver,64,25,39
Ludan,eredar,1629,monk,mistweaver,160,85,75
Místme,tichondrius,1629,monk,mistweaver,78,41,37
Tuesdây,wyrmrest-accord,1628,monk,mistweaver,30,20,10
Drama,tichondrius,1627,monk,mistweaver,44,30,14
Baldbutcute,darkspear,1627,monk,mistweaver,28,19,9
Avãrîce,stormrage,1626,monk,mistweaver,24,17,7
Cryptmist,frostmourne,1626,monk,mistweaver,48,32,16
Valelarus,doomhammer,1626,monk,mistweaver,42,24,18
Zxenn,tichondrius,1626,monk,mistweaver,30,17,13
Josciel,ragnaros,1626,monk,mistweaver,543,277,266
Qoong,tichondrius,1625,monk,mistweaver,70,42,28
Wittymonk,illidan,1625,monk,mistweaver,99,57,42
Bodhisattvax,bleeding-hollow,1625,monk,mistweaver,42,24,18
Zlatan,thaurissan,1625,monk,mistweaver,30,17,13
Peachtea,burning-legion,1625,monk,mistweaver,45,21,24
Crentist,mannoroth,1624,monk,mistweaver,40,31,9
Innerchii,tichondrius,1624,monk,mistweaver,24,17,7
Dirtyde,sargeras,1624,monk,mistweaver,181,87,94
Fistergand,frostwolf,1623,monk,mistweaver,37,30,7
Solusek,korgath,1623,monk,mistweaver,36,27,9
Starryysky,illidan,1623,monk,mistweaver,48,32,16
Lickthefist,sargeras,1623,monk,mistweaver,30,20,10
Röshi,kelthuzad,1623,monk,mistweaver,54,35,19
Zhíu,ragnaros,1623,monk,mistweaver,54,33,21
Liteup,korgath,1623,monk,mistweaver,102,62,40
Nicotinetap,tichondrius,1623,monk,mistweaver,30,18,12
Chignar,dathremar,1622,monk,mistweaver,30,17,13
Swuseng,tichondrius,1622,monk,mistweaver,54,29,25
Ywingtsuan,frostmourne,1622,monk,mistweaver,41,21,20
Diobrando,illidan,1621,monk,mistweaver,63,40,23
Valian,tichondrius,1621,monk,mistweaver,42,22,20
Ghðst,ragnaros,1620,monk,mistweaver,42,24,18
Monkwalker,tichondrius,1620,monk,mistweaver,66,35,31
Swolington,proudmoore,1619,monk,mistweaver,41,26,15
Intertwine,frostmourne,1619,monk,mistweaver,30,17,13
Footloverx,area-52,1618,monk,mistweaver,38,29,9
Avz,azralon,1618,monk,mistweaver,30,21,9
Metakillër,ragnaros,1618,monk,mistweaver,98,53,45
Masamunes,thrall,1616,monk,mistweaver,50,38,12
Stormpounder,proudmoore,1616,monk,mistweaver,60,40,20
Locusta,tichondrius,1616,monk,mistweaver,30,19,11
Drinkkin,bleeding-hollow,1616,monk,mistweaver,114,68,46
Swiixm,frostmourne,1616,monk,mistweaver,64,38,26
Mwgodqtxtko,nazjatar,1616,monk,mistweaver,54,32,22
Sebsws,proudmoore,1616,monk,mistweaver,100,59,41
Immamonkey,tichondrius,1616,monk,mistweaver,200,114,86
Wokoon,kelthuzad,1615,monk,mistweaver,27,21,6
Nekzí,sargeras,1615,monk,mistweaver,30,20,10
Slipperybobs,tichondrius,1615,monk,mistweaver,89,57,32
Yuï,bleeding-hollow,1615,monk,mistweaver,36,21,15
Bréwmaster,stormrage,1615,monk,mistweaver,36,17,19
Mukboo,tichondrius,1615,monk,mistweaver,36,17,19
Kungfuturdle,tichondrius,1614,monk,mistweaver,101,58,43
Xtacie,sargeras,1614,monk,mistweaver,66,30,36
Keiirah,zuluhed,1614,monk,mistweaver,60,24,36
Greenvan,tichondrius,1613,monk,mistweaver,24,17,7
Pacee,deathwing,1613,monk,mistweaver,24,17,7
Kûshi,stormrage,1613,monk,mistweaver,35,23,12
Kendro,trollbane,1613,monk,mistweaver,59,38,21
Whoonmonk,tichondrius,1613,monk,mistweaver,66,41,25
Somebodym,illidan,1613,monk,mistweaver,36,22,14
Merkey,tichondrius,1613,monk,mistweaver,72,39,33
Yunmen,blades-edge,1613,monk,mistweaver,113,61,52
Tharja,bonechewer,1612,monk,mistweaver,56,34,22
Craziediemon,malganis,1612,monk,mistweaver,38,23,15
Qords,tichondrius,1612,monk,mistweaver,148,77,71
Musedz,barthilas,1612,monk,mistweaver,60,23,37
Ninakittenx,staghelm,1611,monk,mistweaver,60,36,24
Ggjudo,sargeras,1611,monk,mistweaver,52,31,21
Braindi,arathor,1611,monk,mistweaver,54,30,24
Dlysezzic,tichondrius,1611,monk,mistweaver,98,54,44
Tweiliax,tichondrius,1611,monk,mistweaver,51,26,25
Prisonike,bleeding-hollow,1610,monk,mistweaver,60,36,24
Sudury,tichondrius,1610,monk,mistweaver,96,55,41
Pingpang,stormreaver,1610,monk,mistweaver,81,46,35
Korata,frostwolf,1610,monk,mistweaver,42,23,19
Healzpapi,tichondrius,1609,monk,mistweaver,214,117,97
Hîbîscus,illidan,1609,monk,mistweaver,32,17,15
Lazura,tichondrius,1609,monk,mistweaver,65,33,32
Planetariumz,bleeding-hollow,1608,monk,mistweaver,320,168,152
Revivalol,dragonmaw,1608,monk,mistweaver,77,40,37
Suntzulml,quelthalas,1608,monk,mistweaver,219,113,106
Mîstchievous,sargeras,1607,monk,mistweaver,28,21,7
Jadestørmz,illidan,1607,monk,mistweaver,30,20,10
Azahri,sargeras,1607,monk,mistweaver,46,29,17
Santiaguiño,ragnaros,1607,monk,mistweaver,71,27,44
Tubby,eredar,1606,monk,mistweaver,36,22,14
Ramisan,barthilas,1606,monk,mistweaver,77,44,33
Mýthik,hyjal,1606,monk,mistweaver,66,37,29
Gooseoba,tichondrius,1605,monk,mistweaver,24,18,6
Tarkir,quelthalas,1605,monk,mistweaver,89,55,34
Tamingpanda,wildhammer,1605,monk,mistweaver,60,33,27
Eppsmonk,tichondrius,1604,monk,mistweaver,30,18,12
Oblivion,wildhammer,1604,monk,mistweaver,61,36,25
Oochi,illidan,1604,monk,mistweaver,60,31,29
Cymonka,sargeras,1603,monk,mistweaver,30,17,13
Goochtickles,bleeding-hollow,1602,monk,mistweaver,128,79,49
Gess,stormscale,1602,monk,mistweaver,108,54,54
Docpalpatine,tichondrius,1602,monk,mistweaver,36,17,19
Xuenws,tichondrius,1602,monk,mistweaver,84,36,48
Bussyweaver,sargeras,1601,monk,mistweaver,147,90,57
Bowstâff,lightbringer,1601,monk,mistweaver,36,22,14
Zeroxe,area-52,1600,monk,mistweaver,42,30,12
Slothman,nagrand,1600,monk,mistweaver,144,82,62
Mistysweep,sargeras,1600,monk,mistweaver,85,45,40
Manchu,stormrage,1599,monk,mistweaver,30,18,12
Jackphan,azralon,1598,monk,mistweaver,112,66,46
Bobbybiz,bleeding-hollow,1597,monk,mistweaver,152,86,66
Snoozzy,kelthuzad,1596,monk,mistweaver,42,21,21
Lightskinmon,area-52,1595,monk,mistweaver,42,23,19
Monkzilla,tichondrius,1593,monk,mistweaver,24,17,7
Cisneros,doomhammer,1593,monk,mistweaver,291,156,135
Slashsmack,caelestrasz,1593,monk,mistweaver,86,46,40
Flagreturned,illidan,1593,monk,mistweaver,36,19,17
Chavbrew,stormrage,1592,monk,mistweaver,85,46,39
Onees,tichondrius,1590,monk,mistweaver,99,49,50
Furyjames,quelthalas,1589,monk,mistweaver,103,45,58
Anagark,barthilas,1588,monk,mistweaver,45,34,11
Brosiedon,sargeras,1588,monk,mistweaver,148,71,77
Coralys,sargeras,1587,monk,mistweaver,42,36,6
Toastage,tichondrius,1587,monk,mistweaver,48,28,20
Songwei,barthilas,1587,monk,mistweaver,89,50,39
Rileyreidfan,azjolnerub,1586,monk,mistweaver,30,21,9
Neonep,stormrage,1586,monk,mistweaver,130,72,58
Rakia,moon-guard,1586,monk,mistweaver,219,110,109
Kwoon,hyjal,1585,monk,mistweaver,52,30,22
Luvdeluxe,skullcrusher,1585,monk,mistweaver,67,32,35
Yoshinator,area-52,1585,monk,mistweaver,42,20,22
Miniswag,arthas,1584,monk,mistweaver,54,22,32
Musachi,barthilas,1582,monk,mistweaver,84,41,43
Scrotburg,thrall,1579,monk,mistweaver,36,19,17
Victuskk,tichondrius,1577,monk,mistweaver,67,45,22
Pumakicks,tichondrius,1576,monk,mistweaver,70,37,33
Waataafaak,malganis,1576,monk,mistweaver,93,47,46
Mfmiscreant,illidan,1576,monk,mistweaver,48,20,28
Peege,kelthuzad,1574,monk,mistweaver,89,59,30
Lozza,jubeithos,1574,monk,mistweaver,54,32,22
Tamonger,stormrage,1574,monk,mistweaver,224,119,105
Wildfists,tichondrius,1574,monk,mistweaver,738,370,368
Bigpøppa,tichondrius,1573,monk,mistweaver,60,33,27
Chevvyy,azshara,1573,monk,mistweaver,36,18,18
Beboté,quelthalas,1573,monk,mistweaver,205,97,108
Snoodle,korgath,1572,monk,mistweaver,168,92,76
Buffmonkdmg,tichondrius,1571,monk,mistweaver,90,48,42
Vohdka,malganis,1569,monk,mistweaver,148,86,62
Ckqt,stormrage,1569,monk,mistweaver,41,23,18
Emporertrump,bleeding-hollow,1569,monk,mistweaver,289,150,139
Boneykicks,tichondrius,1569,monk,mistweaver,42,21,21
Treessome,tichondrius,1567,monk,mistweaver,29,20,9
Mvqws,tichondrius,1564,monk,mistweaver,32,24,8
Bebess,moon-guard,1564,monk,mistweaver,51,28,23
Sshri,illidan,1564,monk,mistweaver,257,128,129
Eatmykïtty,dalaran,1563,monk,mistweaver,36,23,13
Frogsarecool,stormrage,1563,monk,mistweaver,40,20,20
Zkingmonk,stormrage,1563,monk,mistweaver,48,20,28
Rockcalm,malganis,1562,monk,mistweaver,74,38,36
Hatsu,madoran,1562,monk,mistweaver,155,79,76
Muzzen,fizzcrank,1562,monk,mistweaver,40,20,20
Tiduskies,crushridge,1562,monk,mistweaver,54,25,29
Bøkky,frostmourne,1561,monk,mistweaver,126,76,50
Spaazz,tichondrius,1561,monk,mistweaver,113,68,45
Fistuhcuffs,sargeras,1561,monk,mistweaver,87,49,38
Gsv,sargeras,1560,monk,mistweaver,144,82,62
Wide,scarlet-crusade,1560,monk,mistweaver,30,17,13
Voltekkor,tichondrius,1558,monk,mistweaver,32,18,14
Buoymoose,bleeding-hollow,1557,monk,mistweaver,53,35,18
Bunnygal,thaurissan,1557,monk,mistweaver,143,73,70
Bobthedrag,illidan,1555,monk,mistweaver,147,79,68
Pappaya,tichondrius,1554,monk,mistweaver,30,20,10
Aramonk,tichondrius,1554,monk,mistweaver,64,37,27
Lonebamboo,tichondrius,1553,monk,mistweaver,56,28,28
Jerumay,tichondrius,1552,monk,mistweaver,58,34,24
Zerker,nagrand,1552,monk,mistweaver,61,29,32
Nelly,grizzly-hills,1552,monk,mistweaver,36,17,19
Zugroi,frostmourne,1551,monk,mistweaver,30,25,5
Ekèl,tichondrius,1551,monk,mistweaver,113,60,53
Dedracula,quelthalas,1550,monk,mistweaver,51,37,14
Nailtech,tichondrius,1550,monk,mistweaver,66,37,29
Sabersatin,sargeras,1550,monk,mistweaver,42,21,21
Statue,cenarius,1549,monk,mistweaver,29,17,12
Hunkymonky,thrall,1549,monk,mistweaver,81,44,37
Kungfused,frostmourne,1549,monk,mistweaver,54,28,26
Frenchfries,dragonmaw,1547,monk,mistweaver,72,34,38
Krob,bleeding-hollow,1544,monk,mistweaver,33,17,16
Kymoshenz,sargeras,1543,monk,mistweaver,24,17,7
Lariv,bleeding-hollow,1543,monk,mistweaver,73,39,34
Haiyà,malganis,1542,monk,mistweaver,30,17,13
Monkatron,arthas,1542,monk,mistweaver,36,20,16
Sushî,eonar,1541,monk,mistweaver,24,19,5
Bruceki,bleeding-hollow,1540,monk,mistweaver,47,26,21
Omii,darkspear,1540,monk,mistweaver,34,17,17
Notfw,tichondrius,1540,monk,mistweaver,64,27,37
Lørðjimmy,sargeras,1539,monk,mistweaver,42,29,13
Soothinn,tichondrius,1536,monk,mistweaver,60,41,19
Scrapfu,proudmoore,1536,monk,mistweaver,83,44,39
Babychi,frostmourne,1535,monk,mistweaver,91,49,42
Fissg,frostmourne,1535,monk,mistweaver,48,25,23
Squaanched,emerald-dream,1535,monk,mistweaver,48,17,31
Forgèt,kelthuzad,1534,monk,mistweaver,30,16,14
Keileas,moon-guard,1534,monk,mistweaver,94,43,51
Austinm,tichondrius,1532,monk,mistweaver,24,16,8
Fehthermane,area-52,1531,monk,mistweaver,82,51,31
Jugies,emerald-dream,1531,monk,mistweaver,66,40,26
Jinjunxi,tichondrius,1531,monk,mistweaver,96,57,39
Kungpaofish,tichondrius,1531,monk,mistweaver,30,16,14
Ghorb,boulderfist,1530,monk,mistweaver,99,54,45
Jlowbob,tichondrius,1530,monk,mistweaver,96,51,45
Brucechez,tichondrius,1529,monk,mistweaver,24,16,8
Chiban,misha,1529,monk,mistweaver,30,18,12
Monkgyfatso,tichondrius,1528,monk,mistweaver,21,18,3
Napzzxo,sargeras,1528,monk,mistweaver,30,19,11
Banterx,sargeras,1528,monk,mistweaver,79,39,40
Carzo,area-52,1527,monk,mistweaver,38,23,15
Tirêd,sargeras,1526,monk,mistweaver,120,66,54
Turbofist,bleeding-hollow,1526,monk,mistweaver,35,17,18
Lépøissøn,tichondrius,1525,monk,mistweaver,30,16,14
Atsugin,khazgoroth,1525,monk,mistweaver,36,16,20
Ghim,frostmourne,1525,monk,mistweaver,102,45,57
Fister,garithos,1524,monk,mistweaver,70,46,24
Rockemsockem,gorefiend,1524,monk,mistweaver,72,41,31
Peezadelo,azralon,1523,monk,mistweaver,45,25,20
Mistohh,kiljaeden,1522,monk,mistweaver,24,16,8
Maripaulita,ragnaros,1522,monk,mistweaver,30,17,13
Marsha,tichondrius,1522,monk,mistweaver,72,31,41
Jitsu,frostmane,1521,monk,mistweaver,105,64,41
Gngrbeardman,tichondrius,1519,monk,mistweaver,39,21,18
Kiqz,stormrage,1519,monk,mistweaver,30,16,14
Yurm,moon-guard,1518,monk,mistweaver,54,38,16
Brewswayne,argent-dawn,1518,monk,mistweaver,36,23,13
Aledal,agamaggan,1517,monk,mistweaver,66,41,25
Dharma,khaz-modan,1517,monk,mistweaver,102,56,46
Ophibrew,zuljin,1516,monk,mistweaver,30,16,14
Romdansik,tichondrius,1515,monk,mistweaver,136,73,63
Mis,tichondrius,1514,monk,mistweaver,30,16,14
Voodubrew,area-52,1514,monk,mistweaver,48,24,24
Xenitate,bleeding-hollow,1513,monk,mistweaver,36,19,17
Chelada,sargeras,1513,monk,mistweaver,48,22,26
Sorowblade,lothar,1512,monk,mistweaver,56,35,21
Pcyesh,nemesis,1512,monk,mistweaver,92,50,42
Themonkfunk,bleeding-hollow,1511,monk,mistweaver,36,25,11
Wohrfnok,illidan,1511,monk,mistweaver,36,24,12
Justsidiousm,sargeras,1510,monk,mistweaver,36,26,10
Brewmanchew,frostmourne,1509,monk,mistweaver,135,75,60
Aristea,emerald-dream,1509,monk,mistweaver,30,16,14
Zettelkasten,tichondrius,1508,monk,mistweaver,42,18,24
Oakleet,bleeding-hollow,1507,monk,mistweaver,48,27,21
Chìforce,sargeras,1507,monk,mistweaver,53,23,30
Nelda,gorgonnash,1505,monk,mistweaver,108,64,44
Greenpigo,tichondrius,1504,monk,mistweaver,18,17,1
Närza,kelthuzad,1504,monk,mistweaver,54,30,24
Dextr,arthas,1503,monk,mistweaver,87,50,37
Hazelbazel,bleeding-hollow,1502,monk,mistweaver,42,27,15
Glad,stormscale,1502,monk,mistweaver,306,163,143
Santhz,ragnaros,1501,monk,mistweaver,24,16,8
Axellrod,tichondrius,1500,monk,mistweaver,60,38,22
Märthä,azralon,1500,monk,mistweaver,161,85,76
Grimaku,tichondrius,1500,monk,mistweaver,51,23,28
Dareelyst,arygos,1500,monk,mistweaver,42,17,25
Xomonik,borean-tundra,1499,monk,mistweaver,66,39,27
Ferrarí,quelthalas,1499,monk,mistweaver,281,153,128
Lekrosa,thrall,1499,monk,mistweaver,71,38,33
Beejae,tichondrius,1499,monk,mistweaver,31,16,15
Äncient,quelthalas,1497,monk,mistweaver,142,82,60
Tinypunch,emerald-dream,1496,monk,mistweaver,72,34,38
Missweaver,sargeras,1495,monk,mistweaver,78,39,39
Hiiyaa,tichondrius,1493,monk,mistweaver,128,63,65
Fidgetspinna,zuljin,1493,monk,mistweaver,44,21,23
Mcdubbles,korgath,1493,monk,mistweaver,48,20,28
Hoggs,sargeras,1492,monk,mistweaver,181,105,76
Showshoway,tichondrius,1492,monk,mistweaver,229,110,119
Seung,duskwood,1492,monk,mistweaver,255,121,134
Leemîn,tichondrius,1491,monk,mistweaver,42,30,12
Juchiyosamu,illidan,1491,monk,mistweaver,27,16,11
Caellum,quelthalas,1490,monk,mistweaver,41,27,14
Abdoolah,illidan,1488,monk,mistweaver,140,73,67
Fistnanweavn,dawnbringer,1488,monk,mistweaver,132,62,70
Jèricho,thrall,1487,monk,mistweaver,84,49,35
Conormonk,tichondrius,1486,monk,mistweaver,24,18,6
Vardeh,stormscale,1486,monk,mistweaver,96,59,37
Warzsong,azralon,1486,monk,mistweaver,54,33,21
Saeloon,frostmourne,1486,monk,mistweaver,77,36,41
Buddhabud,sargeras,1485,monk,mistweaver,54,28,26
Grandpå,tichondrius,1484,monk,mistweaver,42,23,19
Ebrew,frostmourne,1483,monk,mistweaver,60,37,23
Swiftyboi,tichondrius,1483,monk,mistweaver,132,64,68
Barnåcle,darkspear,1482,monk,mistweaver,60,37,23
Pagtuk,daggerspine,1482,monk,mistweaver,60,28,32
Phatcheeks,aegwynn,1480,monk,mistweaver,111,64,47
Âfrika,ysondre,1480,monk,mistweaver,65,31,34
Rômmul,azralon,1478,monk,mistweaver,48,32,16
Clipping,tichondrius,1478,monk,mistweaver,48,29,19
Monkybidness,tichondrius,1478,monk,mistweaver,51,24,27
Taigared,ragnaros,1478,monk,mistweaver,45,17,28
Talented,azuremyst,1477,monk,mistweaver,63,41,22
Bastilaqt,korgath,1477,monk,mistweaver,157,83,74
Ungankable,sargeras,1477,monk,mistweaver,303,156,147
Drfoochi,tichondrius,1477,monk,mistweaver,60,29,31
Srshy,drakkari,1477,monk,mistweaver,60,27,33
Monkpowaz,stormrage,1476,monk,mistweaver,42,26,16
Reque,illidan,1475,monk,mistweaver,234,132,102
Popchi,stormrage,1475,monk,mistweaver,48,18,30
Bruceteå,area-52,1473,monk,mistweaver,29,19,10
Mòñk,shattered-halls,1473,monk,mistweaver,42,26,16
Hymasterlol,tichondrius,1473,monk,mistweaver,60,28,32
Göat,emerald-dream,1472,monk,mistweaver,57,29,28
Wheygodx,lothar,1471,monk,mistweaver,42,28,14
Willowa,frostmourne,1470,monk,mistweaver,50,30,20
Fisthealz,area-52,1469,monk,mistweaver,30,22,8
Tuss,tichondrius,1468,monk,mistweaver,76,31,45
Dovhug,draenor,1465,monk,mistweaver,66,30,36
Gotmonk,aggramar,1464,monk,mistweaver,30,19,11
Ÿipman,frostmourne,1464,monk,mistweaver,48,22,26
Dangerkage,stormrage,1463,monk,mistweaver,42,17,25
Fattyboy,area-52,1462,monk,mistweaver,73,48,25
Brewball,illidan,1462,monk,mistweaver,41,24,17
Mustaf,stormrage,1462,monk,mistweaver,132,67,65
Iamamonk,kelthuzad,1461,monk,mistweaver,44,29,15
Lenee,frostmourne,1461,monk,mistweaver,39,25,14
Docwang,malganis,1460,monk,mistweaver,60,39,21
Topnotch,malganis,1460,monk,mistweaver,66,38,28
Odindad,tichondrius,1460,monk,mistweaver,108,57,51
Quinoo,emerald-dream,1460,monk,mistweaver,51,25,26
Himah,area-52,1460,monk,mistweaver,36,16,20
Gnomepuncher,dalaran,1459,monk,mistweaver,48,25,23
Iluvthugnmcz,sargeras,1459,monk,mistweaver,112,58,54
Fistea,frostmourne,1459,monk,mistweaver,51,24,27
Kazov,proudmoore,1458,monk,mistweaver,178,92,86
Hitaru,azralon,1457,monk,mistweaver,64,39,25
Çät,frostmourne,1457,monk,mistweaver,38,22,16
Guïnness,tichondrius,1455,monk,mistweaver,30,18,12
Americå,zuljin,1453,monk,mistweaver,60,39,21
Saulgóòdman,tichondrius,1453,monk,mistweaver,42,18,24
Fairyeflora,wyrmrest-accord,1452,monk,mistweaver,48,31,17
Rôbo,emerald-dream,1452,monk,mistweaver,29,16,13
Themys,zuljin,1451,monk,mistweaver,42,26,16
Rosellina,kelthuzad,1451,monk,mistweaver,38,23,15
Janeil,wyrmrest-accord,1451,monk,mistweaver,300,153,147
Baee,cairne,1451,monk,mistweaver,43,17,26
Pomonk,nazjatar,1450,monk,mistweaver,69,45,24
Jeolmyung,tichondrius,1450,monk,mistweaver,33,17,16
Mcfisted,area-52,1450,monk,mistweaver,81,41,40
Caliroll,gorefiend,1450,monk,mistweaver,70,31,39
Xtrememisty,frostmourne,1449,monk,mistweaver,66,35,31
Bresmeatfore,barthilas,1446,monk,mistweaver,54,33,21
Lidela,sargeras,1445,monk,mistweaver,52,27,25
Diagrams,tichondrius,1444,monk,mistweaver,23,16,7
Prf,ragnaros,1443,monk,mistweaver,69,39,30
Darkjab,tichondrius,1442,monk,mistweaver,48,22,26
Shenzuu,daggerspine,1441,monk,mistweaver,24,18,6
Meshugah,quelthalas,1441,monk,mistweaver,124,59,65
Kirshta,kelthuzad,1439,monk,mistweaver,38,28,10
Elcidx,tichondrius,1438,monk,mistweaver,24,15,9
Proctology,tichondrius,1438,monk,mistweaver,40,24,16
Zonianman,tichondrius,1438,monk,mistweaver,113,63,50
Nukeproof,stormreaver,1438,monk,mistweaver,31,16,15
Kariwanji,tichondrius,1438,monk,mistweaver,305,155,150
Bigs,duskwood,1438,monk,mistweaver,35,15,20
Taekwondope,antonidas,1437,monk,mistweaver,25,16,9
Cooltran,tichondrius,1437,monk,mistweaver,36,22,14
Kaelastra,stormrage,1437,monk,mistweaver,114,62,52
Nijl,sargeras,1436,monk,mistweaver,18,15,3
Grandsonweez,thrall,1436,monk,mistweaver,65,27,38
Xaurian,firetree,1435,monk,mistweaver,103,59,44
Outhume,eredar,1435,monk,mistweaver,30,15,15
Dhomonk,rexxar,1434,monk,mistweaver,29,17,12
Benex,tichondrius,1434,monk,mistweaver,35,19,16
Alinejat,auchindoun,1433,monk,mistweaver,24,15,9
Monktor,dalaran,1433,monk,mistweaver,78,41,37
Fartknocker,magtheridon,1433,monk,mistweaver,30,15,15
Safiel,proudmoore,1433,monk,mistweaver,118,51,67
Softer,frostmane,1432,monk,mistweaver,24,15,9
Jackâl,malganis,1432,monk,mistweaver,31,19,12
Mungka,tichondrius,1432,monk,mistweaver,94,47,47
Gotosleepkid,dalaran,1432,monk,mistweaver,50,25,25
Dåßz,illidan,1432,monk,mistweaver,49,22,27
Anxin,tichondrius,1431,monk,mistweaver,30,15,15
Kemmy,ravencrest,1429,monk,mistweaver,37,21,16
Fuqame,kiljaeden,1428,monk,mistweaver,42,19,23
Poundmedaddi,tichondrius,1427,monk,mistweaver,139,84,55
Titanus,chogall,1427,monk,mistweaver,48,26,22
Vorikson,stormrage,1426,monk,mistweaver,228,108,120
Jooshy,tichondrius,1426,monk,mistweaver,83,39,44
Fistlord,zuljin,1425,monk,mistweaver,32,18,14
Gomey,bleeding-hollow,1425,monk,mistweaver,32,18,14
Bbyyoda,illidan,1425,monk,mistweaver,132,70,62
Tenshu,runetotem,1425,monk,mistweaver,93,48,45
Mastamonksta,illidan,1425,monk,mistweaver,34,16,18
Pøkemonk,malganis,1424,monk,mistweaver,24,15,9
Chuks,nerzhul,1424,monk,mistweaver,212,117,95
Goocn,tichondrius,1424,monk,mistweaver,66,35,31
Bergoth,bleeding-hollow,1422,monk,mistweaver,24,15,9
Friskyfister,tichondrius,1422,monk,mistweaver,30,15,15
Brüce,ragnaros,1421,monk,mistweaver,57,33,24
Jasonmonk,sargeras,1420,monk,mistweaver,31,19,12
Sob,frostmourne,1420,monk,mistweaver,113,66,47
Taijutzu,darkspear,1419,monk,mistweaver,24,15,9
Mingchen,tichondrius,1419,monk,mistweaver,36,21,15
Telospateo,ragnaros,1418,monk,mistweaver,90,48,42
Mightbweavin,bleeding-hollow,1418,monk,mistweaver,126,58,68
Dumbmonk,frostmourne,1416,monk,mistweaver,18,15,3
Comonk,area-52,1416,monk,mistweaver,24,15,9
Punch,lothar,1414,monk,mistweaver,37,21,16
Bakus,tichondrius,1414,monk,mistweaver,35,19,16
Hadryan,proudmoore,1414,monk,mistweaver,190,96,94
Puoll,gallywix,1413,monk,mistweaver,128,68,60
Markofzugzug,tichondrius,1413,monk,mistweaver,36,15,21
Sihgriid,tichondrius,1412,monk,mistweaver,50,27,23
Alianli,tichondrius,1412,monk,mistweaver,65,16,49
Monkeybooze,sargeras,1411,monk,mistweaver,44,26,18
Thors,gorgonnash,1411,monk,mistweaver,78,44,34
Güwop,tichondrius,1411,monk,mistweaver,81,43,38
Ralphiex,tichondrius,1411,monk,mistweaver,101,53,48
Xenzas,chogall,1410,monk,mistweaver,29,17,12
Shoumi,turalyon,1410,monk,mistweaver,30,17,13
Noodalie,moon-guard,1408,monk,mistweaver,30,22,8
Nyght,moon-guard,1408,monk,mistweaver,96,41,55
Hungfuu,tichondrius,1407,monk,mistweaver,18,15,3
Knucklebadge,tichondrius,1407,monk,mistweaver,47,30,17
Sobuu,wyrmrest-accord,1406,monk,mistweaver,30,24,6
Zeelos,kelthuzad,1406,monk,mistweaver,24,15,9
Vegoku,moon-guard,1406,monk,mistweaver,137,72,65
Jmonks,stormrage,1406,monk,mistweaver,66,27,39
Sisfist,blackhand,1405,monk,mistweaver,30,16,14
Mistcrab,tichondrius,1403,monk,mistweaver,71,44,27
Thirteendads,turalyon,1403,monk,mistweaver,35,17,18
Sonicenergy,tichondrius,1402,monk,mistweaver,57,27,30
Xiang,dreadmaul,1401,monk,mistweaver,48,29,19
Zarma,stormrage,1401,monk,mistweaver,88,48,40
Lunarc,mannoroth,1401,monk,mistweaver,93,50,43
Bbunglee,tichondrius,1400,monk,mistweaver,41,27,14
Ric,gundrak,1400,monk,mistweaver,81,48,33
Waxxi,barthilas,1400,monk,mistweaver,135,78,57
Clyteai,arthas,1398,monk,mistweaver,24,16,8
Carlosm,tichondrius,1398,monk,mistweaver,30,19,11
Shyntä,dalaran,1396,monk,mistweaver,42,25,17
ßrewslèè,tichondrius,1396,monk,mistweaver,157,84,73
Pimpolhona,nemesis,1396,monk,mistweaver,126,61,65
Edbtz,illidan,1394,monk,mistweaver,24,18,6
Xyamïxo,tichondrius,1394,monk,mistweaver,60,35,25
Htm,barthilas,1392,monk,mistweaver,41,16,25
Mcfluffey,area-52,1391,monk,mistweaver,89,49,40
Metapôd,tichondrius,1389,monk,mistweaver,63,32,31
Damemasduro,ragnaros,1389,monk,mistweaver,554,270,284
Dblfistez,stormreaver,1389,monk,mistweaver,52,23,29
Twirl,mugthol,1389,monk,mistweaver,42,18,24
Hyugga,azralon,1388,monk,mistweaver,71,42,29
Taipanni,sargeras,1388,monk,mistweaver,40,16,24
Kymist,stormrage,1386,monk,mistweaver,134,71,63
Verelaana,moon-guard,1386,monk,mistweaver,41,21,20
Vum,quelthalas,1385,monk,mistweaver,21,16,5
Bârcõdë,tichondrius,1384,monk,mistweaver,36,23,13
Redweave,moon-guard,1383,monk,mistweaver,36,17,19
Flixz,stormrage,1382,monk,mistweaver,48,25,23
Riokhan,ragnaros,1381,monk,mistweaver,54,31,23
Ojiin,wyrmrest-accord,1381,monk,mistweaver,227,119,108
Valiantroar,shandris,1381,monk,mistweaver,38,16,22
Hummerkungfu,azralon,1380,monk,mistweaver,79,40,39
Phoenixspark,gnomeregan,1379,monk,mistweaver,44,30,14
Tanskee,sargeras,1378,monk,mistweaver,65,38,27
Akván,ragnaros,1378,monk,mistweaver,85,43,42
Shandaspanda,rivendare,1378,monk,mistweaver,54,26,28
Sangthos,darkspear,1378,monk,mistweaver,204,90,114
Monkol,nemesis,1377,monk,mistweaver,30,18,12
Sodosopaw,area-52,1376,monk,mistweaver,82,41,41
Pablojám,ragnaros,1375,monk,mistweaver,42,23,19
Mystafista,tichondrius,1375,monk,mistweaver,29,15,14
Xxgonchi,quelthalas,1374,monk,mistweaver,140,77,63
Afabled,drakkari,1373,monk,mistweaver,48,26,22
Ozen,burning-blade,1373,monk,mistweaver,74,38,36
Baroon,chogall,1373,monk,mistweaver,93,40,53
Metalmønk,nerzhul,1372,monk,mistweaver,43,29,14
Hybrid,draenor,1371,monk,mistweaver,36,21,15
Sinistuhm,tichondrius,1371,monk,mistweaver,47,25,22
Rhynoo,lothar,1371,monk,mistweaver,96,51,45
Kylièjenner,gilneas,1370,monk,mistweaver,70,39,31
Presas,nemesis,1370,monk,mistweaver,54,25,29
Thyfist,frostmourne,1369,monk,mistweaver,28,16,12
Beätfeet,tichondrius,1368,monk,mistweaver,30,19,11
Fonnf,nemesis,1368,monk,mistweaver,26,15,11
Vonn,drakkari,1368,monk,mistweaver,83,42,41
Fistful,destromath,1367,monk,mistweaver,18,15,3
Mintÿ,wyrmrest-accord,1366,monk,mistweaver,48,24,24
Trüa,stormrage,1364,monk,mistweaver,30,20,10
Soothem,tichondrius,1364,monk,mistweaver,103,64,39
Lanifer,area-52,1364,monk,mistweaver,35,20,15
Tianji,malganis,1363,monk,mistweaver,42,26,16
Tert,aerie-peak,1363,monk,mistweaver,146,83,63
Bibibi,moon-guard,1362,monk,mistweaver,30,15,15
Pepperoncini,korgath,1361,monk,mistweaver,93,43,50
Snuzzao,darkspear,1359,monk,mistweaver,44,22,22
Trixië,vashj,1358,monk,mistweaver,29,15,14
Tobyblack,illidan,1357,monk,mistweaver,123,60,63
Aokuâng,malganis,1356,monk,mistweaver,91,56,35
Ataxic,illidan,1355,monk,mistweaver,29,15,14
Ninjagordu,nemesis,1353,monk,mistweaver,118,57,61
Pandemikmonk,turalyon,1349,monk,mistweaver,48,22,26
Cdeez,malganis,1347,monk,mistweaver,36,23,13
Nornangus,sargeras,1346,monk,mistweaver,53,25,28
Monkqi,lightbringer,1344,monk,mistweaver,30,23,7
Hensing,malganis,1344,monk,mistweaver,24,14,10
Itsnoozes,illidan,1343,monk,mistweaver,18,14,4
Hydrig,ragnaros,1343,monk,mistweaver,18,14,4
Onegai,tichondrius,1343,monk,mistweaver,18,14,4
Rylens,draka,1343,monk,mistweaver,40,25,15
Siserfister,sargeras,1343,monk,mistweaver,24,14,10
Khylu,kelthuzad,1342,monk,mistweaver,18,14,4
Zor,stormscale,1342,monk,mistweaver,18,14,4
Cnww,tichondrius,1342,monk,mistweaver,24,14,10
Jonnymon,sargeras,1341,monk,mistweaver,18,14,4
Vulbeast,dalaran,1341,monk,mistweaver,18,14,4
Lustymonk,kelthuzad,1341,monk,mistweaver,18,14,4
Cilantrõ,malorne,1341,monk,mistweaver,30,21,9
Lõgan,azralon,1341,monk,mistweaver,58,29,29
Evyllyn,bleeding-hollow,1340,monk,mistweaver,18,14,4
Anthuri,frostmourne,1339,monk,mistweaver,95,62,33
Allegedheals,tichondrius,1339,monk,mistweaver,60,26,34
Pisswalker,area-52,1338,monk,mistweaver,18,14,4
Catmonk,the-forgotten-coast,1338,monk,mistweaver,24,14,10
Kungfuchious,dalaran,1338,monk,mistweaver,31,18,13
Sengesen,sargeras,1338,monk,mistweaver,28,15,13
Inkar,tichondrius,1338,monk,mistweaver,30,14,16
Ðamntaiyo,sargeras,1336,monk,mistweaver,35,19,16
Atruefister,tichondrius,1336,monk,mistweaver,79,42,37
Ryantiger,tichondrius,1336,monk,mistweaver,30,14,16
Karynia,illidan,1335,monk,mistweaver,110,56,54
Iielia,wyrmrest-accord,1335,monk,mistweaver,35,16,19
Streetjezus,bloodhoof,1335,monk,mistweaver,64,28,36
Limi,malganis,1334,monk,mistweaver,24,17,7
Chañi,ragnaros,1333,monk,mistweaver,59,33,26
Åvå,emerald-dream,1333,monk,mistweaver,73,29,44
Tamagotchi,emerald-dream,1332,monk,mistweaver,30,16,14
Naxanax,area-52,1332,monk,mistweaver,66,33,33
Jellobag,frostmane,1331,monk,mistweaver,24,14,10
Inebriated,auchindoun,1329,monk,mistweaver,24,14,10
Hotpotatoee,aerie-peak,1325,monk,mistweaver,129,66,63
Neww,tichondrius,1325,monk,mistweaver,58,25,33
Pandalee,skullcrusher,1324,monk,mistweaver,54,33,21
Tenzing,azgalor,1324,monk,mistweaver,24,14,10
Zenmasta,exodar,1324,monk,mistweaver,36,19,17
Awwchi,tichondrius,1324,monk,mistweaver,54,26,28
Moltenbeard,trollbane,1323,monk,mistweaver,54,35,19
Momochi,malygos,1323,monk,mistweaver,30,16,14
Turkspin,smolderthorn,1322,monk,mistweaver,33,24,9
Nerfmonk,spirestone,1322,monk,mistweaver,24,14,10
Pydelo,tichondrius,1322,monk,mistweaver,24,14,10
Precóggodx,tichondrius,1322,monk,mistweaver,24,14,10
Jeffdagnome,moon-guard,1320,monk,mistweaver,96,48,48
Zeevaliara,caelestrasz,1320,monk,mistweaver,30,15,15
Brewamp,zuljin,1320,monk,mistweaver,35,17,18
Psykhed,emerald-dream,1319,monk,mistweaver,78,33,45
Gerranni,wyrmrest-accord,1318,monk,mistweaver,24,16,8
Nazvik,quelthalas,1318,monk,mistweaver,24,14,10
Shon,frostmourne,1316,monk,mistweaver,24,14,10
Albusventos,azralon,1315,monk,mistweaver,35,21,14
Smackdat,azjolnerub,1315,monk,mistweaver,58,29,29
Kungfumika,ragnaros,1314,monk,mistweaver,48,23,25
Johnkreese,andorhal,1313,monk,mistweaver,30,14,16
Breezymist,doomhammer,1311,monk,mistweaver,30,14,16
Nuubchi,stormrage,1310,monk,mistweaver,24,14,10
Dashenna,illidan,1310,monk,mistweaver,84,32,52
Rollypunch,illidan,1309,monk,mistweaver,48,28,20
Orgrrim,area-52,1309,monk,mistweaver,24,14,10
Trapeez,kelthuzad,1308,monk,mistweaver,24,16,8
Asliam,undermine,1308,monk,mistweaver,36,23,13
Lotusdream,argent-dawn,1308,monk,mistweaver,90,46,44
Odogin,tichondrius,1307,monk,mistweaver,65,41,24
Valapan,tichondrius,1306,monk,mistweaver,72,39,33
Sweatweaver,frostmourne,1306,monk,mistweaver,94,43,51
Mango,spirestone,1305,monk,mistweaver,42,24,18
Hafu,wildhammer,1305,monk,mistweaver,54,29,25
Shizunô,stormrage,1305,monk,mistweaver,36,17,19
Fânnybâws,stormrage,1302,monk,mistweaver,36,18,18
Hirahxx,frostmourne,1301,monk,mistweaver,27,16,11
Melrose,kiljaeden,1301,monk,mistweaver,24,14,10
Bluemyselph,tichondrius,1300,monk,mistweaver,40,21,19
Endér,tichondrius,1300,monk,mistweaver,160,82,78
Kickbone,tichondrius,1300,monk,mistweaver,60,30,30
Raidenmnx,tichondrius,1300,monk,mistweaver,96,47,49
Chitacos,trollbane,1300,monk,mistweaver,30,14,16
Twinktoez,bleeding-hollow,1299,monk,mistweaver,26,15,11
Szuka,tichondrius,1297,monk,mistweaver,36,20,16
Kung,tichondrius,1297,monk,mistweaver,30,14,16
Monktyson,barthilas,1296,monk,mistweaver,66,43,23
Lawroadp,tichondrius,1295,monk,mistweaver,57,33,24
Rapope,quelthalas,1294,monk,mistweaver,65,32,33
Gguldduk,tichondrius,1292,monk,mistweaver,40,26,14
Ymiron,smolderthorn,1292,monk,mistweaver,42,15,27
Monkisses,bonechewer,1290,monk,mistweaver,65,36,29
Speedymonk,malfurion,1289,monk,mistweaver,60,25,35
Zarakna,sargeras,1288,monk,mistweaver,210,112,98
Giatzo,barthilas,1288,monk,mistweaver,73,35,38
Perzevel,azshara,1286,monk,mistweaver,30,19,11
Gallorex,frostmourne,1286,monk,mistweaver,42,24,18
Onekickman,dalaran,1283,monk,mistweaver,72,41,31
Healyboi,bronzebeard,1283,monk,mistweaver,52,22,30
Boozebear,spirestone,1282,monk,mistweaver,136,68,68
Kìmjungheal,tichondrius,1281,monk,mistweaver,41,21,20
Stendari,moon-guard,1281,monk,mistweaver,30,14,16
Tankozorr,zuljin,1281,monk,mistweaver,60,27,33
Chnzhs,tichondrius,1281,monk,mistweaver,58,18,40
Zeiana,proudmoore,1280,monk,mistweaver,38,22,16
Miçrosoft,area-52,1279,monk,mistweaver,78,46,32
Holdmychi,stormrage,1279,monk,mistweaver,55,29,26
Iloki,shuhalo,1279,monk,mistweaver,81,40,41
Siddlez,frostmourne,1278,monk,mistweaver,53,36,17
Byakugan,moon-guard,1277,monk,mistweaver,41,23,18
Börg,bleeding-hollow,1277,monk,mistweaver,38,19,19
Fludz,burning-blade,1276,monk,mistweaver,66,28,38
Kiso,sargeras,1274,monk,mistweaver,29,14,15
Tigraxus,proudmoore,1274,monk,mistweaver,43,19,24
Evilstep,tichondrius,1272,monk,mistweaver,131,68,63
Selfhealings,korgath,1272,monk,mistweaver,71,31,40
Zxychi,hyjal,1271,monk,mistweaver,23,14,9
Galiplays,zangarmarsh,1271,monk,mistweaver,35,19,16
Rustedbarrel,azjolnerub,1271,monk,mistweaver,46,23,23
Ratioed,moon-guard,1270,monk,mistweaver,65,45,20
Mortimir,echo-isles,1269,monk,mistweaver,42,21,21
Cthulumonk,lightnings-blade,1269,monk,mistweaver,36,14,22
Onlyhands,whisperwind,1268,monk,mistweaver,47,24,23
Makimä,stormrage,1267,monk,mistweaver,80,41,39
Miretunie,arathor,1266,monk,mistweaver,98,57,41
Monkeynut,whisperwind,1265,monk,mistweaver,125,65,60
Dragonwarior,zuluhed,1261,monk,mistweaver,26,15,11
Zenquadz,elune,1259,monk,mistweaver,36,25,11
Wmo,tichondrius,1258,monk,mistweaver,23,15,8
Marimonkori,stormscale,1258,monk,mistweaver,63,32,31
Monkêy,ghostlands,1258,monk,mistweaver,66,30,36
Keyszz,tichondrius,1258,monk,mistweaver,218,97,121
Teil,illidan,1257,monk,mistweaver,48,25,23
Pépto,bleeding-hollow,1257,monk,mistweaver,70,35,35
Zuchi,frostmourne,1255,monk,mistweaver,24,14,10
Ninjatoots,aerie-peak,1255,monk,mistweaver,79,42,37
Hongmeï,illidan,1254,monk,mistweaver,48,25,23
Liamaz,amanthul,1254,monk,mistweaver,30,14,16
Hungrydevil,tichondrius,1253,monk,mistweaver,30,15,15
Sayd,misha,1251,monk,mistweaver,24,15,9
Darkheälzz,sargeras,1251,monk,mistweaver,122,60,62
Omimonk,sargeras,1251,monk,mistweaver,56,24,32
Donnieyen,aerie-peak,1250,monk,mistweaver,19,14,5
Maiitoguy,illidan,1250,monk,mistweaver,48,24,24
Lelomonk,ragnaros,1249,monk,mistweaver,84,43,41
Afw,moon-guard,1248,monk,mistweaver,38,21,17
Shefcurry,boulderfist,1248,monk,mistweaver,24,13,11
Mwomegalul,sargeras,1248,monk,mistweaver,30,13,17
Ticmonk,frostmourne,1247,monk,mistweaver,18,13,5
Feel,frostmourne,1247,monk,mistweaver,18,13,5
Annisokay,bleeding-hollow,1247,monk,mistweaver,18,13,5
Beefyteet,tichondrius,1247,monk,mistweaver,18,13,5
Gothamonk,tichondrius,1247,monk,mistweaver,24,13,11
Demisodax,tichondrius,1247,monk,mistweaver,24,13,11
Mlngo,illidan,1247,monk,mistweaver,24,13,11
Steadfastsr,black-dragonflight,1246,monk,mistweaver,18,13,5
Mirokushan,skywall,1246,monk,mistweaver,117,65,52
Shinarri,thrall,1246,monk,mistweaver,141,77,64
Gottí,sargeras,1246,monk,mistweaver,24,13,11
Danceofchiji,tichondrius,1246,monk,mistweaver,24,13,11
Fheng,emerald-dream,1246,monk,mistweaver,24,13,11
Bullët,tichondrius,1246,monk,mistweaver,84,43,41
Cowsgonuts,gorefiend,1246,monk,mistweaver,30,13,17
Hîddëncløùdx,tichondrius,1245,monk,mistweaver,18,13,5
Nawzhy,emerald-dream,1245,monk,mistweaver,24,13,11
Drunkgiraffe,zuljin,1244,monk,mistweaver,18,13,5
Ironfistorm,stormrage,1244,monk,mistweaver,36,24,12
Shilakamesn,tichondrius,1244,monk,mistweaver,24,13,11
React,frostwolf,1242,monk,mistweaver,18,13,5
Psypalm,zuljin,1242,monk,mistweaver,18,13,5
Ammonk,bloodhoof,1242,monk,mistweaver,18,13,5
Kreacher,ravencrest,1242,monk,mistweaver,71,37,34
Rehder,barthilas,1241,monk,mistweaver,24,13,11
Puya,nemesis,1241,monk,mistweaver,36,18,18
Poppyharlow,saurfang,1240,monk,mistweaver,24,17,7
Darrhon,illidan,1240,monk,mistweaver,125,65,60
Meldrop,tichondrius,1240,monk,mistweaver,30,13,17
Miyung,quelthalas,1240,monk,mistweaver,30,13,17
Elmozosz,thrall,1239,monk,mistweaver,24,13,11
Noogiie,barthilas,1238,monk,mistweaver,22,14,8
Originalmonk,tichondrius,1237,monk,mistweaver,18,13,5
Madkickzack,blades-edge,1237,monk,mistweaver,30,13,17
Oyyo,tichondrius,1237,monk,mistweaver,95,35,60
Safigirl,doomhammer,1236,monk,mistweaver,67,39,28
Monkash,sargeras,1234,monk,mistweaver,24,13,11
Lolkungfu,spirestone,1234,monk,mistweaver,24,13,11
Madnox,sargeras,1234,monk,mistweaver,36,19,17
Kodrik,tichondrius,1234,monk,mistweaver,84,44,40
Vchii,tichondrius,1234,monk,mistweaver,30,13,17
Midfrie,ghostlands,1233,monk,mistweaver,24,15,9
Knaveus,frostmourne,1233,monk,mistweaver,54,30,24
Critôris,tichondrius,1233,monk,mistweaver,24,13,11
Lothnälar,ragnaros,1231,monk,mistweaver,36,26,10
Azizyzz,barthilas,1231,monk,mistweaver,42,20,22
Kaølin,azralon,1228,monk,mistweaver,18,13,5
Fkedyourwife,dalaran,1227,monk,mistweaver,30,13,17
Gôrr,tichondrius,1226,monk,mistweaver,42,23,19
Zefta,moon-guard,1226,monk,mistweaver,42,18,24
Dirtyshef,deathwing,1225,monk,mistweaver,75,32,43
Petsëmatary,bleeding-hollow,1224,monk,mistweaver,41,16,25
Cheesemónk,tichondrius,1222,monk,mistweaver,30,13,17
Habuba,eredar,1221,monk,mistweaver,18,13,5
Binghe,illidan,1221,monk,mistweaver,63,35,28
Monxellius,moon-guard,1221,monk,mistweaver,105,51,54
Ninjahogan,azgalor,1221,monk,mistweaver,32,15,17
Xstepfister,tichondrius,1220,monk,mistweaver,52,25,27
Zignzag,stormscale,1220,monk,mistweaver,36,13,23
Cammy,aerie-peak,1219,monk,mistweaver,32,20,12
Pixelface,barthilas,1218,monk,mistweaver,18,13,5
Troutline,bonechewer,1218,monk,mistweaver,84,50,34
Hashìba,kiljaeden,1217,monk,mistweaver,18,13,5
Xulieng,tichondrius,1215,monk,mistweaver,331,169,162
Sedition,emerald-dream,1215,monk,mistweaver,323,162,161
Ludafist,whisperwind,1212,monk,mistweaver,72,37,35
Enfoque,quelthalas,1210,monk,mistweaver,77,43,34
Monknificent,medivh,1210,monk,mistweaver,36,15,21
Aeress,kelthuzad,1208,monk,mistweaver,30,13,17
Chaotics,bleeding-hollow,1207,monk,mistweaver,41,25,16
Razod,stormrage,1207,monk,mistweaver,223,115,108
Stephani,turalyon,1207,monk,mistweaver,43,22,21
Tjitsu,zuljin,1207,monk,mistweaver,38,19,19
Haruko,baelgun,1207,monk,mistweaver,46,14,32
Biggoosie,korgath,1206,monk,mistweaver,76,47,29
Chunkynorris,stormscale,1206,monk,mistweaver,38,18,20
Foomanshoes,shandris,1204,monk,mistweaver,52,14,38
Dokfu,tichondrius,1201,monk,mistweaver,207,113,94
Chainwax,korgath,1201,monk,mistweaver,56,30,26
Taichichuan,tichondrius,1201,monk,mistweaver,71,36,35
Ieatshrooms,malfurion,1201,monk,mistweaver,66,26,40
Elcidw,tichondrius,1200,monk,mistweaver,21,14,7
Lenakai,malganis,1199,monk,mistweaver,35,13,22
Michaeljordn,destromath,1199,monk,mistweaver,44,16,28
Menadraene,wyrmrest-accord,1198,monk,mistweaver,26,14,12
Wraithfire,uldum,1197,monk,mistweaver,48,24,24
Dasubb,crushridge,1196,monk,mistweaver,23,13,10
Puffpuffp,nazgrel,1196,monk,mistweaver,24,13,11
Zsalcior,jaedenar,1195,monk,mistweaver,36,24,12
Drexlla,barthilas,1191,monk,mistweaver,38,23,15
Titofresh,quelthalas,1191,monk,mistweaver,33,15,18
Eqoy,moon-guard,1191,monk,mistweaver,30,13,17
Raphzen,stormrage,1189,monk,mistweaver,33,17,16
Soapy,moon-guard,1188,monk,mistweaver,35,16,19
Littlegeorge,moon-guard,1187,monk,mistweaver,36,24,12
Smokee,blackhand,1187,monk,mistweaver,30,15,15
Tusil,tichondrius,1187,monk,mistweaver,36,13,23
Hinudhera,barthilas,1186,monk,mistweaver,104,51,53
Soderbergh,ysera,1185,monk,mistweaver,36,13,23
Valdosta,bloodscalp,1183,monk,mistweaver,54,29,25
Joeyfists,frostwolf,1181,monk,mistweaver,38,19,19
Noctes,thunderlord,1179,monk,mistweaver,36,22,14
Blackthorne,illidan,1179,monk,mistweaver,30,14,16
Kreezoo,tichondrius,1178,monk,mistweaver,51,24,27
Kromkwando,burning-blade,1177,monk,mistweaver,42,13,29
Iseeyouqt,tichondrius,1176,monk,mistweaver,20,13,7
Monkoala,illidan,1176,monk,mistweaver,42,21,21
Touchkarma,stormrage,1175,monk,mistweaver,90,45,45
Mongénoio,nemesis,1172,monk,mistweaver,26,13,13
Purging,draka,1171,monk,mistweaver,98,68,30
Touzin,bleeding-hollow,1171,monk,mistweaver,28,14,14
Hamandchi,sargeras,1169,monk,mistweaver,23,16,7
Evílryü,quelthalas,1168,monk,mistweaver,27,16,11
Gazzoxsan,chogall,1168,monk,mistweaver,31,13,18
Lumïnous,moon-guard,1167,monk,mistweaver,36,17,19
Daddyrugburn,area-52,1167,monk,mistweaver,53,25,28
Hie,laughing-skull,1166,monk,mistweaver,90,38,52
Shwankeesha,thrall,1165,monk,mistweaver,28,14,14
Miraculer,drakkari,1163,monk,mistweaver,28,14,14
Chèmosh,fenris,1162,monk,mistweaver,29,13,16
Polofasho,illidan,1159,monk,mistweaver,23,13,10
Madmint,illidan,1159,monk,mistweaver,60,26,34
Stevejabz,malganis,1156,monk,mistweaver,30,13,17
Callibella,amanthul,1155,monk,mistweaver,26,13,13
Hammonk,deathwing,1154,monk,mistweaver,36,20,16
Orenj,boulderfist,1154,monk,mistweaver,36,17,19
Fudoki,area-52,1153,monk,mistweaver,36,13,23
Envymonk,tichondrius,1152,monk,mistweaver,18,12,6
Magmuruk,garrosh,1152,monk,mistweaver,18,12,6
Qimeng,sargeras,1152,monk,mistweaver,30,12,18
Iilgayrob,stormrage,1151,monk,mistweaver,18,12,6
Karaka,ysera,1151,monk,mistweaver,22,14,8
Bigthing,burning-blade,1151,monk,mistweaver,24,12,12
Danceschi,area-52,1151,monk,mistweaver,24,12,12
Billycobham,tichondrius,1151,monk,mistweaver,24,12,12
Affrika,ragnaros,1151,monk,mistweaver,53,25,28
Møzy,darkspear,1150,monk,mistweaver,18,12,6
Pissweever,barthilas,1150,monk,mistweaver,18,12,6
Ragepalm,aegwynn,1150,monk,mistweaver,36,19,17
Monkybizniss,skywall,1150,monk,mistweaver,24,12,12
Habaneroz,wyrmrest-accord,1150,monk,mistweaver,24,12,12
Shaweaver,caelestrasz,1150,monk,mistweaver,24,12,12
Strixx,silvermoon,1148,monk,mistweaver,30,21,9
Onlythumbs,area-52,1148,monk,mistweaver,18,12,6
Zallie,frostmourne,1147,monk,mistweaver,18,12,6
Jïngwei,proudmoore,1147,monk,mistweaver,24,12,12
Smashgordon,burning-legion,1147,monk,mistweaver,30,12,18
Bopmykarma,kelthuzad,1146,monk,mistweaver,25,12,13
Kaniou,proudmoore,1146,monk,mistweaver,29,13,16
Azenia,barthilas,1146,monk,mistweaver,30,12,18
Kelpri,sentinels,1145,monk,mistweaver,18,12,6
Jagichan,area-52,1145,monk,mistweaver,18,12,6
Monkaveli,ursin,1145,monk,mistweaver,78,37,41
Antimoine,saurfang,1144,monk,mistweaver,54,31,23
Monkgov,illidan,1144,monk,mistweaver,24,12,12
Bozzychi,illidan,1143,monk,mistweaver,30,12,18
Onemonkk,tichondrius,1141,monk,mistweaver,132,72,60
Uwufistgodx,tichondrius,1141,monk,mistweaver,30,12,18
Crankxx,malganis,1139,monk,mistweaver,21,13,8
Frothy,bleeding-hollow,1139,monk,mistweaver,24,12,12
Dreadknotz,hyjal,1139,monk,mistweaver,51,25,26
Calmemaybe,darkspear,1138,monk,mistweaver,18,12,6
Tetsuo,altar-of-storms,1137,monk,mistweaver,18,12,6
Çuß,kelthuzad,1137,monk,mistweaver,30,12,18
Darksoult,kelthuzad,1136,monk,mistweaver,72,23,49
Kexti,wyrmrest-accord,1135,monk,mistweaver,45,18,27
Paraíba,azralon,1135,monk,mistweaver,35,12,23
Illushadio,moon-guard,1132,monk,mistweaver,18,12,6
Herbivorous,sargeras,1131,monk,mistweaver,24,12,12
Hastle,windrunner,1130,monk,mistweaver,78,43,35
Modelman,area-52,1130,monk,mistweaver,26,14,12
Gobfu,emerald-dream,1130,monk,mistweaver,65,26,39
Chicheez,sargeras,1129,monk,mistweaver,22,13,9
Ciru,zangarmarsh,1129,monk,mistweaver,43,18,25
Kongpoo,kelthuzad,1127,monk,mistweaver,21,14,7
Atiantian,proudmoore,1127,monk,mistweaver,36,12,24
Fitmonje,drakkari,1126,monk,mistweaver,43,22,21
Boostmonk,terenas,1126,monk,mistweaver,78,34,44
Fistmeister,tichondrius,1125,monk,mistweaver,30,19,11
Crãsh,quelthalas,1125,monk,mistweaver,28,15,13
Rxtea,darkspear,1124,monk,mistweaver,25,13,12
Tübes,trollbane,1122,monk,mistweaver,24,12,12
Ursorcen,frostmourne,1122,monk,mistweaver,33,16,17
Honjada,tichondrius,1121,monk,mistweaver,18,12,6
Jighte,illidan,1121,monk,mistweaver,30,16,14
Tinze,bonechewer,1121,monk,mistweaver,43,17,26
Tsyatvo,illidan,1119,monk,mistweaver,24,14,10
Fluffykitty,deathwing,1119,monk,mistweaver,45,19,26
Whiteknight,tichondrius,1118,monk,mistweaver,14,13,1
Orbí,tichondrius,1113,monk,mistweaver,54,35,19
Lepasfin,sargeras,1112,monk,mistweaver,30,20,10
Sukrit,darkspear,1111,monk,mistweaver,52,24,28
Halfaling,tichondrius,1109,monk,mistweaver,18,12,6
Rosinhood,illidan,1109,monk,mistweaver,80,41,39
Shaolyyn,zuljin,1107,monk,mistweaver,156,82,74
Kafuru,quelthalas,1105,monk,mistweaver,22,13,9
Lolcutie,shandris,1105,monk,mistweaver,37,21,16
Rowbur,thrall,1101,monk,mistweaver,57,36,21
Emenboats,zuljin,1096,monk,mistweaver,70,44,26
Fruitcakezz,arthas,1095,monk,mistweaver,18,12,6
Kimonk,proudmoore,1095,monk,mistweaver,36,21,15
Lushona,ragnaros,1093,monk,mistweaver,36,26,10
Gentle,cenarius,1093,monk,mistweaver,26,12,14
Shoguns,zuljin,1091,monk,mistweaver,48,24,24
Keekirx,tichondrius,1088,monk,mistweaver,28,14,14
Zendemic,thrall,1087,monk,mistweaver,60,36,24
Coachputmein,barthilas,1086,monk,mistweaver,17,12,5
Skydouken,sargeras,1086,monk,mistweaver,22,12,10
Focalors,proudmoore,1085,monk,mistweaver,20,12,8
Knucklez,frostwolf,1078,monk,mistweaver,90,49,41
Pwned,ghostlands,1078,monk,mistweaver,63,21,42
Lzt,ragnaros,1075,monk,mistweaver,34,13,21
Hapgido,deathwing,1074,monk,mistweaver,62,31,31
Harryrichard,sargeras,1073,monk,mistweaver,23,12,11
Lita,barthilas,1071,monk,mistweaver,17,12,5
Keeanuweaves,tichondrius,1069,monk,mistweaver,13,12,1
Hakushin,ragnaros,1067,monk,mistweaver,36,20,16
Jackburton,deathwing,1066,monk,mistweaver,18,13,5
Lizavet,stormrage,1065,monk,mistweaver,30,22,8
Cosetteb,proudmoore,1064,monk,mistweaver,23,12,11
Shanalot,stormrage,1063,monk,mistweaver,19,12,7
Hache,azjolnerub,1062,monk,mistweaver,86,37,49
Chugs,malorne,1062,monk,mistweaver,57,16,41
Duelist,the-scryers,1056,monk,mistweaver,12,11,1
Jmanownz,stormrage,1056,monk,mistweaver,12,11,1
Spirits,dreadmaul,1056,monk,mistweaver,18,11,7
Haren,gundrak,1056,monk,mistweaver,18,11,7
Mistussy,sargeras,1056,monk,mistweaver,18,11,7
Yangzai,tichondrius,1056,monk,mistweaver,18,11,7
Saitamâ,tichondrius,1056,monk,mistweaver,18,11,7
Mxxb,illidan,1056,monk,mistweaver,18,11,7
Solidww,moon-guard,1055,monk,mistweaver,12,11,1
Alandis,spinebreaker,1055,monk,mistweaver,18,11,7
Ninjachavez,tichondrius,1055,monk,mistweaver,18,11,7
Ephéyxq,area-52,1055,monk,mistweaver,18,11,7
Undertickle,illidan,1055,monk,mistweaver,18,11,7
Iplus,thrall,1055,monk,mistweaver,18,11,7
Axibar,tichondrius,1055,monk,mistweaver,18,11,7
Ryanx,azjolnerub,1055,monk,mistweaver,18,11,7
Stephenia,tichondrius,1055,monk,mistweaver,18,11,7
Fkinbis,area-52,1055,monk,mistweaver,18,11,7
Lemmetouch,illidan,1055,monk,mistweaver,24,11,13
Dowzk,tichondrius,1055,monk,mistweaver,24,11,13
Imafqnbaby,tichondrius,1055,monk,mistweaver,24,11,13
Chillionaíre,proudmoore,1055,monk,mistweaver,24,11,13
Kriticalkush,kelthuzad,1055,monk,mistweaver,24,11,13
Taelinn,moonrunner,1055,monk,mistweaver,30,11,19
Raonoc,area-52,1055,monk,mistweaver,30,11,19
Evilbit,boulderfist,1054,monk,mistweaver,18,11,7
Børraicho,ragnaros,1054,monk,mistweaver,18,11,7
Phazorr,frostmourne,1054,monk,mistweaver,18,11,7
Punchopuncho,malganis,1054,monk,mistweaver,24,11,13
Cungflu,crushridge,1054,monk,mistweaver,24,11,13
Zhuangnimane,tichondrius,1053,monk,mistweaver,12,11,1
Shogundachi,moon-guard,1053,monk,mistweaver,21,13,8
Lindraice,illidan,1053,monk,mistweaver,18,11,7
Zoochans,tichondrius,1053,monk,mistweaver,67,40,27
Walmartguard,arthas,1053,monk,mistweaver,40,20,20
Arahabaki,wyrmrest-accord,1053,monk,mistweaver,24,11,13
Topanga,azralon,1053,monk,mistweaver,42,12,30
Theymistbuda,kelthuzad,1052,monk,mistweaver,12,11,1
Djslimweaver,stormrage,1052,monk,mistweaver,14,11,3
Wungpo,the-forgotten-coast,1052,monk,mistweaver,18,11,7
Havasupai,turalyon,1052,monk,mistweaver,18,11,7
Creamchop,stormreaver,1052,monk,mistweaver,18,11,7
Vayce,barthilas,1052,monk,mistweaver,24,11,13
Karnbroo,frostmourne,1052,monk,mistweaver,24,11,13
Benedïct,korgath,1052,monk,mistweaver,24,11,13
Zenspice,stormrage,1051,monk,mistweaver,18,11,7
Rolybones,boulderfist,1051,monk,mistweaver,19,11,8
Steenkk,tichondrius,1051,monk,mistweaver,60,29,31
Superbae,area-52,1051,monk,mistweaver,24,11,13
Dégg,thrall,1050,monk,mistweaver,18,11,7
Jimmythemist,mugthol,1050,monk,mistweaver,18,11,7
Eldrik,stormrage,1050,monk,mistweaver,18,11,7
Sevenpunch,area-52,1050,monk,mistweaver,30,11,19
Dellunnax,azralon,1049,monk,mistweaver,18,11,7
Pichiquechi,frostmourne,1049,monk,mistweaver,24,11,13
Lochekx,stonemaul,1048,monk,mistweaver,48,17,31
Ilani,malganis,1047,monk,mistweaver,18,11,7
Monky,black-dragonflight,1047,monk,mistweaver,18,11,7
Decha,skywall,1047,monk,mistweaver,18,11,7
Shaolinmists,malganis,1045,monk,mistweaver,12,11,1
Feynzen,frostmourne,1044,monk,mistweaver,18,11,7
Xbrewtal,tichondrius,1043,monk,mistweaver,128,71,57
Philthyjutsu,moon-guard,1042,monk,mistweaver,12,11,1
Dustyweaver,illidan,1039,monk,mistweaver,55,22,33
Patman,nazjatar,1038,monk,mistweaver,18,12,6
Teancrumpets,wyrmrest-accord,1038,monk,mistweaver,48,20,28
Leësin,ragnaros,1037,monk,mistweaver,18,11,7
Blorkk,area-52,1035,monk,mistweaver,18,11,7
Rektfu,emerald-dream,1033,monk,mistweaver,27,13,14
Tadaku,dalaran,1033,monk,mistweaver,37,17,20
Reinah,malganis,1033,monk,mistweaver,30,11,19
Poem,grizzly-hills,1032,monk,mistweaver,21,12,9
Mahhnaga,tichondrius,1032,monk,mistweaver,101,42,59
Merand,tichondrius,1031,monk,mistweaver,36,20,16
Baiji,gorefiend,1030,monk,mistweaver,12,11,1
Esotericzeo,mugthol,1030,monk,mistweaver,72,35,37
Chopy,dragonblight,1030,monk,mistweaver,66,32,34
Ahshurra,blackhand,1029,monk,mistweaver,41,14,27
Joxo,nordrassil,1028,monk,mistweaver,18,13,5
Marnartou,zuljin,1026,monk,mistweaver,12,11,1
Ambuinc,burning-blade,1024,monk,mistweaver,18,11,7
Dalillamas,sargeras,1023,monk,mistweaver,14,12,2
Schein,sargeras,1023,monk,mistweaver,17,11,6
Koyon,sargeras,1023,monk,mistweaver,17,11,6
Nezukó,malganis,1022,monk,mistweaver,17,11,6
Venomqt,laughing-skull,1021,monk,mistweaver,17,11,6
Ghostmk,nagrand,1021,monk,mistweaver,30,12,18
Grizzchan,sargeras,1017,monk,mistweaver,17,11,6
Ainz,nagrand,1016,monk,mistweaver,30,15,15
Kocksnapper,stormreaver,1014,monk,mistweaver,86,48,38
Vitcheztein,ragnaros,1007,monk,mistweaver,17,11,6
Twizzurp,magtheridon,1007,monk,mistweaver,21,12,9
Bigjuicers,bleeding-hollow,1006,monk,mistweaver,17,11,6
Supmybrew,frostmourne,1005,monk,mistweaver,23,11,12
Kpeste,tichondrius,1002,monk,mistweaver,78,41,37
Vencö,tichondrius,1001,monk,mistweaver,33,11,22
Yookho,tichondrius,1000,monk,mistweaver,17,12,5
Matchuh,stormrage,1000,monk,mistweaver,55,24,31
Clutchinmist,malganis,1000,monk,mistweaver,40,12,28
Bearchi,sargeras,997,monk,mistweaver,21,12,9
Telrande,ysondre,994,monk,mistweaver,35,24,11
Beefdadyfist,tichondrius,994,monk,mistweaver,36,14,22
Gòss,azgalor,993,monk,mistweaver,61,25,36
Tisafister,kelthuzad,992,monk,mistweaver,28,12,16
Honorviejos,illidan,991,monk,mistweaver,23,11,12
Bonquavius,thrall,990,monk,mistweaver,20,11,9
Whitepotato,bleeding-hollow,986,monk,mistweaver,132,69,63
Lilbee,azjolnerub,986,monk,mistweaver,23,12,11
Mintbear,illidan,984,monk,mistweaver,14,11,3
Silito,drakkari,981,monk,mistweaver,138,55,83
Bomer,moknathal,980,monk,mistweaver,49,29,20
Monkgringo,azralon,978,monk,mistweaver,76,40,36
Winniethepoo,borean-tundra,975,monk,mistweaver,19,11,8
Ogsimpsonn,tichondrius,972,monk,mistweaver,20,11,9
Kfpanda,hellscream,971,monk,mistweaver,83,38,45
Soulex,blackwater-raiders,970,monk,mistweaver,23,12,11
Deadlyzz,gilneas,970,monk,mistweaver,99,51,48
Sipu,wyrmrest-accord,969,monk,mistweaver,41,20,21
Djwushu,blackhand,969,monk,mistweaver,26,11,15
Klanianhere,sargeras,960,monk,mistweaver,12,10,2
Gnet,azralon,960,monk,mistweaver,12,10,2
Woes,stormreaver,960,monk,mistweaver,12,10,2
Toonahroll,area-52,960,monk,mistweaver,12,10,2
Hype,ursin,960,monk,mistweaver,12,10,2
Drizzywow,arathor,960,monk,mistweaver,12,10,2
Wordword,tichondrius,960,monk,mistweaver,18,10,8
Impersonal,sargeras,960,monk,mistweaver,18,10,8
Thatfknguy,sargeras,960,monk,mistweaver,18,10,8
Mauvem,tichondrius,960,monk,mistweaver,18,10,8
Titti,korgath,960,monk,mistweaver,18,10,8
Agilities,sargeras,960,monk,mistweaver,18,10,8
Mywave,bleeding-hollow,960,monk,mistweaver,18,10,8
Chevvy,azshara,960,monk,mistweaver,18,10,8
Syro,spinebreaker,960,monk,mistweaver,18,10,8
Greenfriend,illidan,960,monk,mistweaver,18,10,8
Dapperdabz,illidan,960,monk,mistweaver,18,10,8
Suitosky,ragnaros,960,monk,mistweaver,24,10,14
Barlyfe,tichondrius,960,monk,mistweaver,24,10,14
Sharpstorm,darkspear,959,monk,mistweaver,12,10,2
Mïstyfïsty,moon-guard,959,monk,mistweaver,12,10,2
Hanlover,tichondrius,959,monk,mistweaver,12,10,2
Shâdòw,ragnaros,959,monk,mistweaver,12,10,2
Nezkabad,frostmourne,959,monk,mistweaver,12,10,2
Chanîng,frostmourne,959,monk,mistweaver,18,10,8
Melpaine,frostmourne,959,monk,mistweaver,18,10,8
Diâblomw,barthilas,959,monk,mistweaver,18,10,8
Truefists,stormrage,959,monk,mistweaver,18,10,8
Insidedog,frostmourne,959,monk,mistweaver,18,10,8
Beaver,zuljin,959,monk,mistweaver,18,10,8
Monkmarz,malygos,959,monk,mistweaver,23,10,13
Anabolicx,khazgoroth,959,monk,mistweaver,24,10,14
Pumpsx,area-52,959,monk,mistweaver,24,10,14
Twïst,tichondrius,958,monk,mistweaver,12,10,2
Kåtê,sargeras,958,monk,mistweaver,12,10,2
Trazmold,emerald-dream,958,monk,mistweaver,18,10,8
Fïish,stormrage,958,monk,mistweaver,18,10,8
Nientea,wyrmrest-accord,958,monk,mistweaver,18,10,8
Lostinmistz,tichondrius,958,monk,mistweaver,18,10,8
Fistfreak,stormrage,957,monk,mistweaver,18,10,8
Inkers,detheroc,957,monk,mistweaver,18,10,8
Oldfashheals,tichondrius,957,monk,mistweaver,24,10,14
Mizzycash,malganis,957,monk,mistweaver,26,10,16
Strokahontas,stormreaver,957,monk,mistweaver,42,10,32
Bamboozile,arthas,956,monk,mistweaver,18,10,8
Diligentmonk,illidan,955,monk,mistweaver,27,11,16
Indigojo,silver-hand,955,monk,mistweaver,30,10,20
Bojflow,dalaran,954,monk,mistweaver,18,10,8
Wessex,sargeras,954,monk,mistweaver,18,10,8
Prodivuss,stormrage,954,monk,mistweaver,24,10,14
Aotd,tichondrius,954,monk,mistweaver,24,10,14
Divaweaver,sargeras,953,monk,mistweaver,24,10,14
Daddbear,kiljaeden,952,monk,mistweaver,18,10,8
Kurtall,area-52,952,monk,mistweaver,24,10,14
Rdmptn,bleeding-hollow,952,monk,mistweaver,24,10,14
Fìst,hyjal,951,monk,mistweaver,18,10,8
Kailzchi,area-52,951,monk,mistweaver,18,10,8
Brewtalitops,illidan,950,monk,mistweaver,18,10,8
Shinobui,jubeithos,950,monk,mistweaver,18,10,8
Lañdo,uldaman,950,monk,mistweaver,23,12,11
Omegasix,nazjatar,949,monk,mistweaver,18,10,8
Palomagozzu,ragnaros,947,monk,mistweaver,18,10,8
Howu,tichondrius,947,monk,mistweaver,35,12,23
Jæmz,moon-guard,944,monk,mistweaver,36,13,23
Kiyou,drakkari,940,monk,mistweaver,18,10,8
Kyndrïa,tichondrius,938,monk,mistweaver,155,71,84
Nigondatnay,tichondrius,927,monk,mistweaver,16,11,5
Sahalee,sargeras,927,monk,mistweaver,38,18,20
Ultramaga,dentarg,927,monk,mistweaver,28,10,18
Nosweaver,malganis,926,monk,mistweaver,14,11,3
Tcoon,frostmourne,925,monk,mistweaver,26,11,15
Siamack,illidan,920,monk,mistweaver,14,11,3
Kratis,doomhammer,915,monk,mistweaver,71,28,43
Karkata,sargeras,914,monk,mistweaver,48,20,28
Kangeroo,tichondrius,912,monk,mistweaver,21,11,10
Sensey,veknilash,910,monk,mistweaver,17,10,7
Julox,azralon,910,monk,mistweaver,18,10,8
Lovechabill,darkspear,906,monk,mistweaver,17,10,7
Ægo,sargeras,906,monk,mistweaver,22,11,11
Xentra,stormrage,895,monk,mistweaver,11,10,1
Griddio,wyrmrest-accord,895,monk,mistweaver,14,10,4
Delassian,moon-guard,894,monk,mistweaver,37,16,21
Inbu,tichondrius,893,monk,mistweaver,26,10,16
Gino,proudmoore,890,monk,mistweaver,214,99,115
Stickbundle,illidan,888,monk,mistweaver,15,11,4
Edj,drenden,884,monk,mistweaver,75,37,38
Boojaa,silvermoon,882,monk,mistweaver,83,33,50
Madmoose,smolderthorn,879,monk,mistweaver,48,18,30
Galyndra,darkspear,877,monk,mistweaver,13,10,3
Imnumberone,alterac-mountains,864,monk,mistweaver,12,9,3
Rumor,lethon,864,monk,mistweaver,12,9,3
Daneil,illidan,864,monk,mistweaver,12,9,3
Franqx,tichondrius,864,monk,mistweaver,12,9,3
Ggonext,wyrmrest-accord,864,monk,mistweaver,12,9,3
Flicksx,arthas,864,monk,mistweaver,12,9,3
Zbhm,illidan,864,monk,mistweaver,12,9,3
Sâx,stormreaver,864,monk,mistweaver,12,9,3
Horndog,skullcrusher,864,monk,mistweaver,12,9,3
Mistyfisty,laughing-skull,864,monk,mistweaver,14,9,5
Xitearith,ragnaros,864,monk,mistweaver,18,9,9
Pinkfairy,wyrmrest-accord,864,monk,mistweaver,18,9,9
Kármah,emerald-dream,864,monk,mistweaver,18,9,9
Pantypirate,tichondrius,864,monk,mistweaver,18,9,9
Hulkhogan,mugthol,863,monk,mistweaver,14,11,3
Brewley,thrall,863,monk,mistweaver,12,9,3
Theminivan,sargeras,863,monk,mistweaver,12,9,3
Brewtillis,tichondrius,863,monk,mistweaver,12,9,3
Ztalian,moon-guard,863,monk,mistweaver,12,9,3
Kazzichi,area-52,863,monk,mistweaver,12,9,3
Beastmonk,sargeras,863,monk,mistweaver,12,9,3
Tjab,kiljaeden,863,monk,mistweaver,18,9,9
Neverfake,sargeras,863,monk,mistweaver,18,9,9
Shadowbringr,proudmoore,863,monk,mistweaver,18,9,9
Strummies,tichondrius,863,monk,mistweaver,18,9,9
Bootytoes,emerald-dream,863,monk,mistweaver,18,9,9
Srgtbingo,azgalor,863,monk,mistweaver,18,9,9
Boothchi,kelthuzad,863,monk,mistweaver,18,9,9
Sumaran,hydraxis,863,monk,mistweaver,18,9,9
Fìst,zuljin,863,monk,mistweaver,18,9,9
Slickbeef,thrall,863,monk,mistweaver,24,9,15
Icytoned,kelthuzad,863,monk,mistweaver,24,9,15
Globalmonk,emerald-dream,862,monk,mistweaver,12,9,3
Zac,veknilash,862,monk,mistweaver,12,9,3
Ørçhid,ravenholdt,862,monk,mistweaver,12,9,3
Pharmasee,proudmoore,862,monk,mistweaver,12,9,3
Kungupanda,nesingwary,862,monk,mistweaver,24,9,15
Jhaded,tichondrius,862,monk,mistweaver,24,9,15
Madussy,zuljin,862,monk,mistweaver,24,9,15
Kromrax,stormrage,862,monk,mistweaver,24,9,15
Lillyanda,lightbringer,861,monk,mistweaver,12,9,3
Gitwwrekd,area-52,861,monk,mistweaver,12,9,3
Monkydoo,blackhand,861,monk,mistweaver,18,9,9
Justfakeit,area-52,861,monk,mistweaver,18,9,9
Dumplinz,tichondrius,860,monk,mistweaver,12,9,3
Moonkers,tichondrius,860,monk,mistweaver,18,9,9
Håzê,kul-tiras,860,monk,mistweaver,18,9,9
Yudrin,zuljin,859,monk,mistweaver,24,9,15
Medge,kelthuzad,858,monk,mistweaver,18,9,9
Monkism,warsong,855,monk,mistweaver,12,9,3
Winwakamank,sargeras,855,monk,mistweaver,24,9,15
Rabico,azralon,854,monk,mistweaver,12,9,3
Rauschende,feathermoon,854,monk,mistweaver,12,9,3
Maqaveli,sargeras,854,monk,mistweaver,18,9,9
Tubbytiph,ghostlands,853,monk,mistweaver,30,9,21
Eago,sargeras,852,monk,mistweaver,24,9,15
Zeeboogerton,wildhammer,851,monk,mistweaver,12,9,3
Bullshido,aerie-peak,851,monk,mistweaver,18,9,9
Epptwo,aggramar,851,monk,mistweaver,30,9,21
Goodgodsz,tichondrius,849,monk,mistweaver,12,9,3
Gesir,tichondrius,848,monk,mistweaver,21,10,11
Sìrtankallot,stormrage,837,monk,mistweaver,32,9,23
Dreamy,mugthol,833,monk,mistweaver,48,17,31
Kimchimaj,tichondrius,832,monk,mistweaver,18,9,9
Fakelove,kelthuzad,830,monk,mistweaver,28,10,18
Seaja,malganis,823,monk,mistweaver,99,26,73
Måz,malorne,822,monk,mistweaver,21,12,9
Domisalamii,sargeras,815,monk,mistweaver,17,9,8
Eggwoll,velen,814,monk,mistweaver,15,10,5
Obàma,tichondrius,809,monk,mistweaver,19,10,9
Matsakaicin,azralon,809,monk,mistweaver,22,10,12
Goodluck,madoran,809,monk,mistweaver,27,10,17
Paniku,sargeras,807,monk,mistweaver,51,17,34
Tokkyo,frostmourne,804,monk,mistweaver,66,15,51
Picoree,frostmourne,799,monk,mistweaver,15,10,5
Udmonk,tichondrius,799,monk,mistweaver,14,9,5
Mastahp,tichondrius,797,monk,mistweaver,22,9,13
Sivedrafely,arthas,793,monk,mistweaver,35,10,25
Qlispe,bloodscalp,784,monk,mistweaver,76,35,41
Omnly,stormrage,768,monk,mistweaver,12,8,4
Kaskã,tichondrius,768,monk,mistweaver,12,8,4
Dontchattome,sargeras,768,monk,mistweaver,12,8,4
Ericfu,tichondrius,768,monk,mistweaver,12,8,4
Kaystorm,stormrage,768,monk,mistweaver,12,8,4
Scrypter,proudmoore,768,monk,mistweaver,12,8,4
Cuckoon,malganis,768,monk,mistweaver,12,8,4
Brewtankx,tichondrius,768,monk,mistweaver,12,8,4
Bralex,black-dragonflight,768,monk,mistweaver,12,8,4
Snowbunny,llane,768,monk,mistweaver,12,8,4
Prodigious,illidan,768,monk,mistweaver,12,8,4
Shquiz,sargeras,768,monk,mistweaver,12,8,4
Sainlaurent,tichondrius,768,monk,mistweaver,12,8,4
Chipapi,sargeras,768,monk,mistweaver,12,8,4
Funkmunk,aegwynn,768,monk,mistweaver,12,8,4
Fangerlia,moon-guard,768,monk,mistweaver,12,8,4
Vexed,illidan,768,monk,mistweaver,12,8,4
Leesinga,alexstrasza,768,monk,mistweaver,12,8,4
Kobuya,tichondrius,768,monk,mistweaver,12,8,4
Tuladura,tichondrius,768,monk,mistweaver,12,8,4
Tubescreamer,barthilas,768,monk,mistweaver,12,8,4
Sàìñtàsønìà,kelthuzad,768,monk,mistweaver,12,8,4
Picklefartjr,malfurion,768,monk,mistweaver,12,8,4
Kwatann,bonechewer,768,monk,mistweaver,18,8,10
Watercowz,tichondrius,768,monk,mistweaver,18,8,10
Torakigai,hyjal,768,monk,mistweaver,18,8,10
Rockyßalboa,sargeras,768,monk,mistweaver,18,8,10
Backflip,nemesis,768,monk,mistweaver,18,8,10
Mmrmonkey,tichondrius,768,monk,mistweaver,18,8,10
Phyte,kelthuzad,768,monk,mistweaver,18,8,10
Drkeen,frostmourne,768,monk,mistweaver,28,10,18
Erwynz,tichondrius,768,monk,mistweaver,24,8,16
Psyx,frostmourne,767,monk,mistweaver,12,8,4
Kymosolomk,sargeras,767,monk,mistweaver,12,8,4
Blitzcombo,thrall,767,monk,mistweaver,12,8,4
Nøzawri,area-52,767,monk,mistweaver,12,8,4
Pungeebi,tichondrius,767,monk,mistweaver,12,8,4
Rilenn,area-52,767,monk,mistweaver,12,8,4
Abird,tichondrius,767,monk,mistweaver,12,8,4
Pandicapped,the-underbog,767,monk,mistweaver,12,8,4
Sììre,tichondrius,767,monk,mistweaver,12,8,4
Mightbewôrth,thunderhorn,767,monk,mistweaver,12,8,4
Bogez,area-52,767,monk,mistweaver,18,8,10
Dùffmán,jubeithos,767,monk,mistweaver,18,8,10
Harmoñize,moon-guard,767,monk,mistweaver,18,8,10
Alfonzó,tichondrius,767,monk,mistweaver,18,8,10
Notastreamer,frostmourne,767,monk,mistweaver,18,8,10
Elfass,bleeding-hollow,767,monk,mistweaver,18,8,10
Buymymixtape,ursin,767,monk,mistweaver,18,8,10
Ocmonk,hyjal,767,monk,mistweaver,18,8,10
Dabnhash,emerald-dream,767,monk,mistweaver,18,8,10
Vvsm,tichondrius,767,monk,mistweaver,18,8,10
Barleygar,tichondrius,767,monk,mistweaver,18,8,10
Palden,blackrock,767,monk,mistweaver,18,8,10
Onegai,illidan,767,monk,mistweaver,24,8,16
Bambolee,thunderhorn,766,monk,mistweaver,12,8,4
Skonk,shattered-hand,766,monk,mistweaver,12,8,4
Apexian,kelthuzad,766,monk,mistweaver,12,8,4
Artomist,stormrage,766,monk,mistweaver,12,8,4
Catchdismist,tichondrius,766,monk,mistweaver,12,8,4
Nakiki,cenarion-circle,766,monk,mistweaver,12,8,4
Jnziww,area-52,766,monk,mistweaver,12,8,4
Selfiestíck,tichondrius,766,monk,mistweaver,12,8,4
Tàekwondo,drakkari,766,monk,mistweaver,18,8,10
Orthôdox,tichondrius,766,monk,mistweaver,18,8,10
Malusiftw,tichondrius,766,monk,mistweaver,18,8,10
Biglinky,sargeras,765,monk,mistweaver,18,8,10
Wzzi,tichondrius,765,monk,mistweaver,18,8,10
Slinger,kalecgos,764,monk,mistweaver,16,9,7
Scips,fizzcrank,764,monk,mistweaver,18,8,10
Savyi,stormreaver,763,monk,mistweaver,12,8,4
Dower,archimonde,763,monk,mistweaver,16,9,7
Tigmo,alleria,762,monk,mistweaver,18,8,10
Kushmintz,whisperwind,762,monk,mistweaver,18,8,10
Fufu,terokkar,761,monk,mistweaver,18,8,10
Angrybrewski,tichondrius,757,monk,mistweaver,18,8,10
Fusionspell,stormrage,747,monk,mistweaver,24,8,16
Prddoss,quelthalas,745,monk,mistweaver,12,8,4
Sätsu,bleeding-hollow,735,monk,mistweaver,17,8,9
Karlrogan,stormrage,734,monk,mistweaver,16,9,7
Áasuna,ragnaros,734,monk,mistweaver,20,9,11
Senseißones,area-52,734,monk,mistweaver,23,8,15
Whosaidthat,frostmourne,723,monk,mistweaver,18,8,10
Kryflex,frostmourne,720,monk,mistweaver,15,9,6
Thaliondor,stormrage,720,monk,mistweaver,15,9,6
Bombshellxo,illidan,719,monk,mistweaver,11,8,3
Whee,wyrmrest-accord,703,monk,mistweaver,11,8,3
Teddybéar,illidan,703,monk,mistweaver,14,8,6
Kármâ,darkspear,703,monk,mistweaver,14,8,6
Keloxx,ragnaros,702,monk,mistweaver,16,10,6
Hirav,khazgoroth,697,monk,mistweaver,21,9,12
Shortbuss,aegwynn,696,monk,mistweaver,14,8,6
Minttea,kiljaeden,690,monk,mistweaver,28,9,19
Hunchojack,undermine,672,monk,mistweaver,10,8,2
Rawmonk,blackrock,672,monk,mistweaver,12,7,5
Jasonluv,illidan,672,monk,mistweaver,12,7,5
Jaxvisto,dalaran,672,monk,mistweaver,12,7,5
Opclassxd,illidan,672,monk,mistweaver,12,7,5
Brimhildaa,tichondrius,672,monk,mistweaver,12,7,5
Laggytoodope,kelthuzad,672,monk,mistweaver,12,7,5
Mwr,frostmourne,672,monk,mistweaver,12,7,5
Yuumeì,senjin,672,monk,mistweaver,12,7,5
Mundane,sargeras,672,monk,mistweaver,12,7,5
Zbell,sargeras,672,monk,mistweaver,12,7,5
Kyrap,stormscale,672,monk,mistweaver,12,7,5
Rookere,malganis,672,monk,mistweaver,12,7,5
Darong,tichondrius,672,monk,mistweaver,12,7,5
Såd,zuljin,672,monk,mistweaver,12,7,5
Dogmonster,stormrage,672,monk,mistweaver,12,7,5
Immersion,the-forgotten-coast,672,monk,mistweaver,12,7,5
Brantkicks,tichondrius,672,monk,mistweaver,12,7,5
Lynio,area-52,672,monk,mistweaver,12,7,5
Kegwalker,earthen-ring,672,monk,mistweaver,12,7,5
Arumat,shadow-council,672,monk,mistweaver,12,7,5
Ashmisty,kelthuzad,672,monk,mistweaver,12,7,5
Lilpøøter,tichondrius,672,monk,mistweaver,12,7,5
Yaloon,stormrage,672,monk,mistweaver,12,7,5
Loppjr,tichondrius,672,monk,mistweaver,12,7,5
Brokenfeels,azralon,672,monk,mistweaver,12,7,5
Strawberriez,kelthuzad,672,monk,mistweaver,12,7,5
Aniwhy,tichondrius,672,monk,mistweaver,12,7,5
Zhoutai,malganis,672,monk,mistweaver,12,7,5
Moönk,tichondrius,672,monk,mistweaver,12,7,5
Boorams,tichondrius,672,monk,mistweaver,12,7,5
Toothpick,blackrock,672,monk,mistweaver,12,7,5
Fox,azshara,672,monk,mistweaver,12,7,5
Galeindra,whisperwind,672,monk,mistweaver,12,7,5
Copamine,dalaran,672,monk,mistweaver,12,7,5
Vesaves,azralon,672,monk,mistweaver,12,7,5
Abevx,bonechewer,672,monk,mistweaver,12,7,5
Tooflyfobrew,sargeras,672,monk,mistweaver,12,7,5
Notrof,korgath,672,monk,mistweaver,12,7,5
Sweetröll,stormrage,672,monk,mistweaver,12,7,5
Missclickx,azralon,672,monk,mistweaver,12,7,5
Saiyañ,proudmoore,672,monk,mistweaver,12,7,5
Synpunch,tichondrius,672,monk,mistweaver,12,7,5
Ishtári,tichondrius,672,monk,mistweaver,15,8,7
Fistay,burning-legion,672,monk,mistweaver,15,8,7
Sjw,icecrown,672,monk,mistweaver,14,7,7
Èxpèrtisè,jubeithos,672,monk,mistweaver,14,7,7
Matthew,ravencrest,672,monk,mistweaver,18,7,11
Thevy,area-52,672,monk,mistweaver,18,7,11
Monktu,frostmourne,672,monk,mistweaver,18,7,11
Argoholic,proudmoore,672,monk,mistweaver,18,7,11
Audrun,frostmourne,672,monk,mistweaver,18,7,11
Russtie,sargeras,672,monk,mistweaver,18,7,11
Catchmemaybe,stormscale,672,monk,mistweaver,24,7,17
Tayytay,kiljaeden,671,monk,mistweaver,12,7,5
Universalize,zuljin,671,monk,mistweaver,12,7,5
Monkgins,area-52,671,monk,mistweaver,12,7,5
Iwonson,mugthol,671,monk,mistweaver,12,7,5
Delightni,area-52,671,monk,mistweaver,12,7,5
Shwrmist,bleeding-hollow,671,monk,mistweaver,12,7,5
Jbonk,hyjal,671,monk,mistweaver,12,7,5
Hornymonkale,thrall,671,monk,mistweaver,12,7,5
Rizchi,tichondrius,671,monk,mistweaver,12,7,5
Alisoly,tichondrius,671,monk,mistweaver,12,7,5
Niculinha,nemesis,671,monk,mistweaver,12,7,5
Shórtlived,skullcrusher,671,monk,mistweaver,13,7,6
Táishen,wyrmrest-accord,671,monk,mistweaver,16,8,8
Bükki,ragnaros,671,monk,mistweaver,18,7,11
Femifist,lightbringer,671,monk,mistweaver,18,7,11
Sterow,kiljaeden,671,monk,mistweaver,18,7,11
Paradissô,tichondrius,671,monk,mistweaver,18,7,11
Thahomie,nordrassil,671,monk,mistweaver,24,7,17
Drizzie,queldorei,671,monk,mistweaver,24,7,17
Swann,stormreaver,670,monk,mistweaver,12,7,5
Onlyfistss,illidan,670,monk,mistweaver,12,7,5
Jianrèn,wyrmrest-accord,670,monk,mistweaver,12,7,5
Microdose,blackrock,670,monk,mistweaver,18,7,11
Khaldi,tichondrius,670,monk,mistweaver,19,7,12
Pandaranga,saurfang,670,monk,mistweaver,28,8,20
Runkfyr,ragnaros,670,monk,mistweaver,30,7,23
Nymchi,stormrage,669,monk,mistweaver,12,7,5
Unlemike,runetotem,669,monk,mistweaver,12,7,5
Tzidkiyahu,barthilas,669,monk,mistweaver,12,7,5
Melyodis,thrall,669,monk,mistweaver,18,7,11
Absolutvodca,nemesis,669,monk,mistweaver,24,7,17
Ügway,azralon,669,monk,mistweaver,30,7,23
Gímley,bleeding-hollow,667,monk,mistweaver,12,7,5
Balooballs,frostmourne,667,monk,mistweaver,18,7,11
Shihfu,azralon,667,monk,mistweaver,24,7,17
Dornix,illidan,664,monk,mistweaver,18,7,11
Wetspaghetti,malganis,661,monk,mistweaver,18,7,11
Munchan,hyjal,654,monk,mistweaver,11,9,2
Akfourseven,barthilas,645,monk,mistweaver,72,32,40
Karu,barthilas,639,monk,mistweaver,18,8,10
Rènh,ragnaros,639,monk,mistweaver,17,7,10
Reflexsivex,malganis,638,monk,mistweaver,11,7,4
Tomaz,nazjatar,632,monk,mistweaver,11,7,4
Saucyfists,silvermoon,624,monk,mistweaver,15,8,7
Sourcandyx,area-52,624,monk,mistweaver,15,7,8
Berzerk,dalvengyr,624,monk,mistweaver,15,7,8
Blessedbalor,tichondrius,624,monk,mistweaver,21,7,14
Praydoh,tichondrius,623,monk,mistweaver,11,7,4
Jetchi,proudmoore,623,monk,mistweaver,11,7,4
Azz,barthilas,623,monk,mistweaver,11,7,4
Aerona,stormreaver,617,monk,mistweaver,12,8,4
Mistyheals,emerald-dream,617,monk,mistweaver,17,10,7
Jayjaybrew,area-52,615,monk,mistweaver,22,8,14
Happymonk,tichondrius,613,monk,mistweaver,43,8,35
Pandica,kiljaeden,607,monk,mistweaver,11,7,4
Robochöp,emerald-dream,606,monk,mistweaver,14,7,7
Monjepa,illidan,604,monk,mistweaver,20,7,13
Pandamoanda,azgalor,593,monk,mistweaver,16,7,9
Reoc,bleeding-hollow,592,monk,mistweaver,13,7,6
Kruxx,anvilmar,576,monk,mistweaver,6,6,0
Bdâwg,frostmourne,576,monk,mistweaver,6,6,0
Watty,zuljin,576,monk,mistweaver,6,6,0
Minivanmom,illidan,576,monk,mistweaver,6,6,0
Ozáí,illidan,576,monk,mistweaver,6,6,0
Munkï,tichondrius,576,monk,mistweaver,6,6,0
Chrîstmas,proudmoore,576,monk,mistweaver,6,6,0
Jg,staghelm,576,monk,mistweaver,6,6,0
Kryptoniko,illidan,576,monk,mistweaver,6,6,0
Larkssmw,zuljin,576,monk,mistweaver,6,6,0
Søck,malfurion,576,monk,mistweaver,6,6,0
Dracc,zuljin,576,monk,mistweaver,12,6,6
Sekushî,kelthuzad,576,monk,mistweaver,12,6,6
Kaztíel,ragnaros,576,monk,mistweaver,12,6,6
Wuwei,onyxia,576,monk,mistweaver,12,6,6
Emerald,emerald-dream,576,monk,mistweaver,12,6,6
Meisterbrew,garona,576,monk,mistweaver,12,6,6
Eightpoint,illidan,576,monk,mistweaver,12,6,6
Daarl,burning-blade,576,monk,mistweaver,12,6,6
Até,azralon,576,monk,mistweaver,12,6,6
Tunchii,sargeras,576,monk,mistweaver,12,6,6
Ñightingale,queldorei,576,monk,mistweaver,12,6,6
Transcend,nerzhul,576,monk,mistweaver,12,6,6
Underpants,skullcrusher,576,monk,mistweaver,12,6,6
Wèave,tichondrius,576,monk,mistweaver,12,6,6
Dreamfist,emerald-dream,576,monk,mistweaver,12,6,6
Mtsalt,bleeding-hollow,576,monk,mistweaver,12,6,6
Ryukenshin,proudmoore,576,monk,mistweaver,12,6,6
Frésa,ragnaros,576,monk,mistweaver,12,6,6
Magnustavick,bleeding-hollow,576,monk,mistweaver,12,6,6
Mënmä,ragnaros,576,monk,mistweaver,12,6,6
Lackofsleep,tichondrius,576,monk,mistweaver,12,6,6
Silkymoves,tichondrius,576,monk,mistweaver,12,6,6
Zchi,zuljin,576,monk,mistweaver,12,6,6
Dgmonk,tichondrius,576,monk,mistweaver,12,6,6
Zeshmo,firetree,576,monk,mistweaver,12,6,6
Flfltmfrl,tichondrius,576,monk,mistweaver,12,6,6
Gnomshini,proudmoore,576,monk,mistweaver,12,6,6
Boppweave,tichondrius,576,monk,mistweaver,12,6,6
Cerrado,emerald-dream,576,monk,mistweaver,12,6,6
Bearmode,wyrmrest-accord,576,monk,mistweaver,12,6,6
Brujitsu,thrall,576,monk,mistweaver,12,6,6
Dungfish,mugthol,576,monk,mistweaver,12,6,6
Steyi,nazjatar,576,monk,mistweaver,12,6,6
Shaqkobe,area-52,576,monk,mistweaver,12,6,6
Jieterchan,malganis,576,monk,mistweaver,12,6,6
Broyoulined,spirestone,576,monk,mistweaver,12,6,6
Jbg,staghelm,576,monk,mistweaver,12,6,6
Lumiän,area-52,576,monk,mistweaver,12,6,6
Rajile,sargeras,576,monk,mistweaver,12,6,6
Aerlin,tichondrius,576,monk,mistweaver,12,6,6
Karrigwyn,tichondrius,576,monk,mistweaver,12,6,6
Caradlevinge,ragnaros,576,monk,mistweaver,12,6,6
Faccemelter,illidan,576,monk,mistweaver,12,6,6
Imakeplaysyo,illidan,576,monk,mistweaver,12,6,6
Bamboozïe,arthas,576,monk,mistweaver,12,6,6
Trins,azjolnerub,576,monk,mistweaver,12,6,6
Janim,illidan,576,monk,mistweaver,12,6,6
Mesak,ragnaros,576,monk,mistweaver,15,7,8
Simarity,kelthuzad,576,monk,mistweaver,18,6,12
Tragictea,zuljin,576,monk,mistweaver,18,6,12
Fistweebin,area-52,576,monk,mistweaver,18,6,12
Hugerichard,wyrmrest-accord,576,monk,mistweaver,18,6,12
Rollsrice,area-52,576,monk,mistweaver,18,6,12
Chingwang,frostmourne,576,monk,mistweaver,18,6,12
Mwgapper,sargeras,576,monk,mistweaver,18,6,12
Tohkmonk,crushridge,575,monk,mistweaver,6,6,0
Shabudinetz,stormrage,575,monk,mistweaver,6,6,0
Itsjohnnylol,azuremyst,575,monk,mistweaver,12,6,6
Sknypicho,malganis,575,monk,mistweaver,12,6,6
Xinn,kiljaeden,575,monk,mistweaver,12,6,6
Agrïppa,caelestrasz,575,monk,mistweaver,12,6,6
Compacier,illidan,575,monk,mistweaver,12,6,6
Rocketfist,bleeding-hollow,575,monk,mistweaver,12,6,6
Misha,akama,575,monk,mistweaver,12,6,6
Criarla,tichondrius,575,monk,mistweaver,12,6,6
Almondmïlk,bonechewer,575,monk,mistweaver,12,6,6
Myrsken,area-52,575,monk,mistweaver,12,6,6
Putisucia,nordrassil,575,monk,mistweaver,12,6,6
Morhe,the-forgotten-coast,575,monk,mistweaver,12,6,6
Soysaucë,malganis,575,monk,mistweaver,12,6,6
Salindrena,thrall,575,monk,mistweaver,12,6,6
Nf,zuljin,575,monk,mistweaver,12,6,6
Freeoni,sargeras,575,monk,mistweaver,12,6,6
Glitchi,area-52,575,monk,mistweaver,12,6,6
Liucang,archimonde,575,monk,mistweaver,12,6,6
Miso,nathrezim,575,monk,mistweaver,12,6,6
Clytpuncher,emerald-dream,575,monk,mistweaver,12,6,6
Zargtruth,proudmoore,575,monk,mistweaver,12,6,6
Hibìscus,tichondrius,575,monk,mistweaver,12,6,6
Laopow,area-52,575,monk,mistweaver,12,6,6
Buttfists,stormrage,575,monk,mistweaver,12,6,6
Ormchi,stormrage,575,monk,mistweaver,13,6,7
Opmother,elune,575,monk,mistweaver,18,6,12
Fortyozkilla,thrall,575,monk,mistweaver,18,6,12
Freepunchz,frostmourne,575,monk,mistweaver,18,6,12
Beatboxblues,skullcrusher,574,monk,mistweaver,12,6,6
Yanedin,dalaran,574,monk,mistweaver,12,6,6
Cornfist,zuljin,573,monk,mistweaver,12,6,6
Dokuho,silvermoon,572,monk,mistweaver,12,6,6
Mënace,skullcrusher,572,monk,mistweaver,12,6,6
Gaturis,tichondrius,572,monk,mistweaver,21,7,14
Paladinei,tichondrius,571,monk,mistweaver,12,6,6
Samanosukee,illidan,571,monk,mistweaver,12,6,6
Bógus,tichondrius,571,monk,mistweaver,12,6,6
Keekismonk,gorefiend,566,monk,mistweaver,12,6,6
Dejohnette,quelthalas,565,monk,mistweaver,12,6,6
Boofie,perenolde,559,monk,mistweaver,11,6,5
Gyunyumanjuu,proudmoore,559,monk,mistweaver,11,6,5
Sohéi,proudmoore,559,monk,mistweaver,17,6,11
Fiztingfaded,area-52,551,monk,mistweaver,26,9,17
Ñoobmonk,tichondrius,543,monk,mistweaver,11,6,5
Saltyone,firetree,543,monk,mistweaver,14,7,7
Bigolagile,velen,537,monk,mistweaver,22,6,16
Tøåst,illidan,527,monk,mistweaver,11,6,5
Rakesh,azralon,525,monk,mistweaver,9,7,2
Yuløn,illidan,511,monk,mistweaver,8,6,2
Räyè,tichondrius,511,monk,mistweaver,8,6,2
Oldmanwalker,mannoroth,511,monk,mistweaver,11,6,5
Chickntendys,sargeras,511,monk,mistweaver,11,6,5
Feihung,executus,511,monk,mistweaver,11,6,5
Tbrew,area-52,511,monk,mistweaver,14,6,8
Figurines,sargeras,496,monk,mistweaver,19,6,13
Roskoh,area-52,493,monk,mistweaver,19,6,13
Danwunwolf,tichondrius,480,monk,mistweaver,6,5,1
Dbmmonk,malganis,480,monk,mistweaver,6,5,1
Meepz,arthas,480,monk,mistweaver,6,5,1
Pinot,dragonmaw,480,monk,mistweaver,6,5,1
Yuldaddy,tichondrius,480,monk,mistweaver,6,5,1
Spicym,proudmoore,480,monk,mistweaver,6,5,1
Ceronash,dalaran,480,monk,mistweaver,6,5,1
Theodôn,dalaran,480,monk,mistweaver,6,5,1
Ninjaheals,spirestone,480,monk,mistweaver,6,5,1
Donatello,arthas,480,monk,mistweaver,6,5,1
Grumpî,tichondrius,480,monk,mistweaver,6,5,1
Jurassaf,illidan,480,monk,mistweaver,6,5,1
Thegreentaco,tichondrius,480,monk,mistweaver,6,5,1
Shandilla,proudmoore,480,monk,mistweaver,6,5,1
Satiremaster,frostmourne,480,monk,mistweaver,6,5,1
Getswept,area-52,480,monk,mistweaver,6,5,1
Stepfíster,tichondrius,480,monk,mistweaver,6,5,1
Serénity,kiljaeden,480,monk,mistweaver,6,5,1
Alvinete,tichondrius,480,monk,mistweaver,6,5,1
Zammymonk,area-52,480,monk,mistweaver,6,5,1
Pyoapple,tichondrius,480,monk,mistweaver,6,5,1
Mongénoìo,nemesis,480,monk,mistweaver,6,5,1
Yajirobei,area-52,480,monk,mistweaver,6,5,1
Møzy,tichondrius,480,monk,mistweaver,6,5,1
Nickimínaj,illidan,480,monk,mistweaver,6,5,1
Zuchi,barthilas,480,monk,mistweaver,6,5,1
Kayflock,tichondrius,480,monk,mistweaver,6,5,1
Dirtysmonk,mugthol,480,monk,mistweaver,6,5,1
Blackmist,khazgoroth,480,monk,mistweaver,6,5,1
Siddharthä,barthilas,480,monk,mistweaver,6,5,1
Genia,ragnaros,480,monk,mistweaver,6,5,1
Chifang,elune,480,monk,mistweaver,6,5,1
Rivnn,sargeras,480,monk,mistweaver,6,5,1
Mistwalk,tichondrius,480,monk,mistweaver,6,5,1
Pandatong,tichondrius,480,monk,mistweaver,6,5,1
Touchoftism,proudmoore,480,monk,mistweaver,6,5,1
Khidda,barthilas,480,monk,mistweaver,6,5,1
Choibaedal,tichondrius,480,monk,mistweaver,7,5,2
Ouibaguette,kelthuzad,480,monk,mistweaver,12,5,7
Otzyy,turalyon,480,monk,mistweaver,12,5,7
Judo,khadgar,480,monk,mistweaver,12,5,7
Gnarmony,malganis,480,monk,mistweaver,12,5,7
Snooky,kiljaeden,480,monk,mistweaver,12,5,7
Whipllash,tichondrius,480,monk,mistweaver,12,5,7
Zlatân,sargeras,480,monk,mistweaver,12,5,7
Amybaby,sargeras,480,monk,mistweaver,12,5,7
Chronost,sargeras,480,monk,mistweaver,12,5,7
Palumorww,deathwing,480,monk,mistweaver,12,5,7
Thehomìe,tichondrius,480,monk,mistweaver,12,5,7
Piece,blackrock,480,monk,mistweaver,12,5,7
Rzeznik,boulderfist,480,monk,mistweaver,12,5,7
Mythsmonkx,barthilas,480,monk,mistweaver,12,5,7
Kimjongkick,sargeras,480,monk,mistweaver,12,5,7
Cloudl,silvermoon,480,monk,mistweaver,12,5,7
Zenwyatt,area-52,480,monk,mistweaver,12,5,7
Bigolbootay,tichondrius,480,monk,mistweaver,12,5,7
Mistymarc,zuljin,480,monk,mistweaver,12,5,7
Nîxs,frostmourne,480,monk,mistweaver,12,5,7
Btipton,tichondrius,480,monk,mistweaver,12,5,7
Joggï,stormrage,480,monk,mistweaver,12,5,7
Khadfu,sargeras,480,monk,mistweaver,12,5,7
Kaiøken,tichondrius,480,monk,mistweaver,12,5,7
Touchofdell,illidan,480,monk,mistweaver,12,5,7
Brewtari,whisperwind,480,monk,mistweaver,12,5,7
Odradek,thunderlord,480,monk,mistweaver,12,5,7
Rawmonk,malganis,480,monk,mistweaver,12,5,7
Serpp,kelthuzad,480,monk,mistweaver,12,5,7
Cannenmonk,sargeras,480,monk,mistweaver,12,5,7
Onak,illidan,480,monk,mistweaver,12,5,7
Biggyballs,tichondrius,480,monk,mistweaver,12,5,7
Jumexo,sargeras,480,monk,mistweaver,12,5,7
Eraticmonk,illidan,480,monk,mistweaver,12,5,7
Guerrero,tichondrius,480,monk,mistweaver,12,5,7
Xavelha,tichondrius,480,monk,mistweaver,12,5,7
Crìstiano,malganis,480,monk,mistweaver,12,5,7
Linxiss,tichondrius,480,monk,mistweaver,12,5,7
Wdsprdpanic,tichondrius,480,monk,mistweaver,12,5,7
Ìsrael,sargeras,480,monk,mistweaver,12,5,7
Vashnir,lothar,480,monk,mistweaver,12,5,7
Ariss,ragnaros,480,monk,mistweaver,12,5,7
Kungfused,antonidas,480,monk,mistweaver,12,5,7
Masonn,kiljaeden,480,monk,mistweaver,12,5,7
Zarrend,stormrage,480,monk,mistweaver,12,5,7
Xiaotaimei,frostmourne,480,monk,mistweaver,12,5,7
Bruiseu,illidan,480,monk,mistweaver,18,5,13
Sna,dragonmaw,480,monk,mistweaver,18,5,13
Blackflag,queldorei,480,monk,mistweaver,18,5,13
Skyrim,tichondrius,480,monk,mistweaver,18,5,13
Sagapunch,hyjal,480,monk,mistweaver,18,5,13
Duckpond,nerzhul,480,monk,mistweaver,18,5,13
Màngø,ragnaros,480,monk,mistweaver,24,5,19
Cckknckr,sargeras,480,monk,mistweaver,24,5,19
Monqq,tichondrius,479,monk,mistweaver,6,5,1
Badkarmasix,tichondrius,479,monk,mistweaver,6,5,1
Chimpo,ragnaros,479,monk,mistweaver,12,5,7
Qi,draktharon,479,monk,mistweaver,12,5,7
Bitrau,destromath,479,monk,mistweaver,12,5,7
Paticus,area-52,479,monk,mistweaver,12,5,7
Tianhu,sargeras,479,monk,mistweaver,12,5,7
Troutz,sargeras,479,monk,mistweaver,12,5,7
Annara,tichondrius,479,monk,mistweaver,12,5,7
Wisepaw,tichondrius,479,monk,mistweaver,12,5,7
Satchelgizmo,tichondrius,479,monk,mistweaver,18,5,13
Westchi,arthas,479,monk,mistweaver,18,5,13
Manxxin,illidan,479,monk,mistweaver,18,5,13
Ltsneaky,bladefist,479,monk,mistweaver,30,5,25
Shmello,akama,478,monk,mistweaver,6,5,1
Jb,burning-blade,478,monk,mistweaver,12,5,7
Moojìtsu,stormrage,478,monk,mistweaver,12,5,7
Cahuun,baelgun,478,monk,mistweaver,12,5,7
Anußisito,stormrage,478,monk,mistweaver,18,5,13
Tutulee,tichondrius,477,monk,mistweaver,6,5,1
Doicare,tichondrius,477,monk,mistweaver,12,5,7
Sputnîk,nemesis,468,monk,mistweaver,22,10,12
Yungsun,ragnaros,463,monk,mistweaver,13,6,7
Drgigglez,tichondrius,463,monk,mistweaver,11,5,6
Zønnis,zuljin,448,monk,mistweaver,10,6,4
Jentmonk,tichondrius,448,monk,mistweaver,10,5,5
Majinyooshi,kelthuzad,448,monk,mistweaver,10,5,5
Moistspot,frostmourne,447,monk,mistweaver,8,6,2
Scoopyafupa,illidan,447,monk,mistweaver,8,6,2
Graoul,thaurissan,447,monk,mistweaver,11,5,6
Drizzimonk,thrall,447,monk,mistweaver,11,5,6
Summersoup,zuljin,447,monk,mistweaver,11,5,6
Bengal,arthas,447,monk,mistweaver,11,5,6
Indrazzxx,jubeithos,426,monk,mistweaver,11,7,4
Bellátíx,quelthalas,426,monk,mistweaver,17,9,8
Mindengo,sargeras,426,monk,mistweaver,15,7,8
Yinlong,illidan,416,monk,mistweaver,10,5,5
Durath,burning-blade,415,monk,mistweaver,10,5,5
Nikitip,tichondrius,384,monk,mistweaver,6,4,2
Raires,tichondrius,384,monk,mistweaver,6,4,2
Chopana,malganis,384,monk,mistweaver,6,4,2
Renzin,gilneas,384,monk,mistweaver,6,4,2
Tinyboots,area-52,384,monk,mistweaver,6,4,2
Sunnfistway,sargeras,384,monk,mistweaver,6,4,2
Scovillah,emerald-dream,384,monk,mistweaver,6,4,2
Justamönk,moon-guard,384,monk,mistweaver,6,4,2
Snmonk,illidan,384,monk,mistweaver,6,4,2
Chopsake,khadgar,384,monk,mistweaver,6,4,2
Fistfyre,kiljaeden,384,monk,mistweaver,6,4,2
Brucetea,chogall,384,monk,mistweaver,6,4,2
Keepcryin,gorefiend,384,monk,mistweaver,6,4,2
Ufs,illidan,384,monk,mistweaver,6,4,2
Snoogiee,khazgoroth,384,monk,mistweaver,6,4,2
Monkinator,anvilmar,384,monk,mistweaver,6,4,2
Alshee,nagrand,384,monk,mistweaver,6,4,2
Saren,nordrassil,384,monk,mistweaver,6,4,2
Doodoodookie,thunderhorn,384,monk,mistweaver,6,4,2
Vetism,thrall,384,monk,mistweaver,6,4,2
Blpkosher,tichondrius,384,monk,mistweaver,6,4,2
Talker,stormrage,384,monk,mistweaver,6,4,2
Treysongz,illidan,384,monk,mistweaver,6,4,2
Howziexd,tichondrius,384,monk,mistweaver,6,4,2
Avendare,tichondrius,384,monk,mistweaver,6,4,2
Healkinxo,tichondrius,384,monk,mistweaver,6,4,2
Zamzae,tichondrius,384,monk,mistweaver,6,4,2
Balduglybaby,tichondrius,384,monk,mistweaver,6,4,2
Macnia,frostmourne,384,monk,mistweaver,6,4,2
Levoz,area-52,384,monk,mistweaver,6,4,2
Kharazina,azralon,384,monk,mistweaver,6,4,2
Shakeweightt,blackrock,384,monk,mistweaver,6,4,2
Tic,barthilas,384,monk,mistweaver,6,4,2
Põng,tichondrius,384,monk,mistweaver,6,4,2
Kwazinator,area-52,384,monk,mistweaver,6,4,2
Nipfuu,maelstrom,384,monk,mistweaver,6,4,2
Jâzze,zuljin,384,monk,mistweaver,6,4,2
Throws,stormrage,384,monk,mistweaver,6,4,2
Bháv,tichondrius,384,monk,mistweaver,6,4,2
Dude,tichondrius,384,monk,mistweaver,6,4,2
Kruznîk,illidan,384,monk,mistweaver,6,4,2
Drchake,quelthalas,384,monk,mistweaver,6,4,2
Kokochiggy,tichondrius,384,monk,mistweaver,6,4,2
Lyla,aegwynn,384,monk,mistweaver,6,4,2
Kàdè,dalaran,384,monk,mistweaver,6,4,2
Keyndanlamor,sargeras,384,monk,mistweaver,6,4,2
Punteeftw,sargeras,384,monk,mistweaver,6,4,2
Danie,nerzhul,384,monk,mistweaver,6,4,2
Kennjin,spinebreaker,384,monk,mistweaver,6,4,2
Dakism,sargeras,384,monk,mistweaver,6,4,2
Glorioushole,area-52,384,monk,mistweaver,6,4,2
Beersmonk,tichondrius,384,monk,mistweaver,6,4,2
Rizzjutsu,stormrage,384,monk,mistweaver,6,4,2
Lingerer,aerie-peak,384,monk,mistweaver,6,4,2
Stellae,emerald-dream,384,monk,mistweaver,10,5,5
Plopnspheres,arthas,384,monk,mistweaver,10,4,6
Rìzzo,tichondrius,384,monk,mistweaver,12,4,8
Mõnk,illidan,384,monk,mistweaver,12,4,8
Yunei,tichondrius,384,monk,mistweaver,12,4,8
Pandàmonium,frostmourne,384,monk,mistweaver,12,4,8
Jincíe,area-52,384,monk,mistweaver,12,4,8
Mccoy,quelthalas,384,monk,mistweaver,12,4,8
Sim,frostmourne,384,monk,mistweaver,12,4,8
Zënløvë,tichondrius,384,monk,mistweaver,12,4,8
Hoyocochino,quelthalas,384,monk,mistweaver,12,4,8
Galsello,moon-guard,384,monk,mistweaver,12,4,8
Pax,boulderfist,384,monk,mistweaver,12,4,8
Frankènmonk,illidan,384,monk,mistweaver,12,4,8
Lazy,shattered-halls,384,monk,mistweaver,12,4,8
Crakgirl,malganis,384,monk,mistweaver,12,4,8
Mockz,dentarg,384,monk,mistweaver,12,4,8
Macktickle,zuljin,384,monk,mistweaver,12,4,8
Nicolascåge,destromath,384,monk,mistweaver,12,4,8
Fistorcstar,daggerspine,384,monk,mistweaver,12,4,8
Darkeiji,stormrage,384,monk,mistweaver,12,4,8
Jimbojenkins,bleeding-hollow,384,monk,mistweaver,12,4,8
Shredmw,tichondrius,384,monk,mistweaver,12,4,8
Neversweep,tichondrius,384,monk,mistweaver,12,4,8
Migchi,sargeras,384,monk,mistweaver,12,4,8
Nutbag,norgannon,384,monk,mistweaver,12,4,8
Darylphilbin,emerald-dream,384,monk,mistweaver,12,4,8
Fluffykaboom,destromath,384,monk,mistweaver,12,4,8
Valkana,kelthuzad,384,monk,mistweaver,12,4,8
Sprinkli,sargeras,384,monk,mistweaver,12,4,8
Windwalken,sargeras,384,monk,mistweaver,12,4,8
Greentea,kaelthas,384,monk,mistweaver,12,4,8
Tanipto,tichondrius,384,monk,mistweaver,12,4,8
Mingfei,uther,384,monk,mistweaver,12,4,8
Iamapotato,tichondrius,384,monk,mistweaver,18,4,14
Therivermist,tichondrius,383,monk,mistweaver,6,4,2
Tsukuyômi,thrall,383,monk,mistweaver,6,4,2
Esleif,moonrunner,383,monk,mistweaver,12,4,8
Fvl,barthilas,383,monk,mistweaver,12,4,8
Zyemell,tichondrius,383,monk,mistweaver,12,4,8
Biggddaddy,thaurissan,383,monk,mistweaver,12,4,8
Jigong,bleeding-hollow,383,monk,mistweaver,12,4,8
Izgoku,frostmane,383,monk,mistweaver,18,4,14
Rollbot,kelthuzad,382,monk,mistweaver,6,4,2
Drzoid,thrall,382,monk,mistweaver,12,4,8
Baaron,sargeras,382,monk,mistweaver,12,4,8
Taintickler,stormrage,382,monk,mistweaver,18,4,14
Sence,lightnings-blade,382,monk,mistweaver,18,4,14
Kurrama,twisting-nether,381,monk,mistweaver,12,4,8
Jeme,tichondrius,379,monk,mistweaver,12,4,8
Sáble,stormrage,351,monk,mistweaver,11,4,7
Daddywarpig,tichondrius,336,monk,mistweaver,9,4,5
Zhihua,moon-guard,336,monk,mistweaver,21,4,17
ßiggiesmallz,barthilas,330,monk,mistweaver,12,5,7
Stunnedheals,arthas,330,monk,mistweaver,16,5,11
Xiaovega,dalaran,329,monk,mistweaver,16,5,11
Kimchidelite,gorefiend,319,monk,mistweaver,5,4,1
Hauntings,hellscream,319,monk,mistweaver,5,4,1
Hundski,bleeding-hollow,288,monk,mistweaver,6,3,3
Densíty,kiljaeden,288,monk,mistweaver,6,3,3
Psii,the-venture-co,288,monk,mistweaver,6,3,3
Rasgacrú,stormrage,288,monk,mistweaver,6,3,3
Madson,darkspear,288,monk,mistweaver,6,3,3
Maybeyooshi,kelthuzad,288,monk,mistweaver,6,3,3
Zóë,korgath,288,monk,mistweaver,6,3,3
Flakkon,hyjal,288,monk,mistweaver,6,3,3
Monkgodx,tichondrius,288,monk,mistweaver,6,3,3
Ighostgirls,thrall,288,monk,mistweaver,6,3,3
ßöe,sargeras,288,monk,mistweaver,6,3,3
Dedmk,azralon,288,monk,mistweaver,6,3,3
Leeleeyong,tichondrius,288,monk,mistweaver,6,3,3
Cashina,azralon,288,monk,mistweaver,6,3,3
Austaar,frostmourne,288,monk,mistweaver,6,3,3
Facekandy,tichondrius,288,monk,mistweaver,6,3,3
Macproblem,malganis,288,monk,mistweaver,6,3,3
Teclas,ragnaros,288,monk,mistweaver,6,3,3
Thiccstroke,illidan,288,monk,mistweaver,6,3,3
Monaks,barthilas,288,monk,mistweaver,6,3,3
Lemeta,tichondrius,288,monk,mistweaver,6,3,3
Ðreadhot,malganis,288,monk,mistweaver,6,3,3
Mustard,arthas,288,monk,mistweaver,6,3,3
Marçi,moon-guard,288,monk,mistweaver,6,3,3
Mystï,silvermoon,288,monk,mistweaver,6,3,3
Smungus,bloodscalp,288,monk,mistweaver,6,3,3
Polyphia,lothar,288,monk,mistweaver,6,3,3
Bakanani,magtheridon,288,monk,mistweaver,6,3,3
Lyántrying,korgath,288,monk,mistweaver,6,3,3
Tambher,lightbringer,288,monk,mistweaver,6,3,3
Grogio,wyrmrest-accord,288,monk,mistweaver,6,3,3
Greenteafrãp,bleeding-hollow,288,monk,mistweaver,6,3,3
Darches,quelthalas,288,monk,mistweaver,6,3,3
Voguex,area-52,288,monk,mistweaver,6,3,3
Fammi,stormrage,288,monk,mistweaver,6,3,3
Streetcreds,bleeding-hollow,288,monk,mistweaver,6,3,3
Feelsogöod,tichondrius,288,monk,mistweaver,6,3,3
Dkdakìng,stormrage,288,monk,mistweaver,6,3,3
Yoshimiitsu,bleeding-hollow,288,monk,mistweaver,6,3,3
Zamerà,bleeding-hollow,288,monk,mistweaver,6,3,3
Jutsu,moon-guard,288,monk,mistweaver,6,3,3
Giggacuck,frostmourne,288,monk,mistweaver,6,3,3
Seii,ravenholdt,288,monk,mistweaver,6,3,3
Furrykisser,tichondrius,288,monk,mistweaver,6,3,3
Seshiro,area-52,288,monk,mistweaver,6,3,3
Quartztiger,sargeras,288,monk,mistweaver,6,3,3
Notcheez,area-52,288,monk,mistweaver,6,3,3
Növa,alterac-mountains,288,monk,mistweaver,6,3,3
Hooverphonic,ragnaros,288,monk,mistweaver,6,3,3
Dbgzx,illidan,288,monk,mistweaver,6,3,3
Droppinfast,sargeras,288,monk,mistweaver,6,3,3
Nomonko,tichondrius,288,monk,mistweaver,6,3,3
Swansational,sargeras,288,monk,mistweaver,6,3,3
Fistin,laughing-skull,288,monk,mistweaver,6,3,3
Spiritmist,sargeras,288,monk,mistweaver,6,3,3
Spacoli,stormrage,288,monk,mistweaver,6,3,3
Foxjade,thrall,288,monk,mistweaver,6,3,3
Kotonnoha,quelthalas,288,monk,mistweaver,6,3,3
Chayim,wyrmrest-accord,288,monk,mistweaver,6,3,3
Lundch,tichondrius,288,monk,mistweaver,6,3,3
Vidrus,gorefiend,288,monk,mistweaver,6,3,3
Chingu,ragnaros,288,monk,mistweaver,6,3,3
Tunaroll,tichondrius,288,monk,mistweaver,6,3,3
Baelmao,wyrmrest-accord,288,monk,mistweaver,6,3,3
Bosschops,illidan,288,monk,mistweaver,6,3,3
Lightweaving,norgannon,288,monk,mistweaver,6,3,3
Stigzz,stormrage,288,monk,mistweaver,6,3,3
Vasera,moon-guard,288,monk,mistweaver,6,3,3
Fysicalx,stormrage,288,monk,mistweaver,6,3,3
Mipkek,saurfang,288,monk,mistweaver,6,3,3
Möösê,moon-guard,288,monk,mistweaver,6,3,3
Miýagi,sargeras,288,monk,mistweaver,6,3,3
Aphrodîîte,area-52,288,monk,mistweaver,6,3,3
Arinix,tichondrius,288,monk,mistweaver,6,3,3
Cädemaddöx,stormrage,288,monk,mistweaver,6,3,3
Omnivò,emerald-dream,288,monk,mistweaver,6,3,3
Quander,tichondrius,288,monk,mistweaver,6,3,3
Gguldduck,tichondrius,288,monk,mistweaver,6,3,3
Kayla,ursin,288,monk,mistweaver,6,3,3
Ase,frostwolf,288,monk,mistweaver,6,3,3
Zzizzi,tichondrius,288,monk,mistweaver,6,3,3
Skâ,kiljaeden,288,monk,mistweaver,6,3,3
Imisswodxo,illidan,288,monk,mistweaver,6,3,3
Duckingkarma,tichondrius,288,monk,mistweaver,6,3,3
Zaçh,frostmane,288,monk,mistweaver,6,3,3
Backup,lothar,288,monk,mistweaver,11,4,7
Kúrios,azralon,288,monk,mistweaver,10,3,7
Dreadneck,sargeras,288,monk,mistweaver,12,3,9
Chilliweaver,frostmourne,288,monk,mistweaver,12,3,9
Øtpp,sargeras,288,monk,mistweaver,12,3,9
Porkmist,icecrown,288,monk,mistweaver,12,3,9
Gentlefists,sargeras,288,monk,mistweaver,12,3,9
Fitofryfitof,aegwynn,288,monk,mistweaver,12,3,9
Mwtouch,nemesis,288,monk,mistweaver,12,3,9
Selfîe,ysera,288,monk,mistweaver,12,3,9
Mistabrew,frostmourne,288,monk,mistweaver,12,3,9
Wizcaulifa,stormrage,288,monk,mistweaver,12,3,9
Wørm,emerald-dream,288,monk,mistweaver,12,3,9
Katalina,alexstrasza,288,monk,mistweaver,12,3,9
Hixemonk,illidan,288,monk,mistweaver,12,3,9
Korvishka,malganis,288,monk,mistweaver,12,3,9
Aokuang,malganis,288,monk,mistweaver,21,4,17
Imakiya,tichondrius,288,monk,mistweaver,17,3,14
Holandri,moon-guard,287,monk,mistweaver,6,3,3
Iarw,tichondrius,287,monk,mistweaver,6,3,3
Gatsbi,arthas,287,monk,mistweaver,6,3,3
Alanimistw,khadgar,287,monk,mistweaver,6,3,3
Pikafist,tichondrius,287,monk,mistweaver,6,3,3
Starskreem,tichondrius,287,monk,mistweaver,6,3,3
Deyseddia,azgalor,287,monk,mistweaver,6,3,3
Fistidmi,area-52,287,monk,mistweaver,11,4,7
Shlumpuh,tichondrius,287,monk,mistweaver,16,4,12
Uninvited,perenolde,286,monk,mistweaver,6,3,3
Lilpielover,zuljin,286,monk,mistweaver,15,4,11
Klassik,thrall,286,monk,mistweaver,21,4,17
Timjongill,stormrage,271,monk,mistweaver,11,3,8
Fingies,garrosh,271,monk,mistweaver,11,3,8
Lildae,burning-legion,256,monk,mistweaver,4,4,0
Koragro,tichondrius,239,monk,mistweaver,5,3,2
Isit,vashj,234,monk,mistweaver,9,4,5
Zeisei,wyrmrest-accord,234,monk,mistweaver,10,4,6
Hirado,kelthuzad,234,monk,mistweaver,16,4,12
Friedpanda,kelthuzad,234,monk,mistweaver,16,4,12
Badnboojie,malganis,234,monk,mistweaver,21,4,17
Shaotee,tichondrius,208,monk,mistweaver,7,3,4
Fujiô,illidan,192,monk,mistweaver,4,3,1
Furryfisttin,illidan,192,monk,mistweaver,8,3,5
Wangba,tichondrius,192,monk,mistweaver,6,2,4
Bamboøzled,daggerspine,192,monk,mistweaver,6,2,4
Gyatso,aegwynn,192,monk,mistweaver,6,2,4
Mistbeard,aggramar,192,monk,mistweaver,6,2,4
Primez,frostmourne,192,monk,mistweaver,6,2,4
Skadouch,wyrmrest-accord,192,monk,mistweaver,6,2,4
Apparent,lightnings-blade,192,monk,mistweaver,6,2,4
Zåz,nazgrel,192,monk,mistweaver,6,2,4
Yenizä,illidan,192,monk,mistweaver,6,2,4
Flexmonk,barthilas,192,monk,mistweaver,6,2,4
Djbluezx,tichondrius,192,monk,mistweaver,6,2,4
Sebasu,perenolde,192,monk,mistweaver,6,2,4
Fortnight,emerald-dream,192,monk,mistweaver,6,2,4
Lilknucks,bonechewer,192,monk,mistweaver,6,2,4
Acena,stormrage,192,monk,mistweaver,6,2,4
Broxxenidas,quelthalas,192,monk,mistweaver,6,2,4
Caralia,exodar,192,monk,mistweaver,6,2,4
Tarae,nagrand,192,monk,mistweaver,6,2,4
Wamii,tichondrius,192,monk,mistweaver,6,2,4
Fäded,trollbane,192,monk,mistweaver,6,2,4
Selocke,bleeding-hollow,192,monk,mistweaver,6,2,4
Melocotonn,goldrinn,192,monk,mistweaver,6,2,4
Privm,moonrunner,192,monk,mistweaver,6,2,4
Udjun,bleeding-hollow,192,monk,mistweaver,6,2,4
Kîkû,moon-guard,192,monk,mistweaver,6,2,4
Springsummer,tichondrius,192,monk,mistweaver,6,2,4
Xanzee,area-52,192,monk,mistweaver,6,2,4
Demödras,stormrage,192,monk,mistweaver,6,2,4
Foxmacleod,bleeding-hollow,192,monk,mistweaver,6,2,4
Zengoku,zuljin,192,monk,mistweaver,6,2,4
Gullystylez,hellscream,192,monk,mistweaver,6,2,4
Drfistyfingr,malganis,192,monk,mistweaver,6,2,4
Tommywiseau,amanthul,192,monk,mistweaver,6,2,4
Rekque,amanthul,192,monk,mistweaver,6,2,4
Ashenn,area-52,192,monk,mistweaver,6,2,4
Vams,barthilas,192,monk,mistweaver,6,2,4
Rubntug,zuljin,192,monk,mistweaver,6,2,4
Aquamonk,tichondrius,192,monk,mistweaver,6,2,4
Ahlam,tichondrius,192,monk,mistweaver,6,2,4
Theriní,stormrage,192,monk,mistweaver,6,2,4
Fïstbeaver,malganis,192,monk,mistweaver,6,2,4
Hitchslapz,tichondrius,192,monk,mistweaver,6,2,4
Jittersx,silvermoon,192,monk,mistweaver,6,2,4
Pandamanapua,dragonmaw,192,monk,mistweaver,6,2,4
Iililiililil,stormrage,192,monk,mistweaver,6,2,4
Tigerlust,sargeras,192,monk,mistweaver,6,2,4
Ricecákez,alterac-mountains,192,monk,mistweaver,6,2,4
Kickflipy,dalaran,192,monk,mistweaver,6,2,4
Nilonsso,sargeras,192,monk,mistweaver,6,2,4
Bamboozle,blackrock,192,monk,mistweaver,6,2,4
Bodyshot,area-52,192,monk,mistweaver,6,2,4
Banidiin,moon-guard,192,monk,mistweaver,6,2,4
Jaybum,sargeras,192,monk,mistweaver,6,2,4
Touchbot,tichondrius,192,monk,mistweaver,6,2,4
Míyãgí,tichondrius,192,monk,mistweaver,6,2,4
Kåelarayn,moon-guard,192,monk,mistweaver,6,2,4
Quickhands,dalaran,192,monk,mistweaver,6,2,4
Onepunch,exodar,192,monk,mistweaver,7,2,5
Glowsgreenby,area-52,192,monk,mistweaver,8,2,6
Coffeek,area-52,192,monk,mistweaver,8,2,6
Mung,boulderfist,192,monk,mistweaver,12,2,10
Ðetroitsmash,sargeras,192,monk,mistweaver,12,2,10
Bubblekit,nerzhul,192,monk,mistweaver,12,2,10
Monkik,laughing-skull,192,monk,mistweaver,12,2,10
Hellcow,frostmourne,192,monk,mistweaver,12,2,10
Taymonk,stormrage,192,monk,mistweaver,12,2,10
Tacoma,sargeras,192,monk,mistweaver,12,2,10
Hunglikejfk,thrall,192,monk,mistweaver,12,2,10
Missmagda,darkspear,192,monk,mistweaver,12,2,10
Kick,dragonmaw,192,monk,mistweaver,12,2,10
Gândhi,kiljaeden,192,monk,mistweaver,12,2,10
Yomamaflo,wildhammer,192,monk,mistweaver,12,2,10
Fuchizaki,ragnaros,192,monk,mistweaver,12,2,10
Salzamonk,aggramar,192,monk,mistweaver,12,2,10
Göönsqüäd,moon-guard,192,monk,mistweaver,12,2,10
Whynotec,tichondrius,192,monk,mistweaver,12,2,10
Sanytea,sargeras,192,monk,mistweaver,12,2,10
Chuggernaut,illidan,192,monk,mistweaver,15,2,13
Fatde,daggerspine,192,monk,mistweaver,18,2,16
Farmerstan,sargeras,192,monk,mistweaver,18,2,16
Senzmist,lightbringer,191,monk,mistweaver,6,2,4
Realisthands,barthilas,191,monk,mistweaver,6,2,4
Honestworkz,area-52,191,monk,mistweaver,6,2,4
Blazebeast,blackhand,191,monk,mistweaver,6,2,4
Rorik,deathwing,191,monk,mistweaver,12,2,10
Phystweaver,malganis,175,monk,mistweaver,11,2,9
Fistaholic,turalyon,159,monk,mistweaver,5,2,3
Pathad,stormrage,159,monk,mistweaver,5,2,3
Duskier,garithos,144,monk,mistweaver,3,3,0
Miestro,tichondrius,138,monk,mistweaver,6,3,3
Spicybrew,tichondrius,138,monk,mistweaver,7,3,4
Wifflenut,tichondrius,138,monk,mistweaver,11,4,7
Fijiwater,stormrage,138,monk,mistweaver,9,3,6
ßøøstêðçhåñ,illidan,138,monk,mistweaver,9,3,6
Slimweaver,stormrage,138,monk,mistweaver,13,4,9
Vyostao,ragnaros,138,monk,mistweaver,11,3,8
Liaoran,stormrage,128,monk,mistweaver,4,2,2
Averagéjoe,tichondrius,127,monk,mistweaver,8,2,6
Mysstickle,icecrown,96,monk,mistweaver,3,2,1
Kungfucheeks,illidan,96,monk,mistweaver,6,1,5
Ezpzmonk,bloodscalp,96,monk,mistweaver,6,1,5
Jamesboong,illidan,96,monk,mistweaver,6,1,5
Hawrang,tichondrius,96,monk,mistweaver,6,1,5
Bannedbybliz,thrall,96,monk,mistweaver,6,1,5
Backfistt,tichondrius,96,monk,mistweaver,6,1,5
Rockfu,illidan,96,monk,mistweaver,6,1,5
Shrimptown,dalaran,96,monk,mistweaver,6,1,5
Zrza,tichondrius,96,monk,mistweaver,6,1,5
Stickyloads,illidan,96,monk,mistweaver,6,1,5
Meniscusmonk,emerald-dream,96,monk,mistweaver,6,1,5
Fatboyswag,tichondrius,96,monk,mistweaver,6,1,5
Froggie,illidan,96,monk,mistweaver,6,1,5
Brewtalìty,tichondrius,96,monk,mistweaver,6,1,5
Samaera,uther,96,monk,mistweaver,6,1,5
Kenvuki,emerald-dream,96,monk,mistweaver,6,1,5
Kimmyfists,tichondrius,96,monk,mistweaver,6,1,5
Yangdingtian,sargeras,96,monk,mistweaver,6,1,5
Ruion,moon-guard,96,monk,mistweaver,6,1,5
Daeio,burning-legion,96,monk,mistweaver,6,1,5
Emrose,demon-soul,96,monk,mistweaver,6,1,5
Kayakpunch,moon-guard,96,monk,mistweaver,6,1,5
Squidbillie,moon-guard,96,monk,mistweaver,6,1,5
Turkeydinner,frostmourne,96,monk,mistweaver,6,1,5
Criminall,aegwynn,96,monk,mistweaver,6,1,5
Sheff,daggerspine,96,monk,mistweaver,6,1,5
Tedbondy,moon-guard,96,monk,mistweaver,6,1,5
Lainerya,moon-guard,96,monk,mistweaver,6,1,5
Lomist,nazjatar,96,monk,mistweaver,6,1,5
Twistedchi,stormrage,96,monk,mistweaver,6,1,5
Hedgefrogs,stormrage,96,monk,mistweaver,6,1,5
Dirack,quelthalas,96,monk,mistweaver,6,1,5
Tzobee,stormrage,96,monk,mistweaver,6,1,5
Súprä,stormrage,96,monk,mistweaver,6,1,5
Naveex,bleeding-hollow,96,monk,mistweaver,6,1,5
Findorato,windrunner,96,monk,mistweaver,6,1,5
Monkuxe,zuljin,96,monk,mistweaver,6,1,5
Kiawe,zuljin,96,monk,mistweaver,6,1,5
Charrek,zuljin,96,monk,mistweaver,6,1,5
Raylá,kelthuzad,96,monk,mistweaver,6,1,5
Dankestkhan,korialstrasz,96,monk,mistweaver,6,1,5
Notthefather,area-52,96,monk,mistweaver,6,1,5
Limejuulpod,malganis,96,monk,mistweaver,6,1,5
Danicah,altar-of-storms,96,monk,mistweaver,6,1,5
Ogmonk,skullcrusher,96,monk,mistweaver,6,1,5
Kaÿñ,area-52,96,monk,mistweaver,6,1,5
Ünarù,area-52,96,monk,mistweaver,6,1,5
Tofugoku,area-52,96,monk,mistweaver,6,1,5
Faméd,stormrage,96,monk,mistweaver,8,1,7
Ghostsofur,tichondrius,96,monk,mistweaver,12,1,11
Eliwenn,ragnaros,96,monk,mistweaver,12,1,11
Théophila,illidan,96,monk,mistweaver,12,1,11
Zenmidget,kelthuzad,96,monk,mistweaver,12,1,11
Selectra,malfurion,95,monk,mistweaver,6,1,5
Fairymonk,frostwolf,79,monk,mistweaver,5,1,4
Clixstermonk,area-52,79,monk,mistweaver,5,1,4
Thalreyzian,vashj,64,monk,mistweaver,4,1,3
Rockxtv,illidan,63,monk,mistweaver,2,2,0
Deethnutth,bleeding-hollow,63,monk,mistweaver,2,2,0
Fumoo,sargeras,42,monk,mistweaver,10,3,7
Mataleao,emerald-dream,42,monk,mistweaver,10,2,8
Whtnyhuston,sargeras,42,monk,mistweaver,12,2,10
Vazana,moon-guard,30,monk,mistweaver,18,7,11
Worldpvp,nerzhul,1398,monk,brewmaster,39,16,23
Epucphail,kelthuzad,1221,monk,brewmaster,78,33,45
Omgar,frostmourne,1046,monk,brewmaster,44,17,27
Daesun,quelthalas,958,monk,brewmaster,18,10,8
Robbo,tichondrius,576,monk,brewmaster,18,6,12
Chochas,tichondrius,477,monk,brewmaster,12,5,7
Morpheous,whisperwind,383,monk,brewmaster,6,4,2
Doughboy,skullcrusher,383,monk,brewmaster,12,4,8
Genié,moon-guard,288,monk,brewmaster,6,3,3
Akhar,nazgrel,288,monk,brewmaster,6,3,3
Lonebamboo,tichondrius,288,monk,brewmaster,12,3,9
Quaria,moon-guard,288,monk,brewmaster,18,3,15
Daedae,quelthalas,192,monk,brewmaster,8,3,5
Sistuhfista,tichondrius,192,monk,brewmaster,6,2,4
Drunkfight,zuljin,192,monk,brewmaster,18,2,16
Encry,zuljin,191,monk,brewmaster,6,2,4
Ferrarí,quelthalas,79,monk,brewmaster,11,1,10
Rín,dalaran,42,monk,brewmaster,7,2,5
Yerky,stormrage,2300,monk,windwalker,95,54,41
Neighbors,sargeras,2287,monk,windwalker,139,76,63
Iminglee,area-52,2264,monk,windwalker,118,62,56
Keyam,illidan,2208,monk,windwalker,101,54,47
Primez,frostmourne,2195,monk,windwalker,83,45,38
Judo,agamaggan,2157,monk,windwalker,86,46,40
Sean,nazjatar,2143,monk,windwalker,72,38,34
Senseiww,sargeras,2143,monk,windwalker,126,64,62
Pacmankr,tichondrius,2135,monk,windwalker,153,80,73
Thewy,tichondrius,2132,monk,windwalker,108,55,53
Fueld,burning-legion,2132,monk,windwalker,378,192,186
Cmx,sargeras,2125,monk,windwalker,172,88,84
Riversøng,frostmourne,2115,monk,windwalker,84,46,38
Chyx,tichondrius,2113,monk,windwalker,112,57,55
Xyän,bleeding-hollow,2112,monk,windwalker,94,47,47
Edenx,sargeras,2111,monk,windwalker,66,38,28
Flattsww,tichondrius,2111,monk,windwalker,274,140,134
Stárset,illidan,2104,monk,windwalker,96,54,42
Rickybobbyx,vashj,2103,monk,windwalker,119,61,58
Iílílílílílí,area-52,2101,monk,windwalker,84,43,41
Catgallery,tichondrius,2100,monk,windwalker,203,105,98
Homun,tichondrius,2100,monk,windwalker,94,46,48
Bigherosixx,tichondrius,2097,monk,windwalker,120,65,55
Chopt,zuljin,2061,monk,windwalker,90,45,45
Fatal,bonechewer,2059,monk,windwalker,118,65,53
Hypnøtìze,frostmourne,2055,monk,windwalker,203,107,96
Larryjonés,area-52,2051,monk,windwalker,209,106,103
Liamllama,barthilas,2036,monk,windwalker,176,92,84
Rytes,moon-guard,2025,monk,windwalker,189,99,90
Xølik,draenor,2019,monk,windwalker,60,43,17
Blackpandax,tichondrius,2008,monk,windwalker,107,55,52
Spotifyfan,ysera,1994,monk,windwalker,189,103,86
Touchofdeáth,stormrage,1991,monk,windwalker,161,88,73
Hakri,arthas,1987,monk,windwalker,30,21,9
Madtiger,scilla,1978,monk,windwalker,135,69,66
Droguex,tichondrius,1973,monk,windwalker,276,131,145
Cuteirl,tichondrius,1970,monk,windwalker,84,53,31
Shïvïr,azralon,1962,monk,windwalker,207,107,100
Fínzy,tichondrius,1962,monk,windwalker,203,104,99
Crashandflow,zuljin,1961,monk,windwalker,60,33,27
Inbu,tichondrius,1957,monk,windwalker,158,79,79
Bdw,tichondrius,1955,monk,windwalker,142,84,58
Dzq,stormrage,1953,monk,windwalker,98,55,43
Robbo,tichondrius,1949,monk,windwalker,71,37,34
Kranelo,tichondrius,1946,monk,windwalker,54,32,22
Percentx,tichondrius,1935,monk,windwalker,60,29,31
Repbrew,sargeras,1934,monk,windwalker,81,40,41
Baddi,uldum,1931,monk,windwalker,154,79,75
Wondý,quelthalas,1931,monk,windwalker,173,86,87
Nehji,illidan,1927,monk,windwalker,141,70,71
Wwlékinhø,azralon,1926,monk,windwalker,90,51,39
Yuujitsu,sargeras,1924,monk,windwalker,169,90,79
Hiurge,tichondrius,1922,monk,windwalker,102,52,50
Torkscrew,bleeding-hollow,1919,monk,windwalker,42,25,17
Frootsmoothi,thrall,1919,monk,windwalker,106,52,54
Broomooster,bleeding-hollow,1919,monk,windwalker,65,29,36
Choplo,demon-soul,1911,monk,windwalker,78,43,35
Omnly,stormrage,1901,monk,windwalker,56,30,26
Tippytap,bleeding-hollow,1899,monk,windwalker,119,60,59
Weathermanxv,kelthuzad,1896,monk,windwalker,123,56,67
Duhäst,sargeras,1895,monk,windwalker,78,46,32
Conngaline,stormreaver,1893,monk,windwalker,419,206,213
Threnody,malganis,1891,monk,windwalker,82,39,43
Lodbork,tichondrius,1887,monk,windwalker,437,223,214
Lhiri,moon-guard,1886,monk,windwalker,65,33,32
Gaslighterr,tichondrius,1883,monk,windwalker,57,35,22
Maozhën,tichondrius,1882,monk,windwalker,60,31,29
Sínsayer,tichondrius,1882,monk,windwalker,123,55,68
Mikephoenix,tichondrius,1877,monk,windwalker,133,69,64
Jaxvisto,dalaran,1868,monk,windwalker,101,51,50
Unhappyclown,tichondrius,1867,monk,windwalker,167,94,73
Screwz,tichondrius,1867,monk,windwalker,67,33,34
Mikeyx,area-52,1862,monk,windwalker,36,21,15
Shírÿu,azralon,1857,monk,windwalker,83,42,41
Garypool,emerald-dream,1856,monk,windwalker,33,20,13
Boeycalma,illidan,1855,monk,windwalker,60,36,24
Alshee,nagrand,1846,monk,windwalker,45,24,21
Guylian,tichondrius,1845,monk,windwalker,58,30,28
Tschi,illidan,1844,monk,windwalker,42,29,13
Artam,thrall,1844,monk,windwalker,89,51,38
Smokechief,hyjal,1844,monk,windwalker,60,33,27
Helvectius,tichondrius,1843,monk,windwalker,192,90,102
Züdo,area-52,1841,monk,windwalker,105,55,50
Allmight,wyrmrest-accord,1839,monk,windwalker,105,58,47
Bunnygal,thaurissan,1838,monk,windwalker,82,43,39
Napbox,bleeding-hollow,1837,monk,windwalker,152,79,73
Absurd,mannoroth,1836,monk,windwalker,33,21,12
Kuranchi,sargeras,1836,monk,windwalker,42,23,19
Sunfistway,sargeras,1835,monk,windwalker,80,48,32
Karmerr,proudmoore,1835,monk,windwalker,66,35,31
Peachcactus,sargeras,1833,monk,windwalker,42,27,15
Rockxtv,illidan,1831,monk,windwalker,60,27,33
Lopez,sargeras,1825,monk,windwalker,54,35,19
Backfliptime,ragnaros,1825,monk,windwalker,46,28,18
Lahri,silvermoon,1824,monk,windwalker,80,48,32
Nelariah,wyrmrest-accord,1822,monk,windwalker,59,28,31
Sylash,ragnaros,1821,monk,windwalker,36,21,15
Zionk,tichondrius,1820,monk,windwalker,114,79,35
Sentomaru,bleeding-hollow,1820,monk,windwalker,66,33,33
Elfoverde,stormrage,1819,monk,windwalker,48,30,18
Vybïn,tichondrius,1816,monk,windwalker,294,146,148
Micai,thrall,1813,monk,windwalker,42,25,17
Bakha,illidan,1812,monk,windwalker,35,22,13
Shisama,area-52,1812,monk,windwalker,62,38,24
Doczen,malganis,1812,monk,windwalker,60,29,31
Jamut,stormrage,1812,monk,windwalker,54,23,31
Senritsuh,drakkari,1811,monk,windwalker,58,29,29
Maomaogun,tichondrius,1810,monk,windwalker,42,29,13
Xìðñ,moon-guard,1808,monk,windwalker,102,70,32
Hailan,area-52,1808,monk,windwalker,48,29,19
Turbofist,bleeding-hollow,1803,monk,windwalker,42,25,17
Imasterl,proudmoore,1803,monk,windwalker,51,27,24
Bussÿ,area-52,1803,monk,windwalker,111,54,57
Furiamvp,stormrage,1801,monk,windwalker,54,28,26
Accidntprone,zangarmarsh,1801,monk,windwalker,54,28,26
Ghooch,illidan,1800,monk,windwalker,66,39,27
Muhli,kiljaeden,1800,monk,windwalker,42,22,20
Monkatron,arthas,1799,monk,windwalker,119,60,59
Marçi,moon-guard,1799,monk,windwalker,139,64,75
Fátë,tichondrius,1790,monk,windwalker,114,50,64
Brewceo,area-52,1787,monk,windwalker,66,34,32
Dwarfmonk,tichondrius,1782,monk,windwalker,48,22,26
Innerverse,tichondrius,1781,monk,windwalker,53,26,27
Snebyos,tichondrius,1780,monk,windwalker,107,62,45
Alps,darkspear,1780,monk,windwalker,48,24,24
Atsuyuki,nemesis,1778,monk,windwalker,55,25,30
Rockyßalboa,sargeras,1774,monk,windwalker,85,50,35
Thuyvan,barthilas,1773,monk,windwalker,54,31,23
Serthean,illidan,1773,monk,windwalker,230,112,118
Mhmmzz,sargeras,1769,monk,windwalker,114,58,56
Tristantwo,sargeras,1761,monk,windwalker,96,47,49
Gigached,zuljin,1759,monk,windwalker,75,35,40
Jümmy,area-52,1757,monk,windwalker,54,26,28
Phistea,area-52,1749,monk,windwalker,75,37,38
Jåðëðrägøñ,sargeras,1745,monk,windwalker,61,36,25
Kagebunshin,kelthuzad,1744,monk,windwalker,42,25,17
Bruceteå,area-52,1744,monk,windwalker,36,19,17
Zynflex,tichondrius,1743,monk,windwalker,59,27,32
Tragorin,tichondrius,1740,monk,windwalker,60,31,29
Danimalz,stormrage,1737,monk,windwalker,60,31,29
Nyofu,moon-guard,1737,monk,windwalker,47,23,24
Pandagirlw,tichondrius,1735,monk,windwalker,72,43,29
Lidä,tichondrius,1735,monk,windwalker,60,25,35
Ambal,hellscream,1734,monk,windwalker,55,32,23
Syerzie,dalaran,1732,monk,windwalker,93,42,51
Kárma,malganis,1731,monk,windwalker,42,24,18
Khawai,sargeras,1730,monk,windwalker,54,29,25
Jasey,area-52,1729,monk,windwalker,29,21,8
Jükedx,stormrage,1728,monk,windwalker,91,54,37
Mechamonk,aerie-peak,1728,monk,windwalker,105,46,59
Iremía,azralon,1727,monk,windwalker,48,26,22
Altaidm,ragnaros,1724,monk,windwalker,61,30,31
Monkgyatso,drakthul,1722,monk,windwalker,126,65,61
Raphåel,area-52,1722,monk,windwalker,35,18,17
Xanaxåddict,sargeras,1722,monk,windwalker,225,113,112
Hîddènsõündx,tichondrius,1721,monk,windwalker,36,18,18
Boostedww,bloodscalp,1720,monk,windwalker,48,25,23
Warblaze,barthilas,1720,monk,windwalker,62,31,31
Chunlee,tichondrius,1718,monk,windwalker,42,22,20
Vai,korgath,1716,monk,windwalker,94,46,48
Takkeya,zuljin,1713,monk,windwalker,42,25,17
Livitsu,aerie-peak,1712,monk,windwalker,30,18,12
Haco,malganis,1710,monk,windwalker,57,31,26
Orkmonk,tichondrius,1708,monk,windwalker,42,28,14
Tenooki,illidan,1707,monk,windwalker,41,19,22
Squidie,tichondrius,1707,monk,windwalker,48,19,29
Setback,tichondrius,1706,monk,windwalker,24,18,6
Rakije,barthilas,1703,monk,windwalker,72,44,28
Excalibrew,malganis,1703,monk,windwalker,66,36,30
Tôpsônworld,tichondrius,1700,monk,windwalker,66,39,27
Capiirotta,nemesis,1700,monk,windwalker,128,75,53
Sickbanga,barthilas,1699,monk,windwalker,36,18,18
Akanq,tichondrius,1698,monk,windwalker,39,21,18
Öñlýfåñs,tichondrius,1698,monk,windwalker,65,33,32
Xas,sentinels,1698,monk,windwalker,78,36,42
Humonkulous,darkspear,1696,monk,windwalker,43,19,24
Wolffangfist,sargeras,1695,monk,windwalker,75,45,30
Daracus,kelthuzad,1694,monk,windwalker,38,24,14
Mastâ,kelthuzad,1694,monk,windwalker,116,62,54
Titanus,chogall,1689,monk,windwalker,379,195,184
Xï,proudmoore,1688,monk,windwalker,86,47,39
Ojii,tichondrius,1687,monk,windwalker,58,26,32
Haharetsdead,illidan,1686,monk,windwalker,131,71,60
Shids,barthilas,1686,monk,windwalker,47,22,25
Nightww,area-52,1683,monk,windwalker,60,34,26
Zenluckydo,grizzly-hills,1683,monk,windwalker,113,61,52
Jaspier,quelthalas,1682,monk,windwalker,53,28,25
Thåi,anubarak,1682,monk,windwalker,48,19,29
Vanmonk,eonar,1681,monk,windwalker,36,18,18
Jatzai,emerald-dream,1680,monk,windwalker,52,24,28
Hellstabberm,lightbringer,1678,monk,windwalker,48,26,22
Zhoku,tichondrius,1674,monk,windwalker,30,19,11
Miýagi,sargeras,1671,monk,windwalker,47,28,19
Jdanîel,ragnaros,1671,monk,windwalker,42,21,21
Zenigma,area-52,1670,monk,windwalker,45,24,21
Dea,thrall,1670,monk,windwalker,84,43,41
Watercowz,tichondrius,1669,monk,windwalker,36,22,14
Bigpoppap,tichondrius,1668,monk,windwalker,54,29,25
Madtigon,scilla,1668,monk,windwalker,42,22,20
Ighostgirls,thrall,1668,monk,windwalker,35,18,17
Hèllòkîttý,illidan,1666,monk,windwalker,30,19,11
Hæt,stormrage,1665,monk,windwalker,48,23,25
Shaszx,zuljin,1661,monk,windwalker,47,25,22
Bamron,fizzcrank,1660,monk,windwalker,113,57,56
Windmónk,tichondrius,1657,monk,windwalker,156,76,80
Gêrôx,sargeras,1656,monk,windwalker,42,21,21
Galaxystrike,illidan,1655,monk,windwalker,60,32,28
Quanyaozu,ragnaros,1654,monk,windwalker,32,19,13
Wørm,emerald-dream,1653,monk,windwalker,36,21,15
Fiddletix,stormrage,1647,monk,windwalker,55,28,27
Dumplíngs,emerald-dream,1647,monk,windwalker,59,27,32
Bearface,blades-edge,1646,monk,windwalker,88,36,52
Mists,velen,1645,monk,windwalker,54,31,23
Oxli,emerald-dream,1645,monk,windwalker,46,26,20
Npepper,khadgar,1645,monk,windwalker,112,59,53
Rïggen,thrall,1644,monk,windwalker,88,50,38
Ludanford,eitrigg,1643,monk,windwalker,48,22,26
Foxchik,zuljin,1641,monk,windwalker,76,42,34
Pankekz,tichondrius,1639,monk,windwalker,192,97,95
Akumà,tichondrius,1636,monk,windwalker,48,19,29
Akir,zuljin,1635,monk,windwalker,29,20,9
Rnmedic,stormrage,1632,monk,windwalker,56,24,32
Hotwatertank,area-52,1629,monk,windwalker,60,34,26
Harde,thrall,1629,monk,windwalker,83,43,40
Kungpóa,sargeras,1628,monk,windwalker,39,23,16
Singao,malganis,1628,monk,windwalker,74,36,38
Djjackyd,stormrage,1625,monk,windwalker,30,17,13
Ddoongmonk,tichondrius,1625,monk,windwalker,48,21,27
Plucky,tichondrius,1624,monk,windwalker,37,18,19
Tnsnow,illidan,1623,monk,windwalker,36,21,15
Fuqmeh,darkspear,1621,monk,windwalker,84,42,42
Phistycuffs,bleeding-hollow,1621,monk,windwalker,85,40,45
Jigong,bleeding-hollow,1620,monk,windwalker,42,23,19
Karelio,wyrmrest-accord,1619,monk,windwalker,48,22,26
Aidenww,area-52,1618,monk,windwalker,24,17,7
Sonsia,arthas,1618,monk,windwalker,112,64,48
Fatboí,sargeras,1618,monk,windwalker,51,29,22
Fimeu,kiljaeden,1617,monk,windwalker,54,28,26
Corsan,illidan,1616,monk,windwalker,48,33,15
Hadoukeñ,thrall,1616,monk,windwalker,41,22,19
Jbills,muradin,1615,monk,windwalker,71,41,30
Banyasong,tichondrius,1615,monk,windwalker,108,62,46
Zeati,tichondrius,1613,monk,windwalker,24,17,7
Azizyzz,barthilas,1613,monk,windwalker,30,20,10
Euman,sargeras,1613,monk,windwalker,36,21,15
Themanski,area-52,1612,monk,windwalker,46,24,22
Cpapi,sargeras,1612,monk,windwalker,60,30,30
Xinpa,quelthalas,1612,monk,windwalker,38,19,19
Fapmonk,illidan,1611,monk,windwalker,59,39,20
Whøru,azralon,1611,monk,windwalker,42,17,25
Ehdunno,kelthuzad,1610,monk,windwalker,68,37,31
Punchco,senjin,1610,monk,windwalker,42,21,21
Hím,garrosh,1609,monk,windwalker,87,52,35
Fistnu,aggramar,1608,monk,windwalker,83,49,34
Bumbleechi,azralon,1606,monk,windwalker,36,17,19
Toyotatacoma,bleeding-hollow,1605,monk,windwalker,42,27,15
Daeio,burning-legion,1605,monk,windwalker,31,19,12
Rennafgc,stormrage,1605,monk,windwalker,36,20,16
Jegann,tichondrius,1605,monk,windwalker,140,71,69
Sterow,kiljaeden,1604,monk,windwalker,42,21,21
Flyingfury,illidan,1604,monk,windwalker,54,25,29
Facekandy,tichondrius,1602,monk,windwalker,34,18,16
Xradu,dawnbringer,1601,monk,windwalker,82,49,33
Bruhmesoftly,thrall,1601,monk,windwalker,60,34,26
Flattswwjr,tichondrius,1601,monk,windwalker,36,19,17
Pepeloser,illidan,1601,monk,windwalker,48,23,25
Ronk,the-forgotten-coast,1600,monk,windwalker,30,17,13
Homunculusx,bleeding-hollow,1600,monk,windwalker,42,19,23
Shôckley,tichondrius,1598,monk,windwalker,129,71,58
Dirtypunch,proudmoore,1598,monk,windwalker,42,19,23
Windwalker,blackhand,1597,monk,windwalker,35,19,16
Mitras,dragonblight,1594,monk,windwalker,30,19,11
Lingerer,aerie-peak,1593,monk,windwalker,110,57,53
Marcusm,bleeding-hollow,1592,monk,windwalker,33,20,13
Surgarush,moon-guard,1592,monk,windwalker,106,64,42
Fistyuh,illidan,1590,monk,windwalker,54,31,23
Druta,illidan,1589,monk,windwalker,48,35,13
Feyalash,stormrage,1589,monk,windwalker,74,33,41
Kuffy,kelthuzad,1584,monk,windwalker,67,37,30
Peacefulpaco,malganis,1583,monk,windwalker,54,30,24
Reprap,elune,1582,monk,windwalker,58,33,25
Kogoli,frostwolf,1580,monk,windwalker,101,47,54
Råii,sargeras,1579,monk,windwalker,30,20,10
Wonderx,darkspear,1579,monk,windwalker,30,20,10
Gøgeta,stormrage,1579,monk,windwalker,173,86,87
Copenfist,black-dragonflight,1578,monk,windwalker,36,21,15
Yogiji,proudmoore,1578,monk,windwalker,48,26,22
Udderpunch,barthilas,1578,monk,windwalker,46,21,25
Chucksandmk,barthilas,1577,monk,windwalker,66,32,34
Kitingqt,area-52,1576,monk,windwalker,42,19,23
Pinot,dragonmaw,1572,monk,windwalker,42,17,25
Saucyfists,silvermoon,1568,monk,windwalker,64,32,32
Meatwrap,mugthol,1566,monk,windwalker,52,26,26
Unlike,tichondrius,1566,monk,windwalker,102,49,53
Rigi,stormrage,1564,monk,windwalker,107,46,61
Ráchez,tichondrius,1559,monk,windwalker,93,54,39
Jerax,thunderlord,1559,monk,windwalker,109,59,50
Brewbaker,hyjal,1556,monk,windwalker,86,48,38
Chongzly,frostmourne,1552,monk,windwalker,90,44,46
Dïsturbedtko,azralon,1552,monk,windwalker,120,58,62
Allmother,area-52,1552,monk,windwalker,43,19,24
Fistnafurry,tichondrius,1550,monk,windwalker,42,21,21
Fornoraisin,thrall,1547,monk,windwalker,54,21,33
Nagato,nemesis,1545,monk,windwalker,23,17,6
Thouther,sargeras,1545,monk,windwalker,42,17,25
Ranchy,zuljin,1543,monk,windwalker,144,71,73
Chingu,ragnaros,1543,monk,windwalker,123,59,64
Therapeutics,moon-guard,1543,monk,windwalker,102,47,55
Okoh,wyrmrest-accord,1542,monk,windwalker,50,28,22
Pokinpooters,stormrage,1536,monk,windwalker,129,65,64
Lørdjåshïn,azjolnerub,1534,monk,windwalker,30,16,14
Çraßsßùrgêr,bonechewer,1533,monk,windwalker,24,16,8
Adilm,illidan,1533,monk,windwalker,30,16,14
Veso,tichondrius,1532,monk,windwalker,18,16,2
Hamyu,illidan,1531,monk,windwalker,36,18,18
Healzpapi,tichondrius,1530,monk,windwalker,120,73,47
Bakedmonk,smolderthorn,1530,monk,windwalker,82,32,50
Zaabuza,azralon,1528,monk,windwalker,60,39,21
Feelsogöod,tichondrius,1528,monk,windwalker,64,38,26
Wât,bleeding-hollow,1528,monk,windwalker,30,16,14
Panduh,moon-guard,1528,monk,windwalker,198,100,98
Domiik,ragnaros,1528,monk,windwalker,36,17,19
Drakfu,tichondrius,1527,monk,windwalker,45,26,19
Deezfist,illidan,1527,monk,windwalker,36,17,19
Napoleonic,vashj,1524,monk,windwalker,30,20,10
Hagano,drakkari,1523,monk,windwalker,107,55,52
Muritors,ragnaros,1523,monk,windwalker,36,17,19
Byakugun,wyrmrest-accord,1522,monk,windwalker,36,21,15
Zòrrò,area-52,1521,monk,windwalker,24,16,8
Naagg,tichondrius,1521,monk,windwalker,30,16,14
Yoshifistsu,malganis,1521,monk,windwalker,54,26,28
Odogin,tichondrius,1520,monk,windwalker,65,42,23
Göllyjee,tichondrius,1517,monk,windwalker,90,39,51
Bløødÿ,ragnaros,1516,monk,windwalker,21,17,4
Wenisdeep,frostmourne,1516,monk,windwalker,94,47,47
Kómugi,area-52,1514,monk,windwalker,137,72,65
Borekkar,emerald-dream,1512,monk,windwalker,47,24,23
Kutz,proudmoore,1512,monk,windwalker,81,40,41
Odi,stonemaul,1509,monk,windwalker,101,48,53
Sgarbossa,tortheldrin,1509,monk,windwalker,42,16,26
Arizøna,illidan,1507,monk,windwalker,80,44,36
Hòlygòd,dalaran,1506,monk,windwalker,88,45,43
Geekweek,frostmourne,1503,monk,windwalker,30,17,13
Nject,malganis,1502,monk,windwalker,108,60,48
Ökami,tichondrius,1501,monk,windwalker,56,29,27
Dabzin,stormrage,1501,monk,windwalker,87,44,43
Varn,frostmourne,1500,monk,windwalker,95,46,49
Yeawe,tichondrius,1499,monk,windwalker,36,19,17
Punchiboi,thrall,1498,monk,windwalker,48,27,21
Captnmurphy,tichondrius,1498,monk,windwalker,29,16,13
Ascilica,firetree,1495,monk,windwalker,24,16,8
Tigerstrikes,sargeras,1494,monk,windwalker,30,19,11
Sleýin,tichondrius,1493,monk,windwalker,190,101,89
Monkings,tichondrius,1491,monk,windwalker,65,30,35
Allure,frostmourne,1489,monk,windwalker,45,20,25
Simonb,tichondrius,1487,monk,windwalker,54,24,30
Minimonke,moon-guard,1486,monk,windwalker,86,45,41
Rockemsockem,gorefiend,1485,monk,windwalker,90,48,42
Wizcaulifa,stormrage,1484,monk,windwalker,30,17,13
Astteell,proudmoore,1484,monk,windwalker,45,18,27
Kiulang,kelthuzad,1483,monk,windwalker,93,44,49
Yamoshì,stormrage,1482,monk,windwalker,54,30,24
Jdkick,sargeras,1482,monk,windwalker,42,16,26
Aubiemonk,malygos,1479,monk,windwalker,30,16,14
Yungtoochi,tichondrius,1479,monk,windwalker,54,23,31
Sivedrafely,arthas,1475,monk,windwalker,60,30,30
Beverage,frostmourne,1475,monk,windwalker,51,24,27
Atreia,malganis,1474,monk,windwalker,26,17,9
Ohgiddyttv,dalaran,1468,monk,windwalker,83,43,40
Sckmonk,tichondrius,1466,monk,windwalker,34,16,18
ßlesséd,tichondrius,1465,monk,windwalker,85,36,49
Butjaum,stormrage,1464,monk,windwalker,70,34,36
Senseî,altar-of-storms,1460,monk,windwalker,60,27,33
Wartenja,frostmourne,1459,monk,windwalker,90,42,48
Gójó,tichondrius,1458,monk,windwalker,36,23,13
Katsübooy,azralon,1458,monk,windwalker,310,158,152
Tyroneßanks,stormrage,1457,monk,windwalker,36,20,16
Mastahp,tichondrius,1457,monk,windwalker,42,23,19
Xogum,azralon,1453,monk,windwalker,30,16,14
Grimpossible,malganis,1452,monk,windwalker,66,32,34
Shishosenin,quelthalas,1450,monk,windwalker,218,104,114
Callae,dreadmaul,1449,monk,windwalker,66,34,32
Lickthefist,sargeras,1445,monk,windwalker,24,16,8
Infest,azralon,1442,monk,windwalker,42,30,12
Wind,misha,1440,monk,windwalker,55,35,20
Pånkekz,tichondrius,1440,monk,windwalker,90,45,45
Lavinci,area-52,1437,monk,windwalker,30,15,15
Smoothboxing,tichondrius,1436,monk,windwalker,116,66,50
Jackdaniel,sargeras,1435,monk,windwalker,24,15,9
Aizu,ragnaros,1435,monk,windwalker,30,15,15
Wüsok,thrall,1435,monk,windwalker,30,15,15
Rocketfrogg,bleeding-hollow,1434,monk,windwalker,36,15,21
Ahrk,emerald-dream,1434,monk,windwalker,78,30,48
Kungfupurk,bleeding-hollow,1433,monk,windwalker,24,15,9
Fistys,area-52,1433,monk,windwalker,117,60,57
Izu,senjin,1433,monk,windwalker,30,15,15
Heiwei,stormrage,1432,monk,windwalker,24,15,9
Skippa,emerald-dream,1432,monk,windwalker,54,30,24
Bhodie,zuljin,1432,monk,windwalker,74,32,42
Xuenws,tichondrius,1429,monk,windwalker,24,15,9
Rafên,moon-guard,1429,monk,windwalker,42,15,27
Giatzo,barthilas,1427,monk,windwalker,66,37,29
Mattyj,darkspear,1423,monk,windwalker,30,15,15
Chuchinga,tichondrius,1423,monk,windwalker,90,43,47
Judgevr,frostmourne,1423,monk,windwalker,39,17,22
Rocketfist,bleeding-hollow,1422,monk,windwalker,102,48,54
Daddyrugburn,area-52,1421,monk,windwalker,119,57,62
Dazzler,ragnaros,1419,monk,windwalker,66,35,31
Maunk,illidan,1418,monk,windwalker,18,15,3
Gún,ragnaros,1416,monk,windwalker,89,45,44
Convectuoso,illidan,1414,monk,windwalker,24,15,9
Norrischucks,sargeras,1412,monk,windwalker,30,22,8
Daslow,quelthalas,1412,monk,windwalker,146,75,71
Whizz,frostmane,1408,monk,windwalker,37,17,20
Gesir,tichondrius,1407,monk,windwalker,57,25,32
Sodamint,sargeras,1403,monk,windwalker,44,16,28
Saiyajinsoul,ragnaros,1402,monk,windwalker,60,29,31
Chingwang,frostmourne,1400,monk,windwalker,41,24,17
Creonus,proudmoore,1400,monk,windwalker,56,24,32
Showshoway,tichondrius,1396,monk,windwalker,65,27,38
Meniscusmonk,emerald-dream,1392,monk,windwalker,35,17,18
Milkychi,frostmourne,1392,monk,windwalker,40,15,25
Asaltofsorts,tichondrius,1390,monk,windwalker,30,18,12
Onepunchman,quelthalas,1389,monk,windwalker,51,19,32
Versuri,azralon,1387,monk,windwalker,117,60,57
Shlumpuh,tichondrius,1385,monk,windwalker,42,18,24
Trapeez,kelthuzad,1383,monk,windwalker,70,40,30
Mannkin,zuluhed,1383,monk,windwalker,38,16,22
Kawasakii,tichondrius,1382,monk,windwalker,166,83,83
Pepepunch,bleeding-hollow,1381,monk,windwalker,36,15,21
Niked,tichondrius,1379,monk,windwalker,36,15,21
Chopsake,khadgar,1377,monk,windwalker,66,40,26
Shianjuo,ragnaros,1372,monk,windwalker,42,20,22
Eavale,destromath,1371,monk,windwalker,121,61,60
Bradyfour,moon-guard,1370,monk,windwalker,83,42,41
Tacofox,tichondrius,1369,monk,windwalker,119,57,62
Tassmonk,hyjal,1367,monk,windwalker,36,17,19
Brewmaker,sargeras,1366,monk,windwalker,51,24,27
Varekaî,frostmourne,1365,monk,windwalker,62,32,30
Chigang,deathwing,1362,monk,windwalker,42,22,20
Screwballz,blackrock,1360,monk,windwalker,117,53,64
Headsmasher,wyrmrest-accord,1359,monk,windwalker,113,51,62
Sarious,lightbringer,1354,monk,windwalker,273,142,131
Kriticalkush,kelthuzad,1353,monk,windwalker,24,17,7
Chihad,stormrage,1352,monk,windwalker,42,25,17
Owned,dreadmaul,1349,monk,windwalker,36,23,13
Kungfusacks,sargeras,1346,monk,windwalker,24,16,8
Sultanofwind,malganis,1344,monk,windwalker,24,14,10
Dalearnhardt,proudmoore,1343,monk,windwalker,18,14,4
Zuì,sargeras,1342,monk,windwalker,24,14,10
Astrofu,tichondrius,1341,monk,windwalker,82,34,48
Dakenprime,tichondrius,1340,monk,windwalker,82,40,42
Telospateo,ragnaros,1340,monk,windwalker,30,14,16
Obiiwan,tichondrius,1340,monk,windwalker,42,17,25
Bluntdoctor,stormreaver,1340,monk,windwalker,66,24,42
Dkdakìng,stormrage,1339,monk,windwalker,24,14,10
Gigagirth,emerald-dream,1338,monk,windwalker,30,14,16
Skymonge,stormrage,1338,monk,windwalker,104,48,56
Tingum,kelthuzad,1337,monk,windwalker,34,15,19
Ghaelessi,senjin,1336,monk,windwalker,77,42,35
Novoctek,quelthalas,1336,monk,windwalker,30,14,16
Büster,tichondrius,1334,monk,windwalker,24,14,10
Raskalnikov,kelthuzad,1334,monk,windwalker,32,16,16
Kungfüsed,stormrage,1329,monk,windwalker,36,19,17
Resolver,stormscale,1327,monk,windwalker,52,27,25
Yeji,altar-of-storms,1326,monk,windwalker,24,14,10
Saltystepbro,illidan,1323,monk,windwalker,24,14,10
Æeeæ,hakkar,1318,monk,windwalker,18,14,4
Jajabelugeng,tichondrius,1315,monk,windwalker,24,14,10
Omimonk,sargeras,1314,monk,windwalker,24,14,10
Shocclol,stormrage,1306,monk,windwalker,27,17,10
Acharä,tichondrius,1305,monk,windwalker,36,20,16
Goonkeg,frostmourne,1304,monk,windwalker,30,14,16
Madbuffz,nemesis,1304,monk,windwalker,72,32,40
Twïst,tichondrius,1303,monk,windwalker,18,14,4
Xiaowën,nemesis,1300,monk,windwalker,63,31,32
Owenxdd,stormrage,1299,monk,windwalker,62,33,29
Xøxo,trollbane,1299,monk,windwalker,48,22,26
Tianhu,sargeras,1295,monk,windwalker,36,20,16
Tino,kelthuzad,1295,monk,windwalker,66,35,31
Jacquelline,moon-guard,1294,monk,windwalker,36,19,17
Anarska,thrall,1291,monk,windwalker,96,46,50
Çhëèch,tichondrius,1291,monk,windwalker,47,20,27
Dodried,ragnaros,1290,monk,windwalker,52,24,28
Yrn,crushridge,1287,monk,windwalker,60,32,28
Fanetö,stormrage,1283,monk,windwalker,48,15,33
Highku,drenden,1282,monk,windwalker,30,17,13
Opmother,elune,1279,monk,windwalker,47,26,21
Smalltall,area-52,1278,monk,windwalker,26,14,12
Siddharthä,barthilas,1274,monk,windwalker,36,20,16
Rbs,tichondrius,1274,monk,windwalker,87,35,52
Hitchslapz,tichondrius,1271,monk,windwalker,30,15,15
Garmakasmonk,skullcrusher,1269,monk,windwalker,40,19,21
Wutangkillaß,kiljaeden,1266,monk,windwalker,48,18,30
Weezzyboi,tichondrius,1263,monk,windwalker,42,22,20
Natus,greymane,1262,monk,windwalker,36,18,18
Calmpunchman,mannoroth,1258,monk,windwalker,31,14,17
Murder,magtheridon,1256,monk,windwalker,43,21,22
Renrukie,frostmourne,1256,monk,windwalker,30,14,16
Supremekick,frostmourne,1254,monk,windwalker,43,27,16
Pangpoong,tichondrius,1249,monk,windwalker,99,44,55
Baconbiscuit,area-52,1247,monk,windwalker,30,13,17
ßájkà,area-52,1247,monk,windwalker,30,13,17
Prostotak,area-52,1246,monk,windwalker,18,13,5
Molta,tichondrius,1246,monk,windwalker,24,13,11
Pamii,quelthalas,1246,monk,windwalker,36,13,23
Båshkin,terenas,1245,monk,windwalker,42,19,23
Hèàvy,stormrage,1244,monk,windwalker,24,13,11
Bükki,ragnaros,1243,monk,windwalker,18,13,5
Bowlbreak,sargeras,1243,monk,windwalker,36,20,16
Nuclearpunch,tichondrius,1242,monk,windwalker,24,13,11
Rozlynnww,tichondrius,1242,monk,windwalker,24,13,11
Gelgameks,eredar,1242,monk,windwalker,30,13,17
Sedition,emerald-dream,1241,monk,windwalker,94,46,48
Killmachine,farstriders,1241,monk,windwalker,189,91,98
Grocerymonk,malganis,1240,monk,windwalker,30,13,17
Xinghao,tichondrius,1240,monk,windwalker,30,13,17
Honkbazz,illidan,1238,monk,windwalker,30,13,17
Slapcîty,bleeding-hollow,1238,monk,windwalker,30,13,17
Blumpfu,thrall,1235,monk,windwalker,24,13,11
Ilvory,tichondrius,1235,monk,windwalker,30,13,17
Metios,aggramar,1234,monk,windwalker,52,22,30
Felgolos,azralon,1232,monk,windwalker,27,17,10
Zettelkasten,tichondrius,1232,monk,windwalker,72,35,37
Ipnam,kelthuzad,1231,monk,windwalker,22,14,8
Starymww,tichondrius,1230,monk,windwalker,24,13,11
Finesse,frostwolf,1227,monk,windwalker,18,13,5
Ruckm,stormrage,1225,monk,windwalker,24,13,11
Currycooker,tichondrius,1220,monk,windwalker,29,13,16
Kungxxl,kiljaeden,1219,monk,windwalker,95,44,51
Razielic,frostmourne,1212,monk,windwalker,66,29,37
Rasta,ragnaros,1211,monk,windwalker,30,17,13
Weewalker,wyrmrest-accord,1207,monk,windwalker,27,14,13
Gurda,wyrmrest-accord,1203,monk,windwalker,72,34,38
Ofn,moon-guard,1202,monk,windwalker,96,45,51
Xéia,area-52,1201,monk,windwalker,60,23,37
Rufaso,sargeras,1199,monk,windwalker,54,24,30
Wwmonks,sargeras,1197,monk,windwalker,18,13,5
Honeyjaem,tichondrius,1193,monk,windwalker,29,14,15
Xxvbamm,thrall,1193,monk,windwalker,29,13,16
Stickyloads,illidan,1190,monk,windwalker,78,35,43
Marstol,bleeding-hollow,1186,monk,windwalker,53,31,22
Leehofook,azshara,1180,monk,windwalker,84,40,44
Slapstun,barthilas,1176,monk,windwalker,77,28,49
Hinakii,dalaran,1175,monk,windwalker,144,62,82
Moopdahoop,stormrage,1174,monk,windwalker,124,67,57
Sleepÿ,area-52,1171,monk,windwalker,84,34,50
Milktank,medivh,1167,monk,windwalker,69,40,29
Mommysalamii,moon-guard,1167,monk,windwalker,25,13,12
Anavara,drakkari,1160,monk,windwalker,48,24,24
Kandinarra,jubeithos,1156,monk,windwalker,58,31,27
Habana,stormreaver,1155,monk,windwalker,54,20,34
Sahhalea,sargeras,1153,monk,windwalker,56,25,31
Linkya,daggerspine,1152,monk,windwalker,22,14,8
Xedou,azralon,1151,monk,windwalker,18,12,6
Soprà,zuljin,1151,monk,windwalker,24,12,12
Lalpu,tichondrius,1151,monk,windwalker,30,12,18
Hybrid,stormrage,1150,monk,windwalker,18,12,6
Mcbluffin,onyxia,1150,monk,windwalker,18,12,6
Hulkapro,azralon,1150,monk,windwalker,51,30,21
Pikotaro,tichondrius,1150,monk,windwalker,24,12,12
Antiherox,sargeras,1149,monk,windwalker,18,12,6
Jabman,stormrage,1149,monk,windwalker,33,13,20
Bigfel,nazjatar,1148,monk,windwalker,24,12,12
Boxxzer,kelthuzad,1147,monk,windwalker,18,12,6
Dobsy,bleeding-hollow,1147,monk,windwalker,24,12,12
Stendari,moon-guard,1147,monk,windwalker,30,12,18
Misery,stormscale,1146,monk,windwalker,23,15,8
Omashu,nemesis,1145,monk,windwalker,24,12,12
Tenshu,runetotem,1141,monk,windwalker,24,12,12
Mechabre,stormrage,1140,monk,windwalker,18,12,6
Acindian,malganis,1140,monk,windwalker,36,18,18
Ugrak,chogall,1140,monk,windwalker,24,12,12
Píñg,area-52,1140,monk,windwalker,33,13,20
Delorenzi,hellscream,1137,monk,windwalker,24,12,12
Kfpeeves,sargeras,1134,monk,windwalker,30,15,15
Shinjiki,tichondrius,1134,monk,windwalker,29,12,17
Duwhack,wyrmrest-accord,1133,monk,windwalker,30,12,18
Bigxthaplug,moon-guard,1132,monk,windwalker,30,12,18
Boldyr,sargeras,1128,monk,windwalker,24,12,12
Shinaniganz,chogall,1128,monk,windwalker,42,17,25
Iamanangel,illidan,1127,monk,windwalker,30,20,10
Spinning,nagrand,1122,monk,windwalker,30,12,18
Monkii,bonechewer,1121,monk,windwalker,33,21,12
Stigzz,stormrage,1118,monk,windwalker,23,12,11
Jimothydab,lightbringer,1117,monk,windwalker,23,12,11
Gorton,lightbringer,1114,monk,windwalker,24,12,12
Vetism,thrall,1113,monk,windwalker,22,12,10
Imonkalot,destromath,1111,monk,windwalker,55,23,32
Lyfegiver,blackrock,1110,monk,windwalker,20,13,7
Jinpo,lightninghoof,1110,monk,windwalker,60,32,28
Loadedfries,frostmourne,1110,monk,windwalker,24,12,12
Silvopanda,azralon,1108,monk,windwalker,161,79,82
Fitmonje,drakkari,1108,monk,windwalker,28,13,15
Lexivixi,khazgoroth,1103,monk,windwalker,96,48,48
Tochtlea,wyrmrest-accord,1102,monk,windwalker,23,12,11
Drektarz,area-52,1098,monk,windwalker,111,52,59
Angerday,illidan,1097,monk,windwalker,30,12,18
Deadlyfist,stormrage,1089,monk,windwalker,47,19,28
Vokarhi,whisperwind,1082,monk,windwalker,24,15,9
Lööpér,tichondrius,1081,monk,windwalker,24,13,11
Ojiin,wyrmrest-accord,1079,monk,windwalker,24,13,11
Quanon,stormreaver,1071,monk,windwalker,33,14,19
Sandii,azralon,1070,monk,windwalker,87,48,39
Tokyozesty,area-52,1056,monk,windwalker,18,11,7
Yavaxye,stormrage,1056,monk,windwalker,24,11,13
Songokusan,thrall,1055,monk,windwalker,18,11,7
Whitepandax,tichondrius,1055,monk,windwalker,18,11,7
Rubntug,zuljin,1055,monk,windwalker,18,11,7
Abenobashi,malganis,1055,monk,windwalker,18,11,7
Hate,korialstrasz,1055,monk,windwalker,18,11,7
Sockem,arthas,1055,monk,windwalker,24,11,13
Monkfy,moon-guard,1054,monk,windwalker,17,11,6
Monkamax,tichondrius,1054,monk,windwalker,18,11,7
Powerfisterr,stormrage,1054,monk,windwalker,18,11,7
Zenpachi,hyjal,1053,monk,windwalker,27,11,16
Wimdrewk,quelthalas,1053,monk,windwalker,39,12,27
Kristiana,aegwynn,1052,monk,windwalker,18,11,7
Razekahl,wyrmrest-accord,1052,monk,windwalker,30,11,19
Hira,zuljin,1052,monk,windwalker,30,11,19
Zenkam,ragnaros,1052,monk,windwalker,30,11,19
Drunkmaster,frostmourne,1051,monk,windwalker,18,11,7
Lotusdream,argent-dawn,1051,monk,windwalker,23,11,12
Suntzuvius,tichondrius,1050,monk,windwalker,24,11,13
Turbodyne,tichondrius,1050,monk,windwalker,24,11,13
Whtnyhuston,sargeras,1049,monk,windwalker,24,11,13
Chowlaos,coilfang,1048,monk,windwalker,18,11,7
Miyage,emerald-dream,1045,monk,windwalker,54,31,23
Caulífla,barthilas,1045,monk,windwalker,24,11,13
Chaosrose,area-52,1044,monk,windwalker,18,11,7
Aedale,emerald-dream,1044,monk,windwalker,45,23,22
Tremonk,kelthuzad,1043,monk,windwalker,18,11,7
Tert,aerie-peak,1043,monk,windwalker,24,11,13
Tsubal,mugthol,1042,monk,windwalker,18,11,7
Gentlefists,sargeras,1041,monk,windwalker,24,11,13
Hylithia,proudmoore,1040,monk,windwalker,30,17,13
Tobearus,stormscale,1038,monk,windwalker,35,18,17
Jnx,emerald-dream,1038,monk,windwalker,24,11,13
Arshavin,skullcrusher,1038,monk,windwalker,30,11,19
Mcnipple,moonrunner,1036,monk,windwalker,18,11,7
Dynamo,blackrock,1036,monk,windwalker,30,11,19
Kungfused,frostmourne,1035,monk,windwalker,30,11,19
Natintell,drakkari,1032,monk,windwalker,71,33,38
Abboo,hyjal,1030,monk,windwalker,24,12,12
Blackychan,scilla,1027,monk,windwalker,36,15,21
Steenkk,tichondrius,1023,monk,windwalker,24,11,13
Sébástián,drakkari,1021,monk,windwalker,52,28,24
Åsurã,stormrage,1021,monk,windwalker,34,11,23
Leafondawind,boulderfist,1020,monk,windwalker,29,11,18
Tzidkiyahu,barthilas,1018,monk,windwalker,28,16,12
Rosarìolover,stormrage,1008,monk,windwalker,36,18,18
Bonflur,quelthalas,1007,monk,windwalker,352,173,179
Averagewang,sargeras,1002,monk,windwalker,54,28,26
Brewzllee,tichondrius,1000,monk,windwalker,66,34,32
Nutcrakerz,tichondrius,995,monk,windwalker,30,18,12
Romeoe,muradin,992,monk,windwalker,30,11,19
Fatde,daggerspine,991,monk,windwalker,47,27,20
Traxshin,kelthuzad,982,monk,windwalker,30,12,18
Rollsroycist,trollbane,975,monk,windwalker,49,27,22
Kush,dalvengyr,969,monk,windwalker,33,15,18
Mynamegeorge,area-52,968,monk,windwalker,46,21,25
Ðilara,area-52,960,monk,windwalker,12,10,2
Kegrolls,proudmoore,960,monk,windwalker,12,10,2
Aýre,ravencrest,960,monk,windwalker,12,10,2
Fettywhopper,kaelthas,960,monk,windwalker,12,10,2
Glad,tichondrius,960,monk,windwalker,12,10,2
Shadmtwo,tichondrius,960,monk,windwalker,12,10,2
Xuenfu,tichondrius,960,monk,windwalker,18,10,8
Afrosamurai,thrall,960,monk,windwalker,18,10,8
Zoomerxd,stormrage,960,monk,windwalker,18,10,8
Hitt,barthilas,960,monk,windwalker,24,10,14
Kinkykyle,emerald-dream,960,monk,windwalker,24,10,14
Tazermw,sargeras,959,monk,windwalker,12,10,2
Rskmedaddy,tichondrius,959,monk,windwalker,12,10,2
Plotting,tichondrius,959,monk,windwalker,18,10,8
Goldfornudez,area-52,959,monk,windwalker,18,10,8
Kaize,sargeras,959,monk,windwalker,18,10,8
Undertickle,illidan,959,monk,windwalker,18,10,8
Iol,whisperwind,959,monk,windwalker,18,10,8
Neejitsu,malganis,959,monk,windwalker,18,10,8
Jnco,thrall,958,monk,windwalker,18,10,8
Zunfu,tichondrius,958,monk,windwalker,18,10,8
Thiccdih,area-52,958,monk,windwalker,24,10,14
Sxywind,azgalor,957,monk,windwalker,18,10,8
Mônkdunk,daggerspine,957,monk,windwalker,18,10,8
Avz,azralon,957,monk,windwalker,24,10,14
Memonk,ysera,957,monk,windwalker,24,10,14
Vuadeira,azralon,957,monk,windwalker,30,10,20
Skyvaan,barthilas,956,monk,windwalker,18,10,8
Ezpzmonk,bloodscalp,956,monk,windwalker,21,11,10
Dangodxz,quelthalas,955,monk,windwalker,22,11,11
Thalreyzian,vashj,954,monk,windwalker,24,10,14
Megatraun,tichondrius,953,monk,windwalker,18,10,8
Alcaquito,goldrinn,950,monk,windwalker,18,10,8
Samaelsin,emerald-dream,948,monk,windwalker,30,10,20
Hehex,bleeding-hollow,943,monk,windwalker,23,10,13
Madmint,illidan,941,monk,windwalker,23,11,12
Ryucko,azralon,933,monk,windwalker,18,10,8
Mcwallets,moon-guard,933,monk,windwalker,78,33,45
Nedpanders,nagrand,930,monk,windwalker,18,11,7
Thäiländiä,bleeding-hollow,928,monk,windwalker,36,20,16
Reeperfist,area-52,927,monk,windwalker,14,11,3
Clytpuncher,emerald-dream,926,monk,windwalker,23,10,13
Shnooze,barthilas,926,monk,windwalker,66,23,43
Poanda,illidan,914,monk,windwalker,24,13,11
Thedeäd,stormrage,904,monk,windwalker,42,13,29
Scarlos,tichondrius,894,monk,windwalker,199,94,105
Raninn,bleeding-hollow,894,monk,windwalker,22,10,12
Ipmán,moon-guard,892,monk,windwalker,41,18,23
Veganbacon,mannoroth,875,monk,windwalker,14,10,4
Poormanx,illidan,864,monk,windwalker,12,9,3
Gucchimane,illidan,864,monk,windwalker,12,9,3
Rhyskrispiez,sargeras,864,monk,windwalker,12,9,3
Wwrizz,frostmane,864,monk,windwalker,12,9,3
Loenius,wyrmrest-accord,864,monk,windwalker,12,9,3
Arunaa,tichondrius,864,monk,windwalker,12,9,3
Jaige,illidan,864,monk,windwalker,18,9,9
Tmjojo,tichondrius,864,monk,windwalker,24,9,15
Chiang,chogall,864,monk,windwalker,24,9,15
Poem,grizzly-hills,863,monk,windwalker,12,9,3
Danksweaver,malganis,863,monk,windwalker,12,9,3
Aligned,zuljin,863,monk,windwalker,12,9,3
Stepsista,sargeras,863,monk,windwalker,18,9,9
Helicopter,borean-tundra,863,monk,windwalker,18,9,9
Tomatosaucin,area-52,863,monk,windwalker,18,9,9
Rodign,hyjal,863,monk,windwalker,18,9,9
Vandamme,durotan,863,monk,windwalker,18,9,9
Azzmane,bronzebeard,863,monk,windwalker,18,9,9
Röllup,area-52,863,monk,windwalker,18,9,9
Kahpital,azralon,863,monk,windwalker,18,9,9
Inko,ragnaros,863,monk,windwalker,24,9,15
Somethingre,sargeras,862,monk,windwalker,12,9,3
Mapaly,ragnaros,862,monk,windwalker,18,9,9
Funji,skullcrusher,862,monk,windwalker,18,9,9
Kaishya,emerald-dream,861,monk,windwalker,12,9,3
Kentodne,stormrage,861,monk,windwalker,18,9,9
Zackesé,area-52,861,monk,windwalker,24,9,15
Pandagendon,quelthalas,860,monk,windwalker,12,9,3
Arimonk,mannoroth,860,monk,windwalker,18,9,9
Ryútt,illidan,860,monk,windwalker,24,9,15
Romeonjuliet,tichondrius,859,monk,windwalker,18,9,9
Legsweeps,tichondrius,859,monk,windwalker,24,9,15
Selfless,gilneas,858,monk,windwalker,18,9,9
Anatomyx,kelthuzad,858,monk,windwalker,18,9,9
Acena,stormrage,856,monk,windwalker,24,9,15
Rowenoa,tichondrius,856,monk,windwalker,30,9,21
Pastarasta,malganis,854,monk,windwalker,18,10,8
Hairybadger,destromath,848,monk,windwalker,12,9,3
Agroétudo,azralon,838,monk,windwalker,18,9,9
Phuumyn,llane,829,monk,windwalker,17,9,8
Thekilla,aegwynn,827,monk,windwalker,18,9,9
Knuckbutter,sargeras,824,monk,windwalker,33,11,22
Nobmaster,garrosh,815,monk,windwalker,22,9,13
Scoobfly,illidan,814,monk,windwalker,17,9,8
Lolqtxd,sargeras,810,monk,windwalker,26,10,16
Cráne,duskwood,797,monk,windwalker,14,9,5
Tulalong,area-52,797,monk,windwalker,20,9,11
Yeonguo,drakthul,795,monk,windwalker,16,9,7
Rykouu,area-52,784,monk,windwalker,19,9,10
Axtîn,stormreaver,768,monk,windwalker,12,8,4
Crakgirl,malganis,768,monk,windwalker,12,8,4
Sistuhfista,tichondrius,768,monk,windwalker,12,8,4
Kungpaochicn,tichondrius,768,monk,windwalker,12,8,4
Twichyling,tichondrius,768,monk,windwalker,12,8,4
Involve,tichondrius,768,monk,windwalker,12,8,4
Awfulww,tichondrius,768,monk,windwalker,12,8,4
Khungfeu,area-52,768,monk,windwalker,12,8,4
Hitman,thrall,768,monk,windwalker,12,8,4
Kkonaman,illidan,768,monk,windwalker,12,8,4
Bootowsky,zuljin,768,monk,windwalker,12,8,4
Kambrielx,zuljin,768,monk,windwalker,12,8,4
Jamaldamort,sargeras,768,monk,windwalker,12,8,4
Kfchi,tichondrius,768,monk,windwalker,16,9,7
Rerolled,moon-guard,768,monk,windwalker,18,8,10
Miuss,illidan,768,monk,windwalker,18,8,10
Stepfistz,aegwynn,768,monk,windwalker,18,8,10
Richywayne,bleeding-hollow,768,monk,windwalker,18,8,10
Güwop,tichondrius,768,monk,windwalker,18,8,10
Gnomepuncher,dalaran,768,monk,windwalker,18,8,10
Mahatmä,dalaran,768,monk,windwalker,18,8,10
Amphíon,kelthuzad,768,monk,windwalker,18,8,10
Ludenz,emerald-dream,768,monk,windwalker,18,8,10
Slimcognito,zuljin,768,monk,windwalker,18,8,10
Ballok,bleeding-hollow,768,monk,windwalker,18,8,10
Taggz,thunderlord,768,monk,windwalker,18,8,10
Skela,emerald-dream,768,monk,windwalker,18,8,10
Goonsy,tichondrius,768,monk,windwalker,18,8,10
Leegueen,tichondrius,768,monk,windwalker,18,8,10
Röllö,tichondrius,768,monk,windwalker,21,9,12
Blackìce,sargeras,768,monk,windwalker,24,8,16
Monke,onyxia,768,monk,windwalker,24,8,16
Shinobiww,area-52,768,monk,windwalker,24,8,16
Raikou,frostmourne,767,monk,windwalker,12,8,4
Tews,quelthalas,767,monk,windwalker,12,8,4
Prickhead,sargeras,767,monk,windwalker,15,9,6
Fumoo,sargeras,767,monk,windwalker,16,9,7
Xunzao,emerald-dream,767,monk,windwalker,18,8,10
Silkzy,frostwolf,767,monk,windwalker,18,8,10
Faashbae,illidan,767,monk,windwalker,18,8,10
Supernam,sargeras,767,monk,windwalker,18,8,10
Biggyballs,tichondrius,767,monk,windwalker,18,8,10
Akrethar,medivh,767,monk,windwalker,18,8,10
Metalmønk,nerzhul,767,monk,windwalker,18,8,10
Iarw,tichondrius,767,monk,windwalker,18,8,10
Aydowon,illidan,767,monk,windwalker,18,8,10
Pipochen,ragnaros,767,monk,windwalker,18,8,10
Suspicious,malfurion,767,monk,windwalker,18,8,10
Zukki,zuljin,767,monk,windwalker,18,8,10
Luckystrike,area-52,767,monk,windwalker,24,8,16
Yoshimotto,area-52,766,monk,windwalker,12,8,4
Nf,zuljin,766,monk,windwalker,12,8,4
Ragraxx,quelthalas,766,monk,windwalker,18,8,10
Karatay,tichondrius,765,monk,windwalker,12,8,4
Jackboi,the-underbog,765,monk,windwalker,24,8,16
Jãe,stormrage,764,monk,windwalker,24,8,16
Extinctión,stormscale,762,monk,windwalker,12,8,4
Sprinkli,sargeras,761,monk,windwalker,24,8,16
Kïri,wyrmrest-accord,760,monk,windwalker,15,9,6
Ogre,the-venture-co,756,monk,windwalker,18,8,10
Kilabit,azshara,756,monk,windwalker,44,19,25
Kylièjenner,gilneas,755,monk,windwalker,18,8,10
Wodinswolf,sargeras,749,monk,windwalker,18,8,10
Hontaruk,ragnaros,749,monk,windwalker,29,8,21
Deathgoku,norgannon,735,monk,windwalker,17,8,9
Shinjaru,area-52,735,monk,windwalker,22,8,14
Habanèro,tichondrius,734,monk,windwalker,17,8,9
Alkaholik,stormrage,719,monk,windwalker,23,8,15
Chaipie,kelthuzad,703,monk,windwalker,11,8,3
Onepunch,exodar,702,monk,windwalker,14,8,6
Kurha,queldorei,690,monk,windwalker,24,8,16
Strokahontas,stormreaver,672,monk,windwalker,12,7,5
Jwazz,tichondrius,672,monk,windwalker,12,7,5
Peterpunch,illidan,672,monk,windwalker,12,7,5
Shry,kiljaeden,672,monk,windwalker,12,7,5
Incaustik,ragnaros,672,monk,windwalker,12,7,5
Ganjäsmoke,skullcrusher,672,monk,windwalker,12,7,5
Goldx,ragnaros,672,monk,windwalker,12,7,5
Danzr,ragnaros,672,monk,windwalker,12,7,5
Touchbot,tichondrius,672,monk,windwalker,12,7,5
Bibis,sargeras,672,monk,windwalker,12,7,5
Porxhub,tichondrius,672,monk,windwalker,12,7,5
Redami,gnomeregan,672,monk,windwalker,12,7,5
Shiphappens,barthilas,672,monk,windwalker,12,7,5
Atengie,stormrage,672,monk,windwalker,12,7,5
Kudrix,frostwolf,672,monk,windwalker,12,7,5
Bramicaye,malganis,672,monk,windwalker,12,7,5
Yoojimin,kiljaeden,672,monk,windwalker,12,7,5
Crittinka,bonechewer,672,monk,windwalker,12,7,5
Gothamonk,tichondrius,672,monk,windwalker,12,7,5
Ázão,stormrage,672,monk,windwalker,12,7,5
Bangtanboy,tichondrius,672,monk,windwalker,12,7,5
Kryptikkyt,gilneas,672,monk,windwalker,12,7,5
Goosyloosy,dathremar,672,monk,windwalker,12,7,5
Monkuban,destromath,672,monk,windwalker,12,7,5
Tag,tichondrius,672,monk,windwalker,12,7,5
Jxyfist,illidan,672,monk,windwalker,12,7,5
Garofalo,tichondrius,672,monk,windwalker,12,7,5
Dragonwhirl,stormrage,672,monk,windwalker,12,7,5
Lilpøøter,tichondrius,672,monk,windwalker,12,7,5
Dublefist,draktharon,672,monk,windwalker,12,7,5
Ftxyolo,azralon,672,monk,windwalker,12,7,5
Ristion,moon-guard,672,monk,windwalker,12,7,5
Buffmonkdmg,tichondrius,672,monk,windwalker,15,8,7
Tapzm,area-52,672,monk,windwalker,18,7,11
Stevezee,barthilas,672,monk,windwalker,18,7,11
Verizani,stormrage,672,monk,windwalker,18,7,11
Popchi,stormrage,672,monk,windwalker,18,7,11
Paracetamonk,kelthuzad,672,monk,windwalker,18,7,11
Pandaforlife,area-52,672,monk,windwalker,18,7,11
Awcfanboy,bleeding-hollow,672,monk,windwalker,21,8,13
Monkyun,tichondrius,672,monk,windwalker,24,7,17
Kapoerista,azralon,671,monk,windwalker,12,7,5
Reckin,frostmourne,671,monk,windwalker,12,7,5
Døjø,dalaran,671,monk,windwalker,12,7,5
Mosaden,suramar,671,monk,windwalker,12,7,5
Bauddor,ragnaros,671,monk,windwalker,12,7,5
Bataan,tichondrius,671,monk,windwalker,12,7,5
Qebui,darkspear,671,monk,windwalker,12,7,5
Quietbegger,sargeras,671,monk,windwalker,12,7,5
Keys,earthen-ring,671,monk,windwalker,12,7,5
Drainar,bleeding-hollow,671,monk,windwalker,12,7,5
Leozen,skullcrusher,671,monk,windwalker,18,7,11
Inaruss,ragnaros,671,monk,windwalker,18,7,11
Huángbó,blackhand,670,monk,windwalker,10,8,2
Astorari,illidan,670,monk,windwalker,12,7,5
Minusmonk,dalaran,670,monk,windwalker,12,7,5
Cryptique,tichondrius,670,monk,windwalker,12,7,5
Solafyde,aerie-peak,670,monk,windwalker,16,8,8
Merand,tichondrius,670,monk,windwalker,18,7,11
Dekù,ragnaros,669,monk,windwalker,12,7,5
Santiie,drakkari,669,monk,windwalker,18,7,11
Elmanteca,ragnaros,668,monk,windwalker,12,7,5
Kuungfoo,tichondrius,667,monk,windwalker,12,7,5
Hyun,stormrage,666,monk,windwalker,12,7,5
Liänä,quelthalas,658,monk,windwalker,18,7,11
Honghong,kargath,655,monk,windwalker,17,8,9
Léesin,stormrage,655,monk,windwalker,17,7,10
Titsmagees,frostwolf,639,monk,windwalker,23,7,16
Shadowstripe,the-venture-co,638,monk,windwalker,11,7,4
Mùnkey,nagrand,638,monk,windwalker,17,7,10
Fmbbasedgód,tichondrius,623,monk,windwalker,17,7,10
Iilmachoggy,stormrage,607,monk,windwalker,11,7,4
Sistafistaa,akama,606,monk,windwalker,14,7,7
Goblinitto,archimonde,576,monk,windwalker,6,6,0
Srýbrø,illidan,576,monk,windwalker,6,6,0
Selfîe,ysera,576,monk,windwalker,6,6,0
Griswolld,ragnaros,576,monk,windwalker,6,6,0
Aveium,moon-guard,576,monk,windwalker,6,6,0
Makgøra,malganis,576,monk,windwalker,6,6,0
Bonzibuddy,barthilas,576,monk,windwalker,12,6,6
Fivebears,blackwing-lair,576,monk,windwalker,12,6,6
Monksoon,tichondrius,576,monk,windwalker,12,6,6
Tribunez,stormrage,576,monk,windwalker,12,6,6
Kaminagi,proudmoore,576,monk,windwalker,12,6,6
Frânkdux,tichondrius,576,monk,windwalker,12,6,6
Affected,lightninghoof,576,monk,windwalker,12,6,6
Tahs,azralon,576,monk,windwalker,12,6,6
Xoir,tichondrius,576,monk,windwalker,12,6,6
Yimmy,zuluhed,576,monk,windwalker,12,6,6
Läôtzu,fizzcrank,576,monk,windwalker,12,6,6
Brewlong,area-52,576,monk,windwalker,12,6,6
Silvyrx,boulderfist,576,monk,windwalker,12,6,6
Monasticc,undermine,576,monk,windwalker,12,6,6
Rafyww,tichondrius,576,monk,windwalker,12,6,6
Detoxalt,sargeras,576,monk,windwalker,12,6,6
Funtscat,zuljin,576,monk,windwalker,12,6,6
Syffer,sargeras,576,monk,windwalker,12,6,6
Gaps,ragnaros,576,monk,windwalker,12,6,6
Jubei,dragonmaw,576,monk,windwalker,12,6,6
Bakacia,ragnaros,576,monk,windwalker,12,6,6
Fúgg,zuljin,576,monk,windwalker,12,6,6
Varicin,zuljin,576,monk,windwalker,12,6,6
Dippy,moon-guard,576,monk,windwalker,12,6,6
Bvndio,ragnaros,576,monk,windwalker,12,6,6
Santatsu,emerald-dream,576,monk,windwalker,12,6,6
Birgs,sargeras,576,monk,windwalker,12,6,6
Orcslam,tichondrius,576,monk,windwalker,12,6,6
Kawasakizph,tichondrius,576,monk,windwalker,12,6,6
Grandsonweez,thrall,576,monk,windwalker,12,6,6
Creamchop,stormreaver,576,monk,windwalker,12,6,6
Jaykun,ragnaros,576,monk,windwalker,12,6,6
Xua,sargeras,576,monk,windwalker,12,6,6
Tinypunch,emerald-dream,576,monk,windwalker,12,6,6
Guuttzz,area-52,576,monk,windwalker,12,6,6
Coldridge,bleeding-hollow,576,monk,windwalker,12,6,6
Forthekicks,tichondrius,576,monk,windwalker,19,8,11
Bollzdepe,wyrmrest-accord,576,monk,windwalker,18,6,12
Kuafu,illidan,576,monk,windwalker,18,6,12
Awsmonk,malygos,576,monk,windwalker,18,6,12
Lxg,emerald-dream,576,monk,windwalker,18,6,12
Monjimen,ragnaros,576,monk,windwalker,18,6,12
Káizen,area-52,576,monk,windwalker,18,6,12
Fruitpünch,tichondrius,576,monk,windwalker,18,6,12
Tayden,korgath,575,monk,windwalker,12,6,6
Yoshimoku,dalaran,575,monk,windwalker,12,6,6
Kalrsk,frostmourne,575,monk,windwalker,12,6,6
Frimayadri,area-52,575,monk,windwalker,12,6,6
Atulzo,emerald-dream,575,monk,windwalker,12,6,6
Kajjou,illidan,575,monk,windwalker,20,6,14
Zhixx,stormrage,574,monk,windwalker,12,6,6
Dragorovich,aerie-peak,574,monk,windwalker,12,6,6
Linwong,garithos,574,monk,windwalker,12,6,6
Fistidmi,area-52,573,monk,windwalker,12,6,6
Jish,bleeding-hollow,572,monk,windwalker,12,6,6
Tøxicø,quelthalas,572,monk,windwalker,16,7,9
Stellae,emerald-dream,543,monk,windwalker,11,6,5
Bakicaa,dalaran,527,monk,windwalker,11,6,5
Wft,frostmourne,527,monk,windwalker,11,6,5
Rokkenstone,wyrmrest-accord,527,monk,windwalker,11,6,5
Jowtaro,azralon,522,monk,windwalker,16,7,9
Shindoro,bonechewer,521,monk,windwalker,16,10,6
Nitrobrewed,stormrage,480,monk,windwalker,6,5,1
Hennyww,dalaran,480,monk,windwalker,6,5,1
Iloveabby,sargeras,480,monk,windwalker,6,5,1
Bomba,arthas,480,monk,windwalker,6,5,1
Kuranchi,illidan,480,monk,windwalker,6,5,1
Monkskiiz,tichondrius,480,monk,windwalker,6,5,1
Zegood,tichondrius,480,monk,windwalker,6,5,1
Kimmyfists,tichondrius,480,monk,windwalker,6,5,1
Getmistéd,sargeras,480,monk,windwalker,6,5,1
Zakaza,kelthuzad,480,monk,windwalker,6,5,1
Miresa,kelthuzad,480,monk,windwalker,6,5,1
Varimå,area-52,480,monk,windwalker,6,5,1
Koochies,aegwynn,480,monk,windwalker,6,5,1
Yenjung,azralon,480,monk,windwalker,6,5,1
Pikadejegue,nemesis,480,monk,windwalker,6,5,1
Pleasetouch,emerald-dream,480,monk,windwalker,6,5,1
Iflykites,zuljin,480,monk,windwalker,6,5,1
Shevchenkô,quelthalas,480,monk,windwalker,6,5,1
Blazebeast,blackhand,480,monk,windwalker,9,6,3
Ýogï,stormrage,480,monk,windwalker,10,6,4
Tyrus,kelthuzad,480,monk,windwalker,9,5,4
Chakrah,laughing-skull,480,monk,windwalker,12,5,7
Zadaa,alleria,480,monk,windwalker,12,5,7
Xueyu,malganis,480,monk,windwalker,12,5,7
Mepepegaclap,malganis,480,monk,windwalker,12,5,7
Transcend,nerzhul,480,monk,windwalker,12,5,7
Lokimana,zuljin,480,monk,windwalker,12,5,7
Zakuu,blackrock,480,monk,windwalker,12,5,7
Birean,area-52,480,monk,windwalker,12,5,7
Ferknights,moon-guard,480,monk,windwalker,12,5,7
Antril,bleeding-hollow,480,monk,windwalker,12,5,7
Zhíu,ragnaros,480,monk,windwalker,12,5,7
Pathad,stormrage,480,monk,windwalker,12,5,7
Tenkix,zuljin,480,monk,windwalker,12,5,7
Tripster,wyrmrest-accord,480,monk,windwalker,12,5,7
Valdur,sargeras,480,monk,windwalker,12,5,7
Kickkick,burning-blade,480,monk,windwalker,12,5,7
Tigerwoo,tichondrius,480,monk,windwalker,12,5,7
Bokchoii,sargeras,480,monk,windwalker,12,5,7
Chrisdamonk,stormrage,480,monk,windwalker,12,5,7
Abdoolah,illidan,480,monk,windwalker,12,5,7
Trunkx,area-52,480,monk,windwalker,12,5,7
Nomonko,tichondrius,480,monk,windwalker,12,5,7
Plagai,fizzcrank,480,monk,windwalker,12,5,7
Ultraop,emerald-dream,480,monk,windwalker,12,5,7
Omoplàta,illidan,480,monk,windwalker,12,5,7
Idonthustle,area-52,480,monk,windwalker,12,5,7
Yacub,tichondrius,480,monk,windwalker,12,5,7
Browniemix,tichondrius,480,monk,windwalker,12,5,7
Toughmonk,tichondrius,480,monk,windwalker,12,5,7
Ãcé,ragnaros,480,monk,windwalker,18,5,13
Maisoftheart,barthilas,480,monk,windwalker,18,5,13
Vinndz,azralon,480,monk,windwalker,18,5,13
Gabaan,azralon,480,monk,windwalker,18,5,13
Smigz,area-52,480,monk,windwalker,18,5,13
Zmajevratnik,illidan,479,monk,windwalker,6,5,1
Søuei,skullcrusher,479,monk,windwalker,12,5,7
Tababtz,illidan,479,monk,windwalker,12,5,7
Kiukiukiu,tichondrius,479,monk,windwalker,12,5,7
Shà,kelthuzad,479,monk,windwalker,12,5,7
Brzy,spinebreaker,479,monk,windwalker,12,5,7
Hêrsh,frostmourne,479,monk,windwalker,17,5,12
Breakbonez,dalaran,479,monk,windwalker,24,5,19
Tamonk,veknilash,478,monk,windwalker,6,5,1
Smashdmonk,gnomeregan,476,monk,windwalker,12,5,7
Leisa,jaedenar,463,monk,windwalker,11,5,6
Orcarucas,illidan,447,monk,windwalker,8,6,2
Mcmaplol,tichondrius,447,monk,windwalker,11,5,6
Chisuschrist,hyjal,432,monk,windwalker,15,5,10
Prettyflacko,thrall,416,monk,windwalker,10,5,5
Yomonk,hydraxis,384,monk,windwalker,6,4,2
Mabaoguo,aerie-peak,384,monk,windwalker,6,4,2
Illiea,cenarius,384,monk,windwalker,6,4,2
Donbaltica,ragnaros,384,monk,windwalker,6,4,2
Spacefolk,quelthalas,384,monk,windwalker,6,4,2
Castiwhite,quelthalas,384,monk,windwalker,6,4,2
Sobuu,wyrmrest-accord,384,monk,windwalker,6,4,2
Fistedby,nesingwary,384,monk,windwalker,6,4,2
Lowkn,sargeras,384,monk,windwalker,6,4,2
Liucang,archimonde,384,monk,windwalker,6,4,2
Molific,gurubashi,384,monk,windwalker,6,4,2
Hazed,lightbringer,384,monk,windwalker,6,4,2
Kiggo,bonechewer,384,monk,windwalker,6,4,2
Satchelgizmo,tichondrius,384,monk,windwalker,6,4,2
Preceptonk,azralon,384,monk,windwalker,6,4,2
Orbgodx,darkspear,384,monk,windwalker,6,4,2
Stevìl,medivh,384,monk,windwalker,6,4,2
Imperio,stormrage,384,monk,windwalker,6,4,2
Xulieng,tichondrius,384,monk,windwalker,6,4,2
Barleygar,tichondrius,384,monk,windwalker,6,4,2
Thewyjr,illidan,384,monk,windwalker,6,4,2
Chopana,malganis,384,monk,windwalker,6,4,2
Zenitsu,burning-blade,384,monk,windwalker,6,4,2
Jackphan,azralon,384,monk,windwalker,6,4,2
Ganksyou,sargeras,384,monk,windwalker,6,4,2
Ðøhkø,nemesis,384,monk,windwalker,6,4,2
Trembull,gurubashi,384,monk,windwalker,6,4,2
Vernki,laughing-skull,384,monk,windwalker,6,4,2
Aedalithe,stormrage,384,monk,windwalker,6,4,2
Milli,twisting-nether,384,monk,windwalker,6,4,2
Thoraki,illidan,384,monk,windwalker,6,4,2
Chizhao,tichondrius,384,monk,windwalker,6,4,2
Freetristan,sargeras,384,monk,windwalker,6,4,2
Korgark,tichondrius,384,monk,windwalker,6,4,2
Cowhoe,icecrown,384,monk,windwalker,6,4,2
Champoo,executus,384,monk,windwalker,6,4,2
Paullyfists,garona,384,monk,windwalker,6,4,2
Ezpumpm,azralon,384,monk,windwalker,6,4,2
Saitamami,tichondrius,384,monk,windwalker,6,4,2
Fearrae,sargeras,384,monk,windwalker,6,4,2
Punchbuggy,frostmourne,384,monk,windwalker,6,4,2
Monkespin,stormrage,384,monk,windwalker,6,4,2
Vetting,stormrage,384,monk,windwalker,6,4,2
Research,frostmourne,384,monk,windwalker,6,4,2
Kame,moon-guard,384,monk,windwalker,6,4,2
Winney,frostmourne,384,monk,windwalker,6,4,2
Delaî,dalaran,384,monk,windwalker,6,4,2
Evanyfist,proudmoore,384,monk,windwalker,6,4,2
Gorblox,emerald-dream,384,monk,windwalker,6,4,2
Crave,tichondrius,384,monk,windwalker,6,4,2
Jbebe,tichondrius,384,monk,windwalker,6,4,2
Cowsgonuts,gorefiend,384,monk,windwalker,6,4,2
Etrasu,thrall,384,monk,windwalker,6,4,2
Eçua,tichondrius,384,monk,windwalker,7,4,3
Serenitys,tanaris,384,monk,windwalker,9,4,5
Kickflipy,dalaran,384,monk,windwalker,15,5,10
Xinvictus,frostmourne,384,monk,windwalker,12,4,8
Solrise,wyrmrest-accord,384,monk,windwalker,12,4,8
Tesdra,moon-guard,384,monk,windwalker,12,4,8
Kygol,zuljin,384,monk,windwalker,12,4,8
Raekwan,area-52,384,monk,windwalker,12,4,8
Cranjis,agamaggan,384,monk,windwalker,12,4,8
Jxytwo,arygos,384,monk,windwalker,12,4,8
Ohtani,frostwolf,384,monk,windwalker,12,4,8
Tóru,kelthuzad,384,monk,windwalker,12,4,8
Giorhno,ragnaros,384,monk,windwalker,12,4,8
Wheresmyjuul,malganis,384,monk,windwalker,12,4,8
Fluffykitty,deathwing,384,monk,windwalker,12,4,8
Mysticzen,tichondrius,384,monk,windwalker,12,4,8
Threnz,magtheridon,384,monk,windwalker,12,4,8
Gngrbeardman,tichondrius,384,monk,windwalker,12,4,8
Sdns,stormrage,384,monk,windwalker,12,4,8
Chijinx,area-52,384,monk,windwalker,12,4,8
Téoo,azralon,384,monk,windwalker,12,4,8
Evilstep,tichondrius,384,monk,windwalker,12,4,8
Rookz,drakthul,384,monk,windwalker,12,4,8
Cudzingtin,dalaran,384,monk,windwalker,12,4,8
Machita,spirestone,384,monk,windwalker,12,4,8
Kfp,gorefiend,384,monk,windwalker,12,4,8
Talondien,dalaran,384,monk,windwalker,12,4,8
Nakwood,proudmoore,384,monk,windwalker,12,4,8
Piece,blackrock,384,monk,windwalker,12,4,8
Merçeÿ,tichondrius,384,monk,windwalker,12,4,8
Ferrarí,quelthalas,384,monk,windwalker,12,4,8
Bwan,kelthuzad,384,monk,windwalker,12,4,8
Sïfu,barthilas,384,monk,windwalker,12,4,8
Ramisan,barthilas,384,monk,windwalker,12,4,8
Jayr,bleeding-hollow,384,monk,windwalker,18,4,14
Mönk,blood-furnace,384,monk,windwalker,18,4,14
Ruì,malganis,384,monk,windwalker,18,4,14
Fistermus,tichondrius,384,monk,windwalker,36,4,32
Zanmonk,moon-guard,383,monk,windwalker,6,4,2
Chugs,malorne,383,monk,windwalker,18,4,14
Viko,llane,382,monk,windwalker,6,4,2
Lilutha,illidan,382,monk,windwalker,12,4,8
Pandalex,draenor,382,monk,windwalker,12,4,8
Liw,quelthalas,362,monk,windwalker,21,7,14
Broxxenidas,quelthalas,351,monk,windwalker,11,4,7
Nakuang,tichondrius,339,monk,windwalker,24,7,17
Ariannahxd,malganis,330,monk,windwalker,15,5,10
Mistyfist,bleeding-hollow,330,monk,windwalker,22,5,17
Jeffspicoli,emerald-dream,319,monk,windwalker,5,4,1
Oyyo,tichondrius,288,monk,windwalker,6,3,3
Mgzx,kelthuzad,288,monk,windwalker,6,3,3
Detox,sargeras,288,monk,windwalker,6,3,3
Dripharder,tichondrius,288,monk,windwalker,6,3,3
Slurrpslutt,proudmoore,288,monk,windwalker,6,3,3
Mistérfister,blackrock,288,monk,windwalker,6,3,3
Karkata,sargeras,288,monk,windwalker,6,3,3
Bunnynoodle,gnomeregan,288,monk,windwalker,6,3,3
Harvex,area-52,288,monk,windwalker,6,3,3
Frogepoge,area-52,288,monk,windwalker,6,3,3
Lomist,nazjatar,288,monk,windwalker,6,3,3
Zexana,gorefiend,288,monk,windwalker,6,3,3
Sýññ,illidan,288,monk,windwalker,6,3,3
Sosm,kelthuzad,288,monk,windwalker,6,3,3
Kallandron,thunderhorn,288,monk,windwalker,6,3,3
Fistay,burning-legion,288,monk,windwalker,6,3,3
Burash,frostwolf,288,monk,windwalker,6,3,3
Daspmonk,nagrand,288,monk,windwalker,6,3,3
Tigerlust,sargeras,288,monk,windwalker,6,3,3
Kyzen,trollbane,288,monk,windwalker,6,3,3
Raires,tichondrius,288,monk,windwalker,6,3,3
Brewtool,tichondrius,288,monk,windwalker,6,3,3
Lackofsleep,tichondrius,288,monk,windwalker,6,3,3
Militantww,tichondrius,288,monk,windwalker,6,3,3
Carmelfist,kargath,288,monk,windwalker,6,3,3
Hábìtz,area-52,288,monk,windwalker,6,3,3
Zonianman,tichondrius,288,monk,windwalker,6,3,3
Mlngo,illidan,288,monk,windwalker,6,3,3
Mcfluffey,area-52,288,monk,windwalker,6,3,3
Tictox,sargeras,288,monk,windwalker,6,3,3
Conterkick,stormrage,288,monk,windwalker,6,3,3
Niçky,tichondrius,288,monk,windwalker,6,3,3
Matins,tichondrius,288,monk,windwalker,6,3,3
Dorander,frostmourne,288,monk,windwalker,6,3,3
Gulmokk,tichondrius,288,monk,windwalker,6,3,3
ßluedream,dalaran,288,monk,windwalker,6,3,3
Tsosai,wyrmrest-accord,288,monk,windwalker,6,3,3
Rhonco,quelthalas,288,monk,windwalker,6,3,3
Bogez,area-52,288,monk,windwalker,6,3,3
Apølon,azralon,288,monk,windwalker,6,3,3
Spaaca,kelthuzad,288,monk,windwalker,6,3,3
Onepunchmän,zuljin,288,monk,windwalker,6,3,3
Akumuh,tichondrius,288,monk,windwalker,6,3,3
Fysicalx,stormrage,288,monk,windwalker,6,3,3
Maserati,azjolnerub,288,monk,windwalker,6,3,3
Monkdruffy,tichondrius,288,monk,windwalker,6,3,3
Tonkchi,khaz-modan,288,monk,windwalker,6,3,3
Pusily,tichondrius,288,monk,windwalker,6,3,3
Hellcow,frostmourne,288,monk,windwalker,6,3,3
Crayóns,stormreaver,288,monk,windwalker,6,3,3
Swurvex,bleeding-hollow,288,monk,windwalker,6,3,3
Momkisserl,sargeras,288,monk,windwalker,6,3,3
Evilbit,boulderfist,288,monk,windwalker,6,3,3
Reflexsivex,malganis,288,monk,windwalker,6,3,3
Thalassassin,bleeding-hollow,288,monk,windwalker,6,3,3
Triixxy,thrall,288,monk,windwalker,6,3,3
Choibaedal,tichondrius,288,monk,windwalker,6,3,3
Leemîn,tichondrius,288,monk,windwalker,6,3,3
Atezo,tichondrius,288,monk,windwalker,6,3,3
Cannafist,tichondrius,288,monk,windwalker,6,3,3
Highaskite,tichondrius,288,monk,windwalker,6,3,3
Wungpow,magtheridon,288,monk,windwalker,6,3,3
Bromonster,zuljin,288,monk,windwalker,6,3,3
Gageismonk,mugthol,288,monk,windwalker,6,3,3
Rumlee,sargeras,288,monk,windwalker,6,3,3
Badvisto,dalaran,288,monk,windwalker,6,3,3
Legolos,runetotem,288,monk,windwalker,6,3,3
Hanzøu,ragnaros,288,monk,windwalker,6,3,3
Goodluck,madoran,288,monk,windwalker,6,3,3
Monklad,malganis,288,monk,windwalker,6,3,3
Muffinz,shattered-halls,288,monk,windwalker,6,3,3
Rampant,anubarak,288,monk,windwalker,9,4,5
Aangg,madoran,288,monk,windwalker,12,3,9
Natörr,dalaran,288,monk,windwalker,12,3,9
Atarii,emerald-dream,288,monk,windwalker,12,3,9
Dmhsaint,sargeras,288,monk,windwalker,12,3,9
Vova,bleeding-hollow,288,monk,windwalker,12,3,9
Meatcleave,kiljaeden,288,monk,windwalker,12,3,9
Kickxy,sargeras,288,monk,windwalker,12,3,9
Setzua,cairne,288,monk,windwalker,12,3,9
Shizzyowoxd,bleeding-hollow,288,monk,windwalker,12,3,9
Bujiburger,frostmourne,288,monk,windwalker,12,3,9
Keloxx,ragnaros,288,monk,windwalker,12,3,9
Okuraseru,bleeding-hollow,288,monk,windwalker,12,3,9
Senseixww,sargeras,288,monk,windwalker,12,3,9
Kthanïd,ragnaros,288,monk,windwalker,12,3,9
Saohta,quelthalas,288,monk,windwalker,12,3,9
Messym,illidan,288,monk,windwalker,12,3,9
Wwx,whisperwind,288,monk,windwalker,12,3,9
Tofugoku,area-52,288,monk,windwalker,12,3,9
Donn,illidan,288,monk,windwalker,12,3,9
Howlit,illidan,288,monk,windwalker,12,3,9
Paramendic,frostwolf,288,monk,windwalker,12,3,9
Maziyen,thunderlord,288,monk,windwalker,12,3,9
Raviolipolie,sargeras,288,monk,windwalker,12,3,9
Joreg,moon-guard,288,monk,windwalker,12,3,9
Brewmooser,area-52,287,monk,windwalker,6,3,3
Firstfire,stormrage,287,monk,windwalker,12,3,9
Gaziee,tichondrius,271,monk,windwalker,11,3,8
Dafuqk,stormrage,256,monk,windwalker,16,3,13
Rockfu,illidan,239,monk,windwalker,5,3,2
Hellrosennin,area-52,239,monk,windwalker,5,3,2
Çruel,dalaran,223,monk,windwalker,8,3,5
Klamfu,thrall,192,monk,windwalker,4,3,1
Mùk,tichondrius,192,monk,windwalker,4,3,1
Möösê,moon-guard,192,monk,windwalker,6,2,4
Averagéjoe,tichondrius,192,monk,windwalker,6,2,4
Lonebamboo,tichondrius,192,monk,windwalker,6,2,4
Hydraoxy,moon-guard,192,monk,windwalker,6,2,4
Undmonge,azralon,192,monk,windwalker,6,2,4
Privix,tichondrius,192,monk,windwalker,6,2,4
Happymonk,tichondrius,192,monk,windwalker,6,2,4
Mcoos,tichondrius,192,monk,windwalker,6,2,4
Gøldéngødx,tichondrius,192,monk,windwalker,6,2,4
Imafqnbaby,tichondrius,192,monk,windwalker,6,2,4
Smungus,bloodscalp,192,monk,windwalker,6,2,4
Metaxzy,sargeras,192,monk,windwalker,6,2,4
Brëwslee,twisting-nether,192,monk,windwalker,6,2,4
Musclemanx,tichondrius,192,monk,windwalker,6,2,4
Strongmandan,twisting-nether,192,monk,windwalker,6,2,4
Mîghtguy,barthilas,192,monk,windwalker,6,2,4
Sinistuhm,tichondrius,192,monk,windwalker,6,2,4
Jüdo,barthilas,192,monk,windwalker,6,2,4
Wrynnerverse,tichondrius,192,monk,windwalker,6,2,4
Weendwolker,moon-guard,192,monk,windwalker,6,2,4
Icesmoker,frostmourne,192,monk,windwalker,6,2,4
Jagichan,area-52,192,monk,windwalker,6,2,4
Furrykisser,tichondrius,192,monk,windwalker,6,2,4
Kakusanni,nemesis,192,monk,windwalker,6,2,4
Yopper,tichondrius,192,monk,windwalker,6,2,4
Kitfisty,kiljaeden,192,monk,windwalker,6,2,4
Epî,tichondrius,192,monk,windwalker,6,2,4
Mîstchievous,sargeras,192,monk,windwalker,6,2,4
Bhoredom,kiljaeden,192,monk,windwalker,6,2,4
Hossdelgadoe,kiljaeden,192,monk,windwalker,6,2,4
Brokenfeels,azralon,192,monk,windwalker,6,2,4
Gracesowner,moon-guard,192,monk,windwalker,6,2,4
Dragoro,exodar,192,monk,windwalker,6,2,4
Fistpumps,thrall,192,monk,windwalker,6,2,4
Spirits,dreadmaul,192,monk,windwalker,6,2,4
Meidan,azralon,192,monk,windwalker,6,2,4
Troutz,sargeras,192,monk,windwalker,6,2,4
Upcoming,moon-guard,192,monk,windwalker,6,2,4
Vulpirino,drakkari,192,monk,windwalker,6,2,4
Taringa,drakkari,192,monk,windwalker,6,2,4
Sù,moon-guard,192,monk,windwalker,6,2,4
Khnum,fizzcrank,192,monk,windwalker,6,2,4
Rouladecave,zuljin,192,monk,windwalker,6,2,4
Induhca,area-52,192,monk,windwalker,6,2,4
Deyasth,zuljin,192,monk,windwalker,6,2,4
Thöran,ragnaros,192,monk,windwalker,6,2,4
Akiiko,draenor,192,monk,windwalker,6,2,4
Lìpz,zuljin,192,monk,windwalker,6,2,4
Prf,ragnaros,192,monk,windwalker,6,2,4
Fuchizaki,ragnaros,192,monk,windwalker,6,2,4
Ked,ragnaros,192,monk,windwalker,6,2,4
Pvptone,bleeding-hollow,192,monk,windwalker,6,2,4
Bakusao,bleeding-hollow,192,monk,windwalker,6,2,4
Eîr,emerald-dream,192,monk,windwalker,6,2,4
Xarra,bleeding-hollow,192,monk,windwalker,6,2,4
Salanzoww,bleeding-hollow,192,monk,windwalker,6,2,4
Trillek,firetree,192,monk,windwalker,6,2,4
Streetcreds,bleeding-hollow,192,monk,windwalker,6,2,4
Robocto,area-52,192,monk,windwalker,6,2,4
Merrell,area-52,192,monk,windwalker,6,2,4
Zengawd,magtheridon,192,monk,windwalker,6,2,4
Jadiel,quelthalas,192,monk,windwalker,6,2,4
Monkbro,altar-of-storms,192,monk,windwalker,6,2,4
Flicksx,arthas,192,monk,windwalker,6,2,4
Tadaku,dalaran,192,monk,windwalker,6,2,4
Fistnyou,norgannon,192,monk,windwalker,6,2,4
Heävenly,kelthuzad,192,monk,windwalker,6,2,4
Toxicaff,dalaran,192,monk,windwalker,6,2,4
Takazawas,bonechewer,192,monk,windwalker,6,2,4
Hutmok,dalaran,192,monk,windwalker,6,2,4
Tenfingers,dalaran,192,monk,windwalker,6,2,4
Coomerww,kelthuzad,192,monk,windwalker,6,2,4
Boeingair,kelthuzad,192,monk,windwalker,6,2,4
Mtnbrew,sargeras,192,monk,windwalker,6,2,4
Gumrag,illidan,192,monk,windwalker,6,2,4
Bubblewater,illidan,192,monk,windwalker,6,2,4
Burningfist,stormrage,192,monk,windwalker,6,2,4
Defacen,illidan,192,monk,windwalker,6,2,4
Astralsurfer,tichondrius,192,monk,windwalker,6,2,4
Saywha,windrunner,192,monk,windwalker,6,2,4
Youngnudy,sargeras,192,monk,windwalker,6,2,4
Théwy,tichondrius,192,monk,windwalker,6,2,4
Sukrit,darkspear,192,monk,windwalker,6,2,4
Grëyfox,sargeras,192,monk,windwalker,6,2,4
Puraimu,sargeras,192,monk,windwalker,6,2,4
Guyfíeri,velen,192,monk,windwalker,8,2,6
Motivmonk,uldum,192,monk,windwalker,12,2,10
Dankestkhan,korialstrasz,192,monk,windwalker,12,2,10
Eliwenn,ragnaros,192,monk,windwalker,12,2,10
Pongo,kelthuzad,192,monk,windwalker,12,2,10
Bruceflea,gurubashi,192,monk,windwalker,18,2,16
Staypuftmm,tichondrius,191,monk,windwalker,6,2,4
Kipao,deathwing,191,monk,windwalker,12,2,10
Punch,agamaggan,175,monk,windwalker,11,2,9
Wheatsli,malganis,159,monk,windwalker,5,2,3
Lazy,shattered-halls,159,monk,windwalker,5,2,3
Fendi,stormrage,159,monk,windwalker,5,2,3
Goku,frostmourne,159,monk,windwalker,5,2,3
Shenlong,jaedenar,159,monk,windwalker,6,2,4
Heavytrain,azralon,138,monk,windwalker,10,4,6
Choyou,bleeding-hollow,138,monk,windwalker,10,4,6
Heartsies,sargeras,128,monk,windwalker,4,2,2
Monkwayz,emerald-dream,96,monk,windwalker,3,2,1
Neaxain,tichondrius,96,monk,windwalker,3,2,1
Vanishm,ragnaros,96,monk,windwalker,3,2,1
Jayjaybrew,area-52,96,monk,windwalker,3,2,1
Jg,staghelm,96,monk,windwalker,6,1,5
Ravenius,moon-guard,96,monk,windwalker,6,1,5
Zinque,emerald-dream,96,monk,windwalker,6,1,5
Netang,emerald-dream,96,monk,windwalker,6,1,5
Jh,korgath,96,monk,windwalker,6,1,5
Spicybrew,tichondrius,96,monk,windwalker,6,1,5
Pandacottoco,azralon,96,monk,windwalker,6,1,5
Piccolo,emerald-dream,96,monk,windwalker,6,1,5
Munnk,stormreaver,96,monk,windwalker,6,1,5
Furrwalker,tichondrius,96,monk,windwalker,6,1,5
Kablam,frostmourne,96,monk,windwalker,6,1,5
Saruyo,frostmourne,96,monk,windwalker,6,1,5
Vanaxi,moon-guard,96,monk,windwalker,6,1,5
Sanemi,amanthul,96,monk,windwalker,6,1,5
Quaria,moon-guard,96,monk,windwalker,6,1,5
Tmtricks,tichondrius,96,monk,windwalker,6,1,5
Banidiin,moon-guard,96,monk,windwalker,6,1,5
Blacdaryl,destromath,96,monk,windwalker,6,1,5
Molsonicee,tichondrius,96,monk,windwalker,6,1,5
Emßerly,thrall,96,monk,windwalker,6,1,5
Siserfister,sargeras,96,monk,windwalker,6,1,5
Æsir,moon-guard,96,monk,windwalker,6,1,5
Srgtbingo,azgalor,96,monk,windwalker,6,1,5
Lainerya,moon-guard,96,monk,windwalker,6,1,5
Teewin,area-52,96,monk,windwalker,6,1,5
Bussyweaver,sargeras,96,monk,windwalker,6,1,5
Forestweaver,area-52,96,monk,windwalker,6,1,5
Murgleh,misha,96,monk,windwalker,6,1,5
Buddaba,tichondrius,96,monk,windwalker,6,1,5
Cerocool,hyjal,96,monk,windwalker,6,1,5
Gablle,tol-barad,96,monk,windwalker,6,1,5
Friëden,quelthalas,96,monk,windwalker,6,1,5
Nbatrap,stormrage,96,monk,windwalker,6,1,5
Cystweaver,dalaran,96,monk,windwalker,6,1,5
Minimonki,bleeding-hollow,96,monk,windwalker,6,1,5
Srshy,drakkari,96,monk,windwalker,6,1,5
Giriom,thrall,96,monk,windwalker,6,1,5
Monkanome,gilneas,96,monk,windwalker,6,1,5
Bvndo,illidan,96,monk,windwalker,6,1,5
Chipócluda,ragnaros,96,monk,windwalker,6,1,5
Memurk,bleeding-hollow,96,monk,windwalker,6,1,5
Yípman,uldum,96,monk,windwalker,6,1,5
Comical,malygos,96,monk,windwalker,6,1,5
Londobell,frostmourne,96,monk,windwalker,6,1,5
Windlordx,illidan,96,monk,windwalker,6,1,5
Imingleejr,illidan,96,monk,windwalker,6,1,5
Xhu,kelthuzad,96,monk,windwalker,6,1,5
Boomboomspin,illidan,96,monk,windwalker,6,1,5
Tubshark,kelthuzad,96,monk,windwalker,6,1,5
Espanasan,dalaran,96,monk,windwalker,6,1,5
Ischys,kelthuzad,96,monk,windwalker,6,1,5
Pléb,kelthuzad,96,monk,windwalker,6,1,5
Monkspanka,nemesis,96,monk,windwalker,6,1,5
Tuskytwofist,kargath,96,monk,windwalker,12,1,11
Cmon,icecrown,96,monk,windwalker,12,1,11
Yosisoy,zuljin,79,monk,windwalker,5,1,4
Hít,bonechewer,64,monk,windwalker,4,1,3
Criminall,aegwynn,64,monk,windwalker,4,1,3
Zhatafaq,ragnaros,48,monk,windwalker,3,1,2
Stumpling,earthen-ring,42,monk,windwalker,10,3,7
Alzen,tichondrius,42,monk,windwalker,9,2,7
Kreese,rivendare,42,monk,windwalker,9,2,7
Cosetteb,proudmoore,31,monk,windwalker,2,1,1
Notamønk,bonechewer,31,monk,windwalker,2,1,1
Laggyfist,frostmourne,16,monk,windwalker,1,1,0
Rèxpéi,area-52,2157,paladin,holy,84,48,36
Overwhelm,muradin,2125,paladin,holy,64,39,25
Holylolz,ragnaros,2125,paladin,holy,258,132,126
Sunita,arthas,2116,paladin,holy,189,99,90
Pattar,area-52,2107,paladin,holy,66,37,29
Dreathhammer,muradin,2093,paladin,holy,96,48,48
Tmborn,tichondrius,2093,paladin,holy,119,57,62
Caveyodeler,zuluhed,2048,paladin,holy,77,45,32
Digglesx,area-52,2012,paladin,holy,78,35,43
Bubblebuddyx,tichondrius,2010,paladin,holy,136,66,70
Bilmurii,zuljin,1990,paladin,holy,102,54,48
Curator,emerald-dream,1964,paladin,holy,74,37,37
Saacbot,area-52,1959,paladin,holy,81,34,47
Reverbz,malganis,1953,paladin,holy,120,56,64
Badnold,area-52,1952,paladin,holy,55,26,29
Bombboyoz,area-52,1936,paladin,holy,84,44,40
Eskerda,nemesis,1926,paladin,holy,65,32,33
Flõw,gnomeregan,1919,paladin,holy,84,52,32
Hamsti,sargeras,1909,paladin,holy,125,63,62
Baelsimp,illidan,1898,paladin,holy,96,50,46
Flashv,barthilas,1896,paladin,holy,62,32,30
Braindeadrsj,anetheron,1890,paladin,holy,185,99,86
Angrycubanx,black-dragonflight,1887,paladin,holy,50,25,25
Jaywalker,baelgun,1885,paladin,holy,78,45,33
Nickimahoj,tichondrius,1882,paladin,holy,98,48,50
Thejustice,tichondrius,1870,paladin,holy,162,79,83
Careless,malganis,1869,paladin,holy,54,28,26
Cynthianna,tichondrius,1865,paladin,holy,266,137,129
Bravepala,tichondrius,1862,paladin,holy,78,35,43
Thejustices,tichondrius,1860,paladin,holy,36,22,14
Chenzo,exodar,1856,paladin,holy,206,110,96
Sde,kelthuzad,1855,paladin,holy,132,61,71
Uxe,zuljin,1853,paladin,holy,66,33,33
Judgejim,barthilas,1851,paladin,holy,228,110,118
Scrubbinton,zuljin,1850,paladin,holy,114,58,56
Pelletbrain,emerald-dream,1850,paladin,holy,262,133,129
Nyctemavanna,ragnaros,1848,paladin,holy,124,65,59
Ðáxø,sargeras,1846,paladin,holy,48,25,23
Truluck,area-52,1845,paladin,holy,135,69,66
Ddeuk,tichondrius,1841,paladin,holy,593,309,284
Dýstopia,stormrage,1841,paladin,holy,41,21,20
Skillenjoyer,tichondrius,1839,paladin,holy,78,49,29
Bobthemad,proudmoore,1838,paladin,holy,59,33,26
Bobthemad,illidan,1838,paladin,holy,59,33,26
Bushyy,tichondrius,1838,paladin,holy,54,26,28
Duallkore,stormrage,1835,paladin,holy,78,42,36
Sojupapi,area-52,1826,paladin,holy,239,119,120
Ppgdx,azralon,1826,paladin,holy,78,34,44
Cyphinx,darkspear,1822,paladin,holy,103,48,55
Csupremacy,tichondrius,1822,paladin,holy,99,46,53
Memnoche,frostmane,1821,paladin,holy,89,53,36
Sacbubldead,area-52,1820,paladin,holy,126,79,47
Perfect,crushridge,1820,paladin,holy,56,28,28
Deadlyassian,sargeras,1819,paladin,holy,100,54,46
Ðáx,sargeras,1817,paladin,holy,87,44,43
Everrlasting,tichondrius,1817,paladin,holy,72,36,36
Fonypally,tichondrius,1815,paladin,holy,332,171,161
Fukndibs,kiljaeden,1811,paladin,holy,172,85,87
Sd,kelthuzad,1811,paladin,holy,123,59,64
Bubblist,tichondrius,1811,paladin,holy,68,28,40
Bravepl,tichondrius,1808,paladin,holy,73,28,45
Dracfire,zuljin,1807,paladin,holy,45,24,21
Zetsubõ,stormrage,1806,paladin,holy,54,24,30
Insthy,illidan,1804,paladin,holy,185,97,88
Ængelic,barthilas,1803,paladin,holy,202,107,95
Dyppally,moon-guard,1803,paladin,holy,102,51,51
Wtbmana,frostmourne,1801,paladin,holy,72,39,33
Varies,kelthuzad,1801,paladin,holy,58,28,30
Tylennis,archimonde,1801,paladin,holy,172,82,90
Richpiana,nathrezim,1800,paladin,holy,106,60,46
Kevinthecube,nerzhul,1797,paladin,holy,60,44,16
Hongwoosang,tichondrius,1795,paladin,holy,188,89,99
Colepal,zuljin,1792,paladin,holy,96,42,54
Hats,icecrown,1791,paladin,holy,233,120,113
Esd,kelthuzad,1791,paladin,holy,65,27,38
Chobbler,tichondrius,1788,paladin,holy,66,26,40
Boomda,tichondrius,1787,paladin,holy,199,110,89
Amourranth,stormrage,1785,paladin,holy,52,30,22
Scamlikely,tichondrius,1785,paladin,holy,121,62,59
Airbad,tichondrius,1785,paladin,holy,53,23,30
Veejayx,tichondrius,1775,paladin,holy,44,21,23
Zilea,kiljaeden,1768,paladin,holy,48,24,24
Hps,argent-dawn,1759,paladin,holy,42,22,20
Eskerda,azralon,1756,paladin,holy,202,96,106
Theebus,tichondrius,1753,paladin,holy,71,28,43
Defensezone,tichondrius,1749,paladin,holy,74,36,38
Adrizzyx,barthilas,1748,paladin,holy,42,23,19
Mercedez,bleeding-hollow,1744,paladin,holy,102,53,49
Ihaveajob,zuluhed,1730,paladin,holy,42,23,19
Evylinn,burning-legion,1727,paladin,holy,150,83,67
Cewekmbek,barthilas,1727,paladin,holy,48,19,29
Mayru,ragnaros,1721,paladin,holy,45,25,20
Chenzio,garona,1719,paladin,holy,63,41,22
Fixyouz,mannoroth,1718,paladin,holy,118,55,63
Ckaïnë,stormrage,1714,paladin,holy,68,36,32
Pallice,queldorei,1714,paladin,holy,126,61,65
Softsister,tichondrius,1713,paladin,holy,42,22,20
Heaven,gurubashi,1705,paladin,holy,47,22,25
Bombboyozjr,area-52,1701,paladin,holy,36,24,12
Taargaryenn,tichondrius,1701,paladin,holy,60,32,28
Fortold,bloodhoof,1692,paladin,holy,54,23,31
Virabelle,gurubashi,1690,paladin,holy,48,25,23
Yuuichi,moon-guard,1688,paladin,holy,76,37,39
Stephon,area-52,1686,paladin,holy,66,29,37
Holymooie,frostmourne,1681,paladin,holy,42,20,22
Citylights,tichondrius,1677,paladin,holy,51,28,23
Xciss,kiljaeden,1675,paladin,holy,332,162,170
Beejae,stormreaver,1675,paladin,holy,53,23,30
Barcie,lothar,1675,paladin,holy,78,29,49
Tenêbrae,area-52,1674,paladin,holy,52,33,19
Mangoflash,malganis,1673,paladin,holy,66,26,40
Bubbleofil,barthilas,1671,paladin,holy,36,26,10
Sàga,hyjal,1671,paladin,holy,53,29,24
Chunzhangsqs,tichondrius,1670,paladin,holy,54,24,30
Mvpj,medivh,1669,paladin,holy,153,78,75
Cheerleader,bleeding-hollow,1668,paladin,holy,138,62,76
Denthus,dragonmaw,1663,paladin,holy,47,25,22
Imshmackedd,darkspear,1663,paladin,holy,84,35,49
Tiernoo,illidan,1662,paladin,holy,98,46,52
Fary,malganis,1661,paladin,holy,36,20,16
Runihaveaids,stormrage,1661,paladin,holy,232,123,109
Landrysdad,malorne,1660,paladin,holy,54,26,28
Zacháry,sargeras,1659,paladin,holy,290,151,139
Ivan,tichondrius,1659,paladin,holy,136,62,74
Sacridas,fizzcrank,1657,paladin,holy,36,20,16
Shijielol,tichondrius,1656,paladin,holy,42,22,20
Zunit,laughing-skull,1656,paladin,holy,46,22,24
Thorfinaa,moon-guard,1653,paladin,holy,71,38,33
Avengom,tichondrius,1653,paladin,holy,357,179,178
Lalatinaford,amanthul,1647,paladin,holy,76,44,32
Kustp,tichondrius,1646,paladin,holy,189,105,84
Kensyzs,tichondrius,1644,paladin,holy,60,24,36
Boklahoma,stormrage,1643,paladin,holy,36,25,11
Ppgddxx,azralon,1643,paladin,holy,30,18,12
Nerfretpls,area-52,1642,paladin,holy,42,20,22
Arcanux,thrall,1639,paladin,holy,42,19,23
Dazargeros,moon-guard,1638,paladin,holy,132,66,66
Bushys,tichondrius,1638,paladin,holy,42,21,21
Gaelinar,tichondrius,1637,paladin,holy,60,29,31
Bpalaayo,kelthuzad,1636,paladin,holy,94,37,57
Ellyarian,emerald-dream,1635,paladin,holy,42,22,20
Bpalaax,kelthuzad,1635,paladin,holy,46,23,23
Teenytoots,burning-legion,1635,paladin,holy,87,35,52
Oing,tichondrius,1634,paladin,holy,76,45,31
Enzõ,illidan,1632,paladin,holy,48,26,22
Castleknight,tichondrius,1632,paladin,holy,77,38,39
Rhönin,sargeras,1632,paladin,holy,54,22,32
Rhunon,dalaran,1631,paladin,holy,78,41,37
Shazuwu,illidan,1630,paladin,holy,30,17,13
Xcuse,tichondrius,1630,paladin,holy,84,43,41
Boundric,emerald-dream,1629,paladin,holy,42,23,19
Gazapal,thrall,1628,paladin,holy,168,95,73
Pála,dalaran,1625,paladin,holy,164,80,84
Songminsu,proudmoore,1625,paladin,holy,99,47,52
Deepnasty,galakrond,1624,paladin,holy,215,110,105
Piïls,sargeras,1623,paladin,holy,42,20,22
Solfire,stormreaver,1622,paladin,holy,92,45,47
Bopbotx,area-52,1621,paladin,holy,49,17,32
Gospel,duskwood,1617,paladin,holy,65,37,28
Aldrion,stormrage,1617,paladin,holy,54,28,26
Scoopzi,frostmourne,1616,paladin,holy,47,27,20
Rhönin,illidan,1616,paladin,holy,42,22,20
Minefujiko,tichondrius,1616,paladin,holy,381,194,187
Sinfolly,whisperwind,1615,paladin,holy,90,47,43
Ascion,tichondrius,1614,paladin,holy,119,58,61
Censy,tichondrius,1613,paladin,holy,30,17,13
Caitthegreat,malorne,1613,paladin,holy,42,23,19
Nodenom,blackrock,1612,paladin,holy,30,18,12
Vmxp,barthilas,1611,paladin,holy,94,56,38
Sekitar,ragnaros,1611,paladin,holy,155,79,76
Zergmé,executus,1610,paladin,holy,42,21,21
Ricopal,frostmourne,1610,paladin,holy,36,17,19
Madorian,bleeding-hollow,1610,paladin,holy,71,31,40
Bërzerk,zuluhed,1609,paladin,holy,93,44,49
Denke,thrall,1609,paladin,holy,36,17,19
Jealp,sargeras,1608,paladin,holy,42,26,16
Roundhere,area-52,1608,paladin,holy,30,18,12
Naxzy,quelthalas,1608,paladin,holy,46,27,19
Moonmi,tichondrius,1608,paladin,holy,187,106,81
Larryhoova,malganis,1608,paladin,holy,36,20,16
Crâfty,bleeding-hollow,1608,paladin,holy,83,45,38
Dwarrior,quelthalas,1606,paladin,holy,39,18,21
Forsakenlite,sargeras,1606,paladin,holy,90,41,49
Raigha,stormrage,1604,paladin,holy,42,22,20
Zhula,nerzhul,1601,paladin,holy,48,31,17
Erikx,smolderthorn,1601,paladin,holy,120,66,54
Orphandog,zuljin,1600,paladin,holy,29,21,8
Gjoker,azralon,1600,paladin,holy,42,25,17
Jiraya,nemesis,1598,paladin,holy,79,39,40
Wuhbp,illidan,1596,paladin,holy,88,44,44
Peggy,azralon,1596,paladin,holy,39,18,21
Klam,kelthuzad,1595,paladin,holy,96,48,48
Brynnhild,stormrage,1592,paladin,holy,126,62,64
Ricardão,emerald-dream,1592,paladin,holy,36,17,19
Asherm,moon-guard,1590,paladin,holy,98,48,50
Abellpally,tichondrius,1589,paladin,holy,54,23,31
Beyondsausag,malganis,1589,paladin,holy,125,53,72
Madsama,quelthalas,1587,paladin,holy,72,39,33
Retsincewod,zuluhed,1586,paladin,holy,54,28,26
Kencyz,tichondrius,1585,paladin,holy,37,22,15
Chonsic,darkspear,1582,paladin,holy,90,40,50
Bopthebomb,sargeras,1580,paladin,holy,71,33,38
Sevenword,tichondrius,1577,paladin,holy,67,38,29
Molki,tichondrius,1575,paladin,holy,111,64,47
Thelac,dalaran,1575,paladin,holy,72,39,33
Regivän,azralon,1575,paladin,holy,78,39,39
Dodgeandhoj,nerzhul,1572,paladin,holy,36,19,17
Babaganôush,illidan,1571,paladin,holy,35,18,17
Leonideez,moon-guard,1571,paladin,holy,42,17,25
Gwok,thrall,1569,paladin,holy,167,89,78
Aluríel,quelthalas,1568,paladin,holy,56,28,28
Drisx,sargeras,1567,paladin,holy,96,48,48
Peelmeree,kelthuzad,1565,paladin,holy,36,18,18
Hônòr,thrall,1564,paladin,holy,51,29,22
Ashley,sargeras,1563,paladin,holy,42,22,20
Sprjustice,frostmourne,1562,paladin,holy,36,18,18
Nontheism,malganis,1559,paladin,holy,42,19,23
Senorbaxter,emerald-dream,1557,paladin,holy,66,27,39
Montageflav,illidan,1554,paladin,holy,56,27,29
Gorgona,illidan,1551,paladin,holy,107,53,54
Ilovecanada,sargeras,1550,paladin,holy,34,19,15
Crabsaladpal,illidan,1550,paladin,holy,112,62,50
Xinqingle,tichondrius,1550,paladin,holy,471,237,234
Sheriff,tanaris,1547,paladin,holy,48,22,26
Quertz,sargeras,1545,paladin,holy,149,87,62
Jässy,muradin,1545,paladin,holy,59,29,30
Amiigo,tichondrius,1545,paladin,holy,54,24,30
Riptonix,stormrage,1540,paladin,holy,121,66,55
Saibasita,tichondrius,1539,paladin,holy,48,33,15
Discordnitro,illidan,1539,paladin,holy,36,20,16
Killmoth,illidan,1539,paladin,holy,269,130,139
Slüg,bleeding-hollow,1536,paladin,holy,264,134,130
Handsomedan,twisting-nether,1533,paladin,holy,72,34,38
Holyknight,veknilash,1532,paladin,holy,89,45,44
Rg,nerzhul,1532,paladin,holy,219,108,111
Drägonmynuts,tichondrius,1532,paladin,holy,109,45,64
Avahir,moon-guard,1528,paladin,holy,60,30,30
Saveursavior,bleeding-hollow,1524,paladin,holy,147,70,77
Vaerume,sargeras,1523,paladin,holy,123,66,57
Kidstable,nathrezim,1523,paladin,holy,70,27,43
Superzero,area-52,1520,paladin,holy,48,26,22
Beyönd,quelthalas,1520,paladin,holy,78,39,39
Pandahorn,tichondrius,1520,paladin,holy,54,23,31
Wokeinator,malganis,1519,paladin,holy,249,135,114
Dageraad,tichondrius,1519,paladin,holy,30,16,14
Bigoldman,tichondrius,1519,paladin,holy,72,37,35
Sadamell,tichondrius,1518,paladin,holy,24,16,8
Jiberish,illidan,1515,paladin,holy,126,60,66
Bebebig,tichondrius,1511,paladin,holy,182,100,82
Maeyz,sargeras,1511,paladin,holy,126,67,59
Bosat,drakkari,1509,paladin,holy,48,19,29
Bushÿ,tichondrius,1508,paladin,holy,94,52,42
Humañ,tichondrius,1507,paladin,holy,60,32,28
Cjqcjq,tichondrius,1507,paladin,holy,41,21,20
Kdex,tichondrius,1505,paladin,holy,84,37,47
Goldensmile,frostmourne,1504,paladin,holy,36,19,17
Kencyxx,tichondrius,1504,paladin,holy,42,19,23
Ageroÿ,sargeras,1503,paladin,holy,61,31,30
Doofum,stormrage,1503,paladin,holy,131,58,73
Serendipidy,bleeding-hollow,1503,paladin,holy,98,43,55
Brumm,quelthalas,1501,paladin,holy,77,39,38
Konvi,tichondrius,1501,paladin,holy,129,60,69
Guerrer,hyjal,1499,paladin,holy,566,285,281
Rodrigo,frostmourne,1499,paladin,holy,81,39,42
Saphri,kiljaeden,1497,paladin,holy,214,110,104
Harryhui,tichondrius,1496,paladin,holy,42,23,19
Jeromee,area-52,1496,paladin,holy,48,19,29
Haitishammer,stormrage,1494,paladin,holy,78,37,41
Lightkillerx,thrall,1494,paladin,holy,84,37,47
Daenrahh,azralon,1491,paladin,holy,176,91,85
Paladanim,tichondrius,1490,paladin,holy,77,23,54
Nickiminhoj,stormrage,1488,paladin,holy,51,29,22
Neurôtoxins,frostmourne,1488,paladin,holy,54,27,27
Prettylightx,kelthuzad,1487,paladin,holy,259,128,131
Irunnal,kelthuzad,1486,paladin,holy,41,27,14
Donkeydumper,wyrmrest-accord,1486,paladin,holy,118,67,51
Stophamrtime,barthilas,1484,paladin,holy,42,20,22
Condone,earthen-ring,1484,paladin,holy,96,44,52
Baitur,zuljin,1480,paladin,holy,49,21,28
Regivan,nemesis,1479,paladin,holy,42,16,26
Aulty,sargeras,1479,paladin,holy,77,28,49
Fredward,bleeding-hollow,1478,paladin,holy,35,18,17
Dewlight,zuljin,1477,paladin,holy,161,77,84
Jorik,lightbringer,1477,paladin,holy,42,20,22
Dimix,sargeras,1476,paladin,holy,65,32,33
Lhpal,ragnaros,1475,paladin,holy,30,19,11
Zenkk,sargeras,1475,paladin,holy,57,23,34
Caobobby,tichondrius,1474,paladin,holy,57,25,32
Buqi,barthilas,1474,paladin,holy,57,23,34
Percüles,sargeras,1473,paladin,holy,66,38,28
Atelva,moon-guard,1471,paladin,holy,75,46,29
Judgemode,the-scryers,1468,paladin,holy,96,41,55
Ryhighdi,sargeras,1467,paladin,holy,48,22,26
Ooppa,proudmoore,1467,paladin,holy,61,26,35
Pasda,frostmourne,1467,paladin,holy,77,29,48
Blarr,azshara,1466,paladin,holy,84,34,50
Glørythrives,tichondrius,1465,paladin,holy,57,25,32
Vitabro,bleeding-hollow,1464,paladin,holy,155,81,74
Traumaboy,terenas,1463,paladin,holy,87,44,43
Danpros,azralon,1462,paladin,holy,84,34,50
Hughmyron,stormrage,1461,paladin,holy,40,24,16
Cohesion,draenor,1461,paladin,holy,77,35,42
Jezëbel,azralon,1460,paladin,holy,52,27,25
Sanasana,spirestone,1459,paladin,holy,117,66,51
Allitharis,tichondrius,1458,paladin,holy,112,59,53
Indemnity,wildhammer,1457,paladin,holy,69,40,29
Gotomars,tichondrius,1457,paladin,holy,89,45,44
Wonpai,frostmourne,1457,paladin,holy,57,26,31
Wonpaiv,frostmourne,1456,paladin,holy,53,21,32
Gankstapwn,tichondrius,1455,paladin,holy,59,27,32
Omfgitsyang,tichondrius,1453,paladin,holy,41,24,17
Devöut,aggramar,1453,paladin,holy,103,48,55
Handyandy,kelthuzad,1450,paladin,holy,118,61,57
Zakath,the-underbog,1449,paladin,holy,72,31,41
Zoeyxo,tichondrius,1448,paladin,holy,80,42,38
Noback,ragnaros,1448,paladin,holy,66,31,35
Kihluxo,frostmourne,1446,paladin,holy,101,56,45
Tigranes,proudmoore,1444,paladin,holy,36,17,19
Celsica,kelthuzad,1443,paladin,holy,153,73,80
Chowdar,proudmoore,1443,paladin,holy,78,36,42
Holyprotectr,tichondrius,1442,paladin,holy,30,17,13
Cykcp,burning-legion,1441,paladin,holy,72,34,38
Danyuel,zuljin,1441,paladin,holy,86,39,47
Notdjalex,zuljin,1440,paladin,holy,30,19,11
Holyhades,auchindoun,1439,paladin,holy,125,70,55
Sigmapepe,quelthalas,1436,paladin,holy,96,52,44
Ryhigh,sargeras,1436,paladin,holy,89,38,51
Rarth,nemesis,1434,paladin,holy,65,26,39
Xuantianchai,tichondrius,1431,paladin,holy,30,15,15
Shagalaga,tichondrius,1431,paladin,holy,155,72,83
Kriegmeister,amanthul,1429,paladin,holy,48,24,24
Herakleitos,firetree,1428,paladin,holy,69,41,28
Nume,nesingwary,1428,paladin,holy,96,49,47
Lyticmartyr,bleeding-hollow,1427,paladin,holy,48,24,24
Nrpzy,stormrage,1425,paladin,holy,83,39,44
Brioc,tichondrius,1424,paladin,holy,36,22,14
Lothnalar,ragnaros,1424,paladin,holy,54,23,31
Justeight,stormrage,1423,paladin,holy,66,37,29
Mastadin,illidan,1422,paladin,holy,36,19,17
Mabia,tichondrius,1421,paladin,holy,215,111,104
Splashleyy,bleeding-hollow,1421,paladin,holy,148,69,79
Holyterror,dentarg,1420,paladin,holy,48,25,23
Vodokus,area-52,1420,paladin,holy,106,46,60
Graceyrae,tichondrius,1419,paladin,holy,50,30,20
Jpwx,barthilas,1419,paladin,holy,30,15,15
Droopyz,quelthalas,1418,paladin,holy,66,27,39
Decalli,tichondrius,1417,paladin,holy,69,35,34
Dartpuncher,frostmourne,1414,paladin,holy,120,63,57
Realpalada,tichondrius,1414,paladin,holy,65,25,40
Alessan,nemesis,1413,paladin,holy,31,18,13
Cynical,dalvengyr,1413,paladin,holy,120,64,56
Palladomal,azralon,1413,paladin,holy,84,41,43
Xuanxingchai,tichondrius,1413,paladin,holy,72,30,42
Unbreakable,antonidas,1412,paladin,holy,51,36,15
Berseus,tichondrius,1411,paladin,holy,78,31,47
Lliliiliil,illidan,1410,paladin,holy,68,39,29
Quadrifoglio,moon-guard,1409,paladin,holy,205,106,99
Arral,malganis,1408,paladin,holy,66,31,35
Samaze,tichondrius,1407,paladin,holy,126,61,65
Vasar,tichondrius,1406,paladin,holy,37,26,11
Maleguz,azralon,1406,paladin,holy,309,159,150
Kokomö,kelthuzad,1404,paladin,holy,47,21,26
Nxkita,sargeras,1403,paladin,holy,54,28,26
Nanøha,frostmourne,1402,paladin,holy,88,26,62
Crüst,proudmoore,1401,paladin,holy,42,21,21
Liå,frostmourne,1399,paladin,holy,96,49,47
Wálker,ragnaros,1399,paladin,holy,98,48,50
Talantyr,zuljin,1398,paladin,holy,48,23,25
Uprise,chogall,1397,paladin,holy,66,33,33
Fabîan,guldan,1395,paladin,holy,42,22,20
Kirilx,vashj,1395,paladin,holy,48,25,23
Dadcantsac,frostmourne,1395,paladin,holy,87,41,46
Anderentonso,tichondrius,1395,paladin,holy,54,24,30
Paladinaiko,nemesis,1394,paladin,holy,117,57,60
Vêgenace,proudmoore,1394,paladin,holy,39,19,20
Enuug,malfurion,1390,paladin,holy,78,48,30
Holyramen,illidan,1389,paladin,holy,209,98,111
Anea,kelthuzad,1388,paladin,holy,32,17,15
Sapphiros,tichondrius,1388,paladin,holy,68,25,43
Summercarma,area-52,1387,paladin,holy,27,15,12
Odiinn,stormscale,1385,paladin,holy,85,39,46
Viviana,shadowmoon,1385,paladin,holy,46,20,26
Granitei,quelthalas,1384,paladin,holy,50,24,26
Luminainre,zuljin,1384,paladin,holy,149,66,83
Stormzy,zuljin,1383,paladin,holy,80,39,41
Ricemang,kiljaeden,1380,paladin,holy,53,24,29
Palapoxi,arygos,1377,paladin,holy,77,36,41
Doorii,tichondrius,1377,paladin,holy,47,18,29
Oralen,daggerspine,1376,paladin,holy,60,29,31
Ibury,quelthalas,1376,paladin,holy,139,67,72
Delilahxoxo,mugthol,1376,paladin,holy,63,26,37
Leónrey,stormrage,1376,paladin,holy,92,33,59
Lu,the-venture-co,1371,paladin,holy,34,15,19
Fiate,azralon,1370,paladin,holy,36,16,20
Massivesac,frostmourne,1369,paladin,holy,36,22,14
Jimmipepe,quelthalas,1369,paladin,holy,42,24,18
Palltard,illidan,1369,paladin,holy,42,18,24
Mânz,zuljin,1369,paladin,holy,60,21,39
Shaidd,bleeding-hollow,1368,paladin,holy,77,34,43
Mellidi,azralon,1367,paladin,holy,42,23,19
Saeranella,moon-guard,1366,paladin,holy,106,44,62
Paladinaa,lothar,1364,paladin,holy,104,41,63
Gorilla,kiljaeden,1362,paladin,holy,59,15,44
Rengen,frostmourne,1360,paladin,holy,42,22,20
Xöchïqüëtzäl,tichondrius,1360,paladin,holy,29,15,14
Bakoø,tichondrius,1360,paladin,holy,65,31,34
Zephyrvalor,sargeras,1360,paladin,holy,48,18,30
Jestiny,amanthul,1356,paladin,holy,97,55,42
Choonsly,tichondrius,1356,paladin,holy,69,36,33
Lightupx,stormrage,1356,paladin,holy,61,22,39
Negodoskate,nemesis,1353,paladin,holy,207,105,102
Amadeo,hyjal,1353,paladin,holy,101,44,57
Galabanja,malganis,1350,paladin,holy,42,24,18
Bulgecranker,tichondrius,1350,paladin,holy,36,20,16
Hawtwangs,proudmoore,1349,paladin,holy,48,26,22
Hamen,frostwolf,1349,paladin,holy,41,22,19
Møcha,moon-guard,1347,paladin,holy,44,23,21
Palazin,frostmourne,1347,paladin,holy,128,54,74
Flippo,sargeras,1346,paladin,holy,36,17,19
Hoonjojjyanp,tichondrius,1346,paladin,holy,35,15,20
Piura,stormreaver,1345,paladin,holy,48,23,25
Clare,burning-blade,1345,paladin,holy,61,28,33
Airbusx,tichondrius,1343,paladin,holy,24,14,10
Aberos,stonemaul,1343,paladin,holy,69,24,45
Mctacos,proudmoore,1342,paladin,holy,18,14,4
Ocean,sargeras,1342,paladin,holy,30,14,16
Miswalkpally,ragnaros,1342,paladin,holy,30,14,16
Rhamadicinu,frostmourne,1341,paladin,holy,55,31,24
Bakoo,tichondrius,1341,paladin,holy,54,27,27
Htmlar,tichondrius,1338,paladin,holy,75,41,34
Xiaoladin,frostmourne,1337,paladin,holy,25,16,9
Güido,stormrage,1337,paladin,holy,42,23,19
Röniin,ragnaros,1337,paladin,holy,298,156,142
Minereth,quelthalas,1337,paladin,holy,59,30,29
Leonrey,stormrage,1337,paladin,holy,43,21,22
Malakor,thrall,1334,paladin,holy,87,46,41
Finerkane,quelthalas,1334,paladin,holy,138,62,76
Alphanerd,burning-blade,1333,paladin,holy,55,27,28
Therealdeal,sargeras,1332,paladin,holy,77,41,36
Hawianbread,stormrage,1331,paladin,holy,60,33,27
Nepnade,stormrage,1331,paladin,holy,47,25,22
Rezmefool,tichondrius,1331,paladin,holy,133,59,74
Buri,tichondrius,1330,paladin,holy,42,17,25
Phinnik,tichondrius,1329,paladin,holy,250,125,125
Riporeo,rexxar,1327,paladin,holy,24,18,6
Syrenz,khazgoroth,1327,paladin,holy,42,24,18
Ashgrim,kiljaeden,1327,paladin,holy,77,37,40
Catechism,laughing-skull,1325,paladin,holy,44,24,20
Deepsearide,illidan,1324,paladin,holy,150,82,68
Alcaedra,shadowsong,1324,paladin,holy,92,45,47
Jordenz,bonechewer,1324,paladin,holy,30,14,16
Consecrated,daggerspine,1324,paladin,holy,75,30,45
Mcllovin,kiljaeden,1323,paladin,holy,60,28,32
Lucciuzz,tichondrius,1323,paladin,holy,68,29,39
Dimior,quelthalas,1322,paladin,holy,54,29,25
Zantdemption,frostmourne,1322,paladin,holy,30,15,15
Îcandy,stormrage,1319,paladin,holy,24,16,8
Kektrixia,tichondrius,1318,paladin,holy,24,15,9
Ùnholypally,jubeithos,1316,paladin,holy,71,42,29
Nilin,tichondrius,1316,paladin,holy,24,14,10
Ramphastoz,quelthalas,1316,paladin,holy,66,29,37
Valandiel,proudmoore,1315,paladin,holy,61,15,46
Sinay,azshara,1314,paladin,holy,76,43,33
Jaenus,azralon,1314,paladin,holy,66,32,34
Hodl,barthilas,1313,paladin,holy,113,58,55
Papaa,nemesis,1312,paladin,holy,166,79,87
Mawning,kelthuzad,1311,paladin,holy,220,111,109
Ryhighh,sargeras,1311,paladin,holy,93,37,56
Twck,hyjal,1309,paladin,holy,168,81,87
Holyredx,bleeding-hollow,1307,paladin,holy,126,70,56
Solanin,frostmourne,1307,paladin,holy,75,38,37
Ozpal,burning-blade,1305,paladin,holy,38,24,14
Errant,bonechewer,1305,paladin,holy,53,31,22
Wiley,dark-iron,1305,paladin,holy,36,20,16
Santiadin,ragnaros,1304,paladin,holy,20,15,5
Dreadrot,azralon,1302,paladin,holy,50,24,26
Sorkar,tichondrius,1301,paladin,holy,129,66,63
Einjerhar,quelthalas,1300,paladin,holy,48,22,26
Dóminos,quelthalas,1298,paladin,holy,48,24,24
Galearn,ragnaros,1298,paladin,holy,30,14,16
Ironpaladin,sargeras,1297,paladin,holy,90,39,51
Shámder,quelthalas,1295,paladin,holy,59,27,32
Vurian,uther,1295,paladin,holy,90,36,54
Ballsmcgee,bleeding-hollow,1294,paladin,holy,141,63,78
Botburger,stormrage,1293,paladin,holy,30,14,16
Goodwood,ghostlands,1293,paladin,holy,90,41,49
Jacobhowda,tichondrius,1292,paladin,holy,54,25,29
Colbroggins,crushridge,1289,paladin,holy,45,24,21
Daphillen,frostmourne,1288,paladin,holy,41,23,18
Yadiyadiyada,barthilas,1287,paladin,holy,42,24,18
Lørdthemar,azralon,1286,paladin,holy,60,26,34
Blessthfall,bleeding-hollow,1286,paladin,holy,51,14,37
Undefeatæd,korgath,1285,paladin,holy,52,29,23
Psuito,ragnaros,1285,paladin,holy,60,32,28
Quarall,blackhand,1283,paladin,holy,58,29,29
Slygonjinn,area-52,1281,paladin,holy,36,14,22
Swordstrikes,tichondrius,1271,paladin,holy,29,14,15
Merll,ragnaros,1267,paladin,holy,121,58,63
Klamindor,emerald-dream,1266,paladin,holy,48,22,26
Cowladino,tichondrius,1265,paladin,holy,55,27,28
Affrika,ysondre,1264,paladin,holy,104,52,52
Pallin,sargeras,1264,paladin,holy,90,41,49
Sneakypal,dalaran,1263,paladin,holy,58,22,36
Motoa,stormrage,1262,paladin,holy,36,19,17
Dumpytrucks,sargeras,1262,paladin,holy,48,24,24
Chånïng,frostmourne,1262,paladin,holy,42,16,26
Hèró,barthilas,1261,paladin,holy,30,16,14
Coltlocks,sargeras,1261,paladin,holy,54,26,28
Thiccholy,deathwing,1260,paladin,holy,170,93,77
Lilfingered,malganis,1260,paladin,holy,57,29,28
Vithar,bleeding-hollow,1259,paladin,holy,173,84,89
Randuir,proudmoore,1258,paladin,holy,68,38,30
Salipally,dalaran,1258,paladin,holy,101,46,55
Showtíme,steamwheedle-cartel,1257,paladin,holy,25,14,11
Lafasíta,ragnaros,1257,paladin,holy,36,19,17
Brenenk,quelthalas,1257,paladin,holy,65,32,33
Imabandagins,bleeding-hollow,1257,paladin,holy,109,52,57
Holyslapy,illidan,1255,paladin,holy,71,38,33
Troypolamalu,dark-iron,1255,paladin,holy,30,14,16
Holysplonk,stonemaul,1255,paladin,holy,72,30,42
Lightleadsme,sargeras,1254,paladin,holy,234,113,121
Swazanaseger,frostmourne,1252,paladin,holy,42,22,20
Ckemosabe,emerald-dream,1252,paladin,holy,38,14,24
Deidei,blood-furnace,1251,paladin,holy,29,17,12
Wukongsunn,dalaran,1251,paladin,holy,30,14,16
Elizzabeth,skullcrusher,1248,paladin,holy,41,25,16
Whitekao,illidan,1247,paladin,holy,18,13,5
Elutherios,tichondrius,1247,paladin,holy,54,26,28
Hopeyouheal,sargeras,1247,paladin,holy,30,14,16
Darkbringer,frostmourne,1245,paladin,holy,76,38,38
Silvermind,tichondrius,1244,paladin,holy,30,17,13
Freyr,deathwing,1244,paladin,holy,38,21,17
Bubblepigo,tichondrius,1243,paladin,holy,36,22,14
Sologriefer,sargeras,1242,paladin,holy,30,13,17
Scarlet,skywall,1241,paladin,holy,30,13,17
Herroprease,frostmane,1241,paladin,holy,30,13,17
Cudiskush,tichondrius,1237,paladin,holy,45,26,19
Anatnof,malganis,1237,paladin,holy,30,16,14
Roundbutts,stormrage,1237,paladin,holy,27,14,13
Chewyjitsu,tichondrius,1237,paladin,holy,54,23,31
Kristienna,boulderfist,1236,paladin,holy,35,16,19
Cbm,tichondrius,1235,paladin,holy,23,14,9
Chewiipal,dalaran,1235,paladin,holy,57,31,26
Judgynomnom,the-underbog,1234,paladin,holy,36,13,23
Elladan,illidan,1234,paladin,holy,66,20,46
Tuor,nerzhul,1233,paladin,holy,18,13,5
Twìceborn,emerald-dream,1233,paladin,holy,24,13,11
Kariack,malganis,1231,paladin,holy,30,15,15
Diebeatus,zuljin,1231,paladin,holy,54,25,29
Justizz,vashj,1228,paladin,holy,65,35,30
Mobitz,dalvengyr,1228,paladin,holy,36,16,20
Wodlim,azralon,1228,paladin,holy,37,13,24
Venictus,frostwolf,1227,paladin,holy,24,13,11
Gareyn,moon-guard,1227,paladin,holy,36,14,22
Mundomaloo,quelthalas,1226,paladin,holy,59,31,28
Moogmodular,malganis,1226,paladin,holy,98,47,51
Crocfacex,tichondrius,1226,paladin,holy,46,18,28
Harke,drakkari,1224,paladin,holy,18,13,5
Szsfstnoob,tichondrius,1224,paladin,holy,30,13,17
Aellithiene,tichondrius,1221,paladin,holy,30,13,17
Ballingirl,gnomeregan,1220,paladin,holy,51,22,29
Akromma,drakkari,1219,paladin,holy,47,25,22
Ramspartan,drakkari,1218,paladin,holy,106,52,54
Whangsta,tichondrius,1217,paladin,holy,48,21,27
Bárdokø,ragnaros,1216,paladin,holy,84,42,42
Monts,azralon,1215,paladin,holy,61,24,37
Saffranzord,azralon,1214,paladin,holy,73,35,38
Tandury,tichondrius,1214,paladin,holy,60,28,32
Hobbsone,trollbane,1214,paladin,holy,137,54,83
Savagegirlz,tichondrius,1213,paladin,holy,82,35,47
Sventyn,frostmourne,1212,paladin,holy,55,29,26
Kamaelyn,proudmoore,1211,paladin,holy,133,68,65
Tizzi,eredar,1210,paladin,holy,23,13,10
Capedcrusade,area-52,1208,paladin,holy,24,13,11
Yérn,barthilas,1208,paladin,holy,42,15,27
Krysalid,stormrage,1207,paladin,holy,39,22,17
Kënsi,quelthalas,1206,paladin,holy,158,82,76
Kenric,quelthalas,1204,paladin,holy,77,30,47
Burgalveist,azgalor,1202,paladin,holy,25,15,10
Contémpt,kelthuzad,1202,paladin,holy,30,14,16
Stemi,kelthuzad,1202,paladin,holy,59,21,38
Oopalaoo,azralon,1202,paladin,holy,54,19,35
Chor,tichondrius,1201,paladin,holy,22,14,8
Nikopala,tichondrius,1201,paladin,holy,39,20,19
Chopsparks,khadgar,1201,paladin,holy,147,75,72
Galeras,norgannon,1201,paladin,holy,164,70,94
Holyflux,winterhoof,1200,paladin,holy,18,13,5
Maaxxee,zuljin,1200,paladin,holy,27,13,14
Aoishie,bleeding-hollow,1200,paladin,holy,90,40,50
Boarfarmer,tichondrius,1199,paladin,holy,87,37,50
Mörphêus,tichondrius,1197,paladin,holy,54,30,24
Shorthordeon,kelthuzad,1194,paladin,holy,54,30,24
Dreemie,tichondrius,1194,paladin,holy,54,20,34
Dbolpala,frostmourne,1192,paladin,holy,48,26,22
Jessuss,shandris,1192,paladin,holy,51,21,30
Swanp,stormrage,1191,paladin,holy,60,26,34
Encantado,thrall,1190,paladin,holy,43,20,23
Yogafire,kelthuzad,1188,paladin,holy,24,13,11
Pallythre,proudmoore,1187,paladin,holy,54,23,31
Faileeria,malganis,1185,paladin,holy,36,25,11
Sinara,detheroc,1184,paladin,holy,143,69,74
Hulksmash,terenas,1184,paladin,holy,41,13,28
Bubblebooty,drakthul,1182,paladin,holy,60,38,22
Donoph,blades-edge,1182,paladin,holy,44,20,24
Granklol,tichondrius,1181,paladin,holy,98,41,57
Paladinomoto,sargeras,1180,paladin,holy,46,22,24
Sixtynine,nathrezim,1180,paladin,holy,78,35,43
Prosykt,sargeras,1179,paladin,holy,36,14,22
Myrthedara,kargath,1178,paladin,holy,33,16,17
Mianheyo,quelthalas,1178,paladin,holy,41,18,23
Vänhélsing,tichondrius,1176,paladin,holy,37,16,21
Barbaluzz,quelthalas,1174,paladin,holy,257,123,134
Psychorino,tichondrius,1173,paladin,holy,33,13,20
Madcandy,illidan,1172,paladin,holy,24,15,9
Ihr,kiljaeden,1162,paladin,holy,84,39,45
Pemodyne,illidan,1161,paladin,holy,66,21,45
Jazzmatic,dalaran,1157,paladin,holy,53,24,29
Babylonfive,zuluhed,1157,paladin,holy,126,53,73
Hammercy,tichondrius,1155,paladin,holy,73,39,34
Onecmpeter,kelthuzad,1152,paladin,holy,67,38,29
Shxz,illidan,1152,paladin,holy,24,12,12
Dispirit,the-forgotten-coast,1151,paladin,holy,41,25,16
Ej,ragnaros,1151,paladin,holy,24,12,12
Holycowisroy,illidan,1150,paladin,holy,24,12,12
Picorii,frostmourne,1150,paladin,holy,30,12,18
Bignum,illidan,1150,paladin,holy,36,12,24
Toroke,nemesis,1149,paladin,holy,60,33,27
Boxjang,tichondrius,1149,paladin,holy,24,12,12
Lòuisvuttion,tichondrius,1148,paladin,holy,18,12,6
Bluemitch,malfurion,1147,paladin,holy,36,14,22
Lindnerxo,malganis,1147,paladin,holy,36,12,24
Toesy,area-52,1146,paladin,holy,64,27,37
Oldgrumpster,stormrage,1145,paladin,holy,123,54,69
Renteria,sargeras,1144,paladin,holy,24,12,12
Homiepaldino,nordrassil,1143,paladin,holy,30,12,18
Lindsans,illidan,1142,paladin,holy,18,12,6
Repèntance,stormrage,1142,paladin,holy,24,12,12
Iramm,gallywix,1141,paladin,holy,18,12,6
Daik,proudmoore,1140,paladin,holy,34,20,14
Thorgard,antonidas,1140,paladin,holy,30,17,13
Dazztrain,barthilas,1139,paladin,holy,24,12,12
Exxin,turalyon,1139,paladin,holy,90,40,50
Elogant,mannoroth,1138,paladin,holy,58,33,25
Flareous,moon-guard,1138,paladin,holy,30,12,18
Smitty,korgath,1137,paladin,holy,30,12,18
Zavop,tichondrius,1136,paladin,holy,24,12,12
Raqu,laughing-skull,1136,paladin,holy,54,24,30
Heniou,tichondrius,1136,paladin,holy,59,26,33
Rajava,gallywix,1132,paladin,holy,78,43,35
Holodecoy,bleeding-hollow,1129,paladin,holy,50,22,28
Kipow,proudmoore,1128,paladin,holy,30,14,16
Alarter,azralon,1128,paladin,holy,36,13,23
Divinetits,sargeras,1127,paladin,holy,32,13,19
Clehley,turalyon,1126,paladin,holy,54,24,30
Belmonte,greymane,1125,paladin,holy,18,12,6
Dawnhammer,mugthol,1125,paladin,holy,58,28,30
Jiaofu,illidan,1123,paladin,holy,24,12,12
Kentö,area-52,1123,paladin,holy,30,14,16
Mywifeisbad,tichondrius,1122,paladin,holy,18,12,6
Bonz,ragnaros,1121,paladin,holy,24,12,12
Salitheion,queldorei,1120,paladin,holy,42,14,28
Sloppybobby,zuljin,1119,paladin,holy,30,16,14
Dueprøcess,elune,1119,paladin,holy,24,12,12
Ziggzag,hyjal,1117,paladin,holy,78,34,44
Bunksta,kelthuzad,1116,paladin,holy,52,25,27
Center,ragnaros,1116,paladin,holy,29,12,17
Meatburger,stormrage,1113,paladin,holy,30,12,18
Ouken,frostmourne,1111,paladin,holy,55,22,33
Holyhali,zuljin,1111,paladin,holy,80,27,53
Ëd,moon-guard,1110,paladin,holy,180,89,91
Holymorph,tichondrius,1108,paladin,holy,22,13,9
Zowolf,quelthalas,1108,paladin,holy,65,33,32
Acori,azralon,1108,paladin,holy,39,18,21
Onno,tichondrius,1105,paladin,holy,54,28,26
Kelthor,azralon,1104,paladin,holy,36,18,18
Freezion,aegwynn,1104,paladin,holy,33,15,18
Lovehan,tichondrius,1103,paladin,holy,27,12,15
Holysols,zuljin,1102,paladin,holy,24,12,12
Joeboomers,tichondrius,1098,paladin,holy,118,62,56
Lavarball,tichondrius,1098,paladin,holy,41,14,27
Vamir,magtheridon,1093,paladin,holy,48,24,24
Whosharted,area-52,1092,paladin,holy,66,36,30
Balanoriaa,azralon,1092,paladin,holy,62,29,33
Hojula,area-52,1087,paladin,holy,16,12,4
Unworn,proudmoore,1087,paladin,holy,66,34,32
Tittanfalls,illidan,1086,paladin,holy,48,25,23
Lobõ,ragnaros,1086,paladin,holy,48,18,30
Maín,tichondrius,1085,paladin,holy,22,12,10
Liadrin,sentinels,1085,paladin,holy,29,12,17
Teloniow,quelthalas,1084,paladin,holy,38,19,19
Holyginger,barthilas,1084,paladin,holy,90,32,58
Overthrrow,kelthuzad,1082,paladin,holy,180,93,87
Salivan,darkspear,1082,paladin,holy,27,13,14
Palaadiin,sargeras,1081,paladin,holy,60,33,27
Hivers,stormrage,1081,paladin,holy,48,22,26
Spikele,barthilas,1079,paladin,holy,30,13,17
Ahundo,stonemaul,1078,paladin,holy,71,39,32
Shocka,norgannon,1078,paladin,holy,90,48,42
Bloodyhull,azralon,1077,paladin,holy,18,12,6
Trivv,illidan,1077,paladin,holy,39,13,26
Maldobarr,stormrage,1075,paladin,holy,30,12,18
Rykeran,warsong,1074,paladin,holy,120,66,54
Rogrmurtaugh,sargeras,1073,paladin,holy,65,30,35
Vaalbara,fizzcrank,1070,paladin,holy,30,14,16
Resio,illidan,1068,paladin,holy,36,13,23
Lycheelz,illidan,1064,paladin,holy,48,26,22
Constantino,hakkar,1064,paladin,holy,24,13,11
Júpiter,kiljaeden,1064,paladin,holy,40,17,23
Fuzed,frostmourne,1063,paladin,holy,163,81,82
Vidalia,barthilas,1062,paladin,holy,23,12,11
Fatsoo,sargeras,1062,paladin,holy,25,12,13
Buckybarnes,gorefiend,1061,paladin,holy,42,26,16
Mitshuki,ragnaros,1060,paladin,holy,30,12,18
Lukas,vashj,1059,paladin,holy,176,89,87
Cephadrome,proudmoore,1058,paladin,holy,42,20,22
Mèdic,illidan,1057,paladin,holy,62,34,28
Odriew,sargeras,1056,paladin,holy,18,11,7
Narcissism,emerald-dream,1056,paladin,holy,18,11,7
Babe,crushridge,1056,paladin,holy,30,11,19
Waifu,area-52,1055,paladin,holy,18,11,7
Twichy,tichondrius,1055,paladin,holy,18,11,7
Lazio,frostmourne,1055,paladin,holy,24,11,13
Lickmysacx,tichondrius,1055,paladin,holy,30,11,19
Trivana,durotan,1054,paladin,holy,19,12,7
Pseudoret,tichondrius,1054,paladin,holy,18,11,7
Pality,illidan,1054,paladin,holy,24,11,13
Holygutzz,barthilas,1054,paladin,holy,30,11,19
Bloodrefuge,tichondrius,1054,paladin,holy,46,12,34
Beerüs,crushridge,1053,paladin,holy,48,22,26
Stingay,nemesis,1052,paladin,holy,24,11,13
Eldessia,wyrmrest-accord,1052,paladin,holy,24,11,13
Malakk,zuljin,1051,paladin,holy,47,25,22
Jonfox,stormrage,1051,paladin,holy,70,35,35
Hoopzz,illidan,1050,paladin,holy,30,11,19
Zxylight,hyjal,1048,paladin,holy,18,11,7
Kolmourn,deathwing,1048,paladin,holy,30,11,19
Palooma,area-52,1047,paladin,holy,72,29,43
Boostsixty,proudmoore,1046,paladin,holy,36,13,23
Èmmà,stormrage,1044,paladin,holy,87,41,46
Hybbo,runetotem,1042,paladin,holy,24,12,12
Tig,alleria,1042,paladin,holy,30,11,19
Ramhammerz,sargeras,1039,paladin,holy,150,71,79
Tyriam,stormscale,1038,paladin,holy,18,11,7
Waldir,silver-hand,1038,paladin,holy,36,11,25
Kymosolopal,sargeras,1038,paladin,holy,36,11,25
Mcduss,proudmoore,1037,paladin,holy,18,11,7
Xq,aegwynn,1037,paladin,holy,41,18,23
Cloûd,tichondrius,1036,paladin,holy,25,14,11
Raenilil,area-52,1036,paladin,holy,41,20,21
Nugsbunne,tichondrius,1035,paladin,holy,115,49,66
Whiteknight,kilrogg,1034,paladin,holy,24,11,13
Kromthael,burning-blade,1032,paladin,holy,24,11,13
Pheriox,agamaggan,1032,paladin,holy,24,11,13
Starfaith,illidan,1032,paladin,holy,67,27,40
Seonghwa,kelthuzad,1031,paladin,holy,70,40,30
Troxnar,ragnaros,1030,paladin,holy,64,38,26
Palqq,tichondrius,1025,paladin,holy,24,11,13
Stompcomp,tichondrius,1024,paladin,holy,75,32,43
Klansey,magtheridon,1023,paladin,holy,54,30,24
Wrathmatics,arthas,1022,paladin,holy,82,38,44
Minouther,area-52,1022,paladin,holy,80,32,48
Ahsys,tichondrius,1022,paladin,holy,53,18,35
Tylnish,hyjal,1021,paladin,holy,24,11,13
Voxoen,bleeding-hollow,1021,paladin,holy,24,11,13
Lexdor,quelthalas,1021,paladin,holy,24,11,13
Asclepiius,frostmourne,1020,paladin,holy,59,32,27
Erán,quelthalas,1019,paladin,holy,218,109,109
Tacori,gorefiend,1017,paladin,holy,24,13,11
Dissident,stormrage,1016,paladin,holy,87,37,50
Varenka,stormrage,1015,paladin,holy,83,36,47
Iamholyman,dragonmaw,1014,paladin,holy,29,14,15
Kithkannon,tichondrius,1007,paladin,holy,51,17,34
Kbot,zuljin,1005,paladin,holy,15,11,4
Tarnak,kelthuzad,1005,paladin,holy,33,11,22
Adventholy,tichondrius,1004,paladin,holy,42,19,23
Sutadansa,doomhammer,1001,paladin,holy,89,47,42
Paulx,malganis,999,paladin,holy,87,46,41
Gigadunker,tichondrius,999,paladin,holy,29,13,16
Ðß,arthas,995,paladin,holy,30,15,15
Westlysñipes,tichondrius,995,paladin,holy,92,44,48
Hzo,tichondrius,989,paladin,holy,17,11,6
Kaina,wildhammer,987,paladin,holy,53,22,31
Colombía,illidan,986,paladin,holy,54,27,27
Agravaine,moon-guard,986,paladin,holy,23,11,12
Lawroadm,tichondrius,985,paladin,holy,18,12,6
Gillgamesh,sentinels,978,paladin,holy,24,16,8
Shanvo,tichondrius,977,paladin,holy,46,28,18
Carneguisada,sargeras,975,paladin,holy,42,20,22
Imajeala,thrall,973,paladin,holy,76,42,34
Marcopolo,azralon,972,paladin,holy,29,11,18
Huijji,illidan,967,paladin,holy,24,15,9
Photons,emerald-dream,966,paladin,holy,24,13,11
Romeoo,silver-hand,964,paladin,holy,66,26,40
Hammerabi,moon-guard,963,paladin,holy,21,13,8
Divinadin,stormrage,961,paladin,holy,94,51,43
Thoryin,tichondrius,960,paladin,holy,12,10,2
Síríús,malganis,960,paladin,holy,15,11,4
Svitanie,bleeding-hollow,960,paladin,holy,80,38,42
Biwi,zuljin,960,paladin,holy,97,35,62
Arevia,stormrage,959,paladin,holy,18,10,8
Kagranac,moon-guard,959,paladin,holy,24,10,14
Zakh,proudmoore,959,paladin,holy,32,12,20
Milkovir,quelthalas,959,paladin,holy,42,10,32
Bubblet,bleeding-hollow,958,paladin,holy,18,10,8
Vajuicy,dalaran,957,paladin,holy,24,10,14
Lightswitchx,stormrage,957,paladin,holy,24,10,14
Jdxqt,darkspear,957,paladin,holy,30,10,20
Zayiro,eonar,957,paladin,holy,30,10,20
Paluh,sargeras,956,paladin,holy,24,10,14
Marklite,area-52,955,paladin,holy,24,10,14
Tèhflip,tichondrius,954,paladin,holy,24,10,14
Evanlina,bleeding-hollow,953,paladin,holy,18,10,8
Avasti,proudmoore,953,paladin,holy,24,10,14
Dragonchaos,ragnaros,953,paladin,holy,27,11,16
Hruuhwa,wyrmrest-accord,952,paladin,holy,18,10,8
Madnhairy,zuljin,952,paladin,holy,24,10,14
Kusotarão,nemesis,952,paladin,holy,24,10,14
Zafenate,nemesis,952,paladin,holy,24,10,14
Aiyoku,illidan,951,paladin,holy,18,10,8
Caike,frostmourne,950,paladin,holy,18,10,8
Beefyjones,illidan,949,paladin,holy,18,10,8
Heálbót,tichondrius,949,paladin,holy,20,10,10
Palawun,nerzhul,949,paladin,holy,45,11,34
Paladam,burning-blade,948,paladin,holy,24,10,14
Holydood,thunderhorn,947,paladin,holy,18,10,8
Hitsilent,warsong,947,paladin,holy,18,10,8
Tolliver,area-52,944,paladin,holy,18,11,7
Lazygamerr,sargeras,944,paladin,holy,18,10,8
Snnow,stormrage,942,paladin,holy,36,21,15
Lemuzinho,ragnaros,941,paladin,holy,24,10,14
Sweettartts,zuljin,941,paladin,holy,36,10,26
Joshington,stormrage,938,paladin,holy,29,10,19
Doidyph,frostmourne,935,paladin,holy,24,10,14
Pallyox,hellscream,933,paladin,holy,12,10,2
Bubbleosevèn,frostmourne,932,paladin,holy,30,10,20
Cooldbrew,frostmourne,932,paladin,holy,34,11,23
Mikeawk,tichondrius,932,paladin,holy,36,10,26
Gênji,eldrethalas,930,paladin,holy,54,20,34
Ramzäbeoulve,tichondrius,930,paladin,holy,96,25,71
Eradrae,mannoroth,929,paladin,holy,58,23,35
Saìdelia,moon-guard,929,paladin,holy,71,24,47
Finaldecis,zuljin,929,paladin,holy,42,10,32
Ljusett,frostmourne,925,paladin,holy,97,43,54
Hurkalzul,azralon,923,paladin,holy,24,10,14
Swamprat,zuljin,922,paladin,holy,23,10,13
Shâka,stormrage,921,paladin,holy,57,28,29
Monad,nazjatar,921,paladin,holy,60,29,31
Hentaiangel,kiljaeden,918,paladin,holy,39,19,20
Lysetskriger,azralon,915,paladin,holy,24,12,12
Ascension,amanthul,915,paladin,holy,144,57,87
Iwaterboy,malganis,912,paladin,holy,24,14,10
Ilse,deathwing,911,paladin,holy,27,10,17
Va,onyxia,906,paladin,holy,150,75,75
Scorcholdman,tichondrius,906,paladin,holy,35,10,25
Grumpybubble,sargeras,905,paladin,holy,19,11,8
Zhahira,hakkar,905,paladin,holy,24,10,14
Thaedrun,hydraxis,896,paladin,holy,54,26,28
Durendin,bonechewer,894,paladin,holy,14,10,4
Fedpowell,tichondrius,894,paladin,holy,23,10,13
Redentor,dalaran,892,paladin,holy,44,24,20
Shananakin,azshara,892,paladin,holy,29,13,16
Takodaddy,elune,889,paladin,holy,16,10,6
Lennon,stormrage,888,paladin,holy,84,38,46
Blackiron,frostmourne,883,paladin,holy,32,11,21
Letsirk,doomhammer,880,paladin,holy,30,11,19
Papakatsu,proudmoore,878,paladin,holy,48,22,26
Trâshcårt,sargeras,864,paladin,holy,12,9,3
Sovice,illidan,864,paladin,holy,12,9,3
Athanaiëll,proudmoore,864,paladin,holy,22,11,11
Rachaelucky,malganis,864,paladin,holy,18,9,9
Deadry,ysera,864,paladin,holy,18,9,9
Mâdâra,stormrage,864,paladin,holy,18,9,9
Zilzag,moon-guard,864,paladin,holy,23,9,14
Diamondwater,tichondrius,864,paladin,holy,24,9,15
Racketyman,illidan,863,paladin,holy,12,9,3
Auraingraham,stormscale,863,paladin,holy,18,9,9
Cheers,garona,863,paladin,holy,18,9,9
Lamas,kelthuzad,863,paladin,holy,18,9,9
Paintthinner,frostmourne,863,paladin,holy,24,9,15
Onlycams,sargeras,863,paladin,holy,24,9,15
Flow,spinebreaker,863,paladin,holy,24,9,15
Proxima,laughing-skull,863,paladin,holy,24,9,15
Niense,wyrmrest-accord,862,paladin,holy,12,9,3
Krackanut,kelthuzad,862,paladin,holy,18,9,9
Msheen,azralon,861,paladin,holy,12,9,3
Potatopasta,area-52,861,paladin,holy,12,9,3
Gothsick,zuljin,857,paladin,holy,18,9,9
Holyquadz,elune,857,paladin,holy,18,9,9
Slippyp,darkspear,857,paladin,holy,18,9,9
Spamsalot,malganis,857,paladin,holy,24,9,15
Stricken,kul-tiras,857,paladin,holy,24,9,15
Pathalerix,eonar,854,paladin,holy,18,9,9
Løl,zuljin,854,paladin,holy,54,22,32
Saxmurderz,tichondrius,853,paladin,holy,18,9,9
Holyiseasy,alleria,853,paladin,holy,29,11,18
Nedorshock,stormrage,853,paladin,holy,24,9,15
Veronica,sentinels,852,paladin,holy,42,9,33
Vëlar,tichondrius,851,paladin,holy,18,9,9
Mytolo,malganis,851,paladin,holy,24,9,15
Nualrossan,veknilash,848,paladin,holy,53,21,32
Ðeathspire,tichondrius,846,paladin,holy,18,10,8
Alydralmao,area-52,845,paladin,holy,24,9,15
Maalik,thrall,844,paladin,holy,18,9,9
Andormu,wyrmrest-accord,841,paladin,holy,24,9,15
Allegiance,drenden,840,paladin,holy,17,10,7
Jaok,tichondrius,831,paladin,holy,21,10,11
Orleenz,zuljin,831,paladin,holy,35,15,20
Supercutee,malganis,830,paladin,holy,22,9,13
Bainn,nerzhul,822,paladin,holy,73,31,42
Alltoohuman,nagrand,821,paladin,holy,23,9,14
Palaknight,tichondrius,812,paladin,holy,60,21,39
Êctheliøn,drakkari,807,paladin,holy,18,10,8
Weenustickle,barthilas,807,paladin,holy,32,10,22
Praisin,zuljin,805,paladin,holy,18,9,9
Davinity,senjin,799,paladin,holy,23,9,14
Snowdawg,blackhand,788,paladin,holy,30,10,20
Cyandra,moon-guard,783,paladin,holy,13,9,4
Holythunderx,tichondrius,782,paladin,holy,25,9,16
Holyfrénzy,thrall,776,paladin,holy,25,9,16
Alkyna,kelthuzad,768,paladin,holy,12,8,4
Notalkyna,kelthuzad,768,paladin,holy,12,8,4
Archerxx,ragnaros,768,paladin,holy,12,8,4
Swellowsx,tichondrius,768,paladin,holy,12,8,4
Siebens,illidan,768,paladin,holy,12,8,4
Kritzyx,stormrage,768,paladin,holy,12,8,4
Artús,ragnaros,768,paladin,holy,18,8,10
Loganholy,tichondrius,768,paladin,holy,18,8,10
Zero,anetheron,768,paladin,holy,18,8,10
Saintus,proudmoore,768,paladin,holy,18,8,10
Mattc,tichondrius,768,paladin,holy,24,8,16
Rawpaladin,blackrock,768,paladin,holy,24,8,16
Ahkairee,whisperwind,768,paladin,holy,24,8,16
Voladis,malganis,768,paladin,holy,30,8,22
Bestpally,alterac-mountains,767,paladin,holy,12,8,4
Mhera,sargeras,767,paladin,holy,12,8,4
Fupascoopa,illidan,767,paladin,holy,12,8,4
Linaiah,moon-guard,767,paladin,holy,12,8,4
Ezmødë,kelthuzad,767,paladin,holy,12,8,4
Kriegstier,scarlet-crusade,767,paladin,holy,12,8,4
Miniweiner,proudmoore,767,paladin,holy,18,8,10
Kigz,illidan,767,paladin,holy,18,8,10
Trancelancer,kelthuzad,767,paladin,holy,18,8,10
Wonpai,barthilas,767,paladin,holy,18,8,10
Lanzzelot,goldrinn,767,paladin,holy,18,8,10
Bopsamdi,barthilas,767,paladin,holy,24,8,16
Trevmagoosey,tichondrius,767,paladin,holy,24,8,16
Wrekster,tichondrius,766,paladin,holy,18,8,10
Wakethelight,illidan,766,paladin,holy,18,8,10
Banga,farstriders,766,paladin,holy,18,8,10
Holydeath,arthas,766,paladin,holy,24,8,16
Agert,bloodhoof,766,paladin,holy,36,8,28
Thonar,stormrage,765,paladin,holy,12,8,4
Lightsòut,frostmourne,765,paladin,holy,24,8,16
Revenere,tichondrius,765,paladin,holy,36,8,28
Grumpy,the-forgotten-coast,764,paladin,holy,12,8,4
Instaded,illidan,764,paladin,holy,18,8,10
Guççi,thunderlord,764,paladin,holy,25,9,16
Plsdontburst,tichondrius,763,paladin,holy,12,8,4
Pambam,thrall,763,paladin,holy,18,9,9
Jereth,kelthuzad,763,paladin,holy,18,8,10
Etlas,windrunner,763,paladin,holy,18,8,10
Porkwatchy,eonar,762,paladin,holy,24,8,16
Gyle,stormrage,761,paladin,holy,18,8,10
Sixthycent,kiljaeden,760,paladin,holy,18,8,10
Mcpuffin,aggramar,760,paladin,holy,18,8,10
Mixtapes,kargath,757,paladin,holy,12,8,4
Blacktemplar,area-52,755,paladin,holy,18,8,10
Crusæder,stormrage,753,paladin,holy,12,8,4
Unsungherø,skywall,752,paladin,holy,12,8,4
Jyin,emerald-dream,750,paladin,holy,24,8,16
Willycrow,nordrassil,740,paladin,holy,18,8,10
Mirotchburns,illidan,724,paladin,holy,16,9,7
Ashera,amanthul,722,paladin,holy,26,9,17
Mfn,tichondrius,714,paladin,holy,18,9,9
Bigolbittiez,tichondrius,712,paladin,holy,22,9,13
Sanastris,zuljin,693,paladin,holy,20,8,12
Nea,argent-dawn,684,paladin,holy,95,32,63
Visanth,bonechewer,677,paladin,holy,24,9,15
Femsquatch,kelthuzad,672,paladin,holy,12,7,5
Dgpaladin,tichondrius,672,paladin,holy,12,7,5
Xiaoholy,barthilas,672,paladin,holy,12,7,5
Busdid,sargeras,672,paladin,holy,12,7,5
Loyantal,tichondrius,672,paladin,holy,12,7,5
Jachunga,bleeding-hollow,672,paladin,holy,12,7,5
Farvadin,illidan,672,paladin,holy,12,7,5
Gimmethéloot,stormrage,672,paladin,holy,12,7,5
Zpsychotycx,tichondrius,672,paladin,holy,12,7,5
Imsuffering,zuljin,672,paladin,holy,12,7,5
Crinject,sargeras,672,paladin,holy,12,7,5
Oîn,area-52,672,paladin,holy,12,7,5
Pkkcandy,archimonde,672,paladin,holy,12,7,5
Canny,emerald-dream,672,paladin,holy,12,7,5
Brogepi,cenarius,672,paladin,holy,12,7,5
Mlpx,stormrage,672,paladin,holy,12,7,5
Iamguess,stormscale,672,paladin,holy,18,7,11
Orekilol,stormrage,672,paladin,holy,18,7,11
Obllivionn,wildhammer,672,paladin,holy,18,7,11
Oreki,area-52,672,paladin,holy,18,7,11
Emmipal,tichondrius,672,paladin,holy,18,7,11
Stompedlawl,illidan,672,paladin,holy,24,7,17
Sensible,sargeras,672,paladin,holy,24,7,17
Boraz,bleeding-hollow,672,paladin,holy,36,7,29
Thin,ragnaros,671,paladin,holy,12,7,5
Doktavius,lightbringer,671,paladin,holy,12,7,5
Thrandeill,bleeding-hollow,671,paladin,holy,12,7,5
Lördnextdoor,tichondrius,671,paladin,holy,12,7,5
Billytwoshoe,laughing-skull,671,paladin,holy,12,7,5
Cirillah,quelthalas,671,paladin,holy,12,7,5
Scatterslol,korgath,671,paladin,holy,12,7,5
Aràyleus,kelthuzad,671,paladin,holy,12,7,5
Rahruan,wyrmrest-accord,671,paladin,holy,12,7,5
Votasha,tichondrius,671,paladin,holy,18,7,11
Milonus,frostmourne,671,paladin,holy,18,7,11
Lemmiéwinkzz,sargeras,671,paladin,holy,18,7,11
Loguto,stormrage,671,paladin,holy,18,7,11
Animal,korialstrasz,671,paladin,holy,18,7,11
Shoppee,jubeithos,671,paladin,holy,18,7,11
Virkas,area-52,671,paladin,holy,18,7,11
Sýteck,sargeras,671,paladin,holy,24,7,17
Éætûgýäëí,area-52,671,paladin,holy,42,8,34
Bolzar,zuljin,670,paladin,holy,12,7,5
Korvén,area-52,670,paladin,holy,12,7,5
Bjdreams,ragnaros,670,paladin,holy,12,7,5
Extee,proudmoore,670,paladin,holy,12,7,5
Kalthorne,wyrmrest-accord,670,paladin,holy,12,7,5
Pradå,tichondrius,670,paladin,holy,12,7,5
Ingrìd,ragnaros,670,paladin,holy,12,7,5
Numenor,kiljaeden,670,paladin,holy,18,7,11
Tropicorn,proudmoore,670,paladin,holy,18,7,11
Rebelion,nagrand,670,paladin,holy,24,7,17
Drgn,azgalor,670,paladin,holy,30,7,23
Pluto,the-underbog,669,paladin,holy,12,7,5
Balkin,kelthuzad,669,paladin,holy,12,7,5
Stationarity,frostmourne,669,paladin,holy,18,7,11
Solef,stormrage,669,paladin,holy,18,7,11
Røusseff,azralon,669,paladin,holy,18,7,11
Jiralla,ragnaros,669,paladin,holy,18,7,11
Kimahri,anvilmar,669,paladin,holy,36,7,29
Lovinglight,zuljin,668,paladin,holy,12,7,5
Annii,aegwynn,666,paladin,holy,12,7,5
Vanquishyr,stormrage,666,paladin,holy,30,7,23
Geroden,tichondrius,665,paladin,holy,18,7,11
Bangerzzx,sargeras,663,paladin,holy,18,7,11
Chaós,queldorei,657,paladin,holy,18,7,11
Gnomesexer,illidan,655,paladin,holy,17,7,10
Ryuzu,arathor,640,paladin,holy,16,8,8
Emojunz,ragnaros,638,paladin,holy,11,7,4
Mycow,tichondrius,638,paladin,holy,17,7,10
Mikiná,proudmoore,638,paladin,holy,22,7,15
Koraesta,stormrage,632,paladin,holy,17,7,10
Bullivan,sisters-of-elune,630,paladin,holy,23,7,16
Luxsit,tichondrius,626,paladin,holy,30,9,21
Mamothman,barthilas,622,paladin,holy,18,9,9
Usebandage,sargeras,617,paladin,holy,16,9,7
Hildibrandt,stormrage,606,paladin,holy,14,7,7
Mojiberus,wyrmrest-accord,606,paladin,holy,14,7,7
Turnevil,wyrmrest-accord,591,paladin,holy,19,7,12
Wonpait,frostmourne,576,paladin,holy,9,7,2
Fadiez,sargeras,576,paladin,holy,12,6,6
Centimus,moon-guard,576,paladin,holy,12,6,6
Holydubya,illidan,576,paladin,holy,12,6,6
Ùthèr,tichondrius,576,paladin,holy,12,6,6
Drossp,illidan,576,paladin,holy,12,6,6
Tríno,malganis,576,paladin,holy,12,6,6
Doradar,zuljin,576,paladin,holy,12,6,6
Jurjen,quelthalas,576,paladin,holy,12,6,6
Vamplyy,kelthuzad,576,paladin,holy,12,6,6
Catharsis,tichondrius,576,paladin,holy,12,6,6
Gbj,staghelm,576,paladin,holy,12,6,6
Holymomia,blackrock,576,paladin,holy,12,6,6
Irêsha,quelthalas,576,paladin,holy,12,6,6
Squarehammer,blackrock,576,paladin,holy,12,6,6
Neeks,zuljin,576,paladin,holy,12,6,6
Tolentino,elune,576,paladin,holy,12,6,6
Amadin,winterhoof,576,paladin,holy,12,6,6
Dequincy,tichondrius,576,paladin,holy,12,6,6
Faie,frostmourne,576,paladin,holy,12,6,6
Jnzip,area-52,576,paladin,holy,15,7,8
Ironjudge,hakkar,576,paladin,holy,17,6,11
Imsoholy,tichondrius,576,paladin,holy,18,6,12
Remibear,tichondrius,576,paladin,holy,18,6,12
Marleigh,kelthuzad,576,paladin,holy,18,6,12
Nikxx,tichondrius,576,paladin,holy,18,6,12
Ghrumpy,thrall,576,paladin,holy,18,6,12
Jiråchi,sargeras,576,paladin,holy,18,6,12
Nelliellx,tichondrius,576,paladin,holy,18,6,12
Okcheon,tichondrius,576,paladin,holy,18,6,12
Lubed,aegwynn,576,paladin,holy,18,6,12
Shocksta,dalaran,576,paladin,holy,18,6,12
Kelosia,bonechewer,576,paladin,holy,18,6,12
Marien,kelthuzad,576,paladin,holy,18,6,12
Santiagolol,ragnaros,576,paladin,holy,24,6,18
Acpally,tichondrius,576,paladin,holy,24,6,18
Okx,illidan,575,paladin,holy,6,6,0
Borntocoom,stormrage,575,paladin,holy,12,6,6
Auralyon,tichondrius,575,paladin,holy,12,6,6
Hammersdown,stormrage,575,paladin,holy,12,6,6
Roachpally,area-52,575,paladin,holy,12,6,6
Leatherfase,dalaran,575,paladin,holy,12,6,6
Aldrukor,quelthalas,575,paladin,holy,12,6,6
Bigpal,area-52,575,paladin,holy,12,6,6
Emptyjump,eredar,575,paladin,holy,12,6,6
Anderious,moon-guard,575,paladin,holy,12,6,6
Septimia,illidan,575,paladin,holy,12,6,6
Nøzawkalypse,kelthuzad,575,paladin,holy,12,6,6
Luminouser,stormrage,575,paladin,holy,12,6,6
Cassiel,barthilas,575,paladin,holy,12,6,6
Docternoon,stormrage,575,paladin,holy,12,6,6
Nochance,queldorei,575,paladin,holy,12,6,6
Mendes,stormrage,575,paladin,holy,12,6,6
Grombaby,lightnings-blade,575,paladin,holy,12,6,6
Taiion,proudmoore,575,paladin,holy,18,6,12
Clonazedin,ragnaros,575,paladin,holy,18,6,12
Hojadin,area-52,575,paladin,holy,18,6,12
Areura,hellscream,575,paladin,holy,18,6,12
Asunä,bloodscalp,575,paladin,holy,18,6,12
Theprimus,darkspear,574,paladin,holy,6,6,0
Pizzaface,stormrage,574,paladin,holy,12,6,6
Rhonielson,tichondrius,574,paladin,holy,12,6,6
Litebright,bleeding-hollow,574,paladin,holy,12,6,6
Kilion,illidan,574,paladin,holy,18,6,12
Mileihot,quelthalas,574,paladin,holy,18,6,12
Beefstewmre,dalaran,573,paladin,holy,18,6,12
Iluvitar,kiljaeden,573,paladin,holy,18,6,12
Metalpriest,shattered-halls,573,paladin,holy,24,6,18
Nellie,deathwing,572,paladin,holy,12,6,6
Holymomo,malganis,572,paladin,holy,12,6,6
Tehgodofdmg,tichondrius,572,paladin,holy,18,6,12
Ducii,stormrage,571,paladin,holy,18,6,12
Fantasy,ragnaros,571,paladin,holy,24,6,18
Cynotik,moon-guard,570,paladin,holy,12,6,6
Maplleafs,kelthuzad,560,paladin,holy,24,6,18
Fleshoflíght,azjolnerub,559,paladin,holy,17,6,11
Glueconsumer,wyrmrest-accord,558,paladin,holy,12,7,5
Fayernaa,proudmoore,557,paladin,holy,10,7,3
Powtilted,thrall,543,paladin,holy,11,6,5
Redpally,emerald-dream,543,paladin,holy,16,6,10
Gabs,quelthalas,543,paladin,holy,16,6,10
Antivaxer,frostmourne,543,paladin,holy,17,6,11
Eboi,daggerspine,542,paladin,holy,26,7,19
Louisvuttiøn,tichondrius,527,paladin,holy,11,6,5
Leggomyagro,fenris,522,paladin,holy,26,7,19
Tyygore,nagrand,521,paladin,holy,19,8,11
Biggestkritz,frostmourne,511,paladin,holy,14,6,8
Splyts,stormrage,490,paladin,holy,23,7,16
Badboí,azralon,480,paladin,holy,6,5,1
Josabbilra,tichondrius,480,paladin,holy,6,5,1
Zenastra,moon-guard,480,paladin,holy,6,5,1
Bigboiyahurd,sargeras,480,paladin,holy,6,5,1
Mjölk,tichondrius,480,paladin,holy,6,5,1
Darfnarvis,sargeras,480,paladin,holy,6,5,1
Isecretly,stormrage,480,paladin,holy,6,5,1
Dlt,frostmourne,480,paladin,holy,6,5,1
Zanduncy,stormrage,480,paladin,holy,6,5,1
Cotopax,sargeras,480,paladin,holy,15,7,8
Keodis,suramar,480,paladin,holy,12,5,7
Vicentê,ragnaros,480,paladin,holy,12,5,7
Beila,illidan,480,paladin,holy,12,5,7
Garethorne,illidan,480,paladin,holy,12,5,7
Trycider,lightninghoof,480,paladin,holy,12,5,7
Runterran,illidan,480,paladin,holy,12,5,7
Mightypally,area-52,480,paladin,holy,12,5,7
Subotai,frostmourne,480,paladin,holy,12,5,7
Zhangliyi,tichondrius,480,paladin,holy,12,5,7
Cleanprotein,tichondrius,480,paladin,holy,12,5,7
Drunknbum,area-52,480,paladin,holy,12,5,7
Fartburger,saurfang,480,paladin,holy,12,5,7
Velline,tichondrius,480,paladin,holy,12,5,7
Eneraxx,proudmoore,480,paladin,holy,12,5,7
Gendevo,suramar,480,paladin,holy,12,5,7
Gøldenlight,illidan,480,paladin,holy,12,5,7
Timeparadox,illidan,480,paladin,holy,12,5,7
Twoshockz,stormrage,480,paladin,holy,12,5,7
Leddie,stormrage,480,paladin,holy,12,5,7
Tryvor,stormrage,480,paladin,holy,12,5,7
Inmortall,illidan,480,paladin,holy,12,5,7
Mortolla,duskwood,480,paladin,holy,12,5,7
Sixty,sargeras,480,paladin,holy,12,5,7
Slexpala,tichondrius,480,paladin,holy,12,5,7
Scubblez,zuljin,480,paladin,holy,12,5,7
Jeryko,gundrak,480,paladin,holy,12,5,7
Oxycleän,doomhammer,480,paladin,holy,12,5,7
Bíteme,sargeras,480,paladin,holy,15,6,9
Chimp,kiljaeden,480,paladin,holy,18,5,13
Stahz,illidan,480,paladin,holy,18,5,13
Chrisgrin,malganis,480,paladin,holy,18,5,13
Ashenira,barthilas,480,paladin,holy,18,5,13
Wêsleypipes,crushridge,480,paladin,holy,18,5,13
Mootumba,boulderfist,480,paladin,holy,24,5,19
Bubbleosèven,tichondrius,479,paladin,holy,6,5,1
Mightythorxx,tichondrius,479,paladin,holy,12,5,7
Bubbes,nerzhul,479,paladin,holy,12,5,7
Lmy,stormrage,479,paladin,holy,12,5,7
Ellisar,kiljaeden,479,paladin,holy,12,5,7
Hulkamaniac,blackhand,479,paladin,holy,12,5,7
Holyshasha,tichondrius,479,paladin,holy,12,5,7
Joelsama,area-52,479,paladin,holy,12,5,7
Pazztez,arthas,479,paladin,holy,12,5,7
Nielec,arygos,479,paladin,holy,12,5,7
Judgejitsu,black-dragonflight,479,paladin,holy,12,5,7
Tankgreed,quelthalas,479,paladin,holy,12,5,7
Loabandit,malorne,479,paladin,holy,12,5,7
Goksuu,ragnaros,479,paladin,holy,12,5,7
Lachaple,illidan,479,paladin,holy,12,5,7
Healadelphia,illidan,479,paladin,holy,18,5,13
Meistyr,thrall,479,paladin,holy,18,5,13
Ozirus,frostmourne,478,paladin,holy,12,5,7
Yobnai,zuljin,478,paladin,holy,12,5,7
Mfpink,thrall,478,paladin,holy,12,5,7
Boiducéu,azralon,478,paladin,holy,12,5,7
Sihylde,quelthalas,478,paladin,holy,18,5,13
Duecesz,area-52,478,paladin,holy,26,5,21
Goingturbo,wyrmrest-accord,477,paladin,holy,12,5,7
Sovereignt,aggramar,477,paladin,holy,12,5,7
Thaeldan,archimonde,477,paladin,holy,18,5,13
Stilreigning,darkspear,476,paladin,holy,12,5,7
Crazykil,fenris,476,paladin,holy,12,5,7
Miros,wyrmrest-accord,473,paladin,holy,12,5,7
Callmeweazy,arathor,472,paladin,holy,18,5,13
Granada,kirin-tor,470,paladin,holy,18,5,13
Parts,aerie-peak,468,paladin,holy,30,5,25
Toastedheals,stormreaver,463,paladin,holy,17,5,12
Darkwingdad,illidan,452,paladin,holy,35,13,22
Blancaflór,ragnaros,447,paladin,holy,11,5,6
Blassphamy,chogall,447,paladin,holy,14,6,8
Nabora,aggramar,446,paladin,holy,29,5,24
Ziggerqt,stormrage,432,paladin,holy,15,5,10
Kratheus,azralon,431,paladin,holy,11,5,6
Belfordz,stormrage,430,paladin,holy,15,6,9
Nivie,moon-guard,430,paladin,holy,15,5,10
Rashell,garrosh,426,paladin,holy,16,7,9
Mousesack,dragonmaw,426,paladin,holy,16,7,9
Valhallaborn,illidan,426,paladin,holy,15,6,9
Retribution,mannoroth,426,paladin,holy,23,6,17
Ziti,bonechewer,415,paladin,holy,8,5,3
Sushiopath,area-52,415,paladin,holy,14,5,9
Dewagon,area-52,398,paladin,holy,25,5,20
Vgeater,ysera,397,paladin,holy,13,5,8
Synasthesia,zuljin,384,paladin,holy,6,4,2
Oceania,grizzly-hills,384,paladin,holy,6,4,2
Volphorix,illidan,384,paladin,holy,6,4,2
Respect,black-dragonflight,384,paladin,holy,6,4,2
Robötwizard,tichondrius,384,paladin,holy,6,4,2
Anonymvs,eredar,384,paladin,holy,6,4,2
Rc,tichondrius,384,paladin,holy,6,4,2
Immensepower,tichondrius,384,paladin,holy,6,4,2
Ceeten,tichondrius,384,paladin,holy,6,4,2
Icac,stormrage,384,paladin,holy,6,4,2
Aswaran,jaedenar,384,paladin,holy,6,4,2
Eladore,hakkar,384,paladin,holy,6,4,2
Arleos,mannoroth,384,paladin,holy,6,4,2
Lightwerk,frostmourne,384,paladin,holy,6,4,2
Decree,rexxar,384,paladin,holy,6,4,2
Grfauxpal,sargeras,384,paladin,holy,6,4,2
Ohthatguy,sargeras,384,paladin,holy,6,4,2
Tontô,barthilas,384,paladin,holy,6,4,2
Nickahunnid,sargeras,384,paladin,holy,6,4,2
Ladanthal,barthilas,384,paladin,holy,6,4,2
Nfl,moon-guard,384,paladin,holy,9,5,4
Dragnix,dalaran,384,paladin,holy,11,4,7
Penpal,sargeras,384,paladin,holy,12,4,8
Cubic,wyrmrest-accord,384,paladin,holy,12,4,8
Zamn,frostmourne,384,paladin,holy,12,4,8
Nerfrets,stormrage,384,paladin,holy,12,4,8
Demonsbane,frostmourne,384,paladin,holy,12,4,8
Floweezy,thrall,384,paladin,holy,12,4,8
Sentence,moon-guard,384,paladin,holy,12,4,8
Maicolsalanu,quelthalas,384,paladin,holy,12,4,8
Swolsus,illidan,384,paladin,holy,12,4,8
Alicethemad,aerie-peak,384,paladin,holy,12,4,8
Alkina,kelthuzad,384,paladin,holy,12,4,8
Daflash,emerald-dream,384,paladin,holy,12,4,8
Nikkixo,ysera,384,paladin,holy,12,4,8
Egf,illidan,384,paladin,holy,12,4,8
Tyryan,azralon,384,paladin,holy,12,4,8
Ajlol,thrall,384,paladin,holy,12,4,8
Zundralak,korgath,384,paladin,holy,12,4,8
Gùmbý,illidan,384,paladin,holy,12,4,8
Bigtimepali,tichondrius,384,paladin,holy,12,4,8
Saintcassi,wyrmrest-accord,384,paladin,holy,12,4,8
Gotredwings,proudmoore,384,paladin,holy,12,4,8
Gâbríél,maiev,384,paladin,holy,12,4,8
Lesauceboss,tichondrius,384,paladin,holy,12,4,8
Bighardshock,aggramar,384,paladin,holy,12,4,8
Eull,skullcrusher,384,paladin,holy,12,4,8
Purdicks,emerald-dream,384,paladin,holy,12,4,8
Qoop,tichondrius,384,paladin,holy,12,4,8
Wangzu,wildhammer,384,paladin,holy,12,4,8
Sacratess,area-52,384,paladin,holy,12,4,8
Derbizzle,darkspear,384,paladin,holy,12,4,8
Devsrdumb,bonechewer,384,paladin,holy,12,4,8
Cadap,bleeding-hollow,384,paladin,holy,12,4,8
Lánná,tichondrius,384,paladin,holy,12,4,8
Palastik,malganis,384,paladin,holy,12,4,8
Justarius,stormrage,384,paladin,holy,12,4,8
Ardrider,emerald-dream,384,paladin,holy,18,4,14
Mory,aegwynn,384,paladin,holy,18,4,14
Bloodangelz,sargeras,384,paladin,holy,18,4,14
Luminali,frostwolf,384,paladin,holy,18,4,14
Beebopper,illidan,384,paladin,holy,18,4,14
Riyu,blackrock,384,paladin,holy,18,4,14
Kaminasol,quelthalas,384,paladin,holy,18,4,14
Retholyprot,tichondrius,384,paladin,holy,18,4,14
Cutebtw,zuljin,384,paladin,holy,18,4,14
Hímüra,nemesis,384,paladin,holy,18,4,14
Õblivion,jubeithos,384,paladin,holy,18,4,14
Shockzer,bloodscalp,384,paladin,holy,23,4,19
Scah,illidan,383,paladin,holy,6,4,2
Namaru,hellscream,383,paladin,holy,12,4,8
Lunchmoney,aggramar,383,paladin,holy,12,4,8
Rënner,stormrage,383,paladin,holy,12,4,8
Thulamon,zuljin,383,paladin,holy,12,4,8
Vorex,ragnaros,383,paladin,holy,12,4,8
Fivestarzx,malganis,383,paladin,holy,12,4,8
Lightbeard,feathermoon,383,paladin,holy,12,4,8
Tennesse,sargeras,383,paladin,holy,18,4,14
Anjøs,azralon,383,paladin,holy,18,4,14
Gokzurah,dragonmaw,383,paladin,holy,18,4,14
Alyosya,barthilas,383,paladin,holy,24,4,20
Outforblood,stormscale,382,paladin,holy,8,4,4
Veliona,thaurissan,382,paladin,holy,12,4,8
Sleepadin,shadowsong,382,paladin,holy,12,4,8
Densom,aggramar,381,paladin,holy,12,4,8
Rustacian,area-52,380,paladin,holy,12,4,8
Gornack,draka,379,paladin,holy,12,4,8
Gnomeslapper,frostmourne,351,paladin,holy,11,4,7
Palewan,kiljaeden,351,paladin,holy,11,4,7
Aärøn,stormrage,351,paladin,holy,11,4,7
Cristineth,tanaris,351,paladin,holy,14,5,9
Nvgesus,undermine,329,paladin,holy,16,5,11
Sothalas,dalaran,328,paladin,holy,15,6,9
Pakalun,area-52,319,paladin,holy,14,4,10
Clearcoms,stormrage,304,paladin,holy,7,4,3
Veeve,emerald-dream,304,paladin,holy,7,4,3
Nulric,moon-guard,304,paladin,holy,13,4,9
Nskkbr,frostmourne,304,paladin,holy,13,4,9
Rett,chogall,288,paladin,holy,8,5,3
Repgodx,illidan,288,paladin,holy,6,3,3
Feelsögood,tichondrius,288,paladin,holy,6,3,3
Hazkal,sargeras,288,paladin,holy,6,3,3
Kshock,proudmoore,288,paladin,holy,6,3,3
Kusunoki,kelthuzad,288,paladin,holy,6,3,3
Datguysname,illidan,288,paladin,holy,6,3,3
Holysheesh,cenarion-circle,288,paladin,holy,6,3,3
Odinns,proudmoore,288,paladin,holy,6,3,3
Yacè,moon-guard,288,paladin,holy,6,3,3
Kharissia,proudmoore,288,paladin,holy,6,3,3
Arena,mannoroth,288,paladin,holy,6,3,3
Powerassasin,tichondrius,288,paladin,holy,6,3,3
Demoniret,ragnaros,288,paladin,holy,6,3,3
Lighteiron,moonrunner,288,paladin,holy,6,3,3
Phut,stormrage,288,paladin,holy,6,3,3
Laythoz,hyjal,288,paladin,holy,6,3,3
Kaleroenin,cenarius,288,paladin,holy,6,3,3
Dayatthespa,stormrage,288,paladin,holy,6,3,3
Lànd,tichondrius,288,paladin,holy,6,3,3
Breesh,nerzhul,288,paladin,holy,6,3,3
Brightcore,stormrage,288,paladin,holy,6,3,3
Krritter,illidan,288,paladin,holy,6,3,3
Nipon,stormrage,288,paladin,holy,6,3,3
Banpally,tichondrius,288,paladin,holy,6,3,3
Psalms,lightnings-blade,288,paladin,holy,6,3,3
Leronos,zuljin,288,paladin,holy,6,3,3
Tpane,kelthuzad,288,paladin,holy,6,3,3
Rheepent,hyjal,288,paladin,holy,6,3,3
Miggsy,stormrage,288,paladin,holy,6,3,3
Apally,drakthul,288,paladin,holy,6,3,3
Wonpæi,frostmourne,288,paladin,holy,6,3,3
Barquin,dalaran,288,paladin,holy,6,3,3
Schwârts,blackrock,288,paladin,holy,6,3,3
Antarcticala,frostmourne,288,paladin,holy,6,3,3
Árrest,tichondrius,288,paladin,holy,6,3,3
Kãrmä,area-52,288,paladin,holy,6,3,3
Sigfriéd,tichondrius,288,paladin,holy,6,3,3
Thyedron,azralon,288,paladin,holy,6,3,3
Paen,area-52,288,paladin,holy,6,3,3
Vanitasz,bleeding-hollow,288,paladin,holy,6,3,3
Soapgirl,area-52,288,paladin,holy,6,3,3
Grimmey,azjolnerub,288,paladin,holy,6,3,3
Jackywacky,malganis,288,paladin,holy,6,3,3
Alîcë,wyrmrest-accord,288,paladin,holy,6,3,3
Aduhrawl,moon-guard,288,paladin,holy,6,3,3
Stormvikingx,darkspear,288,paladin,holy,6,3,3
Holzinger,quelthalas,288,paladin,holy,6,3,3
Gompa,bleeding-hollow,288,paladin,holy,6,3,3
Mindfoolness,sargeras,288,paladin,holy,6,3,3
Gutzzx,frostmourne,288,paladin,holy,6,3,3
Andronik,bleeding-hollow,288,paladin,holy,6,3,3
Guidö,stormrage,288,paladin,holy,8,3,5
Urudith,azralon,288,paladin,holy,11,3,8
Mosso,bleeding-hollow,288,paladin,holy,12,3,9
Ratface,dathremar,288,paladin,holy,12,3,9
Ehbowlskesk,zuljin,288,paladin,holy,12,3,9
Repths,illidan,288,paladin,holy,12,3,9
Revoraal,frostmourne,288,paladin,holy,12,3,9
Mevand,windrunner,288,paladin,holy,12,3,9
Yanggongru,sargeras,288,paladin,holy,12,3,9
Kommuna,stormscale,288,paladin,holy,12,3,9
Drippinheals,eitrigg,288,paladin,holy,12,3,9
Deckter,ragnaros,288,paladin,holy,12,3,9
Imabigkidnow,emerald-dream,288,paladin,holy,12,3,9
Teerblood,illidan,288,paladin,holy,12,3,9
Sanctifyd,kiljaeden,288,paladin,holy,12,3,9
Thichammer,frostmourne,288,paladin,holy,12,3,9
Dráugus,azralon,288,paladin,holy,12,3,9
Afkyouheal,suramar,288,paladin,holy,12,3,9
Rudez,kiljaeden,288,paladin,holy,12,3,9
Quits,tichondrius,288,paladin,holy,12,3,9
Geðff,burning-legion,288,paladin,holy,12,3,9
Tolipos,earthen-ring,288,paladin,holy,12,3,9
Taethelan,malganis,288,paladin,holy,12,3,9
Eijara,shattered-hand,288,paladin,holy,12,3,9
Serca,khadgar,288,paladin,holy,12,3,9
Haldry,wyrmrest-accord,288,paladin,holy,12,3,9
Hemmyr,deathwing,288,paladin,holy,12,3,9
Prâytorian,illidan,288,paladin,holy,12,3,9
Dartherion,shandris,288,paladin,holy,12,3,9
Ariste,emerald-dream,288,paladin,holy,12,3,9
Beeodin,malganis,288,paladin,holy,12,3,9
Buslightyear,azralon,288,paladin,holy,12,3,9
Hugokpz,quelthalas,288,paladin,holy,18,3,15
Bigboppapump,lightnings-blade,288,paladin,holy,18,3,15
Tooholy,kiljaeden,288,paladin,holy,18,3,15
Flarisic,kelthuzad,288,paladin,holy,18,3,15
Mathalt,area-52,288,paladin,holy,18,3,15
Alogagain,frostmourne,288,paladin,holy,18,3,15
Capsiel,caelestrasz,288,paladin,holy,18,3,15
Holyslapz,nazjatar,287,paladin,holy,6,3,3
Avantasias,sargeras,287,paladin,holy,12,3,9
Spacebacon,thunderlord,287,paladin,holy,12,3,9
Fokatayew,korialstrasz,287,paladin,holy,12,3,9
Giscicatrice,firetree,287,paladin,holy,12,3,9
Rost,jaedenar,287,paladin,holy,24,3,21
Moraxeus,gundrak,286,paladin,holy,6,3,3
Hehealsyou,alleria,285,paladin,holy,12,3,9
Schnabdain,exodar,285,paladin,holy,18,3,15
Sellathice,khadgar,271,paladin,holy,11,3,8
Malthisz,antonidas,265,paladin,holy,17,5,12
Iradruidz,tichondrius,255,paladin,holy,11,3,8
Holywoof,agamaggan,234,paladin,holy,11,5,6
Itheternal,dalaran,234,paladin,holy,9,4,5
Wëlch,nemesis,234,paladin,holy,16,4,12
Inarit,thrall,232,paladin,holy,22,5,17
Jaxal,nordrassil,208,paladin,holy,7,3,4
Bigdmcgee,frostmourne,192,paladin,holy,6,2,4
Patpatterson,mannoroth,192,paladin,holy,6,2,4
Cheliere,kiljaeden,192,paladin,holy,6,2,4
Svane,thunderlord,192,paladin,holy,6,2,4
Gilazhar,eldrethalas,192,paladin,holy,6,2,4
Razzypal,sargeras,192,paladin,holy,6,2,4
Hitabull,hyjal,192,paladin,holy,6,2,4
Flintstone,barthilas,192,paladin,holy,6,2,4
Eckò,malganis,192,paladin,holy,6,2,4
Technicolour,frostmourne,192,paladin,holy,6,2,4
Veguê,ragnaros,192,paladin,holy,6,2,4
Sainttom,sargeras,192,paladin,holy,6,2,4
Ronnierawdog,frostmourne,192,paladin,holy,6,2,4
Beaconlol,proudmoore,192,paladin,holy,6,2,4
Kimbr,gallywix,192,paladin,holy,6,2,4
Mangchì,tichondrius,192,paladin,holy,6,2,4
Jabusty,kelthuzad,192,paladin,holy,6,2,4
Tumatauenga,burning-blade,192,paladin,holy,6,2,4
Pallydeen,illidan,192,paladin,holy,6,2,4
Drii,moon-guard,192,paladin,holy,6,2,4
Lazydin,tichondrius,192,paladin,holy,6,2,4
Eicke,malganis,192,paladin,holy,6,2,4
Misakiqs,sargeras,192,paladin,holy,6,2,4
Antoniano,ragnaros,192,paladin,holy,6,2,4
Smôres,sargeras,192,paladin,holy,6,2,4
Pearlx,ragnaros,192,paladin,holy,6,2,4
Nachius,ragnaros,192,paladin,holy,6,2,4
Flexxborn,thrall,192,paladin,holy,6,2,4
Ironmanfrank,tichondrius,192,paladin,holy,6,2,4
Borngood,tichondrius,192,paladin,holy,6,2,4
Romaztlan,area-52,192,paladin,holy,6,2,4
Toonchies,barthilas,192,paladin,holy,6,2,4
Healheal,tichondrius,192,paladin,holy,6,2,4
Healnsqueal,stormrage,192,paladin,holy,6,2,4
Chinaballoon,moonrunner,192,paladin,holy,6,2,4
Pgpal,kelthuzad,192,paladin,holy,6,2,4
Mordirhar,tichondrius,192,paladin,holy,6,2,4
Raywhite,kelthuzad,192,paladin,holy,6,2,4
Lóli,azralon,192,paladin,holy,6,2,4
Stormwinter,azralon,192,paladin,holy,6,2,4
Elchupalibre,tichondrius,192,paladin,holy,6,2,4
Turnipfãrmer,tichondrius,192,paladin,holy,6,2,4
Akj,tichondrius,192,paladin,holy,6,2,4
Xtabelcnu,illidan,192,paladin,holy,6,2,4
Bakapal,tichondrius,192,paladin,holy,6,2,4
Iolwhat,sargeras,192,paladin,holy,6,2,4
Breach,blades-edge,192,paladin,holy,6,2,4
Trâgedy,azjolnerub,192,paladin,holy,6,2,4
Goldirock,quelthalas,192,paladin,holy,6,2,4
Câno,quelthalas,192,paladin,holy,6,2,4
Xinane,dalaran,192,paladin,holy,6,2,4
Raiel,aegwynn,192,paladin,holy,6,2,4
Wâr,aegwynn,192,paladin,holy,6,2,4
Bravomedic,emerald-dream,192,paladin,holy,6,2,4
Jastella,illidan,192,paladin,holy,6,2,4
Goldieg,tichondrius,192,paladin,holy,6,2,4
Cathandrix,malganis,192,paladin,holy,6,2,4
Illbubble,duskwood,192,paladin,holy,7,2,5
Naxzero,shadowsong,192,paladin,holy,8,2,6
Minzyy,frostmourne,192,paladin,holy,12,2,10
Gavril,kirin-tor,192,paladin,holy,12,2,10
Märdrius,tichondrius,192,paladin,holy,12,2,10
Trojani,malganis,192,paladin,holy,12,2,10
Carmiínha,azralon,192,paladin,holy,12,2,10
Murkpal,frostmourne,192,paladin,holy,12,2,10
Vaylindor,area-52,192,paladin,holy,12,2,10
Cehart,windrunner,192,paladin,holy,12,2,10
Hxnny,kiljaeden,192,paladin,holy,12,2,10
Willywønka,azgalor,192,paladin,holy,12,2,10
Bohoqt,tichondrius,192,paladin,holy,12,2,10
Giuseppepee,malganis,192,paladin,holy,12,2,10
Piupiubiu,stormrage,192,paladin,holy,12,2,10
Streetacus,stormrage,192,paladin,holy,12,2,10
Einheilagr,stormrage,192,paladin,holy,12,2,10
Spoons,malganis,192,paladin,holy,12,2,10
Dwemeor,azuremyst,192,paladin,holy,12,2,10
Bighausse,thrall,192,paladin,holy,12,2,10
Shoresy,terokkar,192,paladin,holy,18,2,16
Levarious,thunderlord,192,paladin,holy,18,2,16
Krypton,tichondrius,192,paladin,holy,18,2,16
Ronatiú,tichondrius,192,paladin,holy,18,2,16
Waifupaladin,azralon,192,paladin,holy,18,2,16
Cedinea,wyrmrest-accord,191,paladin,holy,6,2,4
Prh,frostmourne,191,paladin,holy,6,2,4
Holygota,nemesis,191,paladin,holy,6,2,4
Mose,scilla,191,paladin,holy,6,2,4
Arobelse,sargeras,191,paladin,holy,12,2,10
Myû,korgath,160,paladin,holy,10,3,7
Itsoverninek,emerald-dream,159,paladin,holy,17,2,15
Hearthledger,ragnaros,144,paladin,holy,3,3,0
Elrecka,stormrage,144,paladin,holy,9,2,7
Whitedozer,darkspear,138,paladin,holy,10,4,6
Zela,ghostlands,137,paladin,holy,21,3,18
Guelmin,azralon,112,paladin,holy,7,2,5
Kamí,elune,96,paladin,holy,6,1,5
Evilpallie,illidan,96,paladin,holy,6,1,5
Cathraga,moknathal,96,paladin,holy,6,1,5
Syrenadrel,hydraxis,96,paladin,holy,6,1,5
Criaharn,turalyon,96,paladin,holy,6,1,5
Netéro,skywall,96,paladin,holy,6,1,5
Deadlyassian,ysera,96,paladin,holy,6,1,5
Chucknoreis,azralon,96,paladin,holy,6,1,5
Kurook,moon-guard,96,paladin,holy,6,1,5
Retattack,area-52,96,paladin,holy,6,1,5
Sevina,twisting-nether,96,paladin,holy,6,1,5
Luxs,tichondrius,96,paladin,holy,6,1,5
Daz,spinebreaker,96,paladin,holy,6,1,5
Wings,arygos,96,paladin,holy,6,1,5
Combidin,garrosh,96,paladin,holy,6,1,5
Romeh,malganis,96,paladin,holy,6,1,5
Ploppers,sargeras,96,paladin,holy,6,1,5
Silreck,ragnaros,96,paladin,holy,6,1,5
Zwilliam,frostmourne,96,paladin,holy,6,1,5
Couchz,area-52,96,paladin,holy,6,1,5
Parzsival,blood-furnace,96,paladin,holy,6,1,5
Shartea,moon-guard,96,paladin,holy,6,1,5
Yikyok,stormrage,96,paladin,holy,6,1,5
Elronda,malganis,96,paladin,holy,6,1,5
Phpremium,dalaran,96,paladin,holy,6,1,5
Oofky,ragnaros,96,paladin,holy,6,1,5
Traditionalp,area-52,96,paladin,holy,6,1,5
Tetulia,quelthalas,96,paladin,holy,6,1,5
Palabora,kelthuzad,96,paladin,holy,6,1,5
Jeffylolmar,sargeras,96,paladin,holy,6,1,5
Boppal,tichondrius,96,paladin,holy,6,1,5
Khaosactual,proudmoore,96,paladin,holy,6,1,5
Chakris,wyrmrest-accord,96,paladin,holy,6,1,5
Arturias,kiljaeden,96,paladin,holy,6,1,5
Antigone,tichondrius,96,paladin,holy,6,1,5
ßls,illidan,96,paladin,holy,6,1,5
Razuel,frostmourne,96,paladin,holy,6,1,5
Oncehumanoid,stormrage,96,paladin,holy,6,1,5
Therëv,zuljin,96,paladin,holy,6,1,5
Lgbtq,trollbane,96,paladin,holy,6,1,5
Komugì,thrall,96,paladin,holy,6,1,5
Crosjudge,zuljin,96,paladin,holy,6,1,5
Cremefraichè,tichondrius,96,paladin,holy,6,1,5
Zoneyy,proudmoore,96,paladin,holy,6,1,5
Vîxey,ragnaros,96,paladin,holy,6,1,5
Kaynè,senjin,96,paladin,holy,6,1,5
Burgasari,tichondrius,96,paladin,holy,6,1,5
Greddlok,rivendare,96,paladin,holy,6,1,5
Hibunny,thaurissan,96,paladin,holy,6,1,5
Owllii,frostwolf,96,paladin,holy,6,1,5
Tradorel,illidan,96,paladin,holy,6,1,5
Keltheas,rivendare,96,paladin,holy,6,1,5
Tfcpaladin,the-forgotten-coast,96,paladin,holy,6,1,5
Trixzthot,barthilas,96,paladin,holy,6,1,5
Bayraa,tichondrius,96,paladin,holy,6,1,5
Rhinno,lothar,96,paladin,holy,6,1,5
Tarpeeksi,tichondrius,96,paladin,holy,6,1,5
Sherrill,nagrand,96,paladin,holy,6,1,5
Victores,illidan,96,paladin,holy,6,1,5
Ripadin,dunemaul,96,paladin,holy,11,1,10
Grîshnâkh,ragnaros,96,paladin,holy,11,1,10
Rockysh,tichondrius,96,paladin,holy,12,1,11
Dapallytroll,area-52,96,paladin,holy,12,1,11
Ordained,moonrunner,96,paladin,holy,12,1,11
Midnightboto,dragonmaw,96,paladin,holy,12,1,11
Nickpala,bleeding-hollow,96,paladin,holy,12,1,11
Zentrick,whisperwind,96,paladin,holy,12,1,11
Jwilks,black-dragonflight,96,paladin,holy,12,1,11
Jumahji,illidan,96,paladin,holy,12,1,11
Pedin,stormrage,96,paladin,holy,12,1,11
Lafawndah,blackhand,96,paladin,holy,12,1,11
Soloist,tichondrius,96,paladin,holy,12,1,11
Yccorz,frostmourne,96,paladin,holy,12,1,11
Vexe,emerald-dream,96,paladin,holy,12,1,11
Aenwyl,quelthalas,96,paladin,holy,24,1,23
Arlé,stormrage,95,paladin,holy,6,1,5
Ååron,thrall,89,paladin,holy,11,3,8
Emilywilis,sargeras,84,paladin,holy,17,5,12
Zaeris,proudmoore,79,paladin,holy,5,1,4
Athenia,moon-guard,63,paladin,holy,6,3,3
Paladinkofwa,tichondrius,48,paladin,holy,3,1,2
Jkethuhsnake,ghostlands,48,paladin,holy,21,1,20
Burgermeat,bleeding-hollow,42,paladin,holy,9,2,7
Alpinestârs,tichondrius,42,paladin,holy,9,2,7
Justinbebr,tichondrius,42,paladin,holy,14,3,11
Kziwei,stormrage,31,paladin,holy,2,1,1
Shkafell,ragnaros,9,paladin,holy,8,2,6
Oghal,frostmourne,9,paladin,holy,23,3,20
Vânguards,tichondrius,2250,paladin,retribution,111,62,49
Vanguards,tichondrius,2192,paladin,retribution,78,43,35
Imitlol,alexstrasza,2154,paladin,retribution,181,91,90
Zozo,zuljin,2152,paladin,retribution,95,50,45
Venguards,azralon,2151,paladin,retribution,127,68,59
Hamburgeryu,tichondrius,2119,paladin,retribution,100,49,51
Thørmento,azralon,2118,paladin,retribution,201,107,94
Notvelic,tichondrius,2111,paladin,retribution,146,74,72
Condiments,earthen-ring,2110,paladin,retribution,144,77,67
Coolvelic,tichondrius,2110,paladin,retribution,156,79,77
Angryvelic,tichondrius,2107,paladin,retribution,105,52,53
Evanguards,tichondrius,2105,paladin,retribution,202,102,100
Picachü,ragnaros,2104,paladin,retribution,125,63,62
Yuji,darkspear,2102,paladin,retribution,108,54,54
Shôtgun,tichondrius,2101,paladin,retribution,138,69,69
Tramatic,sargeras,2100,paladin,retribution,126,63,63
Xalarius,illidan,2096,paladin,retribution,65,33,32
Lanteranth,drenden,2096,paladin,retribution,204,102,102
Hollyflame,tichondrius,2077,paladin,retribution,191,97,94
Lvladen,sargeras,2065,paladin,retribution,84,41,43
Quitzz,tichondrius,2050,paladin,retribution,117,58,59
Dayuanzhong,tichondrius,2044,paladin,retribution,105,52,53
Bullmarket,tichondrius,2035,paladin,retribution,215,105,110
Thulêan,moon-guard,2035,paladin,retribution,215,105,110
Xexe,stormreaver,2030,paladin,retribution,150,74,76
Xiaoqingye,tichondrius,2026,paladin,retribution,113,59,54
Caperx,tichondrius,2026,paladin,retribution,66,31,35
Wasteddwolf,tichondrius,2025,paladin,retribution,177,90,87
Alicê,moon-guard,2018,paladin,retribution,84,41,43
Bartharious,malganis,2017,paladin,retribution,108,53,55
Slíckhuman,spinebreaker,2014,paladin,retribution,108,64,44
Iqt,moon-guard,2011,paladin,retribution,132,66,66
Furylolz,tichondrius,2009,paladin,retribution,70,35,35
Maledraenei,sargeras,2004,paladin,retribution,119,58,61
Mashbringer,moon-guard,2001,paladin,retribution,78,42,36
Mcconnell,sargeras,1988,paladin,retribution,66,40,26
Aldda,azralon,1988,paladin,retribution,134,63,71
Dreamcastx,tichondrius,1985,paladin,retribution,161,79,82
Genericuser,sargeras,1984,paladin,retribution,82,44,38
Ohuo,tichondrius,1983,paladin,retribution,328,175,153
Ryuseiblade,ragnaros,1983,paladin,retribution,120,56,64
Simplybést,zuljin,1981,paladin,retribution,180,88,92
Swurvezx,bleeding-hollow,1976,paladin,retribution,59,37,22
Ashenhallow,alexstrasza,1973,paladin,retribution,42,27,15
Møemøeda,illidan,1973,paladin,retribution,60,28,32
Bigdickrick,ragnaros,1972,paladin,retribution,54,32,22
Ämoureux,bleeding-hollow,1970,paladin,retribution,141,67,74
Theblèss,tichondrius,1969,paladin,retribution,127,59,68
Yccorz,frostmourne,1968,paladin,retribution,230,118,112
Conndiment,earthen-ring,1968,paladin,retribution,90,45,45
Holychris,shadowmoon,1968,paladin,retribution,144,67,77
Smortain,tichondrius,1966,paladin,retribution,95,44,51
Caveyodeler,zuluhed,1962,paladin,retribution,66,31,35
Kubota,sargeras,1958,paladin,retribution,60,36,24
Dreamcastz,tichondrius,1957,paladin,retribution,48,33,15
Kurôsh,kalecgos,1955,paladin,retribution,96,52,44
Draenkz,quelthalas,1954,paladin,retribution,57,37,20
Damionblade,proudmoore,1953,paladin,retribution,265,141,124
Ðori,tichondrius,1952,paladin,retribution,82,38,44
Kraggar,arthas,1951,paladin,retribution,66,41,25
Lazypally,frostmourne,1951,paladin,retribution,66,35,31
Scathol,tichondrius,1950,paladin,retribution,78,38,40
Enjoy,frostmourne,1947,paladin,retribution,60,34,26
Xuantianchai,tichondrius,1944,paladin,retribution,60,36,24
Bøgård,sargeras,1941,paladin,retribution,299,151,148
Dratzq,ragnaros,1938,paladin,retribution,90,49,41
Daxxj,akama,1937,paladin,retribution,164,77,87
Mikeqiaodan,tichondrius,1936,paladin,retribution,150,75,75
Nbtv,tichondrius,1931,paladin,retribution,78,36,42
Indivisionxp,tichondrius,1928,paladin,retribution,55,34,21
Omnnii,tichondrius,1928,paladin,retribution,71,38,33
Fossilz,sargeras,1927,paladin,retribution,59,31,28
Xxwitcherxx,stormrage,1926,paladin,retribution,129,70,59
Mwqyyds,tichondrius,1915,paladin,retribution,148,71,77
Xuanxingchai,tichondrius,1915,paladin,retribution,83,35,48
Monkeypala,dathremar,1911,paladin,retribution,54,30,24
Metallíka,nemesis,1910,paladin,retribution,77,36,41
Memorisë,ragnaros,1907,paladin,retribution,283,146,137
Ozzium,ragnaros,1907,paladin,retribution,161,80,81
Hammrekt,illidan,1905,paladin,retribution,48,25,23
Furgalicious,area-52,1904,paladin,retribution,125,60,65
Bestowed,moon-guard,1903,paladin,retribution,93,46,47
Valytonz,wyrmrest-accord,1901,paladin,retribution,78,38,40
Angelguards,tichondrius,1900,paladin,retribution,60,30,30
Clapstick,illidan,1900,paladin,retribution,72,33,39
Zanthus,shadow-council,1896,paladin,retribution,35,20,15
Dadadalala,tichondrius,1895,paladin,retribution,36,20,16
Danceholy,tichondrius,1894,paladin,retribution,81,39,42
Cønk,khadgar,1892,paladin,retribution,170,100,70
Kamadonezuko,illidan,1892,paladin,retribution,89,44,45
Asukaba,sargeras,1892,paladin,retribution,80,37,43
Bluerunebar,illidan,1890,paladin,retribution,60,33,27
Peledin,azralon,1890,paladin,retribution,95,48,47
Attkdmgcurry,illidan,1890,paladin,retribution,71,34,37
Dtaitou,tichondrius,1889,paladin,retribution,60,28,32
Dankrachet,thrall,1888,paladin,retribution,72,35,37
Vendatha,darkspear,1887,paladin,retribution,30,25,5
Hellsingwolf,zuljin,1885,paladin,retribution,30,20,10
Pécorino,malganis,1884,paladin,retribution,52,31,21
Palypants,proudmoore,1881,paladin,retribution,43,21,22
Iäl,tichondrius,1881,paladin,retribution,71,31,40
Alpinestârs,tichondrius,1880,paladin,retribution,158,75,83
Zeldoul,magtheridon,1879,paladin,retribution,71,36,35
Homelanderp,tichondrius,1879,paladin,retribution,81,41,40
Ðiviñe,zuluhed,1878,paladin,retribution,160,86,74
Savøx,sargeras,1875,paladin,retribution,177,100,77
Roushex,sargeras,1875,paladin,retribution,72,35,37
Matthrian,moon-guard,1875,paladin,retribution,90,38,52
Voidaz,stormscale,1873,paladin,retribution,60,31,29
Attkdamdam,illidan,1871,paladin,retribution,54,26,28
Beautiful,proudmoore,1870,paladin,retribution,135,72,63
Fairgame,dathremar,1869,paladin,retribution,60,28,32
Koyoikonan,tichondrius,1867,paladin,retribution,42,28,14
Alexjones,stormrage,1866,paladin,retribution,78,43,35
Bohring,bleeding-hollow,1865,paladin,retribution,54,29,25
Parlore,moon-guard,1865,paladin,retribution,168,89,79
Xilio,tichondrius,1865,paladin,retribution,72,36,36
Pallehx,tichondrius,1862,paladin,retribution,71,33,38
Juffury,illidan,1861,paladin,retribution,66,32,34
Getmeabag,tichondrius,1861,paladin,retribution,54,25,29
Slaneesh,ragnaros,1861,paladin,retribution,72,30,42
Sweetfish,kiljaeden,1860,paladin,retribution,65,36,29
Talymra,ragnaros,1860,paladin,retribution,72,38,34
Víkk,zuljin,1860,paladin,retribution,182,94,88
Galeatus,tichondrius,1860,paladin,retribution,73,30,43
Teniale,moon-guard,1859,paladin,retribution,54,28,26
Chuoo,proudmoore,1859,paladin,retribution,46,22,24
Therëv,zuljin,1857,paladin,retribution,101,50,51
Ksvoten,azralon,1856,paladin,retribution,53,31,22
Dréveleth,quelthalas,1856,paladin,retribution,143,67,76
Saakero,illidan,1855,paladin,retribution,60,32,28
Retroreq,tichondrius,1854,paladin,retribution,166,88,78
Alecx,tichondrius,1853,paladin,retribution,58,33,25
Marthellus,quelthalas,1853,paladin,retribution,79,38,41
Subtilizer,tichondrius,1851,paladin,retribution,48,32,16
Foofs,shadowmoon,1851,paladin,retribution,53,26,27
Gelosagrado,illidan,1850,paladin,retribution,165,75,90
Solanin,frostmourne,1849,paladin,retribution,35,20,15
Burnning,tichondrius,1849,paladin,retribution,57,30,27
Hurv,area-52,1848,paladin,retribution,53,30,23
Moocowd,senjin,1847,paladin,retribution,66,35,31
Miktley,area-52,1847,paladin,retribution,66,32,34
Iloveqiqi,sargeras,1846,paladin,retribution,54,26,28
Retxsilver,thrall,1845,paladin,retribution,136,69,67
Sacredknight,kelthuzad,1845,paladin,retribution,48,23,25
Mixz,bleeding-hollow,1843,paladin,retribution,60,36,24
Nishru,sargeras,1843,paladin,retribution,60,32,28
Auxilio,arathor,1843,paladin,retribution,60,29,31
Divinehammer,proudmoore,1843,paladin,retribution,66,31,35
Lejeñd,stormrage,1842,paladin,retribution,65,34,31
Mikhàël,stormscale,1840,paladin,retribution,52,37,15
Truthkeeper,moon-guard,1840,paladin,retribution,47,23,24
Luosiding,tichondrius,1840,paladin,retribution,155,68,87
Chuckvandam,illidan,1839,paladin,retribution,54,36,18
Popje,zuljin,1839,paladin,retribution,36,20,16
Grifnballs,agamaggan,1839,paladin,retribution,56,31,25
Roguesmoker,zuljin,1839,paladin,retribution,59,31,28
Sukilol,tichondrius,1839,paladin,retribution,114,58,56
Immobilized,frostmourne,1839,paladin,retribution,58,29,29
Mvpj,medivh,1839,paladin,retribution,48,23,25
Ilaaria,moon-guard,1838,paladin,retribution,66,44,22
Zanur,tichondrius,1837,paladin,retribution,160,80,80
Kushsessions,zuljin,1837,paladin,retribution,42,20,22
Alodorx,tichondrius,1836,paladin,retribution,36,23,13
Vip,frostmourne,1836,paladin,retribution,108,55,53
Paladincane,sargeras,1835,paladin,retribution,185,99,86
Avenging,wyrmrest-accord,1835,paladin,retribution,62,32,30
Kangsang,illidan,1835,paladin,retribution,70,33,37
Lolcraftv,tichondrius,1834,paladin,retribution,60,30,30
Dkdldkdld,tichondrius,1833,paladin,retribution,36,27,9
Lilglick,illidan,1833,paladin,retribution,36,21,15
Holyfused,illidan,1833,paladin,retribution,53,28,25
Masqadin,tichondrius,1832,paladin,retribution,36,26,10
Shiryn,illidan,1832,paladin,retribution,62,33,29
Leonilx,tichondrius,1832,paladin,retribution,48,21,27
Kaitúr,stormrage,1831,paladin,retribution,56,29,27
ßò,area-52,1830,paladin,retribution,46,31,15
Hge,proudmoore,1830,paladin,retribution,53,32,21
Awbie,moon-guard,1830,paladin,retribution,60,30,30
Dubliner,garona,1830,paladin,retribution,47,23,24
Eldenblade,moon-guard,1829,paladin,retribution,54,31,23
Honeydutchtv,black-dragonflight,1829,paladin,retribution,174,79,95
Hammrekt,kelthuzad,1829,paladin,retribution,47,20,27
Chainsapally,stormrage,1828,paladin,retribution,54,38,16
Palabora,kelthuzad,1828,paladin,retribution,53,28,25
Bornterrible,queldorei,1828,paladin,retribution,54,25,29
Idenline,moon-guard,1827,paladin,retribution,59,30,29
Blake,frostmourne,1827,paladin,retribution,53,24,29
Wolfs,firetree,1826,paladin,retribution,66,29,37
Alxndrr,area-52,1825,paladin,retribution,108,58,50
Apollidin,malganis,1825,paladin,retribution,111,50,61
Lyrz,sargeras,1824,paladin,retribution,115,69,46
Monchmon,tichondrius,1824,paladin,retribution,47,24,23
Praysnblaze,zuljin,1824,paladin,retribution,55,28,27
Zèrà,thunderhorn,1823,paladin,retribution,54,26,28
Pantufä,stormrage,1822,paladin,retribution,53,29,24
Jonathein,barthilas,1822,paladin,retribution,138,72,66
Saradomin,kelthuzad,1822,paladin,retribution,129,66,63
Cryof,illidan,1822,paladin,retribution,72,28,44
Saakadin,illidan,1821,paladin,retribution,48,29,19
Jereth,kelthuzad,1821,paladin,retribution,77,46,31
Olixx,blackrock,1821,paladin,retribution,54,30,24
Promethèus,jubeithos,1821,paladin,retribution,66,34,32
Kíngkáísér,azralon,1820,paladin,retribution,29,20,9
Malakor,thrall,1820,paladin,retribution,150,79,71
Fuchí,tichondrius,1820,paladin,retribution,218,106,112
Draidan,area-52,1819,paladin,retribution,131,81,50
Blackcandle,tichondrius,1819,paladin,retribution,48,29,19
Yorøchi,azralon,1819,paladin,retribution,57,31,26
Backdrop,proudmoore,1819,paladin,retribution,169,91,78
Geöspäwn,tichondrius,1819,paladin,retribution,39,20,19
Anbivilent,moon-guard,1819,paladin,retribution,48,23,25
Cardynivans,tichondrius,1819,paladin,retribution,67,25,42
Warstompgg,ragnaros,1818,paladin,retribution,36,25,11
Mervor,quelthalas,1818,paladin,retribution,60,29,31
Zett,jubeithos,1818,paladin,retribution,97,45,52
Dorex,moon-guard,1817,paladin,retribution,111,72,39
Dazargeros,moon-guard,1817,paladin,retribution,30,19,11
Nr,blood-furnace,1817,paladin,retribution,54,32,22
Comeuppance,wyrmrest-accord,1817,paladin,retribution,190,103,87
Evangelìne,darkspear,1816,paladin,retribution,48,32,16
Dwimberlike,ragnaros,1816,paladin,retribution,56,37,19
Chadsteroid,sargeras,1816,paladin,retribution,48,29,19
Xinqingle,tichondrius,1816,paladin,retribution,76,44,32
Kumdonia,illidan,1816,paladin,retribution,36,19,17
Kooi,illidan,1816,paladin,retribution,78,35,43
Tyrillian,aerie-peak,1816,paladin,retribution,48,21,27
Kíngkáiser,azralon,1815,paladin,retribution,46,27,19
Loisterly,bladefist,1814,paladin,retribution,128,70,58
Zulmay,malganis,1814,paladin,retribution,156,78,78
Traize,kelthuzad,1813,paladin,retribution,48,30,18
Ìshen,illidan,1813,paladin,retribution,54,30,24
Dorktanian,stormrage,1813,paladin,retribution,78,40,38
Heatyr,malganis,1813,paladin,retribution,59,28,31
Cagowhite,tichondrius,1813,paladin,retribution,50,23,27
Lovy,area-52,1813,paladin,retribution,66,30,36
Pallysmack,stormrage,1812,paladin,retribution,48,28,20
Arquidea,tichondrius,1812,paladin,retribution,114,61,53
Mürlin,illidan,1812,paladin,retribution,227,112,115
Gabbynator,emerald-dream,1812,paladin,retribution,59,28,31
Rethumtv,tichondrius,1812,paladin,retribution,72,30,42
Arkadiano,drakkari,1812,paladin,retribution,78,29,49
Triston,area-52,1810,paladin,retribution,120,66,54
Lilcyans,ragnaros,1810,paladin,retribution,66,34,32
Ienhova,area-52,1810,paladin,retribution,72,36,36
Primaryee,tichondrius,1810,paladin,retribution,121,53,68
Ladeon,proudmoore,1809,paladin,retribution,72,44,28
Émiluss,stormrage,1809,paladin,retribution,66,33,33
Beaconlol,proudmoore,1808,paladin,retribution,107,67,40
Fussyotter,stormreaver,1808,paladin,retribution,103,59,44
Rédbarön,illidan,1808,paladin,retribution,72,32,40
Màli,akama,1808,paladin,retribution,52,20,32
Stêvêts,tichondrius,1807,paladin,retribution,36,20,16
Downways,sargeras,1807,paladin,retribution,73,39,34
Profundity,area-52,1807,paladin,retribution,70,37,33
Ratg,frostmourne,1807,paladin,retribution,46,24,22
Andelko,tichondrius,1807,paladin,retribution,46,23,23
Strøngkiing,bleeding-hollow,1807,paladin,retribution,66,31,35
Velstadt,sargeras,1807,paladin,retribution,66,29,37
Jhasøn,quelthalas,1806,paladin,retribution,60,40,20
Pornenjoyer,dalaran,1806,paladin,retribution,30,19,11
Darcobs,ragnaros,1806,paladin,retribution,172,90,82
Kishou,stormrage,1806,paladin,retribution,39,20,19
Pambeazley,bronzebeard,1806,paladin,retribution,46,23,23
Mortaine,moon-guard,1806,paladin,retribution,204,101,103
Zeyrox,stormrage,1806,paladin,retribution,54,26,28
Pramethious,sargeras,1806,paladin,retribution,72,34,38
Erodan,moon-guard,1806,paladin,retribution,88,38,50
Annihilàtion,frostmourne,1805,paladin,retribution,42,30,12
Ipomaikai,dragonmaw,1805,paladin,retribution,30,19,11
Çestlavie,korgath,1805,paladin,retribution,90,51,39
Antlkd,quelthalas,1805,paladin,retribution,59,31,28
Angelicwhim,stormrage,1805,paladin,retribution,48,25,23
Christtel,stormrage,1805,paladin,retribution,72,36,36
Koketsu,ragnaros,1805,paladin,retribution,219,109,110
Huuzhaa,tichondrius,1805,paladin,retribution,92,44,48
Panncakeman,tichondrius,1804,paladin,retribution,60,33,27
Ironblade,zuljin,1804,paladin,retribution,54,29,25
Outkas,area-52,1804,paladin,retribution,54,28,26
Palli,moon-guard,1804,paladin,retribution,60,31,29
Lumbersnack,moon-guard,1804,paladin,retribution,75,36,39
Thantore,scilla,1804,paladin,retribution,76,34,42
Justicejosh,frostmourne,1803,paladin,retribution,42,25,17
Reypally,dalaran,1803,paladin,retribution,132,66,66
Niubcjq,tichondrius,1803,paladin,retribution,42,19,23
Lucy,sargeras,1803,paladin,retribution,72,32,40
Disappearing,stormrage,1802,paladin,retribution,48,31,17
Arkcadius,frostmourne,1802,paladin,retribution,96,52,44
Sâdê,bleeding-hollow,1802,paladin,retribution,36,19,17
Tèhflip,tichondrius,1801,paladin,retribution,36,19,17
Gunderbok,emerald-dream,1801,paladin,retribution,63,33,30
Mabia,tichondrius,1801,paladin,retribution,72,37,35
Iloveyouxoxo,tichondrius,1800,paladin,retribution,54,29,25
Duhvine,malganis,1800,paladin,retribution,41,22,19
Ashkandi,tichondrius,1800,paladin,retribution,101,53,48
Sôck,zuljin,1800,paladin,retribution,44,22,22
Kalgormoth,ragnaros,1800,paladin,retribution,89,43,46
Ha,bleeding-hollow,1800,paladin,retribution,64,26,38
Määx,bleeding-hollow,1799,paladin,retribution,42,25,17
Ulcerà,azralon,1797,paladin,retribution,61,28,33
Shotgunzs,tichondrius,1796,paladin,retribution,54,22,32
Joeschmo,area-52,1795,paladin,retribution,48,29,19
Dúrnir,stormscale,1794,paladin,retribution,30,19,11
Kádabrak,tichondrius,1794,paladin,retribution,54,34,20
Obsolete,onyxia,1793,paladin,retribution,108,53,55
Coldzerox,ragnaros,1792,paladin,retribution,173,87,86
Raxadin,stormrage,1791,paladin,retribution,54,29,25
Chadatron,tichondrius,1791,paladin,retribution,42,21,21
Dippedxd,tichondrius,1790,paladin,retribution,78,43,35
Johnmacclane,azralon,1790,paladin,retribution,183,98,85
Galatus,tichondrius,1790,paladin,retribution,59,26,33
Puredecuy,ragnaros,1787,paladin,retribution,72,32,40
Pomboxd,stormrage,1786,paladin,retribution,89,50,39
Apnea,ragnaros,1786,paladin,retribution,186,89,97
Youguessedit,stormrage,1785,paladin,retribution,30,19,11
Areuss,tichondrius,1783,paladin,retribution,41,22,19
Abegáil,area-52,1783,paladin,retribution,54,28,26
Giørther,ragnaros,1783,paladin,retribution,57,29,28
Retsaíyan,tichondrius,1783,paladin,retribution,66,31,35
Honeybunza,area-52,1782,paladin,retribution,80,42,38
Rasler,stormrage,1782,paladin,retribution,186,95,91
Judgejudyx,sargeras,1781,paladin,retribution,31,21,10
Lunalunar,quelthalas,1781,paladin,retribution,65,30,35
Moød,ragnaros,1780,paladin,retribution,95,53,42
Whathehell,black-dragonflight,1780,paladin,retribution,228,115,113
Toughxguy,sargeras,1780,paladin,retribution,116,58,58
Soverejgn,bleeding-hollow,1780,paladin,retribution,422,205,217
Naverpay,tichondrius,1779,paladin,retribution,40,22,18
Dampenedxd,bleeding-hollow,1779,paladin,retribution,98,45,53
Robo,tichondrius,1778,paladin,retribution,30,19,11
Zakladchick,illidan,1778,paladin,retribution,48,26,22
Incubus,rexxar,1778,paladin,retribution,66,30,36
Nhsvikings,bleeding-hollow,1777,paladin,retribution,59,31,28
Galedance,tichondrius,1777,paladin,retribution,52,25,27
Litium,frostmourne,1776,paladin,retribution,54,30,24
Hargol,stormrage,1776,paladin,retribution,102,47,55
Mardùk,stormrage,1775,paladin,retribution,45,30,15
Animepower,moon-guard,1775,paladin,retribution,144,80,64
Hallmark,kelthuzad,1775,paladin,retribution,60,28,32
Titannious,stormrage,1772,paladin,retribution,119,61,58
Thebless,tichondrius,1770,paladin,retribution,47,27,20
Htmlar,tichondrius,1770,paladin,retribution,70,30,40
Filthyape,wyrmrest-accord,1769,paladin,retribution,118,73,45
Syleith,shadow-council,1768,paladin,retribution,115,54,61
Rahkinishu,khaz-modan,1766,paladin,retribution,189,109,80
Talivar,kelthuzad,1766,paladin,retribution,156,89,67
Bigdogchief,stormrage,1765,paladin,retribution,42,24,18
Aegious,darkspear,1764,paladin,retribution,42,22,20
Tofuupal,tichondrius,1764,paladin,retribution,78,38,40
Dippedlol,tichondrius,1762,paladin,retribution,48,28,20
Teknik,stormscale,1760,paladin,retribution,150,74,76
Younghova,kelthuzad,1759,paladin,retribution,96,43,53
Marvallous,area-52,1758,paladin,retribution,90,50,40
Britanybich,area-52,1757,paladin,retribution,72,36,36
Knuckifubuck,illidan,1756,paladin,retribution,36,22,14
Berryblast,shadowmoon,1755,paladin,retribution,48,32,16
Danaimei,tichondrius,1755,paladin,retribution,56,31,25
Quinnzel,barthilas,1754,paladin,retribution,74,41,33
Bigdaddysdic,illidan,1752,paladin,retribution,114,58,56
Neonblade,illidan,1752,paladin,retribution,88,42,46
Adamantïum,azralon,1751,paladin,retribution,72,27,45
Scarotv,malganis,1750,paladin,retribution,60,29,31
Plniss,tichondrius,1749,paladin,retribution,66,34,32
Rethir,illidan,1746,paladin,retribution,65,40,25
Rugay,sargeras,1745,paladin,retribution,29,19,10
Traceless,emerald-dream,1745,paladin,retribution,111,66,45
Pérona,tichondrius,1744,paladin,retribution,48,25,23
Ibullyourmom,tichondrius,1744,paladin,retribution,137,68,69
Thebubbajay,illidan,1743,paladin,retribution,54,31,23
Htnhy,aegwynn,1743,paladin,retribution,60,24,36
Rashbringer,azgalor,1742,paladin,retribution,67,34,33
Yérn,barthilas,1742,paladin,retribution,42,21,21
Josxth,stormrage,1741,paladin,retribution,54,29,25
Mmbakes,shadowsong,1740,paladin,retribution,36,22,14
Tuuro,stormrage,1740,paladin,retribution,241,120,121
Galess,tichondrius,1740,paladin,retribution,60,24,36
Helldevil,zuljin,1739,paladin,retribution,48,25,23
Lundor,ragnaros,1739,paladin,retribution,137,66,71
Popwings,azralon,1738,paladin,retribution,52,27,25
Nitemareforu,stormreaver,1735,paladin,retribution,90,54,36
Lecheroø,tichondrius,1735,paladin,retribution,72,41,31
Gellehar,barthilas,1735,paladin,retribution,36,19,17
Shakalot,illidan,1735,paladin,retribution,114,55,59
Palimedic,sargeras,1734,paladin,retribution,114,55,59
Clee,sargeras,1732,paladin,retribution,111,58,53
Ítsyôúñötmé,tichondrius,1731,paladin,retribution,146,81,65
Rektwings,area-52,1731,paladin,retribution,60,28,32
Zoliz,tichondrius,1730,paladin,retribution,78,42,36
Orindel,tichondrius,1729,paladin,retribution,29,19,10
Galeast,tichondrius,1729,paladin,retribution,66,28,38
Alduur,aggramar,1728,paladin,retribution,48,30,18
Fylerz,blackhand,1728,paladin,retribution,90,49,41
Xiddin,frostmourne,1728,paladin,retribution,66,33,33
Triginhall,moon-guard,1727,paladin,retribution,89,43,46
Thrax,spirestone,1727,paladin,retribution,129,59,70
Cristø,stormrage,1727,paladin,retribution,72,30,42
Coleta,stormrage,1725,paladin,retribution,42,28,14
Nah,emerald-dream,1725,paladin,retribution,57,30,27
Nume,nesingwary,1724,paladin,retribution,64,26,38
Ponytail,dark-iron,1723,paladin,retribution,58,31,27
Riseandgrind,tichondrius,1723,paladin,retribution,36,18,18
Mihawk,drenden,1721,paladin,retribution,30,21,9
Marvinceo,stormreaver,1721,paladin,retribution,36,18,18
Arkantion,whisperwind,1720,paladin,retribution,59,37,22
Holywaffle,nemesis,1720,paladin,retribution,121,63,58
Wantsome,frostmourne,1719,paladin,retribution,55,25,30
Insanity,dethecus,1719,paladin,retribution,42,18,24
Toguro,kelthuzad,1718,paladin,retribution,97,55,42
Pheonixpally,azralon,1718,paladin,retribution,78,33,45
Retrachet,thrall,1717,paladin,retribution,42,21,21
Notae,icecrown,1717,paladin,retribution,42,21,21
Aora,kiljaeden,1717,paladin,retribution,60,24,36
Vanath,bleeding-hollow,1716,paladin,retribution,54,30,24
Éætûgýäëí,area-52,1716,paladin,retribution,42,18,24
Midheaven,moon-guard,1713,paladin,retribution,65,41,24
Ssjlimit,tichondrius,1713,paladin,retribution,53,27,26
Áldin,ragnaros,1711,paladin,retribution,40,23,17
Nqe,area-52,1711,paladin,retribution,94,54,40
Emaus,tichondrius,1711,paladin,retribution,72,28,44
Imcomingbro,blackrock,1710,paladin,retribution,56,27,29
Markcrisman,quelthalas,1709,paladin,retribution,45,22,23
Svinadin,emerald-dream,1708,paladin,retribution,36,21,15
Luzoscura,quelthalas,1708,paladin,retribution,78,43,35
Handyandy,kelthuzad,1708,paladin,retribution,108,47,61
Watchamebaba,malganis,1708,paladin,retribution,54,21,33
Palban,tichondrius,1706,paladin,retribution,78,43,35
Sathandrä,sargeras,1706,paladin,retribution,73,36,37
Lokâr,lightbringer,1706,paladin,retribution,66,30,36
Egirlret,tichondrius,1706,paladin,retribution,48,21,27
Omensageiro,azralon,1705,paladin,retribution,72,27,45
Oneaßoveall,azralon,1704,paladin,retribution,103,57,46
Remethea,sargeras,1704,paladin,retribution,188,95,93
Allixis,wyrmrest-accord,1704,paladin,retribution,52,22,30
Wutefuh,azgalor,1703,paladin,retribution,36,24,12
Genovah,sargeras,1703,paladin,retribution,36,22,14
Glowbulled,area-52,1703,paladin,retribution,60,32,28
Cuteluna,tichondrius,1703,paladin,retribution,54,28,26
Usdacertifed,lightnings-blade,1703,paladin,retribution,191,94,97
Bakafish,tichondrius,1702,paladin,retribution,24,18,6
Vapanor,ragnaros,1702,paladin,retribution,59,30,29
Sugnidrom,frostmourne,1700,paladin,retribution,58,31,27
Kaharule,akama,1700,paladin,retribution,46,20,26
Griffïth,thrall,1699,paladin,retribution,36,21,15
Buckey,kilrogg,1699,paladin,retribution,52,28,24
Lepirate,emerald-dream,1699,paladin,retribution,36,18,18
Voodoovon,tichondrius,1697,paladin,retribution,89,42,47
Bubblemark,tichondrius,1697,paladin,retribution,91,39,52
Izidar,tichondrius,1696,paladin,retribution,42,29,13
Ópsv,quelthalas,1696,paladin,retribution,173,97,76
Bizzaz,moon-guard,1696,paladin,retribution,72,30,42
Lidranas,sargeras,1695,paladin,retribution,57,35,22
Ledster,kelthuzad,1695,paladin,retribution,54,22,32
Axcvnz,draka,1694,paladin,retribution,42,23,19
Nadinebb,proudmoore,1694,paladin,retribution,54,23,31
Liadrives,area-52,1693,paladin,retribution,78,46,32
Zensargge,tichondrius,1693,paladin,retribution,84,34,50
Dazn,tichondrius,1693,paladin,retribution,78,26,52
Keltar,burning-blade,1692,paladin,retribution,30,18,12
Bisket,illidan,1692,paladin,retribution,59,29,30
Justnikop,tichondrius,1692,paladin,retribution,115,56,59
Shova,nemesis,1691,paladin,retribution,42,25,17
Dârkk,tichondrius,1691,paladin,retribution,36,20,16
Forzanapoli,tichondrius,1691,paladin,retribution,48,23,25
Clownfister,barthilas,1690,paladin,retribution,54,29,25
Elegan,frostmourne,1690,paladin,retribution,66,32,34
Xeldar,tichondrius,1689,paladin,retribution,72,37,35
Pickleret,emerald-dream,1689,paladin,retribution,108,51,57
Sandokhán,ragnaros,1689,paladin,retribution,53,25,28
Lasteroy,nemesis,1688,paladin,retribution,88,49,39
Bakapal,tichondrius,1688,paladin,retribution,96,51,45
Actionb,aggramar,1688,paladin,retribution,113,56,57
Solånar,bloodscalp,1688,paladin,retribution,55,24,31
Mønaka,tichondrius,1687,paladin,retribution,48,29,19
ßountystrike,sargeras,1687,paladin,retribution,60,26,34
Noctisu,tichondrius,1687,paladin,retribution,48,18,30
Pathalerix,eonar,1686,paladin,retribution,53,29,24
Healmeboi,tichondrius,1686,paladin,retribution,74,39,35
Borntobebad,barthilas,1686,paladin,retribution,36,18,18
Djdiogø,azralon,1686,paladin,retribution,104,50,54
Utherparty,frostmourne,1685,paladin,retribution,103,55,48
Tzakial,area-52,1685,paladin,retribution,60,25,35
Wing,frostwolf,1684,paladin,retribution,96,49,47
Lillm,malganis,1683,paladin,retribution,96,49,47
Konesky,dalaran,1683,paladin,retribution,57,27,30
Nizzy,caelestrasz,1683,paladin,retribution,42,18,24
Hînøkåmí,tichondrius,1681,paladin,retribution,42,24,18
Hólyélf,illidan,1680,paladin,retribution,102,44,58
Bravepala,tichondrius,1680,paladin,retribution,54,20,34
Sosalo,sargeras,1679,paladin,retribution,81,38,43
Sasorï,stormrage,1679,paladin,retribution,90,41,49
Insîght,frostmourne,1678,paladin,retribution,70,27,43
Lilthroatbby,malganis,1677,paladin,retribution,126,53,73
Siire,darkspear,1676,paladin,retribution,72,39,33
Syreqt,nemesis,1676,paladin,retribution,48,25,23
Semellem,bloodhoof,1675,paladin,retribution,60,28,32
Shieldheart,moon-guard,1674,paladin,retribution,42,23,19
Kuico,ragnaros,1674,paladin,retribution,48,24,24
Jelial,chogall,1673,paladin,retribution,69,35,34
Weike,barthilas,1673,paladin,retribution,100,45,55
Palajeans,stormrage,1672,paladin,retribution,40,23,17
Moolishous,frostmourne,1672,paladin,retribution,89,48,41
Todesgott,tichondrius,1671,paladin,retribution,42,25,17
Elëssar,ragnaros,1671,paladin,retribution,179,91,88
Chriskriego,frostmourne,1671,paladin,retribution,60,24,36
Bubbledober,tichondrius,1670,paladin,retribution,30,20,10
Pumperjer,tichondrius,1669,paladin,retribution,53,26,27
Boarfarmer,tichondrius,1669,paladin,retribution,48,23,25
Theseusz,tichondrius,1666,paladin,retribution,42,30,12
Sniper,uther,1666,paladin,retribution,54,29,25
Palejandro,illidan,1666,paladin,retribution,101,53,48
Powermonster,tichondrius,1666,paladin,retribution,42,19,23
Eurekasret,ragnaros,1665,paladin,retribution,113,60,53
Whosyadaddy,tichondrius,1665,paladin,retribution,148,73,75
Haiden,goldrinn,1665,paladin,retribution,55,23,32
Bübbleqt,exodar,1664,paladin,retribution,30,18,12
Anjurus,moon-guard,1664,paladin,retribution,42,24,18
Perturabeau,bonechewer,1664,paladin,retribution,58,33,25
Kozk,quelthalas,1663,paladin,retribution,213,121,92
Mazaltoff,proudmoore,1663,paladin,retribution,105,53,52
Jxke,barthilas,1663,paladin,retribution,41,20,21
Stompëd,proudmoore,1663,paladin,retribution,62,29,33
Garlond,moon-guard,1662,paladin,retribution,60,32,28
Finaljustice,sargeras,1661,paladin,retribution,30,19,11
Lalatinx,quelthalas,1661,paladin,retribution,108,54,54
Jucker,tichondrius,1661,paladin,retribution,54,23,31
Trippën,tichondrius,1660,paladin,retribution,229,119,110
Xenk,moon-guard,1659,paladin,retribution,34,18,16
Crismj,tichondrius,1659,paladin,retribution,78,41,37
Mesmi,moon-guard,1659,paladin,retribution,94,46,48
Selivara,zuljin,1659,paladin,retribution,42,20,22
Fatkidslag,sargeras,1659,paladin,retribution,42,19,23
Happybubbles,tichondrius,1658,paladin,retribution,42,25,17
Bigjiba,proudmoore,1658,paladin,retribution,48,25,23
Alyxandr,dalaran,1658,paladin,retribution,48,24,24
Redoubt,archimonde,1658,paladin,retribution,47,23,24
Daylin,tichondrius,1657,paladin,retribution,32,19,13
Thoreal,thrall,1657,paladin,retribution,84,41,43
Vanas,stormrage,1657,paladin,retribution,57,26,31
Slashnroses,tichondrius,1656,paladin,retribution,44,19,25
Waffletrain,tichondrius,1655,paladin,retribution,46,22,24
Reckcowning,area-52,1655,paladin,retribution,48,20,28
Alexese,area-52,1654,paladin,retribution,89,55,34
Paladinomg,darkspear,1654,paladin,retribution,130,74,56
Forthestreet,tichondrius,1654,paladin,retribution,88,48,40
Shirael,ragnaros,1654,paladin,retribution,84,41,43
Wîckèd,tichondrius,1654,paladin,retribution,47,21,26
Iggÿ,illidan,1654,paladin,retribution,70,30,40
Itzcupcake,illidan,1653,paladin,retribution,120,69,51
Oppressive,moon-guard,1653,paladin,retribution,380,188,192
Duffnroses,tichondrius,1653,paladin,retribution,60,27,33
Hozna,andorhal,1652,paladin,retribution,61,36,25
Konsentrate,tichondrius,1652,paladin,retribution,162,82,80
Alanthor,ragnaros,1652,paladin,retribution,150,74,76
Misbah,stormrage,1651,paladin,retribution,50,30,20
Lanach,lightbringer,1651,paladin,retribution,64,33,31
Orivia,spirestone,1651,paladin,retribution,54,26,28
Trixtur,tichondrius,1651,paladin,retribution,60,28,32
Rexx,frostmourne,1650,paladin,retribution,54,30,24
Sabotsaint,tichondrius,1649,paladin,retribution,72,29,43
Likzebawlz,tichondrius,1648,paladin,retribution,42,25,17
Zcho,proudmoore,1648,paladin,retribution,63,31,32
Ylilliana,illidan,1648,paladin,retribution,49,22,27
Lánná,tichondrius,1647,paladin,retribution,30,18,12
Divínos,area-52,1647,paladin,retribution,66,34,32
Claudleon,drakkari,1647,paladin,retribution,41,21,20
Nasnyl,stormrage,1646,paladin,retribution,42,20,22
Xerobite,quelthalas,1646,paladin,retribution,70,32,38
Parkwons,tichondrius,1646,paladin,retribution,66,26,40
Akâme,kelthuzad,1645,paladin,retribution,28,19,9
Holdup,moon-guard,1645,paladin,retribution,83,54,29
Amgirlinv,malganis,1645,paladin,retribution,32,20,12
Bigolcriddys,barthilas,1645,paladin,retribution,36,21,15
Geedee,ysera,1645,paladin,retribution,70,39,31
Gwff,tichondrius,1645,paladin,retribution,41,18,23
Eneraxx,proudmoore,1645,paladin,retribution,48,20,28
Yusha,barthilas,1644,paladin,retribution,47,32,15
Därth,azralon,1644,paladin,retribution,46,20,26
Palabeshar,area-52,1644,paladin,retribution,48,18,30
Yezzyll,korgath,1643,paladin,retribution,36,19,17
Blackpie,bleeding-hollow,1643,paladin,retribution,48,23,25
Jackstank,dragonmaw,1642,paladin,retribution,53,33,20
Diebygcd,tichondrius,1642,paladin,retribution,37,21,16
Seraphini,illidan,1642,paladin,retribution,65,34,31
Oathen,proudmoore,1642,paladin,retribution,56,27,29
Schmïtty,tichondrius,1642,paladin,retribution,48,23,25
Furdaddylant,drenden,1641,paladin,retribution,30,18,12
Practícal,moon-guard,1641,paladin,retribution,90,45,45
Serås,silvermoon,1640,paladin,retribution,66,43,23
Pockopea,arygos,1640,paladin,retribution,88,56,32
Shiadfang,tichondrius,1640,paladin,retribution,72,39,33
Angrytitan,tichondrius,1640,paladin,retribution,60,29,31
Lleo,nemesis,1640,paladin,retribution,118,54,64
Cøøkïë,frostmourne,1639,paladin,retribution,48,27,21
Craq,alexstrasza,1639,paladin,retribution,134,64,70
Candysugar,tichondrius,1638,paladin,retribution,30,18,12
Notneo,zuljin,1638,paladin,retribution,59,34,25
Weskar,garithos,1638,paladin,retribution,142,81,61
Ceyh,ragnaros,1638,paladin,retribution,53,25,28
Lirtheil,quelthalas,1637,paladin,retribution,36,21,15
Benoít,zuljin,1637,paladin,retribution,90,51,39
Brightstar,azjolnerub,1637,paladin,retribution,71,39,32
Dimdabbin,malganis,1637,paladin,retribution,42,22,20
Saccro,area-52,1637,paladin,retribution,114,57,57
Jud,frostmourne,1636,paladin,retribution,90,43,47
Frepz,illidan,1635,paladin,retribution,46,25,21
Amanzhul,quelthalas,1635,paladin,retribution,99,46,53
Gimlias,kelthuzad,1635,paladin,retribution,54,25,29
Nuggetpusher,thunderlord,1634,paladin,retribution,55,30,25
Nattandin,ragnaros,1634,paladin,retribution,42,22,20
Mílkywayx,stormrage,1634,paladin,retribution,108,54,54
Daddytoad,tichondrius,1634,paladin,retribution,66,32,34
Lightowen,draka,1634,paladin,retribution,46,22,24
Cyanss,ragnaros,1634,paladin,retribution,47,19,28
Beardy,emerald-dream,1633,paladin,retribution,60,36,24
Inmortall,illidan,1632,paladin,retribution,54,30,24
Ajulgedang,frostmourne,1632,paladin,retribution,120,57,63
Dreneisha,malganis,1631,paladin,retribution,42,22,20
Aiethyria,tichondrius,1630,paladin,retribution,30,18,12
Zayblade,dragonblight,1630,paladin,retribution,40,23,17
Tobaz,azralon,1630,paladin,retribution,85,48,37
Fistâcuffs,stormrage,1630,paladin,retribution,54,22,32
Ulrah,moon-guard,1629,paladin,retribution,120,68,52
Intense,moonrunner,1628,paladin,retribution,40,20,20
Derigoth,quelthalas,1628,paladin,retribution,42,20,22
Kíbá,malganis,1627,paladin,retribution,33,18,15
Làzårus,area-52,1627,paladin,retribution,56,30,26
Masqadin,stormrage,1627,paladin,retribution,36,17,19
Zazaron,kiljaeden,1627,paladin,retribution,54,24,30
Elcíd,quelthalas,1627,paladin,retribution,111,47,64
Ziberax,chogall,1626,paladin,retribution,64,40,24
Damnhammer,tichondrius,1626,paladin,retribution,42,26,16
Gareesa,wyrmrest-accord,1626,paladin,retribution,78,39,39
Gatzu,tichondrius,1626,paladin,retribution,54,24,30
Fluffnac,tichondrius,1625,paladin,retribution,30,17,13
Davinshki,stormrage,1625,paladin,retribution,55,31,24
Notbärry,area-52,1625,paladin,retribution,48,27,21
Tatánka,ragnaros,1625,paladin,retribution,54,29,25
Renckay,ragnaros,1625,paladin,retribution,99,52,47
Chajaaro,ragnaros,1625,paladin,retribution,67,33,34
Goons,frostmourne,1625,paladin,retribution,54,21,33
Ödin,scarlet-crusade,1623,paladin,retribution,48,26,22
Techno,tichondrius,1623,paladin,retribution,175,89,86
Radacos,emerald-dream,1623,paladin,retribution,160,80,80
Joeyrat,area-52,1623,paladin,retribution,42,20,22
Holyflopper,malganis,1623,paladin,retribution,48,21,27
Retrodino,anvilmar,1623,paladin,retribution,48,21,27
Alianór,tichondrius,1623,paladin,retribution,47,19,28
Cyrenity,tichondrius,1623,paladin,retribution,59,19,40
Litler,tichondrius,1622,paladin,retribution,44,30,14
Gobblerr,blackrock,1622,paladin,retribution,30,20,10
Bizarrap,quelthalas,1622,paladin,retribution,43,25,18
Munaru,illidan,1621,paladin,retribution,36,22,14
Pandoro,tichondrius,1621,paladin,retribution,55,33,22
Hazexd,illidan,1621,paladin,retribution,36,20,16
Dashhighborn,sargeras,1621,paladin,retribution,71,38,33
Faladrim,moon-guard,1621,paladin,retribution,160,84,76
Michaelsmith,frostmourne,1621,paladin,retribution,36,17,19
Aredel,drakkari,1621,paladin,retribution,53,24,29
Lêggy,moon-guard,1621,paladin,retribution,54,23,31
Rùckûs,tichondrius,1621,paladin,retribution,47,19,28
Rukkas,sargeras,1621,paladin,retribution,54,21,33
Yukíteru,illidan,1620,paladin,retribution,69,32,37
Merculios,stormrage,1619,paladin,retribution,63,34,29
Tronzyy,trollbane,1619,paladin,retribution,59,26,33
Bbtea,frostmourne,1619,paladin,retribution,48,20,28
Glørious,drakkari,1618,paladin,retribution,90,42,48
Hamerfall,tichondrius,1618,paladin,retribution,54,22,32
Sunnix,illidan,1618,paladin,retribution,48,17,31
Beefjustice,velen,1617,paladin,retribution,60,32,28
Aleríon,ragnaros,1617,paladin,retribution,181,92,89
Holiness,stormreaver,1617,paladin,retribution,48,18,30
Lawmower,sargeras,1616,paladin,retribution,54,32,22
Agamemnom,tichondrius,1616,paladin,retribution,227,116,111
Jackedx,sargeras,1615,paladin,retribution,36,21,15
Zadquel,ragnaros,1615,paladin,retribution,106,61,45
Inquisition,moon-guard,1615,paladin,retribution,30,17,13
Feelsögood,tichondrius,1615,paladin,retribution,45,24,21
Drholypurp,tichondrius,1615,paladin,retribution,59,31,28
Øðyn,sargeras,1615,paladin,retribution,59,30,29
Outstrike,tichondrius,1615,paladin,retribution,36,17,19
Thenextx,illidan,1615,paladin,retribution,66,22,44
Daweeki,area-52,1614,paladin,retribution,24,19,5
Raelan,icecrown,1614,paladin,retribution,77,52,25
Sevik,garithos,1614,paladin,retribution,78,40,38
Goldnhart,wyrmrest-accord,1614,paladin,retribution,78,37,41
Stax,moon-guard,1614,paladin,retribution,42,17,25
Bramot,moon-guard,1613,paladin,retribution,36,20,16
Xbloodknight,malganis,1613,paladin,retribution,50,27,23
Gattís,stormrage,1613,paladin,retribution,79,42,37
Milizi,zuljin,1613,paladin,retribution,72,32,40
Jessheim,emerald-dream,1613,paladin,retribution,42,18,24
Kurasi,frostmourne,1613,paladin,retribution,63,26,37
Milkmemamma,nordrassil,1612,paladin,retribution,36,21,15
Hakson,stormrage,1612,paladin,retribution,61,35,26
Whyta,azralon,1612,paladin,retribution,193,100,93
Telarøn,stormrage,1612,paladin,retribution,200,101,99
Hristian,tichondrius,1612,paladin,retribution,60,30,30
Kaithen,quelthalas,1612,paladin,retribution,248,123,125
Poisson,wildhammer,1612,paladin,retribution,60,27,33
Jvbai,area-52,1612,paladin,retribution,87,39,48
Halrix,stormrage,1611,paladin,retribution,60,34,26
Kevybevy,stormrage,1611,paladin,retribution,150,81,69
Lightslion,stormrage,1611,paladin,retribution,36,18,18
Accépting,sargeras,1611,paladin,retribution,90,43,47
Mordirhar,tichondrius,1611,paladin,retribution,90,39,51
Rahmie,kiljaeden,1611,paladin,retribution,96,41,55
Purejudgemnt,area-52,1610,paladin,retribution,54,33,21
Kadabrak,area-52,1610,paladin,retribution,36,17,19
Atair,antonidas,1609,paladin,retribution,36,21,15
Beeftink,tichondrius,1609,paladin,retribution,100,51,49
Allîe,malganis,1609,paladin,retribution,73,37,36
Battlepope,thrall,1609,paladin,retribution,59,27,32
Utherpendrag,bladefist,1609,paladin,retribution,78,32,46
Regivan,nemesis,1609,paladin,retribution,54,21,33
Rhodela,illidan,1608,paladin,retribution,95,52,43
Sololeveling,malganis,1608,paladin,retribution,98,48,50
Golden,tichondrius,1608,paladin,retribution,42,20,22
Ahsilum,frostmourne,1608,paladin,retribution,48,17,31
Holyroro,area-52,1607,paladin,retribution,44,26,18
Secksorcism,frostwolf,1607,paladin,retribution,42,24,18
Humbubble,cairne,1607,paladin,retribution,41,22,19
Hellfound,bleeding-hollow,1607,paladin,retribution,41,22,19
Shampin,alexstrasza,1607,paladin,retribution,72,38,34
Trolladin,rivendare,1607,paladin,retribution,110,51,59
Wde,zuljin,1607,paladin,retribution,43,18,25
Marehk,thrall,1606,paladin,retribution,59,32,27
Abigaile,ragnaros,1606,paladin,retribution,72,38,34
Shádøwy,nemesis,1606,paladin,retribution,61,32,29
Skilladin,zuljin,1606,paladin,retribution,77,40,37
Ibustcheeks,sargeras,1606,paladin,retribution,71,36,35
Southerly,tichondrius,1606,paladin,retribution,78,39,39
Aefuezar,earthen-ring,1606,paladin,retribution,56,28,28
Lit,alexstrasza,1606,paladin,retribution,52,22,30
Hurtmypp,stormrage,1605,paladin,retribution,48,31,17
Mfgspally,kelthuzad,1605,paladin,retribution,76,45,31
Pçpaladin,stormrage,1605,paladin,retribution,36,21,15
Uoenò,moon-guard,1605,paladin,retribution,41,23,18
Chrisader,stormrage,1605,paladin,retribution,36,19,17
Zarrakra,daggerspine,1605,paladin,retribution,99,52,47
Dïlly,area-52,1605,paladin,retribution,90,46,44
Ragarèn,emerald-dream,1605,paladin,retribution,42,20,22
Cuchuflaiz,drakkari,1604,paladin,retribution,30,17,13
Virtuosi,area-52,1604,paladin,retribution,42,23,19
Joltie,quelthalas,1604,paladin,retribution,220,119,101
Seantate,stormrage,1604,paladin,retribution,36,19,17
Xeniél,illidan,1604,paladin,retribution,36,19,17
Recliner,wyrmrest-accord,1604,paladin,retribution,36,19,17
Rycerzforge,ragnaros,1604,paladin,retribution,74,38,36
Trullz,illidan,1604,paladin,retribution,94,44,50
Rhegyna,quelthalas,1603,paladin,retribution,48,26,22
Plophero,moon-guard,1603,paladin,retribution,54,28,26
Tanishalfelf,stormrage,1603,paladin,retribution,36,18,18
Ÿøzsh,azralon,1603,paladin,retribution,66,30,36
Ascetic,barthilas,1603,paladin,retribution,218,99,119
Skylinator,bleeding-hollow,1603,paladin,retribution,59,26,33
Pocserpala,drakkari,1602,paladin,retribution,42,26,16
Palieop,aerie-peak,1601,paladin,retribution,30,18,12
Leona,stormrage,1601,paladin,retribution,34,20,14
Beshiki,hakkar,1601,paladin,retribution,358,180,178
Aeterias,dalaran,1601,paladin,retribution,202,101,101
Jowliet,stormrage,1601,paladin,retribution,36,17,19
Tonimâster,misha,1601,paladin,retribution,47,21,26
Dmghack,tichondrius,1601,paladin,retribution,42,17,25
Pallydestroy,stormrage,1601,paladin,retribution,48,17,31
Aethelwulf,stormrage,1600,paladin,retribution,42,24,18
Varekaì,frostmourne,1600,paladin,retribution,153,80,73
Sonatas,ursin,1599,paladin,retribution,39,21,18
Mcbroken,tichondrius,1599,paladin,retribution,45,22,23
Hupa,crushridge,1598,paladin,retribution,42,20,22
Samgonz,tichondrius,1597,paladin,retribution,54,32,22
Kymmy,ragnaros,1597,paladin,retribution,54,21,33
Imnoracist,thrall,1597,paladin,retribution,72,24,48
Løøsè,frostmourne,1595,paladin,retribution,36,20,16
Tyirr,kelthuzad,1595,paladin,retribution,138,65,73
Ellyee,jaedenar,1595,paladin,retribution,99,45,54
Dazedpal,tichondrius,1594,paladin,retribution,345,180,165
Layonhánd,ragnaros,1593,paladin,retribution,54,25,29
Fây,sargeras,1593,paladin,retribution,66,29,37
Umbrasanctus,daggerspine,1592,paladin,retribution,54,29,25
Nidalee,kilrogg,1591,paladin,retribution,48,20,28
Torinel,illidan,1590,paladin,retribution,35,17,18
Auralyon,tichondrius,1590,paladin,retribution,42,17,25
Aiseyqt,frostmourne,1589,paladin,retribution,114,70,44
Barcar,area-52,1589,paladin,retribution,39,21,18
Deepsearide,illidan,1589,paladin,retribution,155,82,73
Beardedbrute,korgath,1589,paladin,retribution,42,19,23
Fakesimp,illidan,1587,paladin,retribution,24,17,7
Royalfather,tichondrius,1587,paladin,retribution,52,31,21
Hedilyan,azralon,1587,paladin,retribution,96,48,48
Lucianz,ragnaros,1587,paladin,retribution,60,29,31
Sigmond,azralon,1587,paladin,retribution,63,28,35
Ilovecl,tichondrius,1586,paladin,retribution,54,32,22
Cowsecration,ragnaros,1585,paladin,retribution,24,17,7
Drízzy,ragnaros,1585,paladin,retribution,64,31,33
Swiftskillz,bleeding-hollow,1584,paladin,retribution,159,84,75
Ënfos,azralon,1584,paladin,retribution,42,20,22
Shïnjïtsu,tichondrius,1583,paladin,retribution,24,17,7
Lightlana,frostwolf,1583,paladin,retribution,68,34,34
Arlanso,frostmourne,1583,paladin,retribution,46,22,24
Noholy,nemesis,1583,paladin,retribution,67,28,39
Chuizz,frostmourne,1583,paladin,retribution,48,19,29
Stöneblood,moon-guard,1583,paladin,retribution,54,18,36
Wasembroder,ragnaros,1582,paladin,retribution,121,65,56
Dallyon,stormrage,1582,paladin,retribution,42,21,21
Taphos,icecrown,1581,paladin,retribution,53,30,23
Sinmca,moon-guard,1581,paladin,retribution,68,37,31
Lumaros,wyrmrest-accord,1581,paladin,retribution,54,29,25
Ulrìck,quelthalas,1580,paladin,retribution,65,39,26
Bastiion,stormrage,1580,paladin,retribution,88,43,45
Miniell,tichondrius,1580,paladin,retribution,36,17,19
Palaxoto,nemesis,1580,paladin,retribution,78,33,45
Borrus,malygos,1579,paladin,retribution,78,40,38
Sneeber,stormrage,1578,paladin,retribution,84,42,42
Rimjobrachel,barthilas,1577,paladin,retribution,86,42,44
Fuknshané,area-52,1577,paladin,retribution,68,32,36
Pirofosfato,azralon,1577,paladin,retribution,46,21,25
Anafensa,malganis,1577,paladin,retribution,66,27,39
Malacriianza,quelthalas,1576,paladin,retribution,54,30,24
Leztatium,quelthalas,1576,paladin,retribution,42,21,21
Amialra,moon-guard,1576,paladin,retribution,55,27,28
Fìlìgree,tichondrius,1574,paladin,retribution,55,30,25
Ruhn,eldrethalas,1574,paladin,retribution,36,18,18
Renzo,frostmourne,1574,paladin,retribution,63,28,35
Daleroth,ragnaros,1573,paladin,retribution,39,22,17
Tesak,emerald-dream,1573,paladin,retribution,114,58,56
Purdicks,emerald-dream,1572,paladin,retribution,158,79,79
Stackmymoney,kelthuzad,1572,paladin,retribution,50,22,28
Chancellor,azralon,1571,paladin,retribution,234,125,109
Tatakaicjq,tichondrius,1571,paladin,retribution,129,66,63
Tenacer,darkspear,1571,paladin,retribution,52,24,28
Mormdring,fizzcrank,1571,paladin,retribution,77,35,42
Spala,tichondrius,1571,paladin,retribution,75,32,43
Kdym,azralon,1570,paladin,retribution,30,19,11
Guerrer,hyjal,1568,paladin,retribution,72,39,33
Palmangels,bleeding-hollow,1568,paladin,retribution,44,18,26
Coffeepal,tichondrius,1567,paladin,retribution,48,23,25
Sammyste,elune,1566,paladin,retribution,98,55,43
Articilia,ragnaros,1566,paladin,retribution,42,22,20
Esçanór,darkspear,1566,paladin,retribution,61,30,31
Chiphazard,stormscale,1566,paladin,retribution,58,23,35
Nilin,tichondrius,1565,paladin,retribution,60,31,29
Troyamat,nemesis,1565,paladin,retribution,53,27,26
Andrilsteh,malganis,1565,paladin,retribution,108,48,60
Damndoi,tichondrius,1564,paladin,retribution,54,29,25
Fionno,quelthalas,1564,paladin,retribution,116,58,58
Bogùs,tichondrius,1564,paladin,retribution,54,26,28
Tantradin,area-52,1564,paladin,retribution,48,20,28
Blasstar,quelthalas,1563,paladin,retribution,53,27,26
Marcêl,quelthalas,1562,paladin,retribution,42,23,19
Mixnut,tichondrius,1561,paladin,retribution,65,27,38
Feannor,drakkari,1560,paladin,retribution,70,35,35
Baeflux,kelthuzad,1560,paladin,retribution,48,19,29
Pinkies,frostmourne,1559,paladin,retribution,93,49,44
Arturias,kiljaeden,1559,paladin,retribution,95,49,46
Darguen,ragnaros,1557,paladin,retribution,28,18,10
Lawbandit,tichondrius,1557,paladin,retribution,34,19,15
Chewyjitsu,tichondrius,1557,paladin,retribution,36,20,16
Razneroka,ragnaros,1557,paladin,retribution,51,27,24
Ironcoco,ragnaros,1557,paladin,retribution,53,27,26
Luret,tichondrius,1557,paladin,retribution,34,17,17
Insideous,kelthuzad,1557,paladin,retribution,69,34,35
Tarnyb,illidan,1557,paladin,retribution,50,23,27
Worder,tichondrius,1556,paladin,retribution,41,29,12
Vêgenace,proudmoore,1556,paladin,retribution,48,24,24
Missusomutch,azralon,1556,paladin,retribution,50,17,33
Fótm,bleeding-hollow,1555,paladin,retribution,78,38,40
Bawek,azralon,1555,paladin,retribution,60,25,35
Grifnshlong,agamaggan,1554,paladin,retribution,33,19,14
Bubblelol,bloodhoof,1554,paladin,retribution,98,42,56
Crybátt,quelthalas,1553,paladin,retribution,68,35,33
Luminiscente,ragnaros,1553,paladin,retribution,58,29,29
Skynn,stormrage,1553,paladin,retribution,36,18,18
Alexieus,wyrmrest-accord,1553,paladin,retribution,71,32,39
Ájummalukout,tichondrius,1553,paladin,retribution,63,25,38
Kissherlin,tichondrius,1552,paladin,retribution,30,18,12
Thastrian,stormreaver,1552,paladin,retribution,60,31,29
Yree,ragnaros,1552,paladin,retribution,78,37,41
Notoriouus,bleeding-hollow,1552,paladin,retribution,42,18,24
Yovan,proudmoore,1551,paladin,retribution,90,51,39
Souldrainlol,quelthalas,1551,paladin,retribution,48,27,21
Albïreo,drakkari,1550,paladin,retribution,54,28,26
Detrimentãl,nagrand,1550,paladin,retribution,69,33,36
Holyjoint,uther,1550,paladin,retribution,98,42,56
Souyiro,sargeras,1550,paladin,retribution,64,23,41
Mcholy,thrall,1549,paladin,retribution,50,27,23
Eustace,thunderhorn,1549,paladin,retribution,58,31,27
Zalndraeda,barthilas,1548,paladin,retribution,108,55,53
Caribourider,tichondrius,1548,paladin,retribution,65,29,36
Scrubble,thrall,1547,paladin,retribution,90,44,46
Evilmerdoc,kelthuzad,1547,paladin,retribution,54,26,28
Redemptiøn,nemesis,1547,paladin,retribution,66,26,40
Sozmsjackson,barthilas,1546,paladin,retribution,51,28,23
Alpengeist,turalyon,1546,paladin,retribution,60,29,31
Dgâza,tichondrius,1546,paladin,retribution,48,23,25
Lagwat,sargeras,1545,paladin,retribution,60,37,23
Sweetcandy,sargeras,1545,paladin,retribution,54,28,26
Varlip,wyrmrest-accord,1545,paladin,retribution,53,18,35
Lorienv,sargeras,1544,paladin,retribution,36,17,19
Cloaxy,azgalor,1543,paladin,retribution,181,86,95
Margit,moon-guard,1541,paladin,retribution,36,22,14
Björñ,moon-guard,1541,paladin,retribution,52,29,23
Thaldun,wyrmrest-accord,1541,paladin,retribution,95,41,54
Ðoflamingo,area-52,1540,paladin,retribution,72,38,34
Quadrifoglio,moon-guard,1540,paladin,retribution,138,70,68
Lygophobia,frostmourne,1539,paladin,retribution,42,22,20
Brokeniron,wyrmrest-accord,1539,paladin,retribution,66,31,35
Excalibur,amanthul,1539,paladin,retribution,43,19,24
Frùglé,sargeras,1538,paladin,retribution,36,20,16
Celethor,wyrmrest-accord,1537,paladin,retribution,54,30,24
Tìg,proudmoore,1537,paladin,retribution,143,79,64
Thepinkdept,proudmoore,1537,paladin,retribution,38,20,18
Neovincent,aggramar,1536,paladin,retribution,69,37,32
Aberpal,illidan,1535,paladin,retribution,41,23,18
Freddieroach,tichondrius,1535,paladin,retribution,72,33,39
Greciâ,ragnaros,1535,paladin,retribution,42,18,24
Hammrekt,sargeras,1534,paladin,retribution,24,16,8
Tearet,tichondrius,1534,paladin,retribution,24,16,8
Tæven,tichondrius,1534,paladin,retribution,36,16,20
Álkair,ragnaros,1534,paladin,retribution,83,36,47
Rxes,frostmourne,1534,paladin,retribution,105,45,60
Stônemôuntan,moon-guard,1534,paladin,retribution,84,29,55
Jager,medivh,1533,paladin,retribution,71,41,30
Cókelol,zuljin,1533,paladin,retribution,84,46,38
Snussp,emerald-dream,1533,paladin,retribution,75,38,37
Minidin,kiljaeden,1533,paladin,retribution,120,55,65
Retcuzyaknow,illidan,1533,paladin,retribution,36,16,20
Atterz,azralon,1532,paladin,retribution,46,21,25
Kattkaffe,tichondrius,1531,paladin,retribution,30,16,14
Yiqieyouwei,proudmoore,1531,paladin,retribution,55,25,30
Ezcoatl,stormrage,1530,paladin,retribution,92,47,45
Loyality,sargeras,1530,paladin,retribution,36,16,20
Schankyy,stormrage,1529,paladin,retribution,36,19,17
Unfairness,skullcrusher,1528,paladin,retribution,63,33,30
Ástridr,moon-guard,1528,paladin,retribution,95,43,52
Prettycure,illidan,1528,paladin,retribution,36,16,20
Ezpzxd,arygos,1527,paladin,retribution,116,58,58
Mundomaloo,quelthalas,1527,paladin,retribution,45,21,24
Hefaista,ragnaros,1527,paladin,retribution,42,16,26
Muffinknight,quelthalas,1526,paladin,retribution,66,44,22
Oneshotman,stormrage,1526,paladin,retribution,30,16,14
Kenpachí,doomhammer,1525,paladin,retribution,42,30,12
Venxpeita,azralon,1525,paladin,retribution,24,16,8
Swiftyflower,dawnbringer,1525,paladin,retribution,24,16,8
Tinymeatgang,misha,1524,paladin,retribution,36,19,17
Freiermoth,shadowmoon,1524,paladin,retribution,195,101,94
Holybirkkal,arthas,1524,paladin,retribution,56,29,27
Aoishie,bleeding-hollow,1524,paladin,retribution,108,54,54
Shaidd,bleeding-hollow,1524,paladin,retribution,98,49,49
Flykzu,azralon,1524,paladin,retribution,166,76,90
Jizii,tichondrius,1523,paladin,retribution,78,44,34
Xandia,aegwynn,1523,paladin,retribution,48,16,32
Holyshockss,stormrage,1522,paladin,retribution,30,16,14
Blitzzed,area-52,1522,paladin,retribution,35,18,17
Alacrity,shadowsong,1522,paladin,retribution,39,20,19
Dragin,azralon,1522,paladin,retribution,71,36,35
Landeren,khazgoroth,1522,paladin,retribution,66,29,37
Pvrisxx,frostmourne,1521,paladin,retribution,60,31,29
Whackadin,illidan,1521,paladin,retribution,67,32,35
Whitearmor,draenor,1520,paladin,retribution,69,41,28
Moutai,dalaran,1519,paladin,retribution,83,42,41
Castïël,area-52,1519,paladin,retribution,157,77,80
Andallar,nordrassil,1518,paladin,retribution,60,34,26
Gude,sargeras,1518,paladin,retribution,30,16,14
Shartea,moon-guard,1518,paladin,retribution,64,32,32
Reesescupz,kelthuzad,1518,paladin,retribution,66,26,40
Grubbyhands,tichondrius,1518,paladin,retribution,42,16,26
Worshipmex,tichondrius,1517,paladin,retribution,36,20,16
Relentless,magtheridon,1517,paladin,retribution,107,54,53
Arreliya,sargeras,1517,paladin,retribution,100,49,51
Lorenzinho,azralon,1516,paladin,retribution,80,42,38
Dzx,nemesis,1516,paladin,retribution,347,179,168
Sacredstella,illidan,1516,paladin,retribution,142,72,70
Soterios,daggerspine,1516,paladin,retribution,72,33,39
Sorhihi,illidan,1515,paladin,retribution,36,19,17
Ignasius,blood-furnace,1515,paladin,retribution,54,26,28
Gronmpa,nemesis,1514,paladin,retribution,41,25,16
Sephiroth,hyjal,1514,paladin,retribution,86,40,46
Kendren,ragnaros,1514,paladin,retribution,36,16,20
Bøble,thrall,1514,paladin,retribution,42,16,26
Luminainre,zuljin,1513,paladin,retribution,39,19,20
Rëtribution,tichondrius,1513,paladin,retribution,80,36,44
Howlerhead,illidan,1512,paladin,retribution,30,16,14
Kawkpaladin,kaelthas,1512,paladin,retribution,60,31,29
Bladetm,proudmoore,1512,paladin,retribution,119,59,60
Tagex,malganis,1511,paladin,retribution,161,75,86
Paradisso,tichondrius,1511,paladin,retribution,36,16,20
Guluge,sargeras,1510,paladin,retribution,24,16,8
Thazadin,barthilas,1510,paladin,retribution,28,17,11
Dachenkov,tichondrius,1510,paladin,retribution,30,17,13
Skuxxlord,khazgoroth,1509,paladin,retribution,30,16,14
Kaupe,barthilas,1509,paladin,retribution,41,16,25
Protein,magtheridon,1509,paladin,retribution,42,16,26
Mysticblade,sargeras,1508,paladin,retribution,54,31,23
Smashnasty,area-52,1508,paladin,retribution,48,27,21
Temote,anvilmar,1508,paladin,retribution,132,66,66
Jøestar,proudmoore,1508,paladin,retribution,82,39,43
Cyreus,emerald-dream,1508,paladin,retribution,57,26,31
Snoogans,korgath,1508,paladin,retribution,36,16,20
Miemiesage,illidan,1508,paladin,retribution,42,16,26
Sowasred,emerald-dream,1507,paladin,retribution,84,45,39
Xytoken,tichondrius,1507,paladin,retribution,77,38,39
Liquidkoala,lightbringer,1507,paladin,retribution,58,28,30
Yazuka,wyrmrest-accord,1506,paladin,retribution,54,30,24
Traditionalp,area-52,1506,paladin,retribution,39,21,18
Rethöe,tichondrius,1506,paladin,retribution,30,16,14
Istril,ragnaros,1506,paladin,retribution,292,152,140
Preacherfudd,area-52,1506,paladin,retribution,42,21,21
Bojanglz,frostmourne,1504,paladin,retribution,39,21,18
Cobaine,illidan,1504,paladin,retribution,131,62,69
Piea,tichondrius,1503,paladin,retribution,66,32,34
Eskannór,quelthalas,1502,paladin,retribution,42,18,24
Alphanerd,burning-blade,1501,paladin,retribution,42,26,16
Rohrn,firetree,1501,paladin,retribution,61,35,26
Donao,illidan,1501,paladin,retribution,90,50,40
Lichkingdenn,stormrage,1501,paladin,retribution,54,26,28
Mesaa,illidan,1501,paladin,retribution,39,18,21
Notae,alexstrasza,1501,paladin,retribution,35,16,19
Ezael,crushridge,1501,paladin,retribution,48,21,27
Rillumas,wyrmrest-accord,1501,paladin,retribution,71,30,41
Wickedpälly,kelthuzad,1499,paladin,retribution,42,25,17
Norlannd,ragnaros,1499,paladin,retribution,30,16,14
Morneau,malganis,1499,paladin,retribution,258,132,126
Kookamønga,tichondrius,1498,paladin,retribution,67,32,35
Mordered,proudmoore,1498,paladin,retribution,70,27,43
Hinataa,illidan,1497,paladin,retribution,81,45,36
Audris,chogall,1497,paladin,retribution,65,29,36
Snuggymuffin,barthilas,1496,paladin,retribution,46,27,19
Plusultra,moon-guard,1495,paladin,retribution,48,24,24
Superpaladin,stormrage,1495,paladin,retribution,65,32,33
Schwârts,blackrock,1494,paladin,retribution,70,36,34
Sprinkills,frostmourne,1493,paladin,retribution,48,31,17
Narsys,tichondrius,1493,paladin,retribution,109,50,59
ßabyshark,tichondrius,1493,paladin,retribution,36,16,20
Dartpuncher,frostmourne,1492,paladin,retribution,33,19,14
Upaitaon,stormrage,1491,paladin,retribution,58,29,29
Xdiegox,stormrage,1491,paladin,retribution,36,16,20
Týrael,uldum,1490,paladin,retribution,60,33,27
Sàgadegemeós,stormrage,1489,paladin,retribution,60,32,28
Kemono,dathremar,1488,paladin,retribution,73,42,31
Mathieü,zuljin,1488,paladin,retribution,36,20,16
Shishoknight,quelthalas,1488,paladin,retribution,73,32,41
Grîshnâkh,ragnaros,1487,paladin,retribution,119,61,58
Operise,stormrage,1487,paladin,retribution,48,24,24
Xk,kiljaeden,1487,paladin,retribution,72,33,39
Avvenging,tichondrius,1487,paladin,retribution,36,16,20
Balín,quelthalas,1486,paladin,retribution,25,18,7
Exwars,moon-guard,1485,paladin,retribution,32,21,11
Urpi,drakkari,1485,paladin,retribution,41,25,16
Whets,thrall,1485,paladin,retribution,96,48,48
Sancthia,area-52,1485,paladin,retribution,47,22,25
Haunter,akama,1485,paladin,retribution,54,25,29
Dcountt,area-52,1484,paladin,retribution,47,22,25
Wwanntae,tichondrius,1484,paladin,retribution,70,32,38
Kadbury,icecrown,1484,paladin,retribution,221,101,120
Natsîrt,bleeding-hollow,1483,paladin,retribution,46,27,19
Imhardirl,area-52,1483,paladin,retribution,29,17,12
Levian,spirestone,1483,paladin,retribution,90,46,44
Greasysteve,stormrage,1482,paladin,retribution,60,33,27
Janokaluo,wyrmrest-accord,1481,paladin,retribution,101,52,49
Orestis,stormrage,1480,paladin,retribution,45,24,21
Ralo,khaz-modan,1480,paladin,retribution,30,16,14
Cillessá,kelthuzad,1480,paladin,retribution,132,65,67
Forlam,sargeras,1480,paladin,retribution,108,45,63
Cålamìty,dalaran,1478,paladin,retribution,24,16,8
Imperious,anetheron,1478,paladin,retribution,60,34,26
Viclovin,stormrage,1478,paladin,retribution,58,30,28
Vaqoh,ragnaros,1478,paladin,retribution,42,17,25
Buddyolpally,proudmoore,1477,paladin,retribution,48,23,25
Killeralan,quelthalas,1477,paladin,retribution,74,34,40
Againstfilet,azralon,1477,paladin,retribution,106,43,63
Malandru,darrowmere,1477,paladin,retribution,93,37,56
Konthrus,azralon,1476,paladin,retribution,99,60,39
Airz,stormrage,1476,paladin,retribution,30,17,13
Giulio,moon-guard,1476,paladin,retribution,113,62,51
Limitier,proudmoore,1476,paladin,retribution,36,19,17
Bigpin,shattered-hand,1476,paladin,retribution,53,24,29
Pugnosano,black-dragonflight,1475,paladin,retribution,42,21,21
Holydiver,sargeras,1475,paladin,retribution,158,75,83
Kiritazuma,ravencrest,1475,paladin,retribution,84,39,45
Azoruken,quelthalas,1475,paladin,retribution,71,31,40
Arecht,moon-guard,1474,paladin,retribution,30,19,11
Gigadorff,stormrage,1474,paladin,retribution,60,37,23
Yamush,silver-hand,1474,paladin,retribution,80,40,40
Bubblless,thrall,1474,paladin,retribution,59,27,32
Sunraiz,tichondrius,1473,paladin,retribution,46,26,20
Fressbee,nathrezim,1473,paladin,retribution,41,19,22
Ichigò,sargeras,1472,paladin,retribution,48,30,18
Blulux,ragnaros,1472,paladin,retribution,101,55,46
Zuthora,alleria,1471,paladin,retribution,70,37,33
Ellanaria,thrall,1471,paladin,retribution,117,61,56
Yoboyindahiz,stormrage,1471,paladin,retribution,57,23,34
Rykorth,moon-guard,1470,paladin,retribution,33,20,13
Yawnbringer,tichondrius,1469,paladin,retribution,140,70,70
Mäýhëm,sargeras,1468,paladin,retribution,46,25,21
Reînhard,drakkari,1468,paladin,retribution,42,19,23
Polypal,zuljin,1468,paladin,retribution,42,18,24
Dimmadome,frostmourne,1465,paladin,retribution,78,50,28
Kanyewes,zuluhed,1465,paladin,retribution,71,35,36
Édzor,area-52,1465,paladin,retribution,48,19,29
Nicret,tichondrius,1464,paladin,retribution,24,18,6
Trapqueenlol,alterac-mountains,1464,paladin,retribution,66,27,39
Strabic,stormrage,1464,paladin,retribution,57,23,34
Toughlife,tichondrius,1464,paladin,retribution,72,28,44
Nohpalli,kelthuzad,1463,paladin,retribution,79,43,36
Bañe,lightbringer,1463,paladin,retribution,81,35,46
Bronytime,illidan,1462,paladin,retribution,29,16,13
Dreyan,wyrmrest-accord,1462,paladin,retribution,47,23,24
Sakicc,dalaran,1462,paladin,retribution,48,21,27
Són,ragnaros,1462,paladin,retribution,52,21,31
Sanguinata,shadowsong,1461,paladin,retribution,47,30,17
Crayt,tichondrius,1461,paladin,retribution,97,40,57
Konarik,stormrage,1459,paladin,retribution,46,25,21
Biloro,azralon,1458,paladin,retribution,54,33,21
Ereksean,sargeras,1458,paladin,retribution,50,26,24
Athenauwu,illidan,1458,paladin,retribution,40,19,21
Modafinil,bonechewer,1458,paladin,retribution,55,24,31
Dannyram,zuljin,1457,paladin,retribution,75,40,35
Bebopin,tichondrius,1457,paladin,retribution,58,29,29
Valardaharis,thunderlord,1457,paladin,retribution,100,43,57
Theholysword,tichondrius,1457,paladin,retribution,41,16,25
Dentarg,garrosh,1456,paladin,retribution,66,35,31
Erowyn,tichondrius,1456,paladin,retribution,42,19,23
Vindictacho,tichondrius,1456,paladin,retribution,42,18,24
Esixtytwoone,area-52,1455,paladin,retribution,30,21,9
Krypton,tichondrius,1455,paladin,retribution,36,22,14
Lettuceprey,the-underbog,1455,paladin,retribution,60,33,27
Silvabac,illidan,1455,paladin,retribution,70,38,32
Folgimar,moon-guard,1455,paladin,retribution,72,37,35
Thalorian,azshara,1455,paladin,retribution,51,25,26
Cryptdog,illidan,1455,paladin,retribution,87,40,47
Astharor,stormrage,1454,paladin,retribution,70,40,30
Layoya,aerie-peak,1454,paladin,retribution,34,19,15
Mádz,ragnaros,1454,paladin,retribution,29,16,13
Jorix,stormrage,1454,paladin,retribution,33,17,16
Wesdarian,jaedenar,1454,paladin,retribution,119,56,63
Urfavxbf,baelgun,1453,paladin,retribution,175,94,81
Quotation,silvermoon,1453,paladin,retribution,56,30,26
Sovereignt,aggramar,1453,paladin,retribution,157,84,73
Monchy,bleeding-hollow,1453,paladin,retribution,52,27,25
Carnagias,bleeding-hollow,1452,paladin,retribution,95,50,45
Vexxa,nerzhul,1451,paladin,retribution,36,18,18
Tacien,tichondrius,1451,paladin,retribution,112,54,58
Saphiraz,wildhammer,1451,paladin,retribution,42,17,25
Cyäbyë,frostmourne,1450,paladin,retribution,30,18,12
Drtom,mannoroth,1450,paladin,retribution,39,21,18
Hammerzite,whisperwind,1450,paladin,retribution,30,16,14
Liaadrin,azralon,1450,paladin,retribution,32,16,16
Gokuu,korgath,1450,paladin,retribution,90,44,46
Solandiis,tichondrius,1450,paladin,retribution,67,32,35
Prosykt,sargeras,1450,paladin,retribution,38,16,22
Airplane,malygos,1449,paladin,retribution,24,16,8
Jonfox,stormrage,1449,paladin,retribution,108,54,54
Shourins,tichondrius,1449,paladin,retribution,36,17,19
Lustros,stormrage,1449,paladin,retribution,66,28,38
Avati,sargeras,1448,paladin,retribution,22,16,6
Californía,bleeding-hollow,1448,paladin,retribution,37,23,14
Corrán,thrall,1448,paladin,retribution,36,20,16
Sconci,whisperwind,1448,paladin,retribution,48,22,26
Hamertime,wyrmrest-accord,1447,paladin,retribution,125,62,63
Bullzor,aerie-peak,1445,paladin,retribution,66,43,23
Glizzybertz,bleeding-hollow,1445,paladin,retribution,36,21,15
Angriel,azralon,1445,paladin,retribution,83,38,45
Smallhammer,aegwynn,1444,paladin,retribution,102,45,57
Lestaroth,goldrinn,1444,paladin,retribution,48,16,32
Justicierø,aegwynn,1443,paladin,retribution,58,30,28
Iluminadoor,nemesis,1442,paladin,retribution,29,19,10
Ogholyhands,bleeding-hollow,1442,paladin,retribution,65,34,31
Procs,hyjal,1441,paladin,retribution,48,34,14
Pijbins,moon-guard,1441,paladin,retribution,74,37,37
Antarcticala,frostmourne,1441,paladin,retribution,54,24,30
Inquisídor,nemesis,1440,paladin,retribution,30,17,13
Charleyy,stormscale,1440,paladin,retribution,90,50,40
Rusinator,bonechewer,1440,paladin,retribution,53,27,26
Taeret,tichondrius,1439,paladin,retribution,24,15,9
Awake,chogall,1439,paladin,retribution,24,15,9
Oldsixqs,illidan,1439,paladin,retribution,32,17,15
Kkgame,tichondrius,1439,paladin,retribution,37,19,18
Ozirus,frostmourne,1439,paladin,retribution,56,25,31
Crazymikey,bleeding-hollow,1439,paladin,retribution,42,15,27
Bigdaddypuff,cenarius,1438,paladin,retribution,30,15,15
Thragar,stormrage,1438,paladin,retribution,30,15,15
Holyskeeter,thunderhorn,1438,paladin,retribution,49,20,29
Getdiswork,malygos,1437,paladin,retribution,108,52,56
Dawncröwn,stormrage,1437,paladin,retribution,65,22,43
Cesah,tichondrius,1436,paladin,retribution,24,15,9
Hokkan,quelthalas,1436,paladin,retribution,59,33,26
Xalø,ragnaros,1435,paladin,retribution,24,15,9
Kêrmit,zuljin,1435,paladin,retribution,43,26,17
Zolktro,stormrage,1435,paladin,retribution,52,27,25
Qunima,tichondrius,1435,paladin,retribution,30,15,15
Warmpôcket,proudmoore,1435,paladin,retribution,66,26,40
Devvn,laughing-skull,1434,paladin,retribution,24,15,9
Lumíty,sargeras,1434,paladin,retribution,137,70,67
Bilbain,proudmoore,1434,paladin,retribution,225,114,111
Gimli,mannoroth,1434,paladin,retribution,36,15,21
Mgjun,ragnaros,1433,paladin,retribution,36,18,18
Badbad,icecrown,1433,paladin,retribution,30,15,15
Bloodrefuge,tichondrius,1433,paladin,retribution,30,15,15
Jianwen,kargath,1433,paladin,retribution,30,15,15
Internadi,frostmourne,1433,paladin,retribution,42,20,22
Gummybearz,doomhammer,1433,paladin,retribution,48,20,28
Inexcusable,wyrmrest-accord,1432,paladin,retribution,41,22,19
Onitenshi,stormscale,1432,paladin,retribution,85,41,44
Hatchet,skullcrusher,1431,paladin,retribution,30,15,15
Perzeføne,quelthalas,1431,paladin,retribution,41,20,21
Acallysta,moon-guard,1431,paladin,retribution,54,26,28
Gogofisco,moonrunner,1431,paladin,retribution,48,19,29
Richiggaa,illidan,1430,paladin,retribution,47,29,18
Aztraseneco,ragnaros,1430,paladin,retribution,104,59,45
Lmd,tichondrius,1430,paladin,retribution,66,35,31
Bapped,dalaran,1430,paladin,retribution,60,26,34
Supercharged,area-52,1429,paladin,retribution,30,15,15
Gorriuke,wyrmrest-accord,1428,paladin,retribution,30,18,12
Falaran,azralon,1428,paladin,retribution,62,32,30
Alexandros,nordrassil,1428,paladin,retribution,30,15,15
Alequin,stormrage,1428,paladin,retribution,30,15,15
Artherion,kelthuzad,1428,paladin,retribution,87,35,52
Hrrothgar,muradin,1427,paladin,retribution,48,26,22
Murtag,bloodscalp,1427,paladin,retribution,60,28,32
Cammack,thrall,1427,paladin,retribution,93,39,54
Demonissh,area-52,1427,paladin,retribution,42,15,27
Mechelle,thrall,1426,paladin,retribution,128,71,57
Talantyr,zuljin,1426,paladin,retribution,78,36,42
Faowin,sargeras,1426,paladin,retribution,89,40,49
Killmönger,tichondrius,1426,paladin,retribution,65,29,36
Tribiani,lightbringer,1425,paladin,retribution,24,15,9
Mathalt,area-52,1425,paladin,retribution,51,26,25
Floquiinhos,azralon,1425,paladin,retribution,36,15,21
Âllmíght,quelthalas,1424,paladin,retribution,24,15,9
Miguepally,ragnaros,1424,paladin,retribution,59,25,34
Tekar,altar-of-storms,1424,paladin,retribution,42,17,25
Gànnicus,korgath,1422,paladin,retribution,36,15,21
Pallyseeker,thrall,1420,paladin,retribution,24,15,9
Rafaela,alterac-mountains,1420,paladin,retribution,30,17,13
Arahann,bleeding-hollow,1420,paladin,retribution,29,16,13
Boozier,ragnaros,1420,paladin,retribution,30,16,14
Palpinga,kelthuzad,1420,paladin,retribution,44,18,26
Tåine,suramar,1420,paladin,retribution,48,16,32
Burstpink,zuljin,1419,paladin,retribution,28,17,11
Elri,ragnaros,1418,paladin,retribution,42,25,17
Cuffaladin,fenris,1418,paladin,retribution,54,30,24
Emethala,windrunner,1418,paladin,retribution,42,23,19
Holyshôckz,stormrage,1418,paladin,retribution,86,47,39
Annhette,sargeras,1418,paladin,retribution,31,15,16
Velyssatha,moon-guard,1418,paladin,retribution,56,26,30
Nocomus,andorhal,1418,paladin,retribution,78,35,43
Lolslikeomg,malganis,1418,paladin,retribution,102,42,60
Galanblack,dalaran,1417,paladin,retribution,56,31,25
Blackop,gallywix,1417,paladin,retribution,30,16,14
Napstër,ragnaros,1417,paladin,retribution,36,15,21
Lyricism,tichondrius,1416,paladin,retribution,49,28,21
Wagyou,skywall,1416,paladin,retribution,30,15,15
Jaikerino,emerald-dream,1416,paladin,retribution,42,15,27
Balrok,cenarius,1415,paladin,retribution,185,93,92
Mitchyc,stormrage,1415,paladin,retribution,90,45,45
Hdmi,darkspear,1415,paladin,retribution,41,20,21
Andrinn,nemesis,1415,paladin,retribution,51,24,27
Minzyy,frostmourne,1414,paladin,retribution,24,15,9
Savagedemise,barthilas,1413,paladin,retribution,55,28,27
Hägär,tichondrius,1413,paladin,retribution,67,27,40
Jursch,emerald-dream,1412,paladin,retribution,175,88,87
Rhoche,ysera,1412,paladin,retribution,36,17,19
Oppression,kul-tiras,1412,paladin,retribution,77,29,48
Andrevz,ragnaros,1411,paladin,retribution,78,44,34
Jagehbombs,tichondrius,1411,paladin,retribution,60,31,29
Sote,lightnings-blade,1410,paladin,retribution,45,22,23
Lusangri,thrall,1410,paladin,retribution,45,17,28
Hasla,tichondrius,1410,paladin,retribution,51,19,32
Releváncé,barthilas,1409,paladin,retribution,66,31,35
Vasharien,nerzhul,1409,paladin,retribution,86,39,47
Willzaum,azralon,1408,paladin,retribution,30,19,11
Kalboko,twisting-nether,1408,paladin,retribution,45,23,22
Anivan,moon-guard,1408,paladin,retribution,60,27,33
Reìarthur,stormrage,1408,paladin,retribution,72,32,40
Søøka,azralon,1408,paladin,retribution,84,36,48
Uholypala,dalaran,1408,paladin,retribution,78,33,45
Kulandis,stormrage,1408,paladin,retribution,57,24,33
Modjytech,tichondrius,1408,paladin,retribution,83,32,51
Industry,firetree,1407,paladin,retribution,33,18,15
Milke,chogall,1407,paladin,retribution,36,17,19
Tooholy,kiljaeden,1406,paladin,retribution,87,54,33
Peil,illidan,1406,paladin,retribution,36,15,21
Sophany,shattered-halls,1405,paladin,retribution,40,26,14
Szeq,tichondrius,1405,paladin,retribution,32,16,16
Øxøxø,emerald-dream,1404,paladin,retribution,96,52,44
Outlivz,hyjal,1404,paladin,retribution,33,17,16
Chandlerrj,area-52,1404,paladin,retribution,42,21,21
Gstbubble,hyjal,1404,paladin,retribution,36,15,21
Mhelyssa,goldrinn,1403,paladin,retribution,24,15,9
Zimzob,stormscale,1403,paladin,retribution,30,15,15
Brenaluna,tichondrius,1403,paladin,retribution,55,24,31
Swietomierz,proudmoore,1403,paladin,retribution,48,20,28
Keltec,bonechewer,1403,paladin,retribution,61,25,36
Holyginger,barthilas,1402,paladin,retribution,41,23,18
Pvppaulx,moon-guard,1401,paladin,retribution,71,37,34
Oschy,moon-guard,1401,paladin,retribution,101,51,50
Sellenagomez,malganis,1401,paladin,retribution,60,29,31
Wésters,quelthalas,1401,paladin,retribution,163,77,86
Jdgmnt,sargeras,1401,paladin,retribution,72,33,39
Véxv,emerald-dream,1401,paladin,retribution,92,36,56
Salaminhoo,azralon,1400,paladin,retribution,30,19,11
Eamon,kelthuzad,1400,paladin,retribution,29,15,14
Rasc,barthilas,1400,paladin,retribution,103,48,55
Dorzwaz,draka,1399,paladin,retribution,30,20,10
Palabing,stormrage,1399,paladin,retribution,24,15,9
Holyham,fizzcrank,1398,paladin,retribution,48,27,21
Dfbattlepass,kelthuzad,1397,paladin,retribution,91,49,42
Chuckman,skullcrusher,1397,paladin,retribution,30,16,14
Uxd,tichondrius,1397,paladin,retribution,55,25,30
Messeb,veknilash,1396,paladin,retribution,151,82,69
Pathed,aerie-peak,1396,paladin,retribution,32,16,16
Theretpally,kelthuzad,1396,paladin,retribution,60,28,32
Emmastoned,bleeding-hollow,1396,paladin,retribution,84,39,45
Dalgren,quelthalas,1396,paladin,retribution,105,39,66
Ktwocrank,dalaran,1395,paladin,retribution,43,16,27
Rhodius,dalaran,1393,paladin,retribution,42,23,19
Tmac,azralon,1393,paladin,retribution,68,35,33
Tsunin,area-52,1393,paladin,retribution,94,46,48
Belregn,illidan,1393,paladin,retribution,78,36,42
Taîno,thrall,1391,paladin,retribution,150,80,70
Sthrealys,quelthalas,1391,paladin,retribution,30,16,14
Shlaps,crushridge,1391,paladin,retribution,84,41,43
Judgmentor,malganis,1391,paladin,retribution,82,34,48
Droden,tichondrius,1390,paladin,retribution,55,29,26
Schalpy,illidan,1388,paladin,retribution,60,28,32
Miitt,blackrock,1387,paladin,retribution,36,20,16
Slowedreverb,stormrage,1387,paladin,retribution,81,42,39
Granisdh,aegwynn,1387,paladin,retribution,54,27,27
Pallytoot,aerie-peak,1386,paladin,retribution,60,35,25
Egufro,frostwolf,1386,paladin,retribution,66,36,30
Valikyr,mugthol,1386,paladin,retribution,36,18,18
Puresight,kelthuzad,1385,paladin,retribution,54,27,27
Simplesam,draenor,1385,paladin,retribution,36,15,21
Belgrieve,proudmoore,1384,paladin,retribution,48,22,26
Onnakishi,azralon,1383,paladin,retribution,36,15,21
Deafheavens,moon-guard,1381,paladin,retribution,30,15,15
Zadragon,sargeras,1381,paladin,retribution,66,31,35
Luðo,moon-guard,1380,paladin,retribution,35,15,20
Blindburn,ragnaros,1379,paladin,retribution,36,17,19
Elsinore,senjin,1377,paladin,retribution,35,19,16
Kaelthasar,azralon,1376,paladin,retribution,30,15,15
Maphisto,stormscale,1375,paladin,retribution,42,30,12
Lebowski,nordrassil,1375,paladin,retribution,66,31,35
Gorostas,kelthuzad,1375,paladin,retribution,34,15,19
Delanadras,kelthuzad,1375,paladin,retribution,47,19,28
Cyniaria,moon-guard,1374,paladin,retribution,114,57,57
Stdee,zuljin,1372,paladin,retribution,63,33,30
Adrockiller,quelthalas,1372,paladin,retribution,68,34,34
Pallynation,korgath,1372,paladin,retribution,36,17,19
Auka,zuljin,1371,paladin,retribution,36,18,18
Lornd,quelthalas,1371,paladin,retribution,30,15,15
Dawsonthebos,grizzly-hills,1370,paladin,retribution,30,16,14
Yukiikaze,sargeras,1370,paladin,retribution,46,23,23
Superzooted,sargeras,1370,paladin,retribution,34,15,19
Sona,jubeithos,1370,paladin,retribution,42,18,24
Hurrîcane,illidan,1370,paladin,retribution,48,15,33
Holyrump,bleeding-hollow,1369,paladin,retribution,27,16,11
Minitas,blackrock,1369,paladin,retribution,42,15,27
Jxo,tichondrius,1368,paladin,retribution,30,17,13
Kellissandra,aerie-peak,1368,paladin,retribution,84,34,50
Vaelinarys,ragnaros,1366,paladin,retribution,30,20,10
Ruinlite,emerald-dream,1366,paladin,retribution,48,30,18
Tøpbløke,frostmourne,1366,paladin,retribution,121,60,61
Scubàlicous,magtheridon,1366,paladin,retribution,42,19,23
Eutectic,moon-guard,1366,paladin,retribution,36,15,21
Hurukpaly,azralon,1365,paladin,retribution,52,23,29
Heraolympian,black-dragonflight,1364,paladin,retribution,57,32,25
Áthz,ragnaros,1363,paladin,retribution,41,21,20
Nest,stormrage,1363,paladin,retribution,30,15,15
Hùck,alexstrasza,1363,paladin,retribution,110,51,59
Psadin,thunderlord,1363,paladin,retribution,60,25,35
Alvick,icecrown,1363,paladin,retribution,39,16,23
Äeriah,fizzcrank,1362,paladin,retribution,84,43,41
Öpäf,steamwheedle-cartel,1362,paladin,retribution,55,23,32
Arlizu,quelthalas,1361,paladin,retribution,35,17,18
Ðetroity,stormrage,1359,paladin,retribution,105,57,48
Pal,blackhand,1359,paladin,retribution,44,23,21
Kalendawn,moon-guard,1358,paladin,retribution,76,43,33
Xoxoxoxoxoxo,aegwynn,1357,paladin,retribution,48,23,25
Lightcast,moon-guard,1357,paladin,retribution,72,34,38
Nerilliah,sargeras,1357,paladin,retribution,33,15,18
Pàladwarf,stormrage,1357,paladin,retribution,81,36,45
Mareaaturbo,azralon,1356,paladin,retribution,53,30,23
Wickedwingz,sargeras,1356,paladin,retribution,30,15,15
Mïkhael,nemesis,1356,paladin,retribution,86,37,49
Arbarrus,stormrage,1354,paladin,retribution,31,19,12
Cinacalcet,dalaran,1354,paladin,retribution,29,15,14
Levarious,thunderlord,1354,paladin,retribution,126,62,64
Theldart,ragnaros,1353,paladin,retribution,59,30,29
Lunchhboxx,kelthuzad,1353,paladin,retribution,47,22,25
Adapa,azralon,1353,paladin,retribution,36,16,20
Hrizul,drakthul,1353,paladin,retribution,36,15,21
Dwk,thrall,1353,paladin,retribution,36,15,21
Andronik,bleeding-hollow,1352,paladin,retribution,33,16,17
Warspyder,alterac-mountains,1351,paladin,retribution,48,28,20
Aeroßlaze,dragonmaw,1351,paladin,retribution,36,18,18
Dekho,quelthalas,1351,paladin,retribution,47,19,28
Tlahtoani,illidan,1350,paladin,retribution,23,15,8
Chinsta,zuljin,1349,paladin,retribution,36,22,14
Zantdemption,frostmourne,1349,paladin,retribution,29,15,14
Sländers,sargeras,1348,paladin,retribution,107,49,58
Dwurim,moon-guard,1346,paladin,retribution,48,26,22
Lashlan,barthilas,1345,paladin,retribution,38,24,14
Ddeadwhisper,executus,1345,paladin,retribution,104,56,48
Hazmât,illidan,1345,paladin,retribution,82,32,50
Lightvader,illidan,1344,paladin,retribution,36,15,21
Retman,azuremyst,1344,paladin,retribution,48,19,29
Bossmin,tichondrius,1343,paladin,retribution,24,14,10
Dyskrazia,thrall,1343,paladin,retribution,32,15,17
Zugzugondeez,illidan,1343,paladin,retribution,30,14,16
Dublek,tichondrius,1342,paladin,retribution,18,14,4
Wrathofangus,nesingwary,1342,paladin,retribution,30,14,16
Xygra,stormrage,1342,paladin,retribution,30,14,16
Tævèn,tichondrius,1342,paladin,retribution,30,14,16
Lawdeedawh,tichondrius,1342,paladin,retribution,30,14,16
Kikazaru,moon-guard,1341,paladin,retribution,36,14,22
Icepondpal,proudmoore,1340,paladin,retribution,24,16,8
Retsonictwo,tichondrius,1340,paladin,retribution,30,14,16
Samphlty,azralon,1340,paladin,retribution,30,14,16
Bosutai,dalaran,1340,paladin,retribution,36,15,21
Bubblestar,ragnaros,1340,paladin,retribution,56,23,33
Minikalina,ragnaros,1339,paladin,retribution,24,14,10
Hoodmeatflap,stonemaul,1339,paladin,retribution,30,17,13
Pennedurma,akama,1339,paladin,retribution,46,24,22
Bulioevn,emerald-dream,1339,paladin,retribution,51,24,27
Aaralis,ragnaros,1339,paladin,retribution,30,14,16
Arlleth,area-52,1339,paladin,retribution,42,19,23
Solgrïm,wyrmrest-accord,1339,paladin,retribution,54,24,30
Thadose,bonechewer,1338,paladin,retribution,195,108,87
Neró,quelthalas,1338,paladin,retribution,61,28,33
Healsonyou,windrunner,1338,paladin,retribution,36,14,22
Amarnath,turalyon,1337,paladin,retribution,27,16,11
Iceburg,shadowmoon,1337,paladin,retribution,30,17,13
Redspine,azralon,1337,paladin,retribution,36,14,22
Wlq,frostmourne,1336,paladin,retribution,71,29,42
Nightz,eonar,1336,paladin,retribution,36,14,22
Refulgent,moon-guard,1335,paladin,retribution,58,35,23
Shecara,malygos,1335,paladin,retribution,72,40,32
Avantasias,sargeras,1335,paladin,retribution,82,39,43
Albagail,draka,1335,paladin,retribution,46,20,26
Dogf,tichondrius,1335,paladin,retribution,47,14,33
Prôphêt,stormrage,1334,paladin,retribution,18,14,4
Justsmiteit,dalaran,1334,paladin,retribution,30,17,13
Torvus,bonechewer,1334,paladin,retribution,34,15,19
Flynnee,illidan,1334,paladin,retribution,44,19,25
Carliitoz,quelthalas,1334,paladin,retribution,111,44,67
Oioo,proudmoore,1333,paladin,retribution,21,15,6
Aretwin,dalaran,1333,paladin,retribution,48,23,25
Reptila,bonechewer,1333,paladin,retribution,30,14,16
Väkariän,quelthalas,1333,paladin,retribution,30,14,16
Thortanous,icecrown,1333,paladin,retribution,54,25,29
Astaro,malganis,1333,paladin,retribution,36,14,22
Faaqmee,gorefiend,1332,paladin,retribution,30,19,11
Pallyhealed,tichondrius,1332,paladin,retribution,37,17,20
Malorian,azgalor,1332,paladin,retribution,48,21,27
Lüuz,area-52,1332,paladin,retribution,42,15,27
Trogdorpwn,bonechewer,1331,paladin,retribution,30,17,13
Bonkky,whisperwind,1331,paladin,retribution,30,16,14
Holybalsagna,garrosh,1331,paladin,retribution,66,35,31
Mobitz,dalvengyr,1331,paladin,retribution,48,25,23
Tutankhammer,stormrage,1331,paladin,retribution,100,50,50
Mattilla,tichondrius,1331,paladin,retribution,30,14,16
Keenos,frostmourne,1330,paladin,retribution,25,14,11
Hunsung,tichondrius,1330,paladin,retribution,36,14,22
Däkh,sargeras,1329,paladin,retribution,24,14,10
Bigdoosa,frostmourne,1329,paladin,retribution,40,19,21
Brightsaber,tichondrius,1328,paladin,retribution,63,34,29
Nerfashen,zuljin,1327,paladin,retribution,24,14,10
Revent,drakkari,1327,paladin,retribution,24,14,10
Clayban,stormrage,1327,paladin,retribution,42,22,20
Azajudgeman,nemesis,1327,paladin,retribution,33,14,19
Garcinddra,vashj,1326,paladin,retribution,34,16,18
Ennvy,nemesis,1326,paladin,retribution,30,14,16
Melize,area-52,1325,paladin,retribution,118,57,61
Mikezheng,tichondrius,1325,paladin,retribution,42,19,23
Dexko,silvermoon,1324,paladin,retribution,34,24,10
Akabanee,ragnaros,1324,paladin,retribution,24,14,10
Kiergann,quelthalas,1324,paladin,retribution,65,30,35
Unsignedint,hyjal,1323,paladin,retribution,24,14,10
Kregar,kelthuzad,1323,paladin,retribution,70,38,32
Gixpal,skullcrusher,1323,paladin,retribution,59,31,28
Prïmavera,azralon,1323,paladin,retribution,35,15,20
Christman,illidan,1323,paladin,retribution,78,33,45
Dárí,stormrage,1320,paladin,retribution,132,65,67
Sventyn,frostmourne,1320,paladin,retribution,41,14,27
Bennu,sargeras,1319,paladin,retribution,45,17,28
Oopalaoo,azralon,1318,paladin,retribution,30,15,15
Arkanica,moon-guard,1318,paladin,retribution,41,16,25
Dralkou,kaelthas,1318,paladin,retribution,75,29,46
Serran,durotan,1318,paladin,retribution,54,20,34
Vallahad,emerald-dream,1317,paladin,retribution,24,14,10
Balango,azralon,1316,paladin,retribution,24,14,10
Zoobro,tichondrius,1316,paladin,retribution,71,32,39
Pallypapa,galakrond,1315,paladin,retribution,35,22,13
Hapii,tichondrius,1315,paladin,retribution,47,18,29
Crematória,azralon,1314,paladin,retribution,24,14,10
Ajoladin,illidan,1314,paladin,retribution,75,34,41
Lostkanvas,azralon,1313,paladin,retribution,46,27,19
Lainn,zuljin,1313,paladin,retribution,74,41,33
Phokboi,shattered-hand,1313,paladin,retribution,57,31,26
Vanthor,emerald-dream,1313,paladin,retribution,30,15,15
Siberios,stormrage,1313,paladin,retribution,30,14,16
Ludvigsen,hakkar,1313,paladin,retribution,36,14,22
Autoattacker,mannoroth,1312,paladin,retribution,24,14,10
Hays,barthilas,1311,paladin,retribution,18,14,4
Bravomedic,emerald-dream,1311,paladin,retribution,39,20,19
Melloow,azralon,1311,paladin,retribution,91,43,48
Toyotasupra,azgalor,1310,paladin,retribution,48,29,19
Trg,azralon,1310,paladin,retribution,24,14,10
Darthhelios,illidan,1310,paladin,retribution,36,14,22
Trainstorm,emerald-dream,1309,paladin,retribution,38,19,19
Sunwrath,quelthalas,1309,paladin,retribution,75,32,43
Lumberjack,bloodhoof,1309,paladin,retribution,41,16,25
Normaldude,sargeras,1307,paladin,retribution,30,14,16
Erethonis,bladefist,1307,paladin,retribution,78,36,42
Retrah,azralon,1306,paladin,retribution,24,14,10
Shamo,stormreaver,1306,paladin,retribution,36,14,22
Bayaz,emerald-dream,1304,paladin,retribution,67,36,31
Nadrela,burning-blade,1303,paladin,retribution,54,32,22
Uvatah,quelthalas,1303,paladin,retribution,24,14,10
Elivathord,trollbane,1302,paladin,retribution,29,16,13
Happywow,tichondrius,1302,paladin,retribution,59,30,29
Atrayeus,dawnbringer,1300,paladin,retribution,48,21,27
Saucepally,laughing-skull,1299,paladin,retribution,55,30,25
Oneminute,nerzhul,1299,paladin,retribution,42,21,21
Ultralord,dragonmaw,1299,paladin,retribution,28,14,14
Vtyr,nemesis,1298,paladin,retribution,63,29,34
Brsjak,frostmourne,1297,paladin,retribution,65,33,32
Jerratt,thrall,1297,paladin,retribution,72,31,41
Krinkin,illidan,1297,paladin,retribution,42,14,28
Youwillatone,zuljin,1296,paladin,retribution,42,22,20
Fabolouss,tichondrius,1296,paladin,retribution,114,58,56
Ratburger,blood-furnace,1295,paladin,retribution,23,14,9
Holyfaxis,rexxar,1293,paladin,retribution,38,17,21
Paladingirl,darkspear,1292,paladin,retribution,92,50,42
Vargonha,azralon,1292,paladin,retribution,54,27,27
Mendaltv,dalaran,1292,paladin,retribution,36,17,19
Philfred,frostmourne,1290,paladin,retribution,24,15,9
Perfectgirl,maiev,1290,paladin,retribution,78,38,40
Vosailer,illidan,1290,paladin,retribution,34,16,18
Walleis,moon-guard,1290,paladin,retribution,58,22,36
Vêndar,ragnaros,1289,paladin,retribution,78,33,45
Sóapbubble,tichondrius,1287,paladin,retribution,27,14,13
Critxx,tichondrius,1287,paladin,retribution,83,38,45
Dedsxy,tichondrius,1286,paladin,retribution,30,14,16
Hwanko,tichondrius,1285,paladin,retribution,40,25,15
Broxon,tichondrius,1285,paladin,retribution,64,33,31
Gainen,illidan,1285,paladin,retribution,47,24,23
Paliodin,dalaran,1284,paladin,retribution,36,15,21
ßlððdyßðnez,malganis,1283,paladin,retribution,36,20,16
Sweatylight,bleeding-hollow,1283,paladin,retribution,74,37,37
Arnblass,magtheridon,1283,paladin,retribution,63,27,36
Hodne,blackhand,1282,paladin,retribution,49,26,23
Navicc,zuljin,1279,paladin,retribution,29,14,15
Aellâ,bloodscalp,1278,paladin,retribution,194,102,92
Chippo,aegwynn,1278,paladin,retribution,35,15,20
Denhoward,proudmoore,1277,paladin,retribution,36,14,22
Theuss,nerzhul,1276,paladin,retribution,59,25,34
Yuccalicious,area-52,1275,paladin,retribution,53,23,30
Carolena,thaurissan,1274,paladin,retribution,74,31,43
Dredberserk,stormrage,1273,paladin,retribution,30,16,14
Balster,moon-guard,1273,paladin,retribution,85,40,45
Throwable,illidan,1273,paladin,retribution,64,26,38
Webothhateme,tichondrius,1272,paladin,retribution,36,20,16
Quickthing,dalaran,1271,paladin,retribution,83,47,36
Khorgus,gundrak,1271,paladin,retribution,54,27,27
Såssy,moon-guard,1270,paladin,retribution,72,31,41
Thankyouswen,tichondrius,1269,paladin,retribution,70,31,39
Synthetic,moon-guard,1268,paladin,retribution,78,40,38
Gramaton,malfurion,1268,paladin,retribution,54,25,29
Holytémplar,proudmoore,1267,paladin,retribution,30,14,16
Dewlight,zuljin,1266,paladin,retribution,71,41,30
Giltronix,thrall,1266,paladin,retribution,60,30,30
Palacamâ,quelthalas,1266,paladin,retribution,34,15,19
Mindfoolness,sargeras,1265,paladin,retribution,42,21,21
Formergf,crushridge,1265,paladin,retribution,60,29,31
Wosy,azralon,1263,paladin,retribution,24,15,9
Onemorelight,sargeras,1263,paladin,retribution,54,27,27
Quinnl,dreadmaul,1262,paladin,retribution,38,18,20
Galaxahan,bonechewer,1262,paladin,retribution,64,30,34
Athenariel,bleeding-hollow,1262,paladin,retribution,55,24,31
Punative,darkspear,1262,paladin,retribution,48,16,32
Garruckadin,dalaran,1261,paladin,retribution,25,14,11
Malicia,malorne,1261,paladin,retribution,36,17,19
Herrit,frostmourne,1260,paladin,retribution,144,76,68
Sïrenek,tichondrius,1260,paladin,retribution,55,27,28
Jugheadqc,mugthol,1260,paladin,retribution,63,30,33
Canadianeh,malganis,1260,paladin,retribution,66,28,38
Revent,stormrage,1260,paladin,retribution,54,21,33
Belena,jaedenar,1258,paladin,retribution,36,16,20
Minlarkwa,frostmourne,1257,paladin,retribution,30,16,14
Restitution,area-52,1257,paladin,retribution,35,14,21
Ðivinestørm,stormrage,1256,paladin,retribution,25,14,11
Soana,alexstrasza,1255,paladin,retribution,78,48,30
Alucardlh,ragnaros,1254,paladin,retribution,70,38,32
Huitz,drakkari,1254,paladin,retribution,66,33,33
Snowcrow,tichondrius,1254,paladin,retribution,115,51,64
Snowcrest,cenarius,1251,paladin,retribution,74,33,41
Lvlone,sargeras,1250,paladin,retribution,30,17,13
Menaus,duskwood,1250,paladin,retribution,39,20,19
Barbesacrer,zuljin,1249,paladin,retribution,27,15,12
Smorezz,bonechewer,1249,paladin,retribution,108,50,58
Eleonorr,proudmoore,1248,paladin,retribution,30,16,14
Wölfheärt,tichondrius,1247,paladin,retribution,18,13,5
Truesound,malganis,1247,paladin,retribution,18,13,5
Canadapants,kelthuzad,1247,paladin,retribution,36,21,15
Davinchi,laughing-skull,1247,paladin,retribution,47,27,20
Solidifyxz,area-52,1247,paladin,retribution,24,13,11
Venturep,azralon,1247,paladin,retribution,24,13,11
Daion,quelthalas,1247,paladin,retribution,24,13,11
Billystacks,illidan,1247,paladin,retribution,24,13,11
Thin,ragnaros,1247,paladin,retribution,30,14,16
Hojdin,tichondrius,1247,paladin,retribution,30,13,17
Vlandor,area-52,1246,paladin,retribution,35,19,16
Talvyr,icecrown,1246,paladin,retribution,30,14,16
Steelbreaker,deathwing,1246,paladin,retribution,47,21,26
Beyönd,quelthalas,1246,paladin,retribution,30,13,17
Bizaro,malganis,1246,paladin,retribution,36,13,23
Zephyrvalor,sargeras,1245,paladin,retribution,54,32,22
Rengen,frostmourne,1245,paladin,retribution,24,13,11
Paladinaa,lothar,1245,paladin,retribution,30,13,17
Onemassacre,spirestone,1245,paladin,retribution,36,13,23
Rakzan,nerzhul,1244,paladin,retribution,24,13,11
Hammerina,antonidas,1244,paladin,retribution,35,16,19
Skylexx,ragnaros,1244,paladin,retribution,60,27,33
Mákis,ragnaros,1244,paladin,retribution,30,13,17
Aduhrawl,moon-guard,1244,paladin,retribution,38,14,24
Jaimi,stormreaver,1243,paladin,retribution,18,13,5
Yugee,doomhammer,1243,paladin,retribution,24,13,11
Doktavius,lightbringer,1243,paladin,retribution,24,13,11
Krixes,firetree,1243,paladin,retribution,30,16,14
Treizen,frostmourne,1243,paladin,retribution,37,14,23
Deployed,kaelthas,1243,paladin,retribution,36,13,23
Fallóut,proudmoore,1243,paladin,retribution,42,13,29
Bebitufiufiu,illidan,1242,paladin,retribution,24,13,11
Tedward,emerald-dream,1242,paladin,retribution,24,13,11
Rockbell,kiljaeden,1242,paladin,retribution,24,13,11
Hahe,tichondrius,1242,paladin,retribution,30,13,17
Justeight,stormrage,1242,paladin,retribution,33,13,20
Glorgrim,emerald-dream,1241,paladin,retribution,24,13,11
Anastos,anvilmar,1241,paladin,retribution,24,13,11
Hellhawk,hellscream,1241,paladin,retribution,36,18,18
Aurken,ragnaros,1241,paladin,retribution,30,13,17
Holychow,tichondrius,1240,paladin,retribution,24,13,11
Athamon,nemesis,1240,paladin,retribution,24,13,11
Amadin,emerald-dream,1240,paladin,retribution,24,13,11
Naxadin,tichondrius,1240,paladin,retribution,24,13,11
Mavrixz,illidan,1240,paladin,retribution,30,13,17
Impkpal,tichondrius,1240,paladin,retribution,36,13,23
Nerfmehpls,ragnaros,1239,paladin,retribution,96,54,42
Tifalockhart,dathremar,1239,paladin,retribution,24,13,11
Saintpower,stormscale,1239,paladin,retribution,24,13,11
Shrektacular,malganis,1238,paladin,retribution,24,13,11
Deftonia,stormrage,1238,paladin,retribution,65,31,34
Ràmetep,illidan,1238,paladin,retribution,30,13,17
Theboxx,frostmourne,1238,paladin,retribution,39,16,23
Xalixxa,wyrmrest-accord,1237,paladin,retribution,60,27,33
Siaaryn,darkspear,1237,paladin,retribution,30,13,17
Rigotakp,illidan,1237,paladin,retribution,30,13,17
Pristinne,darkspear,1237,paladin,retribution,82,34,48
Sconey,andorhal,1237,paladin,retribution,34,14,20
Ablunedion,illidan,1237,paladin,retribution,41,14,27
Nornix,fenris,1236,paladin,retribution,24,13,11
Meanlight,zuljin,1236,paladin,retribution,78,42,36
Carenye,thunderhorn,1235,paladin,retribution,37,16,21
Covidin,quelthalas,1234,paladin,retribution,30,13,17
Noblelight,saurfang,1233,paladin,retribution,29,17,12
Cederas,sargeras,1233,paladin,retribution,30,17,13
Pasterõ,ragnaros,1231,paladin,retribution,28,16,12
Pìerre,ragnaros,1231,paladin,retribution,140,69,71
Ôdenswrath,stormscale,1231,paladin,retribution,98,45,53
Chopsparks,khadgar,1231,paladin,retribution,53,21,32
Irand,area-52,1231,paladin,retribution,67,26,41
Krawmwell,lothar,1230,paladin,retribution,78,43,35
Davincintel,tichondrius,1230,paladin,retribution,24,13,11
Uunjaaku,kiljaeden,1230,paladin,retribution,45,22,23
Luke,frostwolf,1230,paladin,retribution,29,13,16
Qpal,area-52,1230,paladin,retribution,30,13,17
Leihateh,moon-guard,1229,paladin,retribution,24,13,11
Elowod,frostmourne,1229,paladin,retribution,24,13,11
Legible,tichondrius,1228,paladin,retribution,28,15,13
Featscrows,nemesis,1228,paladin,retribution,48,20,28
Uhklathel,quelthalas,1228,paladin,retribution,63,25,38
Heindallr,nemesis,1227,paladin,retribution,48,22,26
Forged,steamwheedle-cartel,1227,paladin,retribution,135,56,79
Thorsenâ,sargeras,1226,paladin,retribution,27,17,10
Hiikari,silver-hand,1225,paladin,retribution,30,14,16
Haawkala,ragnaros,1225,paladin,retribution,30,13,17
Misskilljoy,proudmoore,1225,paladin,retribution,30,13,17
Keegân,area-52,1224,paladin,retribution,16,14,2
Hellcallerl,quelthalas,1224,paladin,retribution,24,13,11
Dankpaladin,frostwolf,1224,paladin,retribution,30,13,17
Retneyspears,darkspear,1224,paladin,retribution,42,18,24
Amarith,queldorei,1224,paladin,retribution,76,31,45
Ulessys,bleeding-hollow,1223,paladin,retribution,54,27,27
Tonnerre,silvermoon,1223,paladin,retribution,72,33,39
Ekyu,sargeras,1222,paladin,retribution,25,15,10
Gys,ragnaros,1222,paladin,retribution,60,31,29
Lungjuice,stormrage,1222,paladin,retribution,47,18,29
Albion,sargeras,1222,paladin,retribution,36,13,23
Füriøsa,quelthalas,1221,paladin,retribution,59,29,30
Areaky,khazgoroth,1220,paladin,retribution,38,22,16
Imrahilaf,korialstrasz,1220,paladin,retribution,36,13,23
Demihoj,illidan,1220,paladin,retribution,36,13,23
Lortrin,quelthalas,1218,paladin,retribution,24,13,11
Naghret,area-52,1218,paladin,retribution,24,13,11
Beastyone,tichondrius,1218,paladin,retribution,116,61,55
Uglymugz,area-52,1218,paladin,retribution,37,16,21
Sycomaniac,illidan,1218,paladin,retribution,35,13,22
Marshman,kelthuzad,1217,paladin,retribution,30,17,13
Redeviliu,tichondrius,1217,paladin,retribution,41,15,26
Holyshoc,kiljaeden,1216,paladin,retribution,56,28,28
Brucedwal,moon-guard,1216,paladin,retribution,63,31,32
Vassen,echo-isles,1216,paladin,retribution,33,16,17
Ròwdy,area-52,1214,paladin,retribution,23,13,10
Fogonaventa,nemesis,1214,paladin,retribution,57,18,39
Madalynn,quelthalas,1213,paladin,retribution,54,21,33
Armstrongz,bleeding-hollow,1210,paladin,retribution,36,13,23
Azëitona,azralon,1208,paladin,retribution,24,13,11
Xupalaa,azralon,1208,paladin,retribution,44,23,21
Barbaluzz,quelthalas,1207,paladin,retribution,31,16,15
Xenagos,akama,1207,paladin,retribution,30,13,17
Gwendolyynn,moon-guard,1206,paladin,retribution,40,24,16
Longinus,eredar,1206,paladin,retribution,24,13,11
Bubbleöseven,agamaggan,1205,paladin,retribution,57,27,30
Shusekki,drakkari,1204,paladin,retribution,111,54,57
Botïs,sargeras,1203,paladin,retribution,36,22,14
Rediems,drakkari,1203,paladin,retribution,42,21,21
Soledad,tichondrius,1202,paladin,retribution,30,15,15
Hibrael,azralon,1201,paladin,retribution,56,32,24
Stõnêdpimp,agamaggan,1201,paladin,retribution,29,13,16
Thal,silvermoon,1199,paladin,retribution,36,20,16
Sturka,illidan,1199,paladin,retribution,60,29,31
Johnyfresh,jubeithos,1199,paladin,retribution,44,20,24
Rinneblack,ragnaros,1199,paladin,retribution,30,13,17
Cexus,tichondrius,1198,paladin,retribution,23,13,10
Oathden,area-52,1198,paladin,retribution,34,18,16
Rönän,sargeras,1198,paladin,retribution,29,13,16
Finishearlyx,kelthuzad,1198,paladin,retribution,35,13,22
Lucigiorna,stormrage,1197,paladin,retribution,50,22,28
Thomãs,moon-guard,1195,paladin,retribution,29,13,16
Eetswaz,frostmourne,1193,paladin,retribution,36,20,16
Virrata,tichondrius,1193,paladin,retribution,26,14,12
Pikatripa,quelthalas,1192,paladin,retribution,38,17,21
Spartus,area-52,1191,paladin,retribution,26,15,11
Avelane,caelestrasz,1191,paladin,retribution,52,24,28
Malavon,azralon,1190,paladin,retribution,21,14,7
Noblearthur,feathermoon,1190,paladin,retribution,24,15,9
Unsung,stormreaver,1190,paladin,retribution,47,23,24
Verguetas,ragnaros,1190,paladin,retribution,60,27,33
Dinpal,tichondrius,1190,paladin,retribution,36,13,23
Jèrico,quelthalas,1188,paladin,retribution,32,14,18
Dynamais,barthilas,1187,paladin,retribution,54,21,33
Reptaur,bleeding-hollow,1185,paladin,retribution,64,31,33
Stealhearsp,tichondrius,1185,paladin,retribution,41,14,27
Holycower,tichondrius,1182,paladin,retribution,24,15,9
Páláx,stormrage,1181,paladin,retribution,51,22,29
Dsio,bleeding-hollow,1180,paladin,retribution,34,13,21
Ezekìël,tichondrius,1179,paladin,retribution,24,15,9
Paim,tol-barad,1179,paladin,retribution,32,13,19
Noskill,moonrunner,1176,paladin,retribution,48,29,19
Shadowarius,aerie-peak,1176,paladin,retribution,66,32,34
Jerseÿ,sargeras,1176,paladin,retribution,39,18,21
Bleeked,emerald-dream,1174,paladin,retribution,25,14,11
Basstian,bleeding-hollow,1174,paladin,retribution,100,40,60
Greasy,quelthalas,1173,paladin,retribution,32,13,19
Kaladini,jubeithos,1171,paladin,retribution,22,13,9
Schnabdain,exodar,1171,paladin,retribution,66,36,30
Crosshammer,quelthalas,1170,paladin,retribution,42,20,22
Popwingzz,sargeras,1170,paladin,retribution,66,23,43
Linias,quelthalas,1169,paladin,retribution,21,14,7
Holyrõller,malganis,1169,paladin,retribution,30,14,16
Irantir,drakkari,1169,paladin,retribution,107,47,60
Pengideath,barthilas,1168,paladin,retribution,30,14,16
Souljahgirl,demon-soul,1168,paladin,retribution,42,18,24
Mikkylol,tichondrius,1165,paladin,retribution,28,13,15
Soopadupa,trollbane,1164,paladin,retribution,68,36,32
Solomonss,frostmourne,1163,paladin,retribution,58,21,37
Thaly,shadowmoon,1161,paladin,retribution,49,20,29
Suncrashkid,nerzhul,1160,paladin,retribution,169,91,78
Rynis,arthas,1160,paladin,retribution,34,14,20
Draerys,drakkari,1159,paladin,retribution,36,26,10
Oraborra,area-52,1158,paladin,retribution,36,14,22
Thørîm,nazjatar,1154,paladin,retribution,36,15,21
Kaysonso,thunderlord,1153,paladin,retribution,49,18,31
Hammrekt,dalaran,1152,paladin,retribution,18,12,6
Furylolx,tichondrius,1152,paladin,retribution,18,12,6
Greatwyrm,illidan,1152,paladin,retribution,18,12,6
Huavi,tichondrius,1152,paladin,retribution,18,12,6
Ghøjan,malganis,1152,paladin,retribution,23,15,8
Critwink,illidan,1152,paladin,retribution,21,12,9
Vânguârds,tichondrius,1152,paladin,retribution,24,12,12
Pique,malganis,1152,paladin,retribution,24,12,12
Jivvy,eredar,1152,paladin,retribution,30,12,18
Cöjax,dalaran,1151,paladin,retribution,18,12,6
Jeinova,barthilas,1151,paladin,retribution,105,62,43
Talions,illidan,1151,paladin,retribution,24,12,12
Allohes,area-52,1151,paladin,retribution,24,12,12
Zhaslk,ragnaros,1151,paladin,retribution,24,12,12
ßrittany,gnomeregan,1151,paladin,retribution,24,12,12
Torosagrado,drakkari,1151,paladin,retribution,24,12,12
Lhacius,drakkari,1151,paladin,retribution,28,13,15
Dragynfist,malganis,1151,paladin,retribution,30,12,18
Fâmed,tichondrius,1151,paladin,retribution,30,12,18
Sukmyret,sargeras,1151,paladin,retribution,30,12,18
Geospawn,tichondrius,1151,paladin,retribution,30,12,18
Softmograne,tichondrius,1151,paladin,retribution,30,12,18
Jameson,andorhal,1150,paladin,retribution,18,12,6
Hashmaal,tichondrius,1150,paladin,retribution,39,20,19
Alvinsane,proudmoore,1150,paladin,retribution,24,12,12
Bubbleblast,elune,1150,paladin,retribution,30,12,18
Trinade,stormrage,1150,paladin,retribution,30,12,18
Andrixi,bonechewer,1149,paladin,retribution,18,12,6
Vaaga,quelthalas,1149,paladin,retribution,24,12,12
Yeeter,thrall,1149,paladin,retribution,24,12,12
Retosterone,stormrage,1149,paladin,retribution,30,12,18
Saffuki,frostmourne,1149,paladin,retribution,30,12,18
Emisoul,sargeras,1149,paladin,retribution,30,12,18
Kadryck,drakkari,1148,paladin,retribution,18,12,6
Daukan,quelthalas,1148,paladin,retribution,24,12,12
Dontaylor,tichondrius,1148,paladin,retribution,30,12,18
Bigdpally,frostmourne,1148,paladin,retribution,36,12,24
Rickadin,bleeding-hollow,1147,paladin,retribution,22,13,9
Pocacoco,azralon,1147,paladin,retribution,22,13,9
Phanna,the-forgotten-coast,1147,paladin,retribution,24,12,12
Arkoth,kelthuzad,1147,paladin,retribution,24,12,12
Smudgexy,frostmourne,1147,paladin,retribution,30,12,18
Mongerr,drakkari,1146,paladin,retribution,24,12,12
Røshea,hydraxis,1146,paladin,retribution,24,12,12
Ireckon,stormrage,1146,paladin,retribution,24,12,12
Marhaus,emerald-dream,1146,paladin,retribution,24,12,12
Deathodin,tichondrius,1146,paladin,retribution,24,12,12
Mikehawkhuge,area-52,1146,paladin,retribution,60,26,34
Adathan,ghostlands,1146,paladin,retribution,30,12,18
Capedcrusade,area-52,1145,paladin,retribution,18,12,6
Savethejelly,moon-guard,1145,paladin,retribution,24,12,12
Cathode,area-52,1145,paladin,retribution,24,12,12
Deosfires,ragnaros,1145,paladin,retribution,28,13,15
Riggen,thrall,1144,paladin,retribution,30,12,18
Lightshope,coilfang,1143,paladin,retribution,18,12,6
Elbigboy,tichondrius,1143,paladin,retribution,89,45,44
Thoti,tichondrius,1143,paladin,retribution,25,12,13
Scudstock,tichondrius,1143,paladin,retribution,71,34,37
Joeseph,stormrage,1143,paladin,retribution,30,12,18
Seongje,tichondrius,1143,paladin,retribution,39,13,26
Stormwinter,azralon,1143,paladin,retribution,36,12,24
Oniizuna,thrall,1142,paladin,retribution,24,12,12
Ginbirdup,kelthuzad,1141,paladin,retribution,18,12,6
Swiftxheal,stormrage,1141,paladin,retribution,24,12,12
Velarelan,moon-guard,1141,paladin,retribution,30,12,18
Kelthálas,illidan,1141,paladin,retribution,30,12,18
Beachyo,tichondrius,1140,paladin,retribution,18,12,6
Bingbingcd,tichondrius,1140,paladin,retribution,30,13,17
Athenax,area-52,1139,paladin,retribution,24,12,12
Victidin,quelthalas,1138,paladin,retribution,24,12,12
Brahion,icecrown,1137,paladin,retribution,62,33,29
Sarkorius,moon-guard,1137,paladin,retribution,24,12,12
Gavrill,thrall,1137,paladin,retribution,30,13,17
Narcolepso,azralon,1137,paladin,retribution,30,12,18
Akiralons,ragnaros,1137,paladin,retribution,30,12,18
Haiyaa,frostwolf,1137,paladin,retribution,66,25,41
Drekgor,drakkari,1136,paladin,retribution,42,21,21
Soyafed,mugthol,1135,paladin,retribution,58,30,28
Vejita,frostmourne,1135,paladin,retribution,24,12,12
Areura,hellscream,1134,paladin,retribution,21,13,8
Mandragor,borean-tundra,1134,paladin,retribution,36,21,15
Vynlorderan,area-52,1134,paladin,retribution,24,12,12
Dresdén,skullcrusher,1133,paladin,retribution,18,12,6
Bradoxx,thorium-brotherhood,1133,paladin,retribution,78,43,35
Maverickxz,nemesis,1133,paladin,retribution,29,12,17
Meltedcheese,destromath,1132,paladin,retribution,30,15,15
Ðß,arthas,1132,paladin,retribution,30,13,17
Eddardstark,agamaggan,1131,paladin,retribution,68,31,37
Joelanson,blood-furnace,1130,paladin,retribution,54,29,25
Jdn,ysera,1130,paladin,retribution,60,29,31
Grãnd,tortheldrin,1129,paladin,retribution,29,12,17
Salasong,hellscream,1129,paladin,retribution,60,20,40
Fortueni,illidan,1128,paladin,retribution,94,55,39
Stepurgameup,ghostlands,1128,paladin,retribution,54,29,25
Arun,arthas,1128,paladin,retribution,33,15,18
Chbestafera,nemesis,1127,paladin,retribution,18,12,6
Gamber,frostmourne,1127,paladin,retribution,38,16,22
Ducii,stormrage,1126,paladin,retribution,46,22,24
Redyomi,drakkari,1126,paladin,retribution,36,13,23
Damorte,ragnaros,1125,paladin,retribution,30,15,15
Sparkchaser,proudmoore,1125,paladin,retribution,24,12,12
Dirkadirkka,stormrage,1125,paladin,retribution,24,12,12
Newerlight,tichondrius,1124,paladin,retribution,25,13,12
Reivilly,azralon,1124,paladin,retribution,30,13,17
Palavittar,azralon,1122,paladin,retribution,23,13,10
Dannoruk,ragnaros,1121,paladin,retribution,30,12,18
Thorviim,azralon,1120,paladin,retribution,37,17,20
Zaklehblue,daggerspine,1118,paladin,retribution,60,24,36
Darkknes,quelthalas,1116,paladin,retribution,41,20,21
Statícx,ragnaros,1116,paladin,retribution,103,43,60
Deathwyz,thunderlord,1116,paladin,retribution,36,14,22
Yenkmeilleur,zuljin,1115,paladin,retribution,24,13,11
Diablosgrim,stormrage,1114,paladin,retribution,24,18,6
Streetsaint,frostmourne,1114,paladin,retribution,66,32,34
Adelsman,quelthalas,1113,paladin,retribution,30,14,16
Sandicang,azuremyst,1112,paladin,retribution,54,27,27
Drágons,stormrage,1109,paladin,retribution,72,30,42
Wilmâ,ragnaros,1109,paladin,retribution,30,12,18
Rcon,khadgar,1107,paladin,retribution,24,13,11
Greatgirthy,hyjal,1106,paladin,retribution,30,13,17
Thanatiel,area-52,1104,paladin,retribution,66,37,29
Savagefck,sargeras,1103,paladin,retribution,24,15,9
Billnighy,alleria,1103,paladin,retribution,66,32,34
Vanillur,tichondrius,1103,paladin,retribution,55,24,31
Gtate,azjolnerub,1102,paladin,retribution,23,12,11
Decareos,tichondrius,1102,paladin,retribution,29,12,17
Hyperforce,area-52,1099,paladin,retribution,30,12,18
Soukaa,illidan,1097,paladin,retribution,23,12,11
Gorgrand,gorgonnash,1097,paladin,retribution,39,14,25
Holladrik,frostmourne,1096,paladin,retribution,36,12,24
Lucifuge,twisting-nether,1095,paladin,retribution,18,12,6
Durothar,dalaran,1095,paladin,retribution,42,22,20
Aowynd,tichondrius,1094,paladin,retribution,79,39,40
Riggar,uther,1094,paladin,retribution,77,31,46
Kegmight,emerald-dream,1093,paladin,retribution,41,13,28
Kittylickers,tichondrius,1092,paladin,retribution,108,56,52
Omenix,laughing-skull,1091,paladin,retribution,29,12,17
Cheesetitan,tichondrius,1090,paladin,retribution,52,22,30
Mcbraín,quelthalas,1089,paladin,retribution,30,12,18
Alairius,tichondrius,1087,paladin,retribution,23,15,8
Killumminati,tichondrius,1087,paladin,retribution,21,13,8
Rikkupìgu,sargeras,1087,paladin,retribution,20,12,8
Pldd,tichondrius,1087,paladin,retribution,76,33,43
Pallydin,smolderthorn,1086,paladin,retribution,30,15,15
Rétribution,farstriders,1086,paladin,retribution,46,21,25
Mybadfoo,lethon,1085,paladin,retribution,18,13,5
Salvations,queldorei,1085,paladin,retribution,60,30,30
Xandish,illidan,1084,paladin,retribution,20,12,8
Bubblegums,nagrand,1084,paladin,retribution,69,39,30
Grimhammer,the-scryers,1083,paladin,retribution,61,31,30
Thirtyfivemm,area-52,1083,paladin,retribution,58,29,29
Thorsmites,sargeras,1082,paladin,retribution,42,17,25
Bubbleosevn,dragonmaw,1079,paladin,retribution,26,12,14
Astralweed,quelthalas,1079,paladin,retribution,54,19,35
Eliasor,illidan,1077,paladin,retribution,18,13,5
Lízandor,ragnaros,1077,paladin,retribution,17,12,5
Zir,frostmourne,1077,paladin,retribution,47,24,23
Saamuus,quelthalas,1077,paladin,retribution,32,13,19
Warswordz,stormrage,1077,paladin,retribution,40,16,24
Clefairy,arathor,1076,paladin,retribution,39,23,16
Jonsnou,tol-barad,1074,paladin,retribution,36,14,22
Zorkus,turalyon,1073,paladin,retribution,42,22,20
Brightfire,dawnbringer,1073,paladin,retribution,36,13,23
Missoutale,aerie-peak,1072,paladin,retribution,82,35,47
Trappadin,sargeras,1070,paladin,retribution,42,19,23
Heiinneken,queldorei,1065,paladin,retribution,20,12,8
Kaidao,black-dragonflight,1065,paladin,retribution,24,12,12
Karimpro,emerald-dream,1065,paladin,retribution,38,15,23
Morddrohung,hyjal,1063,paladin,retribution,18,12,6
Holygerp,darrowmere,1060,paladin,retribution,18,12,6
Anyatay,ragnaros,1060,paladin,retribution,77,28,49
Tinithis,tichondrius,1059,paladin,retribution,17,12,5
Andras,emerald-dream,1059,paladin,retribution,22,12,10
Caitlyn,nazjatar,1058,paladin,retribution,30,17,13
Jinfandi,gurubashi,1058,paladin,retribution,36,13,23
Lessera,tichondrius,1057,paladin,retribution,26,12,14
Zözo,zuljin,1056,paladin,retribution,18,11,7
Retsupreme,tichondrius,1056,paladin,retribution,18,11,7
Dasp,nagrand,1056,paladin,retribution,18,11,7
Hardnow,emerald-dream,1056,paladin,retribution,24,11,13
Makayla,kiljaeden,1056,paladin,retribution,24,11,13
Wogharder,stormrage,1056,paladin,retribution,30,11,19
Siq,arthas,1056,paladin,retribution,30,11,19
Bakednub,malganis,1056,paladin,retribution,35,11,24
Redarted,thrall,1055,paladin,retribution,18,11,7
Volcathos,moon-guard,1055,paladin,retribution,18,11,7
Ricocheto,ragnaros,1055,paladin,retribution,18,11,7
Wonpaiv,frostmourne,1055,paladin,retribution,18,11,7
Jakkatähn,malganis,1055,paladin,retribution,24,11,13
Thrandeill,bleeding-hollow,1055,paladin,retribution,24,11,13
Kmackk,tichondrius,1055,paladin,retribution,24,11,13
Armstrong,azralon,1055,paladin,retribution,24,11,13
Pugnacity,stormrage,1055,paladin,retribution,30,11,19
Imposstopzc,chogall,1055,paladin,retribution,53,19,34
Grimven,stormrage,1054,paladin,retribution,18,11,7
Hrota,laughing-skull,1054,paladin,retribution,18,11,7
Gannecus,bleeding-hollow,1054,paladin,retribution,18,11,7
Arena,mannoroth,1054,paladin,retribution,24,11,13
Protarena,zuljin,1054,paladin,retribution,24,11,13
Telvannî,sargeras,1054,paladin,retribution,24,11,13
Pallyzo,zuljin,1054,paladin,retribution,24,11,13
Varaben,sargeras,1054,paladin,retribution,36,11,25
Ðreschí,ragnaros,1053,paladin,retribution,22,11,11
Dividin,stormrage,1053,paladin,retribution,24,11,13
Vincible,illidan,1053,paladin,retribution,24,11,13
Divineknight,moonrunner,1053,paladin,retribution,24,11,13
Cripplemakër,stormrage,1052,paladin,retribution,18,11,7
Vynesonia,emerald-dream,1052,paladin,retribution,21,12,9
Brolando,hyjal,1052,paladin,retribution,24,11,13
Jåckél,wyrmrest-accord,1052,paladin,retribution,30,11,19
Iesous,kiljaeden,1051,paladin,retribution,18,11,7
Ragnore,shadow-council,1051,paladin,retribution,21,12,9
Exulta,illidan,1051,paladin,retribution,60,32,28
Daeriius,moon-guard,1051,paladin,retribution,24,11,13
Dominance,blackrock,1051,paladin,retribution,24,11,13
Sleekz,moon-guard,1051,paladin,retribution,24,11,13
Hermacles,stormrage,1051,paladin,retribution,25,11,14
Libertylol,tichondrius,1051,paladin,retribution,28,12,16
Släyèr,tichondrius,1051,paladin,retribution,30,11,19
Caonizumu,area-52,1051,paladin,retribution,30,11,19
Ranthoril,hydraxis,1050,paladin,retribution,12,11,1
Vankaer,uldum,1050,paladin,retribution,18,11,7
Cowhair,tichondrius,1050,paladin,retribution,24,11,13
Tacohuntter,stormrage,1050,paladin,retribution,24,11,13
Kaélthas,eonar,1050,paladin,retribution,24,11,13
Connore,stormrage,1050,paladin,retribution,24,11,13
Saîntpaul,shattered-halls,1050,paladin,retribution,30,11,19
Ødin,turalyon,1049,paladin,retribution,18,11,7
Freÿdis,tichondrius,1049,paladin,retribution,18,11,7
Reaslovak,jubeithos,1049,paladin,retribution,18,11,7
Mangguo,tichondrius,1049,paladin,retribution,24,11,13
Gringi,blackrock,1049,paladin,retribution,24,11,13
Amlovích,quelthalas,1049,paladin,retribution,24,11,13
Wingalings,malganis,1049,paladin,retribution,28,12,16
Morghelm,stormrage,1048,paladin,retribution,12,11,1
Unknownplay,tichondrius,1048,paladin,retribution,18,11,7
Lïgma,dalaran,1048,paladin,retribution,18,11,7
Jajabola,zuljin,1048,paladin,retribution,24,11,13
Dorka,illidan,1048,paladin,retribution,30,11,19
Teewrecks,frostmourne,1048,paladin,retribution,30,11,19
Tieberion,bleeding-hollow,1048,paladin,retribution,30,11,19
Pappábear,tichondrius,1047,paladin,retribution,26,16,10
Everyni,area-52,1047,paladin,retribution,18,11,7
Stonekey,warsong,1046,paladin,retribution,18,11,7
Kiboko,tichondrius,1046,paladin,retribution,19,11,8
Pickypally,moon-guard,1046,paladin,retribution,30,17,13
Lunchboxz,nazjatar,1046,paladin,retribution,24,11,13
Flashbang,nazgrel,1046,paladin,retribution,30,11,19
Pâpito,drakkari,1046,paladin,retribution,30,11,19
Doogo,cenarius,1045,paladin,retribution,18,11,7
Souiler,thunderlord,1045,paladin,retribution,22,12,10
Guji,jubeithos,1045,paladin,retribution,24,11,13
Kènjii,sargeras,1044,paladin,retribution,40,20,20
Strobeyjr,tichondrius,1044,paladin,retribution,24,11,13
Rensvall,frostmourne,1043,paladin,retribution,24,13,11
Çløúdéd,area-52,1043,paladin,retribution,24,11,13
Berthalas,stormrage,1042,paladin,retribution,18,11,7
Pallyjs,anetheron,1042,paladin,retribution,18,11,7
Biblestomp,laughing-skull,1042,paladin,retribution,18,11,7
Brocolinî,zuljin,1042,paladin,retribution,24,11,13
Holyfilers,thunderlord,1042,paladin,retribution,30,11,19
Weenerboy,nerzhul,1041,paladin,retribution,18,11,7
Ilumine,mannoroth,1041,paladin,retribution,24,11,13
Neutroo,stormrage,1039,paladin,retribution,24,11,13
Ceebuck,thrall,1038,paladin,retribution,24,11,13
Fenfrineflo,azralon,1035,paladin,retribution,42,13,29
Willhookah,azralon,1034,paladin,retribution,54,25,29
Bainn,nerzhul,1033,paladin,retribution,49,28,21
Mortika,frostmourne,1033,paladin,retribution,36,17,19
Kryzshine,frostmourne,1030,paladin,retribution,18,11,7
Atreuss,moon-guard,1029,paladin,retribution,42,21,21
Asunima,wyrmrest-accord,1029,paladin,retribution,24,11,13
Dreadain,gilneas,1027,paladin,retribution,24,11,13
Holyqunt,dalaran,1026,paladin,retribution,24,11,13
Murtsza,ragnaros,1026,paladin,retribution,60,21,39
Moraxeus,gundrak,1020,paladin,retribution,18,11,7
Theseuus,stormrage,1020,paladin,retribution,60,27,33
Furnost,drenden,1019,paladin,retribution,23,11,12
Wasimodo,emerald-dream,1019,paladin,retribution,66,31,35
Pleasureman,gallywix,1017,paladin,retribution,24,12,12
Volorick,dalaran,1016,paladin,retribution,38,13,25
Sisterbubble,dathremar,1013,paladin,retribution,29,11,18
Dirtfunk,illidan,1011,paladin,retribution,48,18,30
Alpine,nordrassil,1009,paladin,retribution,85,44,41
Nejie,nazjatar,1009,paladin,retribution,42,21,21
Tuff,ysera,1008,paladin,retribution,36,21,15
Keu,emerald-dream,1008,paladin,retribution,63,26,37
Judgingu,proudmoore,1006,paladin,retribution,21,11,10
Chilenoman,ragnaros,1004,paladin,retribution,48,21,27
Loween,thunderlord,1002,paladin,retribution,54,22,32
Smithulu,kelthuzad,997,paladin,retribution,45,24,21
Tyrswrath,sargeras,992,paladin,retribution,36,19,17
Bigsamtp,laughing-skull,992,paladin,retribution,23,11,12
Whitepally,kiljaeden,992,paladin,retribution,28,11,17
Iammj,skywall,990,paladin,retribution,17,11,6
Guanglong,malganis,989,paladin,retribution,32,11,21
Ssparkk,stormrage,989,paladin,retribution,35,12,23
Veroth,caelestrasz,988,paladin,retribution,26,11,15
Lêe,dalaran,987,paladin,retribution,15,12,3
Tharkeves,cenarius,987,paladin,retribution,22,11,11
Playandrunn,illidan,984,paladin,retribution,22,11,11
Vinjonc,drenden,977,paladin,retribution,60,30,30
Webby,azjolnerub,975,paladin,retribution,26,12,14
Hammerhitter,lightbringer,972,paladin,retribution,36,14,22
Follower,sargeras,967,paladin,retribution,71,31,40
Cès,tichondrius,960,paladin,retribution,12,10,2
Bigfkndam,dathremar,960,paladin,retribution,12,10,2
Eloinflated,malganis,960,paladin,retribution,18,10,8
Überlin,whisperwind,960,paladin,retribution,18,10,8
Ripsader,stormrage,960,paladin,retribution,18,10,8
Meleegodx,darkspear,960,paladin,retribution,18,10,8
Hyphenated,frostmourne,960,paladin,retribution,18,10,8
Hasmere,tichondrius,960,paladin,retribution,18,10,8
Bigboiszn,area-52,960,paladin,retribution,18,10,8
Saven,proudmoore,960,paladin,retribution,18,10,8
Tiduz,tichondrius,960,paladin,retribution,18,10,8
Khanid,emerald-dream,960,paladin,retribution,18,10,8
Èmmà,stormrage,960,paladin,retribution,18,10,8
Emiaru,illidan,960,paladin,retribution,22,11,11
Fumaçaa,nemesis,960,paladin,retribution,27,13,14
Giovannas,tichondrius,960,paladin,retribution,24,10,14
Legèndaïry,tichondrius,960,paladin,retribution,24,10,14
Randomwalk,illidan,960,paladin,retribution,24,10,14
Talionz,illidan,960,paladin,retribution,24,10,14
Friendfriend,proudmoore,960,paladin,retribution,24,10,14
Alodor,dalaran,960,paladin,retribution,24,10,14
Komonai,illidan,960,paladin,retribution,24,10,14
Miketavius,moon-guard,960,paladin,retribution,24,10,14
Drriz,stormrage,960,paladin,retribution,24,10,14
Wryly,mannoroth,960,paladin,retribution,30,10,20
Gompa,bleeding-hollow,960,paladin,retribution,30,10,20
Kasoon,illidan,959,paladin,retribution,12,10,2
Bop,azralon,959,paladin,retribution,12,10,2
Strattaltork,ragnaros,959,paladin,retribution,18,10,8
Shawra,moon-guard,959,paladin,retribution,18,10,8
Kayaman,tichondrius,959,paladin,retribution,18,10,8
Lightsheart,lightbringer,959,paladin,retribution,18,10,8
Daeyang,tichondrius,959,paladin,retribution,18,10,8
Astraelon,bleeding-hollow,959,paladin,retribution,18,10,8
ßöbby,sargeras,959,paladin,retribution,18,10,8
Yugawn,maiev,959,paladin,retribution,18,10,8
Kaetix,frostmourne,959,paladin,retribution,18,10,8
Lawzaddy,tichondrius,959,paladin,retribution,18,10,8
Andriaana,moon-guard,959,paladin,retribution,18,10,8
Lyghts,darkspear,959,paladin,retribution,18,10,8
Grimmune,illidan,959,paladin,retribution,24,10,14
Déathkiing,area-52,959,paladin,retribution,24,10,14
Dithfeo,tichondrius,959,paladin,retribution,24,10,14
Roddaric,nerzhul,959,paladin,retribution,24,10,14
Zetka,tichondrius,959,paladin,retribution,24,10,14
Hôtt,kul-tiras,959,paladin,retribution,24,10,14
Tazanian,aegwynn,959,paladin,retribution,24,10,14
Runö,frostmourne,959,paladin,retribution,37,10,27
Littlebadbad,tichondrius,958,paladin,retribution,12,10,2
Sathras,madoran,958,paladin,retribution,18,10,8
Deadpoolman,emerald-dream,958,paladin,retribution,18,10,8
Svenn,eredar,958,paladin,retribution,18,10,8
Noitra,azralon,958,paladin,retribution,18,10,8
Zyden,hellscream,958,paladin,retribution,18,10,8
Bootcrusader,thrall,958,paladin,retribution,21,11,10
Avengercc,tichondrius,958,paladin,retribution,24,10,14
Benevolént,area-52,958,paladin,retribution,24,10,14
Korranix,sargeras,958,paladin,retribution,28,11,17
Krønos,nordrassil,958,paladin,retribution,28,11,17
Verdicts,moon-guard,958,paladin,retribution,30,10,20
Fokatayew,korialstrasz,958,paladin,retribution,30,10,20
Donmi,dalaran,957,paladin,retribution,15,11,4
Checkeettpal,sargeras,957,paladin,retribution,18,10,8
Grünt,ragnaros,957,paladin,retribution,18,10,8
Olsen,stormrage,957,paladin,retribution,18,10,8
Poobiotic,frostmourne,957,paladin,retribution,18,10,8
Luxord,ysera,957,paladin,retribution,22,11,11
Retxmack,lightnings-blade,957,paladin,retribution,24,10,14
Rektodin,tichondrius,957,paladin,retribution,24,10,14
Petunias,malganis,957,paladin,retribution,30,10,20
Brifos,sargeras,957,paladin,retribution,31,10,21
Vulkaros,azralon,956,paladin,retribution,12,10,2
Vacoro,tichondrius,956,paladin,retribution,18,10,8
Caylorn,illidan,956,paladin,retribution,18,10,8
Ryumi,lightbringer,956,paladin,retribution,24,10,14
Runscapemain,feathermoon,955,paladin,retribution,22,11,11
Bigjwpb,illidan,955,paladin,retribution,244,117,127
Vólko,frostmourne,955,paladin,retribution,21,10,11
Flyinpankake,illidan,955,paladin,retribution,24,10,14
Heälmeñow,tichondrius,955,paladin,retribution,24,10,14
Winbott,sargeras,955,paladin,retribution,30,10,20
Torujo,drakkari,954,paladin,retribution,18,10,8
Lunchboxpaly,stormrage,954,paladin,retribution,18,10,8
Cacaine,goldrinn,954,paladin,retribution,21,11,10
Kelenis,bonechewer,954,paladin,retribution,24,10,14
Tomcat,bladefist,954,paladin,retribution,24,10,14
Sòl,stormrage,954,paladin,retribution,24,10,14
Didymus,boulderfist,954,paladin,retribution,41,17,24
Coffiecup,frostmane,953,paladin,retribution,18,10,8
Kelleybelly,black-dragonflight,953,paladin,retribution,25,10,15
Llght,hydraxis,952,paladin,retribution,18,10,8
Aura,stormreaver,952,paladin,retribution,18,10,8
Exeneyder,elune,952,paladin,retribution,25,10,15
Housemix,gurubashi,951,paladin,retribution,18,12,6
Edjr,stormrage,951,paladin,retribution,18,10,8
Giancenna,illidan,950,paladin,retribution,18,10,8
Aewein,ragnaros,950,paladin,retribution,23,10,13
Lionag,ragnaros,950,paladin,retribution,24,10,14
Xhotbutters,korgath,945,paladin,retribution,31,13,18
Ridethispony,tichondrius,945,paladin,retribution,36,10,26
Mehchelol,azgalor,939,paladin,retribution,36,19,17
Unicochori,drakkari,939,paladin,retribution,24,10,14
Charopiinho,azralon,938,paladin,retribution,30,10,20
Sanctum,barthilas,936,paladin,retribution,153,72,81
Bigboytime,area-52,934,paladin,retribution,24,10,14
Lailaa,balnazzar,932,paladin,retribution,30,13,17
Cherrypally,area-52,927,paladin,retribution,23,10,13
Nerfret,zuljin,926,paladin,retribution,14,11,3
Celerios,stormreaver,926,paladin,retribution,19,11,8
Cuthroat,area-52,926,paladin,retribution,318,156,162
Biggin,garona,924,paladin,retribution,136,51,85
Bukkning,tichondrius,922,paladin,retribution,58,17,41
Pallyoh,moknathal,921,paladin,retribution,41,23,18
Vengecide,proudmoore,920,paladin,retribution,24,13,11
Kokuryuha,quelthalas,919,paladin,retribution,52,24,28
Diësëlsmoke,bronzebeard,917,paladin,retribution,18,10,8
Toepuller,doomhammer,917,paladin,retribution,42,21,21
Slædgæhæmmær,bonechewer,917,paladin,retribution,42,13,29
Brandforge,thunderlord,916,paladin,retribution,18,10,8
Goldranger,hakkar,916,paladin,retribution,42,22,20
Elgigante,azshara,914,paladin,retribution,48,25,23
Avlystein,wyrmrest-accord,914,paladin,retribution,89,29,60
Taéyeon,quelthalas,911,paladin,retribution,21,10,11
Rebukezz,dalaran,911,paladin,retribution,23,10,13
Stinaz,quelthalas,911,paladin,retribution,23,10,13
Eljefee,emerald-dream,902,paladin,retribution,29,12,17
Zentrick,whisperwind,902,paladin,retribution,42,16,26
Lilsquirt,proudmoore,901,paladin,retribution,23,14,9
Nuisances,illidan,899,paladin,retribution,18,10,8
Kilidin,illidan,899,paladin,retribution,21,10,11
Iralyn,frostmane,899,paladin,retribution,24,10,14
Denthor,lightbringer,894,paladin,retribution,20,10,10
Leennoox,quelthalas,894,paladin,retribution,41,17,24
Narthres,drakkari,894,paladin,retribution,28,10,18
Tectorr,proudmoore,893,paladin,retribution,78,38,40
Àmárìs,tichondrius,882,paladin,retribution,22,10,12
Releváncé,frostmourne,879,paladin,retribution,33,10,23
Allandaa,frostmourne,878,paladin,retribution,25,10,15
Dragollias,anvilmar,874,paladin,retribution,30,10,20
Deltajk,drakkari,872,paladin,retribution,42,19,23
Jonnywick,duskwood,872,paladin,retribution,36,13,23
Juang,arthas,866,paladin,retribution,54,24,30
Akumasakana,earthen-ring,864,paladin,retribution,12,9,3
Divenelena,sargeras,864,paladin,retribution,12,9,3
Skinnipeen,frostmourne,864,paladin,retribution,12,9,3
Arukan,ragnaros,864,paladin,retribution,12,9,3
Notprot,zuljin,864,paladin,retribution,12,9,3
Raggnarokk,kelthuzad,864,paladin,retribution,12,9,3
Naughtygames,area-52,864,paladin,retribution,12,9,3
Arimae,turalyon,864,paladin,retribution,12,9,3
Swegswog,frostmourne,864,paladin,retribution,12,9,3
Slivkoff,wyrmrest-accord,864,paladin,retribution,12,9,3
Fierfox,moon-guard,864,paladin,retribution,12,9,3
Chrigpal,tichondrius,864,paladin,retribution,12,9,3
Sonô,sargeras,864,paladin,retribution,12,9,3
Tlawn,tichondrius,864,paladin,retribution,18,9,9
Brohtato,area-52,864,paladin,retribution,18,9,9
Rendyrend,frostmourne,864,paladin,retribution,18,9,9
Bigdixss,tichondrius,864,paladin,retribution,18,9,9
Zzerox,ragnaros,864,paladin,retribution,18,9,9
Nite,thrall,864,paladin,retribution,18,9,9
Héber,nemesis,864,paladin,retribution,18,9,9
Rockdeath,sargeras,864,paladin,retribution,18,9,9
Beefdaddyx,tichondrius,864,paladin,retribution,18,9,9
Wogyu,area-52,864,paladin,retribution,18,9,9
Strodvarn,proudmoore,864,paladin,retribution,18,9,9
Axeliee,kiljaeden,864,paladin,retribution,18,9,9
Yáhtzee,tichondrius,864,paladin,retribution,22,10,12
Althsar,thunderlord,864,paladin,retribution,26,11,15
Bageru,gnomeregan,864,paladin,retribution,24,9,15
Manryux,tichondrius,864,paladin,retribution,24,9,15
Hulfsark,stormrage,864,paladin,retribution,24,9,15
Suro,moon-guard,864,paladin,retribution,24,9,15
Yowanehaku,illidan,864,paladin,retribution,24,9,15
Pistis,kelthuzad,864,paladin,retribution,24,9,15
Traevel,moon-guard,864,paladin,retribution,24,9,15
Auranove,azralon,864,paladin,retribution,24,9,15
Valinorean,nemesis,864,paladin,retribution,24,9,15
Stoof,arygos,864,paladin,retribution,24,9,15
Ownedcrazy,stormrage,864,paladin,retribution,24,9,15
Saintgeórge,frostmourne,864,paladin,retribution,25,9,16
Doxan,quelthalas,864,paladin,retribution,30,9,21
Stolzy,tichondrius,864,paladin,retribution,31,9,22
Mightymagnus,silvermoon,863,paladin,retribution,12,9,3
Glorious,drakkari,863,paladin,retribution,12,9,3
Tayvar,stormrage,863,paladin,retribution,12,9,3
Mightythorxx,tichondrius,863,paladin,retribution,12,9,3
Heathen,spirestone,863,paladin,retribution,12,9,3
Spruk,greymane,863,paladin,retribution,12,9,3
Veliona,thaurissan,863,paladin,retribution,12,9,3
Lenlaar,shadowsong,863,paladin,retribution,12,9,3
Pallyofhell,area-52,863,paladin,retribution,12,9,3
Valandur,kelthuzad,863,paladin,retribution,18,9,9
Jhaann,tichondrius,863,paladin,retribution,18,9,9
Paliwarrior,illidan,863,paladin,retribution,18,9,9
Drinkn,kelthuzad,863,paladin,retribution,18,9,9
Relsetta,sargeras,863,paladin,retribution,18,9,9
Holyweaponz,sargeras,863,paladin,retribution,18,9,9
Avacii,illidan,863,paladin,retribution,18,9,9
Landryy,icecrown,863,paladin,retribution,18,9,9
Ahzalon,azralon,863,paladin,retribution,18,9,9
Lightballz,vashj,863,paladin,retribution,18,9,9
Enril,azgalor,863,paladin,retribution,18,9,9
Ltt,dalaran,863,paladin,retribution,18,9,9
Wálker,ragnaros,863,paladin,retribution,18,9,9
Hailsatans,ragnaros,863,paladin,retribution,18,9,9
Remorâ,blackrock,863,paladin,retribution,18,9,9
Wimans,quelthalas,863,paladin,retribution,18,9,9
Escanøor,stormrage,863,paladin,retribution,18,9,9
Wideloadphd,malganis,863,paladin,retribution,18,9,9
Heizero,area-52,863,paladin,retribution,18,9,9
Hammertime,boulderfist,863,paladin,retribution,18,9,9
Ironprice,tichondrius,863,paladin,retribution,18,9,9
Mohrdeth,bonechewer,863,paladin,retribution,18,9,9
Loraven,wyrmrest-accord,863,paladin,retribution,18,9,9
Dreamlightz,tichondrius,863,paladin,retribution,18,9,9
Trevion,malganis,863,paladin,retribution,24,9,15
Mateeka,malganis,863,paladin,retribution,24,9,15
Rivzx,tichondrius,863,paladin,retribution,24,9,15
Stricken,kul-tiras,863,paladin,retribution,24,9,15
Delvious,proudmoore,863,paladin,retribution,24,9,15
Terrordin,illidan,863,paladin,retribution,24,9,15
Galadriele,zuljin,863,paladin,retribution,24,9,15
Amntir,sargeras,863,paladin,retribution,24,9,15
Nuuska,dalaran,863,paladin,retribution,24,9,15
Roländ,thrall,863,paladin,retribution,24,9,15
Thickdam,korgath,863,paladin,retribution,24,9,15
Zerohöur,emerald-dream,863,paladin,retribution,30,9,21
Deddy,malganis,863,paladin,retribution,30,9,21
Zrkoria,ragnaros,863,paladin,retribution,36,9,27
Zero,garona,863,paladin,retribution,36,9,27
Ástedór,ragnaros,862,paladin,retribution,12,9,3
Sabêr,ragnaros,862,paladin,retribution,12,9,3
Badboí,azralon,862,paladin,retribution,12,9,3
Keiora,sargeras,862,paladin,retribution,12,9,3
Fante,alleria,862,paladin,retribution,16,10,6
Chàrron,garrosh,862,paladin,retribution,18,9,9
Surrogat,ragnaros,862,paladin,retribution,18,9,9
Lightblade,stormrage,862,paladin,retribution,18,9,9
Rocknpally,icecrown,862,paladin,retribution,18,9,9
Naritan,greymane,862,paladin,retribution,18,9,9
Pinelli,aegwynn,862,paladin,retribution,18,9,9
Xlnc,illidan,862,paladin,retribution,18,9,9
Illëst,stormrage,862,paladin,retribution,18,9,9
Omegaziion,garrosh,862,paladin,retribution,18,9,9
Karelys,area-52,862,paladin,retribution,20,9,11
Ashric,moon-guard,862,paladin,retribution,24,9,15
Aewynn,nemesis,862,paladin,retribution,24,9,15
Boogerred,korialstrasz,862,paladin,retribution,24,9,15
Gerian,altar-of-storms,862,paladin,retribution,24,9,15
Retligious,kelthuzad,861,paladin,retribution,12,9,3
Stevas,khazgoroth,861,paladin,retribution,12,9,3
Ringout,tichondrius,861,paladin,retribution,18,9,9
Borélock,kelthuzad,861,paladin,retribution,18,9,9
Kommuna,stormscale,861,paladin,retribution,18,9,9
Clamhammer,malganis,861,paladin,retribution,18,9,9
Guttis,nemesis,861,paladin,retribution,18,9,9
Aerandír,stormrage,861,paladin,retribution,18,9,9
Ashess,sargeras,861,paladin,retribution,24,9,15
Rennalux,stormrage,861,paladin,retribution,24,9,15
Deztrom,dalaran,860,paladin,retribution,12,9,3
Punjabeast,illidan,860,paladin,retribution,16,10,6
Jiasmat,ragnaros,860,paladin,retribution,28,12,16
Unholypally,suramar,860,paladin,retribution,24,9,15
Rusticles,aerie-peak,860,paladin,retribution,24,9,15
Lexdor,quelthalas,860,paladin,retribution,30,9,21
Easiestcomp,sargeras,859,paladin,retribution,18,9,9
Khetzi,thunderhorn,859,paladin,retribution,18,9,9
Kylarha,stormrage,859,paladin,retribution,18,9,9
Layonthis,the-venture-co,859,paladin,retribution,18,9,9
Mòse,emerald-dream,859,paladin,retribution,18,9,9
Atularis,tichondrius,858,paladin,retribution,12,9,3
Irongiant,grizzly-hills,858,paladin,retribution,18,9,9
Derethen,emerald-dream,858,paladin,retribution,18,9,9
Alysca,tichondrius,858,paladin,retribution,18,9,9
Abuenano,ragnaros,857,paladin,retribution,12,9,3
Vick,zuljin,857,paladin,retribution,12,9,3
Holyzeen,darkspear,857,paladin,retribution,17,11,6
Alerz,moon-guard,857,paladin,retribution,15,9,6
Amyrana,medivh,857,paladin,retribution,24,9,15
Frostbitee,nerzhul,856,paladin,retribution,18,9,9
Atilas,ragnaros,856,paladin,retribution,18,9,9
Zerolayer,proudmoore,855,paladin,retribution,12,9,3
Maraboujan,nemesis,855,paladin,retribution,18,9,9
Persefaní,moon-guard,855,paladin,retribution,18,9,9
Clariten,ghostlands,855,paladin,retribution,24,9,15
Agonyss,quelthalas,853,paladin,retribution,18,9,9
Goldfînger,zuljin,853,paladin,retribution,24,9,15
Jade,black-dragonflight,853,paladin,retribution,30,9,21
Eldirn,bleeding-hollow,848,paladin,retribution,18,9,9
Leyon,alterac-mountains,847,paladin,retribution,18,9,9
Elysés,stormrage,846,paladin,retribution,17,9,8
Morthalos,moon-guard,845,paladin,retribution,23,9,14
Reti,ursin,844,paladin,retribution,193,94,99
Hotdgwatr,bleeding-hollow,843,paladin,retribution,24,10,14
Avaheal,dragonmaw,842,paladin,retribution,23,9,14
Palgiga,tichondrius,834,paladin,retribution,18,9,9
Palee,garrosh,833,paladin,retribution,44,19,25
Brioc,tichondrius,832,paladin,retribution,22,9,13
Lemuzinho,ragnaros,831,paladin,retribution,14,10,4
Bellamor,burning-blade,830,paladin,retribution,17,9,8
Poppmybubble,frostmourne,816,paladin,retribution,21,9,12
Hallowgrave,moon-guard,815,paladin,retribution,11,9,2
Sinica,barthilas,815,paladin,retribution,17,9,8
Fiate,azralon,815,paladin,retribution,23,9,14
ßirdie,ragnaros,814,paladin,retribution,23,9,14
Yulzypal,tichondrius,813,paladin,retribution,17,9,8
Cozzey,amanthul,810,paladin,retribution,17,9,8
Naeamen,dragonmaw,808,paladin,retribution,15,10,5
Porterhousee,bleeding-hollow,807,paladin,retribution,23,11,12
Sondaar,madoran,807,paladin,retribution,65,18,47
Zela,ghostlands,805,paladin,retribution,23,9,14
Connextion,terenas,800,paladin,retribution,22,9,13
Lizzyz,illidan,799,paladin,retribution,20,9,11
Witewolf,illidan,798,paladin,retribution,19,10,9
Erós,azralon,798,paladin,retribution,22,9,13
Navex,tichondrius,797,paladin,retribution,16,9,7
Gryphin,moon-guard,797,paladin,retribution,20,9,11
Lightfdre,rexxar,797,paladin,retribution,33,11,22
Kûrâmâ,ragnaros,796,paladin,retribution,16,9,7
Kiloalpha,area-52,791,paladin,retribution,22,9,13
Lítebearer,kelthuzad,787,paladin,retribution,17,9,8
Kletüs,quelthalas,784,paladin,retribution,13,9,4
Rspect,trollbane,782,paladin,retribution,11,9,2
Jdisco,bonechewer,782,paladin,retribution,19,9,10
Wrekkin,stormrage,772,paladin,retribution,37,9,28
Retpa,tichondrius,768,paladin,retribution,12,8,4
Hypheríon,ragnaros,768,paladin,retribution,12,8,4
Franckz,ragnaros,768,paladin,retribution,12,8,4
Pochanaw,wyrmrest-accord,768,paladin,retribution,12,8,4
Liangguang,tichondrius,768,paladin,retribution,12,8,4
Unicornslayr,antonidas,768,paladin,retribution,12,8,4
Céllash,tichondrius,768,paladin,retribution,12,8,4
Sebbytheman,tichondrius,768,paladin,retribution,12,8,4
Tolliver,area-52,768,paladin,retribution,12,8,4
Depøpulatìng,moon-guard,768,paladin,retribution,12,8,4
Twobuttons,draktharon,768,paladin,retribution,12,8,4
Lotarow,wyrmrest-accord,768,paladin,retribution,12,8,4
Syorì,wyrmrest-accord,768,paladin,retribution,12,8,4
Swellows,tichondrius,768,paladin,retribution,12,8,4
Takinvcards,area-52,768,paladin,retribution,12,8,4
Arellis,barthilas,768,paladin,retribution,12,8,4
Valoren,spinebreaker,768,paladin,retribution,12,8,4
Cratos,nemesis,768,paladin,retribution,12,8,4
Illustrata,illidan,768,paladin,retribution,12,8,4
Allpower,azralon,768,paladin,retribution,12,8,4
Luzmu,azralon,768,paladin,retribution,12,8,4
Pennywenny,barthilas,768,paladin,retribution,12,8,4
Eskynor,sargeras,768,paladin,retribution,12,8,4
Baloria,stormrage,768,paladin,retribution,12,8,4
Brotherjon,stormrage,768,paladin,retribution,12,8,4
Mortalbeef,zuljin,768,paladin,retribution,12,8,4
Lastjedi,whisperwind,768,paladin,retribution,12,8,4
Laboøn,stormrage,768,paladin,retribution,12,8,4
Zelo,emerald-dream,768,paladin,retribution,12,8,4
Meditaté,emerald-dream,768,paladin,retribution,12,8,4
Soymilkdrnka,sargeras,768,paladin,retribution,12,8,4
Djangø,azuremyst,768,paladin,retribution,12,8,4
Cutebtw,zuljin,768,paladin,retribution,16,9,7
Grimreaperx,azralon,768,paladin,retribution,17,8,9
Zøzø,zuljin,768,paladin,retribution,18,8,10
Jachugz,tichondrius,768,paladin,retribution,18,8,10
Zaxxous,hyjal,768,paladin,retribution,18,8,10
Ohmyglob,bleeding-hollow,768,paladin,retribution,18,8,10
Mythbuster,frostwolf,768,paladin,retribution,18,8,10
Nozfferatu,drakkari,768,paladin,retribution,18,8,10
Roxiomoxa,ragnaros,768,paladin,retribution,18,8,10
Roshord,quelthalas,768,paladin,retribution,18,8,10
Xamo,drakkari,768,paladin,retribution,18,8,10
Jerichô,destromath,768,paladin,retribution,18,8,10
Maanuel,ragnaros,768,paladin,retribution,18,8,10
Nikho,thunderlord,768,paladin,retribution,18,8,10
Jeralldo,ragnaros,768,paladin,retribution,18,8,10
Caution,rexxar,768,paladin,retribution,18,8,10
Mizumaru,sargeras,768,paladin,retribution,18,8,10
Ratkiller,barthilas,768,paladin,retribution,18,8,10
Jebpal,tichondrius,768,paladin,retribution,18,8,10
Turaylon,bloodscalp,768,paladin,retribution,18,8,10
Vanquishy,burning-legion,768,paladin,retribution,18,8,10
Dynamism,frostmourne,768,paladin,retribution,18,8,10
Bubbletaunt,frostmourne,768,paladin,retribution,18,8,10
Noansr,proudmoore,768,paladin,retribution,18,8,10
Smiteup,sargeras,768,paladin,retribution,18,8,10
Gersin,azralon,768,paladin,retribution,18,8,10
Quiznossubs,kelthuzad,768,paladin,retribution,18,8,10
Palakanda,azralon,768,paladin,retribution,18,8,10
Inquísítor,stormrage,768,paladin,retribution,18,8,10
Theehopper,shandris,768,paladin,retribution,18,8,10
Deltronzerø,area-52,768,paladin,retribution,24,8,16
Bergz,agamaggan,768,paladin,retribution,24,8,16
Immunelf,azgalor,768,paladin,retribution,24,8,16
Forgivers,kiljaeden,768,paladin,retribution,24,8,16
Cnret,tichondrius,768,paladin,retribution,24,8,16
Vibránium,tichondrius,768,paladin,retribution,24,8,16
Rexpeitaboot,azralon,768,paladin,retribution,24,8,16
Bubbleblade,burning-blade,768,paladin,retribution,24,8,16
Marcopolo,azralon,768,paladin,retribution,24,8,16
Isayas,tichondrius,768,paladin,retribution,24,8,16
Crasíus,quelthalas,768,paladin,retribution,30,8,22
Garethorne,illidan,768,paladin,retribution,30,8,22
Roundhere,area-52,768,paladin,retribution,30,8,22
Goldmembër,malganis,768,paladin,retribution,30,8,22
Jarlsirius,tichondrius,767,paladin,retribution,12,8,4
Keit,moon-guard,767,paladin,retribution,12,8,4
Awsem,barthilas,767,paladin,retribution,12,8,4
Hqknight,moon-guard,767,paladin,retribution,12,8,4
Infamoustool,barthilas,767,paladin,retribution,12,8,4
Gläd,tichondrius,767,paladin,retribution,12,8,4
Hoelï,stormrage,767,paladin,retribution,12,8,4
Smitetheweak,rivendare,767,paladin,retribution,12,8,4
Invictus,onyxia,767,paladin,retribution,12,8,4
Rhumil,tichondrius,767,paladin,retribution,12,8,4
Acidhammer,kelthuzad,767,paladin,retribution,12,8,4
Greybrox,barthilas,767,paladin,retribution,12,8,4
Dinapal,frostmourne,767,paladin,retribution,12,8,4
Gospel,duskwood,767,paladin,retribution,12,8,4
Mægenta,tichondrius,767,paladin,retribution,12,8,4
Baladine,zuljin,767,paladin,retribution,12,8,4
Darkestday,hellscream,767,paladin,retribution,12,8,4
Elhoj,illidan,767,paladin,retribution,12,8,4
Sauceclock,illidan,767,paladin,retribution,12,8,4
Faith,thorium-brotherhood,767,paladin,retribution,12,8,4
Darkeclipse,area-52,767,paladin,retribution,12,8,4
Meatyblessin,area-52,767,paladin,retribution,12,8,4
Husurdaddy,dalaran,767,paladin,retribution,12,8,4
Holydaddyy,area-52,767,paladin,retribution,12,8,4
Brubb,illidan,767,paladin,retribution,18,8,10
Angeluquis,quelthalas,767,paladin,retribution,18,8,10
Yyh,illidan,767,paladin,retribution,18,8,10
Blackmuu,malganis,767,paladin,retribution,18,8,10
Jeffprobstt,kelthuzad,767,paladin,retribution,18,8,10
Nutsmashèr,illidan,767,paladin,retribution,18,8,10
Nooplug,illidan,767,paladin,retribution,18,8,10
Nightfallz,farstriders,767,paladin,retribution,18,8,10
Stroods,stormrage,767,paladin,retribution,18,8,10
Janumbers,frostwolf,767,paladin,retribution,18,8,10
Yurinos,illidan,767,paladin,retribution,18,8,10
Zyras,whisperwind,767,paladin,retribution,18,8,10
Avasti,proudmoore,767,paladin,retribution,18,8,10
Toxanator,frostmourne,767,paladin,retribution,18,8,10
Mhortái,stormrage,767,paladin,retribution,18,8,10
Dontsleep,magtheridon,767,paladin,retribution,18,8,10
Holytrev,tichondrius,767,paladin,retribution,18,8,10
Yoiro,stormrage,767,paladin,retribution,18,8,10
Hughkane,tichondrius,767,paladin,retribution,18,8,10
Verbum,malfurion,767,paladin,retribution,18,8,10
Sermon,moon-guard,767,paladin,retribution,18,8,10
Hikarae,bleeding-hollow,767,paladin,retribution,18,8,10
Rodsley,zuljin,767,paladin,retribution,18,8,10
Bruhstice,area-52,767,paladin,retribution,18,8,10
Gåbrîel,emerald-dream,767,paladin,retribution,18,8,10
Yehdardi,frostmourne,767,paladin,retribution,18,8,10
Doobiehigh,proudmoore,767,paladin,retribution,18,8,10
Pudgë,bleeding-hollow,767,paladin,retribution,18,8,10
Chriscoz,korgath,767,paladin,retribution,24,8,16
Ollyollyawks,bloodscalp,767,paladin,retribution,24,8,16
Shãnks,illidan,767,paladin,retribution,24,8,16
Ashbrînger,emerald-dream,767,paladin,retribution,24,8,16
Saifollah,area-52,767,paladin,retribution,30,8,22
Judgementalz,frostwolf,766,paladin,retribution,12,8,4
Palapeludo,azralon,766,paladin,retribution,12,8,4
Passion,wyrmrest-accord,766,paladin,retribution,12,8,4
Dreek,azralon,766,paladin,retribution,12,8,4
Deesqueezie,area-52,766,paladin,retribution,12,8,4
Bübbleboy,malganis,766,paladin,retribution,12,8,4
Otorten,bladefist,766,paladin,retribution,12,8,4
Dubledeez,malganis,766,paladin,retribution,12,8,4
Wehrmachtt,emerald-dream,766,paladin,retribution,18,8,10
Nussaar,kelthuzad,766,paladin,retribution,18,8,10
Dalance,draka,766,paladin,retribution,18,8,10
Dragonbait,khadgar,766,paladin,retribution,18,8,10
Nevanethus,frostmourne,766,paladin,retribution,18,8,10
Masho,skullcrusher,766,paladin,retribution,18,8,10
Crtinsideyou,skullcrusher,766,paladin,retribution,21,9,12
Hanael,quelthalas,766,paladin,retribution,19,8,11
Mothh,terokkar,765,paladin,retribution,12,8,4
Nikinaki,stormrage,765,paladin,retribution,12,8,4
Holyhammered,kelthuzad,765,paladin,retribution,12,8,4
Kristary,ragnaros,765,paladin,retribution,12,8,4
Gírthbrooks,hyjal,765,paladin,retribution,12,8,4
Peepilled,uldum,765,paladin,retribution,12,8,4
Zuljaboi,thrall,765,paladin,retribution,12,8,4
Darktaron,ragnaros,765,paladin,retribution,18,8,10
Wexting,ragnaros,765,paladin,retribution,18,8,10
Micurs,hyjal,765,paladin,retribution,24,8,16
Lightahean,proudmoore,765,paladin,retribution,24,8,16
Butchur,area-52,765,paladin,retribution,30,8,22
Angelz,garrosh,764,paladin,retribution,18,8,10
Calithia,destromath,764,paladin,retribution,18,8,10
Xanamun,magtheridon,764,paladin,retribution,18,8,10
Freesorrow,area-52,764,paladin,retribution,19,8,11
Guccii,quelthalas,763,paladin,retribution,18,8,10
Deathblazer,blades-edge,763,paladin,retribution,18,8,10
Palade,proudmoore,763,paladin,retribution,18,8,10
Mooroy,moon-guard,763,paladin,retribution,18,8,10
Amorimbr,area-52,763,paladin,retribution,24,8,16
Jebadia,proudmoore,762,paladin,retribution,12,8,4
Faerdrik,emerald-dream,762,paladin,retribution,18,8,10
Aetol,proudmoore,762,paladin,retribution,24,8,16
Flisk,garona,761,paladin,retribution,12,8,4
Gilmax,emerald-dream,760,paladin,retribution,18,8,10
Slar,emerald-dream,760,paladin,retribution,18,8,10
Mordrime,moon-guard,760,paladin,retribution,18,8,10
Palman,frostmourne,759,paladin,retribution,18,8,10
Trodos,quelthalas,758,paladin,retribution,12,8,4
Aladid,aggramar,758,paladin,retribution,12,8,4
Appolas,shattered-hand,758,paladin,retribution,12,8,4
Chombe,tichondrius,758,paladin,retribution,18,8,10
Populate,tichondrius,752,paladin,retribution,12,8,4
Piojopaladin,quelthalas,752,paladin,retribution,25,8,17
Supreme,farstriders,751,paladin,retribution,29,8,21
Cleavix,tichondrius,751,paladin,retribution,35,8,27
Captdangle,stormrage,750,paladin,retribution,12,8,4
Dunecan,tichondrius,750,paladin,retribution,17,8,9
Maelie,shadowmoon,749,paladin,retribution,12,8,4
Oogablah,wyrmrest-accord,749,paladin,retribution,12,8,4
Gemutlich,khazgoroth,748,paladin,retribution,23,8,15
Jorkoh,the-scryers,747,paladin,retribution,29,8,21
Shanuslight,moon-guard,742,paladin,retribution,21,9,12
Yulasa,area-52,735,paladin,retribution,14,9,5
Retartin,kelthuzad,735,paladin,retribution,20,9,11
Hekki,ragnaros,735,paladin,retribution,19,8,11
Xcream,nemesis,735,paladin,retribution,32,9,23
Swholly,senjin,733,paladin,retribution,21,10,11
Felordron,silvermoon,731,paladin,retribution,22,9,13
Retgasm,drakthul,729,paladin,retribution,16,8,8
Necrodar,ragnaros,722,paladin,retribution,14,9,5
Darkpalaa,gallywix,722,paladin,retribution,18,8,10
Bomdia,stormrage,720,paladin,retribution,15,8,7
Whisk,tichondrius,720,paladin,retribution,15,8,7
Oxoslayeroxo,firetree,717,paladin,retribution,21,8,13
Romonite,bleeding-hollow,715,paladin,retribution,29,8,21
Lilbursty,tichondrius,714,paladin,retribution,19,9,10
Newwow,tichondrius,714,paladin,retribution,21,9,12
Andorsi,elune,714,paladin,retribution,21,9,12
Ryanslover,kelthuzad,714,paladin,retribution,23,9,14
Pantheeon,altar-of-storms,713,paladin,retribution,30,9,21
Kaallell,blackhand,710,paladin,retribution,22,9,13
Andelk,tichondrius,703,paladin,retribution,14,9,5
Chstypuller,tichondrius,703,paladin,retribution,22,8,14
Mujika,area-52,702,paladin,retribution,14,8,6
Zägä,quelthalas,702,paladin,retribution,26,8,18
Wadalee,tichondrius,702,paladin,retribution,26,8,18
Artaxerxes,stormrage,701,paladin,retribution,20,8,12
Valdarin,emerald-dream,701,paladin,retribution,20,8,12
Bratette,fenris,701,paladin,retribution,62,22,40
Palaðu,azralon,700,paladin,retribution,14,8,6
Kromcrush,azralon,700,paladin,retribution,16,8,8
Fizzlewig,malganis,688,paladin,retribution,19,8,11
Paullokis,gallywix,686,paladin,retribution,13,8,5
Turtlehoof,thrall,684,paladin,retribution,19,8,11
Sparklepuss,turalyon,676,paladin,retribution,17,8,9
Paltarrd,bleeding-hollow,672,paladin,retribution,12,7,5
Safename,area-52,672,paladin,retribution,12,7,5
Nailuj,moon-guard,672,paladin,retribution,12,7,5
Holyåvenger,thunderhorn,672,paladin,retribution,12,7,5
Qsx,bleeding-hollow,672,paladin,retribution,12,7,5
Near,saurfang,672,paladin,retribution,12,7,5
Jellybrah,stormrage,672,paladin,retribution,12,7,5
Araguaney,bleeding-hollow,672,paladin,retribution,12,7,5
Garzzy,tichondrius,672,paladin,retribution,12,7,5
Alahster,sargeras,672,paladin,retribution,12,7,5
Uríel,frostmourne,672,paladin,retribution,12,7,5
Dabbicus,tichondrius,672,paladin,retribution,12,7,5
Noxtrael,frostmourne,672,paladin,retribution,12,7,5
Kanaki,gilneas,672,paladin,retribution,12,7,5
Rektributíon,area-52,672,paladin,retribution,12,7,5
Pallisix,barthilas,672,paladin,retribution,12,7,5
Griezadin,azgalor,672,paladin,retribution,12,7,5
Bighoochie,moon-guard,672,paladin,retribution,12,7,5
Skylightz,area-52,672,paladin,retribution,12,7,5
Aurðra,kiljaeden,672,paladin,retribution,12,7,5
Rexinarr,area-52,672,paladin,retribution,12,7,5
Merkzz,arthas,672,paladin,retribution,12,7,5
Condign,moon-guard,672,paladin,retribution,12,7,5
Steezyret,barthilas,672,paladin,retribution,12,7,5
Steelemantle,moon-guard,672,paladin,retribution,12,7,5
Motivlight,area-52,672,paladin,retribution,12,7,5
Imcjq,tichondrius,672,paladin,retribution,12,7,5
Shadoweelite,sargeras,672,paladin,retribution,12,7,5
Cëlestial,drakkari,672,paladin,retribution,12,7,5
Supernampal,sargeras,672,paladin,retribution,12,7,5
Unitiss,velen,672,paladin,retribution,12,7,5
Wackobeef,barthilas,672,paladin,retribution,12,7,5
Homelord,drakkari,672,paladin,retribution,12,7,5
Naarumaster,stormrage,672,paladin,retribution,12,7,5
Nutbro,tichondrius,672,paladin,retribution,12,7,5
Boxader,dalaran,672,paladin,retribution,12,7,5
Popwingsz,nemesis,672,paladin,retribution,12,7,5
Montyer,ragnaros,672,paladin,retribution,12,7,5
Turner,skullcrusher,672,paladin,retribution,12,7,5
Trejetë,tichondrius,672,paladin,retribution,12,7,5
Attackonpal,illidan,672,paladin,retribution,12,7,5
Thephreak,madoran,672,paladin,retribution,12,7,5
Schecterbug,stormrage,672,paladin,retribution,12,7,5
Irahan,stormrage,672,paladin,retribution,12,7,5
Mikâel,cairne,672,paladin,retribution,12,7,5
Holreshee,tichondrius,672,paladin,retribution,12,7,5
Laurenlight,tichondrius,672,paladin,retribution,12,7,5
Holycar,illidan,672,paladin,retribution,12,7,5
Paredes,demon-soul,672,paladin,retribution,12,7,5
Meridional,tichondrius,672,paladin,retribution,12,7,5
Eduardoap,azralon,672,paladin,retribution,12,7,5
Montecrîsto,area-52,672,paladin,retribution,12,7,5
Bootyfùnk,tichondrius,672,paladin,retribution,12,7,5
Thüridan,azralon,672,paladin,retribution,12,7,5
Iloveket,blackrock,672,paladin,retribution,12,7,5
Tmwesker,azralon,672,paladin,retribution,12,7,5
Teléza,illidan,672,paladin,retribution,12,7,5
Fermion,illidan,672,paladin,retribution,12,7,5
Slighted,illidan,672,paladin,retribution,12,7,5
Wèbb,burning-legion,672,paladin,retribution,12,7,5
Aurelea,frostmourne,672,paladin,retribution,12,7,5
Layson,uldum,672,paladin,retribution,12,7,5
Uprisen,daggerspine,672,paladin,retribution,12,7,5
Mes,dragonmaw,672,paladin,retribution,12,7,5
Brookeh,frostmourne,672,paladin,retribution,12,7,5
Bigblackbull,whisperwind,672,paladin,retribution,12,7,5
Chäinswellx,area-52,672,paladin,retribution,12,7,5
Nosferätu,illidan,672,paladin,retribution,12,7,5
Balduin,quelthalas,672,paladin,retribution,12,7,5
Vozy,bronzebeard,672,paladin,retribution,12,7,5
Khêll,sargeras,672,paladin,retribution,12,7,5
Hèlfar,wyrmrest-accord,672,paladin,retribution,12,7,5
Pals,bronzebeard,672,paladin,retribution,12,7,5
Leaelda,wyrmrest-accord,672,paladin,retribution,16,8,8
Paladan,tichondrius,672,paladin,retribution,17,7,10
Anjocaído,nemesis,672,paladin,retribution,18,7,11
Orin,guldan,672,paladin,retribution,18,7,11
Shoresy,terokkar,672,paladin,retribution,18,7,11
Neverwogx,kirin-tor,672,paladin,retribution,18,7,11
Urukap,goldrinn,672,paladin,retribution,18,7,11
Moistbible,kelthuzad,672,paladin,retribution,18,7,11
Roundbutts,stormrage,672,paladin,retribution,18,7,11
Gigantidab,tichondrius,672,paladin,retribution,18,7,11
Valantor,anvilmar,672,paladin,retribution,18,7,11
Knaring,aggramar,672,paladin,retribution,18,7,11
Trfreedomz,frostmourne,672,paladin,retribution,18,7,11
Vodulight,tichondrius,672,paladin,retribution,18,7,11
Aldhebarán,ragnaros,672,paladin,retribution,18,7,11
Paintpumper,malganis,672,paladin,retribution,18,7,11
Hølyshyt,tichondrius,672,paladin,retribution,18,7,11
Eurthswrath,lightbringer,672,paladin,retribution,18,7,11
Nawwll,stonemaul,672,paladin,retribution,18,7,11
Zotro,sargeras,672,paladin,retribution,18,7,11
Vernon,ragnaros,672,paladin,retribution,18,7,11
Kipow,proudmoore,672,paladin,retribution,18,7,11
Tothegravetv,illidan,672,paladin,retribution,18,7,11
Aledin,frostmourne,672,paladin,retribution,18,7,11
Kloud,sargeras,672,paladin,retribution,18,7,11
Cliftôn,illidan,672,paladin,retribution,18,7,11
Bdaws,tichondrius,672,paladin,retribution,18,7,11
Serinos,zuljin,672,paladin,retribution,18,7,11
Absolution,gurubashi,672,paladin,retribution,18,7,11
Solambul,tichondrius,672,paladin,retribution,18,7,11
Ziti,bonechewer,672,paladin,retribution,18,7,11
Lmac,frostmourne,672,paladin,retribution,18,7,11
Teamamerica,proudmoore,672,paladin,retribution,18,7,11
Xvetis,thrall,672,paladin,retribution,18,7,11
Atalzel,kiljaeden,672,paladin,retribution,18,7,11
Mayoclinic,frostmane,672,paladin,retribution,18,7,11
Rebelion,nagrand,672,paladin,retribution,18,7,11
Zugonomics,proudmoore,672,paladin,retribution,18,7,11
Cylano,tichondrius,672,paladin,retribution,18,7,11
Lakera,proudmoore,672,paladin,retribution,18,7,11
Geospawn,bleeding-hollow,672,paladin,retribution,18,7,11
Guidö,stormrage,672,paladin,retribution,22,8,14
Kamí,elune,672,paladin,retribution,21,7,14
Haimdallr,azralon,672,paladin,retribution,24,7,17
Ballsmcgee,bleeding-hollow,672,paladin,retribution,24,7,17
Digider,area-52,672,paladin,retribution,24,7,17
Tenethor,area-52,672,paladin,retribution,24,7,17
Kyuubî,bloodhoof,672,paladin,retribution,24,7,17
Goozlight,area-52,672,paladin,retribution,24,7,17
Heavener,tichondrius,672,paladin,retribution,24,7,17
Hayden,stormscale,672,paladin,retribution,24,7,17
Heilige,thrall,672,paladin,retribution,24,7,17
Ganan,frostmane,672,paladin,retribution,24,7,17
Spoelstra,dragonmaw,672,paladin,retribution,30,7,23
Tanesdeline,area-52,671,paladin,retribution,12,7,5
Holypillager,zuljin,671,paladin,retribution,12,7,5
Darawin,korgath,671,paladin,retribution,12,7,5
Palameme,hyjal,671,paladin,retribution,12,7,5
Ðrêâð,kirin-tor,671,paladin,retribution,12,7,5
Åphrodite,bleeding-hollow,671,paladin,retribution,12,7,5
Joobas,zuljin,671,paladin,retribution,12,7,5
Kizaru,shuhalo,671,paladin,retribution,12,7,5
Zerofans,ragnaros,671,paladin,retribution,12,7,5
Smuglý,wyrmrest-accord,671,paladin,retribution,12,7,5
Lowkeyy,tichondrius,671,paladin,retribution,12,7,5
Dillysdilly,zuljin,671,paladin,retribution,12,7,5
Annii,aegwynn,671,paladin,retribution,12,7,5
Krossret,thrall,671,paladin,retribution,12,7,5
Xfiles,alterac-mountains,671,paladin,retribution,12,7,5
Guthdrak,azgalor,671,paladin,retribution,12,7,5
Holyretribut,tichondrius,671,paladin,retribution,12,7,5
Tonytoi,aegwynn,671,paladin,retribution,12,7,5
Loctár,tichondrius,671,paladin,retribution,12,7,5
Jåy,nazjatar,671,paladin,retribution,12,7,5
Prophesied,zuljin,671,paladin,retribution,12,7,5
Lystia,malfurion,671,paladin,retribution,12,7,5
Ironpaladin,sargeras,671,paladin,retribution,12,7,5
Blingster,hellscream,671,paladin,retribution,12,7,5
Dabnpaladin,moon-guard,671,paladin,retribution,12,7,5
Koohny,stormrage,671,paladin,retribution,12,7,5
Ranknoob,khazgoroth,671,paladin,retribution,12,7,5
Thorean,sargeras,671,paladin,retribution,12,7,5
Jaybbers,malganis,671,paladin,retribution,12,7,5
Shivaku,area-52,671,paladin,retribution,12,7,5
Elemezs,tichondrius,671,paladin,retribution,12,7,5
Darktank,malganis,671,paladin,retribution,12,7,5
Kaynè,senjin,671,paladin,retribution,12,7,5
Shadd,destromath,671,paladin,retribution,12,7,5
Mürdøx,illidan,671,paladin,retribution,12,7,5
Hopebreaker,spinebreaker,671,paladin,retribution,12,7,5
Ruca,icecrown,671,paladin,retribution,12,7,5
Showfet,dalaran,671,paladin,retribution,16,8,8
Auriol,azshara,671,paladin,retribution,14,7,7
Bettyböp,bleeding-hollow,671,paladin,retribution,18,7,11
Sixty,sargeras,671,paladin,retribution,18,7,11
Wolfgrad,stormrage,671,paladin,retribution,18,7,11
Tyelca,zuljin,671,paladin,retribution,18,7,11
Ottiepal,kelthuzad,671,paladin,retribution,18,7,11
Golozzakum,tichondrius,671,paladin,retribution,18,7,11
Ailo,nemesis,671,paladin,retribution,18,7,11
Thadrian,nazgrel,671,paladin,retribution,18,7,11
Babyshuangs,illidan,671,paladin,retribution,18,7,11
Littlemoses,exodar,671,paladin,retribution,18,7,11
Kaidoz,aegwynn,671,paladin,retribution,18,7,11
Jakkburton,stormrage,671,paladin,retribution,18,7,11
Valtariel,wyrmrest-accord,671,paladin,retribution,18,7,11
Ibull,stormscale,671,paladin,retribution,18,7,11
Lemonliime,moon-guard,671,paladin,retribution,18,7,11
Dragomnnm,stormrage,671,paladin,retribution,18,7,11
Hasbi,area-52,671,paladin,retribution,18,7,11
Nibuwolfx,daggerspine,671,paladin,retribution,18,7,11
Bubbleôsevèn,stormrage,671,paladin,retribution,18,7,11
Vaelicus,emerald-dream,671,paladin,retribution,18,7,11
Basslinee,quelthalas,671,paladin,retribution,18,7,11
Jazztice,mannoroth,671,paladin,retribution,18,7,11
Ane,gorefiend,671,paladin,retribution,18,7,11
Blaeng,shandris,671,paladin,retribution,18,7,11
Inareus,agamaggan,671,paladin,retribution,18,7,11
Hisenberg,drakkari,671,paladin,retribution,18,7,11
Contritus,kiljaeden,671,paladin,retribution,18,7,11
Giorgyos,ragnaros,671,paladin,retribution,18,7,11
Drpawg,tichondrius,671,paladin,retribution,18,7,11
Jswyrm,quelthalas,671,paladin,retribution,18,7,11
Doraléous,illidan,671,paladin,retribution,24,7,17
Indemnity,wildhammer,671,paladin,retribution,24,7,17
Swissalami,proudmoore,670,paladin,retribution,12,7,5
Capsiel,caelestrasz,670,paladin,retribution,12,7,5
Biggwill,proudmoore,670,paladin,retribution,12,7,5
Skankysocks,tichondrius,670,paladin,retribution,12,7,5
Holychach,tichondrius,670,paladin,retribution,12,7,5
Tomaz,ragnaros,670,paladin,retribution,12,7,5
Itsapoc,sargeras,670,paladin,retribution,12,7,5
Blackflare,undermine,670,paladin,retribution,12,7,5
Hanno,azshara,670,paladin,retribution,12,7,5
Lomis,azgalor,670,paladin,retribution,12,7,5
Riek,sargeras,670,paladin,retribution,16,8,8
Jorgevercilo,azralon,670,paladin,retribution,18,7,11
Zaeris,proudmoore,670,paladin,retribution,18,7,11
Augus,arygos,670,paladin,retribution,18,7,11
Delukk,azralon,670,paladin,retribution,18,7,11
Grindlimg,dalaran,670,paladin,retribution,18,7,11
Rampetos,mannoroth,670,paladin,retribution,18,7,11
Tpane,kelthuzad,670,paladin,retribution,18,7,11
Murdameek,area-52,670,paladin,retribution,24,7,17
Zealotry,tichondrius,670,paladin,retribution,24,7,17
Exer,ragnaros,670,paladin,retribution,24,7,17
Terroll,bonechewer,669,paladin,retribution,13,7,6
Tpaartes,mannoroth,669,paladin,retribution,18,7,11
Sîegfried,moon-guard,669,paladin,retribution,18,7,11
Denstain,kul-tiras,669,paladin,retribution,18,7,11
Playmaker,mannoroth,669,paladin,retribution,21,8,13
Salvø,tichondrius,669,paladin,retribution,24,7,17
Sponce,kirin-tor,669,paladin,retribution,30,7,23
Vooltron,bonechewer,668,paladin,retribution,12,7,5
Praisin,zuljin,668,paladin,retribution,12,7,5
Glowstone,emerald-dream,668,paladin,retribution,18,7,11
Alexanderrex,illidan,668,paladin,retribution,18,7,11
Bennygee,moonrunner,668,paladin,retribution,24,7,17
Kapaw,windrunner,667,paladin,retribution,12,7,5
Tacosmells,thunderlord,667,paladin,retribution,18,7,11
Mandow,tichondrius,667,paladin,retribution,22,8,14
Calmador,proudmoore,666,paladin,retribution,12,7,5
Imsoosmall,sargeras,666,paladin,retribution,12,7,5
Batix,malfurion,666,paladin,retribution,12,7,5
Toogud,moon-guard,666,paladin,retribution,21,8,13
Boomeers,emerald-dream,666,paladin,retribution,24,7,17
Chaosbubble,burning-legion,665,paladin,retribution,18,7,11
Kithrin,emerald-dream,664,paladin,retribution,12,7,5
Dweezill,daggerspine,664,paladin,retribution,18,7,11
Trutax,black-dragonflight,662,paladin,retribution,18,7,11
Elderbill,emerald-dream,659,paladin,retribution,12,7,5
Olstonie,garrosh,658,paladin,retribution,12,7,5
Nicepally,moon-guard,657,paladin,retribution,18,7,11
Taego,tichondrius,655,paladin,retribution,17,7,10
Iceddcoffee,barthilas,655,paladin,retribution,17,7,10
Mèdic,illidan,654,paladin,retribution,17,7,10
Palliful,runetotem,651,paladin,retribution,18,7,11
Tooperilous,exodar,639,paladin,retribution,16,7,9
Vietnomeez,tichondrius,639,paladin,retribution,17,7,10
Epòc,frostmourne,639,paladin,retribution,20,8,12
Goldclaw,moon-guard,639,paladin,retribution,20,8,12
Hanicon,dragonmaw,638,paladin,retribution,16,7,9
Unversed,illidan,637,paladin,retribution,18,9,9
Fatalpally,antonidas,633,paladin,retribution,17,7,10
Arkeon,shadowsong,631,paladin,retribution,17,7,10
Táçô,illidan,623,paladin,retribution,11,7,4
Krossfyre,kiljaeden,623,paladin,retribution,17,7,10
Ethernaly,quelthalas,623,paladin,retribution,17,7,10
Jortesh,tichondrius,622,paladin,retribution,15,7,8
Alkon,quelthalas,619,paladin,retribution,27,7,20
Grinzin,azralon,618,paladin,retribution,17,9,8
Shuckles,windrunner,618,paladin,retribution,26,8,18
Antoniano,ragnaros,617,paladin,retribution,13,8,5
Vanaris,blackrock,615,paladin,retribution,15,7,8
Saltytaco,gurubashi,608,paladin,retribution,16,7,9
Frêyr,barthilas,608,paladin,retribution,22,7,15
Anarkay,frostmourne,607,paladin,retribution,10,7,3
Kelhell,stormrage,607,paladin,retribution,11,7,4
Chestbrah,nemesis,607,paladin,retribution,14,7,7
Tolkki,dalaran,607,paladin,retribution,26,7,19
Captqueso,stormrage,606,paladin,retribution,14,7,7
Sixtynine,nathrezim,592,paladin,retribution,31,7,24
Unïk,zuljin,591,paladin,retribution,11,7,4
Warbird,lightnings-blade,591,paladin,retribution,13,7,6
Theomere,sargeras,586,paladin,retribution,27,10,17
Hinnamnor,tichondrius,576,paladin,retribution,6,6,0
Xandiê,sargeras,576,paladin,retribution,6,6,0
Liht,blood-furnace,576,paladin,retribution,6,6,0
Lucard,drakkari,576,paladin,retribution,6,6,0
Spellshield,barthilas,576,paladin,retribution,6,6,0
Fibonaci,sargeras,576,paladin,retribution,6,6,0
Thøradin,moon-guard,576,paladin,retribution,6,6,0
Odegaret,illidan,576,paladin,retribution,10,7,3
Dumbledwarf,hyjal,576,paladin,retribution,12,6,6
Cvpal,stormrage,576,paladin,retribution,12,6,6
Cjq,tichondrius,576,paladin,retribution,12,6,6
Irushthots,tichondrius,576,paladin,retribution,12,6,6
Wyon,stormrage,576,paladin,retribution,12,6,6
Ironaddict,frostmourne,576,paladin,retribution,12,6,6
Cybopig,kelthuzad,576,paladin,retribution,12,6,6
Epicbro,kiljaeden,576,paladin,retribution,12,6,6
Koyourfamily,proudmoore,576,paladin,retribution,12,6,6
Healplzz,tichondrius,576,paladin,retribution,12,6,6
Emetselchs,tichondrius,576,paladin,retribution,12,6,6
Byebyetwinks,khaz-modan,576,paladin,retribution,12,6,6
Aura,emerald-dream,576,paladin,retribution,12,6,6
Raywhite,kelthuzad,576,paladin,retribution,12,6,6
Snivasgo,ragnaros,576,paladin,retribution,12,6,6
Leonkennedyx,stormrage,576,paladin,retribution,12,6,6
Thaléros,tichondrius,576,paladin,retribution,12,6,6
Onixx,kargath,576,paladin,retribution,12,6,6
Bootacious,tichondrius,576,paladin,retribution,12,6,6
Hjolgrim,sargeras,576,paladin,retribution,12,6,6
Arraladin,tichondrius,576,paladin,retribution,12,6,6
Bigdig,stormrage,576,paladin,retribution,12,6,6
Thiccpala,tichondrius,576,paladin,retribution,12,6,6
Beluros,tichondrius,576,paladin,retribution,12,6,6
Sacerbelator,zuluhed,576,paladin,retribution,12,6,6
Jabrohnie,sargeras,576,paladin,retribution,12,6,6
Accept,frostmourne,576,paladin,retribution,12,6,6
Kulikahn,terenas,576,paladin,retribution,12,6,6
Beato,silvermoon,576,paladin,retribution,12,6,6
Vilert,balnazzar,576,paladin,retribution,12,6,6
Immensepower,tichondrius,576,paladin,retribution,12,6,6
Xavorn,illidan,576,paladin,retribution,12,6,6
Proctrlx,tichondrius,576,paladin,retribution,12,6,6
Oynx,emerald-dream,576,paladin,retribution,12,6,6
Cause,farstriders,576,paladin,retribution,12,6,6
Bloodyängel,emerald-dream,576,paladin,retribution,12,6,6
Piroc,tichondrius,576,paladin,retribution,12,6,6
Crânkdât,frostmourne,576,paladin,retribution,12,6,6
Bloodeladin,deathwing,576,paladin,retribution,12,6,6
Yungcheezy,illidan,576,paladin,retribution,12,6,6
Lebubbles,azuremyst,576,paladin,retribution,12,6,6
Pokeyabutt,hydraxis,576,paladin,retribution,12,6,6
Supramario,dragonmaw,576,paladin,retribution,12,6,6
Zèró,terokkar,576,paladin,retribution,12,6,6
Germ,korgath,576,paladin,retribution,12,6,6
Pállyho,tichondrius,576,paladin,retribution,12,6,6
Zercker,ragnaros,576,paladin,retribution,12,6,6
Troegenator,stormrage,576,paladin,retribution,12,6,6
Jacklo,the-venture-co,576,paladin,retribution,12,6,6
Glynisir,sargeras,576,paladin,retribution,12,6,6
Gambitdin,moon-guard,576,paladin,retribution,12,6,6
Hydroponicz,tichondrius,576,paladin,retribution,12,6,6
Potatopasta,area-52,576,paladin,retribution,12,6,6
Retsuxks,twisting-nether,576,paladin,retribution,12,6,6
Obeliskk,frostmourne,576,paladin,retribution,12,6,6
Bruxx,twisting-nether,576,paladin,retribution,12,6,6
Hammerd,area-52,576,paladin,retribution,12,6,6
Nragedpal,illidan,576,paladin,retribution,12,6,6
Sparticuss,frostmane,576,paladin,retribution,12,6,6
Ashley,sargeras,576,paladin,retribution,12,6,6
Bigkspally,korgath,576,paladin,retribution,12,6,6
Dogecoln,bleeding-hollow,576,paladin,retribution,12,6,6
Antonn,stormrage,576,paladin,retribution,12,6,6
Grim,eonar,576,paladin,retribution,12,6,6
Zägreus,moon-guard,576,paladin,retribution,12,6,6
Porxhux,tichondrius,576,paladin,retribution,12,6,6
Trixzthot,barthilas,576,paladin,retribution,12,6,6
Mikeyqt,nemesis,576,paladin,retribution,12,6,6
Holycrp,proudmoore,576,paladin,retribution,12,6,6
Cübe,malganis,576,paladin,retribution,12,6,6
Memepaladin,area-52,576,paladin,retribution,12,6,6
Breid,sargeras,576,paladin,retribution,12,6,6
Enj,stormrage,576,paladin,retribution,12,6,6
Brpistol,azralon,576,paladin,retribution,12,6,6
Venter,bleeding-hollow,576,paladin,retribution,12,6,6
Çhñkzrèt,illidan,576,paladin,retribution,12,6,6
Aëriy,moon-guard,576,paladin,retribution,12,6,6
Gàreth,aerie-peak,576,paladin,retribution,12,6,6
Zuther,spirestone,576,paladin,retribution,12,6,6
Holycrusador,bleeding-hollow,576,paladin,retribution,12,6,6
Zoroastrø,azralon,576,paladin,retribution,12,6,6
Sneely,kelthuzad,576,paladin,retribution,12,6,6
Vozy,shandris,576,paladin,retribution,12,6,6
Mystictoast,area-52,576,paladin,retribution,12,6,6
Panicbubblin,stormrage,576,paladin,retribution,12,6,6
Òp,illidan,576,paladin,retribution,12,6,6
Thuggrnaut,darkspear,576,paladin,retribution,12,6,6
Longtai,proudmoore,576,paladin,retribution,12,6,6
Rhoruk,turalyon,576,paladin,retribution,12,6,6
Retboy,archimonde,576,paladin,retribution,12,6,6
Sonicblazer,darrowmere,576,paladin,retribution,12,6,6
Klamindor,emerald-dream,576,paladin,retribution,12,6,6
Banzz,azralon,576,paladin,retribution,12,6,6
Fallenp,hakkar,576,paladin,retribution,12,6,6
Octaviak,moon-guard,576,paladin,retribution,12,6,6
Nýze,area-52,576,paladin,retribution,12,6,6
Careyprice,area-52,576,paladin,retribution,12,6,6
Seeys,tichondrius,576,paladin,retribution,12,6,6
Gánico,ragnaros,576,paladin,retribution,12,6,6
Sabêr,mannoroth,576,paladin,retribution,12,6,6
Skarlagen,moon-guard,576,paladin,retribution,12,6,6
Masemune,bonechewer,576,paladin,retribution,12,6,6
Alphali,quelthalas,576,paladin,retribution,12,6,6
Totalaustin,sargeras,576,paladin,retribution,12,6,6
Rohad,thrall,576,paladin,retribution,12,6,6
Nyroxz,quelthalas,576,paladin,retribution,12,6,6
Sóláris,moon-guard,576,paladin,retribution,12,6,6
Dýnamo,azralon,576,paladin,retribution,12,6,6
Evelimash,bloodhoof,576,paladin,retribution,12,6,6
Zeröcoöl,malganis,576,paladin,retribution,12,6,6
Seballedo,drakkari,576,paladin,retribution,12,6,6
Afterdawn,dreadmaul,576,paladin,retribution,12,6,6
Geesworld,nazjatar,576,paladin,retribution,12,6,6
Koûtt,ragnaros,576,paladin,retribution,12,6,6
Pallyalli,burning-blade,576,paladin,retribution,12,6,6
Soapgirl,area-52,576,paladin,retribution,12,6,6
Lyà,area-52,576,paladin,retribution,12,6,6
Fálko,azralon,576,paladin,retribution,12,6,6
Smaugg,boulderfist,576,paladin,retribution,15,7,8
Trulymental,bleeding-hollow,576,paladin,retribution,13,6,7
Xanaxlol,sargeras,576,paladin,retribution,16,7,9
Sunwalker,tichondrius,576,paladin,retribution,17,6,11
Joshington,stormrage,576,paladin,retribution,21,7,14
Koreancannon,tichondrius,576,paladin,retribution,21,7,14
Júdgedredd,illidan,576,paladin,retribution,18,6,12
Ishuffle,malganis,576,paladin,retribution,18,6,12
Abregut,ragnaros,576,paladin,retribution,18,6,12
Kochinodin,ragnaros,576,paladin,retribution,18,6,12
Slowmoshend,illidan,576,paladin,retribution,18,6,12
Kramsìb,ragnaros,576,paladin,retribution,18,6,12
Xpect,spinebreaker,576,paladin,retribution,18,6,12
Liandroa,stormrage,576,paladin,retribution,18,6,12
Washavy,drakkari,576,paladin,retribution,18,6,12
Femaledog,ragnaros,576,paladin,retribution,18,6,12
Divineera,frostmourne,576,paladin,retribution,18,6,12
Nufi,magtheridon,576,paladin,retribution,18,6,12
Jafbe,mugthol,576,paladin,retribution,18,6,12
Càséy,zuljin,576,paladin,retribution,18,6,12
Wreathy,sargeras,576,paladin,retribution,18,6,12
Goldskìn,sargeras,576,paladin,retribution,18,6,12
Niksilp,malfurion,576,paladin,retribution,18,6,12
Pauliss,sargeras,576,paladin,retribution,18,6,12
Felwythe,emerald-dream,576,paladin,retribution,18,6,12
Shiftybugar,tichondrius,576,paladin,retribution,18,6,12
Omniknìght,stormrage,576,paladin,retribution,18,6,12
Hetodo,blood-furnace,576,paladin,retribution,18,6,12
Kronicle,bleeding-hollow,576,paladin,retribution,18,6,12
Retz,tichondrius,576,paladin,retribution,18,6,12
Simplychi,area-52,576,paladin,retribution,18,6,12
Astolfo,tortheldrin,576,paladin,retribution,18,6,12
Kaïty,azralon,576,paladin,retribution,18,6,12
Ålltimer,stormrage,576,paladin,retribution,18,6,12
Respect,moon-guard,576,paladin,retribution,18,6,12
Sourpatchh,stormrage,576,paladin,retribution,18,6,12
Kreigvar,moon-guard,576,paladin,retribution,18,6,12
Cupcaked,blackrock,576,paladin,retribution,23,6,17
Exorcìst,tichondrius,576,paladin,retribution,24,6,18
Hojpack,tichondrius,576,paladin,retribution,24,6,18
Supermetroid,vashj,576,paladin,retribution,24,6,18
Holyhymen,mannoroth,576,paladin,retribution,24,6,18
Pallyfreddyy,frostmourne,576,paladin,retribution,24,6,18
Spoons,malganis,576,paladin,retribution,24,6,18
Dragrias,altar-of-storms,575,paladin,retribution,10,7,3
Blëssëd,zuljin,575,paladin,retribution,12,6,6
Potiguar,azralon,575,paladin,retribution,12,6,6
Crixius,eredar,575,paladin,retribution,12,6,6
Vincentnero,runetotem,575,paladin,retribution,12,6,6
Apollon,zuljin,575,paladin,retribution,12,6,6
Übermane,illidan,575,paladin,retribution,12,6,6
Arkmedys,azralon,575,paladin,retribution,12,6,6
Jovolur,dalaran,575,paladin,retribution,12,6,6
Jotajotamz,quelthalas,575,paladin,retribution,12,6,6
Onecmpeter,kelthuzad,575,paladin,retribution,12,6,6
Drágônbôrn,tichondrius,575,paladin,retribution,12,6,6
Kelbii,sargeras,575,paladin,retribution,12,6,6
Toscadin,ragnaros,575,paladin,retribution,12,6,6
Shaggrilla,trollbane,575,paladin,retribution,12,6,6
Jolandrine,sargeras,575,paladin,retribution,12,6,6
Knobody,emerald-dream,575,paladin,retribution,12,6,6
Skelà,sargeras,575,paladin,retribution,12,6,6
Camcam,thrall,575,paladin,retribution,12,6,6
Vanmauren,quelthalas,575,paladin,retribution,12,6,6
Blankei,stormrage,575,paladin,retribution,12,6,6
Yuzuru,mannoroth,575,paladin,retribution,12,6,6
Skyangel,illidan,575,paladin,retribution,12,6,6
Laluce,malganis,575,paladin,retribution,12,6,6
Killmode,kelthuzad,575,paladin,retribution,12,6,6
Butterbeanz,tanaris,575,paladin,retribution,12,6,6
Ikanacanyon,stormrage,575,paladin,retribution,12,6,6
Warboard,tichondrius,575,paladin,retribution,15,7,8
Trekpii,area-52,575,paladin,retribution,13,6,7
Bebedor,azralon,575,paladin,retribution,15,6,9
Retoric,maelstrom,575,paladin,retribution,18,6,12
Anoleak,tichondrius,575,paladin,retribution,18,6,12
Nashtty,guldan,575,paladin,retribution,18,6,12
Oceangal,illidan,575,paladin,retribution,18,6,12
Valdi,stonemaul,575,paladin,retribution,18,6,12
Haziel,darkspear,575,paladin,retribution,18,6,12
Cropcircles,whisperwind,575,paladin,retribution,18,6,12
Faffyi,thunderlord,575,paladin,retribution,18,6,12
Palpaladines,quelthalas,575,paladin,retribution,18,6,12
Killstien,illidan,575,paladin,retribution,24,6,18
Lecarde,cenarion-circle,575,paladin,retribution,24,6,18
Vecknilashx,quelthalas,575,paladin,retribution,24,6,18
Freiror,azralon,574,paladin,retribution,12,6,6
Clasheoff,mannoroth,574,paladin,retribution,12,6,6
Belzibuth,zuljin,574,paladin,retribution,12,6,6
Korann,proudmoore,574,paladin,retribution,12,6,6
Kkrewk,illidan,574,paladin,retribution,12,6,6
Crithealss,dalaran,574,paladin,retribution,12,6,6
Ihmperiuus,quelthalas,574,paladin,retribution,12,6,6
Akeero,khaz-modan,574,paladin,retribution,12,6,6
Darqtank,smolderthorn,574,paladin,retribution,18,6,12
Synnderilla,wyrmrest-accord,574,paladin,retribution,18,6,12
Halordriest,tichondrius,574,paladin,retribution,18,6,12
Tamahu,azralon,574,paladin,retribution,18,6,12
Judgemèntal,illidan,574,paladin,retribution,20,6,14
Takz,daggerspine,574,paladin,retribution,26,6,20
Kalayton,nesingwary,573,paladin,retribution,12,6,6
Tauyoshi,azjolnerub,573,paladin,retribution,12,6,6
Phankro,quelthalas,573,paladin,retribution,12,6,6
Gämä,azralon,573,paladin,retribution,18,6,12
Scyni,kelthuzad,573,paladin,retribution,20,6,14
Alluxian,zuljin,573,paladin,retribution,24,6,18
Callahan,frostwolf,572,paladin,retribution,12,6,6
Thorbrecht,moon-guard,572,paladin,retribution,12,6,6
Chadrickk,tichondrius,572,paladin,retribution,12,6,6
Ajaex,area-52,571,paladin,retribution,12,6,6
Kalerien,wildhammer,571,paladin,retribution,12,6,6
Lucent,duskwood,571,paladin,retribution,18,6,12
Bunkalunk,lightbringer,570,paladin,retribution,15,6,9
Niáa,quelthalas,570,paladin,retribution,18,6,12
Ginwow,hakkar,570,paladin,retribution,18,6,12
Palâdino,azralon,568,paladin,retribution,21,7,14
Halldhyr,quelthalas,566,paladin,retribution,12,6,6
Lorawynn,cenarion-circle,557,paladin,retribution,11,6,5
Ssggk,proudmoore,553,paladin,retribution,17,6,11
Bringbackrmp,tichondrius,543,paladin,retribution,11,6,5
Zyllo,area-52,543,paladin,retribution,14,7,7
Holymanè,tichondrius,543,paladin,retribution,14,7,7
Wunderbread,dalaran,543,paladin,retribution,17,6,11
Gloren,garrosh,543,paladin,retribution,17,6,11
Buffalosaucé,illidan,543,paladin,retribution,17,6,11
Suslazin,area-52,543,paladin,retribution,20,7,13
Fødãø,azralon,542,paladin,retribution,11,6,5
Criskaruz,ragnaros,542,paladin,retribution,17,6,11
Taegwyn,thunderlord,542,paladin,retribution,22,6,16
Hadagoodlay,zuljin,528,paladin,retribution,15,6,9
Fulgal,jubeithos,528,paladin,retribution,15,6,9
Svaanah,moon-guard,527,paladin,retribution,11,6,5
Sucris,kelthuzad,527,paladin,retribution,11,6,5
Tazzul,turalyon,527,paladin,retribution,15,7,8
Vardrik,darkspear,527,paladin,retribution,15,6,9
Yuriie,stormrage,527,paladin,retribution,17,6,11
Radiantheart,norgannon,525,paladin,retribution,11,6,5
Briaelyne,tichondrius,522,paladin,retribution,25,8,17
Parkhwi,tichondrius,521,paladin,retribution,28,7,21
Nathaniel,galakrond,511,paladin,retribution,14,6,8
ßìgdám,bleeding-hollow,511,paladin,retribution,17,6,11
Javiermiléi,quelthalas,511,paladin,retribution,26,6,20
Pemodyne,illidan,495,paladin,retribution,13,6,7
Spàrhawke,stormrage,495,paladin,retribution,13,6,7
Fionax,frostmourne,495,paladin,retribution,21,6,15
Senorwang,dalaran,494,paladin,retribution,13,6,7
Akemih,ragnaros,480,paladin,retribution,6,5,1
Bubblybuns,proudmoore,480,paladin,retribution,6,5,1
Strykerrz,tanaris,480,paladin,retribution,6,5,1
Gramsby,aggramar,480,paladin,retribution,6,5,1
Wambo,emerald-dream,480,paladin,retribution,6,5,1
Corevp,frostmourne,480,paladin,retribution,6,5,1
Kongo,darkspear,480,paladin,retribution,6,5,1
Einjerhar,quelthalas,480,paladin,retribution,6,5,1
Bauschret,thrall,480,paladin,retribution,6,5,1
Mcjudgin,kilrogg,480,paladin,retribution,6,5,1
Wabnote,twisting-nether,480,paladin,retribution,6,5,1
Kettlebaby,wildhammer,480,paladin,retribution,6,5,1
Moozafa,kiljaeden,480,paladin,retribution,6,5,1
Everwaken,ragnaros,480,paladin,retribution,6,5,1
Silviis,stormrage,480,paladin,retribution,6,5,1
Tdm,bleeding-hollow,480,paladin,retribution,6,5,1
Kelimir,dathremar,480,paladin,retribution,6,5,1
Shibbx,quelthalas,480,paladin,retribution,6,5,1
Zelowrath,emerald-dream,480,paladin,retribution,6,5,1
Oldlemon,tichondrius,480,paladin,retribution,6,5,1
Rekindle,barthilas,480,paladin,retribution,6,5,1
Eomàr,barthilas,480,paladin,retribution,6,5,1
Kimitail,tichondrius,480,paladin,retribution,6,5,1
Ganrof,mugthol,480,paladin,retribution,6,5,1
Mmrdonator,icecrown,480,paladin,retribution,6,5,1
Mythîcxd,tichondrius,480,paladin,retribution,6,5,1
Speedlight,ragnaros,480,paladin,retribution,6,5,1
Mardrïus,tichondrius,480,paladin,retribution,6,5,1
Adrieoss,stormrage,480,paladin,retribution,6,5,1
Iamurpal,hakkar,480,paladin,retribution,6,5,1
Pickleparker,stormrage,480,paladin,retribution,6,5,1
Jùnmå,tichondrius,480,paladin,retribution,6,5,1
Fistrozenemy,illidan,480,paladin,retribution,6,5,1
Rangedmelee,stormrage,480,paladin,retribution,6,5,1
Míkau,barthilas,480,paladin,retribution,6,5,1
Mandymuze,illidan,480,paladin,retribution,6,5,1
Mollymatt,drenden,480,paladin,retribution,6,5,1
Van,tichondrius,480,paladin,retribution,6,5,1
Tenkäi,quelthalas,480,paladin,retribution,6,5,1
Demetriusxy,tichondrius,480,paladin,retribution,6,5,1
Dragon,uldum,480,paladin,retribution,6,5,1
Lafasíta,ragnaros,480,paladin,retribution,6,5,1
Zeprikito,nemesis,480,paladin,retribution,6,5,1
Guggle,lothar,480,paladin,retribution,6,5,1
Overbet,area-52,480,paladin,retribution,9,6,3
Romeh,malganis,480,paladin,retribution,8,5,3
Bootscrapper,sargeras,480,paladin,retribution,11,6,5
Siamac,illidan,480,paladin,retribution,13,7,6
Goodwood,ghostlands,480,paladin,retribution,12,6,6
Wetterguuch,area-52,480,paladin,retribution,12,5,7
Lumpylot,sargeras,480,paladin,retribution,12,5,7
Lücid,arthas,480,paladin,retribution,12,5,7
Hattie,arthas,480,paladin,retribution,12,5,7
Wreckina,tichondrius,480,paladin,retribution,12,5,7
Dinobe,arthas,480,paladin,retribution,12,5,7
Delightt,sargeras,480,paladin,retribution,12,5,7
Bold,frostmourne,480,paladin,retribution,12,5,7
Supasavage,maiev,480,paladin,retribution,12,5,7
Suddify,area-52,480,paladin,retribution,12,5,7
Shinymoo,laughing-skull,480,paladin,retribution,12,5,7
Mikewazowski,chogall,480,paladin,retribution,12,5,7
Addisen,malganis,480,paladin,retribution,12,5,7
Hegarth,archimonde,480,paladin,retribution,12,5,7
Dimsimbar,frostmourne,480,paladin,retribution,12,5,7
Theraptos,frostmourne,480,paladin,retribution,12,5,7
Fixyouz,mannoroth,480,paladin,retribution,12,5,7
Rhaegorn,drakkari,480,paladin,retribution,12,5,7
Kaelel,barthilas,480,paladin,retribution,12,5,7
Retroactive,thunderlord,480,paladin,retribution,12,5,7
Seratonyn,malganis,480,paladin,retribution,12,5,7
Faithkiller,garrosh,480,paladin,retribution,12,5,7
Rymondo,sargeras,480,paladin,retribution,12,5,7
Mickelodeon,sargeras,480,paladin,retribution,12,5,7
Critadins,thrall,480,paladin,retribution,12,5,7
Cedwarlancy,sargeras,480,paladin,retribution,12,5,7
Perasticus,garrosh,480,paladin,retribution,12,5,7
Principe,queldorei,480,paladin,retribution,12,5,7
Wahpop,sargeras,480,paladin,retribution,12,5,7
Callandør,illidan,480,paladin,retribution,12,5,7
Redearth,bleeding-hollow,480,paladin,retribution,12,5,7
Shadomourne,arthas,480,paladin,retribution,12,5,7
Ganster,dreadmaul,480,paladin,retribution,12,5,7
Mikeawk,tichondrius,480,paladin,retribution,12,5,7
Daddyspit,arthas,480,paladin,retribution,12,5,7
Únhøly,aegwynn,480,paladin,retribution,12,5,7
Sabericdos,proudmoore,480,paladin,retribution,12,5,7
Crucifuk,sargeras,480,paladin,retribution,12,5,7
Morbop,proudmoore,480,paladin,retribution,12,5,7
Toojazzyleah,proudmoore,480,paladin,retribution,12,5,7
Akain,tichondrius,480,paladin,retribution,12,5,7
Tisu,kiljaeden,480,paladin,retribution,12,5,7
Bigbleuu,kiljaeden,480,paladin,retribution,12,5,7
Níngjìngy,tichondrius,480,paladin,retribution,12,5,7
Lowhp,tichondrius,480,paladin,retribution,12,5,7
Shadòw,emerald-dream,480,paladin,retribution,12,5,7
Bullpaladin,barthilas,480,paladin,retribution,12,5,7
Lastal,kiljaeden,480,paladin,retribution,12,5,7
Zulyourmom,tichondrius,480,paladin,retribution,12,5,7
Yoroding,tichondrius,480,paladin,retribution,12,5,7
Hotnchocolat,stormrage,480,paladin,retribution,12,5,7
Liadryn,kiljaeden,480,paladin,retribution,12,5,7
Delaswing,quelthalas,480,paladin,retribution,12,5,7
Farmerzonly,tichondrius,480,paladin,retribution,12,5,7
Ärlex,moon-guard,480,paladin,retribution,12,5,7
Semamnohands,illidan,480,paladin,retribution,12,5,7
Heamis,thunderlord,480,paladin,retribution,12,5,7
Valkaurus,drakkari,480,paladin,retribution,12,5,7
Azerothmajor,tichondrius,480,paladin,retribution,12,5,7
Ssawsy,illidan,480,paladin,retribution,12,5,7
Foxesshadow,tichondrius,480,paladin,retribution,12,5,7
Ankmael,ragnaros,480,paladin,retribution,12,5,7
Õblivion,jubeithos,480,paladin,retribution,12,5,7
Noleyboo,proudmoore,480,paladin,retribution,12,5,7
Namiiswan,area-52,480,paladin,retribution,12,5,7
Trensei,emerald-dream,480,paladin,retribution,12,5,7
Beatman,blades-edge,480,paladin,retribution,12,5,7
Aeoliá,moon-guard,480,paladin,retribution,12,5,7
Aeolus,uldaman,480,paladin,retribution,12,5,7
Raveen,veknilash,480,paladin,retribution,12,5,7
Metalpriest,shattered-halls,480,paladin,retribution,12,5,7
Baelmun,thrall,480,paladin,retribution,12,5,7
Héathèn,area-52,480,paladin,retribution,12,5,7
Lodin,kalecgos,480,paladin,retribution,12,5,7
Fistopain,staghelm,480,paladin,retribution,12,5,7
Meith,ragnaros,480,paladin,retribution,12,5,7
Methor,thrall,480,paladin,retribution,12,5,7
Uneazyxx,tichondrius,480,paladin,retribution,12,5,7
Minzyp,illidan,480,paladin,retribution,12,5,7
Isevp,illidan,480,paladin,retribution,12,5,7
Tarà,sargeras,480,paladin,retribution,12,5,7
Diplomacy,illidan,480,paladin,retribution,12,5,7
Randvi,sargeras,480,paladin,retribution,12,5,7
Nohtu,quelthalas,480,paladin,retribution,12,5,7
Hinamattsuri,velen,480,paladin,retribution,12,5,7
Dirtbagg,demon-soul,480,paladin,retribution,12,5,7
Dipho,illidan,480,paladin,retribution,12,5,7
Pallypallyy,aerie-peak,480,paladin,retribution,12,5,7
Flavor,cairne,480,paladin,retribution,12,5,7
Shiningtendi,aerie-peak,480,paladin,retribution,12,5,7
Trinkhammer,illidan,480,paladin,retribution,12,5,7
Thickgirl,bleeding-hollow,480,paladin,retribution,12,5,7
Dehya,sargeras,480,paladin,retribution,12,5,7
Hallastus,stormrage,480,paladin,retribution,12,5,7
Gotwingz,moon-guard,480,paladin,retribution,12,5,7
Keelroi,sargeras,480,paladin,retribution,12,5,7
Kuyueh,tichondrius,480,paladin,retribution,12,5,7
Varezion,vashj,480,paladin,retribution,12,5,7
Líønheart,stormrage,480,paladin,retribution,12,5,7
Pussandboots,cairne,480,paladin,retribution,12,5,7
Selentia,shadowmoon,480,paladin,retribution,12,5,7
Hekcthor,ragnaros,480,paladin,retribution,12,5,7
Holyham,bonechewer,480,paladin,retribution,12,5,7
Jadedx,stormrage,480,paladin,retribution,12,5,7
Berapal,tichondrius,480,paladin,retribution,12,5,7
Alexpalad,sargeras,480,paladin,retribution,12,5,7
Loudpaq,guldan,480,paladin,retribution,12,5,7
Hkingx,frostwolf,480,paladin,retribution,12,5,7
Merphy,tichondrius,480,paladin,retribution,12,5,7
Balmain,moon-guard,480,paladin,retribution,12,5,7
Cranick,bleeding-hollow,480,paladin,retribution,12,5,7
Undefeatæd,korgath,480,paladin,retribution,12,5,7
Buslightyear,azralon,480,paladin,retribution,12,5,7
Thrasheric,ragnaros,480,paladin,retribution,12,5,7
Maxduo,bleeding-hollow,480,paladin,retribution,12,5,7
Gotenks,trollbane,480,paladin,retribution,12,5,7
Joonzu,frostmane,480,paladin,retribution,12,5,7
Shaktii,ragnaros,480,paladin,retribution,12,5,7
Emotiza,illidan,480,paladin,retribution,12,5,7
Adrexious,dalaran,480,paladin,retribution,12,5,7
Ravage,lothar,480,paladin,retribution,12,5,7
Polisexüs,azralon,480,paladin,retribution,12,5,7
ßraveheart,zuljin,480,paladin,retribution,12,5,7
Mágna,illidan,480,paladin,retribution,12,5,7
Shieldgrab,illidan,480,paladin,retribution,12,5,7
Itaghí,sargeras,480,paladin,retribution,12,5,7
Sigismud,quelthalas,480,paladin,retribution,12,5,7
Swishey,tichondrius,480,paladin,retribution,12,5,7
Cairdk,ragnaros,480,paladin,retribution,12,5,7
Gennara,ragnaros,480,paladin,retribution,12,5,7
Vain,shuhalo,480,paladin,retribution,12,5,7
Yellowmay,sargeras,480,paladin,retribution,12,5,7
Bigolhammer,khadgar,480,paladin,retribution,12,5,7
Lightknight,lothar,480,paladin,retribution,12,5,7
Chenghisret,tichondrius,480,paladin,retribution,12,5,7
Kirklandbeef,gorefiend,480,paladin,retribution,12,5,7
Rikku,undermine,480,paladin,retribution,12,5,7
Silreck,ragnaros,480,paladin,retribution,12,5,7
Jaenus,azralon,480,paladin,retribution,12,5,7
Banglin,draenor,480,paladin,retribution,12,5,7
Bigmilkdog,tichondrius,480,paladin,retribution,12,5,7
Jonbonholy,sargeras,480,paladin,retribution,12,5,7
Locustknight,illidan,480,paladin,retribution,12,5,7
Darksaint,hellscream,480,paladin,retribution,12,5,7
Holytankadin,alleria,480,paladin,retribution,12,5,7
Wonas,ragnaros,480,paladin,retribution,12,5,7
Rakkhalar,ragnaros,480,paladin,retribution,12,5,7
Loctherion,ragnaros,480,paladin,retribution,12,5,7
Gavriel,quelthalas,480,paladin,retribution,12,5,7
Jaslexa,illidan,480,paladin,retribution,12,5,7
Leslievernon,ursin,480,paladin,retribution,12,5,7
Holydawa,zuljin,480,paladin,retribution,12,5,7
Stamptime,emerald-dream,480,paladin,retribution,12,5,7
Luxetveritas,tichondrius,480,paladin,retribution,12,5,7
Jinuhn,illidan,480,paladin,retribution,12,5,7
Xizzor,darkspear,480,paladin,retribution,12,5,7
Funk,sargeras,480,paladin,retribution,12,5,7
Freerating,moon-guard,480,paladin,retribution,15,6,9
Ckrim,malganis,480,paladin,retribution,16,5,11
Thepeony,tichondrius,480,paladin,retribution,17,5,12
Harke,drakkari,480,paladin,retribution,18,5,13
Midnightboto,dragonmaw,480,paladin,retribution,18,5,13
Melgamis,quelthalas,480,paladin,retribution,18,5,13
Boopif,sargeras,480,paladin,retribution,18,5,13
Deecompose,sargeras,480,paladin,retribution,18,5,13
Papazon,tichondrius,480,paladin,retribution,18,5,13
Spótt,stormrage,480,paladin,retribution,18,5,13
Odiato,stormrage,480,paladin,retribution,18,5,13
Photons,emerald-dream,480,paladin,retribution,18,5,13
Reehzlol,stormrage,480,paladin,retribution,18,5,13
Holycots,stormrage,480,paladin,retribution,18,5,13
Moltensilver,emerald-dream,480,paladin,retribution,18,5,13
Ztpz,illidan,480,paladin,retribution,18,5,13
Seraphim,tichondrius,480,paladin,retribution,18,5,13
Razuel,frostmourne,480,paladin,retribution,18,5,13
Alibuda,tichondrius,480,paladin,retribution,18,5,13
Theril,kelthuzad,480,paladin,retribution,18,5,13
Typheuz,wyrmrest-accord,480,paladin,retribution,18,5,13
Gingibeno,tichondrius,480,paladin,retribution,18,5,13
Purged,wyrmrest-accord,480,paladin,retribution,18,5,13
Tikkun,area-52,480,paladin,retribution,18,5,13
Downs,tichondrius,480,paladin,retribution,18,5,13
Furrpally,tichondrius,480,paladin,retribution,18,5,13
Zightmare,azralon,480,paladin,retribution,18,5,13
Bigboynathan,frostmourne,480,paladin,retribution,18,5,13
Grïmaldus,moon-guard,480,paladin,retribution,19,5,14
Firexfist,gurubashi,480,paladin,retribution,24,5,19
Azdan,ragnaros,480,paladin,retribution,30,5,25
Ajaxen,azshara,479,paladin,retribution,6,5,1
Reidolitrao,nemesis,479,paladin,retribution,6,5,1
Kremation,zuljin,479,paladin,retribution,6,5,1
Palaknight,tichondrius,479,paladin,retribution,6,5,1
Asttryd,barthilas,479,paladin,retribution,12,7,5
Ashera,amanthul,479,paladin,retribution,12,5,7
Ðarksealz,laughing-skull,479,paladin,retribution,12,5,7
Farvadin,illidan,479,paladin,retribution,12,5,7
Mereoleona,elune,479,paladin,retribution,12,5,7
Robz,malygos,479,paladin,retribution,12,5,7
Inqa,thunderlord,479,paladin,retribution,12,5,7
Noctis,nerzhul,479,paladin,retribution,12,5,7
Cowsavior,terenas,479,paladin,retribution,12,5,7
Rayrunner,tanaris,479,paladin,retribution,12,5,7
Cóg,area-52,479,paladin,retribution,12,5,7
Giricoret,azralon,479,paladin,retribution,12,5,7
Zelrich,moon-guard,479,paladin,retribution,12,5,7
Minjikim,tichondrius,479,paladin,retribution,12,5,7
Kaylafell,kelthuzad,479,paladin,retribution,12,5,7
Chrisqwa,sargeras,479,paladin,retribution,12,5,7
Khels,gilneas,479,paladin,retribution,12,5,7
Sgtskittles,aggramar,479,paladin,retribution,12,5,7
Reedeemer,bonechewer,479,paladin,retribution,12,5,7
Heneaz,quelthalas,479,paladin,retribution,12,5,7
Memoríez,zuljin,479,paladin,retribution,12,5,7
Murderous,frostmourne,479,paladin,retribution,12,5,7
Maswell,emerald-dream,479,paladin,retribution,12,5,7
Evielia,tichondrius,479,paladin,retribution,12,5,7
Holyzolt,zuljin,479,paladin,retribution,18,5,13
Provail,stormrage,479,paladin,retribution,18,5,13
Griz,magtheridon,479,paladin,retribution,18,5,13
Agelikos,moon-guard,479,paladin,retribution,18,5,13
Oilme,bleeding-hollow,479,paladin,retribution,18,5,13
Kajoruun,bleeding-hollow,479,paladin,retribution,24,5,19
Kief,emerald-dream,479,paladin,retribution,24,5,19
Disconnect,azjolnerub,479,paladin,retribution,24,5,19
Palypunchh,darrowmere,478,paladin,retribution,12,6,6
Ashheart,the-venture-co,478,paladin,retribution,12,5,7
Herbzilla,haomarush,478,paladin,retribution,12,5,7
Impia,tichondrius,478,paladin,retribution,12,5,7
Neipala,ragnaros,478,paladin,retribution,12,5,7
Lagun,wyrmrest-accord,478,paladin,retribution,12,5,7
Millicentt,quelthalas,478,paladin,retribution,12,5,7
Chengduqq,illidan,478,paladin,retribution,12,5,7
Vonfraud,lightbringer,478,paladin,retribution,18,5,13
Alvis,kiljaeden,478,paladin,retribution,24,5,19
Jammsheed,arthas,477,paladin,retribution,12,5,7
Benzen,bleeding-hollow,477,paladin,retribution,12,5,7
Anard,eredar,477,paladin,retribution,13,5,8
Kaminasol,quelthalas,477,paladin,retribution,18,5,13
Pedromuulos,misha,477,paladin,retribution,24,5,19
Solstein,dalaran,474,paladin,retribution,12,5,7
Dubaron,burning-blade,473,paladin,retribution,12,5,7
Torms,illidan,463,paladin,retribution,15,7,8
Kforty,kiljaeden,458,paladin,retribution,18,7,11
Pablito,fizzcrank,457,paladin,retribution,21,7,14
Thepallyx,silvermoon,448,paladin,retribution,16,5,11
Kumahdori,stormrage,447,paladin,retribution,8,6,2
Remake,stormrage,447,paladin,retribution,8,6,2
Bloodybill,frostmane,447,paladin,retribution,11,5,6
Jireen,tichondrius,447,paladin,retribution,11,5,6
Asarul,ragnaros,447,paladin,retribution,14,6,8
Clarïtý,stormrage,446,paladin,retribution,20,6,14
Holythanos,bleeding-hollow,445,paladin,retribution,17,5,12
Árèz,frostmourne,441,paladin,retribution,17,7,10
Lorgax,alterac-mountains,432,paladin,retribution,15,5,10
Dreadrein,tichondrius,431,paladin,retribution,11,5,6
Neverforgot,quelthalas,431,paladin,retribution,11,5,6
Zzf,turalyon,431,paladin,retribution,11,5,6
Ahzreal,garona,426,paladin,retribution,16,8,8
Regivän,azralon,426,paladin,retribution,12,6,6
Hálløwéð,firetree,426,paladin,retribution,14,6,8
Stankylordz,sargeras,426,paladin,retribution,19,8,11
Rashrind,moon-guard,426,paladin,retribution,23,8,15
Sundher,ragnaros,426,paladin,retribution,29,7,22
Kimochiyuh,illidan,425,paladin,retribution,17,7,10
Yemotis,emerald-dream,416,paladin,retribution,10,5,5
Ææøææøææøææø,illidan,416,paladin,retribution,10,5,5
Molodino,nemesis,416,paladin,retribution,10,5,5
Lndrenk,gallywix,416,paladin,retribution,13,5,8
Stahny,thrall,415,paladin,retribution,10,5,5
Hrödric,stormrage,415,paladin,retribution,11,5,6
Saviorsavior,bleeding-hollow,415,paladin,retribution,11,5,6
Epxilon,ragnaros,415,paladin,retribution,14,5,9
Waffulzz,moonrunner,415,paladin,retribution,20,5,15
Rainingrets,tichondrius,404,paladin,retribution,28,10,18
Iamriched,illidan,400,paladin,retribution,13,5,8
Thechoseno,tichondrius,400,paladin,retribution,13,5,8
Sydnneeyy,kelthuzad,399,paladin,retribution,5,5,0
Bubblebùtt,tichondrius,384,paladin,retribution,6,4,2
Plateßound,black-dragonflight,384,paladin,retribution,6,4,2
Laventus,area-52,384,paladin,retribution,6,4,2
Gooeylouie,thunderlord,384,paladin,retribution,6,4,2
Crocfacex,tichondrius,384,paladin,retribution,6,4,2
Casko,wyrmrest-accord,384,paladin,retribution,6,4,2
Anaxxie,azralon,384,paladin,retribution,6,4,2
Owllii,frostwolf,384,paladin,retribution,6,4,2
Waycooltwo,darrowmere,384,paladin,retribution,6,4,2
Vxm,illidan,384,paladin,retribution,6,4,2
Snajky,sargeras,384,paladin,retribution,6,4,2
Giancarloss,quelthalas,384,paladin,retribution,6,4,2
Akadios,azralon,384,paladin,retribution,6,4,2
Slakyph,zuljin,384,paladin,retribution,6,4,2
Farlayne,quelthalas,384,paladin,retribution,6,4,2
Drakewood,moon-guard,384,paladin,retribution,6,4,2
Aohxmathoss,zuljin,384,paladin,retribution,6,4,2
Warspite,caelestrasz,384,paladin,retribution,6,4,2
Wyrmblood,moon-guard,384,paladin,retribution,6,4,2
Sentence,moon-guard,384,paladin,retribution,6,4,2
Leoros,blackrock,384,paladin,retribution,6,4,2
Dartárok,ragnaros,384,paladin,retribution,6,4,2
Pronther,ragnaros,384,paladin,retribution,6,4,2
Saulhudson,bleeding-hollow,384,paladin,retribution,6,4,2
Sasukee,quelthalas,384,paladin,retribution,6,4,2
Gilgamesh,moonrunner,384,paladin,retribution,6,4,2
Lilpéep,area-52,384,paladin,retribution,6,4,2
Ashlín,sargeras,384,paladin,retribution,6,4,2
Inactive,gilneas,384,paladin,retribution,6,4,2
Reclusiarch,tichondrius,384,paladin,retribution,6,4,2
Reckoniing,moon-guard,384,paladin,retribution,6,4,2
Chillpal,illidan,384,paladin,retribution,6,4,2
Tyranoss,azralon,384,paladin,retribution,6,4,2
Salithan,gilneas,384,paladin,retribution,6,4,2
Dazztrain,barthilas,384,paladin,retribution,6,4,2
Ironpallyx,garrosh,384,paladin,retribution,6,4,2
Easiestclass,azshara,384,paladin,retribution,6,4,2
Täintcrusher,illidan,384,paladin,retribution,6,4,2
Protopally,zuljin,384,paladin,retribution,6,4,2
Trynith,area-52,384,paladin,retribution,6,4,2
Bastila,zuljin,384,paladin,retribution,6,4,2
Koal,area-52,384,paladin,retribution,6,4,2
Flfltmf,tichondrius,384,paladin,retribution,6,4,2
Taiffan,azralon,384,paladin,retribution,6,4,2
Rockysh,tichondrius,384,paladin,retribution,6,4,2
Xs,nagrand,384,paladin,retribution,6,4,2
Maeldart,quelthalas,384,paladin,retribution,6,4,2
Daylit,proudmoore,384,paladin,retribution,6,4,2
Hugëhammer,emerald-dream,384,paladin,retribution,6,4,2
Airmight,frostmourne,384,paladin,retribution,6,4,2
Dwarfineas,dalaran,384,paladin,retribution,6,4,2
Luluwu,stormrage,384,paladin,retribution,6,4,2
Nutonhands,moon-guard,384,paladin,retribution,6,4,2
Pappablanco,stormrage,384,paladin,retribution,6,4,2
Shadp,frostmourne,384,paladin,retribution,6,4,2
Palagan,frostmourne,384,paladin,retribution,6,4,2
Heniou,tichondrius,384,paladin,retribution,6,4,2
Plottwists,bleeding-hollow,384,paladin,retribution,6,4,2
Unluckopal,illidan,384,paladin,retribution,6,4,2
Canibaluy,ragnaros,384,paladin,retribution,6,4,2
Holybubble,silvermoon,384,paladin,retribution,6,4,2
Expiate,tichondrius,384,paladin,retribution,6,4,2
Ashgrim,kiljaeden,384,paladin,retribution,6,4,2
Temptrez,bleeding-hollow,384,paladin,retribution,6,4,2
Cenital,quelthalas,384,paladin,retribution,6,4,2
Aswaran,jaedenar,384,paladin,retribution,6,4,2
Crewsade,sargeras,384,paladin,retribution,6,4,2
Ascencer,spirestone,384,paladin,retribution,6,4,2
Anstyl,moon-guard,384,paladin,retribution,6,4,2
Dörisseline,bleeding-hollow,384,paladin,retribution,6,4,2
Kpopsicle,frostmourne,384,paladin,retribution,6,4,2
Lalatinaford,amanthul,384,paladin,retribution,6,4,2
Babylonfive,zuluhed,384,paladin,retribution,6,4,2
Legionare,quelthalas,384,paladin,retribution,6,4,2
Atheistqtlol,illidan,384,paladin,retribution,6,4,2
Dyreilas,stormrage,384,paladin,retribution,6,4,2
Seven,blackwing-lair,384,paladin,retribution,6,4,2
Lothremar,stormrage,384,paladin,retribution,6,4,2
Bmorezaddy,tichondrius,384,paladin,retribution,6,4,2
Chunggus,eredar,384,paladin,retribution,6,4,2
Trisøn,area-52,384,paladin,retribution,6,4,2
Aymer,thrall,384,paladin,retribution,6,4,2
Heliösdark,quelthalas,384,paladin,retribution,6,4,2
Rohlin,boulderfist,384,paladin,retribution,6,4,2
Doç,stormrage,384,paladin,retribution,6,4,2
Yuliu,magtheridon,384,paladin,retribution,6,4,2
Cratt,chromaggus,384,paladin,retribution,6,4,2
Vorne,tortheldrin,384,paladin,retribution,6,4,2
Darklyght,madoran,384,paladin,retribution,6,4,2
Mesiaussx,area-52,384,paladin,retribution,6,4,2
Kaypross,area-52,384,paladin,retribution,6,4,2
Xöchïqüëtzäl,tichondrius,384,paladin,retribution,6,4,2
Fxxku,tichondrius,384,paladin,retribution,6,4,2
Goontaa,staghelm,384,paladin,retribution,6,4,2
Thottylight,stormrage,384,paladin,retribution,6,4,2
Notaefc,icecrown,384,paladin,retribution,6,4,2
Tanrid,moon-guard,384,paladin,retribution,6,4,2
Liebesleid,quelthalas,384,paladin,retribution,6,4,2
Mhuzz,nemesis,384,paladin,retribution,6,4,2
Krewe,uldaman,384,paladin,retribution,6,4,2
Couraegus,azgalor,384,paladin,retribution,6,4,2
Pray,thunderlord,384,paladin,retribution,6,4,2
Patrikuu,tichondrius,384,paladin,retribution,6,4,2
Raphaelo,tichondrius,384,paladin,retribution,6,4,2
Redempshun,drenden,384,paladin,retribution,6,4,2
Merlinä,illidan,384,paladin,retribution,7,4,3
Bigddady,quelthalas,384,paladin,retribution,8,4,4
Armilus,area-52,384,paladin,retribution,11,5,6
Minaxx,dalaran,384,paladin,retribution,9,4,5
Thõre,frostmourne,384,paladin,retribution,15,5,10
Phattpump,tichondrius,384,paladin,retribution,12,4,8
Eddf,ursin,384,paladin,retribution,12,4,8
Mirâ,tichondrius,384,paladin,retribution,12,4,8
Vhaun,cairne,384,paladin,retribution,12,4,8
Gloryholy,shattered-hand,384,paladin,retribution,12,4,8
Kratosq,tichondrius,384,paladin,retribution,12,4,8
Grimdel,moon-guard,384,paladin,retribution,12,4,8
Fiorena,malganis,384,paladin,retribution,12,4,8
Baptism,shattered-hand,384,paladin,retribution,12,4,8
Réxul,ragnaros,384,paladin,retribution,12,4,8
Exolust,dalaran,384,paladin,retribution,12,4,8
Sethy,feathermoon,384,paladin,retribution,12,4,8
Thaleros,tichondrius,384,paladin,retribution,12,4,8
Zexion,azralon,384,paladin,retribution,12,4,8
Sanctïon,bleeding-hollow,384,paladin,retribution,12,4,8
Botch,drenden,384,paladin,retribution,12,4,8
Ihitthose,moon-guard,384,paladin,retribution,12,4,8
Remm,emerald-dream,384,paladin,retribution,12,4,8
Glexann,sargeras,384,paladin,retribution,12,4,8
Oppaladin,elune,384,paladin,retribution,12,4,8
Joepepperoni,korgath,384,paladin,retribution,12,4,8
Goloh,shadowmoon,384,paladin,retribution,12,4,8
Wards,thunderlord,384,paladin,retribution,12,4,8
Ðorlie,malganis,384,paladin,retribution,12,4,8
Adrn,tichondrius,384,paladin,retribution,12,4,8
Mashy,moon-guard,384,paladin,retribution,12,4,8
Thejüdge,malfurion,384,paladin,retribution,12,4,8
Moosgo,emerald-dream,384,paladin,retribution,12,4,8
Blikzy,caelestrasz,384,paladin,retribution,12,4,8
Treboroyal,area-52,384,paladin,retribution,12,4,8
Kiami,tichondrius,384,paladin,retribution,12,4,8
Drakensang,tichondrius,384,paladin,retribution,12,4,8
Rightz,muradin,384,paladin,retribution,12,4,8
Jimithing,senjin,384,paladin,retribution,12,4,8
Passinpeace,tichondrius,384,paladin,retribution,12,4,8
Msjudged,blackrock,384,paladin,retribution,12,4,8
Øathßreaker,laughing-skull,384,paladin,retribution,12,4,8
Varuul,nerzhul,384,paladin,retribution,12,4,8
Kyrianjutsu,area-52,384,paladin,retribution,12,4,8
Picorii,frostmourne,384,paladin,retribution,12,4,8
Marlynx,tichondrius,384,paladin,retribution,12,4,8
Aidillon,shadowsong,384,paladin,retribution,12,4,8
Lenneth,nordrassil,384,paladin,retribution,12,4,8
Taelpalx,stormrage,384,paladin,retribution,12,4,8
Tëmplar,bleeding-hollow,384,paladin,retribution,12,4,8
Lowther,bleeding-hollow,384,paladin,retribution,12,4,8
Phelix,lightninghoof,384,paladin,retribution,12,4,8
Cafre,illidan,384,paladin,retribution,12,4,8
Tyronethebbc,tichondrius,384,paladin,retribution,12,4,8
Kurook,moon-guard,384,paladin,retribution,12,4,8
Fengyutongqs,tichondrius,384,paladin,retribution,12,4,8
Evilmoocow,grizzly-hills,384,paladin,retribution,12,4,8
Adauto,illidan,384,paladin,retribution,12,4,8
Veshral,arthas,384,paladin,retribution,12,4,8
Actionman,bleeding-hollow,384,paladin,retribution,12,4,8
Dionysius,silvermoon,384,paladin,retribution,12,4,8
Dohsevèn,tichondrius,384,paladin,retribution,12,4,8
Eldruin,amanthul,384,paladin,retribution,12,4,8
Andromëdä,hyjal,384,paladin,retribution,12,4,8
Kamianna,tichondrius,384,paladin,retribution,12,4,8
Givinpowpows,korgath,384,paladin,retribution,12,4,8
Bauldrin,moon-guard,384,paladin,retribution,12,4,8
Simpforomenx,emerald-dream,384,paladin,retribution,12,4,8
Jimxeung,tichondrius,384,paladin,retribution,12,4,8
Kegari,tichondrius,384,paladin,retribution,12,4,8
Dezul,stormscale,384,paladin,retribution,12,4,8
Jeddmaus,tichondrius,384,paladin,retribution,12,4,8
Prettylightx,kelthuzad,384,paladin,retribution,12,4,8
Ddawz,proudmoore,384,paladin,retribution,12,4,8
Justsaiyen,bleeding-hollow,384,paladin,retribution,12,4,8
Eettooko,aegwynn,384,paladin,retribution,12,4,8
Sahbabii,baelgun,384,paladin,retribution,12,4,8
Zakh,proudmoore,384,paladin,retribution,12,4,8
Nicc,kelthuzad,384,paladin,retribution,12,4,8
Volphorix,illidan,384,paladin,retribution,12,4,8
Korijame,area-52,384,paladin,retribution,12,4,8
Blargnarg,area-52,384,paladin,retribution,12,4,8
Tirinor,malganis,384,paladin,retribution,12,4,8
Bangerr,bonechewer,384,paladin,retribution,12,4,8
Rouzygoozy,illidan,384,paladin,retribution,12,4,8
Hølyknìght,tichondrius,384,paladin,retribution,12,4,8
Leail,frostmourne,384,paladin,retribution,12,4,8
Crystahlmeth,sargeras,384,paladin,retribution,12,4,8
Smontis,sargeras,384,paladin,retribution,12,4,8
Lightmodel,sargeras,384,paladin,retribution,12,4,8
Whoowhat,zuljin,384,paladin,retribution,12,4,8
Yedema,tichondrius,384,paladin,retribution,12,4,8
Uver,tichondrius,384,paladin,retribution,12,4,8
Palinator,bleeding-hollow,384,paladin,retribution,12,4,8
Alínna,ragnaros,384,paladin,retribution,12,4,8
Oroürke,stormrage,384,paladin,retribution,12,4,8
Gerudö,stormrage,384,paladin,retribution,12,4,8
Àpolo,stormrage,384,paladin,retribution,12,4,8
Goodgardener,hyjal,384,paladin,retribution,12,4,8
Tufybighamer,malganis,384,paladin,retribution,12,4,8
Slimxx,burning-blade,384,paladin,retribution,12,4,8
Strugglèbus,thrall,384,paladin,retribution,12,4,8
Craphtyßop,zuljin,384,paladin,retribution,12,4,8
Crazysyco,proudmoore,384,paladin,retribution,12,4,8
Retspec,darkspear,384,paladin,retribution,12,4,8
Maelificus,aggramar,384,paladin,retribution,12,4,8
Paldan,illidan,384,paladin,retribution,12,4,8
Icekiss,tichondrius,384,paladin,retribution,12,4,8
Greenracer,kiljaeden,384,paladin,retribution,12,4,8
Salvatores,ragnaros,384,paladin,retribution,12,4,8
Bubblestuft,illidan,384,paladin,retribution,12,4,8
Pogwogs,illidan,384,paladin,retribution,12,4,8
Gripadin,tichondrius,384,paladin,retribution,12,4,8
Ilsey,ragnaros,384,paladin,retribution,12,4,8
Senion,velen,384,paladin,retribution,12,4,8
Catuvalos,kiljaeden,384,paladin,retribution,12,4,8
Mercuryx,tichondrius,384,paladin,retribution,12,4,8
Aricen,thunderhorn,384,paladin,retribution,12,4,8
Sigmapepe,quelthalas,384,paladin,retribution,12,4,8
Mikeelul,tichondrius,384,paladin,retribution,12,4,8
Niolite,ragnaros,384,paladin,retribution,12,4,8
Simonis,windrunner,384,paladin,retribution,12,4,8
Thêirin,lightbringer,384,paladin,retribution,12,4,8
Strøngwin,bleeding-hollow,384,paladin,retribution,12,4,8
Elflicious,illidan,384,paladin,retribution,12,4,8
Illhaveacoke,moon-guard,384,paladin,retribution,12,4,8
Vonmagnus,sargeras,384,paladin,retribution,12,4,8
Ippótis,sargeras,384,paladin,retribution,12,4,8
Dose,moon-guard,384,paladin,retribution,12,4,8
Avataar,blades-edge,384,paladin,retribution,12,4,8
Lânnâ,tichondrius,384,paladin,retribution,12,4,8
Juliusplzher,area-52,384,paladin,retribution,12,4,8
Lokkillos,drakkari,384,paladin,retribution,12,4,8
Tymy,tichondrius,384,paladin,retribution,12,4,8
Bracen,emerald-dream,384,paladin,retribution,12,4,8
Smöke,frostmourne,384,paladin,retribution,12,4,8
Lépéedophil,zuljin,384,paladin,retribution,12,4,8
Roodictz,zuljin,384,paladin,retribution,12,4,8
Pallyforeva,sargeras,384,paladin,retribution,12,4,8
Acquiesce,bleeding-hollow,384,paladin,retribution,16,5,11
Batmanp,quelthalas,384,paladin,retribution,13,4,9
Ccpx,area-52,384,paladin,retribution,18,4,14
Powercelest,quelthalas,384,paladin,retribution,18,4,14
Caityaj,illidan,384,paladin,retribution,18,4,14
Theadona,runetotem,384,paladin,retribution,18,4,14
Draknals,illidan,384,paladin,retribution,18,4,14
Tylnish,hyjal,384,paladin,retribution,18,4,14
Retsáiyan,tichondrius,384,paladin,retribution,18,4,14
Xinoh,area-52,384,paladin,retribution,18,4,14
ßén,bleeding-hollow,384,paladin,retribution,18,4,14
Talurius,azralon,384,paladin,retribution,18,4,14
Ongang,illidan,384,paladin,retribution,18,4,14
Essexqt,blackhand,384,paladin,retribution,18,4,14
Milfcrusader,tichondrius,384,paladin,retribution,18,4,14
Malisaa,tichondrius,384,paladin,retribution,18,4,14
Fragnum,barthilas,384,paladin,retribution,18,4,14
Iskándar,tichondrius,384,paladin,retribution,24,4,20
Mhakoi,bleeding-hollow,384,paladin,retribution,24,4,20
Matrium,kiljaeden,384,paladin,retribution,24,4,20
Backfattammy,bleeding-hollow,384,paladin,retribution,24,4,20
Memorabilia,quelthalas,383,paladin,retribution,6,4,2
Thaerim,ragnaros,383,paladin,retribution,6,4,2
Dabsmaster,dalaran,383,paladin,retribution,6,4,2
Pajjy,azralon,383,paladin,retribution,6,4,2
Adandon,dalaran,383,paladin,retribution,6,4,2
Balador,uldum,383,paladin,retribution,6,4,2
Charmeine,zuljin,383,paladin,retribution,6,4,2
Themachon,stormrage,383,paladin,retribution,6,4,2
Sinficha,quelthalas,383,paladin,retribution,6,4,2
Amazarak,stormrage,383,paladin,retribution,12,4,8
Holyqt,thunderlord,383,paladin,retribution,12,4,8
Øexørcistta,nemesis,383,paladin,retribution,12,4,8
Mugann,malganis,383,paladin,retribution,12,4,8
Kennysun,azralon,383,paladin,retribution,12,4,8
Desrexen,malganis,383,paladin,retribution,12,4,8
Holyburger,hakkar,383,paladin,retribution,12,4,8
Nastenatren,steamwheedle-cartel,383,paladin,retribution,18,4,14
Imimmune,garithos,383,paladin,retribution,18,4,14
Funkknight,sargeras,383,paladin,retribution,18,4,14
Dago,azralon,383,paladin,retribution,18,4,14
Stunnaax,frostmourne,383,paladin,retribution,18,4,14
Balnot,blackrock,383,paladin,retribution,18,4,14
Paladocka,stormrage,383,paladin,retribution,24,4,20
Hadrianus,azralon,383,paladin,retribution,24,4,20
Ðrekai,moon-guard,383,paladin,retribution,24,4,20
Kenbad,aegwynn,382,paladin,retribution,6,4,2
Kungrowl,emerald-dream,382,paladin,retribution,6,4,2
Derpnstein,gorgonnash,382,paladin,retribution,12,4,8
Zedekia,aerie-peak,382,paladin,retribution,12,4,8
Sundreland,moon-guard,382,paladin,retribution,12,4,8
Amerok,malfurion,378,paladin,retribution,18,4,14
Nyms,gallywix,374,paladin,retribution,36,4,32
Vegetå,malganis,372,paladin,retribution,37,8,29
Novachrono,bladefist,367,paladin,retribution,9,5,4
Barzø,tichondrius,367,paladin,retribution,11,4,7
Crucifine,wyrmrest-accord,367,paladin,retribution,11,4,7
Goinglarge,frostmourne,367,paladin,retribution,11,4,7
Mop,eitrigg,367,paladin,retribution,17,4,13
Feelmenu,deathwing,367,paladin,retribution,17,4,13
Nohozano,area-52,352,paladin,retribution,10,4,6
Bibimbop,boulderfist,352,paladin,retribution,13,5,8
Gordonryan,bleeding-hollow,352,paladin,retribution,16,4,12
Sesshomâru,nemesis,351,paladin,retribution,11,4,7
Páladian,quelthalas,351,paladin,retribution,11,4,7
Conquistador,proudmoore,351,paladin,retribution,11,4,7
Estarosta,azralon,351,paladin,retribution,17,4,13
Língnafòx,tichondrius,336,paladin,retribution,9,5,4
Bruujqt,moon-guard,336,paladin,retribution,9,5,4
Titansnake,illidan,336,paladin,retribution,9,4,5
Meduselda,kelthuzad,335,paladin,retribution,9,5,4
Yellowflash,sentinels,330,paladin,retribution,17,7,10
Returdstrenf,illidan,330,paladin,retribution,20,5,15
Dubbz,silvermoon,320,paladin,retribution,10,4,6
Asolace,dark-iron,320,paladin,retribution,10,4,6
Junmá,tichondrius,319,paladin,retribution,5,4,1
Ruulight,tichondrius,319,paladin,retribution,5,4,1
Karig,sargeras,319,paladin,retribution,8,4,4
Jadelong,azshara,319,paladin,retribution,8,4,4
Holyshasha,tichondrius,319,paladin,retribution,8,4,4
Holynaps,malganis,319,paladin,retribution,9,4,5
Wrath,frostmourne,319,paladin,retribution,14,4,10
Darkjewmagic,frostmourne,319,paladin,retribution,14,4,10
Naizen,tichondrius,304,paladin,retribution,7,4,3
Torrthak,area-52,304,paladin,retribution,7,4,3
Jacobelaylo,moon-guard,288,paladin,retribution,6,3,3
Purekiller,destromath,288,paladin,retribution,6,3,3
Daigorro,illidan,288,paladin,retribution,6,3,3
Pahlevahn,stormrage,288,paladin,retribution,6,3,3
Senisse,illidan,288,paladin,retribution,6,3,3
Ironboxer,tichondrius,288,paladin,retribution,6,3,3
Nickahunnid,sargeras,288,paladin,retribution,6,3,3
Kanachi,bleeding-hollow,288,paladin,retribution,6,3,3
Siyepaladin,illidan,288,paladin,retribution,6,3,3
Menjo,malganis,288,paladin,retribution,6,3,3
Shakemup,stormrage,288,paladin,retribution,6,3,3
Zuezz,korialstrasz,288,paladin,retribution,6,3,3
Nickotines,kelthuzad,288,paladin,retribution,6,3,3
Eldanx,stormrage,288,paladin,retribution,6,3,3
Shockdoctor,stormrage,288,paladin,retribution,6,3,3
Holyoverdose,laughing-skull,288,paladin,retribution,6,3,3
Vaels,sargeras,288,paladin,retribution,6,3,3
Mki,kargath,288,paladin,retribution,6,3,3
Ataraxy,bleeding-hollow,288,paladin,retribution,6,3,3
Xbertiize,tichondrius,288,paladin,retribution,6,3,3
Kôld,tichondrius,288,paladin,retribution,6,3,3
Judgem,tichondrius,288,paladin,retribution,6,3,3
Bubblet,bleeding-hollow,288,paladin,retribution,6,3,3
Mayfirepal,hyjal,288,paladin,retribution,6,3,3
Àxçël,hyjal,288,paladin,retribution,6,3,3
Borisdablade,bleeding-hollow,288,paladin,retribution,6,3,3
Lorainn,ragnaros,288,paladin,retribution,6,3,3
Vük,destromath,288,paladin,retribution,6,3,3
Kyperion,stormrage,288,paladin,retribution,6,3,3
Reiot,sargeras,288,paladin,retribution,6,3,3
Numela,moon-guard,288,paladin,retribution,6,3,3
Konyfotm,bleeding-hollow,288,paladin,retribution,6,3,3
Mcfleye,malganis,288,paladin,retribution,6,3,3
Morlunè,tichondrius,288,paladin,retribution,6,3,3
Obbzz,spirestone,288,paladin,retribution,6,3,3
Kloernstarr,sargeras,288,paladin,retribution,6,3,3
Tsubakî,norgannon,288,paladin,retribution,6,3,3
Vanitasz,bleeding-hollow,288,paladin,retribution,6,3,3
Shibbz,illidan,288,paladin,retribution,6,3,3
Sadamell,tichondrius,288,paladin,retribution,6,3,3
Chickenlover,tichondrius,288,paladin,retribution,6,3,3
Slüg,bleeding-hollow,288,paladin,retribution,6,3,3
Krackanut,kelthuzad,288,paladin,retribution,6,3,3
Baladinn,tichondrius,288,paladin,retribution,6,3,3
Everith,bleeding-hollow,288,paladin,retribution,6,3,3
Astasia,laughing-skull,288,paladin,retribution,6,3,3
Holyplaise,tichondrius,288,paladin,retribution,6,3,3
Draeneihead,gnomeregan,288,paladin,retribution,6,3,3
Rost,jaedenar,288,paladin,retribution,6,3,3
Snippdeux,garrosh,288,paladin,retribution,6,3,3
Sâbër,moon-guard,288,paladin,retribution,6,3,3
Pallyson,thunderhorn,288,paladin,retribution,6,3,3
Nhanless,tichondrius,288,paladin,retribution,6,3,3
Gorillawings,tichondrius,288,paladin,retribution,6,3,3
Dfz,mannoroth,288,paladin,retribution,6,3,3
Thorkell,moon-guard,288,paladin,retribution,6,3,3
Nalenne,alexstrasza,288,paladin,retribution,6,3,3
Ýøg,tichondrius,288,paladin,retribution,6,3,3
Holyyness,bleeding-hollow,288,paladin,retribution,6,3,3
Brahlix,area-52,288,paladin,retribution,6,3,3
Deadlyskills,arathor,288,paladin,retribution,6,3,3
Jojoboskies,aegwynn,288,paladin,retribution,6,3,3
Vynlen,uldaman,288,paladin,retribution,6,3,3
Lituation,sargeras,288,paladin,retribution,6,3,3
Zeroret,tichondrius,288,paladin,retribution,6,3,3
Dev,frostwolf,288,paladin,retribution,6,3,3
Pallynatir,ragnaros,288,paladin,retribution,6,3,3
Lasonil,zuljin,288,paladin,retribution,6,3,3
Varo,laughing-skull,288,paladin,retribution,6,3,3
Casadorez,tichondrius,288,paladin,retribution,6,3,3
Qoop,tichondrius,288,paladin,retribution,6,3,3
Pvar,stormrage,288,paladin,retribution,6,3,3
Apocryphx,stormrage,288,paladin,retribution,6,3,3
Jónò,tichondrius,288,paladin,retribution,6,3,3
Ludicrus,tichondrius,288,paladin,retribution,6,3,3
Divinebehind,laughing-skull,288,paladin,retribution,6,3,3
Hybrix,tichondrius,288,paladin,retribution,6,3,3
Exaltedthot,zuljin,288,paladin,retribution,6,3,3
Pâllywhacker,bleeding-hollow,288,paladin,retribution,6,3,3
Holycenter,stormrage,288,paladin,retribution,6,3,3
Coldverdict,tichondrius,288,paladin,retribution,6,3,3
Miangder,tichondrius,288,paladin,retribution,6,3,3
Efilios,tichondrius,288,paladin,retribution,6,3,3
Bigdamham,tichondrius,288,paladin,retribution,6,3,3
Chicoweather,sargeras,288,paladin,retribution,6,3,3
Ximenita,ragnaros,288,paladin,retribution,6,3,3
Chiraqret,thunderhorn,288,paladin,retribution,6,3,3
Stømpdøwn,tichondrius,288,paladin,retribution,6,3,3
Netflixnfeet,stormreaver,288,paladin,retribution,6,3,3
Salamislappr,stormrage,288,paladin,retribution,6,3,3
Karwryn,magtheridon,288,paladin,retribution,6,3,3
Syvir,area-52,288,paladin,retribution,6,3,3
Zilladin,darkspear,288,paladin,retribution,6,3,3
Pipay,proudmoore,288,paladin,retribution,6,3,3
Xaospaladin,frostmourne,288,paladin,retribution,6,3,3
Babar,doomhammer,288,paladin,retribution,6,3,3
Arngrim,the-venture-co,288,paladin,retribution,6,3,3
Theßest,baelgun,288,paladin,retribution,6,3,3
Kegman,thrall,288,paladin,retribution,6,3,3
Nerfmywings,frostmourne,288,paladin,retribution,6,3,3
Assaultron,dalaran,288,paladin,retribution,6,3,3
Tahonto,malganis,288,paladin,retribution,6,3,3
Pirupiru,quelthalas,288,paladin,retribution,6,3,3
Ulfsark,garrosh,288,paladin,retribution,6,3,3
Ouken,frostmourne,288,paladin,retribution,6,3,3
Thecrusaders,proudmoore,288,paladin,retribution,6,3,3
Zugzorr,azralon,288,paladin,retribution,6,3,3
Absolvus,emerald-dream,288,paladin,retribution,6,3,3
Reallyfe,skullcrusher,288,paladin,retribution,6,3,3
Lencelia,deathwing,288,paladin,retribution,6,3,3
Palladini,jubeithos,288,paladin,retribution,6,3,3
Finnthepally,proudmoore,288,paladin,retribution,6,3,3
Bigdmcgee,frostmourne,288,paladin,retribution,6,3,3
Timu,suramar,288,paladin,retribution,6,3,3
Itzon,proudmoore,288,paladin,retribution,6,3,3
Légolas,llane,288,paladin,retribution,6,3,3
Lowbb,sargeras,288,paladin,retribution,6,3,3
Luminali,frostwolf,288,paladin,retribution,6,3,3
Tekkies,barthilas,288,paladin,retribution,6,3,3
Hadory,shattered-halls,288,paladin,retribution,6,3,3
Aelael,icecrown,288,paladin,retribution,6,3,3
Taynos,tichondrius,288,paladin,retribution,6,3,3
Luxuriousman,fizzcrank,288,paladin,retribution,6,3,3
Legelight,malganis,288,paladin,retribution,6,3,3
Scamadin,tichondrius,288,paladin,retribution,6,3,3
Bíteme,sargeras,288,paladin,retribution,6,3,3
Valadinna,tichondrius,288,paladin,retribution,6,3,3
Buttflapster,proudmoore,288,paladin,retribution,6,3,3
Lóli,azralon,288,paladin,retribution,6,3,3
Boladosx,azralon,288,paladin,retribution,6,3,3
Bivol,whisperwind,288,paladin,retribution,6,3,3
Pixilade,barthilas,288,paladin,retribution,6,3,3
Rhoynar,quelthalas,288,paladin,retribution,6,3,3
Halnarran,area-52,288,paladin,retribution,6,3,3
Dordrolan,frostmourne,288,paladin,retribution,6,3,3
Cocodog,kiljaeden,288,paladin,retribution,6,3,3
Lighttzz,azralon,288,paladin,retribution,6,3,3
Mvpp,dalaran,288,paladin,retribution,6,3,3
Alocr,drakkari,288,paladin,retribution,6,3,3
Divinetits,sargeras,288,paladin,retribution,6,3,3
Darthalion,quelthalas,288,paladin,retribution,6,3,3
Runebane,doomhammer,288,paladin,retribution,6,3,3
Condexx,quelthalas,288,paladin,retribution,6,3,3
Otame,quelthalas,288,paladin,retribution,6,3,3
Danks,arthas,288,paladin,retribution,6,3,3
Haarun,blackrock,288,paladin,retribution,6,3,3
Zenpally,doomhammer,288,paladin,retribution,6,3,3
Therocker,darkspear,288,paladin,retribution,6,3,3
Wonpai,frostmourne,288,paladin,retribution,6,3,3
Vixybae,illidan,288,paladin,retribution,6,3,3
Tûrbotax,sargeras,288,paladin,retribution,6,3,3
Nyxkithar,nagrand,288,paladin,retribution,6,3,3
Moox,wyrmrest-accord,288,paladin,retribution,6,3,3
Mónstër,ragnaros,288,paladin,retribution,6,3,3
Kräthöz,quelthalas,288,paladin,retribution,6,3,3
Xizima,ragnaros,288,paladin,retribution,6,3,3
Dráugus,azralon,288,paladin,retribution,6,3,3
Beepsmash,executus,288,paladin,retribution,6,3,3
Orangepa,dalaran,288,paladin,retribution,6,3,3
Marof,spirestone,288,paladin,retribution,6,3,3
Transwoman,frostmourne,288,paladin,retribution,6,3,3
Dimitrony,quelthalas,288,paladin,retribution,6,3,3
Víctor,quelthalas,288,paladin,retribution,6,3,3
Jestiny,amanthul,288,paladin,retribution,6,3,3
Twochains,aegwynn,288,paladin,retribution,6,3,3
Kahleesy,sargeras,288,paladin,retribution,6,3,3
Sinhero,area-52,288,paladin,retribution,6,3,3
Uritank,thrall,288,paladin,retribution,6,3,3
Nâtion,cenarius,288,paladin,retribution,6,3,3
Coachcarter,nerzhul,288,paladin,retribution,6,3,3
Bootboi,thrall,288,paladin,retribution,6,3,3
Kithrah,dathremar,288,paladin,retribution,6,3,3
Feikonia,queldorei,288,paladin,retribution,6,3,3
Ankhz,area-52,288,paladin,retribution,6,3,3
Warchaos,skullcrusher,288,paladin,retribution,6,3,3
Flareous,moon-guard,288,paladin,retribution,6,3,3
Holyshrekt,frostmourne,288,paladin,retribution,6,3,3
Stepbrodi,moon-guard,288,paladin,retribution,6,3,3
Brodyb,malganis,288,paladin,retribution,6,3,3
Alexrt,frostmourne,288,paladin,retribution,6,3,3
Slopzy,sargeras,288,paladin,retribution,6,3,3
Radbout,blackrock,288,paladin,retribution,6,3,3
Açaelus,wyrmrest-accord,288,paladin,retribution,6,3,3
Nerfretpls,area-52,288,paladin,retribution,6,3,3
Gapingpooter,shadowmoon,288,paladin,retribution,6,3,3
Teazie,ursin,288,paladin,retribution,6,3,3
Kickflipped,dalaran,288,paladin,retribution,6,3,3
Makiligos,area-52,288,paladin,retribution,6,3,3
Normnom,area-52,288,paladin,retribution,6,3,3
Bigdumpy,thaurissan,288,paladin,retribution,6,3,3
Leá,illidan,288,paladin,retribution,6,3,3
Coldzito,ragnaros,288,paladin,retribution,6,3,3
Sprezzatura,illidan,288,paladin,retribution,6,3,3
Ðova,moon-guard,288,paladin,retribution,6,3,3
Lovelàce,proudmoore,288,paladin,retribution,6,3,3
Tadaki,dalaran,288,paladin,retribution,6,3,3
Rectaluse,dalaran,288,paladin,retribution,6,3,3
Netguru,ragnaros,288,paladin,retribution,6,3,3
Lightheartx,proudmoore,288,paladin,retribution,6,3,3
Zaghad,ragnaros,288,paladin,retribution,9,4,5
Ivanko,dalaran,288,paladin,retribution,7,3,4
Retattack,area-52,288,paladin,retribution,10,4,6
Josepala,stormrage,288,paladin,retribution,9,3,6
Eljosco,nordrassil,288,paladin,retribution,12,3,9
Dalden,trollbane,288,paladin,retribution,12,3,9
Marrike,moon-guard,288,paladin,retribution,12,3,9
Ucvnt,illidan,288,paladin,retribution,12,3,9
Darkkantares,ragnaros,288,paladin,retribution,12,3,9
Paladatrox,ragnaros,288,paladin,retribution,12,3,9
Bigjoetheceo,mannoroth,288,paladin,retribution,12,3,9
Baconsock,kelthuzad,288,paladin,retribution,12,3,9
Ogtandoness,azgalor,288,paladin,retribution,12,3,9
Momhips,bloodscalp,288,paladin,retribution,12,3,9
Asukaxt,illidan,288,paladin,retribution,12,3,9
Ajara,moon-guard,288,paladin,retribution,12,3,9
Chetmorton,emerald-dream,288,paladin,retribution,12,3,9
Påladin,area-52,288,paladin,retribution,12,3,9
Tolleytrain,malganis,288,paladin,retribution,12,3,9
Aeltharix,blackwater-raiders,288,paladin,retribution,12,3,9
Bulbi,emerald-dream,288,paladin,retribution,12,3,9
Sanction,the-forgotten-coast,288,paladin,retribution,12,3,9
Balancelight,azgalor,288,paladin,retribution,12,3,9
Aenwyl,quelthalas,288,paladin,retribution,12,3,9
Burom,kelthuzad,288,paladin,retribution,12,3,9
Slania,area-52,288,paladin,retribution,12,3,9
Thnannan,tichondrius,288,paladin,retribution,12,3,9
Kuoch,shandris,288,paladin,retribution,12,3,9
Corthic,area-52,288,paladin,retribution,12,3,9
Quelite,sargeras,288,paladin,retribution,12,3,9
Unspankable,burning-legion,288,paladin,retribution,12,3,9
Mwanmwa,blades-edge,288,paladin,retribution,12,3,9
Calvary,stormscale,288,paladin,retribution,12,3,9
Kentö,area-52,288,paladin,retribution,12,3,9
Bubblebooty,drakthul,288,paladin,retribution,12,3,9
Aggromatik,zuljin,288,paladin,retribution,12,3,9
Säv,tichondrius,288,paladin,retribution,12,3,9
Svane,thunderlord,288,paladin,retribution,12,3,9
Ashy,bonechewer,288,paladin,retribution,12,3,9
Darkshield,stormrage,288,paladin,retribution,12,3,9
Homeboywill,hyjal,288,paladin,retribution,12,3,9
Wasabipal,malganis,288,paladin,retribution,12,3,9
Tacoroll,tichondrius,288,paladin,retribution,12,3,9
Urmumsbeefer,thrall,288,paladin,retribution,12,3,9
Bigplucker,kelthuzad,288,paladin,retribution,12,3,9
Sàber,tichondrius,288,paladin,retribution,12,3,9
Ashlïe,moon-guard,288,paladin,retribution,12,3,9
Tarpeeksi,tichondrius,288,paladin,retribution,12,3,9
Brutaldeath,area-52,288,paladin,retribution,12,3,9
Asellusarc,kelthuzad,288,paladin,retribution,12,3,9
Nik,the-underbog,288,paladin,retribution,12,3,9
Aduynn,tichondrius,288,paladin,retribution,12,3,9
Tíron,dalaran,288,paladin,retribution,12,3,9
Smokeys,sargeras,288,paladin,retribution,12,3,9
Theodrei,darrowmere,288,paladin,retribution,12,3,9
Dävis,ragnaros,288,paladin,retribution,12,3,9
Holydiarrhea,illidan,288,paladin,retribution,12,3,9
Dárkness,blades-edge,288,paladin,retribution,12,3,9
Vintibusca,azralon,288,paladin,retribution,12,3,9
Kreigan,hellscream,288,paladin,retribution,12,3,9
Ultrah,area-52,288,paladin,retribution,12,3,9
Thunddarr,stormrage,288,paladin,retribution,12,3,9
Gashlycrumb,tichondrius,288,paladin,retribution,12,3,9
Aafushou,proudmoore,288,paladin,retribution,12,3,9
Leronos,zuljin,288,paladin,retribution,12,3,9
Lilby,lightbringer,288,paladin,retribution,12,3,9
Johnus,lightbringer,288,paladin,retribution,12,3,9
Fpaladin,tichondrius,288,paladin,retribution,12,3,9
Wälly,garona,288,paladin,retribution,12,3,9
Palâdin,zuljin,288,paladin,retribution,12,3,9
Fknnoath,frostmourne,288,paladin,retribution,12,3,9
Yepsqorz,tichondrius,288,paladin,retribution,12,3,9
Laelias,lightbringer,288,paladin,retribution,12,3,9
Donsagrado,quelthalas,288,paladin,retribution,12,3,9
Aválerion,proudmoore,288,paladin,retribution,12,3,9
Sbpluss,illidan,288,paladin,retribution,12,3,9
Bringbakbuff,illidan,288,paladin,retribution,12,3,9
Zippzyx,tichondrius,288,paladin,retribution,12,3,9
Lue,boulderfist,288,paladin,retribution,12,3,9
Cromsecrate,dalaran,288,paladin,retribution,12,3,9
Tharinty,ragnaros,288,paladin,retribution,12,3,9
Crusticus,stormrage,288,paladin,retribution,12,3,9
Treezey,durotan,288,paladin,retribution,12,3,9
Koltar,stormrage,288,paladin,retribution,12,3,9
Tutle,nathrezim,288,paladin,retribution,12,3,9
Olorunn,tichondrius,288,paladin,retribution,12,3,9
Perdiseus,stormrage,288,paladin,retribution,12,3,9
Xkillz,korgath,288,paladin,retribution,12,3,9
Sivan,crushridge,288,paladin,retribution,12,3,9
Somite,stormrage,288,paladin,retribution,12,3,9
Varthinator,stormrage,288,paladin,retribution,12,3,9
Tarkovkappa,illidan,288,paladin,retribution,12,3,9
Yeluh,malganis,288,paladin,retribution,12,3,9
Vaaleria,dalaran,288,paladin,retribution,12,3,9
Lightfûry,kelthuzad,288,paladin,retribution,12,3,9
Lìnkzq,frostmourne,288,paladin,retribution,12,3,9
Kãrën,emerald-dream,288,paladin,retribution,12,3,9
Geekpala,thrall,288,paladin,retribution,12,3,9
Rxxkiee,tichondrius,288,paladin,retribution,12,3,9
Ðeathguise,ysera,288,paladin,retribution,12,3,9
Clorpi,drakkari,288,paladin,retribution,12,3,9
Flashstark,area-52,288,paladin,retribution,12,3,9
Merothin,drakkari,288,paladin,retribution,12,3,9
Uzbadkhazad,ragnaros,288,paladin,retribution,12,3,9
Kloerny,sargeras,288,paladin,retribution,12,3,9
Walkerbait,nazgrel,288,paladin,retribution,12,3,9
Kaorah,drakkari,288,paladin,retribution,12,3,9
Sessybrexy,bleeding-hollow,288,paladin,retribution,12,3,9
Madworld,moon-guard,288,paladin,retribution,12,3,9
Elpal,thrall,288,paladin,retribution,12,3,9
Pallypòwer,garrosh,288,paladin,retribution,12,3,9
Jontapally,stormrage,288,paladin,retribution,12,3,9
Lìghtning,stormrage,288,paladin,retribution,12,3,9
Corni,kiljaeden,288,paladin,retribution,12,3,9
Lxwd,tichondrius,288,paladin,retribution,12,3,9
Amega,bleeding-hollow,288,paladin,retribution,12,3,9
Hardclimacks,frostmourne,288,paladin,retribution,12,3,9
Veguê,ragnaros,288,paladin,retribution,12,3,9
Spiritkeep,veknilash,288,paladin,retribution,12,3,9
Mightbeard,proudmoore,288,paladin,retribution,14,3,11
Divinedabs,stormrage,288,paladin,retribution,18,3,15
Bullworm,ragnaros,288,paladin,retribution,18,3,15
Zoriå,sargeras,288,paladin,retribution,18,3,15
Taredowo,area-52,288,paladin,retribution,18,3,15
Bellzebut,sargeras,288,paladin,retribution,18,3,15
Mollybop,stormrage,288,paladin,retribution,18,3,15
Rohland,illidan,288,paladin,retribution,18,3,15
Fourchon,tichondrius,288,paladin,retribution,18,3,15
Voorrkk,kelthuzad,288,paladin,retribution,18,3,15
Pepepally,area-52,288,paladin,retribution,18,3,15
Whangsta,tichondrius,288,paladin,retribution,24,3,21
Sweetpally,moonrunner,287,paladin,retribution,6,3,3
Nøxus,azralon,287,paladin,retribution,6,3,3
Kimbr,gallywix,287,paladin,retribution,6,3,3
Matøs,stormrage,287,paladin,retribution,6,3,3
Tenshí,windrunner,287,paladin,retribution,6,3,3
Holytrails,sargeras,287,paladin,retribution,6,3,3
Covidxlx,hakkar,287,paladin,retribution,6,3,3
Nalahra,moon-guard,287,paladin,retribution,9,4,5
Paladinkofwa,tichondrius,287,paladin,retribution,12,4,8
Reathe,llane,287,paladin,retribution,12,3,9
Níka,turalyon,287,paladin,retribution,12,3,9
Laylee,anvilmar,287,paladin,retribution,12,3,9
Mynnorath,emerald-dream,287,paladin,retribution,12,3,9
Divinetank,amanthul,287,paladin,retribution,12,3,9
Stainless,magtheridon,287,paladin,retribution,12,3,9
Cruz,silver-hand,286,paladin,retribution,12,3,9
Hukah,darkspear,286,paladin,retribution,18,3,15
Tyrack,ragnaros,271,paladin,retribution,11,3,8
Ronatiú,tichondrius,271,paladin,retribution,11,3,8
Bostonbird,sargeras,271,paladin,retribution,11,3,8
Milkmi,frostmourne,271,paladin,retribution,11,3,8
Ôv,norgannon,256,paladin,retribution,4,4,0
Gabrielú,lightninghoof,256,paladin,retribution,10,3,7
Wingsproc,stormrage,256,paladin,retribution,10,3,7
Logaen,stormrage,256,paladin,retribution,16,3,13
Trippierett,bloodscalp,256,paladin,retribution,16,3,13
Kealthamar,wyrmrest-accord,255,paladin,retribution,4,4,0
Gusset,tichondrius,255,paladin,retribution,8,4,4
Hoeliekow,dalaran,255,paladin,retribution,12,5,7
Serazan,moon-guard,255,paladin,retribution,11,3,8
Vero,agamaggan,254,paladin,retribution,23,3,20
Anoxis,tichondrius,239,paladin,retribution,5,3,2
Thomir,tichondrius,239,paladin,retribution,5,3,2
Egu,mugthol,239,paladin,retribution,5,3,2
Wegie,emerald-dream,239,paladin,retribution,5,3,2
Helberth,stormrage,239,paladin,retribution,5,3,2
Badmix,tichondrius,239,paladin,retribution,5,3,2
Sôsaboy,tichondrius,239,paladin,retribution,5,3,2
Ðablordx,tichondrius,239,paladin,retribution,9,4,5
Palitard,tichondrius,234,paladin,retribution,7,5,2
Malumá,ragnaros,234,paladin,retribution,11,6,5
Carneguisada,sargeras,234,paladin,retribution,10,5,5
Inarit,thrall,234,paladin,retribution,8,4,4
Westee,stormrage,234,paladin,retribution,8,4,4
Swiftysh,ragnaros,234,paladin,retribution,9,4,5
Stinkystan,korgath,234,paladin,retribution,10,4,6
Filoz,ragnaros,234,paladin,retribution,17,5,12
Sølaire,stormrage,234,paladin,retribution,14,4,10
Matts,sargeras,234,paladin,retribution,15,4,11
Needbuffs,ysondre,234,paladin,retribution,15,4,11
Pearlx,ragnaros,234,paladin,retribution,16,4,12
Hølydiver,rivendare,233,paladin,retribution,15,4,11
Píkachü,azralon,224,paladin,retribution,10,3,7
Livalil,chogall,224,paladin,retribution,16,3,13
Wabukis,illidan,223,paladin,retribution,8,3,5
Tydrialin,tichondrius,223,paladin,retribution,8,3,5
Lhury,quelthalas,223,paladin,retribution,8,3,5
Argonis,shadowsong,223,paladin,retribution,8,3,5
Ráky,quelthalas,223,paladin,retribution,14,3,11
Diotiz,area-52,208,paladin,retribution,11,4,7
Moistsaiyan,blood-furnace,206,paladin,retribution,7,3,4
Mjman,tichondrius,192,paladin,retribution,4,3,1
Undrgrndman,dalaran,192,paladin,retribution,4,3,1
Powerassasin,tichondrius,192,paladin,retribution,4,3,1
Biggbraiin,drakkari,192,paladin,retribution,4,3,1
Zhspeilian,tichondrius,192,paladin,retribution,11,4,7
Anonymvs,eredar,192,paladin,retribution,9,3,6
Crijr,ragnaros,192,paladin,retribution,6,2,4
Angelscrÿ,stormrage,192,paladin,retribution,6,2,4
Trenbolóne,area-52,192,paladin,retribution,6,2,4
Spyglas,quelthalas,192,paladin,retribution,6,2,4
Nicerice,dalaran,192,paladin,retribution,6,2,4
Virisanctii,stormrage,192,paladin,retribution,6,2,4
Angeluzlk,quelthalas,192,paladin,retribution,6,2,4
Lightkillerx,thrall,192,paladin,retribution,6,2,4
Starski,korgath,192,paladin,retribution,6,2,4
Trê,sargeras,192,paladin,retribution,6,2,4
Fallan,khaz-modan,192,paladin,retribution,6,2,4
Trøn,kalecgos,192,paladin,retribution,6,2,4
Stépz,frostmourne,192,paladin,retribution,6,2,4
Mexipaladin,thrall,192,paladin,retribution,6,2,4
Rochet,kiljaeden,192,paladin,retribution,6,2,4
Insidous,galakrond,192,paladin,retribution,6,2,4
Halot,skullcrusher,192,paladin,retribution,6,2,4
Crnoshock,area-52,192,paladin,retribution,6,2,4
Jazzmatic,dalaran,192,paladin,retribution,6,2,4
Outofholy,stormrage,192,paladin,retribution,6,2,4
Cowlomus,ragnaros,192,paladin,retribution,6,2,4
Moohulk,ragnaros,192,paladin,retribution,6,2,4
Heartsend,nerzhul,192,paladin,retribution,6,2,4
Repèntance,stormrage,192,paladin,retribution,6,2,4
Mosés,area-52,192,paladin,retribution,6,2,4
Gîmply,proudmoore,192,paladin,retribution,6,2,4
Alphönsë,quelthalas,192,paladin,retribution,6,2,4
Cloudx,shattered-hand,192,paladin,retribution,6,2,4
Calmpressure,tichondrius,192,paladin,retribution,6,2,4
Amarexp,stormrage,192,paladin,retribution,6,2,4
Metalsword,tichondrius,192,paladin,retribution,6,2,4
Shanehere,thrall,192,paladin,retribution,6,2,4
Xenophanes,dalaran,192,paladin,retribution,6,2,4
Spanx,blackwing-lair,192,paladin,retribution,6,2,4
Eull,skullcrusher,192,paladin,retribution,6,2,4
Holymight,gurubashi,192,paladin,retribution,6,2,4
Blackbeerd,stormrage,192,paladin,retribution,6,2,4
Pállymán,proudmoore,192,paladin,retribution,6,2,4
Disastroùs,frostmourne,192,paladin,retribution,6,2,4
Sleepynug,proudmoore,192,paladin,retribution,6,2,4
Zenix,tanaris,192,paladin,retribution,6,2,4
Blastoise,drakkari,192,paladin,retribution,6,2,4
Minereth,quelthalas,192,paladin,retribution,6,2,4
Dwarfpaladin,dragonmaw,192,paladin,retribution,6,2,4
Greatblade,barthilas,192,paladin,retribution,6,2,4
Hulc,ysera,192,paladin,retribution,6,2,4
Tomackin,quelthalas,192,paladin,retribution,6,2,4
Dorados,gallywix,192,paladin,retribution,6,2,4
Desterro,quelthalas,192,paladin,retribution,6,2,4
Gasunits,stormrage,192,paladin,retribution,6,2,4
Kêy,the-venture-co,192,paladin,retribution,6,2,4
Roity,proudmoore,192,paladin,retribution,6,2,4
Soundscape,proudmoore,192,paladin,retribution,6,2,4
Tyrfall,akama,192,paladin,retribution,6,2,4
Loocille,frostmourne,192,paladin,retribution,6,2,4
Islain,smolderthorn,192,paladin,retribution,6,2,4
Shaqueefah,illidan,192,paladin,retribution,6,2,4
Whataio,tichondrius,192,paladin,retribution,6,2,4
Litjoint,hyjal,192,paladin,retribution,6,2,4
Mendes,stormrage,192,paladin,retribution,6,2,4
Ekhia,ragnaros,192,paladin,retribution,6,2,4
Rây,stormrage,192,paladin,retribution,6,2,4
Issac,tichondrius,192,paladin,retribution,6,2,4
Haznthley,proudmoore,192,paladin,retribution,6,2,4
Palix,bonechewer,192,paladin,retribution,6,2,4
Holywafu,tichondrius,192,paladin,retribution,6,2,4
Exalter,malganis,192,paladin,retribution,6,2,4
Eyecandý,tichondrius,192,paladin,retribution,6,2,4
Legionret,thrall,192,paladin,retribution,6,2,4
Crânkz,blackrock,192,paladin,retribution,6,2,4
Avengzeus,tichondrius,192,paladin,retribution,6,2,4
Whyurunning,area-52,192,paladin,retribution,6,2,4
Ordinary,greymane,192,paladin,retribution,6,2,4
Holypoizan,tichondrius,192,paladin,retribution,6,2,4
Zenarus,stormrage,192,paladin,retribution,6,2,4
Lilpally,frostmourne,192,paladin,retribution,6,2,4
Pelegroot,azralon,192,paladin,retribution,6,2,4
Ookcoo,tichondrius,192,paladin,retribution,6,2,4
Prèèd,frostmourne,192,paladin,retribution,6,2,4
Oxycleän,doomhammer,192,paladin,retribution,6,2,4
Motrîn,sargeras,192,paladin,retribution,6,2,4
Holycakes,malygos,192,paladin,retribution,6,2,4
Kåshmïr,tichondrius,192,paladin,retribution,6,2,4
Shebas,kilrogg,192,paladin,retribution,6,2,4
Bøzø,stormrage,192,paladin,retribution,6,2,4
Adavinn,azjolnerub,192,paladin,retribution,6,2,4
Omegabubble,garrosh,192,paladin,retribution,6,2,4
Martin,haomarush,192,paladin,retribution,6,2,4
Guelmin,azralon,192,paladin,retribution,6,2,4
Morcant,drakkari,192,paladin,retribution,6,2,4
Ohsoclose,bleeding-hollow,192,paladin,retribution,6,2,4
Duz,malganis,192,paladin,retribution,6,2,4
Rúdely,tichondrius,192,paladin,retribution,6,2,4
Ramises,nemesis,192,paladin,retribution,6,2,4
Hurkalzul,azralon,192,paladin,retribution,6,2,4
Dexstarr,frostmourne,192,paladin,retribution,6,2,4
Psychlight,quelthalas,192,paladin,retribution,6,2,4
Streetacus,stormrage,192,paladin,retribution,6,2,4
Ghatte,azralon,192,paladin,retribution,6,2,4
Helioos,stormrage,192,paladin,retribution,6,2,4
Abivion,stormrage,192,paladin,retribution,6,2,4
Durotar,ragnaros,192,paladin,retribution,6,2,4
Çßitching,baelgun,192,paladin,retribution,6,2,4
Wyot,tichondrius,192,paladin,retribution,6,2,4
Killmoth,illidan,192,paladin,retribution,6,2,4
Retku,tichondrius,192,paladin,retribution,6,2,4
Scoobs,bleeding-hollow,192,paladin,retribution,6,2,4
Tuama,frostmourne,192,paladin,retribution,6,2,4
Sac,sargeras,192,paladin,retribution,6,2,4
Androgeos,hyjal,192,paladin,retribution,6,2,4
Twck,hyjal,192,paladin,retribution,6,2,4
Barragañ,malganis,192,paladin,retribution,6,2,4
Airane,sargeras,192,paladin,retribution,6,2,4
Domiet,bleeding-hollow,192,paladin,retribution,6,2,4
Æyden,azgalor,192,paladin,retribution,6,2,4
Egf,illidan,192,paladin,retribution,6,2,4
Izaacckk,hakkar,192,paladin,retribution,6,2,4
Petsmacker,dalaran,192,paladin,retribution,6,2,4
Varianpally,kelthuzad,192,paladin,retribution,6,2,4
Stlgunna,tichondrius,192,paladin,retribution,6,2,4
Maviskuku,tichondrius,192,paladin,retribution,6,2,4
Achalius,queldorei,192,paladin,retribution,6,2,4
Tyberas,wyrmrest-accord,192,paladin,retribution,6,2,4
Lèo,ghostlands,192,paladin,retribution,6,2,4
Ugotburstt,arthas,192,paladin,retribution,6,2,4
Nestus,shuhalo,192,paladin,retribution,6,2,4
Dakoo,burning-blade,192,paladin,retribution,6,2,4
Citadehl,bleeding-hollow,192,paladin,retribution,6,2,4
Lightgasm,alterac-mountains,192,paladin,retribution,6,2,4
Alasper,malganis,192,paladin,retribution,6,2,4
Dimensions,spirestone,192,paladin,retribution,6,2,4
Taddedpally,tichondrius,192,paladin,retribution,6,2,4
Invïctus,dalaran,192,paladin,retribution,6,2,4
Krabbiepatty,wyrmrest-accord,192,paladin,retribution,6,2,4
Jaok,tichondrius,192,paladin,retribution,6,2,4
Gordyn,khazgoroth,192,paladin,retribution,6,2,4
Holywrecked,khazgoroth,192,paladin,retribution,6,2,4
Liht,khazgoroth,192,paladin,retribution,6,2,4
Whittia,wyrmrest-accord,192,paladin,retribution,6,2,4
Awarena,area-52,192,paladin,retribution,6,2,4
Fairbairn,tichondrius,192,paladin,retribution,6,2,4
Ddeuk,tichondrius,192,paladin,retribution,6,2,4
Johnygoodboi,khazgoroth,192,paladin,retribution,6,2,4
Pallylyfe,wyrmrest-accord,192,paladin,retribution,6,2,4
Vindified,tichondrius,192,paladin,retribution,6,2,4
Reepr,tichondrius,192,paladin,retribution,6,2,4
Hafra,zuljin,192,paladin,retribution,6,2,4
Piousgecko,illidan,192,paladin,retribution,6,2,4
Felourian,malganis,192,paladin,retribution,6,2,4
Xoppo,tichondrius,192,paladin,retribution,6,2,4
Yamn,tichondrius,192,paladin,retribution,6,2,4
Bërzerk,zuluhed,192,paladin,retribution,6,2,4
Stlthykilla,cenarion-circle,192,paladin,retribution,6,2,4
Byonsay,zuljin,192,paladin,retribution,6,2,4
Ret,onyxia,192,paladin,retribution,6,2,4
Moshio,nagrand,192,paladin,retribution,6,2,4
Galdraxis,dalaran,192,paladin,retribution,6,2,4
Blessinofsac,nagrand,192,paladin,retribution,6,2,4
Ogretchair,zuljin,192,paladin,retribution,6,2,4
Zoeyxo,tichondrius,192,paladin,retribution,6,2,4
Bharan,dalaran,192,paladin,retribution,6,2,4
Hogù,tichondrius,192,paladin,retribution,6,2,4
Smolbeef,tichondrius,192,paladin,retribution,6,2,4
Kolten,kelthuzad,192,paladin,retribution,6,2,4
Granada,kirin-tor,192,paladin,retribution,6,2,4
Cyliex,illidan,192,paladin,retribution,6,2,4
Runterran,illidan,192,paladin,retribution,6,2,4
Ríf,sargeras,192,paladin,retribution,6,2,4
Extramustard,frostmourne,192,paladin,retribution,6,2,4
Tysads,darkspear,192,paladin,retribution,6,2,4
Buri,tichondrius,192,paladin,retribution,6,2,4
Thorrh,malganis,192,paladin,retribution,6,2,4
Machoo,laughing-skull,192,paladin,retribution,6,2,4
Rite,azralon,192,paladin,retribution,6,2,4
Líghts,caelestrasz,192,paladin,retribution,6,2,4
Tormentoxd,azralon,192,paladin,retribution,6,2,4
Felkor,caelestrasz,192,paladin,retribution,6,2,4
Homiepaldino,nordrassil,192,paladin,retribution,6,2,4
Schooiez,tichondrius,192,paladin,retribution,6,2,4
Tôhru,ragnaros,192,paladin,retribution,6,2,4
Brucitenjr,illidan,192,paladin,retribution,6,2,4
Carmelito,hakkar,192,paladin,retribution,6,2,4
Stöny,illidan,192,paladin,retribution,6,2,4
Noscajj,tichondrius,192,paladin,retribution,6,2,4
Verzuhazadon,tichondrius,192,paladin,retribution,6,2,4
Diänë,ragnaros,192,paladin,retribution,6,2,4
Forprophet,blackrock,192,paladin,retribution,6,2,4
Ladner,tichondrius,192,paladin,retribution,6,2,4
Ryuuku,gilneas,192,paladin,retribution,6,2,4
Retikulous,tichondrius,192,paladin,retribution,6,2,4
Sigurd,khadgar,192,paladin,retribution,6,2,4
Cudiskush,tichondrius,192,paladin,retribution,6,2,4
Malakk,zuljin,192,paladin,retribution,6,2,4
Rheddbull,bonechewer,192,paladin,retribution,6,2,4
Retro,magtheridon,192,paladin,retribution,6,2,4
Kigz,illidan,192,paladin,retribution,6,2,4
Madnhairy,zuljin,192,paladin,retribution,6,2,4
Twatiegodx,malganis,192,paladin,retribution,6,2,4
Juiicebox,darrowmere,192,paladin,retribution,6,2,4
Detk,darrowmere,192,paladin,retribution,6,2,4
Quessillo,ragnaros,192,paladin,retribution,6,2,4
Paladam,burning-blade,192,paladin,retribution,6,2,4
Armasexodus,barthilas,192,paladin,retribution,6,2,4
Thejokermp,kelthuzad,192,paladin,retribution,6,2,4
Voro,barthilas,192,paladin,retribution,6,2,4
Azúlá,garona,192,paladin,retribution,6,2,4
Juggerat,barthilas,192,paladin,retribution,6,2,4
Rekos,zuljin,192,paladin,retribution,6,2,4
Honeydews,zuljin,192,paladin,retribution,6,2,4
Majinpal,illidan,192,paladin,retribution,6,2,4
Daddykronz,magtheridon,192,paladin,retribution,6,2,4
Sweettartts,zuljin,192,paladin,retribution,6,2,4
Realbad,lightbringer,192,paladin,retribution,6,2,4
Crosjudge,zuljin,192,paladin,retribution,6,2,4
Yoúngdolph,elune,192,paladin,retribution,6,2,4
Ðuel,area-52,192,paladin,retribution,6,2,4
Theodden,tichondrius,192,paladin,retribution,6,2,4
Mazexd,illidan,192,paladin,retribution,6,2,4
Oroth,ragnaros,192,paladin,retribution,6,2,4
Révolution,barthilas,192,paladin,retribution,6,2,4
Juanvaldez,muradin,192,paladin,retribution,6,2,4
Pushabuton,illidan,192,paladin,retribution,6,2,4
Palåth,barthilas,192,paladin,retribution,6,2,4
Freslys,zuljin,192,paladin,retribution,6,2,4
Yeshayah,dalaran,192,paladin,retribution,6,2,4
Dritan,lightbringer,192,paladin,retribution,6,2,4
Retbullvodka,tichondrius,192,paladin,retribution,6,2,4
Vengx,sargeras,192,paladin,retribution,6,2,4
Ohthatguy,sargeras,192,paladin,retribution,6,2,4
Míguelito,sargeras,192,paladin,retribution,6,2,4
Bigdret,moon-guard,192,paladin,retribution,6,2,4
Holysmokz,emerald-dream,192,paladin,retribution,6,2,4
Luke,moon-guard,192,paladin,retribution,6,2,4
Titamn,area-52,192,paladin,retribution,6,2,4
Brizdiz,area-52,192,paladin,retribution,6,2,4
Toto,sargeras,192,paladin,retribution,6,2,4
Brand,emerald-dream,192,paladin,retribution,6,2,4
Crimsonjudge,sargeras,192,paladin,retribution,6,2,4
Pallycow,kargath,192,paladin,retribution,6,2,4
Alexandros,the-underbog,192,paladin,retribution,6,2,4
Drintense,area-52,192,paladin,retribution,6,2,4
Logust,area-52,192,paladin,retribution,6,2,4
Caeson,moon-guard,192,paladin,retribution,6,2,4
Réalg,area-52,192,paladin,retribution,6,2,4
Sinsy,moon-guard,192,paladin,retribution,6,2,4
Astrøworld,sargeras,192,paladin,retribution,6,2,4
Axelx,sargeras,192,paladin,retribution,6,2,4
Bradybub,sargeras,192,paladin,retribution,6,2,4
Aleio,moon-guard,192,paladin,retribution,6,2,4
Atan,emerald-dream,192,paladin,retribution,6,2,4
Neydisa,sargeras,192,paladin,retribution,6,2,4
Roseheart,emerald-dream,192,paladin,retribution,6,2,4
Nëø,moon-guard,192,paladin,retribution,6,2,4
Dayim,moon-guard,192,paladin,retribution,6,2,4
Gangsta,silvermoon,192,paladin,retribution,6,2,4
Dynastyhero,area-52,192,paladin,retribution,6,2,4
Thaidron,area-52,192,paladin,retribution,6,2,4
Zeliq,silvermoon,192,paladin,retribution,6,2,4
Honeyduw,moon-guard,192,paladin,retribution,6,2,4
Nyc,sargeras,192,paladin,retribution,6,2,4
Holypumper,moon-guard,192,paladin,retribution,6,2,4
Gredel,sargeras,192,paladin,retribution,6,2,4
Strîkes,emerald-dream,192,paladin,retribution,6,2,4
Guacamello,emerald-dream,192,paladin,retribution,6,2,4
Lumpypotatos,aegwynn,192,paladin,retribution,10,3,7
Pòßà,malganis,192,paladin,retribution,7,2,5
Jessecash,tichondrius,192,paladin,retribution,12,3,9
Murgly,tichondrius,192,paladin,retribution,8,2,6
Raylewis,ghostlands,192,paladin,retribution,9,2,7
Orellios,moon-guard,192,paladin,retribution,9,2,7
Misease,illidan,192,paladin,retribution,9,2,7
Thormonger,dalaran,192,paladin,retribution,14,3,11
Alberich,tichondrius,192,paladin,retribution,11,2,9
Flexedonyou,sentinels,192,paladin,retribution,12,2,10
Terppy,stormrage,192,paladin,retribution,12,2,10
Cabacarl,quelthalas,192,paladin,retribution,12,2,10
Slithix,stormreaver,192,paladin,retribution,12,2,10
Jarvin,kiljaeden,192,paladin,retribution,12,2,10
Rayli,dalaran,192,paladin,retribution,12,2,10
Simbelmyne,thrall,192,paladin,retribution,12,2,10
Fazoéli,stormrage,192,paladin,retribution,12,2,10
Kaiyleigh,sargeras,192,paladin,retribution,12,2,10
Nygardian,sargeras,192,paladin,retribution,12,2,10
Elarilein,emerald-dream,192,paladin,retribution,12,2,10
Léa,illidan,192,paladin,retribution,12,2,10
Dánteé,ragnaros,192,paladin,retribution,12,2,10
Octí,quelthalas,192,paladin,retribution,12,2,10
Kheltas,area-52,192,paladin,retribution,12,2,10
Goldfaith,sargeras,192,paladin,retribution,12,2,10
Calferx,area-52,192,paladin,retribution,12,2,10
Criixx,malganis,192,paladin,retribution,12,2,10
Lamer,proudmoore,192,paladin,retribution,12,2,10
Rîf,malganis,192,paladin,retribution,12,2,10
Seratox,illidan,192,paladin,retribution,12,2,10
Clrty,area-52,192,paladin,retribution,12,2,10
Ghratadin,bleeding-hollow,192,paladin,retribution,12,2,10
Holyelfs,boulderfist,192,paladin,retribution,12,2,10
Arminhamer,sargeras,192,paladin,retribution,12,2,10
Sleepybiden,darkspear,192,paladin,retribution,12,2,10
Hurlnix,stormscale,192,paladin,retribution,12,2,10
Kedubb,stormrage,192,paladin,retribution,12,2,10
Phawkes,eredar,192,paladin,retribution,12,2,10
Sïncere,frostmourne,192,paladin,retribution,12,2,10
Vantz,tichondrius,192,paladin,retribution,12,2,10
Goomie,icecrown,192,paladin,retribution,12,2,10
Ricopal,frostmourne,192,paladin,retribution,12,2,10
Cronodxl,quelthalas,192,paladin,retribution,12,2,10
Holyshifts,exodar,192,paladin,retribution,12,2,10
Krístem,stormrage,192,paladin,retribution,12,2,10
Grimsfate,emerald-dream,192,paladin,retribution,12,2,10
Vamplyy,kelthuzad,192,paladin,retribution,12,2,10
Yawnday,farstriders,192,paladin,retribution,12,2,10
Killerspally,area-52,192,paladin,retribution,12,2,10
Jachug,tichondrius,192,paladin,retribution,12,2,10
Gilfan,proudmoore,192,paladin,retribution,12,2,10
Ðáddý,zuljin,192,paladin,retribution,12,2,10
Alyosya,barthilas,192,paladin,retribution,12,2,10
Renorhal,moon-guard,192,paladin,retribution,12,2,10
Bubzfordubz,sargeras,192,paladin,retribution,12,2,10
Spîke,sargeras,192,paladin,retribution,12,2,10
Anahl,icecrown,192,paladin,retribution,12,2,10
Seltzer,tichondrius,192,paladin,retribution,12,2,10
Zatoci,shadowsong,192,paladin,retribution,17,2,15
Runandhide,aerie-peak,192,paladin,retribution,18,2,16
Dorisseline,emerald-dream,192,paladin,retribution,18,2,16
Oldmanmark,jubeithos,191,paladin,retribution,6,2,4
Túss,khazgoroth,191,paladin,retribution,6,2,4
Dkpally,doomhammer,191,paladin,retribution,6,2,4
Lahila,area-52,191,paladin,retribution,6,2,4
Larlanos,bloodhoof,190,paladin,retribution,12,2,10
Jaidun,stormrage,190,paladin,retribution,12,2,10
Thugmuffin,thrall,176,paladin,retribution,7,3,4
Wokeinator,malganis,175,paladin,retribution,11,3,8
Baalduru,borean-tundra,175,paladin,retribution,11,2,9
Divinetoco,stormrage,175,paladin,retribution,11,2,9
Wellowar,moon-guard,170,paladin,retribution,11,4,7
Jnxzster,sargeras,169,paladin,retribution,11,4,7
Laysonus,moon-guard,169,paladin,retribution,11,4,7
Bubbletop,tichondrius,169,paladin,retribution,11,4,7
Oates,sargeras,159,paladin,retribution,5,2,3
Bubbledown,bleeding-hollow,159,paladin,retribution,5,2,3
Beelzebøss,frostmourne,159,paladin,retribution,5,2,3
Sorgeno,ursin,159,paladin,retribution,5,2,3
Maldayn,quelthalas,159,paladin,retribution,5,2,3
Hobbsone,trollbane,159,paladin,retribution,5,2,3
Pallydeen,illidan,159,paladin,retribution,5,2,3
Kaorii,mannoroth,159,paladin,retribution,5,2,3
Ubbhe,quelthalas,159,paladin,retribution,5,2,3
Whoopsie,dragonmaw,159,paladin,retribution,5,2,3
Seasondbeef,shandris,159,paladin,retribution,5,2,3
Perallta,tichondrius,144,paladin,retribution,3,3,0
Whiplashlol,frostwolf,144,paladin,retribution,3,3,0
Holeesheett,tichondrius,144,paladin,retribution,9,2,7
Chancéllor,stormrage,138,paladin,retribution,6,3,3
Leevii,azralon,138,paladin,retribution,11,4,7
Åddict,kelthuzad,138,paladin,retribution,10,3,7
Iæl,stormrage,138,paladin,retribution,10,3,7
Dathromir,stormrage,138,paladin,retribution,15,3,12
Bubbleosèven,tichondrius,138,paladin,retribution,16,3,13
Sweetbunz,altar-of-storms,128,paladin,retribution,4,2,2
Stârfôx,area-52,128,paladin,retribution,4,2,2
Anbor,azralon,128,paladin,retribution,4,2,2
Mikwa,ragnaros,128,paladin,retribution,4,2,2
Telaenchufo,ragnaros,128,paladin,retribution,4,2,2
Seebastian,kelthuzad,128,paladin,retribution,4,2,2
Holyjoe,area-52,128,paladin,retribution,4,2,2
Comptoncody,area-52,128,paladin,retribution,9,3,6
Khileeha,sargeras,128,paladin,retribution,10,2,8
Sofiora,thunderlord,128,paladin,retribution,10,2,8
Vishpal,malganis,112,paladin,retribution,7,2,5
Dazak,ragnaros,96,paladin,retribution,3,2,1
Shalith,thrall,96,paladin,retribution,3,2,1
Gaismagorm,ragnaros,96,paladin,retribution,3,2,1
Utho,wyrmrest-accord,96,paladin,retribution,3,2,1
Swordstrikes,tichondrius,96,paladin,retribution,3,2,1
Simple,ghostlands,96,paladin,retribution,16,3,13
Bigshaftt,gorgonnash,96,paladin,retribution,6,1,5
Brutalize,moon-guard,96,paladin,retribution,6,1,5
Tehgodofdmg,tichondrius,96,paladin,retribution,6,1,5
Flashbubble,sargeras,96,paladin,retribution,6,1,5
Ünkøwn,stormrage,96,paladin,retribution,6,1,5
Holyclapzy,stormrage,96,paladin,retribution,6,1,5
Smïthh,area-52,96,paladin,retribution,6,1,5
Balloony,stormrage,96,paladin,retribution,6,1,5
Ret,burning-legion,96,paladin,retribution,6,1,5
Djset,blackhand,96,paladin,retribution,6,1,5
Vicentez,area-52,96,paladin,retribution,6,1,5
Fydepala,stormrage,96,paladin,retribution,6,1,5
Palajem,stormrage,96,paladin,retribution,6,1,5
Dafoq,stormrage,96,paladin,retribution,6,1,5
Respiratoryy,kelthuzad,96,paladin,retribution,6,1,5
Orthín,stormrage,96,paladin,retribution,6,1,5
Brank,agamaggan,96,paladin,retribution,6,1,5
Ashlane,tichondrius,96,paladin,retribution,6,1,5
Duecesz,area-52,96,paladin,retribution,6,1,5
Yøu,tichondrius,96,paladin,retribution,6,1,5
Thòrisòn,stormrage,96,paladin,retribution,6,1,5
Cupidxbye,tichondrius,96,paladin,retribution,6,1,5
Ahrieze,moon-guard,96,paladin,retribution,6,1,5
Sanddor,moon-guard,96,paladin,retribution,6,1,5
Mîrrors,barthilas,96,paladin,retribution,6,1,5
Acpally,tichondrius,96,paladin,retribution,6,1,5
Coltoniac,kaelthas,96,paladin,retribution,6,1,5
Valadinn,tichondrius,96,paladin,retribution,6,1,5
Raams,moon-guard,96,paladin,retribution,6,1,5
Checkmater,malganis,96,paladin,retribution,6,1,5
Franchy,stormrage,96,paladin,retribution,6,1,5
Chuggawhugga,area-52,96,paladin,retribution,6,1,5
Dûälïpä,barthilas,96,paladin,retribution,6,1,5
Sleyn,stormrage,96,paladin,retribution,6,1,5
Zulzander,kelthuzad,96,paladin,retribution,6,1,5
Scuffedhoj,tichondrius,96,paladin,retribution,6,1,5
Jüstice,tichondrius,96,paladin,retribution,6,1,5
Chootoy,tichondrius,96,paladin,retribution,6,1,5
Bromango,emerald-dream,96,paladin,retribution,6,1,5
Yesdaddyxo,emerald-dream,96,paladin,retribution,6,1,5
Englishdude,tichondrius,96,paladin,retribution,6,1,5
Grimsical,kelthuzad,96,paladin,retribution,6,1,5
Revendreth,caelestrasz,96,paladin,retribution,6,1,5
Gdesign,tichondrius,96,paladin,retribution,6,1,5
Dìlf,zuljin,96,paladin,retribution,6,1,5
Turahk,amanthul,96,paladin,retribution,6,1,5
Kuribohs,tichondrius,96,paladin,retribution,6,1,5
Lythos,dathremar,96,paladin,retribution,6,1,5
Bigdampally,tichondrius,96,paladin,retribution,6,1,5
Bosmoklikdat,moon-guard,96,paladin,retribution,6,1,5
Poeboyz,stormrage,96,paladin,retribution,6,1,5
Prahv,shuhalo,96,paladin,retribution,6,1,5
Nytto,lightnings-blade,96,paladin,retribution,6,1,5
Pipesmoke,dunemaul,96,paladin,retribution,6,1,5
Tyrannos,tichondrius,96,paladin,retribution,6,1,5
Pùteduvilage,zuljin,96,paladin,retribution,6,1,5
Erindor,emerald-dream,96,paladin,retribution,6,1,5
Thumos,sargeras,96,paladin,retribution,6,1,5
Warrenke,area-52,96,paladin,retribution,6,1,5
Tehbeasty,hyjal,96,paladin,retribution,6,1,5
Rodrigo,frostmourne,96,paladin,retribution,6,1,5
Donoph,blades-edge,96,paladin,retribution,6,1,5
Mentalíssues,moon-guard,96,paladin,retribution,6,1,5
Bruwdblood,bleeding-hollow,96,paladin,retribution,6,1,5
Scyfher,stormrage,96,paladin,retribution,6,1,5
Warhero,sargeras,96,paladin,retribution,6,1,5
Murzo,hyjal,96,paladin,retribution,6,1,5
Slayalot,icecrown,96,paladin,retribution,6,1,5
Retsarro,frostmourne,96,paladin,retribution,6,1,5
Odos,zuljin,96,paladin,retribution,6,1,5
Judgémental,bleeding-hollow,96,paladin,retribution,6,1,5
Sneakycastro,bleeding-hollow,96,paladin,retribution,6,1,5
Maldobarr,stormrage,96,paladin,retribution,6,1,5
Palium,stormrage,96,paladin,retribution,6,1,5
Chakin,burning-legion,96,paladin,retribution,6,1,5
Zwilliam,frostmourne,96,paladin,retribution,6,1,5
Retrib,tichondrius,96,paladin,retribution,6,1,5
Salennai,daggerspine,96,paladin,retribution,6,1,5
Vatherollin,proudmoore,96,paladin,retribution,6,1,5
Febimus,magtheridon,96,paladin,retribution,6,1,5
Lòuisvuttion,tichondrius,96,paladin,retribution,6,1,5
Astolan,runetotem,96,paladin,retribution,6,1,5
Daelann,moon-guard,96,paladin,retribution,6,1,5
Gressilin,arthas,96,paladin,retribution,6,1,5
Këys,earthen-ring,96,paladin,retribution,6,1,5
Gazef,proudmoore,96,paladin,retribution,6,1,5
Retx,arthas,96,paladin,retribution,6,1,5
Cyona,gallywix,96,paladin,retribution,6,1,5
Luiiguii,drakkari,96,paladin,retribution,6,1,5
Ryudoshël,nemesis,96,paladin,retribution,6,1,5
Kytheon,zuluhed,96,paladin,retribution,6,1,5
Carloss,drakkari,96,paladin,retribution,6,1,5
Madtrollaids,kiljaeden,96,paladin,retribution,6,1,5
Parts,aerie-peak,96,paladin,retribution,6,1,5
Rodt,dalaran,96,paladin,retribution,6,1,5
Tooshka,azshara,96,paladin,retribution,6,1,5
Meanervini,kiljaeden,96,paladin,retribution,6,1,5
Deviill,winterhoof,96,paladin,retribution,6,1,5
Scrubdin,illidan,96,paladin,retribution,6,1,5
Beebopper,illidan,96,paladin,retribution,6,1,5
Ariolo,baelgun,96,paladin,retribution,6,1,5
Aldwyn,deathwing,96,paladin,retribution,6,1,5
Isskandar,moon-guard,96,paladin,retribution,6,1,5
Krylaa,madoran,96,paladin,retribution,6,1,5
Krelya,ragnaros,96,paladin,retribution,6,1,5
Lightmessiah,perenolde,96,paladin,retribution,6,1,5
Aragonns,illidan,96,paladin,retribution,6,1,5
Shamashjoel,black-dragonflight,96,paladin,retribution,6,1,5
Chainjustice,area-52,96,paladin,retribution,6,1,5
Slantee,illidan,96,paladin,retribution,6,1,5
Tradalia,illidan,96,paladin,retribution,6,1,5
Justtrollin,black-dragonflight,96,paladin,retribution,6,1,5
Repsforjêsus,hydraxis,96,paladin,retribution,6,1,5
Rg,nerzhul,96,paladin,retribution,6,1,5
Killerofmind,azralon,96,paladin,retribution,6,1,5
Marcovk,quelthalas,96,paladin,retribution,6,1,5
Conámi,ragnaros,96,paladin,retribution,6,1,5
Adjudicator,shuhalo,96,paladin,retribution,6,1,5
Goksuu,ragnaros,96,paladin,retribution,6,1,5
Tharok,spirestone,96,paladin,retribution,6,1,5
Latchpaladin,sargeras,96,paladin,retribution,6,1,5
Jeeb,blackrock,96,paladin,retribution,6,1,5
Riçky,tichondrius,96,paladin,retribution,6,1,5
Talahar,boulderfist,96,paladin,retribution,6,1,5
Ssjgodvy,illidan,96,paladin,retribution,6,1,5
Röniin,ragnaros,96,paladin,retribution,6,1,5
Daivdsonbr,azralon,96,paladin,retribution,6,1,5
Chapichapi,illidan,96,paladin,retribution,6,1,5
Wakethelight,illidan,96,paladin,retribution,6,1,5
Maeyz,sargeras,96,paladin,retribution,6,1,5
Giita,quelthalas,96,paladin,retribution,6,1,5
Freyrr,azralon,96,paladin,retribution,6,1,5
Topsid,sargeras,96,paladin,retribution,6,1,5
Kroman,quelthalas,96,paladin,retribution,6,1,5
Liongolden,azralon,96,paladin,retribution,6,1,5
Chøcølatte,azralon,96,paladin,retribution,6,1,5
Brynleigh,malganis,96,paladin,retribution,6,1,5
Zpaladino,azralon,96,paladin,retribution,6,1,5
Skadooshh,illidan,96,paladin,retribution,6,1,5
Energizzed,azralon,96,paladin,retribution,6,1,5
Holyxsmokes,illidan,96,paladin,retribution,6,1,5
Scah,illidan,96,paladin,retribution,6,1,5
Wrongnumber,blackrock,96,paladin,retribution,6,1,5
Angusbeef,hyjal,96,paladin,retribution,6,1,5
Nvrbubble,area-52,96,paladin,retribution,6,1,5
Scarllye,illidan,96,paladin,retribution,6,1,5
Skeeta,area-52,96,paladin,retribution,6,1,5
Boundric,emerald-dream,96,paladin,retribution,6,1,5
Zko,frostmourne,96,paladin,retribution,6,1,5
Shortj,malganis,96,paladin,retribution,6,1,5
Urudith,azralon,96,paladin,retribution,6,1,5
Mastadin,illidan,96,paladin,retribution,6,1,5
Bubbllicious,thrall,96,paladin,retribution,6,1,5
Teupaiécornu,azralon,96,paladin,retribution,6,1,5
Ding,wyrmrest-accord,96,paladin,retribution,6,1,5
Partenna,quelthalas,96,paladin,retribution,6,1,5
Alk,windrunner,96,paladin,retribution,6,1,5
Cots,azralon,96,paladin,retribution,6,1,5
Adobro,tichondrius,96,paladin,retribution,6,1,5
Kamael,darrowmere,96,paladin,retribution,6,1,5
Krulu,thrall,96,paladin,retribution,6,1,5
Hungheracles,thrall,96,paladin,retribution,6,1,5
Fourwives,sargeras,96,paladin,retribution,6,1,5
Coffeebean,quelthalas,96,paladin,retribution,6,1,5
Chawbanger,proudmoore,96,paladin,retribution,6,1,5
Akirahikarri,frostwolf,96,paladin,retribution,6,1,5
Samsaratry,proudmoore,96,paladin,retribution,6,1,5
Palagwen,emerald-dream,96,paladin,retribution,6,1,5
Kírí,quelthalas,96,paladin,retribution,6,1,5
Lakinipally,lightbringer,96,paladin,retribution,6,1,5
Àurorâ,tichondrius,96,paladin,retribution,6,1,5
Kamakazê,sargeras,96,paladin,retribution,6,1,5
Måtrix,sargeras,96,paladin,retribution,6,1,5
Asheryte,sargeras,96,paladin,retribution,6,1,5
Bravsirrobin,firetree,96,paladin,retribution,6,1,5
Thorgard,antonidas,96,paladin,retribution,6,1,5
Trinkysteve,frostmane,96,paladin,retribution,7,1,6
Lelythia,bleeding-hollow,96,paladin,retribution,7,1,6
Cherix,thrall,96,paladin,retribution,9,1,8
Whosyourdady,azjolnerub,96,paladin,retribution,12,1,11
Roosterface,azjolnerub,96,paladin,retribution,12,1,11
Kënsi,quelthalas,96,paladin,retribution,12,1,11
Reinhardburm,quelthalas,96,paladin,retribution,12,1,11
Zalacar,azralon,96,paladin,retribution,12,1,11
Oshia,destromath,96,paladin,retribution,12,1,11
Retski,thrall,96,paladin,retribution,12,1,11
Miniminx,malganis,96,paladin,retribution,12,1,11
Siglud,tichondrius,96,paladin,retribution,12,1,11
Hojpocketx,tichondrius,96,paladin,retribution,12,1,11
Catholica,tichondrius,96,paladin,retribution,12,1,11
Séykän,ragnaros,96,paladin,retribution,12,1,11
Æpaldin,tichondrius,96,paladin,retribution,12,1,11
Hondacivicsi,mannoroth,96,paladin,retribution,12,1,11
Bregalad,bleeding-hollow,96,paladin,retribution,12,1,11
Imbackk,quelthalas,96,paladin,retribution,12,1,11
Yobnai,zuljin,96,paladin,retribution,12,1,11
Yoropal,tichondrius,96,paladin,retribution,12,1,11
Axiskai,gorgonnash,96,paladin,retribution,12,1,11
Lorenzojr,sargeras,96,paladin,retribution,12,1,11
Rimorse,illidan,96,paladin,retribution,12,1,11
Geykum,tichondrius,96,paladin,retribution,17,1,16
Orendis,illidan,95,paladin,retribution,12,1,11
Hottest,wyrmrest-accord,84,paladin,retribution,13,5,8
Wainkywink,malganis,84,paladin,retribution,19,4,15
Laydarus,frostmourne,79,paladin,retribution,5,1,4
Ryxxi,sargeras,79,paladin,retribution,5,1,4
Goldieg,tichondrius,79,paladin,retribution,5,1,4
Bowdown,wildhammer,79,paladin,retribution,5,1,4
Sprjustice,frostmourne,79,paladin,retribution,6,1,5
Hivers,stormrage,79,paladin,retribution,11,1,10
Dronedròp,illidan,63,paladin,retribution,2,2,0
Belenor,quelthalas,63,paladin,retribution,2,2,0
Corvious,tichondrius,63,paladin,retribution,2,2,0
Crayonpal,tichondrius,63,paladin,retribution,2,2,0
Piston,kiljaeden,63,paladin,retribution,2,2,0
Kroneckerr,ragnaros,48,paladin,retribution,8,3,5
Tryvor,stormrage,48,paladin,retribution,3,1,2
Cïelo,dragonmaw,42,paladin,retribution,6,2,4
Dabakle,stormrage,42,paladin,retribution,8,2,6
Thisissus,tichondrius,42,paladin,retribution,8,2,6
Voncruz,proudmoore,42,paladin,retribution,12,2,10
Tydirion,burning-legion,31,paladin,retribution,2,1,1
Patrious,moon-guard,31,paladin,retribution,2,1,1
Øgre,illidan,31,paladin,retribution,2,1,1
Tanneth,zuljin,31,paladin,retribution,2,1,1
Gorila,stormrage,31,paladin,retribution,2,1,1
Salx,tichondrius,31,paladin,retribution,8,1,7
Retributión,darkspear,16,paladin,retribution,1,1,0
Brinxy,ragnaros,16,paladin,retribution,1,1,0
Warumbruder,stormrage,16,paladin,retribution,1,1,0
Bluether,sargeras,16,paladin,retribution,1,1,0
Cóisy,frostmourne,16,paladin,retribution,1,1,0
ßleider,quelthalas,1906,paladin,protection,55,39,16
Ëlmaster,nemesis,1831,paladin,protection,126,80,46
Degenratebri,moon-guard,1753,paladin,protection,63,44,19
Aluvia,malygos,1741,paladin,protection,70,50,20
Zhspeilian,tichondrius,1730,paladin,protection,84,47,37
Höpönpöppö,frostmourne,1729,paladin,protection,48,26,22
Kierolechita,ragnaros,1721,paladin,protection,262,135,127
Sigmapepe,quelthalas,1718,paladin,protection,120,83,37
Crâfty,bleeding-hollow,1717,paladin,protection,113,65,48
Motates,malganis,1706,paladin,protection,93,48,45
Wilder,turalyon,1676,paladin,protection,47,27,20
Dankerton,tichondrius,1670,paladin,protection,38,20,18
Jimmipepe,quelthalas,1668,paladin,protection,164,107,57
Sutadansa,doomhammer,1666,paladin,protection,158,79,79
Zealna,tichondrius,1663,paladin,protection,35,24,11
Eclipsor,bleeding-hollow,1657,paladin,protection,48,30,18
Vondonna,moon-guard,1655,paladin,protection,113,65,48
Sôlux,quelthalas,1638,paladin,protection,56,31,25
Lxwd,tichondrius,1636,paladin,protection,131,66,65
Uglyboyryan,sargeras,1632,paladin,protection,102,57,45
Zephyrvalor,sargeras,1628,paladin,protection,158,77,81
Poppadock,veknilash,1613,paladin,protection,74,44,30
Bighardshock,aggramar,1589,paladin,protection,42,23,19
Blackmiya,tichondrius,1570,paladin,protection,31,20,11
Øziris,goldrinn,1567,paladin,protection,74,33,41
Cusino,tichondrius,1560,paladin,protection,56,34,22
Rehtua,bleeding-hollow,1557,paladin,protection,83,35,48
Wowmike,sargeras,1518,paladin,protection,126,66,60
Demloc,doomhammer,1496,paladin,protection,48,21,27
Chozverialyz,ysondre,1494,paladin,protection,68,32,36
Tooholy,kiljaeden,1486,paladin,protection,41,22,19
Borrus,malygos,1480,paladin,protection,48,28,20
Aeythyr,wyrmrest-accord,1469,paladin,protection,84,38,46
Terayus,veknilash,1464,paladin,protection,30,18,12
Zexion,azralon,1450,paladin,protection,45,19,26
Alekvin,moon-guard,1442,paladin,protection,36,19,17
Íaan,drakkari,1433,paladin,protection,70,43,27
Taillien,bonechewer,1415,paladin,protection,70,41,29
Whëëls,stormreaver,1411,paladin,protection,41,22,19
Arcilys,illidan,1398,paladin,protection,60,29,31
Lorec,zuljin,1395,paladin,protection,54,25,29
Modafinil,bonechewer,1390,paladin,protection,117,53,64
Domocho,azgalor,1387,paladin,protection,47,24,23
Herimi,drakkari,1379,paladin,protection,107,43,64
Bt,quelthalas,1376,paladin,protection,41,25,16
Goldjade,khazgoroth,1374,paladin,protection,119,49,70
Rakasho,azralon,1370,paladin,protection,60,23,37
Goeun,destromath,1369,paladin,protection,37,16,21
Aopidsfihjov,stormrage,1355,paladin,protection,107,55,52
Almeta,kelthuzad,1350,paladin,protection,36,18,18
Jenesis,illidan,1348,paladin,protection,30,20,10
Khrome,cenarion-circle,1346,paladin,protection,217,80,137
Stormvikingx,darkspear,1336,paladin,protection,24,14,10
Palahogx,sargeras,1333,paladin,protection,30,14,16
Fredward,bleeding-hollow,1329,paladin,protection,30,14,16
Canibaluy,ragnaros,1329,paladin,protection,40,18,22
Ronor,thorium-brotherhood,1323,paladin,protection,48,24,24
Jkethuhsnake,ghostlands,1306,paladin,protection,51,31,20
Thorsmites,sargeras,1273,paladin,protection,48,18,30
Poorly,thorium-brotherhood,1266,paladin,protection,48,24,24
Protdream,tichondrius,1245,paladin,protection,18,13,5
Xbloodknight,malganis,1243,paladin,protection,36,13,23
Lythos,dathremar,1238,paladin,protection,42,19,23
Imthabromb,dragonblight,1189,paladin,protection,41,20,21
Lelythia,bleeding-hollow,1161,paladin,protection,65,25,40
Ratzon,dalaran,1156,paladin,protection,23,14,9
Chanimalf,tichondrius,1118,paladin,protection,18,13,5
Gredo,queldorei,1070,paladin,protection,17,12,5
Zakh,proudmoore,1053,paladin,protection,18,11,7
Bronislav,draka,1053,paladin,protection,18,11,7
Penitent,barthilas,1052,paladin,protection,18,11,7
Blicka,dragonblight,1031,paladin,protection,30,11,19
Bullivan,sisters-of-elune,963,paladin,protection,40,14,26
Devonius,sargeras,959,paladin,protection,18,10,8
Bubblemark,tichondrius,959,paladin,protection,24,10,14
Strontimus,moon-guard,958,paladin,protection,12,10,2
Ndnpaly,bonechewer,953,paladin,protection,12,10,2
Danthorin,malfurion,940,paladin,protection,44,10,34
Matadore,arygos,908,paladin,protection,22,11,11
Alexcydragon,quelthalas,863,paladin,protection,18,9,9
Holybull,maiev,859,paladin,protection,18,9,9
Hittit,thrall,859,paladin,protection,30,9,21
Cherubic,sargeras,858,paladin,protection,30,9,21
Kittié,proudmoore,818,paladin,protection,38,10,28
Negativeiq,moon-guard,798,paladin,protection,10,10,0
Trâgedy,azjolnerub,768,paladin,protection,12,8,4
Courageousz,dalaran,768,paladin,protection,18,8,10
Zackthepally,area-52,768,paladin,protection,24,8,16
Crusâder,area-52,767,paladin,protection,24,8,16
Lothwrynn,senjin,762,paladin,protection,18,8,10
Dirkdigglerz,bleeding-hollow,746,paladin,protection,23,8,15
Halnoth,dethecus,702,paladin,protection,11,8,3
Buslightyear,azralon,672,paladin,protection,12,7,5
Kurokodieru,dalaran,672,paladin,protection,18,7,11
Valkaire,area-52,671,paladin,protection,12,7,5
Nobleblood,emerald-dream,669,paladin,protection,18,7,11
Trågédy,zuljin,576,paladin,protection,6,6,0
Sølis,alleria,576,paladin,protection,12,6,6
Lessera,tichondrius,576,paladin,protection,12,6,6
Paldyn,illidan,575,paladin,protection,12,6,6
Huwglyndur,trollbane,575,paladin,protection,12,6,6
Steverógers,frostmourne,480,paladin,protection,6,5,1
Kiehui,lightbringer,480,paladin,protection,12,5,7
Typhoontravv,thrall,480,paladin,protection,12,5,7
Gotankz,moon-guard,480,paladin,protection,12,5,7
Tankfest,sargeras,480,paladin,protection,12,5,7
Bullmarket,tichondrius,480,paladin,protection,18,5,13
Thulêan,moon-guard,480,paladin,protection,18,5,13
Lewstelamon,korialstrasz,446,paladin,protection,10,6,4
Thorkell,moon-guard,384,paladin,protection,6,4,2
Ibubblë,wildhammer,384,paladin,protection,6,4,2
Guidö,stormrage,384,paladin,protection,6,4,2
Holyknight,veknilash,384,paladin,protection,14,5,9
Valisari,korialstrasz,384,paladin,protection,12,4,8
Gîmply,proudmoore,384,paladin,protection,12,4,8
Zaeris,proudmoore,384,paladin,protection,12,4,8
Bullheaded,silvermoon,384,paladin,protection,12,4,8
Belmorlin,moon-guard,384,paladin,protection,12,4,8
Ilovéyou,barthilas,384,paladin,protection,12,4,8
Rikurena,bonechewer,383,paladin,protection,6,4,2
Jahirie,aegwynn,351,paladin,protection,17,4,13
Isecretly,stormrage,335,paladin,protection,7,7,0
Thortanous,icecrown,288,paladin,protection,6,3,3
Cheers,garona,288,paladin,protection,6,3,3
Drágons,stormrage,288,paladin,protection,6,3,3
Kooshh,thunderlord,288,paladin,protection,12,3,9
Irahan,stormrage,288,paladin,protection,12,3,9
Eliteyahtzee,kelthuzad,288,paladin,protection,12,3,9
Urfavxbf,baelgun,288,paladin,protection,13,3,10
Cots,azralon,271,paladin,protection,11,3,8
Saeranella,moon-guard,240,paladin,protection,9,3,6
Blâckhârt,saurfang,234,paladin,protection,9,4,5
Stompem,zuljin,192,paladin,protection,6,2,4
Immensepower,tichondrius,192,paladin,protection,6,2,4
Xinqingle,tichondrius,192,paladin,protection,6,2,4
Troxnar,ragnaros,192,paladin,protection,6,2,4
Protbeeff,area-52,192,paladin,protection,6,2,4
Zatheus,area-52,192,paladin,protection,6,2,4
Òp,illidan,192,paladin,protection,10,3,7
Zifre,ragnaros,192,paladin,protection,12,2,10
Consecrated,daggerspine,192,paladin,protection,12,2,10
Dwarvendude,sargeras,159,paladin,protection,11,2,9
Combidin,garrosh,96,paladin,protection,6,1,5
Thrandaic,frostmourne,96,paladin,protection,6,1,5
Lasonil,zuljin,96,paladin,protection,6,1,5
Holykura,thrall,96,paladin,protection,6,1,5
Qtipds,moon-guard,96,paladin,protection,6,1,5
Airane,sargeras,96,paladin,protection,6,1,5
Mtanchokeme,stormrage,96,paladin,protection,9,1,8
Chàrron,garrosh,79,paladin,protection,5,1,4
Garbagedisc,scilla,2139,priest,holy,114,56,58
Yötönyö,sargeras,2082,priest,holy,114,57,57
Priestlike,tichondrius,2010,priest,holy,127,68,59
Pianohouse,illidan,1998,priest,holy,132,70,62
Dogbutt,burning-legion,1996,priest,holy,222,111,111
Pickle,illidan,1974,priest,holy,86,49,37
Fusira,gurubashi,1941,priest,holy,48,25,23
Rustymvp,nagrand,1936,priest,holy,161,77,84
Saintjpii,tichondrius,1910,priest,holy,161,96,65
Tirrify,frostmourne,1899,priest,holy,54,29,25
Cokeheals,kelthuzad,1897,priest,holy,42,26,16
Fluent,emerald-dream,1895,priest,holy,192,91,101
Onemission,whisperwind,1889,priest,holy,72,27,45
Cinnalite,darkspear,1870,priest,holy,42,29,13
Teslashield,bleeding-hollow,1856,priest,holy,54,25,29
Ninbara,tichondrius,1851,priest,holy,102,49,53
Tookiex,stormrage,1847,priest,holy,61,29,32
Mynaevis,malganis,1845,priest,holy,78,43,35
Lilyxo,bleeding-hollow,1845,priest,holy,72,36,36
Peat,hyjal,1844,priest,holy,54,27,27
Lëønë,nemesis,1842,priest,holy,148,93,55
Superduperr,illidan,1840,priest,holy,66,33,33
Vandalia,shadowsong,1837,priest,holy,181,89,92
Gerpe,stormrage,1830,priest,holy,189,106,83
Citrinesta,illidan,1828,priest,holy,305,172,133
Mastuti,azralon,1828,priest,holy,143,70,73
Lagemela,quelthalas,1825,priest,holy,101,47,54
Hyouka,area-52,1824,priest,holy,285,151,134
Pmos,sargeras,1823,priest,holy,40,21,19
Nickydamous,moon-guard,1817,priest,holy,66,38,28
Meatboxmoldy,blood-furnace,1817,priest,holy,82,41,41
Iniquitatem,tichondrius,1817,priest,holy,60,23,37
Tromnasty,area-52,1816,priest,holy,90,53,37
Whitetails,illidan,1816,priest,holy,54,31,23
Rootandboot,frostmourne,1815,priest,holy,49,29,20
Onikûdaki,sargeras,1814,priest,holy,86,37,49
Whalexo,kelthuzad,1813,priest,holy,261,127,134
Sweatynick,proudmoore,1813,priest,holy,227,109,118
Immthuggin,tichondrius,1813,priest,holy,120,53,67
Scyner,bleeding-hollow,1811,priest,holy,152,87,65
Dmgisop,illidan,1811,priest,holy,141,80,61
Clarifytwo,arathor,1809,priest,holy,48,29,19
Qnzo,tichondrius,1806,priest,holy,60,39,21
Pipelayerx,illidan,1804,priest,holy,50,25,25
Murkd,tichondrius,1804,priest,holy,145,68,77
Dreckie,sargeras,1801,priest,holy,207,105,102
Gill,proudmoore,1800,priest,holy,148,78,70
Moonideli,moon-guard,1783,priest,holy,90,46,44
Walnut,kelthuzad,1782,priest,holy,42,23,19
Turnipp,sargeras,1780,priest,holy,42,19,23
Zenelu,tichondrius,1775,priest,holy,482,239,243
Haruspex,azralon,1774,priest,holy,123,58,65
Jjmms,akama,1755,priest,holy,275,137,138
Goodlife,frostmourne,1753,priest,holy,107,52,55
Óst,tichondrius,1747,priest,holy,54,23,31
Heavyflo,kelthuzad,1746,priest,holy,96,49,47
Jüdaspriest,gorefiend,1744,priest,holy,53,20,33
Nanatoo,sargeras,1743,priest,holy,42,22,20
Iovesosa,kelthuzad,1739,priest,holy,39,22,17
Pigogo,tichondrius,1737,priest,holy,157,86,71
Verymuscular,stormrage,1737,priest,holy,73,37,36
Dream,kelthuzad,1736,priest,holy,96,48,48
Zazul,frostmane,1734,priest,holy,107,61,46
Iloveethan,moon-guard,1726,priest,holy,95,53,42
Icychain,area-52,1726,priest,holy,35,19,16
Minipriest,sargeras,1726,priest,holy,48,23,25
Bloodlinex,malganis,1724,priest,holy,207,116,91
Blazedpri,tichondrius,1721,priest,holy,30,18,12
Qtasiangirl,emerald-dream,1721,priest,holy,93,42,51
Soulghast,gorefiend,1720,priest,holy,42,24,18
Nildryck,malganis,1720,priest,holy,42,19,23
Cheekypriest,stormrage,1714,priest,holy,66,30,36
Eccentricx,sargeras,1712,priest,holy,30,18,12
Falsegodx,tichondrius,1706,priest,holy,132,69,63
Yyuan,tichondrius,1705,priest,holy,48,23,25
Snowymooie,frostmourne,1697,priest,holy,54,25,29
Illooj,eonar,1696,priest,holy,55,33,22
Baip,sargeras,1696,priest,holy,42,25,17
Packet,zuluhed,1694,priest,holy,42,28,14
Moldymeatbox,blood-furnace,1691,priest,holy,47,26,21
ßsimp,darrowmere,1689,priest,holy,89,42,47
Geoffrred,illidan,1686,priest,holy,54,21,33
Pws,azralon,1683,priest,holy,66,29,37
Candohp,frostmourne,1682,priest,holy,42,22,20
Soloqqt,tichondrius,1675,priest,holy,42,24,18
Gaudthree,tichondrius,1675,priest,holy,48,26,22
Santyel,ragnaros,1668,priest,holy,102,54,48
Hannavi,illidan,1667,priest,holy,72,51,21
Myles,alexstrasza,1667,priest,holy,42,24,18
Cosmicyiff,area-52,1666,priest,holy,76,38,38
Moosepriestx,sargeras,1660,priest,holy,42,19,23
Cryptron,tichondrius,1660,priest,holy,114,50,64
Elbowbeans,tichondrius,1658,priest,holy,112,53,59
Iluvthgnmicz,sargeras,1655,priest,holy,57,30,27
Fyne,kelthuzad,1653,priest,holy,224,115,109
Djdazzle,kargath,1652,priest,holy,35,18,17
Wankenobi,stormrage,1651,priest,holy,297,149,148
Stonemonkeyp,sargeras,1646,priest,holy,231,127,104
Illmindofmoo,sargeras,1645,priest,holy,41,18,23
Pancakeboi,tichondrius,1638,priest,holy,167,77,90
Bopang,emerald-dream,1638,priest,holy,59,27,32
Auntbrittany,tichondrius,1636,priest,holy,135,73,62
Quicklight,sargeras,1633,priest,holy,54,30,24
Dfâc,moon-guard,1633,priest,holy,44,23,21
Dntchekpvpme,tichondrius,1630,priest,holy,42,23,19
Hardiness,tichondrius,1627,priest,holy,66,45,21
Qnarisha,tichondrius,1626,priest,holy,131,69,62
Iaz,darkspear,1626,priest,holy,50,22,28
Wisdumos,frostmourne,1625,priest,holy,72,36,36
Snookp,kiljaeden,1620,priest,holy,77,44,33
Dgpriest,tichondrius,1620,priest,holy,48,23,25
Pej,emerald-dream,1620,priest,holy,54,22,32
Holydome,daggerspine,1619,priest,holy,54,20,34
Archbishop,stormscale,1615,priest,holy,154,78,76
Clarify,arathor,1615,priest,holy,84,35,49
Miserable,emerald-dream,1614,priest,holy,102,56,46
Dinosmeow,sargeras,1614,priest,holy,90,41,49
Lickless,illidan,1613,priest,holy,48,23,25
Hpcando,frostmourne,1612,priest,holy,43,26,17
Endure,moon-guard,1610,priest,holy,42,22,20
Leoshi,turalyon,1604,priest,holy,48,27,21
Jiñx,destromath,1601,priest,holy,54,27,27
Dylbags,frostmourne,1600,priest,holy,35,21,14
Vatan,dalaran,1600,priest,holy,42,24,18
Lisnup,tichondrius,1600,priest,holy,45,22,23
Lemmiewinkzx,sargeras,1598,priest,holy,24,17,7
Madomie,bladefist,1597,priest,holy,36,20,16
Thisistragic,frostmourne,1594,priest,holy,34,26,8
Gosilly,tichondrius,1594,priest,holy,36,22,14
Washdp,frostmourne,1591,priest,holy,60,26,34
Evilpriest,stormrage,1590,priest,holy,42,21,21
Manbooty,illidan,1588,priest,holy,39,22,17
Shïryn,illidan,1585,priest,holy,53,26,27
Cerebrill,bleeding-hollow,1585,priest,holy,51,24,27
Noniok,blackrock,1583,priest,holy,80,49,31
Operandi,sargeras,1583,priest,holy,41,22,19
Alathea,elune,1583,priest,holy,237,113,124
Dypkillet,moon-guard,1582,priest,holy,150,71,79
Bloodyx,bleeding-hollow,1573,priest,holy,30,19,11
Iaptop,tichondrius,1569,priest,holy,36,20,16
Avis,illidan,1569,priest,holy,134,67,67
Hatxsu,emerald-dream,1568,priest,holy,58,24,34
Cutiepriest,gnomeregan,1565,priest,holy,151,86,65
Padrecarras,ragnaros,1565,priest,holy,60,30,30
ßeautiful,sargeras,1562,priest,holy,42,22,20
Pootyspanked,daggerspine,1559,priest,holy,113,66,47
Krobs,bleeding-hollow,1559,priest,holy,48,20,28
Tarlex,illidan,1555,priest,holy,94,43,51
Tytusx,stormrage,1543,priest,holy,44,22,22
Heluupa,illidan,1538,priest,holy,113,71,42
Sanojaz,ragnaros,1538,priest,holy,60,33,27
Punkndrublic,sargeras,1537,priest,holy,189,91,98
Tookz,stormrage,1530,priest,holy,24,16,8
Sukeena,malganis,1530,priest,holy,125,60,65
Rubymisfit,sargeras,1528,priest,holy,30,16,14
Bubbles,drakthul,1527,priest,holy,532,265,267
Nielbomb,tichondrius,1527,priest,holy,414,206,208
Soaphia,kelthuzad,1525,priest,holy,130,65,65
Bibleblak,stormrage,1525,priest,holy,54,27,27
Dispassion,stormrage,1523,priest,holy,182,90,92
Healinsucks,proudmoore,1519,priest,holy,52,29,23
Anguishment,stormrage,1517,priest,holy,385,193,192
Handsumheals,kiljaeden,1515,priest,holy,55,32,23
Holypopocat,tichondrius,1514,priest,holy,33,18,15
Saetia,drenden,1513,priest,holy,69,40,29
Ducky,drakthul,1513,priest,holy,66,38,28
Praggy,proudmoore,1513,priest,holy,48,20,28
Miamama,hydraxis,1513,priest,holy,42,17,25
Joeschmoe,proudmoore,1512,priest,holy,42,22,20
Boboxiao,illidan,1512,priest,holy,47,16,31
Cantheel,stormrage,1507,priest,holy,235,119,116
Downturn,tichondrius,1507,priest,holy,42,18,24
Tortellino,hyjal,1505,priest,holy,30,19,11
Oyy,barthilas,1505,priest,holy,150,76,74
Exploded,moon-guard,1505,priest,holy,96,48,48
Arçhángël,moon-guard,1503,priest,holy,102,57,45
Einheit,stormrage,1502,priest,holy,48,28,20
Cardinalpéll,frostmourne,1498,priest,holy,74,39,35
Giveheadpats,moon-guard,1496,priest,holy,164,80,84
Symbolofhope,moon-guard,1495,priest,holy,75,36,39
Tazzi,chromaggus,1494,priest,holy,79,35,44
Sacrifer,moon-guard,1493,priest,holy,120,60,60
Kostantina,kelthuzad,1484,priest,holy,42,18,24
Tranquilty,tichondrius,1480,priest,holy,84,36,48
Wøo,area-52,1476,priest,holy,172,89,83
Macko,wyrmrest-accord,1476,priest,holy,37,18,19
Goyimhealer,area-52,1476,priest,holy,53,23,30
Chadopri,stormrage,1475,priest,holy,60,34,26
Plebiss,burning-blade,1473,priest,holy,364,190,174
Illyasviel,terenas,1472,priest,holy,103,41,62
Adrenalinn,illidan,1471,priest,holy,60,34,26
Ðemi,zuljin,1469,priest,holy,69,38,31
Dawnside,wyrmrest-accord,1468,priest,holy,701,372,329
Edmen,stormrage,1466,priest,holy,96,47,49
Exol,ragnaros,1465,priest,holy,48,25,23
Soleyxo,frostmourne,1464,priest,holy,90,47,43
Aisperwind,shadowsong,1462,priest,holy,120,62,58
Musashibo,kelthuzad,1462,priest,holy,67,25,42
Ayanamil,tichondrius,1460,priest,holy,79,57,22
Artiannaa,bleeding-hollow,1460,priest,holy,75,46,29
Vampiric,laughing-skull,1460,priest,holy,68,38,30
Matthiass,thrall,1458,priest,holy,184,88,96
Discconnect,dark-iron,1456,priest,holy,41,19,22
Reverenced,stormrage,1452,priest,holy,126,72,54
Maplesyrupz,moonrunner,1452,priest,holy,40,16,24
Sooyáaa,illidan,1447,priest,holy,288,131,157
Pics,emerald-dream,1446,priest,holy,40,22,18
Griddly,alterac-mountains,1445,priest,holy,55,17,38
Swrvlol,emerald-dream,1444,priest,holy,36,25,11
Owlchubz,mannoroth,1443,priest,holy,121,57,64
Chervz,chogall,1443,priest,holy,78,32,46
Dapcum,illidan,1441,priest,holy,30,20,10
Strivedaily,proudmoore,1440,priest,holy,279,133,146
Cuaiminator,ragnaros,1438,priest,holy,65,36,29
Rolence,tichondrius,1437,priest,holy,86,46,40
Akëla,nemesis,1436,priest,holy,52,28,24
Necroplasma,area-52,1433,priest,holy,55,31,24
Xedus,mannoroth,1433,priest,holy,74,32,42
Shieldspamx,tichondrius,1432,priest,holy,24,20,4
Krukam,sargeras,1432,priest,holy,58,28,30
Hypepriest,sargeras,1431,priest,holy,24,17,7
Iggyp,hyjal,1430,priest,holy,217,113,104
Pesca,proudmoore,1429,priest,holy,36,15,21
Marïmba,azralon,1428,priest,holy,42,20,22
Wrinkletink,whisperwind,1426,priest,holy,49,24,25
Qtcookiebunz,proudmoore,1424,priest,holy,35,17,18
Taashigi,frostmourne,1423,priest,holy,58,31,27
Klondikebar,whisperwind,1418,priest,holy,54,31,23
Camedy,illidan,1415,priest,holy,119,57,62
Discospider,sargeras,1412,priest,holy,37,20,17
Tòxìç,stormrage,1411,priest,holy,187,96,91
Mizzbehavn,tichondrius,1410,priest,holy,50,26,24
Kaelthos,quelthalas,1409,priest,holy,101,50,51
Kovaxx,frostmourne,1407,priest,holy,156,74,82
Voïdx,emerald-dream,1407,priest,holy,54,20,34
Îcarus,tichondrius,1406,priest,holy,36,17,19
Berzum,chogall,1406,priest,holy,36,17,19
ßugsy,illidan,1402,priest,holy,60,31,29
Sacredforce,sargeras,1400,priest,holy,66,21,45
Loosejeans,blackrock,1399,priest,holy,36,18,18
Vìxèn,zuljin,1397,priest,holy,121,53,68
Holyb,tichondrius,1396,priest,holy,89,46,43
Bradythree,moon-guard,1394,priest,holy,40,25,15
Pettypriest,dalaran,1394,priest,holy,201,95,106
Bestgirlna,area-52,1393,priest,holy,144,64,80
Floquii,area-52,1391,priest,holy,52,25,27
Applepieyum,illidan,1391,priest,holy,108,46,62
Soapfan,kelthuzad,1387,priest,holy,195,94,101
Dreäveler,stormrage,1385,priest,holy,27,15,12
Fenty,nemesis,1384,priest,holy,59,33,26
Plod,kelthuzad,1380,priest,holy,42,25,17
Etain,bloodscalp,1380,priest,holy,65,35,30
Akaneo,tichondrius,1380,priest,holy,36,18,18
Xenatic,emerald-dream,1380,priest,holy,138,67,71
Suirr,tichondrius,1377,priest,holy,36,16,20
Painpaws,moon-guard,1376,priest,holy,24,16,8
Glaius,kiljaeden,1376,priest,holy,84,40,44
Åutumn,tichondrius,1374,priest,holy,26,18,8
Doob,ghostlands,1374,priest,holy,48,25,23
Methodist,proudmoore,1374,priest,holy,84,31,53
Holynug,stormrage,1370,priest,holy,36,19,17
Preacherr,bonechewer,1368,priest,holy,42,24,18
Sabene,greymane,1364,priest,holy,91,44,47
Leggoscams,tichondrius,1360,priest,holy,44,22,22
Mikeyxo,gnomeregan,1359,priest,holy,44,26,18
Maddrox,sargeras,1359,priest,holy,47,26,21
Aurorias,burning-legion,1359,priest,holy,60,24,36
Rihen,tichondrius,1358,priest,holy,525,257,268
Chemod,quelthalas,1355,priest,holy,47,26,21
Cyelena,quelthalas,1355,priest,holy,72,32,40
Quartzolio,azralon,1353,priest,holy,59,35,24
Muffinecho,sargeras,1353,priest,holy,85,36,49
Shaldra,bleeding-hollow,1348,priest,holy,109,64,45
Ghostiepants,tichondrius,1347,priest,holy,53,25,28
Sappes,area-52,1346,priest,holy,54,27,27
Hérò,barthilas,1345,priest,holy,50,28,22
Dioecesis,moon-guard,1345,priest,holy,83,30,53
Debussynjoyr,malganis,1339,priest,holy,24,14,10
Andruel,ragnaros,1338,priest,holy,109,56,53
Esvary,quelthalas,1337,priest,holy,134,71,63
Kurandies,nemesis,1337,priest,holy,73,37,36
Kernelious,illidan,1337,priest,holy,30,14,16
Hizha,tichondrius,1335,priest,holy,42,24,18
Ænußís,stormrage,1335,priest,holy,84,46,38
Spriest,kul-tiras,1332,priest,holy,74,41,33
Kaelsgf,kaelthas,1331,priest,holy,54,22,32
Trufumthunzi,illidan,1330,priest,holy,26,17,9
Xumer,quelthalas,1329,priest,holy,56,29,27
Karrera,kelthuzad,1328,priest,holy,66,36,30
Droneboy,moon-guard,1327,priest,holy,36,20,16
Merellia,moon-guard,1324,priest,holy,108,52,56
Nylaza,kiljaeden,1324,priest,holy,90,42,48
Holyshytt,tichondrius,1323,priest,holy,59,31,28
Psytrance,proudmoore,1323,priest,holy,29,15,14
Mkenze,moon-guard,1323,priest,holy,174,80,94
Healztonic,dalaran,1323,priest,holy,85,38,47
Dispersed,thrall,1319,priest,holy,92,42,50
Priestlie,malganis,1318,priest,holy,98,43,55
Freshtodeath,malganis,1316,priest,holy,48,28,20
Cûrry,bleeding-hollow,1313,priest,holy,24,14,10
Lectra,firetree,1313,priest,holy,40,21,19
Phearix,zuljin,1313,priest,holy,54,23,31
Lexiié,area-52,1312,priest,holy,55,33,22
Mercý,zuljin,1309,priest,holy,60,34,26
Ksâh,bleeding-hollow,1309,priest,holy,36,17,19
Urdaisyy,kelthuzad,1306,priest,holy,36,14,22
Animè,zuluhed,1305,priest,holy,89,52,37
Xinferesia,sargeras,1305,priest,holy,61,25,36
Gracarix,frostmourne,1304,priest,holy,40,23,17
Dunanan,moon-guard,1304,priest,holy,30,17,13
Snuffsnorter,kelthuzad,1304,priest,holy,41,16,25
Cutensoft,moon-guard,1302,priest,holy,60,28,32
Xrafa,azralon,1301,priest,holy,84,38,46
Yujawang,sargeras,1300,priest,holy,36,17,19
Nowwow,tichondrius,1299,priest,holy,41,22,19
Cristobal,chogall,1299,priest,holy,30,15,15
Giusep,tichondrius,1297,priest,holy,48,22,26
Duhàst,sargeras,1296,priest,holy,95,43,52
Littlebat,proudmoore,1294,priest,holy,82,41,41
Holyfromrmp,tichondrius,1294,priest,holy,99,44,55
Deemmortii,stormrage,1289,priest,holy,43,18,25
Xanky,frostmourne,1287,priest,holy,34,18,16
Lilyanná,tichondrius,1284,priest,holy,54,26,28
Holiermilk,demon-soul,1281,priest,holy,239,110,129
Edessa,lothar,1280,priest,holy,102,44,58
Amaristinaa,frostmourne,1279,priest,holy,46,21,25
Spïcÿ,frostmourne,1276,priest,holy,60,29,31
Duskherald,zuljin,1274,priest,holy,96,45,51
Dadcantdeath,frostmourne,1274,priest,holy,32,14,18
Visse,auchindoun,1273,priest,holy,42,29,13
Priestprease,malganis,1272,priest,holy,39,20,19
Holyphodays,sargeras,1270,priest,holy,59,20,39
Faerielee,thrall,1268,priest,holy,30,14,16
Raskreia,dragonmaw,1268,priest,holy,30,14,16
Tegridyfarm,malganis,1265,priest,holy,35,19,16
Threesclass,tichondrius,1262,priest,holy,29,14,15
Cruxave,aegwynn,1260,priest,holy,82,42,40
Mirshadow,tichondrius,1260,priest,holy,48,24,24
Cusquena,caelestrasz,1259,priest,holy,48,24,24
Danerÿ,ragnaros,1255,priest,holy,56,28,28
Alrüna,moon-guard,1253,priest,holy,62,30,32
Benjamints,thrall,1252,priest,holy,30,15,15
Padreamarol,ragnaros,1252,priest,holy,68,32,36
Galadrael,quelthalas,1252,priest,holy,35,16,19
Zallstan,zuljin,1249,priest,holy,30,15,15
Valkur,aegwynn,1248,priest,holy,219,105,114
Bjorke,tichondrius,1247,priest,holy,30,13,17
Oxynor,zuljin,1246,priest,holy,24,13,11
Wabie,illidan,1246,priest,holy,30,13,17
Shoepooper,kelthuzad,1245,priest,holy,24,13,11
Zumnb,quelthalas,1243,priest,holy,134,61,73
Irídium,area-52,1243,priest,holy,30,13,17
Bmouth,tichondrius,1241,priest,holy,24,13,11
Fanseband,dalaran,1240,priest,holy,41,22,19
Daisie,bleeding-hollow,1240,priest,holy,150,78,72
Manocloth,frostmourne,1239,priest,holy,25,15,10
Akainuu,nazjatar,1239,priest,holy,61,26,35
Fearnfaith,zuljin,1239,priest,holy,36,13,23
Valiann,lightbringer,1238,priest,holy,24,13,11
Deathrina,moon-guard,1236,priest,holy,39,21,18
Cléah,sargeras,1235,priest,holy,113,53,60
Altera,drakkari,1233,priest,holy,30,13,17
Kälashnikova,ragnaros,1232,priest,holy,116,59,57
Etros,wyrmrest-accord,1232,priest,holy,102,47,55
Junatoh,area-52,1231,priest,holy,55,29,26
Dagaen,thunderlord,1230,priest,holy,240,120,120
Healgirls,dalaran,1230,priest,holy,59,28,31
Aiwa,winterhoof,1229,priest,holy,18,13,5
Breathkeeper,proudmoore,1226,priest,holy,36,13,23
Snoorklizzak,malganis,1225,priest,holy,24,13,11
Delthas,nagrand,1225,priest,holy,224,121,103
Zerolimitzz,arthas,1225,priest,holy,48,22,26
Whitepigogo,tichondrius,1225,priest,holy,30,13,17
Celinsa,ragnaros,1223,priest,holy,36,18,18
Xarithea,caelestrasz,1222,priest,holy,41,19,22
Arterrmis,barthilas,1222,priest,holy,65,29,36
Urisaegin,senjin,1222,priest,holy,52,23,29
Tïto,blackrock,1220,priest,holy,50,23,27
Frïsk,illidan,1219,priest,holy,64,30,34
Titô,frostmourne,1215,priest,holy,53,28,25
Firewatcher,sisters-of-elune,1214,priest,holy,30,17,13
Destïnÿ,zuljin,1213,priest,holy,51,24,27
Salaknib,frostmourne,1206,priest,holy,40,17,23
Dóctóre,thrall,1205,priest,holy,61,24,37
Stayhealed,tichondrius,1201,priest,holy,45,22,23
Akö,jubeithos,1200,priest,holy,30,14,16
Vernis,nazjatar,1200,priest,holy,36,15,21
Pílí,drakkari,1198,priest,holy,60,28,32
Gronix,blood-furnace,1195,priest,holy,42,22,20
Qelient,proudmoore,1192,priest,holy,48,26,22
Ukizeal,moknathal,1192,priest,holy,134,63,71
Theophobe,illidan,1190,priest,holy,85,45,40
Darkheals,azralon,1190,priest,holy,52,20,32
Stennic,emerald-dream,1183,priest,holy,33,17,16
Dolandir,quelthalas,1181,priest,holy,30,18,12
Kazehanaa,ragnaros,1180,priest,holy,42,22,20
Flemyth,eitrigg,1180,priest,holy,40,16,24
Pôê,blood-furnace,1171,priest,holy,24,13,11
Bismund,chogall,1166,priest,holy,48,24,24
Bonsana,shadowsong,1164,priest,holy,36,21,15
Haushauha,azralon,1164,priest,holy,48,23,25
Suzzanna,frostmourne,1160,priest,holy,41,23,18
Aftercare,moon-guard,1157,priest,holy,72,27,45
Ranøth,deathwing,1155,priest,holy,74,31,43
Milkgulper,illidan,1152,priest,holy,24,12,12
Leonihpriest,nemesis,1151,priest,holy,30,12,18
Trompiscola,quelthalas,1151,priest,holy,30,12,18
Lightwell,blackrock,1150,priest,holy,18,12,6
Löstský,azralon,1148,priest,holy,37,19,18
Mêgumin,area-52,1147,priest,holy,18,13,5
Konãn,ragnaros,1145,priest,holy,18,12,6
Ôôöô,sargeras,1145,priest,holy,24,13,11
Selket,stormscale,1145,priest,holy,96,42,54
Fiction,kelthuzad,1142,priest,holy,18,13,5
Floppytatas,illidan,1142,priest,holy,279,143,136
Luxar,aegwynn,1141,priest,holy,18,12,6
Meiev,quelthalas,1139,priest,holy,24,12,12
Anemonie,gorefiend,1138,priest,holy,122,52,70
Kasiry,ragnaros,1137,priest,holy,90,37,53
Voidthulhu,stormrage,1134,priest,holy,167,66,101
Rienis,sargeras,1132,priest,holy,42,17,25
Fallaner,destromath,1129,priest,holy,65,28,37
Tianqing,tichondrius,1126,priest,holy,34,12,22
Aprocalypse,malganis,1123,priest,holy,42,17,25
Dactylion,moon-guard,1119,priest,holy,24,12,12
Æsir,skullcrusher,1119,priest,holy,30,12,18
Niná,arathor,1114,priest,holy,20,13,7
Zojhira,khazgoroth,1114,priest,holy,66,32,34
Carray,goldrinn,1113,priest,holy,49,16,33
Veane,tichondrius,1111,priest,holy,68,28,40
Atlana,gilneas,1107,priest,holy,24,16,8
Mailboxxy,kelthuzad,1107,priest,holy,42,18,24
Divona,blackhand,1106,priest,holy,66,23,43
Veltaxis,moon-guard,1095,priest,holy,174,77,97
Dotsallover,sargeras,1091,priest,holy,38,14,24
Sanaconda,sargeras,1090,priest,holy,36,12,24
Kytiana,blackwing-lair,1088,priest,holy,729,357,372
Rdvark,stormrage,1085,priest,holy,26,12,14
Bwaka,dalaran,1084,priest,holy,18,12,6
Sôlîånia,alterac-mountains,1081,priest,holy,39,27,12
Gewbrr,malganis,1073,priest,holy,24,12,12
Beckzz,illidan,1070,priest,holy,26,17,9
Mavuiss,barthilas,1069,priest,holy,25,12,13
Sinthe,stormrage,1056,priest,holy,24,11,13
Badgoy,dalaran,1056,priest,holy,24,11,13
Ímhotep,sargeras,1055,priest,holy,18,11,7
Pesian,dalaran,1055,priest,holy,22,12,10
Sorrowful,mannoroth,1055,priest,holy,30,11,19
Iilmama,area-52,1054,priest,holy,18,11,7
Saltypepper,thunderhorn,1052,priest,holy,30,14,16
Amayå,kelthuzad,1052,priest,holy,24,11,13
Amynthel,tichondrius,1052,priest,holy,30,11,19
Jsky,wyrmrest-accord,1050,priest,holy,21,11,10
Karenpigbear,area-52,1050,priest,holy,243,107,136
Dotdotdead,earthen-ring,1049,priest,holy,18,11,7
Jol,aggramar,1049,priest,holy,30,13,17
Soulhealer,shadowmoon,1048,priest,holy,24,13,11
Paradoxbot,kelthuzad,1045,priest,holy,18,11,7
Dylirium,dathremar,1044,priest,holy,18,11,7
Fadedvi,wyrmrest-accord,1042,priest,holy,45,21,24
Titoj,tichondrius,1035,priest,holy,38,19,19
Zhideevskiy,trollbane,1033,priest,holy,42,20,22
Alicia,nazjatar,1032,priest,holy,18,13,5
Pikachuwu,moon-guard,1032,priest,holy,17,12,5
Lieuwe,kelthuzad,1032,priest,holy,30,12,18
Seventeen,hyjal,1029,priest,holy,30,11,19
Healle,proudmoore,1027,priest,holy,23,11,12
Tranith,jubeithos,1027,priest,holy,24,11,13
Celani,gilneas,1026,priest,holy,24,11,13
Ninbará,stormrage,1023,priest,holy,26,12,14
Justjoekingh,gurubashi,1021,priest,holy,22,12,10
Hälø,moon-guard,1019,priest,holy,27,12,15
Krishpriest,azshara,1018,priest,holy,24,15,9
Fivestarz,malganis,1014,priest,holy,24,11,13
Fayth,maiev,1005,priest,holy,53,25,28
Pandamila,azralon,1004,priest,holy,19,11,8
Zantara,lightbringer,1002,priest,holy,24,12,12
Maiyennefer,proudmoore,996,priest,holy,36,13,23
Sybenela,proudmoore,994,priest,holy,61,28,33
Souljourner,stormrage,993,priest,holy,95,46,49
Pottime,tichondrius,989,priest,holy,76,33,43
Yinaiteen,drakkari,985,priest,holy,64,33,31
Cultofsins,tichondrius,982,priest,holy,23,11,12
Priesttess,skullcrusher,981,priest,holy,23,11,12
Seråphim,sargeras,979,priest,holy,66,36,30
Ragekiller,lothar,964,priest,holy,59,28,31
Eredwarraim,akama,964,priest,holy,48,21,27
Adephene,illidan,960,priest,holy,18,10,8
Jameswarren,silvermoon,959,priest,holy,11,11,0
Runalor,zuljin,959,priest,holy,18,10,8
Bunbuns,spirestone,959,priest,holy,18,10,8
Naxray,quelthalas,959,priest,holy,18,10,8
Pèrona,tichondrius,959,priest,holy,24,10,14
Trickyhobo,area-52,958,priest,holy,12,10,2
Folate,frostmourne,957,priest,holy,18,10,8
Holyfizzle,dethecus,957,priest,holy,54,28,26
Wockus,dalaran,956,priest,holy,18,10,8
Bugshott,tichondrius,956,priest,holy,32,10,22
Noobepriest,thrall,955,priest,holy,18,10,8
Priestybear,illidan,955,priest,holy,18,10,8
Cappoo,tichondrius,955,priest,holy,36,10,26
Xoraya,proudmoore,954,priest,holy,18,10,8
Rottigus,skullcrusher,951,priest,holy,18,10,8
Dovoso,kargath,951,priest,holy,26,10,16
Hycinamun,malganis,949,priest,holy,25,10,15
Allaras,eldrethalas,946,priest,holy,24,10,14
Novous,area-52,944,priest,holy,30,10,20
Horimiya,silvermoon,943,priest,holy,23,11,12
Aszdriel,azralon,936,priest,holy,18,10,8
Taylorsmites,emerald-dream,931,priest,holy,42,18,24
Dipanddøts,area-52,926,priest,holy,17,10,7
Bienhechora,quelthalas,924,priest,holy,18,10,8
Zelaya,hellscream,919,priest,holy,45,17,28
Aliorixa,stormrage,908,priest,holy,26,11,15
Artyòm,stormrage,897,priest,holy,297,138,159
Meibuff,frostmourne,896,priest,holy,50,18,32
Veni,kiljaeden,885,priest,holy,23,10,13
Teheleopapi,quelthalas,877,priest,holy,75,19,56
Rustymvpfan,nagrand,864,priest,holy,18,9,9
Holyxb,bleeding-hollow,863,priest,holy,18,9,9
Mhp,illidan,863,priest,holy,18,9,9
Xhadow,sargeras,863,priest,holy,18,9,9
Glöws,area-52,863,priest,holy,24,9,15
Çummiñs,malganis,862,priest,holy,18,9,9
Mëïsoön,quelthalas,862,priest,holy,18,9,9
Leapofdoubt,zuljin,861,priest,holy,12,9,3
Ilurvyou,frostwolf,861,priest,holy,24,9,15
Legoland,skullcrusher,859,priest,holy,12,9,3
Chaynal,proudmoore,859,priest,holy,18,9,9
Meowforheals,sargeras,859,priest,holy,18,9,9
Duonaiameng,illidan,859,priest,holy,18,9,9
Faedre,smolderthorn,858,priest,holy,18,9,9
Skywritten,area-52,857,priest,holy,18,9,9
Swis,area-52,857,priest,holy,24,9,15
Adjectives,nerzhul,854,priest,holy,24,9,15
Shkeyia,stonemaul,852,priest,holy,30,9,21
Sondrak,doomhammer,846,priest,holy,47,19,28
Aldryth,lightbringer,838,priest,holy,18,9,9
Pharmacee,korgath,836,priest,holy,102,33,69
Hamburgle,blackrock,831,priest,holy,16,10,6
Psïren,quelthalas,831,priest,holy,28,9,19
Conno,thunderlord,829,priest,holy,54,27,27
Jovon,frostmourne,828,priest,holy,29,9,20
Bigmommyxo,whisperwind,811,priest,holy,33,10,23
Ascian,daggerspine,809,priest,holy,18,10,8
Helgar,frostmourne,808,priest,holy,18,10,8
Híkarí,windrunner,796,priest,holy,14,9,5
Gbumy,tichondrius,784,priest,holy,13,9,4
Yikari,sargeras,783,priest,holy,11,9,2
Saceryito,quelthalas,770,priest,holy,13,9,4
Releknosleep,frostwolf,769,priest,holy,20,10,10
Sengmin,burning-blade,768,priest,holy,12,8,4
Powerwordsuc,malganis,768,priest,holy,12,8,4
Gudóngmáe,tichondrius,768,priest,holy,12,8,4
Fotmtrash,the-underbog,768,priest,holy,12,8,4
Turnip,zuljin,768,priest,holy,12,8,4
Becrixx,thunderlord,768,priest,holy,18,8,10
Yanyo,skullcrusher,768,priest,holy,18,8,10
Voidzx,tichondrius,768,priest,holy,18,8,10
Ugotknocked,bleeding-hollow,768,priest,holy,18,8,10
Khalesî,ragnaros,767,priest,holy,12,8,4
Superheals,nordrassil,767,priest,holy,12,8,4
Unhöly,norgannon,767,priest,holy,12,8,4
Sunwarden,dalaran,767,priest,holy,12,8,4
Tonybanderas,shattered-halls,767,priest,holy,18,8,10
Pomdom,tichondrius,767,priest,holy,18,8,10
Boundword,emerald-dream,767,priest,holy,18,8,10
Hynzor,barthilas,767,priest,holy,30,8,22
Prayzar,illidan,766,priest,holy,12,8,4
Raphan,stormrage,766,priest,holy,12,8,4
Ofmanyfaces,illidan,766,priest,holy,12,8,4
Zeroo,maiev,765,priest,holy,12,8,4
Manatea,moon-guard,765,priest,holy,18,8,10
Velyndra,icecrown,765,priest,holy,18,8,10
Yuritzi,duskwood,765,priest,holy,18,8,10
Prayboy,aerie-peak,765,priest,holy,24,8,16
Olivinpain,malganis,765,priest,holy,30,8,22
Morticiá,blackrock,764,priest,holy,12,8,4
Lenlune,bloodscalp,763,priest,holy,18,8,10
Laj,proudmoore,763,priest,holy,30,8,22
Papergaruru,illidan,762,priest,holy,30,8,22
Uzakichan,arygos,760,priest,holy,30,8,22
Priestognic,azralon,759,priest,holy,16,9,7
Shadøwreaper,azralon,758,priest,holy,27,10,17
Fäñcÿ,tichondrius,734,priest,holy,17,8,9
Rylance,burning-blade,720,priest,holy,21,8,13
Leist,ragnaros,719,priest,holy,24,9,15
Msdash,tichondrius,717,priest,holy,15,8,7
Saintfulsins,sargeras,716,priest,holy,15,8,7
Amunsu,stormrage,711,priest,holy,30,11,19
Messra,dathremar,707,priest,holy,30,8,22
Jaytee,aggramar,703,priest,holy,14,9,5
Humz,ragnaros,703,priest,holy,14,8,6
Undevout,tichondrius,672,priest,holy,12,7,5
Pevis,thrall,672,priest,holy,12,7,5
Tewiyakichkn,tichondrius,672,priest,holy,12,7,5
Hehehealyou,emerald-dream,672,priest,holy,12,7,5
Canibumsmoke,illidan,672,priest,holy,12,7,5
Qiahariya,emerald-dream,672,priest,holy,12,7,5
Nwok,frostmourne,672,priest,holy,12,7,5
Deevious,barthilas,672,priest,holy,12,7,5
Pgpriest,kelthuzad,672,priest,holy,12,7,5
Shadedlight,dalaran,672,priest,holy,12,7,5
Beliana,boulderfist,672,priest,holy,16,8,8
Selidri,proudmoore,672,priest,holy,18,7,11
Nicksfury,stormrage,672,priest,holy,18,7,11
Tylexus,tichondrius,672,priest,holy,18,7,11
Drelia,jubeithos,672,priest,holy,24,7,17
Xpenance,ragnaros,672,priest,holy,24,7,17
Jordandoesnt,tichondrius,671,priest,holy,12,7,5
Suppòrt,stormrage,671,priest,holy,12,7,5
Deidre,illidan,671,priest,holy,16,8,8
Braevera,wyrmrest-accord,671,priest,holy,18,7,11
Cataline,emerald-dream,671,priest,holy,18,7,11
Diablomonk,warsong,671,priest,holy,18,7,11
Razakam,tichondrius,671,priest,holy,18,7,11
Dankpope,malganis,670,priest,holy,12,7,5
Exlord,illidan,670,priest,holy,12,7,5
Lndsynbritny,darkspear,670,priest,holy,18,7,11
Arena,lothar,669,priest,holy,12,7,5
Context,mannoroth,669,priest,holy,12,7,5
Skeyfyr,frostmourne,669,priest,holy,18,7,11
Dëâth,ghostlands,669,priest,holy,21,8,13
Klassy,thrall,668,priest,holy,17,8,9
Kisstina,tichondrius,667,priest,holy,24,7,17
Vichealer,firetree,660,priest,holy,12,7,5
Yidra,illidan,623,priest,holy,17,7,10
ßöp,sargeras,620,priest,holy,11,7,4
Blackprez,dathremar,613,priest,holy,17,7,10
Boogiedo,area-52,607,priest,holy,11,7,4
Punishing,illidan,606,priest,holy,16,7,9
Papadarkness,tichondrius,603,priest,holy,14,7,7
Sizuré,frostmourne,591,priest,holy,11,7,4
Ishtana,bleeding-hollow,584,priest,holy,17,9,8
Hectorz,zuljin,576,priest,holy,6,6,0
Chandracath,draktharon,576,priest,holy,6,6,0
Archaellia,area-52,576,priest,holy,12,6,6
Sìnz,area-52,576,priest,holy,12,6,6
Sigx,area-52,576,priest,holy,12,6,6
Everest,barthilas,576,priest,holy,12,6,6
Jezebëll,nemesis,576,priest,holy,12,6,6
Shockterror,area-52,576,priest,holy,12,6,6
Lyleth,lightnings-blade,576,priest,holy,12,6,6
Didntâsk,arthas,576,priest,holy,12,6,6
Linvial,moon-guard,576,priest,holy,12,6,6
Hysteria,dalaran,576,priest,holy,12,6,6
Unsubbedd,sargeras,576,priest,holy,12,6,6
Feverx,tichondrius,576,priest,holy,12,6,6
Xtcbtc,sargeras,576,priest,holy,12,6,6
Telarith,sargeras,576,priest,holy,12,6,6
Calissy,proudmoore,576,priest,holy,12,6,6
Zraken,emerald-dream,576,priest,holy,12,6,6
Bootleg,crushridge,576,priest,holy,12,6,6
Benedictiion,tichondrius,576,priest,holy,12,6,6
Skylust,azralon,576,priest,holy,12,6,6
Gustáv,sargeras,576,priest,holy,18,6,12
Lolcrafthd,ragnaros,576,priest,holy,18,6,12
Xhirra,quelthalas,576,priest,holy,18,6,12
Atenai,sargeras,576,priest,holy,18,6,12
Estaria,the-forgotten-coast,576,priest,holy,18,6,12
Fertalize,maiev,576,priest,holy,24,6,18
Youngwavy,area-52,575,priest,holy,12,6,6
Mattkoster,mannoroth,575,priest,holy,12,6,6
Handgina,frostmourne,575,priest,holy,12,6,6
Healfouru,frostmourne,575,priest,holy,12,6,6
Nevifell,area-52,575,priest,holy,13,6,7
Kephrek,eonar,575,priest,holy,18,6,12
Därkness,azralon,575,priest,holy,18,6,12
Dundamer,shattered-hand,575,priest,holy,18,6,12
Sêtsunà,dalaran,575,priest,holy,36,6,30
Cassíopeía,blackhand,574,priest,holy,12,6,6
Sacerdetiza,drakkari,574,priest,holy,12,6,6
Laiya,nathrezim,574,priest,holy,15,6,9
Ruhaani,moon-guard,574,priest,holy,18,6,12
Aeoliana,laughing-skull,572,priest,holy,12,6,6
Altara,malygos,569,priest,holy,12,6,6
Zual,hakkar,569,priest,holy,12,6,6
Sanntana,echo-isles,563,priest,holy,24,6,18
Skalzi,thrall,559,priest,holy,11,6,5
París,mannoroth,559,priest,holy,17,6,11
Smellybox,area-52,558,priest,holy,19,7,12
Satíva,dark-iron,543,priest,holy,11,6,5
Eatsoupbro,tichondrius,543,priest,holy,17,6,11
Albina,kelthuzad,526,priest,holy,11,6,5
Jesaminealbe,quelthalas,516,priest,holy,21,7,14
Trupriest,alleria,511,priest,holy,8,6,2
Jâmïè,gurubashi,511,priest,holy,11,6,5
Vandamnation,barthilas,511,priest,holy,14,6,8
Helorren,nagrand,506,priest,holy,20,6,14
Privx,bleeding-hollow,480,priest,holy,6,5,1
Huxleypoo,boulderfist,480,priest,holy,6,5,1
Malpraktice,mugthol,480,priest,holy,6,5,1
Onion,garona,480,priest,holy,6,5,1
Jaaregis,area-52,480,priest,holy,6,5,1
Geartrixy,darkspear,480,priest,holy,6,5,1
Design,frostmourne,480,priest,holy,8,5,3
Toje,korgath,480,priest,holy,13,6,7
Secrèt,tichondrius,480,priest,holy,12,5,7
Meehx,illidan,480,priest,holy,12,5,7
Shadowblazed,arthas,480,priest,holy,12,5,7
Nzkbr,frostmourne,480,priest,holy,12,5,7
Greytness,tichondrius,480,priest,holy,12,5,7
Maelei,ragnaros,480,priest,holy,12,5,7
Anahka,tichondrius,480,priest,holy,12,5,7
Vaibye,dalaran,480,priest,holy,12,5,7
Dumbthott,illidan,480,priest,holy,12,5,7
Timbobaloo,thrall,480,priest,holy,12,5,7
Xeras,ravencrest,480,priest,holy,12,5,7
Turkings,proudmoore,480,priest,holy,12,5,7
Gad,moon-guard,480,priest,holy,12,5,7
Blackoss,sargeras,480,priest,holy,12,5,7
Phatheals,proudmoore,480,priest,holy,12,5,7
Buttercupx,vashj,480,priest,holy,12,5,7
Anomoly,kiljaeden,480,priest,holy,12,5,7
Steve,drakthul,480,priest,holy,12,5,7
Írithyll,sargeras,480,priest,holy,12,5,7
Rysie,winterhoof,480,priest,holy,12,5,7
Bunnykinz,moon-guard,480,priest,holy,12,5,7
Capriestsun,hydraxis,480,priest,holy,12,5,7
Vaíl,wyrmrest-accord,480,priest,holy,12,5,7
Drkwispers,stormrage,480,priest,holy,12,5,7
Chûrch,malganis,480,priest,holy,18,5,13
Holyharlot,sargeras,480,priest,holy,18,5,13
Dankenz,darkspear,480,priest,holy,18,5,13
Halfsorrow,tichondrius,480,priest,holy,18,5,13
Nancynibbler,bleeding-hollow,480,priest,holy,24,5,19
Tmturnt,tichondrius,479,priest,holy,10,5,5
Miganmarkle,sargeras,479,priest,holy,12,5,7
Threreye,sargeras,479,priest,holy,12,5,7
Freshblubear,blood-furnace,479,priest,holy,12,5,7
Dchi,tichondrius,479,priest,holy,12,5,7
Pûrplehaze,aegwynn,479,priest,holy,12,5,7
Mímì,wyrmrest-accord,479,priest,holy,12,5,7
Mythica,gurubashi,479,priest,holy,18,5,13
Pactru,ragnaros,479,priest,holy,18,5,13
Unni,azralon,479,priest,holy,18,5,13
Asuryani,lightbringer,477,priest,holy,12,5,7
Jeraphìm,tichondrius,447,priest,holy,18,9,9
Shadowchárm,bleeding-hollow,447,priest,holy,11,5,6
Enzö,frostmourne,424,priest,holy,21,7,14
Nolar,shadowmoon,415,priest,holy,11,5,6
Ticheals,tichondrius,384,priest,holy,6,4,2
Arcmage,malganis,384,priest,holy,6,4,2
Khallmir,goldrinn,384,priest,holy,6,4,2
Tiestô,tichondrius,384,priest,holy,6,4,2
Xusin,tichondrius,384,priest,holy,6,4,2
Schátten,spirestone,384,priest,holy,6,4,2
Yav,exodar,384,priest,holy,6,4,2
Faukauf,zuljin,384,priest,holy,6,4,2
Thünderbird,area-52,384,priest,holy,6,4,2
Dookieate,destromath,384,priest,holy,6,4,2
Halfdeath,sargeras,384,priest,holy,6,4,2
Chanyt,azralon,384,priest,holy,6,4,2
Zallp,sargeras,384,priest,holy,6,4,2
Patchyemoly,frostmourne,384,priest,holy,6,4,2
Unholywood,lightbringer,384,priest,holy,10,5,5
Döyöuliftbro,tichondrius,384,priest,holy,12,4,8
Spags,nagrand,384,priest,holy,12,4,8
Hoglet,moon-guard,384,priest,holy,12,4,8
Hazzang,tichondrius,384,priest,holy,12,4,8
Yumä,kiljaeden,384,priest,holy,12,4,8
Sätîvá,tichondrius,384,priest,holy,12,4,8
Depressednun,moon-guard,384,priest,holy,12,4,8
Rofrofmu,aegwynn,384,priest,holy,12,4,8
Salyd,onyxia,384,priest,holy,12,4,8
Darknuzs,sargeras,384,priest,holy,12,4,8
Râven,proudmoore,384,priest,holy,12,4,8
Frozencherry,elune,384,priest,holy,12,4,8
Voidrachet,thrall,384,priest,holy,12,4,8
Zapix,tichondrius,384,priest,holy,12,4,8
Carti,bleeding-hollow,384,priest,holy,12,4,8
Ithardtoheal,sargeras,384,priest,holy,12,4,8
Mellow,tichondrius,384,priest,holy,12,4,8
Spshady,aegwynn,384,priest,holy,12,4,8
Cheeseycake,illidan,384,priest,holy,12,4,8
Chambler,aegwynn,384,priest,holy,18,4,14
Aeøns,sargeras,384,priest,holy,18,4,14
Pavle,laughing-skull,384,priest,holy,19,4,15
Fesix,akama,383,priest,holy,6,4,2
Healia,tichondrius,383,priest,holy,12,4,8
Dyianah,wyrmrest-accord,383,priest,holy,12,4,8
Zeruhl,kiljaeden,382,priest,holy,12,4,8
Remixcandoit,malganis,379,priest,holy,12,4,8
Brownsnooter,sargeras,367,priest,holy,11,4,7
Stradey,tichondrius,367,priest,holy,11,4,7
Sharkda,frostmourne,350,priest,holy,17,4,13
Santamuerte,agamaggan,336,priest,holy,15,4,11
Enzö,illidan,327,priest,holy,25,8,17
Rybbukk,wyrmrest-accord,319,priest,holy,11,4,7
Kabutta,stormrage,318,priest,holy,14,4,10
Wubbi,blackrock,288,priest,holy,6,3,3
Vynlanesh,illidan,288,priest,holy,6,3,3
Epicnoobpwnr,sargeras,288,priest,holy,6,3,3
Foreva,lightbringer,288,priest,holy,6,3,3
Trying,ysera,288,priest,holy,6,3,3
Ñÿx,arthas,288,priest,holy,6,3,3
Oohso,chogall,288,priest,holy,6,3,3
Laurens,fenris,288,priest,holy,6,3,3
Yokoshukumeì,aerie-peak,288,priest,holy,6,3,3
Cessar,proudmoore,288,priest,holy,6,3,3
Purgeoften,sargeras,288,priest,holy,6,3,3
Glycol,illidan,288,priest,holy,6,3,3
Kittler,illidan,288,priest,holy,6,3,3
Franquitó,illidan,288,priest,holy,6,3,3
Asatruu,stormrage,288,priest,holy,6,3,3
Arguseonp,proudmoore,288,priest,holy,6,3,3
Barclan,destromath,288,priest,holy,6,3,3
Orderic,ragnaros,288,priest,holy,6,3,3
Sagapriest,hyjal,288,priest,holy,6,3,3
Smiteyducks,stormrage,288,priest,holy,6,3,3
Healdog,thrall,288,priest,holy,6,3,3
Roseriela,moon-guard,288,priest,holy,6,3,3
Shwayp,zuljin,288,priest,holy,6,3,3
Charbosan,gorgonnash,288,priest,holy,6,3,3
Rbmxp,barthilas,288,priest,holy,6,3,3
Zesho,firetree,288,priest,holy,6,3,3
Dividëd,stormrage,288,priest,holy,6,3,3
Matiuca,stormrage,288,priest,holy,6,3,3
Shredh,tichondrius,288,priest,holy,6,3,3
Whitewalls,moonrunner,288,priest,holy,6,3,3
Discountay,burning-legion,288,priest,holy,6,3,3
Opeli,stormrage,288,priest,holy,6,3,3
Mucada,tichondrius,288,priest,holy,6,3,3
Calvisper,thunderlord,288,priest,holy,6,3,3
Bagoheals,area-52,288,priest,holy,6,3,3
Palastiel,hyjal,288,priest,holy,6,3,3
Tseirpyeroc,area-52,288,priest,holy,6,3,3
Ärchangél,tichondrius,288,priest,holy,6,3,3
Kustem,tichondrius,288,priest,holy,6,3,3
Crypthion,emerald-dream,288,priest,holy,6,3,3
Alwaystry,tichondrius,288,priest,holy,6,3,3
Meatguzzler,tichondrius,288,priest,holy,6,3,3
Whehaw,kelthuzad,288,priest,holy,6,3,3
Aardyx,frostmourne,288,priest,holy,6,3,3
Plánemo,azralon,288,priest,holy,6,3,3
Darkmoonsun,frostmourne,288,priest,holy,6,3,3
Grindr,ragnaros,288,priest,holy,6,3,3
Nerfdisc,azralon,288,priest,holy,6,3,3
Deeznuhh,tichondrius,288,priest,holy,6,3,3
Dunrirck,quelthalas,288,priest,holy,6,3,3
Whitezz,frostmourne,288,priest,holy,6,3,3
Lullabya,tichondrius,288,priest,holy,6,3,3
Smalltoad,lightnings-blade,288,priest,holy,6,3,3
Greet,hyjal,288,priest,holy,6,3,3
Zombyrot,tichondrius,288,priest,holy,6,3,3
Muertabella,kiljaeden,288,priest,holy,6,3,3
Iamjakehill,area-52,288,priest,holy,9,4,5
Likelydapper,tichondrius,288,priest,holy,7,3,4
Lifesvr,kiljaeden,288,priest,holy,12,3,9
Holyvulpin,barthilas,288,priest,holy,12,3,9
Lalight,tichondrius,288,priest,holy,12,3,9
Murderballad,tichondrius,288,priest,holy,12,3,9
Healiûm,bleeding-hollow,288,priest,holy,12,3,9
Hòwen,tichondrius,288,priest,holy,12,3,9
Disperse,vashj,288,priest,holy,12,3,9
Sarkozzlol,tichondrius,288,priest,holy,12,3,9
Jichu,blackrock,288,priest,holy,12,3,9
Øliverxp,lightbringer,288,priest,holy,12,3,9
Smitepie,malganis,288,priest,holy,12,3,9
Mushtakraken,mugthol,288,priest,holy,12,3,9
Ísábella,ragnaros,288,priest,holy,12,3,9
Haedn,azralon,288,priest,holy,12,3,9
Zhadowbolts,thrall,288,priest,holy,12,3,9
Irilde,proudmoore,288,priest,holy,12,3,9
Pèngotnerfed,exodar,288,priest,holy,12,3,9
Jezuz,aerie-peak,288,priest,holy,12,3,9
Vyvanse,azuremyst,288,priest,holy,18,3,15
Pringlés,suramar,288,priest,holy,24,3,21
Fìngerbanger,lightnings-blade,287,priest,holy,6,3,3
Korhíl,ragnaros,287,priest,holy,6,3,3
Auradaluz,stormrage,287,priest,holy,12,3,9
Mikeliteo,blades-edge,283,priest,holy,18,3,15
Titò,tichondrius,239,priest,holy,13,4,9
Bofin,stormrage,234,priest,holy,16,4,12
Ftheman,tichondrius,234,priest,holy,17,4,13
Halö,doomhammer,223,priest,holy,14,3,11
Damokek,tichondrius,192,priest,holy,9,3,6
Yevøn,ragnaros,192,priest,holy,6,2,4
Mindgoblin,terokkar,192,priest,holy,6,2,4
Tuulipp,aegwynn,192,priest,holy,6,2,4
Jilt,aerie-peak,192,priest,holy,6,2,4
Dentwo,aggramar,192,priest,holy,6,2,4
Niftÿ,tichondrius,192,priest,holy,6,2,4
Hypodontia,caelestrasz,192,priest,holy,6,2,4
Wagnerr,jubeithos,192,priest,holy,6,2,4
Jakemies,arathor,192,priest,holy,6,2,4
Hansa,ragnaros,192,priest,holy,6,2,4
Lavigne,tichondrius,192,priest,holy,6,2,4
Shemhazai,ragnaros,192,priest,holy,6,2,4
Sensitive,eitrigg,192,priest,holy,6,2,4
Felmnir,ragnaros,192,priest,holy,6,2,4
Invisibler,tichondrius,192,priest,holy,6,2,4
Igotubrah,malganis,192,priest,holy,6,2,4
Mommyafk,moon-guard,192,priest,holy,6,2,4
Karmapi,malganis,192,priest,holy,6,2,4
Dorraheals,tichondrius,192,priest,holy,6,2,4
Schatzié,malganis,192,priest,holy,6,2,4
Belfortx,tichondrius,192,priest,holy,6,2,4
Aeroalisson,azralon,192,priest,holy,6,2,4
Arodar,wyrmrest-accord,192,priest,holy,6,2,4
Gusho,frostmourne,192,priest,holy,6,2,4
Gles,quelthalas,192,priest,holy,6,2,4
Skeemask,moon-guard,192,priest,holy,6,2,4
Mamabless,quelthalas,192,priest,holy,6,2,4
Dëëdëëpants,moon-guard,192,priest,holy,6,2,4
Nodorme,quelthalas,192,priest,holy,6,2,4
Aethriem,bleeding-hollow,192,priest,holy,6,2,4
Verboden,kelthuzad,192,priest,holy,6,2,4
Mitras,moon-guard,192,priest,holy,6,2,4
Starzard,kelthuzad,192,priest,holy,6,2,4
Angelface,darkspear,192,priest,holy,6,2,4
Mutedox,frostmourne,192,priest,holy,6,2,4
Jonhey,tichondrius,192,priest,holy,6,2,4
Drippyjoones,sargeras,192,priest,holy,6,2,4
Keicel,zuljin,192,priest,holy,6,2,4
Whitelabel,proudmoore,192,priest,holy,6,2,4
ßræcher,black-dragonflight,192,priest,holy,6,2,4
Voltstein,dalaran,192,priest,holy,6,2,4
Nikci,tichondrius,192,priest,holy,6,2,4
Opas,rivendare,192,priest,holy,6,2,4
Ôp,sargeras,192,priest,holy,6,2,4
Nonbinary,trollbane,192,priest,holy,6,2,4
Dayatthaspa,stormrage,192,priest,holy,6,2,4
Pandap,dalaran,192,priest,holy,6,2,4
Saenax,area-52,192,priest,holy,6,2,4
Mendx,tichondrius,192,priest,holy,6,2,4
Mizriz,emerald-dream,192,priest,holy,6,2,4
Bilbopriest,illidan,192,priest,holy,6,2,4
Silentprayer,area-52,192,priest,holy,6,2,4
Speyside,medivh,192,priest,holy,6,2,4
Swipathefox,tichondrius,192,priest,holy,6,2,4
Lebwonjamdi,tichondrius,192,priest,holy,6,2,4
Daddyhammer,area-52,192,priest,holy,6,2,4
Prescella,sargeras,192,priest,holy,6,2,4
Mevix,firetree,192,priest,holy,6,2,4
Eblis,the-underbog,192,priest,holy,6,2,4
Saintguard,tichondrius,192,priest,holy,11,3,8
Langyi,tichondrius,192,priest,holy,10,2,8
Nevertelsp,malganis,192,priest,holy,12,2,10
Excellency,tichondrius,192,priest,holy,12,2,10
Fraggydaddy,frostmourne,192,priest,holy,12,2,10
Okitoki,tichondrius,192,priest,holy,12,2,10
Althir,ragnaros,192,priest,holy,12,2,10
Pinoculus,illidan,192,priest,holy,12,2,10
Dawnwind,warsong,192,priest,holy,12,2,10
Bigtizzle,illidan,192,priest,holy,12,2,10
Påticus,area-52,192,priest,holy,13,2,11
Gillís,thrall,192,priest,holy,18,2,16
Postymalone,azgalor,191,priest,holy,6,2,4
Lohila,kiljaeden,191,priest,holy,8,2,6
Sneaks,frostmourne,159,priest,holy,5,2,3
Identìty,moon-guard,138,priest,holy,8,3,5
Sweetvoyeur,stormrage,138,priest,holy,9,3,6
Pumpss,area-52,138,priest,holy,11,3,8
Bigvuqoffdam,area-52,138,priest,holy,16,3,13
Denarel,frostmourne,137,priest,holy,17,4,13
Pasmalade,zuljin,112,priest,holy,7,2,5
Lilpaprika,sargeras,96,priest,holy,6,1,5
Vøido,whisperwind,96,priest,holy,6,1,5
Grasy,ragnaros,96,priest,holy,6,1,5
Shadyvoodoo,barthilas,96,priest,holy,6,1,5
Lerien,thrall,96,priest,holy,6,1,5
Yungmazikeen,proudmoore,96,priest,holy,6,1,5
Acpriest,tichondrius,96,priest,holy,6,1,5
Bofuri,barthilas,96,priest,holy,6,1,5
Majjic,proudmoore,96,priest,holy,6,1,5
Sukmysplooge,queldorei,96,priest,holy,6,1,5
Dontgome,proudmoore,96,priest,holy,6,1,5
Tammyone,emerald-dream,96,priest,holy,6,1,5
Janova,tichondrius,96,priest,holy,6,1,5
Luciellis,sargeras,96,priest,holy,6,1,5
Missjules,illidan,96,priest,holy,6,1,5
Kastwalker,earthen-ring,96,priest,holy,6,1,5
Angelicduck,illidan,96,priest,holy,6,1,5
Thorzan,eredar,96,priest,holy,6,1,5
Kagura,dunemaul,96,priest,holy,6,1,5
Minamy,tichondrius,96,priest,holy,6,1,5
Hubbabubble,wyrmrest-accord,96,priest,holy,6,1,5
Alëssana,illidan,96,priest,holy,6,1,5
Rakel,nathrezim,96,priest,holy,6,1,5
Deryus,dalaran,96,priest,holy,6,1,5
Viehweg,azralon,96,priest,holy,6,1,5
Tuuros,wyrmrest-accord,96,priest,holy,6,1,5
Voodooloa,tichondrius,96,priest,holy,6,1,5
Burpees,dalaran,96,priest,holy,6,1,5
Bloodcure,ysera,96,priest,holy,6,1,5
Thotsteal,lightbringer,96,priest,holy,6,1,5
Hiroshikun,azshara,96,priest,holy,6,1,5
Dietcokee,stormrage,96,priest,holy,6,1,5
Chrystella,nagrand,96,priest,holy,6,1,5
Yungsherm,tichondrius,96,priest,holy,6,1,5
Bunked,bleeding-hollow,96,priest,holy,6,1,5
Olassi,stormrage,96,priest,holy,6,1,5
Lasaldra,quelthalas,96,priest,holy,6,1,5
Sarïya,moon-guard,96,priest,holy,6,1,5
Alaskaa,moon-guard,96,priest,holy,6,1,5
Milkymana,tichondrius,96,priest,holy,6,1,5
Burtier,zuljin,96,priest,holy,6,1,5
Akami,tichondrius,96,priest,holy,6,1,5
Hottaters,tichondrius,96,priest,holy,6,1,5
Tichealstwo,tichondrius,96,priest,holy,6,1,5
Bigboyadam,frostmourne,96,priest,holy,6,1,5
Alvorr,ragnaros,96,priest,holy,6,1,5
Novoul,stormrage,96,priest,holy,6,1,5
Faithmelter,stormrage,96,priest,holy,6,1,5
Hüde,stormrage,96,priest,holy,6,1,5
Djriest,sargeras,96,priest,holy,12,1,11
Gutrose,area-52,96,priest,holy,12,1,11
Donmartin,tichondrius,96,priest,holy,12,1,11
Barryp,wyrmrest-accord,96,priest,holy,12,1,11
Wiralyn,nathrezim,79,priest,holy,11,1,10
Undrcvr,sargeras,2273,priest,discipline,132,73,59
Èfflux,sargeras,2257,priest,discipline,103,61,42
Whammiez,tichondrius,2243,priest,discipline,84,50,34
Gentlewoman,ragnaros,2236,priest,discipline,93,56,37
Strickmaney,nathrezim,2157,priest,discipline,294,156,138
Pesian,dalaran,2153,priest,discipline,233,121,112
Yefri,ravencrest,2147,priest,discipline,201,114,87
Reedyjrrtv,tichondrius,2145,priest,discipline,168,88,80
Cinnamontage,illidan,2142,priest,discipline,114,64,50
Castsmite,tichondrius,2141,priest,discipline,99,52,47
Solecíto,ragnaros,2138,priest,discipline,165,106,59
Shikinomi,illidan,2133,priest,discipline,78,46,32
Shazdo,illidan,2128,priest,discipline,66,44,22
Reecepack,moon-guard,2126,priest,discipline,89,49,40
Wcnmb,blackrock,2123,priest,discipline,72,46,26
Jiangfeng,tichondrius,2120,priest,discipline,72,37,35
Devinere,tichondrius,2119,priest,discipline,580,317,263
Celestiah,kelthuzad,2119,priest,discipline,72,37,35
Zxxkawaii,tichondrius,2118,priest,discipline,169,90,79
Rukiyou,frostwolf,2117,priest,discipline,210,105,105
Baldzx,sargeras,2116,priest,discipline,292,160,132
Idkmyname,proudmoore,2115,priest,discipline,76,40,36
Nusrah,tichondrius,2114,priest,discipline,87,45,42
Twocrshort,area-52,2112,priest,discipline,185,110,75
Frksake,area-52,2111,priest,discipline,192,114,78
Sylvphrena,stormrage,2111,priest,discipline,78,42,36
Klydasoreass,malganis,2107,priest,discipline,83,47,36
Kovulol,area-52,2107,priest,discipline,126,67,59
Néylo,illidan,2106,priest,discipline,112,56,56
Psyches,dalaran,2106,priest,discipline,109,50,59
Kkelly,stormrage,2105,priest,discipline,257,131,126
Amberturd,cenarius,2103,priest,discipline,102,48,54
Woolp,frostmourne,2102,priest,discipline,100,58,42
Changwongpk,kelthuzad,2101,priest,discipline,237,124,113
Søryn,madoran,2100,priest,discipline,108,55,53
Veivei,tichondrius,2095,priest,discipline,59,38,21
Proxs,sargeras,2079,priest,discipline,234,121,113
Ante,stonemaul,2075,priest,discipline,108,59,49
Pancakeboi,tichondrius,2070,priest,discipline,131,64,67
Cosmicyiff,area-52,2062,priest,discipline,212,115,97
Classmaster,stormrage,2054,priest,discipline,183,100,83
Soupbean,zuljin,2046,priest,discipline,90,45,45
Esqueue,illidan,2044,priest,discipline,54,26,28
Leorid,stormrage,2043,priest,discipline,196,99,97
Veiveilol,tichondrius,2038,priest,discipline,89,42,47
Lemonmint,tichondrius,2035,priest,discipline,154,76,78
Clearclouds,tichondrius,2025,priest,discipline,332,176,156
Astroverse,tichondrius,2024,priest,discipline,118,67,51
Crutched,blackhand,2022,priest,discipline,60,35,25
Bholebender,tichondrius,2022,priest,discipline,101,50,51
Zámmy,area-52,2021,priest,discipline,65,44,21
Praemal,tichondrius,2017,priest,discipline,102,47,55
Blessxo,ragnaros,2016,priest,discipline,96,45,51
Mauvex,stormrage,2014,priest,discipline,631,307,324
Eluneslight,tichondrius,2012,priest,discipline,108,55,53
Poporeborn,tichondrius,2012,priest,discipline,247,124,123
Instoway,illidan,2011,priest,discipline,168,98,70
Houseaddict,illidan,2011,priest,discipline,109,60,49
Adûnaic,frostmourne,2011,priest,discipline,463,232,231
Rmpmeeper,kilrogg,2008,priest,discipline,132,72,60
Jiangfenglol,tichondrius,2006,priest,discipline,156,74,82
Reilacoste,moon-guard,2002,priest,discipline,83,41,42
Sÿnpriest,illidan,2000,priest,discipline,426,209,217
Xajen,illidan,1996,priest,discipline,84,39,45
Nucypher,illidan,1993,priest,discipline,204,118,86
Boykoz,zuljin,1990,priest,discipline,163,84,79
Markers,spinebreaker,1989,priest,discipline,130,64,66
Sinthe,stormrage,1987,priest,discipline,59,34,25
Jakemies,arathor,1983,priest,discipline,96,52,44
Nerfthedoc,blackrock,1981,priest,discipline,79,46,33
Crabsp,illidan,1981,priest,discipline,132,68,64
Smokezter,area-52,1981,priest,discipline,159,81,78
Crutch,blackhand,1980,priest,discipline,54,30,24
Etharass,illidan,1976,priest,discipline,84,36,48
Dayx,malganis,1975,priest,discipline,108,54,54
Høwtokill,azralon,1975,priest,discipline,179,83,96
Néy,illidan,1974,priest,discipline,78,54,24
Fhenomenal,tichondrius,1972,priest,discipline,126,57,69
Cklifer,tichondrius,1970,priest,discipline,58,33,25
Azzäm,tichondrius,1970,priest,discipline,90,48,42
Goodlife,frostmourne,1967,priest,discipline,71,34,37
Robdàwg,illidan,1966,priest,discipline,78,39,39
Kayern,kelthuzad,1965,priest,discipline,58,38,20
Fannyny,tichondrius,1965,priest,discipline,202,116,86
Peruggia,tichondrius,1965,priest,discipline,157,79,78
Jthealz,tichondrius,1962,priest,discipline,72,36,36
Muhfinx,tichondrius,1961,priest,discipline,65,38,27
Aratis,bleeding-hollow,1961,priest,discipline,90,44,46
Stinkiez,area-52,1956,priest,discipline,207,116,91
Hospetal,tichondrius,1955,priest,discipline,146,74,72
Ogneus,crushridge,1955,priest,discipline,75,35,40
Curachon,darkspear,1953,priest,discipline,105,48,57
Awàken,sargeras,1952,priest,discipline,57,35,22
Sonicboomsz,azralon,1952,priest,discipline,128,64,64
Iilmama,area-52,1948,priest,discipline,105,55,50
Miamama,hydraxis,1946,priest,discipline,165,88,77
Hairyleg,kelthuzad,1946,priest,discipline,78,36,42
Deathblind,kelthuzad,1945,priest,discipline,95,48,47
Wapriest,blades-edge,1943,priest,discipline,581,294,287
Gosharbg,tichondrius,1940,priest,discipline,34,24,10
Amine,tichondrius,1940,priest,discipline,108,55,53
Sarkozzlol,tichondrius,1938,priest,discipline,84,43,41
Mimz,trollbane,1936,priest,discipline,172,88,84
Praeyer,area-52,1936,priest,discipline,386,196,190
Penanceperry,bleeding-hollow,1936,priest,discipline,292,141,151
Supaflute,tichondrius,1935,priest,discipline,102,47,55
Plaedo,stormscale,1932,priest,discipline,52,28,24
Fádé,illidan,1932,priest,discipline,97,48,49
Noted,aegwynn,1931,priest,discipline,158,101,57
Namilol,tichondrius,1931,priest,discipline,54,30,24
Darkvss,illidan,1929,priest,discipline,72,39,33
Donmartin,tichondrius,1929,priest,discipline,94,50,44
Kalyndaxo,frostmourne,1928,priest,discipline,102,51,51
Budings,tichondrius,1927,priest,discipline,143,77,66
Velftrixi,sargeras,1927,priest,discipline,180,94,86
Stepxo,sargeras,1925,priest,discipline,129,68,61
Hectorz,zuljin,1925,priest,discipline,136,62,74
Ccgo,tichondrius,1924,priest,discipline,142,72,70
Alisas,malganis,1924,priest,discipline,190,90,100
Balsak,zuljin,1924,priest,discipline,152,72,80
Antts,tichondrius,1922,priest,discipline,60,39,21
Lovelike,tichondrius,1922,priest,discipline,74,41,33
Invincible,ragnaros,1919,priest,discipline,94,51,43
Diabloluckie,tichondrius,1919,priest,discipline,120,62,58
Vinnydiesel,tichondrius,1918,priest,discipline,66,32,34
Likethis,ragnaros,1916,priest,discipline,484,246,238
Fotmvark,stormrage,1916,priest,discipline,78,36,42
Evicereith,ragnaros,1915,priest,discipline,54,29,25
Yeeseafood,tichondrius,1913,priest,discipline,76,34,42
Anasuzana,stormrage,1911,priest,discipline,66,38,28
Artíst,sargeras,1911,priest,discipline,119,64,55
Rawze,tichondrius,1911,priest,discipline,93,44,49
Varenon,stormrage,1910,priest,discipline,159,90,69
Tinyheal,sargeras,1910,priest,discipline,202,109,93
Bearfriend,malorne,1910,priest,discipline,58,30,28
Qipriest,tichondrius,1909,priest,discipline,90,40,50
Shallwedance,tichondrius,1906,priest,discipline,86,50,36
Omhz,tichondrius,1905,priest,discipline,96,49,47
Cosenzza,tichondrius,1905,priest,discipline,78,37,41
Snackermz,tichondrius,1905,priest,discipline,136,61,75
Sabalonely,tichondrius,1904,priest,discipline,54,24,30
Dairy,the-underbog,1902,priest,discipline,61,37,24
Aitri,hakkar,1902,priest,discipline,193,94,99
Fotmtrash,the-underbog,1897,priest,discipline,48,26,22
Praitne,tichondrius,1897,priest,discipline,119,59,60
Riseandshine,illidan,1896,priest,discipline,54,38,16
Pølupoker,illidan,1895,priest,discipline,59,27,32
Boriz,frostmourne,1892,priest,discipline,79,44,35
Zerorizz,tichondrius,1890,priest,discipline,42,20,22
Ndzy,malganis,1890,priest,discipline,48,21,27
Niniua,tichondrius,1887,priest,discipline,47,25,22
Eudog,zuljin,1886,priest,discipline,24,20,4
Athênå,tichondrius,1886,priest,discipline,192,110,82
Haunting,nerzhul,1886,priest,discipline,209,103,106
Discopenguin,kelthuzad,1885,priest,discipline,60,34,26
Usefirstaid,sargeras,1883,priest,discipline,42,26,16
Grimacê,sargeras,1883,priest,discipline,122,62,60
Cupitan,tichondrius,1883,priest,discipline,62,27,35
Drnn,thrall,1882,priest,discipline,132,70,62
Abt,proudmoore,1882,priest,discipline,66,31,35
Usedwrap,sargeras,1881,priest,discipline,78,43,35
Throatgoated,moon-guard,1881,priest,discipline,47,21,26
Rubymisfit,sargeras,1881,priest,discipline,84,37,47
Xiaoqunzi,tichondrius,1879,priest,discipline,167,81,86
Hugemilkys,tichondrius,1878,priest,discipline,136,77,59
Cremona,tichondrius,1878,priest,discipline,84,39,45
Jangbi,tichondrius,1877,priest,discipline,76,33,43
Breakmoon,tichondrius,1876,priest,discipline,78,33,45
Chee,bleeding-hollow,1875,priest,discipline,72,39,33
Sñ,illidan,1874,priest,discipline,48,27,21
Reydehaiti,ragnaros,1874,priest,discipline,247,121,126
Rileymcgerr,tichondrius,1873,priest,discipline,42,24,18
Fordranger,frostmourne,1873,priest,discipline,64,32,32
Redonkulos,wyrmrest-accord,1873,priest,discipline,210,102,108
Dellaptop,sargeras,1871,priest,discipline,88,51,37
Capcana,tichondrius,1871,priest,discipline,140,74,66
Hadoka,ragnaros,1871,priest,discipline,66,29,37
Renfury,bleeding-hollow,1869,priest,discipline,54,25,29
Montagehey,illidan,1868,priest,discipline,83,43,40
ßeyonder,tichondrius,1868,priest,discipline,146,69,77
Layons,nemesis,1867,priest,discipline,146,93,53
Candyshack,area-52,1867,priest,discipline,117,66,51
Lidoradra,zuljin,1867,priest,discipline,77,36,41
Walterwhite,bleeding-hollow,1867,priest,discipline,48,22,26
Bkwhopper,emerald-dream,1866,priest,discipline,239,130,109
Meloxicamm,tichondrius,1866,priest,discipline,233,118,115
Notatk,tichondrius,1866,priest,discipline,221,99,122
Wheresmyvape,tichondrius,1865,priest,discipline,38,22,16
Xtcbtc,sargeras,1865,priest,discipline,99,50,49
Tiestô,tichondrius,1864,priest,discipline,48,29,19
Pitayakiller,tichondrius,1864,priest,discipline,59,32,27
Syllè,area-52,1864,priest,discipline,54,27,27
Shugelol,tichondrius,1862,priest,discipline,30,21,9
Rèvrin,sargeras,1862,priest,discipline,114,56,58
Spoõks,darkspear,1862,priest,discipline,141,69,72
Tormybew,illidan,1861,priest,discipline,53,29,24
Cokeheals,tichondrius,1861,priest,discipline,60,29,31
Eyolo,tichondrius,1860,priest,discipline,144,70,74
Bubblekanush,tichondrius,1859,priest,discipline,36,22,14
Quaree,stormrage,1859,priest,discipline,716,366,350
Thefiveoh,malganis,1858,priest,discipline,62,38,24
Usebindwound,sargeras,1857,priest,discipline,108,65,43
Highskrizzle,thrall,1857,priest,discipline,67,37,30
Duw,icecrown,1857,priest,discipline,151,75,76
Phludd,malganis,1856,priest,discipline,82,45,37
Ravnica,kelthuzad,1856,priest,discipline,82,43,39
Pregnantmale,area-52,1856,priest,discipline,214,112,102
Mumrah,antonidas,1856,priest,discipline,148,71,77
Presence,blood-furnace,1855,priest,discipline,42,23,19
Vànhendrix,tichondrius,1855,priest,discipline,59,32,27
Shadey,onyxia,1855,priest,discipline,54,26,28
Nayzoh,darkspear,1855,priest,discipline,78,37,41
Vidzar,area-52,1854,priest,discipline,42,28,14
Drsquiddy,tichondrius,1854,priest,discipline,47,30,17
Stayspooked,moon-guard,1852,priest,discipline,54,31,23
Jtheals,illidan,1852,priest,discipline,35,20,15
Yaksa,proudmoore,1852,priest,discipline,78,35,43
Centalinkxo,frostmourne,1851,priest,discipline,72,36,36
Curney,stormrage,1850,priest,discipline,71,51,20
Joezyxz,tichondrius,1850,priest,discipline,210,111,99
Shieldspamx,tichondrius,1850,priest,discipline,89,41,48
Mautmaut,quelthalas,1849,priest,discipline,77,53,24
Whiterhino,spirestone,1849,priest,discipline,67,32,35
Corvenna,zuljin,1848,priest,discipline,60,33,27
Lumies,tichondrius,1848,priest,discipline,42,21,21
Polarnight,zuljin,1848,priest,discipline,59,29,30
Paidtowin,frostmourne,1848,priest,discipline,68,30,38
Chiot,tichondrius,1847,priest,discipline,71,55,16
Bigshieldlol,illidan,1847,priest,discipline,60,39,21
Chromielol,tichondrius,1847,priest,discipline,54,31,23
Tzïñåçåñ,tichondrius,1847,priest,discipline,54,29,25
Didy,dark-iron,1847,priest,discipline,82,39,43
Voidnoodles,area-52,1846,priest,discipline,60,32,28
Ultradumb,ragnaros,1846,priest,discipline,42,21,21
Jmjeezy,tichondrius,1846,priest,discipline,48,22,26
Leonilcx,tichondrius,1845,priest,discipline,902,456,446
Koalakazamzy,shadow-council,1845,priest,discipline,58,29,29
Gotdro,kelthuzad,1845,priest,discipline,80,39,41
Quèénstar,tichondrius,1845,priest,discipline,85,35,50
Cavityx,illidan,1844,priest,discipline,52,30,22
Troja,malganis,1843,priest,discipline,78,43,35
Steelcity,tichondrius,1843,priest,discipline,54,28,26
Dacine,illidan,1843,priest,discipline,60,30,30
Bubbliez,frostmourne,1843,priest,discipline,59,28,31
Nickydamous,moon-guard,1843,priest,discipline,66,31,35
Fearmen,tichondrius,1842,priest,discipline,83,48,35
Anyra,stormrage,1842,priest,discipline,57,29,28
Zelená,trollbane,1841,priest,discipline,128,77,51
Vampirê,tichondrius,1841,priest,discipline,66,35,31
Kck,sentinels,1841,priest,discipline,95,44,51
Meoveryou,stormrage,1840,priest,discipline,92,50,42
Syliva,frostmourne,1840,priest,discipline,65,30,35
Donutpriest,kelthuzad,1839,priest,discipline,78,44,34
Inquisitionx,frostmourne,1839,priest,discipline,283,156,127
Koalakazamza,shadow-council,1839,priest,discipline,62,28,34
Katalad,wyrmrest-accord,1838,priest,discipline,66,40,26
Drtyror,area-52,1838,priest,discipline,191,109,82
Tistapriest,proudmoore,1837,priest,discipline,70,41,29
Waggers,moon-guard,1837,priest,discipline,42,23,19
Lotion,icecrown,1837,priest,discipline,48,25,23
Tmversace,tichondrius,1837,priest,discipline,123,64,59
Rayllyn,bleeding-hollow,1836,priest,discipline,30,22,8
Miraclesoul,tichondrius,1836,priest,discipline,38,26,12
Hairypenance,sargeras,1836,priest,discipline,72,39,33
Testzpriests,dalaran,1836,priest,discipline,42,22,20
Celestiah,illidan,1836,priest,discipline,60,30,30
Wpj,barthilas,1836,priest,discipline,93,41,52
Binipriest,tichondrius,1835,priest,discipline,67,40,27
Jamino,jubeithos,1835,priest,discipline,111,60,51
Tmeugene,tichondrius,1835,priest,discipline,40,21,19
Icychain,area-52,1835,priest,discipline,76,34,42
Bugweeb,sargeras,1834,priest,discipline,87,56,31
Twopiece,blackrock,1834,priest,discipline,54,31,23
Rÿzo,tichondrius,1834,priest,discipline,111,63,48
Thottsteal,queldorei,1834,priest,discipline,60,31,29
June,dragonmaw,1834,priest,discipline,60,30,30
Angelforcez,frostmourne,1834,priest,discipline,53,23,30
Rigxy,arthas,1833,priest,discipline,147,92,55
Ameliarys,sargeras,1833,priest,discipline,103,51,52
Jadon,sargeras,1832,priest,discipline,54,42,12
Sons,zuljin,1832,priest,discipline,54,29,25
Oloriinn,stormrage,1831,priest,discipline,36,24,12
Antagzy,bleeding-hollow,1830,priest,discipline,108,69,39
Msai,tichondrius,1830,priest,discipline,114,68,46
Yotinha,stormrage,1830,priest,discipline,48,28,20
Pzx,zuljin,1830,priest,discipline,54,31,23
Obsolete,area-52,1830,priest,discipline,60,33,27
Strvnge,malganis,1830,priest,discipline,60,28,32
Faeleath,emerald-dream,1830,priest,discipline,80,37,43
Veejae,tichondrius,1829,priest,discipline,54,29,25
Cpks,tichondrius,1828,priest,discipline,76,48,28
Baphomet,hyjal,1828,priest,discipline,88,53,35
Misatomori,tichondrius,1828,priest,discipline,54,28,26
Epitoh,bleeding-hollow,1828,priest,discipline,78,36,42
Sleetherp,barthilas,1827,priest,discipline,64,37,27
Fishondabeat,proudmoore,1827,priest,discipline,42,23,19
Fracxured,sargeras,1827,priest,discipline,68,31,37
Bohomagz,tichondrius,1826,priest,discipline,42,24,18
Haduth,area-52,1826,priest,discipline,272,148,124
Bloodyxx,bleeding-hollow,1825,priest,discipline,34,23,11
Buffle,zuluhed,1825,priest,discipline,66,38,28
Yokuz,thunderlord,1825,priest,discipline,48,26,22
Mackulate,tichondrius,1825,priest,discipline,65,34,31
Cokeheals,kelthuzad,1825,priest,discipline,54,28,26
Mancito,mannoroth,1825,priest,discipline,174,90,84
Aprîl,quelthalas,1825,priest,discipline,72,37,35
Däzzlë,quelthalas,1825,priest,discipline,72,35,37
Pnsp,perenolde,1824,priest,discipline,42,30,12
Xholyshietz,emerald-dream,1824,priest,discipline,71,48,23
Pervysaged,sargeras,1824,priest,discipline,60,40,20
Archìtects,wyrmrest-accord,1824,priest,discipline,108,68,40
Clockwororan,tichondrius,1824,priest,discipline,84,50,34
Cya,deathwing,1824,priest,discipline,54,30,24
Zygotes,tichondrius,1824,priest,discipline,39,21,18
Deadpla,ragnaros,1824,priest,discipline,143,73,70
Temérios,azralon,1824,priest,discipline,60,30,30
Aethestan,zuljin,1824,priest,discipline,102,50,52
Tuxen,wyrmrest-accord,1823,priest,discipline,48,29,19
Swurvexo,bleeding-hollow,1823,priest,discipline,47,28,19
Guiila,azralon,1823,priest,discipline,71,38,33
Barthol,malygos,1823,priest,discipline,225,115,110
Sprankels,bleeding-hollow,1823,priest,discipline,108,55,53
Abepriest,zuljin,1823,priest,discipline,232,113,119
Luhkx,stormrage,1823,priest,discipline,54,25,29
Fallspriest,frostmourne,1822,priest,discipline,42,25,17
Lands,ragnaros,1822,priest,discipline,120,69,51
Memoria,emerald-dream,1822,priest,discipline,117,60,57
Ggwizkaboo,tichondrius,1822,priest,discipline,60,30,30
Zachon,sargeras,1822,priest,discipline,54,27,27
Bamboon,tanaris,1821,priest,discipline,150,79,71
Rerollpriest,firetree,1821,priest,discipline,53,25,28
Ultrà,ragnaros,1820,priest,discipline,71,44,27
Wreklol,tichondrius,1820,priest,discipline,60,34,26
Dietcokee,stormrage,1820,priest,discipline,62,31,31
Ujelin,kiljaeden,1820,priest,discipline,48,24,24
Tophr,illidan,1819,priest,discipline,41,24,17
Vinvictus,tichondrius,1819,priest,discipline,444,227,217
Chk,moon-guard,1819,priest,discipline,136,65,71
Saviorlol,tichondrius,1819,priest,discipline,65,31,34
Soojwa,frostmourne,1819,priest,discipline,54,24,30
Summersetisl,tichondrius,1818,priest,discipline,72,31,41
Novel,moon-guard,1817,priest,discipline,30,24,6
Despairx,tichondrius,1817,priest,discipline,102,66,36
Guerisser,hyjal,1817,priest,discipline,176,104,72
Gaudthree,tichondrius,1817,priest,discipline,46,25,21
Exdric,kiljaeden,1817,priest,discipline,108,51,57
Akuzaki,illidan,1817,priest,discipline,54,25,29
Sliktrik,area-52,1817,priest,discipline,65,29,36
Dapp,barthilas,1817,priest,discipline,77,33,44
Cynthus,dalvengyr,1816,priest,discipline,102,60,42
Lichtschreit,zuljin,1816,priest,discipline,41,24,17
Juicyturon,moon-guard,1816,priest,discipline,77,45,32
Dispassion,dalaran,1816,priest,discipline,58,33,25
Zulazane,azralon,1816,priest,discipline,378,207,171
Tryfekta,frostmourne,1816,priest,discipline,114,62,52
Woodowl,tichondrius,1816,priest,discipline,46,25,21
Kragenn,malganis,1816,priest,discipline,195,103,92
Jackski,nemesis,1816,priest,discipline,48,25,23
Hideonlight,barthilas,1816,priest,discipline,645,332,313
Legendary,ragnaros,1816,priest,discipline,78,33,45
Mødilon,nemesis,1815,priest,discipline,47,29,18
Rythmzz,kiljaeden,1815,priest,discipline,108,59,49
Engle,arathor,1815,priest,discipline,42,22,20
Selenitax,sargeras,1815,priest,discipline,104,52,52
Badnsweaty,sargeras,1815,priest,discipline,76,38,38
Ousïa,quelthalas,1815,priest,discipline,164,81,83
Mommyafk,moon-guard,1815,priest,discipline,54,25,29
Myeryc,frostmourne,1815,priest,discipline,53,21,32
Diwara,ragnaros,1814,priest,discipline,60,37,23
Fullmetals,azralon,1814,priest,discipline,53,30,23
Memoriesorz,tichondrius,1814,priest,discipline,553,294,259
Zuwukey,kirin-tor,1814,priest,discipline,163,85,78
Tanmo,illidan,1814,priest,discipline,96,50,46
Fibbre,tichondrius,1814,priest,discipline,121,54,67
Razdaz,twisting-nether,1814,priest,discipline,66,29,37
Relicx,firetree,1813,priest,discipline,54,33,21
Youhealme,area-52,1813,priest,discipline,90,54,36
Hoonjojjyang,tichondrius,1813,priest,discipline,66,37,29
Morboo,proudmoore,1813,priest,discipline,78,43,35
Svzy,illidan,1813,priest,discipline,48,26,22
Wandynha,nemesis,1813,priest,discipline,119,63,56
Crypcanheal,sargeras,1813,priest,discipline,551,277,274
Sasha,muradin,1813,priest,discipline,142,70,72
Sixfourtank,tichondrius,1813,priest,discipline,53,26,27
Falsity,kelthuzad,1813,priest,discipline,66,32,34
Ahoy,sargeras,1812,priest,discipline,75,46,29
Heart,misha,1812,priest,discipline,150,84,66
Abstention,area-52,1812,priest,discipline,66,35,31
Cardinaldave,frostmourne,1812,priest,discipline,54,28,26
Tiernocookie,illidan,1812,priest,discipline,466,235,231
Fatbellyx,sargeras,1812,priest,discipline,72,36,36
Iyoui,tichondrius,1811,priest,discipline,42,28,14
Tyrrshadow,skywall,1811,priest,discipline,104,58,46
Tallïa,stormrage,1811,priest,discipline,155,82,73
Louisé,hydraxis,1811,priest,discipline,90,46,44
Cellestine,aggramar,1811,priest,discipline,157,80,77
Olark,durotan,1811,priest,discipline,423,209,214
Wübbie,emerald-dream,1810,priest,discipline,72,40,32
Trengodqt,destromath,1810,priest,discipline,235,129,106
Pawnza,tichondrius,1810,priest,discipline,120,65,55
Paytin,illidan,1810,priest,discipline,71,32,39
Arguseonp,proudmoore,1809,priest,discipline,54,37,17
Ãbelladanger,area-52,1809,priest,discipline,65,43,22
Jemine,tichondrius,1809,priest,discipline,108,64,44
Scrollozaddy,illidan,1809,priest,discipline,306,181,125
Thepumps,sargeras,1809,priest,discipline,73,43,30
Paramour,laughing-skull,1809,priest,discipline,108,59,49
Jaquels,area-52,1809,priest,discipline,130,65,65
Cearáa,azralon,1809,priest,discipline,65,32,33
Thedude,spirestone,1809,priest,discipline,71,34,37
Varbirttok,sargeras,1809,priest,discipline,61,29,32
Dabaojian,tichondrius,1809,priest,discipline,60,28,32
Aube,frostmourne,1809,priest,discipline,51,23,28
Nudithree,malganis,1808,priest,discipline,38,26,12
Vbear,dunemaul,1808,priest,discipline,71,39,32
Shadowcakes,tichondrius,1808,priest,discipline,60,32,28
Pkkdestiny,archimonde,1808,priest,discipline,71,37,34
Catbabyorz,tichondrius,1808,priest,discipline,84,41,43
Pns,perenolde,1808,priest,discipline,66,32,34
Buhroketwo,thrall,1807,priest,discipline,66,41,25
Marcìano,bleeding-hollow,1807,priest,discipline,85,49,36
Dopeypriest,area-52,1807,priest,discipline,120,68,52
Nomsayin,stormrage,1806,priest,discipline,48,32,16
Gices,area-52,1806,priest,discipline,36,24,12
Exøtic,tichondrius,1806,priest,discipline,54,35,19
Ayakashi,frostmourne,1806,priest,discipline,75,46,29
Wormface,moon-guard,1806,priest,discipline,58,35,23
Senzy,tichondrius,1806,priest,discipline,150,81,69
Releriel,area-52,1806,priest,discipline,58,31,27
Ðiscipline,kelthuzad,1806,priest,discipline,253,134,119
Inthemix,stormreaver,1806,priest,discipline,376,197,179
Yezhua,zuljin,1806,priest,discipline,84,44,40
Danceslol,area-52,1806,priest,discipline,59,28,31
Purplebeauty,tichondrius,1805,priest,discipline,198,119,79
Bonigan,sargeras,1805,priest,discipline,197,118,79
Rylla,illidan,1805,priest,discipline,66,34,32
Deathwisher,illidan,1805,priest,discipline,251,127,124
Maghobou,tichondrius,1805,priest,discipline,66,30,36
Öxhö,tichondrius,1804,priest,discipline,44,31,13
Ðsco,tichondrius,1804,priest,discipline,36,24,12
Absorbs,stormrage,1804,priest,discipline,30,19,11
Selath,ragnaros,1804,priest,discipline,47,26,21
Angelumlucis,frostmane,1804,priest,discipline,145,80,65
Syrillia,wildhammer,1804,priest,discipline,142,78,64
Barrenbuffet,zuljin,1804,priest,discipline,272,136,136
Cln,bleeding-hollow,1804,priest,discipline,65,32,33
Taipriest,frostmourne,1804,priest,discipline,222,103,119
Jinais,zuluhed,1803,priest,discipline,48,33,15
Phillthevoid,sargeras,1803,priest,discipline,45,29,16
Applecare,illidan,1803,priest,discipline,102,60,42
Tarlex,illidan,1803,priest,discipline,168,94,74
Goldsunx,emerald-dream,1803,priest,discipline,152,85,67
Tjphess,zuljin,1803,priest,discipline,240,130,110
Luciuz,tichondrius,1803,priest,discipline,84,45,39
Cbalnom,tichondrius,1803,priest,discipline,70,37,33
Sußlime,frostwolf,1803,priest,discipline,90,47,43
Criil,area-52,1803,priest,discipline,42,19,23
Manyhot,tichondrius,1802,priest,discipline,51,32,19
Yrñwiotøø,illidan,1802,priest,discipline,54,33,21
Bmouth,tichondrius,1802,priest,discipline,102,59,43
Dijkstracted,ragnaros,1802,priest,discipline,187,106,81
Reignen,tichondrius,1802,priest,discipline,183,101,82
Seifong,frostmourne,1802,priest,discipline,125,68,57
Deathallpoly,tichondrius,1802,priest,discipline,431,227,204
Ritzzx,ragnaros,1802,priest,discipline,107,55,52
Retardèr,tichondrius,1801,priest,discipline,97,68,29
Reverendtun,area-52,1801,priest,discipline,83,55,28
Merit,emerald-dream,1801,priest,discipline,165,92,73
Sinday,zuljin,1801,priest,discipline,72,38,34
Wânda,tichondrius,1801,priest,discipline,111,57,54
Lípjju,tichondrius,1801,priest,discipline,54,24,30
Geekynerd,frostmourne,1800,priest,discipline,151,98,53
Bigmomcook,tichondrius,1800,priest,discipline,215,125,90
Imissdave,dethecus,1800,priest,discipline,48,27,21
Narakku,sargeras,1800,priest,discipline,108,59,49
Holyhõ,stormrage,1800,priest,discipline,60,32,28
Bwgyx,area-52,1800,priest,discipline,42,22,20
Bibleblak,stormrage,1800,priest,discipline,102,53,49
Alola,illidan,1800,priest,discipline,135,69,66
Shamáng,tichondrius,1800,priest,discipline,152,73,79
Shenanígans,malganis,1800,priest,discipline,42,19,23
Bomí,tichondrius,1799,priest,discipline,84,41,43
Fearinoculúm,bleeding-hollow,1798,priest,discipline,24,19,5
Thaldrum,tichondrius,1798,priest,discipline,91,36,55
Vaaynee,ragnaros,1797,priest,discipline,114,61,53
Secondes,azralon,1797,priest,discipline,36,19,17
Comebaack,stormrage,1797,priest,discipline,98,51,47
Horzp,bleeding-hollow,1797,priest,discipline,72,32,40
Jaytee,aggramar,1796,priest,discipline,78,38,40
Impvp,tichondrius,1795,priest,discipline,89,49,40
Marython,tichondrius,1794,priest,discipline,148,76,72
Wormclergy,tichondrius,1794,priest,discipline,92,45,47
Holyster,tichondrius,1794,priest,discipline,50,24,26
Onikûdaki,sargeras,1794,priest,discipline,59,27,32
Frostinal,illidan,1793,priest,discipline,226,116,110
Fancydisc,barthilas,1792,priest,discipline,36,23,13
Topbruv,tichondrius,1792,priest,discipline,60,36,24
Lesx,tichondrius,1791,priest,discipline,66,36,30
Dipadre,azralon,1790,priest,discipline,102,72,30
Nearo,barthilas,1789,priest,discipline,77,37,40
Ryno,cenarion-circle,1788,priest,discipline,80,43,37
Kostantina,kelthuzad,1788,priest,discipline,184,86,98
Ohsop,chogall,1787,priest,discipline,68,42,26
Euphorz,tichondrius,1786,priest,discipline,36,19,17
Priceléss,tichondrius,1784,priest,discipline,30,22,8
Xsy,stormrage,1784,priest,discipline,54,31,23
Rlzpriest,tichondrius,1784,priest,discipline,124,65,59
Pride,moon-guard,1784,priest,discipline,148,66,82
Psyjes,stormrage,1783,priest,discipline,116,70,46
Gochuxx,tichondrius,1783,priest,discipline,72,38,34
Gibens,tichondrius,1781,priest,discipline,149,79,70
Usedmedkit,sargeras,1780,priest,discipline,47,28,19
Blesstwo,ragnaros,1779,priest,discipline,48,24,24
Mindseye,azgalor,1779,priest,discipline,138,68,70
Kóba,bleeding-hollow,1778,priest,discipline,48,33,15
Høðj,tichondrius,1778,priest,discipline,36,19,17
Meltmeltz,nerzhul,1778,priest,discipline,104,51,53
Oohso,chogall,1778,priest,discipline,126,60,66
Khorium,stormrage,1776,priest,discipline,64,29,35
Fleckyy,tichondrius,1776,priest,discipline,42,19,23
Ksâh,bleeding-hollow,1774,priest,discipline,81,50,31
Whalexo,kelthuzad,1774,priest,discipline,155,82,73
Tekneeq,barthilas,1774,priest,discipline,196,103,93
Pesca,proudmoore,1774,priest,discipline,125,59,66
Nickzx,tichondrius,1773,priest,discipline,76,51,25
Pnub,aggramar,1772,priest,discipline,105,52,53
Barley,chogall,1770,priest,discipline,58,30,28
Deathlullaby,malganis,1769,priest,discipline,72,37,35
Mcgg,tichondrius,1769,priest,discipline,210,99,111
Auxp,tichondrius,1769,priest,discipline,59,23,36
Dannycarrier,tichondrius,1768,priest,discipline,30,21,9
Jackski,aerie-peak,1768,priest,discipline,36,24,12
Smitelytius,tichondrius,1768,priest,discipline,36,21,15
Kabugi,illidan,1768,priest,discipline,96,52,44
Bellaelle,stormrage,1768,priest,discipline,69,35,34
Hungrybone,proudmoore,1768,priest,discipline,885,447,438
Catbabyeah,tichondrius,1767,priest,discipline,54,42,12
Írithyll,stormrage,1767,priest,discipline,59,33,26
Pibkac,stormrage,1767,priest,discipline,69,34,35
Kälëy,ragnaros,1766,priest,discipline,268,150,118
Kavxo,sargeras,1766,priest,discipline,131,73,58
Sobamian,tichondrius,1766,priest,discipline,146,66,80
Healum,nemesis,1765,priest,discipline,106,59,47
Oghealz,lightnings-blade,1765,priest,discipline,84,38,46
Badrapture,sargeras,1764,priest,discipline,104,73,31
Osis,rivendare,1764,priest,discipline,165,80,85
Sebpriest,proudmoore,1764,priest,discipline,42,20,22
Rúbybest,tichondrius,1764,priest,discipline,72,30,42
Sweetnipsbro,tichondrius,1763,priest,discipline,125,64,61
Deadpriesst,arthas,1763,priest,discipline,72,36,36
Rmxx,illidan,1762,priest,discipline,173,98,75
Astroluma,illidan,1762,priest,discipline,136,72,64
Darbybean,bleeding-hollow,1762,priest,discipline,54,28,26
Bloodyx,bleeding-hollow,1762,priest,discipline,232,119,113
Grimoz,illidan,1762,priest,discipline,77,35,42
Zaryx,wildhammer,1761,priest,discipline,48,29,19
Meatguzzler,tichondrius,1761,priest,discipline,85,51,34
Matin,frostmourne,1761,priest,discipline,51,27,24
Gothmidget,illidan,1761,priest,discipline,60,29,31
Raysx,stormrage,1759,priest,discipline,83,37,46
Kaddy,mannoroth,1757,priest,discipline,130,60,70
Khaoshealer,destromath,1757,priest,discipline,191,88,103
Compxx,barthilas,1756,priest,discipline,66,38,28
Powerwordwap,malganis,1756,priest,discipline,71,33,38
Spliffs,tichondrius,1755,priest,discipline,176,87,89
Shadheda,andorhal,1755,priest,discipline,68,33,35
Papabrokuttv,sargeras,1755,priest,discipline,42,19,23
Skunkbishop,sargeras,1753,priest,discipline,243,117,126
Séxgodx,tichondrius,1751,priest,discipline,59,28,31
Zins,emerald-dream,1750,priest,discipline,114,54,60
Ancilx,area-52,1749,priest,discipline,84,41,43
Ukishizumi,tichondrius,1748,priest,discipline,149,78,71
Nyluh,deathwing,1748,priest,discipline,74,38,36
Sanddglokta,tichondrius,1748,priest,discipline,332,167,165
Shadowbuzz,barthilas,1748,priest,discipline,84,42,42
Raizy,stormrage,1748,priest,discipline,53,26,27
Ferguss,ragnaros,1747,priest,discipline,79,42,37
Dudebanger,sargeras,1745,priest,discipline,36,26,10
Alarin,whisperwind,1745,priest,discipline,60,30,30
Evilear,tichondrius,1745,priest,discipline,66,31,35
Ninbara,tichondrius,1745,priest,discipline,59,27,32
Pomdom,tichondrius,1744,priest,discipline,72,34,38
Pisshorse,tichondrius,1743,priest,discipline,65,47,18
Hamstip,sargeras,1743,priest,discipline,98,58,40
Byck,tichondrius,1743,priest,discipline,60,26,34
Natoshi,illidan,1742,priest,discipline,48,25,23
Cursèlol,tichondrius,1742,priest,discipline,96,48,48
Jabberwolky,blackrock,1742,priest,discipline,60,23,37
Leapofdoubt,zuljin,1741,priest,discipline,256,132,124
Envio,moon-guard,1740,priest,discipline,60,36,24
Melshiesty,stormrage,1740,priest,discipline,53,24,29
Cody,magtheridon,1738,priest,discipline,90,59,31
Stinkypinkÿ,bleeding-hollow,1738,priest,discipline,45,27,18
Aloxc,drakkari,1738,priest,discipline,36,19,17
Chaner,scarlet-crusade,1738,priest,discipline,127,61,66
Jimmythedon,mugthol,1738,priest,discipline,82,38,44
Surfgang,tichondrius,1738,priest,discipline,77,35,42
Whatsadot,tichondrius,1737,priest,discipline,60,46,14
Leticia,magtheridon,1737,priest,discipline,159,78,81
Marejaynez,tichondrius,1737,priest,discipline,289,141,148
Stoneflute,emerald-dream,1736,priest,discipline,189,108,81
Orderic,ragnaros,1736,priest,discipline,57,32,25
Ilovemia,zuljin,1736,priest,discipline,42,23,19
Creamedcorn,tichondrius,1736,priest,discipline,40,21,19
Pgpriest,kelthuzad,1736,priest,discipline,114,56,58
Haruspex,azralon,1736,priest,discipline,107,48,59
Kelthax,sargeras,1736,priest,discipline,54,23,31
Niark,frostmourne,1736,priest,discipline,48,20,28
Maybedead,tichondrius,1734,priest,discipline,42,26,16
Aupascamarad,tichondrius,1734,priest,discipline,35,19,16
Obscure,malygos,1734,priest,discipline,74,32,42
Larisa,moon-guard,1733,priest,discipline,54,32,22
Claverr,stormrage,1733,priest,discipline,39,23,16
Neverbeen,tichondrius,1733,priest,discipline,822,428,394
Bublehead,zuljin,1733,priest,discipline,132,62,70
Syo,dreadmaul,1732,priest,discipline,137,72,65
Verymuscular,stormrage,1732,priest,discipline,66,34,32
Castsmites,tichondrius,1731,priest,discipline,51,27,24
Saelom,frostmourne,1730,priest,discipline,78,49,29
Murth,laughing-skull,1729,priest,discipline,47,30,17
Johanna,tichondrius,1729,priest,discipline,41,26,15
Adrio,malorne,1729,priest,discipline,350,175,175
Dirtydebbie,lightnings-blade,1729,priest,discipline,64,30,34
Priestass,bleeding-hollow,1728,priest,discipline,227,118,109
Airelia,sargeras,1728,priest,discipline,54,28,26
Dëàthwîsh,tichondrius,1728,priest,discipline,53,26,27
Deeznuhh,tichondrius,1728,priest,discipline,47,19,28
Blasphêmy,malganis,1727,priest,discipline,86,52,34
Frenezyz,ragnaros,1727,priest,discipline,66,37,29
Thatruth,duskwood,1727,priest,discipline,48,26,22
Beeffdaddy,tichondrius,1727,priest,discipline,198,98,100
Oogs,tichondrius,1727,priest,discipline,244,108,136
Åpples,tichondrius,1727,priest,discipline,71,31,40
Apoorstudent,tichondrius,1726,priest,discipline,116,72,44
Mxfd,tichondrius,1726,priest,discipline,47,27,20
Dévore,dalaran,1726,priest,discipline,46,25,21
Plumpkinn,kiljaeden,1726,priest,discipline,106,54,52
Flagiddyflag,kelthuzad,1726,priest,discipline,48,24,24
Analogxz,nemesis,1726,priest,discipline,168,81,87
Vonpaolo,emerald-dream,1725,priest,discipline,24,20,4
Conifer,emerald-dream,1725,priest,discipline,72,41,31
Barthbelro,kiljaeden,1725,priest,discipline,87,49,38
Xxqq,illidan,1725,priest,discipline,113,60,53
Litterfeet,moon-guard,1725,priest,discipline,101,51,50
Goneqt,illidan,1725,priest,discipline,60,29,31
Jezebëll,nemesis,1724,priest,discipline,192,99,93
Kebab,tichondrius,1723,priest,discipline,30,18,12
Natahlia,area-52,1723,priest,discipline,90,44,46
Jexso,tichondrius,1723,priest,discipline,199,96,103
Dontlineme,tichondrius,1723,priest,discipline,142,64,78
Xidis,vashj,1723,priest,discipline,71,29,42
Mååxxee,zuljin,1722,priest,discipline,30,18,12
Vegetable,suramar,1722,priest,discipline,36,18,18
Downturn,tichondrius,1722,priest,discipline,54,23,31
Starpass,illidan,1721,priest,discipline,60,42,18
Canibumsmoke,illidan,1721,priest,discipline,99,50,49
Fhinky,tichondrius,1721,priest,discipline,213,105,108
Philmacrakn,stormrage,1721,priest,discipline,167,81,86
Flamédøtz,ragnaros,1720,priest,discipline,54,30,24
Luwoona,tichondrius,1720,priest,discipline,107,48,59
Opriest,queldorei,1718,priest,discipline,54,27,27
Ggsaurusrex,area-52,1718,priest,discipline,66,31,35
Ooit,tichondrius,1717,priest,discipline,24,22,2
Septmoon,tichondrius,1717,priest,discipline,66,34,32
Cixelpvp,area-52,1717,priest,discipline,53,27,26
Wizpell,area-52,1717,priest,discipline,42,18,24
Epicp,sargeras,1716,priest,discipline,30,18,12
Pissfeet,tichondrius,1716,priest,discipline,30,18,12
Rotbaron,bleeding-hollow,1716,priest,discipline,108,48,60
Woobgasm,sargeras,1715,priest,discipline,72,46,26
Zlowbly,ragnaros,1715,priest,discipline,36,21,15
Dippyboi,whisperwind,1715,priest,discipline,60,30,30
Ganapati,the-underbog,1715,priest,discipline,36,18,18
Meshuggah,archimonde,1713,priest,discipline,42,22,20
Indiglo,arthas,1713,priest,discipline,138,68,70
Mygameslaggy,area-52,1713,priest,discipline,78,33,45
Likehisname,tichondrius,1713,priest,discipline,48,19,29
Marminator,stormrage,1713,priest,discipline,66,24,42
Pastapizza,zuljin,1712,priest,discipline,24,22,2
Rachell,emerald-dream,1712,priest,discipline,36,26,10
Twixicecream,sargeras,1712,priest,discipline,35,24,11
Shrooks,frostmourne,1712,priest,discipline,56,30,26
Bakara,jubeithos,1712,priest,discipline,42,18,24
Nxghtmares,tichondrius,1711,priest,discipline,428,210,218
Trebrooke,sargeras,1710,priest,discipline,161,88,73
Touchrr,tichondrius,1710,priest,discipline,108,58,50
Demaholy,illidan,1710,priest,discipline,163,82,81
Valothrian,area-52,1710,priest,discipline,172,86,86
Dorgondra,wyrmrest-accord,1709,priest,discipline,48,26,22
Shadzx,andorhal,1709,priest,discipline,71,34,37
Universe,spinebreaker,1707,priest,discipline,64,43,21
Andreslol,sargeras,1707,priest,discipline,54,32,22
Caveria,emerald-dream,1707,priest,discipline,283,146,137
Asthenia,saurfang,1706,priest,discipline,120,59,61
Sodezz,stormrage,1705,priest,discipline,36,21,15
Bfts,illidan,1705,priest,discipline,227,119,108
Mellow,tichondrius,1705,priest,discipline,170,89,81
Discflips,dalaran,1705,priest,discipline,239,117,122
Forti,sargeras,1705,priest,discipline,156,74,82
Squaanchy,bleeding-hollow,1705,priest,discipline,129,61,68
Highprofile,proudmoore,1705,priest,discipline,42,19,23
Anmu,illidan,1704,priest,discipline,30,19,11
Dream,kelthuzad,1704,priest,discipline,36,21,15
Staars,ragnaros,1704,priest,discipline,66,37,29
Justafkoutpr,gorefiend,1703,priest,discipline,54,36,18
Sùlyvahñ,tichondrius,1702,priest,discipline,30,18,12
Gfayde,sargeras,1702,priest,discipline,36,20,16
Nightcráwler,illidan,1702,priest,discipline,89,47,42
Shnozberry,tichondrius,1702,priest,discipline,114,46,68
Sätîvá,tichondrius,1701,priest,discipline,44,24,20
Irenesome,tichondrius,1701,priest,discipline,45,21,24
Fullfear,lothar,1699,priest,discipline,54,33,21
Bigbrother,andorhal,1699,priest,discipline,36,21,15
Beowulfy,stormrage,1699,priest,discipline,48,27,21
Nexp,tichondrius,1698,priest,discipline,141,90,51
Cruces,malorne,1698,priest,discipline,33,18,15
Nanoboost,dark-iron,1698,priest,discipline,759,380,379
Nasser,tichondrius,1698,priest,discipline,42,18,24
Prïestitute,zuljin,1697,priest,discipline,150,92,58
Clydeington,illidan,1697,priest,discipline,49,29,20
Cryptron,tichondrius,1697,priest,discipline,54,28,26
Papafajita,area-52,1697,priest,discipline,71,34,37
Nancynibbler,bleeding-hollow,1697,priest,discipline,70,32,38
Lamont,archimonde,1697,priest,discipline,50,21,29
Mixful,bleeding-hollow,1696,priest,discipline,40,27,13
Twêet,frostmourne,1696,priest,discipline,186,87,99
Pìuzera,azralon,1695,priest,discipline,89,45,44
Serakiki,nemesis,1694,priest,discipline,90,51,39
Metaverse,lightbringer,1694,priest,discipline,39,21,18
Mintadnade,nemesis,1694,priest,discipline,198,100,98
Slickwilly,bloodhoof,1694,priest,discipline,275,137,138
Vandamnation,barthilas,1694,priest,discipline,223,107,116
Stepsistér,ragnaros,1693,priest,discipline,54,29,25
Deathtones,barthilas,1693,priest,discipline,167,85,82
Geon,sargeras,1693,priest,discipline,107,53,54
Afflickzz,kelthuzad,1692,priest,discipline,42,26,16
Klttzz,sargeras,1692,priest,discipline,72,40,32
Yunnan,executus,1692,priest,discipline,119,65,54
Smyted,tichondrius,1692,priest,discipline,79,43,36
Auntbrittany,tichondrius,1692,priest,discipline,36,18,18
Scab,anetheron,1692,priest,discipline,161,79,82
Beelzebul,illidan,1692,priest,discipline,66,31,35
Hotgirlshiit,dalaran,1691,priest,discipline,364,175,189
Bosspriest,tichondrius,1691,priest,discipline,48,23,25
Drethor,saurfang,1691,priest,discipline,76,36,40
Pigogo,tichondrius,1690,priest,discipline,45,26,19
Slùm,barthilas,1689,priest,discipline,49,30,19
Mastaspell,illidan,1689,priest,discipline,31,18,13
Elybele,sargeras,1689,priest,discipline,114,61,53
Yobell,tichondrius,1688,priest,discipline,36,23,13
Argylemomo,emerald-dream,1688,priest,discipline,202,103,99
Zrn,bleeding-hollow,1688,priest,discipline,102,47,55
Wildsmite,hyjal,1688,priest,discipline,222,102,120
Verboden,kelthuzad,1687,priest,discipline,36,25,11
Duubz,kelthuzad,1687,priest,discipline,96,51,45
Oopsy,bleeding-hollow,1687,priest,discipline,60,31,29
Scryphe,kelthuzad,1687,priest,discipline,180,89,91
Kastep,tichondrius,1687,priest,discipline,94,46,48
Synsparks,tichondrius,1687,priest,discipline,77,35,42
Luvenia,sargeras,1686,priest,discipline,186,101,85
Fõrcedtowipe,tichondrius,1686,priest,discipline,215,113,102
Änanti,tichondrius,1686,priest,discipline,160,79,81
Andypr,illidan,1686,priest,discipline,66,25,41
Jerome,tichondrius,1685,priest,discipline,105,61,44
Catonement,moon-guard,1684,priest,discipline,690,335,355
Salvation,tichondrius,1684,priest,discipline,60,27,33
Turtlez,area-52,1684,priest,discipline,78,35,43
Opscurum,bleeding-hollow,1683,priest,discipline,60,36,24
Rámmstein,wyrmrest-accord,1682,priest,discipline,126,68,58
Giveheadpats,moon-guard,1682,priest,discipline,167,90,77
Persimmons,lightbringer,1682,priest,discipline,131,70,61
Fyshme,frostmourne,1682,priest,discipline,42,22,20
Skvmbag,tichondrius,1681,priest,discipline,40,26,14
Märzy,thrall,1681,priest,discipline,42,26,16
Onineko,bleeding-hollow,1681,priest,discipline,57,32,25
Luthiene,area-52,1681,priest,discipline,245,136,109
Shrimpouh,illidan,1681,priest,discipline,78,43,35
Plaguebaby,stormrage,1681,priest,discipline,45,23,22
Rilad,icecrown,1681,priest,discipline,222,111,111
Goatspriesta,kelthuzad,1681,priest,discipline,50,25,25
Serrahs,tichondrius,1681,priest,discipline,59,29,30
Melforn,moon-guard,1681,priest,discipline,59,28,31
Ieveling,skywall,1681,priest,discipline,65,30,35
Lingdums,tichondrius,1680,priest,discipline,31,18,13
Falsegodxd,tichondrius,1680,priest,discipline,42,20,22
Laggytwodope,tichondrius,1679,priest,discipline,48,32,16
Washdp,frostmourne,1679,priest,discipline,47,24,23
Poosydoodlez,malganis,1679,priest,discipline,105,48,57
Qtasiangirl,emerald-dream,1679,priest,discipline,109,47,62
Shastea,crushridge,1678,priest,discipline,76,41,35
Derpmodé,staghelm,1678,priest,discipline,54,28,26
Nabukom,destromath,1678,priest,discipline,52,25,27
Toastspriest,tichondrius,1677,priest,discipline,107,60,47
Shesaidthat,stormrage,1677,priest,discipline,274,143,131
Koopy,kiljaeden,1677,priest,discipline,120,62,58
Mealmassttr,frostmourne,1677,priest,discipline,173,82,91
Holyfall,sargeras,1676,priest,discipline,220,116,104
Gurgs,emerald-dream,1676,priest,discipline,38,19,19
Probs,frostmourne,1676,priest,discipline,149,73,76
Chañing,frostmourne,1676,priest,discipline,90,43,47
Muffinboy,illidan,1676,priest,discipline,60,21,39
Narodiz,nemesis,1675,priest,discipline,48,26,22
Chewey,tichondrius,1675,priest,discipline,71,35,36
Bonehead,warsong,1675,priest,discipline,48,23,25
Snakedoc,emerald-dream,1674,priest,discipline,96,50,46
Jennyle,sargeras,1673,priest,discipline,78,43,35
Bingleboi,area-52,1673,priest,discipline,369,198,171
Howiecakes,bloodhoof,1673,priest,discipline,75,33,42
Aco,tichondrius,1672,priest,discipline,150,79,71
Acpriest,tichondrius,1672,priest,discipline,135,69,66
Dojacatx,frostmourne,1672,priest,discipline,114,57,57
Eetsqt,barthilas,1671,priest,discipline,120,74,46
Meemó,area-52,1671,priest,discipline,36,22,14
Räpture,andorhal,1671,priest,discipline,46,28,18
Hrdz,zuljin,1671,priest,discipline,40,22,18
Perothon,garrosh,1670,priest,discipline,153,82,71
Zilah,ravencrest,1670,priest,discipline,138,72,66
Flagiddy,kelthuzad,1670,priest,discipline,57,27,30
Dachenchen,tichondrius,1669,priest,discipline,36,27,9
Auras,boulderfist,1669,priest,discipline,70,41,29
Drée,zuljin,1669,priest,discipline,44,23,21
Bigdaddios,dalaran,1669,priest,discipline,57,29,28
Kagemetsu,sargeras,1669,priest,discipline,152,74,78
Boostedpi,tichondrius,1669,priest,discipline,44,21,23
Madmilesstv,zuljin,1669,priest,discipline,51,24,27
Jmlz,tichondrius,1668,priest,discipline,36,23,13
Elilium,tichondrius,1668,priest,discipline,80,48,32
Alomari,zuljin,1668,priest,discipline,32,19,13
Milkkz,zuljin,1668,priest,discipline,54,30,24
Klitarus,barthilas,1668,priest,discipline,48,23,25
Maximiliano,barthilas,1668,priest,discipline,43,19,24
Mcfref,tichondrius,1667,priest,discipline,135,70,65
Dpendant,frostmourne,1667,priest,discipline,119,56,63
Muffingal,tichondrius,1666,priest,discipline,36,19,17
Nelpesh,tichondrius,1666,priest,discipline,60,27,33
Fearnought,stormrage,1665,priest,discipline,224,121,103
Icemocha,tichondrius,1665,priest,discipline,54,25,29
Kepp,korgath,1665,priest,discipline,69,30,39
Meren,kelthuzad,1664,priest,discipline,36,24,12
Góndhi,tichondrius,1664,priest,discipline,42,25,17
Crysknife,korgath,1664,priest,discipline,35,20,15
Rmx,illidan,1664,priest,discipline,41,20,21
Kujox,tichondrius,1664,priest,discipline,94,44,50
Knoskeezy,proudmoore,1663,priest,discipline,30,22,8
Gekko,azgalor,1663,priest,discipline,54,21,33
Shocklol,stormrage,1662,priest,discipline,29,22,7
Niik,tichondrius,1662,priest,discipline,36,25,11
Syrul,tichondrius,1662,priest,discipline,87,50,37
Hallucinogen,kelthuzad,1662,priest,discipline,95,51,44
Isilador,moon-guard,1662,priest,discipline,119,52,67
Fugazy,barthilas,1661,priest,discipline,44,24,20
Fisp,moon-guard,1661,priest,discipline,72,33,39
Bvh,kelthuzad,1661,priest,discipline,57,22,35
Joeyslaps,frostwolf,1660,priest,discipline,64,34,30
Resisted,gorefiend,1660,priest,discipline,238,120,118
Cayleey,stormrage,1659,priest,discipline,90,40,50
Randomprist,area-52,1658,priest,discipline,33,18,15
Luciellis,sargeras,1658,priest,discipline,162,83,79
Imms,tichondrius,1658,priest,discipline,48,21,27
Caveron,tichondrius,1657,priest,discipline,42,23,19
Pocket,alleria,1656,priest,discipline,36,21,15
Ÿsk,tichondrius,1656,priest,discipline,222,117,105
Swaheally,frostmourne,1656,priest,discipline,48,25,23
Toopriestly,deathwing,1656,priest,discipline,65,32,33
Yaz,emerald-dream,1656,priest,discipline,71,34,37
Sarïya,moon-guard,1656,priest,discipline,143,68,75
Hm,the-scryers,1655,priest,discipline,36,25,11
Valith,bleeding-hollow,1655,priest,discipline,82,47,35
Theravus,moon-guard,1655,priest,discipline,124,67,57
Dances,emerald-dream,1655,priest,discipline,42,22,20
Hermanmiller,frostmourne,1655,priest,discipline,48,25,23
Shádowman,thrall,1655,priest,discipline,126,65,61
Batiatus,moon-guard,1655,priest,discipline,252,127,125
Vcainyfairy,stormrage,1655,priest,discipline,531,267,264
Naranjitá,ragnaros,1654,priest,discipline,66,42,24
Darknuz,sargeras,1654,priest,discipline,53,27,26
Sacredmoon,dreadmaul,1654,priest,discipline,36,18,18
Perceptions,dalaran,1653,priest,discipline,42,26,16
Hypes,korgath,1653,priest,discipline,115,65,50
Kathere,tichondrius,1653,priest,discipline,42,23,19
Zunitpriest,laughing-skull,1653,priest,discipline,36,18,18
Timbobaloo,thrall,1652,priest,discipline,82,47,35
Vtp,frostmourne,1652,priest,discipline,70,40,30
Kelime,azralon,1652,priest,discipline,60,34,26
Jammeslight,quelthalas,1652,priest,discipline,154,81,73
Glassbirds,stormrage,1652,priest,discipline,48,25,23
Airalia,bleeding-hollow,1650,priest,discipline,36,23,13
Somefire,proudmoore,1650,priest,discipline,155,78,77
Peelforheals,nordrassil,1650,priest,discipline,78,39,39
Yotz,destromath,1650,priest,discipline,60,27,33
Packa,khaz-modan,1649,priest,discipline,42,26,16
Hanley,tichondrius,1649,priest,discipline,85,48,37
Larry,tichondrius,1649,priest,discipline,65,31,34
Jatral,azralon,1649,priest,discipline,64,30,34
Nopang,tichondrius,1649,priest,discipline,167,77,90
Lanäthel,sargeras,1648,priest,discipline,28,19,9
Nancya,stormrage,1648,priest,discipline,69,45,24
Dreamteller,tichondrius,1648,priest,discipline,48,24,24
Eazyp,stormrage,1647,priest,discipline,34,19,15
Jönsnow,ghostlands,1647,priest,discipline,78,42,36
Bigtomwudi,illidan,1647,priest,discipline,82,43,39
Krewesin,ravencrest,1647,priest,discipline,43,22,21
Trollpreist,tichondrius,1647,priest,discipline,148,75,73
Lòthnalar,ragnaros,1647,priest,discipline,60,29,31
Dorazòn,bleeding-hollow,1647,priest,discipline,54,25,29
Twistynipple,malganis,1646,priest,discipline,42,25,17
Saintguard,tichondrius,1646,priest,discipline,246,127,119
Iamjakehill,area-52,1646,priest,discipline,154,79,75
Rosaparksxo,sargeras,1645,priest,discipline,70,35,35
Piils,sargeras,1645,priest,discipline,42,21,21
Cavatea,illidan,1645,priest,discipline,42,21,21
Maatrrixx,drakkari,1645,priest,discipline,60,19,41
Azurestorm,tichondrius,1644,priest,discipline,60,31,29
Cptcancer,tichondrius,1644,priest,discipline,54,23,31
Toddmund,tichondrius,1644,priest,discipline,64,25,39
Tonydatiger,the-forgotten-coast,1643,priest,discipline,36,21,15
Silkydeath,frostmourne,1643,priest,discipline,60,33,27
Holyneuro,illidan,1643,priest,discipline,42,22,20
Judis,barthilas,1643,priest,discipline,78,39,39
Skwishee,illidan,1642,priest,discipline,58,36,22
Kuell,ragnaros,1642,priest,discipline,53,29,24
Ixchelune,kelthuzad,1642,priest,discipline,243,122,121
Reiae,malganis,1642,priest,discipline,70,27,43
Alguîen,ragnaros,1640,priest,discipline,115,61,54
Life,amanthul,1639,priest,discipline,143,84,59
Randompreest,stormrage,1639,priest,discipline,42,23,19
Purplepil,sargeras,1639,priest,discipline,36,18,18
Lunarina,hyjal,1638,priest,discipline,167,75,92
Manryu,tichondrius,1637,priest,discipline,132,68,64
Evvylou,stormrage,1637,priest,discipline,42,19,23
Zprist,illidan,1637,priest,discipline,66,29,37
Choochang,sargeras,1636,priest,discipline,35,27,8
Aethriem,bleeding-hollow,1636,priest,discipline,54,33,21
Notkim,zuljin,1636,priest,discipline,83,47,36
Takomochi,sargeras,1636,priest,discipline,41,22,19
Purged,shadowmoon,1636,priest,discipline,379,203,176
Döllyy,illidan,1636,priest,discipline,48,22,26
Oiled,barthilas,1635,priest,discipline,98,63,35
Frag,frostmourne,1635,priest,discipline,132,72,60
Mutedox,frostmourne,1635,priest,discipline,47,24,23
Mangolatte,frostmourne,1634,priest,discipline,55,41,14
Thirdplace,tichondrius,1634,priest,discipline,36,24,12
Ngin,queldorei,1634,priest,discipline,36,21,15
Hårper,area-52,1634,priest,discipline,75,37,38
Beejaex,stormreaver,1634,priest,discipline,48,22,26
Benedictiion,tichondrius,1634,priest,discipline,86,38,48
Zëref,azralon,1633,priest,discipline,88,52,36
Priestreto,zuljin,1633,priest,discipline,119,66,53
Creòle,area-52,1633,priest,discipline,42,23,19
Huxleypoo,boulderfist,1633,priest,discipline,42,22,20
Kazuret,ragnaros,1633,priest,discipline,272,141,131
Bacpack,area-52,1633,priest,discipline,177,89,88
Jâmïè,gurubashi,1632,priest,discipline,41,31,10
Neuterednuts,zuljin,1632,priest,discipline,48,27,21
Hasby,area-52,1632,priest,discipline,180,99,81
Ärchangél,tichondrius,1632,priest,discipline,98,52,46
Buhroke,thrall,1632,priest,discipline,62,29,33
Soulcleave,dark-iron,1632,priest,discipline,84,38,46
Kayare,area-52,1632,priest,discipline,53,23,30
Haquin,malganis,1632,priest,discipline,42,18,24
Justanoutlaw,darkspear,1631,priest,discipline,102,64,38
Gödtier,frostwolf,1631,priest,discipline,42,18,24
Meip,illidan,1630,priest,discipline,24,17,7
Jâldabaoth,area-52,1630,priest,discipline,72,45,27
Skadín,stormrage,1630,priest,discipline,155,92,63
Gamepass,tichondrius,1630,priest,discipline,48,24,24
Megz,zuljin,1630,priest,discipline,46,23,23
Asj,illidan,1629,priest,discipline,45,30,15
Valyx,tichondrius,1629,priest,discipline,189,102,87
Bluecho,tichondrius,1629,priest,discipline,48,25,23
Szx,akama,1629,priest,discipline,50,24,26
Jzd,dreadmaul,1628,priest,discipline,66,36,30
Bustit,azgalor,1628,priest,discipline,52,28,24
Kazgry,illidan,1628,priest,discipline,42,22,20
Bhoyka,ragnaros,1628,priest,discipline,57,29,28
Chookspriest,tichondrius,1628,priest,discipline,179,90,89
Crawly,illidan,1628,priest,discipline,119,59,60
Jaysshadow,illidan,1627,priest,discipline,35,23,12
Archecho,area-52,1627,priest,discipline,36,22,14
Oesobagi,tichondrius,1627,priest,discipline,113,66,47
Saltlevels,sargeras,1627,priest,discipline,174,94,80
Djc,tichondrius,1627,priest,discipline,96,50,46
Gutrìck,tichondrius,1627,priest,discipline,42,20,22
Çammy,frostmourne,1626,priest,discipline,24,17,7
Andrew,sargeras,1626,priest,discipline,30,20,10
Discavow,bleeding-hollow,1626,priest,discipline,51,31,20
Krupticus,tichondrius,1626,priest,discipline,40,24,16
Brothercarl,stormrage,1626,priest,discipline,95,51,44
Arianagrande,garona,1626,priest,discipline,95,50,45
Raxekk,stormrage,1626,priest,discipline,48,25,23
Odealp,stormscale,1626,priest,discipline,42,20,22
Uroka,malganis,1626,priest,discipline,42,19,23
Bòngu,tichondrius,1626,priest,discipline,58,24,34
Mylo,azralon,1625,priest,discipline,48,28,20
Psycozis,hyjal,1625,priest,discipline,262,138,124
Luhhx,sargeras,1625,priest,discipline,134,70,64
Highmoon,kelthuzad,1625,priest,discipline,42,20,22
Esciel,ragnaros,1625,priest,discipline,122,57,65
Linarindil,hyjal,1624,priest,discipline,126,63,63
Zunari,thrall,1624,priest,discipline,54,27,27
Momorabbit,tichondrius,1624,priest,discipline,36,17,19
Ussmissouri,area-52,1624,priest,discipline,141,63,78
Bobbyrich,sargeras,1623,priest,discipline,30,18,12
Caesus,sargeras,1623,priest,discipline,124,70,54
Fenty,nemesis,1623,priest,discipline,95,51,44
Bonoo,tichondrius,1623,priest,discipline,335,175,160
Nutshotxx,skullcrusher,1623,priest,discipline,250,118,132
Astrøpriest,tichondrius,1623,priest,discipline,66,28,38
Leviathanh,tichondrius,1622,priest,discipline,104,67,37
Elbeefsteak,ragnaros,1622,priest,discipline,54,32,22
Swagraptor,stormreaver,1622,priest,discipline,168,89,79
Lawbster,jubeithos,1622,priest,discipline,34,18,16
Grizzlysmite,stormrage,1622,priest,discipline,361,177,184
Vsat,illidan,1622,priest,discipline,54,26,28
Badhabit,zuluhed,1622,priest,discipline,109,51,58
Wickedpriest,malganis,1622,priest,discipline,54,25,29
Kûrtt,azralon,1622,priest,discipline,42,19,23
Woodricks,frostmourne,1622,priest,discipline,71,27,44
Spicer,eredar,1621,priest,discipline,41,25,16
Tuniepope,sargeras,1621,priest,discipline,75,45,30
Pedobearx,ragnaros,1621,priest,discipline,178,89,89
Deathsmoke,ragnaros,1621,priest,discipline,112,55,57
Fialiadia,illidan,1621,priest,discipline,54,20,34
Tammyone,emerald-dream,1620,priest,discipline,66,42,24
Pigro,area-52,1620,priest,discipline,30,19,11
Wodturbo,bleeding-hollow,1620,priest,discipline,61,36,25
Holyphodays,sargeras,1620,priest,discipline,193,105,88
Brxddx,sargeras,1620,priest,discipline,125,64,61
Darknuzs,sargeras,1620,priest,discipline,42,21,21
Umadcüzubad,azralon,1620,priest,discipline,127,62,65
Gosarix,tichondrius,1619,priest,discipline,24,17,7
Meditåtion,tichondrius,1619,priest,discipline,280,149,131
Crøws,ragnaros,1619,priest,discipline,294,145,149
Dfâc,moon-guard,1619,priest,discipline,96,47,49
Baddmachine,illidan,1619,priest,discipline,47,21,26
Skcits,sargeras,1618,priest,discipline,42,26,16
Conezy,frostmourne,1618,priest,discipline,78,42,36
Nohéalforu,stormrage,1618,priest,discipline,48,25,23
Discgoddess,proudmoore,1618,priest,discipline,169,87,82
Punisherror,area-52,1618,priest,discipline,52,22,30
Jmr,onyxia,1617,priest,discipline,24,17,7
Cazuex,ragnaros,1617,priest,discipline,30,20,10
Khathor,kargath,1617,priest,discipline,30,17,13
Gurlyounasty,khazgoroth,1617,priest,discipline,103,55,48
Ezelra,frostmourne,1617,priest,discipline,47,25,22
Ingladforx,azralon,1617,priest,discipline,83,41,42
Maxla,tichondrius,1616,priest,discipline,119,71,48
Prayussy,tichondrius,1616,priest,discipline,135,72,63
Charbosan,gorgonnash,1616,priest,discipline,746,383,363
Zyonn,chogall,1616,priest,discipline,36,18,18
Anahka,tichondrius,1616,priest,discipline,48,21,27
Shaddäye,andorhal,1616,priest,discipline,48,20,28
Apathist,sargeras,1615,priest,discipline,72,45,27
Saintpleb,sargeras,1615,priest,discipline,30,18,12
Kraamur,area-52,1615,priest,discipline,96,57,39
Predolph,illidan,1615,priest,discipline,60,34,26
Jîtters,silvermoon,1615,priest,discipline,84,45,39
Halfcutt,tichondrius,1615,priest,discipline,96,48,48
Velandrys,earthen-ring,1614,priest,discipline,72,36,36
Hottymcdotty,black-dragonflight,1614,priest,discipline,42,21,21
Galandora,kelthuzad,1614,priest,discipline,48,23,25
Selfless,barthilas,1614,priest,discipline,66,28,38
Iovedoctor,tichondrius,1614,priest,discipline,78,25,53
Sâsh,stormrage,1613,priest,discipline,72,40,32
Lîk,tichondrius,1613,priest,discipline,193,107,86
Aåurøra,stormrage,1613,priest,discipline,46,23,23
Trezz,hakkar,1613,priest,discipline,46,23,23
ßðßßÿ,area-52,1613,priest,discipline,42,21,21
Mattgarska,tichondrius,1613,priest,discipline,48,17,31
Alfié,kelthuzad,1612,priest,discipline,48,33,15
Draxxankou,tanaris,1612,priest,discipline,103,59,44
Bombdevil,quelthalas,1612,priest,discipline,72,40,32
Itachî,ravencrest,1612,priest,discipline,42,23,19
Kks,tichondrius,1612,priest,discipline,90,46,44
Halö,area-52,1612,priest,discipline,246,125,121
Alphôn,bleeding-hollow,1612,priest,discipline,36,17,19
Spicey,korgath,1611,priest,discipline,51,37,14
Gsek,nemesis,1611,priest,discipline,36,23,13
Scruge,frostmourne,1611,priest,discipline,55,32,23
Littleshower,illidan,1611,priest,discipline,43,23,20
Vincejddp,zuljin,1611,priest,discipline,199,105,94
Tonybanderas,shattered-halls,1611,priest,discipline,120,63,57
Haill,quelthalas,1611,priest,discipline,76,38,38
Shadoris,antonidas,1611,priest,discipline,48,23,25
Cinsare,moon-guard,1610,priest,discipline,84,49,35
Psychic,bladefist,1610,priest,discipline,130,75,55
Yidra,illidan,1610,priest,discipline,36,19,17
Blathers,malganis,1610,priest,discipline,92,48,44
Moalboal,tichondrius,1610,priest,discipline,268,136,132
Billybobjane,jubeithos,1610,priest,discipline,42,21,21
Interworld,illidan,1610,priest,discipline,50,24,26
Mortteus,agamaggan,1610,priest,discipline,60,28,32
Pleasant,dathremar,1610,priest,discipline,123,52,71
Twistèr,zuljin,1610,priest,discipline,69,29,40
Degenerates,blood-furnace,1610,priest,discipline,48,20,28
Másterclass,stormrage,1609,priest,discipline,29,22,7
Smashhley,bleeding-hollow,1609,priest,discipline,200,114,86
Krusheal,tichondrius,1609,priest,discipline,47,22,25
Gránd,emerald-dream,1609,priest,discipline,54,22,32
Gsek,azralon,1608,priest,discipline,54,34,20
Cléríc,moon-guard,1608,priest,discipline,67,42,25
Indigojuly,sargeras,1608,priest,discipline,82,47,35
Alcázardeyo,area-52,1608,priest,discipline,150,84,66
Wrekkit,area-52,1608,priest,discipline,84,42,42
Reginaa,nemesis,1608,priest,discipline,65,30,35
Buttfive,illidan,1608,priest,discipline,58,24,34
Lines,sargeras,1607,priest,discipline,88,47,41
Jiñx,destromath,1607,priest,discipline,278,147,131
Kaeda,drenden,1607,priest,discipline,84,44,40
Hootheals,illidan,1607,priest,discipline,46,24,22
Samirah,arthas,1607,priest,discipline,84,43,41
Preeste,stormrage,1607,priest,discipline,44,22,22
Darknus,sargeras,1607,priest,discipline,78,37,41
Rustypinball,bleeding-hollow,1606,priest,discipline,105,62,43
Mkowns,tichondrius,1606,priest,discipline,90,52,38
Teewat,illidan,1606,priest,discipline,42,23,19
Swartzp,tichondrius,1606,priest,discipline,122,64,58
Xhadow,sargeras,1606,priest,discipline,161,84,77
Mclyte,whisperwind,1606,priest,discipline,203,103,100
Healbaby,illidan,1606,priest,discipline,358,181,177
Lovesy,burning-legion,1606,priest,discipline,60,30,30
Darkispriest,tichondrius,1606,priest,discipline,36,17,19
Powerwordqt,kalecgos,1606,priest,discipline,60,26,34
Trojanphobia,bleeding-hollow,1605,priest,discipline,54,29,25
Yoggismydad,emerald-dream,1605,priest,discipline,185,95,90
Shiromar,tichondrius,1605,priest,discipline,102,51,51
Takosoufflé,emerald-dream,1605,priest,discipline,48,22,26
Abbydaddy,illidan,1605,priest,discipline,51,23,28
Lolkwtf,sargeras,1605,priest,discipline,49,22,27
Míkò,sargeras,1604,priest,discipline,18,17,1
Jagita,kelthuzad,1604,priest,discipline,31,20,11
Hoglet,moon-guard,1604,priest,discipline,65,39,26
Tanthsondis,illidan,1604,priest,discipline,54,28,26
Staywild,tichondrius,1604,priest,discipline,66,34,32
Tidbitsy,malganis,1604,priest,discipline,108,55,53
Giblettz,lightbringer,1604,priest,discipline,141,69,72
Vern,laughing-skull,1604,priest,discipline,78,29,49
Zerokool,moonrunner,1603,priest,discipline,48,29,19
Fukneasy,darkspear,1603,priest,discipline,37,20,17
Feymuhsjr,black-dragonflight,1603,priest,discipline,54,29,25
Iamgess,kilrogg,1603,priest,discipline,42,22,20
Tooeasy,vashj,1603,priest,discipline,36,17,19
Xävier,farstriders,1603,priest,discipline,48,22,26
Resortv,illidan,1602,priest,discipline,42,32,10
Hõlyshìt,whisperwind,1602,priest,discipline,30,19,11
Aetyn,tichondrius,1602,priest,discipline,61,33,28
Arcalon,thrall,1602,priest,discipline,86,45,41
Gromkekz,area-52,1602,priest,discipline,73,38,35
Ragretsxo,darkspear,1602,priest,discipline,150,75,75
Manstench,tichondrius,1602,priest,discipline,81,40,41
Crizem,bleeding-hollow,1602,priest,discipline,242,119,123
Bennito,moon-guard,1602,priest,discipline,211,96,115
Ünagi,thrall,1602,priest,discipline,77,34,43
Zymmie,moon-guard,1602,priest,discipline,102,45,57
Psyclick,zuljin,1601,priest,discipline,30,21,9
Invicta,frostwolf,1601,priest,discipline,27,18,9
Hølycrit,icecrown,1601,priest,discipline,63,36,27
Primalshadow,kaelthas,1601,priest,discipline,36,19,17
Størmy,kiljaeden,1601,priest,discipline,306,160,146
Bistek,bleeding-hollow,1601,priest,discipline,166,83,83
Mhp,illidan,1601,priest,discipline,51,20,31
Cyntech,area-52,1600,priest,discipline,29,23,6
Marethelia,stonemaul,1600,priest,discipline,60,34,26
Tricklee,tichondrius,1600,priest,discipline,47,26,21
Cezure,stormrage,1600,priest,discipline,341,187,154
Jhivagosp,tichondrius,1600,priest,discipline,42,23,19
Mepisth,sargeras,1600,priest,discipline,66,36,30
Zarakonna,illidan,1600,priest,discipline,60,32,28
Nijoral,tichondrius,1600,priest,discipline,368,194,174
Eccentrixx,mannoroth,1600,priest,discipline,54,28,26
Zãrrãlis,arthas,1600,priest,discipline,234,115,119
Kukion,uldum,1600,priest,discipline,48,22,26
Smoochinz,sargeras,1600,priest,discipline,52,23,29
Bigsmart,tichondrius,1598,priest,discipline,56,25,31
Dupaforted,stormrage,1598,priest,discipline,71,26,45
Valeilah,illidan,1597,priest,discipline,126,80,46
Healzyea,eonar,1597,priest,discipline,48,28,20
Spx,frostmourne,1597,priest,discipline,84,46,38
Zackor,maiev,1597,priest,discipline,64,34,30
Shutkap,sargeras,1597,priest,discipline,48,23,25
Pocserpriest,drakkari,1597,priest,discipline,44,21,23
Mdibaxx,tichondrius,1597,priest,discipline,89,40,49
Healther,firetree,1596,priest,discipline,48,24,24
Pettypriest,dalaran,1596,priest,discipline,79,39,40
Ivorytiger,bleeding-hollow,1596,priest,discipline,42,19,23
Takethat,emerald-dream,1595,priest,discipline,90,58,32
Serenewisp,tichondrius,1595,priest,discipline,101,48,53
Onezor,frostmourne,1594,priest,discipline,78,39,39
Gummachine,tichondrius,1594,priest,discipline,36,17,19
Comana,frostmourne,1594,priest,discipline,53,25,28
Blacklog,darkspear,1593,priest,discipline,50,25,25
Winsforgoldd,area-52,1593,priest,discipline,57,28,29
Ariês,tichondrius,1593,priest,discipline,60,22,38
Planchebois,zuljin,1592,priest,discipline,36,20,16
Vehex,malganis,1591,priest,discipline,30,20,10
Astalail,emerald-dream,1591,priest,discipline,40,21,19
Dellitor,illidan,1591,priest,discipline,65,33,32
Darenlor,tichondrius,1591,priest,discipline,165,82,83
Blobble,tichondrius,1591,priest,discipline,132,65,67
Yugewap,hyjal,1590,priest,discipline,202,115,87
Aralia,ragnaros,1590,priest,discipline,152,76,76
Isteri,thrall,1590,priest,discipline,52,26,26
Woosanghong,tichondrius,1590,priest,discipline,90,44,46
Sanitizer,frostmourne,1590,priest,discipline,60,28,32
Emotionally,sargeras,1589,priest,discipline,30,20,10
Karmapi,malganis,1589,priest,discipline,54,31,23
Ems,dawnbringer,1589,priest,discipline,243,122,121
Ooft,tichondrius,1589,priest,discipline,46,23,23
Lilbaldjosh,frostmourne,1589,priest,discipline,120,54,66
Bigolbush,moon-guard,1588,priest,discipline,24,17,7
Notoriousmmä,illidan,1588,priest,discipline,75,45,30
Daleyn,ragnaros,1588,priest,discipline,54,30,24
Scpzi,frostmourne,1588,priest,discipline,42,21,21
Raffimilk,tichondrius,1588,priest,discipline,45,22,23
Eggsdenny,illidan,1588,priest,discipline,36,17,19
Rondrica,stormscale,1587,priest,discipline,48,31,17
Voltstein,dalaran,1587,priest,discipline,199,105,94
Buchöna,quelthalas,1587,priest,discipline,113,58,55
Primael,tichondrius,1587,priest,discipline,40,18,22
Highasf,sargeras,1586,priest,discipline,78,45,33
Motions,frostmourne,1586,priest,discipline,56,23,33
Magnuscorp,illidan,1585,priest,discipline,36,20,16
Playsoon,illidan,1585,priest,discipline,130,70,60
Säcrilege,drakkari,1585,priest,discipline,231,123,108
Deadnyx,tichondrius,1585,priest,discipline,42,22,20
Akëla,nemesis,1585,priest,discipline,159,78,81
Angeldawn,stormrage,1585,priest,discipline,40,18,22
Medikhurts,bleeding-hollow,1584,priest,discipline,36,23,13
Arkeyz,quelthalas,1584,priest,discipline,60,30,30
Hermeneutic,illidan,1584,priest,discipline,45,22,23
Tý,frostmourne,1584,priest,discipline,54,24,30
Lovesthebox,frostmourne,1584,priest,discipline,108,47,61
Dotsfortots,malfurion,1583,priest,discipline,41,21,20
Cigarillõ,thrall,1583,priest,discipline,35,17,18
Puttles,tichondrius,1583,priest,discipline,83,33,50
Tastyloads,illidan,1582,priest,discipline,144,74,70
Sacrify,ragnaros,1582,priest,discipline,231,114,117
Vanderbeek,frostmourne,1582,priest,discipline,84,39,45
Bisholan,frostwolf,1582,priest,discipline,97,43,54
Supôrte,nemesis,1581,priest,discipline,101,54,47
Weapestrong,tichondrius,1581,priest,discipline,48,24,24
Shieldharder,stormrage,1581,priest,discipline,39,18,21
Gus,the-venture-co,1580,priest,discipline,78,44,34
Ayabae,illidan,1580,priest,discipline,963,473,490
Dasaq,sargeras,1580,priest,discipline,48,19,29
Cringepriest,area-52,1579,priest,discipline,54,33,21
Faithmelter,stormrage,1579,priest,discipline,167,89,78
Tyksu,area-52,1579,priest,discipline,201,106,95
Csjy,illidan,1579,priest,discipline,78,37,41
Carti,bleeding-hollow,1578,priest,discipline,244,135,109
Zyklonova,frostmourne,1578,priest,discipline,42,22,20
Zombiz,tichondrius,1577,priest,discipline,59,32,27
Sensaye,dalaran,1577,priest,discipline,150,76,74
Marshpillow,barthilas,1577,priest,discipline,192,96,96
Zizziz,tichondrius,1577,priest,discipline,66,33,33
Katlø,stormrage,1576,priest,discipline,49,29,20
Bater,mugthol,1576,priest,discipline,52,30,22
Rexîfy,zuljin,1576,priest,discipline,75,43,32
Lolweedbro,illidan,1576,priest,discipline,160,90,70
Alaran,magtheridon,1576,priest,discipline,47,23,24
Knucklesandy,tichondrius,1576,priest,discipline,35,17,18
Oyy,barthilas,1576,priest,discipline,102,48,54
Mettypws,tichondrius,1576,priest,discipline,71,33,38
Staysmall,stormrage,1576,priest,discipline,42,19,23
Descubra,stormrage,1575,priest,discipline,102,60,42
Blindingstar,area-52,1575,priest,discipline,69,39,30
Amaranth,the-forgotten-coast,1575,priest,discipline,48,26,22
Honeyduutch,black-dragonflight,1575,priest,discipline,90,44,46
Ketapriest,frostmourne,1575,priest,discipline,142,67,75
Yungbaker,area-52,1574,priest,discipline,29,17,12
Discobish,sargeras,1574,priest,discipline,48,21,27
Brezi,azralon,1573,priest,discipline,53,32,21
Fleshsack,area-52,1573,priest,discipline,30,17,13
Skillfull,chogall,1573,priest,discipline,312,168,144
Hopanda,tichondrius,1573,priest,discipline,89,47,42
Catpictures,stormrage,1573,priest,discipline,54,26,28
Kihlupr,frostmourne,1573,priest,discipline,58,25,33
Cäpriestsunn,thrall,1572,priest,discipline,36,22,14
Hoshx,sargeras,1572,priest,discipline,87,49,38
Overpriest,ragnaros,1572,priest,discipline,40,22,18
Bubblebuddí,tichondrius,1572,priest,discipline,68,37,31
Flatlining,illidan,1572,priest,discipline,90,48,42
Seriosity,kelthuzad,1572,priest,discipline,54,23,31
Anastasìá,barthilas,1572,priest,discipline,64,23,41
Archeo,area-52,1572,priest,discipline,60,19,41
Madpriest,blades-edge,1571,priest,discipline,36,20,16
Bushybush,darkspear,1571,priest,discipline,120,63,57
Tokaru,frostmourne,1571,priest,discipline,56,26,30
Whitecaster,tichondrius,1570,priest,discipline,30,17,13
Gommacura,stormrage,1570,priest,discipline,405,208,197
Zinnar,dalaran,1570,priest,discipline,120,54,66
Liteztvp,tichondrius,1570,priest,discipline,168,75,93
Soõ,tichondrius,1569,priest,discipline,33,21,12
Goo,boulderfist,1569,priest,discipline,48,29,19
Ppsp,azralon,1569,priest,discipline,42,25,17
Incisions,moon-guard,1569,priest,discipline,114,61,53
Ol,firetree,1569,priest,discipline,57,28,29
Purgen,tichondrius,1568,priest,discipline,36,20,16
Sêlbus,stormrage,1568,priest,discipline,287,148,139
Holécriss,tichondrius,1568,priest,discipline,173,88,85
Lelenia,tichondrius,1568,priest,discipline,130,65,65
Disperse,vashj,1568,priest,discipline,197,96,101
Hennywhite,sargeras,1568,priest,discipline,107,51,56
Aleana,ragnaros,1568,priest,discipline,54,25,29
Padrekevedø,azralon,1567,priest,discipline,42,27,15
Sïlvermoon,ravencrest,1567,priest,discipline,36,20,16
Safetyy,bleeding-hollow,1567,priest,discipline,44,24,20
Feymuhs,blackrock,1567,priest,discipline,90,48,42
Aphrodìtë,tichondrius,1567,priest,discipline,145,75,70
Karebenniian,area-52,1567,priest,discipline,117,59,58
Fairlightpp,zuljin,1567,priest,discipline,78,39,39
Priestykro,stormrage,1567,priest,discipline,60,28,32
Itsmurphy,sargeras,1567,priest,discipline,156,72,84
Gospels,tichondrius,1566,priest,discipline,52,37,15
Kflexx,hydraxis,1566,priest,discipline,158,64,94
Alexsp,amanthul,1565,priest,discipline,76,45,31
Sacredlight,malygos,1565,priest,discipline,117,61,56
Amayå,kelthuzad,1565,priest,discipline,54,23,31
Feivalentine,illidan,1565,priest,discipline,42,17,25
Scarabless,bleeding-hollow,1564,priest,discipline,138,62,76
Whateverbrah,tichondrius,1564,priest,discipline,45,20,25
Goodvybes,tichondrius,1563,priest,discipline,89,46,43
Valdurai,stormrage,1563,priest,discipline,47,24,23
Myles,alexstrasza,1563,priest,discipline,186,93,93
Soyul,tichondrius,1563,priest,discipline,47,19,28
Hadtogothere,kelthuzad,1562,priest,discipline,209,103,106
Zortkis,garithos,1562,priest,discipline,58,25,33
Dreaminz,tichondrius,1561,priest,discipline,42,26,16
Maomaoangel,tichondrius,1561,priest,discipline,60,30,30
Jjmms,akama,1561,priest,discipline,322,149,173
Jylertason,kelthuzad,1561,priest,discipline,58,26,32
Eshimä,quelthalas,1560,priest,discipline,138,82,56
Antifaithx,frostmourne,1560,priest,discipline,36,21,15
Googolplex,tichondrius,1560,priest,discipline,93,54,39
Verna,dunemaul,1560,priest,discipline,91,50,41
Holyvoice,wyrmrest-accord,1560,priest,discipline,75,40,35
Shathraxi,crushridge,1560,priest,discipline,48,21,27
Moustachío,stormrage,1559,priest,discipline,59,27,32
Melitele,magtheridon,1558,priest,discipline,36,21,15
Vanco,tichondrius,1558,priest,discipline,59,32,27
Twistinfate,hyjal,1558,priest,discipline,119,58,61
Someonesxy,aggramar,1558,priest,discipline,46,22,24
Siddhar,illidan,1558,priest,discipline,49,23,26
Pennumbra,barthilas,1558,priest,discipline,84,31,53
Bobelgum,emerald-dream,1557,priest,discipline,42,31,11
Qenq,tichondrius,1557,priest,discipline,30,17,13
Zachlol,area-52,1557,priest,discipline,108,61,47
Vullena,moon-guard,1557,priest,discipline,152,80,72
Gucciflops,tichondrius,1557,priest,discipline,48,25,23
Illuminare,sargeras,1557,priest,discipline,166,85,81
Dontgome,proudmoore,1557,priest,discipline,42,21,21
Ropriest,frostmourne,1557,priest,discipline,59,29,30
Zelfina,arthas,1557,priest,discipline,42,20,22
Datdarnbéar,stormrage,1557,priest,discipline,54,25,29
Chocopp,illidan,1557,priest,discipline,78,33,45
Luxah,bloodhoof,1556,priest,discipline,51,31,20
Qoon,tichondrius,1556,priest,discipline,30,17,13
Vicara,moon-guard,1556,priest,discipline,129,57,72
Tarlonypp,malganis,1555,priest,discipline,45,22,23
Avashar,illidan,1555,priest,discipline,42,20,22
Sinnskløft,tichondrius,1555,priest,discipline,56,23,33
Josquin,illidan,1554,priest,discipline,120,60,60
Marantbourge,frostmourne,1554,priest,discipline,146,71,75
Overshields,caelestrasz,1554,priest,discipline,52,19,33
Hiraa,frostmourne,1553,priest,discipline,36,23,13
Saentha,sargeras,1553,priest,discipline,74,40,34
Cario,emerald-dream,1553,priest,discipline,45,24,21
Gilthðniel,quelthalas,1552,priest,discipline,231,111,120
Mfynch,sargeras,1551,priest,discipline,66,40,26
Grannieslove,sargeras,1551,priest,discipline,48,28,20
Magazíne,tichondrius,1551,priest,discipline,42,23,19
Leliane,tichondrius,1551,priest,discipline,66,35,31
Sorrowful,mannoroth,1550,priest,discipline,30,19,11
Sensitive,eitrigg,1550,priest,discipline,36,22,14
Cultxo,sargeras,1550,priest,discipline,66,37,29
Orzington,laughing-skull,1550,priest,discipline,122,66,56
Unisia,tichondrius,1550,priest,discipline,98,41,57
Rebzyyx,tichondrius,1549,priest,discipline,38,25,13
Senpriest,ragnaros,1549,priest,discipline,35,21,14
Jabreez,illidan,1549,priest,discipline,59,35,24
Rousesz,ragnaros,1549,priest,discipline,42,23,19
Keaina,malganis,1549,priest,discipline,49,25,24
Önagashøw,azralon,1549,priest,discipline,277,140,137
Rourk,medivh,1549,priest,discipline,161,81,80
Spacecowboyz,stormrage,1549,priest,discipline,60,30,30
Lydra,ragnaros,1549,priest,discipline,231,109,122
Rdson,malganis,1549,priest,discipline,43,18,25
Fámóus,stormrage,1549,priest,discipline,83,30,53
Nisagerx,tichondrius,1548,priest,discipline,33,19,14
Mudshadow,tichondrius,1548,priest,discipline,138,71,67
Nelfpriest,khadgar,1548,priest,discipline,89,44,45
Inerluna,tichondrius,1548,priest,discipline,75,31,44
Kencyy,tichondrius,1547,priest,discipline,30,19,11
Azureslaps,tichondrius,1547,priest,discipline,218,109,109
Jugeumx,proudmoore,1547,priest,discipline,48,19,29
Uriyel,quelthalas,1546,priest,discipline,119,62,57
Androalis,thaurissan,1546,priest,discipline,102,53,49
Zugzugheal,bleeding-hollow,1546,priest,discipline,75,35,40
Bóì,barthilas,1545,priest,discipline,36,26,10
Jtrxyz,tichondrius,1545,priest,discipline,30,18,12
Wisher,tichondrius,1545,priest,discipline,188,89,99
Shadöwtest,quelthalas,1545,priest,discipline,113,49,64
Juckerr,tichondrius,1544,priest,discipline,251,132,119
Ricekak,haomarush,1543,priest,discipline,78,46,32
Curemeste,illidan,1543,priest,discipline,151,81,70
Matics,tichondrius,1543,priest,discipline,62,33,29
Xillak,ragnaros,1543,priest,discipline,36,19,17
Dawnsy,arygos,1543,priest,discipline,56,26,30
Played,dark-iron,1543,priest,discipline,62,24,38
Happylonely,farstriders,1542,priest,discipline,33,20,13
Justashadow,zangarmarsh,1542,priest,discipline,103,59,44
Metick,illidan,1542,priest,discipline,48,18,30
Benin,shattered-hand,1541,priest,discipline,36,22,14
Extel,sargeras,1541,priest,discipline,54,30,24
Zórg,stormrage,1541,priest,discipline,56,30,26
Makuwu,area-52,1541,priest,discipline,93,49,44
Winss,tichondrius,1541,priest,discipline,220,114,106
Jacksreturne,kelthuzad,1541,priest,discipline,502,255,247
Slipzie,sargeras,1540,priest,discipline,95,55,40
Qmabayteckkl,tichondrius,1540,priest,discipline,42,23,19
Shastyr,tichondrius,1540,priest,discipline,90,46,44
Alex,boulderfist,1540,priest,discipline,189,90,99
Unholyhusky,sargeras,1539,priest,discipline,60,38,22
Voidmutex,emerald-dream,1539,priest,discipline,41,22,19
Daddydoeet,zuljin,1539,priest,discipline,42,22,20
Akayayuelol,tichondrius,1538,priest,discipline,37,28,9
Life,thrall,1538,priest,discipline,101,50,51
Mutilla,tichondrius,1537,priest,discipline,32,22,10
Shadowdaddy,barthilas,1537,priest,discipline,96,55,41
Yangpriest,malfurion,1537,priest,discipline,51,26,25
Babirygen,khaz-modan,1537,priest,discipline,48,23,25
Voidrachet,thrall,1537,priest,discipline,48,18,30
Tokoyo,sargeras,1536,priest,discipline,82,53,29
Croissånt,illidan,1536,priest,discipline,30,18,12
Sportsgloss,tichondrius,1536,priest,discipline,132,73,59
Calientaeggs,drakkari,1536,priest,discipline,382,202,180
Psyclicker,zuljin,1536,priest,discipline,47,23,24
Shadowgobbo,thrall,1536,priest,discipline,66,31,35
Priestsz,stormrage,1535,priest,discipline,169,90,79
Zivn,tichondrius,1535,priest,discipline,766,399,367
Santhiel,ragnaros,1535,priest,discipline,42,18,24
Mattkoster,mannoroth,1535,priest,discipline,44,17,27
Mswatermelon,malganis,1534,priest,discipline,44,24,20
Sevÿ,malygos,1534,priest,discipline,40,20,20
Dopeyspriest,area-52,1534,priest,discipline,50,24,26
Maid,demon-soul,1534,priest,discipline,63,28,35
Anastasiá,barthilas,1534,priest,discipline,48,21,27
Shadowglezy,area-52,1533,priest,discipline,107,59,48
Wtfamdoing,quelthalas,1533,priest,discipline,65,35,30
Baìter,zuljin,1533,priest,discipline,89,47,42
Wiñtér,tichondrius,1533,priest,discipline,54,28,26
Vorazzun,quelthalas,1533,priest,discipline,100,50,50
Priesmatco,area-52,1533,priest,discipline,81,40,41
Holdentudikz,area-52,1533,priest,discipline,89,43,46
Suitoo,ragnaros,1533,priest,discipline,54,25,29
Nesx,azuremyst,1532,priest,discipline,66,40,26
Zsofi,rivendare,1532,priest,discipline,116,54,62
Cityboyy,tichondrius,1532,priest,discipline,37,17,20
Goatedpriest,kelthuzad,1531,priest,discipline,24,16,8
Wbu,frostmourne,1531,priest,discipline,28,17,11
Pryst,bonechewer,1531,priest,discipline,54,28,26
Vañity,malganis,1531,priest,discipline,66,33,33
Nonbinary,trollbane,1531,priest,discipline,60,26,34
Mombi,bloodhoof,1530,priest,discipline,30,18,12
Besó,proudmoore,1530,priest,discipline,144,81,63
Merkinhealz,darkspear,1530,priest,discipline,112,59,53
Emytoty,ragnaros,1530,priest,discipline,190,99,91
Aríola,frostmourne,1529,priest,discipline,69,37,32
Truce,moon-guard,1528,priest,discipline,77,39,38
Mindblasterx,kelthuzad,1528,priest,discipline,345,171,174
Bigwap,illidan,1528,priest,discipline,66,30,36
Rafers,tichondrius,1528,priest,discipline,36,16,20
Epijho,area-52,1527,priest,discipline,42,25,17
Jamesxupttv,draenor,1527,priest,discipline,82,48,34
Slippedadisc,kelthuzad,1527,priest,discipline,108,59,49
Kencyx,tichondrius,1527,priest,discipline,30,16,14
Lightsight,burning-blade,1527,priest,discipline,30,16,14
Vezaxx,barthilas,1527,priest,discipline,178,92,86
Luxury,blackrock,1527,priest,discipline,54,27,27
Suekmydisc,frostmourne,1526,priest,discipline,36,20,16
Nerfdisc,azralon,1526,priest,discipline,159,84,75
Lolcrafthd,ragnaros,1526,priest,discipline,124,62,62
Alëssana,illidan,1526,priest,discipline,128,63,65
Mastahspell,illidan,1526,priest,discipline,36,16,20
Wonpaipri,frostmourne,1526,priest,discipline,110,48,62
Ghostchant,thrall,1525,priest,discipline,41,20,21
Pilixil,bleeding-hollow,1525,priest,discipline,72,35,37
Tooze,draka,1525,priest,discipline,60,27,33
Umbrous,ysera,1525,priest,discipline,42,18,24
Ååron,illidan,1524,priest,discipline,76,44,32
Gankdez,kelthuzad,1524,priest,discipline,136,69,67
Rómmul,azralon,1524,priest,discipline,71,34,37
Psÿçhë,stormrage,1524,priest,discipline,36,16,20
Somethingkoo,sargeras,1523,priest,discipline,83,46,37
Sonofbetch,emerald-dream,1523,priest,discipline,55,30,25
Swiggster,thrall,1523,priest,discipline,84,44,40
Bloodytears,kiljaeden,1523,priest,discipline,138,65,73
Ivf,darrowmere,1523,priest,discipline,125,57,68
Antonietta,drakkari,1522,priest,discipline,24,16,8
Ricopri,frostmourne,1522,priest,discipline,36,23,13
Sadnez,illidan,1522,priest,discipline,157,89,68
Madhairy,ragnaros,1522,priest,discipline,126,65,61
Niurouchuan,tichondrius,1522,priest,discipline,123,60,63
Lauretânia,nemesis,1522,priest,discipline,146,71,75
Zenobiai,hyjal,1521,priest,discipline,163,87,76
Rhima,tichondrius,1521,priest,discipline,133,67,66
Elysiana,wyrmrest-accord,1521,priest,discipline,66,33,33
Pheener,stormreaver,1521,priest,discipline,198,97,101
Frymii,frostmourne,1521,priest,discipline,36,16,20
Magpul,arthas,1521,priest,discipline,36,16,20
Herder,zuljin,1520,priest,discipline,52,30,22
Angusb,sargeras,1520,priest,discipline,170,85,85
Ezzy,bleeding-hollow,1520,priest,discipline,48,24,24
Razledazzled,grizzly-hills,1520,priest,discipline,133,63,70
Oneinurdome,moknathal,1520,priest,discipline,60,28,32
Vegfem,dalaran,1520,priest,discipline,64,27,37
Holyclappah,illidan,1519,priest,discipline,233,122,111
Radackan,quelthalas,1519,priest,discipline,117,61,56
Kimjongdots,illidan,1519,priest,discipline,56,29,27
Hideyason,area-52,1519,priest,discipline,60,31,29
Zllik,illidan,1519,priest,discipline,101,52,49
Friendzonefw,illidan,1519,priest,discipline,144,71,73
Dædrà,stormrage,1519,priest,discipline,76,37,39
Blessrish,icecrown,1519,priest,discipline,66,31,35
Akuhei,illidan,1518,priest,discipline,24,16,8
Peacewrench,moon-guard,1518,priest,discipline,118,59,59
Cexcexyomi,tichondrius,1517,priest,discipline,94,50,44
Erinzdern,quelthalas,1517,priest,discipline,88,43,45
Joní,malganis,1517,priest,discipline,41,18,23
Tbirdpriest,tichondrius,1516,priest,discipline,46,27,19
Ilickdeadppl,sargeras,1516,priest,discipline,82,47,35
Swapsy,illidan,1516,priest,discipline,53,29,24
Bonnieron,frostmourne,1516,priest,discipline,77,39,38
Triangle,draka,1516,priest,discipline,36,17,19
Drupmonst,dalaran,1516,priest,discipline,60,26,34
Vels,blackrock,1515,priest,discipline,30,18,12
Dsls,daggerspine,1515,priest,discipline,30,16,14
Lyrä,kiljaeden,1515,priest,discipline,102,54,48
Lavenderism,moon-guard,1515,priest,discipline,96,50,46
Undevout,tichondrius,1515,priest,discipline,36,16,20
Mxst,frostmourne,1514,priest,discipline,18,16,2
Stickypriest,dreadmaul,1514,priest,discipline,18,16,2
Defilex,tichondrius,1514,priest,discipline,56,39,17
Weakwind,burning-blade,1514,priest,discipline,56,33,23
Zenfromwish,frostmourne,1514,priest,discipline,68,37,31
Shnítzel,thrall,1514,priest,discipline,168,89,79
Thranduil,kiljaeden,1514,priest,discipline,142,75,67
Gamist,area-52,1514,priest,discipline,206,102,104
Tecnica,kelthuzad,1514,priest,discipline,155,75,80
Vonyka,area-52,1514,priest,discipline,48,23,25
Inssania,ragnaros,1513,priest,discipline,60,28,32
Gustáv,sargeras,1512,priest,discipline,72,37,35
Mse,eonar,1511,priest,discipline,48,26,22
Allysheedy,sargeras,1511,priest,discipline,54,29,25
Galestick,illidan,1511,priest,discipline,30,16,14
Ulzaar,nerzhul,1511,priest,discipline,89,37,52
Greyx,moon-guard,1510,priest,discipline,48,25,23
Absørptiøn,area-52,1510,priest,discipline,293,146,147
Manascythe,illidan,1510,priest,discipline,46,22,24
Zroheals,illidan,1510,priest,discipline,107,48,59
Agraheals,barthilas,1509,priest,discipline,42,22,20
Scræm,sargeras,1509,priest,discipline,115,52,63
Myds,sargeras,1508,priest,discipline,30,24,6
Aleykz,illidan,1508,priest,discipline,101,54,47
Ballzach,ysera,1508,priest,discipline,197,102,95
Mandymuze,barthilas,1508,priest,discipline,77,37,40
Labraidor,tichondrius,1508,priest,discipline,211,95,116
Melsebek,stormrage,1508,priest,discipline,58,26,32
Lildeen,area-52,1507,priest,discipline,44,26,18
Azuremissile,tichondrius,1507,priest,discipline,103,57,46
Billzerian,nemesis,1507,priest,discipline,141,75,66
Boujeeheals,darkspear,1507,priest,discipline,48,22,26
Propagàndhi,daggerspine,1507,priest,discipline,158,72,86
Sâishâ,proudmoore,1507,priest,discipline,194,85,109
Shadyhoe,alterac-mountains,1506,priest,discipline,21,17,4
Hawtzp,stormrage,1506,priest,discipline,42,24,18
Tartapelle,zuljin,1506,priest,discipline,90,51,39
Ndeezy,malganis,1506,priest,discipline,30,16,14
Forsakenz,jaedenar,1506,priest,discipline,102,50,52
Diskope,kelthuzad,1505,priest,discipline,24,16,8
Altarboy,agamaggan,1505,priest,discipline,62,30,32
Idolize,proudmoore,1505,priest,discipline,98,44,54
Tazzi,chromaggus,1504,priest,discipline,73,44,29
Dadcantdeath,frostmourne,1504,priest,discipline,93,51,42
Blinxed,tichondrius,1504,priest,discipline,120,59,61
Legó,illidan,1504,priest,discipline,60,29,31
Daburnz,bleeding-hollow,1504,priest,discipline,120,57,63
Pootzy,malganis,1504,priest,discipline,87,36,51
Shonkee,tichondrius,1503,priest,discipline,33,20,13
Littledog,velen,1503,priest,discipline,64,33,31
Brahp,frostmourne,1503,priest,discipline,53,19,34
Khaoticdark,stormrage,1502,priest,discipline,36,20,16
Pics,emerald-dream,1502,priest,discipline,48,22,26
Artista,quelthalas,1501,priest,discipline,100,54,46
Yoozi,sargeras,1501,priest,discipline,126,63,63
Compromise,the-scryers,1501,priest,discipline,64,30,34
Bailez,malganis,1500,priest,discipline,55,30,25
Xtri,kelthuzad,1500,priest,discipline,36,19,17
Kaguyä,ragnaros,1500,priest,discipline,101,51,50
Braffuki,frostmourne,1500,priest,discipline,107,54,53
Valtres,tichondrius,1499,priest,discipline,30,16,14
Somnix,emerald-dream,1499,priest,discipline,140,70,70
Shunio,illidan,1499,priest,discipline,60,25,35
Jpray,bleeding-hollow,1498,priest,discipline,121,65,56
Aexdawg,malganis,1498,priest,discipline,126,67,59
Delrey,sargeras,1498,priest,discipline,56,28,28
Boundword,emerald-dream,1498,priest,discipline,142,66,76
Meepsw,stormrage,1498,priest,discipline,78,36,42
Inkders,detheroc,1498,priest,discipline,58,26,32
Hotpockets,detheroc,1497,priest,discipline,29,16,13
Unholyhand,moon-guard,1497,priest,discipline,84,45,39
Yorp,tichondrius,1497,priest,discipline,72,36,36
Malpractíce,zuljin,1497,priest,discipline,119,59,60
Thottee,bleeding-hollow,1497,priest,discipline,120,55,65
Valixia,sargeras,1497,priest,discipline,90,41,49
Venustas,daggerspine,1497,priest,discipline,72,29,43
Prniss,tichondrius,1496,priest,discipline,41,25,16
Doutoodou,tichondrius,1495,priest,discipline,94,55,39
Mtito,drakkari,1495,priest,discipline,49,27,22
Penummbra,frostmourne,1495,priest,discipline,30,16,14
Amarexlol,stormrage,1495,priest,discipline,54,27,27
Holymagetv,tichondrius,1495,priest,discipline,62,27,35
Klowdz,burning-blade,1494,priest,discipline,311,163,148
Späcehulk,illidan,1494,priest,discipline,55,22,33
Sgiath,alleria,1493,priest,discipline,42,30,12
Sleezi,emerald-dream,1493,priest,discipline,60,34,26
Healthreat,area-52,1493,priest,discipline,76,42,34
Bradythree,moon-guard,1493,priest,discipline,38,20,18
Keyoshe,altar-of-storms,1493,priest,discipline,295,146,149
Prayf,area-52,1493,priest,discipline,245,121,124
Ruminationz,stormrage,1493,priest,discipline,274,129,145
Weezyxo,tichondrius,1493,priest,discipline,46,19,27
Phasmaaxd,tichondrius,1492,priest,discipline,89,48,41
Dbod,tichondrius,1492,priest,discipline,251,126,125
Bubblerwrapp,malganis,1492,priest,discipline,36,17,19
Rezee,kelthuzad,1491,priest,discipline,28,17,11
Constin,doomhammer,1491,priest,discipline,36,20,16
Saiyana,frostmourne,1491,priest,discipline,178,87,91
Brakála,ragnaros,1491,priest,discipline,48,21,27
Cobjr,frostmourne,1490,priest,discipline,52,29,23
Huevos,blackwing-lair,1490,priest,discipline,156,83,73
Vemilli,tichondrius,1490,priest,discipline,46,23,23
Helarix,malganis,1490,priest,discipline,175,86,89
Kalilol,tichondrius,1490,priest,discipline,132,61,71
Somberr,dalaran,1489,priest,discipline,47,26,21
Triggaz,tichondrius,1489,priest,discipline,138,75,63
Inot,nemesis,1489,priest,discipline,121,56,65
Alelith,quelthalas,1489,priest,discipline,59,27,32
Discobluntzz,tichondrius,1488,priest,discipline,54,31,23
Sibble,boulderfist,1488,priest,discipline,101,49,52
Howdaw,tichondrius,1488,priest,discipline,59,26,33
Durtybubz,tichondrius,1487,priest,discipline,167,95,72
Watchemeyolo,tichondrius,1487,priest,discipline,66,35,31
Sermøn,azuremyst,1487,priest,discipline,321,166,155
Luxyel,azralon,1487,priest,discipline,149,65,84
Xtty,thrall,1486,priest,discipline,43,24,19
Coldphobia,uldum,1486,priest,discipline,245,132,113
Windroseh,proudmoore,1486,priest,discipline,60,32,28
Tyszie,sargeras,1485,priest,discipline,36,20,16
Tëmpting,moon-guard,1485,priest,discipline,50,25,25
Kiritomauti,ragnaros,1485,priest,discipline,58,28,30
Aerdaras,illidan,1485,priest,discipline,80,36,44
Sëv,stormrage,1485,priest,discipline,41,18,23
Drully,moon-guard,1484,priest,discipline,172,86,86
Chernota,kiljaeden,1484,priest,discipline,108,52,56
Griddly,alterac-mountains,1483,priest,discipline,108,57,51
Dingldangle,tichondrius,1483,priest,discipline,144,70,74
Arzaei,quelthalas,1483,priest,discipline,130,61,69
Blacklightz,korgath,1483,priest,discipline,91,42,49
Prff,ragnaros,1483,priest,discipline,42,19,23
Stynke,bleeding-hollow,1483,priest,discipline,66,20,46
Sauile,kelthuzad,1482,priest,discipline,168,94,74
Vampiric,laughing-skull,1482,priest,discipline,60,33,27
Trickyhobo,area-52,1482,priest,discipline,151,80,71
Rháényra,tichondrius,1482,priest,discipline,48,25,23
Nottahealer,anvilmar,1482,priest,discipline,42,20,22
Lumia,quelthalas,1482,priest,discipline,45,19,26
Iinu,tichondrius,1481,priest,discipline,137,72,65
Pvprashida,tichondrius,1481,priest,discipline,136,67,69
Buqisama,barthilas,1481,priest,discipline,102,47,55
Bakøo,tichondrius,1480,priest,discipline,49,32,17
Pipete,frostmourne,1480,priest,discipline,174,98,76
Kuriyasu,emerald-dream,1480,priest,discipline,209,113,96
Dontstopxo,lightbringer,1480,priest,discipline,76,37,39
Toxictampax,azjolnerub,1480,priest,discipline,114,55,59
Sineater,zuljin,1480,priest,discipline,83,40,43
Hysteria,dalaran,1480,priest,discipline,70,33,37
Sstar,area-52,1479,priest,discipline,24,16,8
Holymeta,dunemaul,1479,priest,discipline,72,42,30
Steefe,arygos,1479,priest,discipline,38,21,17
Minii,tichondrius,1479,priest,discipline,103,55,48
Nvroom,illidan,1479,priest,discipline,55,28,27
Aumsi,illidan,1479,priest,discipline,104,48,56
Jodaa,sargeras,1478,priest,discipline,36,17,19
Mørathy,ragnaros,1477,priest,discipline,72,46,26
Jinxaleyster,ragnaros,1477,priest,discipline,143,81,62
Thorzan,eredar,1477,priest,discipline,48,26,22
Preacharóund,frostmourne,1477,priest,discipline,146,74,72
Zerolyn,tichondrius,1476,priest,discipline,131,70,61
Thadino,nagrand,1476,priest,discipline,126,61,65
Shaytyme,tichondrius,1476,priest,discipline,62,23,39
Imcringing,illidan,1475,priest,discipline,48,30,18
Jjløver,tichondrius,1475,priest,discipline,31,19,12
Madjak,lightnings-blade,1475,priest,discipline,126,72,54
Luanwanx,tichondrius,1475,priest,discipline,91,51,40
Mightydrëk,malganis,1475,priest,discipline,29,16,13
Sinzex,tichondrius,1475,priest,discipline,84,45,39
Daelynne,area-52,1475,priest,discipline,34,17,17
Bittyheals,illidan,1475,priest,discipline,48,22,26
Faxingberlin,sargeras,1475,priest,discipline,46,18,28
Haizsu,tichondrius,1474,priest,discipline,77,38,39
Dabaksp,area-52,1474,priest,discipline,63,31,32
Visìons,tichondrius,1474,priest,discipline,66,30,36
Xîîaotong,tichondrius,1473,priest,discipline,37,23,14
Alyndral,illidan,1473,priest,discipline,50,29,21
Ringofvalor,lightnings-blade,1473,priest,discipline,160,85,75
Swagndragon,zuljin,1473,priest,discipline,86,42,44
Bushwaker,darkspear,1472,priest,discipline,59,33,26
Lily,blackrock,1472,priest,discipline,36,19,17
Euphotic,tichondrius,1472,priest,discipline,75,38,37
Talripington,area-52,1471,priest,discipline,41,25,16
Rufían,quelthalas,1471,priest,discipline,48,25,23
Brian,lightnings-blade,1471,priest,discipline,52,27,25
Confesiional,area-52,1471,priest,discipline,71,32,39
Bigtimeplay,tichondrius,1470,priest,discipline,42,25,17
Kiddonia,whisperwind,1470,priest,discipline,51,25,26
Doesine,area-52,1469,priest,discipline,42,25,17
Zjqf,akama,1469,priest,discipline,185,94,91
Travoidicus,wyrmrest-accord,1469,priest,discipline,109,55,54
Vacyle,azralon,1468,priest,discipline,174,93,81
Draazja,dalaran,1468,priest,discipline,146,74,72
Zerola,sargeras,1468,priest,discipline,71,34,37
Temnah,sargeras,1468,priest,discipline,50,22,28
Dazull,bleeding-hollow,1468,priest,discipline,41,16,25
Dorashadows,tichondrius,1467,priest,discipline,24,17,7
Sandfire,thrall,1467,priest,discipline,30,16,14
Stargoddess,illidan,1467,priest,discipline,168,84,84
Krymze,tichondrius,1467,priest,discipline,36,16,20
Saxy,quelthalas,1466,priest,discipline,68,38,30
Blodwell,illidan,1466,priest,discipline,133,67,66
Basisc,frostmourne,1465,priest,discipline,219,122,97
Wöödy,area-52,1465,priest,discipline,40,21,19
Whehaw,kelthuzad,1465,priest,discipline,143,71,72
Azaradet,ragnaros,1465,priest,discipline,87,36,51
Aizetsu,sargeras,1464,priest,discipline,36,21,15
Billymaays,azgalor,1464,priest,discipline,145,80,65
Vøidroid,malganis,1464,priest,discipline,156,82,74
Apâthy,area-52,1464,priest,discipline,69,32,37
Dib,arathor,1463,priest,discipline,48,25,23
Bandèl,tichondrius,1462,priest,discipline,48,31,17
Frogfrompad,tichondrius,1462,priest,discipline,89,54,35
Tajee,area-52,1462,priest,discipline,271,140,131
Gðttlich,stormrage,1462,priest,discipline,38,19,19
Yeyoz,tichondrius,1462,priest,discipline,124,60,64
Blavkata,area-52,1462,priest,discipline,76,30,46
Tallshiraz,destromath,1461,priest,discipline,76,46,30
Fallenumbra,area-52,1461,priest,discipline,77,44,33
Javox,drakkari,1461,priest,discipline,36,19,17
Chainsalight,stormrage,1461,priest,discipline,156,81,75
Holypuffs,burning-legion,1461,priest,discipline,77,35,42
Bloodify,azralon,1461,priest,discipline,121,54,67
Syfy,thrall,1461,priest,discipline,114,48,66
Thyrians,ragnaros,1460,priest,discipline,42,24,18
Joktips,proudmoore,1460,priest,discipline,174,94,80
Bugsbright,tichondrius,1459,priest,discipline,256,137,119
Fanatic,nemesis,1459,priest,discipline,399,206,193
Femìnazzi,ragnaros,1458,priest,discipline,88,48,40
Renewed,frostmourne,1458,priest,discipline,52,28,24
Zaemyn,dalaran,1458,priest,discipline,50,22,28
Akåsha,zuljin,1458,priest,discipline,98,42,56
Sublîme,sargeras,1457,priest,discipline,105,61,44
Kafarmer,frostmourne,1457,priest,discipline,119,68,51
Ermec,azralon,1457,priest,discipline,48,22,26
Fleshliight,area-52,1456,priest,discipline,51,31,20
Shykaii,azralon,1456,priest,discipline,108,61,47
Sadistic,hyjal,1456,priest,discipline,118,59,59
Akovob,tichondrius,1456,priest,discipline,50,25,25
Payperbuff,tichondrius,1455,priest,discipline,30,20,10
Tiannatrump,stormrage,1455,priest,discipline,53,31,22
Sappes,area-52,1455,priest,discipline,200,110,90
Aleistria,emerald-dream,1454,priest,discipline,42,26,16
Lethalrosé,thrall,1454,priest,discipline,30,17,13
Icetraygang,suramar,1454,priest,discipline,421,224,197
Velastirra,saurfang,1454,priest,discipline,328,171,157
Solkadp,tichondrius,1454,priest,discipline,34,16,18
Modotszilla,bleeding-hollow,1454,priest,discipline,36,16,20
Grimspriest,moon-guard,1453,priest,discipline,47,23,24
Thoaxx,magtheridon,1453,priest,discipline,54,24,30
Havocshadows,deathwing,1452,priest,discipline,219,129,90
Aubieheal,malygos,1452,priest,discipline,91,50,41
Akash,ragnaros,1452,priest,discipline,71,39,32
Puddín,area-52,1452,priest,discipline,84,42,42
Mistàclean,tichondrius,1452,priest,discipline,89,43,46
Xeras,misha,1452,priest,discipline,47,21,26
Bobet,zuljin,1452,priest,discipline,73,28,45
Tonesandi,malganis,1451,priest,discipline,42,27,15
Noblesx,illidan,1451,priest,discipline,54,30,24
Høllywood,nazgrel,1451,priest,discipline,57,28,29
Beefoverload,durotan,1451,priest,discipline,141,66,75
Ssgpak,tichondrius,1450,priest,discipline,29,21,8
Spookynun,moon-guard,1450,priest,discipline,216,122,94
Jubalie,guldan,1450,priest,discipline,52,27,25
Guccigriimes,tichondrius,1450,priest,discipline,81,37,44
Bnn,arathor,1449,priest,discipline,23,16,7
Eirua,proudmoore,1449,priest,discipline,78,35,43
Notfandy,tichondrius,1449,priest,discipline,48,19,29
Nek,malganis,1448,priest,discipline,103,61,42
Spazmode,malganis,1448,priest,discipline,81,43,38
Tomseleck,frostmourne,1448,priest,discipline,35,16,19
Iivelaughluv,kiljaeden,1447,priest,discipline,69,40,29
Diableero,barthilas,1447,priest,discipline,47,26,21
Lexaprö,moon-guard,1447,priest,discipline,70,38,32
Sinsuu,tichondrius,1447,priest,discipline,192,104,88
Nolar,shadowmoon,1447,priest,discipline,90,40,50
Velzirya,zuljin,1447,priest,discipline,89,39,50
Newchaos,hakkar,1446,priest,discipline,40,24,16
Elagabal,tichondrius,1446,priest,discipline,36,19,17
Battlemage,magtheridon,1446,priest,discipline,111,58,53
Mileslol,azgalor,1446,priest,discipline,68,34,34
Mäe,nemesis,1446,priest,discipline,60,26,34
Sleepiest,wyrmrest-accord,1445,priest,discipline,49,26,23
Zeusqt,azralon,1445,priest,discipline,180,94,86
Krillan,ysera,1445,priest,discipline,120,61,59
Augustrox,ragnaros,1445,priest,discipline,164,78,86
Vhexz,sargeras,1444,priest,discipline,80,52,28
Aloo,zuljin,1444,priest,discipline,57,37,20
Fakechow,nathrezim,1444,priest,discipline,139,71,68
Blakalicious,illidan,1443,priest,discipline,39,27,12
Specialed,wildhammer,1443,priest,discipline,71,39,32
Paare,stormrage,1443,priest,discipline,42,21,21
Jeresh,sargeras,1443,priest,discipline,65,21,44
Winnzhor,bonechewer,1442,priest,discipline,100,57,43
Shalters,tichondrius,1442,priest,discipline,60,31,29
Famemolol,tichondrius,1442,priest,discipline,456,218,238
Easypriest,tichondrius,1441,priest,discipline,96,50,46
Sreykalip,frostmourne,1441,priest,discipline,48,24,24
Voidathon,sargeras,1441,priest,discipline,36,17,19
Shadowblax,thrall,1441,priest,discipline,160,75,85
Punkndrublic,sargeras,1440,priest,discipline,129,66,63
Lavazzå,tichondrius,1440,priest,discipline,36,18,18
Docmcstufins,darkspear,1440,priest,discipline,65,31,34
Kristyenna,boulderfist,1440,priest,discipline,42,20,22
Ínfocus,area-52,1440,priest,discipline,138,65,73
Zhatfko,illidan,1440,priest,discipline,78,31,47
Ðohko,ragnaros,1439,priest,discipline,42,25,17
Figueiredø,goldrinn,1439,priest,discipline,80,43,37
Ketaminè,tichondrius,1439,priest,discipline,54,29,25
Pinchevato,ragnaros,1439,priest,discipline,270,138,132
Scrubx,malganis,1438,priest,discipline,18,15,3
Bohomag,tichondrius,1438,priest,discipline,24,15,9
Necroshine,vashj,1438,priest,discipline,57,25,32
Mason,winterhoof,1437,priest,discipline,24,15,9
Heelznfeelz,tichondrius,1437,priest,discipline,45,23,22
Miaria,chogall,1437,priest,discipline,138,69,69
Joesus,kelthuzad,1437,priest,discipline,38,17,21
Arfaxad,quelthalas,1436,priest,discipline,18,15,3
Vivián,tichondrius,1436,priest,discipline,115,63,52
Compåctdisc,sargeras,1436,priest,discipline,36,18,18
Bryelx,ragnaros,1436,priest,discipline,174,84,90
Syruhl,tichondrius,1436,priest,discipline,35,16,19
Amãnita,illidan,1436,priest,discipline,35,15,20
Pphill,aegwynn,1436,priest,discipline,48,19,29
Floratil,ragnaros,1436,priest,discipline,60,23,37
Murdock,the-forgotten-coast,1435,priest,discipline,56,31,25
Jaindoe,illidan,1435,priest,discipline,159,84,75
Penetron,tichondrius,1435,priest,discipline,144,75,69
Bootycough,malganis,1435,priest,discipline,63,32,31
Rëckful,area-52,1435,priest,discipline,819,412,407
Conorpriest,tichondrius,1435,priest,discipline,30,15,15
Sliding,wyrmrest-accord,1435,priest,discipline,30,15,15
Lonpriest,stormrage,1435,priest,discipline,210,99,111
Earface,blades-edge,1435,priest,discipline,56,19,37
Addisonraee,tichondrius,1434,priest,discipline,18,15,3
Miix,proudmoore,1434,priest,discipline,18,15,3
Yea,shadow-council,1434,priest,discipline,27,19,8
Baali,moon-guard,1434,priest,discipline,41,27,14
Evpray,area-52,1434,priest,discipline,54,35,19
Mosarra,agamaggan,1434,priest,discipline,30,16,14
Luminous,moon-guard,1434,priest,discipline,137,73,64
Mamabless,quelthalas,1434,priest,discipline,740,378,362
Meatboxmoldy,blood-furnace,1434,priest,discipline,30,15,15
Detainedz,malganis,1434,priest,discipline,30,15,15
Priestmode,garona,1434,priest,discipline,78,34,44
Vineller,malganis,1434,priest,discipline,36,15,21
Remusha,dalaran,1434,priest,discipline,42,16,26
Giomoreno,tichondrius,1433,priest,discipline,30,15,15
Zaneshy,azralon,1433,priest,discipline,49,19,30
Amorus,illidan,1432,priest,discipline,60,40,20
Psílocybín,icecrown,1432,priest,discipline,50,31,19
Welovan,sargeras,1432,priest,discipline,88,47,41
Wøo,area-52,1432,priest,discipline,113,60,53
Necrodiva,magtheridon,1432,priest,discipline,84,43,41
Rôôk,kiljaeden,1432,priest,discipline,56,26,30
Lullabya,tichondrius,1431,priest,discipline,24,15,9
Fathersean,sargeras,1431,priest,discipline,24,15,9
Napzz,sargeras,1431,priest,discipline,45,27,18
Shelak,frostmourne,1431,priest,discipline,104,55,49
Frankoizz,quelthalas,1431,priest,discipline,55,25,30
Swu,tichondrius,1431,priest,discipline,44,18,26
Davinatrans,azralon,1430,priest,discipline,111,57,54
Burroviejo,quelthalas,1430,priest,discipline,46,23,23
Zuss,tichondrius,1430,priest,discipline,52,23,29
Axelrod,tichondrius,1430,priest,discipline,66,27,39
Eridan,moon-guard,1429,priest,discipline,65,33,32
Kwaremont,sargeras,1429,priest,discipline,30,15,15
Tainna,quelthalas,1428,priest,discipline,78,44,34
Elexy,tichondrius,1428,priest,discipline,72,37,35
Shaylari,kelthuzad,1428,priest,discipline,159,75,84
Solestro,malganis,1428,priest,discipline,36,15,21
Dayquills,illidan,1428,priest,discipline,36,15,21
Linkolln,sargeras,1427,priest,discipline,30,18,12
Fleische,thrall,1427,priest,discipline,48,27,21
Bakí,hyjal,1427,priest,discipline,32,17,15
Cherryfuzz,sargeras,1427,priest,discipline,89,45,44
Pumtootoot,tichondrius,1427,priest,discipline,36,15,21
Buffrmppls,ragnaros,1427,priest,discipline,36,15,21
Alphe,sargeras,1426,priest,discipline,42,25,17
Dreadpriate,emerald-dream,1426,priest,discipline,116,58,58
Hugépenance,tichondrius,1425,priest,discipline,30,20,10
Covnite,bloodscalp,1425,priest,discipline,48,26,22
Voicekal,sargeras,1425,priest,discipline,77,41,36
Camisoda,smolderthorn,1425,priest,discipline,34,17,17
Yeshùa,drakkari,1425,priest,discipline,137,68,69
Teeds,stormrage,1425,priest,discipline,69,34,35
Flexxwzkaboo,thrall,1425,priest,discipline,68,33,35
Yözsh,azralon,1425,priest,discipline,63,27,36
Digop,azralon,1425,priest,discipline,41,17,24
Wíckéd,frostmourne,1425,priest,discipline,57,23,34
Sterycraiied,stormreaver,1424,priest,discipline,74,51,23
Langyi,tichondrius,1424,priest,discipline,72,41,31
ßlest,stormrage,1424,priest,discipline,150,84,66
Cella,frostmourne,1424,priest,discipline,48,24,24
Yótecuro,quelthalas,1424,priest,discipline,84,39,45
Roshik,stormrage,1423,priest,discipline,54,33,21
Eavin,laughing-skull,1423,priest,discipline,343,171,172
Shakky,queldorei,1423,priest,discipline,84,37,47
Inmøthep,ragnaros,1423,priest,discipline,68,29,39
Pungentonion,tichondrius,1423,priest,discipline,36,15,21
Nolan,drakkari,1422,priest,discipline,47,27,20
Zørb,area-52,1422,priest,discipline,54,31,23
Priøst,tichondrius,1422,priest,discipline,75,43,32
Ohgiddyy,dalaran,1422,priest,discipline,79,38,41
Tyzrapture,illidan,1422,priest,discipline,53,21,32
Bloatie,zuljin,1421,priest,discipline,42,28,14
Poine,tichondrius,1421,priest,discipline,36,20,16
Sumrand,frostmourne,1421,priest,discipline,30,16,14
Betterheals,tichondrius,1421,priest,discipline,169,88,81
Izikial,illidan,1421,priest,discipline,48,24,24
Kurobankai,tichondrius,1421,priest,discipline,51,25,26
Spacelaces,stormrage,1420,priest,discipline,30,20,10
Holycast,arygos,1420,priest,discipline,24,15,9
Sentactic,illidan,1420,priest,discipline,33,17,16
Inmotion,tichondrius,1420,priest,discipline,30,15,15
Pretzah,barthilas,1419,priest,discipline,60,46,14
Machinecoach,stormrage,1419,priest,discipline,30,15,15
Brotatochip,andorhal,1419,priest,discipline,49,24,25
Malavidax,malganis,1419,priest,discipline,108,45,63
Leviosa,bleeding-hollow,1418,priest,discipline,32,19,13
Helianna,whisperwind,1418,priest,discipline,223,110,113
Shufflnjoyer,sargeras,1418,priest,discipline,114,54,60
Holyish,proudmoore,1418,priest,discipline,42,19,23
Vundead,tichondrius,1418,priest,discipline,36,16,20
Guccísandals,emerald-dream,1418,priest,discipline,36,15,21
Ammcho,tichondrius,1418,priest,discipline,42,16,26
Boycrazy,nerzhul,1417,priest,discipline,24,15,9
Ekros,illidan,1417,priest,discipline,40,23,17
Soméone,sargeras,1417,priest,discipline,236,123,113
Nidüz,stormrage,1417,priest,discipline,156,72,84
Bllaazze,frostwolf,1417,priest,discipline,60,25,35
Nutsin,tichondrius,1417,priest,discipline,36,15,21
Zäelly,moon-guard,1416,priest,discipline,198,100,98
Flexeggette,illidan,1416,priest,discipline,37,18,19
Bent,gurubashi,1415,priest,discipline,41,22,19
Dagónet,sargeras,1415,priest,discipline,72,38,34
Sungji,tichondrius,1415,priest,discipline,30,15,15
Sasaberry,frostmourne,1415,priest,discipline,169,80,89
Dtsgx,tichondrius,1414,priest,discipline,27,16,11
Kayluhn,area-52,1414,priest,discipline,42,24,18
Muromsnel,proudmoore,1414,priest,discipline,120,59,61
Ankhxiety,area-52,1414,priest,discipline,71,33,38
Faerline,kelthuzad,1414,priest,discipline,35,15,20
Aubine,sargeras,1414,priest,discipline,41,15,26
Ananiel,moon-guard,1413,priest,discipline,24,15,9
Benedictüs,tichondrius,1413,priest,discipline,202,104,98
Koizs,frostmourne,1413,priest,discipline,30,15,15
Clancygilroy,thrall,1413,priest,discipline,96,47,49
Emmelly,whisperwind,1413,priest,discipline,78,33,45
Daluu,tichondrius,1413,priest,discipline,51,18,33
Snoog,tichondrius,1413,priest,discipline,54,17,37
Feløre,quelthalas,1412,priest,discipline,51,32,19
Sýpha,dalaran,1412,priest,discipline,51,25,26
Accismus,khadgar,1412,priest,discipline,78,37,41
Smegmancer,korgath,1412,priest,discipline,66,31,35
Sofluffy,burning-blade,1412,priest,discipline,59,27,32
Raileight,illidan,1412,priest,discipline,56,25,31
Handyheals,frostmourne,1411,priest,discipline,113,62,51
Sierrastorms,moon-guard,1411,priest,discipline,30,15,15
Snoozemaster,cenarius,1411,priest,discipline,30,15,15
Posabilties,bleeding-hollow,1411,priest,discipline,42,20,22
Karmatron,chogall,1411,priest,discipline,42,17,25
Macnabber,malganis,1410,priest,discipline,42,27,15
Humpbackz,tichondrius,1410,priest,discipline,42,24,18
Fashion,bleeding-hollow,1410,priest,discipline,54,30,24
Finnabustt,tichondrius,1410,priest,discipline,149,70,79
Elsanto,stormrage,1409,priest,discipline,24,15,9
Silnetlee,tichondrius,1408,priest,discipline,30,16,14
Hpalisdawg,malorne,1408,priest,discipline,31,16,15
Eatmyfear,quelthalas,1408,priest,discipline,247,122,125
Nightheals,sargeras,1408,priest,discipline,54,25,29
Verchou,shattered-hand,1408,priest,discipline,36,15,21
Midoopriest,proudmoore,1408,priest,discipline,36,15,21
Kawin,goldrinn,1407,priest,discipline,101,54,47
Nepy,stormrage,1407,priest,discipline,87,46,41
Sunenergy,tichondrius,1407,priest,discipline,78,41,37
Jaeza,azralon,1407,priest,discipline,93,45,48
Ïndis,ragnaros,1407,priest,discipline,40,16,24
Kerez,skywall,1406,priest,discipline,45,27,18
Jilt,aerie-peak,1406,priest,discipline,96,55,41
Ünarû,illidan,1406,priest,discipline,120,65,55
Halliburton,illidan,1406,priest,discipline,188,98,90
Mursey,sargeras,1406,priest,discipline,117,55,62
Lavvari,durotan,1405,priest,discipline,36,25,11
Seáoflions,aggramar,1405,priest,discipline,24,15,9
Dmlx,frostmourne,1405,priest,discipline,156,90,66
Mangueroide,quelthalas,1405,priest,discipline,123,63,60
Chimiechurro,proudmoore,1405,priest,discipline,90,45,45
Akkassha,zuljin,1405,priest,discipline,48,22,26
Ghøstfaces,illidan,1405,priest,discipline,43,16,27
Tryst,the-underbog,1404,priest,discipline,60,37,23
Chaøz,emerald-dream,1403,priest,discipline,65,41,24
Itsmaám,moon-guard,1403,priest,discipline,48,28,20
Gwyneth,whisperwind,1403,priest,discipline,80,35,45
Kjpriest,kelthuzad,1402,priest,discipline,54,34,20
Therialjp,ragnaros,1402,priest,discipline,42,25,17
Izanemi,sargeras,1402,priest,discipline,71,39,32
Discalaneous,tichondrius,1402,priest,discipline,45,20,25
Nicety,skywall,1402,priest,discipline,50,22,28
Chaniste,moon-guard,1401,priest,discipline,46,27,19
Kaonn,frostmourne,1401,priest,discipline,251,133,118
Bubbahotep,laughing-skull,1401,priest,discipline,52,25,27
Yishaarj,tichondrius,1401,priest,discipline,53,24,29
Khyonne,nemesis,1400,priest,discipline,68,37,31
Sistamaggie,bleeding-hollow,1400,priest,discipline,84,43,41
Kibariyb,drakkari,1400,priest,discipline,40,19,21
Stormìst,korgath,1399,priest,discipline,30,18,12
Peristalsis,nesingwary,1399,priest,discipline,36,16,20
Coldvbs,barthilas,1398,priest,discipline,46,26,20
Slumpbusterx,bonechewer,1398,priest,discipline,205,95,110
Moonarie,draka,1397,priest,discipline,42,25,17
Namemetwo,malganis,1397,priest,discipline,126,59,67
Diabiitus,stormrage,1396,priest,discipline,105,61,44
Relaax,illidan,1396,priest,discipline,30,15,15
Rabbix,aggramar,1395,priest,discipline,36,20,16
Jacob,shadowmoon,1395,priest,discipline,171,82,89
Vøíd,sargeras,1394,priest,discipline,41,23,18
Luffzie,barthilas,1394,priest,discipline,162,85,77
Karminha,azralon,1393,priest,discipline,24,17,7
Freck,stormrage,1393,priest,discipline,42,25,17
Icônz,malganis,1393,priest,discipline,59,31,28
Lilblackguys,stormrage,1393,priest,discipline,120,59,61
Scriptz,frostwolf,1393,priest,discipline,66,30,36
Raggasoca,malganis,1393,priest,discipline,99,44,55
Ðiplø,tichondrius,1392,priest,discipline,35,21,14
Oprawinfree,tichondrius,1392,priest,discipline,130,72,58
Letkidscome,archimonde,1391,priest,discipline,33,18,15
Tluoc,nemesis,1391,priest,discipline,47,25,22
Ggums,tichondrius,1391,priest,discipline,108,54,54
Gimmedomex,tichondrius,1390,priest,discipline,102,58,44
Smittën,barthilas,1390,priest,discipline,72,40,32
Scortum,goldrinn,1390,priest,discipline,36,20,16
Phayzz,area-52,1390,priest,discipline,123,63,60
Moneymurph,blackrock,1390,priest,discipline,44,16,28
Chofis,nathrezim,1389,priest,discipline,36,24,12
Worstpriest,stormscale,1389,priest,discipline,36,20,16
Pyta,frostmourne,1389,priest,discipline,68,36,32
Xyló,area-52,1388,priest,discipline,118,65,53
Aimeé,chromaggus,1387,priest,discipline,96,40,56
Krindil,korgath,1386,priest,discipline,107,60,47
Unholywizard,sargeras,1386,priest,discipline,66,37,29
Strawson,quelthalas,1386,priest,discipline,117,56,61
Kobayashy,ragnaros,1385,priest,discipline,48,29,19
Vexyy,tichondrius,1385,priest,discipline,32,19,13
Kevarsin,dalaran,1385,priest,discipline,60,31,29
Kìttý,cenarius,1385,priest,discipline,48,23,25
Laüren,ragnaros,1385,priest,discipline,103,46,57
Atyourcervix,emerald-dream,1384,priest,discipline,32,20,12
Tungus,shadowsong,1384,priest,discipline,97,51,46
Misfyt,emerald-dream,1384,priest,discipline,78,40,38
Yanye,tichondrius,1384,priest,discipline,161,78,83
Itsme,quelthalas,1384,priest,discipline,77,36,41
Victrix,tichondrius,1384,priest,discipline,118,51,67
Thalyssarah,azralon,1384,priest,discipline,41,17,24
Kms,sargeras,1383,priest,discipline,74,41,33
Arkenes,dalaran,1383,priest,discipline,78,41,37
Kerahk,drakkari,1383,priest,discipline,44,20,24
Wholeness,kelthuzad,1383,priest,discipline,48,21,27
Seleniax,sargeras,1383,priest,discipline,41,16,25
Holykushed,tichondrius,1382,priest,discipline,38,19,19
Aurajade,queldorei,1382,priest,discipline,36,18,18
Dessire,ragnaros,1382,priest,discipline,35,17,18
Starshollow,ragnaros,1382,priest,discipline,111,53,58
Shrax,emerald-dream,1382,priest,discipline,149,68,81
Sukmysplooge,queldorei,1382,priest,discipline,66,28,38
Tiskka,magtheridon,1382,priest,discipline,68,28,40
Èuneekz,thrall,1382,priest,discipline,42,16,26
Sílvia,durotan,1381,priest,discipline,60,28,32
Moresbo,frostmourne,1380,priest,discipline,42,24,18
Spacebeard,tichondrius,1380,priest,discipline,46,22,24
Armî,ragnaros,1380,priest,discipline,82,39,43
Jinniu,azralon,1380,priest,discipline,42,17,25
Pegwraith,sargeras,1379,priest,discipline,64,36,28
Gristus,twisting-nether,1378,priest,discipline,47,27,20
Tyreliy,eitrigg,1378,priest,discipline,199,104,95
Lìlí,tichondrius,1378,priest,discipline,66,34,32
Doggyy,tichondrius,1378,priest,discipline,178,91,87
Joichua,sargeras,1378,priest,discipline,62,30,32
Drhutchinson,illidan,1377,priest,discipline,30,16,14
Oldris,darkspear,1377,priest,discipline,47,25,22
Goosemongler,bleeding-hollow,1377,priest,discipline,36,18,18
Lexinalis,stormrage,1376,priest,discipline,29,17,12
Kallixprime,ragnaros,1376,priest,discipline,53,29,24
Fádéd,tichondrius,1376,priest,discipline,29,15,14
Bøness,area-52,1376,priest,discipline,142,73,69
Feorlar,tichondrius,1376,priest,discipline,120,56,64
Sixfiggas,darkspear,1375,priest,discipline,24,17,7
Aldrych,malganis,1375,priest,discipline,61,35,26
Rickjames,laughing-skull,1375,priest,discipline,104,58,46
Dlysexic,barthilas,1375,priest,discipline,66,35,31
Drinkndrive,tichondrius,1375,priest,discipline,57,30,27
Piskel,vashj,1375,priest,discipline,66,29,37
Jelzz,area-52,1374,priest,discipline,33,18,15
Dominantz,khazgoroth,1374,priest,discipline,78,42,36
Palpitine,kiljaeden,1374,priest,discipline,66,35,31
Sackura,quelthalas,1374,priest,discipline,73,36,37
Artiannaa,bleeding-hollow,1373,priest,discipline,66,35,31
Kwitty,tichondrius,1373,priest,discipline,83,44,39
Zombieheals,gundrak,1373,priest,discipline,53,27,26
Quinnx,tichondrius,1373,priest,discipline,54,27,27
Mäí,ragnaros,1372,priest,discipline,120,67,53
Halcyon,eonar,1372,priest,discipline,74,34,40
Mauriel,proudmoore,1372,priest,discipline,42,19,23
Rrain,proudmoore,1372,priest,discipline,53,23,30
Avis,illidan,1371,priest,discipline,60,37,23
Wildmanfrank,tichondrius,1371,priest,discipline,49,30,19
Zortroz,tichondrius,1371,priest,discipline,28,17,11
Gnralways,andorhal,1371,priest,discipline,87,41,46
Karazhan,burning-legion,1371,priest,discipline,44,19,25
Methodist,proudmoore,1371,priest,discipline,94,39,55
Miserable,emerald-dream,1371,priest,discipline,101,40,61
Sluttiness,tichondrius,1370,priest,discipline,81,47,34
Tatereh,illidan,1370,priest,discipline,64,34,30
Endeshealer,suramar,1370,priest,discipline,54,28,26
Jìtters,silvermoon,1370,priest,discipline,36,17,19
Growth,fizzcrank,1370,priest,discipline,72,26,46
Devilwithin,moon-guard,1369,priest,discipline,47,28,19
Arvida,ragnaros,1369,priest,discipline,66,39,27
Kyoku,tanaris,1369,priest,discipline,47,27,20
Aarei,stormrage,1369,priest,discipline,30,16,14
Mawlaana,frostmourne,1369,priest,discipline,42,21,21
Onjah,kiljaeden,1369,priest,discipline,60,25,35
Jesisapollo,blackrock,1368,priest,discipline,23,15,8
Allivan,frostwolf,1368,priest,discipline,30,19,11
Anymoon,tichondrius,1368,priest,discipline,96,53,43
Zènó,bleeding-hollow,1368,priest,discipline,36,19,17
Donzorro,ragnaros,1367,priest,discipline,99,51,48
Mørphina,azralon,1366,priest,discipline,24,16,8
Poefosho,stormrage,1366,priest,discipline,260,132,128
Endereth,skullcrusher,1366,priest,discipline,306,144,162
Solsano,stormrage,1365,priest,discipline,76,44,32
Idel,runetotem,1365,priest,discipline,36,16,20
Voyou,icecrown,1365,priest,discipline,130,57,73
Purgingsyns,illidan,1364,priest,discipline,56,34,22
Nars,draka,1364,priest,discipline,30,16,14
Hideyourkids,stormreaver,1364,priest,discipline,83,42,41
Naelsaze,tichondrius,1363,priest,discipline,22,15,7
Shortty,arthas,1363,priest,discipline,36,23,13
Halfyo,dragonmaw,1363,priest,discipline,90,49,41
Holyjibs,moon-guard,1362,priest,discipline,37,26,11
Dokthekim,frostmourne,1362,priest,discipline,56,29,27
Temkcalb,ragnaros,1361,priest,discipline,90,46,44
Sinnertitanz,quelthalas,1361,priest,discipline,90,46,44
Lalo,bleeding-hollow,1361,priest,discipline,40,17,23
Rakpriest,nerzhul,1360,priest,discipline,43,29,14
Curasia,drakkari,1360,priest,discipline,57,37,20
Andariel,quelthalas,1360,priest,discipline,42,27,15
Supski,destromath,1360,priest,discipline,30,15,15
Feedya,tichondrius,1360,priest,discipline,507,246,261
Trummp,tichondrius,1359,priest,discipline,75,40,35
Powerwordzz,dragonmaw,1359,priest,discipline,72,36,36
Crucïfïx,stormrage,1358,priest,discipline,70,41,29
Nexoox,drakkari,1358,priest,discipline,42,23,19
Lexiahp,frostmourne,1358,priest,discipline,31,15,16
Ålexánder,quelthalas,1358,priest,discipline,54,23,31
Tûbes,trollbane,1358,priest,discipline,101,42,59
Replacednewb,chogall,1357,priest,discipline,57,30,27
Eiju,proudmoore,1357,priest,discipline,42,19,23
Marcuse,ragnaros,1357,priest,discipline,73,27,46
Aerdune,dalaran,1356,priest,discipline,68,36,32
Smirkinlive,illidan,1356,priest,discipline,51,27,24
Cyphrus,hyjal,1356,priest,discipline,47,21,26
Matchakatt,tichondrius,1355,priest,discipline,65,41,24
Kymmei,warsong,1354,priest,discipline,30,15,15
PlayerWDHGQY,illidan,1354,priest,discipline,243,118,125
Smileshadowx,frostmourne,1353,priest,discipline,27,16,11
Msdash,tichondrius,1353,priest,discipline,42,23,19
Srwilly,ragnaros,1353,priest,discipline,87,47,40
Renews,azralon,1353,priest,discipline,52,28,24
Rêvelation,trollbane,1353,priest,discipline,159,85,74
Rvxy,tichondrius,1353,priest,discipline,90,48,42
Vaticly,hyjal,1353,priest,discipline,132,62,70
Mateekie,malganis,1352,priest,discipline,43,24,19
Chìbiusa,proudmoore,1352,priest,discipline,106,52,54
Stoutqt,arthas,1351,priest,discipline,30,23,7
Hootin,whisperwind,1351,priest,discipline,62,35,27
Risedead,azralon,1351,priest,discipline,132,70,62
Saegusa,tichondrius,1351,priest,discipline,76,35,41
Djefe,tichondrius,1350,priest,discipline,106,53,53
Pagän,illidan,1349,priest,discipline,45,25,20
Selenthea,moon-guard,1349,priest,discipline,100,52,48
Beñzi,sargeras,1348,priest,discipline,26,16,10
Rickitz,bleeding-hollow,1348,priest,discipline,60,32,28
Toysqt,sargeras,1348,priest,discipline,29,15,14
Yayoo,exodar,1348,priest,discipline,45,23,22
Howdydoo,azshara,1348,priest,discipline,73,33,40
Skadim,azralon,1348,priest,discipline,156,68,88
Hellagud,kargath,1346,priest,discipline,78,42,36
Revreal,thrall,1346,priest,discipline,48,25,23
Eblis,the-underbog,1346,priest,discipline,63,26,37
Pelagius,suramar,1345,priest,discipline,44,19,25
ßræcher,black-dragonflight,1344,priest,discipline,36,24,12
Photos,stormrage,1344,priest,discipline,60,37,23
Myspacegirl,tichondrius,1344,priest,discipline,43,23,20
Hoppus,stormrage,1344,priest,discipline,96,47,49
Scaloni,proudmoore,1343,priest,discipline,29,18,11
Textmepls,barthilas,1343,priest,discipline,54,32,22
Censyz,tichondrius,1343,priest,discipline,24,14,10
Elciid,tichondrius,1343,priest,discipline,24,14,10
Swaggie,skullcrusher,1343,priest,discipline,24,14,10
Mthwz,tichondrius,1343,priest,discipline,24,14,10
Fadewench,sargeras,1343,priest,discipline,41,21,20
Lucsor,malganis,1343,priest,discipline,119,60,59
Míssdank,tichondrius,1343,priest,discipline,36,18,18
Mitoloshi,ragnaros,1343,priest,discipline,126,61,65
Grapeedrank,tichondrius,1342,priest,discipline,45,30,15
Crazykitsune,thaurissan,1342,priest,discipline,42,27,15
Annefrank,azjolnerub,1342,priest,discipline,24,14,10
Loopzw,tichondrius,1342,priest,discipline,24,14,10
Lawroade,tichondrius,1342,priest,discipline,67,36,31
What,moon-guard,1342,priest,discipline,132,66,66
Flab,tichondrius,1342,priest,discipline,34,17,17
Kayzen,frostmourne,1342,priest,discipline,36,15,21
Goseoa,tichondrius,1342,priest,discipline,60,24,36
Spursky,emerald-dream,1341,priest,discipline,18,14,4
Saintclac,illidan,1341,priest,discipline,24,15,9
Redcoolaid,moon-guard,1341,priest,discipline,24,14,10
Carlita,ravenholdt,1341,priest,discipline,24,14,10
Ophailea,thrall,1341,priest,discipline,66,37,29
Psyfriend,area-52,1341,priest,discipline,30,14,16
Zoap,stormrage,1341,priest,discipline,60,26,34
Gnomelester,kiljaeden,1340,priest,discipline,36,21,15
Teiam,skullcrusher,1340,priest,discipline,24,14,10
Phonomena,malganis,1340,priest,discipline,162,85,77
Bionix,stormrage,1340,priest,discipline,72,37,35
Storylord,malganis,1340,priest,discipline,30,14,16
Pactosombrio,azralon,1339,priest,discipline,134,78,56
Hollowsp,tichondrius,1339,priest,discipline,30,14,16
Rondebarber,thunderlord,1338,priest,discipline,90,47,43
Mellerwine,azralon,1338,priest,discipline,505,262,243
Vehlind,quelthalas,1338,priest,discipline,101,52,49
Krané,area-52,1338,priest,discipline,57,29,28
Kasiry,ragnaros,1338,priest,discipline,78,38,40
Ucksy,blackrock,1338,priest,discipline,30,14,16
Foremender,illidan,1338,priest,discipline,84,33,51
Lildubs,bloodhoof,1337,priest,discipline,18,14,4
Seniro,tichondrius,1337,priest,discipline,42,27,15
Kazandraah,quelthalas,1337,priest,discipline,36,23,13
Aveil,bloodscalp,1337,priest,discipline,46,27,19
Theboogieman,magtheridon,1337,priest,discipline,89,48,41
Muuq,frostmourne,1337,priest,discipline,221,110,111
Leejungjae,tichondrius,1337,priest,discipline,39,19,20
Monâ,sargeras,1337,priest,discipline,30,14,16
Foxspritques,area-52,1337,priest,discipline,58,16,42
Chaseshadow,kelthuzad,1336,priest,discipline,23,18,5
Lilazngirl,stormrage,1336,priest,discipline,30,19,11
Devout,dentarg,1336,priest,discipline,24,14,10
Såge,chogall,1336,priest,discipline,302,160,142
Metagameswag,tichondrius,1335,priest,discipline,24,14,10
Vìrus,jubeithos,1335,priest,discipline,30,17,13
Krukam,sargeras,1335,priest,discipline,84,47,37
Icyspicy,shadowsong,1335,priest,discipline,91,49,42
Crashed,frostmourne,1335,priest,discipline,60,27,33
Scrubnubz,barthilas,1335,priest,discipline,36,16,20
Shadina,gorefiend,1335,priest,discipline,36,14,22
Yaholyfather,aerie-peak,1334,priest,discipline,24,14,10
Pherïox,drakkari,1334,priest,discipline,36,19,17
Talbadontu,thrall,1334,priest,discipline,42,22,20
Erossenin,proudmoore,1334,priest,discipline,30,15,15
Papafuego,stormrage,1333,priest,discipline,18,14,4
Galnaine,emerald-dream,1333,priest,discipline,24,14,10
Angelicus,ragnaros,1333,priest,discipline,318,163,155
Bubblerenew,altar-of-storms,1333,priest,discipline,30,14,16
Rblood,emerald-dream,1332,priest,discipline,54,33,21
Fatherbrah,kelthuzad,1332,priest,discipline,27,15,12
Oomed,bonechewer,1332,priest,discipline,147,73,74
Phenic,aggramar,1332,priest,discipline,41,18,23
Feltsmaces,shadowmoon,1332,priest,discipline,35,14,21
Layu,azralon,1332,priest,discipline,36,14,22
Müsic,stormrage,1331,priest,discipline,24,14,10
Noveh,tichondrius,1331,priest,discipline,36,17,19
Bigskill,proudmoore,1331,priest,discipline,48,21,27
Rhayzel,ragnaros,1330,priest,discipline,54,36,18
Bathenape,bleeding-hollow,1330,priest,discipline,40,23,17
Fatherßrian,draktharon,1330,priest,discipline,88,49,39
Holyfromrmp,tichondrius,1330,priest,discipline,72,35,37
Hunanbeef,kiljaeden,1330,priest,discipline,106,51,55
Decline,balnazzar,1330,priest,discipline,30,14,16
Náay,ragnaros,1329,priest,discipline,47,30,17
Emotionless,bonechewer,1329,priest,discipline,140,75,65
Mpshield,kiljaeden,1328,priest,discipline,37,22,15
Vodhka,arthas,1328,priest,discipline,24,14,10
Themoon,tichondrius,1328,priest,discipline,24,14,10
Jeanbi,ragnaros,1328,priest,discipline,42,23,19
Namî,barthilas,1328,priest,discipline,215,115,100
Honypot,ysondre,1328,priest,discipline,96,51,45
Raydz,altar-of-storms,1328,priest,discipline,272,130,142
Kivz,stormrage,1328,priest,discipline,48,21,27
Zóe,eredar,1327,priest,discipline,70,37,33
Tursai,frostmourne,1327,priest,discipline,63,31,32
ßlackøut,sargeras,1327,priest,discipline,30,14,16
Nêrô,dalaran,1327,priest,discipline,66,29,37
Shenanigans,illidan,1326,priest,discipline,23,14,9
Danrien,azralon,1326,priest,discipline,34,20,14
Effsinstinks,illidan,1326,priest,discipline,24,14,10
Cathiah,darkspear,1326,priest,discipline,260,133,127
Healmedaddyy,korgath,1326,priest,discipline,207,99,108
Healznfeel,tichondrius,1326,priest,discipline,54,23,31
Turrec,illidan,1325,priest,discipline,18,14,4
Juliusceazer,skywall,1325,priest,discipline,128,73,55
Magicßoy,magtheridon,1325,priest,discipline,298,153,145
Durgen,stormreaver,1325,priest,discipline,43,20,23
Zapix,tichondrius,1325,priest,discipline,36,15,21
Blessedelf,tichondrius,1325,priest,discipline,66,26,40
Edmust,black-dragonflight,1324,priest,discipline,24,14,10
Plasmax,ragnaros,1324,priest,discipline,56,19,37
Xerzosh,area-52,1323,priest,discipline,154,81,73
Jaysontatum,gurubashi,1323,priest,discipline,33,17,16
Zawi,zuljin,1323,priest,discipline,103,50,53
Bedläm,kilrogg,1323,priest,discipline,54,23,31
Kaeshia,proudmoore,1322,priest,discipline,30,18,12
Gariell,ragnaros,1322,priest,discipline,24,14,10
Illen,nemesis,1322,priest,discipline,60,34,26
Methodist,sargeras,1322,priest,discipline,30,17,13
Amarøth,illidan,1320,priest,discipline,30,14,16
Powerwordshy,area-52,1320,priest,discipline,30,14,16
Ayakoji,proudmoore,1320,priest,discipline,48,20,28
Sanarion,area-52,1319,priest,discipline,60,36,24
Volkova,quelthalas,1319,priest,discipline,54,30,24
Nadiaxo,moon-guard,1319,priest,discipline,65,35,30
Nøzmonica,kelthuzad,1319,priest,discipline,32,15,17
Sidepiëce,area-52,1318,priest,discipline,35,14,21
Neutrino,quelthalas,1317,priest,discipline,29,14,15
Rookieone,thrall,1317,priest,discipline,92,44,48
Ripscrew,area-52,1316,priest,discipline,24,14,10
Gäindalt,tichondrius,1316,priest,discipline,42,24,18
Malevolently,illidan,1316,priest,discipline,137,62,75
Demimo,frostwolf,1315,priest,discipline,30,18,12
Hustleplay,tichondrius,1315,priest,discipline,48,27,21
Holyninfo,quelthalas,1315,priest,discipline,102,54,48
Eleeira,zuljin,1315,priest,discipline,42,18,24
Eirenth,bleeding-hollow,1314,priest,discipline,46,32,14
Thelondon,tichondrius,1314,priest,discipline,27,15,12
Blaydun,elune,1313,priest,discipline,114,66,48
Moontearss,tichondrius,1313,priest,discipline,48,25,23
Jjojae,illidan,1313,priest,discipline,30,14,16
Mynigajeff,zuljin,1312,priest,discipline,68,33,35
Darkquinn,boulderfist,1312,priest,discipline,284,132,152
Huck,khazgoroth,1312,priest,discipline,42,19,23
Discgolfsux,sargeras,1312,priest,discipline,68,29,39
Jsuschristix,zuljin,1311,priest,discipline,36,23,13
Empower,garrosh,1311,priest,discipline,51,30,21
Médic,guldan,1311,priest,discipline,30,17,13
Peavzian,kiljaeden,1311,priest,discipline,64,30,34
Goodwin,darkspear,1310,priest,discipline,48,29,19
Chîna,hyjal,1310,priest,discipline,126,76,50
Chloangel,frostmourne,1310,priest,discipline,24,14,10
Conney,mugthol,1310,priest,discipline,24,14,10
Pico,spirestone,1310,priest,discipline,72,41,31
Warmth,moon-guard,1310,priest,discipline,81,44,37
Eclìpsè,barthilas,1310,priest,discipline,50,23,27
Slyoda,area-52,1310,priest,discipline,42,19,23
Yunganal,sargeras,1309,priest,discipline,30,17,13
Súlfuro,quelthalas,1309,priest,discipline,119,60,59
Malarkie,sargeras,1309,priest,discipline,30,14,16
Kakera,tichondrius,1308,priest,discipline,24,14,10
Jaskil,skywall,1308,priest,discipline,78,42,36
Aesudan,dalaran,1308,priest,discipline,63,33,30
Booyâh,muradin,1308,priest,discipline,54,27,27
Majesticar,moon-guard,1307,priest,discipline,30,20,10
Rompenepes,drakkari,1307,priest,discipline,24,14,10
Clickbait,spirestone,1307,priest,discipline,24,14,10
Soaphia,kelthuzad,1307,priest,discipline,120,68,52
Médíc,dalaran,1307,priest,discipline,63,32,31
Fìngerbanger,lightnings-blade,1307,priest,discipline,198,98,100
Jinicuil,quelthalas,1307,priest,discipline,54,25,29
Holyrotape,nemesis,1307,priest,discipline,63,28,35
Dominie,area-52,1306,priest,discipline,18,14,4
Priestgobrr,emerald-dream,1305,priest,discipline,50,30,20
Mommyshere,vashj,1305,priest,discipline,71,41,30
Bloo,draktharon,1305,priest,discipline,42,24,18
Ruthlèss,ragnaros,1305,priest,discipline,54,28,26
Filterd,azshara,1305,priest,discipline,30,14,16
Exploded,moon-guard,1305,priest,discipline,85,34,51
Vandaley,tichondrius,1304,priest,discipline,30,19,11
Chinstrap,zuljin,1304,priest,discipline,24,14,10
Nooice,dalaran,1304,priest,discipline,30,14,16
Dahrwin,thrall,1303,priest,discipline,42,24,18
Testament,greymane,1303,priest,discipline,182,90,92
ßoogey,tichondrius,1303,priest,discipline,47,22,25
Gustavustus,barthilas,1303,priest,discipline,42,14,28
Dalowks,area-52,1302,priest,discipline,54,24,30
Poorass,sargeras,1301,priest,discipline,30,19,11
Aedarelyn,ysera,1301,priest,discipline,42,22,20
Lampfood,alterac-mountains,1301,priest,discipline,36,17,19
Helibix,bleeding-hollow,1301,priest,discipline,162,74,88
Evilnyllah,stormrage,1300,priest,discipline,32,20,12
Gurbooz,illidan,1300,priest,discipline,62,35,27
Priést,stormrage,1300,priest,discipline,45,19,26
Spõt,stormrage,1300,priest,discipline,48,19,29
Morningzz,tichondrius,1299,priest,discipline,84,36,48
Tarny,tichondrius,1298,priest,discipline,46,29,17
Sofhya,ragnaros,1298,priest,discipline,124,66,58
Sinnon,turalyon,1298,priest,discipline,36,19,17
Bandagebabe,sargeras,1298,priest,discipline,36,15,21
Timeglass,kelthuzad,1297,priest,discipline,47,26,21
Mechahomo,dalaran,1297,priest,discipline,52,28,24
Ahane,wyrmrest-accord,1297,priest,discipline,66,31,35
Sæýfír,illidan,1296,priest,discipline,24,14,10
Sòraka,tichondrius,1296,priest,discipline,130,65,65
Dabbinton,chogall,1296,priest,discipline,52,26,26
Hydramîst,ragnaros,1296,priest,discipline,36,15,21
Pottime,tichondrius,1295,priest,discipline,50,30,20
Boostvoid,terenas,1295,priest,discipline,245,132,113
Fenian,frostmourne,1295,priest,discipline,123,60,63
Flatëarth,tichondrius,1294,priest,discipline,376,179,197
Travita,quelthalas,1293,priest,discipline,54,29,25
Füuzin,stormrage,1293,priest,discipline,96,46,50
Dadthegreat,bonechewer,1292,priest,discipline,42,25,17
Usmond,azralon,1292,priest,discipline,48,23,25
Unfriend,sargeras,1291,priest,discipline,48,22,26
Rakket,moon-guard,1291,priest,discipline,36,16,20
Soulclap,sargeras,1291,priest,discipline,35,14,21
Voodooloa,tichondrius,1291,priest,discipline,90,35,55
Lunett,area-52,1291,priest,discipline,52,19,33
Lyxx,kelthuzad,1290,priest,discipline,22,15,7
Xmasmiracle,korgath,1290,priest,discipline,112,65,47
Elixia,maiev,1290,priest,discipline,70,38,32
Avarice,magtheridon,1289,priest,discipline,40,24,16
Cubski,darkspear,1289,priest,discipline,31,15,16
Leprêtre,hakkar,1289,priest,discipline,42,20,22
Moralism,moon-guard,1288,priest,discipline,56,36,20
Troublmaker,illidan,1288,priest,discipline,46,24,22
Webbii,frostmourne,1288,priest,discipline,60,29,31
Bibops,area-52,1288,priest,discipline,37,15,22
Nocturnalx,moon-guard,1287,priest,discipline,82,51,31
Bbm,stormscale,1287,priest,discipline,105,52,53
Iwonthealu,senjin,1286,priest,discipline,30,16,14
Khaleth,suramar,1286,priest,discipline,48,20,28
Prelate,moon-guard,1286,priest,discipline,36,15,21
Rôxxy,thrall,1285,priest,discipline,48,27,21
Snowinvan,tichondrius,1285,priest,discipline,47,26,21
Brounly,drakkari,1285,priest,discipline,72,36,36
Nenemsis,drakkari,1285,priest,discipline,38,16,22
Boibussy,tichondrius,1285,priest,discipline,36,15,21
Dolm,tichondrius,1284,priest,discipline,250,124,126
Voidmaker,area-52,1284,priest,discipline,48,17,31
Antxres,sargeras,1283,priest,discipline,29,14,15
Penancepapi,stormrage,1283,priest,discipline,30,14,16
Rotass,hyjal,1282,priest,discipline,96,51,45
Boojanglez,exodar,1282,priest,discipline,48,25,23
Canharm,tichondrius,1282,priest,discipline,73,29,44
Presto,kalecgos,1281,priest,discipline,24,19,5
Crackneesha,tichondrius,1281,priest,discipline,30,19,11
Rashad,proudmoore,1281,priest,discipline,71,41,30
Holymagic,lightnings-blade,1281,priest,discipline,53,29,24
Zenthaz,thrall,1281,priest,discipline,80,40,40
Dismybracket,tichondrius,1281,priest,discipline,42,20,22
Lifeswap,area-52,1281,priest,discipline,54,21,33
Invocational,moon-guard,1280,priest,discipline,129,66,63
Touchér,whisperwind,1280,priest,discipline,29,14,15
Pkriest,illidan,1279,priest,discipline,30,14,16
Briefs,stormrage,1278,priest,discipline,21,15,6
Wísh,emerald-dream,1278,priest,discipline,90,54,36
Goingserious,frostmourne,1278,priest,discipline,189,104,85
Bloodsorrow,ragnaros,1278,priest,discipline,72,39,33
Slewt,aggramar,1278,priest,discipline,48,25,23
Kakao,stormreaver,1278,priest,discipline,120,51,69
Slimshieldy,illidan,1277,priest,discipline,28,15,13
Phaille,chromaggus,1277,priest,discipline,170,91,79
Gungagingong,queldorei,1276,priest,discipline,66,38,28
Finake,kelthuzad,1276,priest,discipline,85,48,37
Fairylìght,stormrage,1276,priest,discipline,67,24,43
Ttakayasu,bleeding-hollow,1275,priest,discipline,180,102,78
Lowkii,malfurion,1275,priest,discipline,35,17,18
Orìsel,wyrmrest-accord,1274,priest,discipline,153,72,81
Nylaza,kiljaeden,1274,priest,discipline,71,28,43
Medo,dalaran,1272,priest,discipline,88,46,42
Strict,the-forgotten-coast,1272,priest,discipline,29,14,15
Lîghtsaber,illidan,1272,priest,discipline,46,16,30
Drilbitt,jaedenar,1271,priest,discipline,21,15,6
Kìn,tol-barad,1271,priest,discipline,54,22,32
Healmegently,bonechewer,1271,priest,discipline,45,15,30
Markspell,stormrage,1270,priest,discipline,145,77,68
Derlanger,frostmourne,1270,priest,discipline,48,25,23
Mythica,gurubashi,1270,priest,discipline,224,116,108
Foose,suramar,1270,priest,discipline,48,23,25
Cilpri,emerald-dream,1269,priest,discipline,25,14,11
Twotimechamp,azshara,1269,priest,discipline,50,26,24
Termiina,hyjal,1269,priest,discipline,85,41,44
Glauga,azralon,1269,priest,discipline,66,24,42
Theheal,ragnaros,1269,priest,discipline,63,21,42
Eluko,tichondrius,1268,priest,discipline,33,18,15
Forliang,proudmoore,1268,priest,discipline,27,14,13
Lätöxïkä,alleria,1268,priest,discipline,65,33,32
Jjayleroux,hyjal,1268,priest,discipline,54,26,28
Franku,quelthalas,1267,priest,discipline,33,23,10
Sojumike,proudmoore,1267,priest,discipline,60,31,29
Köto,dalaran,1267,priest,discipline,77,39,38
Aggravating,mugthol,1267,priest,discipline,176,89,87
Thokrül,lightbringer,1266,priest,discipline,42,23,19
Miraz,the-venture-co,1266,priest,discipline,53,29,24
Boocharni,wyrmrest-accord,1266,priest,discipline,92,50,42
Xavaat,nerzhul,1266,priest,discipline,84,38,46
Nometh,emerald-dream,1266,priest,discipline,90,38,52
Atemlos,malorne,1265,priest,discipline,42,24,18
Penitentrowr,illidan,1265,priest,discipline,77,40,37
Deadlykíss,sargeras,1265,priest,discipline,54,26,28
Welorian,mannoroth,1265,priest,discipline,54,24,30
Cromekolo,tichondrius,1264,priest,discipline,27,16,11
Docvalentino,malganis,1264,priest,discipline,24,14,10
Aipata,stormrage,1264,priest,discipline,74,41,33
Karnival,aggramar,1264,priest,discipline,48,23,25
Raisonpriest,tichondrius,1264,priest,discipline,182,87,95
Keskima,malganis,1263,priest,discipline,87,54,33
Kethal,area-52,1263,priest,discipline,37,19,18
Toorshul,tichondrius,1262,priest,discipline,48,26,22
Saràh,stormscale,1262,priest,discipline,94,43,51
Reindharth,quelthalas,1262,priest,discipline,90,38,52
Kristt,thrall,1262,priest,discipline,41,16,25
Emlix,tichondrius,1262,priest,discipline,42,14,28
Barrieroflig,tichondrius,1261,priest,discipline,45,25,20
Vanszz,area-52,1260,priest,discipline,54,26,28
Marhuana,stormreaver,1260,priest,discipline,47,19,28
Greif,garrosh,1259,priest,discipline,54,25,29
Heniupriest,tichondrius,1259,priest,discipline,48,22,26
Alawn,wyrmrest-accord,1259,priest,discipline,120,52,68
Atelios,azralon,1258,priest,discipline,30,20,10
Quasenada,stormrage,1258,priest,discipline,23,14,9
Nerzghoul,sargeras,1258,priest,discipline,42,24,18
Kymosolop,sargeras,1258,priest,discipline,25,14,11
Skall,kirin-tor,1258,priest,discipline,41,21,20
Capricornio,nemesis,1258,priest,discipline,60,30,30
Saadboii,thrall,1257,priest,discipline,61,31,30
Themøn,quelthalas,1257,priest,discipline,36,18,18
Dralaan,proudmoore,1257,priest,discipline,92,44,48
Kenzao,nemesis,1257,priest,discipline,64,30,34
Lge,kelthuzad,1257,priest,discipline,31,14,17
Dartonya,thrall,1257,priest,discipline,36,15,21
Hawktalonuke,moon-guard,1256,priest,discipline,90,50,40
Nìght,trollbane,1256,priest,discipline,102,54,48
Klingande,tichondrius,1255,priest,discipline,75,39,36
Knifê,moon-guard,1255,priest,discipline,108,54,54
Kauldër,illidan,1255,priest,discipline,58,21,37
Norriam,moon-guard,1254,priest,discipline,41,27,14
Thotznprayrz,bleeding-hollow,1254,priest,discipline,36,23,13
Ðelight,ragnaros,1254,priest,discipline,72,36,36
Chavkoraken,stormrage,1254,priest,discipline,38,15,23
Educated,tichondrius,1254,priest,discipline,38,14,24
Saviorsélf,tichondrius,1253,priest,discipline,162,76,86
Cajl,dathremar,1253,priest,discipline,137,63,74
Rbgeezus,lightnings-blade,1252,priest,discipline,113,57,56
Nightmxs,tichondrius,1252,priest,discipline,54,25,29
Këyglock,kelthuzad,1252,priest,discipline,252,111,141
Bröke,nemesis,1251,priest,discipline,114,61,53
Vynlanesh,illidan,1251,priest,discipline,66,34,32
Mannius,tichondrius,1251,priest,discipline,106,49,57
Slickbakk,illidan,1251,priest,discipline,74,32,42
Dosarix,sargeras,1250,priest,discipline,40,23,17
Pêrsephône,tichondrius,1250,priest,discipline,246,118,128
Gorechop,aegwynn,1250,priest,discipline,71,29,42
Zumanîty,zangarmarsh,1249,priest,discipline,24,15,9
Zaroki,sargeras,1249,priest,discipline,24,14,10
Jestiann,aegwynn,1249,priest,discipline,257,131,126
Thoughtcrime,doomhammer,1249,priest,discipline,62,31,31
Ktqt,moon-guard,1249,priest,discipline,253,125,128
Tmspongwo,tichondrius,1248,priest,discipline,30,21,9
Dispelbot,kelthuzad,1248,priest,discipline,160,90,70
Allhubris,stormrage,1248,priest,discipline,24,13,11
Frikapp,stormrage,1248,priest,discipline,24,13,11
Lalaliza,kelthuzad,1248,priest,discipline,24,13,11
Radgars,frostmourne,1248,priest,discipline,55,27,28
Haø,stormrage,1248,priest,discipline,302,147,155
Curiosities,kiljaeden,1248,priest,discipline,30,13,17
Iatemykids,tichondrius,1247,priest,discipline,24,13,11
Lvcia,thrall,1247,priest,discipline,70,35,35
Pianohouse,illidan,1247,priest,discipline,30,13,17
Calamithus,illidan,1247,priest,discipline,30,13,17
Pce,korialstrasz,1247,priest,discipline,34,13,21
Dottinu,area-52,1246,priest,discipline,24,19,5
Furydos,zuljin,1246,priest,discipline,24,13,11
Peacetreaty,bleeding-hollow,1246,priest,discipline,24,13,11
Picurry,frostmourne,1246,priest,discipline,24,13,11
Vancake,quelthalas,1246,priest,discipline,222,103,119
Zumbaoqepdqt,quelthalas,1246,priest,discipline,66,30,36
Bearz,the-underbog,1246,priest,discipline,30,13,17
Iol,spinebreaker,1246,priest,discipline,30,13,17
Keepfit,proudmoore,1245,priest,discipline,52,29,23
Armspriest,stormrage,1245,priest,discipline,59,31,28
Youaint,sargeras,1245,priest,discipline,30,13,17
Epophy,stormrage,1244,priest,discipline,18,13,5
Kellogss,magtheridon,1244,priest,discipline,18,13,5
Elivice,ragnaros,1244,priest,discipline,24,13,11
Kantareller,tichondrius,1244,priest,discipline,148,80,68
Tubrisildris,zuljin,1244,priest,discipline,30,13,17
Seí,barthilas,1244,priest,discipline,30,13,17
Gomer,stormrage,1243,priest,discipline,24,14,10
Bingoreferee,kelthuzad,1243,priest,discipline,24,13,11
Crunchywater,stormrage,1243,priest,discipline,30,13,17
Haetas,zuljin,1243,priest,discipline,30,13,17
Cyaja,moon-guard,1243,priest,discipline,31,13,18
Meiev,quelthalas,1243,priest,discipline,36,13,23
Deagled,tichondrius,1243,priest,discipline,36,13,23
Okiin,malganis,1243,priest,discipline,36,13,23
Grapës,jubeithos,1242,priest,discipline,48,23,25
Breeannà,doomhammer,1242,priest,discipline,34,16,18
Cuddly,shandris,1242,priest,discipline,119,54,65
Tassadaraiur,tichondrius,1242,priest,discipline,86,37,49
Touchyouboy,stormrage,1242,priest,discipline,35,15,20
Keleset,area-52,1242,priest,discipline,36,13,23
Quickq,barthilas,1241,priest,discipline,42,24,18
Dragndatwagn,malganis,1241,priest,discipline,27,15,12
Healaryduff,skullcrusher,1241,priest,discipline,24,13,11
Frotters,kiljaeden,1241,priest,discipline,24,13,11
Moresex,azralon,1241,priest,discipline,85,43,42
Harborcoat,whisperwind,1241,priest,discipline,35,14,21
Tubz,boulderfist,1241,priest,discipline,36,13,23
Wantsumcandy,illidan,1240,priest,discipline,102,61,41
Ruaba,area-52,1240,priest,discipline,24,13,11
Biggerstaff,icecrown,1240,priest,discipline,33,16,17
Rando,shattered-halls,1240,priest,discipline,59,28,31
Arodar,wyrmrest-accord,1240,priest,discipline,30,14,16
Shadlo,chogall,1240,priest,discipline,30,13,17
Spacegrassfx,bleeding-hollow,1239,priest,discipline,24,14,10
Discrepancy,sargeras,1239,priest,discipline,24,14,10
Sadury,tichondrius,1239,priest,discipline,246,135,111
Sunwalken,stormrage,1239,priest,discipline,30,13,17
Skylark,bronzebeard,1239,priest,discipline,36,13,23
Dics,barthilas,1238,priest,discipline,18,13,5
Daegal,malfurion,1238,priest,discipline,18,13,5
Saviorkaï,barthilas,1238,priest,discipline,45,25,20
Feloxi,lightnings-blade,1238,priest,discipline,24,13,11
Tunare,dalaran,1238,priest,discipline,24,13,11
Wisher,gorefiend,1238,priest,discipline,41,22,19
Cvstodia,tichondrius,1238,priest,discipline,30,16,14
Xsqt,stormrage,1238,priest,discipline,60,31,29
Misaosan,azralon,1238,priest,discipline,60,29,31
Fumes,ghostlands,1238,priest,discipline,138,66,72
Masochist,barthilas,1237,priest,discipline,152,83,69
Jesstor,frostmourne,1237,priest,discipline,24,13,11
Pinkhandcuff,gorefiend,1237,priest,discipline,54,25,29
Xuxao,azralon,1237,priest,discipline,35,15,20
Tdmheals,zuluhed,1236,priest,discipline,36,25,11
Holycoww,lightnings-blade,1236,priest,discipline,24,13,11
Whitesharks,tichondrius,1236,priest,discipline,24,13,11
Holyren,sargeras,1236,priest,discipline,134,69,65
Gregorovich,ragnaros,1236,priest,discipline,59,27,32
Hellsembrace,lightbringer,1236,priest,discipline,30,13,17
Naniwa,ragnaros,1236,priest,discipline,39,16,23
Mikori,tichondrius,1235,priest,discipline,18,13,5
Nerylia,stormrage,1235,priest,discipline,18,13,5
Deadlydocc,illidan,1235,priest,discipline,39,23,16
Kideater,quelthalas,1235,priest,discipline,24,13,11
Bonkerwaffle,kelthuzad,1235,priest,discipline,54,29,25
Fesix,akama,1235,priest,discipline,42,22,20
Betrthenadam,bleeding-hollow,1235,priest,discipline,66,32,34
Duatneter,quelthalas,1235,priest,discipline,84,39,45
Rhennythal,tichondrius,1235,priest,discipline,30,13,17
Tossôff,proudmoore,1234,priest,discipline,18,13,5
Undefiled,rexxar,1234,priest,discipline,42,24,18
Awyn,elune,1234,priest,discipline,48,25,23
Hobbs,trollbane,1234,priest,discipline,48,24,24
Léto,burning-blade,1234,priest,discipline,48,21,27
Chervz,chogall,1234,priest,discipline,30,13,17
Beastpriest,dalvengyr,1234,priest,discipline,30,13,17
Miznewbooty,garona,1233,priest,discipline,30,17,13
Ickarus,anubarak,1233,priest,discipline,90,49,41
Sichuankeith,frostmourne,1233,priest,discipline,24,13,11
Kinkypriest,tichondrius,1233,priest,discipline,24,13,11
Dårc,tichondrius,1233,priest,discipline,113,58,55
Anöa,emerald-dream,1233,priest,discipline,36,16,20
Glitterballs,khazgoroth,1232,priest,discipline,24,13,11
Tigop,alleria,1232,priest,discipline,24,13,11
Calcifer,drakkari,1232,priest,discipline,30,13,17
Kuroyanagi,ragnaros,1232,priest,discipline,36,13,23
Xora,frostmourne,1232,priest,discipline,36,13,23
Nanabritches,moon-guard,1231,priest,discipline,163,84,79
Ðiviniti,moon-guard,1231,priest,discipline,36,17,19
Karamapang,illidan,1231,priest,discipline,122,56,66
Demimang,emerald-dream,1231,priest,discipline,30,13,17
Samàél,frostmourne,1231,priest,discipline,41,17,24
Holyxb,bleeding-hollow,1231,priest,discipline,36,13,23
Empty,frostmourne,1230,priest,discipline,18,13,5
Shïtheals,frostmourne,1230,priest,discipline,42,25,17
Alenio,sargeras,1230,priest,discipline,30,14,16
Ón,tichondrius,1230,priest,discipline,30,13,17
Riotgearmd,sargeras,1229,priest,discipline,30,17,13
Wanaatlarboy,dark-iron,1229,priest,discipline,41,23,18
Lichae,ragnaros,1229,priest,discipline,48,24,24
Yürika,emerald-dream,1229,priest,discipline,168,73,95
Kurtsheals,destromath,1228,priest,discipline,60,31,29
Krypticus,tichondrius,1227,priest,discipline,54,31,23
Aape,frostmourne,1227,priest,discipline,24,13,11
Swolequadz,elune,1227,priest,discipline,38,20,18
Senliastra,medivh,1226,priest,discipline,30,18,12
Jeffo,baelgun,1226,priest,discipline,78,44,34
Notdavido,illidan,1226,priest,discipline,48,26,22
Yotinha,nemesis,1226,priest,discipline,24,13,11
Healtomuch,nagrand,1226,priest,discipline,120,59,61
Pavarotti,laughing-skull,1226,priest,discipline,44,19,25
Gurbooz,tichondrius,1225,priest,discipline,77,35,42
Bendoverbb,tichondrius,1225,priest,discipline,30,13,17
Gäindalf,tichondrius,1224,priest,discipline,22,14,8
Kapriestun,tichondrius,1224,priest,discipline,66,37,29
Hanuloa,tichondrius,1224,priest,discipline,114,57,57
Eneco,alleria,1223,priest,discipline,297,156,141
Castnngcouch,tichondrius,1223,priest,discipline,217,103,114
Fearufaraway,tichondrius,1223,priest,discipline,36,13,23
Ahitaro,ragnaros,1223,priest,discipline,60,18,42
Aud,kiljaeden,1222,priest,discipline,18,14,4
Kummar,burning-blade,1222,priest,discipline,24,13,11
Kosiris,stormrage,1222,priest,discipline,102,41,61
Olêander,tichondrius,1221,priest,discipline,97,55,42
Hoffmanx,emerald-dream,1221,priest,discipline,24,13,11
Dittless,stormrage,1221,priest,discipline,60,29,31
Beecakes,illidan,1220,priest,discipline,29,16,13
Zadae,area-52,1220,priest,discipline,63,34,29
Pòba,malganis,1220,priest,discipline,30,13,17
Kessavannell,frostwolf,1219,priest,discipline,24,13,11
Séraphin,proudmoore,1219,priest,discipline,37,16,21
Jic,barthilas,1219,priest,discipline,66,25,41
Snekboy,hakkar,1218,priest,discipline,78,45,33
Nonamegame,sargeras,1218,priest,discipline,78,42,36
Cypress,dreadmaul,1218,priest,discipline,162,87,75
Pyper,medivh,1218,priest,discipline,29,14,15
Chopstix,senjin,1218,priest,discipline,35,16,19
Lanakill,hyjal,1218,priest,discipline,56,25,31
Gdessairmed,exodar,1218,priest,discipline,37,16,21
Gobnik,illidan,1217,priest,discipline,42,26,16
Yvága,ragnaros,1217,priest,discipline,48,27,21
Forestpriest,area-52,1217,priest,discipline,24,13,11
Pacopriest,tichondrius,1217,priest,discipline,24,13,11
Kinkykween,tichondrius,1216,priest,discipline,24,13,11
Novous,area-52,1216,priest,discipline,68,29,39
Göats,emerald-dream,1215,priest,discipline,24,13,11
Alexena,senjin,1215,priest,discipline,37,17,20
Russbell,ragnaros,1215,priest,discipline,131,57,74
Plznokill,tichondrius,1215,priest,discipline,48,20,28
Eîr,tichondrius,1215,priest,discipline,72,29,43
Vandwrath,moon-guard,1214,priest,discipline,24,14,10
Kadkne,stormrage,1214,priest,discipline,29,16,13
Myvanwy,silvermoon,1214,priest,discipline,30,13,17
Wise,wildhammer,1213,priest,discipline,129,65,64
Xpera,dalaran,1212,priest,discipline,203,97,106
Nóin,tichondrius,1212,priest,discipline,72,33,39
Psïcopata,gallywix,1212,priest,discipline,60,20,40
Dotersacer,quelthalas,1211,priest,discipline,31,15,16
Anakou,emerald-dream,1210,priest,discipline,35,20,15
Abhu,quelthalas,1210,priest,discipline,77,41,36
Svrite,area-52,1210,priest,discipline,35,17,18
Zulkmoon,ragnaros,1210,priest,discipline,84,31,53
Stunsilence,malganis,1209,priest,discipline,26,14,12
Keliedeyn,emerald-dream,1209,priest,discipline,60,28,32
Deckardkane,stormrage,1209,priest,discipline,32,14,18
Anthoras,stormrage,1208,priest,discipline,24,13,11
Ariavish,area-52,1208,priest,discipline,48,25,23
Kodaks,frostmourne,1208,priest,discipline,93,46,47
Fatäl,moon-guard,1208,priest,discipline,64,23,41
Stusy,tichondrius,1207,priest,discipline,18,13,5
Pixa,tichondrius,1207,priest,discipline,72,33,39
Xïlencer,tichondrius,1206,priest,discipline,96,56,40
Nothinsexual,frostmourne,1206,priest,discipline,26,14,12
Cast,bronzebeard,1206,priest,discipline,82,37,45
Dpshealer,azralon,1206,priest,discipline,66,29,37
Discotecno,tichondrius,1205,priest,discipline,48,25,23
Gurkorr,boulderfist,1205,priest,discipline,57,24,33
Discs,detheroc,1205,priest,discipline,31,13,18
Kafzial,zuljin,1204,priest,discipline,80,48,32
Laggin,queldorei,1204,priest,discipline,47,25,22
Sureno,muradin,1204,priest,discipline,54,28,26
Visse,auchindoun,1204,priest,discipline,435,209,226
Rowman,frostmourne,1204,priest,discipline,47,22,25
Libationz,area-52,1204,priest,discipline,108,49,59
Psychiatrist,darkspear,1204,priest,discipline,58,25,33
Nêcrô,tichondrius,1203,priest,discipline,22,13,9
Ithvedriel,moon-guard,1203,priest,discipline,67,32,35
Spellpower,azralon,1203,priest,discipline,47,22,25
Whitezz,frostmourne,1202,priest,discipline,42,21,21
Khamata,kelthuzad,1202,priest,discipline,40,19,21
Kyrabon,ragnaros,1201,priest,discipline,30,17,13
Wrathchildd,azralon,1201,priest,discipline,84,42,42
Healzyew,dragonmaw,1201,priest,discipline,79,31,48
Ohnotready,tichondrius,1200,priest,discipline,24,13,11
Zephxd,illidan,1199,priest,discipline,64,31,33
Burpees,dalaran,1199,priest,discipline,88,39,49
Aladelre,aerie-peak,1199,priest,discipline,74,32,42
Terenor,thrall,1199,priest,discipline,48,13,35
Jawdypriest,barthilas,1198,priest,discipline,44,27,17
Yukih,tichondrius,1198,priest,discipline,64,29,35
Shinomiko,frostmourne,1198,priest,discipline,162,63,99
Lebwonjamdi,tichondrius,1197,priest,discipline,28,13,15
Paidessanto,azralon,1196,priest,discipline,134,69,65
Docbek,illidan,1196,priest,discipline,83,40,43
Healbilli,archimonde,1196,priest,discipline,30,13,17
Adaele,ragnaros,1195,priest,discipline,66,32,34
Metius,smolderthorn,1194,priest,discipline,21,14,7
Fozil,area-52,1194,priest,discipline,62,33,29
Karaasbull,tichondrius,1194,priest,discipline,46,22,24
Sasafras,feathermoon,1193,priest,discipline,87,43,44
Ricksanchez,moonrunner,1193,priest,discipline,30,13,17
Brooklyn,draka,1192,priest,discipline,30,16,14
Bladam,bleeding-hollow,1192,priest,discipline,27,13,14
Babino,illidan,1192,priest,discipline,66,26,40
Kriseria,moon-guard,1191,priest,discipline,24,17,7
Psïren,quelthalas,1191,priest,discipline,107,56,51
Healyoudead,draenor,1191,priest,discipline,41,15,26
Rachia,barthilas,1190,priest,discipline,72,43,29
Evelien,kiljaeden,1190,priest,discipline,66,31,35
Sanitater,frostmourne,1190,priest,discipline,102,47,55
Dzpi,azralon,1190,priest,discipline,96,43,53
Azkillatroll,quelthalas,1190,priest,discipline,48,20,28
Protega,illidan,1189,priest,discipline,22,14,8
Decastro,silvermoon,1189,priest,discipline,23,13,10
Holyycrit,kelthuzad,1189,priest,discipline,30,16,14
Ödin,tichondrius,1189,priest,discipline,60,31,29
Menorsita,tichondrius,1189,priest,discipline,120,57,63
Maiyennefer,proudmoore,1189,priest,discipline,48,20,28
Rinmaru,dark-iron,1188,priest,discipline,24,14,10
Iltharaph,illidan,1188,priest,discipline,25,14,11
Kruciphix,tichondrius,1187,priest,discipline,29,20,9
Kaxleigh,emerald-dream,1187,priest,discipline,29,18,11
Inarius,dragonblight,1187,priest,discipline,55,23,32
Braindrip,thrall,1187,priest,discipline,36,14,22
Sunael,quelthalas,1186,priest,discipline,29,20,9
Yusarin,garona,1186,priest,discipline,30,14,16
Sargasm,darkspear,1185,priest,discipline,21,14,7
Eluv,area-52,1185,priest,discipline,44,25,19
Nadjika,moon-guard,1185,priest,discipline,57,26,31
Valonar,emerald-dream,1185,priest,discipline,47,20,27
Tesserak,tichondrius,1184,priest,discipline,105,49,56
Inferis,ragnaros,1183,priest,discipline,393,195,198
Unwòke,dalaran,1182,priest,discipline,24,14,10
Happydot,stormrage,1182,priest,discipline,30,14,16
Belletrael,wyrmrest-accord,1182,priest,discipline,70,32,38
Kßnstuff,area-52,1182,priest,discipline,37,15,22
Doubtmyfaith,frostmourne,1181,priest,discipline,42,21,21
Artermis,barthilas,1180,priest,discipline,85,37,48
Kiaras,stormrage,1179,priest,discipline,48,25,23
Omgpeeldude,akama,1179,priest,discipline,33,13,20
Gabrieleron,quelthalas,1177,priest,discipline,30,18,12
Runemidgard,illidan,1177,priest,discipline,24,13,11
Aerîs,magtheridon,1177,priest,discipline,40,16,24
Iwillsaveyou,tichondrius,1177,priest,discipline,40,16,24
Damoclexz,area-52,1176,priest,discipline,72,38,34
Feumanchu,area-52,1176,priest,discipline,32,14,18
Goldenfatty,blackrock,1175,priest,discipline,26,13,13
Jagelclam,gorefiend,1175,priest,discipline,47,22,25
Matafuka,ragnaros,1175,priest,discipline,45,20,25
Kethseth,ragnaros,1175,priest,discipline,102,45,57
Onef,quelthalas,1175,priest,discipline,35,15,20
Hiheals,anvilmar,1174,priest,discipline,36,20,16
Mindlames,bleeding-hollow,1173,priest,discipline,68,30,38
Minimelo,stormrage,1172,priest,discipline,23,13,10
Spyzz,gilneas,1172,priest,discipline,36,18,18
Aliciab,andorhal,1172,priest,discipline,78,36,42
Darrong,darkspear,1172,priest,discipline,52,24,28
Aynone,blood-furnace,1171,priest,discipline,149,70,79
Anddori,moknathal,1171,priest,discipline,54,25,29
Forprophet,proudmoore,1171,priest,discipline,34,13,21
Näme,frostmourne,1170,priest,discipline,105,46,59
Kerazul,sargeras,1169,priest,discipline,42,20,22
Kostadinov,tichondrius,1169,priest,discipline,30,13,17
Cathêlay,bleeding-hollow,1168,priest,discipline,118,56,62
Audacy,azuremyst,1167,priest,discipline,51,29,22
Pushap,blood-furnace,1167,priest,discipline,108,58,50
Poilu,laughing-skull,1165,priest,discipline,25,15,10
Junss,tichondrius,1165,priest,discipline,23,13,10
Deadshöt,gorefiend,1163,priest,discipline,20,13,7
Abalowpt,nemesis,1163,priest,discipline,48,22,26
Ghettobarbie,kelthuzad,1162,priest,discipline,24,14,10
Sontïx,sargeras,1162,priest,discipline,31,13,18
Theryan,ragnaros,1161,priest,discipline,72,31,41
Heallarious,stormrage,1160,priest,discipline,52,30,22
Mxrru,stonemaul,1160,priest,discipline,143,68,75
Mäy,greymane,1160,priest,discipline,36,14,22
Eveilar,sargeras,1159,priest,discipline,24,15,9
Semirg,moon-guard,1158,priest,discipline,30,13,17
Velinna,tichondrius,1158,priest,discipline,42,16,26
Toastanator,wyrmrest-accord,1156,priest,discipline,220,115,105
Celf,ragnaros,1156,priest,discipline,36,13,23
Tmpriest,tichondrius,1156,priest,discipline,68,20,48
Xaerwolaeth,area-52,1155,priest,discipline,34,16,18
Maraagsdad,tichondrius,1152,priest,discipline,18,12,6
Bangseight,sargeras,1152,priest,discipline,18,12,6
Souvlaki,amanthul,1152,priest,discipline,24,12,12
Cindyloux,tichondrius,1152,priest,discipline,24,12,12
Teddyy,tichondrius,1152,priest,discipline,24,12,12
Swagdemøn,kelthuzad,1152,priest,discipline,24,12,12
Çherish,stormrage,1152,priest,discipline,24,12,12
Xinnie,illidan,1152,priest,discipline,108,48,60
Ømegagødx,illidan,1152,priest,discipline,30,12,18
Faithbuild,emerald-dream,1151,priest,discipline,18,12,6
Woolly,tichondrius,1151,priest,discipline,18,12,6
Souriel,tichondrius,1151,priest,discipline,96,51,45
Word,korgath,1151,priest,discipline,24,12,12
Marmintor,stormrage,1151,priest,discipline,24,12,12
Pewwpew,malganis,1151,priest,discipline,24,12,12
Sshhaaddooww,tichondrius,1151,priest,discipline,24,12,12
Randrimm,stormrage,1151,priest,discipline,24,12,12
Hyoeun,dragonmaw,1151,priest,discipline,24,12,12
Kiriko,mannoroth,1151,priest,discipline,24,12,12
Vampriest,frostmourne,1151,priest,discipline,31,14,17
Kaztorz,tichondrius,1151,priest,discipline,28,12,16
Graymorick,malganis,1151,priest,discipline,30,12,18
Attenea,illidan,1151,priest,discipline,36,12,24
Ilmx,illidan,1150,priest,discipline,12,12,0
Agrolazor,frostwolf,1150,priest,discipline,12,12,0
Tomp,tichondrius,1150,priest,discipline,18,12,6
Wizeau,dalaran,1150,priest,discipline,18,12,6
Celeztiah,area-52,1150,priest,discipline,18,12,6
Rapturebtw,sargeras,1150,priest,discipline,18,12,6
Aaff,tichondrius,1150,priest,discipline,18,12,6
Chkashaa,emerald-dream,1150,priest,discipline,42,21,21
Rhaist,sargeras,1150,priest,discipline,36,18,18
Ahealer,alterac-mountains,1150,priest,discipline,24,12,12
Icesnowli,tichondrius,1150,priest,discipline,24,12,12
Glöws,area-52,1150,priest,discipline,24,12,12
Longday,kelthuzad,1150,priest,discipline,24,12,12
Cenrtrix,stormrage,1150,priest,discipline,24,12,12
Wartrix,bonechewer,1150,priest,discipline,24,12,12
Abercromby,malganis,1150,priest,discipline,25,12,13
Yoxxoo,tichondrius,1150,priest,discipline,36,17,19
Penancedeez,moon-guard,1150,priest,discipline,35,15,20
Maxximuss,bleeding-hollow,1150,priest,discipline,42,17,25
Profpepper,tichondrius,1149,priest,discipline,18,12,6
Troubler,tichondrius,1149,priest,discipline,18,12,6
Nerfholyplz,illidan,1149,priest,discipline,24,12,12
Shadowchaos,malganis,1149,priest,discipline,24,12,12
Ariste,tichondrius,1149,priest,discipline,24,12,12
Vatikn,stormrage,1149,priest,discipline,24,12,12
Pakc,tichondrius,1149,priest,discipline,24,12,12
Whitenoiz,kiljaeden,1149,priest,discipline,24,12,12
Kitenix,proudmoore,1149,priest,discipline,35,14,21
Jacqueline,tichondrius,1149,priest,discipline,30,12,18
Tslacalls,malganis,1148,priest,discipline,18,12,6
Való,stormrage,1148,priest,discipline,18,12,6
Nelf,warsong,1148,priest,discipline,26,14,12
Dènalí,area-52,1148,priest,discipline,24,12,12
Highelfpally,sargeras,1148,priest,discipline,24,12,12
Littlegiirl,illidan,1148,priest,discipline,24,12,12
Luminatio,quelthalas,1148,priest,discipline,76,36,40
Revolki,azralon,1148,priest,discipline,48,12,36
Zhuyin,illidan,1147,priest,discipline,12,12,0
Rlkeyboard,sargeras,1147,priest,discipline,18,12,6
Tegridyfarm,malganis,1147,priest,discipline,18,12,6
Profetico,ragnaros,1147,priest,discipline,83,43,40
Icykal,tichondrius,1147,priest,discipline,24,12,12
Tranquilty,tichondrius,1147,priest,discipline,24,12,12
Taboogie,tichondrius,1147,priest,discipline,30,12,18
Katjaa,quelthalas,1147,priest,discipline,44,13,31
Scrubgames,garrosh,1146,priest,discipline,12,12,0
Bakerstr,tichondrius,1146,priest,discipline,18,12,6
Níaa,ragnaros,1146,priest,discipline,24,12,12
Smightful,garona,1146,priest,discipline,24,12,12
Derowent,emerald-dream,1146,priest,discipline,30,13,17
Fearthepain,lethon,1146,priest,discipline,30,12,18
Kreon,tichondrius,1145,priest,discipline,18,12,6
Namecusein,ragnaros,1145,priest,discipline,24,12,12
Beansofdean,proudmoore,1145,priest,discipline,24,12,12
Leensay,mannoroth,1145,priest,discipline,24,12,12
Nenedada,tichondrius,1145,priest,discipline,24,12,12
Halidiir,frostmourne,1144,priest,discipline,18,13,5
Hoochiemomma,kelthuzad,1144,priest,discipline,24,13,11
Mashpotato,aerie-peak,1144,priest,discipline,24,13,11
Honeyweiss,cairne,1144,priest,discipline,30,16,14
Voidwyrm,tichondrius,1144,priest,discipline,108,57,51
Dumbboxx,emerald-dream,1144,priest,discipline,24,12,12
Notskynet,tichondrius,1144,priest,discipline,24,12,12
Tmchicken,tichondrius,1144,priest,discipline,24,12,12
Nardhead,sargeras,1143,priest,discipline,42,24,18
Depressedboy,wyrmrest-accord,1143,priest,discipline,24,12,12
Tygrr,kelthuzad,1143,priest,discipline,24,12,12
Qbanota,drakkari,1143,priest,discipline,156,63,93
Inveritu,kiljaeden,1143,priest,discipline,30,12,18
Vyvanse,azuremyst,1143,priest,discipline,99,32,67
Unagidrop,malganis,1142,priest,discipline,22,13,9
Telrane,aggramar,1142,priest,discipline,24,12,12
Raivn,illidan,1142,priest,discipline,24,12,12
Ferilla,illidan,1142,priest,discipline,24,12,12
Múd,mannoroth,1142,priest,discipline,42,12,30
Jivita,lightbringer,1141,priest,discipline,24,14,10
Lumentusk,stormscale,1141,priest,discipline,24,12,12
Vanhealsing,tichondrius,1141,priest,discipline,24,12,12
Fantasyx,ragnaros,1140,priest,discipline,29,16,13
Meddyglyn,area-52,1140,priest,discipline,24,13,11
Stroodle,illidan,1140,priest,discipline,71,34,37
Scalpell,tichondrius,1139,priest,discipline,18,12,6
Núgz,tichondrius,1139,priest,discipline,47,31,16
Tyrea,kiljaeden,1139,priest,discipline,24,12,12
Osombra,azralon,1139,priest,discipline,36,17,19
Amäo,illidan,1139,priest,discipline,29,13,16
Padragon,tichondrius,1139,priest,discipline,30,12,18
Kippin,frostmourne,1138,priest,discipline,18,12,6
Draniev,azralon,1138,priest,discipline,83,44,39
Shooshanaa,stormrage,1138,priest,discipline,24,12,12
Elvspriesly,doomhammer,1138,priest,discipline,104,51,53
Papergaruru,illidan,1138,priest,discipline,102,47,55
Tetha,fizzcrank,1138,priest,discipline,48,22,26
Claireredfld,lightbringer,1137,priest,discipline,18,12,6
Drywàter,tichondrius,1137,priest,discipline,81,45,36
Lynnar,stormrage,1137,priest,discipline,81,44,37
Feelmyheels,frostmourne,1137,priest,discipline,48,24,24
Donoras,ursin,1137,priest,discipline,36,17,19
Barrysanders,zuljin,1136,priest,discipline,72,38,34
Hanuroa,tichondrius,1136,priest,discipline,184,92,92
Brotherheals,nagrand,1136,priest,discipline,66,33,33
Holyhog,whisperwind,1136,priest,discipline,51,23,28
Sprinkling,sargeras,1136,priest,discipline,34,15,19
Sölemn,barthilas,1136,priest,discipline,59,26,33
Gromkor,ragnaros,1135,priest,discipline,18,12,6
Xarid,moon-guard,1135,priest,discipline,18,12,6
Blessings,aerie-peak,1135,priest,discipline,72,37,35
Leuviáh,ragnaros,1135,priest,discipline,24,12,12
Skokie,area-52,1135,priest,discipline,30,12,18
Calliah,moknathal,1134,priest,discipline,35,19,16
Alizeë,illidan,1134,priest,discipline,137,74,63
Senumbra,tichondrius,1134,priest,discipline,24,12,12
Tkawesome,area-52,1134,priest,discipline,42,15,27
Yddwin,quelthalas,1131,priest,discipline,52,27,25
Theleena,malorne,1131,priest,discipline,36,17,19
Ihealyoudeal,korgath,1130,priest,discipline,18,12,6
Skruffles,black-dragonflight,1130,priest,discipline,29,17,12
Looneý,drakkari,1130,priest,discipline,123,69,54
Melithor,frostmourne,1130,priest,discipline,24,12,12
Coachbombae,tichondrius,1129,priest,discipline,18,13,5
Charybdis,bonechewer,1129,priest,discipline,92,56,36
Makkima,area-52,1129,priest,discipline,48,20,28
Corthien,thrall,1129,priest,discipline,30,12,18
Hëstia,darkspear,1128,priest,discipline,30,18,12
Nøfaith,area-52,1128,priest,discipline,24,12,12
Galaxypepe,medivh,1128,priest,discipline,29,12,17
Bornindeath,proudmoore,1128,priest,discipline,30,12,18
Cyrilien,tichondrius,1127,priest,discipline,52,29,23
Ragnarøk,warsong,1127,priest,discipline,30,12,18
Killían,darkspear,1126,priest,discipline,61,31,30
Pahdre,tichondrius,1125,priest,discipline,18,12,6
Skeepsi,area-52,1125,priest,discipline,60,34,26
Sänctus,emerald-dream,1125,priest,discipline,24,12,12
Zolibeth,azshara,1124,priest,discipline,24,15,9
Haidees,akama,1124,priest,discipline,46,28,18
Thrudarkness,thrall,1124,priest,discipline,25,15,10
Xuun,illidan,1124,priest,discipline,81,44,37
Velriana,tichondrius,1124,priest,discipline,30,12,18
Mucgib,frostmourne,1124,priest,discipline,74,27,47
Jahsheer,kiljaeden,1123,priest,discipline,20,14,6
Weregonnadie,stormrage,1123,priest,discipline,30,12,18
Ðåmìéñ,tichondrius,1122,priest,discipline,24,12,12
Imbot,ragnaros,1122,priest,discipline,24,12,12
Exsufficate,frostmourne,1122,priest,discipline,34,15,19
Islandpink,malganis,1122,priest,discipline,42,12,30
Londog,vashj,1121,priest,discipline,78,36,42
Primeevil,black-dragonflight,1119,priest,discipline,24,14,10
Deehilie,illidan,1119,priest,discipline,49,25,24
Kerith,ragnaros,1118,priest,discipline,46,34,12
Youngboys,stormreaver,1118,priest,discipline,57,28,29
Puralux,balnazzar,1117,priest,discipline,42,25,17
Cyberpriest,stormrage,1117,priest,discipline,66,27,39
Abbot,zangarmarsh,1115,priest,discipline,155,73,82
Alimony,chogall,1114,priest,discipline,23,12,11
Zinr,tichondrius,1114,priest,discipline,370,175,195
Eirana,skywall,1114,priest,discipline,78,36,42
Blackbubba,tichondrius,1114,priest,discipline,66,29,37
Vitalizes,nagrand,1114,priest,discipline,30,13,17
Kelelin,frostwolf,1114,priest,discipline,30,12,18
Deadäss,sargeras,1113,priest,discipline,54,14,40
Steezyy,black-dragonflight,1112,priest,discipline,71,33,38
Yamahaz,lethon,1112,priest,discipline,30,13,17
Foxyy,wildhammer,1112,priest,discipline,35,14,21
Fushia,emerald-dream,1107,priest,discipline,45,16,29
Enkognito,tichondrius,1106,priest,discipline,52,33,19
Pûrplehaze,aegwynn,1106,priest,discipline,23,12,11
Mchinder,tanaris,1106,priest,discipline,94,48,46
Optîmuskrayt,tichondrius,1106,priest,discipline,83,40,43
Tootsieroll,dark-iron,1106,priest,discipline,53,25,28
Raihn,garrosh,1106,priest,discipline,37,14,23
Kithlas,emerald-dream,1105,priest,discipline,32,17,15
Cuckfist,darkspear,1105,priest,discipline,71,30,41
Opri,andorhal,1104,priest,discipline,48,20,28
Mosher,zuluhed,1103,priest,discipline,18,12,6
Ataraksija,sargeras,1103,priest,discipline,21,13,8
Averli,moon-guard,1103,priest,discipline,42,18,24
Khallmir,goldrinn,1100,priest,discipline,120,56,64
Mindkilla,area-52,1099,priest,discipline,214,109,105
Jtewatch,zuljin,1098,priest,discipline,60,35,25
Goodbyekiss,illidan,1098,priest,discipline,107,51,56
Jaster,proudmoore,1097,priest,discipline,48,31,17
Vákc,quelthalas,1096,priest,discipline,23,12,11
Anäster,ragnaros,1096,priest,discipline,59,30,29
Darkxrp,bleeding-hollow,1096,priest,discipline,30,13,17
Draiger,quelthalas,1096,priest,discipline,36,14,22
Fistavert,stormreaver,1095,priest,discipline,24,12,12
Preezoo,tichondrius,1095,priest,discipline,64,25,39
Tuoday,agamaggan,1094,priest,discipline,21,12,9
Shadowpáin,ragnaros,1094,priest,discipline,24,12,12
Zhaann,kelthuzad,1094,priest,discipline,48,23,25
Happyholy,tichondrius,1094,priest,discipline,36,14,22
Sístermary,stormrage,1093,priest,discipline,30,18,12
Iseeyoulookn,stormrage,1093,priest,discipline,29,14,15
Mcdizzle,bloodscalp,1093,priest,discipline,90,41,49
Nuvea,tichondrius,1093,priest,discipline,27,12,15
Annaphilaxis,sargeras,1091,priest,discipline,44,22,22
Ketone,malganis,1090,priest,discipline,125,65,60
Zacksnotcool,sargeras,1090,priest,discipline,33,13,20
Saren,dethecus,1089,priest,discipline,15,13,2
Priestøuchme,tichondrius,1089,priest,discipline,29,13,16
Thinmintt,wyrmrest-accord,1089,priest,discipline,108,47,61
Papipreach,sargeras,1088,priest,discipline,24,15,9
Bigdaddyku,hyjal,1088,priest,discipline,34,20,14
Mylkshakez,emerald-dream,1088,priest,discipline,31,13,18
Bombmarley,azralon,1088,priest,discipline,30,12,18
Salovoth,area-52,1088,priest,discipline,48,17,31
Fhelurian,quelthalas,1088,priest,discipline,36,12,24
Holysmokesx,tichondrius,1087,priest,discipline,22,12,10
Antiraus,aerie-peak,1086,priest,discipline,24,13,11
Fatherfilth,frostwolf,1086,priest,discipline,30,14,16
Slaac,malfurion,1085,priest,discipline,23,12,11
Quavö,tichondrius,1085,priest,discipline,68,29,39
Elbowbeans,tichondrius,1085,priest,discipline,34,12,22
Kidha,stormrage,1085,priest,discipline,60,19,41
Ariyaned,quelthalas,1084,priest,discipline,18,12,6
Todrecas,ragnaros,1084,priest,discipline,24,13,11
Painpaws,moon-guard,1084,priest,discipline,28,12,16
Nécrofear,drakkari,1083,priest,discipline,20,13,7
Vaddaru,kirin-tor,1083,priest,discipline,66,38,28
Tigrania,proudmoore,1083,priest,discipline,23,12,11
Scirzzy,tichondrius,1083,priest,discipline,29,14,15
Chroly,stormrage,1083,priest,discipline,65,29,36
Watdahealydo,darkspear,1081,priest,discipline,24,13,11
Nostrande,stormrage,1080,priest,discipline,21,12,9
Synes,bleeding-hollow,1080,priest,discipline,34,12,22
Benmem,illidan,1078,priest,discipline,141,68,73
Fregè,ysera,1078,priest,discipline,30,12,18
Mortecraft,sargeras,1076,priest,discipline,30,17,13
Sheriff,lightbringer,1076,priest,discipline,153,80,73
Justinagnpr,tichondrius,1072,priest,discipline,30,14,16
Nervinia,tichondrius,1072,priest,discipline,30,12,18
Redchord,kiljaeden,1072,priest,discipline,33,13,20
Drtesak,illidan,1070,priest,discipline,17,12,5
Chinsta,tichondrius,1069,priest,discipline,38,15,23
Berzap,frostmourne,1068,priest,discipline,30,18,12
Kloudypriest,moon-guard,1065,priest,discipline,53,26,27
Twinkmuncher,proudmoore,1065,priest,discipline,25,12,13
Newheal,quelthalas,1064,priest,discipline,30,16,14
Trustheals,tichondrius,1064,priest,discipline,134,71,63
Lytherina,aegwynn,1064,priest,discipline,36,19,17
Vahlen,azralon,1062,priest,discipline,23,12,11
Fulldesire,dalaran,1061,priest,discipline,69,39,30
Xojelas,quelthalas,1060,priest,discipline,24,13,11
Pochis,bleeding-hollow,1060,priest,discipline,87,42,45
Chickadies,barthilas,1059,priest,discipline,18,12,6
Linarelitha,area-52,1059,priest,discipline,80,39,41
Rileau,tichondrius,1059,priest,discipline,30,12,18
Kikyo,antonidas,1059,priest,discipline,31,12,19
Sivamint,aerie-peak,1058,priest,discipline,42,16,26
Littlehcl,tichondrius,1056,priest,discipline,18,11,7
Roentgen,sargeras,1056,priest,discipline,18,11,7
Lespaula,ragnaros,1056,priest,discipline,24,12,12
Smiliebomb,tichondrius,1056,priest,discipline,24,11,13
Dirtyone,dark-iron,1056,priest,discipline,30,12,18
Lilbabynaga,stormrage,1056,priest,discipline,75,27,48
Crucifer,proudmoore,1055,priest,discipline,12,11,1
Ròen,tichondrius,1055,priest,discipline,18,11,7
Neonpriest,tichondrius,1055,priest,discipline,18,11,7
Piftw,illidan,1055,priest,discipline,18,11,7
Elfgasmic,blackwater-raiders,1055,priest,discipline,18,11,7
Chawp,kelthuzad,1055,priest,discipline,18,11,7
Jonesy,tichondrius,1055,priest,discipline,24,11,13
Arcosis,turalyon,1055,priest,discipline,24,11,13
Cency,tichondrius,1055,priest,discipline,24,11,13
Jangma,tichondrius,1055,priest,discipline,24,11,13
Halcyonzx,tichondrius,1055,priest,discipline,24,11,13
Ffej,bleeding-hollow,1055,priest,discipline,24,11,13
Tooziq,stormrage,1055,priest,discipline,24,11,13
Pro,proudmoore,1055,priest,discipline,24,11,13
Victordaddy,illidan,1055,priest,discipline,24,11,13
Carboload,thrall,1055,priest,discipline,24,11,13
Wintrow,sargeras,1055,priest,discipline,30,11,19
Voidgames,area-52,1055,priest,discipline,30,11,19
Lampvpgerl,illidan,1055,priest,discipline,36,11,25
Aiss,malganis,1054,priest,discipline,16,12,4
Anneyann,fenris,1054,priest,discipline,30,19,11
Missyoung,tichondrius,1054,priest,discipline,18,11,7
Náñí,area-52,1054,priest,discipline,18,11,7
Chastised,moon-guard,1054,priest,discipline,674,330,344
Aguavenditaa,quelthalas,1054,priest,discipline,24,11,13
Dpsmercy,sargeras,1054,priest,discipline,24,11,13
Aikinorz,tichondrius,1054,priest,discipline,24,11,13
Gumiho,drakkari,1054,priest,discipline,87,39,48
Syndrox,kelthuzad,1053,priest,discipline,12,11,1
Doubt,eredar,1053,priest,discipline,18,11,7
Wale,akama,1053,priest,discipline,18,11,7
Whitepigogo,tichondrius,1053,priest,discipline,18,11,7
Kajhy,ragnaros,1053,priest,discipline,48,22,26
Orisons,bleeding-hollow,1053,priest,discipline,24,11,13
Polteageist,frostmourne,1053,priest,discipline,24,11,13
Ayezex,tichondrius,1053,priest,discipline,48,21,27
Màva,zuljin,1053,priest,discipline,30,11,19
Rezy,darkspear,1053,priest,discipline,30,11,19
Wâtermelon,stormrage,1052,priest,discipline,18,11,7
Slavoj,gurubashi,1052,priest,discipline,41,19,22
Kovie,twisting-nether,1052,priest,discipline,24,11,13
Docpriestelf,kelthuzad,1052,priest,discipline,24,11,13
Buffhpriest,tichondrius,1052,priest,discipline,24,11,13
Chiri,tichondrius,1051,priest,discipline,18,11,7
Oncemore,khazgoroth,1051,priest,discipline,18,11,7
Holyshart,stonemaul,1051,priest,discipline,23,12,11
Darkills,tichondrius,1051,priest,discipline,24,11,13
Noxientp,bleeding-hollow,1051,priest,discipline,24,11,13
Jayqwellen,bleeding-hollow,1051,priest,discipline,30,11,19
Xanderp,thrall,1051,priest,discipline,30,11,19
Saviorr,dalaran,1051,priest,discipline,30,11,19
Moopha,zuljin,1050,priest,discipline,12,11,1
Zarfel,ragnaros,1050,priest,discipline,18,11,7
Healdog,thrall,1050,priest,discipline,18,11,7
Neuro,barthilas,1050,priest,discipline,18,11,7
Ajazz,zuljin,1050,priest,discipline,24,11,13
Shiikari,terenas,1050,priest,discipline,24,11,13
Darkmoonsun,frostmourne,1050,priest,discipline,24,11,13
Thotsteal,lightbringer,1050,priest,discipline,24,11,13
Lalight,tichondrius,1050,priest,discipline,30,11,19
Sofunchode,illidan,1049,priest,discipline,30,11,19
Inmortar,dalaran,1049,priest,discipline,30,11,19
Exanthrope,stormrage,1048,priest,discipline,18,11,7
Sajahsa,moon-guard,1048,priest,discipline,25,15,10
Elexianpi,stormrage,1048,priest,discipline,30,11,19
Jackflashh,hakkar,1047,priest,discipline,78,35,43
Sinwifi,ragnaros,1047,priest,discipline,64,27,37
Skinnyfat,azralon,1046,priest,discipline,18,11,7
Classifiedcc,illidan,1046,priest,discipline,264,132,132
Feff,shuhalo,1046,priest,discipline,30,11,19
Oniizanagi,thrall,1046,priest,discipline,30,11,19
Nippols,skullcrusher,1045,priest,discipline,18,11,7
Hangingmeat,jubeithos,1045,priest,discipline,24,11,13
Everluna,stormrage,1043,priest,discipline,12,11,1
Rhapsodias,area-52,1043,priest,discipline,18,11,7
Ahualol,tichondrius,1043,priest,discipline,18,11,7
Lilbabe,stormrage,1043,priest,discipline,24,11,13
Panelopie,maiev,1042,priest,discipline,18,11,7
Sendia,hydraxis,1038,priest,discipline,66,31,35
Merlynaah,azralon,1038,priest,discipline,36,11,25
Lovetotouch,malganis,1037,priest,discipline,24,11,13
Kuppel,tichondrius,1037,priest,discipline,30,11,19
Kiilltic,sargeras,1037,priest,discipline,36,13,23
Deusthanatos,medivh,1036,priest,discipline,70,36,34
Lzzp,azralon,1036,priest,discipline,24,11,13
Gongá,moon-guard,1035,priest,discipline,108,43,65
Prignues,tichondrius,1033,priest,discipline,18,11,7
Uchihalol,tichondrius,1032,priest,discipline,24,11,13
Prawda,area-52,1031,priest,discipline,30,11,19
Geulis,illidan,1030,priest,discipline,65,30,35
Bubbleyo,shandris,1029,priest,discipline,18,11,7
Erelim,durotan,1029,priest,discipline,89,36,53
Yosicuro,ragnaros,1028,priest,discipline,24,13,11
Crossbones,cenarion-circle,1027,priest,discipline,80,43,37
Egraner,drakkari,1027,priest,discipline,24,11,13
Priestvamp,azralon,1027,priest,discipline,36,13,23
Throwinshadê,stormrage,1026,priest,discipline,219,116,103
Cynthir,stormrage,1026,priest,discipline,24,11,13
Efrem,tichondrius,1025,priest,discipline,69,32,37
Chêrubim,arthas,1025,priest,discipline,24,11,13
Clergy,arthas,1024,priest,discipline,21,14,7
Elomszz,tichondrius,1024,priest,discipline,22,11,11
Naxiest,stormrage,1024,priest,discipline,29,11,18
Bakharftw,nemesis,1023,priest,discipline,28,17,11
Harlei,tichondrius,1023,priest,discipline,24,14,10
Mxd,bleeding-hollow,1021,priest,discipline,20,12,8
Treenewbeems,tichondrius,1020,priest,discipline,49,25,24
Mgfoxxie,scarlet-crusade,1020,priest,discipline,30,12,18
Kenray,sargeras,1020,priest,discipline,48,18,30
Deemmortii,stormrage,1020,priest,discipline,40,11,29
Thadan,uldaman,1019,priest,discipline,24,11,13
Sév,frostmane,1017,priest,discipline,190,89,101
Rahna,azralon,1017,priest,discipline,30,11,19
Steck,illidan,1016,priest,discipline,64,27,37
Nightmxres,zuljin,1016,priest,discipline,30,11,19
Jèf,stormrage,1015,priest,discipline,23,11,12
Shaydeep,nagrand,1015,priest,discipline,28,12,16
Profît,stormrage,1014,priest,discipline,24,12,12
Hathamet,thrall,1013,priest,discipline,60,25,35
Rigityrekt,aggramar,1012,priest,discipline,30,22,8
Zatroux,ragnaros,1011,priest,discipline,74,34,40
Drãith,magtheridon,1009,priest,discipline,24,12,12
Uljinoo,blackwing-lair,1009,priest,discipline,92,41,51
Azrïel,mannoroth,1007,priest,discipline,48,28,20
Buschlatte,frostmane,1007,priest,discipline,23,11,12
Dynopriest,kelthuzad,1007,priest,discipline,29,11,18
Lesserfaith,sargeras,1006,priest,discipline,21,11,10
Ehmacros,kelthuzad,1005,priest,discipline,35,11,24
Noriniani,sargeras,1004,priest,discipline,18,13,5
Bubblebuster,lightbringer,1004,priest,discipline,55,24,31
Ioudas,ragnaros,1004,priest,discipline,35,11,24
Vidzz,silvermoon,1003,priest,discipline,23,11,12
Zeun,spinebreaker,1003,priest,discipline,40,14,26
Lördgrim,stormrage,1002,priest,discipline,25,13,12
Tikel,ragnaros,1001,priest,discipline,21,11,10
Stinkyfingr,frostmourne,1000,priest,discipline,42,15,27
Sharayu,madoran,999,priest,discipline,42,22,20
Arianthe,darrowmere,998,priest,discipline,26,12,14
Whitewidowx,eredar,997,priest,discipline,21,12,9
Bårriër,darkspear,996,priest,discipline,23,12,11
Futatsi,zuljin,996,priest,discipline,29,11,18
Rbmxp,barthilas,994,priest,discipline,21,12,9
Mottsarella,mugthol,994,priest,discipline,78,42,36
Mikkik,zuljin,992,priest,discipline,42,26,16
Robertsmurda,emerald-dream,992,priest,discipline,22,11,11
Norastanne,moon-guard,992,priest,discipline,27,12,15
Sharkda,frostmourne,989,priest,discipline,57,31,26
Lilflexi,lightbringer,988,priest,discipline,22,11,11
Taiji,whisperwind,987,priest,discipline,17,11,6
Laeral,quelthalas,987,priest,discipline,35,14,21
Carbonated,zuljin,986,priest,discipline,17,11,6
Antonella,malganis,985,priest,discipline,33,12,21
Mando,area-52,981,priest,discipline,146,78,68
Diamontie,tichondrius,977,priest,discipline,26,16,10
Alurand,bleeding-hollow,976,priest,discipline,18,11,7
Ðrip,burning-legion,976,priest,discipline,22,11,11
Kahari,perenolde,976,priest,discipline,22,11,11
Hèáls,tichondrius,975,priest,discipline,66,29,37
Covfefe,draka,972,priest,discipline,84,30,54
Mëïsoön,quelthalas,969,priest,discipline,17,11,6
Jebadiia,tichondrius,969,priest,discipline,75,34,41
Leoi,fenris,968,priest,discipline,63,31,32
Moomagic,sargeras,968,priest,discipline,59,28,31
Cravex,stormrage,963,priest,discipline,36,18,18
Åphrødite,bonechewer,961,priest,discipline,22,12,10
Åz,quelthalas,961,priest,discipline,24,12,12
Cezanne,tichondrius,961,priest,discipline,125,52,73
Mxchsm,stormrage,960,priest,discipline,12,10,2
Charón,tichondrius,960,priest,discipline,12,10,2
Tapel,khazgoroth,960,priest,discipline,48,27,21
Renghost,illidan,960,priest,discipline,18,10,8
Ishyeboi,stormrage,960,priest,discipline,18,10,8
Priesticules,illidan,960,priest,discipline,18,10,8
Bswagxx,illidan,960,priest,discipline,18,10,8
Tickleme,zuljin,960,priest,discipline,18,10,8
Pissgóblin,stormrage,960,priest,discipline,18,10,8
Belielosong,moon-guard,960,priest,discipline,57,29,28
Fyne,kelthuzad,960,priest,discipline,21,10,11
Notlowboy,area-52,960,priest,discipline,24,10,14
Ajxoz,thrall,960,priest,discipline,24,10,14
Nobodystarx,steamwheedle-cartel,960,priest,discipline,24,10,14
Lilpurp,sargeras,960,priest,discipline,28,10,18
Futuuncle,tichondrius,960,priest,discipline,30,10,20
Luzhú,illidan,960,priest,discipline,30,10,20
Henchwoman,stormrage,959,priest,discipline,12,10,2
Strawberryzz,area-52,959,priest,discipline,12,10,2
Trailmixx,bleeding-hollow,959,priest,discipline,12,10,2
Kk,fizzcrank,959,priest,discipline,12,10,2
Elimix,frostmourne,959,priest,discipline,12,10,2
Jinforever,tichondrius,959,priest,discipline,12,10,2
Oduum,tichondrius,959,priest,discipline,18,10,8
Dudurr,zuluhed,959,priest,discipline,18,10,8
Minnowhead,kelthuzad,959,priest,discipline,18,10,8
Filthmaster,moon-guard,959,priest,discipline,18,10,8
Olibreaker,tichondrius,959,priest,discipline,18,10,8
Dubai,tichondrius,959,priest,discipline,18,10,8
Bicardii,area-52,959,priest,discipline,18,10,8
Slenden,illidan,959,priest,discipline,18,10,8
Elphié,sargeras,959,priest,discipline,18,10,8
Hundski,darkspear,959,priest,discipline,18,10,8
Cigma,magtheridon,959,priest,discipline,18,10,8
Floppeh,khazgoroth,959,priest,discipline,18,10,8
Tamzy,eredar,959,priest,discipline,18,10,8
Groove,kelthuzad,959,priest,discipline,18,10,8
Recoverys,illidan,959,priest,discipline,18,10,8
Budlyy,dalaran,959,priest,discipline,18,10,8
Kelaara,gnomeregan,959,priest,discipline,19,10,9
Stylébender,tichondrius,959,priest,discipline,24,10,14
Tamtwo,the-forgotten-coast,959,priest,discipline,24,10,14
Lindsanp,illidan,959,priest,discipline,24,10,14
Calahra,malganis,959,priest,discipline,24,10,14
Pontiffvelen,area-52,959,priest,discipline,24,10,14
Abbyy,barthilas,959,priest,discipline,24,10,14
Rum,kirin-tor,959,priest,discipline,24,10,14
Mosquito,tichondrius,959,priest,discipline,24,10,14
Döyöuliftbro,tichondrius,959,priest,discipline,24,10,14
Johadorr,shadowsong,959,priest,discipline,24,10,14
Tshik,ragnaros,959,priest,discipline,24,10,14
Livin,kelthuzad,959,priest,discipline,30,10,20
Azide,mannoroth,958,priest,discipline,12,10,2
Janna,jubeithos,958,priest,discipline,18,10,8
Chknhealer,darkspear,958,priest,discipline,18,10,8
Phrìke,illidan,958,priest,discipline,18,10,8
Amonerpriest,tichondrius,958,priest,discipline,18,10,8
Tîg,nemesis,958,priest,discipline,21,10,11
Câstiêl,malganis,958,priest,discipline,24,10,14
Itha,illidan,958,priest,discipline,24,10,14
Ritzien,jubeithos,958,priest,discipline,24,10,14
Taedrid,stormrage,958,priest,discipline,89,35,54
Gonchar,bleeding-hollow,958,priest,discipline,30,10,20
Powerranger,senjin,957,priest,discipline,18,10,8
Bigchalupaz,sargeras,957,priest,discipline,18,10,8
Bubblebeasst,area-52,957,priest,discipline,18,10,8
Wilburre,sargeras,957,priest,discipline,18,10,8
Rescueherø,tichondrius,957,priest,discipline,38,20,18
Jazmiine,ragnaros,957,priest,discipline,24,10,14
Kinhilo,ragnaros,957,priest,discipline,24,10,14
Rellington,frostwolf,957,priest,discipline,24,10,14
Moc,jubeithos,957,priest,discipline,36,10,26
Xøspëélls,ragnaros,956,priest,discipline,12,10,2
Chanyt,azralon,956,priest,discipline,12,10,2
Prilance,hyjal,956,priest,discipline,24,10,14
Mottomami,nemesis,956,priest,discipline,24,10,14
Mevix,firetree,956,priest,discipline,24,10,14
Kissmyvoìd,frostmourne,956,priest,discipline,24,10,14
Smallbrains,emerald-dream,956,priest,discipline,30,10,20
Noopnoop,burning-blade,955,priest,discipline,18,10,8
Dorlala,tichondrius,955,priest,discipline,18,10,8
Synthas,tichondrius,955,priest,discipline,18,10,8
Çõrlëøñè,illidan,955,priest,discipline,24,10,14
Bachaterah,skullcrusher,955,priest,discipline,24,10,14
Glassbones,kelthuzad,955,priest,discipline,30,10,20
Felmnir,ragnaros,955,priest,discipline,30,10,20
Fidalus,stormrage,955,priest,discipline,38,10,28
Hanklin,lightnings-blade,954,priest,discipline,18,10,8
Ihelp,altar-of-storms,954,priest,discipline,18,10,8
Liloffended,sargeras,954,priest,discipline,18,10,8
Febronia,aerie-peak,954,priest,discipline,18,10,8
Hateznamez,bladefist,954,priest,discipline,18,10,8
Xyberius,barthilas,954,priest,discipline,24,10,14
Judgejudyx,tichondrius,954,priest,discipline,24,10,14
Acésnóf,stormrage,954,priest,discipline,24,10,14
Discjuice,tichondrius,954,priest,discipline,36,10,26
Kajagoogoö,emerald-dream,953,priest,discipline,18,10,8
Kirigäya,quelthalas,953,priest,discipline,18,10,8
Lusch,stormscale,953,priest,discipline,70,37,33
Ôvr,area-52,953,priest,discipline,26,11,15
Flagged,azgalor,953,priest,discipline,24,10,14
Xenonfaith,bleeding-hollow,952,priest,discipline,17,12,5
Anonymoûs,silver-hand,952,priest,discipline,24,14,10
Jessicä,malganis,952,priest,discipline,18,10,8
Actiop,stormrage,952,priest,discipline,18,10,8
Stennic,emerald-dream,952,priest,discipline,18,10,8
Vazara,tichondrius,952,priest,discipline,18,10,8
Unholyio,barthilas,952,priest,discipline,18,10,8
Worthy,runetotem,952,priest,discipline,18,10,8
Xiöm,quelthalas,952,priest,discipline,24,10,14
Daijoubu,lightnings-blade,951,priest,discipline,24,10,14
Possumvendor,dalaran,951,priest,discipline,30,10,20
Ppinmuhbutt,tichondrius,951,priest,discipline,36,10,26
Discbubbles,moonrunner,950,priest,discipline,18,10,8
Artmend,malganis,950,priest,discipline,24,10,14
Zeas,moon-guard,950,priest,discipline,66,23,43
Threlad,elune,949,priest,discipline,18,10,8
Zhadowbolts,thrall,949,priest,discipline,18,10,8
Dreamskull,aegwynn,949,priest,discipline,26,11,15
Dwennalous,stormrage,949,priest,discipline,24,10,14
Novoc,blackhand,949,priest,discipline,54,22,32
Hypnogypsy,malganis,948,priest,discipline,18,10,8
Lasslìn,bonechewer,948,priest,discipline,18,10,8
Filterz,korgath,948,priest,discipline,24,10,14
Prófessór,tichondrius,948,priest,discipline,24,10,14
Samsunglions,tichondrius,947,priest,discipline,18,10,8
Braxxten,tichondrius,944,priest,discipline,50,21,29
Tjxx,zuljin,944,priest,discipline,30,10,20
Nikkazul,drakkari,943,priest,discipline,30,14,16
Emmarîl,sargeras,943,priest,discipline,29,10,19
Butdidüdie,tichondrius,943,priest,discipline,30,10,20
Praiz,tichondrius,942,priest,discipline,24,15,9
Kaladaz,destromath,941,priest,discipline,18,10,8
Prlest,proudmoore,941,priest,discipline,60,26,34
Lookfig,frostmourne,941,priest,discipline,24,10,14
Discyple,ysera,941,priest,discipline,24,10,14
Icemeilarda,illidan,940,priest,discipline,81,32,49
Sinnz,emerald-dream,939,priest,discipline,30,11,19
Sisterdeáth,area-52,938,priest,discipline,24,11,13
Neehow,hyjal,936,priest,discipline,12,10,2
Boosserbro,dawnbringer,936,priest,discipline,42,21,21
Macoa,zuljin,936,priest,discipline,66,29,37
Ophiuchus,jubeithos,936,priest,discipline,32,12,20
Holywarrior,smolderthorn,935,priest,discipline,24,10,14
Miel,kargath,935,priest,discipline,60,22,38
Mcmorphy,stormrage,931,priest,discipline,53,23,30
Alexz,area-52,927,priest,discipline,14,11,3
Biggunsaint,icecrown,927,priest,discipline,20,11,9
Toastedheal,stormreaver,927,priest,discipline,20,11,9
Sublety,aerie-peak,927,priest,discipline,66,28,38
Avipriest,area-52,927,priest,discipline,29,10,19
Heladio,ragnaros,926,priest,discipline,20,11,9
Fenders,stormrage,926,priest,discipline,23,10,13
Gankchange,tichondrius,926,priest,discipline,26,11,15
Touchmylight,suramar,925,priest,discipline,53,27,26
Voidwulf,azgalor,924,priest,discipline,107,52,55
Kaladîn,dark-iron,921,priest,discipline,20,11,9
Shemhazai,ragnaros,921,priest,discipline,20,11,9
Rymzxx,ragnaros,918,priest,discipline,19,11,8
Thekingheals,draenor,918,priest,discipline,28,14,14
Jeanmarc,aerie-peak,918,priest,discipline,78,32,46
Xiaz,lightbringer,912,priest,discipline,18,12,6
Twistedead,illidan,911,priest,discipline,21,11,10
Katalla,spirestone,911,priest,discipline,27,10,17
Mègadèath,area-52,911,priest,discipline,35,10,25
Priestrix,frostmourne,910,priest,discipline,55,22,33
Kencys,tichondrius,906,priest,discipline,22,11,11
Shadowdeathx,bleeding-hollow,906,priest,discipline,23,10,13
Brock,lightbringer,905,priest,discipline,27,11,16
Ðanté,the-venture-co,904,priest,discipline,22,13,9
Corrûpt,stormrage,904,priest,discipline,20,11,9
Ohashi,ragnaros,902,priest,discipline,18,11,7
Unholydomina,zuljin,901,priest,discipline,78,36,42
Mvqjlm,tichondrius,895,priest,discipline,14,10,4
Plaedito,stormscale,895,priest,discipline,23,10,13
Bellack,emerald-dream,895,priest,discipline,73,31,42
Càipirinha,tichondrius,895,priest,discipline,28,10,18
Fujinpriest,azralon,894,priest,discipline,28,10,18
Shayylii,stormrage,894,priest,discipline,32,10,22
Aladdinlol,tichondrius,894,priest,discipline,34,10,24
Chapitä,drakkari,893,priest,discipline,16,10,6
Malhotra,amanthul,892,priest,discipline,21,12,9
Kaizzen,gorgonnash,891,priest,discipline,17,10,7
Tezcatyo,area-52,891,priest,discipline,17,10,7
Archcerion,stormreaver,891,priest,discipline,28,11,17
Frojasensei,tichondrius,879,priest,discipline,17,10,7
Partypack,stormrage,878,priest,discipline,19,11,8
Mixxd,shuhalo,877,priest,discipline,30,13,17
Terric,shattered-hand,867,priest,discipline,24,10,14
Dirtydickdan,sargeras,864,priest,discipline,12,9,3
Squiddyjr,tichondrius,864,priest,discipline,12,9,3
Photic,malganis,864,priest,discipline,12,9,3
Gillette,thunderlord,864,priest,discipline,12,9,3
Dinar,tichondrius,864,priest,discipline,12,9,3
Elise,ravenholdt,864,priest,discipline,12,9,3
Trinaty,senjin,864,priest,discipline,12,9,3
Marcalus,garrosh,864,priest,discipline,15,9,6
Omgnerfz,zuljin,864,priest,discipline,18,9,9
Drbønghitmd,tichondrius,864,priest,discipline,18,9,9
Shadooe,tichondrius,864,priest,discipline,18,9,9
Phurbosjr,sargeras,864,priest,discipline,18,9,9
Shoepooper,kelthuzad,864,priest,discipline,18,9,9
Challengerz,suramar,864,priest,discipline,18,9,9
Illstyles,tichondrius,864,priest,discipline,18,9,9
Norikoo,malganis,864,priest,discipline,18,9,9
Nißirøux,sargeras,864,priest,discipline,18,9,9
Wv,kelthuzad,864,priest,discipline,18,9,9
Dimanche,thunderlord,864,priest,discipline,18,9,9
Arcmage,malganis,864,priest,discipline,18,9,9
Rima,stormscale,864,priest,discipline,18,9,9
Stubby,shadowsong,864,priest,discipline,18,9,9
Ilovedailies,frostmourne,864,priest,discipline,18,9,9
Toteme,proudmoore,864,priest,discipline,18,9,9
Healthyadult,zuluhed,864,priest,discipline,18,9,9
Cinnalite,darkspear,864,priest,discipline,18,9,9
Seyvyur,black-dragonflight,864,priest,discipline,18,9,9
Makdaddy,skullcrusher,864,priest,discipline,18,9,9
Irar,tichondrius,864,priest,discipline,18,9,9
Træway,tichondrius,864,priest,discipline,18,9,9
Æßøäîètîÿ,sargeras,864,priest,discipline,18,9,9
Celerisp,malganis,864,priest,discipline,18,9,9
Abraz,kiljaeden,864,priest,discipline,18,9,9
Trezz,aegwynn,864,priest,discipline,18,9,9
Easywins,sargeras,864,priest,discipline,24,9,15
Kfcchicken,proudmoore,864,priest,discipline,24,9,15
Ninbará,stormrage,864,priest,discipline,24,9,15
Physics,frostmane,864,priest,discipline,24,9,15
Lostmind,malganis,864,priest,discipline,24,9,15
Dakp,sargeras,864,priest,discipline,24,9,15
Samsypriest,frostmourne,863,priest,discipline,12,9,3
Maplesyrupz,moonrunner,863,priest,discipline,12,9,3
Softqt,tichondrius,863,priest,discipline,12,9,3
Stroserous,hyjal,863,priest,discipline,12,9,3
Thirddps,illidan,863,priest,discipline,12,9,3
Djxkidrock,moon-guard,863,priest,discipline,12,9,3
Chillaxin,dreadmaul,863,priest,discipline,12,9,3
Helleamh,tichondrius,863,priest,discipline,12,9,3
Nightz,illidan,863,priest,discipline,12,9,3
Maleklek,azralon,863,priest,discipline,12,9,3
Dkarla,lightnings-blade,863,priest,discipline,16,10,6
Pillböx,tichondrius,863,priest,discipline,18,9,9
Sentenel,duskwood,863,priest,discipline,18,9,9
Fila,azralon,863,priest,discipline,18,9,9
Oprst,tichondrius,863,priest,discipline,18,9,9
Darkrecovery,sargeras,863,priest,discipline,18,9,9
Eyepod,bleeding-hollow,863,priest,discipline,18,9,9
Deean,demon-soul,863,priest,discipline,18,9,9
Iamrisen,tichondrius,863,priest,discipline,18,9,9
Lemmiewinkzx,sargeras,863,priest,discipline,18,9,9
Healsforcash,bleeding-hollow,863,priest,discipline,21,9,12
Poonanixo,gundrak,863,priest,discipline,22,9,13
Uhatetoseeit,malganis,863,priest,discipline,24,9,15
Mudbuttman,kelthuzad,863,priest,discipline,24,9,15
Kamasutra,drakthul,863,priest,discipline,24,9,15
Løøtgoblin,skullcrusher,863,priest,discipline,24,9,15
Kyüra,sargeras,863,priest,discipline,30,9,21
Bugshott,tichondrius,863,priest,discipline,31,9,22
Mothra,ragnaros,862,priest,discipline,12,9,3
Tinyjunk,stormrage,862,priest,discipline,12,9,3
Felina,maiev,862,priest,discipline,12,9,3
Lacerating,illidan,862,priest,discipline,18,9,9
Ocxpriest,azralon,862,priest,discipline,18,9,9
Pandia,quelthalas,862,priest,discipline,18,9,9
Zælya,stormrage,862,priest,discipline,18,9,9
Ppomx,tichondrius,862,priest,discipline,18,9,9
Satanshealer,terokkar,862,priest,discipline,18,9,9
Neuroflex,proudmoore,862,priest,discipline,18,9,9
Redclover,tichondrius,862,priest,discipline,18,9,9
Jasolini,area-52,862,priest,discipline,18,9,9
Aheneas,quelthalas,862,priest,discipline,18,9,9
Runnow,area-52,862,priest,discipline,18,9,9
Drerrdaytv,kelthuzad,862,priest,discipline,18,9,9
Releknosleep,frostwolf,862,priest,discipline,19,9,10
Monvireaux,area-52,862,priest,discipline,24,9,15
Fäÿë,tichondrius,862,priest,discipline,24,9,15
Giannis,garrosh,862,priest,discipline,24,9,15
Çøçø,tichondrius,861,priest,discipline,12,9,3
Zil,spinebreaker,861,priest,discipline,12,9,3
Cremexo,tichondrius,861,priest,discipline,16,9,7
Sorros,cenarion-circle,861,priest,discipline,18,10,8
Adrameléch,area-52,861,priest,discipline,18,9,9
Synapse,moon-guard,861,priest,discipline,18,9,9
Kaldric,korgath,861,priest,discipline,18,9,9
Discountay,burning-legion,861,priest,discipline,18,9,9
Seader,alterac-mountains,861,priest,discipline,24,9,15
Jeraphìm,tichondrius,860,priest,discipline,18,9,9
Drzz,tichondrius,860,priest,discipline,18,9,9
Griggleslol,tichondrius,859,priest,discipline,12,9,3
Demonwizard,sargeras,859,priest,discipline,18,9,9
Pizdük,stormrage,859,priest,discipline,18,9,9
Selson,stormrage,859,priest,discipline,30,9,21
Notahero,tichondrius,858,priest,discipline,12,9,3
Jacktractive,area-52,858,priest,discipline,15,10,5
Preachermang,laughing-skull,858,priest,discipline,18,9,9
Asatruu,stormrage,858,priest,discipline,24,9,15
Divinity,hellscream,858,priest,discipline,24,9,15
Ricflayer,lothar,858,priest,discipline,24,9,15
Roßyn,quelthalas,857,priest,discipline,18,9,9
Rugaru,emerald-dream,857,priest,discipline,21,10,11
Touchedbygud,frostmourne,857,priest,discipline,26,11,15
Jhonka,nerzhul,856,priest,discipline,12,9,3
Rohee,illidan,856,priest,discipline,18,9,9
Damushi,frostmourne,856,priest,discipline,18,9,9
Sipmemaster,tichondrius,856,priest,discipline,24,9,15
Caiitlynn,quelthalas,856,priest,discipline,24,9,15
Susannahh,goldrinn,854,priest,discipline,18,9,9
Igotdots,scilla,854,priest,discipline,42,18,24
Sunayriah,illidan,853,priest,discipline,12,9,3
Mangoes,scilla,853,priest,discipline,20,9,11
Alterboy,garrosh,852,priest,discipline,36,14,22
Zathanel,ragnaros,852,priest,discipline,24,9,15
Uckuck,illidan,851,priest,discipline,18,9,9
Whitegirlirl,blackrock,850,priest,discipline,12,9,3
Jikoguu,stormscale,850,priest,discipline,30,9,21
Serana,maelstrom,848,priest,discipline,147,72,75
Snevini,azralon,848,priest,discipline,30,11,19
Nubzin,tichondrius,846,priest,discipline,18,9,9
Brahskeet,illidan,841,priest,discipline,30,9,21
Darkblesxd,quelthalas,837,priest,discipline,12,9,3
Thelonioüs,tichondrius,832,priest,discipline,55,20,35
Rockrock,zuljin,831,priest,discipline,14,11,3
Creepa,kul-tiras,831,priest,discipline,16,9,7
Healloween,stormrage,829,priest,discipline,21,11,10
Supersede,sargeras,828,priest,discipline,173,80,93
Delithara,tichondrius,826,priest,discipline,18,9,9
Holyshield,jubeithos,825,priest,discipline,19,10,9
Mydranol,tichondrius,824,priest,discipline,29,9,20
Khinthazin,barthilas,815,priest,discipline,48,20,28
Såx,stormreaver,814,priest,discipline,21,9,12
Arizztocrat,tichondrius,814,priest,discipline,23,9,14
Ipód,tichondrius,813,priest,discipline,15,10,5
Mikebroowwnn,firetree,813,priest,discipline,22,11,11
Perzeval,azshara,813,priest,discipline,23,9,14
Breathkeeper,proudmoore,810,priest,discipline,27,10,17
Ryukim,tichondrius,809,priest,discipline,26,12,14
Enrika,stormrage,806,priest,discipline,29,13,16
Wellheeled,norgannon,806,priest,discipline,21,9,12
Wingchick,azshara,805,priest,discipline,66,24,42
Acenthe,sargeras,800,priest,discipline,16,9,7
Darkmolt,vashj,795,priest,discipline,20,9,11
Winston,tichondrius,784,priest,discipline,19,9,10
Jessikal,quelthalas,784,priest,discipline,19,9,10
Fátima,tichondrius,783,priest,discipline,11,9,2
Tidepodzxo,moon-guard,783,priest,discipline,11,9,2
Butdidudied,sargeras,783,priest,discipline,17,9,8
Bambi,dunemaul,768,priest,discipline,12,8,4
Xactly,sargeras,768,priest,discipline,12,8,4
Discipline,the-scryers,768,priest,discipline,12,8,4
Sip,sargeras,768,priest,discipline,12,8,4
Ñightelf,area-52,768,priest,discipline,12,8,4
Fzz,queldorei,768,priest,discipline,12,8,4
Qohoo,tichondrius,768,priest,discipline,12,8,4
Abbyc,frostmourne,768,priest,discipline,12,8,4
Bubbletrubbl,blackrock,768,priest,discipline,12,8,4
Zenelu,tichondrius,768,priest,discipline,12,8,4
Goofs,moon-guard,768,priest,discipline,12,8,4
Bananass,sargeras,768,priest,discipline,12,8,4
Nydrosia,frostmourne,768,priest,discipline,12,8,4
Sweethole,illidan,768,priest,discipline,12,8,4
Skerrz,illidan,768,priest,discipline,12,8,4
Criiltwo,area-52,768,priest,discipline,12,8,4
Sallydaddy,wyrmrest-accord,768,priest,discipline,12,8,4
Slpox,sargeras,768,priest,discipline,12,8,4
Nausitoo,ragnaros,768,priest,discipline,12,8,4
Plosux,tichondrius,768,priest,discipline,12,8,4
Evèlyn,dathremar,768,priest,discipline,12,8,4
Spitonmejuli,illidan,768,priest,discipline,12,8,4
Pws,azralon,768,priest,discipline,12,8,4
Heeka,kelthuzad,768,priest,discipline,12,8,4
Notsquishy,tichondrius,768,priest,discipline,12,8,4
Dabû,tichondrius,768,priest,discipline,12,8,4
Voltekkeh,tichondrius,768,priest,discipline,12,8,4
Yansuanmu,tichondrius,768,priest,discipline,12,8,4
Soloqqt,tichondrius,768,priest,discipline,12,8,4
Xzliak,area-52,768,priest,discipline,12,8,4
Sìkarìa,illidan,768,priest,discipline,12,8,4
Twwety,thrall,768,priest,discipline,12,8,4
Myòvó,tichondrius,768,priest,discipline,12,8,4
Zeepew,tichondrius,768,priest,discipline,12,8,4
Angeldúst,the-forgotten-coast,768,priest,discipline,12,8,4
Spriestbro,emerald-dream,768,priest,discipline,12,8,4
Melielectra,tichondrius,768,priest,discipline,18,8,10
Yosps,tichondrius,768,priest,discipline,18,8,10
Cowboydanpri,malganis,768,priest,discipline,18,8,10
Alcoric,illidan,768,priest,discipline,18,8,10
Sussywussy,stormrage,768,priest,discipline,18,8,10
Dehf,bleeding-hollow,768,priest,discipline,18,8,10
Jpgpng,tichondrius,768,priest,discipline,18,8,10
Sotore,bleeding-hollow,768,priest,discipline,18,8,10
Owlchubz,mannoroth,768,priest,discipline,18,8,10
Punchyxz,illidan,768,priest,discipline,18,8,10
Ifortalot,lothar,768,priest,discipline,18,8,10
Immörtality,stormrage,768,priest,discipline,18,8,10
Xtradotz,tichondrius,768,priest,discipline,18,8,10
Mellisonant,stormrage,768,priest,discipline,18,8,10
Jubinátor,tichondrius,768,priest,discipline,18,8,10
Robinophelia,sargeras,768,priest,discipline,18,8,10
Esseks,tichondrius,768,priest,discipline,18,8,10
Shadowkenlol,tichondrius,768,priest,discipline,18,8,10
Manbelow,bleeding-hollow,768,priest,discipline,27,9,18
Minyeong,tichondrius,768,priest,discipline,24,8,16
Nuditwo,malganis,768,priest,discipline,24,8,16
Ayani,khadgar,768,priest,discipline,24,8,16
Jinzp,area-52,768,priest,discipline,24,8,16
Hugeshield,stormrage,768,priest,discipline,24,8,16
Synnlawl,bleeding-hollow,768,priest,discipline,24,8,16
Voidrisu,sargeras,768,priest,discipline,24,8,16
Mavalie,zuljin,768,priest,discipline,24,8,16
Dylan,shuhalo,768,priest,discipline,24,8,16
Fréákk,ragnaros,768,priest,discipline,24,8,16
Iulu,doomhammer,767,priest,discipline,12,8,4
Mariels,quelthalas,767,priest,discipline,12,8,4
Maga,laughing-skull,767,priest,discipline,12,8,4
Piusxll,tichondrius,767,priest,discipline,12,8,4
Ahnightmares,tichondrius,767,priest,discipline,12,8,4
Pandaboots,illidan,767,priest,discipline,12,8,4
Alarisa,chogall,767,priest,discipline,12,8,4
Tubshark,moon-guard,767,priest,discipline,12,8,4
Hölymöly,moon-guard,767,priest,discipline,12,8,4
Miketython,chogall,767,priest,discipline,12,8,4
Urgetopurge,dunemaul,767,priest,discipline,12,8,4
Lelyna,stormrage,767,priest,discipline,12,8,4
Geniusidiot,area-52,767,priest,discipline,12,8,4
Shinemyhead,stormrage,767,priest,discipline,12,8,4
Elkies,area-52,767,priest,discipline,12,8,4
Clerkpriest,dragonmaw,767,priest,discipline,12,8,4
Gawlas,azshara,767,priest,discipline,12,8,4
Cassiuss,kelthuzad,767,priest,discipline,12,8,4
Rainny,proudmoore,767,priest,discipline,12,8,4
Lucènt,frostmourne,767,priest,discipline,12,8,4
Vyndïllïn,tichondrius,767,priest,discipline,12,8,4
Ryuuka,sargeras,767,priest,discipline,12,8,4
Kynsias,stormrage,767,priest,discipline,15,8,7
Datspice,stormrage,767,priest,discipline,18,8,10
Grotti,ragnaros,767,priest,discipline,18,8,10
Jùdas,ravencrest,767,priest,discipline,18,8,10
Phobe,windrunner,767,priest,discipline,18,8,10
Remuni,tichondrius,767,priest,discipline,18,8,10
Triazolam,illidan,767,priest,discipline,18,8,10
Analiesa,moon-guard,767,priest,discipline,18,8,10
Pehkthree,hyjal,767,priest,discipline,18,8,10
Hesus,deathwing,767,priest,discipline,18,8,10
Holyslap,nerzhul,767,priest,discipline,18,8,10
Doublesix,malganis,767,priest,discipline,18,8,10
Dawnside,wyrmrest-accord,767,priest,discipline,24,8,16
Providennce,tichondrius,767,priest,discipline,24,8,16
Weston,bleeding-hollow,767,priest,discipline,24,8,16
Fatherdan,blackrock,767,priest,discipline,24,8,16
Hl,dalaran,767,priest,discipline,24,8,16
Falro,tichondrius,767,priest,discipline,24,8,16
Showakoi,ragnaros,767,priest,discipline,28,9,19
Shirley,skywall,767,priest,discipline,30,8,22
Imb,nagrand,766,priest,discipline,12,8,4
Fakér,illidan,766,priest,discipline,12,8,4
Dorós,coilfang,766,priest,discipline,12,8,4
Juniorfloyd,tichondrius,766,priest,discipline,12,8,4
Ariel,veknilash,766,priest,discipline,12,8,4
Grizzblessed,sargeras,766,priest,discipline,12,8,4
Mineral,sargeras,766,priest,discipline,12,8,4
Spitefuldirk,dalaran,766,priest,discipline,12,8,4
Jerserra,emerald-dream,766,priest,discipline,12,8,4
Xhaajyh,area-52,766,priest,discipline,12,8,4
Kynnen,mannoroth,766,priest,discipline,12,8,4
Eiderwood,moon-guard,766,priest,discipline,12,8,4
Abzorbed,stormrage,766,priest,discipline,12,8,4
Shockalishus,stormrage,766,priest,discipline,12,8,4
Purus,tichondrius,766,priest,discipline,18,8,10
Shaerel,dalaran,766,priest,discipline,18,8,10
Mondrielris,tichondrius,766,priest,discipline,18,8,10
Nogetget,frostmourne,766,priest,discipline,18,8,10
Gõd,zuluhed,766,priest,discipline,18,8,10
Yarock,kelthuzad,766,priest,discipline,18,8,10
Via,chogall,766,priest,discipline,18,8,10
Invisapowa,hyjal,766,priest,discipline,18,8,10
Spriest,kul-tiras,766,priest,discipline,18,8,10
Saphet,draktharon,766,priest,discipline,18,8,10
Bübbler,tichondrius,765,priest,discipline,12,8,4
Tsunadae,hakkar,765,priest,discipline,12,8,4
Pollyphia,kiljaeden,765,priest,discipline,12,8,4
Rahmynpriest,tichondrius,765,priest,discipline,12,8,4
Bandaidvibes,tichondrius,765,priest,discipline,12,8,4
Aybaby,kiljaeden,765,priest,discipline,18,8,10
Sahray,quelthalas,765,priest,discipline,18,8,10
Nursébeardy,whisperwind,765,priest,discipline,18,8,10
Frekigeri,dalaran,765,priest,discipline,18,8,10
Dirtyprïest,bonechewer,765,priest,discipline,18,8,10
Shalther,thrall,765,priest,discipline,18,8,10
Elrywn,stormrage,765,priest,discipline,24,8,16
Xiphz,stormrage,765,priest,discipline,24,8,16
Brosbeforeho,tichondrius,765,priest,discipline,24,8,16
Velinthra,proudmoore,764,priest,discipline,12,8,4
Kathlick,thrall,764,priest,discipline,12,8,4
Glepstein,emerald-dream,764,priest,discipline,18,8,10
Chandrella,zuljin,764,priest,discipline,18,8,10
Lobstersock,malganis,764,priest,discipline,18,8,10
Healrat,thrall,764,priest,discipline,18,8,10
Gudnewsevone,illidan,764,priest,discipline,18,8,10
Iciana,proudmoore,764,priest,discipline,18,8,10
Alinastarkov,area-52,764,priest,discipline,20,8,12
Itchybubble,emerald-dream,763,priest,discipline,12,8,4
Glownoodle,stormrage,763,priest,discipline,12,8,4
Deadheadfred,bonechewer,763,priest,discipline,18,8,10
Rókue,silvermoon,763,priest,discipline,18,8,10
Casstiell,proudmoore,763,priest,discipline,18,8,10
Ashlìe,moon-guard,763,priest,discipline,18,8,10
Nsquared,illidan,763,priest,discipline,24,8,16
Squatrack,tichondrius,763,priest,discipline,24,8,16
Stumbelz,stormrage,762,priest,discipline,12,8,4
Nuell,malganis,762,priest,discipline,12,8,4
Yurick,garrosh,762,priest,discipline,12,8,4
Badazzfrank,tichondrius,762,priest,discipline,18,8,10
Manaburnout,blackhand,762,priest,discipline,30,8,22
Criticaal,aegwynn,761,priest,discipline,18,8,10
Oniyuri,dark-iron,760,priest,discipline,12,8,4
Fluxus,sargeras,760,priest,discipline,12,8,4
Cheuksin,korgath,759,priest,discipline,12,8,4
Lifesavér,tichondrius,759,priest,discipline,12,8,4
Tâmpîcö,ragnaros,759,priest,discipline,18,8,10
Kasamm,nazjatar,756,priest,discipline,18,8,10
Flannigan,veknilash,753,priest,discipline,12,8,4
Alleviate,frostmourne,751,priest,discipline,17,8,9
Chadeux,bleeding-hollow,751,priest,discipline,18,8,10
Whitepi,tichondrius,751,priest,discipline,21,9,12
Peacebewithu,echo-isles,749,priest,discipline,12,8,4
Worldhealer,area-52,749,priest,discipline,18,8,10
Knez,ragnaros,745,priest,discipline,21,11,10
Phathighs,nagrand,739,priest,discipline,18,8,10
Pokebox,frostmourne,735,priest,discipline,16,8,8
Álûcard,illidan,734,priest,discipline,13,9,4
Krewed,ravencrest,734,priest,discipline,14,9,5
Unholyshield,frostmourne,734,priest,discipline,17,8,9
Itssehctap,chogall,732,priest,discipline,14,9,5
Aloragon,tichondrius,732,priest,discipline,17,8,9
Priestmain,thrall,731,priest,discipline,17,8,9
Sacredream,illidan,730,priest,discipline,17,8,9
Notarealdoc,uldaman,726,priest,discipline,20,9,11
Kloevu,stormrage,725,priest,discipline,17,8,9
Itxo,quelthalas,723,priest,discipline,16,9,7
Invoice,bloodscalp,719,priest,discipline,17,8,9
Pðpë,area-52,718,priest,discipline,11,8,3
Clarity,arthas,718,priest,discipline,15,9,6
Asfw,chogall,717,priest,discipline,18,10,8
Nikniknak,bleeding-hollow,715,priest,discipline,15,9,6
Nås,elune,711,priest,discipline,22,10,12
Sadier,moon-guard,708,priest,discipline,26,9,17
Trashdiscx,stormrage,707,priest,discipline,25,11,14
Cylocibin,kiljaeden,705,priest,discipline,23,10,13
Sölei,tichondrius,704,priest,discipline,22,8,14
Noneedruid,ragnaros,703,priest,discipline,11,8,3
Aenbubble,tichondrius,703,priest,discipline,14,8,6
Melancholies,moon-guard,703,priest,discipline,20,8,12
Styléßéndérx,illidan,687,priest,discipline,11,8,3
Zylemm,malganis,687,priest,discipline,17,8,9
Väin,proudmoore,685,priest,discipline,27,10,17
Läsombra,area-52,684,priest,discipline,17,9,8
Absorbn,barthilas,672,priest,discipline,12,7,5
Josephlin,quelthalas,672,priest,discipline,12,7,5
Fronkeytko,tichondrius,672,priest,discipline,12,7,5
Onipapae,frostmourne,672,priest,discipline,12,7,5
Basedgód,arathor,672,priest,discipline,12,7,5
Gucciboon,frostmourne,672,priest,discipline,12,7,5
Holyhand,auchindoun,672,priest,discipline,12,7,5
Djwienerbum,darkspear,672,priest,discipline,12,7,5
Scandi,tichondrius,672,priest,discipline,12,7,5
Ìceheals,tichondrius,672,priest,discipline,12,7,5
Aeyde,proudmoore,672,priest,discipline,12,7,5
Artirie,darkspear,672,priest,discipline,12,7,5
Harrydisc,shattered-hand,672,priest,discipline,12,7,5
Ogdisc,gallywix,672,priest,discipline,12,7,5
Toyz,arthas,672,priest,discipline,12,7,5
Horízon,illidan,672,priest,discipline,12,7,5
Jnglpriestx,thrall,672,priest,discipline,12,7,5
Xellda,azjolnerub,672,priest,discipline,12,7,5
Ikkemen,tichondrius,672,priest,discipline,12,7,5
Thewaker,tichondrius,672,priest,discipline,12,7,5
Ahnit,azralon,672,priest,discipline,12,7,5
Marejayne,tichondrius,672,priest,discipline,12,7,5
Moondèx,maelstrom,672,priest,discipline,12,7,5
Kripple,tichondrius,672,priest,discipline,12,7,5
Nerfdisc,elune,672,priest,discipline,12,7,5
Squigic,turalyon,672,priest,discipline,12,7,5
Whataday,tichondrius,672,priest,discipline,12,7,5
Rickmason,frostmane,672,priest,discipline,12,7,5
Holyscuz,zuljin,672,priest,discipline,12,7,5
Yodud,tichondrius,672,priest,discipline,12,7,5
Penanced,tichondrius,672,priest,discipline,12,7,5
Amoureuxz,bleeding-hollow,672,priest,discipline,12,7,5
Xantard,malganis,672,priest,discipline,12,7,5
Hly,frostmourne,672,priest,discipline,12,7,5
Walpurgis,skywall,672,priest,discipline,12,7,5
Burgersl,illidan,672,priest,discipline,12,7,5
Gäüga,burning-legion,672,priest,discipline,12,7,5
Pavesarii,proudmoore,672,priest,discipline,12,7,5
Kiloe,tichondrius,672,priest,discipline,12,7,5
Powerwôrdhug,destromath,672,priest,discipline,12,7,5
Sideform,tichondrius,672,priest,discipline,12,7,5
Dráugr,ragnaros,672,priest,discipline,12,7,5
Tuladim,tichondrius,672,priest,discipline,12,7,5
Interacts,darkspear,672,priest,discipline,12,7,5
Shadion,sargeras,672,priest,discipline,12,7,5
Tòodles,stormrage,672,priest,discipline,12,7,5
Mixedprotein,tichondrius,672,priest,discipline,12,7,5
Gothii,tichondrius,672,priest,discipline,12,7,5
Sadsadge,sargeras,672,priest,discipline,12,7,5
Pandaniaco,drakkari,672,priest,discipline,12,7,5
Omsi,emerald-dream,672,priest,discipline,12,7,5
Dwarfxomp,ragnaros,672,priest,discipline,12,7,5
Greenteababy,tichondrius,672,priest,discipline,12,7,5
Holyshiiet,area-52,672,priest,discipline,12,7,5
Brehzy,zuljin,672,priest,discipline,12,7,5
Jenhawkinsx,frostmourne,672,priest,discipline,12,7,5
Eddic,wyrmrest-accord,672,priest,discipline,12,7,5
Pinkprincess,tichondrius,672,priest,discipline,12,7,5
Sabrino,azralon,672,priest,discipline,12,7,5
Sevros,moon-guard,672,priest,discipline,12,7,5
Eneldz,quelthalas,672,priest,discipline,12,7,5
Clevelandboy,blackrock,672,priest,discipline,12,7,5
Kymomeh,sargeras,672,priest,discipline,12,7,5
Ninielly,stormrage,672,priest,discipline,14,8,6
Photicz,thrall,672,priest,discipline,17,8,9
Getgudwtrada,frostmourne,672,priest,discipline,15,7,8
Rigotakx,illidan,672,priest,discipline,18,7,11
Upsahl,area-52,672,priest,discipline,18,7,11
Manbooty,illidan,672,priest,discipline,18,7,11
Iwillrezguys,tichondrius,672,priest,discipline,18,7,11
Mockr,kiljaeden,672,priest,discipline,18,7,11
Brotheraram,kelthuzad,672,priest,discipline,18,7,11
Hayna,emerald-dream,672,priest,discipline,18,7,11
Aryeinna,illidan,672,priest,discipline,18,7,11
Criminalsp,frostmourne,672,priest,discipline,18,7,11
Xayda,area-52,672,priest,discipline,18,7,11
Sagapriest,hyjal,672,priest,discipline,18,7,11
Tisifone,ragnaros,672,priest,discipline,18,7,11
Azari,illidan,672,priest,discipline,18,7,11
Joeybats,frostwolf,672,priest,discipline,18,7,11
Dingledot,sargeras,672,priest,discipline,18,7,11
Nayng,tichondrius,672,priest,discipline,18,7,11
Jugeum,proudmoore,672,priest,discipline,18,7,11
Jagsp,area-52,672,priest,discipline,18,7,11
Burblespue,burning-blade,672,priest,discipline,18,7,11
Lidole,barthilas,672,priest,discipline,18,7,11
Dxs,hydraxis,672,priest,discipline,18,7,11
Ayumihamaski,tichondrius,672,priest,discipline,18,7,11
Burkett,sargeras,672,priest,discipline,18,7,11
Xalty,emerald-dream,672,priest,discipline,21,8,13
Pïque,proudmoore,672,priest,discipline,24,7,17
Ezrah,kelthuzad,672,priest,discipline,24,7,17
Stríkes,emerald-dream,672,priest,discipline,24,7,17
Polyesterp,frostmourne,672,priest,discipline,24,7,17
Jbtytime,proudmoore,672,priest,discipline,24,7,17
Autogenic,malganis,672,priest,discipline,24,7,17
Teamz,illidan,672,priest,discipline,24,7,17
Mindfak,bleeding-hollow,672,priest,discipline,24,7,17
Diebetus,zuljin,672,priest,discipline,24,7,17
Babymieo,illidan,672,priest,discipline,24,7,17
Discpriestxo,malganis,672,priest,discipline,30,7,23
Thalladori,area-52,671,priest,discipline,16,10,6
Crossblèssèr,sargeras,671,priest,discipline,12,7,5
Danílo,quelthalas,671,priest,discipline,12,7,5
Mahelet,drakkari,671,priest,discipline,12,7,5
Esohpr,frostmourne,671,priest,discipline,12,7,5
Linlight,stormrage,671,priest,discipline,12,7,5
Thattpriest,thrall,671,priest,discipline,12,7,5
Jeremey,darkspear,671,priest,discipline,12,7,5
Popeofdope,queldorei,671,priest,discipline,12,7,5
Jasonlol,sargeras,671,priest,discipline,12,7,5
Saintsnap,bleeding-hollow,671,priest,discipline,12,7,5
Zarfs,burning-blade,671,priest,discipline,12,7,5
Bombinburbon,durotan,671,priest,discipline,12,7,5
Travakel,proudmoore,671,priest,discipline,12,7,5
Curra,frostmourne,671,priest,discipline,12,7,5
Trinidy,illidan,671,priest,discipline,12,7,5
Atheenia,icecrown,671,priest,discipline,12,7,5
Serafím,goldrinn,671,priest,discipline,12,7,5
Synesth,area-52,671,priest,discipline,12,7,5
Milkymommies,tichondrius,671,priest,discipline,12,7,5
Windwolf,dalvengyr,671,priest,discipline,12,7,5
Maenard,emerald-dream,671,priest,discipline,12,7,5
Lumyra,malganis,671,priest,discipline,12,7,5
Geyforpray,tichondrius,671,priest,discipline,12,7,5
Moonpeace,tichondrius,671,priest,discipline,12,7,5
Skgangmm,tichondrius,671,priest,discipline,12,7,5
Beocca,nerzhul,671,priest,discipline,12,7,5
Kenprizle,sargeras,671,priest,discipline,12,7,5
Fatherjerry,kiljaeden,671,priest,discipline,12,7,5
Altari,whisperwind,671,priest,discipline,12,7,5
Sophistdew,proudmoore,671,priest,discipline,12,7,5
Clerkbum,emerald-dream,671,priest,discipline,12,7,5
Lightschosen,malganis,671,priest,discipline,12,7,5
Fatherleem,tichondrius,671,priest,discipline,12,7,5
Hammersholy,stormrage,671,priest,discipline,12,7,5
Moirâ,silvermoon,671,priest,discipline,12,7,5
Lebanese,frostmourne,671,priest,discipline,12,7,5
Debigheal,stormrage,671,priest,discipline,12,7,5
Donkeycube,tichondrius,671,priest,discipline,12,7,5
Epik,moknathal,671,priest,discipline,15,8,7
Painkiller,lightbringer,671,priest,discipline,17,7,10
Pecadu,azralon,671,priest,discipline,18,7,11
Adofthealer,illidan,671,priest,discipline,18,7,11
Rillding,tichondrius,671,priest,discipline,18,7,11
Merxy,bleeding-hollow,671,priest,discipline,18,7,11
Noiri,aegwynn,671,priest,discipline,18,7,11
Randomheal,dunemaul,671,priest,discipline,18,7,11
Ganelm,vashj,671,priest,discipline,18,7,11
Revivemepls,tichondrius,671,priest,discipline,18,7,11
Slobmygnob,illidan,671,priest,discipline,18,7,11
Soùlsista,sargeras,671,priest,discipline,18,7,11
Vania,tortheldrin,671,priest,discipline,18,7,11
Xalatath,stormrage,671,priest,discipline,18,7,11
Xiaozhui,tichondrius,671,priest,discipline,24,7,17
Caeda,icecrown,671,priest,discipline,24,7,17
Floorpray,tichondrius,671,priest,discipline,24,7,17
Malansuo,wyrmrest-accord,671,priest,discipline,30,7,23
Dirtydogma,zuljin,671,priest,discipline,30,7,23
Mitras,moon-guard,670,priest,discipline,12,7,5
Scratchmyear,tichondrius,670,priest,discipline,12,7,5
Mortïmer,alleria,670,priest,discipline,12,7,5
Fatherhands,illidan,670,priest,discipline,12,7,5
Donus,frostmane,670,priest,discipline,12,7,5
Angelicduck,illidan,670,priest,discipline,12,7,5
Triplekil,tichondrius,670,priest,discipline,12,7,5
Kastwalker,earthen-ring,670,priest,discipline,12,7,5
Cromagnøn,dalaran,670,priest,discipline,12,7,5
Xð,jubeithos,670,priest,discipline,12,7,5
Dotsrboe,illidan,670,priest,discipline,12,7,5
Madskills,shadow-council,670,priest,discipline,12,7,5
Antìdote,tichondrius,670,priest,discipline,12,7,5
Fedge,kelthuzad,670,priest,discipline,12,7,5
Brokennurse,area-52,670,priest,discipline,13,7,6
Spiceenjoyer,emerald-dream,670,priest,discipline,15,8,7
Xeras,ravencrest,670,priest,discipline,18,7,11
Râku,area-52,670,priest,discipline,18,7,11
Arkathus,stormrage,670,priest,discipline,18,7,11
Zgzz,stormrage,670,priest,discipline,24,7,17
Kerfos,azralon,669,priest,discipline,10,8,2
Ðowörk,illidan,669,priest,discipline,12,7,5
Gabryanna,emerald-dream,669,priest,discipline,18,7,11
Dorst,bonechewer,669,priest,discipline,18,7,11
Waterßoÿ,emerald-dream,669,priest,discipline,21,8,13
Laj,proudmoore,669,priest,discipline,24,7,17
Tílanga,azralon,668,priest,discipline,12,7,5
Darthvalak,illidan,668,priest,discipline,12,7,5
Nielic,arygos,668,priest,discipline,12,7,5
Fallenängel,senjin,668,priest,discipline,12,7,5
Butterflyblu,ragnaros,668,priest,discipline,13,7,6
Albertth,ragnaros,668,priest,discipline,18,7,11
Typhon,blackhand,668,priest,discipline,18,7,11
Butterblessr,thunderlord,668,priest,discipline,19,7,12
Viehweg,azralon,667,priest,discipline,18,7,11
Nikasaur,azgalor,667,priest,discipline,18,7,11
Healzutwo,tichondrius,667,priest,discipline,18,7,11
Tassik,dalaran,667,priest,discipline,18,7,11
Glisserin,zuljin,666,priest,discipline,12,7,5
Sihua,illidan,666,priest,discipline,18,7,11
Tenet,stormscale,666,priest,discipline,18,7,11
Charlie,azshara,665,priest,discipline,12,7,5
Pharaoh,deathwing,665,priest,discipline,18,7,11
Grapedraankk,kelthuzad,664,priest,discipline,12,7,5
Crossblesser,alleria,663,priest,discipline,12,7,5
Laopao,proudmoore,663,priest,discipline,35,13,22
Sezyks,stormrage,655,priest,discipline,17,7,10
Rcx,sargeras,655,priest,discipline,17,7,10
Plasticbag,frostmourne,654,priest,discipline,17,7,10
Lonerush,hyjal,652,priest,discipline,19,7,12
Pridesp,tichondrius,639,priest,discipline,14,8,6
Dreadxshadow,stormrage,628,priest,discipline,24,12,12
Swagacious,malganis,624,priest,discipline,13,8,5
Elliepls,tichondrius,624,priest,discipline,15,7,8
Holysmegma,dreadmaul,623,priest,discipline,11,7,4
Ezpríest,kelthuzad,623,priest,discipline,11,7,4
Azaleth,sargeras,623,priest,discipline,17,7,10
Praisedalort,illidan,621,priest,discipline,15,8,7
Tmnaarcanttv,tichondrius,618,priest,discipline,13,8,5
Skellybells,sargeras,617,priest,discipline,22,12,10
Elevatez,stormrage,608,priest,discipline,10,7,3
Åffliction,sargeras,607,priest,discipline,11,7,4
Coolzo,dethecus,607,priest,discipline,14,8,6
Jimyo,tichondrius,607,priest,discipline,15,7,8
Coutúre,illidan,606,priest,discipline,11,7,4
Codiroli,tichondrius,606,priest,discipline,14,7,7
Athzziry,ragnaros,599,priest,discipline,21,7,14
Applekrisp,sargeras,589,priest,discipline,25,8,17
Càptain,moon-guard,576,priest,discipline,6,6,0
Kwx,tichondrius,576,priest,discipline,6,6,0
Pearl,chogall,576,priest,discipline,6,6,0
Gód,moonrunner,576,priest,discipline,6,6,0
Healia,tichondrius,576,priest,discipline,6,6,0
Madelyn,stormrage,576,priest,discipline,6,6,0
Smashfacëwin,tichondrius,576,priest,discipline,6,6,0
Porffy,malygos,576,priest,discipline,6,6,0
Chop,kelthuzad,576,priest,discipline,6,6,0
Darkxd,bleeding-hollow,576,priest,discipline,6,6,0
Delai,dalaran,576,priest,discipline,6,6,0
Illmatíc,malganis,576,priest,discipline,6,6,0
Eldoras,zuljin,576,priest,discipline,6,6,0
Biomadd,hellscream,576,priest,discipline,9,7,2
Joanoarc,destromath,576,priest,discipline,12,6,6
Bambucha,ragnaros,576,priest,discipline,12,6,6
Nieni,wyrmrest-accord,576,priest,discipline,12,6,6
Napr,proudmoore,576,priest,discipline,12,6,6
Jopocket,bleeding-hollow,576,priest,discipline,12,6,6
Missrachel,kiljaeden,576,priest,discipline,12,6,6
Surletoit,tichondrius,576,priest,discipline,12,6,6
Ahnassi,stormrage,576,priest,discipline,12,6,6
Decades,moon-guard,576,priest,discipline,12,6,6
Celypriest,moon-guard,576,priest,discipline,12,6,6
Nineoneoneh,stormrage,576,priest,discipline,12,6,6
Luun,bleeding-hollow,576,priest,discipline,12,6,6
Flarkyllama,area-52,576,priest,discipline,12,6,6
Johnnysyns,frostmourne,576,priest,discipline,12,6,6
Altheria,malganis,576,priest,discipline,12,6,6
Akinap,thrall,576,priest,discipline,12,6,6
Seléne,tichondrius,576,priest,discipline,12,6,6
Neep,turalyon,576,priest,discipline,12,6,6
Rëy,bleeding-hollow,576,priest,discipline,12,6,6
Tcfx,bleeding-hollow,576,priest,discipline,12,6,6
Ikancastt,tichondrius,576,priest,discipline,12,6,6
Kurtx,tichondrius,576,priest,discipline,12,6,6
Kabutta,stormrage,576,priest,discipline,12,6,6
Wøah,stormrage,576,priest,discipline,12,6,6
Scrublahr,the-venture-co,576,priest,discipline,12,6,6
Priesterson,tichondrius,576,priest,discipline,12,6,6
Hereges,azralon,576,priest,discipline,12,6,6
Raakun,stormrage,576,priest,discipline,12,6,6
Taviesh,tichondrius,576,priest,discipline,12,6,6
Datwunguy,sargeras,576,priest,discipline,12,6,6
Obstetrician,tichondrius,576,priest,discipline,12,6,6
Scripture,stormreaver,576,priest,discipline,12,6,6
Purpskurp,stormrage,576,priest,discipline,12,6,6
Helacia,jubeithos,576,priest,discipline,12,6,6
Dimebahg,mugthol,576,priest,discipline,12,6,6
Ereessea,hyjal,576,priest,discipline,12,6,6
Moselol,tichondrius,576,priest,discipline,12,6,6
Nokzo,dalaran,576,priest,discipline,12,6,6
Electricdisc,korgath,576,priest,discipline,12,6,6
Twinkøgøâøàd,azralon,576,priest,discipline,12,6,6
Kzo,gnomeregan,576,priest,discipline,12,6,6
Thelastfight,frostmourne,576,priest,discipline,12,6,6
Ruinr,illidan,576,priest,discipline,12,6,6
Bìgdisc,sargeras,576,priest,discipline,12,6,6
Amphion,skullcrusher,576,priest,discipline,12,6,6
Fatherjohnny,azuremyst,576,priest,discipline,12,6,6
Puritykitty,zuljin,576,priest,discipline,12,6,6
Johnio,tichondrius,576,priest,discipline,12,6,6
Babburger,tichondrius,576,priest,discipline,12,6,6
Velýs,moon-guard,576,priest,discipline,12,6,6
Ripret,tichondrius,576,priest,discipline,12,6,6
Wabie,illidan,576,priest,discipline,12,6,6
Moqoro,azralon,576,priest,discipline,12,6,6
Nethir,moon-guard,576,priest,discipline,12,6,6
Prostrat,deathwing,576,priest,discipline,12,6,6
Xiaochenchen,tichondrius,576,priest,discipline,12,6,6
Treri,bleeding-hollow,576,priest,discipline,12,6,6
Stat,thrall,576,priest,discipline,12,6,6
Lisau,tichondrius,576,priest,discipline,12,6,6
Saelomism,frostmourne,576,priest,discipline,12,6,6
Raichu,blackrock,576,priest,discipline,12,6,6
Riasgremøry,stormrage,576,priest,discipline,12,6,6
Panikâ,thrall,576,priest,discipline,12,6,6
Bernietopper,tichondrius,576,priest,discipline,12,6,6
Annuli,stormrage,576,priest,discipline,12,6,6
Yannigirl,area-52,576,priest,discipline,12,6,6
Instaboned,sargeras,576,priest,discipline,12,6,6
Boppdot,tichondrius,576,priest,discipline,12,6,6
Bigsàd,proudmoore,576,priest,discipline,12,6,6
Slouch,emerald-dream,576,priest,discipline,12,6,6
Stankychimpo,malganis,576,priest,discipline,12,6,6
Rin,ghostlands,576,priest,discipline,12,6,6
Jrøc,sargeras,576,priest,discipline,12,6,6
Wodpriestx,stormrage,576,priest,discipline,12,6,6
Padrë,tichondrius,576,priest,discipline,12,6,6
Bloodfaith,stormrage,576,priest,discipline,12,6,6
Photicz,malganis,576,priest,discipline,12,6,6
Bootypudding,moon-guard,576,priest,discipline,12,6,6
Bumps,zuljin,576,priest,discipline,12,6,6
Mediterranee,tichondrius,576,priest,discipline,12,6,6
Kawasakix,tichondrius,576,priest,discipline,12,6,6
Shwayp,zuljin,576,priest,discipline,12,6,6
Skiza,stormrage,576,priest,discipline,12,6,6
Armour,kelthuzad,576,priest,discipline,12,6,6
Warlocks,lightbringer,576,priest,discipline,12,6,6
Capriestsunx,malfurion,576,priest,discipline,12,6,6
Saintjpii,tichondrius,576,priest,discipline,12,6,6
Zaperama,tichondrius,576,priest,discipline,12,6,6
Keldrii,sentinels,576,priest,discipline,12,6,6
Syncope,garona,576,priest,discipline,12,6,6
Randyortonn,tichondrius,576,priest,discipline,12,6,6
Rïshloo,ragnaros,576,priest,discipline,12,6,6
Redkiwi,illidan,576,priest,discipline,12,6,6
Intrav,malganis,576,priest,discipline,12,6,6
Chaotikx,kelthuzad,576,priest,discipline,12,6,6
Saviorsëlf,tichondrius,576,priest,discipline,12,6,6
Hínáta,kelthuzad,576,priest,discipline,12,6,6
Imfresh,illidan,576,priest,discipline,12,6,6
Darkinfusion,illidan,576,priest,discipline,12,6,6
Asleep,sargeras,576,priest,discipline,12,6,6
Astralshadow,barthilas,576,priest,discipline,12,6,6
Chicoryx,illidan,576,priest,discipline,12,6,6
Priil,emerald-dream,576,priest,discipline,12,6,6
Inukimi,sargeras,576,priest,discipline,12,6,6
Aenai,sargeras,576,priest,discipline,12,6,6
Mayineedruid,ragnaros,576,priest,discipline,17,8,9
Holytickles,stormrage,576,priest,discipline,15,7,8
Bigfirebet,tichondrius,576,priest,discipline,15,7,8
Preyforme,tichondrius,576,priest,discipline,13,6,7
Holytitanzz,quelthalas,576,priest,discipline,16,7,9
Speedboat,frostmourne,576,priest,discipline,14,6,8
Mayzal,emerald-dream,576,priest,discipline,24,9,15
Fiéstah,illidan,576,priest,discipline,21,7,14
Priestmass,dalaran,576,priest,discipline,18,6,12
Dgpriest,tichondrius,576,priest,discipline,18,6,12
Junethegreat,tichondrius,576,priest,discipline,18,6,12
Lildes,tichondrius,576,priest,discipline,18,6,12
Dots,tichondrius,576,priest,discipline,18,6,12
Ershackleton,illidan,576,priest,discipline,18,6,12
Slimshadylp,illidan,576,priest,discipline,18,6,12
Komicks,tichondrius,576,priest,discipline,18,6,12
Purifyhoes,sargeras,576,priest,discipline,18,6,12
Sojang,tichondrius,576,priest,discipline,18,6,12
Synaptikk,proudmoore,576,priest,discipline,18,6,12
Decokim,tichondrius,576,priest,discipline,18,6,12
Drossv,shadowmoon,576,priest,discipline,18,6,12
Fartnutts,dalaran,576,priest,discipline,18,6,12
Fadedhalo,magtheridon,576,priest,discipline,18,6,12
Averages,stormrage,576,priest,discipline,18,6,12
Peaky,moonrunner,576,priest,discipline,18,6,12
Jarzo,thunderhorn,576,priest,discipline,18,6,12
Nupanda,tichondrius,576,priest,discipline,18,6,12
Sandelios,aggramar,576,priest,discipline,18,6,12
Keepsleepin,stormrage,576,priest,discipline,18,6,12
Stepbrohelp,barthilas,576,priest,discipline,18,6,12
Pekeatz,tichondrius,576,priest,discipline,18,6,12
Oymay,illidan,576,priest,discipline,18,6,12
Çørrúptíøñz,tichondrius,576,priest,discipline,18,6,12
Plztrainme,spinebreaker,576,priest,discipline,18,6,12
Spøokz,stormreaver,576,priest,discipline,18,6,12
Xpenance,ragnaros,576,priest,discipline,18,6,12
Asmødeus,bleeding-hollow,576,priest,discipline,18,6,12
Fearles,thrall,576,priest,discipline,18,6,12
Goobiesz,tichondrius,576,priest,discipline,18,6,12
Snupyfangirl,area-52,576,priest,discipline,18,6,12
Slthrysnake,area-52,576,priest,discipline,18,6,12
Repriest,malganis,576,priest,discipline,18,6,12
Voldenmort,dragonmaw,576,priest,discipline,18,6,12
Ímgucci,malganis,576,priest,discipline,18,6,12
Starp,tichondrius,576,priest,discipline,18,6,12
Deadlylight,frostmourne,576,priest,discipline,18,6,12
Jiedx,tichondrius,576,priest,discipline,18,6,12
Thedeadheal,malganis,576,priest,discipline,18,6,12
Mylà,ragnaros,576,priest,discipline,20,6,14
Cûrry,bleeding-hollow,576,priest,discipline,24,6,18
Felixfire,moon-guard,576,priest,discipline,24,6,18
Drupith,dalaran,576,priest,discipline,24,6,18
Bree,area-52,576,priest,discipline,24,6,18
Nachòs,wildhammer,575,priest,discipline,6,6,0
Kephrek,eonar,575,priest,discipline,6,6,0
Astrìx,tichondrius,575,priest,discipline,6,6,0
Aanora,illidan,575,priest,discipline,12,6,6
Gdrf,sargeras,575,priest,discipline,12,6,6
Imhotap,illidan,575,priest,discipline,12,6,6
Hödü,tichondrius,575,priest,discipline,12,6,6
Andriloveyou,barthilas,575,priest,discipline,12,6,6
Brahmin,nazjatar,575,priest,discipline,12,6,6
Supermelt,emerald-dream,575,priest,discipline,12,6,6
Lúçíd,sargeras,575,priest,discipline,12,6,6
Umbramortìs,tichondrius,575,priest,discipline,12,6,6
Shaellito,goldrinn,575,priest,discipline,12,6,6
Chowdä,kiljaeden,575,priest,discipline,12,6,6
Wickedmoon,emerald-dream,575,priest,discipline,12,6,6
Akapegando,ragnaros,575,priest,discipline,12,6,6
Mcfluffin,aggramar,575,priest,discipline,12,6,6
Nejisaiyan,sargeras,575,priest,discipline,12,6,6
Spiritbear,thrall,575,priest,discipline,12,6,6
Siabo,tichondrius,575,priest,discipline,12,6,6
Forroc,stormrage,575,priest,discipline,12,6,6
Juress,area-52,575,priest,discipline,12,6,6
Uncensøred,tichondrius,575,priest,discipline,12,6,6
Trienolone,emerald-dream,575,priest,discipline,12,6,6
Amgen,bleeding-hollow,575,priest,discipline,12,6,6
Haedn,azralon,575,priest,discipline,12,6,6
Swaptohealer,misha,575,priest,discipline,12,6,6
Nevertelsp,malganis,575,priest,discipline,12,6,6
Spaddox,arathor,575,priest,discipline,12,6,6
Khaibit,stormrage,575,priest,discipline,12,6,6
Nineoneone,kilrogg,575,priest,discipline,12,6,6
Nordheal,stormrage,575,priest,discipline,12,6,6
Pulso,area-52,575,priest,discipline,12,6,6
Moarhaste,kelthuzad,575,priest,discipline,12,6,6
Paqwee,tichondrius,575,priest,discipline,12,6,6
Herzattacken,malganis,575,priest,discipline,12,6,6
Silveri,thrall,575,priest,discipline,12,6,6
Eclipsos,dalaran,575,priest,discipline,12,6,6
Pinaybebe,kiljaeden,575,priest,discipline,12,6,6
Peeinbottles,stormrage,575,priest,discipline,16,7,9
Biltpeter,tichondrius,575,priest,discipline,15,6,9
Whoôx,khazgoroth,575,priest,discipline,17,6,11
Mortaroth,doomhammer,575,priest,discipline,18,6,12
Villageidiot,lightbringer,575,priest,discipline,18,6,12
Snuzziest,darkspear,575,priest,discipline,18,6,12
Scenekîd,moon-guard,575,priest,discipline,18,6,12
Runecarver,anvilmar,575,priest,discipline,18,6,12
Beymax,moon-guard,575,priest,discipline,24,6,18
Baldpate,tichondrius,575,priest,discipline,24,6,18
Epicaah,quelthalas,574,priest,discipline,12,6,6
Chalmersyo,tichondrius,574,priest,discipline,12,6,6
Mikol,eredar,574,priest,discipline,12,6,6
Evilmajor,icecrown,574,priest,discipline,12,6,6
Wilita,drakkari,574,priest,discipline,12,6,6
Senareyn,thrall,574,priest,discipline,12,6,6
Darkphoxy,azralon,574,priest,discipline,12,6,6
Tenchü,azralon,574,priest,discipline,18,6,12
Papadarkness,tichondrius,574,priest,discipline,24,6,18
Mezervescent,thrall,574,priest,discipline,24,6,18
Prebruisz,baelgun,573,priest,discipline,12,6,6
Axhia,dentarg,573,priest,discipline,12,6,6
Fanaeth,arathor,573,priest,discipline,12,6,6
Reilean,sargeras,573,priest,discipline,12,6,6
Myhealz,agamaggan,573,priest,discipline,12,6,6
Ságrádá,area-52,573,priest,discipline,12,6,6
Naimillia,stormrage,573,priest,discipline,18,6,12
Izzymariepie,dragonmaw,573,priest,discipline,18,6,12
Banepriest,sargeras,573,priest,discipline,18,6,12
Phantoms,moon-guard,573,priest,discipline,18,6,12
Bigchip,sargeras,573,priest,discipline,24,6,18
Aragingclue,burning-legion,572,priest,discipline,12,6,6
Marpi,quelthalas,572,priest,discipline,24,6,18
Voidlordd,kelthuzad,571,priest,discipline,12,6,6
Trialla,medivh,571,priest,discipline,18,6,12
Grandraf,dreadmaul,570,priest,discipline,12,6,6
Zanyp,akama,570,priest,discipline,18,6,12
Eumalfa,dalaran,567,priest,discipline,12,6,6
Antipreist,bonechewer,567,priest,discipline,12,6,6
Gwynne,barthilas,559,priest,discipline,11,6,5
Adeptphd,tichondrius,559,priest,discipline,23,6,17
Garyhooves,zuljin,558,priest,discipline,17,6,11
Justfaith,barthilas,558,priest,discipline,17,6,11
Zeno,haomarush,557,priest,discipline,11,6,5
Gringotaco,tichondrius,554,priest,discipline,26,9,17
Ãdolfhealer,dalaran,544,priest,discipline,10,7,3
Flavorgrave,tichondrius,544,priest,discipline,16,6,10
Zaroff,turalyon,543,priest,discipline,11,6,5
Awaken81B7AE,illidan,543,priest,discipline,17,6,11
Mørbol,tichondrius,541,priest,discipline,20,7,13
Moonlightx,destromath,528,priest,discipline,9,7,2
Tealien,dalaran,527,priest,discipline,11,6,5
Quartzolio,azralon,527,priest,discipline,17,6,11
Pasquell,emerald-dream,526,priest,discipline,11,6,5
Nosgoróth,quelthalas,522,priest,discipline,13,7,6
Mesiausx,stormrage,522,priest,discipline,14,7,7
Dotdotdead,earthen-ring,522,priest,discipline,16,7,9
Balikina,stormrage,521,priest,discipline,17,7,10
Onahaihu,tichondrius,521,priest,discipline,20,7,13
Bhavu,tichondrius,521,priest,discipline,22,7,15
Identìty,moon-guard,521,priest,discipline,28,7,21
Øçñæøæçñøñçæ,sargeras,520,priest,discipline,12,7,5
Ethari,crushridge,520,priest,discipline,21,7,14
Safewurd,sargeras,511,priest,discipline,8,6,2
Smíght,thrall,511,priest,discipline,11,6,5
Enphý,quelthalas,511,priest,discipline,11,6,5
Jinxheal,tichondrius,511,priest,discipline,14,6,8
Bigtang,kiljaeden,511,priest,discipline,14,6,8
Lilmad,stormrage,511,priest,discipline,20,6,14
Germanica,area-52,509,priest,discipline,32,11,21
Horridheals,shandris,505,priest,discipline,10,6,4
Ibangedaqt,malganis,497,priest,discipline,29,12,17
Earys,ragnaros,496,priest,discipline,22,6,16
Aquandrelea,aegwynn,495,priest,discipline,7,6,1
Leist,ragnaros,495,priest,discipline,11,6,5
Yait,tichondrius,495,priest,discipline,14,7,7
Silverspöön,bleeding-hollow,495,priest,discipline,13,6,7
Pertril,stormrage,480,priest,discipline,6,5,1
Emiyawagrano,tichondrius,480,priest,discipline,6,5,1
Aetonyx,anvilmar,480,priest,discipline,6,5,1
Corov,korgath,480,priest,discipline,6,5,1
Káldorei,proudmoore,480,priest,discipline,6,5,1
Hansa,ragnaros,480,priest,discipline,6,5,1
Stegp,kelthuzad,480,priest,discipline,6,5,1
Shadowgïrl,azralon,480,priest,discipline,6,5,1
Elitejustin,area-52,480,priest,discipline,6,5,1
Deathdreamer,azjolnerub,480,priest,discipline,6,5,1
Kazedx,barthilas,480,priest,discipline,6,5,1
Deacoderx,area-52,480,priest,discipline,6,5,1
Dzikuss,aegwynn,480,priest,discipline,6,5,1
Kénnypowers,tichondrius,480,priest,discipline,6,5,1
Sharkbones,tichondrius,480,priest,discipline,6,5,1
Hateutoo,sargeras,480,priest,discipline,6,5,1
Kardinalkeso,frostmourne,480,priest,discipline,6,5,1
Sixnoh,moonrunner,480,priest,discipline,6,5,1
Phantømz,zuljin,480,priest,discipline,6,5,1
Armanp,hyjal,480,priest,discipline,6,5,1
Cxmplex,malganis,480,priest,discipline,6,5,1
Uncletouchy,illidan,480,priest,discipline,6,5,1
Danawhitex,thrall,480,priest,discipline,6,5,1
Xorriz,bleeding-hollow,480,priest,discipline,6,5,1
Privx,bleeding-hollow,480,priest,discipline,6,5,1
Bulleitrye,emerald-dream,480,priest,discipline,6,5,1
Thugliffe,frostmourne,480,priest,discipline,6,5,1
Bebyyourside,malganis,480,priest,discipline,6,5,1
Kumzamboni,dalaran,480,priest,discipline,6,5,1
Xxmewo,sargeras,480,priest,discipline,6,5,1
Noite,azralon,480,priest,discipline,6,5,1
Unishooter,illidan,480,priest,discipline,6,5,1
Djd,frostmourne,480,priest,discipline,6,5,1
Nawtyforever,tichondrius,480,priest,discipline,6,5,1
Mercedés,alleria,480,priest,discipline,6,5,1
Pèngotnerfed,exodar,480,priest,discipline,6,5,1
Imwithham,tichondrius,480,priest,discipline,10,6,4
Aelriah,thrall,480,priest,discipline,12,5,7
Sabela,moon-guard,480,priest,discipline,12,5,7
Hopenä,dragonmaw,480,priest,discipline,12,5,7
Iforted,sargeras,480,priest,discipline,12,5,7
Alleeyy,tichondrius,480,priest,discipline,12,5,7
Scyndar,bonechewer,480,priest,discipline,12,5,7
Soulbane,frostmourne,480,priest,discipline,12,5,7
Icarryozz,darkspear,480,priest,discipline,12,5,7
Shadowcrash,zuljin,480,priest,discipline,12,5,7
Rofrofmu,aegwynn,480,priest,discipline,12,5,7
Lourrdz,tichondrius,480,priest,discipline,12,5,7
Krazyapollo,tichondrius,480,priest,discipline,12,5,7
Lchcl,tichondrius,480,priest,discipline,12,5,7
Hotdice,bleeding-hollow,480,priest,discipline,12,5,7
Tarwow,moon-guard,480,priest,discipline,12,5,7
Toonahx,area-52,480,priest,discipline,12,5,7
Giraffebaitt,zuljin,480,priest,discipline,12,5,7
Ellipsiz,area-52,480,priest,discipline,12,5,7
Cw,wildhammer,480,priest,discipline,12,5,7
Anellas,sargeras,480,priest,discipline,12,5,7
Yaheals,gorefiend,480,priest,discipline,12,5,7
Altaeres,tichondrius,480,priest,discipline,12,5,7
Seraphang,stormrage,480,priest,discipline,12,5,7
Yauntoo,tichondrius,480,priest,discipline,12,5,7
Lingt,drakkari,480,priest,discipline,12,5,7
Makeshiftz,zuljin,480,priest,discipline,12,5,7
Raslin,bonechewer,480,priest,discipline,12,5,7
Discogs,frostmourne,480,priest,discipline,12,5,7
Beetrap,wyrmrest-accord,480,priest,discipline,12,5,7
Shwrma,bleeding-hollow,480,priest,discipline,12,5,7
Voidquil,bonechewer,480,priest,discipline,12,5,7
Whosjoe,tichondrius,480,priest,discipline,12,5,7
Hello,tichondrius,480,priest,discipline,12,5,7
Hotlink,daggerspine,480,priest,discipline,12,5,7
Idryn,quelthalas,480,priest,discipline,12,5,7
Shôta,kelthuzad,480,priest,discipline,12,5,7
Inflate,frostmourne,480,priest,discipline,12,5,7
Shelfedelf,gurubashi,480,priest,discipline,12,5,7
Shädyönë,tichondrius,480,priest,discipline,12,5,7
Castholy,nordrassil,480,priest,discipline,12,5,7
Vyrah,area-52,480,priest,discipline,12,5,7
Piffbadar,tichondrius,480,priest,discipline,12,5,7
Jmanhealz,stormrage,480,priest,discipline,12,5,7
Supernamp,sargeras,480,priest,discipline,12,5,7
Spîteful,illidan,480,priest,discipline,12,5,7
Angelvoid,chogall,480,priest,discipline,12,5,7
Kurahashe,moon-guard,480,priest,discipline,12,5,7
Gudóngmae,stormrage,480,priest,discipline,12,5,7
Serenderpity,moon-guard,480,priest,discipline,12,5,7
Ptam,tichondrius,480,priest,discipline,12,5,7
Blackdeathx,tichondrius,480,priest,discipline,12,5,7
Feyns,illidan,480,priest,discipline,12,5,7
Fancycorpse,tichondrius,480,priest,discipline,12,5,7
Tommyjr,tichondrius,480,priest,discipline,12,5,7
Raeana,area-52,480,priest,discipline,12,5,7
Townbicyclé,area-52,480,priest,discipline,12,5,7
Eltanji,wyrmrest-accord,480,priest,discipline,12,5,7
Lastbubble,area-52,480,priest,discipline,12,5,7
Mistify,bleeding-hollow,480,priest,discipline,12,5,7
Dweem,stormrage,480,priest,discipline,12,5,7
Powerwordkfc,kelthuzad,480,priest,discipline,12,5,7
Alpacasama,illidan,480,priest,discipline,12,5,7
Wreklol,sargeras,480,priest,discipline,12,5,7
Tigawoods,khaz-modan,480,priest,discipline,12,5,7
Tòxìç,stormrage,480,priest,discipline,12,5,7
Widewinks,thrall,480,priest,discipline,12,5,7
Pillowfinger,illidan,480,priest,discipline,12,5,7
Knowknows,tichondrius,480,priest,discipline,12,5,7
Azngød,tichondrius,480,priest,discipline,12,5,7
Soll,veknilash,480,priest,discipline,12,5,7
Thadopepope,tichondrius,480,priest,discipline,12,5,7
Justgoon,tichondrius,480,priest,discipline,12,5,7
Canswersp,sargeras,480,priest,discipline,12,5,7
Jackymv,kelthuzad,480,priest,discipline,12,5,7
Goonie,spirestone,480,priest,discipline,12,5,7
Vérse,stormrage,480,priest,discipline,12,5,7
Istvala,zuljin,480,priest,discipline,12,5,7
Pumice,destromath,480,priest,discipline,12,5,7
Imhðtep,ragnaros,480,priest,discipline,12,5,7
Meatytrash,area-52,480,priest,discipline,12,5,7
Augus,velen,480,priest,discipline,12,5,7
Derisha,ragnaros,480,priest,discipline,12,5,7
Technetium,illidan,480,priest,discipline,12,5,7
Amperx,wyrmrest-accord,480,priest,discipline,12,5,7
Gstvsrrn,tichondrius,480,priest,discipline,12,5,7
Saucelord,barthilas,480,priest,discipline,12,5,7
Kopipriest,barthilas,480,priest,discipline,12,5,7
Humblemumble,barthilas,480,priest,discipline,12,5,7
Typhia,moon-guard,480,priest,discipline,12,5,7
Barrist,wyrmrest-accord,480,priest,discipline,12,5,7
Fatalpush,moon-guard,480,priest,discipline,12,5,7
Younext,sargeras,480,priest,discipline,12,5,7
Stambuff,tichondrius,480,priest,discipline,12,5,7
Yukishield,illidan,480,priest,discipline,12,5,7
Starzard,kelthuzad,480,priest,discipline,12,5,7
Vikks,tichondrius,480,priest,discipline,12,5,7
Mikes,sargeras,480,priest,discipline,12,5,7
Robbailey,dalvengyr,480,priest,discipline,12,5,7
Mywifesaidno,sargeras,480,priest,discipline,12,5,7
Stunzeed,staghelm,480,priest,discipline,12,5,7
Taikosqt,azralon,480,priest,discipline,12,5,7
Htx,dunemaul,480,priest,discipline,12,5,7
Drmattydubz,tichondrius,480,priest,discipline,12,5,7
Thiella,azralon,480,priest,discipline,12,5,7
Harrygazm,shattered-hand,480,priest,discipline,12,5,7
Bluffzp,boulderfist,480,priest,discipline,12,5,7
Apbrady,sargeras,480,priest,discipline,12,5,7
Yujawang,sargeras,480,priest,discipline,12,5,7
Äpriest,sargeras,480,priest,discipline,12,5,7
Shadowjisha,emerald-dream,480,priest,discipline,12,5,7
Kallenk,proudmoore,480,priest,discipline,12,5,7
Gatty,kiljaeden,480,priest,discipline,13,5,8
Jedmosby,korgath,480,priest,discipline,14,5,9
Pasher,sargeras,480,priest,discipline,18,5,13
Healiesuwu,kiljaeden,480,priest,discipline,18,5,13
Levingurt,darkspear,480,priest,discipline,18,5,13
Bebe,fizzcrank,480,priest,discipline,18,5,13
Kershl,aegwynn,480,priest,discipline,18,5,13
Sypii,stormrage,480,priest,discipline,18,5,13
Ticheals,tichondrius,480,priest,discipline,18,5,13
Sevenlions,stormrage,480,priest,discipline,18,5,13
Cheekypriest,stormrage,480,priest,discipline,18,5,13
Jahratu,tichondrius,480,priest,discipline,18,5,13
Ollarlamente,zuljin,480,priest,discipline,18,5,13
Vetisrx,thrall,480,priest,discipline,18,5,13
Klerick,kiljaeden,480,priest,discipline,18,5,13
Touchèr,sargeras,480,priest,discipline,18,5,13
Ludens,bleeding-hollow,480,priest,discipline,18,5,13
Aguadejamica,tichondrius,480,priest,discipline,18,5,13
Kark,tichondrius,480,priest,discipline,18,5,13
Mustyfribble,korgath,480,priest,discipline,18,5,13
Georgepells,barthilas,480,priest,discipline,24,5,19
Remixcandoit,malganis,479,priest,discipline,6,5,1
Krisdavra,thrall,479,priest,discipline,6,5,1
Confuses,area-52,479,priest,discipline,6,5,1
Tonymòntana,area-52,479,priest,discipline,6,5,1
Bossay,icecrown,479,priest,discipline,6,5,1
Syrissa,thrall,479,priest,discipline,6,5,1
Sevioletté,wyrmrest-accord,479,priest,discipline,6,5,1
Priuhpism,tichondrius,479,priest,discipline,6,5,1
Sanaconda,sargeras,479,priest,discipline,7,5,2
Berzum,chogall,479,priest,discipline,10,6,4
Grudgin,turalyon,479,priest,discipline,11,6,5
Clerical,skullcrusher,479,priest,discipline,12,5,7
Preesia,misha,479,priest,discipline,12,5,7
Tubelight,sargeras,479,priest,discipline,12,5,7
Pandaball,frostwolf,479,priest,discipline,12,5,7
Mistnamed,emerald-dream,479,priest,discipline,12,5,7
Chadlyfe,tichondrius,479,priest,discipline,12,5,7
Atheíst,tichondrius,479,priest,discipline,12,5,7
Photogirl,area-52,479,priest,discipline,12,5,7
Azhaell,quelthalas,479,priest,discipline,12,5,7
Ibuyfeetpics,tichondrius,479,priest,discipline,12,5,7
Aalicya,tanaris,479,priest,discipline,12,5,7
Coldvb,barthilas,479,priest,discipline,12,5,7
Gaaq,stormrage,479,priest,discipline,12,5,7
Krynoobz,senjin,479,priest,discipline,12,5,7
Techninë,chogall,479,priest,discipline,12,5,7
Drayen,korgath,479,priest,discipline,12,5,7
Averageheals,stormrage,479,priest,discipline,12,5,7
Fadêd,wildhammer,479,priest,discipline,12,5,7
Kelody,zuljin,479,priest,discipline,12,5,7
Greatzapan,tichondrius,479,priest,discipline,12,5,7
Omgimissher,black-dragonflight,479,priest,discipline,12,5,7
Mythine,moon-guard,479,priest,discipline,12,5,7
Vynthorian,frostmourne,479,priest,discipline,12,5,7
Selea,frostwolf,479,priest,discipline,12,5,7
Frazzysparks,stormrage,479,priest,discipline,12,5,7
Torrantt,bonechewer,479,priest,discipline,12,5,7
Xenedart,quelthalas,479,priest,discipline,12,5,7
Demished,zuljin,479,priest,discipline,12,5,7
Dabrat,darkspear,479,priest,discipline,18,6,12
Goodboyyoshi,tichondrius,479,priest,discipline,15,5,10
Crusifixx,tichondrius,479,priest,discipline,18,5,13
Cxview,sargeras,479,priest,discipline,18,5,13
Wort,cairne,479,priest,discipline,18,5,13
Asmitä,stormrage,479,priest,discipline,24,5,19
Pylenn,emerald-dream,478,priest,discipline,12,5,7
Ansgar,eonar,478,priest,discipline,12,5,7
Liñkzq,frostmourne,478,priest,discipline,12,5,7
Invisibler,tichondrius,478,priest,discipline,24,5,19
Pingleangel,tichondrius,477,priest,discipline,12,5,7
Solzal,korgath,477,priest,discipline,12,5,7
Goldenlilly,moon-guard,477,priest,discipline,18,5,13
Laydrel,sargeras,476,priest,discipline,12,5,7
Lotzofhealz,wyrmrest-accord,476,priest,discipline,12,5,7
Rescueworker,kelthuzad,473,priest,discipline,12,5,7
Divinebones,gurubashi,473,priest,discipline,18,5,13
Forober,queldorei,466,priest,discipline,39,14,25
Devivi,malganis,463,priest,discipline,11,5,6
Thehealinck,magtheridon,448,priest,discipline,10,5,5
Faíthless,sargeras,447,priest,discipline,11,5,6
Shadowkr,tichondrius,447,priest,discipline,11,5,6
Hungzilla,malganis,447,priest,discipline,11,5,6
Ihazhealzz,area-52,447,priest,discipline,11,5,6
Darkascended,arthas,447,priest,discipline,14,6,8
Guillotinee,ragnaros,447,priest,discipline,13,5,8
Cuisino,tichondrius,446,priest,discipline,11,5,6
Gnepe,sargeras,441,priest,discipline,17,7,10
Sorzartluz,malganis,432,priest,discipline,9,6,3
Proftimothy,tichondrius,432,priest,discipline,15,6,9
Agrotothemax,tichondrius,432,priest,discipline,15,5,10
Fxxkdamn,tichondrius,432,priest,discipline,21,6,15
Nefastó,ragnaros,431,priest,discipline,12,6,6
Bérzerk,dalvengyr,431,priest,discipline,11,5,6
Frenchfries,sargeras,431,priest,discipline,11,5,6
Texmix,stormrage,431,priest,discipline,21,6,15
Shadowbishop,barthilas,427,priest,discipline,12,7,5
Divìne,kiljaeden,426,priest,discipline,12,6,6
Stickheal,tichondrius,425,priest,discipline,13,6,7
Thøt,malganis,420,priest,discipline,14,6,8
Discshady,tichondrius,416,priest,discipline,10,5,5
Iloveshannon,stormrage,415,priest,discipline,8,5,3
Felyreilyana,caelestrasz,415,priest,discipline,11,5,6
Kuwapre,proudmoore,415,priest,discipline,14,6,8
Mooray,thrall,415,priest,discipline,14,5,9
Ramsakz,proudmoore,413,priest,discipline,10,5,5
Esredarksun,sargeras,412,priest,discipline,16,5,11
Whodatpriest,blackhand,399,priest,discipline,5,5,0
Normill,bonechewer,399,priest,discipline,7,5,2
Bunked,bleeding-hollow,392,priest,discipline,23,7,16
Soupbeanx,zuljin,384,priest,discipline,6,4,2
Granger,senjin,384,priest,discipline,6,4,2
Norbert,zuljin,384,priest,discipline,6,4,2
Ahleven,tichondrius,384,priest,discipline,6,4,2
Pprriieesst,tichondrius,384,priest,discipline,6,4,2
Aerlinn,tichondrius,384,priest,discipline,6,4,2
Anasuzana,zuljin,384,priest,discipline,6,4,2
Thugish,frostwolf,384,priest,discipline,6,4,2
Fûsoya,zuljin,384,priest,discipline,6,4,2
Pollitoasado,tichondrius,384,priest,discipline,6,4,2
Bumbleedot,azralon,384,priest,discipline,6,4,2
Taevier,ghostlands,384,priest,discipline,6,4,2
Miniambá,tichondrius,384,priest,discipline,6,4,2
Delloria,stormrage,384,priest,discipline,6,4,2
Silentluna,tichondrius,384,priest,discipline,6,4,2
Uhohmd,senjin,384,priest,discipline,6,4,2
Giyom,tichondrius,384,priest,discipline,6,4,2
Feminizm,tichondrius,384,priest,discipline,6,4,2
Discotec,stormrage,384,priest,discipline,6,4,2
Ritalyn,korgath,384,priest,discipline,6,4,2
Jixxersp,malganis,384,priest,discipline,6,4,2
Healscityy,tichondrius,384,priest,discipline,6,4,2
Relicxz,firetree,384,priest,discipline,6,4,2
Gladexp,tichondrius,384,priest,discipline,6,4,2
Ihealfunny,blood-furnace,384,priest,discipline,6,4,2
Lavigne,tichondrius,384,priest,discipline,6,4,2
Merçy,zuljin,384,priest,discipline,6,4,2
Optimism,frostmane,384,priest,discipline,6,4,2
Otterblast,illidan,384,priest,discipline,6,4,2
Holisticx,tichondrius,384,priest,discipline,6,4,2
Subscribe,khazgoroth,384,priest,discipline,6,4,2
Perkalicious,thrall,384,priest,discipline,6,4,2
Potatopriest,frostmourne,384,priest,discipline,6,4,2
Babe,aerie-peak,384,priest,discipline,6,4,2
Mythuxxz,sargeras,384,priest,discipline,6,4,2
Fadedyourgo,tichondrius,384,priest,discipline,6,4,2
Lilvf,barthilas,384,priest,discipline,6,4,2
Gdlsheretic,sargeras,384,priest,discipline,6,4,2
Crode,bleeding-hollow,384,priest,discipline,6,4,2
Deathrina,moon-guard,384,priest,discipline,6,4,2
Gardiancloun,sargeras,384,priest,discipline,6,4,2
Lithelin,frostmourne,384,priest,discipline,6,4,2
Demongodtren,blackrock,384,priest,discipline,6,4,2
Vladlèna,moon-guard,384,priest,discipline,6,4,2
Tobaiss,arygos,384,priest,discipline,6,4,2
Celanea,bleeding-hollow,384,priest,discipline,6,4,2
Béépboop,tichondrius,384,priest,discipline,6,4,2
Monkeyp,barthilas,384,priest,discipline,6,4,2
Djchickpea,chogall,384,priest,discipline,6,4,2
Blzy,area-52,384,priest,discipline,6,4,2
Celani,gilneas,384,priest,discipline,6,4,2
Mikèp,sargeras,384,priest,discipline,6,4,2
Bubbleboi,malganis,384,priest,discipline,6,4,2
Ghostz,alleria,384,priest,discipline,6,4,2
Leebow,tichondrius,384,priest,discipline,6,4,2
Ranthrough,tichondrius,384,priest,discipline,6,4,2
Auntiegrimm,silvermoon,384,priest,discipline,6,4,2
Uglydiego,quelthalas,384,priest,discipline,6,4,2
Dioecesis,moon-guard,384,priest,discipline,6,4,2
Ðyluxx,blackwater-raiders,384,priest,discipline,6,4,2
Zelenka,whisperwind,384,priest,discipline,6,4,2
Faithx,frostmourne,384,priest,discipline,6,4,2
Hiphopanomis,arthas,384,priest,discipline,6,4,2
Elcidd,tichondrius,384,priest,discipline,6,4,2
Dimedaddy,tichondrius,384,priest,discipline,6,4,2
Xanarcine,moon-guard,384,priest,discipline,6,4,2
Kàobeini,tichondrius,384,priest,discipline,6,4,2
Tosbanned,barthilas,384,priest,discipline,6,4,2
Chü,dalaran,384,priest,discipline,6,4,2
Chambler,aegwynn,384,priest,discipline,6,4,2
Ruems,area-52,384,priest,discipline,6,4,2
Rmpenjoyerx,area-52,384,priest,discipline,6,4,2
Metéora,nemesis,384,priest,discipline,6,4,2
Chemdawwg,aerie-peak,384,priest,discipline,6,4,2
Holylover,illidan,384,priest,discipline,6,4,2
Batface,frostmourne,384,priest,discipline,6,4,2
Discospider,sargeras,384,priest,discipline,6,4,2
Crueldotz,illidan,384,priest,discipline,6,4,2
Flaytality,shadowsong,384,priest,discipline,6,4,2
Yunggawd,illidan,384,priest,discipline,6,4,2
Babygsuss,tichondrius,384,priest,discipline,6,4,2
Otpp,sargeras,384,priest,discipline,6,4,2
Yuntingmingo,tichondrius,384,priest,discipline,6,4,2
Jaxthree,illidan,384,priest,discipline,6,4,2
Dredgeflay,thrall,384,priest,discipline,6,4,2
Äni,sargeras,384,priest,discipline,6,4,2
Epiipen,area-52,384,priest,discipline,6,4,2
Pándamonium,hyjal,384,priest,discipline,6,4,2
Zäán,sargeras,384,priest,discipline,6,4,2
Draehoe,kelthuzad,384,priest,discipline,6,4,2
Popeachini,sargeras,384,priest,discipline,6,4,2
Brácho,ragnaros,384,priest,discipline,6,4,2
Tristanp,frostmourne,384,priest,discipline,6,4,2
Jooback,kelthuzad,384,priest,discipline,6,4,2
Terisar,emerald-dream,384,priest,discipline,6,4,2
Killmeplzz,ragnaros,384,priest,discipline,6,4,2
Papaheal,runetotem,384,priest,discipline,6,4,2
Goyqqp,illidan,384,priest,discipline,6,4,2
Spyderco,mugthol,384,priest,discipline,6,4,2
Mafuyusan,proudmoore,384,priest,discipline,6,4,2
Kwazshell,area-52,384,priest,discipline,7,4,3
Shadp,tichondrius,384,priest,discipline,9,5,4
Deckx,khazgoroth,384,priest,discipline,12,6,6
Judeath,area-52,384,priest,discipline,8,4,4
Brodel,dark-iron,384,priest,discipline,9,4,5
Annoka,sargeras,384,priest,discipline,17,6,11
Juvell,illidan,384,priest,discipline,15,5,10
Nvøsuperstar,zuljin,384,priest,discipline,15,5,10
Keepri,tichondrius,384,priest,discipline,12,4,8
Fatherwyatt,bleeding-hollow,384,priest,discipline,12,4,8
Dogeastwest,tichondrius,384,priest,discipline,12,4,8
Danceofpales,bleeding-hollow,384,priest,discipline,12,4,8
Awesomeguyx,tichondrius,384,priest,discipline,12,4,8
Gokiburiuwu,illidan,384,priest,discipline,12,4,8
Biubiubium,tichondrius,384,priest,discipline,12,4,8
Littlean,frostmourne,384,priest,discipline,12,4,8
Stilgeist,proudmoore,384,priest,discipline,12,4,8
Priestcrys,quelthalas,384,priest,discipline,12,4,8
Darkspearr,tichondrius,384,priest,discipline,12,4,8
Thenamesnorm,tichondrius,384,priest,discipline,12,4,8
Bobolaine,illidan,384,priest,discipline,12,4,8
Vanagør,emerald-dream,384,priest,discipline,12,4,8
Meshuggåh,khazgoroth,384,priest,discipline,12,4,8
Valzzdor,zuljin,384,priest,discipline,12,4,8
Stonemonkeyp,sargeras,384,priest,discipline,12,4,8
Holyshiitzz,illidan,384,priest,discipline,12,4,8
Suzono,hyjal,384,priest,discipline,12,4,8
Gangshet,illidan,384,priest,discipline,12,4,8
Alcoricc,illidan,384,priest,discipline,12,4,8
Hokutos,tichondrius,384,priest,discipline,12,4,8
Wìd,khazgoroth,384,priest,discipline,12,4,8
Vyvivienx,tichondrius,384,priest,discipline,12,4,8
Blighttyy,proudmoore,384,priest,discipline,12,4,8
Cryptoccocus,zuljin,384,priest,discipline,12,4,8
Voidscrypt,thrall,384,priest,discipline,12,4,8
Shookones,malganis,384,priest,discipline,12,4,8
Fades,hellscream,384,priest,discipline,12,4,8
Eilana,tichondrius,384,priest,discipline,12,4,8
Echoos,proudmoore,384,priest,discipline,12,4,8
Daryldeath,tichondrius,384,priest,discipline,12,4,8
Zaylahh,blackrock,384,priest,discipline,12,4,8
Cezzko,tichondrius,384,priest,discipline,12,4,8
Seyler,barthilas,384,priest,discipline,12,4,8
Barclan,destromath,384,priest,discipline,12,4,8
Tangykiwi,dalaran,384,priest,discipline,12,4,8
Crazyfinley,dalaran,384,priest,discipline,12,4,8
Qyotasa,zuljin,384,priest,discipline,12,4,8
Templár,dalaran,384,priest,discipline,12,4,8
Disperse,sargeras,384,priest,discipline,12,4,8
Sugarlorde,destromath,384,priest,discipline,12,4,8
Teehowdie,aegwynn,384,priest,discipline,12,4,8
Lucet,aegwynn,384,priest,discipline,12,4,8
Skydemons,malganis,384,priest,discipline,12,4,8
Xavios,alexstrasza,384,priest,discipline,12,4,8
Azuvah,alexstrasza,384,priest,discipline,12,4,8
Srazul,azralon,384,priest,discipline,12,4,8
Liljunky,zuljin,384,priest,discipline,12,4,8
Jejer,moon-guard,384,priest,discipline,12,4,8
Caèlum,area-52,384,priest,discipline,12,4,8
Satelite,feathermoon,384,priest,discipline,12,4,8
Lenigrast,blackrock,384,priest,discipline,12,4,8
Meekheal,tichondrius,384,priest,discipline,12,4,8
Zafti,laughing-skull,384,priest,discipline,12,4,8
Qtpriestx,tichondrius,384,priest,discipline,12,4,8
Pearlwing,area-52,384,priest,discipline,12,4,8
Laqqet,sargeras,384,priest,discipline,12,4,8
Psyclo,stormrage,384,priest,discipline,12,4,8
Exisa,stormrage,384,priest,discipline,12,4,8
Auttø,area-52,384,priest,discipline,12,4,8
Jån,moon-guard,384,priest,discipline,12,4,8
Insomnya,sargeras,384,priest,discipline,12,4,8
Lankyschlong,frostmourne,384,priest,discipline,12,4,8
Akewnón,stormrage,384,priest,discipline,12,4,8
Billiard,stormrage,384,priest,discipline,12,4,8
Bigarxidia,bleeding-hollow,384,priest,discipline,12,4,8
Hrathren,caelestrasz,384,priest,discipline,12,4,8
Crypticus,nazjatar,384,priest,discipline,12,4,8
Selitos,executus,384,priest,discipline,12,4,8
Amys,kargath,384,priest,discipline,12,4,8
Kepptwo,korgath,384,priest,discipline,12,4,8
Ranksix,area-52,384,priest,discipline,12,4,8
Gooseundead,tichondrius,384,priest,discipline,12,4,8
Holynova,nerzhul,384,priest,discipline,12,4,8
Jonahas,sargeras,384,priest,discipline,12,4,8
Kymil,deathwing,384,priest,discipline,12,4,8
Killä,area-52,384,priest,discipline,12,4,8
Sìrena,tichondrius,384,priest,discipline,12,4,8
Nokhoron,eldrethalas,384,priest,discipline,12,4,8
Skêptic,tichondrius,384,priest,discipline,12,4,8
Sweetskittle,malganis,384,priest,discipline,12,4,8
Huckdaddy,tichondrius,384,priest,discipline,12,4,8
Zenjitsu,quelthalas,384,priest,discipline,12,4,8
Zaphfkiel,ragnaros,384,priest,discipline,12,4,8
Plebiss,burning-blade,384,priest,discipline,12,4,8
Chaxiubao,stormrage,384,priest,discipline,12,4,8
Biop,burning-blade,384,priest,discipline,12,4,8
Zhanay,ragnaros,384,priest,discipline,12,4,8
Urdaisyy,kelthuzad,384,priest,discipline,12,4,8
Nha,stormrage,384,priest,discipline,12,4,8
Discpi,illidan,384,priest,discipline,13,4,9
Gottaheal,blood-furnace,384,priest,discipline,14,4,10
Capixaba,stormrage,384,priest,discipline,18,4,14
Antalian,wyrmrest-accord,384,priest,discipline,18,4,14
Miandel,wildhammer,384,priest,discipline,18,4,14
Disçxrespeçt,cairne,384,priest,discipline,18,4,14
Fatzoid,the-forgotten-coast,384,priest,discipline,18,4,14
Kymohek,sargeras,384,priest,discipline,18,4,14
Diablomonk,warsong,384,priest,discipline,18,4,14
Vikingkøng,ragnaros,384,priest,discipline,18,4,14
Rainms,sargeras,384,priest,discipline,18,4,14
Råd,illidan,384,priest,discipline,18,4,14
Polythis,kelthuzad,384,priest,discipline,18,4,14
Shadowdroid,tichondrius,384,priest,discipline,18,4,14
Chemod,quelthalas,384,priest,discipline,18,4,14
Heilige,uldum,384,priest,discipline,30,4,26
Såviør,suramar,383,priest,discipline,6,4,2
Jonnycanuckz,duskwood,383,priest,discipline,6,4,2
Strithe,kiljaeden,383,priest,discipline,6,4,2
Mirex,tichondrius,383,priest,discipline,6,4,2
Needalung,stormrage,383,priest,discipline,6,4,2
Hopfit,the-underbog,383,priest,discipline,6,4,2
Loffthedabsl,tichondrius,383,priest,discipline,6,4,2
Shialebuff,gundrak,383,priest,discipline,6,4,2
Mythanex,bleeding-hollow,383,priest,discipline,6,4,2
Discodork,bleeding-hollow,383,priest,discipline,6,4,2
Shén,barthilas,383,priest,discipline,6,4,2
Coorslite,proudmoore,383,priest,discipline,6,4,2
Anoxic,kiljaeden,383,priest,discipline,12,4,8
Whatisholy,bleeding-hollow,383,priest,discipline,12,4,8
Bäldùr,moon-guard,383,priest,discipline,12,4,8
Sybal,suramar,383,priest,discipline,12,4,8
Mangaloochi,amanthul,383,priest,discipline,12,4,8
Kimbeloria,bleeding-hollow,383,priest,discipline,12,4,8
Fathergrey,emerald-dream,383,priest,discipline,12,4,8
Ioharusame,quelthalas,383,priest,discipline,17,5,12
Crozuhn,moon-guard,383,priest,discipline,18,4,14
Linndy,illidan,382,priest,discipline,6,4,2
Nocturnimal,grizzly-hills,382,priest,discipline,12,4,8
Bunnychloe,sargeras,381,priest,discipline,12,4,8
Primela,sargeras,381,priest,discipline,12,4,8
Myobi,tichondrius,381,priest,discipline,12,4,8
Mystexo,barthilas,367,priest,discipline,11,4,7
Burtier,zuljin,367,priest,discipline,11,4,7
Valdri,sargeras,367,priest,discipline,11,4,7
Cøwbøycrytøø,azralon,367,priest,discipline,23,4,19
Llaarrkkss,tichondrius,351,priest,discipline,11,4,7
Scrïpt,thaurissan,351,priest,discipline,11,4,7
Mcseven,sargeras,351,priest,discipline,11,4,7
Mêga,illidan,351,priest,discipline,14,5,9
Lightshizzle,illidan,351,priest,discipline,14,5,9
Gamorâ,sargeras,349,priest,discipline,14,5,9
Voidly,illidan,336,priest,discipline,9,5,4
Kefkå,sargeras,336,priest,discipline,9,4,5
Rosabell,ragnaros,336,priest,discipline,21,4,17
Grianné,mannoroth,335,priest,discipline,9,4,5
Siobhin,wyrmrest-accord,335,priest,discipline,11,4,7
Causeoflife,eitrigg,335,priest,discipline,11,4,7
Subvert,zuljin,330,priest,discipline,7,5,2
Nymphomana,tichondrius,330,priest,discipline,10,6,4
Prayanmantis,tichondrius,330,priest,discipline,14,5,9
Takedisdisc,tichondrius,330,priest,discipline,17,6,11
Xiangjiao,tichondrius,330,priest,discipline,17,6,11
Qtgirlsofine,bleeding-hollow,330,priest,discipline,15,5,10
Deeply,tichondrius,330,priest,discipline,17,5,12
Lilgeek,kelthuzad,330,priest,discipline,21,5,16
Mangshadoom,silvermoon,330,priest,discipline,22,5,17
Sacredpatty,frostmane,319,priest,discipline,5,4,1
Maccten,tichondrius,319,priest,discipline,9,5,4
Smarttakka,emerald-dream,319,priest,discipline,8,4,4
Manachai,the-forgotten-coast,319,priest,discipline,14,4,10
Klizzy,tichondrius,319,priest,discipline,14,4,10
Rancidcookie,tichondrius,304,priest,discipline,13,4,9
Kayodee,stormrage,288,priest,discipline,8,4,4
Alladys,shattered-hand,288,priest,discipline,6,3,3
Sabene,greymane,288,priest,discipline,6,3,3
Extremedp,blackwing-lair,288,priest,discipline,6,3,3
Oxicontin,sargeras,288,priest,discipline,6,3,3
Rocq,senjin,288,priest,discipline,6,3,3
Popeofhope,queldorei,288,priest,discipline,6,3,3
Hükk,kalecgos,288,priest,discipline,6,3,3
Xusin,tichondrius,288,priest,discipline,6,3,3
Bgundy,sargeras,288,priest,discipline,6,3,3
Lashelin,sargeras,288,priest,discipline,6,3,3
Midget,darkspear,288,priest,discipline,6,3,3
Chav,kiljaeden,288,priest,discipline,6,3,3
Xuxu,frostmourne,288,priest,discipline,6,3,3
Bigpoppapwn,darkspear,288,priest,discipline,6,3,3
Grafîx,frostmourne,288,priest,discipline,6,3,3
Aia,frostwolf,288,priest,discipline,6,3,3
Zuuji,frostmourne,288,priest,discipline,6,3,3
Khaospriest,proudmoore,288,priest,discipline,6,3,3
Wakandafev,frostmourne,288,priest,discipline,6,3,3
Swollenarms,kiljaeden,288,priest,discipline,6,3,3
Cheesemelt,kiljaeden,288,priest,discipline,6,3,3
Kawesha,emerald-dream,288,priest,discipline,6,3,3
Minatick,sargeras,288,priest,discipline,6,3,3
Nikci,tichondrius,288,priest,discipline,6,3,3
Demonsp,frostmourne,288,priest,discipline,6,3,3
Chazzyy,frostmourne,288,priest,discipline,6,3,3
Nokizzgrizz,sargeras,288,priest,discipline,6,3,3
Guillotine,azralon,288,priest,discipline,6,3,3
Jovon,frostmourne,288,priest,discipline,6,3,3
Oofx,darkspear,288,priest,discipline,6,3,3
Sasagui,bloodscalp,288,priest,discipline,6,3,3
Tmall,tichondrius,288,priest,discipline,6,3,3
Ìdiot,saurfang,288,priest,discipline,6,3,3
Leya,kiljaeden,288,priest,discipline,6,3,3
Illegalkill,tichondrius,288,priest,discipline,6,3,3
Nutdrip,tichondrius,288,priest,discipline,6,3,3
Mks,barthilas,288,priest,discipline,6,3,3
Imjheals,frostmourne,288,priest,discipline,6,3,3
Ìhatermp,tichondrius,288,priest,discipline,6,3,3
Chavvy,tichondrius,288,priest,discipline,6,3,3
Turdsyn,sargeras,288,priest,discipline,6,3,3
Buc,barthilas,288,priest,discipline,6,3,3
Diamondz,emerald-dream,288,priest,discipline,6,3,3
Fure,mannoroth,288,priest,discipline,6,3,3
Quefase,proudmoore,288,priest,discipline,6,3,3
Adelda,nazjatar,288,priest,discipline,6,3,3
Dìngobaby,stormrage,288,priest,discipline,6,3,3
Callèèn,stormrage,288,priest,discipline,6,3,3
Pumpkinpino,stormrage,288,priest,discipline,6,3,3
Benance,tichondrius,288,priest,discipline,6,3,3
Belarra,norgannon,288,priest,discipline,6,3,3
Relianth,stormrage,288,priest,discipline,6,3,3
Imagees,stormscale,288,priest,discipline,6,3,3
Zdarkspeedz,stormrage,288,priest,discipline,6,3,3
Ashidox,proudmoore,288,priest,discipline,6,3,3
Skyfury,darkspear,288,priest,discipline,6,3,3
Edmen,stormrage,288,priest,discipline,6,3,3
Humps,sargeras,288,priest,discipline,6,3,3
Zzavidwong,tichondrius,288,priest,discipline,6,3,3
Coerce,tichondrius,288,priest,discipline,6,3,3
Tethy,saurfang,288,priest,discipline,6,3,3
Tempname,thunderhorn,288,priest,discipline,6,3,3
Fouroneo,tichondrius,288,priest,discipline,6,3,3
Poøpoopeepee,tichondrius,288,priest,discipline,6,3,3
Healyhaney,stormrage,288,priest,discipline,6,3,3
Zeroghp,tichondrius,288,priest,discipline,6,3,3
Kleiâ,tichondrius,288,priest,discipline,6,3,3
Maniacx,stormrage,288,priest,discipline,6,3,3
Mesuki,malganis,288,priest,discipline,6,3,3
Reanimater,bronzebeard,288,priest,discipline,6,3,3
Bestworldxz,illidan,288,priest,discipline,6,3,3
Sarafem,lothar,288,priest,discipline,6,3,3
Éxploït,tichondrius,288,priest,discipline,6,3,3
Slottie,malganis,288,priest,discipline,6,3,3
Farnzz,malganis,288,priest,discipline,6,3,3
Nazgúl,lothar,288,priest,discipline,6,3,3
Deezdotz,alterac-mountains,288,priest,discipline,6,3,3
Rockdroid,illidan,288,priest,discipline,6,3,3
Drewsies,anvilmar,288,priest,discipline,6,3,3
Luminarylily,tichondrius,288,priest,discipline,6,3,3
Barackhobama,malganis,288,priest,discipline,6,3,3
Zaradomin,kelthuzad,288,priest,discipline,6,3,3
Illiteratex,sargeras,288,priest,discipline,6,3,3
Kiazma,zuljin,288,priest,discipline,6,3,3
Heratic,malganis,288,priest,discipline,6,3,3
Ayoheals,zuljin,288,priest,discipline,6,3,3
Milesa,korgath,288,priest,discipline,6,3,3
Prazph,quelthalas,288,priest,discipline,6,3,3
Julisof,quelthalas,288,priest,discipline,6,3,3
Vìxèn,zuljin,288,priest,discipline,6,3,3
Astraetus,zuljin,288,priest,discipline,6,3,3
Frye,bleeding-hollow,288,priest,discipline,6,3,3
Paradoxbot,kelthuzad,288,priest,discipline,6,3,3
Hellokuti,silvermoon,288,priest,discipline,6,3,3
Fackinheals,kelthuzad,288,priest,discipline,6,3,3
Drrunk,bleeding-hollow,288,priest,discipline,6,3,3
Sassygayboyx,bleeding-hollow,288,priest,discipline,6,3,3
Nizr,bleeding-hollow,288,priest,discipline,6,3,3
Zegron,rexxar,288,priest,discipline,6,3,3
Nevermyndz,bleeding-hollow,288,priest,discipline,6,3,3
Eiricka,kelthuzad,288,priest,discipline,6,3,3
Roseriela,moon-guard,288,priest,discipline,6,3,3
Lifeswaplol,kelthuzad,288,priest,discipline,6,3,3
Nyxvoid,ragnaros,288,priest,discipline,6,3,3
Powerchucha,area-52,288,priest,discipline,6,3,3
Zaxxriee,malganis,288,priest,discipline,6,3,3
Fausto,kiljaeden,288,priest,discipline,6,3,3
Athlete,magtheridon,288,priest,discipline,6,3,3
Lowfatsnack,aggramar,288,priest,discipline,6,3,3
Dredre,aggramar,288,priest,discipline,6,3,3
Animityz,illidan,288,priest,discipline,6,3,3
Mindmelts,gallywix,288,priest,discipline,6,3,3
Empyreanlite,dalaran,288,priest,discipline,6,3,3
Yogosun,dalaran,288,priest,discipline,6,3,3
Wiseguise,illidan,288,priest,discipline,6,3,3
Mingoms,illidan,288,priest,discipline,6,3,3
Strokingmydx,illidan,288,priest,discipline,6,3,3
Plzdonthitme,turalyon,288,priest,discipline,6,3,3
Idhealthat,tichondrius,288,priest,discipline,6,3,3
Dradinx,illidan,288,priest,discipline,6,3,3
Kovskii,blackrock,288,priest,discipline,6,3,3
Bessias,area-52,288,priest,discipline,6,3,3
Îcecube,sargeras,288,priest,discipline,6,3,3
Iamsatan,illidan,288,priest,discipline,6,3,3
Skeemask,moon-guard,288,priest,discipline,6,3,3
Drinkmymilk,hakkar,288,priest,discipline,6,3,3
Swinee,tichondrius,288,priest,discipline,6,3,3
Tsukihí,ragnaros,288,priest,discipline,6,3,3
Merylstreepz,illidan,288,priest,discipline,6,3,3
Kujoh,tichondrius,288,priest,discipline,6,3,3
Mindgamez,stormreaver,288,priest,discipline,6,3,3
Pwrwordthicc,illidan,288,priest,discipline,6,3,3
Hypoz,sargeras,288,priest,discipline,6,3,3
Shadowform,illidan,288,priest,discipline,6,3,3
Crocsnsocks,sargeras,288,priest,discipline,6,3,3
Boogiê,illidan,288,priest,discipline,6,3,3
Aspéct,aegwynn,288,priest,discipline,6,3,3
Anzulupriest,alexstrasza,288,priest,discipline,6,3,3
Havefaith,whisperwind,288,priest,discipline,6,3,3
Magicbus,blackrock,288,priest,discipline,6,3,3
Kaldoon,azjolnerub,288,priest,discipline,6,3,3
Sandreth,bonechewer,288,priest,discipline,6,3,3
Asilberixi,tichondrius,288,priest,discipline,6,3,3
Àneres,illidan,288,priest,discipline,6,3,3
Nellìel,whisperwind,288,priest,discipline,6,3,3
Keyohh,tichondrius,288,priest,discipline,6,3,3
Madalôn,nemesis,288,priest,discipline,6,3,3
Liminality,illidan,288,priest,discipline,6,3,3
Dumbthott,illidan,288,priest,discipline,6,3,3
Ææae,nemesis,288,priest,discipline,6,3,3
Mongatzuya,illidan,288,priest,discipline,6,3,3
Arythor,tichondrius,288,priest,discipline,6,3,3
Itzkü,malganis,288,priest,discipline,6,3,3
Alucardibee,turalyon,288,priest,discipline,6,3,3
Chigge,area-52,288,priest,discipline,6,3,3
Lostnthought,aggramar,288,priest,discipline,6,3,3
Numinous,wyrmrest-accord,288,priest,discipline,6,3,3
Rotnn,thrall,288,priest,discipline,6,3,3
Lyriczx,kelthuzad,288,priest,discipline,6,3,3
Isto,aegwynn,288,priest,discipline,6,3,3
Killduran,hellscream,288,priest,discipline,6,3,3
Kaiah,gorefiend,288,priest,discipline,6,3,3
Methandrial,hyjal,288,priest,discipline,6,3,3
Vanzera,thrall,288,priest,discipline,6,3,3
Ichheilen,thrall,288,priest,discipline,6,3,3
Jadpad,gorefiend,288,priest,discipline,6,3,3
Slaystation,wildhammer,288,priest,discipline,6,3,3
Painful,arathor,288,priest,discipline,6,3,3
Jüdaspriest,gorefiend,288,priest,discipline,6,3,3
Fadèd,wildhammer,288,priest,discipline,6,3,3
Bubblejunkie,lethon,288,priest,discipline,9,4,5
Whackagnome,kelthuzad,288,priest,discipline,9,4,5
Onegil,tichondrius,288,priest,discipline,7,3,4
Jjaeminkim,area-52,288,priest,discipline,19,7,12
Zodiá,dentarg,288,priest,discipline,14,4,10
Bubblez,gorefiend,288,priest,discipline,12,3,9
Kustem,tichondrius,288,priest,discipline,12,3,9
Sibble,deathwing,288,priest,discipline,12,3,9
Slackinhealz,thrall,288,priest,discipline,12,3,9
Nuaghtyheals,illidan,288,priest,discipline,12,3,9
Ricxaw,frostmourne,288,priest,discipline,12,3,9
Discfigured,tichondrius,288,priest,discipline,12,3,9
Gloomswrath,illidan,288,priest,discipline,12,3,9
Fitzop,frostmourne,288,priest,discipline,12,3,9
Die,crushridge,288,priest,discipline,12,3,9
Vandi,moon-guard,288,priest,discipline,12,3,9
Gwenoviere,whisperwind,288,priest,discipline,12,3,9
Realheal,tichondrius,288,priest,discipline,12,3,9
Járngreipr,nerzhul,288,priest,discipline,12,3,9
Lovebbw,sargeras,288,priest,discipline,12,3,9
Schüco,tichondrius,288,priest,discipline,12,3,9
Miliotis,sargeras,288,priest,discipline,12,3,9
Soleyxo,frostmourne,288,priest,discipline,12,3,9
Hokon,tortheldrin,288,priest,discipline,12,3,9
Phillyrivers,area-52,288,priest,discipline,12,3,9
Minzyx,tichondrius,288,priest,discipline,12,3,9
Doomageddon,thorium-brotherhood,288,priest,discipline,12,3,9
Virydian,stormrage,288,priest,discipline,12,3,9
Kurnak,arthas,288,priest,discipline,12,3,9
Twohpriest,aerie-peak,288,priest,discipline,12,3,9
Spampws,aerie-peak,288,priest,discipline,12,3,9
Devili,wyrmrest-accord,288,priest,discipline,12,3,9
Baldy,arthas,288,priest,discipline,12,3,9
Disconelf,barthilas,288,priest,discipline,12,3,9
Bewbeez,fizzcrank,288,priest,discipline,12,3,9
Paztech,arthas,288,priest,discipline,12,3,9
Zemms,tichondrius,288,priest,discipline,12,3,9
Chen,chogall,288,priest,discipline,12,3,9
Aoeprophet,area-52,288,priest,discipline,12,3,9
Healinghaze,tichondrius,288,priest,discipline,12,3,9
Awøaqexs,area-52,288,priest,discipline,12,3,9
Chaddadbod,emerald-dream,288,priest,discipline,12,3,9
Bobbybacala,velen,288,priest,discipline,12,3,9
Googus,bleeding-hollow,288,priest,discipline,12,3,9
Drhuhu,stormrage,288,priest,discipline,12,3,9
Bån,ragnaros,288,priest,discipline,12,3,9
Diviñetõuch,kelthuzad,288,priest,discipline,12,3,9
Toppers,bladefist,288,priest,discipline,12,3,9
Râven,proudmoore,288,priest,discipline,12,3,9
Skimpdubs,bleeding-hollow,288,priest,discipline,12,3,9
Ophindrip,zuljin,288,priest,discipline,12,3,9
Chubbsxo,proudmoore,288,priest,discipline,12,3,9
Lavéy,ragnaros,288,priest,discipline,12,3,9
Freák,zuljin,288,priest,discipline,12,3,9
Purify,sargeras,288,priest,discipline,12,3,9
Phantøms,zuljin,288,priest,discipline,12,3,9
Km,zuljin,288,priest,discipline,12,3,9
Hail,kaelthas,288,priest,discipline,12,3,9
Oyao,tichondrius,288,priest,discipline,12,3,9
Aaxahfon,moon-guard,288,priest,discipline,12,3,9
Dumplolz,quelthalas,288,priest,discipline,12,3,9
Xìdís,vashj,288,priest,discipline,12,3,9
Willica,stormrage,288,priest,discipline,12,3,9
Numinous,lothar,288,priest,discipline,12,3,9
Krewtoo,illidan,288,priest,discipline,12,3,9
Abefromann,sargeras,288,priest,discipline,12,3,9
Spspsp,illidan,288,priest,discipline,12,3,9
Pedialyte,kiljaeden,288,priest,discipline,12,3,9
Kaeso,magtheridon,288,priest,discipline,12,3,9
Shattgreen,malganis,288,priest,discipline,12,3,9
Muriaticacid,tichondrius,288,priest,discipline,12,3,9
Balooch,frostmourne,288,priest,discipline,14,3,11
Chirho,malganis,288,priest,discipline,18,3,15
Laneska,stormrage,288,priest,discipline,18,3,15
Pravant,illidan,288,priest,discipline,18,3,15
Pheegawn,proudmoore,288,priest,discipline,18,3,15
Zarøw,tichondrius,288,priest,discipline,24,3,21
Orchidp,tichondrius,2334,priest,shadow,300,185,115
Jennaôrtega,tichondrius,2321,priest,shadow,120,75,45
Pboo,tichondrius,2315,priest,shadow,78,49,29
Luvkak,tichondrius,2304,priest,shadow,100,55,45
Yeazy,stormrage,2296,priest,shadow,108,62,46
Kishoengi,sargeras,2238,priest,shadow,126,74,52
Disembly,illidan,2223,priest,shadow,87,50,37
Scandi,tichondrius,2215,priest,shadow,90,53,37
Edd,tichondrius,2215,priest,shadow,158,84,74
Yeona,tichondrius,2195,priest,shadow,101,60,41
Mearas,kelthuzad,2189,priest,shadow,88,52,36
Disemble,illidan,2186,priest,shadow,78,44,34
Techbadar,tichondrius,2185,priest,shadow,125,65,60
Targora,lightninghoof,2178,priest,shadow,156,88,68
Ejr,altar-of-storms,2172,priest,shadow,127,64,63
Apbrady,sargeras,2167,priest,shadow,126,67,59
Strwbrynaner,sargeras,2159,priest,shadow,186,99,87
Zçythe,tichondrius,2158,priest,shadow,84,51,33
Oohhmágáá,azralon,2157,priest,shadow,84,60,24
Painpaws,moon-guard,2154,priest,shadow,111,67,44
Louloudots,malganis,2141,priest,shadow,178,98,80
Moraver,kelthuzad,2141,priest,shadow,74,39,35
Healingstats,tichondrius,2137,priest,shadow,71,38,33
Zyrith,sargeras,2137,priest,shadow,111,58,53
Sin,guldan,2135,priest,shadow,395,214,181
Welplayedman,emerald-dream,2130,priest,shadow,88,53,35
Eradication,frostmourne,2129,priest,shadow,111,69,42
Geovanni,barthilas,2129,priest,shadow,101,52,49
Claudiosip,tichondrius,2127,priest,shadow,79,51,28
Zlipz,frostmourne,2125,priest,shadow,66,42,24
Amyyds,illidan,2124,priest,shadow,161,101,60
Palumorp,deathwing,2118,priest,shadow,90,57,33
Kottun,stormrage,2110,priest,shadow,66,38,28
Lìám,frostmourne,2110,priest,shadow,187,102,85
Kuraga,bleeding-hollow,2107,priest,shadow,386,210,176
Pdfileclass,tichondrius,2106,priest,shadow,72,47,25
Bayter,frostmourne,2105,priest,shadow,181,97,84
Yenïza,illidan,2104,priest,shadow,178,96,82
Alisasa,tichondrius,2083,priest,shadow,72,40,32
Omenx,emerald-dream,2078,priest,shadow,108,58,50
Spamndam,tichondrius,2076,priest,shadow,78,45,33
Dream,tichondrius,2066,priest,shadow,180,88,92
Vtp,frostmourne,2052,priest,shadow,116,66,50
Ombravuota,blades-edge,2052,priest,shadow,264,137,127
Swswswswsw,stormrage,2050,priest,shadow,107,68,39
Nekroscream,queldorei,2050,priest,shadow,95,53,42
Criminalsp,frostmourne,2050,priest,shadow,83,42,41
Xiaozhui,tichondrius,2046,priest,shadow,117,62,55
Laundryday,korgath,2043,priest,shadow,96,51,45
Shibuu,moon-guard,2024,priest,shadow,82,46,36
Pbxx,tichondrius,2018,priest,shadow,64,36,28
Cozies,stormreaver,2016,priest,shadow,166,89,77
Expr,area-52,2011,priest,shadow,120,65,55
Holydose,moon-guard,2004,priest,shadow,126,60,66
Gâdzêd,kelthuzad,2003,priest,shadow,62,38,24
Remixsp,malganis,1998,priest,shadow,60,33,27
Metasp,sargeras,1996,priest,shadow,96,51,45
Babyh,tichondrius,1994,priest,shadow,77,41,36
Royx,stormreaver,1993,priest,shadow,71,38,33
Bobbyvagene,area-52,1990,priest,shadow,92,46,46
Talbadar,tichondrius,1985,priest,shadow,90,54,36
Blackoss,sargeras,1985,priest,shadow,117,63,54
Bibleblak,stormrage,1982,priest,shadow,138,78,60
Gromkekz,area-52,1982,priest,shadow,131,67,64
Heheheg,tichondrius,1980,priest,shadow,173,86,87
Keygodx,illidan,1977,priest,shadow,60,36,24
Ivn,tichondrius,1977,priest,shadow,77,43,34
Kiriko,mannoroth,1977,priest,shadow,101,56,45
Viyana,stormrage,1977,priest,shadow,204,104,100
Erebusz,tichondrius,1976,priest,shadow,209,107,102
Yoggsarodney,tichondrius,1973,priest,shadow,49,32,17
Eunu,tichondrius,1967,priest,shadow,245,119,126
Delasoul,malganis,1965,priest,shadow,111,64,47
Mamísonga,ragnaros,1965,priest,shadow,71,35,36
Taylorsp,tichondrius,1964,priest,shadow,94,55,39
Aro,tichondrius,1964,priest,shadow,78,41,37
Maskali,tichondrius,1963,priest,shadow,262,126,136
Blax,stormscale,1959,priest,shadow,126,66,60
Urelz,illidan,1956,priest,shadow,30,21,9
Ousïa,quelthalas,1956,priest,shadow,135,67,68
Soapee,illidan,1955,priest,shadow,221,113,108
Stinkiez,area-52,1954,priest,shadow,270,142,128
Psyfiend,alterac-mountains,1953,priest,shadow,81,46,35
Greaterfade,stormrage,1952,priest,shadow,60,34,26
Jugeumx,proudmoore,1951,priest,shadow,66,36,30
Kydraah,ragnaros,1950,priest,shadow,71,41,30
Garpd,tichondrius,1947,priest,shadow,138,80,58
Niark,frostmourne,1946,priest,shadow,82,41,41
Wetleaftx,chogall,1945,priest,shadow,42,29,13
Zlips,frostmourne,1942,priest,shadow,116,54,62
Helmsman,tichondrius,1940,priest,shadow,224,117,107
Arobahn,tichondrius,1940,priest,shadow,148,76,72
Yberisa,zuljin,1936,priest,shadow,155,81,74
Fatherfeet,tichondrius,1932,priest,shadow,114,64,50
Nozp,stormrage,1930,priest,shadow,48,28,20
Ysuran,moon-guard,1930,priest,shadow,184,106,78
Puppyboyx,moon-guard,1929,priest,shadow,80,41,39
Katallyst,tichondrius,1926,priest,shadow,77,36,41
Dyrr,barthilas,1921,priest,shadow,221,106,115
Stresscube,tichondrius,1915,priest,shadow,46,28,18
Cheesëburg,illidan,1915,priest,shadow,54,28,26
Missyoung,tichondrius,1912,priest,shadow,73,42,31
Asmødeus,bleeding-hollow,1912,priest,shadow,101,54,47
Ilovevivien,spirestone,1911,priest,shadow,54,30,24
Voidkay,tichondrius,1908,priest,shadow,48,38,10
Ensanity,stormrage,1908,priest,shadow,149,76,73
Zlowbly,ragnaros,1904,priest,shadow,178,95,83
Vamp,proudmoore,1899,priest,shadow,82,52,30
Knowknow,tichondrius,1897,priest,shadow,144,71,73
Xaneo,kelthuzad,1895,priest,shadow,59,37,22
Ssupasonic,tichondrius,1880,priest,shadow,103,63,40
Mindblastx,kelthuzad,1880,priest,shadow,63,35,28
Netheerix,tichondrius,1879,priest,shadow,51,30,21
Metricdotem,terenas,1878,priest,shadow,48,30,18
Marfas,illidan,1878,priest,shadow,104,49,55
Johai,uldum,1873,priest,shadow,72,48,24
Nutdrip,tichondrius,1872,priest,shadow,47,28,19
Mythsnake,ragnaros,1872,priest,shadow,49,29,20
Soar,ravencrest,1872,priest,shadow,47,26,21
Drmuhammad,sargeras,1870,priest,shadow,46,28,18
Cmg,sargeras,1869,priest,shadow,60,31,29
Atarri,illidan,1868,priest,shadow,54,31,23
Creapture,zuluhed,1864,priest,shadow,42,24,18
Sênju,thrall,1864,priest,shadow,77,40,37
Xayp,kelthuzad,1863,priest,shadow,101,73,28
Theophobe,illidan,1862,priest,shadow,42,32,10
Wizkxjwap,tichondrius,1862,priest,shadow,36,24,12
Shortwombat,korgath,1860,priest,shadow,60,29,31
Christmasgal,uldum,1859,priest,shadow,30,27,3
Meehx,illidan,1859,priest,shadow,108,67,41
Fungame,malganis,1855,priest,shadow,50,35,15
Evenly,tichondrius,1855,priest,shadow,138,76,62
Itkev,area-52,1854,priest,shadow,35,27,8
Ericzssp,tichondrius,1854,priest,shadow,63,36,27
Bubbyflay,area-52,1853,priest,shadow,53,32,21
Couldntbeme,sargeras,1852,priest,shadow,54,31,23
Ussmissouri,area-52,1852,priest,shadow,235,126,109
Rileyreidx,ragnaros,1850,priest,shadow,48,32,16
Echoos,proudmoore,1849,priest,shadow,42,28,14
Nevertelsp,malganis,1848,priest,shadow,140,89,51
Bagjoe,illidan,1848,priest,shadow,212,112,100
Sodíum,wyrmrest-accord,1848,priest,shadow,107,51,56
Yoggismydad,emerald-dream,1847,priest,shadow,48,29,19
Wafflezsp,frostmourne,1847,priest,shadow,120,62,58
Derisha,ragnaros,1845,priest,shadow,128,71,57
Sapoopettas,quelthalas,1845,priest,shadow,54,26,28
Griffsp,sargeras,1844,priest,shadow,203,101,102
Xhadow,sargeras,1843,priest,shadow,96,50,46
Bornagain,gundrak,1843,priest,shadow,53,27,26
Vtplz,bleeding-hollow,1843,priest,shadow,65,33,32
Kattallyst,tichondrius,1842,priest,shadow,89,45,44
Psyphi,duskwood,1841,priest,shadow,84,40,44
Ayumihamaski,tichondrius,1840,priest,shadow,57,39,18
Voidgodtko,tichondrius,1840,priest,shadow,48,26,22
Tidals,sargeras,1839,priest,shadow,60,38,22
Dí,illidan,1839,priest,shadow,78,44,34
Soyul,tichondrius,1838,priest,shadow,114,64,50
Pnub,aggramar,1838,priest,shadow,65,34,31
Snoog,tichondrius,1837,priest,shadow,54,28,26
Keliarc,sargeras,1836,priest,shadow,102,54,48
Stunsilence,sargeras,1835,priest,shadow,42,23,19
Snookp,kiljaeden,1835,priest,shadow,267,139,128
Stankychimpo,malganis,1834,priest,shadow,54,32,22
Estéve,wyrmrest-accord,1834,priest,shadow,113,58,55
Niurouchuan,tichondrius,1834,priest,shadow,62,31,31
Furbog,area-52,1833,priest,shadow,42,31,11
Priestpogger,tichondrius,1831,priest,shadow,48,31,17
Phubar,stormreaver,1831,priest,shadow,78,34,44
Remedio,emerald-dream,1830,priest,shadow,33,21,12
Cøtt,emerald-dream,1829,priest,shadow,48,30,18
Doma,malganis,1829,priest,shadow,43,26,17
Yb,kelthuzad,1829,priest,shadow,54,32,22
Auttø,area-52,1829,priest,shadow,45,26,19
Maìden,sargeras,1829,priest,shadow,84,41,43
Kalantris,ragnaros,1828,priest,shadow,64,41,23
Throwshade,moon-guard,1828,priest,shadow,89,56,33
Giriosp,thrall,1827,priest,shadow,31,22,9
Kfcpriest,barthilas,1827,priest,shadow,54,26,28
Ventusp,azralon,1826,priest,shadow,105,61,44
Voiders,area-52,1826,priest,shadow,288,164,124
Celypriest,moon-guard,1825,priest,shadow,30,25,5
What,drakthul,1825,priest,shadow,54,35,19
Carbsauce,tichondrius,1825,priest,shadow,60,37,23
Ptam,tichondrius,1825,priest,shadow,47,26,21
Silero,dalaran,1824,priest,shadow,116,76,40
Idiotgarbage,moon-guard,1824,priest,shadow,48,26,22
Hÿperion,quelthalas,1823,priest,shadow,60,38,22
Insanity,azuremyst,1823,priest,shadow,137,77,60
Snòzberry,illidan,1822,priest,shadow,66,36,30
Samsypriest,frostmourne,1821,priest,shadow,64,38,26
Mindslips,tichondrius,1821,priest,shadow,144,82,62
Bearoom,frostmourne,1820,priest,shadow,66,39,27
Plaguesus,dalaran,1820,priest,shadow,64,35,29
Nhela,kelthuzad,1820,priest,shadow,60,29,31
Vil,lightnings-blade,1819,priest,shadow,90,50,40
Ellindria,spinebreaker,1818,priest,shadow,95,57,38
Peggable,moon-guard,1818,priest,shadow,59,32,27
Disxlyec,barthilas,1817,priest,shadow,142,79,63
Dots,tichondrius,1816,priest,shadow,53,33,20
Katarot,area-52,1816,priest,shadow,51,30,21
Discipline,chogall,1816,priest,shadow,48,26,22
Hollister,illidan,1816,priest,shadow,246,132,114
Havocshadows,deathwing,1815,priest,shadow,94,58,36
Jeseck,quelthalas,1815,priest,shadow,110,59,51
Blissily,sargeras,1814,priest,shadow,75,47,28
Manic,skywall,1814,priest,shadow,168,96,72
Irasponsible,stormrage,1814,priest,shadow,42,23,19
Holytalk,tichondrius,1814,priest,shadow,60,30,30
Drupith,dalaran,1814,priest,shadow,54,27,27
Nawzyh,emerald-dream,1813,priest,shadow,48,26,22
Melonsoda,stormrage,1813,priest,shadow,48,26,22
Headbrake,malganis,1813,priest,shadow,54,26,28
Resonator,laughing-skull,1813,priest,shadow,46,22,24
Invain,executus,1812,priest,shadow,30,24,6
Felrynpr,malganis,1811,priest,shadow,47,28,19
Chazzwizz,area-52,1811,priest,shadow,48,26,22
Ðantex,thrall,1811,priest,shadow,296,155,141
Xannè,tichondrius,1811,priest,shadow,60,30,30
Relapse,emerald-dream,1810,priest,shadow,36,25,11
Tomcruisé,zuljin,1810,priest,shadow,54,31,23
Llamabush,malganis,1809,priest,shadow,39,26,13
Doublesix,malganis,1809,priest,shadow,72,43,29
Brokenspc,tichondrius,1809,priest,shadow,148,80,68
Krelaeren,tichondrius,1809,priest,shadow,65,33,32
Cixelpvp,area-52,1809,priest,shadow,54,26,28
Arthrix,sargeras,1807,priest,shadow,72,46,26
Bumps,zuljin,1807,priest,shadow,76,43,33
Inflate,frostmourne,1807,priest,shadow,114,62,52
Esteedees,bonechewer,1807,priest,shadow,132,71,61
Mindgoblin,terokkar,1807,priest,shadow,96,48,48
Ericxd,area-52,1807,priest,shadow,77,38,39
Edai,malganis,1806,priest,shadow,229,124,105
Exoticfather,stormrage,1806,priest,shadow,66,33,33
Dispel,agamaggan,1805,priest,shadow,32,24,8
Ghostz,alleria,1805,priest,shadow,60,39,21
Invincible,ragnaros,1805,priest,shadow,72,41,31
Jomm,area-52,1805,priest,shadow,69,37,32
Brickzyhehe,dalaran,1805,priest,shadow,113,58,55
Naosoupriest,azralon,1804,priest,shadow,53,40,13
Healingstat,tichondrius,1804,priest,shadow,39,25,14
Secrèt,tichondrius,1804,priest,shadow,30,19,11
Manofmystery,dalaran,1804,priest,shadow,48,28,20
Bearzugzug,frostmourne,1803,priest,shadow,36,23,13
Panndaz,tichondrius,1803,priest,shadow,30,19,11
Inmotion,tichondrius,1803,priest,shadow,30,19,11
Euthanasìa,deathwing,1803,priest,shadow,70,31,39
Potatopriest,stormrage,1802,priest,shadow,42,31,11
Korrà,turalyon,1802,priest,shadow,30,19,11
Dilonpi,area-52,1801,priest,shadow,66,47,19
Eclipsë,malganis,1800,priest,shadow,24,19,5
Sheiizy,azralon,1800,priest,shadow,90,52,38
Hástür,quelthalas,1797,priest,shadow,151,82,69
Darkvagician,malganis,1797,priest,shadow,47,25,22
Jojotwo,illidan,1794,priest,shadow,102,52,50
Sleepynuj,stormrage,1792,priest,shadow,78,48,30
Axelrod,tichondrius,1792,priest,shadow,48,29,19
Deuz,quelthalas,1789,priest,shadow,220,113,107
Jthreetx,kelthuzad,1788,priest,shadow,40,23,17
Zhiwanam,tichondrius,1786,priest,shadow,59,34,25
Lillyp,malganis,1786,priest,shadow,42,21,21
Milan,dalaran,1784,priest,shadow,93,57,36
Jydge,tichondrius,1780,priest,shadow,39,22,17
Pengwinxl,agamaggan,1779,priest,shadow,48,25,23
Almycn,tichondrius,1776,priest,shadow,56,30,26
Plztrainme,spinebreaker,1776,priest,shadow,124,65,59
Ayniah,tichondrius,1775,priest,shadow,46,22,24
Pinguisursi,kelthuzad,1774,priest,shadow,36,27,9
Míslead,kelthuzad,1771,priest,shadow,36,27,9
Shadowforsho,sargeras,1771,priest,shadow,64,30,34
Griffsp,stormrage,1765,priest,shadow,77,44,33
Kovie,twisting-nether,1758,priest,shadow,206,119,87
Keser,kelthuzad,1758,priest,shadow,40,22,18
Krovnp,stormrage,1756,priest,shadow,36,24,12
Orgasmiq,frostmourne,1755,priest,shadow,84,45,39
Eklunð,proudmoore,1754,priest,shadow,53,28,25
Afromon,suramar,1750,priest,shadow,72,45,27
Mepisth,sargeras,1748,priest,shadow,72,46,26
Sukes,korgath,1747,priest,shadow,150,82,68
Zanthix,tichondrius,1745,priest,shadow,54,26,28
Impérial,stormrage,1744,priest,shadow,179,107,72
Mindburn,nemesis,1742,priest,shadow,84,38,46
Shalla,blackrock,1740,priest,shadow,96,53,43
Bhadbhaabie,lethon,1738,priest,shadow,24,19,5
Emopriestqt,tichondrius,1737,priest,shadow,144,79,65
Saevita,area-52,1737,priest,shadow,66,34,32
Iceveins,illidan,1736,priest,shadow,46,27,19
Ticklefingrs,malganis,1734,priest,shadow,60,35,25
Tamajka,the-forgotten-coast,1734,priest,shadow,117,57,60
Plushys,emerald-dream,1733,priest,shadow,66,44,22
Shelize,kirin-tor,1732,priest,shadow,307,156,151
Laokele,tichondrius,1731,priest,shadow,48,29,19
Dildocrates,darkspear,1730,priest,shadow,48,28,20
Messiahp,illidan,1730,priest,shadow,53,25,28
Aristedes,thrall,1729,priest,shadow,35,20,15
Dispèrsion,darkspear,1729,priest,shadow,88,42,46
Xmewo,sargeras,1728,priest,shadow,41,25,16
Lebronjâmes,tichondrius,1726,priest,shadow,42,25,17
Dxsc,tichondrius,1725,priest,shadow,72,41,31
Drohung,sargeras,1723,priest,shadow,54,30,24
Pesca,proudmoore,1721,priest,shadow,90,47,43
Moralism,moon-guard,1719,priest,shadow,235,135,100
Brokentrojan,moon-guard,1718,priest,shadow,48,23,25
Perfectz,stormrage,1716,priest,shadow,42,24,18
Álvarez,tichondrius,1716,priest,shadow,110,56,54
Soný,stormrage,1715,priest,shadow,69,38,31
Saintjudys,tichondrius,1714,priest,shadow,36,23,13
Brownie,blackrock,1713,priest,shadow,41,23,18
Krytical,illidan,1710,priest,shadow,166,97,69
Alyndral,illidan,1710,priest,shadow,78,43,35
Nishishabi,tichondrius,1707,priest,shadow,48,24,24
Finfangfoom,laughing-skull,1707,priest,shadow,69,33,36
Thaumaturgy,chogall,1706,priest,shadow,48,25,23
Cathery,tichondrius,1704,priest,shadow,36,18,18
Tidbitsy,malganis,1704,priest,shadow,151,71,80
Snuffp,sargeras,1703,priest,shadow,125,81,44
Jessticalz,frostmourne,1703,priest,shadow,48,24,24
Shwayp,zuljin,1702,priest,shadow,36,22,14
Moonideli,moon-guard,1702,priest,shadow,49,29,20
Twoboo,bleeding-hollow,1701,priest,shadow,72,40,32
Antìdote,tichondrius,1700,priest,shadow,176,101,75
Darkenside,moon-guard,1699,priest,shadow,48,28,20
Akuvurá,nemesis,1699,priest,shadow,137,78,59
Ddark,tichondrius,1697,priest,shadow,66,41,25
Palmerin,ravencrest,1697,priest,shadow,102,53,49
Cavaliersr,ragnaros,1696,priest,shadow,90,53,37
Badbwoi,frostmourne,1696,priest,shadow,61,29,32
Nvøsuperstar,zuljin,1695,priest,shadow,72,37,35
Nickdeath,tichondrius,1694,priest,shadow,54,28,26
Mockr,kiljaeden,1693,priest,shadow,138,76,62
Ikillfast,tichondrius,1692,priest,shadow,174,98,76
Shadelink,tichondrius,1692,priest,shadow,42,22,20
Madcaddies,bonechewer,1691,priest,shadow,108,53,55
Arion,wyrmrest-accord,1689,priest,shadow,54,35,19
Crbandit,moon-guard,1688,priest,shadow,103,62,41
Sinning,kelthuzad,1686,priest,shadow,24,18,6
Rizzle,emerald-dream,1684,priest,shadow,76,46,30
Holyxb,bleeding-hollow,1683,priest,shadow,137,76,61
Giveheadpats,moon-guard,1683,priest,shadow,222,121,101
Iuka,emerald-dream,1683,priest,shadow,183,96,87
Hadoka,ragnaros,1682,priest,shadow,28,19,9
Nonamegame,sargeras,1681,priest,shadow,106,60,46
Pettypriest,dalaran,1680,priest,shadow,195,102,93
Himikko,illidan,1680,priest,shadow,40,19,21
Alykus,emerald-dream,1679,priest,shadow,58,30,28
Silkyx,tichondrius,1679,priest,shadow,36,18,18
Yayonaise,tichondrius,1678,priest,shadow,36,21,15
Delbringer,moon-guard,1678,priest,shadow,152,84,68
Fxxkdamn,tichondrius,1676,priest,shadow,35,23,12
Woodney,ragnaros,1676,priest,shadow,30,19,11
Kultil,dalaran,1676,priest,shadow,84,49,35
Littlewench,sargeras,1676,priest,shadow,86,49,37
Girthed,bloodscalp,1676,priest,shadow,92,48,44
Crayon,stormrage,1676,priest,shadow,48,25,23
Tsmc,moon-guard,1675,priest,shadow,96,51,45
Evx,demon-soul,1673,priest,shadow,96,50,46
Sochron,stormrage,1672,priest,shadow,128,67,61
Dirtyysanta,tichondrius,1671,priest,shadow,40,24,16
Clownface,tichondrius,1671,priest,shadow,42,24,18
Lauretânia,nemesis,1670,priest,shadow,84,41,43
Fantasía,moon-guard,1670,priest,shadow,114,54,60
Shadowblastx,sargeras,1668,priest,shadow,54,31,23
Desaros,tichondrius,1668,priest,shadow,102,52,50
Darkness,azralon,1668,priest,shadow,61,29,32
Saintpleb,sargeras,1667,priest,shadow,137,82,55
Slasheal,caelestrasz,1666,priest,shadow,90,47,43
Lucsor,malganis,1665,priest,shadow,109,58,51
Nuggs,mannoroth,1665,priest,shadow,42,21,21
Luzira,stormrage,1662,priest,shadow,42,25,17
Xdipi,proudmoore,1662,priest,shadow,44,25,19
Swaggylee,tichondrius,1661,priest,shadow,40,22,18
Avraf,sargeras,1660,priest,shadow,42,20,22
Mscleo,lothar,1660,priest,shadow,173,81,92
Qreckful,proudmoore,1658,priest,shadow,34,22,12
Zachlol,area-52,1658,priest,shadow,66,36,30
Cheereos,stormrage,1657,priest,shadow,42,27,15
Deadsp,thrall,1657,priest,shadow,115,58,57
Shadowkr,tichondrius,1656,priest,shadow,42,26,16
Uploading,moon-guard,1655,priest,shadow,30,19,11
Pluse,bonechewer,1655,priest,shadow,52,31,21
Raptorjésus,azjolnerub,1654,priest,shadow,42,22,20
Ilovealina,gorefiend,1653,priest,shadow,30,21,9
Nottonightqt,barthilas,1652,priest,shadow,42,26,16
Priestzerath,azralon,1652,priest,shadow,69,38,31
Shadowlife,bonechewer,1652,priest,shadow,62,33,29
Djcyrus,barthilas,1652,priest,shadow,54,28,26
Ðemi,zuljin,1652,priest,shadow,108,55,53
Brothofnzoth,emerald-dream,1651,priest,shadow,118,63,55
Nevermôre,area-52,1650,priest,shadow,54,36,18
Vaporachi,emerald-dream,1650,priest,shadow,42,28,14
Dovoso,kargath,1650,priest,shadow,54,30,24
Skrillô,emerald-dream,1650,priest,shadow,53,27,26
Fenix,bloodhoof,1650,priest,shadow,52,25,27
Caricius,ravenholdt,1649,priest,shadow,36,20,16
Jags,area-52,1648,priest,shadow,48,19,29
Docbek,illidan,1647,priest,shadow,44,28,16
Griddly,alterac-mountains,1646,priest,shadow,72,41,31
Partypriest,tichondrius,1646,priest,shadow,71,39,32
Mimósa,quelthalas,1645,priest,shadow,49,29,20
Painful,malganis,1645,priest,shadow,62,36,26
Salvate,tichondrius,1645,priest,shadow,42,24,18
Amarexlol,stormrage,1645,priest,shadow,66,37,29
Imabeast,stormrage,1644,priest,shadow,71,39,32
Vashrapani,stormrage,1644,priest,shadow,273,141,132
Sigx,area-52,1643,priest,shadow,30,21,9
Gaymalenurse,sargeras,1643,priest,shadow,48,25,23
Swungzebra,stormrage,1642,priest,shadow,140,83,57
Destta,stormrage,1641,priest,shadow,34,19,15
Voidazepam,zuljin,1641,priest,shadow,96,53,43
Deeaann,tichondrius,1641,priest,shadow,304,162,142
Ajazz,zuljin,1640,priest,shadow,42,27,15
Trenbologni,illidan,1639,priest,shadow,174,99,75
Folesian,tichondrius,1638,priest,shadow,54,31,23
Despairx,tichondrius,1638,priest,shadow,36,19,17
Nullreferenc,frostmourne,1637,priest,shadow,81,45,36
Scarabless,bleeding-hollow,1637,priest,shadow,90,47,43
Pumpss,area-52,1636,priest,shadow,73,41,32
Fancycorpse,tichondrius,1635,priest,shadow,60,27,33
Alip,tichondrius,1633,priest,shadow,64,41,23
Gìdem,aggramar,1633,priest,shadow,33,19,14
Evelën,azralon,1633,priest,shadow,42,22,20
Grimdox,tichondrius,1631,priest,shadow,48,36,12
Aqurielen,turalyon,1631,priest,shadow,71,45,26
Cixelp,area-52,1631,priest,shadow,42,23,19
Mushill,tichondrius,1631,priest,shadow,102,51,51
Safe,illidan,1629,priest,shadow,97,51,46
Sempiternus,barthilas,1628,priest,shadow,46,24,22
Kurindrize,illidan,1627,priest,shadow,30,18,12
Sarâda,moon-guard,1626,priest,shadow,177,95,82
Fireballingg,tichondrius,1625,priest,shadow,30,18,12
Ightdoe,zuljin,1624,priest,shadow,57,36,21
Whysoserious,duskwood,1624,priest,shadow,30,17,13
Coral,stormscale,1624,priest,shadow,53,30,23
Dontpvponme,illidan,1623,priest,shadow,36,24,12
Mêdúsa,area-52,1621,priest,shadow,58,30,28
Dorraheals,tichondrius,1620,priest,shadow,41,22,19
Rhick,azralon,1619,priest,shadow,83,52,31
Solstunn,moon-guard,1619,priest,shadow,48,24,24
Ilostmybible,quelthalas,1619,priest,shadow,46,23,23
Gershwinner,daggerspine,1619,priest,shadow,36,17,19
Iogical,kelthuzad,1618,priest,shadow,116,70,46
Hurtfeet,sargeras,1618,priest,shadow,90,45,45
Thenamesnorm,tichondrius,1617,priest,shadow,59,36,23
Dustnbonez,area-52,1617,priest,shadow,36,20,16
Sècret,tichondrius,1617,priest,shadow,40,20,20
Darkestzell,azralon,1616,priest,shadow,41,20,21
Drossv,shadowmoon,1614,priest,shadow,42,20,22
Healzium,blackwater-raiders,1613,priest,shadow,56,28,28
Vallfiresp,malganis,1612,priest,shadow,40,22,18
Biubiubium,tichondrius,1611,priest,shadow,42,26,16
Gineska,tichondrius,1611,priest,shadow,36,22,14
Pegwraith,sargeras,1611,priest,shadow,41,25,16
Snackabre,moon-guard,1611,priest,shadow,36,20,16
Benjamints,thrall,1610,priest,shadow,104,61,43
Crazyherb,azralon,1610,priest,shadow,125,70,55
Cxrsed,illidan,1610,priest,shadow,42,22,20
Jeffgordo,tichondrius,1609,priest,shadow,86,52,34
Kwõnc,tichondrius,1609,priest,shadow,56,29,27
Warklaw,frostmourne,1609,priest,shadow,72,34,38
Nodoubt,barthilas,1609,priest,shadow,58,26,32
Adopted,wyrmrest-accord,1608,priest,shadow,66,37,29
Wenger,crushridge,1608,priest,shadow,138,70,68
Methandrial,hyjal,1607,priest,shadow,129,70,59
Shmage,malganis,1606,priest,shadow,54,28,26
Ludapriest,moon-guard,1606,priest,shadow,42,21,21
Likesshadows,tichondrius,1605,priest,shadow,84,57,27
Moc,jubeithos,1605,priest,shadow,36,22,14
Fight,icecrown,1605,priest,shadow,60,33,27
Cyanovoid,thrall,1605,priest,shadow,48,26,22
Bubbzy,daggerspine,1605,priest,shadow,60,31,29
Gelato,velen,1605,priest,shadow,36,17,19
Krooked,kelthuzad,1604,priest,shadow,84,53,31
Hriest,tichondrius,1604,priest,shadow,42,23,19
Shadowdurps,area-52,1604,priest,shadow,66,36,30
Murkqz,stormrage,1604,priest,shadow,54,29,25
Clamchowdy,kiljaeden,1603,priest,shadow,27,18,9
Ayooblitz,guldan,1603,priest,shadow,42,26,16
Scalpell,tichondrius,1603,priest,shadow,263,135,128
Fâêlyn,wyrmrest-accord,1603,priest,shadow,94,46,48
Shadork,area-52,1602,priest,shadow,49,31,18
Cloax,azgalor,1602,priest,shadow,48,29,19
Aspéct,aegwynn,1602,priest,shadow,30,17,13
Hotphoyou,moon-guard,1600,priest,shadow,60,39,21
Manifestor,illidan,1600,priest,shadow,86,51,35
Machinecoach,stormrage,1600,priest,shadow,40,20,20
Gusho,frostmourne,1599,priest,shadow,175,88,87
Wifegrip,tichondrius,1598,priest,shadow,42,19,23
Ranthrough,tichondrius,1597,priest,shadow,78,48,30
Radicional,azralon,1596,priest,shadow,36,20,16
Minamy,tichondrius,1593,priest,shadow,30,17,13
Priestine,dreadmaul,1593,priest,shadow,168,86,82
Rhoku,nesingwary,1592,priest,shadow,74,43,31
Ulqüiorra,azralon,1592,priest,shadow,42,23,19
Graviton,tichondrius,1591,priest,shadow,72,40,32
Xæl,tichondrius,1587,priest,shadow,96,60,36
Shadowzypher,wyrmrest-accord,1586,priest,shadow,42,23,19
Nihenben,illidan,1586,priest,shadow,72,38,34
Chillypriest,azjolnerub,1585,priest,shadow,42,23,19
Nexumbra,dunemaul,1585,priest,shadow,120,64,56
Fluttershÿ,ragnaros,1584,priest,shadow,54,28,26
Lolshadow,amanthul,1584,priest,shadow,78,39,39
Occult,bloodscalp,1584,priest,shadow,99,48,51
Faedyspriest,sargeras,1581,priest,shadow,42,23,19
Pepps,proudmoore,1581,priest,shadow,572,294,278
Greyyan,wyrmrest-accord,1580,priest,shadow,279,152,127
Vaala,jubeithos,1580,priest,shadow,60,30,30
Thiazine,kiljaeden,1578,priest,shadow,33,26,7
Teddipriest,tichondrius,1578,priest,shadow,35,19,16
Dillydackx,sargeras,1577,priest,shadow,114,61,53
Voltétt,tichondrius,1576,priest,shadow,38,20,18
Brotherrob,area-52,1576,priest,shadow,65,34,31
Whitehandpr,tichondrius,1576,priest,shadow,402,204,198
Brothercarl,stormrage,1576,priest,shadow,48,24,24
Darkshadows,ravenholdt,1575,priest,shadow,30,20,10
Çummiñs,malganis,1575,priest,shadow,36,21,15
Kaldrir,malganis,1574,priest,shadow,42,27,15
Boogiê,illidan,1574,priest,shadow,114,64,50
Heàvenly,moon-guard,1573,priest,shadow,36,21,15
Bandages,stormreaver,1573,priest,shadow,109,58,51
Ratleen,malganis,1570,priest,shadow,212,103,109
Mealmassttr,frostmourne,1569,priest,shadow,42,21,21
Raahsty,malganis,1569,priest,shadow,36,17,19
Nizeurflayzz,tichondrius,1568,priest,shadow,56,32,24
Milkgrabber,bleeding-hollow,1567,priest,shadow,145,77,68
Sorrentin,ragnaros,1566,priest,shadow,64,34,30
Amentia,area-52,1565,priest,shadow,36,20,16
Xiphoidz,frostmourne,1562,priest,shadow,49,23,26
Iminyou,kelthuzad,1561,priest,shadow,84,50,34
Voidork,tichondrius,1560,priest,shadow,42,26,16
Healypants,eonar,1560,priest,shadow,41,23,18
Bugsbright,tichondrius,1560,priest,shadow,177,96,81
Frankeebutt,stormrage,1559,priest,shadow,54,33,21
Vicara,moon-guard,1559,priest,shadow,101,50,51
Ethandryl,kelthuzad,1558,priest,shadow,39,23,16
Dahliá,frostmourne,1558,priest,shadow,83,45,38
Alex,boulderfist,1557,priest,shadow,54,31,23
Nightelffeet,stormrage,1557,priest,shadow,30,17,13
Voidshift,tichondrius,1556,priest,shadow,336,171,165
Sìnz,area-52,1555,priest,shadow,36,26,10
Hieken,nemesis,1555,priest,shadow,64,38,26
Dottydaddy,emerald-dream,1554,priest,shadow,36,24,12
Juicymist,moon-guard,1554,priest,shadow,276,153,123
Fig,nazgrel,1554,priest,shadow,84,42,42
Nightcráwler,illidan,1553,priest,shadow,42,25,17
Rhima,tichondrius,1552,priest,shadow,24,17,7
Tënëbrë,nemesis,1552,priest,shadow,73,43,30
Vyabl,thrall,1552,priest,shadow,48,25,23
Krazé,tichondrius,1552,priest,shadow,78,39,39
Sindawen,kiljaeden,1551,priest,shadow,66,38,28
Suicider,emerald-dream,1550,priest,shadow,188,95,93
Volkova,quelthalas,1549,priest,shadow,30,19,11
Softs,area-52,1549,priest,shadow,83,42,41
Deiz,tichondrius,1549,priest,shadow,36,18,18
Kuazi,frostmourne,1548,priest,shadow,42,24,18
Proudigy,lightninghoof,1547,priest,shadow,93,54,39
Ibringgears,tichondrius,1547,priest,shadow,91,47,44
Relicsa,proudmoore,1547,priest,shadow,71,36,35
Terranle,tichondrius,1545,priest,shadow,124,63,61
Nøfaith,area-52,1544,priest,shadow,118,53,65
Khelleya,moon-guard,1543,priest,shadow,48,26,22
Toddmund,tichondrius,1543,priest,shadow,167,84,83
Powerwordcry,stormrage,1542,priest,shadow,60,32,28
Suery,hyjal,1542,priest,shadow,84,37,47
Deffaultz,turalyon,1541,priest,shadow,58,34,24
Abientot,tichondrius,1539,priest,shadow,84,47,37
Stepho,dalaran,1539,priest,shadow,42,19,23
Bigboyadam,frostmourne,1538,priest,shadow,88,55,33
Lilithice,moon-guard,1537,priest,shadow,48,25,23
Carniosso,azralon,1537,priest,shadow,134,69,65
Faeinia,elune,1534,priest,shadow,105,61,44
Mightyp,malganis,1534,priest,shadow,42,19,23
Jah,frostmourne,1533,priest,shadow,30,16,14
Aethestan,zuljin,1533,priest,shadow,83,37,46
Irangara,gorefiend,1532,priest,shadow,50,25,25
Anrop,illidan,1531,priest,shadow,48,31,17
Dotdotwin,illidan,1531,priest,shadow,71,43,28
Dikdik,tichondrius,1531,priest,shadow,75,42,33
Originull,emerald-dream,1531,priest,shadow,30,16,14
Iuvrainee,area-52,1531,priest,shadow,96,50,46
Debbie,cairne,1527,priest,shadow,54,32,22
Büd,sargeras,1527,priest,shadow,30,17,13
Slogger,illidan,1527,priest,shadow,35,17,18
Tutuhx,quelthalas,1526,priest,shadow,24,16,8
Skgangmm,tichondrius,1526,priest,shadow,29,18,11
Púrg,frostmourne,1526,priest,shadow,42,24,18
Jojoxxz,illidan,1526,priest,shadow,49,27,22
Purpskurp,stormrage,1525,priest,shadow,42,20,22
Teddysedai,tichondrius,1524,priest,shadow,24,16,8
Jmanhealz,stormrage,1523,priest,shadow,24,16,8
Mellow,tichondrius,1523,priest,shadow,44,24,20
Beckðn,tichondrius,1523,priest,shadow,94,50,44
Ravinny,nemesis,1523,priest,shadow,64,32,32
Slottie,malganis,1521,priest,shadow,42,21,21
Márceline,stormrage,1520,priest,shadow,64,40,24
Emlix,tichondrius,1520,priest,shadow,86,46,40
Spriesto,frostmourne,1520,priest,shadow,35,18,17
Tíosam,ragnaros,1519,priest,shadow,30,16,14
Xannis,thrall,1517,priest,shadow,68,38,30
Pestee,quelthalas,1517,priest,shadow,167,93,74
Pics,emerald-dream,1517,priest,shadow,46,25,21
Keepitlegal,sargeras,1515,priest,shadow,30,16,14
Èvil,tichondrius,1514,priest,shadow,24,16,8
Zhadowbolts,thrall,1514,priest,shadow,41,20,21
Kadralin,illidan,1513,priest,shadow,84,45,39
Shadowflux,thunderlord,1512,priest,shadow,42,17,25
Theorym,tichondrius,1509,priest,shadow,46,32,14
Popejack,stormrage,1509,priest,shadow,45,24,21
Thelordx,barthilas,1507,priest,shadow,66,34,32
Amideus,dunemaul,1507,priest,shadow,42,18,24
Lowkii,malfurion,1505,priest,shadow,63,41,22
Wobbleskank,tichondrius,1505,priest,shadow,84,50,34
Shadylotion,stormrage,1505,priest,shadow,30,16,14
Prickled,zuljin,1505,priest,shadow,91,46,45
Krythe,laughing-skull,1505,priest,shadow,41,19,22
Csheweishan,aerie-peak,1504,priest,shadow,84,44,40
Justfaith,barthilas,1504,priest,shadow,73,35,38
Aeonar,alleria,1503,priest,shadow,57,34,23
Lucael,durotan,1503,priest,shadow,60,33,27
Shadowhazed,tichondrius,1503,priest,shadow,42,23,19
Twistedtéa,garrosh,1503,priest,shadow,42,20,22
Dreaminz,tichondrius,1501,priest,shadow,30,17,13
Shadowthief,magtheridon,1501,priest,shadow,30,16,14
Vynlanesh,illidan,1501,priest,shadow,132,65,67
Danoc,tichondrius,1500,priest,shadow,108,53,55
Marantbourge,frostmourne,1499,priest,shadow,108,65,43
Goodlife,frostmourne,1499,priest,shadow,36,16,20
Bullma,boulderfist,1494,priest,shadow,22,17,5
Irritated,vashj,1494,priest,shadow,24,16,8
Creedence,jubeithos,1493,priest,shadow,65,33,32
Dischaffy,shadowmoon,1491,priest,shadow,42,29,13
Bradythree,moon-guard,1491,priest,shadow,30,19,11
Yeeko,kiljaeden,1491,priest,shadow,30,17,13
Palutena,drakkari,1491,priest,shadow,42,22,20
Nekkz,sargeras,1490,priest,shadow,29,21,8
Stellur,kelthuzad,1490,priest,shadow,29,18,11
Azheel,stormrage,1490,priest,shadow,65,26,39
Harisleidy,quelthalas,1488,priest,shadow,50,28,22
Uncletouches,thrall,1488,priest,shadow,58,31,27
Fïonan,proudmoore,1488,priest,shadow,72,35,37
Ivyslays,area-52,1487,priest,shadow,77,42,35
Cpoppa,sargeras,1487,priest,shadow,72,39,33
Suirr,tichondrius,1486,priest,shadow,36,22,14
Bestwizardx,tichondrius,1484,priest,shadow,33,21,12
Propumper,dalaran,1483,priest,shadow,47,27,20
Numinous,wyrmrest-accord,1483,priest,shadow,74,39,35
Revóra,kelthuzad,1478,priest,shadow,84,51,33
Øbara,frostmourne,1478,priest,shadow,105,57,48
Razzamun,lothar,1478,priest,shadow,36,19,17
Azagthøth,ravenholdt,1478,priest,shadow,239,122,117
Swp,sargeras,1476,priest,shadow,48,29,19
Teeprie,drakthul,1476,priest,shadow,58,35,23
Hypochondria,moon-guard,1475,priest,shadow,51,31,20
Astoshan,moon-guard,1475,priest,shadow,125,73,52
Arataxx,area-52,1474,priest,shadow,66,32,34
Halselin,senjin,1471,priest,shadow,124,75,49
Jeanbi,ragnaros,1469,priest,shadow,150,81,69
Zeromisx,proudmoore,1469,priest,shadow,34,16,18
Rida,zuljin,1467,priest,shadow,50,31,19
Allsmite,aerie-peak,1467,priest,shadow,54,29,25
Shädë,emerald-dream,1467,priest,shadow,54,23,31
Shadowbee,kargath,1466,priest,shadow,32,18,14
Eraseme,bleeding-hollow,1466,priest,shadow,36,18,18
Olrightt,stormrage,1465,priest,shadow,36,19,17
Cuaiminator,ragnaros,1463,priest,shadow,87,47,40
Stivche,frostmourne,1463,priest,shadow,39,19,20
Shadeven,nagrand,1463,priest,shadow,39,18,21
Muurielle,quelthalas,1462,priest,shadow,183,96,87
Plzdontlos,hyjal,1461,priest,shadow,36,22,14
Fritzi,shattered-hand,1456,priest,shadow,30,17,13
Healtheze,kelthuzad,1456,priest,shadow,44,22,22
Maynard,ragnaros,1455,priest,shadow,101,55,46
Whorticiå,area-52,1455,priest,shadow,161,76,85
Malikeht,drakkari,1453,priest,shadow,60,33,27
Mikeysp,tichondrius,1453,priest,shadow,48,26,22
Sînkaî,demon-soul,1453,priest,shadow,166,88,78
Ghedeloco,tichondrius,1451,priest,shadow,30,18,12
Creata,frostmourne,1450,priest,shadow,25,16,9
Spoõks,darkspear,1449,priest,shadow,50,21,29
Kilal,sargeras,1445,priest,shadow,36,24,12
Zatthanea,hellscream,1445,priest,shadow,24,16,8
Grizzlysmite,stormrage,1445,priest,shadow,37,17,20
Sezyks,stormrage,1444,priest,shadow,30,23,7
Aghorï,sargeras,1444,priest,shadow,86,42,44
Lelyna,stormrage,1443,priest,shadow,46,27,19
Plebcakès,sargeras,1441,priest,shadow,55,28,27
Wdnmmd,proudmoore,1441,priest,shadow,157,76,81
Vizioz,tichondrius,1441,priest,shadow,36,16,20
Kokai,area-52,1440,priest,shadow,18,15,3
Mentalprison,khazgoroth,1439,priest,shadow,30,15,15
Nüt,malganis,1437,priest,shadow,53,29,24
Dawnkìn,bleeding-hollow,1437,priest,shadow,138,72,66
ßarracuda,illidan,1436,priest,shadow,114,65,49
Onegil,tichondrius,1436,priest,shadow,75,38,37
Comana,frostmourne,1435,priest,shadow,18,15,3
Moistfather,kelthuzad,1435,priest,shadow,47,29,18
Theodorous,frostmourne,1435,priest,shadow,63,34,29
Papadoll,malganis,1435,priest,shadow,38,20,18
Mindfulness,tichondrius,1434,priest,shadow,24,15,9
Bbeaie,tichondrius,1433,priest,shadow,30,15,15
Ezrashade,tichondrius,1433,priest,shadow,95,44,51
Cartus,emerald-dream,1432,priest,shadow,36,21,15
Duatneter,quelthalas,1432,priest,shadow,66,38,28
Niias,hyjal,1432,priest,shadow,87,50,37
Stromile,tichondrius,1431,priest,shadow,24,17,7
Årann,azralon,1431,priest,shadow,24,15,9
Covidchamp,proudmoore,1431,priest,shadow,24,15,9
Ciem,tichondrius,1431,priest,shadow,24,15,9
Spacethug,illidan,1431,priest,shadow,30,15,15
Fadedatm,illidan,1431,priest,shadow,36,15,21
Umbrah,veknilash,1430,priest,shadow,24,15,9
Wowgreatgame,tichondrius,1430,priest,shadow,59,31,28
Kellsyo,hyjal,1429,priest,shadow,18,15,3
Yuhstin,sargeras,1429,priest,shadow,24,15,9
Synkiz,darkspear,1428,priest,shadow,95,51,44
Sandrö,sargeras,1427,priest,shadow,24,15,9
Supremezx,frostmourne,1427,priest,shadow,78,42,36
Aguitardient,ragnaros,1426,priest,shadow,33,19,14
Stusy,tichondrius,1425,priest,shadow,71,44,27
Younext,sargeras,1425,priest,shadow,63,22,41
Mitoloshi,ragnaros,1424,priest,shadow,42,19,23
Zarøw,tichondrius,1423,priest,shadow,24,15,9
Corthien,thrall,1422,priest,shadow,18,15,3
Frorgnence,stormrage,1422,priest,shadow,36,26,10
Fathersmits,area-52,1422,priest,shadow,24,15,9
Anmu,illidan,1418,priest,shadow,29,16,13
Lilmix,hydraxis,1417,priest,shadow,41,26,15
Rotass,hyjal,1415,priest,shadow,23,16,7
Strokkerx,azralon,1414,priest,shadow,110,59,51
Moogyvoid,tichondrius,1414,priest,shadow,42,19,23
Ramaven,arygos,1413,priest,shadow,78,39,39
Showakoi,ragnaros,1412,priest,shadow,54,29,25
Xammys,malganis,1410,priest,shadow,41,26,15
Pastortee,sargeras,1409,priest,shadow,65,35,30
Flickmybick,sargeras,1409,priest,shadow,93,44,49
Wongÿ,tichondrius,1408,priest,shadow,30,24,6
Sandelios,aggramar,1408,priest,shadow,42,28,14
Shadzie,sargeras,1408,priest,shadow,53,30,23
Vílja,moon-guard,1407,priest,shadow,135,68,67
Chewthefat,darkspear,1406,priest,shadow,29,15,14
Londy,area-52,1405,priest,shadow,477,238,239
ßroßraßroski,sargeras,1403,priest,shadow,42,24,18
Ed,crushridge,1402,priest,shadow,53,30,23
Bastét,skullcrusher,1402,priest,shadow,108,60,48
Ampela,dalaran,1402,priest,shadow,63,33,30
Shirubamoya,gurubashi,1401,priest,shadow,41,23,18
Pandarue,tichondrius,1401,priest,shadow,87,47,40
Zeroghp,tichondrius,1401,priest,shadow,30,15,15
Mindboink,malganis,1400,priest,shadow,82,44,38
Chibii,kelthuzad,1398,priest,shadow,24,22,2
Seedisc,kelthuzad,1398,priest,shadow,51,30,21
Kuazi,khazgoroth,1398,priest,shadow,125,59,66
Aabye,nemesis,1397,priest,shadow,23,16,7
Imhðtep,ragnaros,1397,priest,shadow,84,40,44
Aedaki,garona,1396,priest,shadow,154,85,69
Naieth,aerie-peak,1396,priest,shadow,45,20,25
Grianné,mannoroth,1395,priest,shadow,30,20,10
Scarsdeath,azralon,1395,priest,shadow,52,27,25
Elogant,frostmourne,1395,priest,shadow,112,47,65
Haø,stormrage,1393,priest,shadow,98,50,48
Ashtahius,ragnaros,1392,priest,shadow,113,65,48
Habann,frostmourne,1392,priest,shadow,140,71,69
Nyctelis,sargeras,1392,priest,shadow,40,19,21
Fzz,tichondrius,1391,priest,shadow,29,16,13
Daysgone,bleeding-hollow,1391,priest,shadow,293,154,139
Holyren,sargeras,1391,priest,shadow,68,31,37
Constentien,tichondrius,1390,priest,shadow,30,16,14
Dipírex,azralon,1389,priest,shadow,84,40,44
Mindeas,the-forgotten-coast,1387,priest,shadow,32,15,17
Barelylegalx,tichondrius,1387,priest,shadow,36,16,20
Fäÿë,tichondrius,1386,priest,shadow,54,26,28
Vinasky,moon-guard,1386,priest,shadow,38,16,22
Achíllesheal,stormrage,1385,priest,shadow,101,53,48
Bloodify,azralon,1385,priest,shadow,53,26,27
Healztonic,dalaran,1380,priest,shadow,72,32,40
Tye,medivh,1378,priest,shadow,30,15,15
Bigmollet,tichondrius,1378,priest,shadow,90,37,53
Lawgiva,thrall,1377,priest,shadow,30,19,11
Jadon,sargeras,1377,priest,shadow,38,22,16
Xtcbtc,sargeras,1376,priest,shadow,29,15,14
Miniimenx,azralon,1375,priest,shadow,41,29,12
Voidscrypt,thrall,1374,priest,shadow,106,62,44
Saphet,draktharon,1373,priest,shadow,94,58,36
Coors,lightnings-blade,1371,priest,shadow,30,15,15
ßluedreamx,tichondrius,1370,priest,shadow,23,15,8
Urspareparts,sargeras,1370,priest,shadow,89,48,41
Onixió,ragnaros,1369,priest,shadow,30,15,15
Sylvane,silvermoon,1368,priest,shadow,53,31,22
Spõõky,illidan,1368,priest,shadow,26,15,11
Xionys,sargeras,1368,priest,shadow,60,29,31
Tyisanity,tichondrius,1368,priest,shadow,68,32,36
Stellaryn,moon-guard,1368,priest,shadow,42,17,25
Bûdussy,bonechewer,1366,priest,shadow,73,36,37
Saltheril,burning-blade,1366,priest,shadow,37,18,19
Aránhell,ragnaros,1365,priest,shadow,48,28,20
Nucypher,illidan,1365,priest,shadow,39,17,22
Luminous,moon-guard,1364,priest,shadow,32,18,14
Lolcrafthd,ragnaros,1364,priest,shadow,30,16,14
Scenekîd,moon-guard,1364,priest,shadow,42,20,22
Heihunüwang,kargath,1363,priest,shadow,26,15,11
Phantomz,malganis,1362,priest,shadow,47,30,17
Chaas,ragnaros,1361,priest,shadow,114,59,55
Scadie,goldrinn,1360,priest,shadow,30,15,15
Manofmystery,drenden,1359,priest,shadow,23,15,8
Alvorr,ragnaros,1359,priest,shadow,76,41,35
Shén,barthilas,1358,priest,shadow,95,61,34
Mãstermerlin,frostmourne,1358,priest,shadow,41,20,21
Beloriath,ragnaros,1356,priest,shadow,29,15,14
Irilde,proudmoore,1356,priest,shadow,42,21,21
Icytaken,frostmourne,1353,priest,shadow,48,22,26
Discobish,sargeras,1350,priest,shadow,30,17,13
Andso,azralon,1348,priest,shadow,36,17,19
Janesville,tichondrius,1345,priest,shadow,24,16,8
Littlebagel,nesingwary,1344,priest,shadow,57,32,25
Poague,area-52,1343,priest,shadow,24,14,10
Brwnricetuna,frostmourne,1343,priest,shadow,27,15,12
Task,korgath,1343,priest,shadow,41,18,23
Mcbot,illidan,1342,priest,shadow,18,14,4
Ukishizumi,tichondrius,1342,priest,shadow,18,14,4
Flay,dragonmaw,1342,priest,shadow,18,14,4
Cixelp,tichondrius,1342,priest,shadow,30,14,16
Duckdemon,ragnaros,1341,priest,shadow,101,49,52
Yåmi,arthas,1340,priest,shadow,18,14,4
Mudkrab,gundrak,1340,priest,shadow,18,14,4
Pwrwordsquee,lightbringer,1339,priest,shadow,24,14,10
Antorieth,area-52,1339,priest,shadow,24,14,10
Verbeka,nemesis,1338,priest,shadow,18,14,4
Cptnrockwèll,dalaran,1337,priest,shadow,98,53,45
Labraidor,tichondrius,1336,priest,shadow,105,44,61
Qadris,tichondrius,1336,priest,shadow,36,14,22
Nobutter,archimonde,1335,priest,shadow,24,14,10
Scriptö,fizzcrank,1334,priest,shadow,72,47,25
Pikeysplol,illidan,1334,priest,shadow,24,14,10
Hüde,stormrage,1334,priest,shadow,102,53,49
Osmatspriest,firetree,1334,priest,shadow,33,15,18
Boogle,frostmourne,1333,priest,shadow,59,26,33
Chenny,darkspear,1332,priest,shadow,72,40,32
Zeas,moon-guard,1331,priest,shadow,42,23,19
Ellipses,bleeding-hollow,1331,priest,shadow,30,14,16
Jhivagosp,tichondrius,1331,priest,shadow,34,15,19
Leach,darkspear,1330,priest,shadow,77,33,44
Nyktøs,quelthalas,1326,priest,shadow,42,18,24
Nòemis,quelthalas,1325,priest,shadow,24,14,10
Sacerthu,goldrinn,1325,priest,shadow,36,20,16
Brshki,tichondrius,1324,priest,shadow,18,14,4
Bibledave,whisperwind,1323,priest,shadow,33,17,16
Reverendpope,tichondrius,1323,priest,shadow,48,19,29
Badnfluence,kiljaeden,1322,priest,shadow,30,17,13
Onipapae,frostmourne,1321,priest,shadow,113,58,55
Pacmanlol,greymane,1319,priest,shadow,18,14,4
Shadyvoodoo,barthilas,1319,priest,shadow,104,54,50
Gnow,moon-guard,1319,priest,shadow,65,32,33
Faithplusone,zuljin,1318,priest,shadow,24,15,9
Mortivore,azralon,1318,priest,shadow,30,14,16
Maniwa,dentarg,1317,priest,shadow,42,15,27
Chádeervas,nemesis,1315,priest,shadow,39,24,15
Etan,thrall,1314,priest,shadow,85,44,41
Rammstèin,sargeras,1314,priest,shadow,30,14,16
Lirien,kelthuzad,1312,priest,shadow,56,20,36
Timreaper,barthilas,1311,priest,shadow,41,24,17
Vanisa,hellscream,1309,priest,shadow,53,29,24
Eskettit,korgath,1308,priest,shadow,24,14,10
Alisaie,dalvengyr,1308,priest,shadow,52,27,25
Uvebeendead,the-forgotten-coast,1306,priest,shadow,72,42,30
Goodvybz,illidan,1306,priest,shadow,44,18,26
Shadowtreta,azralon,1305,priest,shadow,42,26,16
Bigvoidman,area-52,1305,priest,shadow,36,15,21
Roylwcheese,illidan,1304,priest,shadow,24,16,8
Kflexx,hydraxis,1303,priest,shadow,24,15,9
Ilumus,lightnings-blade,1300,priest,shadow,24,14,10
Dioscura,malganis,1298,priest,shadow,26,15,11
Zyræl,stormrage,1298,priest,shadow,125,59,66
Sekhen,area-52,1298,priest,shadow,49,23,26
Bustmybubble,tichondrius,1297,priest,shadow,50,34,16
Mamofwar,arthas,1296,priest,shadow,66,29,37
Bobbeans,area-52,1295,priest,shadow,30,18,12
Øvøxø,emerald-dream,1295,priest,shadow,33,15,18
Blindingstar,area-52,1294,priest,shadow,17,14,3
Beautifulgir,illidan,1294,priest,shadow,30,18,12
Reos,jubeithos,1294,priest,shadow,54,32,22
Minðgãmès,illidan,1291,priest,shadow,21,15,6
Ancene,illidan,1290,priest,shadow,42,24,18
Àx,draka,1290,priest,shadow,32,18,14
Hervert,area-52,1289,priest,shadow,36,19,17
Estelars,aggramar,1289,priest,shadow,210,109,101
Thotsndots,blood-furnace,1288,priest,shadow,26,15,11
Tjxx,zuljin,1287,priest,shadow,72,36,36
Lilpika,illidan,1283,priest,shadow,66,31,35
Puerquirri,quelthalas,1280,priest,shadow,36,19,17
Likeleela,azshara,1279,priest,shadow,89,42,47
Valloren,kalecgos,1278,priest,shadow,26,15,11
Ketchuslipin,illidan,1277,priest,shadow,62,27,35
Abolita,korgath,1276,priest,shadow,120,65,55
Alphawon,area-52,1276,priest,shadow,105,51,54
Omenous,area-52,1276,priest,shadow,52,22,30
Furìøns,nemesis,1275,priest,shadow,24,15,9
Ralphiez,tichondrius,1273,priest,shadow,52,27,25
Marni,akama,1272,priest,shadow,91,42,49
Healixd,area-52,1271,priest,shadow,36,14,22
Shadøwheal,stormrage,1269,priest,shadow,36,22,14
Layrissa,whisperwind,1266,priest,shadow,24,15,9
Pozcas,blood-furnace,1265,priest,shadow,24,14,10
Lyriczx,kelthuzad,1265,priest,shadow,42,18,24
Maricotä,azralon,1263,priest,shadow,36,21,15
Festær,area-52,1258,priest,shadow,64,34,30
Synergize,korgath,1254,priest,shadow,60,30,30
Raoel,proudmoore,1253,priest,shadow,24,15,9
Stankylegz,tichondrius,1251,priest,shadow,30,16,14
Zolgeta,exodar,1250,priest,shadow,47,31,16
Gothii,tichondrius,1250,priest,shadow,47,16,31
Zinr,tichondrius,1249,priest,shadow,36,16,20
Jwx,malganis,1248,priest,shadow,18,13,5
Verbane,frostmourne,1248,priest,shadow,24,13,11
Madcuzyaknow,bleeding-hollow,1248,priest,shadow,24,13,11
Envyion,sargeras,1248,priest,shadow,24,13,11
Kristt,thrall,1247,priest,shadow,168,76,92
Keicel,zuljin,1246,priest,shadow,24,13,11
Quinlan,dreadmaul,1246,priest,shadow,40,19,21
Bubblepop,blackhand,1245,priest,shadow,18,13,5
Demples,darkspear,1245,priest,shadow,30,20,10
Cheez,tichondrius,1245,priest,shadow,100,43,57
Fanfansp,tichondrius,1244,priest,shadow,18,13,5
Sakuraginero,illidan,1243,priest,shadow,24,13,11
Shadowjisha,emerald-dream,1243,priest,shadow,33,14,19
Aeingel,amanthul,1243,priest,shadow,47,16,31
Pri,jubeithos,1242,priest,shadow,18,13,5
Ashidox,proudmoore,1242,priest,shadow,27,14,13
Nonbinary,trollbane,1242,priest,shadow,30,14,16
Shadhoee,sargeras,1242,priest,shadow,36,13,23
Jexso,tichondrius,1242,priest,shadow,37,13,24
Houzz,frostmourne,1241,priest,shadow,18,13,5
Xarid,moon-guard,1240,priest,shadow,24,13,11
Xedus,mannoroth,1240,priest,shadow,74,37,37
Nóin,tichondrius,1240,priest,shadow,83,34,49
Shådøw,destromath,1239,priest,shadow,24,13,11
Rucati,cenarius,1239,priest,shadow,39,17,22
Ascian,daggerspine,1239,priest,shadow,30,13,17
Dilly,tichondrius,1238,priest,shadow,21,14,7
Csonka,stormrage,1238,priest,shadow,44,17,27
Xijinping,chogall,1237,priest,shadow,24,13,11
Kàiju,zuljin,1237,priest,shadow,42,19,23
Nums,tichondrius,1236,priest,shadow,48,25,23
Rykispriest,tichondrius,1234,priest,shadow,18,13,5
Dernièreplac,blackrock,1234,priest,shadow,27,16,11
Shadowyeti,illidan,1233,priest,shadow,18,13,5
Cykle,blackrock,1233,priest,shadow,42,13,29
Dockavok,bloodhoof,1232,priest,shadow,18,13,5
Mortemus,drenden,1232,priest,shadow,26,16,10
Hephiron,area-52,1232,priest,shadow,63,25,38
Jiedx,tichondrius,1230,priest,shadow,35,14,21
Elam,ragnaros,1229,priest,shadow,53,19,34
Boill,illidan,1228,priest,shadow,18,13,5
Fadedvoid,malorne,1228,priest,shadow,18,13,5
Cowabungá,azralon,1227,priest,shadow,18,13,5
Kaermor,stormrage,1227,priest,shadow,66,28,38
Simplyfaded,black-dragonflight,1226,priest,shadow,24,13,11
Pfl,area-52,1226,priest,shadow,146,71,75
Payan,barthilas,1224,priest,shadow,54,27,27
Bmô,stormrage,1223,priest,shadow,53,24,29
Antoz,kelthuzad,1222,priest,shadow,49,28,21
Chinchillin,demon-soul,1222,priest,shadow,171,89,82
Brokenpriest,wyrmrest-accord,1220,priest,shadow,51,22,29
Mindraker,turalyon,1217,priest,shadow,18,13,5
Shinyspriest,tichondrius,1212,priest,shadow,89,44,45
Sorrowful,mannoroth,1208,priest,shadow,29,13,16
Castnngcouch,tichondrius,1207,priest,shadow,42,21,21
Tylored,zuljin,1205,priest,shadow,42,16,26
Discpi,illidan,1202,priest,shadow,78,34,44
Senumbra,tichondrius,1200,priest,shadow,36,16,20
Overcastedxo,kelthuzad,1199,priest,shadow,68,40,28
Holydarkness,quelthalas,1196,priest,shadow,65,27,38
Hairypenance,sargeras,1194,priest,shadow,23,13,10
Dockani,sargeras,1194,priest,shadow,66,31,35
Whisper,zuljin,1190,priest,shadow,43,23,20
Lùcìd,dalaran,1189,priest,shadow,24,17,7
Foli,zuljin,1187,priest,shadow,22,14,8
Moon,moonrunner,1186,priest,shadow,47,23,24
Aflstan,frostmourne,1185,priest,shadow,57,34,23
Locjawbe,area-52,1183,priest,shadow,65,29,36
Pristoleiro,azralon,1182,priest,shadow,17,13,4
Anathamaz,stormrage,1182,priest,shadow,36,13,23
Fullfear,lothar,1178,priest,shadow,26,13,13
Darksheals,barthilas,1176,priest,shadow,30,22,8
Mankbadar,tichondrius,1174,priest,shadow,34,13,21
Vynardis,arygos,1173,priest,shadow,61,27,34
Urmorphine,area-52,1170,priest,shadow,209,109,100
Zelashan,proudmoore,1170,priest,shadow,30,14,16
Thedarkshade,area-52,1168,priest,shadow,45,28,17
Pootzy,malganis,1166,priest,shadow,25,13,12
Amestroada,nemesis,1166,priest,shadow,27,14,13
Tanthdrel,proudmoore,1166,priest,shadow,36,18,18
Agraciada,illidan,1164,priest,shadow,57,32,25
Beneficium,nazjatar,1163,priest,shadow,66,35,31
Yaann,zuljin,1162,priest,shadow,42,22,20
Trollypriest,darkspear,1157,priest,shadow,94,44,50
Snakklè,illidan,1152,priest,shadow,18,13,5
Taxzury,tichondrius,1152,priest,shadow,18,12,6
Mmys,tichondrius,1152,priest,shadow,24,12,12
Flamédøtz,ragnaros,1151,priest,shadow,18,12,6
Wojangles,zuljin,1151,priest,shadow,18,12,6
Haracka,quelthalas,1151,priest,shadow,24,12,12
Mindtrip,korgath,1151,priest,shadow,54,23,31
Rmpmeeper,kilrogg,1150,priest,shadow,12,12,0
Airil,mugthol,1150,priest,shadow,18,12,6
Calientaeggs,drakkari,1150,priest,shadow,18,12,6
Shadowp,shattered-halls,1150,priest,shadow,24,12,12
Bàttlepriest,caelestrasz,1150,priest,shadow,36,16,20
Nùm,tichondrius,1147,priest,shadow,21,13,8
Fouroneo,tichondrius,1146,priest,shadow,24,12,12
Teccalil,tichondrius,1146,priest,shadow,24,12,12
Abednego,area-52,1145,priest,shadow,21,13,8
Growth,fizzcrank,1145,priest,shadow,24,12,12
Nktxc,tichondrius,1145,priest,shadow,24,12,12
Dayquills,illidan,1145,priest,shadow,24,12,12
Lidole,barthilas,1145,priest,shadow,30,12,18
Kk,fizzcrank,1144,priest,shadow,24,12,12
Omnivoîd,tichondrius,1144,priest,shadow,24,12,12
Luokni,illidan,1143,priest,shadow,18,12,6
Dralaan,proudmoore,1143,priest,shadow,43,26,17
Îcecube,sargeras,1142,priest,shadow,24,12,12
ßuffysummer,illidan,1141,priest,shadow,30,12,18
Srenity,zuljin,1140,priest,shadow,24,12,12
Kibariyb,drakkari,1139,priest,shadow,30,12,18
Faithhealing,zuljin,1136,priest,shadow,86,42,44
Unholyreáper,magtheridon,1132,priest,shadow,24,12,12
Kundalini,boulderfist,1132,priest,shadow,35,16,19
Vvti,quelthalas,1125,priest,shadow,28,15,13
Lilmermaid,laughing-skull,1118,priest,shadow,24,12,12
Saura,aegwynn,1111,priest,shadow,22,12,10
Knglizward,stormrage,1110,priest,shadow,71,38,33
Matafuka,ragnaros,1109,priest,shadow,88,44,44
Ëlliot,stormrage,1104,priest,shadow,33,15,18
Võid,tichondrius,1103,priest,shadow,23,12,11
Shämus,dalaran,1097,priest,shadow,82,41,41
Thrilas,silver-hand,1092,priest,shadow,24,12,12
Misslost,nerzhul,1081,priest,shadow,23,12,11
Ssphex,tichondrius,1076,priest,shadow,48,26,22
Khaibit,stormrage,1073,priest,shadow,39,23,16
Scormm,runetotem,1073,priest,shadow,24,13,11
Pestî,area-52,1073,priest,shadow,54,20,34
Lyxorr,area-52,1068,priest,shadow,30,12,18
Galice,archimonde,1066,priest,shadow,66,33,33
Eslaughter,twisting-nether,1061,priest,shadow,24,16,8
Valeknun,stormrage,1060,priest,shadow,36,24,12
Khenshin,ragnaros,1058,priest,shadow,59,31,28
Freebolte,frostmourne,1056,priest,shadow,12,11,1
Lastbubble,area-52,1056,priest,shadow,24,11,13
Hakirn,bleeding-hollow,1055,priest,shadow,12,11,1
Patagoniabae,kelthuzad,1055,priest,shadow,12,11,1
Mitogen,malganis,1055,priest,shadow,18,11,7
Icychain,area-52,1055,priest,shadow,18,11,7
Bearuwu,frostmourne,1055,priest,shadow,24,11,13
Sleezi,emerald-dream,1054,priest,shadow,18,11,7
Plenipotent,moon-guard,1054,priest,shadow,26,15,11
Roterick,wyrmrest-accord,1053,priest,shadow,18,11,7
Xdlolqt,sargeras,1053,priest,shadow,24,11,13
Eatmyspells,malganis,1053,priest,shadow,24,11,13
Voidhearted,tichondrius,1053,priest,shadow,30,11,19
Abnormality,trollbane,1052,priest,shadow,12,11,1
Talkura,tichondrius,1052,priest,shadow,12,11,1
Tydïus,illidan,1052,priest,shadow,18,11,7
Bhruno,proudmoore,1052,priest,shadow,18,11,7
Fancyspork,illidan,1052,priest,shadow,24,11,13
Legitgayirl,zuljin,1052,priest,shadow,24,11,13
Féarlust,demon-soul,1051,priest,shadow,18,11,7
Nerfmehard,tichondrius,1050,priest,shadow,18,11,7
Norbon,mugthol,1050,priest,shadow,18,11,7
Oldmanlou,spirestone,1049,priest,shadow,18,11,7
Milojac,hyjal,1049,priest,shadow,18,11,7
Semillion,tichondrius,1049,priest,shadow,24,11,13
Jilt,aerie-peak,1048,priest,shadow,24,11,13
Tinypuppyy,sargeras,1047,priest,shadow,37,14,23
Nocturnalx,moon-guard,1045,priest,shadow,18,11,7
Luzsombraa,stormrage,1042,priest,shadow,24,11,13
Bec,khadgar,1042,priest,shadow,24,11,13
Shadynasti,azshara,1041,priest,shadow,24,14,10
Kushie,saurfang,1039,priest,shadow,24,11,13
Floofball,medivh,1038,priest,shadow,18,11,7
Demoñ,deathwing,1035,priest,shadow,24,11,13
Alzu,ragnaros,1023,priest,shadow,23,11,12
Thaedreu,area-52,1022,priest,shadow,29,11,18
Oglilptown,thunderlord,1005,priest,shadow,60,33,27
Angro,ragnaros,1005,priest,shadow,24,13,11
Ipse,azshara,1004,priest,shadow,84,46,38
Fedodesubaco,gallywix,1004,priest,shadow,51,27,24
Nadrii,illidan,1002,priest,shadow,36,17,19
Sinkz,ragnaros,992,priest,shadow,16,11,5
Pocket,alleria,991,priest,shadow,22,11,11
Janke,malganis,990,priest,shadow,20,11,9
Coolbie,korgath,990,priest,shadow,26,11,15
Daemoon,deathwing,973,priest,shadow,20,12,8
Oxytoxin,sargeras,971,priest,shadow,19,11,8
Soonya,arygos,966,priest,shadow,27,12,15
Discountay,burning-legion,965,priest,shadow,20,11,9
Robhàlford,ragnaros,964,priest,shadow,25,11,14
Insindious,sargeras,963,priest,shadow,15,12,3
Mmrassassin,stormrage,960,priest,shadow,12,10,2
Icarryozz,darkspear,960,priest,shadow,12,10,2
Abc,spirestone,960,priest,shadow,12,10,2
Shadowkenlol,tichondrius,960,priest,shadow,23,13,10
Kong,shandris,960,priest,shadow,18,10,8
Anoumenon,tichondrius,960,priest,shadow,18,10,8
Kissmyvoìd,frostmourne,960,priest,shadow,18,10,8
Pèrona,tichondrius,960,priest,shadow,18,10,8
Jugeum,proudmoore,960,priest,shadow,18,10,8
Plumpkinn,kiljaeden,960,priest,shadow,18,10,8
Evilgeniusx,area-52,960,priest,shadow,18,10,8
Rendoss,arathor,959,priest,shadow,12,10,2
Synergia,drakkari,959,priest,shadow,12,10,2
Inflìctìøn,frostmourne,959,priest,shadow,12,10,2
Jahz,zuljin,959,priest,shadow,12,10,2
Diyel,area-52,959,priest,shadow,12,10,2
Xtradotz,tichondrius,959,priest,shadow,18,10,8
Bestpimp,frostmane,959,priest,shadow,18,10,8
Saitii,dalaran,959,priest,shadow,18,10,8
Ayzen,emerald-dream,959,priest,shadow,18,10,8
Delai,dalaran,959,priest,shadow,18,10,8
Vixova,illidan,959,priest,shadow,18,10,8
Philmacrakn,stormrage,959,priest,shadow,18,10,8
Luciellis,sargeras,959,priest,shadow,18,10,8
Iamjakehill,area-52,959,priest,shadow,18,10,8
Keepsleepin,stormrage,959,priest,shadow,24,10,14
Terý,dalaran,959,priest,shadow,24,10,14
Vikingkøng,ragnaros,958,priest,shadow,12,10,2
Felskie,tichondrius,958,priest,shadow,12,10,2
Deckx,khazgoroth,958,priest,shadow,16,11,5
Bratty,hellscream,958,priest,shadow,15,10,5
Cerriôus,baelgun,958,priest,shadow,18,10,8
Porffy,malygos,958,priest,shadow,18,10,8
Deawalker,khaz-modan,958,priest,shadow,18,10,8
Tatzis,frostmourne,958,priest,shadow,18,10,8
Iggyp,hyjal,958,priest,shadow,18,10,8
Caramelos,moon-guard,958,priest,shadow,24,10,14
Exigyo,quelthalas,957,priest,shadow,23,13,10
Hecáte,dalaran,957,priest,shadow,18,10,8
Holyfüry,ragnaros,956,priest,shadow,12,10,2
Dyé,hydraxis,956,priest,shadow,18,10,8
Såx,stormreaver,956,priest,shadow,24,10,14
Gankdalf,draktharon,955,priest,shadow,18,10,8
Mathertia,dalaran,954,priest,shadow,18,10,8
Mettz,malganis,954,priest,shadow,18,10,8
Slctivhealng,area-52,954,priest,shadow,18,10,8
Lätöxïkä,alleria,954,priest,shadow,24,10,14
Ragnálodbrok,ragnaros,953,priest,shadow,18,10,8
Xora,frostmourne,952,priest,shadow,18,10,8
Fearmongrol,bleeding-hollow,950,priest,shadow,24,10,14
Hitful,azralon,949,priest,shadow,12,10,2
Cymin,dalaran,943,priest,shadow,25,12,13
Farnkxd,bleeding-hollow,925,priest,shadow,32,11,21
Rassalor,frostmane,910,priest,shadow,17,10,7
Flaytonmanin,korgath,910,priest,shadow,21,10,11
Thrageqt,sargeras,908,priest,shadow,20,11,9
Silmeriá,darkspear,904,priest,shadow,29,11,18
Ràvn,emerald-dream,903,priest,shadow,16,12,4
Beeds,sargeras,902,priest,shadow,105,44,61
Khall,sargeras,895,priest,shadow,40,17,23
Exen,moon-guard,894,priest,shadow,18,11,7
Battlepope,the-scryers,890,priest,shadow,31,14,17
Berixa,stormscale,883,priest,shadow,11,10,1
Datcuban,illidan,874,priest,shadow,20,11,9
Lockerest,sargeras,868,priest,shadow,41,13,28
Æë,area-52,864,priest,shadow,12,9,3
Beibeihang,tichondrius,864,priest,shadow,12,9,3
Nutdrip,kelthuzad,864,priest,shadow,12,9,3
Jâmïè,gurubashi,864,priest,shadow,12,9,3
Feverx,tichondrius,864,priest,shadow,12,9,3
Powerwordhim,malganis,864,priest,shadow,12,9,3
Adeptphd,tichondrius,864,priest,shadow,12,9,3
Voidcult,area-52,864,priest,shadow,18,9,9
Slimfo,sargeras,864,priest,shadow,18,9,9
Spookytorch,illidan,864,priest,shadow,18,9,9
Wololo,emerald-dream,864,priest,shadow,18,9,9
Tiernocookie,illidan,864,priest,shadow,18,9,9
Achllia,proudmoore,864,priest,shadow,18,9,9
Bumbleedot,azralon,864,priest,shadow,18,9,9
Swurvexo,bleeding-hollow,864,priest,shadow,24,9,15
Charity,maelstrom,863,priest,shadow,12,9,3
Dyhm,gorgonnash,863,priest,shadow,12,9,3
Melterdecara,tichondrius,863,priest,shadow,12,9,3
Pumtootoot,tichondrius,863,priest,shadow,12,9,3
Sadomyhusein,eitrigg,863,priest,shadow,12,9,3
Ðecease,thrall,863,priest,shadow,18,9,9
Küno,kelthuzad,863,priest,shadow,18,9,9
Dnn,malganis,863,priest,shadow,18,9,9
Iamgayx,kelthuzad,863,priest,shadow,18,9,9
Woosanghong,tichondrius,863,priest,shadow,18,9,9
Delrey,sargeras,863,priest,shadow,18,9,9
Acpriest,tichondrius,863,priest,shadow,24,9,15
Voidrisu,sargeras,863,priest,shadow,24,9,15
Efxsp,sargeras,863,priest,shadow,24,9,15
Everblack,executus,862,priest,shadow,12,9,3
Tyreliy,eitrigg,862,priest,shadow,18,9,9
Dóctóre,thrall,862,priest,shadow,18,9,9
Touchypriest,jaedenar,862,priest,shadow,18,9,9
Arzeuz,ragnaros,862,priest,shadow,18,9,9
Vzell,kiljaeden,862,priest,shadow,18,9,9
Faashrmpbtw,darkspear,861,priest,shadow,12,9,3
Falsegodx,tichondrius,861,priest,shadow,24,9,15
Fósho,khadgar,861,priest,shadow,24,9,15
Melas,stormrage,861,priest,shadow,24,9,15
Viejiyoh,ragnaros,860,priest,shadow,18,9,9
Krypts,shadow-council,859,priest,shadow,18,9,9
Wankenobi,stormrage,859,priest,shadow,18,9,9
Nuttsope,kiljaeden,859,priest,shadow,18,9,9
Willibald,eldrethalas,859,priest,shadow,24,9,15
Methodist,sargeras,859,priest,shadow,24,9,15
Beansontoast,wyrmrest-accord,857,priest,shadow,12,9,3
Theophii,tichondrius,854,priest,shadow,24,9,15
Drkvagician,tichondrius,854,priest,shadow,24,9,15
Zaxine,moon-guard,854,priest,shadow,30,9,21
Mazahr,stormrage,852,priest,shadow,12,9,3
Tictactoejc,tichondrius,852,priest,shadow,12,9,3
Hibot,illidan,849,priest,shadow,30,9,21
Lightbanter,emerald-dream,846,priest,shadow,24,9,15
Kagamì,frostmane,843,priest,shadow,31,9,22
Romero,blood-furnace,837,priest,shadow,72,28,44
Pipiwiwi,tichondrius,831,priest,shadow,16,9,7
Maldicius,emerald-dream,830,priest,shadow,23,9,14
Blonkie,azgalor,821,priest,shadow,24,10,14
Jeängrey,tichondrius,815,priest,shadow,15,10,5
Stylonious,hyjal,815,priest,shadow,15,9,6
Buc,barthilas,813,priest,shadow,15,9,6
Rigotakx,illidan,805,priest,shadow,27,10,17
Fledgeling,frostmourne,799,priest,shadow,14,9,5
Deadcode,frostmane,796,priest,shadow,52,18,34
Lôvecraft,frostmourne,781,priest,shadow,19,9,10
Reignsp,malganis,781,priest,shadow,19,9,10
Silentólògy,malganis,768,priest,shadow,12,8,4
Likeness,proudmoore,768,priest,shadow,12,8,4
Ahleven,tichondrius,768,priest,shadow,12,8,4
Nohealerhere,frostmourne,768,priest,shadow,12,8,4
Hockula,kiljaeden,768,priest,shadow,12,8,4
Härpocrates,area-52,768,priest,shadow,12,8,4
Skraitbussin,tichondrius,768,priest,shadow,12,8,4
Jhené,malganis,768,priest,shadow,12,8,4
Oxycodex,thrall,768,priest,shadow,12,8,4
Ruzhi,moon-guard,768,priest,shadow,12,8,4
Nohesita,stormrage,768,priest,shadow,12,8,4
Rattyp,barthilas,768,priest,shadow,12,8,4
Mumsmilk,sargeras,768,priest,shadow,12,8,4
Eridan,moon-guard,768,priest,shadow,12,8,4
Darkascended,arthas,768,priest,shadow,12,8,4
Púrplenurple,area-52,768,priest,shadow,12,8,4
Ydonburi,tichondrius,768,priest,shadow,12,8,4
Dazull,bleeding-hollow,768,priest,shadow,12,8,4
Stungods,frostmourne,768,priest,shadow,12,8,4
Quartzolio,azralon,768,priest,shadow,12,8,4
Lnoh,area-52,768,priest,shadow,12,8,4
Drosslolz,illidan,768,priest,shadow,18,8,10
Heàl,akama,768,priest,shadow,18,8,10
Iluvwizkx,malganis,768,priest,shadow,18,8,10
Deacoderx,area-52,768,priest,shadow,18,8,10
Pineappleqt,skullcrusher,768,priest,shadow,18,8,10
Àústîn,moon-guard,768,priest,shadow,18,8,10
Voidariah,tichondrius,768,priest,shadow,18,8,10
Duhpriest,frostmourne,768,priest,shadow,18,8,10
Ripchadman,tichondrius,768,priest,shadow,18,8,10
Jdcii,tichondrius,768,priest,shadow,18,8,10
Shadowylorka,sargeras,768,priest,shadow,18,8,10
Skepix,lightbringer,768,priest,shadow,18,8,10
Madmelter,emerald-dream,768,priest,shadow,18,8,10
Mydixi,stormrage,768,priest,shadow,18,8,10
Enchantrez,frostmourne,768,priest,shadow,18,8,10
Alucardibee,turalyon,768,priest,shadow,24,8,16
Synesis,bladefist,768,priest,shadow,24,8,16
Homonid,moon-guard,767,priest,shadow,12,8,4
Valsong,argent-dawn,767,priest,shadow,12,8,4
Shadowlords,emerald-dream,767,priest,shadow,12,8,4
Hairyboxx,frostmourne,767,priest,shadow,12,8,4
Easyrevenge,kelthuzad,767,priest,shadow,12,8,4
Sgssg,illidan,767,priest,shadow,12,8,4
Viq,stormrage,767,priest,shadow,12,8,4
Rogspriest,sargeras,767,priest,shadow,12,8,4
Drteabaghaam,zuljin,767,priest,shadow,12,8,4
Yackle,dawnbringer,767,priest,shadow,12,8,4
Moojoke,zuljin,767,priest,shadow,12,8,4
Tungus,shadowsong,767,priest,shadow,12,8,4
Voidathon,sargeras,767,priest,shadow,12,8,4
Mugiwarà,stormrage,767,priest,shadow,12,8,4
Longlegs,garrosh,767,priest,shadow,14,8,6
Valothrian,area-52,767,priest,shadow,18,8,10
Badxjuju,frostmourne,767,priest,shadow,18,8,10
Tuggyp,tichondrius,767,priest,shadow,18,8,10
Smitepie,malganis,767,priest,shadow,18,8,10
Zonozan,lightnings-blade,767,priest,shadow,18,8,10
Igotubrah,malganis,767,priest,shadow,18,8,10
Solrina,khazgoroth,766,priest,shadow,12,8,4
Sãoleozinho,azralon,766,priest,shadow,12,8,4
Jinzan,stormrage,766,priest,shadow,18,8,10
Chroma,amanthul,766,priest,shadow,18,8,10
Gorebones,emerald-dream,766,priest,shadow,18,8,10
Sadinho,azralon,766,priest,shadow,24,8,16
Rustinheber,stormscale,765,priest,shadow,12,8,4
Clayphace,darkspear,765,priest,shadow,18,8,10
Kumojorno,gilneas,765,priest,shadow,18,8,10
Nachòs,wildhammer,765,priest,shadow,24,8,16
Lotros,area-52,764,priest,shadow,12,8,4
Uikaren,tichondrius,763,priest,shadow,18,8,10
Pactosombrio,azralon,763,priest,shadow,24,8,16
Drkwispers,stormrage,762,priest,shadow,18,8,10
Speckilz,area-52,762,priest,shadow,26,8,18
Hurrdurr,shattered-hand,761,priest,shadow,12,8,4
Sôuljah,skywall,760,priest,shadow,26,10,16
Priestmain,thrall,760,priest,shadow,24,8,16
Aqusia,crushridge,753,priest,shadow,12,8,4
Hydroman,black-dragonflight,753,priest,shadow,18,9,9
Memoria,emerald-dream,751,priest,shadow,15,9,6
Bublethenrun,cenarius,751,priest,shadow,17,9,8
Gedtemanager,dalaran,749,priest,shadow,12,8,4
Vorial,cenarion-circle,735,priest,shadow,17,8,9
Harmlot,tichondrius,733,priest,shadow,14,9,5
Strazloraz,baelgun,719,priest,shadow,11,8,3
Meegoshy,azuremyst,718,priest,shadow,17,8,9
Gorry,ragnaros,717,priest,shadow,18,9,9
Mikó,dawnbringer,714,priest,shadow,29,10,19
Yrrep,kelthuzad,703,priest,shadow,16,8,8
Astari,illidan,702,priest,shadow,26,8,18
Peazyqt,tichondrius,687,priest,shadow,13,8,5
Nutzz,malganis,672,priest,shadow,12,7,5
Cryptoccocus,zuljin,672,priest,shadow,12,7,5
Salanzosp,bleeding-hollow,672,priest,shadow,12,7,5
Wodturbo,bleeding-hollow,672,priest,shadow,12,7,5
Scøøb,malganis,672,priest,shadow,12,7,5
Phéonìx,zuljin,672,priest,shadow,12,7,5
Naùtilus,icecrown,672,priest,shadow,12,7,5
Didy,dark-iron,672,priest,shadow,12,7,5
Lontra,zangarmarsh,672,priest,shadow,12,7,5
Bucksp,zuljin,672,priest,shadow,12,7,5
Kyerñ,stormrage,672,priest,shadow,12,7,5
Diddlur,black-dragonflight,672,priest,shadow,12,7,5
Chicoryx,illidan,672,priest,shadow,12,7,5
Grëýmåttèr,moon-guard,672,priest,shadow,12,7,5
Prizler,tichondrius,672,priest,shadow,12,7,5
Freebolt,barthilas,672,priest,shadow,12,7,5
Lilsweet,stonemaul,672,priest,shadow,12,7,5
Blackaries,frostmourne,672,priest,shadow,12,7,5
Xousa,area-52,672,priest,shadow,12,7,5
Lillyspr,malganis,672,priest,shadow,12,7,5
Fatzoid,the-forgotten-coast,672,priest,shadow,12,7,5
Nazgúl,lothar,672,priest,shadow,12,7,5
Ácÿd,nemesis,672,priest,shadow,12,7,5
Javakhp,illidan,672,priest,shadow,12,7,5
Hårper,area-52,672,priest,shadow,12,7,5
Kwiksi,arthas,672,priest,shadow,12,7,5
Aeøns,sargeras,672,priest,shadow,12,7,5
Cheach,echo-isles,672,priest,shadow,12,7,5
Moonlightx,destromath,672,priest,shadow,12,7,5
Mabisyo,wyrmrest-accord,672,priest,shadow,12,7,5
Esppx,barthilas,672,priest,shadow,12,7,5
Holylip,frostmourne,672,priest,shadow,12,7,5
Leorid,stormrage,672,priest,shadow,12,7,5
Discs,detheroc,672,priest,shadow,12,7,5
Zuuji,frostmourne,672,priest,shadow,12,7,5
Twítch,bonechewer,672,priest,shadow,12,7,5
Rottedjezus,dalaran,672,priest,shadow,12,7,5
Negans,tichondrius,672,priest,shadow,12,7,5
Kastwalker,earthen-ring,672,priest,shadow,12,7,5
Karkoza,proudmoore,672,priest,shadow,12,7,5
Bugweeb,sargeras,672,priest,shadow,12,7,5
Gles,quelthalas,672,priest,shadow,13,7,6
Mòrbídìtý,area-52,672,priest,shadow,13,7,6
Aurilain,emerald-dream,672,priest,shadow,18,7,11
Frúdgé,illidan,672,priest,shadow,18,7,11
Helleamh,tichondrius,672,priest,shadow,18,7,11
Nightious,malganis,672,priest,shadow,18,7,11
Bigbrother,andorhal,672,priest,shadow,18,7,11
Donmartin,tichondrius,672,priest,shadow,18,7,11
Tenaebreu,tichondrius,672,priest,shadow,19,7,12
Veressà,quelthalas,672,priest,shadow,22,8,14
Chês,tichondrius,672,priest,shadow,24,7,17
Preyforme,tichondrius,671,priest,shadow,12,7,5
Webba,azshara,671,priest,shadow,12,7,5
Gaho,tichondrius,671,priest,shadow,12,7,5
Stasis,korialstrasz,671,priest,shadow,12,7,5
Chinstrap,zuljin,671,priest,shadow,12,7,5
Adíos,malganis,671,priest,shadow,12,7,5
Moonpenance,windrunner,671,priest,shadow,12,7,5
Darkrics,barthilas,671,priest,shadow,12,7,5
Spshady,aegwynn,671,priest,shadow,12,7,5
Voltstein,dalaran,671,priest,shadow,12,7,5
Nastyyshadow,aegwynn,671,priest,shadow,12,7,5
Socknapper,sargeras,671,priest,shadow,12,7,5
Spamnhealz,illidan,671,priest,shadow,12,7,5
Havefaith,whisperwind,671,priest,shadow,18,7,11
Pottime,tichondrius,671,priest,shadow,18,7,11
Hollowed,drakkari,671,priest,shadow,18,7,11
Shimz,andorhal,671,priest,shadow,18,7,11
Heion,detheroc,671,priest,shadow,18,7,11
Torangi,tichondrius,671,priest,shadow,18,7,11
Minarhy,moon-guard,671,priest,shadow,18,7,11
Pokeyoobutt,hydraxis,671,priest,shadow,18,7,11
Sagis,moon-guard,671,priest,shadow,18,7,11
Influencing,moon-guard,671,priest,shadow,18,7,11
Digitalangel,area-52,671,priest,shadow,18,7,11
Montcrief,tichondrius,670,priest,shadow,12,7,5
Nerfdisc,azralon,670,priest,shadow,12,7,5
Tonybromoo,kelthuzad,670,priest,shadow,12,7,5
Zaixse,illidan,670,priest,shadow,12,7,5
Iseeyoulookn,stormrage,670,priest,shadow,16,8,8
Bojanglings,undermine,670,priest,shadow,24,7,17
Fruitbasketz,malganis,670,priest,shadow,24,7,17
Sovix,sargeras,669,priest,shadow,12,7,5
Voiddark,thrall,669,priest,shadow,13,7,6
Rhapsidy,barthilas,669,priest,shadow,15,8,7
Gabryanna,emerald-dream,669,priest,shadow,24,7,17
Solraea,stormrage,668,priest,shadow,12,7,5
Rijonkulous,area-52,668,priest,shadow,18,7,11
Lõkî,malganis,667,priest,shadow,12,7,5
Bellalugosi,auchindoun,667,priest,shadow,12,7,5
Lampshayd,sargeras,665,priest,shadow,12,7,5
Crashed,frostmourne,654,priest,shadow,23,7,16
Metaila,aerie-peak,639,priest,shadow,11,7,4
Lucifena,darkspear,639,priest,shadow,11,7,4
Astraetus,zuljin,639,priest,shadow,17,7,10
Holliebell,zuljin,639,priest,shadow,17,7,10
Bouffantbibl,tichondrius,639,priest,shadow,20,8,12
Wzrdtrx,tichondrius,638,priest,shadow,14,8,6
Emmitson,scarlet-crusade,638,priest,shadow,28,7,21
Chiliy,frostmourne,623,priest,shadow,11,7,4
Schelleyyuki,tichondrius,623,priest,shadow,11,7,4
Lzzp,azralon,623,priest,shadow,17,7,10
Glek,tichondrius,608,priest,shadow,16,7,9
Bingleboi,area-52,607,priest,shadow,14,7,7
Dispersed,thrall,607,priest,shadow,14,7,7
Hölyfury,illidan,607,priest,shadow,17,7,10
Seniorpickle,emerald-dream,606,priest,shadow,14,7,7
Bobe,sisters-of-elune,604,priest,shadow,32,12,20
Flowerpetals,emerald-dream,599,priest,shadow,21,7,14
Nylaza,kiljaeden,592,priest,shadow,19,7,12
Mastahmind,illidan,591,priest,shadow,13,7,6
Ìforted,zuljin,587,priest,shadow,19,7,12
Umberries,dreadmaul,585,priest,shadow,19,10,9
Sydgames,area-52,576,priest,shadow,6,6,0
Moonwald,moon-guard,576,priest,shadow,6,6,0
Innovate,dragonmaw,576,priest,shadow,6,6,0
Playsoon,illidan,576,priest,shadow,6,6,0
Nayzarh,darkspear,576,priest,shadow,6,6,0
Lukuku,barthilas,576,priest,shadow,6,6,0
Henrywhopper,fizzcrank,576,priest,shadow,6,6,0
Applepiezz,tichondrius,576,priest,shadow,6,6,0
Dradinx,illidan,576,priest,shadow,7,6,1
Wheelson,wildhammer,576,priest,shadow,12,6,6
Shiikari,terenas,576,priest,shadow,12,6,6
Lleak,tichondrius,576,priest,shadow,12,6,6
Spriestbro,emerald-dream,576,priest,shadow,12,6,6
Jangbi,tichondrius,576,priest,shadow,12,6,6
Rebdomine,magtheridon,576,priest,shadow,12,6,6
Slpox,sargeras,576,priest,shadow,12,6,6
Shadowspain,stormrage,576,priest,shadow,12,6,6
Xpenance,ragnaros,576,priest,shadow,12,6,6
Toddo,trollbane,576,priest,shadow,12,6,6
Studiosxz,tichondrius,576,priest,shadow,12,6,6
Missiønary,area-52,576,priest,shadow,12,6,6
Ershackleton,illidan,576,priest,shadow,12,6,6
Spookyman,malganis,576,priest,shadow,12,6,6
Boxcombo,kelthuzad,576,priest,shadow,12,6,6
Fitchbucker,sargeras,576,priest,shadow,12,6,6
Mks,barthilas,576,priest,shadow,12,6,6
Dellah,stormrage,576,priest,shadow,12,6,6
Sped,saurfang,576,priest,shadow,12,6,6
Imshadow,azralon,576,priest,shadow,12,6,6
Whosjoe,tichondrius,576,priest,shadow,12,6,6
Rahtals,malganis,576,priest,shadow,12,6,6
Sacerdotick,gallywix,576,priest,shadow,12,6,6
Valerift,moon-guard,576,priest,shadow,12,6,6
Froackey,agamaggan,576,priest,shadow,12,6,6
Vengep,sargeras,576,priest,shadow,12,6,6
Tmspongwo,tichondrius,576,priest,shadow,12,6,6
Jeremyissped,proudmoore,576,priest,shadow,12,6,6
Drognar,lightbringer,576,priest,shadow,12,6,6
Kessavannell,frostwolf,576,priest,shadow,12,6,6
Lostnlight,aggramar,576,priest,shadow,12,6,6
Evansong,frostmane,576,priest,shadow,12,6,6
Carosene,thrall,576,priest,shadow,12,6,6
Ôverweight,sargeras,576,priest,shadow,12,6,6
Virsyti,area-52,576,priest,shadow,12,6,6
Heb,thrall,576,priest,shadow,12,6,6
Càipirinha,tichondrius,576,priest,shadow,12,6,6
Nelfonshelf,hyjal,576,priest,shadow,12,6,6
Faztwo,illidan,576,priest,shadow,12,6,6
Zeacho,proudmoore,576,priest,shadow,12,6,6
Jrøck,malganis,576,priest,shadow,12,6,6
Faenzal,area-52,576,priest,shadow,12,6,6
Rachelstarrx,hyjal,576,priest,shadow,12,6,6
Yungjim,the-forgotten-coast,576,priest,shadow,12,6,6
Pønt,sargeras,576,priest,shadow,12,6,6
Lisau,tichondrius,576,priest,shadow,12,6,6
Boneappletee,area-52,576,priest,shadow,12,6,6
Secretpriest,tichondrius,576,priest,shadow,12,6,6
Yiptawh,area-52,576,priest,shadow,12,6,6
Silverblacks,quelthalas,576,priest,shadow,12,6,6
Bipölar,area-52,576,priest,shadow,12,6,6
Catmasters,area-52,576,priest,shadow,13,6,7
Xz,black-dragonflight,576,priest,shadow,16,7,9
Fruitjuice,arthas,576,priest,shadow,18,6,12
Mindgamez,stormreaver,576,priest,shadow,18,6,12
Caeda,icecrown,576,priest,shadow,18,6,12
Soulrulerx,tichondrius,576,priest,shadow,18,6,12
Evaldi,proudmoore,576,priest,shadow,18,6,12
Thrie,ragnaros,576,priest,shadow,24,6,18
Spriestes,thrall,575,priest,shadow,6,6,0
Frëÿjä,proudmoore,575,priest,shadow,6,6,0
Xinthra,stormrage,575,priest,shadow,12,6,6
Boogieboop,frostmourne,575,priest,shadow,12,6,6
Rtdarkcraft,ragnaros,575,priest,shadow,12,6,6
Unclelively,dragonmaw,575,priest,shadow,12,6,6
Linarastia,blackrock,575,priest,shadow,12,6,6
Empower,garrosh,575,priest,shadow,12,6,6
Ricksanchez,moonrunner,575,priest,shadow,12,6,6
Xð,jubeithos,575,priest,shadow,12,6,6
Rustydisc,area-52,575,priest,shadow,12,6,6
Alienà,arthas,575,priest,shadow,12,6,6
Vashyy,stormrage,575,priest,shadow,12,6,6
Morboo,proudmoore,575,priest,shadow,12,6,6
Mìdnìght,ragnaros,575,priest,shadow,12,6,6
Mêrlin,duskwood,575,priest,shadow,12,6,6
Drsonny,proudmoore,575,priest,shadow,12,6,6
Grympriest,wyrmrest-accord,575,priest,shadow,12,6,6
Çovidònenine,tichondrius,575,priest,shadow,12,6,6
Juícifer,illidan,575,priest,shadow,18,6,12
Vøíd,sargeras,575,priest,shadow,18,6,12
Mäe,nemesis,575,priest,shadow,18,6,12
Asmitä,stormrage,575,priest,shadow,18,6,12
Healzahoe,sargeras,575,priest,shadow,18,6,12
Makade,sargeras,575,priest,shadow,18,6,12
Kapriestsun,malorne,574,priest,shadow,12,6,6
Ðaddÿ,bleeding-hollow,574,priest,shadow,12,6,6
Duhk,moon-guard,574,priest,shadow,12,6,6
Papipreach,sargeras,574,priest,shadow,12,6,6
Dhader,area-52,574,priest,shadow,20,6,14
Galedry,ragnaros,574,priest,shadow,24,6,18
Shadowpáin,ragnaros,573,priest,shadow,12,6,6
Midboss,illidan,572,priest,shadow,12,6,6
Jamashud,mannoroth,571,priest,shadow,12,6,6
Raelintha,kelthuzad,571,priest,shadow,15,7,8
Shadowbishop,barthilas,570,priest,shadow,12,6,6
Daisydux,quelthalas,568,priest,shadow,10,7,3
Kkpriest,frostmourne,566,priest,shadow,12,6,6
Holysheht,icecrown,566,priest,shadow,12,6,6
Sarkozzlol,tichondrius,543,priest,shadow,8,7,1
Yourlife,baelgun,543,priest,shadow,11,6,5
Chapyh,malganis,543,priest,shadow,11,6,5
Anttila,ragnaros,543,priest,shadow,17,6,11
Mcpopafeel,thrall,528,priest,shadow,11,7,4
Shadolord,illidan,527,priest,shadow,17,6,11
Holydestroyr,dentarg,527,priest,shadow,21,6,15
Sársaukis,illidan,527,priest,shadow,21,6,15
Totorostarp,tichondrius,521,priest,shadow,22,8,14
Ceoofvoid,moon-guard,511,priest,shadow,8,6,2
Hoshx,sargeras,496,priest,shadow,13,6,7
Kaidow,wyrmrest-accord,480,priest,shadow,6,5,1
Topg,icecrown,480,priest,shadow,6,5,1
Chervz,chogall,480,priest,shadow,6,5,1
Flynni,bleeding-hollow,480,priest,shadow,6,5,1
Polarnight,zuljin,480,priest,shadow,6,5,1
Keynath,burning-blade,480,priest,shadow,6,5,1
Plaguepumper,sargeras,480,priest,shadow,6,5,1
Liloffended,sargeras,480,priest,shadow,6,5,1
Tricklee,tichondrius,480,priest,shadow,6,5,1
Megamind,elune,480,priest,shadow,6,5,1
Fiéstah,illidan,480,priest,shadow,6,5,1
Altera,drakkari,480,priest,shadow,6,5,1
Nawtyforever,tichondrius,480,priest,shadow,6,5,1
Ãbelladanger,area-52,480,priest,shadow,6,5,1
Bigpenance,illidan,480,priest,shadow,6,5,1
Komy,tichondrius,480,priest,shadow,6,5,1
Commotion,dalaran,480,priest,shadow,6,5,1
Likelydapper,tichondrius,480,priest,shadow,6,5,1
Myòvó,tichondrius,480,priest,shadow,6,5,1
Atheistbtw,sargeras,480,priest,shadow,6,5,1
Tensorflow,tichondrius,480,priest,shadow,6,5,1
Death,firetree,480,priest,shadow,6,5,1
Seanuts,emerald-dream,480,priest,shadow,6,5,1
Novasp,sargeras,480,priest,shadow,6,5,1
Jezebëll,nemesis,480,priest,shadow,6,5,1
Minnowhead,kelthuzad,480,priest,shadow,12,5,7
Yddwin,quelthalas,480,priest,shadow,12,5,7
Lucariö,area-52,480,priest,shadow,12,5,7
Faxingberlin,sargeras,480,priest,shadow,12,5,7
Optimism,frostmane,480,priest,shadow,12,5,7
Senadori,azjolnerub,480,priest,shadow,12,5,7
Nås,elune,480,priest,shadow,12,5,7
Seraphims,moon-guard,480,priest,shadow,12,5,7
Ariellie,area-52,480,priest,shadow,12,5,7
Müyrica,ragnaros,480,priest,shadow,12,5,7
Hygeïa,lightbringer,480,priest,shadow,12,5,7
Cryptron,tichondrius,480,priest,shadow,12,5,7
Taofang,wyrmrest-accord,480,priest,shadow,12,5,7
Littledog,velen,480,priest,shadow,12,5,7
Clistyn,quelthalas,480,priest,shadow,12,5,7
Zhangtanchi,moon-guard,480,priest,shadow,12,5,7
Soulistic,arygos,480,priest,shadow,12,5,7
Priestology,echo-isles,480,priest,shadow,12,5,7
Gálfore,malganis,480,priest,shadow,12,5,7
Jenastreaux,wyrmrest-accord,480,priest,shadow,12,5,7
Shádôws,blackhand,480,priest,shadow,12,5,7
Mookelina,stormrage,480,priest,shadow,12,5,7
Rätcömpx,bleeding-hollow,480,priest,shadow,12,5,7
Spriest,kul-tiras,480,priest,shadow,12,5,7
Posest,darkspear,480,priest,shadow,12,5,7
Flukex,tichondrius,480,priest,shadow,12,5,7
Sohalexs,tichondrius,480,priest,shadow,12,5,7
Dmlx,frostmourne,480,priest,shadow,12,5,7
Kabutta,stormrage,480,priest,shadow,12,5,7
Mdt,tichondrius,480,priest,shadow,12,5,7
Everest,barthilas,480,priest,shadow,12,5,7
Bomanic,sargeras,480,priest,shadow,12,5,7
Rakÿna,nemesis,480,priest,shadow,12,5,7
Sâltý,stormrage,480,priest,shadow,12,5,7
Goblindruid,bleeding-hollow,480,priest,shadow,12,5,7
Fatzzbtw,illidan,480,priest,shadow,12,5,7
Mistweaver,tichondrius,480,priest,shadow,12,5,7
Orderic,ragnaros,480,priest,shadow,12,5,7
Onizukakeiji,hyjal,480,priest,shadow,12,5,7
Bunked,bleeding-hollow,480,priest,shadow,12,5,7
Moä,nemesis,480,priest,shadow,12,5,7
Jesstical,frostmourne,480,priest,shadow,12,5,7
Eazye,shadowmoon,480,priest,shadow,12,5,7
Faydes,arthas,480,priest,shadow,13,5,8
Stillmatick,tichondrius,480,priest,shadow,16,6,10
Zerohoür,emerald-dream,480,priest,shadow,16,6,10
Nedajoon,tichondrius,480,priest,shadow,17,6,11
Drakracs,doomhammer,480,priest,shadow,18,5,13
Azrothlol,kul-tiras,480,priest,shadow,18,5,13
Spõt,stormrage,480,priest,shadow,18,5,13
Sybal,suramar,480,priest,shadow,19,5,14
Temnah,sargeras,480,priest,shadow,24,5,19
Merlynaah,azralon,479,priest,shadow,6,5,1
Paradoxbot,kelthuzad,479,priest,shadow,6,5,1
Notahero,tichondrius,479,priest,shadow,6,5,1
Devî,magtheridon,479,priest,shadow,12,5,7
Knoxy,fizzcrank,479,priest,shadow,12,5,7
Wolfeclipse,sargeras,479,priest,shadow,12,5,7
Synisteria,sargeras,479,priest,shadow,12,5,7
Brosbeforeho,tichondrius,479,priest,shadow,18,5,13
Rippmmr,frostmourne,479,priest,shadow,18,5,13
Noodloctopus,area-52,478,priest,shadow,10,6,4
Murtrudin,andorhal,478,priest,shadow,12,5,7
Antiraus,aerie-peak,478,priest,shadow,12,5,7
Thehern,tichondrius,463,priest,shadow,11,5,6
Estarì,proudmoore,463,priest,shadow,11,5,6
Wiiuwiiu,malganis,447,priest,shadow,11,5,6
Forober,queldorei,446,priest,shadow,10,6,4
Aerena,anvilmar,442,priest,shadow,21,7,14
Ryanrealz,tichondrius,432,priest,shadow,9,6,3
Veilozity,tichondrius,432,priest,shadow,15,5,10
Bernhard,azralon,431,priest,shadow,11,5,6
Sohalex,tichondrius,431,priest,shadow,11,5,6
Shietamazon,tichondrius,426,priest,shadow,16,6,10
Shaurana,stormrage,412,priest,shadow,18,6,12
Nizr,bleeding-hollow,399,priest,shadow,5,5,0
Mäte,bleeding-hollow,384,priest,shadow,6,4,2
Pootang,hyjal,384,priest,shadow,6,4,2
Ikiteforhash,zuljin,384,priest,shadow,6,4,2
Diskordia,stormrage,384,priest,shadow,6,4,2
Sungsh,zuljin,384,priest,shadow,6,4,2
Devinere,tichondrius,384,priest,shadow,6,4,2
Priestodan,frostmourne,384,priest,shadow,6,4,2
Choppery,laughing-skull,384,priest,shadow,6,4,2
Dzikuss,aegwynn,384,priest,shadow,6,4,2
Aladarian,tichondrius,384,priest,shadow,6,4,2
Mindflay,tichondrius,384,priest,shadow,6,4,2
Nimabe,tichondrius,384,priest,shadow,6,4,2
Balverix,tichondrius,384,priest,shadow,6,4,2
Dotznbubblez,zuljin,384,priest,shadow,6,4,2
Cånnibäl,tichondrius,384,priest,shadow,6,4,2
Kks,tichondrius,384,priest,shadow,6,4,2
Rolettana,stormrage,384,priest,shadow,6,4,2
Unclecam,tichondrius,384,priest,shadow,6,4,2
Garbagépg,zuljin,384,priest,shadow,6,4,2
Rôss,tichondrius,384,priest,shadow,6,4,2
Prydas,tichondrius,384,priest,shadow,6,4,2
Comoli,tichondrius,384,priest,shadow,6,4,2
Robertlee,stormrage,384,priest,shadow,6,4,2
Quiglius,tichondrius,384,priest,shadow,6,4,2
Drinky,tichondrius,384,priest,shadow,6,4,2
Mutedox,frostmourne,384,priest,shadow,6,4,2
Jaysshadow,illidan,384,priest,shadow,6,4,2
Magiccoon,tichondrius,384,priest,shadow,6,4,2
Hèxxen,moon-guard,384,priest,shadow,6,4,2
Judgejudyx,tichondrius,384,priest,shadow,6,4,2
Bigpurple,crushridge,384,priest,shadow,6,4,2
Træway,tichondrius,384,priest,shadow,6,4,2
Valtres,tichondrius,384,priest,shadow,6,4,2
Tiinkerbell,moon-guard,384,priest,shadow,6,4,2
Fåtê,area-52,384,priest,shadow,6,4,2
Bramstein,jubeithos,384,priest,shadow,6,4,2
Kynyssaelz,proudmoore,384,priest,shadow,6,4,2
Spôoky,illidan,384,priest,shadow,6,4,2
Zork,wildhammer,384,priest,shadow,6,4,2
Lgt,tichondrius,384,priest,shadow,6,4,2
Yuricksus,malganis,384,priest,shadow,6,4,2
Marcusalan,emerald-dream,384,priest,shadow,6,4,2
Tethy,saurfang,384,priest,shadow,6,4,2
Ferzhump,tichondrius,384,priest,shadow,6,4,2
Bigskill,proudmoore,384,priest,shadow,6,4,2
Prostrat,deathwing,384,priest,shadow,6,4,2
Iifa,medivh,384,priest,shadow,6,4,2
Guillotine,azralon,384,priest,shadow,6,4,2
Haedn,azralon,384,priest,shadow,6,4,2
Notlowboy,area-52,384,priest,shadow,6,4,2
Káldorei,proudmoore,384,priest,shadow,6,4,2
Næzha,thrall,384,priest,shadow,6,4,2
Shoelacey,sargeras,384,priest,shadow,6,4,2
Ðrip,burning-legion,384,priest,shadow,6,4,2
Iemon,vashj,384,priest,shadow,6,4,2
Rubymisfit,sargeras,384,priest,shadow,6,4,2
Itha,illidan,384,priest,shadow,6,4,2
Äni,sargeras,384,priest,shadow,6,4,2
Shieldspamx,tichondrius,384,priest,shadow,6,4,2
Shutkap,sargeras,384,priest,shadow,6,4,2
Thänatós,quelthalas,384,priest,shadow,6,4,2
Lenigrast,blackrock,384,priest,shadow,6,4,2
Píty,ragnaros,384,priest,shadow,6,4,2
Mygameslaggy,area-52,384,priest,shadow,6,4,2
Killían,darkspear,384,priest,shadow,6,4,2
Urdaisyy,kelthuzad,384,priest,shadow,6,4,2
Moomoomilker,blackrock,384,priest,shadow,6,4,2
Feminizm,tichondrius,384,priest,shadow,6,4,2
Piftw,illidan,384,priest,shadow,6,4,2
Didittouchme,sargeras,384,priest,shadow,6,4,2
Bax,kilrogg,384,priest,shadow,6,4,2
Capnjazz,illidan,384,priest,shadow,6,4,2
Liquidhorror,tichondrius,384,priest,shadow,7,4,3
Mfn,deathwing,384,priest,shadow,11,4,7
Vaeryl,stormrage,384,priest,shadow,12,4,8
Eeffoc,zuljin,384,priest,shadow,12,4,8
Mìçah,fizzcrank,384,priest,shadow,12,4,8
Fáll,bleeding-hollow,384,priest,shadow,12,4,8
Vundead,tichondrius,384,priest,shadow,12,4,8
Nèurósis,area-52,384,priest,shadow,12,4,8
Mïndgames,kelthuzad,384,priest,shadow,12,4,8
Syncopy,azshara,384,priest,shadow,12,4,8
Dialis,frostmourne,384,priest,shadow,12,4,8
Shademán,stormrage,384,priest,shadow,12,4,8
Aliciari,illidan,384,priest,shadow,12,4,8
Junethegreat,tichondrius,384,priest,shadow,12,4,8
Aerith,barthilas,384,priest,shadow,12,4,8
Thalladori,area-52,384,priest,shadow,12,4,8
Grimmyreap,malygos,384,priest,shadow,12,4,8
Prescella,sargeras,384,priest,shadow,12,4,8
Éx,alterac-mountains,384,priest,shadow,12,4,8
Jinbo,frostmane,384,priest,shadow,12,4,8
Mannyelf,ragnaros,384,priest,shadow,12,4,8
Zacksnotcool,sargeras,384,priest,shadow,12,4,8
Aexdawg,malganis,384,priest,shadow,12,4,8
Dipidorko,proudmoore,384,priest,shadow,12,4,8
Deathbyhot,gorefiend,384,priest,shadow,12,4,8
Jxkep,frostmourne,384,priest,shadow,12,4,8
Oligan,quelthalas,384,priest,shadow,12,4,8
Fatäl,moon-guard,384,priest,shadow,12,4,8
Tokaru,frostmourne,384,priest,shadow,12,4,8
Brickzy,dalaran,384,priest,shadow,12,4,8
Fhelurian,quelthalas,384,priest,shadow,12,4,8
Çïöÿêüäüöàüê,stormrage,384,priest,shadow,12,4,8
Heretoflay,tichondrius,384,priest,shadow,12,4,8
Nôtthehealer,sargeras,384,priest,shadow,12,4,8
Holydrop,sargeras,384,priest,shadow,12,4,8
Jikoguu,stormscale,384,priest,shadow,12,4,8
Arca,cenarion-circle,384,priest,shadow,18,4,14
Lunypriest,azralon,384,priest,shadow,18,4,14
Aliorixa,stormrage,384,priest,shadow,18,4,14
Amazo,nemesis,383,priest,shadow,6,4,2
Skky,nagrand,383,priest,shadow,6,4,2
Thefiveoh,malganis,383,priest,shadow,6,4,2
Unfriend,sargeras,383,priest,shadow,12,4,8
Jammý,burning-legion,383,priest,shadow,12,4,8
Holydork,sargeras,383,priest,shadow,12,4,8
Hermïs,stormrage,383,priest,shadow,12,4,8
Zyte,stormrage,383,priest,shadow,14,4,10
Nocappappy,tichondrius,383,priest,shadow,18,4,14
Capitancook,ragnaros,383,priest,shadow,18,4,14
Leshlight,azuremyst,383,priest,shadow,24,4,20
Honeybunns,skywall,382,priest,shadow,6,4,2
Geulis,illidan,382,priest,shadow,12,4,8
Bwansandi,blackrock,370,priest,shadow,38,8,30
Durgen,stormreaver,367,priest,shadow,17,4,13
Deathzpirit,kiljaeden,352,priest,shadow,10,4,6
Bionix,stormrage,330,priest,shadow,11,5,6
Sgiath,alleria,330,priest,shadow,15,6,9
Libationz,area-52,329,priest,shadow,19,7,12
Hørçrùx,tichondrius,319,priest,shadow,5,4,1
Vaynnx,stormrage,319,priest,shadow,5,4,1
Dtbündertree,nordrassil,319,priest,shadow,5,4,1
Earebus,dalaran,288,priest,shadow,6,3,3
Russbell,ragnaros,288,priest,shadow,6,3,3
Strokkerzin,azralon,288,priest,shadow,6,3,3
Voidballs,tichondrius,288,priest,shadow,6,3,3
Scaadoosh,dalaran,288,priest,shadow,6,3,3
Nizanz,illidan,288,priest,shadow,6,3,3
Quantumgoat,tichondrius,288,priest,shadow,6,3,3
Ohmylaanta,stormrage,288,priest,shadow,6,3,3
Ascundead,tichondrius,288,priest,shadow,6,3,3
Pezziate,tichondrius,288,priest,shadow,6,3,3
Whittysp,tichondrius,288,priest,shadow,6,3,3
Moselol,tichondrius,288,priest,shadow,6,3,3
Sumrand,frostmourne,288,priest,shadow,6,3,3
Nuclease,turalyon,288,priest,shadow,6,3,3
Banmi,tichondrius,288,priest,shadow,6,3,3
Xuxu,frostmourne,288,priest,shadow,6,3,3
Mynameis,dethecus,288,priest,shadow,6,3,3
Amanopriest,illidan,288,priest,shadow,6,3,3
Blakeak,hyjal,288,priest,shadow,6,3,3
Dumpesitwo,frostmourne,288,priest,shadow,6,3,3
Halleßerry,illidan,288,priest,shadow,6,3,3
ßoy,amanthul,288,priest,shadow,6,3,3
Pengwu,moon-guard,288,priest,shadow,6,3,3
Exploded,moon-guard,288,priest,shadow,6,3,3
Henrykane,azgalor,288,priest,shadow,6,3,3
Adelen,illidan,288,priest,shadow,6,3,3
Roommatethor,thaurissan,288,priest,shadow,6,3,3
Suki,alleria,288,priest,shadow,6,3,3
Shakarot,illidan,288,priest,shadow,6,3,3
Oxxymoron,malganis,288,priest,shadow,6,3,3
Auras,boulderfist,288,priest,shadow,6,3,3
Kindyx,ragnaros,288,priest,shadow,6,3,3
Runakk,stonemaul,288,priest,shadow,6,3,3
Squatchlace,tichondrius,288,priest,shadow,6,3,3
Sìkarìa,illidan,288,priest,shadow,6,3,3
Spspsp,illidan,288,priest,shadow,6,3,3
Elitë,frostmourne,288,priest,shadow,6,3,3
Ozzx,stormrage,288,priest,shadow,6,3,3
Enaan,proudmoore,288,priest,shadow,6,3,3
Bubbleguppyx,tichondrius,288,priest,shadow,6,3,3
Menorsita,tichondrius,288,priest,shadow,6,3,3
Wrathhealer,hellscream,288,priest,shadow,6,3,3
Clearclouds,tichondrius,288,priest,shadow,6,3,3
Lolsodacans,malganis,288,priest,shadow,6,3,3
Empyreanlite,dalaran,288,priest,shadow,6,3,3
Soloqqt,tichondrius,288,priest,shadow,6,3,3
Studpriest,tichondrius,288,priest,shadow,6,3,3
Noanswerr,proudmoore,288,priest,shadow,6,3,3
Limèria,emerald-dream,288,priest,shadow,6,3,3
Egraner,drakkari,288,priest,shadow,6,3,3
Shaðows,malganis,288,priest,shadow,6,3,3
Pheegawn,proudmoore,288,priest,shadow,6,3,3
Stroserous,hyjal,288,priest,shadow,6,3,3
Reginaa,nemesis,288,priest,shadow,6,3,3
Döllyy,illidan,288,priest,shadow,6,3,3
Cappoo,tichondrius,288,priest,shadow,6,3,3
Dovakhamut,illidan,288,priest,shadow,6,3,3
Lucènt,frostmourne,288,priest,shadow,6,3,3
Nzuth,dalaran,288,priest,shadow,6,3,3
Pgpriest,kelthuzad,288,priest,shadow,6,3,3
Intheway,bleeding-hollow,288,priest,shadow,6,3,3
Dottiemcfee,alterac-mountains,288,priest,shadow,6,3,3
Lucydrop,area-52,288,priest,shadow,6,3,3
Ceebomb,tichondrius,288,priest,shadow,6,3,3
Osarin,sargeras,288,priest,shadow,6,3,3
Ossirus,emerald-dream,288,priest,shadow,6,3,3
Austul,guldan,288,priest,shadow,6,3,3
Monytrain,emerald-dream,288,priest,shadow,6,3,3
Persimmons,lightbringer,288,priest,shadow,6,3,3
Jaliera,malganis,288,priest,shadow,6,3,3
Issaley,tichondrius,288,priest,shadow,6,3,3
Randyortonn,tichondrius,288,priest,shadow,6,3,3
Reâpêr,kelthuzad,288,priest,shadow,6,3,3
Avadrah,tichondrius,288,priest,shadow,6,3,3
Drelia,jubeithos,288,priest,shadow,6,3,3
Vullena,moon-guard,288,priest,shadow,6,3,3
Nellìel,whisperwind,288,priest,shadow,6,3,3
Xxmewo,sargeras,288,priest,shadow,6,3,3
Aliciab,andorhal,288,priest,shadow,6,3,3
Worldhealer,area-52,288,priest,shadow,6,3,3
Shadymac,sargeras,288,priest,shadow,6,3,3
Judeath,area-52,288,priest,shadow,6,3,3
Leya,kiljaeden,288,priest,shadow,6,3,3
Champ,norgannon,288,priest,shadow,6,3,3
Prignues,tichondrius,288,priest,shadow,6,3,3
Khallmir,goldrinn,288,priest,shadow,6,3,3
ßìrth,kelthuzad,288,priest,shadow,6,3,3
Healiûm,bleeding-hollow,288,priest,shadow,6,3,3
Chewit,kargath,288,priest,shadow,6,3,3
Gospels,tichondrius,288,priest,shadow,6,3,3
Tomseleck,frostmourne,288,priest,shadow,6,3,3
Mhorkarion,quelthalas,288,priest,shadow,6,3,3
Leyspring,moon-guard,288,priest,shadow,6,3,3
Ontherise,kelthuzad,288,priest,shadow,6,3,3
Mlkchocolate,kelthuzad,288,priest,shadow,6,3,3
Halîth,terenas,288,priest,shadow,6,3,3
Oongawa,sargeras,288,priest,shadow,6,3,3
Mallox,quelthalas,288,priest,shadow,6,3,3
Crazchinkin,tichondrius,288,priest,shadow,6,3,3
Sealife,kelthuzad,288,priest,shadow,6,3,3
Wâtermelon,stormrage,288,priest,shadow,6,3,3
Brxddx,sargeras,288,priest,shadow,6,3,3
Polyxenus,moon-guard,288,priest,shadow,6,3,3
Etherrion,area-52,288,priest,shadow,6,3,3
Whalexo,kelthuzad,288,priest,shadow,6,3,3
Pepsí,kaelthas,288,priest,shadow,6,3,3
Haransimongo,area-52,288,priest,shadow,6,3,3
Raptorjesùs,azjolnerub,288,priest,shadow,6,3,3
Samio,area-52,288,priest,shadow,6,3,3
Çræmgøtsøçkd,blackrock,288,priest,shadow,6,3,3
Prosight,tichondrius,288,priest,shadow,6,3,3
Pogchamp,alterac-mountains,288,priest,shadow,6,3,3
Ohsop,chogall,288,priest,shadow,6,3,3
Eddysmokes,tichondrius,288,priest,shadow,6,3,3
Knowufearme,auchindoun,288,priest,shadow,6,3,3
Layyton,anvilmar,288,priest,shadow,6,3,3
Ej,altar-of-storms,288,priest,shadow,6,3,3
Xandir,kaelthas,288,priest,shadow,6,3,3
Toxictampax,azjolnerub,288,priest,shadow,6,3,3
Caiitlynn,quelthalas,288,priest,shadow,6,3,3
Lemmecastpls,sargeras,288,priest,shadow,6,3,3
Onahaihu,tichondrius,288,priest,shadow,9,4,5
Epithet,moon-guard,288,priest,shadow,9,4,5
Valuations,tichondrius,288,priest,shadow,12,3,9
Airn,tichondrius,288,priest,shadow,12,3,9
Shadowpain,the-underbog,288,priest,shadow,12,3,9
Stantz,burning-legion,288,priest,shadow,12,3,9
Maraquinn,bleeding-hollow,288,priest,shadow,12,3,9
Zêrø,aerie-peak,288,priest,shadow,12,3,9
Dunnbledore,area-52,288,priest,shadow,12,3,9
Sybenela,proudmoore,288,priest,shadow,12,3,9
Poppyp,stormrage,288,priest,shadow,12,3,9
Tastyloads,illidan,288,priest,shadow,12,3,9
Demonllama,duskwood,288,priest,shadow,12,3,9
Giantqid,malganis,288,priest,shadow,12,3,9
Mistmare,dalaran,288,priest,shadow,12,3,9
Farnzz,malganis,288,priest,shadow,12,3,9
Shadøwbølt,tichondrius,288,priest,shadow,12,3,9
Mandisa,skywall,288,priest,shadow,12,3,9
Xeras,ravencrest,288,priest,shadow,12,3,9
Scaryspise,nathrezim,288,priest,shadow,12,3,9
Malacanter,stormrage,288,priest,shadow,12,3,9
Twistedbunny,zuljin,287,priest,shadow,6,3,3
Neehow,hyjal,287,priest,shadow,6,3,3
Grímmz,veknilash,287,priest,shadow,7,3,4
Telamorstus,illidan,287,priest,shadow,12,3,9
Kyriana,doomhammer,287,priest,shadow,18,3,15
Runswithrain,lethon,271,priest,shadow,17,3,14
Drzz,tichondrius,256,priest,shadow,4,4,0
Nmm,ravencrest,239,priest,shadow,5,3,2
Nuggetree,tichondrius,239,priest,shadow,5,3,2
Kikkomán,tichondrius,239,priest,shadow,11,3,8
Mindrip,illidan,234,priest,shadow,6,4,2
Risedead,azralon,234,priest,shadow,10,4,6
Actiop,stormrage,223,priest,shadow,8,3,5
Beeffdaddy,tichondrius,223,priest,shadow,8,3,5
Suppòrt,stormrage,192,priest,shadow,4,3,1
Shadowblax,thrall,192,priest,shadow,4,3,1
Donkeycube,tichondrius,192,priest,shadow,4,3,1
Holyhand,auchindoun,192,priest,shadow,4,3,1
Vladsacer,nemesis,192,priest,shadow,9,3,6
Doctafuzz,muradin,192,priest,shadow,6,2,4
Onlyphantoms,kelthuzad,192,priest,shadow,6,2,4
Dogfrompark,illidan,192,priest,shadow,6,2,4
Innergee,aegwynn,192,priest,shadow,6,2,4
Lemmiewinkzx,sargeras,192,priest,shadow,6,2,4
Löstský,azralon,192,priest,shadow,6,2,4
Pandiwoodney,ragnaros,192,priest,shadow,6,2,4
Hail,kaelthas,192,priest,shadow,6,2,4
Kälashnikova,ragnaros,192,priest,shadow,6,2,4
Murkqz,azralon,192,priest,shadow,6,2,4
Dippyzs,alterac-mountains,192,priest,shadow,6,2,4
Avanise,blackrock,192,priest,shadow,6,2,4
Chen,chogall,192,priest,shadow,6,2,4
Fatfinger,stormrage,192,priest,shadow,6,2,4
Selspriest,kelthuzad,192,priest,shadow,6,2,4
Kryoff,illidan,192,priest,shadow,6,2,4
Thewizard,blackrock,192,priest,shadow,6,2,4
Jjaeminkim,area-52,192,priest,shadow,6,2,4
Orethon,thrall,192,priest,shadow,6,2,4
Xyanydê,zuljin,192,priest,shadow,6,2,4
Vanzera,thrall,192,priest,shadow,6,2,4
Ptheld,tichondrius,192,priest,shadow,6,2,4
Voidnoodles,area-52,192,priest,shadow,6,2,4
Tomriddlle,sargeras,192,priest,shadow,6,2,4
Chellelia,stormrage,192,priest,shadow,6,2,4
Kapriestsun,sargeras,192,priest,shadow,6,2,4
Edhelin,illidan,192,priest,shadow,6,2,4
Spacepaq,bleeding-hollow,192,priest,shadow,6,2,4
Slowbreeze,sargeras,192,priest,shadow,6,2,4
Luísthian,quelthalas,192,priest,shadow,6,2,4
Ateras,emerald-dream,192,priest,shadow,6,2,4
Deprive,tichondrius,192,priest,shadow,6,2,4
Thaldrum,tichondrius,192,priest,shadow,6,2,4
Projectalice,ravencrest,192,priest,shadow,6,2,4
Viroga,stormrage,192,priest,shadow,6,2,4
Priést,stormrage,192,priest,shadow,6,2,4
Nodorme,quelthalas,192,priest,shadow,6,2,4
Horsegirls,kelthuzad,192,priest,shadow,6,2,4
Pugsmugglerr,icecrown,192,priest,shadow,6,2,4
Dagaen,thunderlord,192,priest,shadow,6,2,4
Detainedz,malganis,192,priest,shadow,6,2,4
Impur,zuljin,192,priest,shadow,6,2,4
Sshhaaddooww,tichondrius,192,priest,shadow,6,2,4
Quinnx,tichondrius,192,priest,shadow,6,2,4
Sorojín,zuljin,192,priest,shadow,6,2,4
Notgoodatsp,bleeding-hollow,192,priest,shadow,6,2,4
Hgbvljag,proudmoore,192,priest,shadow,6,2,4
Psychohazard,area-52,192,priest,shadow,6,2,4
Kalibaby,darkspear,192,priest,shadow,6,2,4
Hevnlyst,proudmoore,192,priest,shadow,6,2,4
Laq,proudmoore,192,priest,shadow,6,2,4
Vinatt,illidan,192,priest,shadow,6,2,4
Fleshliight,area-52,192,priest,shadow,6,2,4
Fatherleem,tichondrius,192,priest,shadow,6,2,4
Midget,darkspear,192,priest,shadow,6,2,4
Cxmplex,malganis,192,priest,shadow,6,2,4
Sungai,thrall,192,priest,shadow,6,2,4
Reckless,kirin-tor,192,priest,shadow,6,2,4
Dotdotdead,earthen-ring,192,priest,shadow,6,2,4
Sashatwo,proudmoore,192,priest,shadow,6,2,4
Furryoflife,suramar,192,priest,shadow,6,2,4
Layons,nemesis,192,priest,shadow,6,2,4
Offwhit,azralon,192,priest,shadow,6,2,4
Anxìetý,area-52,192,priest,shadow,6,2,4
Massivepuss,illidan,192,priest,shadow,6,2,4
Apâthy,area-52,192,priest,shadow,6,2,4
Nynaeve,emerald-dream,192,priest,shadow,6,2,4
Brounly,drakkari,192,priest,shadow,6,2,4
Unholywood,lightbringer,192,priest,shadow,6,2,4
Judis,barthilas,192,priest,shadow,6,2,4
Lifejuice,tichondrius,192,priest,shadow,6,2,4
Lolsithlord,tichondrius,192,priest,shadow,6,2,4
Shrax,emerald-dream,192,priest,shadow,6,2,4
Enochian,hyjal,192,priest,shadow,6,2,4
Clairvoyantt,tichondrius,192,priest,shadow,6,2,4
Meehow,lightninghoof,192,priest,shadow,6,2,4
Sâishâ,proudmoore,192,priest,shadow,6,2,4
Zarkos,area-52,192,priest,shadow,6,2,4
Juliusceazer,skywall,192,priest,shadow,6,2,4
Voidwyrm,tichondrius,192,priest,shadow,6,2,4
Theono,sargeras,192,priest,shadow,6,2,4
Fadestepx,stormrage,192,priest,shadow,6,2,4
Aape,frostmourne,192,priest,shadow,6,2,4
Clickbait,spirestone,192,priest,shadow,6,2,4
Geoat,barthilas,192,priest,shadow,6,2,4
Auntiegrimm,silvermoon,192,priest,shadow,6,2,4
Trenance,barthilas,192,priest,shadow,6,2,4
Melithor,frostmourne,192,priest,shadow,6,2,4
Biggina,vashj,192,priest,shadow,6,2,4
Alukel,moon-guard,192,priest,shadow,6,2,4
Shmmoie,frostmourne,192,priest,shadow,6,2,4
Byungsik,terenas,192,priest,shadow,6,2,4
Purrpleelff,saurfang,192,priest,shadow,6,2,4
Lyontnmetal,moon-guard,192,priest,shadow,6,2,4
Beertriarch,frostmourne,192,priest,shadow,6,2,4
Kahine,thaurissan,192,priest,shadow,6,2,4
Apparìtions,khazgoroth,192,priest,shadow,6,2,4
Pipete,frostmourne,192,priest,shadow,6,2,4
Hrathren,caelestrasz,192,priest,shadow,6,2,4
Fraggydaddy,frostmourne,192,priest,shadow,6,2,4
Caristae,kelthuzad,192,priest,shadow,12,2,10
Dalyeth,blackrock,192,priest,shadow,12,2,10
Aphôtic,moon-guard,192,priest,shadow,12,2,10
Alizhe,ragnaros,192,priest,shadow,12,2,10
Painful,arathor,192,priest,shadow,12,2,10
Killuminati,hyjal,192,priest,shadow,12,2,10
Kodaks,frostmourne,192,priest,shadow,12,2,10
Belfalst,shandris,192,priest,shadow,12,2,10
Jimmyjangle,kelthuzad,192,priest,shadow,12,2,10
Ozztwo,tichondrius,192,priest,shadow,12,2,10
Kulrig,shuhalo,192,priest,shadow,12,2,10
Tmpriest,tichondrius,175,priest,shadow,11,2,9
Chü,dalaran,169,priest,shadow,12,5,7
Nychka,kelthuzad,160,priest,shadow,10,2,8
Xeevoos,nemesis,159,priest,shadow,5,2,3
Tiizz,malganis,159,priest,shadow,5,2,3
Juckerr,tichondrius,159,priest,shadow,5,2,3
Lilpurp,sargeras,159,priest,shadow,5,2,3
Pugadin,bleeding-hollow,159,priest,shadow,5,2,3
Gobananas,bleeding-hollow,159,priest,shadow,5,2,3
Tlolopolopo,quelthalas,159,priest,shadow,5,2,3
Dekomori,quelthalas,159,priest,shadow,5,2,3
Myndz,stormrage,159,priest,shadow,5,2,3
Gaeira,azralon,159,priest,shadow,11,2,9
Winss,tichondrius,128,priest,shadow,4,2,2
Dingldangle,tichondrius,128,priest,shadow,4,2,2
Cravex,stormrage,128,priest,shadow,4,2,2
Sätîvá,tichondrius,96,priest,shadow,3,2,1
Priestthingz,area-52,96,priest,shadow,8,2,6
Jèf,stormrage,96,priest,shadow,6,1,5
Omygawd,tichondrius,96,priest,shadow,6,1,5
Cultists,tichondrius,96,priest,shadow,6,1,5
Syrul,tichondrius,96,priest,shadow,6,1,5
Onlysams,sargeras,96,priest,shadow,6,1,5
Cáscá,stormrage,96,priest,shadow,6,1,5
Manryu,tichondrius,96,priest,shadow,6,1,5
Leliane,tichondrius,96,priest,shadow,6,1,5
Baerybonds,kiljaeden,96,priest,shadow,6,1,5
Nostrande,stormrage,96,priest,shadow,6,1,5
Zway,moon-guard,96,priest,shadow,6,1,5
Pmpn,tichondrius,96,priest,shadow,6,1,5
Digop,azralon,96,priest,shadow,6,1,5
Icespice,anvilmar,96,priest,shadow,6,1,5
Dadsalad,zuljin,96,priest,shadow,6,1,5
Dazzlems,tichondrius,96,priest,shadow,6,1,5
Fámóus,stormrage,96,priest,shadow,6,1,5
Zymmie,moon-guard,96,priest,shadow,6,1,5
Torturex,zuljin,96,priest,shadow,6,1,5
Kelody,zuljin,96,priest,shadow,6,1,5
Wombitpurple,azgalor,96,priest,shadow,6,1,5
Althlon,emerald-dream,96,priest,shadow,6,1,5
Nightboxer,tichondrius,96,priest,shadow,6,1,5
Mauriel,proudmoore,96,priest,shadow,6,1,5
Mental,deathwing,96,priest,shadow,6,1,5
Vyndictus,shattered-hand,96,priest,shadow,6,1,5
Stunsilence,tichondrius,96,priest,shadow,6,1,5
Voidzx,tichondrius,96,priest,shadow,6,1,5
Poilu,laughing-skull,96,priest,shadow,6,1,5
Squekp,laughing-skull,96,priest,shadow,6,1,5
Cärdi,frostmourne,96,priest,shadow,6,1,5
Marleylei,nesingwary,96,priest,shadow,6,1,5
Tiskka,magtheridon,96,priest,shadow,6,1,5
Psyward,tichondrius,96,priest,shadow,6,1,5
Whatsittoya,tichondrius,96,priest,shadow,6,1,5
Óst,tichondrius,96,priest,shadow,6,1,5
Drippyjoones,sargeras,96,priest,shadow,6,1,5
Slspookyx,tichondrius,96,priest,shadow,6,1,5
Bigdaddios,dalaran,96,priest,shadow,6,1,5
Lukaspriest,proudmoore,96,priest,shadow,6,1,5
Sadury,tichondrius,96,priest,shadow,6,1,5
Lilskizz,dalaran,96,priest,shadow,6,1,5
Dawnbréaker,azralon,96,priest,shadow,6,1,5
Paingivër,drakkari,96,priest,shadow,6,1,5
Sprinkling,sargeras,96,priest,shadow,6,1,5
Rays,drakkari,96,priest,shadow,6,1,5
Mangemoélqc,darkspear,96,priest,shadow,6,1,5
Vdip,illidan,96,priest,shadow,6,1,5
Amikam,barthilas,96,priest,shadow,6,1,5
Oxyy,aerie-peak,96,priest,shadow,6,1,5
Galestick,illidan,96,priest,shadow,6,1,5
Nancynibbler,bleeding-hollow,96,priest,shadow,6,1,5
PlayerWDHGQY,illidan,96,priest,shadow,6,1,5
Karamapang,illidan,96,priest,shadow,6,1,5
Ibangedaqt,malganis,96,priest,shadow,6,1,5
Dwarfxomp,ragnaros,96,priest,shadow,6,1,5
Vineller,malganis,96,priest,shadow,6,1,5
Powerwordwap,malganis,96,priest,shadow,6,1,5
Jaquels,area-52,96,priest,shadow,6,1,5
Beliál,ragnaros,96,priest,shadow,6,1,5
Tusket,black-dragonflight,96,priest,shadow,6,1,5
Wrinkletink,whisperwind,96,priest,shadow,6,1,5
Milliyakk,area-52,96,priest,shadow,6,1,5
Shadowftw,illidan,96,priest,shadow,6,1,5
Iyanne,nemesis,96,priest,shadow,6,1,5
Voidlordx,jubeithos,96,priest,shadow,6,1,5
Releknosleep,frostwolf,96,priest,shadow,6,1,5
Powerwordkfc,kelthuzad,96,priest,shadow,6,1,5
Allaras,eldrethalas,96,priest,shadow,6,1,5
Shadowreck,malganis,96,priest,shadow,6,1,5
Syrillia,wildhammer,96,priest,shadow,6,1,5
Burfdaycake,malganis,96,priest,shadow,6,1,5
Yaelahi,illidan,96,priest,shadow,11,1,10
Kellandis,jubeithos,96,priest,shadow,12,1,11
Jpray,bleeding-hollow,96,priest,shadow,12,1,11
Tallary,azralon,96,priest,shadow,12,1,11
Xïlencer,tichondrius,96,priest,shadow,12,1,11
Murdangus,moon-guard,96,priest,shadow,12,1,11
ßugsy,illidan,96,priest,shadow,12,1,11
Kunof,ragnaros,79,priest,shadow,5,1,4
Xic,thrall,79,priest,shadow,5,1,4
Cervasa,bleeding-hollow,63,priest,shadow,2,2,0
Joktips,proudmoore,48,priest,shadow,3,1,2
Richard,doomhammer,48,priest,shadow,3,1,2
Fadehojx,illidan,42,priest,shadow,9,2,7
Pulpitò,ragnaros,31,priest,shadow,2,1,1
Turelim,illidan,31,priest,shadow,2,1,1
Drpopepurp,tichondrius,31,priest,shadow,2,1,1
Pilixil,bleeding-hollow,16,priest,shadow,1,1,0
Trågédy,azjolnerub,16,priest,shadow,1,1,0
Yellowrose,kelthuzad,2108,rogue,outlaw,121,69,52
Weran,tichondrius,1976,rogue,outlaw,66,34,32
Sadiator,illidan,1876,rogue,outlaw,65,36,29
Dvn,stormrage,1844,rogue,outlaw,54,32,22
Millspec,zuljin,1840,rogue,outlaw,54,33,21
Onethiccboi,tichondrius,1796,rogue,outlaw,78,41,37
Millspec,tichondrius,1762,rogue,outlaw,117,58,59
Supherr,sargeras,1746,rogue,outlaw,83,46,37
Gothamzzing,tichondrius,1738,rogue,outlaw,49,28,21
Xylvána,kiljaeden,1728,rogue,outlaw,126,64,62
Welinth,thunderlord,1724,rogue,outlaw,444,224,220
Dennerdz,tichondrius,1688,rogue,outlaw,47,19,28
Redimído,quelthalas,1674,rogue,outlaw,56,28,28
Lycanthropî,illidan,1655,rogue,outlaw,80,37,43
Arena,uldum,1631,rogue,outlaw,141,67,74
Lardiconn,thrall,1628,rogue,outlaw,42,30,12
Deadracer,moon-guard,1627,rogue,outlaw,60,32,28
Lazeestab,sargeras,1618,rogue,outlaw,172,95,77
Dogeggs,area-52,1609,rogue,outlaw,48,23,25
Càgil,stormrage,1607,rogue,outlaw,34,19,15
Jmaxx,wyrmrest-accord,1603,rogue,outlaw,51,32,19
Gnover,ragnaros,1585,rogue,outlaw,88,45,43
Corevis,moon-guard,1562,rogue,outlaw,60,28,32
Swingonya,stormrage,1562,rogue,outlaw,42,19,23
Blackmont,bleeding-hollow,1544,rogue,outlaw,111,63,48
Supine,illidan,1539,rogue,outlaw,109,58,51
Trêl,velen,1524,rogue,outlaw,141,71,70
Omnïslash,stormrage,1519,rogue,outlaw,54,25,29
Kentaki,tichondrius,1515,rogue,outlaw,60,33,27
Karambit,frostmourne,1486,rogue,outlaw,120,54,66
Trillkage,tichondrius,1483,rogue,outlaw,90,44,46
Heliopolis,bleeding-hollow,1465,rogue,outlaw,36,17,19
Mõtaru,stormrage,1449,rogue,outlaw,66,33,33
Jenaki,gurubashi,1442,rogue,outlaw,62,32,30
Bleaklord,emerald-dream,1440,rogue,outlaw,54,22,32
Disrawen,ragnaros,1438,rogue,outlaw,485,239,246
Mirâge,illidan,1432,rogue,outlaw,61,30,31
Velskud,area-52,1430,rogue,outlaw,82,41,41
Gotosor,quelthalas,1415,rogue,outlaw,144,73,71
Jolly,frostmourne,1413,rogue,outlaw,71,30,41
Fastblast,wyrmrest-accord,1411,rogue,outlaw,30,15,15
Combo,norgannon,1409,rogue,outlaw,167,92,75
Shadowstryfe,tichondrius,1409,rogue,outlaw,47,22,25
Shindeiru,area-52,1399,rogue,outlaw,43,30,13
Mgzx,tichondrius,1399,rogue,outlaw,165,87,78
Fryphilip,dalaran,1397,rogue,outlaw,34,15,19
Luolan,kargath,1378,rogue,outlaw,44,16,28
Itsuksiko,quelthalas,1368,rogue,outlaw,63,30,33
Snakeblisken,emerald-dream,1352,rogue,outlaw,36,15,21
Cidi,moon-guard,1343,rogue,outlaw,48,18,30
Hobblefoot,proudmoore,1340,rogue,outlaw,46,24,22
Jakamungo,area-52,1329,rogue,outlaw,52,26,26
Dross,shadowmoon,1325,rogue,outlaw,30,14,16
Chrisdorner,area-52,1316,rogue,outlaw,25,14,11
Reyskywalker,kelthuzad,1303,rogue,outlaw,24,15,9
Shyzuku,drakkari,1303,rogue,outlaw,44,20,24
Slitherex,thunderlord,1297,rogue,outlaw,51,27,24
Ntrfighter,tichondrius,1258,rogue,outlaw,71,36,35
Cheddery,dalaran,1247,rogue,outlaw,86,46,40
Wátchyoúrbák,wyrmrest-accord,1247,rogue,outlaw,30,14,16
Straite,area-52,1244,rogue,outlaw,24,13,11
Houlton,moon-guard,1234,rogue,outlaw,24,13,11
Aitreena,stormrage,1210,rogue,outlaw,24,13,11
Zanith,wyrmrest-accord,1194,rogue,outlaw,28,15,13
Lovedemtings,dark-iron,1191,rogue,outlaw,28,13,15
Rynica,illidan,1151,rogue,outlaw,53,27,26
Peteylee,stormrage,1150,rogue,outlaw,24,12,12
Mabushi,sargeras,1135,rogue,outlaw,42,15,27
Zogbu,stormrage,1128,rogue,outlaw,42,17,25
Asdestroyerr,tichondrius,1114,rogue,outlaw,26,13,13
Emoond,ragnaros,1110,rogue,outlaw,39,22,17
Vanorn,aerie-peak,1109,rogue,outlaw,60,20,40
Adevoir,hakkar,1099,rogue,outlaw,72,37,35
Itricku,tichondrius,1093,rogue,outlaw,60,23,37
Valefarr,emerald-dream,1090,rogue,outlaw,41,20,21
Zarthrox,bladefist,1086,rogue,outlaw,42,21,21
Johnnyelbows,tichondrius,1078,rogue,outlaw,27,13,14
Azarha,zuljin,1060,rogue,outlaw,66,34,32
Tanadoril,wyrmrest-accord,1051,rogue,outlaw,24,11,13
Wujn,tichondrius,1050,rogue,outlaw,24,11,13
Lumifer,quelthalas,1050,rogue,outlaw,54,18,36
Xyleth,azgalor,1048,rogue,outlaw,53,20,33
Cathat,area-52,1047,rogue,outlaw,24,11,13
Thèory,sargeras,1044,rogue,outlaw,24,11,13
Badpatatas,proudmoore,1043,rogue,outlaw,52,15,37
Amorfirion,frostmourne,1041,rogue,outlaw,24,13,11
Nicademos,bleeding-hollow,1037,rogue,outlaw,18,11,7
Mechamind,draka,1034,rogue,outlaw,18,11,7
Abatoire,wyrmrest-accord,1017,rogue,outlaw,66,31,35
Thuganomics,dark-iron,1008,rogue,outlaw,27,12,15
Lawyergamer,bonechewer,976,rogue,outlaw,44,18,26
Farstrider,tichondrius,974,rogue,outlaw,84,33,51
Hokagesasuke,bleeding-hollow,972,rogue,outlaw,36,14,22
Listrew,stormrage,970,rogue,outlaw,24,12,12
Larmx,tichondrius,960,rogue,outlaw,24,10,14
Inhume,eredar,960,rogue,outlaw,24,10,14
Quapi,tichondrius,959,rogue,outlaw,18,10,8
Preceptor,azralon,956,rogue,outlaw,24,10,14
Nitroxy,quelthalas,950,rogue,outlaw,24,10,14
Stabbymcgee,duskwood,941,rogue,outlaw,24,11,13
Bonizzi,stormrage,940,rogue,outlaw,18,10,8
Shninzy,senjin,910,rogue,outlaw,31,11,20
Pigshank,proudmoore,906,rogue,outlaw,18,10,8
Zeed,ragnaros,866,rogue,outlaw,66,30,36
Donstevano,frostmourne,864,rogue,outlaw,24,9,15
Stabbythorus,stormrage,862,rogue,outlaw,18,9,9
Bebesita,sisters-of-elune,860,rogue,outlaw,18,9,9
Phraze,silvermoon,859,rogue,outlaw,30,14,16
Vîllâîn,tichondrius,859,rogue,outlaw,24,9,15
Yerehmi,quelthalas,852,rogue,outlaw,18,10,8
Ningaturtle,korgath,844,rogue,outlaw,48,19,29
Gfuel,azgalor,827,rogue,outlaw,22,9,13
Fennick,tanaris,823,rogue,outlaw,31,9,22
Tootled,wyrmrest-accord,822,rogue,outlaw,16,10,6
Elitejigsaw,perenolde,822,rogue,outlaw,24,9,15
Sabbathe,kargath,817,rogue,outlaw,26,10,16
Coalie,tichondrius,816,rogue,outlaw,15,9,6
Synj,frostmourne,798,rogue,outlaw,14,9,5
Mhdz,tichondrius,789,rogue,outlaw,24,10,14
Lesty,kelthuzad,768,rogue,outlaw,12,8,4
Cireene,proudmoore,768,rogue,outlaw,12,8,4
Deepsyo,frostmourne,768,rogue,outlaw,12,8,4
Upcrazylol,area-52,768,rogue,outlaw,12,8,4
Yodiegang,tichondrius,768,rogue,outlaw,12,8,4
Airi,darkspear,768,rogue,outlaw,18,8,10
Tarnished,ravenholdt,766,rogue,outlaw,24,8,16
Nvirus,quelthalas,765,rogue,outlaw,18,8,10
Nordedge,stormrage,756,rogue,outlaw,24,8,16
Marraya,area-52,750,rogue,outlaw,18,8,10
Zeetwntyeght,stormrage,747,rogue,outlaw,29,8,21
Gnòme,frostmourne,701,rogue,outlaw,11,8,3
Thompson,bloodscalp,672,rogue,outlaw,12,7,5
Invisidubya,illidan,671,rogue,outlaw,12,7,5
Minuss,rivendare,671,rogue,outlaw,12,7,5
Drsinz,tichondrius,671,rogue,outlaw,18,7,11
Slowtime,quelthalas,671,rogue,outlaw,18,7,11
Vilthoon,sargeras,670,rogue,outlaw,12,7,5
Uzell,sargeras,670,rogue,outlaw,12,7,5
Cosmicò,trollbane,670,rogue,outlaw,12,7,5
Evilkoreanz,tichondrius,670,rogue,outlaw,12,7,5
Jamesallen,silvermoon,659,rogue,outlaw,12,7,5
Adrala,thunderlord,657,rogue,outlaw,12,7,5
Furrykneecap,hyjal,655,rogue,outlaw,12,9,3
Roxy,ghostlands,623,rogue,outlaw,17,7,10
Esky,tichondrius,576,rogue,outlaw,12,6,6
Deeppockets,sargeras,576,rogue,outlaw,12,6,6
Hezi,area-52,576,rogue,outlaw,12,6,6
Sandorrogue,stormrage,576,rogue,outlaw,12,6,6
Riprorin,stormrage,576,rogue,outlaw,18,6,12
Dalaranxp,illidan,576,rogue,outlaw,18,6,12
Drakariano,ragnaros,575,rogue,outlaw,18,6,12
Sprork,kiljaeden,575,rogue,outlaw,18,6,12
Shmoked,moon-guard,575,rogue,outlaw,18,6,12
Geratyere,trollbane,574,rogue,outlaw,18,6,12
Deddyy,zuljin,574,rogue,outlaw,18,6,12
Maglove,nemesis,571,rogue,outlaw,12,6,6
Walyo,stormrage,544,rogue,outlaw,16,7,9
Chapex,ragnaros,511,rogue,outlaw,14,6,8
Tsubamë,tichondrius,480,rogue,outlaw,6,5,1
Sotypical,area-52,480,rogue,outlaw,6,5,1
Tmpikaboo,tichondrius,480,rogue,outlaw,6,5,1
Galfuran,burning-legion,480,rogue,outlaw,12,5,7
Dicenslice,proudmoore,480,rogue,outlaw,12,5,7
Skaven,dunemaul,480,rogue,outlaw,12,5,7
Steviekìcks,frostmourne,480,rogue,outlaw,12,5,7
Bootypie,hyjal,480,rogue,outlaw,12,5,7
Sekkelx,moon-guard,480,rogue,outlaw,12,5,7
Dultz,tichondrius,480,rogue,outlaw,12,5,7
Violetrose,kelthuzad,480,rogue,outlaw,12,5,7
Alexyy,blades-edge,480,rogue,outlaw,12,5,7
Earthinhorn,frostmourne,480,rogue,outlaw,18,5,13
Spikiera,silvermoon,480,rogue,outlaw,18,5,13
Pez,barthilas,480,rogue,outlaw,18,5,13
Falloran,nerzhul,479,rogue,outlaw,12,5,7
Universalize,proudmoore,479,rogue,outlaw,12,5,7
Sasskei,malganis,479,rogue,outlaw,12,5,7
Kasharo,tichondrius,479,rogue,outlaw,12,5,7
Aylyus,kiljaeden,478,rogue,outlaw,12,5,7
Xzarfi,moon-guard,478,rogue,outlaw,30,5,25
Mangaleón,wildhammer,475,rogue,outlaw,12,5,7
Gnork,twisting-nether,475,rogue,outlaw,12,5,7
Alerana,dathremar,474,rogue,outlaw,12,5,7
Darthkelso,arathor,465,rogue,outlaw,24,5,19
Velox,kiljaeden,384,rogue,outlaw,6,4,2
Kents,tichondrius,384,rogue,outlaw,6,4,2
Xylvana,kiljaeden,384,rogue,outlaw,6,4,2
Krypticstab,malganis,384,rogue,outlaw,6,4,2
Flashmob,zuljin,384,rogue,outlaw,6,4,2
Alandoril,tichondrius,384,rogue,outlaw,6,4,2
Xavar,malganis,384,rogue,outlaw,6,4,2
Letty,area-52,384,rogue,outlaw,6,4,2
Jsyn,kiljaeden,384,rogue,outlaw,12,4,8
Sazor,ysera,384,rogue,outlaw,12,4,8
Dayvanie,area-52,384,rogue,outlaw,12,4,8
Showclass,stormrage,384,rogue,outlaw,12,4,8
Darthol,muradin,384,rogue,outlaw,12,4,8
Nello,runetotem,384,rogue,outlaw,12,4,8
Nestha,quelthalas,384,rogue,outlaw,12,4,8
Blingtronx,malganis,384,rogue,outlaw,12,4,8
Subnini,kelthuzad,384,rogue,outlaw,18,4,14
Gheez,quelthalas,383,rogue,outlaw,6,4,2
Katanië,moon-guard,383,rogue,outlaw,12,4,8
Keenstar,moon-guard,383,rogue,outlaw,18,4,14
Houdinilogic,skullcrusher,381,rogue,outlaw,12,4,8
Daftjack,bleeding-hollow,381,rogue,outlaw,12,4,8
Hîzzÿ,ghostlands,350,rogue,outlaw,26,5,21
Siamés,quelthalas,319,rogue,outlaw,14,4,10
Daehyun,moknathal,288,rogue,outlaw,6,3,3
Hepatocyte,anvilmar,288,rogue,outlaw,6,3,3
Dookienotop,thunderhorn,288,rogue,outlaw,6,3,3
Instructor,area-52,288,rogue,outlaw,6,3,3
Bigcolumn,tichondrius,288,rogue,outlaw,6,3,3
Karmagoodttv,stormrage,288,rogue,outlaw,6,3,3
Vierhy,proudmoore,288,rogue,outlaw,6,3,3
Homeschoolx,moon-guard,288,rogue,outlaw,6,3,3
Bàndit,wyrmrest-accord,288,rogue,outlaw,6,3,3
Lacero,bonechewer,288,rogue,outlaw,6,3,3
Hachiwari,moon-guard,288,rogue,outlaw,6,3,3
Whaazz,emerald-dream,288,rogue,outlaw,6,3,3
Twnk,stormrage,288,rogue,outlaw,6,3,3
Hobblefoot,tichondrius,288,rogue,outlaw,6,3,3
Skoalr,thrall,288,rogue,outlaw,6,3,3
Rotjaw,hydraxis,288,rogue,outlaw,6,3,3
Alexdelion,tichondrius,288,rogue,outlaw,6,3,3
Hellstabber,lightbringer,288,rogue,outlaw,6,3,3
Pockettsand,firetree,288,rogue,outlaw,6,3,3
Ghøstfäce,tichondrius,288,rogue,outlaw,6,3,3
Movze,area-52,288,rogue,outlaw,6,3,3
Pikartz,stormrage,288,rogue,outlaw,6,3,3
Slapjak,dalaran,288,rogue,outlaw,6,3,3
Rujkah,archimonde,288,rogue,outlaw,6,3,3
Pilurfs,thrall,288,rogue,outlaw,6,3,3
Machos,azralon,288,rogue,outlaw,6,3,3
Drpibb,ghostlands,288,rogue,outlaw,12,3,9
Ñinjå,alleria,288,rogue,outlaw,18,3,15
Nippsy,aerie-peak,288,rogue,outlaw,18,3,15
Stabyou,sentinels,287,rogue,outlaw,6,3,3
Adysius,malganis,287,rogue,outlaw,6,3,3
Vampireshade,bloodhoof,286,rogue,outlaw,12,3,9
Fenrul,thunderlord,285,rogue,outlaw,12,3,9
Grimthorn,icecrown,285,rogue,outlaw,12,3,9
Smilinjack,ysera,284,rogue,outlaw,12,3,9
Hotboxthefox,illidan,253,rogue,outlaw,11,3,8
Slobernocker,stormrage,192,rogue,outlaw,6,2,4
Eatcheese,sargeras,192,rogue,outlaw,6,2,4
Kpr,sargeras,192,rogue,outlaw,6,2,4
Nïck,korialstrasz,192,rogue,outlaw,6,2,4
Dillwilly,moon-guard,192,rogue,outlaw,6,2,4
Mud,saurfang,192,rogue,outlaw,6,2,4
Creamcakepop,stormrage,192,rogue,outlaw,6,2,4
Matheuzaum,goldrinn,192,rogue,outlaw,6,2,4
Remonezero,moon-guard,192,rogue,outlaw,6,2,4
Duskeron,cenarius,192,rogue,outlaw,6,2,4
Jebubs,tichondrius,192,rogue,outlaw,6,2,4
Touchthetip,bleeding-hollow,192,rogue,outlaw,6,2,4
Squigglies,aerie-peak,192,rogue,outlaw,6,2,4
ßuu,sargeras,192,rogue,outlaw,6,2,4
Prisonshank,arthas,192,rogue,outlaw,6,2,4
Shádyj,velen,192,rogue,outlaw,6,2,4
Vizimyr,malganis,192,rogue,outlaw,12,2,10
Nikosneako,tichondrius,192,rogue,outlaw,12,2,10
Sxs,kiljaeden,192,rogue,outlaw,12,2,10
Pelussy,kiljaeden,192,rogue,outlaw,15,2,13
Manoq,drakkari,191,rogue,outlaw,6,2,4
Landrik,trollbane,191,rogue,outlaw,6,2,4
Òklahomie,frostwolf,191,rogue,outlaw,6,2,4
Philliamson,azgalor,190,rogue,outlaw,12,2,10
Hedillyan,azralon,138,rogue,outlaw,9,3,6
Reginageorge,azuremyst,96,rogue,outlaw,6,1,5
Leiffer,ragnaros,96,rogue,outlaw,6,1,5
Loruk,ragnaros,96,rogue,outlaw,6,1,5
Fateapocryph,azralon,96,rogue,outlaw,6,1,5
Takeiapika,azralon,96,rogue,outlaw,6,1,5
Neilyo,barthilas,96,rogue,outlaw,6,1,5
Sindor,azralon,96,rogue,outlaw,6,1,5
Whatsåpp,gallywix,96,rogue,outlaw,6,1,5
Rinestiria,arthas,96,rogue,outlaw,6,1,5
Denlox,moon-guard,96,rogue,outlaw,6,1,5
Dessenia,illidan,96,rogue,outlaw,6,1,5
Tegernako,firetree,96,rogue,outlaw,6,1,5
Lu,lethon,96,rogue,outlaw,6,1,5
Burt,akama,96,rogue,outlaw,6,1,5
Happyslice,stormrage,96,rogue,outlaw,6,1,5
Raimondo,frostmourne,96,rogue,outlaw,6,1,5
Downsix,sargeras,96,rogue,outlaw,6,1,5
Madge,area-52,96,rogue,outlaw,6,1,5
Xm,sargeras,96,rogue,outlaw,6,1,5
Sleepstryke,stormrage,96,rogue,outlaw,12,1,11
Culpera,undermine,95,rogue,outlaw,6,1,5
Vladdracc,quelthalas,48,rogue,outlaw,3,1,2
Aliasfaker,stormrage,16,rogue,outlaw,1,1,0
Erebüs,thunderlord,2373,rogue,subtlety,120,77,43
Fotg,tichondrius,2265,rogue,subtlety,78,48,30
Battzii,wyrmrest-accord,2170,rogue,subtlety,921,478,443
Alexdelion,tichondrius,2142,rogue,subtlety,90,47,43
Æsshayádlay,tichondrius,2131,rogue,subtlety,81,42,39
Ymxxworld,tichondrius,2107,rogue,subtlety,96,49,47
Thèllè,sargeras,2104,rogue,subtlety,78,46,32
Røgüë,malganis,2100,rogue,subtlety,96,53,43
Kenpàchi,kelthuzad,1995,rogue,subtlety,152,85,67
Hiyõ,tichondrius,1995,rogue,subtlety,190,106,84
Flashmob,zuljin,1991,rogue,subtlety,62,31,31
Danrathm,sargeras,1990,rogue,subtlety,109,59,50
Vendettita,quelthalas,1983,rogue,subtlety,84,47,37
Roguesparrow,illidan,1978,rogue,subtlety,176,99,77
Ajl,drenden,1973,rogue,subtlety,172,88,84
Swadeecup,nagrand,1965,rogue,subtlety,84,41,43
Lies,dalaran,1957,rogue,subtlety,111,53,58
Kidcutti,proudmoore,1952,rogue,subtlety,92,49,43
Zurza,proudmoore,1943,rogue,subtlety,95,44,51
Incoherentz,frostmourne,1940,rogue,subtlety,60,34,26
Rangoons,tichondrius,1938,rogue,subtlety,66,39,27
Cydonian,ragnaros,1937,rogue,subtlety,154,87,67
Yázim,tichondrius,1935,rogue,subtlety,79,48,31
Maulline,tichondrius,1932,rogue,subtlety,60,27,33
Esky,tichondrius,1918,rogue,subtlety,75,40,35
Ulley,sargeras,1914,rogue,subtlety,150,85,65
Norbury,tichondrius,1901,rogue,subtlety,136,67,69
Minaciki,tichondrius,1898,rogue,subtlety,72,41,31
Antoninez,tichondrius,1892,rogue,subtlety,54,29,25
Wetit,illidan,1876,rogue,subtlety,90,60,30
Slashthunder,blades-edge,1876,rogue,subtlety,54,29,25
Needbuff,tichondrius,1865,rogue,subtlety,54,25,29
Wizlysnipz,tichondrius,1859,rogue,subtlety,90,52,38
Coopi,tichondrius,1853,rogue,subtlety,115,60,55
Scuffedjr,tichondrius,1851,rogue,subtlety,96,43,53
Himitu,tichondrius,1849,rogue,subtlety,89,46,43
Stealthypoop,kelthuzad,1845,rogue,subtlety,136,67,69
Coregx,tichondrius,1842,rogue,subtlety,36,24,12
Rõý,area-52,1837,rogue,subtlety,42,23,19
Wazowskiy,tichondrius,1837,rogue,subtlety,181,88,93
Silentkush,arthas,1833,rogue,subtlety,54,33,21
Stunsofpuns,sargeras,1833,rogue,subtlety,60,33,27
Fátálíty,tichondrius,1827,rogue,subtlety,60,30,30
Seengivenchy,zuljin,1825,rogue,subtlety,60,39,21
Smkgpvp,stormrage,1823,rogue,subtlety,68,43,25
Howton,kelthuzad,1822,rogue,subtlety,24,19,5
Beanlord,spinebreaker,1820,rogue,subtlety,93,55,38
Clern,emerald-dream,1818,rogue,subtlety,65,35,30
Ðèãth,area-52,1818,rogue,subtlety,36,19,17
Asoj,tichondrius,1817,rogue,subtlety,60,30,30
Celèphaïs,tichondrius,1817,rogue,subtlety,63,30,33
Stealthyxd,arthas,1815,rogue,subtlety,48,20,28
Ganknvanish,tichondrius,1814,rogue,subtlety,189,96,93
Votekanye,bleeding-hollow,1812,rogue,subtlety,36,28,8
Zerogh,tichondrius,1811,rogue,subtlety,129,75,54
Ideology,azgalor,1811,rogue,subtlety,52,26,26
Sasugay,sargeras,1809,rogue,subtlety,98,61,37
Bigpump,lothar,1809,rogue,subtlety,60,33,27
Bruítzy,barthilas,1809,rogue,subtlety,156,82,74
Dysxliec,dalaran,1808,rogue,subtlety,173,90,83
Díor,azralon,1807,rogue,subtlety,124,70,54
Turtlespeed,thrall,1803,rogue,subtlety,123,74,49
ßaltø,bleeding-hollow,1799,rogue,subtlety,42,19,23
Yunggodmalik,whisperwind,1799,rogue,subtlety,48,19,29
Tyrrantxo,agamaggan,1797,rogue,subtlety,76,42,34
Scuffedsr,tichondrius,1792,rogue,subtlety,48,25,23
Airi,darkspear,1791,rogue,subtlety,85,44,41
Okaylmao,tichondrius,1789,rogue,subtlety,74,41,33
Nightcloud,tichondrius,1785,rogue,subtlety,80,44,36
Kellenx,moon-guard,1780,rogue,subtlety,145,73,72
Shinigâmì,tichondrius,1778,rogue,subtlety,138,83,55
Dvin,stormrage,1770,rogue,subtlety,54,30,24
Gyokkó,sargeras,1770,rogue,subtlety,36,20,16
Gnover,ragnaros,1769,rogue,subtlety,234,136,98
Queuethunder,blades-edge,1756,rogue,subtlety,34,28,6
Greyyfox,illidan,1754,rogue,subtlety,69,33,36
ßuu,sargeras,1749,rogue,subtlety,36,21,15
Aaronjlol,tichondrius,1747,rogue,subtlety,36,23,13
Trc,illidan,1746,rogue,subtlety,50,28,22
Damrat,tichondrius,1743,rogue,subtlety,36,21,15
Marcusr,tichondrius,1739,rogue,subtlety,60,33,27
Lxw,frostmourne,1739,rogue,subtlety,61,29,32
Stabem,moon-guard,1735,rogue,subtlety,99,55,44
Onîkudaki,sargeras,1730,rogue,subtlety,54,23,31
Assassìn,moon-guard,1729,rogue,subtlety,193,104,89
Baeruto,thunderlord,1726,rogue,subtlety,24,18,6
Decóm,zuljin,1725,rogue,subtlety,52,27,25
Brucerogue,tichondrius,1724,rogue,subtlety,326,166,160
Jsnlol,zuljin,1722,rogue,subtlety,30,22,8
Shankntwist,malganis,1722,rogue,subtlety,42,26,16
Axtually,proudmoore,1716,rogue,subtlety,126,69,57
Saprìse,darkspear,1710,rogue,subtlety,72,44,28
Pxb,sargeras,1705,rogue,subtlety,88,40,48
Poizzon,emerald-dream,1704,rogue,subtlety,85,46,39
Majk,eldrethalas,1703,rogue,subtlety,76,37,39
Eekz,illidan,1702,rogue,subtlety,310,172,138
Yoskit,tichondrius,1700,rogue,subtlety,36,21,15
Whoox,khazgoroth,1695,rogue,subtlety,42,29,13
Saltymann,bleeding-hollow,1695,rogue,subtlety,60,35,25
Xiaozhi,tichondrius,1692,rogue,subtlety,52,26,26
Kyubïx,ragnaros,1691,rogue,subtlety,108,66,42
Siyeong,tichondrius,1688,rogue,subtlety,96,57,39
Vellexsis,sargeras,1685,rogue,subtlety,79,41,38
Roguetrix,stormrage,1685,rogue,subtlety,161,80,81
Bobsaget,kiljaeden,1684,rogue,subtlety,94,48,46
Blakezilla,tichondrius,1677,rogue,subtlety,72,42,30
Buffsubrmp,tichondrius,1672,rogue,subtlety,30,19,11
Cut,ragnaros,1672,rogue,subtlety,136,72,64
Yesua,ragnaros,1672,rogue,subtlety,265,134,131
Originalfake,sargeras,1669,rogue,subtlety,45,24,21
Vavnmusic,illidan,1667,rogue,subtlety,78,49,29
Bezeta,azralon,1667,rogue,subtlety,269,144,125
Jaos,tichondrius,1667,rogue,subtlety,42,22,20
Eekz,sargeras,1666,rogue,subtlety,269,139,130
Incognitony,proudmoore,1666,rogue,subtlety,45,22,23
Skitsöu,tichondrius,1665,rogue,subtlety,42,23,19
Vanishcdc,area-52,1664,rogue,subtlety,48,29,19
Chitovera,tichondrius,1663,rogue,subtlety,36,25,11
Zeiss,tichondrius,1663,rogue,subtlety,54,27,27
Yurasick,lightbringer,1657,rogue,subtlety,42,26,16
Themosk,malganis,1656,rogue,subtlety,42,21,21
Camlaw,area-52,1655,rogue,subtlety,90,52,38
Aman,frostmourne,1653,rogue,subtlety,47,29,18
Ðankbud,barthilas,1649,rogue,subtlety,39,19,20
Esmeraldas,frostmourne,1644,rogue,subtlety,53,28,25
Zipperx,tichondrius,1641,rogue,subtlety,65,34,31
Steef,arygos,1636,rogue,subtlety,92,54,38
Îzu,ysera,1636,rogue,subtlety,63,36,27
Fence,moon-guard,1635,rogue,subtlety,48,28,20
Tmskitsou,tichondrius,1634,rogue,subtlety,34,20,14
Furt,frostmourne,1633,rogue,subtlety,44,25,19
Mesqeets,kelthuzad,1632,rogue,subtlety,41,24,17
Nicoaa,tichondrius,1631,rogue,subtlety,194,99,95
Garrotte,tichondrius,1631,rogue,subtlety,140,67,73
Lxke,stormrage,1630,rogue,subtlety,34,22,12
Frusciante,nemesis,1630,rogue,subtlety,90,52,38
Haiev,tichondrius,1630,rogue,subtlety,72,36,36
Stepcurry,tichondrius,1629,rogue,subtlety,36,26,10
Antos,tichondrius,1628,rogue,subtlety,24,17,7
Shreddér,tichondrius,1628,rogue,subtlety,41,20,21
Spookyboogie,aegwynn,1624,rogue,subtlety,64,36,28
Gotto,icecrown,1623,rogue,subtlety,47,24,23
Gptcodeplay,tichondrius,1622,rogue,subtlety,36,25,11
Cuizhudi,tichondrius,1620,rogue,subtlety,50,31,19
Bruitzygg,barthilas,1619,rogue,subtlety,44,20,24
Klawz,norgannon,1618,rogue,subtlety,53,32,21
Neonjk,ragnaros,1618,rogue,subtlety,78,43,35
Astroz,sargeras,1615,rogue,subtlety,42,21,21
Mirâge,illidan,1614,rogue,subtlety,108,59,49
Preceptor,azralon,1614,rogue,subtlety,86,44,42
Energy,auchindoun,1612,rogue,subtlety,56,34,22
Frez,amanthul,1611,rogue,subtlety,30,20,10
Rosoma,kelthuzad,1610,rogue,subtlety,65,38,27
Ozzinton,kelthuzad,1609,rogue,subtlety,30,17,13
Lululee,tichondrius,1609,rogue,subtlety,63,28,35
Piscís,sargeras,1606,rogue,subtlety,60,31,29
Kazzo,tichondrius,1605,rogue,subtlety,45,32,13
Skoalr,thrall,1604,rogue,subtlety,64,43,21
Bombman,tichondrius,1604,rogue,subtlety,125,62,63
Taidath,area-52,1603,rogue,subtlety,42,20,22
Runakó,kelthuzad,1603,rogue,subtlety,48,21,27
Karmagoodttv,stormrage,1602,rogue,subtlety,34,22,12
Dogpaws,moon-guard,1600,rogue,subtlety,46,30,16
Techie,frostmane,1600,rogue,subtlety,68,38,30
Hayzarc,malfurion,1598,rogue,subtlety,42,21,21
Kalvish,dalaran,1597,rogue,subtlety,29,17,12
Vyrenn,destromath,1597,rogue,subtlety,103,50,53
Mtvcribs,emerald-dream,1596,rogue,subtlety,37,22,15
Fancen,drakthul,1591,rogue,subtlety,54,31,23
Saulgoodz,tichondrius,1590,rogue,subtlety,42,23,19
Unshut,tichondrius,1588,rogue,subtlety,30,19,11
Ateabug,wyrmrest-accord,1587,rogue,subtlety,30,17,13
Wowamaze,aegwynn,1584,rogue,subtlety,118,64,54
Tigerinu,stormreaver,1584,rogue,subtlety,52,26,26
Cahlee,sargeras,1582,rogue,subtlety,147,70,77
Saltypwncake,illidan,1580,rogue,subtlety,42,20,22
Jolly,frostmourne,1574,rogue,subtlety,82,47,35
Rufian,ursin,1574,rogue,subtlety,72,40,32
Jawnrogue,tichondrius,1572,rogue,subtlety,30,22,8
Jibdorf,destromath,1571,rogue,subtlety,60,38,22
Åer,dalaran,1566,rogue,subtlety,135,71,64
Overdríver,emerald-dream,1566,rogue,subtlety,36,17,19
Trizin,frostmourne,1563,rogue,subtlety,84,45,39
Amonn,arthas,1558,rogue,subtlety,125,60,65
Tootsio,tichondrius,1557,rogue,subtlety,42,22,20
Revelationzz,turalyon,1557,rogue,subtlety,133,68,65
Acid,warsong,1555,rogue,subtlety,36,23,13
Faelanna,stormrage,1554,rogue,subtlety,79,40,39
Grelinho,stormrage,1554,rogue,subtlety,66,26,40
Stunz,mugthol,1553,rogue,subtlety,62,41,21
Ghyile,stormreaver,1552,rogue,subtlety,36,18,18
Tarny,illidan,1551,rogue,subtlety,64,27,37
Lurios,rivendare,1547,rogue,subtlety,88,48,40
Zaszune,stormrage,1545,rogue,subtlety,30,18,12
Whoô,khazgoroth,1545,rogue,subtlety,84,44,40
Kinbaal,bleeding-hollow,1544,rogue,subtlety,42,26,16
Sandorroguee,stormrage,1544,rogue,subtlety,36,18,18
Danielsylerr,drakkari,1543,rogue,subtlety,42,18,24
Threeplates,silvermoon,1538,rogue,subtlety,93,50,43
Clownboots,tichondrius,1538,rogue,subtlety,145,72,73
Prrey,hydraxis,1536,rogue,subtlety,103,46,57
Mayhemghost,rexxar,1535,rogue,subtlety,72,40,32
Mitsurí,sargeras,1534,rogue,subtlety,24,16,8
Fela,crushridge,1534,rogue,subtlety,148,75,73
Eviscerator,moon-guard,1532,rogue,subtlety,107,48,59
Wansuiye,tichondrius,1528,rogue,subtlety,24,16,8
Rhythmic,ysera,1526,rogue,subtlety,24,16,8
Qq,doomhammer,1526,rogue,subtlety,36,18,18
Axerax,draka,1525,rogue,subtlety,48,24,24
ßeep,windrunner,1525,rogue,subtlety,48,24,24
Corde,hyjal,1523,rogue,subtlety,32,20,12
Dissociated,stormrage,1523,rogue,subtlety,47,17,30
Worrglaive,dalaran,1517,rogue,subtlety,170,91,79
Plado,tichondrius,1517,rogue,subtlety,83,44,39
Whispx,malganis,1517,rogue,subtlety,36,18,18
Lilshanker,tichondrius,1516,rogue,subtlety,62,30,32
Taliwis,burning-blade,1516,rogue,subtlety,36,17,19
Feinting,moon-guard,1514,rogue,subtlety,24,16,8
Killmebaby,lightnings-blade,1514,rogue,subtlety,54,29,25
Usernameqtxo,kelthuzad,1514,rogue,subtlety,135,68,67
Broddz,sargeras,1512,rogue,subtlety,54,30,24
Bugser,tichondrius,1511,rogue,subtlety,96,52,44
Greasybbsea,illidan,1511,rogue,subtlety,126,63,63
Laaggul,tichondrius,1509,rogue,subtlety,24,16,8
Morriz,tichondrius,1505,rogue,subtlety,84,52,32
Brangs,ragnaros,1505,rogue,subtlety,48,27,21
Wongski,darkspear,1503,rogue,subtlety,34,23,11
Illmatíc,kelthuzad,1502,rogue,subtlety,29,16,13
Cerut,illidan,1499,rogue,subtlety,52,27,25
Galaxybrain,icecrown,1498,rogue,subtlety,120,76,44
Huskyi,dalaran,1498,rogue,subtlety,60,30,30
Nargonis,illidan,1497,rogue,subtlety,38,23,15
Eridian,tichondrius,1495,rogue,subtlety,115,58,57
Errorless,moon-guard,1494,rogue,subtlety,66,34,32
Nítzy,quelthalas,1493,rogue,subtlety,54,26,28
Sit,frostwolf,1492,rogue,subtlety,70,39,31
Linkzq,frostmourne,1492,rogue,subtlety,41,17,24
Slap,icecrown,1491,rogue,subtlety,42,17,25
Delphyax,azralon,1489,rogue,subtlety,30,16,14
Pngöd,area-52,1488,rogue,subtlety,29,19,10
Aghanaar,burning-legion,1488,rogue,subtlety,56,27,29
Luradfate,dalaran,1486,rogue,subtlety,275,143,132
Greasymarheo,area-52,1486,rogue,subtlety,66,32,34
Swanl,stormrage,1483,rogue,subtlety,71,39,32
Saraelith,moon-guard,1480,rogue,subtlety,51,29,22
Pichichi,frostmourne,1479,rogue,subtlety,69,41,28
Jinglez,frostmourne,1478,rogue,subtlety,36,22,14
Kidneyisntop,illidan,1478,rogue,subtlety,30,16,14
Speedboi,skullcrusher,1477,rogue,subtlety,134,80,54
Mosedz,tichondrius,1474,rogue,subtlety,48,28,20
Woollord,frostmourne,1474,rogue,subtlety,48,28,20
Roguechamp,aggramar,1471,rogue,subtlety,41,20,21
Pince,black-dragonflight,1470,rogue,subtlety,39,22,17
Morpheûs,tichondrius,1470,rogue,subtlety,52,27,25
Ctrlfreak,hellscream,1468,rogue,subtlety,96,55,41
Swiftdeaths,queldorei,1468,rogue,subtlety,74,37,37
Kaliasteddin,area-52,1467,rogue,subtlety,80,40,40
Tulis,frostmourne,1462,rogue,subtlety,164,96,68
Hotcarl,kiljaeden,1462,rogue,subtlety,46,26,20
Oldgate,azralon,1462,rogue,subtlety,41,23,18
Xandroesh,darkspear,1461,rogue,subtlety,54,31,23
Stankyx,bleeding-hollow,1460,rogue,subtlety,66,37,29
Vigílant,proudmoore,1460,rogue,subtlety,84,41,43
Toxsith,tichondrius,1459,rogue,subtlety,74,43,31
Scenna,stormrage,1457,rogue,subtlety,78,33,45
Axiy,stormrage,1455,rogue,subtlety,65,35,30
Rigotak,illidan,1453,rogue,subtlety,106,54,52
Twotimed,magtheridon,1452,rogue,subtlety,48,27,21
Vyll,stormrage,1452,rogue,subtlety,31,16,15
Krolczz,tichondrius,1449,rogue,subtlety,76,46,30
Murked,barthilas,1449,rogue,subtlety,54,31,23
Trucidovaco,daggerspine,1449,rogue,subtlety,88,40,48
Zernaz,thrall,1448,rogue,subtlety,66,33,33
ßecomeðeath,tichondrius,1446,rogue,subtlety,47,24,23
Welinth,thunderlord,1445,rogue,subtlety,60,28,32
Géminis,sargeras,1444,rogue,subtlety,30,17,13
Kainm,stormrage,1443,rogue,subtlety,272,139,133
Rougething,bleeding-hollow,1443,rogue,subtlety,72,35,37
Lagault,muradin,1442,rogue,subtlety,108,64,44
Bloodylegend,altar-of-storms,1442,rogue,subtlety,36,21,15
Saintt,khaz-modan,1439,rogue,subtlety,36,24,12
Dismayx,tichondrius,1438,rogue,subtlety,42,21,21
Kents,tichondrius,1438,rogue,subtlety,36,15,21
Calebrogue,illidan,1436,rogue,subtlety,24,15,9
Ricros,bleeding-hollow,1435,rogue,subtlety,43,20,23
Smormu,bonechewer,1432,rogue,subtlety,36,17,19
Epipenqt,dark-iron,1431,rogue,subtlety,42,26,16
Hunchó,area-52,1431,rogue,subtlety,77,44,33
Abacura,moon-guard,1431,rogue,subtlety,124,69,55
Chãlons,tichondrius,1431,rogue,subtlety,84,42,42
Deadguys,tichondrius,1430,rogue,subtlety,72,37,35
Weenies,illidan,1425,rogue,subtlety,53,27,26
Superharry,tichondrius,1423,rogue,subtlety,72,38,34
Neilyo,barthilas,1423,rogue,subtlety,101,51,50
Kibbs,korgath,1422,rogue,subtlety,60,30,30
Xleo,drakkari,1422,rogue,subtlety,185,91,94
Smolblade,nordrassil,1422,rogue,subtlety,35,17,18
Humphugull,skullcrusher,1422,rogue,subtlety,47,18,29
Ironfistofcn,tichondrius,1421,rogue,subtlety,72,40,32
Pressuret,frostmourne,1420,rogue,subtlety,41,23,18
Zefeckz,tichondrius,1420,rogue,subtlety,59,29,30
Tolthe,hyjal,1418,rogue,subtlety,80,40,40
Fulkrem,wyrmrest-accord,1410,rogue,subtlety,74,34,40
Notty,kelthuzad,1408,rogue,subtlety,77,43,34
Cv,proudmoore,1404,rogue,subtlety,42,23,19
Pleodonis,tichondrius,1402,rogue,subtlety,77,39,38
Quinity,wyrmrest-accord,1401,rogue,subtlety,186,94,92
Klâng,tichondrius,1399,rogue,subtlety,148,72,76
Arakine,uldaman,1398,rogue,subtlety,38,27,11
Bakedpotato,garithos,1398,rogue,subtlety,66,33,33
Hickery,frostmourne,1396,rogue,subtlety,36,21,15
Sparqxx,tichondrius,1396,rogue,subtlety,45,26,19
Fkrueger,thrall,1396,rogue,subtlety,63,33,30
Hakuchi,tichondrius,1396,rogue,subtlety,31,15,16
Seaki,illidan,1395,rogue,subtlety,23,15,8
Lilplato,area-52,1395,rogue,subtlety,24,15,9
Pãx,stormrage,1395,rogue,subtlety,24,15,9
Yanh,tichondrius,1395,rogue,subtlety,36,16,20
Harlyfknquin,jubeithos,1394,rogue,subtlety,100,55,45
Ziyanbaby,thunderlord,1392,rogue,subtlety,24,15,9
Darkìs,tichondrius,1390,rogue,subtlety,36,19,17
Fofree,hyjal,1389,rogue,subtlety,76,41,35
Odelöt,drakkari,1387,rogue,subtlety,108,59,49
Loquen,ragnaros,1387,rogue,subtlety,66,36,30
Neuschurke,warsong,1386,rogue,subtlety,42,23,19
Sgtbuttfat,dalaran,1385,rogue,subtlety,41,20,21
Tapwaterx,illidan,1385,rogue,subtlety,78,33,45
Najohn,tichondrius,1384,rogue,subtlety,42,20,22
Secrettecbot,barthilas,1383,rogue,subtlety,36,20,16
Nooz,thrall,1382,rogue,subtlety,107,62,45
Lyfallah,proudmoore,1381,rogue,subtlety,136,75,61
Shaoriel,zuljin,1380,rogue,subtlety,24,15,9
Søprøle,ragnaros,1380,rogue,subtlety,98,57,41
Vanvanlords,azralon,1379,rogue,subtlety,78,34,44
Pikabuu,bleeding-hollow,1377,rogue,subtlety,75,32,43
Orîon,scilla,1376,rogue,subtlety,36,20,16
Termkilledu,moon-guard,1375,rogue,subtlety,132,74,58
Gloòm,stormrage,1373,rogue,subtlety,24,16,8
Ojibwe,tichondrius,1373,rogue,subtlety,28,15,13
Kolander,tichondrius,1373,rogue,subtlety,58,29,29
Gøblìn,tichondrius,1373,rogue,subtlety,126,52,74
Stanley,mugthol,1371,rogue,subtlety,39,23,16
Goatforsale,tichondrius,1371,rogue,subtlety,28,16,12
Suhwooh,area-52,1366,rogue,subtlety,67,37,30
Stêf,zuljin,1365,rogue,subtlety,85,53,32
Grinjuk,area-52,1365,rogue,subtlety,29,16,13
Jadier,emerald-dream,1361,rogue,subtlety,47,24,23
Sapyalater,thrall,1361,rogue,subtlety,192,98,94
Jujudaddy,sargeras,1360,rogue,subtlety,42,23,19
Emrogr,tichondrius,1360,rogue,subtlety,81,44,37
Guiguzidr,illidan,1359,rogue,subtlety,124,69,55
Raymga,tichondrius,1355,rogue,subtlety,48,29,19
Denoms,area-52,1351,rogue,subtlety,54,23,31
Hahaurblind,perenolde,1347,rogue,subtlety,62,31,31
Narcoleptic,dalaran,1346,rogue,subtlety,84,40,44
Clayton,frostmourne,1344,rogue,subtlety,49,24,25
Leftyleaf,proudmoore,1343,rogue,subtlety,24,15,9
Sketchyweas,sargeras,1342,rogue,subtlety,44,17,27
Corrier,tichondrius,1340,rogue,subtlety,24,14,10
Tiladar,tichondrius,1339,rogue,subtlety,24,14,10
Adept,whisperwind,1338,rogue,subtlety,24,14,10
Notxerian,stormrage,1338,rogue,subtlety,24,14,10
Spacebase,illidan,1337,rogue,subtlety,24,14,10
Eazyg,tichondrius,1336,rogue,subtlety,24,14,10
Nines,icecrown,1336,rogue,subtlety,30,14,16
Brendantko,arthas,1334,rogue,subtlety,30,14,16
Genève,dreadmaul,1327,rogue,subtlety,24,14,10
Frèyjä,bleeding-hollow,1327,rogue,subtlety,152,81,71
Pegglerogue,fizzcrank,1326,rogue,subtlety,184,90,94
Hollowshade,hydraxis,1323,rogue,subtlety,30,16,14
Dustt,stormrage,1322,rogue,subtlety,30,21,9
Luolan,kargath,1322,rogue,subtlety,30,15,15
Sahima,tichondrius,1320,rogue,subtlety,210,111,99
Gankolicious,nerzhul,1317,rogue,subtlety,18,14,4
Sinnister,queldorei,1317,rogue,subtlety,24,18,6
Kahlx,azralon,1317,rogue,subtlety,90,42,48
Täy,thrall,1316,rogue,subtlety,89,45,44
Tamsy,the-forgotten-coast,1315,rogue,subtlety,21,15,6
Lozion,malganis,1315,rogue,subtlety,42,17,25
Pgo,tichondrius,1314,rogue,subtlety,24,16,8
Shilaya,dreadmaul,1311,rogue,subtlety,36,14,22
Leprocy,tichondrius,1309,rogue,subtlety,22,15,7
Riggz,burning-blade,1308,rogue,subtlety,68,35,33
Thugspice,stormrage,1308,rogue,subtlety,59,30,29
Faxingberlin,skullcrusher,1306,rogue,subtlety,36,15,21
Lisnp,tichondrius,1304,rogue,subtlety,206,98,108
Khorgan,mugthol,1301,rogue,subtlety,36,18,18
Învîsîßull,illidan,1301,rogue,subtlety,34,14,20
Sabedoria,barthilas,1300,rogue,subtlety,96,49,47
Pocketman,barthilas,1299,rogue,subtlety,59,24,35
Autumnsedge,area-52,1299,rogue,subtlety,48,18,30
Bríng,illidan,1298,rogue,subtlety,47,29,18
Eraticrogue,illidan,1298,rogue,subtlety,35,15,20
Flockavelli,zuljin,1296,rogue,subtlety,79,39,40
Vuye,moon-guard,1292,rogue,subtlety,53,21,32
Vaith,wyrmrest-accord,1291,rogue,subtlety,78,33,45
Turec,illidan,1290,rogue,subtlety,29,14,15
Eryx,mugthol,1289,rogue,subtlety,30,19,11
Orangez,malfurion,1289,rogue,subtlety,36,21,15
Insanctus,malganis,1287,rogue,subtlety,23,14,9
Vellkann,azralon,1284,rogue,subtlety,30,21,9
Oatmealcrisp,thrall,1284,rogue,subtlety,36,21,15
Oilyrock,tichondrius,1284,rogue,subtlety,78,44,34
Lefteex,tichondrius,1282,rogue,subtlety,80,43,37
Liryth,lightninghoof,1281,rogue,subtlety,51,29,22
Ikmagine,icecrown,1281,rogue,subtlety,42,17,25
Shellby,tichondrius,1277,rogue,subtlety,92,49,43
Macsap,frostmourne,1277,rogue,subtlety,66,35,31
Sapùwú,stormrage,1277,rogue,subtlety,112,56,56
Hmmkek,frostmourne,1276,rogue,subtlety,23,14,9
Lagula,ragnaros,1274,rogue,subtlety,23,17,6
Ikerz,tichondrius,1272,rogue,subtlety,27,14,13
Shigoo,sargeras,1271,rogue,subtlety,35,15,20
Rezy,lightbringer,1270,rogue,subtlety,41,14,27
Taroo,ragnaros,1268,rogue,subtlety,30,17,13
Dionavelynn,area-52,1267,rogue,subtlety,42,19,23
Pargo,quelthalas,1266,rogue,subtlety,67,30,37
Hollfex,nemesis,1265,rogue,subtlety,44,22,22
Ballflicker,malganis,1264,rogue,subtlety,42,17,25
Hiarolson,stormrage,1263,rogue,subtlety,39,20,19
Kawagreen,tichondrius,1260,rogue,subtlety,51,27,24
Gothblade,malganis,1258,rogue,subtlety,30,15,15
Xoltin,tichondrius,1258,rogue,subtlety,80,36,44
Vap,azralon,1254,rogue,subtlety,36,15,21
Mcromance,khadgar,1253,rogue,subtlety,57,25,32
Glíz,bloodscalp,1250,rogue,subtlety,54,28,26
Mendiant,azralon,1250,rogue,subtlety,125,63,62
Arbitér,moonrunner,1250,rogue,subtlety,64,25,39
Lilstab,hakkar,1249,rogue,subtlety,116,58,58
Tmpikaboo,tichondrius,1248,rogue,subtlety,18,13,5
Kalamarii,stormrage,1246,rogue,subtlety,53,21,32
Seshtime,tichondrius,1245,rogue,subtlety,18,13,5
Mirajoo,tichondrius,1245,rogue,subtlety,88,42,46
Mylovejunex,tichondrius,1244,rogue,subtlety,18,13,5
Harkknight,sargeras,1244,rogue,subtlety,237,129,108
Bloodraina,hyjal,1244,rogue,subtlety,151,72,79
Endlesswaltz,zuljin,1243,rogue,subtlety,30,13,17
Towncar,kelthuzad,1242,rogue,subtlety,24,13,11
Moonvertz,barthilas,1242,rogue,subtlety,24,13,11
Quickxsilver,tichondrius,1240,rogue,subtlety,72,33,39
Vlone,icecrown,1240,rogue,subtlety,30,13,17
Aleh,exodar,1239,rogue,subtlety,24,13,11
Yurkarogue,tichondrius,1238,rogue,subtlety,18,13,5
Miraclesap,stormrage,1238,rogue,subtlety,130,76,54
Stealthkid,tichondrius,1237,rogue,subtlety,24,13,11
Hawwtkunnk,emerald-dream,1237,rogue,subtlety,24,13,11
Mistnazgul,quelthalas,1236,rogue,subtlety,94,53,41
Variat,azralon,1235,rogue,subtlety,54,25,29
Rykojin,dalaran,1234,rogue,subtlety,48,28,20
Pinksleep,sargeras,1234,rogue,subtlety,54,22,32
Oddblade,stormrage,1232,rogue,subtlety,24,14,10
Poolover,barthilas,1232,rogue,subtlety,24,13,11
Kilerhid,quelthalas,1231,rogue,subtlety,42,14,28
Noxik,blackrock,1229,rogue,subtlety,105,54,51
Johnnymayhem,kelthuzad,1227,rogue,subtlety,30,13,17
Dèàdly,korgath,1225,rogue,subtlety,24,13,11
Lapuamagnum,illidan,1225,rogue,subtlety,30,13,17
Draculà,wyrmrest-accord,1224,rogue,subtlety,93,50,43
Hattrìck,area-52,1224,rogue,subtlety,56,28,28
Draef,illidan,1223,rogue,subtlety,24,13,11
Vangroen,quelthalas,1220,rogue,subtlety,36,23,13
Drsinz,tichondrius,1217,rogue,subtlety,67,28,39
Hypermix,tichondrius,1216,rogue,subtlety,48,20,28
Trâshy,stormrage,1215,rogue,subtlety,25,14,11
Riezzoo,malfurion,1214,rogue,subtlety,36,19,17
Boredomkills,frostmane,1213,rogue,subtlety,24,13,11
Sxs,kiljaeden,1213,rogue,subtlety,47,25,22
Yellowdeep,tichondrius,1212,rogue,subtlety,20,14,6
Suñg,tichondrius,1211,rogue,subtlety,30,14,16
Dessenia,illidan,1208,rogue,subtlety,79,47,32
Felistrien,wyrmrest-accord,1207,rogue,subtlety,36,13,23
Gougemebaby,emerald-dream,1202,rogue,subtlety,36,15,21
Vonyx,area-52,1196,rogue,subtlety,36,16,20
Kylerxius,korgath,1192,rogue,subtlety,36,21,15
Abatoire,wyrmrest-accord,1188,rogue,subtlety,51,25,26
Demìurge,tichondrius,1188,rogue,subtlety,27,13,14
Noriel,dathremar,1187,rogue,subtlety,42,21,21
Geeo,emerald-dream,1187,rogue,subtlety,42,17,25
Elmabrox,quelthalas,1183,rogue,subtlety,45,20,25
Roxeni,tichondrius,1181,rogue,subtlety,28,13,15
Tigbits,frostmourne,1181,rogue,subtlety,32,14,18
Gatõ,quelthalas,1181,rogue,subtlety,60,24,36
Cheapdeal,frostmourne,1178,rogue,subtlety,28,13,15
Meer,balnazzar,1177,rogue,subtlety,40,29,11
Maløkeirø,stormrage,1177,rogue,subtlety,79,34,45
Winze,scilla,1176,rogue,subtlety,66,39,27
Esker,dragonmaw,1172,rogue,subtlety,138,70,68
Studders,kiljaeden,1172,rogue,subtlety,65,29,36
Writhes,sargeras,1169,rogue,subtlety,20,13,7
Wokemeup,bleeding-hollow,1168,rogue,subtlety,30,15,15
Ambushr,tichondrius,1161,rogue,subtlety,30,16,14
Gyrfalcon,spirestone,1156,rogue,subtlety,154,72,82
Paulpitation,blood-furnace,1155,rogue,subtlety,39,15,24
Håkünämãtåtä,stormrage,1152,rogue,subtlety,18,12,6
Bèstworld,dalaran,1152,rogue,subtlety,24,12,12
Abssall,tichondrius,1151,rogue,subtlety,18,12,6
Gladlol,stormrage,1151,rogue,subtlety,24,12,12
Allirra,ragnaros,1150,rogue,subtlety,48,32,16
Ppdx,malganis,1150,rogue,subtlety,18,12,6
Alrynik,stormrage,1150,rogue,subtlety,24,14,10
Chakal,illidan,1148,rogue,subtlety,18,12,6
Horyx,zuljin,1148,rogue,subtlety,24,12,12
Itskanashi,frostmourne,1148,rogue,subtlety,81,36,45
Drapezz,kelthuzad,1147,rogue,subtlety,59,32,27
Dawkx,thrall,1147,rogue,subtlety,25,13,12
Psÿchð,azralon,1147,rogue,subtlety,24,12,12
Jalaroot,frostmourne,1146,rogue,subtlety,29,16,13
Spèèd,proudmoore,1146,rogue,subtlety,24,12,12
Dezly,tichondrius,1146,rogue,subtlety,42,12,30
Abogansterr,ragnaros,1144,rogue,subtlety,164,84,80
Wowtheskill,illidan,1144,rogue,subtlety,24,12,12
Jirokun,illidan,1144,rogue,subtlety,24,12,12
Kaminokage,barthilas,1144,rogue,subtlety,45,15,30
Yesuz,illidan,1143,rogue,subtlety,34,19,15
Oilydaimon,tichondrius,1143,rogue,subtlety,61,29,32
Hattorikun,proudmoore,1142,rogue,subtlety,24,12,12
Poohpants,frostmourne,1140,rogue,subtlety,81,38,43
Smokepipe,nerzhul,1139,rogue,subtlety,24,14,10
Pro,burning-legion,1138,rogue,subtlety,30,14,16
Abdullahh,tichondrius,1137,rogue,subtlety,24,13,11
Arÿaa,azralon,1136,rogue,subtlety,54,25,29
Smashol,barthilas,1136,rogue,subtlety,54,23,31
Salätzar,quelthalas,1135,rogue,subtlety,27,13,14
Gank,jubeithos,1134,rogue,subtlety,24,12,12
Zarkans,proudmoore,1133,rogue,subtlety,84,42,42
Betrayerz,darkspear,1132,rogue,subtlety,33,17,16
Micromoon,windrunner,1131,rogue,subtlety,36,13,23
Sícarii,emerald-dream,1130,rogue,subtlety,18,12,6
Ninjadoo,tichondrius,1128,rogue,subtlety,18,12,6
Darkdevilx,tichondrius,1126,rogue,subtlety,36,12,24
Vanishman,ragnaros,1125,rogue,subtlety,30,15,15
Doklim,spinebreaker,1122,rogue,subtlety,74,42,32
Dtelkham,tichondrius,1122,rogue,subtlety,33,13,20
Cutthroat,aegwynn,1121,rogue,subtlety,45,20,25
Sildin,sargeras,1116,rogue,subtlety,36,16,20
Jhors,tichondrius,1114,rogue,subtlety,24,12,12
Jeri,gundrak,1113,rogue,subtlety,30,17,13
Witherblade,area-52,1110,rogue,subtlety,18,12,6
Kelelor,kelthuzad,1108,rogue,subtlety,57,18,39
Venace,agamaggan,1104,rogue,subtlety,23,12,11
Misthios,chogall,1101,rogue,subtlety,29,12,17
Hayatö,ragnaros,1098,rogue,subtlety,54,30,24
Dyane,gilneas,1097,rogue,subtlety,48,21,27
Iheyji,quelthalas,1094,rogue,subtlety,24,14,10
Aynrand,drakkari,1094,rogue,subtlety,45,16,29
Prisonshank,arthas,1093,rogue,subtlety,61,36,25
Shadownibba,illidan,1091,rogue,subtlety,48,26,22
Fangskin,dunemaul,1090,rogue,subtlety,36,19,17
Favès,thrall,1087,rogue,subtlety,60,19,41
Xzert,frostmourne,1085,rogue,subtlety,30,12,18
Jaanmonty,frostmourne,1081,rogue,subtlety,24,12,12
Zwielicht,quelthalas,1081,rogue,subtlety,30,14,16
Lesliechow,sargeras,1080,rogue,subtlety,70,41,29
Indivisible,thunderlord,1080,rogue,subtlety,60,30,30
Stelarstop,drakkari,1080,rogue,subtlety,48,16,32
Riskgo,frostwolf,1071,rogue,subtlety,24,12,12
Imgunnacrumb,malganis,1070,rogue,subtlety,179,85,94
Sixcombopts,area-52,1056,rogue,subtlety,18,11,7
Elwynë,tichondrius,1054,rogue,subtlety,24,11,13
Toestumper,sargeras,1054,rogue,subtlety,41,15,26
Avizura,dragonmaw,1053,rogue,subtlety,18,11,7
Rabe,nagrand,1053,rogue,subtlety,24,11,13
Exacerbatê,mannoroth,1052,rogue,subtlety,18,11,7
Ninetaildfox,arthas,1051,rogue,subtlety,18,11,7
Brilliance,skywall,1051,rogue,subtlety,24,11,13
Xvds,tichondrius,1051,rogue,subtlety,24,11,13
Boonee,frostmourne,1051,rogue,subtlety,24,11,13
Roguish,kiljaeden,1051,rogue,subtlety,38,14,24
Distract,quelthalas,1050,rogue,subtlety,18,11,7
Corntens,area-52,1050,rogue,subtlety,20,11,9
Omgmoon,ragnaros,1048,rogue,subtlety,12,11,1
Liquidmojo,tichondrius,1048,rogue,subtlety,18,11,7
Négrá,ragnaros,1048,rogue,subtlety,18,11,7
Nadari,cenarius,1048,rogue,subtlety,66,31,35
Ðarkrøøxs,stormrage,1048,rogue,subtlety,24,11,13
Trolladrão,goldrinn,1048,rogue,subtlety,24,11,13
Mermm,burning-blade,1048,rogue,subtlety,24,11,13
Waytoosext,tichondrius,1048,rogue,subtlety,24,11,13
Weckful,kelthuzad,1047,rogue,subtlety,18,11,7
Sneaknfizzle,dethecus,1047,rogue,subtlety,30,15,15
Santyno,ragnaros,1047,rogue,subtlety,120,56,64
Kilrogga,azshara,1046,rogue,subtlety,42,23,19
Laotrec,nemesis,1045,rogue,subtlety,33,12,21
Ivanapavlov,kelthuzad,1045,rogue,subtlety,41,14,27
Srmazakre,ragnaros,1044,rogue,subtlety,30,12,18
Olg,arathor,1043,rogue,subtlety,71,36,35
Hyperdexia,stormrage,1042,rogue,subtlety,88,47,41
Prõdigy,blackrock,1041,rogue,subtlety,20,13,7
Lyliym,frostmourne,1041,rogue,subtlety,18,11,7
Chancelör,illidan,1040,rogue,subtlety,18,11,7
Soulvex,barthilas,1040,rogue,subtlety,18,11,7
Nihue,terenas,1040,rogue,subtlety,30,11,19
Glatzkaus,shattered-hand,1039,rogue,subtlety,24,11,13
Yunaka,grizzly-hills,1039,rogue,subtlety,54,18,36
Abaløne,tichondrius,1037,rogue,subtlety,55,22,33
Siniel,scarlet-crusade,1035,rogue,subtlety,27,12,15
Rarkalth,azralon,1033,rogue,subtlety,53,18,35
Relidria,thrall,1032,rogue,subtlety,36,22,14
Kachimodo,illidan,1029,rogue,subtlety,48,23,25
Drpepzi,tichondrius,1025,rogue,subtlety,75,27,48
Relaxsingh,tichondrius,1022,rogue,subtlety,84,33,51
Topapple,mugthol,1021,rogue,subtlety,30,14,16
Ayo,exodar,1019,rogue,subtlety,24,12,12
Maewyn,aerie-peak,1019,rogue,subtlety,25,11,14
Sneakyshots,emerald-dream,1017,rogue,subtlety,13,11,2
Emøtions,darkspear,1016,rogue,subtlety,18,11,7
Slackness,bleeding-hollow,1015,rogue,subtlety,61,35,26
Fateapocryph,azralon,1014,rogue,subtlety,26,13,13
Skallywagg,emerald-dream,1014,rogue,subtlety,63,31,32
Bimbogirl,dalaran,1011,rogue,subtlety,52,29,23
Topsailor,uther,1011,rogue,subtlety,36,16,20
Korviz,area-52,1008,rogue,subtlety,60,30,30
Bloodwish,tichondrius,1007,rogue,subtlety,23,11,12
Lesty,kelthuzad,1006,rogue,subtlety,17,11,6
Ghost,shattered-halls,1006,rogue,subtlety,68,27,41
Log,blackhand,1004,rogue,subtlety,36,18,18
Onara,quelthalas,1003,rogue,subtlety,30,18,12
Kidcudi,bonechewer,1000,rogue,subtlety,48,18,30
Mcghanhain,aegwynn,999,rogue,subtlety,48,21,27
Silentmoralz,tichondrius,996,rogue,subtlety,47,15,32
Feragho,tichondrius,992,rogue,subtlety,34,11,23
Sadtears,thrall,990,rogue,subtlety,16,11,5
Cutx,frostmourne,984,rogue,subtlety,22,11,11
Bubblesr,whisperwind,980,rogue,subtlety,48,22,26
Toe,boulderfist,964,rogue,subtlety,51,25,26
Ascherx,veknilash,960,rogue,subtlety,12,10,2
Geckø,sargeras,959,rogue,subtlety,12,10,2
Geartrix,darkspear,959,rogue,subtlety,16,11,5
Catatonic,moon-guard,959,rogue,subtlety,18,10,8
Alts,tichondrius,959,rogue,subtlety,18,10,8
Spaca,kelthuzad,959,rogue,subtlety,18,10,8
Clerncc,emerald-dream,959,rogue,subtlety,18,10,8
Nightthug,tichondrius,959,rogue,subtlety,24,10,14
Caldø,tichondrius,958,rogue,subtlety,12,10,2
Sapnfappqt,dalaran,958,rogue,subtlety,15,10,5
Lucki,tichondrius,958,rogue,subtlety,18,10,8
Gardianstep,stormrage,958,rogue,subtlety,18,10,8
Fystrong,kelthuzad,958,rogue,subtlety,18,10,8
Jannie,rexxar,958,rogue,subtlety,18,10,8
Aszombie,tichondrius,957,rogue,subtlety,12,10,2
Kløud,uther,957,rogue,subtlety,18,10,8
Stuntedscamp,bleeding-hollow,957,rogue,subtlety,24,10,14
Rooke,draktharon,957,rogue,subtlety,24,10,14
Reclusivexo,tichondrius,956,rogue,subtlety,24,10,14
Merkules,dalaran,955,rogue,subtlety,16,11,5
Orteker,tichondrius,955,rogue,subtlety,18,10,8
Atulano,wyrmrest-accord,955,rogue,subtlety,24,10,14
Înfêrnô,emerald-dream,955,rogue,subtlety,24,10,14
Flavored,bloodhoof,955,rogue,subtlety,24,10,14
Poogodx,proudmoore,954,rogue,subtlety,12,10,2
Keepitshadow,frostmourne,953,rogue,subtlety,18,10,8
Moufwash,sargeras,952,rogue,subtlety,24,10,14
Crucifur,anvilmar,952,rogue,subtlety,24,10,14
Terpsaucey,tichondrius,952,rogue,subtlety,24,10,14
Wolfsfang,frostmourne,951,rogue,subtlety,19,10,9
Uchihaputin,tichondrius,951,rogue,subtlety,24,10,14
Undreas,kiljaeden,950,rogue,subtlety,388,191,197
Juanightstnd,bleeding-hollow,950,rogue,subtlety,24,10,14
Burningfury,arthas,950,rogue,subtlety,24,10,14
Arwy,stormrage,948,rogue,subtlety,19,11,8
Wubbz,stormrage,947,rogue,subtlety,12,10,2
Drspreader,area-52,946,rogue,subtlety,21,11,10
Definitioni,area-52,945,rogue,subtlety,19,10,9
Zelzaramor,ravenholdt,943,rogue,subtlety,30,10,20
Suffêr,dalaran,942,rogue,subtlety,12,10,2
Trinktick,doomhammer,931,rogue,subtlety,30,10,20
Blindedu,dalaran,930,rogue,subtlety,24,10,14
Zamji,tichondrius,928,rogue,subtlety,26,12,14
Shadowspain,malganis,926,rogue,subtlety,24,10,14
Timat,emerald-dream,924,rogue,subtlety,23,10,13
Swayo,tichondrius,920,rogue,subtlety,18,10,8
Beartøøth,stormrage,919,rogue,subtlety,18,10,8
Rouzh,sargeras,910,rogue,subtlety,17,10,7
Êxx,jubeithos,909,rogue,subtlety,17,10,7
Deathben,tichondrius,908,rogue,subtlety,71,21,50
Larmx,tichondrius,906,rogue,subtlety,15,12,3
Spleen,aerie-peak,906,rogue,subtlety,21,10,11
Cerel,baelgun,896,rogue,subtlety,48,13,35
Ninjamf,bleeding-hollow,894,rogue,subtlety,14,10,4
Mhün,malganis,891,rogue,subtlety,22,10,12
Dagasombria,drakkari,890,rogue,subtlety,55,20,35
Zenshin,tichondrius,889,rogue,subtlety,31,10,21
Degrok,quelthalas,867,rogue,subtlety,59,28,31
Nerfretnow,tichondrius,864,rogue,subtlety,12,9,3
Scythix,firetree,864,rogue,subtlety,12,9,3
Poonqtxo,frostmourne,864,rogue,subtlety,12,9,3
Shadówl,tichondrius,864,rogue,subtlety,12,9,3
Escapeartist,darkspear,864,rogue,subtlety,12,9,3
Yodiegang,tichondrius,864,rogue,subtlety,12,9,3
Chainsarogue,stormrage,864,rogue,subtlety,12,9,3
Sitdownplz,darkspear,864,rogue,subtlety,15,10,5
Sagatha,bleeding-hollow,863,rogue,subtlety,12,9,3
Popss,whisperwind,863,rogue,subtlety,18,9,9
Indiecompany,moon-guard,863,rogue,subtlety,18,9,9
Wimpz,hyjal,863,rogue,subtlety,18,9,9
Peacetou,kelthuzad,863,rogue,subtlety,18,9,9
Lunatixz,emerald-dream,863,rogue,subtlety,18,9,9
Revenantss,moon-guard,863,rogue,subtlety,18,9,9
Uglysrogue,sargeras,863,rogue,subtlety,18,9,9
Nemoye,tichondrius,863,rogue,subtlety,18,9,9
Goopthicc,sargeras,863,rogue,subtlety,24,9,15
Illoo,frostmourne,863,rogue,subtlety,24,9,15
Jexy,barthilas,863,rogue,subtlety,24,9,15
Proddivus,stormrage,863,rogue,subtlety,30,9,21
Jamo,kiljaeden,862,rogue,subtlety,18,9,9
Letsparty,malganis,862,rogue,subtlety,18,9,9
Confianzudo,ragnaros,862,rogue,subtlety,54,24,30
Oksanaastan,tichondrius,862,rogue,subtlety,30,9,21
Cosmicò,trollbane,861,rogue,subtlety,12,9,3
Blitzree,thrall,861,rogue,subtlety,12,9,3
Filid,frostmourne,861,rogue,subtlety,18,9,9
Donnice,area-52,861,rogue,subtlety,18,9,9
Biggisdiggis,tichondrius,860,rogue,subtlety,12,9,3
Lanres,stormrage,860,rogue,subtlety,12,9,3
Raqed,eredar,860,rogue,subtlety,24,9,15
Larceny,emerald-dream,860,rogue,subtlety,24,9,15
Oío,ragnaros,859,rogue,subtlety,15,10,5
Overzz,azralon,859,rogue,subtlety,21,9,12
Aoki,tichondrius,859,rogue,subtlety,24,9,15
Gannjalord,frostmane,858,rogue,subtlety,22,10,12
Pumpp,dentarg,858,rogue,subtlety,24,9,15
Bubblesrr,whisperwind,857,rogue,subtlety,32,9,23
Calvin,moon-guard,856,rogue,subtlety,18,9,9
Wrekstun,area-52,855,rogue,subtlety,24,9,15
Drekha,tichondrius,854,rogue,subtlety,28,10,18
Aitormenta,ragnaros,851,rogue,subtlety,12,9,3
Dizzm,area-52,847,rogue,subtlety,12,9,3
Shadowpunx,nemesis,846,rogue,subtlety,12,9,3
Aelnoor,ragnaros,846,rogue,subtlety,24,9,15
Caveil,stormrage,845,rogue,subtlety,17,9,8
Cutindle,illidan,842,rogue,subtlety,18,9,9
Brocolini,zuljin,841,rogue,subtlety,30,12,18
Lemeeng,uldum,838,rogue,subtlety,30,12,18
Elßronkas,quelthalas,836,rogue,subtlety,48,21,27
Ýazim,tichondrius,832,rogue,subtlety,16,9,7
Sorieg,azralon,831,rogue,subtlety,22,11,11
Alexon,wyrmrest-accord,828,rogue,subtlety,84,35,49
Sodomh,aegwynn,818,rogue,subtlety,48,21,27
Eversincee,illidan,814,rogue,subtlety,15,9,6
Gnomerogue,sargeras,811,rogue,subtlety,21,11,10
Raylo,blackhand,807,rogue,subtlety,24,11,13
Vandalyze,sargeras,805,rogue,subtlety,19,10,9
Deathwishx,tichondrius,799,rogue,subtlety,16,9,7
Zaghat,ragnaros,799,rogue,subtlety,22,9,13
Mercaderps,frostmourne,798,rogue,subtlety,33,9,24
Trillkage,tichondrius,797,rogue,subtlety,26,9,17
Zelthy,frostmourne,790,rogue,subtlety,17,9,8
Redtvco,blackrock,789,rogue,subtlety,17,9,8
Samllnuts,area-52,789,rogue,subtlety,30,11,19
Fearnomore,destromath,773,rogue,subtlety,84,29,55
Austínrh,sargeras,768,rogue,subtlety,12,8,4
Astutý,illidan,768,rogue,subtlety,12,8,4
Evilthunder,illidan,768,rogue,subtlety,12,8,4
Wîzz,bleeding-hollow,768,rogue,subtlety,12,8,4
Nicørøbin,tichondrius,768,rogue,subtlety,12,8,4
Czd,frostmourne,768,rogue,subtlety,12,8,4
Khyrax,tichondrius,768,rogue,subtlety,12,8,4
Cójáx,dalaran,768,rogue,subtlety,12,8,4
Zeenxz,tichondrius,768,rogue,subtlety,12,8,4
Commodore,arthas,768,rogue,subtlety,12,8,4
Nuhiva,tichondrius,768,rogue,subtlety,15,9,6
Köfy,quelthalas,768,rogue,subtlety,17,8,9
Nlynn,veknilash,768,rogue,subtlety,18,8,10
Wowcode,tichondrius,768,rogue,subtlety,18,8,10
Bungou,tichondrius,768,rogue,subtlety,18,8,10
Heegawn,proudmoore,768,rogue,subtlety,18,8,10
Calxnnight,terenas,768,rogue,subtlety,18,8,10
Getfkdkid,tichondrius,768,rogue,subtlety,24,8,16
Swippz,tichondrius,768,rogue,subtlety,24,8,16
Kiingspade,tichondrius,767,rogue,subtlety,12,8,4
Gankbang,mugthol,767,rogue,subtlety,12,8,4
Drunknclapz,bleeding-hollow,767,rogue,subtlety,12,8,4
Assasinww,sargeras,767,rogue,subtlety,12,8,4
Microcore,sargeras,767,rogue,subtlety,18,8,10
Siyerogue,illidan,767,rogue,subtlety,18,8,10
Candren,area-52,767,rogue,subtlety,18,8,10
Antmang,bleeding-hollow,767,rogue,subtlety,18,8,10
Ilesire,frostmourne,767,rogue,subtlety,18,8,10
Chuckydoll,sargeras,767,rogue,subtlety,18,8,10
Poisonstrike,khazgoroth,766,rogue,subtlety,12,8,4
Zapstr,bleeding-hollow,766,rogue,subtlety,12,8,4
Razmir,malfurion,766,rogue,subtlety,18,8,10
Raidei,elune,766,rogue,subtlety,18,8,10
Twinkrogue,firetree,766,rogue,subtlety,18,8,10
Ntshaav,illidan,766,rogue,subtlety,18,8,10
Kody,dalaran,765,rogue,subtlety,21,9,12
Yato,mugthol,764,rogue,subtlety,12,8,4
Subtlepuddle,bleeding-hollow,764,rogue,subtlety,24,8,16
ßackshots,kelthuzad,763,rogue,subtlety,18,8,10
Vexyz,tichondrius,763,rogue,subtlety,18,8,10
Shadonas,maelstrom,763,rogue,subtlety,24,8,16
Defaces,illidan,762,rogue,subtlety,12,8,4
Wolfmans,trollbane,762,rogue,subtlety,12,8,4
Shivlightnin,tichondrius,762,rogue,subtlety,24,8,16
Píxíedúst,black-dragonflight,761,rogue,subtlety,24,8,16
Swisha,dathremar,759,rogue,subtlety,18,8,10
Mhasto,azralon,759,rogue,subtlety,18,8,10
Sathrion,zuljin,758,rogue,subtlety,26,10,16
Kerimoynihan,barthilas,757,rogue,subtlety,28,11,17
Darthdad,bleeding-hollow,757,rogue,subtlety,30,8,22
Nijanari,wyrmrest-accord,754,rogue,subtlety,24,8,16
Screwzx,tichondrius,750,rogue,subtlety,17,8,9
Nuff,emerald-dream,736,rogue,subtlety,16,8,8
Stunjunky,area-52,733,rogue,subtlety,17,8,9
Bladefang,quelthalas,732,rogue,subtlety,17,10,7
Tyroshiv,area-52,732,rogue,subtlety,24,9,15
Lilshortyaya,stormrage,719,rogue,subtlety,15,8,7
Hellainuis,kelthuzad,719,rogue,subtlety,17,8,9
Treeless,wyrmrest-accord,719,rogue,subtlety,25,9,16
Reportlowdps,tichondrius,718,rogue,subtlety,11,8,3
Foxolnite,illidan,718,rogue,subtlety,21,8,13
Lerosi,malganis,718,rogue,subtlety,75,21,54
Papiplunders,sargeras,687,rogue,subtlety,13,8,5
Flaremagnet,whisperwind,672,rogue,subtlety,12,7,5
Bledstepelin,frostmourne,672,rogue,subtlety,12,7,5
Ustunned,stormrage,672,rogue,subtlety,12,7,5
Adhd,ravencrest,672,rogue,subtlety,12,7,5
Frooty,stormrage,672,rogue,subtlety,12,7,5
Yangsol,stormrage,672,rogue,subtlety,12,7,5
Àsgà,area-52,672,rogue,subtlety,12,7,5
Orctheripper,garona,672,rogue,subtlety,12,7,5
Syxs,sargeras,672,rogue,subtlety,12,7,5
Bobbyflay,velen,672,rogue,subtlety,12,7,5
Bobfoonk,tichondrius,672,rogue,subtlety,12,7,5
Smang,mugthol,672,rogue,subtlety,12,7,5
Bloodyhairy,area-52,672,rogue,subtlety,12,7,5
Gertrix,darkspear,672,rogue,subtlety,12,7,5
Spötty,stormrage,672,rogue,subtlety,12,7,5
Coughsyrup,sargeras,672,rogue,subtlety,12,7,5
Darkstár,bladefist,672,rogue,subtlety,12,7,5
Joeyzord,stormrage,672,rogue,subtlety,12,7,5
Voldir,cenarion-circle,672,rogue,subtlety,12,7,5
Saraku,barthilas,672,rogue,subtlety,12,7,5
Feyahni,wyrmrest-accord,672,rogue,subtlety,12,7,5
Loria,cenarion-circle,672,rogue,subtlety,15,8,7
Dycrons,lightbringer,672,rogue,subtlety,18,7,11
Clicksbtns,area-52,672,rogue,subtlety,18,7,11
Spytes,kiljaeden,672,rogue,subtlety,18,7,11
Memoríst,frostmourne,672,rogue,subtlety,18,7,11
Patey,malganis,672,rogue,subtlety,18,7,11
Niwbor,azralon,672,rogue,subtlety,24,7,17
Tekrul,area-52,672,rogue,subtlety,30,7,23
Christiaan,area-52,671,rogue,subtlety,12,7,5
Deadsilenth,daggerspine,671,rogue,subtlety,12,7,5
Zetkx,tichondrius,671,rogue,subtlety,12,7,5
Energetìc,stormrage,671,rogue,subtlety,12,7,5
Shadowoog,tichondrius,671,rogue,subtlety,12,7,5
Kidkillz,tichondrius,671,rogue,subtlety,12,7,5
Xemnxnt,stormrage,671,rogue,subtlety,12,7,5
Nezumikami,malganis,671,rogue,subtlety,18,7,11
Sapzz,tichondrius,671,rogue,subtlety,18,7,11
Xalsathoth,sargeras,671,rogue,subtlety,18,7,11
Calimari,frostmourne,671,rogue,subtlety,18,7,11
Multik,tichondrius,671,rogue,subtlety,18,7,11
Beretta,nemesis,671,rogue,subtlety,18,7,11
Vex,durotan,671,rogue,subtlety,24,7,17
Brand,bonechewer,671,rogue,subtlety,30,7,23
Jdmg,azralon,670,rogue,subtlety,12,7,5
Zavrus,kelthuzad,670,rogue,subtlety,18,7,11
Rotjaw,hydraxis,670,rogue,subtlety,18,7,11
Takamoto,windrunner,670,rogue,subtlety,18,7,11
Anteccessor,tichondrius,669,rogue,subtlety,18,7,11
Bõjack,stormrage,669,rogue,subtlety,18,7,11
Rovvo,queldorei,669,rogue,subtlety,24,7,17
Jagó,malganis,667,rogue,subtlety,12,7,5
Chompycat,tichondrius,667,rogue,subtlety,18,7,11
Zapersapp,malygos,666,rogue,subtlety,24,7,17
Schnozz,lightbringer,665,rogue,subtlety,12,7,5
Gotchabak,stormrage,659,rogue,subtlety,12,7,5
Zhuodouqiaga,tichondrius,655,rogue,subtlety,17,7,10
Zaozaa,frostmourne,639,rogue,subtlety,14,8,6
Phyzzi,kargath,639,rogue,subtlety,17,7,10
Flazy,sargeras,623,rogue,subtlety,11,7,4
Coldkill,bleeding-hollow,623,rogue,subtlety,11,7,4
Undalack,ragnaros,621,rogue,subtlety,21,7,14
Carpe,barthilas,618,rogue,subtlety,24,8,16
Namig,cenarion-circle,608,rogue,subtlety,10,7,3
Deadshank,bleeding-hollow,576,rogue,subtlety,6,6,0
Manersi,akama,576,rogue,subtlety,6,6,0
Donçorleone,stormrage,576,rogue,subtlety,6,6,0
Homarx,quelthalas,576,rogue,subtlety,10,7,3
Gibsons,quelthalas,576,rogue,subtlety,12,6,6
Jòwtzy,ragnaros,576,rogue,subtlety,12,6,6
Pamaaj,sargeras,576,rogue,subtlety,12,6,6
Avelmire,sargeras,576,rogue,subtlety,12,6,6
Donpeon,hellscream,576,rogue,subtlety,12,6,6
Sivni,tichondrius,576,rogue,subtlety,12,6,6
Tmpikaboo,mugthol,576,rogue,subtlety,12,6,6
Pingwii,ragnaros,576,rogue,subtlety,12,6,6
Draiygo,nerzhul,576,rogue,subtlety,12,6,6
Palumor,deathwing,576,rogue,subtlety,12,6,6
Unholydood,bonechewer,576,rogue,subtlety,12,6,6
Fkq,emerald-dream,576,rogue,subtlety,12,6,6
Mistrjack,kelthuzad,576,rogue,subtlety,12,6,6
Kindasorry,illidan,576,rogue,subtlety,12,6,6
Xedi,illidan,576,rogue,subtlety,12,6,6
Littlescrub,frostmourne,576,rogue,subtlety,12,6,6
Mutingall,tichondrius,576,rogue,subtlety,12,6,6
Vyserate,malfurion,576,rogue,subtlety,12,6,6
Dërpt,tichondrius,576,rogue,subtlety,12,6,6
Revila,bleeding-hollow,576,rogue,subtlety,12,6,6
Hykoo,tichondrius,576,rogue,subtlety,12,6,6
Ãnimefãnx,moon-guard,576,rogue,subtlety,12,6,6
Lymon,azralon,576,rogue,subtlety,12,6,6
Wongcha,darkspear,576,rogue,subtlety,12,6,6
Baßyøða,stormrage,576,rogue,subtlety,12,6,6
Topfloorboss,illidan,576,rogue,subtlety,12,6,6
Shadxr,tichondrius,576,rogue,subtlety,12,6,6
Athletik,tichondrius,576,rogue,subtlety,12,6,6
Pokekek,stormrage,576,rogue,subtlety,12,6,6
Veterån,tichondrius,576,rogue,subtlety,18,6,12
Ghosted,thrall,576,rogue,subtlety,18,6,12
Snoogly,tichondrius,576,rogue,subtlety,18,6,12
Cinnashank,darkspear,576,rogue,subtlety,18,6,12
Drakariano,ragnaros,576,rogue,subtlety,18,6,12
Jácket,area-52,576,rogue,subtlety,24,6,18
Struggle,sargeras,576,rogue,subtlety,24,6,18
Maulgryve,frostwolf,575,rogue,subtlety,12,6,6
Projectx,tichondrius,575,rogue,subtlety,12,6,6
Whothekilla,tichondrius,575,rogue,subtlety,12,6,6
Mcnastier,dunemaul,575,rogue,subtlety,12,6,6
Scallywag,illidan,575,rogue,subtlety,12,6,6
Azanax,area-52,575,rogue,subtlety,12,6,6
Smakkey,tichondrius,575,rogue,subtlety,12,6,6
Jinxkiller,tichondrius,575,rogue,subtlety,12,6,6
Hindpaw,wyrmrest-accord,575,rogue,subtlety,18,6,12
Dreamcatcher,azralon,575,rogue,subtlety,18,6,12
Zogbu,stormrage,575,rogue,subtlety,18,6,12
Poofus,vashj,575,rogue,subtlety,18,6,12
Karing,onyxia,574,rogue,subtlety,18,6,12
Tòúka,stormrage,574,rogue,subtlety,18,6,12
Dedrater,shadowmoon,574,rogue,subtlety,18,6,12
Alttee,proudmoore,573,rogue,subtlety,12,6,6
Strôbéy,tichondrius,573,rogue,subtlety,24,6,18
Jowelyrandy,drakkari,573,rogue,subtlety,25,6,19
Warghostpvp,illidan,572,rogue,subtlety,12,6,6
Iapologize,area-52,572,rogue,subtlety,12,6,6
Darkpaths,hyjal,572,rogue,subtlety,12,6,6
Supminty,stormrage,571,rogue,subtlety,12,6,6
Xylow,garona,571,rogue,subtlety,27,6,21
Backstàb,durotan,566,rogue,subtlety,12,6,6
Nakedps,garona,566,rogue,subtlety,12,6,6
Pancakestab,saurfang,543,rogue,subtlety,14,7,7
Respia,proudmoore,521,rogue,subtlety,14,7,7
Dogedealer,ragnaros,515,rogue,subtlety,15,7,8
Aruldyr,zuljin,510,rogue,subtlety,14,6,8
Shadaux,frostmourne,480,rogue,subtlety,6,5,1
Matek,darkspear,480,rogue,subtlety,6,5,1
Lowkn,tichondrius,480,rogue,subtlety,6,5,1
Progeriagodx,darkspear,480,rogue,subtlety,6,5,1
Ghoarie,sargeras,480,rogue,subtlety,6,5,1
Kwins,cenarion-circle,480,rogue,subtlety,6,5,1
Natalya,stormreaver,480,rogue,subtlety,6,5,1
Nodeßurglar,kelthuzad,480,rogue,subtlety,6,5,1
Deepsyo,frostmourne,480,rogue,subtlety,6,5,1
Alathir,tichondrius,480,rogue,subtlety,6,5,1
Oceboomer,frostmourne,480,rogue,subtlety,6,5,1
Söda,emerald-dream,480,rogue,subtlety,12,5,7
Snewdaddy,malganis,480,rogue,subtlety,12,5,7
Mitra,eredar,480,rogue,subtlety,12,5,7
Uni,khadgar,480,rogue,subtlety,12,5,7
Blakezillax,tichondrius,480,rogue,subtlety,12,5,7
Recktzful,ragnaros,480,rogue,subtlety,12,5,7
Jon,the-venture-co,480,rogue,subtlety,12,5,7
Jean,tichondrius,480,rogue,subtlety,12,5,7
Shizz,tichondrius,480,rogue,subtlety,12,5,7
Twnice,tichondrius,480,rogue,subtlety,12,5,7
Liqwid,stormrage,480,rogue,subtlety,12,5,7
Sinary,cenarion-circle,480,rogue,subtlety,12,5,7
Blinky,blades-edge,480,rogue,subtlety,12,5,7
Ifríend,emerald-dream,480,rogue,subtlety,12,5,7
Aldessa,draka,480,rogue,subtlety,12,5,7
Chimpo,ravencrest,480,rogue,subtlety,12,5,7
Isonlydosex,tichondrius,480,rogue,subtlety,12,5,7
Pwnsauce,frostmourne,480,rogue,subtlety,12,5,7
Pjh,sargeras,480,rogue,subtlety,12,5,7
Henya,magtheridon,480,rogue,subtlety,12,5,7
Invkill,azralon,480,rogue,subtlety,12,5,7
Milafortnite,tichondrius,480,rogue,subtlety,12,5,7
Defthands,tichondrius,480,rogue,subtlety,12,5,7
Mikènuttz,sargeras,480,rogue,subtlety,12,5,7
Wooluncle,tichondrius,480,rogue,subtlety,12,5,7
Kenyel,frostmourne,480,rogue,subtlety,12,5,7
Ricosap,frostmourne,480,rogue,subtlety,12,5,7
Tizzyb,bleeding-hollow,480,rogue,subtlety,12,5,7
Tessialith,azralon,480,rogue,subtlety,12,5,7
Monkeykongr,lightnings-blade,480,rogue,subtlety,12,5,7
Scrubzz,barthilas,480,rogue,subtlety,12,5,7
Wadge,zuljin,480,rogue,subtlety,12,5,7
Cbdoil,proudmoore,480,rogue,subtlety,12,5,7
Drunknchaos,bleeding-hollow,480,rogue,subtlety,12,5,7
Harasna,emerald-dream,480,rogue,subtlety,12,5,7
Caras,tichondrius,480,rogue,subtlety,12,5,7
Killdrunk,stormrage,480,rogue,subtlety,12,5,7
Hassanssin,area-52,480,rogue,subtlety,12,5,7
Steeldiesel,sargeras,480,rogue,subtlety,12,5,7
Minimumwage,bleeding-hollow,480,rogue,subtlety,12,5,7
Arsènè,whisperwind,480,rogue,subtlety,13,5,8
Psychostabby,tichondrius,480,rogue,subtlety,18,5,13
Greyleywin,azralon,480,rogue,subtlety,18,5,13
Alaeá,stormrage,480,rogue,subtlety,18,5,13
Highwire,stormrage,479,rogue,subtlety,6,5,1
Zitihait,amanthul,479,rogue,subtlety,6,5,1
Deathbeacøn,sargeras,479,rogue,subtlety,12,5,7
Lacero,bonechewer,479,rogue,subtlety,12,5,7
Minato,eredar,479,rogue,subtlety,12,5,7
Smòkéd,tichondrius,479,rogue,subtlety,12,5,7
Catoline,bleeding-hollow,479,rogue,subtlety,12,5,7
Luoan,emerald-dream,479,rogue,subtlety,12,5,7
Brettmckjnr,saurfang,479,rogue,subtlety,12,5,7
Toodlles,stormrage,479,rogue,subtlety,12,5,7
Qlog,tichondrius,479,rogue,subtlety,12,5,7
Crypblade,sargeras,479,rogue,subtlety,12,5,7
Killerupdown,muradin,479,rogue,subtlety,18,5,13
Corchô,moon-guard,479,rogue,subtlety,18,5,13
Gaiuscaesa,moon-guard,479,rogue,subtlety,18,5,13
Frostybeers,kelthuzad,479,rogue,subtlety,18,5,13
Kekdasneak,dragonmaw,479,rogue,subtlety,18,5,13
Fouzz,stormrage,478,rogue,subtlety,15,6,9
Falra,wyrmrest-accord,478,rogue,subtlety,18,5,13
Muffens,alterac-mountains,476,rogue,subtlety,12,5,7
Liamoz,amanthul,475,rogue,subtlety,12,5,7
Hyunco,tichondrius,474,rogue,subtlety,12,5,7
Murdistino,tichondrius,472,rogue,subtlety,12,5,7
Zôliath,tichondrius,448,rogue,subtlety,16,5,11
Fingolfin,terenas,447,rogue,subtlety,11,5,6
Anbuartist,dalaran,447,rogue,subtlety,11,5,6
Backtoch,sargeras,447,rogue,subtlety,11,5,6
Bernardi,uther,447,rogue,subtlety,11,5,6
Notlim,azralon,432,rogue,subtlety,15,5,10
Pangppy,tichondrius,431,rogue,subtlety,11,5,6
Akhila,stormrage,431,rogue,subtlety,11,5,6
Picaropanda,quelthalas,425,rogue,subtlety,22,6,16
Mdrogue,sargeras,416,rogue,subtlety,10,5,5
Cayladin,tichondrius,416,rogue,subtlety,10,5,5
Luriél,stormrage,415,rogue,subtlety,10,5,5
Kathërïnë,azralon,415,rogue,subtlety,16,5,11
Sighzy,sargeras,400,rogue,subtlety,19,5,14
Xvic,bleeding-hollow,384,rogue,subtlety,6,4,2
Rïddïck,tichondrius,384,rogue,subtlety,6,4,2
Wrldstars,illidan,384,rogue,subtlety,6,4,2
Unoshade,illidan,384,rogue,subtlety,6,4,2
Djsyn,bleeding-hollow,384,rogue,subtlety,6,4,2
Dåve,tichondrius,384,rogue,subtlety,6,4,2
Memnõch,emerald-dream,384,rogue,subtlety,6,4,2
Chauva,zuljin,384,rogue,subtlety,6,4,2
Malgoria,tichondrius,384,rogue,subtlety,6,4,2
Bootimus,illidan,384,rogue,subtlety,6,4,2
Deejey,frostmourne,384,rogue,subtlety,6,4,2
Snobbish,tichondrius,384,rogue,subtlety,6,4,2
Altaureen,thrall,384,rogue,subtlety,6,4,2
Starhound,kiljaeden,384,rogue,subtlety,6,4,2
Sapafapa,illidan,384,rogue,subtlety,6,4,2
Invokesap,area-52,384,rogue,subtlety,6,4,2
Zerorog,zuljin,384,rogue,subtlety,6,4,2
Chokonet,gurubashi,384,rogue,subtlety,6,4,2
Prepcoin,malganis,384,rogue,subtlety,6,4,2
Daradria,stormrage,384,rogue,subtlety,6,4,2
Deadopps,stormrage,384,rogue,subtlety,6,4,2
Roberto,darkspear,384,rogue,subtlety,6,4,2
Foreverioi,tichondrius,384,rogue,subtlety,6,4,2
Suggmadi,stormrage,384,rogue,subtlety,6,4,2
Kurosh,kalecgos,384,rogue,subtlety,6,4,2
Subgodx,stormrage,384,rogue,subtlety,6,4,2
Onezik,stormrage,384,rogue,subtlety,6,4,2
Sapntapx,malganis,384,rogue,subtlety,6,4,2
Mirlol,stormrage,384,rogue,subtlety,6,4,2
Fortie,moon-guard,384,rogue,subtlety,6,4,2
Evasionx,tichondrius,384,rogue,subtlety,6,4,2
Emvee,kelthuzad,384,rogue,subtlety,6,4,2
Agilityrush,stormrage,384,rogue,subtlety,6,4,2
Caliph,malganis,384,rogue,subtlety,6,4,2
Bilbobagginz,malganis,384,rogue,subtlety,6,4,2
Vexaryon,quelthalas,384,rogue,subtlety,6,4,2
Nichala,tichondrius,384,rogue,subtlety,6,4,2
Mastrshreddr,kelthuzad,384,rogue,subtlety,6,4,2
Jasam,daggerspine,384,rogue,subtlety,9,5,4
Moshington,kelthuzad,384,rogue,subtlety,8,4,4
Velandros,eonar,384,rogue,subtlety,12,4,8
Miamiganster,lothar,384,rogue,subtlety,12,4,8
Flankks,sargeras,384,rogue,subtlety,12,4,8
Elishadowed,proudmoore,384,rogue,subtlety,12,4,8
Freshcakes,darkspear,384,rogue,subtlety,12,4,8
Gotothegym,tichondrius,384,rogue,subtlety,12,4,8
Nevermoon,gallywix,384,rogue,subtlety,12,4,8
Zzffqsm,tichondrius,384,rogue,subtlety,12,4,8
Tàlion,emerald-dream,384,rogue,subtlety,12,4,8
Woodsapdat,sargeras,384,rogue,subtlety,12,4,8
Restinpeacex,bleeding-hollow,384,rogue,subtlety,12,4,8
Mãtthew,tichondrius,384,rogue,subtlety,12,4,8
Maxparkhurst,moon-guard,384,rogue,subtlety,12,4,8
Rictorr,ragnaros,384,rogue,subtlety,12,4,8
Seutobinhaa,stormrage,384,rogue,subtlety,12,4,8
Cron,arygos,384,rogue,subtlety,12,4,8
Lolgoturbase,hyjal,384,rogue,subtlety,12,4,8
Lazaruslong,stormrage,384,rogue,subtlety,12,4,8
Etyop,azralon,384,rogue,subtlety,12,4,8
Saberbane,tichondrius,384,rogue,subtlety,12,4,8
Keylight,tichondrius,384,rogue,subtlety,12,4,8
Tomas,bloodscalp,384,rogue,subtlety,12,4,8
Blackstabyth,thrall,384,rogue,subtlety,12,4,8
Cytôn,bleeding-hollow,384,rogue,subtlety,12,4,8
Seerenai,moon-guard,384,rogue,subtlety,12,4,8
Muggzy,emerald-dream,384,rogue,subtlety,12,4,8
Dions,ragnaros,384,rogue,subtlety,12,4,8
Xikoro,emerald-dream,384,rogue,subtlety,12,4,8
Booitsdrew,sargeras,384,rogue,subtlety,12,4,8
Hoodiesneaks,stormrage,384,rogue,subtlety,14,4,10
Asneakyfox,thunderlord,384,rogue,subtlety,30,4,26
Gentlesaop,blackrock,383,rogue,subtlety,6,4,2
Morphina,gilneas,383,rogue,subtlety,6,4,2
Vendettã,skullcrusher,383,rogue,subtlety,6,4,2
Stabsolutely,moon-guard,383,rogue,subtlety,6,4,2
Freego,quelthalas,383,rogue,subtlety,6,4,2
Hènnéssy,frostmourne,383,rogue,subtlety,12,4,8
Superhattie,tichondrius,383,rogue,subtlety,12,4,8
Ràinê,dalaran,383,rogue,subtlety,12,4,8
Majimae,sargeras,383,rogue,subtlety,12,4,8
Toxiccarnage,ghostlands,383,rogue,subtlety,14,4,10
Medalist,darkspear,383,rogue,subtlety,18,4,14
Rascallion,tichondrius,381,rogue,subtlety,12,4,8
Knife,moon-guard,381,rogue,subtlety,12,4,8
Jjp,tichondrius,367,rogue,subtlety,11,4,7
Sinice,draka,351,rogue,subtlety,8,5,3
Samuraii,zuljin,335,rogue,subtlety,11,4,7
Idsapdat,illidan,330,rogue,subtlety,9,6,3
Earkeeper,wildhammer,330,rogue,subtlety,8,5,3
Peeryl,daggerspine,327,rogue,subtlety,15,5,10
Rawdawged,illidan,320,rogue,subtlety,16,4,12
Grima,azralon,319,rogue,subtlety,14,4,10
Lemíly,emerald-dream,319,rogue,subtlety,14,4,10
Pvptóne,steamwheedle-cartel,288,rogue,subtlety,6,3,3
Raego,frostmourne,288,rogue,subtlety,6,3,3
Liljonx,tichondrius,288,rogue,subtlety,6,3,3
Kelbrelor,stormrage,288,rogue,subtlety,6,3,3
Zêrøghgødx,tichondrius,288,rogue,subtlety,6,3,3
Amatoxin,tichondrius,288,rogue,subtlety,6,3,3
Redspoison,dalaran,288,rogue,subtlety,6,3,3
Jackcurtis,kelthuzad,288,rogue,subtlety,6,3,3
Slilsp,sargeras,288,rogue,subtlety,6,3,3
Tonjuras,uther,288,rogue,subtlety,6,3,3
Ohnoyoudont,dragonmaw,288,rogue,subtlety,6,3,3
Snackable,tichondrius,288,rogue,subtlety,6,3,3
Gåñðøñ,stormscale,288,rogue,subtlety,6,3,3
Compadrer,area-52,288,rogue,subtlety,6,3,3
Metalz,exodar,288,rogue,subtlety,6,3,3
Bumboklaat,bleeding-hollow,288,rogue,subtlety,6,3,3
Asherian,wyrmrest-accord,288,rogue,subtlety,6,3,3
Wikkihx,emerald-dream,288,rogue,subtlety,6,3,3
Sonymf,frostmourne,288,rogue,subtlety,6,3,3
Shaisty,malganis,288,rogue,subtlety,6,3,3
Belialas,thrall,288,rogue,subtlety,6,3,3
Antijax,stormrage,288,rogue,subtlety,6,3,3
Gotkick,stormrage,288,rogue,subtlety,6,3,3
Sharmoc,ragnaros,288,rogue,subtlety,6,3,3
Rdt,durotan,288,rogue,subtlety,6,3,3
Ralæriel,wyrmrest-accord,288,rogue,subtlety,6,3,3
Hemorrhages,tichondrius,288,rogue,subtlety,6,3,3
Ced,medivh,288,rogue,subtlety,6,3,3
Japz,sargeras,288,rogue,subtlety,6,3,3
Haeqn,azralon,288,rogue,subtlety,6,3,3
Knifetalk,moon-guard,288,rogue,subtlety,6,3,3
Zarrth,malganis,288,rogue,subtlety,6,3,3
Creayuncle,area-52,288,rogue,subtlety,6,3,3
Maliora,area-52,288,rogue,subtlety,6,3,3
Driizzel,sargeras,288,rogue,subtlety,6,3,3
Junemylove,tichondrius,288,rogue,subtlety,6,3,3
Gongarn,thrall,288,rogue,subtlety,6,3,3
Repatriate,dark-iron,288,rogue,subtlety,6,3,3
Xaander,nazjatar,288,rogue,subtlety,6,3,3
Machinshin,dalaran,288,rogue,subtlety,6,3,3
Oj,frostmourne,288,rogue,subtlety,6,3,3
Valaq,tichondrius,288,rogue,subtlety,6,3,3
Dödoubleg,stormrage,288,rogue,subtlety,6,3,3
Bøbinette,sargeras,288,rogue,subtlety,6,3,3
Seanr,stormrage,288,rogue,subtlety,6,3,3
Schneric,stormrage,288,rogue,subtlety,6,3,3
Gangstsprdse,tichondrius,288,rogue,subtlety,6,3,3
Castsequence,khaz-modan,288,rogue,subtlety,6,3,3
Dìngapoof,tichondrius,288,rogue,subtlety,6,3,3
Keytürns,frostmourne,288,rogue,subtlety,6,3,3
Sinfate,bleeding-hollow,288,rogue,subtlety,6,3,3
Woundzx,tichondrius,288,rogue,subtlety,6,3,3
Ascherx,illidan,288,rogue,subtlety,6,3,3
Thargal,tichondrius,288,rogue,subtlety,6,3,3
Reverel,tichondrius,288,rogue,subtlety,6,3,3
Shadowreapz,barthilas,288,rogue,subtlety,6,3,3
Garnoghan,stormrage,288,rogue,subtlety,6,3,3
Rogecoin,illidan,288,rogue,subtlety,6,3,3
Powaah,emerald-dream,288,rogue,subtlety,6,3,3
Izula,spirestone,288,rogue,subtlety,6,3,3
Privz,sargeras,288,rogue,subtlety,6,3,3
Thoxic,barthilas,288,rogue,subtlety,6,3,3
Støné,azjolnerub,288,rogue,subtlety,6,3,3
Mondeaux,moon-guard,288,rogue,subtlety,6,3,3
Trainhealers,tichondrius,288,rogue,subtlety,6,3,3
Taraminkadot,sargeras,288,rogue,subtlety,9,4,5
ßutthead,malganis,288,rogue,subtlety,7,3,4
Ünaru,sargeras,288,rogue,subtlety,7,3,4
Keytonx,tichondrius,288,rogue,subtlety,7,3,4
Terala,perenolde,288,rogue,subtlety,12,3,9
Niujaky,illidan,288,rogue,subtlety,12,3,9
Cincyhirou,exodar,288,rogue,subtlety,12,3,9
Penguineater,tichondrius,288,rogue,subtlety,12,3,9
Wrekage,emerald-dream,288,rogue,subtlety,12,3,9
Woboi,area-52,288,rogue,subtlety,12,3,9
Zeetwntyeght,stormrage,288,rogue,subtlety,12,3,9
Veatrix,zuljin,288,rogue,subtlety,12,3,9
Palla,tichondrius,288,rogue,subtlety,12,3,9
Coolswag,tichondrius,288,rogue,subtlety,12,3,9
Yülia,skywall,288,rogue,subtlety,12,3,9
Yottsu,proudmoore,288,rogue,subtlety,12,3,9
Foofz,kelthuzad,288,rogue,subtlety,12,3,9
Grinz,sargeras,288,rogue,subtlety,12,3,9
Nikkî,hyjal,288,rogue,subtlety,12,3,9
Khazii,scilla,288,rogue,subtlety,12,3,9
Eaxlol,sargeras,288,rogue,subtlety,12,3,9
Hogstradamus,malganis,288,rogue,subtlety,12,3,9
Miloandotis,malganis,288,rogue,subtlety,12,3,9
Imbe,nagrand,288,rogue,subtlety,12,3,9
Rassiter,stonemaul,288,rogue,subtlety,12,3,9
Yamillpgk,ragnaros,288,rogue,subtlety,12,3,9
Badonka,aggramar,288,rogue,subtlety,12,3,9
Bumpamoose,aggramar,288,rogue,subtlety,12,3,9
Smashfacewïn,tichondrius,288,rogue,subtlety,12,3,9
Heretodance,tichondrius,288,rogue,subtlety,18,3,15
Bajeebus,azshara,287,rogue,subtlety,6,3,3
Urukzog,ragnaros,287,rogue,subtlety,6,3,3
Framsteg,kelthuzad,287,rogue,subtlety,6,3,3
Xsneakski,jubeithos,287,rogue,subtlety,6,3,3
Stealheartsr,tichondrius,287,rogue,subtlety,7,3,4
Namiic,thrall,287,rogue,subtlety,12,3,9
Heserth,ragnaros,287,rogue,subtlety,12,3,9
Bromen,ragnaros,287,rogue,subtlety,12,3,9
Minnicent,amanthul,287,rogue,subtlety,18,3,15
Teach,illidan,287,rogue,subtlety,18,3,15
Aycaramba,skywall,286,rogue,subtlety,6,3,3
Cerebrian,malygos,286,rogue,subtlety,6,3,3
Tareduwu,area-52,286,rogue,subtlety,18,3,15
Rotbreath,bleeding-hollow,271,rogue,subtlety,17,3,14
Wickedstuns,malganis,271,rogue,subtlety,17,3,14
Soultakerr,whisperwind,271,rogue,subtlety,17,3,14
Reflexiv,malganis,256,rogue,subtlety,10,3,7
Elsegador,tichondrius,240,rogue,subtlety,9,4,5
Uncleblinker,proudmoore,239,rogue,subtlety,5,3,2
Wulfcrest,moon-guard,239,rogue,subtlety,5,3,2
Youngdraco,tichondrius,239,rogue,subtlety,5,3,2
Radagon,fenris,234,rogue,subtlety,9,4,5
Rocanról,quelthalas,234,rogue,subtlety,12,4,8
Twinkasz,nemesis,234,rogue,subtlety,16,5,11
Sappedwap,thrall,192,rogue,subtlety,4,3,1
Nocte,goldrinn,192,rogue,subtlety,6,2,4
Swingonya,stormrage,192,rogue,subtlety,6,2,4
Runescape,frostmourne,192,rogue,subtlety,6,2,4
Chêckmatê,darkspear,192,rogue,subtlety,6,2,4
Anímosity,darkspear,192,rogue,subtlety,6,2,4
Tryedge,moon-guard,192,rogue,subtlety,6,2,4
Meadview,bleeding-hollow,192,rogue,subtlety,6,2,4
Xyltann,bleeding-hollow,192,rogue,subtlety,6,2,4
Sicksix,bleeding-hollow,192,rogue,subtlety,6,2,4
Pixils,bleeding-hollow,192,rogue,subtlety,6,2,4
Shankmcganks,chogall,192,rogue,subtlety,6,2,4
Letsgobranon,sargeras,192,rogue,subtlety,6,2,4
Skorsh,wyrmrest-accord,192,rogue,subtlety,6,2,4
Lmorningstar,altar-of-storms,192,rogue,subtlety,6,2,4
Dillwilly,moon-guard,192,rogue,subtlety,6,2,4
Sneakyt,shadow-council,192,rogue,subtlety,6,2,4
Gzl,frostmourne,192,rogue,subtlety,6,2,4
Bloodhounder,illidan,192,rogue,subtlety,6,2,4
Happyunhappy,illidan,192,rogue,subtlety,6,2,4
Nubes,illidan,192,rogue,subtlety,6,2,4
Ikthemon,khaz-modan,192,rogue,subtlety,6,2,4
Jâm,nerzhul,192,rogue,subtlety,6,2,4
Buddymelon,thrall,192,rogue,subtlety,6,2,4
Pilurfs,thrall,192,rogue,subtlety,6,2,4
Åaron,thrall,192,rogue,subtlety,6,2,4
Rujkah,archimonde,192,rogue,subtlety,6,2,4
Slycndice,tortheldrin,192,rogue,subtlety,6,2,4
ßroke,emerald-dream,192,rogue,subtlety,6,2,4
Valrec,stormrage,192,rogue,subtlety,6,2,4
Tìlt,whisperwind,192,rogue,subtlety,6,2,4
Gnoescape,burning-legion,192,rogue,subtlety,6,2,4
Tothegravetv,sargeras,192,rogue,subtlety,6,2,4
Pëaches,area-52,192,rogue,subtlety,6,2,4
Smertin,area-52,192,rogue,subtlety,6,2,4
Indicadeath,stormrage,192,rogue,subtlety,6,2,4
Teribád,area-52,192,rogue,subtlety,6,2,4
Bruitzyttv,barthilas,192,rogue,subtlety,6,2,4
Shadowmagikk,sargeras,192,rogue,subtlety,6,2,4
Macklittle,area-52,192,rogue,subtlety,6,2,4
Grue,gundrak,192,rogue,subtlety,6,2,4
Alcinah,sargeras,192,rogue,subtlety,6,2,4
Ërëbus,greymane,192,rogue,subtlety,6,2,4
Brustent,icecrown,192,rogue,subtlety,6,2,4
Pizzarollplz,kelthuzad,192,rogue,subtlety,6,2,4
Sizak,kelthuzad,192,rogue,subtlety,6,2,4
Gannet,spirestone,192,rogue,subtlety,6,2,4
Kami,kelthuzad,192,rogue,subtlety,6,2,4
Elvesnknives,stormrage,192,rogue,subtlety,6,2,4
Stateless,kelthuzad,192,rogue,subtlety,6,2,4
Lenik,azuremyst,192,rogue,subtlety,6,2,4
Wètdream,sargeras,192,rogue,subtlety,6,2,4
Exwhite,proudmoore,192,rogue,subtlety,6,2,4
Yurico,zuljin,192,rogue,subtlety,6,2,4
Brutalpocket,malganis,192,rogue,subtlety,6,2,4
Jeezy,shadowmoon,192,rogue,subtlety,6,2,4
Zerø,barthilas,192,rogue,subtlety,6,2,4
Toomuchcap,aggramar,192,rogue,subtlety,6,2,4
Joegamer,sargeras,192,rogue,subtlety,6,2,4
Pootymunchin,daggerspine,192,rogue,subtlety,6,2,4
Ow,eldrethalas,192,rogue,subtlety,6,2,4
Bambooßobby,area-52,192,rogue,subtlety,6,2,4
Vanquief,sargeras,192,rogue,subtlety,6,2,4
Wyyre,hyjal,192,rogue,subtlety,6,2,4
Tleary,tichondrius,192,rogue,subtlety,6,2,4
Usapped,tichondrius,192,rogue,subtlety,6,2,4
Terrorstrike,tichondrius,192,rogue,subtlety,6,2,4
Rogsky,tichondrius,192,rogue,subtlety,6,2,4
Slíçk,tichondrius,192,rogue,subtlety,6,2,4
Roastful,tichondrius,192,rogue,subtlety,6,2,4
Sticksnstabs,tichondrius,192,rogue,subtlety,6,2,4
Yourhomieaj,tichondrius,192,rogue,subtlety,6,2,4
Sparklepuffy,tichondrius,192,rogue,subtlety,6,2,4
Shadowstryfe,tichondrius,192,rogue,subtlety,6,2,4
Stymie,malorne,192,rogue,subtlety,6,2,4
Zzu,azralon,192,rogue,subtlety,6,2,4
Opwanshinobi,azralon,192,rogue,subtlety,6,2,4
Coalie,tichondrius,192,rogue,subtlety,6,2,4
Lennysnephew,tichondrius,192,rogue,subtlety,6,2,4
Rehze,area-52,192,rogue,subtlety,6,2,4
Icantsleep,tichondrius,192,rogue,subtlety,6,2,4
Mgzx,tichondrius,192,rogue,subtlety,6,2,4
Alakie,cenarius,192,rogue,subtlety,6,2,4
Rhayu,emerald-dream,192,rogue,subtlety,6,2,4
Surplus,stormscale,192,rogue,subtlety,6,2,4
Theweeknd,kiljaeden,192,rogue,subtlety,7,2,5
Xenitech,bleeding-hollow,192,rogue,subtlety,8,2,6
Bâerâ,bloodscalp,192,rogue,subtlety,8,2,6
Krius,blood-furnace,192,rogue,subtlety,12,2,10
Zeriek,stormrage,192,rogue,subtlety,12,2,10
Barmiah,stormrage,192,rogue,subtlety,12,2,10
Xô,lothar,192,rogue,subtlety,12,2,10
Noxîc,zuljin,192,rogue,subtlety,12,2,10
Pouet,caelestrasz,192,rogue,subtlety,12,2,10
Kestor,barthilas,192,rogue,subtlety,12,2,10
Jakeharvey,dalaran,192,rogue,subtlety,12,2,10
Mitchrogue,barthilas,192,rogue,subtlety,12,2,10
Ezmate,frostmourne,192,rogue,subtlety,12,2,10
Bloodyblades,blackhand,192,rogue,subtlety,12,2,10
Soupline,area-52,192,rogue,subtlety,12,2,10
Diabsoule,amanthul,192,rogue,subtlety,12,2,10
Gutpunch,kelthuzad,192,rogue,subtlety,12,2,10
Zabava,malganis,192,rogue,subtlety,12,2,10
Brickjohnson,illidan,192,rogue,subtlety,12,2,10
Souporcereal,aegwynn,192,rogue,subtlety,12,2,10
Nigthdead,nemesis,192,rogue,subtlety,12,2,10
Rogmin,tichondrius,192,rogue,subtlety,12,2,10
Jashyy,tichondrius,192,rogue,subtlety,12,2,10
Wildstory,tichondrius,192,rogue,subtlety,12,2,10
Ghostdragons,tichondrius,192,rogue,subtlety,12,2,10
Myhandisfull,tichondrius,192,rogue,subtlety,12,2,10
Onulyo,tichondrius,192,rogue,subtlety,12,2,10
Flèè,illidan,192,rogue,subtlety,12,2,10
Bleedszfreak,illidan,192,rogue,subtlety,18,2,16
Roguessy,dalaran,192,rogue,subtlety,18,2,16
Vitalz,bloodscalp,191,rogue,subtlety,6,2,4
Seth,stonemaul,191,rogue,subtlety,6,2,4
Lancarlorïus,ragnaros,191,rogue,subtlety,6,2,4
Mccarter,bonechewer,191,rogue,subtlety,12,2,10
Sheiv,shadow-council,190,rogue,subtlety,5,3,2
Tenr,tichondrius,170,rogue,subtlety,13,4,9
Opensap,tichondrius,159,rogue,subtlety,5,2,3
Kanablis,tichondrius,159,rogue,subtlety,5,2,3
Khrezin,stonemaul,159,rogue,subtlety,5,2,3
Koobbo,tichondrius,159,rogue,subtlety,5,2,3
Eliasael,moon-guard,159,rogue,subtlety,5,2,3
Ganksterqt,dentarg,138,rogue,subtlety,10,3,7
Ladelmono,tichondrius,138,rogue,subtlety,15,3,12
Uhtrred,ragnaros,137,rogue,subtlety,10,3,7
Uchihà,sargeras,134,rogue,subtlety,17,3,14
Fadedx,darkspear,128,rogue,subtlety,4,2,2
Earthinhorn,frostmourne,127,rogue,subtlety,8,2,6
Swickwockdus,azralon,112,rogue,subtlety,7,2,5
Rickgone,bleeding-hollow,96,rogue,subtlety,3,2,1
Finlander,area-52,96,rogue,subtlety,5,2,3
Lásko,area-52,96,rogue,subtlety,9,2,7
Frootylol,stormrage,96,rogue,subtlety,6,1,5
Eimr,stormrage,96,rogue,subtlety,6,1,5
Dnb,warsong,96,rogue,subtlety,6,1,5
Aitreena,stormrage,96,rogue,subtlety,6,1,5
Mikea,stormrage,96,rogue,subtlety,6,1,5
Bonizzi,stormrage,96,rogue,subtlety,6,1,5
Thottie,bleeding-hollow,96,rogue,subtlety,6,1,5
Skinnymayne,laughing-skull,96,rogue,subtlety,6,1,5
Srrmortte,gallywix,96,rogue,subtlety,6,1,5
Wrin,sargeras,96,rogue,subtlety,6,1,5
Docheatt,dalaran,96,rogue,subtlety,6,1,5
Originkorean,terenas,96,rogue,subtlety,6,1,5
Vivas,dalaran,96,rogue,subtlety,6,1,5
Deepcutz,barthilas,96,rogue,subtlety,6,1,5
Anistreya,wyrmrest-accord,96,rogue,subtlety,6,1,5
Rooster,muradin,96,rogue,subtlety,6,1,5
Bloodbrawl,caelestrasz,96,rogue,subtlety,6,1,5
Yoodoo,nemesis,96,rogue,subtlety,6,1,5
Meatballjr,frostmane,96,rogue,subtlety,6,1,5
Herian,caelestrasz,96,rogue,subtlety,6,1,5
Grindaicha,dentarg,96,rogue,subtlety,6,1,5
Nobarå,veknilash,96,rogue,subtlety,6,1,5
Koraliya,kiljaeden,96,rogue,subtlety,6,1,5
Ovrfivethosn,malganis,96,rogue,subtlety,6,1,5
Dabrat,frostwolf,96,rogue,subtlety,6,1,5
Sapstick,kiljaeden,96,rogue,subtlety,6,1,5
Aenaesx,malygos,96,rogue,subtlety,6,1,5
Borre,kiljaeden,96,rogue,subtlety,6,1,5
Quackerjacks,lightnings-blade,96,rogue,subtlety,6,1,5
Jokerr,proudmoore,96,rogue,subtlety,6,1,5
Soggysenpai,kelthuzad,96,rogue,subtlety,6,1,5
Akilesx,quelthalas,96,rogue,subtlety,6,1,5
Toxína,quelthalas,96,rogue,subtlety,6,1,5
Dagarah,quelthalas,96,rogue,subtlety,6,1,5
Caalo,quelthalas,96,rogue,subtlety,6,1,5
Slobernocker,stormrage,96,rogue,subtlety,6,1,5
Treasy,malganis,96,rogue,subtlety,6,1,5
Adysius,malganis,96,rogue,subtlety,6,1,5
Nevatell,malganis,96,rogue,subtlety,6,1,5
Halion,nagrand,96,rogue,subtlety,6,1,5
Xone,saurfang,96,rogue,subtlety,6,1,5
Valekk,stormscale,96,rogue,subtlety,6,1,5
Páige,ragnaros,96,rogue,subtlety,6,1,5
Kizakuo,moon-guard,96,rogue,subtlety,6,1,5
Cotuffa,drakkari,96,rogue,subtlety,6,1,5
Macc,khazgoroth,96,rogue,subtlety,6,1,5
Reurog,garrosh,96,rogue,subtlety,6,1,5
Mídnìght,aegwynn,96,rogue,subtlety,6,1,5
Sawred,bonechewer,96,rogue,subtlety,6,1,5
Soosung,moon-guard,96,rogue,subtlety,6,1,5
Anadrol,sargeras,96,rogue,subtlety,6,1,5
Lawyergamer,bonechewer,96,rogue,subtlety,6,1,5
Liloudarog,tichondrius,96,rogue,subtlety,6,1,5
Teleqraph,frostmourne,96,rogue,subtlety,6,1,5
Satanicrizz,tichondrius,96,rogue,subtlety,6,1,5
Dragosha,antonidas,96,rogue,subtlety,6,1,5
Illidin,executus,96,rogue,subtlety,6,1,5
Wabi,tichondrius,96,rogue,subtlety,6,1,5
Spöke,dalvengyr,96,rogue,subtlety,6,1,5
Scowl,dethecus,96,rogue,subtlety,6,1,5
Whaazz,tichondrius,96,rogue,subtlety,6,1,5
Ironrod,shadowmoon,96,rogue,subtlety,6,1,5
Bigcolumn,tichondrius,96,rogue,subtlety,6,1,5
Ghostyd,tichondrius,96,rogue,subtlety,6,1,5
Solideoglria,tichondrius,96,rogue,subtlety,6,1,5
Heimlichkeit,tichondrius,96,rogue,subtlety,6,1,5
Steffmaister,tichondrius,96,rogue,subtlety,6,1,5
Sudokill,tichondrius,96,rogue,subtlety,6,1,5
Crÿptø,azralon,96,rogue,subtlety,6,1,5
Onetwostep,tichondrius,96,rogue,subtlety,6,1,5
Rolomon,tichondrius,96,rogue,subtlety,6,1,5
Robomom,illidan,96,rogue,subtlety,6,1,5
Mintirogue,sargeras,96,rogue,subtlety,6,1,5
Wildtrick,greymane,96,rogue,subtlety,12,1,11
Flelfo,quelthalas,96,rogue,subtlety,12,1,11
Minkys,azralon,79,rogue,subtlety,5,1,4
Zhaanth,bonechewer,79,rogue,subtlety,5,1,4
Vetisx,thrall,64,rogue,subtlety,4,1,3
Vùdõõ,area-52,64,rogue,subtlety,4,1,3
Drpibb,ghostlands,63,rogue,subtlety,2,2,0
Swøøpy,stormrage,48,rogue,subtlety,3,1,2
Thenelis,dalaran,42,rogue,subtlety,11,2,9
Archazx,sargeras,42,rogue,subtlety,12,2,10
Rosê,daggerspine,41,rogue,subtlety,8,4,4
Demonioverde,ragnaros,31,rogue,subtlety,2,1,1
Betakong,quelthalas,31,rogue,subtlety,2,1,1
Traumashears,proudmoore,31,rogue,subtlety,2,1,1
Helzzit,ragnaros,31,rogue,subtlety,2,1,1
Mirrorx,tichondrius,2227,rogue,assassination,234,119,115
Zarkk,kelthuzad,2141,rogue,assassination,311,155,156
Sllabymkcus,sargeras,2126,rogue,assassination,72,37,35
Larmx,tichondrius,2111,rogue,assassination,78,40,38
Xiaochulol,tichondrius,2097,rogue,assassination,96,51,45
Ånko,tichondrius,2033,rogue,assassination,113,53,60
Snortedgfuel,drenden,2015,rogue,assassination,83,41,42
Sinepymkcus,illidan,1991,rogue,assassination,96,44,52
Alethal,tichondrius,1972,rogue,assassination,90,48,42
Ymxxlolz,tichondrius,1899,rogue,assassination,78,37,41
Niarzz,tichondrius,1870,rogue,assassination,104,62,42
Topfloorboss,illidan,1865,rogue,assassination,83,45,38
Endlesswaltz,zuljin,1861,rogue,assassination,39,20,19
Lemon,arygos,1851,rogue,assassination,47,20,27
Sanira,illidan,1848,rogue,assassination,51,26,25
Poonanixo,frostmourne,1846,rogue,assassination,78,38,40
Alterfate,wyrmrest-accord,1839,rogue,assassination,66,33,33
Feinting,moon-guard,1839,rogue,assassination,76,35,41
Jon,the-venture-co,1838,rogue,assassination,54,27,27
Sio,bleeding-hollow,1837,rogue,assassination,60,30,30
Ajúmma,tichondrius,1831,rogue,assassination,57,23,34
Jjp,tichondrius,1827,rogue,assassination,65,33,32
Kenteenx,tichondrius,1823,rogue,assassination,60,28,32
Omnìslash,area-52,1817,rogue,assassination,44,27,17
Köfy,quelthalas,1813,rogue,assassination,87,41,46
Raj,blood-furnace,1810,rogue,assassination,66,29,37
Beaconlight,tichondrius,1808,rogue,assassination,77,31,46
Relän,ragnaros,1805,rogue,assassination,59,33,26
Sairak,tichondrius,1804,rogue,assassination,101,49,52
Plumblossomx,tichondrius,1803,rogue,assassination,54,24,30
Peepoclown,illidan,1782,rogue,assassination,58,29,29
Thargal,tichondrius,1774,rogue,assassination,71,38,33
Bloodlessftw,azralon,1765,rogue,assassination,152,71,81
Lunatixz,emerald-dream,1749,rogue,assassination,59,31,28
Doraz,tichondrius,1736,rogue,assassination,174,91,83
Stealthdeath,quelthalas,1728,rogue,assassination,42,24,18
Cutercarver,proudmoore,1721,rogue,assassination,117,56,61
Bellamor,tichondrius,1711,rogue,assassination,114,66,48
Impkasn,tichondrius,1710,rogue,assassination,84,33,51
Slickyo,area-52,1705,rogue,assassination,42,23,19
Pkkrevolt,archimonde,1704,rogue,assassination,99,50,49
Bukaboo,tichondrius,1701,rogue,assassination,54,40,14
Katmira,tichondrius,1699,rogue,assassination,72,30,42
Vmoney,draenor,1685,rogue,assassination,30,18,12
Inaniss,tichondrius,1678,rogue,assassination,56,30,26
Girio,thrall,1675,rogue,assassination,41,22,19
Vél,blackrock,1674,rogue,assassination,42,22,20
Whooxx,khazgoroth,1673,rogue,assassination,66,29,37
Viicky,ghostlands,1661,rogue,assassination,88,42,46
Seroth,tichondrius,1656,rogue,assassination,36,23,13
Ybby,tichondrius,1655,rogue,assassination,86,41,45
Bellicoses,tichondrius,1651,rogue,assassination,155,84,71
Ivanrah,zuljin,1648,rogue,assassination,45,20,25
Hypnothot,tichondrius,1643,rogue,assassination,144,62,82
Riventrix,zuljin,1640,rogue,assassination,101,47,54
Shyzuku,drakkari,1640,rogue,assassination,48,21,27
Kk,dalaran,1635,rogue,assassination,52,28,24
Wujn,tichondrius,1635,rogue,assassination,197,103,94
Rapcher,illidan,1632,rogue,assassination,148,75,73
Josex,lightbringer,1632,rogue,assassination,48,20,28
Stabasaurus,blood-furnace,1630,rogue,assassination,48,21,27
Olé,azralon,1627,rogue,assassination,78,35,43
Sheerlol,stormrage,1626,rogue,assassination,49,24,25
Poisonous,emerald-dream,1620,rogue,assassination,51,25,26
Assassìn,moon-guard,1618,rogue,assassination,48,27,21
Ultranumb,sargeras,1618,rogue,assassination,51,27,24
Zirkir,mannoroth,1615,rogue,assassination,50,27,23
Vasherr,zuljin,1611,rogue,assassination,55,33,22
Rîa,area-52,1611,rogue,assassination,48,21,27
Lycanthropî,illidan,1611,rogue,assassination,48,20,28
Rinhon,windrunner,1608,rogue,assassination,101,50,51
Sanozü,azralon,1606,rogue,assassination,54,21,33
Yenrab,illidan,1606,rogue,assassination,50,19,31
Foreverioi,tichondrius,1603,rogue,assassination,54,31,23
Elinarra,sargeras,1603,rogue,assassination,42,21,21
Slapjak,dalaran,1600,rogue,assassination,74,33,41
Johnnycryp,barthilas,1595,rogue,assassination,59,28,31
Lucidstorm,tichondrius,1593,rogue,assassination,30,17,13
Chêckmatê,darkspear,1589,rogue,assassination,54,25,29
Devstrike,sargeras,1587,rogue,assassination,53,25,28
Bladä,area-52,1585,rogue,assassination,70,35,35
Nayle,dalaran,1585,rogue,assassination,65,31,34
Katovo,tichondrius,1581,rogue,assassination,53,28,25
Htez,frostmourne,1580,rogue,assassination,42,22,20
Xagreth,illidan,1579,rogue,assassination,40,20,20
Sparqxx,tichondrius,1577,rogue,assassination,233,117,116
Happyslice,stormrage,1575,rogue,assassination,39,22,17
Ãnimefãnx,moon-guard,1574,rogue,assassination,165,81,84
Dairykeen,misha,1572,rogue,assassination,59,27,32
Nightdelphya,azralon,1572,rogue,assassination,48,19,29
Wxvi,tichondrius,1563,rogue,assassination,54,30,24
Quefist,sargeras,1561,rogue,assassination,92,43,49
Replayz,stormrage,1554,rogue,assassination,120,56,64
Valaq,tichondrius,1551,rogue,assassination,136,67,69
Miamiganster,lothar,1550,rogue,assassination,120,54,66
Driprat,area-52,1549,rogue,assassination,36,23,13
Kenyel,frostmourne,1543,rogue,assassination,90,40,50
Isàputàp,tichondrius,1542,rogue,assassination,72,37,35
Nhic,tichondrius,1542,rogue,assassination,57,23,34
Gyutaro,black-dragonflight,1537,rogue,assassination,336,167,169
Khrezin,stonemaul,1537,rogue,assassination,79,36,43
Nsns,drenden,1536,rogue,assassination,236,119,117
Sapmepapi,illidan,1533,rogue,assassination,30,17,13
Purplechil,garrosh,1532,rogue,assassination,165,79,86
Lyapunov,tichondrius,1532,rogue,assassination,66,30,36
Turec,illidan,1532,rogue,assassination,42,16,26
Kidneyshiv,stormrage,1531,rogue,assassination,36,20,16
Skeezy,vashj,1531,rogue,assassination,70,28,42
Strîkér,tichondrius,1529,rogue,assassination,43,20,23
Youwho,kiljaeden,1528,rogue,assassination,195,101,94
Cálí,azralon,1523,rogue,assassination,42,17,25
Garrotte,tichondrius,1521,rogue,assassination,223,105,118
Wxva,tichondrius,1515,rogue,assassination,42,18,24
Spikiera,silvermoon,1513,rogue,assassination,63,31,32
Tryedge,moon-guard,1512,rogue,assassination,36,19,17
Zeth,frostmourne,1501,rogue,assassination,93,37,56
Ulley,sargeras,1499,rogue,assassination,62,30,32
Saiine,drenden,1498,rogue,assassination,66,32,34
Stillsol,stormrage,1495,rogue,assassination,42,29,13
Yanhuaa,illidan,1493,rogue,assassination,109,58,51
Staabzz,thrall,1493,rogue,assassination,71,29,42
Onetwostep,tichondrius,1492,rogue,assassination,39,17,22
Stabem,moon-guard,1487,rogue,assassination,153,82,71
Hickery,frostmourne,1487,rogue,assassination,107,47,60
Brendantko,arthas,1486,rogue,assassination,30,16,14
Osuba,proudmoore,1486,rogue,assassination,116,51,65
Kiosh,tichondrius,1485,rogue,assassination,78,36,42
Paraisbae,tichondrius,1484,rogue,assassination,42,23,19
Sprigzey,frostmourne,1483,rogue,assassination,60,29,31
Sizka,sargeras,1483,rogue,assassination,102,48,54
Camlaw,area-52,1477,rogue,assassination,55,26,29
Shizunö,stormrage,1473,rogue,assassination,56,27,29
Gøblìn,tichondrius,1471,rogue,assassination,97,44,53
Hookahrogue,area-52,1469,rogue,assassination,36,19,17
Ezmate,frostmourne,1465,rogue,assassination,154,72,82
Kidneyisntop,illidan,1463,rogue,assassination,54,28,26
Notjawn,arthas,1459,rogue,assassination,196,102,94
Smkgpvp,stormrage,1456,rogue,assassination,29,16,13
Blackmont,bleeding-hollow,1456,rogue,assassination,60,26,34
Dianiss,ragnaros,1452,rogue,assassination,30,17,13
Madge,area-52,1451,rogue,assassination,82,39,43
Shankeez,tichondrius,1437,rogue,assassination,36,17,19
Øsi,icecrown,1433,rogue,assassination,36,15,21
Cleam,darkspear,1432,rogue,assassination,36,19,17
Lcl,proudmoore,1432,rogue,assassination,299,152,147
Pirrow,moon-guard,1429,rogue,assassination,52,28,24
Leônhart,thrall,1428,rogue,assassination,54,25,29
Kindasorry,illidan,1426,rogue,assassination,155,78,77
Boonee,frostmourne,1422,rogue,assassination,89,44,45
Stabu,dalvengyr,1417,rogue,assassination,30,15,15
Depressedx,illidan,1414,rogue,assassination,54,31,23
Xilorio,skullcrusher,1407,rogue,assassination,66,30,36
Lyliym,frostmourne,1405,rogue,assassination,32,16,16
Shninzy,senjin,1404,rogue,assassination,30,15,15
Evilsanta,sargeras,1404,rogue,assassination,40,18,22
Creamypeach,stormrage,1401,rogue,assassination,81,36,45
Vendëttä,quelthalas,1399,rogue,assassination,48,27,21
Valråvn,bloodscalp,1399,rogue,assassination,29,16,13
Swexee,area-52,1398,rogue,assassination,67,32,35
Playmaker,frostwolf,1396,rogue,assassination,156,82,74
Galaily,proudmoore,1387,rogue,assassination,90,44,46
Kahlx,azralon,1382,rogue,assassination,167,83,84
Xvds,tichondrius,1382,rogue,assassination,42,18,24
Itokuri,ysera,1379,rogue,assassination,42,19,23
Chakarr,stormrage,1374,rogue,assassination,32,22,10
Páïgèvêntürã,bleeding-hollow,1367,rogue,assassination,32,15,17
Pandrogue,shadowsong,1363,rogue,assassination,53,25,28
Kzx,illidan,1356,rogue,assassination,30,16,14
Theblindsap,dalaran,1354,rogue,assassination,30,16,14
Hiddencosts,proudmoore,1345,rogue,assassination,123,63,60
Liesll,thrall,1340,rogue,assassination,36,14,22
Wansuiye,tichondrius,1340,rogue,assassination,42,14,28
Røgüë,malganis,1338,rogue,assassination,30,14,16
Urukzog,ragnaros,1334,rogue,assassination,60,31,29
Apocalipto,barthilas,1332,rogue,assassination,89,38,51
Wongcha,darkspear,1331,rogue,assassination,36,14,22
Vannisshh,shattered-halls,1329,rogue,assassination,196,95,101
Entrerí,illidan,1328,rogue,assassination,27,17,10
Ykvo,illidan,1322,rogue,assassination,30,14,16
Rêdrum,illidan,1313,rogue,assassination,108,39,69
Ambushr,tichondrius,1312,rogue,assassination,24,16,8
Sneakoh,illidan,1312,rogue,assassination,65,24,41
Vimit,tichondrius,1310,rogue,assassination,66,29,37
Harlyquinn,barthilas,1309,rogue,assassination,102,52,50
Coquìn,proudmoore,1303,rogue,assassination,88,43,45
Enyr,frostmourne,1300,rogue,assassination,103,50,53
Powerjuicer,tichondrius,1300,rogue,assassination,66,31,35
Uxaen,tichondrius,1291,rogue,assassination,44,26,18
Skoorbals,tichondrius,1284,rogue,assassination,56,33,23
Gorgdrake,illidan,1283,rogue,assassination,78,39,39
Timat,emerald-dream,1282,rogue,assassination,48,22,26
Aynrand,drakkari,1281,rogue,assassination,36,16,20
Keepitshadow,frostmourne,1279,rogue,assassination,89,45,44
Grasiel,tichondrius,1277,rogue,assassination,62,27,35
Doomcore,barthilas,1276,rogue,assassination,41,21,20
Thepitt,stormrage,1272,rogue,assassination,48,23,25
Torshe,sargeras,1271,rogue,assassination,24,14,10
Keylâ,thrall,1264,rogue,assassination,62,33,29
Seengivenchy,zuljin,1262,rogue,assassination,26,14,12
Engels,quelthalas,1262,rogue,assassination,72,33,39
Ninjadoo,tichondrius,1262,rogue,assassination,68,27,41
Eliasael,moon-guard,1258,rogue,assassination,39,18,21
Lambs,blackhand,1258,rogue,assassination,35,14,21
Regios,shadowmoon,1255,rogue,assassination,71,31,40
Worlddark,quelthalas,1252,rogue,assassination,36,14,22
Lemonlemon,arygos,1247,rogue,assassination,24,13,11
Blindfun,emerald-dream,1247,rogue,assassination,39,21,18
Lakeshark,stormrage,1246,rogue,assassination,36,13,23
Sênorita,tichondrius,1246,rogue,assassination,36,13,23
Beedie,malganis,1244,rogue,assassination,111,55,56
Helecho,tichondrius,1244,rogue,assassination,30,13,17
Jaganz,stormrage,1243,rogue,assassination,24,13,11
Worm,demon-soul,1240,rogue,assassination,36,16,20
Roollz,nemesis,1240,rogue,assassination,33,14,19
Pál,quelthalas,1239,rogue,assassination,36,17,19
Greenlemons,lightnings-blade,1237,rogue,assassination,60,31,29
Papadopolous,zuluhed,1237,rogue,assassination,32,15,17
Laotrec,nemesis,1231,rogue,assassination,43,19,24
Raskapashan,moon-guard,1229,rogue,assassination,36,13,23
Pst,spirestone,1227,rogue,assassination,24,14,10
Stepper,aegwynn,1226,rogue,assassination,36,19,17
Jarcus,aggramar,1225,rogue,assassination,36,13,23
Senpaifuta,proudmoore,1222,rogue,assassination,24,14,10
Shinobick,kelthuzad,1222,rogue,assassination,30,15,15
Jagó,malganis,1215,rogue,assassination,36,17,19
Andreals,ragnaros,1211,rogue,assassination,24,14,10
Riggie,turalyon,1202,rogue,assassination,35,17,18
Dismayx,tichondrius,1198,rogue,assassination,47,20,27
Zxytox,hyjal,1191,rogue,assassination,33,17,16
Jeshka,wyrmrest-accord,1189,rogue,assassination,42,20,22
Lórdx,illidan,1189,rogue,assassination,56,25,31
Xhau,moon-guard,1186,rogue,assassination,81,43,38
Betakong,quelthalas,1180,rogue,assassination,30,15,15
Stepic,illidan,1177,rogue,assassination,65,30,35
Fakie,quelthalas,1176,rogue,assassination,37,21,16
Kriszov,moon-guard,1174,rogue,assassination,154,78,76
Rodanheim,burning-blade,1167,rogue,assassination,90,44,46
Mìtsuru,proudmoore,1165,rogue,assassination,36,20,16
Lycanthropì,illidan,1151,rogue,assassination,18,12,6
Peaches,akama,1151,rogue,assassination,24,12,12
Gùderman,tichondrius,1150,rogue,assassination,18,12,6
Lesentixd,stormrage,1149,rogue,assassination,30,12,18
Slycndice,tortheldrin,1148,rogue,assassination,78,45,33
Odetodindel,nerzhul,1146,rogue,assassination,60,32,28
Sergioz,quelthalas,1144,rogue,assassination,62,27,35
Vindzl,azralon,1139,rogue,assassination,36,12,24
Ixìa,vashj,1135,rogue,assassination,30,12,18
Chingado,kaelthas,1132,rogue,assassination,64,27,37
Peeryl,daggerspine,1129,rogue,assassination,130,74,56
Ràinê,dalaran,1128,rogue,assassination,24,13,11
Spooky,bleeding-hollow,1128,rogue,assassination,112,50,62
Sgnome,quelthalas,1128,rogue,assassination,30,12,18
Lakki,chromaggus,1127,rogue,assassination,30,12,18
Eldan,moon-guard,1121,rogue,assassination,66,24,42
Dothras,stormrage,1119,rogue,assassination,87,43,44
Shivsac,tichondrius,1117,rogue,assassination,47,20,27
Morgoophh,azralon,1116,rogue,assassination,216,110,106
Indivisible,thunderlord,1115,rogue,assassination,102,51,51
Sinnister,queldorei,1110,rogue,assassination,65,24,41
Copler,tichondrius,1110,rogue,assassination,48,17,31
Roguepvp,stormrage,1108,rogue,assassination,64,35,29
Nikhlaus,ragnaros,1107,rogue,assassination,24,13,11
Altarys,ragnaros,1103,rogue,assassination,27,15,12
Respia,proudmoore,1103,rogue,assassination,40,16,24
Dysxliec,dalaran,1101,rogue,assassination,35,12,23
Esraxo,frostmourne,1100,rogue,assassination,20,13,7
Velsad,sargeras,1093,rogue,assassination,35,14,21
Smoketoad,tichondrius,1081,rogue,assassination,30,15,15
Venefix,windrunner,1080,rogue,assassination,34,16,18
Osiriko,thunderlord,1061,rogue,assassination,114,61,53
Cashbigknife,area-52,1061,rogue,assassination,70,28,42
Aiden,burning-legion,1056,rogue,assassination,18,11,7
Ratlips,zuljin,1056,rogue,assassination,22,12,10
Frez,amanthul,1056,rogue,assassination,30,11,19
Vaporwavey,frostmourne,1055,rogue,assassination,18,11,7
Ziggee,sargeras,1055,rogue,assassination,50,25,25
Djfortníte,tichondrius,1055,rogue,assassination,24,11,13
Grafting,tichondrius,1055,rogue,assassination,24,11,13
Zipperx,tichondrius,1053,rogue,assassination,30,11,19
Stuns,azshara,1052,rogue,assassination,18,11,7
Effikacy,uldum,1051,rogue,assassination,24,11,13
Shigoo,sargeras,1051,rogue,assassination,24,11,13
Lefthook,kelthuzad,1051,rogue,assassination,37,15,22
Swingonya,stormrage,1051,rogue,assassination,30,11,19
Kazzo,tichondrius,1050,rogue,assassination,18,11,7
Lancin,azjolnerub,1050,rogue,assassination,24,11,13
Adrianstab,dalaran,1049,rogue,assassination,77,39,38
Roguecity,tichondrius,1048,rogue,assassination,193,85,108
Dochap,blackrock,1047,rogue,assassination,86,38,48
Sinistro,bleeding-hollow,1046,rogue,assassination,30,14,16
Tortador,quelthalas,1044,rogue,assassination,68,32,36
Looprevil,andorhal,1043,rogue,assassination,24,14,10
Caydeseis,stormrage,1031,rogue,assassination,18,11,7
Ñovä,tichondrius,1030,rogue,assassination,30,16,14
Cripstaet,spinebreaker,1029,rogue,assassination,25,12,13
Cjayy,bleeding-hollow,1028,rogue,assassination,37,13,24
Brobrando,tichondrius,1026,rogue,assassination,24,11,13
Deathshadow,dethecus,1025,rogue,assassination,30,11,19
Oddblade,stormrage,1025,rogue,assassination,36,11,25
Vastørogue,azralon,1017,rogue,assassination,61,31,30
Skigskag,shadowsong,1017,rogue,assassination,157,76,81
Snoopdrogado,sargeras,1010,rogue,assassination,52,27,25
Gygáx,terenas,1009,rogue,assassination,66,36,30
Poisønous,tichondrius,1004,rogue,assassination,21,11,10
Elithr,nemesis,1002,rogue,assassination,24,11,13
Edvardd,moon-guard,1001,rogue,assassination,39,20,19
Escape,elune,1001,rogue,assassination,30,14,16
Sheinnér,ragnaros,999,rogue,assassination,49,21,28
Artymesia,medivh,988,rogue,assassination,30,15,15
Feote,ragnaros,986,rogue,assassination,18,12,6
Karing,onyxia,977,rogue,assassination,22,11,11
Pegglerogue,fizzcrank,977,rogue,assassination,84,37,47
Wolgan,nemesis,975,rogue,assassination,61,30,31
Gersonq,moon-guard,965,rogue,assassination,25,13,12
Daggerback,bleeding-hollow,963,rogue,assassination,41,22,19
Loligotyou,stormrage,962,rogue,assassination,64,20,44
Jonuts,bleeding-hollow,960,rogue,assassination,18,10,8
Lakeshark,tichondrius,960,rogue,assassination,18,10,8
Gogothirteen,kiljaeden,960,rogue,assassination,32,15,17
Dizzymoods,stormrage,960,rogue,assassination,24,10,14
Kents,tichondrius,960,rogue,assassination,24,10,14
Synixi,moon-guard,960,rogue,assassination,24,10,14
Nikjawar,illidan,959,rogue,assassination,24,11,13
Downsix,sargeras,959,rogue,assassination,24,10,14
Jxxs,zuljin,959,rogue,assassination,24,10,14
Cerut,illidan,957,rogue,assassination,18,10,8
Combo,norgannon,956,rogue,assassination,24,10,14
Tri,the-underbog,956,rogue,assassination,30,10,20
Average,burning-blade,954,rogue,assassination,27,10,17
Snuzzy,darkspear,954,rogue,assassination,36,10,26
Sangreale,nemesis,953,rogue,assassination,18,10,8
Dockside,stormrage,953,rogue,assassination,18,10,8
Swiftbones,burning-blade,952,rogue,assassination,24,12,12
Arlom,daggerspine,951,rogue,assassination,18,10,8
Wolfsire,queldorei,949,rogue,assassination,24,10,14
Problemchild,rexxar,949,rogue,assassination,24,10,14
Vozzy,proudmoore,947,rogue,assassination,30,17,13
Lilgoosie,korgath,947,rogue,assassination,66,25,41
Xalsathoth,sargeras,946,rogue,assassination,36,10,26
Hattrìck,area-52,943,rogue,assassination,30,10,20
Kuntyou,barthilas,941,rogue,assassination,36,10,26
Headless,dragonmaw,934,rogue,assassination,76,38,38
Atomicgoat,tichondrius,928,rogue,assassination,33,12,21
Euweu,azralon,914,rogue,assassination,24,10,14
Pantypeelz,frostmourne,907,rogue,assassination,29,10,19
Requiescat,bleeding-hollow,902,rogue,assassination,27,10,17
Thenelis,dalaran,897,rogue,assassination,43,10,33
Cryptixx,blades-edge,896,rogue,assassination,41,16,25
Orcwarhammer,tichondrius,886,rogue,assassination,18,10,8
Emrogue,ragnaros,876,rogue,assassination,30,15,15
Turyx,azralon,871,rogue,assassination,90,28,62
Unlucký,sargeras,864,rogue,assassination,12,9,3
Ka,blackhand,864,rogue,assassination,12,9,3
Endworldlife,stormrage,864,rogue,assassination,12,9,3
Chizza,frostmourne,864,rogue,assassination,18,10,8
Cmòón,tichondrius,864,rogue,assassination,18,9,9
Dabrat,frostwolf,864,rogue,assassination,84,36,48
Ahjii,malganis,864,rogue,assassination,30,9,21
Aah,doomhammer,863,rogue,assassination,12,9,3
Dezly,tichondrius,863,rogue,assassination,18,9,9
Entropyphi,daggerspine,863,rogue,assassination,24,9,15
Whoox,khazgoroth,863,rogue,assassination,30,9,21
Mcskipa,sargeras,862,rogue,assassination,12,9,3
Criptoniø,azralon,862,rogue,assassination,52,24,28
Darkdessoft,ragnaros,861,rogue,assassination,24,9,15
Moardner,dalaran,860,rogue,assassination,84,30,54
Ballflicker,malganis,857,rogue,assassination,30,9,21
Shumira,tichondrius,856,rogue,assassination,18,9,9
Wreatus,moon-guard,853,rogue,assassination,108,44,64
Teach,illidan,849,rogue,assassination,102,37,65
Alkal,stormreaver,846,rogue,assassination,32,14,18
Pokiri,wyrmrest-accord,845,rogue,assassination,30,9,21
Thontz,sargeras,843,rogue,assassination,18,9,9
Lanottee,sargeras,829,rogue,assassination,17,10,7
Ripsaw,muradin,829,rogue,assassination,18,9,9
Píxíedúst,black-dragonflight,812,rogue,assassination,34,10,24
Chersy,tichondrius,810,rogue,assassination,32,10,22
Zamorant,emerald-dream,806,rogue,assassination,53,11,42
Zapersapp,malygos,803,rogue,assassination,28,10,18
Luckycrit,frostwolf,788,rogue,assassination,36,14,22
Ôñéèýèdkíñg,stormrage,768,rogue,assassination,12,8,4
Elsegador,tichondrius,768,rogue,assassination,12,8,4
Clairered,tichondrius,768,rogue,assassination,18,8,10
Drakariano,ragnaros,768,rogue,assassination,18,8,10
Macsap,frostmourne,768,rogue,assassination,18,8,10
Snakegødx,sargeras,768,rogue,assassination,21,9,12
Kdrx,thrall,768,rogue,assassination,24,8,16
Atulano,wyrmrest-accord,768,rogue,assassination,24,8,16
Pike,barthilas,767,rogue,assassination,12,8,4
Exeg,tichondrius,767,rogue,assassination,12,8,4
Warmode,zuluhed,767,rogue,assassination,12,8,4
Gøblìn,stormrage,767,rogue,assassination,15,9,6
Zetéra,ragnaros,767,rogue,assassination,18,8,10
Kágé,ragnaros,767,rogue,assassination,18,8,10
Gilbertgr,boulderfist,767,rogue,assassination,18,8,10
Sagatha,bleeding-hollow,767,rogue,assassination,18,8,10
Shiddlesz,area-52,767,rogue,assassination,18,8,10
Drtypzzaknfe,kelthuzad,767,rogue,assassination,24,8,16
Xshadowt,ragnaros,767,rogue,assassination,24,8,16
Frëdlock,kelthuzad,767,rogue,assassination,24,8,16
Sindor,azralon,767,rogue,assassination,30,8,22
Mylovejunex,tichondrius,766,rogue,assassination,12,8,4
ßackshots,kelthuzad,766,rogue,assassination,18,8,10
Gábagool,kiljaeden,766,rogue,assassination,24,8,16
Manersi,akama,764,rogue,assassination,24,8,16
Ðisappéar,ragnaros,764,rogue,assassination,33,9,24
Picaroxp,drakkari,762,rogue,assassination,12,8,4
Skîttlês,kul-tiras,762,rogue,assassination,18,8,10
Zropi,quelthalas,762,rogue,assassination,24,8,16
Slashinsteev,dalaran,761,rogue,assassination,18,8,10
Pikacuulo,ragnaros,760,rogue,assassination,31,9,22
Pusufox,tichondrius,759,rogue,assassination,18,8,10
Roguetwo,the-venture-co,758,rogue,assassination,12,8,4
Núm,tichondrius,756,rogue,assassination,32,12,20
Jaggeddagger,darrowmere,756,rogue,assassination,30,8,22
Snoor,nemesis,753,rogue,assassination,21,9,12
Killua,dalaran,752,rogue,assassination,18,8,10
Anyiele,stormrage,747,rogue,assassination,18,8,10
Vandalyze,sargeras,732,rogue,assassination,17,8,9
Savagedeeps,stormreaver,730,rogue,assassination,18,8,10
Sneakyfoot,gorgonnash,723,rogue,assassination,47,12,35
Slickdude,stormrage,717,rogue,assassination,66,14,52
Cruelworld,stormrage,713,rogue,assassination,30,10,20
Snub,aerie-peak,713,rogue,assassination,28,8,20
Cox,bleeding-hollow,708,rogue,assassination,14,10,4
Ghoulzer,tichondrius,704,rogue,assassination,10,8,2
Superharry,tichondrius,702,rogue,assassination,22,8,14
Chriseanrock,illidan,672,rogue,assassination,12,7,5
Skitsöu,tichondrius,672,rogue,assassination,12,7,5
Sotypical,area-52,672,rogue,assassination,12,7,5
Dzd,stormrage,672,rogue,assassination,12,7,5
Carcass,moon-guard,672,rogue,assassination,12,7,5
Toxicplyer,malganis,672,rogue,assassination,12,7,5
Zunwick,tichondrius,672,rogue,assassination,12,7,5
Lxw,frostmourne,672,rogue,assassination,12,7,5
Zaszune,stormrage,672,rogue,assassination,18,7,11
Elwynë,tichondrius,672,rogue,assassination,18,7,11
Twoheaded,frostmourne,672,rogue,assassination,18,7,11
Nogodplsno,stormrage,672,rogue,assassination,18,7,11
Mydearest,tichondrius,672,rogue,assassination,18,7,11
Slizard,boulderfist,671,rogue,assassination,12,7,5
Mcstabbface,tichondrius,671,rogue,assassination,12,7,5
Deepman,gorefiend,671,rogue,assassination,12,7,5
Løgîc,tichondrius,671,rogue,assassination,12,7,5
Jackbuster,area-52,671,rogue,assassination,12,7,5
Alithileria,moon-guard,671,rogue,assassination,12,7,5
Alizashea,stormrage,671,rogue,assassination,12,7,5
Gucciboo,sargeras,671,rogue,assassination,18,7,11
Johnthefum,malganis,671,rogue,assassination,18,7,11
Ezzdeath,tichondrius,671,rogue,assassination,18,7,11
Spectremg,azralon,671,rogue,assassination,18,7,11
Showclass,stormrage,671,rogue,assassination,18,7,11
Mhortai,stormrage,671,rogue,assassination,18,7,11
Mõtaru,stormrage,671,rogue,assassination,24,7,17
Vhiper,azralon,671,rogue,assassination,24,7,17
Mayyhem,caelestrasz,671,rogue,assassination,24,7,17
Tìnkerton,wyrmrest-accord,671,rogue,assassination,24,7,17
Habock,ragnaros,670,rogue,assassination,17,7,10
Sap,garrosh,670,rogue,assassination,18,7,11
Xhampu,ragnaros,670,rogue,assassination,18,7,11
Çrëeper,illidan,670,rogue,assassination,24,7,17
Anyiel,stormrage,670,rogue,assassination,24,7,17
Heimlichkeit,tichondrius,669,rogue,assassination,18,7,11
Trebyoyoyo,haomarush,669,rogue,assassination,24,7,17
Sneakynight,bleeding-hollow,668,rogue,assassination,18,7,11
Jakkov,blackrock,666,rogue,assassination,18,7,11
Diamondiâ,moon-guard,666,rogue,assassination,30,7,23
Kiorz,tichondrius,665,rogue,assassination,12,7,5
Soupspoon,terenas,664,rogue,assassination,18,7,11
Bityellow,tichondrius,663,rogue,assassination,12,7,5
Slootslayer,azshara,662,rogue,assassination,18,7,11
Muffens,alterac-mountains,662,rogue,assassination,18,7,11
Vladtsepesh,stormrage,662,rogue,assassination,30,7,23
Tralisong,azshara,660,rogue,assassination,18,7,11
Duonati,stormreaver,650,rogue,assassination,18,7,11
Irunaway,thrall,639,rogue,assassination,17,7,10
Tiptoez,bleeding-hollow,637,rogue,assassination,18,8,10
Dragoonz,nemesis,637,rogue,assassination,23,7,16
Runakó,kelthuzad,623,rogue,assassination,11,7,4
Thoxic,barthilas,620,rogue,assassination,17,7,10
Pochomän,ragnaros,618,rogue,assassination,16,9,7
Onulyo,tichondrius,618,rogue,assassination,16,8,8
Passoafaca,azralon,616,rogue,assassination,26,8,18
Roguebasic,frostmourne,612,rogue,assassination,24,8,16
Lethun,zuljin,607,rogue,assassination,14,7,7
Geratyere,trollbane,590,rogue,assassination,19,7,12
Kayriss,antonidas,576,rogue,assassination,12,6,6
Luriél,stormrage,576,rogue,assassination,12,6,6
Zareys,malorne,576,rogue,assassination,12,6,6
Saltoss,frostmourne,576,rogue,assassination,12,6,6
Chipetan,hyjal,576,rogue,assassination,12,6,6
Bloodygoat,area-52,576,rogue,assassination,12,6,6
Lsdlover,tichondrius,576,rogue,assassination,12,6,6
Nicknasty,kelthuzad,576,rogue,assassination,12,6,6
Dylan,frostmourne,576,rogue,assassination,12,6,6
Jaywas,tichondrius,576,rogue,assassination,12,6,6
Arcess,ragnaros,576,rogue,assassination,12,6,6
Lgy,chogall,576,rogue,assassination,12,6,6
Movze,area-52,576,rogue,assassination,12,6,6
Smum,tichondrius,576,rogue,assassination,12,6,6
Revlul,darkspear,576,rogue,assassination,12,6,6
Mosedz,tichondrius,576,rogue,assassination,12,6,6
Daggerthorne,sargeras,576,rogue,assassination,18,6,12
Slipperydog,jubeithos,576,rogue,assassination,18,6,12
Ahji,malganis,576,rogue,assassination,18,6,12
Çõvìd,malganis,576,rogue,assassination,30,6,24
Vayllie,zuljin,575,rogue,assassination,12,6,6
Blaçkout,thrall,575,rogue,assassination,12,6,6
Paradias,moonrunner,575,rogue,assassination,12,6,6
Robinsony,tichondrius,575,rogue,assassination,12,6,6
Alavennian,tichondrius,575,rogue,assassination,12,6,6
Ethaniel,bronzebeard,575,rogue,assassination,15,6,9
Slain,dark-iron,575,rogue,assassination,15,6,9
Miloandotis,malganis,575,rogue,assassination,18,6,12
Hoochzors,deathwing,575,rogue,assassination,18,6,12
Goutetsu,area-52,575,rogue,assassination,24,6,18
Aurrora,kiljaeden,574,rogue,assassination,17,6,11
Mcvillain,kelthuzad,573,rogue,assassination,12,6,6
Vegettaa,azralon,573,rogue,assassination,18,6,12
Yslkyle,skullcrusher,572,rogue,assassination,12,6,6
Akalio,laughing-skull,571,rogue,assassination,18,6,12
Addvilpm,wyrmrest-accord,570,rogue,assassination,12,6,6
Annastasiya,moon-guard,568,rogue,assassination,18,6,12
Vitalz,bloodscalp,568,rogue,assassination,18,6,12
Nektulos,illidan,566,rogue,assassination,13,6,7
Hellwolf,azgalor,565,rogue,assassination,13,6,7
Drpepzi,tichondrius,565,rogue,assassination,24,6,18
Stabsizzle,tichondrius,558,rogue,assassination,23,6,17
Julius,malganis,543,rogue,assassination,14,7,7
Lvx,frostmourne,528,rogue,assassination,9,6,3
Genève,dreadmaul,526,rogue,assassination,11,6,5
Redspoison,dalaran,512,rogue,assassination,10,6,4
Sìcarìus,tichondrius,512,rogue,assassination,22,6,16
Offlinepk,area-52,511,rogue,assassination,12,7,5
Cassini,gorefiend,488,rogue,assassination,21,8,13
Purcius,moon-guard,480,rogue,assassination,6,5,1
Macabre,the-forgotten-coast,480,rogue,assassination,6,5,1
Bigchimpin,frostmourne,480,rogue,assassination,6,5,1
Pwnsauce,frostmourne,480,rogue,assassination,7,5,2
Carnagê,zuljin,480,rogue,assassination,11,5,6
Tberg,emerald-dream,480,rogue,assassination,12,5,7
Fuzzyslow,stormrage,480,rogue,assassination,12,5,7
Váléntíná,tichondrius,480,rogue,assassination,12,5,7
Jezus,ghostlands,480,rogue,assassination,12,5,7
Bleedzbuttah,proudmoore,480,rogue,assassination,12,5,7
Toxan,emerald-dream,480,rogue,assassination,12,5,7
Sonymf,frostmourne,480,rogue,assassination,12,5,7
Gomma,stormrage,480,rogue,assassination,12,5,7
Outsap,tichondrius,480,rogue,assassination,12,5,7
Mercenàrioh,azralon,480,rogue,assassination,12,5,7
Vlayd,ragnaros,480,rogue,assassination,12,5,7
Bloore,fizzcrank,480,rogue,assassination,12,5,7
Roguespawn,dark-iron,480,rogue,assassination,12,5,7
Surprises,azralon,480,rogue,assassination,12,5,7
Cintan,barthilas,480,rogue,assassination,12,5,7
Akayod,tichondrius,480,rogue,assassination,12,5,7
Ppdx,malganis,480,rogue,assassination,12,5,7
Breakxcvii,bleeding-hollow,480,rogue,assassination,12,5,7
Venomsnáke,tichondrius,480,rogue,assassination,12,5,7
Dtelkham,tichondrius,480,rogue,assassination,16,6,10
Yellowdawt,stormrage,480,rogue,assassination,18,5,13
Csguixuan,aerie-peak,480,rogue,assassination,18,5,13
Xm,sargeras,480,rogue,assassination,18,5,13
Limitbreakkz,tichondrius,480,rogue,assassination,18,5,13
Paradise,smolderthorn,479,rogue,assassination,6,5,1
Beartøøth,stormrage,479,rogue,assassination,6,5,1
Dessenia,illidan,479,rogue,assassination,12,5,7
Møfshanks,sargeras,479,rogue,assassination,12,5,7
Scarrog,wyrmrest-accord,479,rogue,assassination,12,5,7
Slayersama,ragnaros,479,rogue,assassination,12,5,7
Meilh,emerald-dream,479,rogue,assassination,12,5,7
Poofhottie,lightbringer,479,rogue,assassination,12,5,7
Bigcolumn,tichondrius,479,rogue,assassination,12,5,7
Mashad,moon-guard,479,rogue,assassination,12,5,7
Prinseraegar,tichondrius,479,rogue,assassination,12,5,7
Vore,elune,479,rogue,assassination,12,5,7
Teeice,bladefist,479,rogue,assassination,12,5,7
Cynalia,sargeras,479,rogue,assassination,15,5,10
Rinestiria,arthas,479,rogue,assassination,18,5,13
Bonzaipopo,stormrage,479,rogue,assassination,18,5,13
Maison,ragnaros,478,rogue,assassination,12,5,7
Bonizzi,stormrage,478,rogue,assassination,12,5,7
Villainrogue,stormrage,478,rogue,assassination,12,5,7
Lethalist,whisperwind,476,rogue,assassination,12,5,7
Adysius,malganis,475,rogue,assassination,12,5,7
Wìndrunner,dalaran,474,rogue,assassination,12,5,7
Gurreth,zuljin,473,rogue,assassination,12,5,7
Killdead,warsong,473,rogue,assassination,12,5,7
Roadog,azralon,472,rogue,assassination,18,5,13
Donamarillo,sargeras,462,rogue,assassination,11,5,6
Gnaark,bleeding-hollow,447,rogue,assassination,11,5,6
Shizz,tichondrius,447,rogue,assassination,14,6,8
Twinkasz,nemesis,425,rogue,assassination,16,6,10
Elixera,sargeras,425,rogue,assassination,16,6,10
Minnicent,amanthul,413,rogue,assassination,10,5,5
Taessin,kelthuzad,384,rogue,assassination,6,4,2
Grima,azralon,384,rogue,assassination,6,4,2
Ballchinian,tichondrius,384,rogue,assassination,6,4,2
Endworldlife,tichondrius,384,rogue,assassination,6,4,2
Buckbreaker,stormrage,384,rogue,assassination,6,4,2
Vinrhayle,sargeras,384,rogue,assassination,6,4,2
Silentzero,quelthalas,384,rogue,assassination,6,4,2
Bungkhole,kiljaeden,384,rogue,assassination,6,4,2
Yurkarogue,tichondrius,384,rogue,assassination,6,4,2
Zervá,dalaran,384,rogue,assassination,6,4,2
Fofree,hyjal,384,rogue,assassination,6,4,2
Shaisty,malganis,384,rogue,assassination,6,4,2
Chokonet,gurubashi,384,rogue,assassination,6,4,2
Schleazy,emerald-dream,384,rogue,assassination,6,4,2
Hollowtipzz,tichondrius,384,rogue,assassination,6,4,2
Colom,moon-guard,384,rogue,assassination,6,4,2
Tmpikaboo,tichondrius,384,rogue,assassination,6,4,2
Nigthdead,nemesis,384,rogue,assassination,6,4,2
Gaige,muradin,384,rogue,assassination,6,4,2
Bootiebandit,tichondrius,384,rogue,assassination,6,4,2
Ikerz,tichondrius,384,rogue,assassination,9,4,5
Mirâge,illidan,384,rogue,assassination,12,4,8
Hirian,misha,384,rogue,assassination,12,4,8
Shadøw,the-forgotten-coast,384,rogue,assassination,12,4,8
Cryoph,illidan,384,rogue,assassination,12,4,8
Eski,kul-tiras,384,rogue,assassination,12,4,8
Muwop,barthilas,384,rogue,assassination,12,4,8
Stabbyboy,malganis,384,rogue,assassination,12,4,8
Ninjamf,bleeding-hollow,384,rogue,assassination,12,4,8
Gridisx,wyrmrest-accord,384,rogue,assassination,12,4,8
Streetjudas,barthilas,384,rogue,assassination,12,4,8
Ròry,dark-iron,384,rogue,assassination,12,4,8
Kargargar,thrall,384,rogue,assassination,12,4,8
Wowslayer,bleeding-hollow,384,rogue,assassination,12,4,8
Señorcheddar,thrall,384,rogue,assassination,12,4,8
Bu,zuljin,384,rogue,assassination,12,4,8
Kehkoa,thrall,384,rogue,assassination,12,4,8
Akhila,stormrage,384,rogue,assassination,12,4,8
Mansa,zangarmarsh,384,rogue,assassination,12,4,8
Poonaniqt,gundrak,384,rogue,assassination,12,4,8
Sillikitti,tichondrius,384,rogue,assassination,12,4,8
Psilocin,sargeras,384,rogue,assassination,12,4,8
Sellers,tichondrius,384,rogue,assassination,12,4,8
Aygon,laughing-skull,384,rogue,assassination,12,4,8
Deepsyo,frostmourne,384,rogue,assassination,12,4,8
Inunofun,stormrage,384,rogue,assassination,12,4,8
Cv,proudmoore,384,rogue,assassination,12,4,8
Celèphaïs,tichondrius,384,rogue,assassination,12,4,8
Denoms,area-52,384,rogue,assassination,18,4,14
Ssigma,tichondrius,384,rogue,assassination,18,4,14
Skinnymayne,laughing-skull,384,rogue,assassination,18,4,14
Escurecer,azralon,384,rogue,assassination,18,4,14
Azrek,sargeras,384,rogue,assassination,18,4,14
Gladlol,stormrage,384,rogue,assassination,18,4,14
Ggassasin,tichondrius,384,rogue,assassination,18,4,14
Wikkihx,emerald-dream,384,rogue,assassination,24,4,20
Vanishman,ragnaros,383,rogue,assassination,6,4,2
Eversincee,illidan,383,rogue,assassination,6,4,2
Jestertyv,hyjal,383,rogue,assassination,12,4,8
Ñinjå,alleria,383,rogue,assassination,12,4,8
Corteleve,nemesis,383,rogue,assassination,12,4,8
Sapstabdead,blackrock,383,rogue,assassination,12,4,8
Steeldiesel,sargeras,383,rogue,assassination,12,4,8
Moiatropos,ragnaros,383,rogue,assassination,12,4,8
Setsu,sargeras,383,rogue,assassination,13,4,9
Wrinklevoss,proudmoore,382,rogue,assassination,12,4,8
Kalandar,moon-guard,382,rogue,assassination,12,4,8
Hésta,moon-guard,382,rogue,assassination,12,4,8
Slobernocker,stormrage,381,rogue,assassination,12,4,8
Fllokii,arygos,381,rogue,assassination,12,4,8
Ðerpius,proudmoore,381,rogue,assassination,12,4,8
Revozy,azralon,381,rogue,assassination,12,4,8
Tolthe,hyjal,351,rogue,assassination,11,4,7
Atrreyu,lightninghoof,350,rogue,assassination,11,4,7
Siniel,scarlet-crusade,336,rogue,assassination,9,4,5
Griefs,tichondrius,330,rogue,assassination,17,5,12
Coopi,tichondrius,320,rogue,assassination,10,4,6
Whatsåpp,gallywix,320,rogue,assassination,10,4,6
Streetjesuz,barthilas,320,rogue,assassination,10,4,6
Pícáróóná,ragnaros,320,rogue,assassination,16,4,12
Suffêr,dalaran,319,rogue,assassination,8,4,4
Ziedrich,frostmourne,318,rogue,assassination,10,4,6
Mügi,ragnaros,288,rogue,assassination,6,3,3
Traviisto,sargeras,288,rogue,assassination,6,3,3
Punkyass,azralon,288,rogue,assassination,6,3,3
Jannie,rexxar,288,rogue,assassination,6,3,3
Greasybbsea,illidan,288,rogue,assassination,6,3,3
Ieu,tichondrius,288,rogue,assassination,6,3,3
Bledstepelin,frostmourne,288,rogue,assassination,6,3,3
Dïeb,zuljin,288,rogue,assassination,6,3,3
Saltypwncake,illidan,288,rogue,assassination,6,3,3
Shímira,azralon,288,rogue,assassination,6,3,3
Worrglaive,dalaran,288,rogue,assassination,6,3,3
Anímosity,darkspear,288,rogue,assassination,6,3,3
Maciota,area-52,288,rogue,assassination,6,3,3
Prodixybn,illidan,288,rogue,assassination,6,3,3
Mcjagerx,darkspear,288,rogue,assassination,6,3,3
Gbg,arathor,288,rogue,assassination,6,3,3
Thâïßòÿgøóñ,jubeithos,288,rogue,assassination,6,3,3
Deeshdosh,illidan,288,rogue,assassination,6,3,3
Syxs,sargeras,288,rogue,assassination,6,3,3
Corrier,tichondrius,288,rogue,assassination,6,3,3
Usernameqtxo,kelthuzad,288,rogue,assassination,6,3,3
Yggskuggi,moon-guard,288,rogue,assassination,6,3,3
Rýuu,bleeding-hollow,288,rogue,assassination,6,3,3
Brlsels,azralon,288,rogue,assassination,6,3,3
Ubun,quelthalas,288,rogue,assassination,6,3,3
Mgv,aegwynn,288,rogue,assassination,6,3,3
Shninzy,stormrage,288,rogue,assassination,6,3,3
Vahrheit,tichondrius,288,rogue,assassination,6,3,3
Cron,arygos,288,rogue,assassination,6,3,3
Chickfilaye,auchindoun,288,rogue,assassination,6,3,3
Calebrogue,illidan,288,rogue,assassination,6,3,3
Gutshøt,tichondrius,288,rogue,assassination,6,3,3
Steffmaister,tichondrius,288,rogue,assassination,6,3,3
Dannodan,proudmoore,288,rogue,assassination,6,3,3
Bigtengu,tichondrius,288,rogue,assassination,6,3,3
Ncb,bleeding-hollow,288,rogue,assassination,6,3,3
Pantsed,sargeras,288,rogue,assassination,6,3,3
Åmg,tichondrius,288,rogue,assassination,6,3,3
Drapezz,kelthuzad,288,rogue,assassination,6,3,3
Wowamaze,aegwynn,288,rogue,assassination,6,3,3
Pikabuu,bleeding-hollow,288,rogue,assassination,6,3,3
Crohnns,barthilas,288,rogue,assassination,6,3,3
Bigheadtony,hellscream,288,rogue,assassination,6,3,3
Emvee,kelthuzad,288,rogue,assassination,6,3,3
Kurosh,kalecgos,288,rogue,assassination,6,3,3
Velandros,eonar,288,rogue,assassination,6,3,3
Gulvzer,tichondrius,288,rogue,assassination,6,3,3
Redlïne,tichondrius,288,rogue,assassination,12,3,9
Knav,destromath,288,rogue,assassination,12,3,9
Brianä,quelthalas,288,rogue,assassination,12,3,9
Shortcut,khadgar,288,rogue,assassination,12,3,9
Tattoo,zuljin,288,rogue,assassination,12,3,9
Benielfman,illidan,288,rogue,assassination,12,3,9
Cydonian,ragnaros,288,rogue,assassination,12,3,9
Brudashmurda,tichondrius,288,rogue,assassination,12,3,9
Aevaela,duskwood,288,rogue,assassination,12,3,9
Pezcore,illidan,288,rogue,assassination,12,3,9
Înfêrnô,emerald-dream,288,rogue,assassination,12,3,9
Karmagoodttv,stormrage,288,rogue,assassination,12,3,9
Sunshinezx,frostmourne,288,rogue,assassination,12,3,9
Axm,azralon,288,rogue,assassination,12,3,9
Joeyzord,stormrage,288,rogue,assassination,12,3,9
Rokkhan,blackrock,288,rogue,assassination,12,3,9
Alttee,proudmoore,288,rogue,assassination,12,3,9
Pintofwoc,area-52,288,rogue,assassination,12,3,9
Finlander,area-52,288,rogue,assassination,12,3,9
Tìlt,whisperwind,288,rogue,assassination,12,3,9
Flattsr,tichondrius,288,rogue,assassination,12,3,9
Arïa,drakkari,288,rogue,assassination,12,3,9
Elevorra,frostmourne,288,rogue,assassination,12,3,9
Bubbski,area-52,288,rogue,assassination,12,3,9
Trinktick,doomhammer,288,rogue,assassination,12,3,9
Virez,kelthuzad,288,rogue,assassination,18,3,15
Ereshkigall,ragnaros,288,rogue,assassination,18,3,15
Stunedya,destromath,287,rogue,assassination,6,3,3
Ghutrencha,area-52,287,rogue,assassination,6,3,3
Shadownibba,illidan,287,rogue,assassination,6,3,3
Moridra,demon-soul,287,rogue,assassination,6,3,3
Gilhela,bloodhoof,287,rogue,assassination,6,3,3
Abuse,gundrak,287,rogue,assassination,6,3,3
Clipp,wildhammer,287,rogue,assassination,6,3,3
Loruk,ragnaros,287,rogue,assassination,6,3,3
Chïdaruma,azralon,287,rogue,assassination,12,3,9
Tracemakerr,emerald-dream,287,rogue,assassination,12,3,9
Olg,arathor,287,rogue,assassination,12,3,9
Talinô,moknathal,287,rogue,assassination,12,3,9
Anarusekkusu,wyrmrest-accord,287,rogue,assassination,12,3,9
Lyndra,thunderlord,287,rogue,assassination,12,3,9
Cricketts,kalecgos,287,rogue,assassination,16,3,13
Greekstryker,durotan,286,rogue,assassination,6,3,3
Lupindathird,frostmane,285,rogue,assassination,12,3,9
Clothies,zuljin,285,rogue,assassination,12,3,9
Sanguinnar,nemesis,285,rogue,assassination,12,3,9
Kiddmurphy,sargeras,271,rogue,assassination,11,3,8
Synesh,moon-guard,255,rogue,assassination,11,3,8
Fatass,tichondrius,255,rogue,assassination,11,3,8
Drøverînsane,thrall,239,rogue,assassination,5,3,2
Tamsy,the-forgotten-coast,239,rogue,assassination,5,3,2
Pitfirex,area-52,239,rogue,assassination,5,3,2
Shigoku,tichondrius,239,rogue,assassination,11,3,8
Walnutrog,area-52,234,rogue,assassination,11,5,6
Pãndã,stormrage,234,rogue,assassination,13,4,9
Skairipa,agamaggan,232,rogue,assassination,7,4,3
Estabo,daggerspine,223,rogue,assassination,8,3,5
Borre,kiljaeden,206,rogue,assassination,13,3,10
Roguegirl,alexstrasza,202,rogue,assassination,18,4,14
Ryunøka,quelthalas,192,rogue,assassination,4,3,1
Guazona,stormrage,192,rogue,assassination,6,2,4
Cktko,stormrage,192,rogue,assassination,6,2,4
Gentlesaop,blackrock,192,rogue,assassination,6,2,4
Wildtrick,greymane,192,rogue,assassination,6,2,4
Zogbu,stormrage,192,rogue,assassination,6,2,4
Amysix,antonidas,192,rogue,assassination,6,2,4
Zaozaa,frostmourne,192,rogue,assassination,6,2,4
Itskanashi,frostmourne,192,rogue,assassination,6,2,4
Kazúmi,stormrage,192,rogue,assassination,6,2,4
Militant,tichondrius,192,rogue,assassination,6,2,4
Karlemagne,blackrock,192,rogue,assassination,6,2,4
Apssal,tichondrius,192,rogue,assassination,6,2,4
Letmesap,lothar,192,rogue,assassination,6,2,4
Ilesire,frostmourne,192,rogue,assassination,6,2,4
Støné,azjolnerub,192,rogue,assassination,6,2,4
Kwins,cenarion-circle,192,rogue,assassination,6,2,4
Yanh,tichondrius,192,rogue,assassination,6,2,4
Ýûñí,tichondrius,192,rogue,assassination,6,2,4
Frostheartyy,azralon,192,rogue,assassination,6,2,4
Omnilol,zuljin,192,rogue,assassination,6,2,4
Sneakysharky,frostmourne,192,rogue,assassination,6,2,4
Asyncore,tichondrius,192,rogue,assassination,6,2,4
Swickwockdus,azralon,192,rogue,assassination,6,2,4
Robomom,illidan,192,rogue,assassination,6,2,4
Deathben,tichondrius,192,rogue,assassination,6,2,4
Shini,malganis,192,rogue,assassination,6,2,4
Asneakyfox,thunderlord,192,rogue,assassination,6,2,4
Wyyre,hyjal,192,rogue,assassination,6,2,4
Jpw,barthilas,192,rogue,assassination,6,2,4
Roguemain,smolderthorn,192,rogue,assassination,6,2,4
Wolfmother,nemesis,192,rogue,assassination,6,2,4
Darkfalleng,azralon,192,rogue,assassination,6,2,4
Poolover,barthilas,192,rogue,assassination,6,2,4
Historymaker,tichondrius,192,rogue,assassination,6,2,4
Quickflash,bloodhoof,192,rogue,assassination,6,2,4
Thianir,emerald-dream,192,rogue,assassination,6,2,4
Brand,bonechewer,192,rogue,assassination,6,2,4
Ennmaa,azralon,192,rogue,assassination,6,2,4
Yoodoo,nemesis,192,rogue,assassination,6,2,4
Savyt,dalaran,192,rogue,assassination,6,2,4
Novarra,tichondrius,192,rogue,assassination,6,2,4
Haeqn,nemesis,192,rogue,assassination,6,2,4
Ssjseem,sargeras,192,rogue,assassination,6,2,4
Ryoushei,ragnaros,192,rogue,assassination,6,2,4
Gabrielgray,firetree,192,rogue,assassination,6,2,4
Märlboro,ragnaros,192,rogue,assassination,6,2,4
Soizhiro,ragnaros,192,rogue,assassination,6,2,4
Toestumper,sargeras,192,rogue,assassination,6,2,4
Takeiapika,azralon,192,rogue,assassination,6,2,4
Happyunhappy,illidan,192,rogue,assassination,6,2,4
Ganksterqt,dentarg,192,rogue,assassination,6,2,4
Garatan,nemesis,192,rogue,assassination,6,2,4
Ninja,jubeithos,192,rogue,assassination,6,2,4
Poohkié,malganis,192,rogue,assassination,6,2,4
Tagerung,malganis,192,rogue,assassination,6,2,4
Baalos,medivh,192,rogue,assassination,6,2,4
Vanishcdc,area-52,192,rogue,assassination,6,2,4
Kellthzard,goldrinn,192,rogue,assassination,6,2,4
Karmakula,wildhammer,192,rogue,assassination,6,2,4
Corchô,moon-guard,192,rogue,assassination,6,2,4
Salätzar,quelthalas,192,rogue,assassination,6,2,4
Lesty,kelthuzad,192,rogue,assassination,6,2,4
Miklos,area-52,192,rogue,assassination,6,2,4
Jaanmonty,frostmourne,192,rogue,assassination,6,2,4
Nítzy,quelthalas,192,rogue,assassination,6,2,4
Zenshin,tichondrius,192,rogue,assassination,6,2,4
Ddeadlykiss,hydraxis,192,rogue,assassination,6,2,4
Procz,kirin-tor,192,rogue,assassination,6,2,4
Someone,ravencrest,192,rogue,assassination,6,2,4
Mermm,burning-blade,192,rogue,assassination,6,2,4
Liridor,quelthalas,192,rogue,assassination,11,2,9
Joelpinkelit,illidan,192,rogue,assassination,11,2,9
Youngtugger,daggerspine,192,rogue,assassination,11,2,9
Pleodonis,tichondrius,192,rogue,assassination,12,2,10
Leyff,stormrage,192,rogue,assassination,12,2,10
Aghanaar,burning-legion,192,rogue,assassination,12,2,10
Novocãin,draka,192,rogue,assassination,12,2,10
Slowtime,quelthalas,192,rogue,assassination,12,2,10
Triarc,area-52,192,rogue,assassination,12,2,10
Seltzie,bleeding-hollow,192,rogue,assassination,12,2,10
Stabsmcslice,laughing-skull,192,rogue,assassination,12,2,10
Geradyn,stormrage,192,rogue,assassination,12,2,10
Watto,ragnaros,192,rogue,assassination,12,2,10
Nines,icecrown,192,rogue,assassination,12,2,10
Dralax,ragnaros,192,rogue,assassination,12,2,10
Bloodwish,tichondrius,192,rogue,assassination,12,2,10
Subculture,emerald-dream,192,rogue,assassination,12,2,10
Alts,tichondrius,192,rogue,assassination,12,2,10
Nikosneako,tichondrius,192,rogue,assassination,12,2,10
Manyt,alterac-mountains,192,rogue,assassination,12,2,10
Jelloshots,blackhand,191,rogue,assassination,12,4,8
Bekaa,nemesis,191,rogue,assassination,6,2,4
Diatonic,illidan,191,rogue,assassination,6,2,4
Cretos,jaedenar,191,rogue,assassination,6,2,4
Donpablò,area-52,175,rogue,assassination,11,2,9
ßalto,bleeding-hollow,160,rogue,assassination,10,2,8
Chronisch,area-52,159,rogue,assassination,5,2,3
Swiftchen,illidan,159,rogue,assassination,5,2,3
Xavar,malganis,159,rogue,assassination,5,2,3
Minato,eredar,138,rogue,assassination,9,4,5
Stâbitha,bloodscalp,138,rogue,assassination,20,4,16
Privz,sargeras,96,rogue,assassination,6,1,5
Yohigo,quelthalas,96,rogue,assassination,6,1,5
Khlapncheeks,emerald-dream,96,rogue,assassination,6,1,5
Shhquiettime,norgannon,96,rogue,assassination,6,1,5
Tzs,sargeras,96,rogue,assassination,6,1,5
Vùdõõ,area-52,96,rogue,assassination,6,1,5
Diser,quelthalas,96,rogue,assassination,6,1,5
Sømeøne,malygos,96,rogue,assassination,6,1,5
Spookyswap,blackrock,96,rogue,assassination,6,1,5
Kiskapolyus,thrall,96,rogue,assassination,6,1,5
Tmterminel,moon-guard,96,rogue,assassination,6,1,5
Liesmith,kelthuzad,96,rogue,assassination,6,1,5
Buhuhbles,area-52,96,rogue,assassination,6,1,5
Elbryán,ragnaros,96,rogue,assassination,6,1,5
Twinkrogue,firetree,96,rogue,assassination,6,1,5
Rafikaa,ragnaros,96,rogue,assassination,6,1,5
Nubes,illidan,96,rogue,assassination,6,1,5
Ntshaav,illidan,96,rogue,assassination,6,1,5
Troclar,quelthalas,96,rogue,assassination,6,1,5
Meritra,ragnaros,96,rogue,assassination,6,1,5
Nebiroth,illidan,96,rogue,assassination,6,1,5
Flinchyy,dalaran,96,rogue,assassination,6,1,5
Wuzi,azralon,96,rogue,assassination,6,1,5
Docheatt,dalaran,96,rogue,assassination,6,1,5
Burtonee,aegwynn,96,rogue,assassination,6,1,5
Sevrow,wyrmrest-accord,96,rogue,assassination,6,1,5
Nightmarës,frostmourne,96,rogue,assassination,6,1,5
Greased,arthas,96,rogue,assassination,6,1,5
Twotimed,magtheridon,96,rogue,assassination,6,1,5
Giftschlange,azralon,96,rogue,assassination,6,1,5
Gianniv,chogall,96,rogue,assassination,6,1,5
Ninjasasory,azralon,96,rogue,assassination,6,1,5
Preceptor,azralon,96,rogue,assassination,6,1,5
Saintjon,bleeding-hollow,96,rogue,assassination,6,1,5
Panamarojo,tichondrius,96,rogue,assassination,6,1,5
Rykojin,dalaran,96,rogue,assassination,6,1,5
Zitihait,amanthul,96,rogue,assassination,6,1,5
Touchthetip,bleeding-hollow,96,rogue,assassination,6,1,5
Assakiller,azralon,96,rogue,assassination,6,1,5
Stêf,zuljin,96,rogue,assassination,6,1,5
Lululee,tichondrius,96,rogue,assassination,6,1,5
Jisatsu,undermine,96,rogue,assassination,6,1,5
Slycraft,gorgonnash,96,rogue,assassination,6,1,5
Icantsleep,tichondrius,96,rogue,assassination,6,1,5
Lu,lethon,96,rogue,assassination,6,1,5
Tòúka,stormrage,96,rogue,assassination,6,1,5
Canesuckr,stormrage,96,rogue,assassination,6,1,5
Detektor,stormrage,96,rogue,assassination,6,1,5
Scylas,stormrage,96,rogue,assassination,6,1,5
Erebüs,thunderlord,96,rogue,assassination,6,1,5
Deathxx,destromath,96,rogue,assassination,6,1,5
Clicksbtns,area-52,96,rogue,assassination,6,1,5
Combøz,tichondrius,96,rogue,assassination,6,1,5
Bourrasque,frostmourne,96,rogue,assassination,6,1,5
Deejey,frostmourne,96,rogue,assassination,6,1,5
Damídia,stormrage,96,rogue,assassination,10,1,9
Lilko,daggerspine,96,rogue,assassination,12,1,11
Acrona,dathremar,96,rogue,assassination,12,1,11
Karparog,ragnaros,96,rogue,assassination,12,1,11
Boogiedewitt,emerald-dream,96,rogue,assassination,12,1,11
Xô,lothar,96,rogue,assassination,12,1,11
Keljadian,black-dragonflight,96,rogue,assassination,12,1,11
Rabidlynsane,deathwing,96,rogue,assassination,12,1,11
Kistef,tichondrius,96,rogue,assassination,12,1,11
Voidbrain,area-52,96,rogue,assassination,12,1,11
Véndéttá,area-52,96,rogue,assassination,12,1,11
Armonica,wyrmrest-accord,96,rogue,assassination,12,1,11
Irotanin,thrall,95,rogue,assassination,6,1,5
Euphylezz,garrosh,95,rogue,assassination,6,1,5
Averagepimpn,tichondrius,79,rogue,assassination,5,1,4
Radiantrogue,nordrassil,79,rogue,assassination,5,1,4
Entriped,stormrage,48,rogue,assassination,3,1,2
Botches,bonechewer,48,rogue,assassination,3,1,2
Stabbindude,illidan,48,rogue,assassination,3,1,2
Gilbarblo,skywall,48,rogue,assassination,9,1,8
Sûshì,tichondrius,48,rogue,assassination,9,1,8
Naoyuki,stormrage,42,rogue,assassination,7,2,5
Nargonis,illidan,42,rogue,assassination,8,2,6
Parmigianore,ragnaros,42,rogue,assassination,10,2,8
Jerzs,tichondrius,42,rogue,assassination,11,2,9
Ajy,tichondrius,31,rogue,assassination,2,1,1
Dàmìan,mugthol,31,rogue,assassination,2,1,1
Najmoiran,area-52,31,rogue,assassination,2,1,1
Ascherx,illidan,16,rogue,assassination,1,1,0
Rompoloyo,quelthalas,15,rogue,assassination,1,1,0
Dyllbar,tichondrius,2283,shaman,restoration,157,89,68
Dadbar,tichondrius,2281,shaman,restoration,108,67,41
Samyeh,tichondrius,2252,shaman,restoration,83,55,28
Yooseafood,tichondrius,2248,shaman,restoration,101,64,37
Orochisháman,stormrage,2222,shaman,restoration,96,55,41
Skipperx,thrall,2191,shaman,restoration,78,48,30
Illiteratex,tichondrius,2168,shaman,restoration,88,49,39
Ttvfoxyllama,tichondrius,2157,shaman,restoration,88,45,43
Akwesy,stormrage,2156,shaman,restoration,135,76,59
Xtremeorc,area-52,2148,shaman,restoration,72,41,31
Aameng,tichondrius,2140,shaman,restoration,120,64,56
Tréway,area-52,2135,shaman,restoration,66,41,25
Crazyshamañ,akama,2131,shaman,restoration,127,69,58
Restobyte,moon-guard,2124,shaman,restoration,72,44,28
Plewt,zuljin,2114,shaman,restoration,178,94,84
Svanteson,wyrmrest-accord,2110,shaman,restoration,126,67,59
Selketh,area-52,2107,shaman,restoration,79,46,33
Iissham,darkspear,2092,shaman,restoration,188,101,87
Kantok,quelthalas,2051,shaman,restoration,89,55,34
Nediar,tichondrius,2050,shaman,restoration,54,39,15
Nemix,barthilas,2049,shaman,restoration,66,38,28
Vicioushands,illidan,2047,shaman,restoration,66,37,29
Madoka,llane,2035,shaman,restoration,107,57,50
Jîneth,tichondrius,2021,shaman,restoration,101,54,47
Zavoky,tichondrius,2020,shaman,restoration,174,92,82
Chairstain,kelthuzad,2015,shaman,restoration,175,101,74
Timpossible,tichondrius,2011,shaman,restoration,459,230,229
Lötus,tichondrius,2010,shaman,restoration,110,61,49
Itsallgoodx,tichondrius,2008,shaman,restoration,114,55,59
Abovesky,proudmoore,2006,shaman,restoration,186,92,94
Coreygunz,illidan,2001,shaman,restoration,60,32,28
Spagetje,tichondrius,2001,shaman,restoration,323,162,161
Smlz,garrosh,1998,shaman,restoration,68,38,30
Sizure,frostmourne,1998,shaman,restoration,124,64,60
Aureal,malganis,1990,shaman,restoration,180,111,69
Boyfromhell,stormrage,1985,shaman,restoration,103,50,53
Corianderism,tichondrius,1982,shaman,restoration,77,40,37
Ravaburst,sargeras,1975,shaman,restoration,72,36,36
Berquon,tichondrius,1974,shaman,restoration,78,40,38
Üchihamadarâ,tichondrius,1968,shaman,restoration,67,37,30
Kurtcx,tichondrius,1966,shaman,restoration,395,202,193
Breuer,tichondrius,1966,shaman,restoration,128,64,64
Caibeeshammy,tichondrius,1963,shaman,restoration,192,97,95
Shamaen,kelthuzad,1952,shaman,restoration,119,60,59
Flarkology,area-52,1951,shaman,restoration,48,25,23
Bigbadsac,frostmourne,1941,shaman,restoration,179,91,88
Blaiserpub,tichondrius,1940,shaman,restoration,76,39,37
Ilavayoualot,malganis,1940,shaman,restoration,148,68,80
Gratiens,zuljin,1939,shaman,restoration,108,51,57
Cruv,thrall,1936,shaman,restoration,96,47,49
Terapatrik,area-52,1935,shaman,restoration,170,87,83
Plorenz,illidan,1934,shaman,restoration,60,36,24
Yungtooth,emerald-dream,1934,shaman,restoration,101,54,47
Jangbi,malganis,1934,shaman,restoration,246,129,117
Oryxx,kiljaeden,1934,shaman,restoration,84,40,44
Menc,frostmourne,1924,shaman,restoration,114,56,58
Ratedpvp,thrall,1923,shaman,restoration,200,115,85
Nayro,bleeding-hollow,1921,shaman,restoration,533,288,245
Angrygochuxx,tichondrius,1920,shaman,restoration,35,21,14
Kimflo,tichondrius,1920,shaman,restoration,466,238,228
Slimdavey,tichondrius,1919,shaman,restoration,208,112,96
Ogctkoy,illidan,1911,shaman,restoration,172,88,84
Wâgu,moon-guard,1906,shaman,restoration,46,21,25
Peyn,shadowsong,1905,shaman,restoration,72,34,38
Shamanese,emerald-dream,1901,shaman,restoration,42,20,22
Kafkaesk,tichondrius,1900,shaman,restoration,72,32,40
Uncleilli,tichondrius,1893,shaman,restoration,65,30,35
Nepos,dragonmaw,1891,shaman,restoration,66,34,32
Huáxià,tichondrius,1888,shaman,restoration,166,86,80
Däbü,tichondrius,1887,shaman,restoration,84,40,44
Mandleman,tichondrius,1884,shaman,restoration,140,85,55
Smrtdeath,zuljin,1884,shaman,restoration,53,30,23
Gragomga,area-52,1882,shaman,restoration,150,75,75
Epicthesloth,sargeras,1881,shaman,restoration,59,32,27
Stormtitan,malganis,1881,shaman,restoration,86,42,44
Eboy,thrall,1877,shaman,restoration,265,137,128
Tisaa,illidan,1876,shaman,restoration,30,20,10
Semtechs,tichondrius,1875,shaman,restoration,403,201,202
Sewerperson,zuljin,1873,shaman,restoration,60,32,28
Lignipzyo,doomhammer,1872,shaman,restoration,48,27,21
Nanosec,tichondrius,1871,shaman,restoration,42,27,15
Esqueue,sargeras,1871,shaman,restoration,48,29,19
Muscleyuan,tichondrius,1866,shaman,restoration,59,27,32
Hulan,tichondrius,1865,shaman,restoration,36,20,16
Kellogsz,malganis,1864,shaman,restoration,96,43,53
Patzog,area-52,1861,shaman,restoration,42,25,17
Bômi,tichondrius,1861,shaman,restoration,184,96,88
Laydboiyo,tichondrius,1861,shaman,restoration,66,32,34
Badshock,tichondrius,1859,shaman,restoration,48,35,13
Hódoong,tichondrius,1857,shaman,restoration,46,24,22
Haedodae,tichondrius,1857,shaman,restoration,81,32,49
Bigmontana,tichondrius,1856,shaman,restoration,54,31,23
Cardïß,tichondrius,1854,shaman,restoration,48,26,22
Moistbeans,tichondrius,1854,shaman,restoration,48,26,22
Oridean,area-52,1854,shaman,restoration,42,22,20
Cmsi,tichondrius,1852,shaman,restoration,48,26,22
Baodan,azshara,1847,shaman,restoration,83,42,41
Moldymeatbox,emerald-dream,1847,shaman,restoration,96,47,49
Mybbro,kiljaeden,1846,shaman,restoration,98,49,49
Wtbtotem,tichondrius,1846,shaman,restoration,66,33,33
Helga,hellscream,1845,shaman,restoration,48,29,19
Solam,greymane,1845,shaman,restoration,60,31,29
Onlytides,malganis,1844,shaman,restoration,42,32,10
Upyourtotem,illidan,1842,shaman,restoration,30,22,8
Shamcena,the-scryers,1842,shaman,restoration,51,28,23
Shamanbini,tichondrius,1839,shaman,restoration,47,26,21
Chocopuff,bleeding-hollow,1838,shaman,restoration,66,33,33
Fluxxy,tichondrius,1838,shaman,restoration,115,53,62
Conjunction,azjolnerub,1837,shaman,restoration,65,29,36
Exceedër,ragnaros,1835,shaman,restoration,60,34,26
Stormlashx,sargeras,1835,shaman,restoration,36,20,16
Zoeyzour,illidan,1835,shaman,restoration,415,221,194
Sokta,azgalor,1834,shaman,restoration,163,81,82
Stylesp,tichondrius,1833,shaman,restoration,60,32,28
Laji,cairne,1833,shaman,restoration,215,110,105
Splashz,illidan,1833,shaman,restoration,71,36,35
Chontastic,darkspear,1833,shaman,restoration,60,27,33
Kwesy,tichondrius,1832,shaman,restoration,42,23,19
Suzhixie,akama,1831,shaman,restoration,175,82,93
Wanghaisham,kelthuzad,1830,shaman,restoration,123,63,60
Papatooties,tichondrius,1830,shaman,restoration,257,124,133
Chobawn,tichondrius,1829,shaman,restoration,60,32,28
Pingatronx,ragnaros,1829,shaman,restoration,60,29,31
Bluekid,barthilas,1828,shaman,restoration,54,30,24
Snoozeshaman,ragnaros,1826,shaman,restoration,36,21,15
Beyoncé,lethon,1826,shaman,restoration,53,30,23
Chazzwozza,area-52,1826,shaman,restoration,53,30,23
Hathul,bleeding-hollow,1826,shaman,restoration,60,33,27
Vlly,tichondrius,1826,shaman,restoration,59,27,32
Tuskcrusher,dalaran,1825,shaman,restoration,72,30,42
Gjök,nemesis,1824,shaman,restoration,54,22,32
Dehsaw,illidan,1821,shaman,restoration,108,54,54
Cryochemist,tichondrius,1819,shaman,restoration,29,23,6
Tarròò,bleeding-hollow,1819,shaman,restoration,60,34,26
Lavalavalava,eonar,1819,shaman,restoration,54,26,28
Bigspaghetti,thrall,1818,shaman,restoration,66,31,35
Terrasham,barthilas,1818,shaman,restoration,47,20,27
Onagi,frostmourne,1817,shaman,restoration,84,53,31
Purpose,nerzhul,1817,shaman,restoration,54,33,21
Totempack,stormrage,1817,shaman,restoration,54,26,28
Gyrogg,scilla,1816,shaman,restoration,525,278,247
Ryuubi,illidan,1815,shaman,restoration,54,34,20
Ogran,stormscale,1815,shaman,restoration,54,25,29
Immabòt,tichondrius,1813,shaman,restoration,59,36,23
Dadidun,tichondrius,1813,shaman,restoration,48,25,23
Ericzlassoz,tichondrius,1812,shaman,restoration,66,42,24
Grymn,sargeras,1812,shaman,restoration,264,132,132
Kurtxc,tichondrius,1810,shaman,restoration,36,25,11
Dantheman,twisting-nether,1810,shaman,restoration,42,23,19
Seimitsu,tichondrius,1810,shaman,restoration,47,24,23
Waterbro,tichondrius,1809,shaman,restoration,101,57,44
Annte,stonemaul,1809,shaman,restoration,64,32,32
Meatballs,kirin-tor,1809,shaman,restoration,62,31,31
Desee,bleeding-hollow,1809,shaman,restoration,54,27,27
Kandshamy,azralon,1807,shaman,restoration,118,69,49
Ookmetide,bleeding-hollow,1807,shaman,restoration,52,29,23
Ghomragar,antonidas,1807,shaman,restoration,82,42,40
Willy,icecrown,1807,shaman,restoration,87,44,43
Raeoki,area-52,1806,shaman,restoration,185,100,85
Totemgripper,moon-guard,1804,shaman,restoration,65,39,26
Hydrocheck,tichondrius,1804,shaman,restoration,94,54,40
Astrøcyte,tichondrius,1804,shaman,restoration,96,46,50
Tolík,ragnaros,1803,shaman,restoration,54,26,28
Earthspeaker,bleeding-hollow,1802,shaman,restoration,54,33,21
Lemmehex,illidan,1802,shaman,restoration,61,37,24
Oceangrown,emerald-dream,1802,shaman,restoration,51,22,29
Joyrex,spinebreaker,1802,shaman,restoration,75,30,45
Jìmmybuckets,tichondrius,1801,shaman,restoration,59,37,22
Stórmstruck,area-52,1800,shaman,restoration,72,41,31
Nktx,tichondrius,1800,shaman,restoration,118,66,52
Holdmytotum,tichondrius,1800,shaman,restoration,52,29,23
Zaapi,dalaran,1800,shaman,restoration,108,60,48
Nazugresha,bleeding-hollow,1800,shaman,restoration,42,23,19
Baseballcap,sargeras,1800,shaman,restoration,78,37,41
Shockmematty,tichondrius,1798,shaman,restoration,36,25,11
Fàlc,stormrage,1798,shaman,restoration,42,22,20
Ganvitchenko,illidan,1798,shaman,restoration,97,47,50
Inmø,ragnaros,1797,shaman,restoration,36,19,17
Kromgul,malfurion,1797,shaman,restoration,96,46,50
Hodoongs,tichondrius,1797,shaman,restoration,49,23,26
Dxxlol,tichondrius,1795,shaman,restoration,54,29,25
Cigaretter,tichondrius,1793,shaman,restoration,56,25,31
Éspresso,moon-guard,1790,shaman,restoration,48,32,16
Fierymoo,frostmourne,1790,shaman,restoration,48,23,25
Deephole,illidan,1788,shaman,restoration,217,110,107
Itsyabøiwill,area-52,1787,shaman,restoration,84,50,34
Vogaz,ragnaros,1785,shaman,restoration,64,33,31
Rollintotems,bleeding-hollow,1785,shaman,restoration,84,39,45
Drupman,dalaran,1784,shaman,restoration,48,24,24
Petrafk,illidan,1783,shaman,restoration,161,72,89
Bombadil,korgath,1782,shaman,restoration,42,22,20
Bubbacheeks,area-52,1781,shaman,restoration,84,50,34
Booramqt,tichondrius,1780,shaman,restoration,47,27,20
Cpplol,tichondrius,1779,shaman,restoration,59,35,24
Zingysham,tichondrius,1777,shaman,restoration,75,39,36
Boxfour,tichondrius,1777,shaman,restoration,105,50,55
Hiermy,tichondrius,1775,shaman,restoration,53,29,24
Blazingtotem,dunemaul,1775,shaman,restoration,125,64,61
Petzah,barthilas,1774,shaman,restoration,54,25,29
Sleepysham,kelthuzad,1771,shaman,restoration,135,71,64
Chessyc,ragnaros,1771,shaman,restoration,65,29,36
Badhealerip,tichondrius,1770,shaman,restoration,86,47,39
Shanasty,bleeding-hollow,1769,shaman,restoration,60,31,29
Waymond,khadgar,1769,shaman,restoration,230,115,115
Ränton,bleeding-hollow,1764,shaman,restoration,54,28,26
Blackpïnk,tichondrius,1764,shaman,restoration,179,91,88
Bozzyy,illidan,1761,shaman,restoration,114,56,58
Linkandwink,nerzhul,1760,shaman,restoration,42,24,18
Julíp,tichondrius,1760,shaman,restoration,58,23,35
Rawdogginher,dalaran,1757,shaman,restoration,42,26,16
Erbicklet,ragnaros,1755,shaman,restoration,166,88,78
Chomang,stormreaver,1755,shaman,restoration,132,62,70
Victorin,zuljin,1754,shaman,restoration,72,48,24
Bobbybigdam,tichondrius,1752,shaman,restoration,93,50,43
Sylicious,barthilas,1751,shaman,restoration,36,24,12
Shawmen,zuljin,1748,shaman,restoration,208,110,98
Gatorwavez,bleeding-hollow,1746,shaman,restoration,89,51,38
Warríed,sargeras,1746,shaman,restoration,59,29,30
Suyy,tichondrius,1746,shaman,restoration,54,26,28
Camer,sargeras,1745,shaman,restoration,54,33,21
Toazty,stormscale,1745,shaman,restoration,75,44,31
Mastashamsta,illidan,1745,shaman,restoration,48,25,23
Svondo,illidan,1744,shaman,restoration,37,25,12
Blackfancy,thrall,1744,shaman,restoration,56,32,24
Targhal,tichondrius,1742,shaman,restoration,254,141,113
Taronì,zuljin,1742,shaman,restoration,72,32,40
Chonchastic,darkspear,1741,shaman,restoration,54,27,27
Diulama,tichondrius,1740,shaman,restoration,69,45,24
Aiyoubro,tichondrius,1738,shaman,restoration,47,26,21
Ftp,kelthuzad,1738,shaman,restoration,47,26,21
Esqueue,tichondrius,1736,shaman,restoration,36,22,14
Pookiexo,illidan,1736,shaman,restoration,41,25,16
Hoshwear,azralon,1733,shaman,restoration,57,40,17
Overtax,tichondrius,1733,shaman,restoration,36,20,16
Gweemextreme,tichondrius,1733,shaman,restoration,88,46,42
Rantòn,bleeding-hollow,1733,shaman,restoration,59,27,32
Moorgl,tichondrius,1732,shaman,restoration,53,26,27
Bacon,lightninghoof,1732,shaman,restoration,204,94,110
Multiduelist,bleeding-hollow,1731,shaman,restoration,36,28,8
Redds,tichondrius,1730,shaman,restoration,114,77,37
Pèpé,sargeras,1730,shaman,restoration,50,30,20
Groundingtot,hydraxis,1730,shaman,restoration,48,27,21
Juicedbydad,kelthuzad,1730,shaman,restoration,48,25,23
Muggz,sargeras,1729,shaman,restoration,60,27,33
Hotknifez,tichondrius,1727,shaman,restoration,30,18,12
Funkesapien,tichondrius,1727,shaman,restoration,54,27,27
Mitchestic,illidan,1727,shaman,restoration,101,42,59
Maloran,zuljin,1727,shaman,restoration,65,24,41
Krazyc,sargeras,1726,shaman,restoration,90,47,43
Héadshot,bleeding-hollow,1726,shaman,restoration,143,71,72
Oninobu,sargeras,1724,shaman,restoration,70,44,26
Hairyrichard,zuljin,1722,shaman,restoration,823,432,391
Phxhouse,illidan,1722,shaman,restoration,324,159,165
Spampurge,emerald-dream,1721,shaman,restoration,36,21,15
Shamanesè,emerald-dream,1721,shaman,restoration,36,18,18
Sìxnìne,tichondrius,1716,shaman,restoration,68,32,36
Inpantsment,barthilas,1714,shaman,restoration,151,78,73
Bizzarro,azgalor,1713,shaman,restoration,79,40,39
Ðiglett,frostmourne,1713,shaman,restoration,146,72,74
Fkwithme,burning-blade,1711,shaman,restoration,66,30,36
Duregar,tichondrius,1709,shaman,restoration,60,35,25
Dolshamizzy,tichondrius,1708,shaman,restoration,36,19,17
Chiggys,area-52,1708,shaman,restoration,65,33,32
Charlesby,tichondrius,1706,shaman,restoration,198,113,85
Tobírama,bleeding-hollow,1705,shaman,restoration,54,23,31
Slm,bleeding-hollow,1704,shaman,restoration,24,18,6
Hustlenflow,tichondrius,1704,shaman,restoration,60,32,28
Elementz,tichondrius,1703,shaman,restoration,222,116,106
Naweiv,caelestrasz,1702,shaman,restoration,54,31,23
Specifyz,arathor,1702,shaman,restoration,42,24,18
Xzxz,sargeras,1701,shaman,restoration,187,105,82
Torrentzx,sargeras,1701,shaman,restoration,36,18,18
Abulailah,sargeras,1699,shaman,restoration,65,37,28
Strives,icecrown,1698,shaman,restoration,66,33,33
Renghostwolf,illidan,1698,shaman,restoration,36,18,18
Lingduacn,tichondrius,1698,shaman,restoration,36,18,18
Doubletåp,emerald-dream,1697,shaman,restoration,41,20,21
Ozmats,malganis,1697,shaman,restoration,88,42,46
Xoweeknd,bleeding-hollow,1697,shaman,restoration,42,19,23
Magma,spirestone,1695,shaman,restoration,102,62,40
Shockxd,illidan,1695,shaman,restoration,48,25,23
Montageb,illidan,1694,shaman,restoration,39,29,10
Bootybpoppin,mugthol,1694,shaman,restoration,120,72,48
Møp,spirestone,1694,shaman,restoration,143,72,71
Namso,tichondrius,1693,shaman,restoration,42,23,19
Nessannix,stormrage,1692,shaman,restoration,223,125,98
Ribbeye,tichondrius,1692,shaman,restoration,154,76,78
Notmugg,sargeras,1691,shaman,restoration,42,24,18
Drammah,malganis,1691,shaman,restoration,72,33,39
Eletius,tichondrius,1690,shaman,restoration,29,26,3
Vrom,whisperwind,1690,shaman,restoration,90,51,39
Sin,bleeding-hollow,1690,shaman,restoration,36,20,16
Wegoagain,tichondrius,1690,shaman,restoration,42,20,22
Xruok,kelthuzad,1689,shaman,restoration,39,24,15
Ittøki,tichondrius,1689,shaman,restoration,41,24,17
Lilgeeh,kelthuzad,1689,shaman,restoration,46,24,22
Shozen,bonechewer,1689,shaman,restoration,54,26,28
Rockzoa,tichondrius,1688,shaman,restoration,60,27,33
Devastaterr,bleeding-hollow,1687,shaman,restoration,110,57,53
Shk,illidan,1686,shaman,restoration,42,27,15
Yehbeen,tichondrius,1686,shaman,restoration,42,25,17
Solidhomme,tichondrius,1684,shaman,restoration,42,23,19
Wraethy,illidan,1683,shaman,restoration,326,167,159
Flappygooch,illidan,1683,shaman,restoration,113,51,62
Platewalrus,illidan,1682,shaman,restoration,42,24,18
Bizzarra,azshara,1681,shaman,restoration,39,26,13
Ibreakanklez,bleeding-hollow,1681,shaman,restoration,42,20,22
Cosmô,sargeras,1679,shaman,restoration,48,20,28
Tanta,gurubashi,1678,shaman,restoration,57,25,32
Isagii,stormrage,1677,shaman,restoration,65,38,27
Shadowz,alexstrasza,1676,shaman,restoration,74,48,26
Dingfu,sargeras,1676,shaman,restoration,202,117,85
Raywhiter,tichondrius,1676,shaman,restoration,62,29,33
Bigdictuna,sargeras,1675,shaman,restoration,242,131,111
Rynoh,dalaran,1675,shaman,restoration,121,64,57
Shacewoman,altar-of-storms,1674,shaman,restoration,174,79,95
Nethyxsoy,frostmourne,1673,shaman,restoration,48,33,15
Urga,hyjal,1672,shaman,restoration,36,20,16
Meepsham,kilrogg,1672,shaman,restoration,42,22,20
Paoran,sargeras,1670,shaman,restoration,70,35,35
Tpokes,sargeras,1669,shaman,restoration,42,22,20
Qksilverz,nemesis,1669,shaman,restoration,83,43,40
Thelphor,nemesis,1669,shaman,restoration,48,24,24
Shamanceylol,barthilas,1668,shaman,restoration,134,73,61
Tokuma,illidan,1667,shaman,restoration,58,26,32
Drekkhal,area-52,1666,shaman,restoration,178,104,74
Skipler,stormrage,1666,shaman,restoration,66,36,30
Horizonsham,stormrage,1666,shaman,restoration,66,36,30
Animus,dark-iron,1665,shaman,restoration,48,30,18
Baern,thrall,1665,shaman,restoration,86,43,43
Scroogz,emerald-dream,1665,shaman,restoration,102,50,52
Sasgöb,illidan,1665,shaman,restoration,83,36,47
Toxidizetkö,azralon,1664,shaman,restoration,48,26,22
Semnicktotem,area-52,1663,shaman,restoration,72,36,36
Heniu,tichondrius,1663,shaman,restoration,60,27,33
Hamrok,moon-guard,1662,shaman,restoration,84,42,42
Mastlau,tichondrius,1662,shaman,restoration,60,30,30
Bogz,korgath,1662,shaman,restoration,209,96,113
Reppinsix,sargeras,1662,shaman,restoration,58,24,34
Bluepigo,tichondrius,1660,shaman,restoration,59,24,35
Prêttylights,bleeding-hollow,1659,shaman,restoration,36,20,16
Youliuhua,tichondrius,1659,shaman,restoration,36,19,17
Belarix,emerald-dream,1659,shaman,restoration,205,96,109
Exshocks,tichondrius,1658,shaman,restoration,54,30,24
Imd,tichondrius,1658,shaman,restoration,42,21,21
Lingdusm,tichondrius,1657,shaman,restoration,36,20,16
Gorillox,chogall,1657,shaman,restoration,42,23,19
Vayces,barthilas,1657,shaman,restoration,199,103,96
Zuescannon,kelthuzad,1656,shaman,restoration,84,39,45
Benjaminx,tichondrius,1655,shaman,restoration,101,63,38
Fatdixb,illidan,1655,shaman,restoration,47,26,21
Restosêxual,tichondrius,1655,shaman,restoration,42,21,21
Mcwindyfists,zuljin,1655,shaman,restoration,48,23,25
Meskthemage,barthilas,1654,shaman,restoration,47,23,24
Novoz,tichondrius,1653,shaman,restoration,42,24,18
Whameradetu,suramar,1653,shaman,restoration,71,31,40
Goobie,crushridge,1651,shaman,restoration,68,43,25
Win,blackwing-lair,1651,shaman,restoration,36,21,15
Cmz,bleeding-hollow,1650,shaman,restoration,137,76,61
Mixxt,illidan,1649,shaman,restoration,36,19,17
Neosham,frostwolf,1649,shaman,restoration,66,31,35
Bolteon,malganis,1648,shaman,restoration,30,21,9
Okïòmó,proudmoore,1648,shaman,restoration,47,21,26
Purgenx,tichondrius,1647,shaman,restoration,42,27,15
Peegee,zuluhed,1647,shaman,restoration,66,28,38
Jsell,zuljin,1646,shaman,restoration,56,28,28
Amdshaman,thrall,1645,shaman,restoration,67,37,30
Fuzzymuzzy,illidan,1644,shaman,restoration,54,29,25
Gabant,azralon,1644,shaman,restoration,42,19,23
Rugmat,tichondrius,1642,shaman,restoration,84,44,40
Weoo,doomhammer,1642,shaman,restoration,48,23,25
Ekss,tichondrius,1642,shaman,restoration,48,19,29
Gordonramsai,sargeras,1641,shaman,restoration,272,148,124
Squimbert,tichondrius,1641,shaman,restoration,48,21,27
Singleorigin,tichondrius,1641,shaman,restoration,105,41,64
Akheeta,tichondrius,1639,shaman,restoration,69,47,22
Chainstuff,area-52,1639,shaman,restoration,53,29,24
Ethikas,tichondrius,1638,shaman,restoration,42,24,18
Erwin,bonechewer,1638,shaman,restoration,225,123,102
Beastofmagic,illidan,1638,shaman,restoration,125,68,57
Dgshaman,tichondrius,1637,shaman,restoration,32,20,12
Cheddaman,kiljaeden,1637,shaman,restoration,48,21,27
Daddybeaarr,thrall,1635,shaman,restoration,55,25,30
Randomshammy,stormrage,1634,shaman,restoration,78,44,34
Gjok,nemesis,1634,shaman,restoration,59,20,39
Quitnectar,aggramar,1633,shaman,restoration,48,24,24
Shortbusqt,hyjal,1631,shaman,restoration,42,23,19
Wawsham,tichondrius,1631,shaman,restoration,48,19,29
Biguaga,tichondrius,1629,shaman,restoration,42,24,18
Shocksauce,tichondrius,1627,shaman,restoration,100,55,45
Intruzionall,barthilas,1627,shaman,restoration,241,130,111
Wonima,tichondrius,1627,shaman,restoration,34,18,16
Foragorn,stormrage,1627,shaman,restoration,217,110,107
Jbalvi,ragnaros,1626,shaman,restoration,141,82,59
Grizze,bonechewer,1626,shaman,restoration,90,41,49
Goranzo,emerald-dream,1626,shaman,restoration,54,24,30
Shocknrot,maelstrom,1623,shaman,restoration,38,23,15
Drfentanylx,emerald-dream,1623,shaman,restoration,30,17,13
Thunderspark,tichondrius,1622,shaman,restoration,54,30,24
Spiritry,tichondrius,1622,shaman,restoration,204,107,97
Enfusiontv,tichondrius,1621,shaman,restoration,30,21,9
Vanella,malganis,1621,shaman,restoration,42,25,17
Texmawave,moon-guard,1621,shaman,restoration,125,71,54
Thuntard,bleeding-hollow,1621,shaman,restoration,48,23,25
Badclass,the-underbog,1618,shaman,restoration,29,21,8
Hooldcool,tichondrius,1618,shaman,restoration,255,147,108
Yoshìmìtsu,illidan,1618,shaman,restoration,102,53,49
Stormstrikes,tichondrius,1618,shaman,restoration,64,26,38
Zeonard,ragnaros,1617,shaman,restoration,252,129,123
Angelbie,tichondrius,1617,shaman,restoration,74,33,41
Kimchimi,tichondrius,1616,shaman,restoration,192,108,84
Skoobasteeve,sargeras,1616,shaman,restoration,75,42,33
Bigamez,azuremyst,1616,shaman,restoration,158,88,70
Durogh,darkspear,1616,shaman,restoration,60,23,37
Sorgal,area-52,1616,shaman,restoration,60,22,38
Kobecoopper,sargeras,1615,shaman,restoration,42,21,21
Sunyang,tichondrius,1615,shaman,restoration,36,17,19
Gki,tichondrius,1614,shaman,restoration,49,34,15
Dazu,drakkari,1614,shaman,restoration,57,38,19
World,frostmourne,1614,shaman,restoration,47,25,22
Quendella,aggramar,1613,shaman,restoration,42,25,17
Polared,hyjal,1613,shaman,restoration,52,25,27
Velar,frostwolf,1613,shaman,restoration,48,19,29
Todems,kalecgos,1612,shaman,restoration,42,24,18
Makocc,tichondrius,1611,shaman,restoration,48,24,24
Unbreakable,illidan,1611,shaman,restoration,91,43,48
Dreadxtotems,illidan,1610,shaman,restoration,77,42,35
Cherryboy,illidan,1610,shaman,restoration,87,45,42
Tesle,illidan,1609,shaman,restoration,54,24,30
Ðoomed,kiljaeden,1608,shaman,restoration,30,19,11
Alett,arathor,1608,shaman,restoration,60,29,31
Plzdontlos,illidan,1607,shaman,restoration,113,69,44
Tideful,area-52,1607,shaman,restoration,42,22,20
Prowdt,azralon,1607,shaman,restoration,418,217,201
Harigomi,tichondrius,1607,shaman,restoration,360,186,174
Ssaotizi,tichondrius,1607,shaman,restoration,329,166,163
Rainingheals,auchindoun,1607,shaman,restoration,44,19,25
Randomshammy,area-52,1606,shaman,restoration,30,17,13
Astrauk,nemesis,1606,shaman,restoration,76,43,33
Raxshock,stormrage,1606,shaman,restoration,42,22,20
Chingobling,illidan,1605,shaman,restoration,54,31,23
Hexrz,area-52,1605,shaman,restoration,42,21,21
Luckyscatter,frostmourne,1605,shaman,restoration,36,18,18
Totemslol,ysera,1605,shaman,restoration,65,31,34
Surginate,zuljin,1605,shaman,restoration,42,18,24
Sliditin,tichondrius,1604,shaman,restoration,36,25,11
Hurú,azralon,1604,shaman,restoration,36,21,15
Spampurge,blackwing-lair,1604,shaman,restoration,37,19,18
Improvize,malganis,1604,shaman,restoration,70,35,35
Polarities,malganis,1604,shaman,restoration,54,21,33
Kratór,kelthuzad,1603,shaman,restoration,47,31,16
Fernetbrança,ragnaros,1603,shaman,restoration,48,26,22
Telchar,quelthalas,1602,shaman,restoration,102,62,40
Tarritos,ragnaros,1602,shaman,restoration,52,26,26
Centalinkxox,frostmourne,1602,shaman,restoration,63,31,32
Lacid,tichondrius,1601,shaman,restoration,68,42,26
Purgebotx,bleeding-hollow,1601,shaman,restoration,114,70,44
Belshiro,sargeras,1601,shaman,restoration,108,51,57
Latorius,frostmourne,1600,shaman,restoration,171,99,72
Shocksfuker,stormrage,1600,shaman,restoration,104,58,46
Darcheros,quelthalas,1600,shaman,restoration,60,31,29
Succmytotems,tichondrius,1600,shaman,restoration,93,47,46
Foilcap,bonechewer,1600,shaman,restoration,296,144,152
Improvedx,akama,1600,shaman,restoration,52,24,28
Ddogz,illidan,1600,shaman,restoration,48,21,27
Gulmuwu,zuljin,1599,shaman,restoration,38,22,16
Yeeraldyn,quelthalas,1599,shaman,restoration,60,29,31
Tevya,dalvengyr,1598,shaman,restoration,83,47,36
Ryeqt,illidan,1598,shaman,restoration,47,23,24
Gemoz,tichondrius,1597,shaman,restoration,30,22,8
Steveyy,frostmourne,1597,shaman,restoration,39,24,15
Hehew,kelthuzad,1597,shaman,restoration,146,76,70
Óompaloompa,frostmourne,1596,shaman,restoration,36,17,19
Bestbrook,tichondrius,1596,shaman,restoration,153,71,82
Harth,zuljin,1594,shaman,restoration,122,70,52
Tideoverdose,tichondrius,1594,shaman,restoration,36,19,17
Dumerslayer,ragnaros,1594,shaman,restoration,42,22,20
Rogrim,malganis,1592,shaman,restoration,54,28,26
Asøg,emerald-dream,1592,shaman,restoration,75,35,40
Yeamn,saurfang,1591,shaman,restoration,165,97,68
Lazie,perenolde,1590,shaman,restoration,30,19,11
Tzyorz,illidan,1589,shaman,restoration,150,79,71
Jazzlightnin,tichondrius,1589,shaman,restoration,71,31,40
Shamsom,tichondrius,1588,shaman,restoration,122,58,64
Specify,arathor,1588,shaman,restoration,90,41,49
Turborundat,area-52,1586,shaman,restoration,225,127,98
Besylate,illidan,1586,shaman,restoration,80,39,41
Snakesoul,area-52,1585,shaman,restoration,133,73,60
Kolanji,akama,1585,shaman,restoration,41,22,19
Vywolf,frostmourne,1583,shaman,restoration,80,46,34
Lilcaju,sargeras,1581,shaman,restoration,29,18,11
Okinn,malganis,1581,shaman,restoration,29,17,12
Zechary,proudmoore,1580,shaman,restoration,48,29,19
Gunrose,proudmoore,1580,shaman,restoration,109,55,54
Pkx,eitrigg,1578,shaman,restoration,47,20,27
Packspiritqt,tichondrius,1577,shaman,restoration,48,27,21
Colterr,thunderhorn,1577,shaman,restoration,36,20,16
Asnalda,emerald-dream,1576,shaman,restoration,57,32,25
Onepunchsham,illidan,1576,shaman,restoration,189,98,91
Rainz,aggramar,1574,shaman,restoration,42,22,20
Arkerus,emerald-dream,1573,shaman,restoration,36,22,14
Shamix,area-52,1573,shaman,restoration,84,39,45
Dawnyshock,arygos,1573,shaman,restoration,41,19,22
Draidosh,area-52,1572,shaman,restoration,89,53,36
Chlckenx,tichondrius,1572,shaman,restoration,111,54,57
Ivìxi,area-52,1571,shaman,restoration,64,30,34
Sikotics,area-52,1568,shaman,restoration,111,58,53
Moosk,zuluhed,1567,shaman,restoration,51,27,24
Zuralah,nemesis,1566,shaman,restoration,160,85,75
Dduddaddu,tichondrius,1565,shaman,restoration,72,37,35
Halfinha,nemesis,1564,shaman,restoration,247,127,120
Nyf,khazgoroth,1564,shaman,restoration,54,24,30
Spurske,emerald-dream,1564,shaman,restoration,78,32,46
Muruaic,dentarg,1563,shaman,restoration,142,75,67
Bigdampurge,illidan,1563,shaman,restoration,95,49,46
Hwyl,frostmourne,1563,shaman,restoration,96,45,51
Waater,lightbringer,1562,shaman,restoration,86,49,37
Wilmar,ragnaros,1560,shaman,restoration,66,33,33
Stonetides,tichondrius,1560,shaman,restoration,78,33,45
Dogecoincäsh,sargeras,1559,shaman,restoration,66,36,30
Shulace,area-52,1558,shaman,restoration,78,38,40
Rulf,proudmoore,1558,shaman,restoration,90,34,56
Vzla,ragnaros,1555,shaman,restoration,96,54,42
Kayadee,stormrage,1554,shaman,restoration,75,37,38
Goatedsham,dalaran,1553,shaman,restoration,65,36,29
Eatmymeatbal,illidan,1551,shaman,restoration,65,26,39
Pherolex,tichondrius,1550,shaman,restoration,42,23,19
Hexxercise,area-52,1549,shaman,restoration,65,46,19
Goosha,tichondrius,1548,shaman,restoration,48,33,15
Lanzero,chogall,1547,shaman,restoration,42,30,12
Lustlolol,korgath,1547,shaman,restoration,167,86,81
Mistarklean,malganis,1546,shaman,restoration,117,52,65
Fujiyama,dark-iron,1545,shaman,restoration,135,70,65
Deathwards,frostmane,1544,shaman,restoration,60,26,34
Hennytides,zuljin,1543,shaman,restoration,42,22,20
Trouvaille,tichondrius,1543,shaman,restoration,47,23,24
Tyar,area-52,1543,shaman,restoration,137,64,73
Shaminham,barthilas,1543,shaman,restoration,72,31,41
Shakrakhan,tichondrius,1542,shaman,restoration,36,17,19
Pedren,thrall,1541,shaman,restoration,33,25,8
Shamxrob,sargeras,1541,shaman,restoration,78,46,32
Tenyks,tichondrius,1537,shaman,restoration,75,42,33
Brongar,bleeding-hollow,1537,shaman,restoration,107,45,62
Wolfsokar,emerald-dream,1537,shaman,restoration,102,39,63
Akubai,kelthuzad,1535,shaman,restoration,78,39,39
Girthquake,agamaggan,1535,shaman,restoration,48,20,28
Fwwrs,illidan,1534,shaman,restoration,31,19,12
Tides,skullcrusher,1533,shaman,restoration,42,18,24
Dbmx,tichondrius,1532,shaman,restoration,30,16,14
Kacham,nerzhul,1530,shaman,restoration,36,20,16
Rookieshaman,tichondrius,1528,shaman,restoration,24,16,8
Oldguy,ragnaros,1526,shaman,restoration,227,114,113
Kaytahn,proudmoore,1525,shaman,restoration,72,39,33
Totesmcgoatz,arthas,1525,shaman,restoration,69,34,35
Chacham,tichondrius,1524,shaman,restoration,91,49,42
Repang,tichondrius,1523,shaman,restoration,36,19,17
Vexxs,shadowmoon,1522,shaman,restoration,30,16,14
Redek,sargeras,1521,shaman,restoration,226,121,105
Riptideafk,sargeras,1521,shaman,restoration,66,34,32
Moocatpie,illidan,1521,shaman,restoration,124,60,64
Rocyt,sargeras,1520,shaman,restoration,66,35,31
Luxiaa,tichondrius,1520,shaman,restoration,59,22,37
Aleforj,quelthalas,1519,shaman,restoration,55,27,28
Rsdyxjh,tichondrius,1519,shaman,restoration,51,22,29
Glocksitotem,malganis,1517,shaman,restoration,140,80,60
Fenrirfuryy,tichondrius,1514,shaman,restoration,54,25,29
Reuxxe,area-52,1513,shaman,restoration,224,115,109
Stylebenderx,frostmourne,1512,shaman,restoration,30,16,14
Spongemama,tichondrius,1511,shaman,restoration,82,41,41
Freesolo,barthilas,1510,shaman,restoration,200,102,98
Bluedynamite,tichondrius,1510,shaman,restoration,66,32,34
Dogood,tichondrius,1510,shaman,restoration,60,27,33
Allcatraz,zuljin,1510,shaman,restoration,58,26,32
Dadauera,azralon,1509,shaman,restoration,30,16,14
Fuzbo,bleeding-hollow,1509,shaman,restoration,47,25,22
Sellmysoul,kelthuzad,1509,shaman,restoration,87,43,44
Bighaircut,darkspear,1509,shaman,restoration,120,55,65
Shamansrock,tichondrius,1509,shaman,restoration,36,16,20
Joltik,area-52,1508,shaman,restoration,225,112,113
Plâto,stormrage,1507,shaman,restoration,30,16,14
Cultsulyvahn,tichondrius,1507,shaman,restoration,73,37,36
Trapghost,cenarius,1506,shaman,restoration,87,41,46
Shamankïng,proudmoore,1505,shaman,restoration,89,46,43
ßread,illidan,1505,shaman,restoration,133,62,71
Purgedubx,tichondrius,1504,shaman,restoration,196,104,92
Pawbed,aegwynn,1503,shaman,restoration,117,64,53
Cokehealsx,tichondrius,1503,shaman,restoration,30,16,14
Agharn,moon-guard,1503,shaman,restoration,51,26,25
Mutaishammy,barthilas,1503,shaman,restoration,96,48,48
Papatreb,haomarush,1503,shaman,restoration,78,39,39
Ballistíc,boulderfist,1502,shaman,restoration,66,38,28
Sphaerus,tichondrius,1501,shaman,restoration,54,30,24
Orkshammy,illidan,1500,shaman,restoration,40,25,15
Ekuku,tichondrius,1498,shaman,restoration,58,33,25
Ban,blackrock,1498,shaman,restoration,39,21,18
Lengin,bleeding-hollow,1497,shaman,restoration,36,21,15
Sbrinz,thrall,1497,shaman,restoration,36,19,17
Choochette,illidan,1497,shaman,restoration,144,67,77
Elementàlius,quelthalas,1497,shaman,restoration,71,32,39
Hruggol,bleeding-hollow,1496,shaman,restoration,90,46,44
Szeav,tichondrius,1496,shaman,restoration,66,33,33
Scamgame,tichondrius,1495,shaman,restoration,30,22,8
Isekai,alterac-mountains,1495,shaman,restoration,90,42,48
Shockszz,onyxia,1494,shaman,restoration,143,69,74
Quakess,zuljin,1494,shaman,restoration,66,28,38
Reformeddogs,tichondrius,1492,shaman,restoration,63,36,27
Køtømine,ragnaros,1491,shaman,restoration,106,67,39
Ärtful,illidan,1491,shaman,restoration,102,55,47
Bwinthewomb,stormrage,1491,shaman,restoration,148,77,71
Vanklayser,ragnaros,1491,shaman,restoration,108,54,54
Mentyb,emerald-dream,1491,shaman,restoration,42,16,26
Zombaschamy,ragnaros,1490,shaman,restoration,30,17,13
Flamehorns,malganis,1490,shaman,restoration,83,44,39
Thunderphury,proudmoore,1490,shaman,restoration,119,53,66
Koomrog,frostmourne,1489,shaman,restoration,32,21,11
Mkyz,tichondrius,1488,shaman,restoration,103,54,49
Hoboman,chogall,1488,shaman,restoration,42,17,25
Hyonkh,tichondrius,1487,shaman,restoration,77,45,32
Yarl,ragnaros,1487,shaman,restoration,42,24,18
Phrophetzee,altar-of-storms,1487,shaman,restoration,51,23,28
Kaaying,tichondrius,1487,shaman,restoration,43,17,26
Jaegertotem,stormrage,1486,shaman,restoration,42,21,21
Damoclez,jubeithos,1486,shaman,restoration,57,23,34
Boryndor,stormrage,1484,shaman,restoration,42,23,19
Jizzlewizwiz,tichondrius,1484,shaman,restoration,181,89,92
Sittinn,malganis,1484,shaman,restoration,78,37,41
Slowpo,illidan,1484,shaman,restoration,47,16,31
Worldx,barthilas,1483,shaman,restoration,162,79,83
Trenhance,stormrage,1481,shaman,restoration,30,23,7
Krewesham,uldaman,1481,shaman,restoration,28,17,11
Abellone,tichondrius,1480,shaman,restoration,33,17,16
Elementols,azralon,1480,shaman,restoration,48,23,25
Hachikø,frostmourne,1480,shaman,restoration,95,44,51
Vazlah,tichondrius,1479,shaman,restoration,24,16,8
Rekashaki,illidan,1479,shaman,restoration,36,19,17
Velesa,kiljaeden,1479,shaman,restoration,54,20,34
Mlpz,black-dragonflight,1478,shaman,restoration,84,47,37
Rumkin,malganis,1478,shaman,restoration,106,58,48
Wuruizec,illidan,1478,shaman,restoration,65,32,33
Boohaha,khadgar,1478,shaman,restoration,35,16,19
Umadilia,area-52,1477,shaman,restoration,32,21,11
Ryukims,tichondrius,1477,shaman,restoration,35,17,18
Miroen,tichondrius,1477,shaman,restoration,146,70,76
Sistronok,bleeding-hollow,1476,shaman,restoration,30,16,14
Ellgric,emerald-dream,1476,shaman,restoration,48,21,27
Defac,proudmoore,1475,shaman,restoration,72,42,30
Maxchungie,azshara,1475,shaman,restoration,30,16,14
Angelabaaby,proudmoore,1475,shaman,restoration,60,28,32
Bakayarøu,tichondrius,1475,shaman,restoration,36,16,20
Yossarabi,bleeding-hollow,1475,shaman,restoration,54,23,31
Vewdew,guldan,1473,shaman,restoration,78,47,31
Unchaman,ragnaros,1472,shaman,restoration,157,78,79
Brainal,sargeras,1472,shaman,restoration,60,25,35
Gluestix,bleeding-hollow,1471,shaman,restoration,43,26,17
Upholderxo,shadowmoon,1471,shaman,restoration,48,25,23
Pissticles,bleeding-hollow,1471,shaman,restoration,150,75,75
Heebeegeebee,stormrage,1470,shaman,restoration,51,31,20
Erthshawk,wildhammer,1470,shaman,restoration,84,44,40
Sàuron,tichondrius,1467,shaman,restoration,180,100,80
Krilick,blackrock,1467,shaman,restoration,107,57,50
Keenie,shadow-council,1467,shaman,restoration,35,17,18
Gangzmmsk,tichondrius,1466,shaman,restoration,24,18,6
Philbert,boulderfist,1466,shaman,restoration,54,31,23
Whoshealing,lightninghoof,1466,shaman,restoration,114,59,55
Stylesp,area-52,1465,shaman,restoration,131,63,68
Springtide,thrall,1464,shaman,restoration,83,43,40
Kandin,icecrown,1462,shaman,restoration,94,51,43
Xiwg,tichondrius,1462,shaman,restoration,72,31,41
Gattious,illidan,1461,shaman,restoration,72,35,37
Hirah,frostmourne,1460,shaman,restoration,23,16,7
Sarkhanvol,aggramar,1460,shaman,restoration,42,27,15
Smartakkar,emerald-dream,1460,shaman,restoration,57,36,21
Thegil,tichondrius,1460,shaman,restoration,102,47,55
Benta,zuljin,1459,shaman,restoration,72,36,36
Nilstorm,quelthalas,1458,shaman,restoration,72,38,34
Graveman,illidan,1457,shaman,restoration,142,79,63
Kwzy,stormrage,1457,shaman,restoration,51,26,25
Pickledegg,tichondrius,1456,shaman,restoration,51,27,24
Teerex,tortheldrin,1456,shaman,restoration,75,38,37
Tizz,quelthalas,1456,shaman,restoration,112,54,58
Draüguss,azralon,1456,shaman,restoration,155,74,81
Freakytiki,azshara,1455,shaman,restoration,52,34,18
Furrytotems,darkspear,1455,shaman,restoration,126,56,70
Trewlolz,sargeras,1454,shaman,restoration,48,24,24
Juicypork,moon-guard,1453,shaman,restoration,44,24,20
Ironcrag,moon-guard,1453,shaman,restoration,259,134,125
Rinnan,malganis,1453,shaman,restoration,103,48,55
Skelesham,zuljin,1452,shaman,restoration,48,33,15
Crittingbull,veknilash,1452,shaman,restoration,214,111,103
Carltonbanks,aggramar,1452,shaman,restoration,36,18,18
Splonkydonky,stonemaul,1450,shaman,restoration,30,18,12
Tidalstorm,ragnaros,1450,shaman,restoration,90,52,38
Pamaj,kelthuzad,1450,shaman,restoration,99,44,55
Jwondo,area-52,1450,shaman,restoration,56,23,33
Mäjorlazer,lightbringer,1449,shaman,restoration,38,19,19
Buffduude,shadowsong,1449,shaman,restoration,48,22,26
Aguinha,azralon,1448,shaman,restoration,78,38,40
Flubydont,icecrown,1448,shaman,restoration,96,44,52
Blowurbubble,tichondrius,1447,shaman,restoration,42,24,18
Anußis,stormrage,1447,shaman,restoration,65,25,40
Circuits,malganis,1446,shaman,restoration,58,30,28
Maakasarg,tichondrius,1445,shaman,restoration,54,24,30
Rommel,azralon,1444,shaman,restoration,57,32,25
Midew,proudmoore,1443,shaman,restoration,45,22,23
Elementorx,stormrage,1443,shaman,restoration,80,38,42
Milkkshake,illidan,1443,shaman,restoration,256,119,137
Boozi,sargeras,1442,shaman,restoration,48,24,24
Alexustexas,tichondrius,1441,shaman,restoration,90,50,40
Wumx,tichondrius,1441,shaman,restoration,54,22,32
Wuargh,area-52,1440,shaman,restoration,220,118,102
Badjojò,ragnaros,1439,shaman,restoration,30,15,15
Breadx,khaz-modan,1439,shaman,restoration,30,15,15
Praxis,tichondrius,1437,shaman,restoration,154,79,75
Miketheseal,bleeding-hollow,1437,shaman,restoration,36,15,21
Jhakrï,tichondrius,1437,shaman,restoration,36,15,21
Owtyobwol,area-52,1436,shaman,restoration,24,15,9
Creatine,area-52,1436,shaman,restoration,71,37,34
Fluiid,tichondrius,1435,shaman,restoration,30,15,15
Jimmymaclroy,frostmourne,1435,shaman,restoration,114,56,58
Dawny,arygos,1435,shaman,restoration,36,15,21
Wardruna,andorhal,1434,shaman,restoration,24,15,9
Ãrthor,stormrage,1434,shaman,restoration,78,42,36
Klimax,tichondrius,1433,shaman,restoration,36,18,18
Geser,silvermoon,1432,shaman,restoration,44,26,18
Haard,area-52,1432,shaman,restoration,30,15,15
Thormør,tichondrius,1432,shaman,restoration,31,15,16
Zaxxrie,sargeras,1432,shaman,restoration,69,26,43
Shamjam,moon-guard,1431,shaman,restoration,24,15,9
Buffdestru,azralon,1431,shaman,restoration,116,66,50
Bluebones,frostmane,1431,shaman,restoration,30,17,13
Insertyzs,azralon,1431,shaman,restoration,66,36,30
Kabasan,illidan,1431,shaman,restoration,60,27,33
Totem,burning-legion,1431,shaman,restoration,36,16,20
Hugebrain,proudmoore,1431,shaman,restoration,124,50,74
Fatherrtime,illidan,1430,shaman,restoration,48,26,22
Galeswind,sargeras,1430,shaman,restoration,72,36,36
Joeschhmoe,tichondrius,1430,shaman,restoration,42,20,22
Totembarx,illidan,1428,shaman,restoration,42,29,13
Grimtar,burning-blade,1428,shaman,restoration,24,16,8
Savs,tichondrius,1428,shaman,restoration,24,15,9
Santiagodx,ragnaros,1427,shaman,restoration,277,135,142
Harbert,black-dragonflight,1426,shaman,restoration,199,105,94
Macdab,malganis,1425,shaman,restoration,42,23,19
Arkuldash,tichondrius,1425,shaman,restoration,54,27,27
Torric,kalecgos,1424,shaman,restoration,66,31,35
Kelta,kelthuzad,1423,shaman,restoration,30,15,15
Atorinà,tichondrius,1423,shaman,restoration,30,15,15
Idowhatcdont,kelthuzad,1421,shaman,restoration,24,15,9
Kephax,eonar,1421,shaman,restoration,123,62,61
Boonno,tichondrius,1421,shaman,restoration,36,15,21
Samanl,tichondrius,1420,shaman,restoration,77,44,33
Nanishock,area-52,1420,shaman,restoration,57,30,27
Cinematticz,tichondrius,1420,shaman,restoration,101,51,50
Pýe,bleeding-hollow,1420,shaman,restoration,42,21,21
Mcshocks,area-52,1419,shaman,restoration,66,37,29
Slothstorm,barthilas,1419,shaman,restoration,59,31,28
Pümba,azralon,1419,shaman,restoration,30,15,15
Azumaa,tichondrius,1419,shaman,restoration,233,112,121
Blaydin,elune,1416,shaman,restoration,24,15,9
Tundertotem,tichondrius,1414,shaman,restoration,80,46,34
Djshammy,barthilas,1414,shaman,restoration,80,42,38
Lunds,tichondrius,1414,shaman,restoration,30,15,15
Vajoku,proudmoore,1414,shaman,restoration,48,22,26
Massif,emerald-dream,1414,shaman,restoration,37,16,21
Bearmanshrek,tichondrius,1414,shaman,restoration,72,26,46
Subnôize,bleeding-hollow,1412,shaman,restoration,129,71,58
Tawahka,hyjal,1412,shaman,restoration,179,87,92
Silhoustes,ragnaros,1411,shaman,restoration,24,15,9
Voluptuous,mannoroth,1411,shaman,restoration,549,277,272
Enflexi,lightbringer,1411,shaman,restoration,53,26,27
Orkwa,bleeding-hollow,1410,shaman,restoration,68,32,36
Otem,frostmourne,1410,shaman,restoration,50,23,27
Goatpornbad,sargeras,1410,shaman,restoration,108,48,60
Catchclause,eonar,1409,shaman,restoration,30,15,15
Meshugga,scarlet-crusade,1409,shaman,restoration,48,23,25
Farö,azralon,1409,shaman,restoration,47,18,29
Xaltas,moon-guard,1407,shaman,restoration,52,33,19
Kaili,illidan,1407,shaman,restoration,63,37,26
Elenix,area-52,1406,shaman,restoration,42,22,20
Odïn,tichondrius,1405,shaman,restoration,53,27,26
Uwuxdlol,tichondrius,1404,shaman,restoration,35,20,15
Sindury,tichondrius,1404,shaman,restoration,216,120,96
Shamfold,illidan,1404,shaman,restoration,30,15,15
Zizö,barthilas,1404,shaman,restoration,42,19,23
Performix,sargeras,1404,shaman,restoration,36,15,21
Ryùko,proudmoore,1404,shaman,restoration,78,30,48
Yamazakì,nemesis,1404,shaman,restoration,51,19,32
Meanbetty,illidan,1403,shaman,restoration,30,17,13
Elex,frostmourne,1403,shaman,restoration,93,41,52
Supdaug,vashj,1402,shaman,restoration,66,32,34
Sploosh,norgannon,1401,shaman,restoration,36,20,16
Reignz,moonrunner,1401,shaman,restoration,45,24,21
Bluetooth,stormrage,1401,shaman,restoration,89,39,50
Graymatterz,ysondre,1399,shaman,restoration,72,34,38
Totemhype,tichondrius,1398,shaman,restoration,74,41,33
Wazskood,stormrage,1398,shaman,restoration,137,66,71
Jfrzd,tichondrius,1397,shaman,restoration,31,21,10
Shaquillius,tichondrius,1397,shaman,restoration,72,35,37
Totemgoddess,nemesis,1397,shaman,restoration,66,30,36
Xdxs,norgannon,1397,shaman,restoration,36,16,20
Drinkharder,stormrage,1395,shaman,restoration,34,16,18
Arginine,tichondrius,1395,shaman,restoration,42,15,27
Curador,nemesis,1394,shaman,restoration,39,24,15
Aceshamm,kelthuzad,1394,shaman,restoration,90,49,41
Jakjohnson,stormrage,1393,shaman,restoration,33,18,15
Kakiscala,proudmoore,1393,shaman,restoration,30,16,14
ßøvîn,thrall,1393,shaman,restoration,71,36,35
Siyusm,illidan,1393,shaman,restoration,72,25,47
Eggrollninja,illidan,1392,shaman,restoration,24,17,7
Mikeyodinson,area-52,1392,shaman,restoration,41,20,21
Windfrenzy,thrall,1392,shaman,restoration,36,15,21
Largeshaman,zuljin,1391,shaman,restoration,30,15,15
Rizam,malganis,1389,shaman,restoration,42,33,9
Kirawindu,zuljin,1387,shaman,restoration,69,39,30
Udungoofedd,the-underbog,1387,shaman,restoration,42,23,19
Halloweenz,area-52,1387,shaman,restoration,30,16,14
Cowtidetotem,thrall,1387,shaman,restoration,36,19,17
Charmize,azralon,1387,shaman,restoration,103,54,49
Woodrose,frostmourne,1387,shaman,restoration,94,46,48
Killercam,maiev,1387,shaman,restoration,282,135,147
Soowecide,tichondrius,1387,shaman,restoration,60,23,37
Rykku,illidan,1386,shaman,restoration,30,16,14
Shazik,spirestone,1386,shaman,restoration,54,21,33
Jodalo,ragnaros,1385,shaman,restoration,173,92,81
Fungus,firetree,1384,shaman,restoration,48,26,22
Windpowa,blackrock,1384,shaman,restoration,42,19,23
Fishman,exodar,1382,shaman,restoration,101,45,56
Spiritwler,tichondrius,1381,shaman,restoration,42,20,22
Çruces,illidan,1381,shaman,restoration,36,17,19
Siggmaster,chogall,1381,shaman,restoration,48,19,29
Indesham,drenden,1380,shaman,restoration,34,17,17
Lanuur,moon-guard,1379,shaman,restoration,54,31,23
Nyathera,barthilas,1378,shaman,restoration,90,50,40
Ottoman,eredar,1378,shaman,restoration,75,32,43
Leca,tichondrius,1378,shaman,restoration,90,38,52
Destrino,area-52,1377,shaman,restoration,48,23,25
Darado,kiljaeden,1377,shaman,restoration,45,20,25
Hannamayzing,arathor,1377,shaman,restoration,36,16,20
Libragirl,tichondrius,1375,shaman,restoration,148,75,73
Psiexrcst,tichondrius,1375,shaman,restoration,72,29,43
Ahaw,area-52,1374,shaman,restoration,78,47,31
Roxzid,area-52,1374,shaman,restoration,57,33,24
Jensenx,proudmoore,1374,shaman,restoration,82,38,44
Shamicare,stormrage,1373,shaman,restoration,142,79,63
Bitxxnumber,tichondrius,1372,shaman,restoration,287,151,136
Earthsrage,illidan,1372,shaman,restoration,42,22,20
Cameltótém,sargeras,1372,shaman,restoration,48,25,23
Desgarcon,zuljin,1370,shaman,restoration,119,64,55
Blackoutsx,stormreaver,1369,shaman,restoration,28,15,13
Gromgrai,bleeding-hollow,1368,shaman,restoration,53,30,23
Shamito,ragnaros,1368,shaman,restoration,51,24,27
Treasonreno,area-52,1368,shaman,restoration,108,47,61
Thenextcdew,illidan,1367,shaman,restoration,48,26,22
Záheer,arthas,1367,shaman,restoration,77,38,39
Onlytidez,area-52,1367,shaman,restoration,77,35,42
Bazinguinha,azralon,1366,shaman,restoration,88,42,46
Thunderborn,laughing-skull,1366,shaman,restoration,36,16,20
Aargonos,tichondrius,1365,shaman,restoration,29,23,6
Sheared,area-52,1365,shaman,restoration,66,34,32
Krevsham,proudmoore,1364,shaman,restoration,56,23,33
Ralinta,tichondrius,1364,shaman,restoration,77,27,50
Kunchan,zuluhed,1362,shaman,restoration,24,16,8
Edhance,area-52,1362,shaman,restoration,119,66,53
Wyått,emerald-dream,1359,shaman,restoration,95,43,52
Djbs,stormrage,1358,shaman,restoration,77,32,45
Karmatide,malganis,1357,shaman,restoration,36,24,12
Kiojin,ragnaros,1357,shaman,restoration,186,99,87
Wagesisdeath,illidan,1357,shaman,restoration,36,17,19
Ndz,anubarak,1356,shaman,restoration,72,41,31
Tamzlol,the-forgotten-coast,1356,shaman,restoration,35,15,20
Wooskier,tichondrius,1355,shaman,restoration,60,32,28
Elementgodx,skullcrusher,1354,shaman,restoration,54,27,27
Urin,emerald-dream,1354,shaman,restoration,39,17,22
Hamshamwitch,shadowmoon,1353,shaman,restoration,36,17,19
Atnaz,drakkari,1352,shaman,restoration,42,24,18
Tumble,frostmourne,1352,shaman,restoration,105,51,54
Amperage,spirestone,1352,shaman,restoration,70,33,37
Asskrap,daggerspine,1350,shaman,restoration,46,25,21
Chandye,proudmoore,1348,shaman,restoration,72,27,45
Daddyk,gnomeregan,1347,shaman,restoration,53,30,23
Greenenergy,tichondrius,1346,shaman,restoration,60,32,28
Balsonz,zuljin,1346,shaman,restoration,30,16,14
Lleonardo,tichondrius,1346,shaman,restoration,54,24,30
Imaspirit,malganis,1346,shaman,restoration,60,25,35
Lildunny,tichondrius,1346,shaman,restoration,36,15,21
Zuljiba,illidan,1345,shaman,restoration,66,39,27
Fàrrò,thrall,1345,shaman,restoration,66,39,27
Cethun,amanthul,1345,shaman,restoration,67,32,35
Xajsham,tichondrius,1344,shaman,restoration,102,54,48
Kultirio,quelthalas,1344,shaman,restoration,61,32,29
Elemen,quelthalas,1344,shaman,restoration,97,48,49
Smniss,tichondrius,1344,shaman,restoration,49,23,26
Zinns,dalaran,1344,shaman,restoration,105,49,56
Orochishaman,stormrage,1343,shaman,restoration,24,14,10
Quequin,quelthalas,1343,shaman,restoration,42,21,21
Touchmytotmm,tichondrius,1342,shaman,restoration,24,14,10
Dwârf,tichondrius,1342,shaman,restoration,24,14,10
Weathersmell,sargeras,1341,shaman,restoration,24,14,10
Crazytotems,dalaran,1341,shaman,restoration,138,71,67
Juvîa,emerald-dream,1341,shaman,restoration,91,38,53
Shockpanda,zuljin,1340,shaman,restoration,18,14,4
Fallhazard,malganis,1340,shaman,restoration,40,24,16
Mudlùst,moon-guard,1339,shaman,restoration,77,40,37
Kachupinsito,ragnaros,1339,shaman,restoration,91,45,46
Uhd,malganis,1339,shaman,restoration,44,21,23
Rzzn,sargeras,1338,shaman,restoration,24,14,10
Shockbot,stormscale,1338,shaman,restoration,67,30,37
Foray,barthilas,1337,shaman,restoration,60,34,26
Furiousnick,stormrage,1337,shaman,restoration,31,15,16
Nagiska,ragnaros,1337,shaman,restoration,34,16,18
Shamkack,kelthuzad,1337,shaman,restoration,89,41,48
Enemyanemone,area-52,1336,shaman,restoration,24,14,10
Earthentotem,tichondrius,1336,shaman,restoration,24,14,10
Orbys,illidan,1335,shaman,restoration,24,14,10
Tayictwo,tichondrius,1335,shaman,restoration,30,14,16
Fläkky,tichondrius,1334,shaman,restoration,30,18,12
Satrixss,ragnaros,1334,shaman,restoration,79,44,35
Aseew,drakkari,1334,shaman,restoration,66,31,35
Woof,agamaggan,1334,shaman,restoration,47,16,31
Nagumi,ragnaros,1333,shaman,restoration,24,16,8
Nerfmytotemz,frostmourne,1333,shaman,restoration,30,14,16
Joyrider,sargeras,1332,shaman,restoration,54,28,26
Totemrack,tichondrius,1332,shaman,restoration,64,32,32
Alátreon,azralon,1332,shaman,restoration,66,30,36
Mudtide,tichondrius,1331,shaman,restoration,72,42,30
Ixis,bleeding-hollow,1331,shaman,restoration,24,14,10
Mengemort,crushridge,1331,shaman,restoration,69,38,31
Lurue,tichondrius,1331,shaman,restoration,42,21,21
Edisto,darkspear,1331,shaman,restoration,30,14,16
Getco,tichondrius,1330,shaman,restoration,42,18,24
Tampíco,ragnaros,1330,shaman,restoration,36,14,22
Joriko,magtheridon,1330,shaman,restoration,36,14,22
Exussh,tichondrius,1329,shaman,restoration,18,15,3
Eccentrix,mannoroth,1329,shaman,restoration,36,14,22
Angron,barthilas,1328,shaman,restoration,34,21,13
Elmoss,thrall,1328,shaman,restoration,36,14,22
Huroth,proudmoore,1328,shaman,restoration,42,14,28
Shimansham,aegwynn,1327,shaman,restoration,235,116,119
Vibration,akama,1326,shaman,restoration,153,80,73
Barbosina,stormrage,1326,shaman,restoration,226,116,110
Azhen,ragnaros,1326,shaman,restoration,138,69,69
Tchaishammy,tichondrius,1326,shaman,restoration,29,14,15
Noobcrits,tichondrius,1325,shaman,restoration,48,27,21
Meatballer,queldorei,1325,shaman,restoration,83,45,38
Ginkuma,illidan,1325,shaman,restoration,30,14,16
Afgoox,tichondrius,1324,shaman,restoration,84,47,37
Klausnomi,jaedenar,1324,shaman,restoration,48,21,27
Oriyani,sargeras,1323,shaman,restoration,30,14,16
Fedinho,azralon,1322,shaman,restoration,30,19,11
Orcaninja,zuljin,1322,shaman,restoration,28,15,13
Restosud,crushridge,1320,shaman,restoration,30,18,12
Ondra,frostmourne,1320,shaman,restoration,48,24,24
Kisimi,proudmoore,1319,shaman,restoration,30,18,12
Cleanfossil,stormrage,1319,shaman,restoration,41,24,17
Bearlysober,draka,1319,shaman,restoration,68,37,31
Boggins,dalaran,1318,shaman,restoration,52,25,27
Clutchinbuds,malganis,1318,shaman,restoration,54,24,30
Badião,azralon,1318,shaman,restoration,131,58,73
Latosos,dalaran,1317,shaman,restoration,36,15,21
Tidalchief,dalaran,1316,shaman,restoration,58,40,18
Aemi,tichondrius,1316,shaman,restoration,120,57,63
Roostershama,tichondrius,1316,shaman,restoration,115,50,65
Phtalid,dalaran,1314,shaman,restoration,88,45,43
Beardcramps,tichondrius,1314,shaman,restoration,84,42,42
Schav,stormrage,1313,shaman,restoration,33,19,14
Raikages,whisperwind,1312,shaman,restoration,48,22,26
Darrann,kiljaeden,1311,shaman,restoration,30,20,10
Goub,skullcrusher,1310,shaman,restoration,24,14,10
Ithappens,senjin,1310,shaman,restoration,30,16,14
Prøduce,tichondrius,1310,shaman,restoration,66,34,32
Orlá,moon-guard,1310,shaman,restoration,54,18,36
Kazino,stormrage,1309,shaman,restoration,28,18,10
Yeetle,gorefiend,1309,shaman,restoration,52,27,25
Sharmut,bleeding-hollow,1309,shaman,restoration,136,68,68
Hefestos,nemesis,1309,shaman,restoration,30,14,16
Absorblife,barthilas,1309,shaman,restoration,69,31,38
Mooshi,exodar,1309,shaman,restoration,69,27,42
Brosidan,anvilmar,1308,shaman,restoration,62,38,24
Medzoe,tichondrius,1307,shaman,restoration,28,15,13
Sukthistotem,kelthuzad,1306,shaman,restoration,30,20,10
Fencepost,bleeding-hollow,1306,shaman,restoration,114,61,53
Cónò,tichondrius,1306,shaman,restoration,108,52,56
Toteapole,malganis,1305,shaman,restoration,94,51,43
Torgah,tichondrius,1305,shaman,restoration,90,44,46
Fíxer,tichondrius,1304,shaman,restoration,85,44,41
Solaraa,proudmoore,1304,shaman,restoration,64,31,33
Genjuu,proudmoore,1304,shaman,restoration,42,20,22
Hüsky,dalaran,1303,shaman,restoration,42,14,28
Babytiramisu,stormrage,1302,shaman,restoration,46,24,22
Tumble,barthilas,1302,shaman,restoration,52,26,26
Badgeshock,area-52,1301,shaman,restoration,108,48,60
Cæl,azralon,1300,shaman,restoration,35,20,15
Tedmosbe,tichondrius,1300,shaman,restoration,84,37,47
Tartar,lightbringer,1299,shaman,restoration,99,60,39
Pushaheal,tichondrius,1299,shaman,restoration,54,31,23
Enalen,argent-dawn,1299,shaman,restoration,61,35,26
Teardrinker,korgath,1299,shaman,restoration,94,46,48
Yarockheal,malganis,1298,shaman,restoration,54,27,27
Bigtoy,frostmane,1296,shaman,restoration,42,14,28
Tequíla,quelthalas,1295,shaman,restoration,24,14,10
Krishshammy,azshara,1295,shaman,restoration,171,86,85
Sòlemn,burning-legion,1295,shaman,restoration,61,22,39
Qitian,tichondrius,1294,shaman,restoration,36,14,22
Defnotheals,kelthuzad,1293,shaman,restoration,90,42,48
Dewstorm,tichondrius,1293,shaman,restoration,41,18,23
Jetstream,shadow-council,1293,shaman,restoration,42,16,26
Izarmona,bleeding-hollow,1292,shaman,restoration,24,15,9
Valst,kiljaeden,1292,shaman,restoration,69,33,36
Slaggdaddy,durotan,1292,shaman,restoration,30,14,16
Murata,tichondrius,1291,shaman,restoration,30,16,14
Totemist,tichondrius,1291,shaman,restoration,54,23,31
Aviator,muradin,1288,shaman,restoration,36,19,17
Problamatic,tichondrius,1288,shaman,restoration,30,14,16
Belgrom,tichondrius,1287,shaman,restoration,42,23,19
Tacho,bleeding-hollow,1287,shaman,restoration,114,56,58
Zetli,tichondrius,1287,shaman,restoration,72,30,42
Twinkolava,nemesis,1286,shaman,restoration,37,23,14
Drazic,area-52,1286,shaman,restoration,49,28,21
Mynigabob,zuljin,1285,shaman,restoration,148,83,65
Uhfishuhl,bleeding-hollow,1285,shaman,restoration,30,16,14
Shamorrhoids,frostmourne,1285,shaman,restoration,137,70,67
Nezzuk,quelthalas,1285,shaman,restoration,96,42,54
Lollzerz,the-forgotten-coast,1285,shaman,restoration,42,16,26
Turblix,tichondrius,1284,shaman,restoration,69,44,25
Ketaminedrip,illidan,1284,shaman,restoration,42,22,20
Stargun,korgath,1284,shaman,restoration,147,76,71
Shämwow,agamaggan,1284,shaman,restoration,838,417,421
Feldstar,stormrage,1284,shaman,restoration,103,47,56
Sparks,ragnaros,1284,shaman,restoration,95,43,52
Strohz,undermine,1282,shaman,restoration,42,21,21
Tym,sargeras,1281,shaman,restoration,42,22,20
Karrydoskftw,ragnaros,1281,shaman,restoration,151,74,77
Alraxion,ragnaros,1281,shaman,restoration,84,41,43
Jabjor,malganis,1281,shaman,restoration,66,25,41
Ulala,azshara,1280,shaman,restoration,72,31,41
Hasselshock,area-52,1280,shaman,restoration,94,40,54
Mudeng,tichondrius,1276,shaman,restoration,60,30,30
Eekumbokum,bleeding-hollow,1275,shaman,restoration,74,39,35
Wunderwaffe,the-underbog,1274,shaman,restoration,102,48,54
Surgedarknes,sargeras,1273,shaman,restoration,27,15,12
Trúnks,magtheridon,1273,shaman,restoration,102,48,54
Retgarr,tichondrius,1272,shaman,restoration,30,17,13
Foodlust,sargeras,1272,shaman,restoration,108,57,51
Tákhisis,darkspear,1271,shaman,restoration,72,33,39
Zugpug,emerald-dream,1271,shaman,restoration,36,14,22
Mythshaman,tichondrius,1270,shaman,restoration,81,33,48
Angelicrain,stormrage,1269,shaman,restoration,30,16,14
Twoflower,frostmourne,1269,shaman,restoration,200,100,100
Derkx,thrall,1268,shaman,restoration,30,22,8
Thomastides,tichondrius,1268,shaman,restoration,78,36,42
Ragerax,trollbane,1266,shaman,restoration,29,18,11
Killdeaderer,barthilas,1266,shaman,restoration,136,79,57
Kripnotik,nathrezim,1266,shaman,restoration,42,16,26
Rahkani,kiljaeden,1265,shaman,restoration,77,39,38
Joocer,emerald-dream,1265,shaman,restoration,102,48,54
Shiestys,tichondrius,1264,shaman,restoration,33,23,10
Shohzegky,azralon,1264,shaman,restoration,97,43,54
Dodirt,laughing-skull,1263,shaman,restoration,30,17,13
Kunio,proudmoore,1261,shaman,restoration,42,22,20
Taò,tichondrius,1261,shaman,restoration,138,65,73
Menah,moon-guard,1260,shaman,restoration,36,20,16
Chagun,illidan,1259,shaman,restoration,36,20,16
Shammimane,tichondrius,1259,shaman,restoration,185,95,90
Hateshifter,kul-tiras,1259,shaman,restoration,36,14,22
Hauby,zuljin,1259,shaman,restoration,48,15,33
Jru,tichondrius,1257,shaman,restoration,31,14,17
Abcmbx,illidan,1255,shaman,restoration,47,20,27
Hicys,azralon,1253,shaman,restoration,161,81,80
Tigrains,proudmoore,1252,shaman,restoration,29,15,14
Ironcaulk,kelthuzad,1252,shaman,restoration,54,26,28
Mòo,barthilas,1252,shaman,restoration,30,14,16
Luto,tichondrius,1251,shaman,restoration,130,71,59
Grandbunder,tichondrius,1251,shaman,restoration,30,14,16
Blodbar,kiljaeden,1249,shaman,restoration,36,24,12
Evilabev,bonechewer,1248,shaman,restoration,24,13,11
Toroph,azralon,1248,shaman,restoration,30,16,14
Jaandar,saurfang,1248,shaman,restoration,171,86,85
Bigwave,zuluhed,1248,shaman,restoration,30,15,15
Swinginwilly,barthilas,1248,shaman,restoration,36,14,22
Bubbert,illidan,1248,shaman,restoration,60,21,39
Tôôz,stormrage,1247,shaman,restoration,18,13,5
Kosiee,frostmourne,1247,shaman,restoration,24,13,11
Peanutto,illidan,1246,shaman,restoration,156,87,69
Graebrah,tichondrius,1246,shaman,restoration,24,13,11
Momolagbbit,tichondrius,1246,shaman,restoration,24,13,11
Crakmane,kelthuzad,1245,shaman,restoration,18,13,5
Tays,tichondrius,1245,shaman,restoration,18,13,5
Scape,emerald-dream,1244,shaman,restoration,18,13,5
Aelwydx,quelthalas,1244,shaman,restoration,287,145,142
Tonka,area-52,1244,shaman,restoration,30,13,17
Shoxx,wyrmrest-accord,1243,shaman,restoration,24,13,11
Orjamba,barthilas,1243,shaman,restoration,88,42,46
Zqshaman,tichondrius,1243,shaman,restoration,30,14,16
Jsoto,ghostlands,1243,shaman,restoration,30,13,17
Stackinheals,thrall,1243,shaman,restoration,42,15,27
Wastedlink,tichondrius,1242,shaman,restoration,24,13,11
Darkn,cenarion-circle,1242,shaman,restoration,36,18,18
Blueteam,blackrock,1242,shaman,restoration,30,13,17
Youarenothim,area-52,1241,shaman,restoration,18,13,5
Savjsh,illidan,1241,shaman,restoration,30,13,17
Chenguanxi,tichondrius,1240,shaman,restoration,18,13,5
Rocksbury,malganis,1240,shaman,restoration,24,13,11
Quady,zuljin,1240,shaman,restoration,24,13,11
Droni,emerald-dream,1240,shaman,restoration,30,16,14
Keekballx,tichondrius,1240,shaman,restoration,30,13,17
Nomediocur,moknathal,1240,shaman,restoration,61,24,37
Spekgawd,emerald-dream,1239,shaman,restoration,18,13,5
Rzul,tichondrius,1239,shaman,restoration,24,13,11
Jnzz,area-52,1239,shaman,restoration,24,13,11
Hearthx,perenolde,1239,shaman,restoration,30,13,17
Battleobobby,medivh,1239,shaman,restoration,41,13,28
Beefstocks,area-52,1238,shaman,restoration,66,32,34
Entropey,daggerspine,1238,shaman,restoration,65,28,37
Cheliz,thrall,1238,shaman,restoration,93,40,53
Lastdwarf,tichondrius,1237,shaman,restoration,18,13,5
Shamakazi,tichondrius,1237,shaman,restoration,31,14,17
Wugmuk,illidan,1236,shaman,restoration,149,73,76
Êdge,quelthalas,1235,shaman,restoration,69,33,36
Turtleinmud,frostmourne,1234,shaman,restoration,24,13,11
Zad,spinebreaker,1234,shaman,restoration,30,13,17
Krolii,tichondrius,1234,shaman,restoration,80,33,47
Kinjin,dragonmaw,1232,shaman,restoration,30,13,17
Kommotion,proudmoore,1232,shaman,restoration,36,13,23
Fênrisulfer,area-52,1231,shaman,restoration,89,37,52
Klaital,boulderfist,1230,shaman,restoration,36,22,14
Kikkóman,malganis,1230,shaman,restoration,48,25,23
Brislin,sargeras,1230,shaman,restoration,238,117,121
Kinshaman,lightnings-blade,1230,shaman,restoration,103,49,54
Peppito,illidan,1229,shaman,restoration,51,29,22
Edemental,area-52,1229,shaman,restoration,129,61,68
Lhost,tanaris,1228,shaman,restoration,30,17,13
Terdsammich,malganis,1227,shaman,restoration,51,27,24
Lüca,wyrmrest-accord,1226,shaman,restoration,357,187,170
Truemooin,wyrmrest-accord,1226,shaman,restoration,557,276,281
Bäsedgód,tichondrius,1225,shaman,restoration,30,13,17
Ozzai,ragnaros,1225,shaman,restoration,42,15,27
Mishalla,tichondrius,1224,shaman,restoration,72,27,45
Delíta,quelthalas,1222,shaman,restoration,71,28,43
Rétt,barthilas,1220,shaman,restoration,24,15,9
Hammerme,barthilas,1220,shaman,restoration,107,40,67
Dcãicer,quelthalas,1219,shaman,restoration,37,23,14
Hoong,garrosh,1219,shaman,restoration,32,17,15
Thizzasta,blackhand,1219,shaman,restoration,40,18,22
Keiox,ragnaros,1218,shaman,restoration,24,13,11
Yamishka,dalaran,1218,shaman,restoration,66,29,37
Donmills,tichondrius,1218,shaman,restoration,54,23,31
Lavablurst,stormrage,1218,shaman,restoration,59,23,36
Exportgold,barthilas,1218,shaman,restoration,42,16,26
Damador,tichondrius,1218,shaman,restoration,36,13,23
Shokxx,malganis,1217,shaman,restoration,72,38,34
Booyahshaman,area-52,1216,shaman,restoration,36,19,17
Infsham,hyjal,1216,shaman,restoration,147,66,81
Spiritbear,zuljin,1215,shaman,restoration,42,27,15
Valentinê,stormrage,1215,shaman,restoration,24,13,11
Fenny,proudmoore,1215,shaman,restoration,41,21,20
Turksham,tichondrius,1213,shaman,restoration,41,22,19
Flametide,proudmoore,1212,shaman,restoration,47,27,20
Mandinga,warsong,1212,shaman,restoration,92,45,47
Väsain,wyrmrest-accord,1212,shaman,restoration,36,16,20
Gallikano,tichondrius,1212,shaman,restoration,48,16,32
Madvillainny,thrall,1211,shaman,restoration,50,26,24
Smashtheface,nagrand,1211,shaman,restoration,54,27,27
Chitoss,gorgonnash,1210,shaman,restoration,132,61,71
Llgll,tichondrius,1210,shaman,restoration,61,24,37
Dabmarinø,tichondrius,1209,shaman,restoration,30,18,12
Freyttreyn,garrosh,1209,shaman,restoration,60,31,29
Certz,dark-iron,1209,shaman,restoration,39,15,24
Paniczone,madoran,1208,shaman,restoration,36,15,21
Voodoototems,frostmourne,1207,shaman,restoration,51,25,26
Alphamael,lightbringer,1207,shaman,restoration,50,20,30
Plausibility,moon-guard,1206,shaman,restoration,24,13,11
Paratroop,bonechewer,1206,shaman,restoration,63,27,36
Watchmytrem,ragnaros,1205,shaman,restoration,72,23,49
Patoron,proudmoore,1204,shaman,restoration,34,17,17
Beardedone,durotan,1203,shaman,restoration,42,24,18
Bluffin,stormrage,1201,shaman,restoration,24,17,7
Saicey,zuljin,1201,shaman,restoration,92,48,44
Magnethor,frostmourne,1200,shaman,restoration,42,24,18
Thräll,shuhalo,1200,shaman,restoration,202,103,99
Ogtrippleog,blackwing-lair,1200,shaman,restoration,47,19,28
Phatheelz,tichondrius,1199,shaman,restoration,35,21,14
Sizbo,thrall,1199,shaman,restoration,42,20,22
Redbulls,azralon,1198,shaman,restoration,96,54,42
Urb,moknathal,1197,shaman,restoration,32,14,18
Cruelface,sargeras,1196,shaman,restoration,26,14,12
Jaegeer,azralon,1195,shaman,restoration,30,16,14
Taekhala,moon-guard,1192,shaman,restoration,42,13,29
Grimmzhul,daggerspine,1191,shaman,restoration,133,69,64
Synkrona,tichondrius,1191,shaman,restoration,38,16,22
Furti,daggerspine,1190,shaman,restoration,34,16,18
Thorsén,ursin,1190,shaman,restoration,54,23,31
Nobiggy,tichondrius,1190,shaman,restoration,33,13,20
Lankae,quelthalas,1188,shaman,restoration,24,15,9
Babibolo,duskwood,1187,shaman,restoration,24,13,11
Lokhtar,zuljin,1184,shaman,restoration,36,17,19
Mochiko,frostmourne,1184,shaman,restoration,86,40,46
Flõp,dalaran,1182,shaman,restoration,20,13,7
Kencyzz,tichondrius,1182,shaman,restoration,23,13,10
Getwetand,quelthalas,1182,shaman,restoration,109,54,55
Reezy,draktharon,1181,shaman,restoration,23,13,10
Stabix,tichondrius,1181,shaman,restoration,66,31,35
Lavamama,sargeras,1180,shaman,restoration,41,15,26
Rimmington,frostmourne,1179,shaman,restoration,54,24,30
Shaokhang,emerald-dream,1179,shaman,restoration,82,33,49
Rajin,sentinels,1178,shaman,restoration,36,18,18
Houhei,stormrage,1178,shaman,restoration,36,14,22
Maserati,korialstrasz,1175,shaman,restoration,64,27,37
Churgarm,zuljin,1174,shaman,restoration,43,24,19
Xolkrem,stormrage,1173,shaman,restoration,36,13,23
Milkmeforhp,frostmourne,1170,shaman,restoration,174,87,87
Vanty,proudmoore,1170,shaman,restoration,29,13,16
Winry,korgath,1169,shaman,restoration,30,14,16
Hedbang,kiljaeden,1169,shaman,restoration,60,24,36
Wazöö,sargeras,1168,shaman,restoration,63,28,35
Oomshamm,area-52,1167,shaman,restoration,130,68,62
Shazikial,illidan,1167,shaman,restoration,44,21,23
Rokogg,thrall,1167,shaman,restoration,43,13,30
Onpoint,frostmourne,1165,shaman,restoration,23,13,10
Bigfatpus,illidan,1164,shaman,restoration,26,14,12
Restoramen,frostmourne,1164,shaman,restoration,43,20,23
Talroh,malganis,1164,shaman,restoration,86,32,54
Grakkah,thrall,1162,shaman,restoration,30,13,17
Dibatotenz,azralon,1160,shaman,restoration,58,22,36
Stahlman,blackhand,1160,shaman,restoration,48,17,31
Youneverknow,frostmourne,1157,shaman,restoration,161,81,80
Hatethetotem,bleeding-hollow,1156,shaman,restoration,52,27,25
Drboidzerg,tichondrius,1154,shaman,restoration,32,20,12
Lulers,cenarius,1154,shaman,restoration,48,22,26
Bekrogh,azralon,1153,shaman,restoration,23,14,9
Dahmerjr,area-52,1153,shaman,restoration,78,43,35
Luckalicious,proudmoore,1152,shaman,restoration,18,12,6
Creativemind,arathor,1152,shaman,restoration,18,12,6
Tripsit,illidan,1152,shaman,restoration,30,12,18
Rawdòggin,emerald-dream,1152,shaman,restoration,33,13,20
Sensibleqt,tichondrius,1151,shaman,restoration,18,12,6
Ruupaul,kiljaeden,1151,shaman,restoration,18,12,6
Booramz,tichondrius,1151,shaman,restoration,18,12,6
Xxchamana,ragnaros,1151,shaman,restoration,18,12,6
Femdorfxo,frostmourne,1151,shaman,restoration,24,12,12
Iightning,frostwolf,1151,shaman,restoration,30,12,18
Hoatboiz,magtheridon,1151,shaman,restoration,54,14,40
Gödöfbüdå,tichondrius,1150,shaman,restoration,18,12,6
Scrototëm,azralon,1150,shaman,restoration,36,21,15
Uglybastrd,stormrage,1150,shaman,restoration,24,12,12
Ponyi,frostmourne,1150,shaman,restoration,30,12,18
Oxicleanxo,sargeras,1150,shaman,restoration,30,12,18
Skrubbles,mugthol,1149,shaman,restoration,18,12,6
Shayprime,tichondrius,1149,shaman,restoration,24,12,12
Loanomi,zuljin,1148,shaman,restoration,30,16,14
Noolube,barthilas,1148,shaman,restoration,24,12,12
Jineluki,emerald-dream,1148,shaman,restoration,53,23,30
Funktotem,zuluhed,1148,shaman,restoration,36,12,24
Adventstrike,tichondrius,1148,shaman,restoration,45,14,31
Ricn,tichondrius,1147,shaman,restoration,24,12,12
Xiaoxiboy,tichondrius,1147,shaman,restoration,24,12,12
Branasou,emerald-dream,1147,shaman,restoration,30,12,18
Nosekandyz,chogall,1147,shaman,restoration,30,12,18
Tizm,stormrage,1146,shaman,restoration,24,12,12
Bitruff,tichondrius,1146,shaman,restoration,24,12,12
Foghoran,quelthalas,1144,shaman,restoration,24,13,11
Boltadeez,tichondrius,1144,shaman,restoration,24,12,12
Aegaeonlol,tichondrius,1144,shaman,restoration,24,12,12
Shockalama,tichondrius,1144,shaman,restoration,84,35,49
Glizzyfeast,illidan,1143,shaman,restoration,18,12,6
Maheva,ragnaros,1142,shaman,restoration,18,12,6
Shockburst,dalaran,1141,shaman,restoration,27,14,13
Skylet,azralon,1140,shaman,restoration,24,12,12
Drumman,skullcrusher,1140,shaman,restoration,66,27,39
Vinceshamwow,lightbringer,1139,shaman,restoration,18,12,6
Laterallus,nagrand,1139,shaman,restoration,92,47,45
Twistah,firetree,1139,shaman,restoration,24,12,12
Docshamwow,malganis,1137,shaman,restoration,18,12,6
Totemfizzle,spirestone,1137,shaman,restoration,24,12,12
Elecpod,frostmourne,1137,shaman,restoration,32,12,20
Gsync,tichondrius,1136,shaman,restoration,76,45,31
Winchi,stormrage,1136,shaman,restoration,24,12,12
Devipersham,frostmourne,1135,shaman,restoration,24,12,12
Charr,nemesis,1133,shaman,restoration,30,14,16
Orcstain,moknathal,1132,shaman,restoration,106,36,70
Smooths,bloodscalp,1131,shaman,restoration,30,16,14
Shampane,arathor,1131,shaman,restoration,24,12,12
Mordzan,area-52,1131,shaman,restoration,26,12,14
Ladilloso,zuljin,1131,shaman,restoration,59,24,35
Lechaman,hakkar,1131,shaman,restoration,66,22,44
Cameltotêm,frostmourne,1130,shaman,restoration,30,17,13
Dragonsauce,grizzly-hills,1130,shaman,restoration,47,19,28
Sannyasin,azralon,1126,shaman,restoration,24,12,12
Uluwatu,bleeding-hollow,1126,shaman,restoration,42,20,22
Dinaliia,lothar,1126,shaman,restoration,36,16,20
Käck,tichondrius,1122,shaman,restoration,62,28,34
Sephyros,ragnaros,1121,shaman,restoration,24,12,12
Eyris,dathremar,1121,shaman,restoration,89,42,47
Bóòchainz,tichondrius,1120,shaman,restoration,22,13,9
Kime,tichondrius,1120,shaman,restoration,78,41,37
Rocksteddy,area-52,1120,shaman,restoration,24,12,12
Allegrata,sargeras,1119,shaman,restoration,30,16,14
Bloodytotems,dethecus,1118,shaman,restoration,24,12,12
Saxaboom,tichondrius,1115,shaman,restoration,30,12,18
Etherys,frostmourne,1114,shaman,restoration,36,21,15
Phira,tichondrius,1114,shaman,restoration,78,40,38
Bikutali,kiljaeden,1114,shaman,restoration,24,12,12
Powerpress,thunderlord,1109,shaman,restoration,24,12,12
Senzxlolxz,lightbringer,1106,shaman,restoration,57,33,24
Mvpstorm,darkspear,1106,shaman,restoration,30,12,18
Shammyguy,stormreaver,1103,shaman,restoration,50,23,27
Ttass,dalaran,1102,shaman,restoration,35,13,22
Eledogg,mannoroth,1099,shaman,restoration,28,13,15
Vinnydsham,tichondrius,1098,shaman,restoration,23,12,11
Moowik,emerald-dream,1098,shaman,restoration,24,12,12
Qüickeze,khazgoroth,1097,shaman,restoration,22,15,7
Lezzer,ragnaros,1097,shaman,restoration,88,35,53
Htsu,quelthalas,1093,shaman,restoration,28,13,15
Shocksamdi,malganis,1093,shaman,restoration,36,13,23
Stormburst,sargeras,1092,shaman,restoration,42,20,22
Tremór,frostmourne,1091,shaman,restoration,30,17,13
Còsmos,illidan,1090,shaman,restoration,130,63,67
Baygone,tichondrius,1088,shaman,restoration,30,14,16
Taquitho,quelthalas,1088,shaman,restoration,75,32,43
Turbluscious,frostmourne,1087,shaman,restoration,79,42,37
Mikeisbadwow,tichondrius,1086,shaman,restoration,16,12,4
Topa,magtheridon,1085,shaman,restoration,36,15,21
Lebs,barthilas,1084,shaman,restoration,20,12,8
Chungie,laughing-skull,1082,shaman,restoration,24,12,12
Belínski,azralon,1080,shaman,restoration,48,26,22
Lavatotem,stormrage,1078,shaman,restoration,47,25,22
Delayy,destromath,1075,shaman,restoration,77,32,45
Narikó,aggramar,1073,shaman,restoration,100,56,44
Umbrood,area-52,1073,shaman,restoration,28,13,15
Grullander,hakkar,1072,shaman,restoration,41,23,18
Racsors,ragnaros,1072,shaman,restoration,36,19,17
Elharm,ragnaros,1072,shaman,restoration,36,13,23
Hazorele,nagrand,1069,shaman,restoration,48,23,25
Zhyrouvstorm,stormrage,1068,shaman,restoration,60,27,33
Arjen,kelthuzad,1066,shaman,restoration,23,15,8
Tharapita,bleeding-hollow,1064,shaman,restoration,54,24,30
Shamanzinh,azralon,1063,shaman,restoration,35,12,23
Shammysham,zuljin,1062,shaman,restoration,37,13,24
Sekkuo,kiljaeden,1061,shaman,restoration,60,28,32
Littledream,quelthalas,1061,shaman,restoration,58,26,32
Omegalmao,sargeras,1056,shaman,restoration,18,11,7
Lfgzookeeper,malganis,1056,shaman,restoration,18,11,7
Nickwoper,emerald-dream,1056,shaman,restoration,18,11,7
Biofly,thrall,1056,shaman,restoration,18,11,7
Handzum,blades-edge,1056,shaman,restoration,18,11,7
Kensyz,tichondrius,1056,shaman,restoration,18,11,7
Brocules,aerie-peak,1056,shaman,restoration,24,11,13
Censyzz,tichondrius,1056,shaman,restoration,24,11,13
Laodo,tichondrius,1056,shaman,restoration,28,12,16
Jukedlawl,illidan,1056,shaman,restoration,30,11,19
Restoele,tichondrius,1055,shaman,restoration,18,11,7
Ophitotem,zuljin,1055,shaman,restoration,18,11,7
Localxhero,stormrage,1055,shaman,restoration,24,11,13
Pericazo,sargeras,1055,shaman,restoration,24,11,13
Sweetpotatoe,malganis,1055,shaman,restoration,24,11,13
Jtrxs,tichondrius,1055,shaman,restoration,24,11,13
Hordeoeuvre,zuljin,1055,shaman,restoration,24,11,13
Mindgooblin,sargeras,1055,shaman,restoration,36,11,25
Cháningtotem,frostmourne,1054,shaman,restoration,18,11,7
Sipo,tichondrius,1054,shaman,restoration,18,11,7
Earthfirex,ragnaros,1054,shaman,restoration,18,11,7
Ituma,tichondrius,1054,shaman,restoration,18,11,7
Vixeen,kelthuzad,1054,shaman,restoration,24,11,13
Keybordternr,tichondrius,1054,shaman,restoration,24,11,13
Elmonkeyloco,bleeding-hollow,1053,shaman,restoration,18,11,7
Murm,burning-blade,1053,shaman,restoration,24,11,13
Possessing,illidan,1053,shaman,restoration,24,11,13
Glark,tichondrius,1051,shaman,restoration,24,11,13
Alfrigg,stormrage,1051,shaman,restoration,30,11,19
Kissmeslowly,zuljin,1050,shaman,restoration,18,11,7
Chebbs,bleeding-hollow,1050,shaman,restoration,18,11,7
Kuhdos,caelestrasz,1050,shaman,restoration,24,11,13
Dragum,blackrock,1050,shaman,restoration,30,11,19
Paradigm,sargeras,1049,shaman,restoration,18,11,7
Millionvoltz,tichondrius,1049,shaman,restoration,24,11,13
Speedranger,stormrage,1049,shaman,restoration,48,20,28
Groundded,tichondrius,1049,shaman,restoration,35,11,24
Totemism,warsong,1048,shaman,restoration,18,11,7
Ryuukas,illidan,1047,shaman,restoration,18,11,7
Pohtayto,darkspear,1047,shaman,restoration,24,11,13
Kaleska,area-52,1047,shaman,restoration,32,11,21
Mcstop,tanaris,1046,shaman,restoration,36,15,21
Eleshortal,azuremyst,1046,shaman,restoration,51,21,30
Lawlsham,korgath,1045,shaman,restoration,18,11,7
Tràuma,caelestrasz,1045,shaman,restoration,45,13,32
Tsünade,anubarak,1044,shaman,restoration,12,11,1
Elpide,area-52,1044,shaman,restoration,18,11,7
Kronko,frostmourne,1044,shaman,restoration,24,11,13
Leogi,daggerspine,1044,shaman,restoration,27,11,16
Gl,nordrassil,1043,shaman,restoration,18,11,7
Cazlukz,demon-soul,1043,shaman,restoration,36,18,18
Kymosoloshm,sargeras,1043,shaman,restoration,24,11,13
Enzÿte,tichondrius,1043,shaman,restoration,24,11,13
Saraguthix,dalaran,1043,shaman,restoration,30,11,19
Pootergash,shadowmoon,1041,shaman,restoration,24,11,13
Volcanô,area-52,1041,shaman,restoration,30,11,19
Adrô,barthilas,1040,shaman,restoration,117,48,69
Geoleo,stormrage,1040,shaman,restoration,42,17,25
Zugzugthug,moon-guard,1040,shaman,restoration,84,33,51
Chablez,shattered-hand,1036,shaman,restoration,42,17,25
Aimiréal,nagrand,1030,shaman,restoration,30,17,13
Zoodoo,nagrand,1027,shaman,restoration,59,21,38
Rekiem,quelthalas,1025,shaman,restoration,28,15,13
Plop,tichondrius,1024,shaman,restoration,16,12,4
Anttoekneeoh,thrall,1024,shaman,restoration,24,12,12
Vaginix,tichondrius,1023,shaman,restoration,30,11,19
Mastrionilol,stormrage,1023,shaman,restoration,34,11,23
Slëvin,frostmourne,1023,shaman,restoration,42,13,29
Kulgur,ravenholdt,1022,shaman,restoration,29,19,10
Dextex,azralon,1022,shaman,restoration,47,26,21
Zonsham,drakkari,1017,shaman,restoration,24,11,13
Frizzie,barthilas,1015,shaman,restoration,89,23,66
Nupi,thaurissan,1013,shaman,restoration,59,26,33
Mikeoxxgigg,kelthuzad,1011,shaman,restoration,75,39,36
Rebbecablack,malganis,1008,shaman,restoration,18,12,6
Lazi,frostmourne,1008,shaman,restoration,27,12,15
Kawixxi,ysondre,1007,shaman,restoration,65,35,30
Volsdeep,illidan,1007,shaman,restoration,21,11,10
Grêgg,area-52,1006,shaman,restoration,22,11,11
Totori,stormscale,1006,shaman,restoration,30,11,19
Illeh,illidan,1005,shaman,restoration,42,19,23
Hoghlinn,stormrage,1003,shaman,restoration,14,12,2
Ttukilowatts,stormrage,1003,shaman,restoration,84,21,63
Smolder,magtheridon,1000,shaman,restoration,54,32,22
Vogelbach,ragnaros,999,shaman,restoration,30,19,11
Shamankie,tichondrius,999,shaman,restoration,40,13,27
Hentaistorm,kiljaeden,998,shaman,restoration,80,41,39
Mythruxx,sargeras,993,shaman,restoration,26,12,14
Betorc,azralon,993,shaman,restoration,36,11,25
Nottrhall,azralon,990,shaman,restoration,14,11,3
Superchunk,shattered-hand,990,shaman,restoration,132,68,64
Dùffman,jubeithos,988,shaman,restoration,29,13,16
Cakinha,stormrage,985,shaman,restoration,42,24,18
Faegle,area-52,984,shaman,restoration,24,11,13
Doomgodx,tichondrius,983,shaman,restoration,36,16,20
Bettoo,ragnaros,980,shaman,restoration,29,12,17
Banterx,emerald-dream,979,shaman,restoration,35,12,23
Laggythought,malganis,977,shaman,restoration,46,14,32
Andrastia,thrall,976,shaman,restoration,24,15,9
Shamadran,hyjal,971,shaman,restoration,23,11,12
Ayahuassca,illidan,971,shaman,restoration,56,25,31
Monorim,barthilas,969,shaman,restoration,30,14,16
Njjshamm,thrall,969,shaman,restoration,36,16,20
Robis,thrall,968,shaman,restoration,161,79,82
Donkeydrill,elune,965,shaman,restoration,24,15,9
Klâus,fizzcrank,960,shaman,restoration,12,10,2
Gabbin,dalaran,960,shaman,restoration,12,10,2
Devilsham,tichondrius,960,shaman,restoration,12,10,2
Sagester,illidan,960,shaman,restoration,16,11,5
Hst,barthilas,960,shaman,restoration,18,10,8
Victusk,tichondrius,960,shaman,restoration,18,10,8
Paperbot,barthilas,960,shaman,restoration,18,10,8
Naisayyds,tichondrius,960,shaman,restoration,18,10,8
Yunotho,sargeras,960,shaman,restoration,18,10,8
Burstekka,tichondrius,960,shaman,restoration,18,10,8
Freerath,tichondrius,960,shaman,restoration,22,10,12
Liquidcdew,illidan,960,shaman,restoration,24,10,14
Enhancex,frostwolf,960,shaman,restoration,24,10,14
Shield,lightnings-blade,960,shaman,restoration,24,10,14
Nisthesham,tichondrius,960,shaman,restoration,24,10,14
Woobsz,sargeras,959,shaman,restoration,12,10,2
Farfar,tichondrius,959,shaman,restoration,12,10,2
Joryu,tichondrius,959,shaman,restoration,18,10,8
Esoterikk,malganis,959,shaman,restoration,18,10,8
Lodekimm,tichondrius,959,shaman,restoration,18,10,8
Awsika,lethon,959,shaman,restoration,18,10,8
Service,llane,959,shaman,restoration,18,10,8
Zensarg,tichondrius,959,shaman,restoration,18,10,8
Jisthexx,senjin,959,shaman,restoration,24,10,14
Matzuga,bleeding-hollow,959,shaman,restoration,24,10,14
Forcè,bleeding-hollow,959,shaman,restoration,24,10,14
Valcn,moon-guard,959,shaman,restoration,24,10,14
Ggoong,tichondrius,959,shaman,restoration,36,10,26
Shyva,frostmourne,958,shaman,restoration,18,10,8
Felzbirt,uldum,958,shaman,restoration,30,14,16
Weirdboi,area-52,958,shaman,restoration,24,10,14
Thundershade,deathwing,958,shaman,restoration,24,10,14
Totomayo,tichondrius,957,shaman,restoration,12,10,2
Humpvack,tichondrius,957,shaman,restoration,18,10,8
Resonence,bleeding-hollow,957,shaman,restoration,18,10,8
Clytiae,arthas,957,shaman,restoration,18,10,8
Athayis,malorne,957,shaman,restoration,59,31,28
Rsham,dragonmaw,956,shaman,restoration,18,10,8
Kroggath,area-52,956,shaman,restoration,18,10,8
Karaaka,ysera,956,shaman,restoration,30,10,20
Oohkillemm,silvermoon,955,shaman,restoration,18,10,8
Askortus,stormrage,955,shaman,restoration,24,10,14
Shammystic,quelthalas,955,shaman,restoration,54,19,35
Booz,caelestrasz,955,shaman,restoration,36,12,24
Volzuna,wyrmrest-accord,954,shaman,restoration,24,10,14
Johnnyblue,barthilas,954,shaman,restoration,30,10,20
Raininwishes,aegwynn,952,shaman,restoration,18,10,8
Santral,ragnaros,952,shaman,restoration,25,10,15
Bruhh,khadgar,951,shaman,restoration,18,10,8
Romcomx,tichondrius,951,shaman,restoration,24,10,14
Soulmiracle,tichondrius,951,shaman,restoration,24,10,14
Overcåst,barthilas,951,shaman,restoration,36,10,26
Castte,ragnaros,950,shaman,restoration,86,38,48
Psilocypher,nazjatar,949,shaman,restoration,36,19,17
Skaehj,saurfang,949,shaman,restoration,56,29,27
Tabby,emerald-dream,948,shaman,restoration,24,10,14
Daxetan,area-52,947,shaman,restoration,18,10,8
Recyclicrab,skullcrusher,945,shaman,restoration,12,10,2
Vulkova,illidan,945,shaman,restoration,24,10,14
Skippe,hyjal,943,shaman,restoration,18,10,8
Matrìx,sargeras,941,shaman,restoration,92,45,47
Mhuns,malganis,940,shaman,restoration,24,10,14
Urao,stormrage,936,shaman,restoration,36,10,26
Boppshock,tichondrius,928,shaman,restoration,16,11,5
Wûbbie,emerald-dream,927,shaman,restoration,35,10,25
Thrallblade,burning-blade,926,shaman,restoration,16,11,5
Haether,madoran,926,shaman,restoration,101,50,51
Colberton,dalaran,926,shaman,restoration,23,10,13
Rastablaze,darkspear,926,shaman,restoration,70,27,43
Artsha,tol-barad,925,shaman,restoration,18,11,7
Shoomas,tichondrius,923,shaman,restoration,23,10,13
Mikeyshockus,hydraxis,922,shaman,restoration,47,19,28
Klev,frostmourne,921,shaman,restoration,33,12,21
Cositax,tichondrius,919,shaman,restoration,18,10,8
Jorko,dathremar,918,shaman,restoration,26,16,10
Brokkghul,illidan,917,shaman,restoration,28,14,14
Malløry,mugthol,917,shaman,restoration,30,12,18
Bakedpototem,magtheridon,913,shaman,restoration,24,10,14
Tineer,tichondrius,912,shaman,restoration,27,10,17
Flexexpress,stormrage,911,shaman,restoration,17,10,7
Privxd,bleeding-hollow,910,shaman,restoration,17,10,7
Mainstreamx,sargeras,908,shaman,restoration,33,10,23
Bitflip,jubeithos,907,shaman,restoration,21,10,11
Jessestevens,kiljaeden,905,shaman,restoration,17,10,7
Tyrión,aggramar,905,shaman,restoration,27,12,15
Alestorm,nemesis,899,shaman,restoration,28,12,16
Señordoge,malganis,895,shaman,restoration,26,10,16
Lyshar,laughing-skull,894,shaman,restoration,20,10,10
Oldhar,kirin-tor,891,shaman,restoration,24,10,14
Shämpäin,moon-guard,891,shaman,restoration,26,10,16
Imperiumrum,azuremyst,887,shaman,restoration,77,41,36
Jenniferlynn,tichondrius,886,shaman,restoration,48,15,33
Swifteyy,area-52,883,shaman,restoration,22,10,12
Astàròth,malganis,880,shaman,restoration,13,10,3
Thrawl,deathwing,875,shaman,restoration,24,11,13
Muur,zangarmarsh,872,shaman,restoration,25,10,15
Orouboros,area-52,869,shaman,restoration,72,25,47
Galarix,nerzhul,867,shaman,restoration,60,16,44
Seiunsky,area-52,864,shaman,restoration,12,9,3
Bakenquake,tichondrius,864,shaman,restoration,12,9,3
ßonevoyage,malganis,864,shaman,restoration,12,9,3
Genesiis,stormrage,864,shaman,restoration,12,9,3
Electricsham,archimonde,864,shaman,restoration,12,9,3
Pangniu,illidan,864,shaman,restoration,12,9,3
Iadyboi,kiljaeden,864,shaman,restoration,12,9,3
Washedupty,illidan,864,shaman,restoration,12,9,3
Èmaxx,barthilas,864,shaman,restoration,12,9,3
Neviahz,illidan,864,shaman,restoration,18,9,9
Kirschblute,proudmoore,864,shaman,restoration,18,9,9
Awyiss,dreadmaul,864,shaman,restoration,18,9,9
Biased,sargeras,864,shaman,restoration,18,9,9
Fiizix,malganis,864,shaman,restoration,18,9,9
Gargrax,malganis,864,shaman,restoration,18,9,9
Flatt,uther,864,shaman,restoration,18,9,9
Plotwave,bleeding-hollow,864,shaman,restoration,18,9,9
Medullarum,suramar,864,shaman,restoration,18,9,9
Hexcalibur,laughing-skull,864,shaman,restoration,18,9,9
Humiliated,stormrage,864,shaman,restoration,24,9,15
Wildmaster,ragnaros,864,shaman,restoration,30,9,21
Køre,tichondrius,863,shaman,restoration,12,9,3
Kzxs,illidan,863,shaman,restoration,12,9,3
Rockemsockem,frostmourne,863,shaman,restoration,12,9,3
Deosculation,tichondrius,863,shaman,restoration,12,9,3
Ajvl,tichondrius,863,shaman,restoration,12,9,3
Shamanology,echo-isles,863,shaman,restoration,15,10,5
Airenne,vashj,863,shaman,restoration,18,9,9
Ataia,tichondrius,863,shaman,restoration,18,9,9
Hoofpics,dalaran,863,shaman,restoration,18,9,9
Multran,stormscale,863,shaman,restoration,18,9,9
Snoff,burning-blade,863,shaman,restoration,18,9,9
Potf,illidan,863,shaman,restoration,18,9,9
Exiledsham,area-52,863,shaman,restoration,18,9,9
Murica,area-52,863,shaman,restoration,18,9,9
Kassper,tichondrius,863,shaman,restoration,18,9,9
Grimmick,area-52,863,shaman,restoration,18,9,9
Gornu,nemesis,863,shaman,restoration,18,9,9
Chlknx,tichondrius,863,shaman,restoration,18,9,9
Thungo,thaurissan,863,shaman,restoration,18,9,9
Buffele,tichondrius,863,shaman,restoration,18,9,9
Discofoot,wyrmrest-accord,863,shaman,restoration,24,9,15
Memorix,stonemaul,863,shaman,restoration,24,9,15
Mastrionilol,dragonmaw,863,shaman,restoration,24,9,15
Yoloswage,tichondrius,863,shaman,restoration,33,10,23
Tycho,skullcrusher,862,shaman,restoration,12,9,3
Obrahma,burning-legion,862,shaman,restoration,18,9,9
Drünk,hyjal,862,shaman,restoration,18,9,9
Mâdy,quelthalas,861,shaman,restoration,12,9,3
Soppin,bleeding-hollow,861,shaman,restoration,18,9,9
Milkstress,whisperwind,861,shaman,restoration,24,9,15
Esanim,tichondrius,860,shaman,restoration,18,9,9
Bacnbitz,hellscream,860,shaman,restoration,24,9,15
Duza,frostmourne,859,shaman,restoration,18,9,9
Xtremedwarf,frostmourne,859,shaman,restoration,18,9,9
Blavan,area-52,859,shaman,restoration,24,9,15
Ironfart,destromath,858,shaman,restoration,18,9,9
Blois,thunderlord,857,shaman,restoration,18,9,9
Vulcanuzz,ragnaros,856,shaman,restoration,24,9,15
Stormblast,stormrage,856,shaman,restoration,42,9,33
Yakella,trollbane,854,shaman,restoration,12,9,3
Donix,destromath,854,shaman,restoration,30,11,19
Lauralai,sargeras,853,shaman,restoration,12,9,3
Mtnju,eredar,852,shaman,restoration,18,9,9
Uggbootz,amanthul,851,shaman,restoration,37,13,24
Çatastrophe,dalaran,849,shaman,restoration,18,9,9
Elementium,azshara,847,shaman,restoration,29,9,20
Fio,nerzhul,846,shaman,restoration,246,111,135
Xinz,guldan,845,shaman,restoration,20,10,10
Danil,emerald-dream,831,shaman,restoration,17,9,8
Sittingwolf,stormreaver,825,shaman,restoration,17,9,8
Juksi,the-scryers,820,shaman,restoration,23,9,14
Insidetrader,illidan,815,shaman,restoration,15,10,5
Zitan,tichondrius,813,shaman,restoration,17,9,8
Slimshaddy,tichondrius,809,shaman,restoration,21,9,12
Deadlyshocks,gilneas,800,shaman,restoration,57,25,32
Importmodule,frostmourne,796,shaman,restoration,23,9,14
Brahsbro,icecrown,789,shaman,restoration,96,46,50
Frankenstien,proudmoore,777,shaman,restoration,25,9,16
Hudepohl,alexstrasza,776,shaman,restoration,23,9,14
Shxl,zuljin,768,shaman,restoration,12,8,4
Kìttý,malganis,768,shaman,restoration,12,8,4
Floofs,kelthuzad,768,shaman,restoration,12,8,4
Xiaoshaman,tichondrius,768,shaman,restoration,12,8,4
Xannysnapper,zuljin,768,shaman,restoration,12,8,4
Hexistential,tichondrius,768,shaman,restoration,12,8,4
Plznostepmom,tichondrius,768,shaman,restoration,12,8,4
Thictoxicity,tichondrius,768,shaman,restoration,12,8,4
Hoonjojjyans,tichondrius,768,shaman,restoration,12,8,4
Vernzi,laughing-skull,768,shaman,restoration,12,8,4
Xiaoshaman,frostmourne,768,shaman,restoration,12,8,4
Kaskä,tichondrius,768,shaman,restoration,12,8,4
Ggdumpy,tichondrius,768,shaman,restoration,12,8,4
Tidesurge,tichondrius,768,shaman,restoration,12,8,4
Steverz,daggerspine,768,shaman,restoration,12,8,4
Xbk,tichondrius,768,shaman,restoration,12,8,4
Yarzin,azjolnerub,768,shaman,restoration,12,8,4
Longlivecrit,exodar,768,shaman,restoration,12,8,4
Lavamon,illidan,768,shaman,restoration,12,8,4
Fyc,wyrmrest-accord,768,shaman,restoration,18,8,10
Wolvez,tichondrius,768,shaman,restoration,18,8,10
Artotem,barthilas,768,shaman,restoration,18,8,10
Sgtsosix,zuljin,768,shaman,restoration,18,8,10
Rhazul,barthilas,768,shaman,restoration,18,8,10
Skymarshal,tichondrius,768,shaman,restoration,18,8,10
Songo,frostmane,768,shaman,restoration,18,8,10
Ändiroba,azralon,768,shaman,restoration,18,8,10
Kaddya,mannoroth,768,shaman,restoration,18,8,10
Toastjr,frostmourne,768,shaman,restoration,18,8,10
Xotheweeknd,bleeding-hollow,768,shaman,restoration,18,8,10
Earthuncle,illidan,768,shaman,restoration,24,8,16
Shampoø,shattered-halls,767,shaman,restoration,12,8,4
Jesuisbatman,zuljin,767,shaman,restoration,12,8,4
Iarepotato,tichondrius,767,shaman,restoration,12,8,4
Gerberbaby,chogall,767,shaman,restoration,12,8,4
Elamentz,bleeding-hollow,767,shaman,restoration,12,8,4
Watergirl,thaurissan,767,shaman,restoration,12,8,4
Raspberri,kelthuzad,767,shaman,restoration,12,8,4
Vindícated,area-52,767,shaman,restoration,12,8,4
Mymojo,tichondrius,767,shaman,restoration,12,8,4
Squirtrussel,boulderfist,767,shaman,restoration,12,8,4
Vernacks,area-52,767,shaman,restoration,12,8,4
Lepoow,illidan,767,shaman,restoration,12,8,4
Hexoffender,thunderlord,767,shaman,restoration,12,8,4
Veeve,kelthuzad,767,shaman,restoration,12,8,4
Tholkt,ragnaros,767,shaman,restoration,15,9,6
Regisphilman,bonechewer,767,shaman,restoration,17,10,7
Tigs,alleria,767,shaman,restoration,18,8,10
Myrakh,zuljin,767,shaman,restoration,18,8,10
Nehpets,kiljaeden,767,shaman,restoration,18,8,10
Chrigshock,black-dragonflight,767,shaman,restoration,18,8,10
Jazziefae,arygos,767,shaman,restoration,18,8,10
Agrîm,tichondrius,767,shaman,restoration,24,8,16
Thunderfucj,tichondrius,767,shaman,restoration,24,8,16
Totemlord,lightnings-blade,766,shaman,restoration,18,8,10
Rapwnzel,tichondrius,766,shaman,restoration,18,8,10
Nooch,malganis,766,shaman,restoration,27,9,18
Magatotem,sargeras,766,shaman,restoration,24,8,16
Gohex,saurfang,765,shaman,restoration,12,8,4
Finaire,queldorei,765,shaman,restoration,12,8,4
Trickyjf,dalaran,765,shaman,restoration,18,8,10
Kanagawa,illidan,765,shaman,restoration,24,8,16
Josiahsham,kelthuzad,764,shaman,restoration,18,8,10
Zuljincj,zuljin,764,shaman,restoration,18,8,10
Moistydank,tichondrius,764,shaman,restoration,24,8,16
Vulcanik,quelthalas,764,shaman,restoration,24,8,16
Vínnie,tichondrius,763,shaman,restoration,18,8,10
Furbiddên,area-52,763,shaman,restoration,24,8,16
ßøn,altar-of-storms,762,shaman,restoration,12,8,4
Shamnnoodlez,area-52,762,shaman,restoration,18,8,10
Extenzz,area-52,761,shaman,restoration,18,8,10
Cremecheese,crushridge,760,shaman,restoration,12,8,4
Groonix,blood-furnace,759,shaman,restoration,12,8,4
Tiä,quelthalas,758,shaman,restoration,24,8,16
Shamanlesa,azralon,757,shaman,restoration,18,8,10
Kordir,kiljaeden,756,shaman,restoration,24,8,16
Amonamarth,tichondrius,753,shaman,restoration,18,8,10
Getpurged,thrall,751,shaman,restoration,17,8,9
Shubba,thrall,747,shaman,restoration,12,8,4
Msooli,tichondrius,745,shaman,restoration,15,10,5
Siksika,bloodscalp,744,shaman,restoration,130,56,74
Ryforges,frostmourne,734,shaman,restoration,14,9,5
Interwebzz,tichondrius,734,shaman,restoration,66,17,49
Picklefartsh,tichondrius,720,shaman,restoration,15,8,7
Unishamx,malganis,720,shaman,restoration,15,8,7
Treris,bleeding-hollow,719,shaman,restoration,11,8,3
Notragii,kelthuzad,719,shaman,restoration,17,8,9
Kencysz,tichondrius,714,shaman,restoration,23,9,14
Stitchez,illidan,714,shaman,restoration,27,9,18
Kyma,black-dragonflight,713,shaman,restoration,25,9,16
Poundmaker,cairne,707,shaman,restoration,15,8,7
Kenithwest,tichondrius,703,shaman,restoration,11,8,3
Purgelordx,proudmoore,703,shaman,restoration,11,8,3
Wasuwant,frostmourne,703,shaman,restoration,14,8,6
Garbagedump,burning-legion,703,shaman,restoration,14,8,6
Kikahna,stormreaver,683,shaman,restoration,22,9,13
Naturescandy,alterac-mountains,676,shaman,restoration,19,8,11
Dizzyswift,tichondrius,672,shaman,restoration,12,7,5
Akurai,stormrage,672,shaman,restoration,12,7,5
Acdc,zuljin,672,shaman,restoration,12,7,5
Toltem,bleeding-hollow,672,shaman,restoration,12,7,5
Zarly,bleeding-hollow,672,shaman,restoration,12,7,5
Kencyi,tichondrius,672,shaman,restoration,12,7,5
Zerwyn,senjin,672,shaman,restoration,12,7,5
Dektide,zuljin,672,shaman,restoration,12,7,5
Joè,bleeding-hollow,672,shaman,restoration,12,7,5
Kustum,tichondrius,672,shaman,restoration,12,7,5
Wreckaholic,alterac-mountains,672,shaman,restoration,12,7,5
Jxx,nordrassil,672,shaman,restoration,12,7,5
Symbox,tichondrius,672,shaman,restoration,12,7,5
Boltekka,tichondrius,672,shaman,restoration,12,7,5
Micgarnagul,illidan,672,shaman,restoration,12,7,5
Mastashambtw,illidan,672,shaman,restoration,12,7,5
Macksimas,tichondrius,672,shaman,restoration,12,7,5
Mørgénstérn,area-52,672,shaman,restoration,12,7,5
Gruestorm,illidan,672,shaman,restoration,12,7,5
Çdñ,tichondrius,672,shaman,restoration,12,7,5
Daxotv,sargeras,672,shaman,restoration,12,7,5
Farmër,illidan,672,shaman,restoration,12,7,5
Heckinpurges,area-52,672,shaman,restoration,12,7,5
Ballofduty,tichondrius,672,shaman,restoration,12,7,5
Paaman,proudmoore,672,shaman,restoration,12,7,5
Dopey,twisting-nether,672,shaman,restoration,12,7,5
Yusbe,ragnaros,672,shaman,restoration,12,7,5
Knockedup,tichondrius,672,shaman,restoration,12,7,5
Invokeesorin,area-52,672,shaman,restoration,12,7,5
Mayim,sargeras,672,shaman,restoration,12,7,5
Mugiwára,ragnaros,672,shaman,restoration,12,7,5
Ghiscar,tichondrius,672,shaman,restoration,12,7,5
Bloodlustxo,frostmourne,672,shaman,restoration,12,7,5
Quiksilvero,khazgoroth,672,shaman,restoration,12,7,5
Iliillililli,tichondrius,672,shaman,restoration,12,7,5
Viprus,nerzhul,672,shaman,restoration,12,7,5
Hexmix,muradin,672,shaman,restoration,12,7,5
Elîas,tichondrius,672,shaman,restoration,12,7,5
Strykked,illidan,672,shaman,restoration,12,7,5
Xueticsham,tichondrius,672,shaman,restoration,12,7,5
Envy,korialstrasz,672,shaman,restoration,12,7,5
Befree,thunderlord,672,shaman,restoration,15,8,7
Zrosurge,stormrage,672,shaman,restoration,14,7,7
Hardlyfe,frostmourne,672,shaman,restoration,18,7,11
Smeagles,ragnaros,672,shaman,restoration,18,7,11
Nikeshocks,detheroc,672,shaman,restoration,18,7,11
Meeb,emerald-dream,672,shaman,restoration,18,7,11
Zanderpla,kelthuzad,672,shaman,restoration,18,7,11
Lindsanx,illidan,672,shaman,restoration,18,7,11
Silverkitty,tichondrius,672,shaman,restoration,18,7,11
Trippzs,barthilas,672,shaman,restoration,18,7,11
Oprawindfuri,whisperwind,672,shaman,restoration,18,7,11
Lildik,tichondrius,672,shaman,restoration,18,7,11
Pjtremblay,frostmourne,672,shaman,restoration,18,7,11
Morphose,tichondrius,672,shaman,restoration,18,7,11
Macavell,tichondrius,672,shaman,restoration,18,7,11
History,burning-blade,672,shaman,restoration,18,7,11
Aromental,sargeras,672,shaman,restoration,18,7,11
Huashiren,illidan,672,shaman,restoration,18,7,11
Stumpyjoe,terokkar,672,shaman,restoration,19,7,12
Foxymama,the-forgotten-coast,672,shaman,restoration,24,7,17
Drathos,azralon,671,shaman,restoration,12,7,5
Flekzs,blackhand,671,shaman,restoration,12,7,5
Wishpool,stormrage,671,shaman,restoration,12,7,5
Sixzo,tichondrius,671,shaman,restoration,12,7,5
Shamiggels,sargeras,671,shaman,restoration,12,7,5
Thormodin,destromath,671,shaman,restoration,12,7,5
Rokvahn,illidan,671,shaman,restoration,12,7,5
Pakdis,sargeras,671,shaman,restoration,12,7,5
Kustys,tichondrius,671,shaman,restoration,12,7,5
Arkilios,tichondrius,671,shaman,restoration,12,7,5
Curtrex,amanthul,671,shaman,restoration,12,7,5
Antysham,emerald-dream,671,shaman,restoration,12,7,5
Blayze,stormscale,671,shaman,restoration,17,8,9
Cheeziee,thrall,671,shaman,restoration,18,7,11
Lvcianrs,thrall,671,shaman,restoration,18,7,11
Caobuloso,azralon,671,shaman,restoration,18,7,11
Kamltoetm,proudmoore,671,shaman,restoration,18,7,11
Bintopean,boulderfist,671,shaman,restoration,18,7,11
Sheariously,sargeras,671,shaman,restoration,18,7,11
Cavolt,stormrage,671,shaman,restoration,18,7,11
Dochavoc,tichondrius,671,shaman,restoration,18,7,11
Riptiddles,nordrassil,671,shaman,restoration,30,7,23
Zevexx,tichondrius,670,shaman,restoration,12,7,5
Jaws,skullcrusher,670,shaman,restoration,12,7,5
Shamanastic,tichondrius,670,shaman,restoration,12,7,5
Bethorá,suramar,670,shaman,restoration,12,7,5
Crynoobs,senjin,670,shaman,restoration,12,7,5
Xuesu,tichondrius,670,shaman,restoration,12,7,5
Flameism,sargeras,670,shaman,restoration,12,7,5
Stormcallerr,sargeras,670,shaman,restoration,12,7,5
Saulgudmon,area-52,670,shaman,restoration,18,7,11
Oprawîndfury,tichondrius,670,shaman,restoration,18,7,11
Hopetotem,zuljin,670,shaman,restoration,18,7,11
Víì,tichondrius,670,shaman,restoration,24,7,17
Toedims,bonechewer,669,shaman,restoration,12,7,5
Knowknown,tichondrius,669,shaman,restoration,12,7,5
Thordan,lothar,669,shaman,restoration,18,7,11
Todem,stormrage,669,shaman,restoration,18,7,11
Nahualtt,quelthalas,669,shaman,restoration,18,7,11
Rrakk,proudmoore,669,shaman,restoration,18,7,11
Logich,dalaran,669,shaman,restoration,18,7,11
Farku,illidan,669,shaman,restoration,36,7,29
Waterspinach,tichondrius,668,shaman,restoration,18,7,11
Evilraven,tichondrius,668,shaman,restoration,18,7,11
Detropolis,illidan,668,shaman,restoration,48,7,41
Wÿrd,illidan,667,shaman,restoration,12,7,5
Kaliøs,ragnaros,667,shaman,restoration,12,7,5
Youngneal,sargeras,667,shaman,restoration,18,7,11
Villainousx,illidan,667,shaman,restoration,18,7,11
Caferino,area-52,666,shaman,restoration,12,7,5
Dennwoop,sargeras,666,shaman,restoration,28,8,20
Dîabeetus,moon-guard,665,shaman,restoration,11,9,2
Ruadhri,moon-guard,665,shaman,restoration,12,7,5
Trodor,tichondrius,665,shaman,restoration,12,7,5
Lamente,ragnaros,655,shaman,restoration,17,7,10
Kihlubra,frostmourne,655,shaman,restoration,25,7,18
Mâyo,thrall,654,shaman,restoration,17,7,10
Wragnus,tichondrius,651,shaman,restoration,31,10,21
Slimcube,illidan,649,shaman,restoration,24,8,16
Stormsurgë,bleeding-hollow,640,shaman,restoration,10,8,2
Healingtime,nerzhul,638,shaman,restoration,14,8,6
Flíx,stormrage,638,shaman,restoration,14,8,6
Cdewschair,tichondrius,623,shaman,restoration,17,7,10
Deacoderz,area-52,618,shaman,restoration,14,8,6
Royblue,illidan,618,shaman,restoration,14,8,6
Îvôry,bloodhoof,618,shaman,restoration,22,10,12
Tolvashoc,emerald-dream,608,shaman,restoration,16,7,9
Bigbrenx,tichondrius,607,shaman,restoration,14,7,7
Drfate,kargath,604,shaman,restoration,16,7,9
Xlash,zuljin,598,shaman,restoration,26,7,19
Grony,malganis,592,shaman,restoration,7,7,0
Vaderung,emerald-dream,592,shaman,restoration,13,7,6
Paraplexed,blackrock,585,shaman,restoration,16,10,6
Kassix,illidan,576,shaman,restoration,6,6,0
Jinyara,malganis,576,shaman,restoration,6,6,0
Limburger,zuljin,576,shaman,restoration,6,6,0
Vrangr,uther,576,shaman,restoration,6,6,0
ßlessthefall,malganis,576,shaman,restoration,6,6,0
Jimmyapple,illidan,576,shaman,restoration,6,6,0
Zontas,illidan,576,shaman,restoration,6,6,0
Tommoorello,lightnings-blade,576,shaman,restoration,6,6,0
Jaygodx,blades-edge,576,shaman,restoration,6,6,0
Duckhead,tichondrius,576,shaman,restoration,6,6,0
Jordnöt,moon-guard,576,shaman,restoration,9,6,3
Mocksy,eredar,576,shaman,restoration,12,6,6
Rlzshaman,tichondrius,576,shaman,restoration,12,6,6
Oppaswag,tichondrius,576,shaman,restoration,12,6,6
Wulfey,sargeras,576,shaman,restoration,12,6,6
Earthside,ragnaros,576,shaman,restoration,12,6,6
Triyourong,proudmoore,576,shaman,restoration,12,6,6
Weqeqwqwqex,ragnaros,576,shaman,restoration,12,6,6
Subhealth,tichondrius,576,shaman,restoration,12,6,6
Mazekheen,barthilas,576,shaman,restoration,12,6,6
Akamâ,stormrage,576,shaman,restoration,12,6,6
Mariansaurus,ragnaros,576,shaman,restoration,12,6,6
Fevolution,dreadmaul,576,shaman,restoration,12,6,6
Nymrose,stormrage,576,shaman,restoration,12,6,6
Unclexflex,tichondrius,576,shaman,restoration,12,6,6
Pikapiko,tichondrius,576,shaman,restoration,12,6,6
Tcurts,stormrage,576,shaman,restoration,12,6,6
Pex,sargeras,576,shaman,restoration,12,6,6
Gullirachad,stormrage,576,shaman,restoration,12,6,6
Aespeon,stormrage,576,shaman,restoration,12,6,6
Callabash,mugthol,576,shaman,restoration,12,6,6
Patmar,dragonmaw,576,shaman,restoration,12,6,6
Spiritbb,area-52,576,shaman,restoration,12,6,6
Abev,bonechewer,576,shaman,restoration,12,6,6
Motatos,malganis,576,shaman,restoration,12,6,6
Iamg,kilrogg,576,shaman,restoration,12,6,6
Ccmeifbald,moon-guard,576,shaman,restoration,12,6,6
Chogramm,illidan,576,shaman,restoration,12,6,6
Dameyo,tichondrius,576,shaman,restoration,12,6,6
Hhex,tichondrius,576,shaman,restoration,12,6,6
Adrec,quelthalas,576,shaman,restoration,12,6,6
Vyy,perenolde,576,shaman,restoration,12,6,6
Scadouche,korgath,576,shaman,restoration,12,6,6
Apathcat,the-forgotten-coast,576,shaman,restoration,12,6,6
Rawdogginit,malfurion,576,shaman,restoration,12,6,6
Xenvale,illidan,576,shaman,restoration,12,6,6
Todayqt,malganis,576,shaman,restoration,12,6,6
Cencyzz,tichondrius,576,shaman,restoration,12,6,6
Lindnerx,malganis,576,shaman,restoration,12,6,6
Sweatshirtz,tanaris,576,shaman,restoration,12,6,6
Ajj,thrall,576,shaman,restoration,12,6,6
Fourinchsham,tichondrius,576,shaman,restoration,12,6,6
Nickbosa,illidan,576,shaman,restoration,12,6,6
Surph,zuljin,576,shaman,restoration,12,6,6
Diptide,bleeding-hollow,576,shaman,restoration,12,6,6
Echoelements,tichondrius,576,shaman,restoration,12,6,6
Bravezf,tichondrius,576,shaman,restoration,12,6,6
Jimmybutler,tichondrius,576,shaman,restoration,12,6,6
Lavawurst,tichondrius,576,shaman,restoration,12,6,6
Deevviouss,barthilas,576,shaman,restoration,12,6,6
Caprise,tichondrius,576,shaman,restoration,12,6,6
Atsukaia,tichondrius,576,shaman,restoration,12,6,6
Brotem,barthilas,576,shaman,restoration,15,7,8
Goodzilla,aegwynn,576,shaman,restoration,18,6,12
Rubmytiki,skywall,576,shaman,restoration,18,6,12
Heysteptotem,tichondrius,576,shaman,restoration,18,6,12
Dhalishama,thrall,576,shaman,restoration,18,6,12
Shäman,anetheron,576,shaman,restoration,18,6,12
Aiyinsitan,illidan,576,shaman,restoration,18,6,12
Shockandmaul,tichondrius,576,shaman,restoration,18,6,12
Sheeno,blackrock,576,shaman,restoration,18,6,12
Kÿlé,darkspear,576,shaman,restoration,18,6,12
Icehole,kelthuzad,576,shaman,restoration,18,6,12
Zâppý,dalaran,576,shaman,restoration,18,6,12
Adodo,tichondrius,576,shaman,restoration,18,6,12
Oscer,tichondrius,576,shaman,restoration,18,6,12
Greensween,thrall,576,shaman,restoration,19,6,13
Blck,malorne,576,shaman,restoration,23,7,16
Shampowl,jaedenar,576,shaman,restoration,20,6,14
Dukaman,malganis,576,shaman,restoration,24,6,18
Froglok,boulderfist,575,shaman,restoration,6,6,0
Ladash,ragnaros,575,shaman,restoration,12,6,6
Xhod,zuljin,575,shaman,restoration,12,6,6
Thuggliife,frostmourne,575,shaman,restoration,12,6,6
Shamàc,tichondrius,575,shaman,restoration,12,6,6
Râine,stormreaver,575,shaman,restoration,12,6,6
Twistedteas,tichondrius,575,shaman,restoration,12,6,6
Sarevoc,sargeras,575,shaman,restoration,12,6,6
Dylie,tichondrius,575,shaman,restoration,12,6,6
Totescamel,tichondrius,575,shaman,restoration,12,6,6
Gushaman,area-52,575,shaman,restoration,12,6,6
Donojo,zuljin,575,shaman,restoration,12,6,6
Cùìó,barthilas,575,shaman,restoration,12,6,6
Hexegin,kelthuzad,575,shaman,restoration,12,6,6
Tagliatelle,kelthuzad,575,shaman,restoration,15,7,8
Numbreseven,frostmourne,575,shaman,restoration,14,6,8
Ragnarüz,ragnaros,575,shaman,restoration,19,7,12
Fouroclock,drakthul,575,shaman,restoration,18,6,12
Girafasuarx,korgath,575,shaman,restoration,18,6,12
Loec,thrall,575,shaman,restoration,18,6,12
Deunan,ragnaros,575,shaman,restoration,18,6,12
Martabakasin,frostmourne,575,shaman,restoration,24,6,18
Shamncheddar,bleeding-hollow,575,shaman,restoration,24,6,18
Shyeahmon,drenden,574,shaman,restoration,12,6,6
Sweatysheet,emerald-dream,574,shaman,restoration,12,6,6
Killerphreak,mannoroth,574,shaman,restoration,12,6,6
Luciuzz,tichondrius,574,shaman,restoration,12,6,6
Snowship,sargeras,574,shaman,restoration,12,6,6
Kunshíí,bleeding-hollow,574,shaman,restoration,15,6,9
Topazlight,thrall,574,shaman,restoration,18,6,12
Camdoc,destromath,574,shaman,restoration,18,6,12
Naishi,mannoroth,573,shaman,restoration,18,6,12
Ctrlaltelite,burning-blade,573,shaman,restoration,18,6,12
Monspiett,azralon,573,shaman,restoration,18,6,12
Spookyosa,dalaran,573,shaman,restoration,36,6,30
Jibberp,tichondrius,572,shaman,restoration,12,6,6
Fogden,alleria,572,shaman,restoration,12,6,6
Killuminatti,nathrezim,572,shaman,restoration,18,6,12
Teebob,hyjal,572,shaman,restoration,18,6,12
Bombsb,tichondrius,572,shaman,restoration,18,6,12
Gimlyman,madoran,567,shaman,restoration,12,6,6
Trustfall,rexxar,566,shaman,restoration,12,6,6
Bloodmoôn,frostmourne,566,shaman,restoration,18,6,12
Kàmï,illidan,559,shaman,restoration,11,6,5
Betterthanya,tichondrius,544,shaman,restoration,10,7,3
Reddleman,stormrage,544,shaman,restoration,22,6,16
Earthnsky,bleeding-hollow,543,shaman,restoration,11,6,5
Brogetic,cenarius,543,shaman,restoration,11,6,5
Saviørkai,barthilas,543,shaman,restoration,14,7,7
Tsunamic,sargeras,528,shaman,restoration,15,6,9
Cornroll,tichondrius,527,shaman,restoration,11,6,5
Thetotemtaco,tichondrius,527,shaman,restoration,11,6,5
Galaxiya,blackhand,525,shaman,restoration,21,7,14
Shamyshame,quelthalas,522,shaman,restoration,12,7,5
Xändra,ragnaros,521,shaman,restoration,18,7,11
Vsvs,tichondrius,521,shaman,restoration,22,7,15
Tyealer,frostwolf,518,shaman,restoration,13,7,6
Gohral,wyrmrest-accord,512,shaman,restoration,16,6,10
Fengfeism,tichondrius,511,shaman,restoration,14,6,8
Watoos,area-52,511,shaman,restoration,20,6,14
Shamining,illidan,510,shaman,restoration,8,6,2
Haldeir,frostmourne,510,shaman,restoration,17,6,11
Rikswordfire,wyrmrest-accord,509,shaman,restoration,16,6,10
Cantshear,zuljin,480,shaman,restoration,6,5,1
Binestein,tichondrius,480,shaman,restoration,6,5,1
Mahevagodx,ragnaros,480,shaman,restoration,6,5,1
Cheddatotz,illidan,480,shaman,restoration,6,5,1
Oopy,icecrown,480,shaman,restoration,6,5,1
Msool,tichondrius,480,shaman,restoration,6,5,1
Çhïcagø,aegwynn,480,shaman,restoration,6,5,1
Fastaslight,bleeding-hollow,480,shaman,restoration,6,5,1
Oprawinfuryy,thrall,480,shaman,restoration,6,5,1
Nuggsfxce,frostmourne,480,shaman,restoration,6,5,1
Bluepenguin,kelthuzad,480,shaman,restoration,6,5,1
Banshaman,tichondrius,480,shaman,restoration,6,5,1
Hellstabbers,lightbringer,480,shaman,restoration,6,5,1
Binishaman,tichondrius,480,shaman,restoration,6,5,1
Reèzx,illidan,480,shaman,restoration,6,5,1
Blueclass,akama,480,shaman,restoration,6,5,1
Esterosa,tichondrius,480,shaman,restoration,6,5,1
Crowingraven,queldorei,480,shaman,restoration,6,5,1
Alasierg,stonemaul,480,shaman,restoration,6,5,1
Shamamsx,illidan,480,shaman,restoration,6,5,1
Zêüs,dragonmaw,480,shaman,restoration,6,5,1
Dankestmemes,illidan,480,shaman,restoration,6,5,1
Boogiefever,area-52,480,shaman,restoration,6,5,1
Hexgodx,illidan,480,shaman,restoration,6,5,1
Fidelityfx,sargeras,480,shaman,restoration,12,5,7
Devastian,quelthalas,480,shaman,restoration,12,5,7
Shambuddy,moon-guard,480,shaman,restoration,12,5,7
Lesnar,area-52,480,shaman,restoration,12,5,7
Nathaan,tichondrius,480,shaman,restoration,12,5,7
Baltarian,emerald-dream,480,shaman,restoration,12,5,7
Synkronaqt,tichondrius,480,shaman,restoration,12,5,7
Nagish,alexstrasza,480,shaman,restoration,12,5,7
Shockwall,stormrage,480,shaman,restoration,12,5,7
Sâxman,stormreaver,480,shaman,restoration,12,5,7
Azrlol,illidan,480,shaman,restoration,12,5,7
Astotems,tichondrius,480,shaman,restoration,12,5,7
Dókki,tichondrius,480,shaman,restoration,12,5,7
Vegaslights,tichondrius,480,shaman,restoration,12,5,7
Teftx,area-52,480,shaman,restoration,12,5,7
Bignutters,bleeding-hollow,480,shaman,restoration,12,5,7
Rouzy,area-52,480,shaman,restoration,12,5,7
Masatotem,burning-blade,480,shaman,restoration,12,5,7
Flaggedname,frostmane,480,shaman,restoration,12,5,7
Sixtyninelol,thunderlord,480,shaman,restoration,12,5,7
Weebzealot,kelthuzad,480,shaman,restoration,12,5,7
Sln,bleeding-hollow,480,shaman,restoration,12,5,7
Dyllbat,illidan,480,shaman,restoration,12,5,7
Nizzarrathur,emerald-dream,480,shaman,restoration,12,5,7
Shimta,kiljaeden,480,shaman,restoration,12,5,7
Goresx,tichondrius,480,shaman,restoration,12,5,7
Latoques,quelthalas,480,shaman,restoration,12,5,7
Illmental,kelthuzad,480,shaman,restoration,12,5,7
Daintydan,illidan,480,shaman,restoration,12,5,7
Drcopafeel,stormrage,480,shaman,restoration,12,5,7
Avelmiré,sargeras,480,shaman,restoration,12,5,7
Krupto,tichondrius,480,shaman,restoration,12,5,7
Ongob,kelthuzad,480,shaman,restoration,12,5,7
Tmkaldärýs,tichondrius,480,shaman,restoration,12,5,7
Needneed,tichondrius,480,shaman,restoration,12,5,7
Doop,kiljaeden,480,shaman,restoration,12,5,7
Thonty,sargeras,480,shaman,restoration,12,5,7
Srbski,emerald-dream,480,shaman,restoration,12,5,7
Saw,ghostlands,480,shaman,restoration,12,5,7
Nøzurbo,area-52,480,shaman,restoration,12,5,7
Teestuh,proudmoore,480,shaman,restoration,12,5,7
Stedi,moon-guard,480,shaman,restoration,12,5,7
Tankseven,tichondrius,480,shaman,restoration,12,5,7
Huulu,blades-edge,480,shaman,restoration,12,5,7
Rykkar,kiljaeden,480,shaman,restoration,12,5,7
Xypress,tichondrius,480,shaman,restoration,12,5,7
Larvabust,azralon,480,shaman,restoration,12,5,7
Trizzeh,moon-guard,480,shaman,restoration,12,5,7
Seukstinyne,frostmourne,480,shaman,restoration,12,5,7
Spiritshocks,tichondrius,480,shaman,restoration,12,5,7
Gomeimsoft,magtheridon,480,shaman,restoration,12,5,7
Kaidis,jubeithos,480,shaman,restoration,12,5,7
Totolorraine,tichondrius,480,shaman,restoration,12,5,7
Bröxigâr,tichondrius,480,shaman,restoration,12,5,7
Deyodin,illidan,480,shaman,restoration,12,5,7
Juked,aegwynn,480,shaman,restoration,12,5,7
Simpinbeen,frostmourne,480,shaman,restoration,12,5,7
Jixxerele,malganis,480,shaman,restoration,12,5,7
Kergan,fenris,480,shaman,restoration,12,5,7
Tingletotem,tichondrius,480,shaman,restoration,12,5,7
Nøir,drakkari,480,shaman,restoration,12,5,7
Kupnicki,zuljin,480,shaman,restoration,12,5,7
Hijodelrayo,drakkari,480,shaman,restoration,12,5,7
Derbain,caelestrasz,480,shaman,restoration,12,5,7
Scrumbum,tichondrius,480,shaman,restoration,16,6,10
Zezlek,malganis,480,shaman,restoration,18,5,13
Animac,bleeding-hollow,480,shaman,restoration,18,5,13
Stoompz,kiljaeden,480,shaman,restoration,18,5,13
Andiamo,deathwing,480,shaman,restoration,18,5,13
Decm,area-52,480,shaman,restoration,18,5,13
Krisu,kelthuzad,480,shaman,restoration,18,5,13
Oilburner,malganis,480,shaman,restoration,18,5,13
Noveske,arthas,480,shaman,restoration,18,5,13
Tehbeast,khadgar,480,shaman,restoration,24,5,19
Danimalls,stormrage,479,shaman,restoration,6,5,1
Terrusguard,thrall,479,shaman,restoration,6,5,1
Greenberry,bonechewer,479,shaman,restoration,10,6,4
Gagonmatotem,skullcrusher,479,shaman,restoration,9,5,4
Beardsworth,emerald-dream,479,shaman,restoration,12,5,7
Welled,area-52,479,shaman,restoration,12,5,7
Highmountain,tichondrius,479,shaman,restoration,12,5,7
Øliverxd,lightbringer,479,shaman,restoration,12,5,7
Kamehamekazi,blackhand,479,shaman,restoration,12,5,7
Estheriea,moon-guard,479,shaman,restoration,12,5,7
Tattoö,elune,479,shaman,restoration,12,5,7
Maczo,kiljaeden,479,shaman,restoration,12,5,7
Aimsely,area-52,479,shaman,restoration,12,5,7
Killonsight,tichondrius,479,shaman,restoration,12,5,7
Sâvage,zuljin,479,shaman,restoration,12,5,7
Arastour,bronzebeard,479,shaman,restoration,12,5,7
Yngvii,tichondrius,479,shaman,restoration,12,5,7
Blkpowerfist,malganis,479,shaman,restoration,12,5,7
Bayonett,wyrmrest-accord,479,shaman,restoration,12,5,7
Piaopiao,skywall,479,shaman,restoration,12,5,7
Uncleg,frostmourne,479,shaman,restoration,12,5,7
Bobaflexqt,korgath,479,shaman,restoration,12,5,7
Drmundo,icecrown,479,shaman,restoration,12,5,7
Smearedbeard,bleeding-hollow,479,shaman,restoration,18,5,13
Beanshammy,stormrage,479,shaman,restoration,18,5,13
Nytestalker,sargeras,479,shaman,restoration,18,5,13
Guronna,arthas,479,shaman,restoration,18,5,13
Haymaker,bleeding-hollow,479,shaman,restoration,24,5,19
Typo,skullcrusher,478,shaman,restoration,6,5,1
Grubbyy,tichondrius,478,shaman,restoration,13,6,7
Samac,ravencrest,478,shaman,restoration,12,5,7
Oregano,korgath,478,shaman,restoration,12,5,7
Stahlye,proudmoore,477,shaman,restoration,6,5,1
Lysergicacid,proudmoore,477,shaman,restoration,6,5,1
Timprecu,azralon,477,shaman,restoration,12,5,7
Furyshock,tichondrius,477,shaman,restoration,18,5,13
Vazan,arthas,476,shaman,restoration,12,5,7
Healcacatoi,zuljin,475,shaman,restoration,12,5,7
Pileef,thrall,473,shaman,restoration,13,7,6
Uderlol,tichondrius,448,shaman,restoration,10,5,5
Brocklee,farstriders,447,shaman,restoration,16,5,11
Lequandarius,sargeras,447,shaman,restoration,17,5,12
Akhae,duskwood,445,shaman,restoration,14,6,8
Shocktopus,emerald-dream,442,shaman,restoration,22,12,10
Sidnii,tichondrius,432,shaman,restoration,9,5,4
Voltzwagon,vashj,431,shaman,restoration,9,6,3
Lampstand,wildhammer,431,shaman,restoration,11,5,6
Zelzus,moon-guard,431,shaman,restoration,11,5,6
Rensel,drakkari,429,shaman,restoration,17,5,12
Littleshasha,tichondrius,426,shaman,restoration,15,6,9
Swampy,tanaris,426,shaman,restoration,15,6,9
Ggezlmao,bleeding-hollow,426,shaman,restoration,16,6,10
Drowsbad,tichondrius,426,shaman,restoration,22,7,15
Zio,akama,425,shaman,restoration,14,6,8
Thelôpen,tichondrius,425,shaman,restoration,23,7,16
Hannibol,tichondrius,416,shaman,restoration,10,5,5
Shockjoy,malganis,415,shaman,restoration,11,5,6
Chûnk,tichondrius,400,shaman,restoration,13,5,8
Clapton,darkspear,400,shaman,restoration,19,5,14
Thua,moon-guard,384,shaman,restoration,6,4,2
Phado,tichondrius,384,shaman,restoration,6,4,2
Excaliburumb,tichondrius,384,shaman,restoration,6,4,2
Telnos,emerald-dream,384,shaman,restoration,6,4,2
Intravz,tichondrius,384,shaman,restoration,6,4,2
Shiriloster,ragnaros,384,shaman,restoration,6,4,2
Djbluex,tichondrius,384,shaman,restoration,6,4,2
Xiaoya,tichondrius,384,shaman,restoration,6,4,2
Xraiduh,area-52,384,shaman,restoration,6,4,2
Famikzmeypro,stormrage,384,shaman,restoration,6,4,2
Elrik,khadgar,384,shaman,restoration,6,4,2
Nepshock,stormrage,384,shaman,restoration,6,4,2
Castia,sargeras,384,shaman,restoration,6,4,2
Wecookin,frostwolf,384,shaman,restoration,6,4,2
Wìnì,dalaran,384,shaman,restoration,6,4,2
Tyshaman,sargeras,384,shaman,restoration,6,4,2
Gotmolk,illidan,384,shaman,restoration,6,4,2
Smeeza,frostmourne,384,shaman,restoration,6,4,2
Ârtík,tichondrius,384,shaman,restoration,6,4,2
Éarl,sargeras,384,shaman,restoration,6,4,2
Skumnasty,tichondrius,384,shaman,restoration,6,4,2
Notretro,uldum,384,shaman,restoration,6,4,2
Aletcheoddox,sargeras,384,shaman,restoration,6,4,2
Bhann,tichondrius,384,shaman,restoration,6,4,2
Xillicit,sargeras,384,shaman,restoration,6,4,2
Kaîowas,malganis,384,shaman,restoration,6,4,2
Bigboorst,kelthuzad,384,shaman,restoration,6,4,2
Shamankofwa,tichondrius,384,shaman,restoration,6,4,2
Shearhands,illidan,384,shaman,restoration,6,4,2
Blazedblue,tichondrius,384,shaman,restoration,6,4,2
Dînk,stormrage,384,shaman,restoration,6,4,2
Aeølus,tichondrius,384,shaman,restoration,6,4,2
Príde,ragnaros,384,shaman,restoration,6,4,2
Shöckäzulu,nazgrel,384,shaman,restoration,6,4,2
Sacroshaman,frostmourne,384,shaman,restoration,6,4,2
Rhox,azralon,384,shaman,restoration,6,4,2
Tisaa,tichondrius,384,shaman,restoration,6,4,2
Drackmon,illidan,384,shaman,restoration,6,4,2
Gumballin,sargeras,384,shaman,restoration,8,4,4
Pomelol,tichondrius,384,shaman,restoration,12,4,8
Babbz,sargeras,384,shaman,restoration,12,4,8
Twiztedwayz,tichondrius,384,shaman,restoration,12,4,8
Saksa,garrosh,384,shaman,restoration,12,4,8
Grüncks,azralon,384,shaman,restoration,12,4,8
Belazeus,tichondrius,384,shaman,restoration,12,4,8
Misakism,sargeras,384,shaman,restoration,12,4,8
Trölencio,quelthalas,384,shaman,restoration,12,4,8
Dallìa,tichondrius,384,shaman,restoration,12,4,8
Shâmbulance,hyjal,384,shaman,restoration,12,4,8
Gbe,tichondrius,384,shaman,restoration,12,4,8
Smashyz,nerzhul,384,shaman,restoration,12,4,8
Ngentotem,frostmourne,384,shaman,restoration,12,4,8
Dikedwarf,burning-blade,384,shaman,restoration,12,4,8
Eternaltotem,darkspear,384,shaman,restoration,12,4,8
Inhale,sargeras,384,shaman,restoration,12,4,8
Lixir,destromath,384,shaman,restoration,12,4,8
Naturasol,quelthalas,384,shaman,restoration,12,4,8
Toobeastly,deathwing,384,shaman,restoration,12,4,8
Dankprotein,tichondrius,384,shaman,restoration,12,4,8
Ciroc,sargeras,384,shaman,restoration,12,4,8
Juraf,malganis,384,shaman,restoration,12,4,8
Flexi,senjin,384,shaman,restoration,12,4,8
Healswin,sargeras,384,shaman,restoration,12,4,8
Yggiz,stormrage,384,shaman,restoration,12,4,8
Naturelover,mugthol,384,shaman,restoration,12,4,8
Rabajood,korgath,384,shaman,restoration,12,4,8
Ayev,illidan,384,shaman,restoration,12,4,8
Boyyo,maiev,384,shaman,restoration,12,4,8
Geontha,drakkari,384,shaman,restoration,12,4,8
Bayslaps,tichondrius,384,shaman,restoration,12,4,8
Spokytv,azralon,384,shaman,restoration,12,4,8
Cgq,tichondrius,384,shaman,restoration,12,4,8
Celements,malganis,384,shaman,restoration,12,4,8
Porkbrains,emerald-dream,384,shaman,restoration,16,5,11
Kezzër,azralon,384,shaman,restoration,16,4,12
Conductivity,frostmourne,384,shaman,restoration,18,4,14
Kermut,frostmourne,384,shaman,restoration,18,4,14
Djoko,tichondrius,384,shaman,restoration,18,4,14
Sèrb,mugthol,384,shaman,restoration,19,4,15
Ilion,nemesis,383,shaman,restoration,6,4,2
Rockyisback,illidan,383,shaman,restoration,6,4,2
Hexnation,frostmourne,383,shaman,restoration,6,4,2
Bøx,ragnaros,383,shaman,restoration,6,4,2
Ozsham,burning-blade,383,shaman,restoration,8,4,4
Snowtem,moonrunner,383,shaman,restoration,12,5,7
Shamamanana,staghelm,383,shaman,restoration,12,4,8
Huugsnkissez,sargeras,383,shaman,restoration,12,4,8
Zìfu,darkspear,383,shaman,restoration,12,4,8
Herteitr,blood-furnace,383,shaman,restoration,12,4,8
Surgetankian,malorne,383,shaman,restoration,12,4,8
Sndtome,tichondrius,383,shaman,restoration,12,4,8
Ânûbis,sargeras,383,shaman,restoration,12,4,8
Tandarin,burning-legion,383,shaman,restoration,12,4,8
Gaboola,tichondrius,383,shaman,restoration,12,4,8
Foogus,tichondrius,383,shaman,restoration,12,4,8
Akharis,frostmane,383,shaman,restoration,21,5,16
Huukron,emerald-dream,382,shaman,restoration,12,4,8
Caulkshock,tichondrius,382,shaman,restoration,12,4,8
Turbö,hyjal,382,shaman,restoration,12,4,8
Shockshow,zuljin,382,shaman,restoration,12,4,8
Chamorro,quelthalas,382,shaman,restoration,18,4,14
Laveidem,frostmourne,382,shaman,restoration,18,4,14
Valien,kiljaeden,381,shaman,restoration,12,4,8
Bubmack,tichondrius,379,shaman,restoration,12,4,8
Andrewot,aerie-peak,378,shaman,restoration,29,4,25
Alwinaa,kiljaeden,367,shaman,restoration,11,4,7
Flavortrash,the-underbog,367,shaman,restoration,11,4,7
Pche,tichondrius,367,shaman,restoration,11,4,7
Aceventuura,hyjal,352,shaman,restoration,22,4,18
Shamanakin,emerald-dream,351,shaman,restoration,8,5,3
Bunnyele,tichondrius,351,shaman,restoration,17,4,13
Avidas,malganis,331,shaman,restoration,15,4,11
Vudu,terokkar,330,shaman,restoration,13,5,8
Hitchsláp,tichondrius,330,shaman,restoration,16,5,11
Intress,moon-guard,329,shaman,restoration,10,6,4
Záika,sargeras,318,shaman,restoration,10,4,6
Elevatezxo,stormrage,304,shaman,restoration,7,4,3
Shomon,khazgoroth,288,shaman,restoration,6,3,3
Gunx,darkspear,288,shaman,restoration,6,3,3
Drwsham,ragnaros,288,shaman,restoration,6,3,3
Forloren,zuljin,288,shaman,restoration,6,3,3
Nondracil,ragnaros,288,shaman,restoration,6,3,3
Shomminn,tichondrius,288,shaman,restoration,6,3,3
Pressyocds,darkspear,288,shaman,restoration,6,3,3
Puntress,barthilas,288,shaman,restoration,6,3,3
Sumyl,ragnaros,288,shaman,restoration,6,3,3
Zoltide,sargeras,288,shaman,restoration,6,3,3
Hungy,wyrmrest-accord,288,shaman,restoration,6,3,3
Millkmachine,daggerspine,288,shaman,restoration,6,3,3
Xxamba,tichondrius,288,shaman,restoration,6,3,3
Goongoon,zuljin,288,shaman,restoration,6,3,3
Nyroh,zuljin,288,shaman,restoration,6,3,3
Beatsmaker,tichondrius,288,shaman,restoration,6,3,3
Pôpamolly,saurfang,288,shaman,restoration,6,3,3
Vitchzestein,ragnaros,288,shaman,restoration,6,3,3
Youngie,dathremar,288,shaman,restoration,6,3,3
Floods,frostmourne,288,shaman,restoration,6,3,3
Megafin,tichondrius,288,shaman,restoration,6,3,3
Bigbadpercy,frostmourne,288,shaman,restoration,6,3,3
Smackzs,sargeras,288,shaman,restoration,6,3,3
Gucciblunts,sargeras,288,shaman,restoration,6,3,3
Maana,dragonmaw,288,shaman,restoration,6,3,3
Cloudycloud,tichondrius,288,shaman,restoration,6,3,3
Jupider,nathrezim,288,shaman,restoration,6,3,3
Snowkingx,illidan,288,shaman,restoration,6,3,3
Owoken,illidan,288,shaman,restoration,6,3,3
Megadabs,malganis,288,shaman,restoration,6,3,3
Shammich,vashj,288,shaman,restoration,6,3,3
Totumstroker,thrall,288,shaman,restoration,6,3,3
Moonrider,nerzhul,288,shaman,restoration,6,3,3
Rollînçoàl,malganis,288,shaman,restoration,6,3,3
Uthprotekta,daggerspine,288,shaman,restoration,6,3,3
Skrubbles,bleeding-hollow,288,shaman,restoration,6,3,3
Stymiedxs,zuljin,288,shaman,restoration,6,3,3
Solitarysham,moon-guard,288,shaman,restoration,6,3,3
Headcrackx,sargeras,288,shaman,restoration,6,3,3
Electriqt,barthilas,288,shaman,restoration,6,3,3
Herpeaz,kelthuzad,288,shaman,restoration,6,3,3
Eleresto,tichondrius,288,shaman,restoration,6,3,3
Mítchconnor,tichondrius,288,shaman,restoration,6,3,3
Sreve,malganis,288,shaman,restoration,6,3,3
Sumdumshaman,illidan,288,shaman,restoration,6,3,3
Fruityrudyy,area-52,288,shaman,restoration,6,3,3
Teladoy,kelthuzad,288,shaman,restoration,6,3,3
Ñoobshaman,tichondrius,288,shaman,restoration,6,3,3
Fwap,bleeding-hollow,288,shaman,restoration,6,3,3
Voron,kiljaeden,288,shaman,restoration,6,3,3
Cowboydans,malganis,288,shaman,restoration,6,3,3
Memetide,daggerspine,288,shaman,restoration,6,3,3
Rakkasham,blackrock,288,shaman,restoration,6,3,3
Laucian,malganis,288,shaman,restoration,6,3,3
Akupapu,illidan,288,shaman,restoration,6,3,3
Siox,zuljin,288,shaman,restoration,6,3,3
Kanntok,quelthalas,288,shaman,restoration,6,3,3
Chocothicc,bleeding-hollow,288,shaman,restoration,6,3,3
Meatboi,khaz-modan,288,shaman,restoration,6,3,3
Jubie,proudmoore,288,shaman,restoration,6,3,3
Spencêrf,illidan,288,shaman,restoration,6,3,3
Nüt,wyrmrest-accord,288,shaman,restoration,6,3,3
Ililiiïiili,tichondrius,288,shaman,restoration,6,3,3
Wolfguts,thrall,288,shaman,restoration,6,3,3
Phinoi,tichondrius,288,shaman,restoration,6,3,3
Totemtots,illidan,288,shaman,restoration,6,3,3
Digglr,tichondrius,288,shaman,restoration,6,3,3
Daggonet,sargeras,288,shaman,restoration,6,3,3
Catnïp,maelstrom,288,shaman,restoration,6,3,3
Dwarfers,emerald-dream,288,shaman,restoration,6,3,3
Yunqboichay,kelthuzad,288,shaman,restoration,6,3,3
Danyax,malganis,288,shaman,restoration,6,3,3
Taproots,ursin,288,shaman,restoration,6,3,3
Shearx,illidan,288,shaman,restoration,6,3,3
Sonsii,tichondrius,288,shaman,restoration,6,3,3
Soloqstayer,tichondrius,288,shaman,restoration,6,3,3
Fete,malganis,288,shaman,restoration,6,3,3
Dimitrio,azralon,288,shaman,restoration,6,3,3
Cloudsh,silvermoon,288,shaman,restoration,6,3,3
Justdeadman,tichondrius,288,shaman,restoration,6,3,3
Zaios,area-52,288,shaman,restoration,6,3,3
Dyxlol,tichondrius,288,shaman,restoration,6,3,3
Squog,sargeras,288,shaman,restoration,6,3,3
Drwaters,lightnings-blade,288,shaman,restoration,6,3,3
Stormshadowx,proudmoore,288,shaman,restoration,6,3,3
Naughtylol,malganis,288,shaman,restoration,6,3,3
Shoota,tichondrius,288,shaman,restoration,6,3,3
Squidazzle,tichondrius,288,shaman,restoration,8,3,5
Ðrunkentotem,tichondrius,288,shaman,restoration,11,4,7
Rebelutioni,lothar,288,shaman,restoration,11,3,8
Malthor,terenas,288,shaman,restoration,12,3,9
Jumpc,ragnaros,288,shaman,restoration,12,3,9
Zéwel,tichondrius,288,shaman,restoration,12,3,9
Moresbythicc,frostmourne,288,shaman,restoration,12,3,9
Bobthashaman,tichondrius,288,shaman,restoration,12,3,9
Strawberryz,sargeras,288,shaman,restoration,12,3,9
Plaboii,magtheridon,288,shaman,restoration,12,3,9
Trysts,wyrmrest-accord,288,shaman,restoration,12,3,9
Cheefgrief,shadowsong,288,shaman,restoration,12,3,9
Equinsuochha,silvermoon,288,shaman,restoration,12,3,9
Shamle,azuremyst,288,shaman,restoration,12,3,9
Sooweecide,tichondrius,288,shaman,restoration,12,3,9
Liltex,malganis,288,shaman,restoration,12,3,9
Emaric,sargeras,288,shaman,restoration,12,3,9
Chocobomb,burning-blade,288,shaman,restoration,12,3,9
Makogo,earthen-ring,288,shaman,restoration,12,3,9
Mochomò,ragnaros,288,shaman,restoration,12,3,9
Juggerr,thunderlord,288,shaman,restoration,12,3,9
Calliope,burning-legion,288,shaman,restoration,12,3,9
Mondaymood,illidan,288,shaman,restoration,12,3,9
Sliccricc,doomhammer,288,shaman,restoration,12,3,9
Bovinefever,kiljaeden,288,shaman,restoration,12,3,9
Oomme,area-52,288,shaman,restoration,12,3,9
Meatyball,tichondrius,288,shaman,restoration,12,3,9
Malenhncemnt,illidan,288,shaman,restoration,12,3,9
Atmospheric,frostmourne,288,shaman,restoration,12,3,9
Shockathot,stormrage,288,shaman,restoration,12,3,9
Scion,thaurissan,288,shaman,restoration,12,3,9
Karratquake,sargeras,288,shaman,restoration,12,3,9
Showkinho,azralon,288,shaman,restoration,12,3,9
Semasham,khazgoroth,288,shaman,restoration,12,3,9
Shamonalisa,altar-of-storms,288,shaman,restoration,12,3,9
Stornbreiker,thrall,288,shaman,restoration,12,3,9
Adosistoxic,zuljin,288,shaman,restoration,14,3,11
Boodaa,stormscale,288,shaman,restoration,18,3,15
Trøuble,deathwing,288,shaman,restoration,18,3,15
Trovac,azralon,287,shaman,restoration,6,3,3
Thean,wyrmrest-accord,287,shaman,restoration,6,3,3
Altryn,shuhalo,287,shaman,restoration,6,3,3
Lïet,quelthalas,287,shaman,restoration,12,3,9
Heatexchange,burning-blade,287,shaman,restoration,12,3,9
Alagorn,icecrown,287,shaman,restoration,12,3,9
Grimnur,bleeding-hollow,287,shaman,restoration,12,3,9
Nottoshammy,dalaran,287,shaman,restoration,12,3,9
Criticalthry,garrosh,287,shaman,restoration,12,3,9
Hawpch,area-52,287,shaman,restoration,19,3,16
Riverrun,shattered-halls,287,shaman,restoration,24,3,21
Garurt,daggerspine,286,shaman,restoration,12,6,6
Kider,drakkari,286,shaman,restoration,6,3,3
Ranek,shuhalo,286,shaman,restoration,6,3,3
Tarlonygg,malganis,281,shaman,restoration,15,6,9
Eloquent,emerald-dream,273,shaman,restoration,19,6,13
Dmoneyswag,illidan,255,shaman,restoration,11,3,8
Hilung,lightnings-blade,255,shaman,restoration,11,3,8
Shamanship,haomarush,239,shaman,restoration,5,3,2
Lickerman,stormreaver,239,shaman,restoration,5,3,2
Hurky,sargeras,239,shaman,restoration,5,3,2
Shåmwiches,tichondrius,234,shaman,restoration,8,4,4
Båndø,tichondrius,234,shaman,restoration,9,4,5
Succies,emerald-dream,234,shaman,restoration,16,4,12
Bigripnow,sargeras,234,shaman,restoration,20,4,16
Tokelahoma,stormrage,234,shaman,restoration,22,4,18
Bigbone,laughing-skull,192,shaman,restoration,9,3,6
Kshock,hyjal,192,shaman,restoration,6,2,4
Jurafxdqt,malganis,192,shaman,restoration,6,2,4
Twistër,illidan,192,shaman,restoration,6,2,4
Sid,frostmourne,192,shaman,restoration,6,2,4
Thunderbleem,hyjal,192,shaman,restoration,6,2,4
Notviscent,illidan,192,shaman,restoration,6,2,4
Rockøh,tichondrius,192,shaman,restoration,6,2,4
Guabanva,wyrmrest-accord,192,shaman,restoration,6,2,4
Fanatix,moon-guard,192,shaman,restoration,6,2,4
Ghostrida,blackrock,192,shaman,restoration,6,2,4
Chainandrain,frostmourne,192,shaman,restoration,6,2,4
Sheems,shadowmoon,192,shaman,restoration,6,2,4
Chungxs,illidan,192,shaman,restoration,6,2,4
Stormwalk,ragnaros,192,shaman,restoration,6,2,4
Mangeegee,malganis,192,shaman,restoration,6,2,4
Kumboi,frostmourne,192,shaman,restoration,6,2,4
Griph,shattered-hand,192,shaman,restoration,6,2,4
Thefurrybox,tichondrius,192,shaman,restoration,6,2,4
Nbax,tichondrius,192,shaman,restoration,6,2,4
Cheesepufs,illidan,192,shaman,restoration,6,2,4
Gwenstifani,sargeras,192,shaman,restoration,6,2,4
Keldara,aerie-peak,192,shaman,restoration,6,2,4
Duality,shattered-halls,192,shaman,restoration,6,2,4
Cvoa,bonechewer,192,shaman,restoration,6,2,4
Aishel,area-52,192,shaman,restoration,6,2,4
Blackaxe,wyrmrest-accord,192,shaman,restoration,6,2,4
Legomyleg,tichondrius,192,shaman,restoration,6,2,4
Cpkzlol,tichondrius,192,shaman,restoration,6,2,4
Alexxspurge,ragnaros,192,shaman,restoration,6,2,4
Gagging,gundrak,192,shaman,restoration,6,2,4
Shikane,hyjal,192,shaman,restoration,6,2,4
Lolcàt,tichondrius,192,shaman,restoration,6,2,4
Dylangs,frostmourne,192,shaman,restoration,6,2,4
Monkeysauce,tichondrius,192,shaman,restoration,6,2,4
Googurt,barthilas,192,shaman,restoration,6,2,4
Khidea,barthilas,192,shaman,restoration,6,2,4
Pandl,frostmourne,192,shaman,restoration,6,2,4
Aderra,garrosh,192,shaman,restoration,6,2,4
Mjxholland,aegwynn,192,shaman,restoration,6,2,4
Hottesthands,barthilas,192,shaman,restoration,6,2,4
Boohoo,dethecus,192,shaman,restoration,6,2,4
Lewse,tichondrius,192,shaman,restoration,6,2,4
Snapertun,tichondrius,192,shaman,restoration,6,2,4
Healyourself,sargeras,192,shaman,restoration,6,2,4
Halfzugzug,sargeras,192,shaman,restoration,6,2,4
Shamsky,tichondrius,192,shaman,restoration,6,2,4
Jamarcuss,tichondrius,192,shaman,restoration,6,2,4
Oaken,spirestone,192,shaman,restoration,6,2,4
Shinydiglett,area-52,192,shaman,restoration,6,2,4
Shamansz,stormrage,192,shaman,restoration,6,2,4
Konga,korialstrasz,192,shaman,restoration,6,2,4
Eye,kelthuzad,192,shaman,restoration,6,2,4
Lakeshow,tichondrius,192,shaman,restoration,6,2,4
Ezeya,area-52,192,shaman,restoration,6,2,4
Zhangyider,illidan,192,shaman,restoration,6,2,4
Hellfiresham,kiljaeden,192,shaman,restoration,6,2,4
Bon,ravencrest,192,shaman,restoration,6,2,4
Karnnages,cenarion-circle,192,shaman,restoration,6,2,4
Cawlin,stormrage,192,shaman,restoration,6,2,4
Magwølfe,area-52,192,shaman,restoration,6,2,4
Toketime,thrall,192,shaman,restoration,6,2,4
Plutoshaker,tichondrius,192,shaman,restoration,6,2,4
Nxboy,proudmoore,192,shaman,restoration,6,2,4
Totemzlol,sargeras,192,shaman,restoration,6,2,4
Hughwang,kelthuzad,192,shaman,restoration,6,2,4
Mauiiei,sargeras,192,shaman,restoration,6,2,4
Raxxom,tichondrius,192,shaman,restoration,6,2,4
Splewtsham,thrall,192,shaman,restoration,6,2,4
Dabrat,lightnings-blade,192,shaman,restoration,6,2,4
Relâx,icecrown,192,shaman,restoration,6,2,4
Ioki,spirestone,192,shaman,restoration,6,2,4
Thundertusks,norgannon,192,shaman,restoration,6,2,4
Firesurge,sargeras,192,shaman,restoration,6,2,4
Zugzugpurge,thrall,192,shaman,restoration,6,2,4
Timbosteve,thrall,192,shaman,restoration,6,2,4
Suspend,gorgonnash,192,shaman,restoration,9,2,7
Kitanoo,kiljaeden,192,shaman,restoration,12,2,10
Bizzy,black-dragonflight,192,shaman,restoration,12,2,10
Lomínark,stormrage,192,shaman,restoration,12,2,10
Paveron,stormrage,192,shaman,restoration,12,2,10
Aoiiro,dentarg,192,shaman,restoration,12,2,10
Rhaksh,sargeras,192,shaman,restoration,12,2,10
Saithô,quelthalas,192,shaman,restoration,12,2,10
Wasiri,illidan,192,shaman,restoration,12,2,10
Kumquat,draka,192,shaman,restoration,12,2,10
Raisongreen,tichondrius,192,shaman,restoration,12,2,10
Danila,blackrock,192,shaman,restoration,12,2,10
Soomer,frostmourne,192,shaman,restoration,12,2,10
Skingreen,nemesis,192,shaman,restoration,12,2,10
Birdizdawerd,shuhalo,192,shaman,restoration,12,2,10
Actios,stormrage,192,shaman,restoration,12,2,10
Ara,zuljin,192,shaman,restoration,12,2,10
Awool,lightbringer,192,shaman,restoration,12,2,10
Rueem,area-52,192,shaman,restoration,12,2,10
Elva,malganis,192,shaman,restoration,12,2,10
Sharish,mannoroth,192,shaman,restoration,12,2,10
Wolpfh,area-52,192,shaman,restoration,12,2,10
Monchsham,area-52,192,shaman,restoration,13,2,11
Schmutz,emerald-dream,192,shaman,restoration,18,2,16
Bootsix,area-52,192,shaman,restoration,18,2,16
Kicksave,illidan,192,shaman,restoration,18,2,16
Doctermoo,daggerspine,192,shaman,restoration,28,3,25
Roogys,emerald-dream,192,shaman,restoration,22,2,20
Thudthudzap,darkspear,191,shaman,restoration,6,2,4
Pwrhouse,ravenholdt,191,shaman,restoration,6,2,4
Machalo,sargeras,191,shaman,restoration,6,2,4
Fóurelements,malganis,191,shaman,restoration,6,2,4
Malsturm,stormrage,191,shaman,restoration,6,2,4
Jammylol,frostmourne,180,shaman,restoration,21,6,15
Ambevsulfr,tichondrius,175,shaman,restoration,11,2,9
Nolij,sargeras,159,shaman,restoration,5,2,3
Restomilk,tichondrius,159,shaman,restoration,5,2,3
Ttvozzyxy,tichondrius,144,shaman,restoration,8,4,4
Stormsanta,emerald-dream,138,shaman,restoration,8,3,5
Waterfaller,tichondrius,138,shaman,restoration,9,3,6
Bigdaddyion,thrall,138,shaman,restoration,9,3,6
Uggerz,barthilas,138,shaman,restoration,9,3,6
Bigbøss,stormrage,138,shaman,restoration,20,3,17
Lyv,stormscale,126,shaman,restoration,25,7,18
Hueymagoo,firetree,112,shaman,restoration,13,2,11
Aricer,proudmoore,112,shaman,restoration,13,2,11
Flêùrs,zuljin,96,shaman,restoration,3,2,1
Downerr,malganis,96,shaman,restoration,3,2,1
Jbahr,hyjal,96,shaman,restoration,3,2,1
Shamtoots,aerie-peak,96,shaman,restoration,9,2,7
Drzeuss,illidan,96,shaman,restoration,6,1,5
Tchamí,blackrock,96,shaman,restoration,6,1,5
Mufflër,the-venture-co,96,shaman,restoration,6,1,5
Crassian,illidan,96,shaman,restoration,6,1,5
Babehmakr,lightnings-blade,96,shaman,restoration,6,1,5
Célty,moon-guard,96,shaman,restoration,6,1,5
Sleepysham,anubarak,96,shaman,restoration,6,1,5
Sshhammann,tichondrius,96,shaman,restoration,6,1,5
Ashborn,archimonde,96,shaman,restoration,6,1,5
Slacken,kiljaeden,96,shaman,restoration,6,1,5
Nøtørious,thrall,96,shaman,restoration,6,1,5
Twizzhurp,bleeding-hollow,96,shaman,restoration,6,1,5
Daiablo,barthilas,96,shaman,restoration,6,1,5
Erii,undermine,96,shaman,restoration,6,1,5
Stickshaman,sargeras,96,shaman,restoration,6,1,5
Shamoover,kelthuzad,96,shaman,restoration,6,1,5
Meramin,illidan,96,shaman,restoration,6,1,5
Thenewsherek,maelstrom,96,shaman,restoration,6,1,5
Kwaztotem,area-52,96,shaman,restoration,6,1,5
Zorg,area-52,96,shaman,restoration,6,1,5
Galiffa,area-52,96,shaman,restoration,6,1,5
Phéônîxgodx,zuljin,96,shaman,restoration,6,1,5
Milkyduds,area-52,96,shaman,restoration,6,1,5
Dasckisham,area-52,96,shaman,restoration,6,1,5
Toyletpaper,mugthol,96,shaman,restoration,6,1,5
Tofuji,barthilas,96,shaman,restoration,6,1,5
Movemaker,shattered-hand,96,shaman,restoration,6,1,5
Statikrage,eonar,96,shaman,restoration,6,1,5
Shamouranth,barthilas,96,shaman,restoration,6,1,5
Churdoodle,area-52,96,shaman,restoration,6,1,5
Ashamanist,barthilas,96,shaman,restoration,6,1,5
Wannabecdeww,kelthuzad,96,shaman,restoration,6,1,5
Daku,tichondrius,96,shaman,restoration,6,1,5
Asanako,illidan,96,shaman,restoration,6,1,5
Lennylemons,stormrage,96,shaman,restoration,6,1,5
Restoz,thrall,96,shaman,restoration,6,1,5
Yggd,zuljin,96,shaman,restoration,6,1,5
Yaola,kiljaeden,96,shaman,restoration,6,1,5
Hadèes,zuljin,96,shaman,restoration,6,1,5
Eleshamanz,tichondrius,96,shaman,restoration,6,1,5
Ogeez,area-52,96,shaman,restoration,6,1,5
Conflïcted,emerald-dream,96,shaman,restoration,6,1,5
Sharmalama,illidan,96,shaman,restoration,6,1,5
Blmqt,stormrage,96,shaman,restoration,6,1,5
Ddolsx,tichondrius,96,shaman,restoration,6,1,5
Blazinowls,illidan,96,shaman,restoration,6,1,5
Swartzqt,tichondrius,96,shaman,restoration,6,1,5
Teathin,ragnaros,96,shaman,restoration,6,1,5
Restorates,tichondrius,96,shaman,restoration,6,1,5
Meattoilet,tichondrius,96,shaman,restoration,6,1,5
Cyberheler,quelthalas,96,shaman,restoration,6,1,5
Restonomnom,the-underbog,96,shaman,restoration,6,1,5
Goblintrap,area-52,96,shaman,restoration,6,1,5
Gadzêd,kelthuzad,96,shaman,restoration,6,1,5
Vulpyr,ragnaros,96,shaman,restoration,6,1,5
Shambita,azralon,96,shaman,restoration,6,1,5
Cluffatty,tichondrius,96,shaman,restoration,6,1,5
Shapaman,tichondrius,96,shaman,restoration,6,1,5
Guildhealer,darkspear,96,shaman,restoration,6,1,5
Finnaburstt,tichondrius,96,shaman,restoration,6,1,5
Groundfaults,bleeding-hollow,96,shaman,restoration,6,1,5
Average,bonechewer,96,shaman,restoration,6,1,5
Dodey,malganis,96,shaman,restoration,6,1,5
Drgiggleheim,tichondrius,96,shaman,restoration,6,1,5
Totempixie,barthilas,96,shaman,restoration,6,1,5
Calicø,durotan,96,shaman,restoration,7,1,6
Finark,tichondrius,96,shaman,restoration,7,1,6
Jips,illidan,96,shaman,restoration,11,1,10
Lucapapa,tichondrius,96,shaman,restoration,12,1,11
Meatlog,dalaran,96,shaman,restoration,12,1,11
Tinytiddies,chogall,96,shaman,restoration,12,1,11
Njolmir,khazgoroth,96,shaman,restoration,12,1,11
Forzeus,zuluhed,96,shaman,restoration,12,1,11
Hexpert,firetree,96,shaman,restoration,12,1,11
Lór,onyxia,96,shaman,restoration,12,1,11
Latishas,alleria,96,shaman,restoration,18,1,17
Okdopey,area-52,95,shaman,restoration,6,1,5
Lupog,illidan,89,shaman,restoration,8,4,4
Vashidda,stormrage,79,shaman,restoration,5,1,4
Varnol,emerald-dream,79,shaman,restoration,5,1,4
Dirtyshammy,mugthol,79,shaman,restoration,11,1,10
Totèm,tichondrius,64,shaman,restoration,4,1,3
Annöying,ysera,42,shaman,restoration,6,2,4
Applicable,tichondrius,42,shaman,restoration,9,2,7
Hatemønger,medivh,42,shaman,restoration,11,2,9
Ttvozzyxy,tichondrius,2385,shaman,elemental,139,89,50
Bronzer,tichondrius,2325,shaman,elemental,75,53,22
Selenna,tichondrius,2305,shaman,elemental,150,90,60
Ranjeesh,frostmourne,2233,shaman,elemental,174,100,74
Bøøgaa,proudmoore,2215,shaman,elemental,143,78,65
Meatbeaterx,aggramar,2189,shaman,elemental,135,70,65
Itzgucci,illidan,2185,shaman,elemental,86,49,37
Beyoncé,lethon,2181,shaman,elemental,80,45,35
Thegloc,illidan,2168,shaman,elemental,59,36,23
Jimmysporty,malganis,2168,shaman,elemental,90,47,43
Mercs,frostmourne,2159,shaman,elemental,86,50,36
Bøulderfist,tichondrius,2157,shaman,elemental,72,44,28
Crøwgød,tichondrius,2156,shaman,elemental,109,65,44
Khazger,area-52,2150,shaman,elemental,113,65,48
Jgmbs,dalaran,2134,shaman,elemental,106,64,42
Axelsteel,illidan,2132,shaman,elemental,66,45,21
Glochaswon,illidan,2131,shaman,elemental,84,51,33
Hitzz,malganis,2127,shaman,elemental,78,49,29
Jazuul,zuljin,2125,shaman,elemental,72,38,34
Lardaz,darkspear,2118,shaman,elemental,60,37,23
Blmqt,stormrage,2117,shaman,elemental,126,83,43
Jeasham,malganis,2114,shaman,elemental,143,75,68
Billycool,tichondrius,2112,shaman,elemental,66,42,24
Benanderson,tichondrius,2111,shaman,elemental,110,61,49
Zoeytur,sargeras,2107,shaman,elemental,84,45,39
Shiggenbasta,tichondrius,2107,shaman,elemental,119,63,56
Hexecute,tichondrius,2106,shaman,elemental,84,42,42
Hollowbaby,tichondrius,2101,shaman,elemental,73,48,25
Luhz,tichondrius,2081,shaman,elemental,209,102,107
Nanosec,tichondrius,2079,shaman,elemental,94,50,44
Strongele,illidan,2063,shaman,elemental,69,40,29
Kaandel,azralon,2054,shaman,elemental,185,93,92
Missedkick,tichondrius,2050,shaman,elemental,175,103,72
Bronzers,tichondrius,2046,shaman,elemental,54,33,21
Tisaa,tichondrius,2025,shaman,elemental,66,32,34
Orçhid,tichondrius,2020,shaman,elemental,60,42,18
Dxxlol,tichondrius,2013,shaman,elemental,102,59,43
Meatbeaterx,bleeding-hollow,2009,shaman,elemental,72,36,36
Iavalash,bleeding-hollow,1995,shaman,elemental,210,103,107
Pikopiko,tichondrius,1989,shaman,elemental,60,36,24
Trenzix,sargeras,1989,shaman,elemental,196,100,96
Reckfulq,proudmoore,1986,shaman,elemental,137,84,53
Kimkar,bleeding-hollow,1982,shaman,elemental,90,48,42
Yejinok,tichondrius,1982,shaman,elemental,126,66,60
Zipzsham,maiev,1979,shaman,elemental,69,50,19
Manofsand,drenden,1970,shaman,elemental,213,109,104
Mazadu,malganis,1967,shaman,elemental,47,27,20
Joedna,tichondrius,1962,shaman,elemental,118,61,57
Ãmg,tichondrius,1960,shaman,elemental,76,50,26
Chunchünmaru,area-52,1957,shaman,elemental,71,40,31
Boomsele,tichondrius,1952,shaman,elemental,61,42,19
Bakenquake,tichondrius,1947,shaman,elemental,92,48,44
Bujii,frostmourne,1929,shaman,elemental,239,119,120
Foudre,malganis,1925,shaman,elemental,42,27,15
Depression,baelgun,1921,shaman,elemental,84,51,33
Hexxás,bloodscalp,1920,shaman,elemental,68,40,28
Safeword,nesingwary,1919,shaman,elemental,74,42,32
Johnsju,sargeras,1915,shaman,elemental,111,57,54
Tenyks,tichondrius,1913,shaman,elemental,117,67,50
Emppege,tichondrius,1911,shaman,elemental,133,64,69
Geodude,executus,1909,shaman,elemental,53,33,20
Dipilga,proudmoore,1908,shaman,elemental,46,35,11
Elefusion,sargeras,1908,shaman,elemental,42,27,15
Scaman,tichondrius,1903,shaman,elemental,36,23,13
Makazar,tichondrius,1901,shaman,elemental,42,26,16
Funuser,hellscream,1895,shaman,elemental,146,81,65
Ultron,deathwing,1890,shaman,elemental,143,74,69
Zò,zuljin,1890,shaman,elemental,66,32,34
Molbeato,uldum,1888,shaman,elemental,102,51,51
Hedeadxs,illidan,1882,shaman,elemental,60,30,30
Matikz,boulderfist,1878,shaman,elemental,142,78,64
Powerdown,blackrock,1878,shaman,elemental,65,32,33
Tremordrfear,lightbringer,1877,shaman,elemental,30,20,10
Sleepysham,kelthuzad,1877,shaman,elemental,126,67,59
Orksham,tichondrius,1877,shaman,elemental,60,30,30
Tyar,area-52,1876,shaman,elemental,45,31,14
Àspect,aegwynn,1875,shaman,elemental,36,20,16
Sasageyo,tichondrius,1873,shaman,elemental,93,51,42
Zynt,illidan,1870,shaman,elemental,36,23,13
Cùìó,barthilas,1868,shaman,elemental,54,25,29
Zapmavz,area-52,1865,shaman,elemental,89,49,40
Jalgago,tichondrius,1865,shaman,elemental,47,20,27
Fàlç,stormrage,1863,shaman,elemental,54,32,22
Uglytotem,tichondrius,1863,shaman,elemental,59,32,27
Illchayqt,frostmourne,1861,shaman,elemental,65,35,30
Shockay,tichondrius,1861,shaman,elemental,56,30,26
Skkarz,malganis,1858,shaman,elemental,158,88,70
Gangmembr,illidan,1857,shaman,elemental,42,25,17
Jøey,nesingwary,1854,shaman,elemental,30,20,10
Shøckys,tichondrius,1849,shaman,elemental,108,49,59
Handzum,blades-edge,1848,shaman,elemental,72,41,31
Dampenedxx,bleeding-hollow,1848,shaman,elemental,151,85,66
Juicébox,tichondrius,1848,shaman,elemental,92,49,43
Sshaman,tichondrius,1846,shaman,elemental,82,40,42
Snookìe,sargeras,1846,shaman,elemental,88,41,47
Hecstacy,dalaran,1842,shaman,elemental,66,42,24
Utilitytotem,moon-guard,1838,shaman,elemental,154,83,71
Chemjenn,korgath,1838,shaman,elemental,84,37,47
Saphlare,tichondrius,1836,shaman,elemental,36,22,14
Rahtal,malganis,1834,shaman,elemental,48,25,23
Starmaker,malganis,1833,shaman,elemental,44,23,21
Planetwaves,malganis,1832,shaman,elemental,42,23,19
Nayro,bleeding-hollow,1828,shaman,elemental,48,32,16
Gaymakaí,sargeras,1828,shaman,elemental,48,27,21
Zzarit,tichondrius,1825,shaman,elemental,48,24,24
Humorlava,tichondrius,1820,shaman,elemental,30,19,11
Magtark,frostwolf,1820,shaman,elemental,61,38,23
Carondes,proudmoore,1820,shaman,elemental,69,38,31
Shôcky,tichondrius,1819,shaman,elemental,54,33,21
Hotdogwaterx,tichondrius,1817,shaman,elemental,62,42,20
Meatyball,tichondrius,1816,shaman,elemental,65,42,23
Baddaboom,sargeras,1816,shaman,elemental,97,54,43
Shockjob,frostmourne,1815,shaman,elemental,36,19,17
Smiteums,sargeras,1813,shaman,elemental,42,24,18
Wangyinanmin,tichondrius,1812,shaman,elemental,30,19,11
Whameradetu,suramar,1809,shaman,elemental,80,38,42
Hadèes,zuljin,1808,shaman,elemental,198,108,90
Dràgoon,thrall,1807,shaman,elemental,30,19,11
Coffinpls,illidan,1806,shaman,elemental,54,33,21
Swigadee,tichondrius,1806,shaman,elemental,84,39,45
Molerat,illidan,1806,shaman,elemental,158,73,85
Bismarks,frostmourne,1805,shaman,elemental,66,38,28
Zuescannon,kelthuzad,1805,shaman,elemental,59,32,27
Drazziqt,malganis,1803,shaman,elemental,45,27,18
Nonomori,frostmourne,1802,shaman,elemental,48,30,18
Torchic,drakkari,1801,shaman,elemental,60,31,29
Monkeysham,dathremar,1800,shaman,elemental,48,30,18
Elementàlius,quelthalas,1800,shaman,elemental,80,46,34
Mackq,tichondrius,1800,shaman,elemental,103,54,49
Osev,stormrage,1795,shaman,elemental,48,26,22
Cepheí,bleeding-hollow,1792,shaman,elemental,77,38,39
Ñîmåbè,tichondrius,1787,shaman,elemental,36,21,15
Ralae,zuljin,1782,shaman,elemental,29,19,10
Donkeyteeth,bleeding-hollow,1779,shaman,elemental,97,54,43
Earthclap,tichondrius,1779,shaman,elemental,79,38,41
Ieeguen,tichondrius,1778,shaman,elemental,48,22,26
Soyboyxxo,barthilas,1774,shaman,elemental,127,65,62
Hazzathxy,tichondrius,1771,shaman,elemental,41,22,19
Zqsyyds,illidan,1770,shaman,elemental,35,19,16
Deathblasts,zuljin,1770,shaman,elemental,48,22,26
Møp,spirestone,1766,shaman,elemental,66,39,27
Swiatek,ragnaros,1764,shaman,elemental,76,42,34
Vkzz,sargeras,1763,shaman,elemental,67,27,40
Groundme,malganis,1756,shaman,elemental,35,19,16
Damadar,zuljin,1754,shaman,elemental,94,49,45
Brezel,azralon,1740,shaman,elemental,42,27,15
Minigible,tichondrius,1739,shaman,elemental,54,23,31
Ktshammy,frostmourne,1738,shaman,elemental,30,21,9
Gravygumdrop,tichondrius,1737,shaman,elemental,98,51,47
Scrymax,area-52,1733,shaman,elemental,72,39,33
Hexistential,tichondrius,1731,shaman,elemental,34,26,8
Taranís,sargeras,1730,shaman,elemental,54,25,29
Hüsky,dalaran,1725,shaman,elemental,53,27,26
Windfurygød,tichondrius,1724,shaman,elemental,60,44,16
Däbü,tichondrius,1724,shaman,elemental,30,18,12
Beibeihangh,tichondrius,1720,shaman,elemental,36,21,15
Apyôn,tichondrius,1719,shaman,elemental,42,24,18
Triknolov,dalaran,1719,shaman,elemental,77,40,37
ßævis,magtheridon,1715,shaman,elemental,60,37,23
Liquidmagma,deathwing,1711,shaman,elemental,100,50,50
Vixeen,kelthuzad,1711,shaman,elemental,42,21,21
Pubechin,jubeithos,1711,shaman,elemental,42,21,21
Scherzer,frostwolf,1711,shaman,elemental,108,48,60
Ayumihamasai,tichondrius,1710,shaman,elemental,60,33,27
Ryanxo,azjolnerub,1709,shaman,elemental,35,21,14
Miroen,tichondrius,1708,shaman,elemental,36,18,18
Flüke,tichondrius,1704,shaman,elemental,54,31,23
Notahappyone,area-52,1703,shaman,elemental,48,34,14
Kustys,tichondrius,1699,shaman,elemental,36,18,18
Trïggerr,blackrock,1695,shaman,elemental,30,18,12
Mytotemisbig,lothar,1694,shaman,elemental,59,38,21
Notbpage,burning-blade,1694,shaman,elemental,102,51,51
Tupacshocker,zuljin,1692,shaman,elemental,30,18,12
Krumpits,barthilas,1685,shaman,elemental,45,26,19
Trnzx,sargeras,1684,shaman,elemental,36,21,15
Shockyshock,emerald-dream,1683,shaman,elemental,46,29,17
Billydreams,drakkari,1683,shaman,elemental,140,69,71
Caserguy,sargeras,1683,shaman,elemental,58,24,34
Ryukims,tichondrius,1682,shaman,elemental,76,41,35
Enkix,drakkari,1681,shaman,elemental,42,23,19
Cyhren,illidan,1679,shaman,elemental,54,33,21
Kigoros,bleeding-hollow,1679,shaman,elemental,60,33,27
Gorjun,stormrage,1679,shaman,elemental,81,38,43
Ptee,tichondrius,1677,shaman,elemental,45,23,22
Zugzugdogg,destromath,1674,shaman,elemental,42,23,19
Zeroclue,area-52,1673,shaman,elemental,40,22,18
Buffele,tichondrius,1672,shaman,elemental,42,18,24
Jerkdaddy,aggramar,1668,shaman,elemental,30,19,11
Sonire,tichondrius,1668,shaman,elemental,227,111,116
Hengler,emerald-dream,1666,shaman,elemental,53,28,25
Deckìn,proudmoore,1663,shaman,elemental,160,85,75
Buju,bleeding-hollow,1662,shaman,elemental,152,84,68
Dewoverload,garithos,1657,shaman,elemental,33,23,10
Letronix,azralon,1656,shaman,elemental,71,34,37
Kawj,eonar,1652,shaman,elemental,36,21,15
Creativemind,ragnaros,1652,shaman,elemental,74,40,34
Dyxlol,tichondrius,1652,shaman,elemental,56,25,31
Thaelia,azgalor,1650,shaman,elemental,40,23,17
Caninius,sargeras,1649,shaman,elemental,48,24,24
Walabi,tichondrius,1649,shaman,elemental,50,22,28
Zeylhe,proudmoore,1647,shaman,elemental,54,26,28
Squealer,sargeras,1644,shaman,elemental,98,50,48
Smoketide,stormrage,1644,shaman,elemental,47,21,26
Shockisha,sisters-of-elune,1644,shaman,elemental,52,23,29
Xodeus,frostmourne,1642,shaman,elemental,42,21,21
Shlmmyjimmy,tichondrius,1642,shaman,elemental,90,33,57
Streetmeat,crushridge,1640,shaman,elemental,125,64,61
Shambergler,tichondrius,1639,shaman,elemental,30,20,10
Waterground,tichondrius,1636,shaman,elemental,43,24,19
Dilonsham,area-52,1635,shaman,elemental,52,32,20
Uglymuger,tichondrius,1635,shaman,elemental,128,60,68
Imense,sargeras,1634,shaman,elemental,77,44,33
Lasso,shattered-hand,1632,shaman,elemental,42,21,21
Semasham,khazgoroth,1631,shaman,elemental,49,25,24
Imnumberl,sargeras,1630,shaman,elemental,78,51,27
Bubbert,illidan,1630,shaman,elemental,72,31,41
Óompaloompa,frostmourne,1628,shaman,elemental,52,32,20
Stormsage,jubeithos,1627,shaman,elemental,54,31,23
Fiftybeers,frostmourne,1627,shaman,elemental,35,19,16
Lff,stormrage,1626,shaman,elemental,24,17,7
Hexlexic,stormrage,1625,shaman,elemental,57,34,23
Shaymîn,malganis,1624,shaman,elemental,38,21,17
Chandye,proudmoore,1620,shaman,elemental,48,22,26
Fruityrudyy,area-52,1618,shaman,elemental,30,22,8
Oldcregg,emerald-dream,1618,shaman,elemental,24,17,7
Eimear,kelthuzad,1618,shaman,elemental,33,20,13
Faygodream,illidan,1618,shaman,elemental,220,119,101
Thunderfaker,tichondrius,1618,shaman,elemental,36,17,19
Conjury,tichondrius,1618,shaman,elemental,48,22,26
Popsoot,area-52,1617,shaman,elemental,36,17,19
Mulak,frostmourne,1616,shaman,elemental,110,54,56
Duality,shattered-halls,1615,shaman,elemental,59,38,21
Chajaa,ragnaros,1615,shaman,elemental,171,86,85
Catdontcare,tichondrius,1613,shaman,elemental,30,17,13
Electriik,kiljaeden,1611,shaman,elemental,66,38,28
Gangstà,stormrage,1611,shaman,elemental,66,30,36
Shamans,zuljin,1610,shaman,elemental,42,31,11
Uglymugshock,tichondrius,1610,shaman,elemental,90,46,44
Orkuss,illidan,1609,shaman,elemental,29,19,10
Sweatshock,frostmourne,1608,shaman,elemental,206,112,94
Thündermoose,tichondrius,1608,shaman,elemental,42,21,21
Xakaeri,hyjal,1607,shaman,elemental,59,32,27
Setò,quelthalas,1607,shaman,elemental,66,35,31
Roxxiggom,aggramar,1605,shaman,elemental,24,19,5
Üchihamadarâ,tichondrius,1605,shaman,elemental,87,48,39
Taxd,sargeras,1605,shaman,elemental,40,21,19
Soo,kiljaeden,1605,shaman,elemental,84,39,45
Jaimenohex,illidan,1603,shaman,elemental,36,19,17
Nutty,dentarg,1602,shaman,elemental,42,24,18
Tulol,tichondrius,1602,shaman,elemental,114,54,60
Illbuyurmom,tichondrius,1602,shaman,elemental,87,41,46
Everspell,lightnings-blade,1602,shaman,elemental,72,33,39
Novajersey,azralon,1601,shaman,elemental,62,33,29
Ssjgreen,illidan,1601,shaman,elemental,66,33,33
Opaltsing,tichondrius,1601,shaman,elemental,39,19,20
Feetfungus,area-52,1601,shaman,elemental,78,35,43
Tidedown,dark-iron,1600,shaman,elemental,36,25,11
Mugumbo,frostmourne,1599,shaman,elemental,61,34,27
Emaric,sargeras,1599,shaman,elemental,36,20,16
Ggoong,tichondrius,1597,shaman,elemental,42,25,17
Datbigthing,frostmourne,1596,shaman,elemental,60,24,36
Igotu,tichondrius,1595,shaman,elemental,30,17,13
Kymo,tichondrius,1591,shaman,elemental,30,17,13
Honeybean,tichondrius,1591,shaman,elemental,96,50,46
Lottogodx,area-52,1590,shaman,elemental,48,28,20
Hurìon,coilfang,1589,shaman,elemental,62,35,27
Zelthakaru,emerald-dream,1587,shaman,elemental,42,18,24
Moodizzle,tichondrius,1586,shaman,elemental,96,51,45
Cornivore,malganis,1582,shaman,elemental,36,19,17
Grimmson,emerald-dream,1578,shaman,elemental,48,20,28
Zap,wyrmrest-accord,1576,shaman,elemental,78,39,39
Talonga,moon-guard,1575,shaman,elemental,66,31,35
Pacapinchhit,azgalor,1574,shaman,elemental,57,34,23
Illmental,kelthuzad,1570,shaman,elemental,109,53,56
Totemsmacker,quelthalas,1569,shaman,elemental,72,38,34
Rodbert,sargeras,1568,shaman,elemental,41,20,21
Muffïn,moon-guard,1561,shaman,elemental,42,24,18
Hexzy,moon-guard,1561,shaman,elemental,73,33,40
Indika,stormrage,1560,shaman,elemental,30,18,12
Krimzs,executus,1560,shaman,elemental,81,37,44
Targhal,tichondrius,1559,shaman,elemental,56,34,22
Climhazard,senjin,1555,shaman,elemental,36,18,18
Dook,ghostlands,1555,shaman,elemental,35,17,18
Stitchis,black-dragonflight,1554,shaman,elemental,69,41,28
Shellshocka,korgath,1554,shaman,elemental,38,20,18
Simada,tichondrius,1554,shaman,elemental,36,17,19
Dtab,tichondrius,1552,shaman,elemental,36,18,18
Volcanoboxer,tichondrius,1552,shaman,elemental,90,44,46
Meatballpie,frostmourne,1548,shaman,elemental,42,25,17
Topax,vashj,1548,shaman,elemental,41,23,18
Doodleburger,dathremar,1545,shaman,elemental,50,41,9
Badandbooshi,stormreaver,1544,shaman,elemental,42,20,22
Drogues,tichondrius,1543,shaman,elemental,47,26,21
Afw,darkspear,1542,shaman,elemental,94,53,41
Døutrina,azralon,1542,shaman,elemental,49,21,28
Huskër,tichondrius,1541,shaman,elemental,94,55,39
Borheals,tichondrius,1537,shaman,elemental,44,21,23
Zappynips,frostmourne,1536,shaman,elemental,51,30,21
Ratson,ragnaros,1535,shaman,elemental,36,19,17
Robot,illidan,1534,shaman,elemental,30,16,14
Tulnak,kelthuzad,1532,shaman,elemental,129,66,63
Lovesthegear,blackrock,1529,shaman,elemental,30,16,14
Xpire,ragnaros,1528,shaman,elemental,30,16,14
Gambezee,kelthuzad,1528,shaman,elemental,36,16,20
Harrypotqueu,zuljin,1527,shaman,elemental,30,16,14
Doxshaman,tichondrius,1525,shaman,elemental,117,65,52
Jamieslays,korgath,1525,shaman,elemental,107,54,53
Generators,area-52,1524,shaman,elemental,265,132,133
Mzzar,tichondrius,1523,shaman,elemental,30,16,14
Tunegrote,ragnaros,1523,shaman,elemental,66,35,31
Daddykooll,tichondrius,1521,shaman,elemental,78,40,38
Draghul,frostwolf,1520,shaman,elemental,43,24,19
Sheman,galakrond,1520,shaman,elemental,58,29,29
Dwarfdude,gorefiend,1517,shaman,elemental,41,24,17
Yasmiel,zuljin,1517,shaman,elemental,60,27,33
Cacahuates,suramar,1516,shaman,elemental,96,55,41
Loxshox,gnomeregan,1516,shaman,elemental,401,199,202
Clapton,darkspear,1515,shaman,elemental,47,21,26
Tawambji,kiljaeden,1509,shaman,elemental,30,16,14
Univearth,emerald-dream,1509,shaman,elemental,90,45,45
Gerrkiing,amanthul,1508,shaman,elemental,35,22,13
Bycrax,ragnaros,1507,shaman,elemental,88,45,43
Evilraven,tichondrius,1506,shaman,elemental,183,91,92
Seventeen,blackrock,1506,shaman,elemental,36,16,20
Busterbrounz,queldorei,1505,shaman,elemental,48,32,16
Kakaaroto,nemesis,1504,shaman,elemental,87,49,38
Cgq,tichondrius,1504,shaman,elemental,114,61,53
Friedmans,illidan,1502,shaman,elemental,138,70,68
Pipelord,destromath,1494,shaman,elemental,30,18,12
Legthul,tichondrius,1493,shaman,elemental,36,17,19
Keldinraz,stormrage,1492,shaman,elemental,48,22,26
Sheriffbj,emerald-dream,1489,shaman,elemental,65,29,36
Cowish,illidan,1487,shaman,elemental,42,23,19
Tuntar,ragnaros,1487,shaman,elemental,174,91,83
Vulkuro,quelthalas,1485,shaman,elemental,48,27,21
Soartotes,sargeras,1484,shaman,elemental,34,19,15
Olboy,thrall,1483,shaman,elemental,30,19,11
Innvious,sargeras,1483,shaman,elemental,60,28,32
Gloi,ragnaros,1481,shaman,elemental,31,19,12
Rss,barthilas,1481,shaman,elemental,77,39,38
Dadadabang,frostmourne,1478,shaman,elemental,40,18,22
Defrout,kelthuzad,1469,shaman,elemental,68,32,36
Genericheat,tichondrius,1468,shaman,elemental,59,31,28
Gahaa,tichondrius,1464,shaman,elemental,23,16,7
Isekai,alterac-mountains,1461,shaman,elemental,268,130,138
Washedupty,illidan,1460,shaman,elemental,118,56,62
Cavolt,stormrage,1459,shaman,elemental,41,21,20
Makocc,tichondrius,1458,shaman,elemental,97,48,49
Soulrak,tichondrius,1457,shaman,elemental,114,53,61
Vktr,drakkari,1456,shaman,elemental,64,33,31
Rinnobunen,wyrmrest-accord,1452,shaman,elemental,100,50,50
Engara,frostmane,1451,shaman,elemental,35,17,18
Thundermatt,aegwynn,1451,shaman,elemental,87,39,48
Fwwrs,illidan,1450,shaman,elemental,26,16,10
Tørosentado,quelthalas,1450,shaman,elemental,94,47,47
Malosa,hyjal,1449,shaman,elemental,65,27,38
Georgejr,thunderlord,1445,shaman,elemental,54,31,23
Syile,stormrage,1445,shaman,elemental,80,37,43
Giversham,bleeding-hollow,1437,shaman,elemental,24,15,9
Kumer,tichondrius,1436,shaman,elemental,34,19,15
Dodona,sargeras,1435,shaman,elemental,86,40,46
Biberom,kelthuzad,1434,shaman,elemental,57,32,25
Stèpbro,sargeras,1432,shaman,elemental,36,18,18
Latoques,quelthalas,1431,shaman,elemental,24,15,9
Pipesable,ragnaros,1430,shaman,elemental,24,15,9
Bikáchu,tichondrius,1429,shaman,elemental,24,15,9
Saraguthix,dalaran,1427,shaman,elemental,60,27,33
Kkangsiki,tichondrius,1427,shaman,elemental,36,16,20
Drazzella,arthas,1422,shaman,elemental,47,21,26
Nøir,drakkari,1422,shaman,elemental,60,26,34
Bramah,bonechewer,1420,shaman,elemental,36,16,20
Joehogan,stormrage,1419,shaman,elemental,73,42,31
Snapstr,illidan,1419,shaman,elemental,36,15,21
Scryerman,area-52,1418,shaman,elemental,30,16,14
Srbski,emerald-dream,1416,shaman,elemental,32,17,15
Blacklm,tichondrius,1413,shaman,elemental,24,15,9
Plotious,antonidas,1413,shaman,elemental,36,19,17
Dumpweed,stormscale,1413,shaman,elemental,42,21,21
Gumballin,sargeras,1412,shaman,elemental,85,41,44
Darizzler,bleeding-hollow,1408,shaman,elemental,48,28,20
Shampainn,demon-soul,1407,shaman,elemental,72,38,34
Morluné,tichondrius,1407,shaman,elemental,54,26,28
Chonkymilk,illidan,1407,shaman,elemental,50,22,28
Conductivity,frostmourne,1406,shaman,elemental,48,24,24
Ectomee,tichondrius,1403,shaman,elemental,30,16,14
Mittss,sargeras,1401,shaman,elemental,106,57,49
Pepîllo,ragnaros,1401,shaman,elemental,126,51,75
Wfb,sargeras,1398,shaman,elemental,30,20,10
Zugzugthug,moon-guard,1395,shaman,elemental,131,69,62
Sweetbabyraé,bleeding-hollow,1391,shaman,elemental,66,42,24
Vuhdu,barthilas,1391,shaman,elemental,24,15,9
Liloggie,illidan,1385,shaman,elemental,23,15,8
Redlava,turalyon,1384,shaman,elemental,31,19,12
Everyst,darkspear,1383,shaman,elemental,65,34,31
Golozok,zuljin,1382,shaman,elemental,35,16,19
Ceedlamb,kelthuzad,1381,shaman,elemental,66,34,32
Richode,burning-legion,1376,shaman,elemental,30,17,13
Shuñk,frostmourne,1376,shaman,elemental,60,27,33
Hurky,sargeras,1375,shaman,elemental,152,78,74
Hansolorz,tichondrius,1375,shaman,elemental,56,26,30
Rolltìde,tichondrius,1372,shaman,elemental,153,85,68
Luvstospooj,thaurissan,1372,shaman,elemental,73,34,39
Zechary,proudmoore,1372,shaman,elemental,48,19,29
Ffaísca,azralon,1371,shaman,elemental,44,22,22
Nuofu,illidan,1367,shaman,elemental,59,30,29
Venekk,shattered-hand,1366,shaman,elemental,29,17,12
Ghorokk,azralon,1363,shaman,elemental,42,31,11
Rythia,elune,1363,shaman,elemental,40,18,22
Telain,quelthalas,1360,shaman,elemental,84,42,42
Baodan,azshara,1356,shaman,elemental,97,51,46
Porkfririe,kelthuzad,1356,shaman,elemental,52,21,31
Stormsanta,emerald-dream,1349,shaman,elemental,35,15,20
Moartotems,kelthuzad,1347,shaman,elemental,30,18,12
Minusshaman,dalaran,1346,shaman,elemental,144,80,64
Snewboii,malganis,1346,shaman,elemental,30,15,15
Spoonforkorc,thrall,1342,shaman,elemental,24,14,10
Bagele,tichondrius,1342,shaman,elemental,30,14,16
Shadowowl,tanaris,1339,shaman,elemental,39,19,20
Oontuk,illidan,1337,shaman,elemental,66,31,35
Laelyk,kiljaeden,1336,shaman,elemental,30,14,16
Alphamael,lightbringer,1333,shaman,elemental,65,38,27
Cocainbear,emerald-dream,1332,shaman,elemental,39,20,19
Arukz,tichondrius,1332,shaman,elemental,30,14,16
Onnyx,proudmoore,1330,shaman,elemental,24,14,10
Exoticz,barthilas,1330,shaman,elemental,53,19,34
Drzhong,frostmourne,1329,shaman,elemental,40,22,18
Totems,the-underbog,1327,shaman,elemental,24,14,10
Totem,burning-legion,1327,shaman,elemental,24,14,10
Ekstasiel,azralon,1323,shaman,elemental,54,28,26
Hufflefluffs,kiljaeden,1323,shaman,elemental,56,29,27
Ragnards,ragnaros,1323,shaman,elemental,79,35,44
Zuldroth,frostmourne,1319,shaman,elemental,30,18,12
Shocks,alleria,1318,shaman,elemental,30,14,16
Lenin,nathrezim,1316,shaman,elemental,62,24,38
Endorovich,mannoroth,1309,shaman,elemental,30,14,16
Yippeekiyay,zuluhed,1307,shaman,elemental,57,25,32
Toho,ragnaros,1304,shaman,elemental,48,25,23
Drvoodoo,tichondrius,1301,shaman,elemental,30,15,15
Ayahuaskah,illidan,1300,shaman,elemental,43,20,23
Pozcaster,tichondrius,1299,shaman,elemental,70,24,46
Hueymagoo,firetree,1295,shaman,elemental,24,14,10
Totempoke,frostmourne,1292,shaman,elemental,23,14,9
Synerggy,hakkar,1291,shaman,elemental,297,151,146
Budgetseaan,stormrage,1290,shaman,elemental,66,38,28
Totemtown,darkspear,1286,shaman,elemental,60,28,32
Seinnome,azralon,1276,shaman,elemental,37,16,21
Bushdeedit,stormrage,1274,shaman,elemental,35,14,21
Madelements,tichondrius,1270,shaman,elemental,32,17,15
Rokogg,thrall,1267,shaman,elemental,29,14,15
Shammany,stormrage,1264,shaman,elemental,48,24,24
Jaapo,barthilas,1259,shaman,elemental,98,48,50
Sugirukifuja,stormrage,1258,shaman,elemental,23,16,7
Baltharzhard,saurfang,1257,shaman,elemental,36,16,20
Moacmathi,quelthalas,1253,shaman,elemental,60,27,33
Destroçadorx,azralon,1249,shaman,elemental,32,15,17
Okïòmó,proudmoore,1248,shaman,elemental,30,13,17
Siò,barthilas,1247,shaman,elemental,15,14,1
Funnysa,tichondrius,1247,shaman,elemental,18,13,5
Ëìê,tichondrius,1247,shaman,elemental,36,13,23
Beerofdoom,proudmoore,1245,shaman,elemental,36,19,17
Lugak,ragnaros,1245,shaman,elemental,41,15,26
Battleshammy,nagrand,1243,shaman,elemental,30,15,15
Maldini,tol-barad,1242,shaman,elemental,36,17,19
Clarix,quelthalas,1241,shaman,elemental,24,13,11
Yodahh,daggerspine,1236,shaman,elemental,39,22,17
Marduul,azralon,1236,shaman,elemental,35,16,19
Kanasya,quelthalas,1234,shaman,elemental,41,17,24
Edenorion,ragnaros,1232,shaman,elemental,48,23,25
Sabtifa,proudmoore,1232,shaman,elemental,30,13,17
Forgediniron,stormrage,1225,shaman,elemental,54,27,27
Chaposz,tichondrius,1221,shaman,elemental,30,13,17
Nírnez,ragnaros,1220,shaman,elemental,42,14,28
Malrom,kelthuzad,1218,shaman,elemental,387,194,193
Saulgudmon,area-52,1215,shaman,elemental,36,19,17
Smithereen,area-52,1215,shaman,elemental,36,16,20
Rafiki,haomarush,1215,shaman,elemental,60,26,34
Øten,area-52,1214,shaman,elemental,30,20,10
Mhaal,wyrmrest-accord,1213,shaman,elemental,106,42,64
Eze,tichondrius,1211,shaman,elemental,58,33,25
Amonita,stonemaul,1210,shaman,elemental,18,13,5
Grezzkall,malganis,1207,shaman,elemental,39,19,20
Bazinguinha,azralon,1207,shaman,elemental,60,28,32
Omegaman,lightninghoof,1204,shaman,elemental,69,35,34
Shamanzinh,azralon,1204,shaman,elemental,42,20,22
Deggle,frostwolf,1201,shaman,elemental,30,14,16
Strugs,area-52,1201,shaman,elemental,59,25,34
Killeniis,tichondrius,1192,shaman,elemental,72,31,41
Araghok,ragnaros,1191,shaman,elemental,36,15,21
Konndor,malganis,1184,shaman,elemental,48,19,29
Lezzer,ragnaros,1167,shaman,elemental,102,45,57
Zhokal,quelthalas,1166,shaman,elemental,125,65,60
Cptnmagma,bleeding-hollow,1162,shaman,elemental,124,57,67
Jaycobb,area-52,1159,shaman,elemental,30,13,17
Zugdabou,bonechewer,1155,shaman,elemental,66,30,36
Kebboz,frostmourne,1152,shaman,elemental,18,12,6
Bovinebeauty,tichondrius,1152,shaman,elemental,18,12,6
Pasto,bleeding-hollow,1152,shaman,elemental,18,12,6
Lilbabyapy,sargeras,1152,shaman,elemental,24,12,12
Councilman,illidan,1152,shaman,elemental,24,12,12
Chenjiawei,tichondrius,1152,shaman,elemental,24,12,12
Krupto,tichondrius,1151,shaman,elemental,24,12,12
Àspec,aegwynn,1151,shaman,elemental,24,12,12
Kang,terenas,1150,shaman,elemental,18,12,6
Poonqtx,frostmourne,1149,shaman,elemental,18,12,6
Skyten,quelthalas,1148,shaman,elemental,27,13,14
Eluulne,silvermoon,1147,shaman,elemental,24,12,12
Kilydily,destromath,1147,shaman,elemental,30,12,18
Motorrad,azralon,1146,shaman,elemental,22,13,9
Shockerfist,thunderlord,1144,shaman,elemental,18,12,6
Enhancers,sargeras,1144,shaman,elemental,24,12,12
Kowabounga,ragnaros,1140,shaman,elemental,24,12,12
Beatryx,the-scryers,1140,shaman,elemental,24,12,12
Yasuriyamile,illidan,1139,shaman,elemental,126,55,71
Thunderblood,nerzhul,1138,shaman,elemental,24,12,12
Muggs,cairne,1137,shaman,elemental,18,12,6
Nuggitz,tichondrius,1136,shaman,elemental,31,20,11
Vodord,arathor,1130,shaman,elemental,24,12,12
Tribalmood,illidan,1130,shaman,elemental,36,14,22
Jashar,spinebreaker,1127,shaman,elemental,24,13,11
Blacklust,tichondrius,1127,shaman,elemental,30,13,17
Shmoo,deathwing,1126,shaman,elemental,27,14,13
Madeleines,goldrinn,1124,shaman,elemental,24,14,10
Firecracker,warsong,1123,shaman,elemental,88,47,41
Johnwilke,area-52,1123,shaman,elemental,43,17,26
Bravederp,kelthuzad,1120,shaman,elemental,63,31,32
Akó,quelthalas,1120,shaman,elemental,36,13,23
Skwiglz,tichondrius,1113,shaman,elemental,90,44,46
Premium,nagrand,1112,shaman,elemental,30,12,18
Karashamy,ragnaros,1107,shaman,elemental,85,40,45
Chanix,ragnaros,1106,shaman,elemental,23,12,11
Afgoox,tichondrius,1105,shaman,elemental,36,24,12
Xoelement,borean-tundra,1103,shaman,elemental,54,25,29
Bulljay,bleeding-hollow,1101,shaman,elemental,27,13,14
Discokid,norgannon,1100,shaman,elemental,30,12,18
Yunow,ragnaros,1096,shaman,elemental,48,20,28
Axelrose,ragnaros,1090,shaman,elemental,36,16,20
Meteorah,kelthuzad,1088,shaman,elemental,63,30,33
Omnath,zuluhed,1083,shaman,elemental,35,19,16
Zappz,thunderlord,1082,shaman,elemental,60,34,26
Shammpain,barthilas,1081,shaman,elemental,59,31,28
Justballs,stormscale,1078,shaman,elemental,48,27,21
Coffee,mugthol,1073,shaman,elemental,48,19,29
Shamarock,stonemaul,1071,shaman,elemental,48,25,23
Shockazulu,vashj,1070,shaman,elemental,47,23,24
Tideborn,azralon,1068,shaman,elemental,28,14,14
Sàuron,tichondrius,1066,shaman,elemental,25,12,13
Bobbymooshay,area-52,1065,shaman,elemental,31,12,19
Afri,tichondrius,1056,shaman,elemental,16,12,4
Szes,tichondrius,1056,shaman,elemental,18,11,7
Redpocket,zuluhed,1056,shaman,elemental,18,11,7
Bestshamus,sargeras,1056,shaman,elemental,18,11,7
Biggiechief,illidan,1056,shaman,elemental,18,11,7
Palcyon,eonar,1056,shaman,elemental,18,11,7
Petrafk,illidan,1056,shaman,elemental,18,11,7
Highsteakss,tichondrius,1055,shaman,elemental,12,11,1
Bootietootie,bleeding-hollow,1055,shaman,elemental,18,11,7
Fanatix,moon-guard,1055,shaman,elemental,18,11,7
Smooths,bloodscalp,1055,shaman,elemental,18,11,7
Shakron,dalaran,1055,shaman,elemental,18,11,7
Ndndurkadurk,malganis,1055,shaman,elemental,18,11,7
Shockalot,emerald-dream,1055,shaman,elemental,24,11,13
Jeffspicele,emerald-dream,1055,shaman,elemental,24,11,13
Thuntard,bleeding-hollow,1055,shaman,elemental,24,11,13
Thathurts,thrall,1054,shaman,elemental,18,11,7
Ayetex,kelthuzad,1054,shaman,elemental,18,11,7
Sumnah,sargeras,1054,shaman,elemental,42,22,20
Lilmollet,tichondrius,1054,shaman,elemental,25,13,12
Traindablue,illidan,1054,shaman,elemental,24,11,13
Blobberino,tichondrius,1054,shaman,elemental,24,11,13
Blastuh,kiljaeden,1053,shaman,elemental,18,11,7
Shocksrus,arthas,1053,shaman,elemental,24,11,13
Madmartiggen,scilla,1051,shaman,elemental,21,12,9
Ôprawindfury,mugthol,1050,shaman,elemental,18,11,7
Taeilendar,ragnaros,1050,shaman,elemental,24,11,13
Drmeangreen,tichondrius,1049,shaman,elemental,43,19,24
Nazz,cenarion-circle,1048,shaman,elemental,18,11,7
Metlar,sargeras,1048,shaman,elemental,24,11,13
Vashidda,stormrage,1048,shaman,elemental,24,11,13
Luxenor,kelthuzad,1046,shaman,elemental,18,11,7
Minzysm,illidan,1045,shaman,elemental,24,11,13
Bonevykin,area-52,1044,shaman,elemental,21,12,9
Enflexi,lightbringer,1044,shaman,elemental,24,11,13
Grandwolf,ragnaros,1040,shaman,elemental,24,11,13
Hodonsin,tichondrius,1039,shaman,elemental,23,11,12
Darkrock,echo-isles,1033,shaman,elemental,24,12,12
Rollypolli,gnomeregan,1022,shaman,elemental,72,36,36
Olani,nesingwary,1022,shaman,elemental,38,12,26
Treesntotemz,darkspear,1020,shaman,elemental,18,11,7
Bigrider,nemesis,1009,shaman,elemental,48,19,29
Geladoo,gallywix,1008,shaman,elemental,68,29,39
Mîkâ,area-52,1007,shaman,elemental,24,11,13
Wälee,sargeras,1004,shaman,elemental,77,37,40
Shambix,illidan,1002,shaman,elemental,19,12,7
Sanlu,tichondrius,991,shaman,elemental,71,34,37
Dizzytotem,dalaran,991,shaman,elemental,24,11,13
Cheweydadawg,shandris,990,shaman,elemental,23,11,12
Shàmpow,darkspear,988,shaman,elemental,23,11,12
Piloncho,ragnaros,983,shaman,elemental,60,24,36
Cîmm,stormrage,972,shaman,elemental,22,11,11
Mistayl,bleeding-hollow,968,shaman,elemental,30,12,18
Asanako,illidan,967,shaman,elemental,88,38,50
Bronan,laughing-skull,961,shaman,elemental,72,29,43
Guybeingdude,sargeras,960,shaman,elemental,12,10,2
Smrtdeath,zuljin,960,shaman,elemental,12,10,2
Graveshocks,illidan,960,shaman,elemental,12,10,2
Folus,azjolnerub,960,shaman,elemental,18,10,8
Hydroponicz,sargeras,960,shaman,elemental,18,10,8
Ðøææøð,stormrage,960,shaman,elemental,18,10,8
Bigdaddyion,thrall,960,shaman,elemental,18,10,8
Lividelemnts,area-52,960,shaman,elemental,18,10,8
Smeagles,ragnaros,960,shaman,elemental,18,10,8
Withinfinity,stormrage,960,shaman,elemental,24,10,14
Aishel,area-52,959,shaman,elemental,18,10,8
Kodyaj,illidan,959,shaman,elemental,18,10,8
Hexoffend,zuljin,959,shaman,elemental,18,10,8
Tidalstorm,thrall,959,shaman,elemental,18,10,8
Ehhmacros,doomhammer,959,shaman,elemental,24,10,14
Aingry,darkspear,958,shaman,elemental,18,10,8
Korlog,tichondrius,957,shaman,elemental,12,10,2
Charabon,ragnaros,957,shaman,elemental,18,10,8
Shockshammy,kiljaeden,956,shaman,elemental,18,10,8
Bigway,area-52,956,shaman,elemental,30,10,20
Chamuko,kelthuzad,955,shaman,elemental,18,10,8
Avni,silver-hand,954,shaman,elemental,18,10,8
Saanrixa,jubeithos,954,shaman,elemental,121,49,72
Tinkd,stormrage,953,shaman,elemental,18,10,8
Izreborn,tichondrius,953,shaman,elemental,24,10,14
Tuksha,alleria,951,shaman,elemental,30,10,20
Karvr,tichondrius,950,shaman,elemental,18,10,8
Brickzilla,dalaran,947,shaman,elemental,18,10,8
Bricx,dalaran,947,shaman,elemental,18,10,8
Elektrå,dalaran,947,shaman,elemental,24,10,14
Shamanic,dunemaul,947,shaman,elemental,89,33,56
Bröly,thunderhorn,946,shaman,elemental,30,10,20
Káládin,malganis,944,shaman,elemental,24,10,14
Duckmasick,tichondrius,941,shaman,elemental,30,10,20
Proignite,drakthul,934,shaman,elemental,35,17,18
Gorron,frostwolf,929,shaman,elemental,24,10,14
Dooman,area-52,927,shaman,elemental,30,10,20
Matria,tanaris,921,shaman,elemental,30,16,14
Lavablaster,kelthuzad,917,shaman,elemental,29,18,11
Sarahfe,wyrmrest-accord,910,shaman,elemental,17,10,7
Aragog,malygos,899,shaman,elemental,32,16,16
Notsock,zuljin,894,shaman,elemental,17,10,7
Threehandz,bleeding-hollow,886,shaman,elemental,55,20,35
Trilz,barthilas,880,shaman,elemental,19,10,9
Helga,hellscream,864,shaman,elemental,12,9,3
Vitaminc,garona,864,shaman,elemental,12,9,3
Jer,tichondrius,864,shaman,elemental,12,9,3
Totey,nemesis,864,shaman,elemental,12,9,3
Notragii,kelthuzad,864,shaman,elemental,12,9,3
Koalatricks,shadow-council,864,shaman,elemental,12,9,3
Bowlcutgodx,sargeras,864,shaman,elemental,12,9,3
Shockbalboa,stormrage,864,shaman,elemental,12,9,3
Drewzie,anvilmar,864,shaman,elemental,18,9,9
Owtyobwol,area-52,864,shaman,elemental,18,9,9
Doorti,area-52,864,shaman,elemental,18,9,9
Exceedër,ragnaros,864,shaman,elemental,18,9,9
Tampíco,ragnaros,864,shaman,elemental,24,9,15
Ratedpvp,thrall,863,shaman,elemental,12,9,3
Ðomzy,tichondrius,863,shaman,elemental,12,9,3
Blöw,tichondrius,863,shaman,elemental,18,9,9
Karagra,tichondrius,863,shaman,elemental,18,9,9
Astrostorm,darkspear,863,shaman,elemental,18,9,9
Hexellént,kiljaeden,863,shaman,elemental,18,9,9
Poseidon,kiljaeden,863,shaman,elemental,18,9,9
Earthfirex,ragnaros,863,shaman,elemental,18,9,9
Lovebody,zuljin,863,shaman,elemental,24,9,15
Stormcop,kelthuzad,863,shaman,elemental,24,9,15
Dtrumpx,tichondrius,863,shaman,elemental,24,9,15
Tecnein,tichondrius,863,shaman,elemental,24,9,15
Thaél,proudmoore,863,shaman,elemental,24,9,15
Dehsaw,illidan,863,shaman,elemental,24,9,15
Elemastery,windrunner,862,shaman,elemental,12,9,3
Tottemic,blackrock,862,shaman,elemental,18,9,9
Zro,ysera,862,shaman,elemental,18,9,9
Cónò,tichondrius,861,shaman,elemental,18,9,9
Phagocytosis,illidan,861,shaman,elemental,18,9,9
Aleysha,dreadmaul,861,shaman,elemental,18,9,9
Jensenx,proudmoore,861,shaman,elemental,24,9,15
Grukall,galakrond,860,shaman,elemental,12,9,3
Galabanjø,malganis,860,shaman,elemental,24,9,15
Nomahuata,cenarion-circle,859,shaman,elemental,24,9,15
Bluetape,azshara,858,shaman,elemental,12,9,3
Velekar,moon-guard,858,shaman,elemental,24,9,15
Xantoor,area-52,857,shaman,elemental,18,9,9
Gorakh,illidan,856,shaman,elemental,18,9,9
Edalandd,zuljin,856,shaman,elemental,24,9,15
Eboy,thrall,847,shaman,elemental,17,9,8
Dellnar,nagrand,847,shaman,elemental,18,9,9
Daiskei,nordrassil,838,shaman,elemental,18,9,9
Mðna,zuluhed,838,shaman,elemental,18,9,9
Vegaslights,tichondrius,816,shaman,elemental,21,9,12
Insanelol,tichondrius,815,shaman,elemental,21,9,12
Mindfields,barthilas,812,shaman,elemental,20,10,10
Zerium,nemesis,810,shaman,elemental,27,10,17
Maxchamo,ragnaros,810,shaman,elemental,31,10,21
Thanwirn,ragnaros,809,shaman,elemental,24,9,15
Relâx,icecrown,779,shaman,elemental,19,9,10
Cduck,zuljin,768,shaman,elemental,12,8,4
Supbrø,zuluhed,768,shaman,elemental,12,8,4
Yurp,illidan,768,shaman,elemental,12,8,4
Synkronaqt,tichondrius,768,shaman,elemental,12,8,4
Bagovs,tichondrius,768,shaman,elemental,12,8,4
Xammaa,illidan,768,shaman,elemental,12,8,4
Artaiva,zuljin,768,shaman,elemental,12,8,4
Squidzy,tichondrius,768,shaman,elemental,12,8,4
Genesisz,tichondrius,768,shaman,elemental,12,8,4
Morabebi,tichondrius,768,shaman,elemental,12,8,4
Groundfaults,bleeding-hollow,768,shaman,elemental,18,8,10
Stayz,tichondrius,768,shaman,elemental,18,8,10
Storminlorka,sargeras,768,shaman,elemental,18,8,10
Thestromp,quelthalas,767,shaman,elemental,12,8,4
Johntrabølta,zuljin,767,shaman,elemental,12,8,4
Blazintotems,arthas,767,shaman,elemental,12,8,4
Uninfluenced,firetree,767,shaman,elemental,12,8,4
Marcøvich,ragnaros,767,shaman,elemental,12,8,4
Tierrox,tichondrius,767,shaman,elemental,12,8,4
Graymatterz,ysondre,767,shaman,elemental,12,8,4
Momothewolf,malganis,767,shaman,elemental,12,8,4
Thandius,arygos,767,shaman,elemental,12,8,4
Barokoshama,area-52,767,shaman,elemental,12,8,4
Flowerchild,proudmoore,767,shaman,elemental,12,8,4
Urb,moknathal,767,shaman,elemental,18,8,10
Mazdamundï,ragnaros,767,shaman,elemental,24,8,16
Fênrisulfer,area-52,766,shaman,elemental,18,8,10
Fearoshimä,drakthul,765,shaman,elemental,18,8,10
Procdepartme,area-52,765,shaman,elemental,18,8,10
Cheddatotz,illidan,764,shaman,elemental,12,8,4
Pãníç,bladefist,764,shaman,elemental,18,8,10
Neebon,jubeithos,763,shaman,elemental,12,8,4
Shachone,zuljin,763,shaman,elemental,18,8,10
Teekona,tichondrius,763,shaman,elemental,18,8,10
Shamofshame,garrosh,763,shaman,elemental,24,8,16
Aeromarius,ragnaros,733,shaman,elemental,13,10,3
Lowiqpleb,tichondrius,719,shaman,elemental,17,8,9
Downerr,malganis,712,shaman,elemental,17,10,7
Pileef,thrall,704,shaman,elemental,10,8,2
Dmt,exodar,704,shaman,elemental,22,8,14
Makogo,earthen-ring,686,shaman,elemental,13,8,5
Thermopile,wildhammer,680,shaman,elemental,25,8,17
Lagroupie,ragnaros,672,shaman,elemental,12,7,5
Hanaruk,ragnaros,672,shaman,elemental,12,7,5
Chazzwozza,area-52,672,shaman,elemental,12,7,5
Cuban,kelthuzad,672,shaman,elemental,12,7,5
Linkzz,malganis,672,shaman,elemental,12,7,5
Toetum,hyjal,672,shaman,elemental,12,7,5
Smellyogre,area-52,672,shaman,elemental,12,7,5
Willy,icecrown,672,shaman,elemental,12,7,5
Drmeatballmd,tichondrius,672,shaman,elemental,12,7,5
Plebshammy,bleeding-hollow,672,shaman,elemental,12,7,5
Thoraq,bleeding-hollow,672,shaman,elemental,12,7,5
Merkal,illidan,672,shaman,elemental,12,7,5
Elemelons,stormrage,672,shaman,elemental,12,7,5
Rahkarg,korgath,672,shaman,elemental,12,7,5
Farku,illidan,672,shaman,elemental,12,7,5
Glizzyjamon,sargeras,672,shaman,elemental,12,7,5
Mesdew,tichondrius,672,shaman,elemental,12,7,5
Tatespeech,barthilas,672,shaman,elemental,12,7,5
Totemzie,illidan,672,shaman,elemental,12,7,5
Varnol,emerald-dream,672,shaman,elemental,12,7,5
Pericazo,sargeras,672,shaman,elemental,12,7,5
Boogielust,frostmourne,672,shaman,elemental,12,7,5
Sèèr,tichondrius,672,shaman,elemental,12,7,5
Ftp,kelthuzad,672,shaman,elemental,15,8,7
Alwaysbulkin,tichondrius,672,shaman,elemental,18,7,11
Xinz,guldan,672,shaman,elemental,18,7,11
Shamigo,tichondrius,672,shaman,elemental,18,7,11
Risker,tichondrius,672,shaman,elemental,18,7,11
Neotrad,proudmoore,672,shaman,elemental,18,7,11
Desdìnova,tortheldrin,672,shaman,elemental,18,7,11
Eravas,thrall,672,shaman,elemental,18,7,11
Dansham,zuljin,672,shaman,elemental,24,7,17
Jacori,malganis,671,shaman,elemental,12,7,5
Stormha,illidan,671,shaman,elemental,12,7,5
Lilthrall,skullcrusher,671,shaman,elemental,12,7,5
Canute,bonechewer,671,shaman,elemental,12,7,5
Oukami,area-52,671,shaman,elemental,12,7,5
Hairyrichard,zuljin,671,shaman,elemental,12,7,5
Lenå,moon-guard,671,shaman,elemental,12,7,5
Trashpandaa,deathwing,671,shaman,elemental,12,7,5
Malito,ursin,671,shaman,elemental,18,7,11
Alariaa,sargeras,670,shaman,elemental,12,7,5
Neukims,nemesis,670,shaman,elemental,20,7,13
Grimlên,skullcrusher,669,shaman,elemental,18,7,11
Idiotstaff,dreadmaul,669,shaman,elemental,24,7,17
Slothycrit,emerald-dream,668,shaman,elemental,30,7,23
Phuamya,dalaran,667,shaman,elemental,12,7,5
Saffoo,frostmourne,667,shaman,elemental,12,7,5
Shamadan,proudmoore,665,shaman,elemental,12,7,5
Warmak,hyjal,664,shaman,elemental,12,7,5
Jyster,area-52,664,shaman,elemental,24,7,17
Cardanø,illidan,652,shaman,elemental,29,7,22
Cheesewheelz,arthas,651,shaman,elemental,22,7,15
Aestheticsx,thrall,640,shaman,elemental,16,7,9
Megalithic,moon-guard,639,shaman,elemental,14,8,6
Koongram,area-52,623,shaman,elemental,11,7,4
Shizzänk,illidan,606,shaman,elemental,11,7,4
Oznog,bleeding-hollow,590,shaman,elemental,19,7,12
Boltadeez,tichondrius,576,shaman,elemental,6,6,0
Dornmawhide,sargeras,576,shaman,elemental,6,6,0
Sxxr,moon-guard,576,shaman,elemental,6,6,0
Adutchcowboy,tichondrius,576,shaman,elemental,6,6,0
Pikapiko,tichondrius,576,shaman,elemental,6,6,0
Kasparøv,tichondrius,576,shaman,elemental,6,6,0
Jinukia,malganis,576,shaman,elemental,12,6,6
Undaunte,sargeras,576,shaman,elemental,12,6,6
Mcgraff,frostmourne,576,shaman,elemental,12,6,6
Getwetand,quelthalas,576,shaman,elemental,12,6,6
Smoketide,illidan,576,shaman,elemental,12,6,6
Deeznuts,the-forgotten-coast,576,shaman,elemental,12,6,6
Darkcharles,illidan,576,shaman,elemental,12,6,6
Cowboy,executus,576,shaman,elemental,12,6,6
Reppinsix,sargeras,576,shaman,elemental,12,6,6
Frosh,nazgrel,576,shaman,elemental,12,6,6
Rubmytotêm,tichondrius,576,shaman,elemental,12,6,6
Shaokhan,azjolnerub,576,shaman,elemental,12,6,6
Jnzz,area-52,576,shaman,elemental,12,6,6
Zunden,illidan,576,shaman,elemental,12,6,6
Riseon,illidan,576,shaman,elemental,12,6,6
Zlateral,malganis,576,shaman,elemental,12,6,6
Bustinbooty,kiljaeden,576,shaman,elemental,12,6,6
Mistysham,illidan,576,shaman,elemental,12,6,6
Littz,malganis,576,shaman,elemental,12,6,6
Spaceghost,illidan,576,shaman,elemental,12,6,6
Doommjölnir,sargeras,576,shaman,elemental,12,6,6
Feuerbart,dalaran,576,shaman,elemental,12,6,6
Dxycollapse,illidan,576,shaman,elemental,12,6,6
Ezevia,stormrage,576,shaman,elemental,12,6,6
Consolx,area-52,576,shaman,elemental,12,6,6
Tairen,ragnaros,576,shaman,elemental,12,6,6
Finark,tichondrius,576,shaman,elemental,12,6,6
Deyodin,illidan,576,shaman,elemental,12,6,6
Orkshammy,illidan,576,shaman,elemental,12,6,6
Fuseillar,illidan,576,shaman,elemental,12,6,6
Torosmile,tichondrius,576,shaman,elemental,18,6,12
Oxdrog,malganis,576,shaman,elemental,18,6,12
Highvoltagex,frostmourne,576,shaman,elemental,18,6,12
Shamamas,area-52,576,shaman,elemental,18,6,12
Bitamin,frostmourne,576,shaman,elemental,18,6,12
Cowtidetotem,thrall,576,shaman,elemental,18,6,12
Wonima,tichondrius,576,shaman,elemental,19,6,13
Hallion,frostmourne,576,shaman,elemental,24,6,18
Asuni,illidan,576,shaman,elemental,24,6,18
Moctezumma,area-52,575,shaman,elemental,12,6,6
Wrathantula,thrall,575,shaman,elemental,12,6,6
Skribblez,tichondrius,575,shaman,elemental,12,6,6
Satup,ragnaros,575,shaman,elemental,12,6,6
Nemei,zuljin,575,shaman,elemental,12,6,6
Drewshammy,zuljin,575,shaman,elemental,12,6,6
Apocalypsehb,quelthalas,575,shaman,elemental,12,6,6
Shøckolate,whisperwind,575,shaman,elemental,12,6,6
Grimitt,suramar,575,shaman,elemental,18,6,12
Ulamøgg,proudmoore,575,shaman,elemental,21,6,15
Dugomik,malganis,574,shaman,elemental,12,6,6
Chanintotem,shattered-halls,574,shaman,elemental,12,6,6
Bcs,lightbringer,573,shaman,elemental,12,6,6
Nezzuk,quelthalas,573,shaman,elemental,12,6,6
Thuggliife,frostmourne,573,shaman,elemental,18,6,12
Totempaul,frostmourne,570,shaman,elemental,18,6,12
Ryudark,stormrage,569,shaman,elemental,24,6,18
Asy,tichondrius,559,shaman,elemental,11,6,5
Frostshear,maiev,557,shaman,elemental,17,6,11
Esbet,echo-isles,555,shaman,elemental,23,6,17
Aitex,kelthuzad,543,shaman,elemental,15,7,8
Thanen,the-scryers,541,shaman,elemental,16,6,10
Aseew,drakkari,522,shaman,elemental,21,9,12
Devipersham,frostmourne,511,shaman,elemental,11,6,5
Love,tichondrius,480,shaman,elemental,6,5,1
Axaxaxaxaxax,illidan,480,shaman,elemental,6,5,1
Sxr,moon-guard,480,shaman,elemental,6,5,1
Immashammyx,area-52,480,shaman,elemental,6,5,1
Riptideafk,sargeras,480,shaman,elemental,6,5,1
Furiousnick,stormrage,480,shaman,elemental,6,5,1
Dîabeetus,moon-guard,480,shaman,elemental,6,5,1
Fenny,proudmoore,480,shaman,elemental,6,5,1
Meatballsx,tichondrius,480,shaman,elemental,6,5,1
Shinydiglett,area-52,480,shaman,elemental,6,5,1
Kultirio,quelthalas,480,shaman,elemental,6,5,1
Azzula,tichondrius,480,shaman,elemental,6,5,1
Shoxz,korgath,480,shaman,elemental,6,5,1
Vulcansh,azralon,480,shaman,elemental,6,5,1
Shamxrob,sargeras,480,shaman,elemental,6,5,1
Josiahsham,kelthuzad,480,shaman,elemental,7,5,2
Firedchips,tichondrius,480,shaman,elemental,17,8,9
Boodissy,tichondrius,480,shaman,elemental,12,5,7
Flamestrife,illidan,480,shaman,elemental,12,5,7
Flukz,nazjatar,480,shaman,elemental,12,5,7
Jènova,whisperwind,480,shaman,elemental,12,5,7
Zeebouzy,illidan,480,shaman,elemental,12,5,7
Wobbleshock,tichondrius,480,shaman,elemental,12,5,7
Trickytotems,stormrage,480,shaman,elemental,12,5,7
Fonsestrelly,emerald-dream,480,shaman,elemental,12,5,7
Slumpinator,tichondrius,480,shaman,elemental,12,5,7
Hexxercise,area-52,480,shaman,elemental,12,5,7
Gjaj,tichondrius,480,shaman,elemental,12,5,7
Shamberheard,kelthuzad,480,shaman,elemental,12,5,7
Grêgg,area-52,480,shaman,elemental,12,5,7
Chomolungma,azralon,480,shaman,elemental,12,5,7
Kissmywalnut,frostmourne,480,shaman,elemental,12,5,7
Thadx,illidan,480,shaman,elemental,12,5,7
Mariarlee,proudmoore,480,shaman,elemental,12,5,7
Drakhe,proudmoore,480,shaman,elemental,12,5,7
Daerönn,azralon,480,shaman,elemental,12,5,7
Jaedrick,chogall,480,shaman,elemental,12,5,7
Zenan,stormreaver,480,shaman,elemental,12,5,7
Sgorr,illidan,480,shaman,elemental,12,5,7
Delement,ragnaros,480,shaman,elemental,12,5,7
Athymus,dragonmaw,480,shaman,elemental,12,5,7
Twistedteas,tichondrius,480,shaman,elemental,12,5,7
Zajashuna,malganis,480,shaman,elemental,12,5,7
Wempa,moon-guard,480,shaman,elemental,12,5,7
Ferdi,kelthuzad,480,shaman,elemental,12,5,7
Junkygreens,proudmoore,480,shaman,elemental,12,5,7
Totemchucker,stormrage,480,shaman,elemental,15,6,9
Flamelink,tichondrius,480,shaman,elemental,20,6,14
Hazznokicks,bleeding-hollow,480,shaman,elemental,21,6,15
Advìl,area-52,480,shaman,elemental,18,5,13
Dwârf,tichondrius,480,shaman,elemental,18,5,13
Firesurge,sargeras,480,shaman,elemental,18,5,13
Arialial,hyjal,480,shaman,elemental,18,5,13
Helapoon,area-52,480,shaman,elemental,18,5,13
Zevelynne,wyrmrest-accord,480,shaman,elemental,24,5,19
Vjeze,frostmourne,480,shaman,elemental,24,5,19
Virô,sargeras,479,shaman,elemental,6,5,1
Shanão,nemesis,479,shaman,elemental,6,5,1
Killdeaderer,barthilas,479,shaman,elemental,6,5,1
Carrbide,malganis,479,shaman,elemental,12,5,7
Ðarkvolts,stormrage,479,shaman,elemental,12,5,7
Sparkyy,kelthuzad,479,shaman,elemental,12,5,7
Olthorson,kelthuzad,479,shaman,elemental,18,5,13
Doughboy,khadgar,478,shaman,elemental,14,6,8
Santee,frostmourne,478,shaman,elemental,12,5,7
Diokles,skywall,478,shaman,elemental,12,5,7
Talraviebor,stormrage,478,shaman,elemental,12,5,7
Tulwah,shadowmoon,447,shaman,elemental,11,6,5
Slogre,tichondrius,447,shaman,elemental,11,5,6
Frequency,kiljaeden,447,shaman,elemental,17,5,12
Adesaa,illidan,426,shaman,elemental,22,6,16
Gunai,malganis,416,shaman,elemental,10,5,5
Kinjin,dragonmaw,415,shaman,elemental,14,5,9
Ripklanian,blood-furnace,400,shaman,elemental,13,5,8
Dgshaman,tichondrius,384,shaman,elemental,6,4,2
Nerfele,tichondrius,384,shaman,elemental,6,4,2
Thunderfuk,exodar,384,shaman,elemental,6,4,2
Ruugo,malganis,384,shaman,elemental,6,4,2
Clamson,tichondrius,384,shaman,elemental,6,4,2
Boøsty,bleeding-hollow,384,shaman,elemental,6,4,2
Coldbeer,frostmourne,384,shaman,elemental,6,4,2
Ryùko,proudmoore,384,shaman,elemental,6,4,2
Weebdestroyr,illidan,384,shaman,elemental,6,4,2
Stormflow,dalaran,384,shaman,elemental,6,4,2
Yeoldkobb,kiljaeden,384,shaman,elemental,6,4,2
Synkrona,tichondrius,384,shaman,elemental,6,4,2
Elebro,emerald-dream,384,shaman,elemental,6,4,2
Ginnagangus,mugthol,384,shaman,elemental,6,4,2
Shammyqua,tichondrius,384,shaman,elemental,6,4,2
Riicc,stormrage,384,shaman,elemental,6,4,2
Jimmyapple,illidan,384,shaman,elemental,6,4,2
Novoz,tichondrius,384,shaman,elemental,6,4,2
Enil,kiljaeden,384,shaman,elemental,6,4,2
Ktom,runetotem,384,shaman,elemental,6,4,2
Dromus,dalvengyr,384,shaman,elemental,6,4,2
Simped,bleeding-hollow,384,shaman,elemental,6,4,2
Dingfu,sargeras,384,shaman,elemental,6,4,2
Oscarmike,auchindoun,384,shaman,elemental,6,4,2
Greensween,thrall,384,shaman,elemental,6,4,2
Wolfgangz,illidan,384,shaman,elemental,6,4,2
Munchies,madoran,384,shaman,elemental,6,4,2
Boogiefever,area-52,384,shaman,elemental,6,4,2
Checkmâte,emerald-dream,384,shaman,elemental,6,4,2
Dragaru,illidan,384,shaman,elemental,6,4,2
Terapatrik,area-52,384,shaman,elemental,6,4,2
Zezlek,malganis,384,shaman,elemental,6,4,2
Knowknown,tichondrius,384,shaman,elemental,6,4,2
Semnicktotem,area-52,384,shaman,elemental,6,4,2
Seraøth,area-52,384,shaman,elemental,6,4,2
Sammila,tichondrius,384,shaman,elemental,6,4,2
Hulan,tichondrius,384,shaman,elemental,6,4,2
Nyroh,zuljin,384,shaman,elemental,6,4,2
Borgmash,chogall,384,shaman,elemental,6,4,2
Ryuubi,illidan,384,shaman,elemental,6,4,2
Kranif,tichondrius,384,shaman,elemental,6,4,2
Wodgodx,sargeras,384,shaman,elemental,6,4,2
Meatballman,malganis,384,shaman,elemental,6,4,2
Lukora,stonemaul,384,shaman,elemental,6,4,2
Trickyjf,dalaran,384,shaman,elemental,6,4,2
Yshi,kelthuzad,384,shaman,elemental,6,4,2
Thorlottie,stormrage,384,shaman,elemental,6,4,2
Mcßooger,tichondrius,384,shaman,elemental,6,4,2
Zappithorus,stormrage,384,shaman,elemental,6,4,2
Drcopafeel,stormrage,384,shaman,elemental,6,4,2
Blueku,tichondrius,384,shaman,elemental,6,4,2
Paltalk,the-forgotten-coast,384,shaman,elemental,6,4,2
Super,azshara,384,shaman,elemental,14,5,9
Nobosham,tichondrius,384,shaman,elemental,12,4,8
Kushnations,chogall,384,shaman,elemental,12,4,8
Natorr,dalaran,384,shaman,elemental,12,4,8
Sin,bleeding-hollow,384,shaman,elemental,12,4,8
Jhivone,tichondrius,384,shaman,elemental,12,4,8
Manitbaggins,earthen-ring,384,shaman,elemental,12,4,8
Duza,frostmourne,384,shaman,elemental,12,4,8
Yukishock,illidan,384,shaman,elemental,12,4,8
Fatherrtime,illidan,384,shaman,elemental,12,4,8
Chainz,illidan,384,shaman,elemental,12,4,8
Ayatsu,thrall,384,shaman,elemental,12,4,8
Lavasurge,area-52,384,shaman,elemental,12,4,8
Rudoboy,ragnaros,384,shaman,elemental,12,4,8
Elryl,sargeras,384,shaman,elemental,12,4,8
Benserkr,lightbringer,384,shaman,elemental,12,4,8
Oohkillemm,silvermoon,384,shaman,elemental,12,4,8
Gomaliquida,quelthalas,384,shaman,elemental,12,4,8
Aiggiggigne,sargeras,384,shaman,elemental,12,4,8
Fouroclock,drakthul,384,shaman,elemental,12,4,8
Shrektar,cenarius,384,shaman,elemental,12,4,8
Naweiv,caelestrasz,384,shaman,elemental,12,4,8
Zizö,barthilas,384,shaman,elemental,12,4,8
Sjostrom,proudmoore,384,shaman,elemental,12,4,8
Rosettee,stormrage,384,shaman,elemental,12,4,8
Anahvee,moon-guard,384,shaman,elemental,12,4,8
Volcanic,azuremyst,384,shaman,elemental,12,4,8
Tdub,frostmourne,384,shaman,elemental,18,4,14
Rickin,hyjal,384,shaman,elemental,18,4,14
Beazel,moon-guard,384,shaman,elemental,18,4,14
Bigstormz,fenris,384,shaman,elemental,18,4,14
Zappyshorty,sargeras,383,shaman,elemental,6,4,2
Hëïmdall,stormrage,383,shaman,elemental,12,4,8
Enroks,greymane,383,shaman,elemental,12,4,8
Machalo,sargeras,383,shaman,elemental,12,4,8
Stórmfuryz,tichondrius,382,shaman,elemental,12,4,8
Roxastir,shattered-halls,382,shaman,elemental,12,4,8
Potatopirate,burning-legion,381,shaman,elemental,18,4,14
Coffeeblacc,magtheridon,379,shaman,elemental,12,4,8
Babyblake,malganis,351,shaman,elemental,8,5,3
Branasou,emerald-dream,351,shaman,elemental,11,4,7
Shk,illidan,351,shaman,elemental,11,4,7
Råys,turalyon,350,shaman,elemental,11,4,7
Stormfronts,kelthuzad,336,shaman,elemental,9,4,5
Trashaman,garona,336,shaman,elemental,9,4,5
Nondracil,ragnaros,336,shaman,elemental,14,4,10
Taraneh,garrosh,325,shaman,elemental,15,5,10
Shamankie,tichondrius,319,shaman,elemental,5,4,1
Orochishaman,stormrage,319,shaman,elemental,5,4,1
Shup,chogall,319,shaman,elemental,5,4,1
Charr,nemesis,304,shaman,elemental,7,4,3
Tsunamibrew,moon-guard,302,shaman,elemental,9,4,5
Iloverina,stormrage,288,shaman,elemental,6,3,3
Awesomeus,barthilas,288,shaman,elemental,6,3,3
Tokelahoma,stormrage,288,shaman,elemental,6,3,3
Fluffyhex,sargeras,288,shaman,elemental,6,3,3
Corneador,ragnaros,288,shaman,elemental,6,3,3
Passion,sargeras,288,shaman,elemental,6,3,3
Oxforcefairy,tichondrius,288,shaman,elemental,6,3,3
Altryn,shuhalo,288,shaman,elemental,6,3,3
Trenhance,stormrage,288,shaman,elemental,6,3,3
Woepost,tichondrius,288,shaman,elemental,6,3,3
Dì,barthilas,288,shaman,elemental,6,3,3
Headshake,malganis,288,shaman,elemental,6,3,3
Aerôv,area-52,288,shaman,elemental,6,3,3
Jaxlightning,nemesis,288,shaman,elemental,6,3,3
Malgrave,ragnaros,288,shaman,elemental,6,3,3
Mønønøke,tichondrius,288,shaman,elemental,6,3,3
Exsh,area-52,288,shaman,elemental,6,3,3
Jurafxdqt,malganis,288,shaman,elemental,6,3,3
Fattizer,sargeras,288,shaman,elemental,6,3,3
Ioki,spirestone,288,shaman,elemental,6,3,3
Dazu,drakkari,288,shaman,elemental,6,3,3
Atokirina,drakkari,288,shaman,elemental,6,3,3
Oingo,destromath,288,shaman,elemental,6,3,3
Spacemilk,stormrage,288,shaman,elemental,6,3,3
Arckos,thrall,288,shaman,elemental,6,3,3
Hedeadx,illidan,288,shaman,elemental,6,3,3
Garalath,bleeding-hollow,288,shaman,elemental,6,3,3
Wabiex,illidan,288,shaman,elemental,6,3,3
Raikages,whisperwind,288,shaman,elemental,6,3,3
Improvize,malganis,288,shaman,elemental,6,3,3
Mabite,frostmourne,288,shaman,elemental,6,3,3
Éarl,sargeras,288,shaman,elemental,6,3,3
Zon,laughing-skull,288,shaman,elemental,6,3,3
Frenchy,hyjal,288,shaman,elemental,6,3,3
Scarshamxn,frostmourne,288,shaman,elemental,6,3,3
Autisty,sargeras,288,shaman,elemental,6,3,3
Moosk,zuluhed,288,shaman,elemental,6,3,3
Nybrax,moknathal,288,shaman,elemental,6,3,3
Groink,kiljaeden,288,shaman,elemental,6,3,3
Blaydin,elune,288,shaman,elemental,6,3,3
Zemleroynoyy,magtheridon,288,shaman,elemental,6,3,3
Largerwang,sargeras,288,shaman,elemental,6,3,3
Vozi,magtheridon,288,shaman,elemental,6,3,3
Hamrok,moon-guard,288,shaman,elemental,6,3,3
Floon,barthilas,288,shaman,elemental,6,3,3
Applicable,tichondrius,288,shaman,elemental,6,3,3
Cvoa,bonechewer,288,shaman,elemental,6,3,3
Raiden,gorgonnash,288,shaman,elemental,6,3,3
Shizamm,hyjal,288,shaman,elemental,6,3,3
Shàman,durotan,288,shaman,elemental,6,3,3
Bigdumb,blackrock,288,shaman,elemental,6,3,3
Shamtactic,thrall,288,shaman,elemental,6,3,3
Vanëssão,stormrage,288,shaman,elemental,6,3,3
Axshaman,darkspear,288,shaman,elemental,6,3,3
Shamyuna,dalaran,288,shaman,elemental,6,3,3
Gödöfbüdå,tichondrius,288,shaman,elemental,6,3,3
Ragor,quelthalas,288,shaman,elemental,6,3,3
Thelphor,nemesis,288,shaman,elemental,6,3,3
Earthfurÿ,quelthalas,288,shaman,elemental,6,3,3
Kurzee,kelthuzad,288,shaman,elemental,6,3,3
Niarkx,frostmourne,288,shaman,elemental,6,3,3
Healingtime,nerzhul,288,shaman,elemental,6,3,3
Dialtone,blackrock,288,shaman,elemental,6,3,3
Tethai,moon-guard,288,shaman,elemental,6,3,3
Blakki,barthilas,288,shaman,elemental,6,3,3
Josephor,lightnings-blade,288,shaman,elemental,6,3,3
Grwarf,korgath,288,shaman,elemental,6,3,3
Häzel,nerzhul,288,shaman,elemental,6,3,3
Daiablo,barthilas,288,shaman,elemental,6,3,3
Arakimara,tichondrius,288,shaman,elemental,6,3,3
Elereeper,area-52,288,shaman,elemental,6,3,3
Talfur,area-52,288,shaman,elemental,6,3,3
Fobb,area-52,288,shaman,elemental,6,3,3
Shajay,area-52,288,shaman,elemental,6,3,3
Bens,malganis,288,shaman,elemental,6,3,3
Barlonso,illidan,288,shaman,elemental,6,3,3
Xhamankng,quelthalas,288,shaman,elemental,6,3,3
Shadeele,cenarius,288,shaman,elemental,6,3,3
Doop,kiljaeden,288,shaman,elemental,6,3,3
Bizle,jaedenar,288,shaman,elemental,6,3,3
Rampàge,ragnaros,288,shaman,elemental,6,3,3
Bolteon,malganis,288,shaman,elemental,6,3,3
Neesta,ragnaros,288,shaman,elemental,6,3,3
Jamsham,tichondrius,288,shaman,elemental,6,3,3
Curtrex,amanthul,288,shaman,elemental,6,3,3
Vibration,akama,288,shaman,elemental,6,3,3
Grimnur,bleeding-hollow,288,shaman,elemental,11,3,8
Honix,area-52,288,shaman,elemental,12,3,9
Healsquish,area-52,288,shaman,elemental,12,3,9
Sumyl,ragnaros,288,shaman,elemental,12,3,9
Coercè,tichondrius,288,shaman,elemental,12,3,9
Juicemcroose,zuljin,288,shaman,elemental,12,3,9
Tawahka,hyjal,288,shaman,elemental,12,3,9
Bloodytotemz,emerald-dream,288,shaman,elemental,12,3,9
Stormklepter,fizzcrank,288,shaman,elemental,12,3,9
Taquitho,quelthalas,288,shaman,elemental,12,3,9
Bitflip,jubeithos,288,shaman,elemental,12,3,9
Lumpyshaman,tichondrius,288,shaman,elemental,12,3,9
Døcholliday,zuluhed,288,shaman,elemental,12,3,9
Onicharm,frostmourne,288,shaman,elemental,12,3,9
Emptee,area-52,288,shaman,elemental,12,3,9
Frakk,silvermoon,288,shaman,elemental,12,3,9
Birdizdawerd,shuhalo,288,shaman,elemental,12,3,9
Winiethepoöh,stormrage,288,shaman,elemental,12,3,9
Selexi,skywall,288,shaman,elemental,12,3,9
Zarîks,kelthuzad,288,shaman,elemental,12,3,9
Olex,zuluhed,288,shaman,elemental,12,3,9
Rìddles,malygos,288,shaman,elemental,18,3,15
Stîînck,azralon,288,shaman,elemental,18,3,15
Strikzjr,frostmourne,287,shaman,elemental,6,3,3
Arakye,stormrage,287,shaman,elemental,6,3,3
Juanisan,stormrage,287,shaman,elemental,6,3,3
Balrog,vashj,287,shaman,elemental,12,3,9
Slåpntickle,darkspear,287,shaman,elemental,12,3,9
Trabolta,hyjal,287,shaman,elemental,12,3,9
Brokahantas,misha,287,shaman,elemental,14,3,11
Awakarn,emerald-dream,287,shaman,elemental,24,4,20
Cropdustr,sargeras,286,shaman,elemental,6,3,3
Hannibol,tichondrius,255,shaman,elemental,11,3,8
Hexytimexoqt,thrall,255,shaman,elemental,11,3,8
Oxxnabatko,amanthul,240,shaman,elemental,9,3,6
Liamus,amanthul,239,shaman,elemental,5,3,2
Ppepe,boulderfist,239,shaman,elemental,5,3,2
Spunjie,frostmourne,239,shaman,elemental,5,3,2
Nikeshocks,detheroc,239,shaman,elemental,5,3,2
Zeldrys,emerald-dream,192,shaman,elemental,6,2,4
Kanbar,emerald-dream,192,shaman,elemental,6,2,4
Chadious,illidan,192,shaman,elemental,6,2,4
Shockt,wyrmrest-accord,192,shaman,elemental,6,2,4
Blaiserpub,tichondrius,192,shaman,elemental,6,2,4
Grandpatits,illidan,192,shaman,elemental,6,2,4
Killtotem,illidan,192,shaman,elemental,6,2,4
Krilick,blackrock,192,shaman,elemental,6,2,4
Jbahr,hyjal,192,shaman,elemental,6,2,4
Yagers,illidan,192,shaman,elemental,6,2,4
Yssyyds,illidan,192,shaman,elemental,6,2,4
Vööbrew,illidan,192,shaman,elemental,6,2,4
Elîas,tichondrius,192,shaman,elemental,6,2,4
Naextramus,ragnaros,192,shaman,elemental,6,2,4
Shablam,daggerspine,192,shaman,elemental,6,2,4
Oriyani,sargeras,192,shaman,elemental,6,2,4
Oppaswag,tichondrius,192,shaman,elemental,6,2,4
Redbulls,azralon,192,shaman,elemental,6,2,4
Dantheman,twisting-nether,192,shaman,elemental,6,2,4
Yangsangchu,tichondrius,192,shaman,elemental,6,2,4
Ric,malganis,192,shaman,elemental,6,2,4
Piffzorz,tichondrius,192,shaman,elemental,6,2,4
Saltywap,proudmoore,192,shaman,elemental,6,2,4
Drünk,hyjal,192,shaman,elemental,6,2,4
Flappygooch,illidan,192,shaman,elemental,6,2,4
Lenxd,dalaran,192,shaman,elemental,6,2,4
Thormzz,tichondrius,192,shaman,elemental,6,2,4
Stickshaman,sargeras,192,shaman,elemental,6,2,4
Ladash,ragnaros,192,shaman,elemental,6,2,4
Zugharder,illidan,192,shaman,elemental,6,2,4
Zaxibow,area-52,192,shaman,elemental,6,2,4
Hehew,kelthuzad,192,shaman,elemental,6,2,4
Ahwahsahdood,stormreaver,192,shaman,elemental,6,2,4
Feels,arthas,192,shaman,elemental,6,2,4
Doomberrie,thrall,192,shaman,elemental,6,2,4
Gorillox,chogall,192,shaman,elemental,6,2,4
Noether,sargeras,192,shaman,elemental,6,2,4
Hruggol,bleeding-hollow,192,shaman,elemental,6,2,4
Yellowfev,thrall,192,shaman,elemental,6,2,4
Nevershockx,kirin-tor,192,shaman,elemental,6,2,4
Eekumbokum,bleeding-hollow,192,shaman,elemental,6,2,4
Sharmut,bleeding-hollow,192,shaman,elemental,6,2,4
Shamantimes,ragnaros,192,shaman,elemental,6,2,4
Alleys,tichondrius,192,shaman,elemental,6,2,4
Rokhnar,zuljin,192,shaman,elemental,6,2,4
Blastj,tichondrius,192,shaman,elemental,6,2,4
Fromundcheez,kelthuzad,192,shaman,elemental,6,2,4
Tartar,lightbringer,192,shaman,elemental,6,2,4
Gulmuwu,zuljin,192,shaman,elemental,6,2,4
Bigbadbolt,malganis,192,shaman,elemental,6,2,4
Funeropolis,stormrage,192,shaman,elemental,6,2,4
Goblarnit,gorefiend,192,shaman,elemental,6,2,4
Stormysteve,hyjal,192,shaman,elemental,6,2,4
Artnatu,nemesis,192,shaman,elemental,6,2,4
Niian,skullcrusher,192,shaman,elemental,6,2,4
Snoocher,kelthuzad,192,shaman,elemental,6,2,4
Rinjio,zuljin,192,shaman,elemental,6,2,4
Shåmwowz,sargeras,192,shaman,elemental,6,2,4
Britisy,stormrage,192,shaman,elemental,6,2,4
Praisegodx,stormrage,192,shaman,elemental,6,2,4
Quakestorm,stormrage,192,shaman,elemental,6,2,4
Heniu,tichondrius,192,shaman,elemental,6,2,4
Ínfected,azralon,192,shaman,elemental,6,2,4
Shamsky,tichondrius,192,shaman,elemental,6,2,4
Matzahmeal,skywall,192,shaman,elemental,6,2,4
Tacotastic,malganis,192,shaman,elemental,6,2,4
Wrestleman,drakthul,192,shaman,elemental,6,2,4
Whitecake,frostmourne,192,shaman,elemental,6,2,4
Kayzee,malganis,192,shaman,elemental,6,2,4
Dirtyprocs,tichondrius,192,shaman,elemental,6,2,4
Puntress,barthilas,192,shaman,elemental,6,2,4
Plasticity,spirestone,192,shaman,elemental,6,2,4
Sid,frostmourne,192,shaman,elemental,6,2,4
Trizzeh,moon-guard,192,shaman,elemental,6,2,4
Shockbot,stormscale,192,shaman,elemental,6,2,4
Grandmaster,frostmourne,192,shaman,elemental,6,2,4
Zuroster,kiljaeden,192,shaman,elemental,7,2,5
Martisor,barthilas,192,shaman,elemental,16,3,13
Electrïck,tichondrius,192,shaman,elemental,12,2,10
Gaboola,tichondrius,192,shaman,elemental,12,2,10
Jedley,azshara,192,shaman,elemental,12,2,10
Fulingyu,moon-guard,192,shaman,elemental,12,2,10
Golemagg,frostmourne,192,shaman,elemental,12,2,10
Harrìson,tichondrius,192,shaman,elemental,12,2,10
Jazzblast,tichondrius,192,shaman,elemental,12,2,10
Fluffy,smolderthorn,192,shaman,elemental,12,2,10
Mega,azralon,192,shaman,elemental,12,2,10
Azl,guldan,192,shaman,elemental,13,2,11
Telryndas,hyjal,192,shaman,elemental,18,2,16
Cyrah,azjolnerub,192,shaman,elemental,18,2,16
Eleveil,emerald-dream,191,shaman,elemental,9,2,7
Hakaskry,caelestrasz,191,shaman,elemental,12,2,10
Statikrage,eonar,180,shaman,elemental,20,5,15
Ramonsanchez,ragnaros,160,shaman,elemental,16,2,14
Mentàl,baelgun,159,shaman,elemental,5,2,3
Hazzardttvz,illidan,159,shaman,elemental,5,2,3
Kidkovid,illidan,159,shaman,elemental,17,2,15
Noslol,bronzebeard,138,shaman,elemental,9,3,6
Uracemytotem,kiljaeden,138,shaman,elemental,10,3,7
Mynigabob,zuljin,128,shaman,elemental,4,2,2
Rahloo,sargeras,127,shaman,elemental,8,2,6
Kobecoopper,sargeras,96,shaman,elemental,6,1,5
Teathin,ragnaros,96,shaman,elemental,6,1,5
Mugiwára,ragnaros,96,shaman,elemental,6,1,5
Orruddon,thaurissan,96,shaman,elemental,6,1,5
Hexondabeach,barthilas,96,shaman,elemental,6,1,5
Staticshok,moon-guard,96,shaman,elemental,6,1,5
Ravaburst,sargeras,96,shaman,elemental,6,1,5
Parallels,blackrock,96,shaman,elemental,6,1,5
Khoden,emerald-dream,96,shaman,elemental,6,1,5
Mdawwg,kelthuzad,96,shaman,elemental,6,1,5
Nerfmytotemz,frostmourne,96,shaman,elemental,6,1,5
Succies,emerald-dream,96,shaman,elemental,6,1,5
Bouje,frostmourne,96,shaman,elemental,6,1,5
Gan,silvermoon,96,shaman,elemental,6,1,5
Thunderbudx,stonemaul,96,shaman,elemental,6,1,5
Ludacrìtz,stormrage,96,shaman,elemental,6,1,5
Drmn,frostmourne,96,shaman,elemental,6,1,5
Snowzy,icecrown,96,shaman,elemental,6,1,5
Tipedc,sargeras,96,shaman,elemental,6,1,5
Macdiesel,tichondrius,96,shaman,elemental,6,1,5
Oakshield,darkspear,96,shaman,elemental,6,1,5
Zral,emerald-dream,96,shaman,elemental,6,1,5
Girafasuarx,korgath,96,shaman,elemental,6,1,5
Bullcowsby,darkspear,96,shaman,elemental,6,1,5
Macdab,malganis,96,shaman,elemental,6,1,5
Zorgen,anvilmar,96,shaman,elemental,6,1,5
Detair,malganis,96,shaman,elemental,6,1,5
Ognerkish,black-dragonflight,96,shaman,elemental,6,1,5
Ggsggs,akama,96,shaman,elemental,6,1,5
Toxidizetkö,azralon,96,shaman,elemental,6,1,5
Cathxy,kelthuzad,96,shaman,elemental,6,1,5
Obiwonsamdi,illidan,96,shaman,elemental,6,1,5
Seanie,bleeding-hollow,96,shaman,elemental,6,1,5
Youngmulakek,area-52,96,shaman,elemental,6,1,5
Nazgore,jubeithos,96,shaman,elemental,6,1,5
Aegaeonlol,tichondrius,96,shaman,elemental,6,1,5
Tatius,stormreaver,96,shaman,elemental,6,1,5
Muruaic,dentarg,96,shaman,elemental,6,1,5
Buckshott,chogall,96,shaman,elemental,6,1,5
Mcshockturds,tichondrius,96,shaman,elemental,6,1,5
Oldshammy,eldrethalas,96,shaman,elemental,6,1,5
Crigga,dalaran,96,shaman,elemental,6,1,5
Firevag,hakkar,96,shaman,elemental,6,1,5
Sinsar,illidan,96,shaman,elemental,6,1,5
Staticshock,darkspear,96,shaman,elemental,12,1,11
Eleshamanz,tichondrius,79,shaman,elemental,5,1,4
Necrolords,tichondrius,79,shaman,elemental,5,1,4
Docadams,chogall,79,shaman,elemental,5,1,4
Camltotem,tichondrius,79,shaman,elemental,5,1,4
Mcstop,tanaris,64,shaman,elemental,4,1,3
Gurdle,frostwolf,48,shaman,elemental,3,1,2
Hbjj,illidan,48,shaman,elemental,3,1,2
Hentaistorm,kiljaeden,48,shaman,elemental,3,1,2
Keyarga,ravencrest,42,shaman,elemental,11,2,9
Dermbo,frostmourne,31,shaman,elemental,2,1,1
Hothouse,malganis,31,shaman,elemental,2,1,1
Elementium,azshara,16,shaman,elemental,1,1,0
Djskinflute,bleeding-hollow,16,shaman,elemental,1,1,0
Deldoduro,azralon,16,shaman,elemental,1,1,0
Jumoma,thrall,16,shaman,elemental,1,1,0
Hizúrú,tichondrius,2282,shaman,enhancement,132,74,58
Vanhalestorm,frostmourne,2264,shaman,enhancement,106,58,48
Mítsurí,tichondrius,2244,shaman,enhancement,210,109,101
Rauthgar,dalaran,2221,shaman,enhancement,114,66,48
Saul,tichondrius,2218,shaman,enhancement,66,42,24
Zarktwo,azralon,2205,shaman,enhancement,153,83,70
Aýanokoji,tichondrius,2201,shaman,enhancement,137,74,63
Alleys,tichondrius,2185,shaman,enhancement,231,118,113
Musclebrains,tichondrius,2176,shaman,enhancement,84,48,36
Axegerd,quelthalas,2147,shaman,enhancement,242,132,110
Bøulderfist,tichondrius,2142,shaman,enhancement,120,76,44
Opoy,sargeras,2142,shaman,enhancement,201,112,89
Musclebrain,tichondrius,2140,shaman,enhancement,174,89,85
Stew,illidan,2138,shaman,enhancement,125,67,58
Crowns,tichondrius,2136,shaman,enhancement,114,59,55
Nopnopajnin,tichondrius,2135,shaman,enhancement,112,57,55
Skydre,area-52,2131,shaman,enhancement,89,54,35
Jimmyjobs,tichondrius,2129,shaman,enhancement,114,70,44
Futeuncle,tichondrius,2123,shaman,enhancement,78,41,37
Swolé,emerald-dream,2122,shaman,enhancement,424,214,210
Stormnala,zuljin,2116,shaman,enhancement,162,92,70
Ftyue,area-52,2116,shaman,enhancement,112,59,53
Rawdòggin,emerald-dream,2113,shaman,enhancement,71,45,26
Proctopus,moon-guard,2112,shaman,enhancement,172,98,74
Musclebrainz,tichondrius,2112,shaman,enhancement,84,41,43
Shapaman,tichondrius,2110,shaman,enhancement,77,53,24
Bjorengahr,emerald-dream,2110,shaman,enhancement,83,53,30
Smxxn,tichondrius,2110,shaman,enhancement,107,52,55
Doomwìnds,stormrage,2108,shaman,enhancement,168,93,75
Shamsz,frostmourne,2106,shaman,enhancement,72,48,24
Wetdraenei,moon-guard,2102,shaman,enhancement,271,152,119
Baseballcap,sargeras,2070,shaman,enhancement,96,58,38
Lashandtrash,tichondrius,2064,shaman,enhancement,54,35,19
Peynful,shadowsong,2063,shaman,enhancement,87,54,33
Shakeys,tichondrius,2060,shaman,enhancement,77,49,28
Realypump,area-52,2046,shaman,enhancement,215,111,104
Zarasvati,tichondrius,2029,shaman,enhancement,167,88,79
Xiaoxiboy,tichondrius,2026,shaman,enhancement,60,38,22
Tastydonut,blackrock,2026,shaman,enhancement,116,70,46
Jazzlightnin,tichondrius,2018,shaman,enhancement,58,36,22
Lustingchery,area-52,2017,shaman,enhancement,123,63,60
Algresh,muradin,2015,shaman,enhancement,66,33,33
Rozboiclique,frostmourne,2012,shaman,enhancement,150,101,49
Windshearbøt,tichondrius,2006,shaman,enhancement,77,47,30
Shamguards,tichondrius,2004,shaman,enhancement,42,31,11
Stronghit,tichondrius,2004,shaman,enhancement,60,32,28
Enhancex,frostwolf,2001,shaman,enhancement,68,36,32
Oosheratchet,illidan,1992,shaman,enhancement,64,44,20
Thiccsha,moon-guard,1985,shaman,enhancement,78,42,36
Beañ,barthilas,1983,shaman,enhancement,352,182,170
Shylabuffkin,area-52,1981,shaman,enhancement,295,159,136
Crownsx,tichondrius,1980,shaman,enhancement,91,41,50
Dopeysimida,illidan,1976,shaman,enhancement,92,57,35
Pizzashaman,illidan,1970,shaman,enhancement,109,64,45
Windfury,chogall,1968,shaman,enhancement,96,51,45
Futeboy,tichondrius,1967,shaman,enhancement,63,32,31
Gatorwaves,bleeding-hollow,1965,shaman,enhancement,54,32,22
Shk,illidan,1964,shaman,enhancement,66,38,28
Zootywild,tichondrius,1963,shaman,enhancement,123,69,54
Grum,zuljin,1961,shaman,enhancement,48,27,21
Spippippin,illidan,1958,shaman,enhancement,92,47,45
Swrdfsh,tichondrius,1955,shaman,enhancement,276,143,133
Typhe,bleeding-hollow,1954,shaman,enhancement,42,27,15
Imchuckbass,tichondrius,1954,shaman,enhancement,122,64,58
Rukagar,barthilas,1951,shaman,enhancement,90,53,37
Dalianyen,bladefist,1951,shaman,enhancement,104,54,50
Balgron,emerald-dream,1949,shaman,enhancement,52,26,26
Tokyofresh,malganis,1947,shaman,enhancement,222,128,94
Ohmálley,tichondrius,1944,shaman,enhancement,62,40,22
Temar,sargeras,1937,shaman,enhancement,89,59,30
Ogeezkush,zuljin,1935,shaman,enhancement,160,93,67
Shakeysham,tichondrius,1934,shaman,enhancement,48,29,19
Kaediea,moon-guard,1932,shaman,enhancement,36,27,9
Artenior,stormrage,1930,shaman,enhancement,135,70,65
Revtide,thrall,1927,shaman,enhancement,72,40,32
Xiaoxiaoxi,tichondrius,1924,shaman,enhancement,60,34,26
Grommi,proudmoore,1924,shaman,enhancement,405,201,204
Fwwrs,illidan,1919,shaman,enhancement,79,51,28
Hallofcost,illidan,1918,shaman,enhancement,150,89,61
Bestshamus,sargeras,1913,shaman,enhancement,83,49,34
Ballinhance,illidan,1908,shaman,enhancement,54,31,23
Earlainn,stormrage,1905,shaman,enhancement,84,48,36
Scaman,tichondrius,1904,shaman,enhancement,24,20,4
Chillpoppin,emerald-dream,1904,shaman,enhancement,42,31,11
Cowaii,illidan,1904,shaman,enhancement,60,37,23
Greenydapooh,nerzhul,1903,shaman,enhancement,60,40,20
Meataballa,the-underbog,1902,shaman,enhancement,72,45,27
Interruptbøt,tichondrius,1901,shaman,enhancement,44,28,16
Sasageyo,tichondrius,1900,shaman,enhancement,37,24,13
Keyturn,tichondrius,1899,shaman,enhancement,78,36,42
Bluntboy,zuljin,1895,shaman,enhancement,62,43,19
Eletastic,tichondrius,1894,shaman,enhancement,72,42,30
Olxsixsm,illidan,1884,shaman,enhancement,74,48,26
Gìmli,tichondrius,1882,shaman,enhancement,65,37,28
Electricity,tichondrius,1880,shaman,enhancement,127,63,64
Daysub,crushridge,1877,shaman,enhancement,60,34,26
Plsnerfret,stormrage,1876,shaman,enhancement,48,33,15
Stormrageman,tichondrius,1875,shaman,enhancement,81,49,32
Harrypotqueu,zuljin,1875,shaman,enhancement,72,40,32
Youngmulakek,area-52,1870,shaman,enhancement,125,83,42
Vonvulviln,emerald-dream,1868,shaman,enhancement,76,41,35
Dano,tichondrius,1867,shaman,enhancement,124,64,60
Napski,cenarius,1866,shaman,enhancement,90,44,46
Jayhastotems,area-52,1864,shaman,enhancement,102,71,31
Zarrka,tichondrius,1864,shaman,enhancement,36,20,16
Superchief,altar-of-storms,1864,shaman,enhancement,104,56,48
Taowth,tichondrius,1862,shaman,enhancement,35,20,15
Ëxceeder,ragnaros,1861,shaman,enhancement,138,78,60
Lavamon,illidan,1860,shaman,enhancement,84,49,35
Blumengarten,stormrage,1858,shaman,enhancement,114,73,41
Wonima,tichondrius,1858,shaman,enhancement,35,20,15
Doomberrie,thrall,1858,shaman,enhancement,138,77,61
Kiddfurious,kelthuzad,1858,shaman,enhancement,132,67,65
Zizö,barthilas,1857,shaman,enhancement,78,54,24
Shamikazi,crushridge,1857,shaman,enhancement,194,115,79
Taikø,area-52,1856,shaman,enhancement,42,25,17
Loabud,tichondrius,1855,shaman,enhancement,58,37,21
Lavitris,illidan,1854,shaman,enhancement,42,29,13
Mcshockturds,tichondrius,1849,shaman,enhancement,143,82,61
Gïrthquake,tichondrius,1849,shaman,enhancement,84,45,39
Antek,quelthalas,1847,shaman,enhancement,165,97,68
Undertów,area-52,1847,shaman,enhancement,48,26,22
Zeûs,lightbringer,1846,shaman,enhancement,72,41,31
Xakaeri,hyjal,1844,shaman,enhancement,60,36,24
Koalakisses,shadow-council,1842,shaman,enhancement,54,32,22
Wautyriex,area-52,1842,shaman,enhancement,54,28,26
Ishano,area-52,1839,shaman,enhancement,48,23,25
Bodai,magtheridon,1838,shaman,enhancement,54,36,18
Bikboisteez,barthilas,1838,shaman,enhancement,98,51,47
Dcg,hyjal,1838,shaman,enhancement,65,33,32
Vulcänyr,quelthalas,1837,shaman,enhancement,60,34,26
Berxek,tichondrius,1835,shaman,enhancement,48,27,21
Thuntard,bleeding-hollow,1835,shaman,enhancement,66,33,33
Kltz,sargeras,1832,shaman,enhancement,53,30,23
Blueraccoon,tichondrius,1830,shaman,enhancement,63,38,25
Turbowolf,sargeras,1829,shaman,enhancement,104,47,57
Yucasinmojo,illidan,1827,shaman,enhancement,55,35,20
Eityhdz,tichondrius,1827,shaman,enhancement,425,216,209
Nomoreswap,zuljin,1825,shaman,enhancement,54,38,16
Shamanabuser,illidan,1825,shaman,enhancement,60,27,33
Flabby,lightbringer,1823,shaman,enhancement,54,26,28
Jokerxksx,tichondrius,1822,shaman,enhancement,72,43,29
Midwestern,emerald-dream,1822,shaman,enhancement,44,26,18
Metako,sargeras,1822,shaman,enhancement,83,47,36
Hooftoface,moon-guard,1822,shaman,enhancement,78,43,35
Pinechanga,ragnaros,1822,shaman,enhancement,78,42,36
Struck,emerald-dream,1821,shaman,enhancement,226,136,90
Gladdorta,azralon,1821,shaman,enhancement,54,30,24
Judgesfotm,bleeding-hollow,1821,shaman,enhancement,75,40,35
Turdfergesen,destromath,1821,shaman,enhancement,88,46,42
Btruez,tichondrius,1819,shaman,enhancement,63,35,28
Thunderlaw,area-52,1819,shaman,enhancement,82,44,38
Whírlwínd,area-52,1818,shaman,enhancement,30,19,11
Hooluu,frostmourne,1818,shaman,enhancement,54,30,24
Addroi,tichondrius,1818,shaman,enhancement,60,28,32
Thromjin,ragnaros,1817,shaman,enhancement,83,51,32
Léxar,sargeras,1817,shaman,enhancement,72,33,39
Movemaker,shattered-hand,1815,shaman,enhancement,30,21,9
Cunkinator,stormrage,1815,shaman,enhancement,115,74,41
Riptiedx,barthilas,1815,shaman,enhancement,48,29,19
Sarthuul,emerald-dream,1814,shaman,enhancement,48,30,18
Thrallas,frostmourne,1814,shaman,enhancement,54,33,21
Boombigshaq,ysera,1813,shaman,enhancement,38,25,13
Louiev,bleeding-hollow,1812,shaman,enhancement,48,28,20
Faultline,khadgar,1811,shaman,enhancement,73,47,26
Legendslayar,area-52,1811,shaman,enhancement,42,27,15
Drakhe,proudmoore,1811,shaman,enhancement,232,128,104
Nygiants,tichondrius,1810,shaman,enhancement,24,19,5
Xibalba,khaz-modan,1810,shaman,enhancement,96,57,39
Sassyx,steamwheedle-cartel,1810,shaman,enhancement,48,27,21
Iamashaman,malganis,1810,shaman,enhancement,302,154,148
Timzero,tichondrius,1809,shaman,enhancement,133,66,67
Adalid,thrall,1808,shaman,enhancement,66,46,20
Yakora,stormrage,1805,shaman,enhancement,114,66,48
Boboyaga,emerald-dream,1805,shaman,enhancement,54,29,25
Enhance,bleeding-hollow,1805,shaman,enhancement,41,20,21
Niuniudada,illidan,1805,shaman,enhancement,84,39,45
Stonetides,tichondrius,1804,shaman,enhancement,36,26,10
Nibrax,moknathal,1804,shaman,enhancement,78,41,37
Elefornoobs,area-52,1803,shaman,enhancement,48,36,12
Mercó,bleeding-hollow,1803,shaman,enhancement,54,31,23
Madonion,zuljin,1803,shaman,enhancement,60,31,29
Blakki,barthilas,1801,shaman,enhancement,66,40,26
Dønkx,tichondrius,1801,shaman,enhancement,71,39,32
Riptideafk,sargeras,1800,shaman,enhancement,75,46,29
Landlordxx,area-52,1795,shaman,enhancement,52,32,20
Norlak,antonidas,1794,shaman,enhancement,90,44,46
Muisor,quelthalas,1792,shaman,enhancement,72,40,32
Dorta,azralon,1792,shaman,enhancement,54,30,24
Jyupaonaiwa,tichondrius,1792,shaman,enhancement,48,25,23
Konfuzious,emerald-dream,1791,shaman,enhancement,141,79,62
Darkcnight,stormrage,1789,shaman,enhancement,93,53,40
Pingatronx,ragnaros,1786,shaman,enhancement,90,64,26
Fujinx,medivh,1786,shaman,enhancement,39,27,12
Dä,tichondrius,1786,shaman,enhancement,42,23,19
Freyía,illidan,1784,shaman,enhancement,30,22,8
Cammeez,area-52,1781,shaman,enhancement,121,62,59
Xaltas,moon-guard,1779,shaman,enhancement,96,60,36
Heisna,stormrage,1779,shaman,enhancement,289,153,136
Díesel,azralon,1777,shaman,enhancement,59,32,27
Garai,emerald-dream,1775,shaman,enhancement,135,69,66
Krovn,stormrage,1772,shaman,enhancement,60,33,27
Mobi,tichondrius,1769,shaman,enhancement,54,31,23
Deandre,illidan,1768,shaman,enhancement,42,22,20
Novedz,illidan,1767,shaman,enhancement,62,32,30
Forksin,tichondrius,1767,shaman,enhancement,70,30,40
Shinian,tichondrius,1765,shaman,enhancement,63,38,25
Sheared,emerald-dream,1763,shaman,enhancement,84,51,33
Worthquake,illidan,1758,shaman,enhancement,84,48,36
Stewtwo,illidan,1758,shaman,enhancement,45,25,20
Durozu,tichondrius,1758,shaman,enhancement,53,27,26
Biubiuz,tichondrius,1757,shaman,enhancement,102,63,39
Gorgonash,magtheridon,1756,shaman,enhancement,48,27,21
Halfzugzug,sargeras,1754,shaman,enhancement,42,29,13
Tdlz,tichondrius,1752,shaman,enhancement,110,67,43
Nonomori,frostmourne,1751,shaman,enhancement,72,41,31
Bigsquatzy,bleeding-hollow,1750,shaman,enhancement,42,23,19
Soshatsumi,tichondrius,1749,shaman,enhancement,76,42,34
Zappithorus,stormrage,1748,shaman,enhancement,54,35,19
Shocksrus,arthas,1747,shaman,enhancement,78,44,34
Kalvishdam,dalaran,1746,shaman,enhancement,36,25,11
Kushnations,chogall,1746,shaman,enhancement,38,20,18
Overpowered,korgath,1745,shaman,enhancement,40,21,19
Sin,bleeding-hollow,1740,shaman,enhancement,35,19,16
Watergirl,thaurissan,1739,shaman,enhancement,212,101,111
Valkriie,tichondrius,1736,shaman,enhancement,37,22,15
Nøtørious,thrall,1735,shaman,enhancement,24,22,2
Onlyshams,dalaran,1732,shaman,enhancement,42,25,17
Badshock,tichondrius,1730,shaman,enhancement,24,22,2
Doex,thrall,1723,shaman,enhancement,48,26,22
Reflexsivx,malganis,1722,shaman,enhancement,48,29,19
Shearx,illidan,1722,shaman,enhancement,75,43,32
Zanderpla,kelthuzad,1720,shaman,enhancement,96,48,48
Speedrush,nagrand,1717,shaman,enhancement,128,76,52
Poizele,tichondrius,1717,shaman,enhancement,294,164,130
Cwippin,tichondrius,1712,shaman,enhancement,134,77,57
Jàro,thrall,1708,shaman,enhancement,48,21,27
Keyturns,tichondrius,1707,shaman,enhancement,24,18,6
Rngena,trollbane,1706,shaman,enhancement,30,18,12
Shamom,silver-hand,1706,shaman,enhancement,160,91,69
Krûde,tichondrius,1703,shaman,enhancement,131,79,52
Asumo,azralon,1703,shaman,enhancement,131,73,58
Clappadactyl,frostmourne,1703,shaman,enhancement,254,136,118
Electrica,quelthalas,1702,shaman,enhancement,36,18,18
Sonofabat,spirestone,1701,shaman,enhancement,230,121,109
Plzbuffme,dalaran,1700,shaman,enhancement,78,46,32
Anadal,kargath,1700,shaman,enhancement,54,26,28
Bbshock,stormrage,1698,shaman,enhancement,84,50,34
Wingshaman,illidan,1698,shaman,enhancement,226,120,106
Axelsteel,illidan,1697,shaman,enhancement,48,21,27
Toobeastly,deathwing,1696,shaman,enhancement,87,48,39
Bitsuey,frostmourne,1696,shaman,enhancement,84,46,38
Stonetrog,blackrock,1695,shaman,enhancement,24,19,5
Synivabyatch,eonar,1695,shaman,enhancement,78,44,34
Clasm,tichondrius,1694,shaman,enhancement,30,22,8
Tkarfuno,exodar,1694,shaman,enhancement,66,34,32
Miketideson,proudmoore,1693,shaman,enhancement,72,38,34
Beaviis,frostmourne,1693,shaman,enhancement,72,37,35
Seltheran,tichondrius,1691,shaman,enhancement,42,29,13
Megalithic,moon-guard,1690,shaman,enhancement,66,44,22
Kamusham,azralon,1690,shaman,enhancement,85,45,40
Shamezee,stormreaver,1689,shaman,enhancement,47,22,25
Nyckysh,illidan,1688,shaman,enhancement,106,56,50
Somebozo,darkspear,1687,shaman,enhancement,157,84,73
Elryl,sargeras,1686,shaman,enhancement,116,64,52
Shamgawd,illidan,1686,shaman,enhancement,51,28,23
Justkitettv,stormrage,1684,shaman,enhancement,42,28,14
Vjeze,frostmourne,1684,shaman,enhancement,30,18,12
Geeblast,area-52,1683,shaman,enhancement,79,47,32
Tuugo,mannoroth,1682,shaman,enhancement,36,24,12
Meewo,sargeras,1682,shaman,enhancement,30,18,12
Vortexfury,area-52,1682,shaman,enhancement,42,20,22
Pla,tichondrius,1681,shaman,enhancement,174,97,77
Täcti,tichondrius,1681,shaman,enhancement,93,51,42
Shamungodc,tichondrius,1681,shaman,enhancement,50,25,25
Tarazhim,kelthuzad,1678,shaman,enhancement,30,19,11
Haishoe,stormrage,1677,shaman,enhancement,58,35,23
Lagroupie,ragnaros,1675,shaman,enhancement,35,23,12
Anzet,ragnaros,1673,shaman,enhancement,36,22,14
Atthegates,illidan,1673,shaman,enhancement,186,92,94
Melifesham,tichondrius,1672,shaman,enhancement,45,28,17
Ioiotete,tichondrius,1671,shaman,enhancement,36,21,15
Volkuul,zuljin,1669,shaman,enhancement,72,40,32
Gorillahazed,tichondrius,1669,shaman,enhancement,183,93,90
Nøname,azshara,1665,shaman,enhancement,239,122,117
Aibheit,area-52,1664,shaman,enhancement,30,28,2
Akormu,tichondrius,1664,shaman,enhancement,58,39,19
Hecks,malorne,1664,shaman,enhancement,96,51,45
Hurrikaine,dalaran,1663,shaman,enhancement,158,84,74
Shockmehard,area-52,1661,shaman,enhancement,95,73,22
Olíndo,tichondrius,1659,shaman,enhancement,42,27,15
Tyranitaur,frostmourne,1659,shaman,enhancement,84,42,42
Shakerina,azralon,1658,shaman,enhancement,122,59,63
Sinestario,illidan,1657,shaman,enhancement,148,83,65
Pashå,norgannon,1656,shaman,enhancement,36,24,12
Swaplord,area-52,1656,shaman,enhancement,30,18,12
Harrìson,tichondrius,1656,shaman,enhancement,41,21,20
Dadadabang,frostmourne,1655,shaman,enhancement,70,43,27
Furrybâstard,wyrmrest-accord,1654,shaman,enhancement,102,59,43
Rêngoku,dalaran,1653,shaman,enhancement,36,26,10
Døømsdáy,thrall,1653,shaman,enhancement,126,67,59
Platanos,proudmoore,1653,shaman,enhancement,170,89,81
Khormac,moon-guard,1652,shaman,enhancement,87,59,28
Windflex,emerald-dream,1651,shaman,enhancement,85,43,42
Ara,barthilas,1650,shaman,enhancement,48,32,16
Meiku,emerald-dream,1649,shaman,enhancement,36,22,14
Darwynz,zuljin,1649,shaman,enhancement,53,28,25
Slapnarp,wyrmrest-accord,1649,shaman,enhancement,90,43,47
Seltherann,tichondrius,1646,shaman,enhancement,36,25,11
Dratna,sisters-of-elune,1645,shaman,enhancement,29,22,7
Vultan,winterhoof,1645,shaman,enhancement,36,25,11
Tandrian,daggerspine,1644,shaman,enhancement,54,25,29
Elemores,tichondrius,1642,shaman,enhancement,66,40,26
Swartzqt,tichondrius,1641,shaman,enhancement,58,28,30
Tyven,tichondrius,1640,shaman,enhancement,94,50,44
Çhïcagø,aegwynn,1640,shaman,enhancement,59,24,35
Murig,bladefist,1638,shaman,enhancement,57,34,23
Ràntòn,bleeding-hollow,1637,shaman,enhancement,35,24,11
Shinydiglett,area-52,1637,shaman,enhancement,36,20,16
Slothycrit,emerald-dream,1637,shaman,enhancement,36,20,16
Lividelement,area-52,1636,shaman,enhancement,30,21,9
Wortwort,tichondrius,1636,shaman,enhancement,111,59,52
Seanan,tichondrius,1635,shaman,enhancement,48,31,17
Askpuntee,sargeras,1635,shaman,enhancement,42,25,17
Egirlshmu,stormrage,1634,shaman,enhancement,54,32,22
Deww,sargeras,1632,shaman,enhancement,76,39,37
Orkuss,illidan,1631,shaman,enhancement,48,25,23
Thunderchad,jubeithos,1631,shaman,enhancement,50,25,25
Tettnanger,azralon,1630,shaman,enhancement,31,19,12
Slashpity,stormrage,1630,shaman,enhancement,63,33,30
Olani,nesingwary,1630,shaman,enhancement,43,22,21
Shámdemons,area-52,1629,shaman,enhancement,96,58,38
Omaguap,tichondrius,1628,shaman,enhancement,50,29,21
Kohatan,moon-guard,1627,shaman,enhancement,98,58,40
Ironaddictz,kiljaeden,1627,shaman,enhancement,70,39,31
Thewindman,sargeras,1626,shaman,enhancement,90,46,44
Hxzard,stormrage,1626,shaman,enhancement,36,17,19
Åvarice,shattered-halls,1626,shaman,enhancement,54,22,32
Alablast,malganis,1625,shaman,enhancement,36,21,15
Shockdome,daggerspine,1624,shaman,enhancement,33,23,10
Zapnclap,tichondrius,1623,shaman,enhancement,42,24,18
Dankthunda,stormrage,1622,shaman,enhancement,126,71,55
Jofstrom,tichondrius,1620,shaman,enhancement,24,18,6
Mokho,stormrage,1620,shaman,enhancement,30,19,11
Venmoo,illidan,1620,shaman,enhancement,42,20,22
Deyodin,illidan,1619,shaman,enhancement,26,18,8
Ceasebelief,tichondrius,1619,shaman,enhancement,36,24,12
Totegoat,nazjatar,1618,shaman,enhancement,54,28,26
Ryziax,tichondrius,1616,shaman,enhancement,41,23,18
Fhenh,proudmoore,1615,shaman,enhancement,131,76,55
Ðr,earthen-ring,1615,shaman,enhancement,122,68,54
Split,zuljin,1614,shaman,enhancement,196,108,88
Stýlébéñdér,kelthuzad,1613,shaman,enhancement,24,17,7
Zmogon,quelthalas,1611,shaman,enhancement,59,30,29
Ryuuraix,area-52,1610,shaman,enhancement,27,18,9
Feroxture,frostmourne,1610,shaman,enhancement,66,38,28
Xlianah,zuljin,1609,shaman,enhancement,54,28,26
Bräindëad,hyjal,1608,shaman,enhancement,131,74,57
Robdaman,tichondrius,1607,shaman,enhancement,24,18,6
Daddymacktv,malganis,1607,shaman,enhancement,74,39,35
Smash,fenris,1606,shaman,enhancement,91,47,44
Smartbunny,illidan,1606,shaman,enhancement,318,160,158
Stormbash,ragnaros,1606,shaman,enhancement,72,30,42
Totemnikiel,stormrage,1602,shaman,enhancement,90,42,48
Shamwik,frostmourne,1601,shaman,enhancement,65,38,27
Volsdeep,illidan,1600,shaman,enhancement,70,38,32
Frëdstorm,kelthuzad,1599,shaman,enhancement,215,108,107
Torgami,tichondrius,1598,shaman,enhancement,49,30,19
Hellamental,malganis,1598,shaman,enhancement,42,22,20
Eliteshamann,tichondrius,1597,shaman,enhancement,96,51,45
Eyecandi,barthilas,1595,shaman,enhancement,151,76,75
Hehew,kelthuzad,1594,shaman,enhancement,83,49,34
Roysoy,stormrage,1591,shaman,enhancement,78,46,32
Mobiediqônú,skywall,1586,shaman,enhancement,36,19,17
Tootshock,illidan,1585,shaman,enhancement,54,27,27
Niceshoe,tichondrius,1582,shaman,enhancement,47,23,24
Shabenn,proudmoore,1580,shaman,enhancement,151,76,75
Zavar,tichondrius,1579,shaman,enhancement,77,40,37
Moistydank,tichondrius,1578,shaman,enhancement,78,51,27
Blackenergy,stormrage,1578,shaman,enhancement,92,48,44
Artsha,tol-barad,1576,shaman,enhancement,35,17,18
Jerykco,drakkari,1575,shaman,enhancement,78,40,38
Jumoma,thrall,1574,shaman,enhancement,54,34,20
Kindaretro,tichondrius,1574,shaman,enhancement,48,29,19
Gambazzlok,terokkar,1574,shaman,enhancement,48,28,20
Zeroshocks,kelthuzad,1573,shaman,enhancement,42,25,17
Dreddfoxy,illidan,1573,shaman,enhancement,36,19,17
Shamanees,area-52,1572,shaman,enhancement,153,76,77
ßlessedx,tichondrius,1571,shaman,enhancement,59,38,21
Nÿh,quelthalas,1569,shaman,enhancement,48,27,21
Shamwows,dalaran,1569,shaman,enhancement,183,91,92
Aoshiferuzz,ragnaros,1566,shaman,enhancement,78,43,35
Shmnsm,kiljaeden,1565,shaman,enhancement,42,18,24
Zugzugenh,stormrage,1564,shaman,enhancement,58,32,26
Lyrzsa,blackwing-lair,1562,shaman,enhancement,74,46,28
Uracemytotem,kiljaeden,1562,shaman,enhancement,84,51,33
Tumble,frostmourne,1562,shaman,enhancement,144,78,66
Juliojones,trollbane,1562,shaman,enhancement,36,18,18
Shamcowhah,frostmourne,1562,shaman,enhancement,36,17,19
Thunda,black-dragonflight,1561,shaman,enhancement,36,22,14
Shockszz,onyxia,1561,shaman,enhancement,36,20,16
Keeba,wyrmrest-accord,1558,shaman,enhancement,60,31,29
ßurstmedaddy,bleeding-hollow,1557,shaman,enhancement,36,27,9
Loadiez,frostmourne,1556,shaman,enhancement,42,28,14
Soupi,illidan,1556,shaman,enhancement,126,68,58
Ephraalin,frostmourne,1556,shaman,enhancement,42,22,20
Deemmorti,stormrage,1555,shaman,enhancement,52,28,24
Cayed,stormscale,1553,shaman,enhancement,90,47,43
Armîn,moon-guard,1544,shaman,enhancement,54,33,21
Lavawreckage,malganis,1544,shaman,enhancement,122,66,56
Heäven,malganis,1543,shaman,enhancement,198,105,93
Udb,the-scryers,1542,shaman,enhancement,53,32,21
Mindfields,barthilas,1542,shaman,enhancement,73,42,31
Rexoss,hyjal,1541,shaman,enhancement,146,79,67
Killbro,blackrock,1540,shaman,enhancement,187,99,88
Elementalïst,durotan,1538,shaman,enhancement,30,19,11
Lenin,nathrezim,1538,shaman,enhancement,54,30,24
Small,alleria,1538,shaman,enhancement,60,32,28
Cowely,madoran,1536,shaman,enhancement,48,29,19
Pedaphil,frostmourne,1534,shaman,enhancement,24,16,8
Feesstt,malganis,1534,shaman,enhancement,48,27,21
Thilv,ravenholdt,1534,shaman,enhancement,48,27,21
Clenlift,emerald-dream,1534,shaman,enhancement,216,114,102
Shamgødx,dalaran,1533,shaman,enhancement,18,16,2
Derzwaz,draka,1532,shaman,enhancement,29,17,12
Killavicious,area-52,1531,shaman,enhancement,84,39,45
Larrylardazz,tichondrius,1530,shaman,enhancement,86,52,34
Azumaa,tichondrius,1530,shaman,enhancement,42,21,21
Dimitrio,azralon,1527,shaman,enhancement,124,63,61
Gordonramsai,sargeras,1526,shaman,enhancement,30,21,9
Deshamann,illidan,1522,shaman,enhancement,100,45,55
Grx,tichondrius,1521,shaman,enhancement,50,25,25
Arlikai,arthas,1520,shaman,enhancement,153,69,84
Dirtyunique,tichondrius,1519,shaman,enhancement,90,51,39
Slapchainz,tichondrius,1519,shaman,enhancement,36,18,18
Solka,illidan,1518,shaman,enhancement,54,32,22
Abigdude,frostmourne,1518,shaman,enhancement,167,89,78
Vásh,quelthalas,1517,shaman,enhancement,24,16,8
Killswitch,bonechewer,1516,shaman,enhancement,30,16,14
Boomershock,stormrage,1516,shaman,enhancement,42,20,22
Vapus,area-52,1515,shaman,enhancement,142,81,61
Ginjij,thrall,1514,shaman,enhancement,30,18,12
Mixn,frostmourne,1513,shaman,enhancement,113,66,47
Balldo,stormrage,1513,shaman,enhancement,36,16,20
Chungussy,blackrock,1512,shaman,enhancement,35,21,14
Flirstatic,nemesis,1512,shaman,enhancement,135,73,62
Delxx,tichondrius,1511,shaman,enhancement,24,16,8
Stormblast,stormrage,1510,shaman,enhancement,41,23,18
Mihrion,moon-guard,1508,shaman,enhancement,41,22,19
Prymalfury,illidan,1508,shaman,enhancement,120,62,58
Daikí,ragnaros,1507,shaman,enhancement,37,21,16
Töpg,garrosh,1506,shaman,enhancement,40,21,19
Elementin,kelthuzad,1503,shaman,enhancement,96,46,50
Yildiri,area-52,1501,shaman,enhancement,18,16,2
Kronkxd,malganis,1501,shaman,enhancement,30,16,14
Kandin,icecrown,1498,shaman,enhancement,54,27,27
Pockethealer,emerald-dream,1494,shaman,enhancement,149,80,69
Sugarpapa,bonechewer,1493,shaman,enhancement,69,42,27
Earthfirex,ragnaros,1493,shaman,enhancement,48,25,23
Hephron,area-52,1493,shaman,enhancement,72,32,40
Shockolatte,sargeras,1492,shaman,enhancement,103,45,58
Quakenbake,emerald-dream,1491,shaman,enhancement,33,20,13
Jäyp,thrall,1490,shaman,enhancement,68,38,30
Amasaei,bleeding-hollow,1488,shaman,enhancement,72,36,36
Bòómz,stormrage,1488,shaman,enhancement,370,179,191
Hungnuts,sargeras,1487,shaman,enhancement,124,67,57
Jamieslays,korgath,1487,shaman,enhancement,53,24,29
Chaposz,tichondrius,1486,shaman,enhancement,91,48,43
Dilfmaster,tichondrius,1486,shaman,enhancement,71,36,35
Shoresy,kaelthas,1485,shaman,enhancement,54,28,26
Arázi,wyrmrest-accord,1485,shaman,enhancement,41,16,25
Casualsham,illidan,1484,shaman,enhancement,48,30,18
Konga,korialstrasz,1483,shaman,enhancement,38,22,16
Saphage,tichondrius,1482,shaman,enhancement,42,22,20
Scrototëm,azralon,1481,shaman,enhancement,81,42,39
Terrible,illidan,1481,shaman,enhancement,36,16,20
Stubbywayne,area-52,1479,shaman,enhancement,207,106,101
Ragnarocck,sargeras,1479,shaman,enhancement,75,36,39
Dashmmy,dalaran,1478,shaman,enhancement,54,26,28
Iamurfather,magtheridon,1477,shaman,enhancement,143,74,69
Armønixx,ragnaros,1476,shaman,enhancement,120,65,55
Falasha,bloodscalp,1475,shaman,enhancement,46,27,19
Forloren,zuljin,1475,shaman,enhancement,52,28,24
Maribain,barthilas,1472,shaman,enhancement,112,65,47
Vøllttz,azralon,1471,shaman,enhancement,24,16,8
Spacex,velen,1470,shaman,enhancement,42,21,21
Lakindrentv,gorefiend,1467,shaman,enhancement,30,17,13
Mackandal,tichondrius,1466,shaman,enhancement,86,43,43
Lavalavalava,dentarg,1465,shaman,enhancement,30,21,9
Skyzik,area-52,1465,shaman,enhancement,54,34,20
Beaversniper,tichondrius,1465,shaman,enhancement,84,38,46
Hyjixtv,stormrage,1464,shaman,enhancement,24,18,6
Woof,agamaggan,1464,shaman,enhancement,30,16,14
Earthlsflat,tichondrius,1463,shaman,enhancement,31,21,10
Daddyzap,stormrage,1462,shaman,enhancement,104,58,46
Àspec,aegwynn,1460,shaman,enhancement,22,16,6
Lavabone,dalaran,1459,shaman,enhancement,66,28,38
Sndhlp,tichondrius,1457,shaman,enhancement,46,29,17
Raxabico,nemesis,1457,shaman,enhancement,38,17,21
Getacho,stormrage,1454,shaman,enhancement,150,72,78
Tictactotem,stormreaver,1452,shaman,enhancement,42,24,18
Xillas,moon-guard,1451,shaman,enhancement,48,28,20
Tigolbittie,sargeras,1451,shaman,enhancement,54,23,31
Scrötotem,saurfang,1450,shaman,enhancement,89,50,39
Lamagra,nemesis,1449,shaman,enhancement,30,19,11
Goribash,wyrmrest-accord,1449,shaman,enhancement,42,26,16
Vanklayser,ragnaros,1449,shaman,enhancement,55,24,31
Surtel,tichondrius,1448,shaman,enhancement,77,36,41
Calich,kelthuzad,1447,shaman,enhancement,62,35,27
Shamann,azshara,1447,shaman,enhancement,63,34,29
Roidzsham,area-52,1446,shaman,enhancement,42,25,17
Zheúz,azralon,1446,shaman,enhancement,56,31,25
Odïn,tichondrius,1444,shaman,enhancement,54,33,21
Drakkaa,tichondrius,1439,shaman,enhancement,31,20,11
Sswf,auchindoun,1439,shaman,enhancement,24,15,9
Cyclrin,sargeras,1439,shaman,enhancement,24,15,9
Teeroll,frostmourne,1439,shaman,enhancement,41,25,16
Exxosenh,tichondrius,1438,shaman,enhancement,18,15,3
Exsh,area-52,1438,shaman,enhancement,18,15,3
Tamtam,gorefiend,1438,shaman,enhancement,24,15,9
Seltz,illidan,1438,shaman,enhancement,30,15,15
Nohandslost,tichondrius,1437,shaman,enhancement,43,30,13
Gundar,chogall,1436,shaman,enhancement,56,31,25
Kinzle,tichondrius,1436,shaman,enhancement,36,15,21
Qvibin,tichondrius,1435,shaman,enhancement,30,21,9
Arque,stormrage,1435,shaman,enhancement,78,49,29
Tungusk,tichondrius,1435,shaman,enhancement,24,15,9
Däbü,tichondrius,1435,shaman,enhancement,30,15,15
Friednocap,kelthuzad,1435,shaman,enhancement,48,21,27
Jummyman,area-52,1434,shaman,enhancement,47,30,17
Wecookin,frostwolf,1433,shaman,enhancement,18,15,3
Vonnsmallpp,area-52,1433,shaman,enhancement,24,15,9
Rojhaz,stormrage,1433,shaman,enhancement,48,28,20
Meattoilet,tichondrius,1431,shaman,enhancement,23,16,7
Cuzcuz,tichondrius,1431,shaman,enhancement,24,15,9
Doomfury,magtheridon,1431,shaman,enhancement,36,21,15
Whydead,sargeras,1431,shaman,enhancement,72,40,32
Pahtaklol,tichondrius,1431,shaman,enhancement,30,15,15
Justincasé,sargeras,1431,shaman,enhancement,96,43,53
Djasura,blackhand,1430,shaman,enhancement,53,29,24
Kushgodd,kiljaeden,1429,shaman,enhancement,60,31,29
Defiant,azgalor,1429,shaman,enhancement,30,15,15
Shalkahn,malganis,1429,shaman,enhancement,53,22,31
Roz,khaz-modan,1428,shaman,enhancement,18,15,3
Earfshock,thrall,1428,shaman,enhancement,74,41,33
Zêus,sargeras,1427,shaman,enhancement,30,17,13
Convolutedx,tichondrius,1427,shaman,enhancement,30,15,15
Texmawave,moon-guard,1425,shaman,enhancement,24,15,9
Grippysockz,dalaran,1424,shaman,enhancement,24,15,9
Drumman,skullcrusher,1423,shaman,enhancement,118,66,52
Sockittooya,bleeding-hollow,1422,shaman,enhancement,54,34,20
Rtÿo,area-52,1422,shaman,enhancement,24,15,9
Raazzasham,moon-guard,1422,shaman,enhancement,65,34,31
Silyshamshyt,stormrage,1421,shaman,enhancement,24,15,9
Zaydax,altar-of-storms,1421,shaman,enhancement,24,15,9
Shamcharles,proudmoore,1421,shaman,enhancement,50,17,33
Tinysha,tichondrius,1420,shaman,enhancement,24,15,9
Dwightjr,emerald-dream,1417,shaman,enhancement,48,23,25
Shamrockcawk,malganis,1415,shaman,enhancement,54,35,19
Clownshòes,tichondrius,1415,shaman,enhancement,42,26,16
Mudroller,moon-guard,1414,shaman,enhancement,52,24,28
Hvalleyranch,area-52,1411,shaman,enhancement,59,27,32
Zere,cenarius,1410,shaman,enhancement,20,17,3
Makocc,tichondrius,1410,shaman,enhancement,92,41,51
Raylord,ragnaros,1406,shaman,enhancement,131,72,59
Firevag,hakkar,1405,shaman,enhancement,135,73,62
Nankdug,tichondrius,1405,shaman,enhancement,47,25,22
Zzar,daggerspine,1404,shaman,enhancement,42,23,19
Orcshamen,tichondrius,1403,shaman,enhancement,60,35,25
Neyter,azralon,1402,shaman,enhancement,90,57,33
Brëw,tichondrius,1402,shaman,enhancement,37,21,16
Goonxdz,illidan,1402,shaman,enhancement,63,26,37
Fyahchaming,drakkari,1401,shaman,enhancement,82,46,36
Lüca,wyrmrest-accord,1401,shaman,enhancement,211,109,102
Talfur,area-52,1400,shaman,enhancement,42,23,19
Nyxxus,tichondrius,1399,shaman,enhancement,30,19,11
Djelemental,darkspear,1394,shaman,enhancement,27,17,10
Zaboomafoo,emerald-dream,1392,shaman,enhancement,69,37,32
Zugzugthug,moon-guard,1392,shaman,enhancement,34,18,16
Stickysham,illidan,1391,shaman,enhancement,42,26,16
Dashinra,stormrage,1391,shaman,enhancement,38,20,18
Orcmanshamn,moon-guard,1390,shaman,enhancement,92,47,45
Groundfaults,bleeding-hollow,1389,shaman,enhancement,35,15,20
Mortzor,frostmourne,1387,shaman,enhancement,35,22,13
Shipmatekev,sargeras,1386,shaman,enhancement,54,29,25
Zktz,warsong,1385,shaman,enhancement,31,17,14
Zute,frostmourne,1384,shaman,enhancement,70,41,29
Zügz,illidan,1383,shaman,enhancement,55,33,22
Rhass,ragnaros,1380,shaman,enhancement,72,34,38
Lazugga,area-52,1378,shaman,enhancement,80,42,38
Katojune,tichondrius,1378,shaman,enhancement,33,16,17
Borwald,dalaran,1377,shaman,enhancement,148,76,72
Tyzek,illidan,1375,shaman,enhancement,42,26,16
Gettatotem,frostmourne,1373,shaman,enhancement,30,17,13
Prasu,spirestone,1372,shaman,enhancement,70,33,37
Froglok,boulderfist,1371,shaman,enhancement,35,17,18
Grendinbal,moon-guard,1370,shaman,enhancement,33,15,18
Tamzlol,the-forgotten-coast,1367,shaman,enhancement,48,26,22
Ventus,thrall,1366,shaman,enhancement,78,35,43
Tigtotem,malganis,1365,shaman,enhancement,24,16,8
Nìke,nazgrel,1364,shaman,enhancement,47,21,26
Psilocypher,nazjatar,1362,shaman,enhancement,42,28,14
Montí,moon-guard,1361,shaman,enhancement,83,51,32
Grohltusk,barthilas,1360,shaman,enhancement,42,24,18
Usul,frostmane,1360,shaman,enhancement,109,56,53
Johnwilke,area-52,1356,shaman,enhancement,119,59,60
Mëister,stormrage,1355,shaman,enhancement,137,70,67
Murlook,sargeras,1354,shaman,enhancement,67,44,23
Brreeaadd,tichondrius,1354,shaman,enhancement,57,25,32
Isbabani,moon-guard,1353,shaman,enhancement,30,16,14
Trenbolone,maiev,1351,shaman,enhancement,77,46,31
Monadazs,ragnaros,1351,shaman,enhancement,50,26,24
Trashfarmer,tichondrius,1351,shaman,enhancement,114,54,60
Mybadshawty,tichondrius,1347,shaman,enhancement,72,32,40
Bessame,sargeras,1346,shaman,enhancement,94,48,46
Døømwinds,tichondrius,1342,shaman,enhancement,24,14,10
Tsaheylu,barthilas,1342,shaman,enhancement,48,22,26
Capershock,sargeras,1341,shaman,enhancement,18,14,4
Magmao,quelthalas,1341,shaman,enhancement,71,43,28
Stormwolf,emerald-dream,1341,shaman,enhancement,42,23,19
Joeschno,bleeding-hollow,1341,shaman,enhancement,41,16,25
Crøwgød,tichondrius,1340,shaman,enhancement,24,14,10
Gaelfury,malganis,1339,shaman,enhancement,54,24,30
Stormgraves,moon-guard,1337,shaman,enhancement,24,14,10
Leaning,wyrmrest-accord,1335,shaman,enhancement,24,14,10
Clumpen,thunderhorn,1335,shaman,enhancement,47,25,22
Electabuzz,arygos,1335,shaman,enhancement,30,15,15
Khorgan,emerald-dream,1334,shaman,enhancement,24,14,10
Vlackz,quelthalas,1334,shaman,enhancement,42,22,20
Kamíhameha,stormrage,1333,shaman,enhancement,110,57,53
Aldinatir,ragnaros,1332,shaman,enhancement,24,14,10
Tizzl,kelthuzad,1332,shaman,enhancement,78,39,39
Atroll,moonrunner,1332,shaman,enhancement,66,30,36
Chapope,quelthalas,1329,shaman,enhancement,46,30,16
Raijû,illidan,1329,shaman,enhancement,24,14,10
Niteshammy,lothar,1328,shaman,enhancement,24,14,10
Hagass,tichondrius,1328,shaman,enhancement,61,28,33
Lazygemini,illidan,1327,shaman,enhancement,78,39,39
Unezx,tichondrius,1326,shaman,enhancement,18,14,4
Shomani,madoran,1326,shaman,enhancement,41,17,24
Leschaises,skullcrusher,1325,shaman,enhancement,27,18,9
Volcanoboxer,tichondrius,1325,shaman,enhancement,21,14,7
Winiethepoöh,stormrage,1325,shaman,enhancement,36,14,22
Doomvin,stormrage,1324,shaman,enhancement,54,29,25
Baloneyfiveo,kiljaeden,1322,shaman,enhancement,56,31,25
Sleekish,moon-guard,1319,shaman,enhancement,30,14,16
Shawkedu,tichondrius,1317,shaman,enhancement,36,16,20
Canabal,eonar,1315,shaman,enhancement,24,14,10
Totesmagotes,scilla,1314,shaman,enhancement,36,22,14
Kungfuvoodoo,tichondrius,1314,shaman,enhancement,24,14,10
Argrax,sargeras,1314,shaman,enhancement,71,41,30
Rokogg,thrall,1312,shaman,enhancement,133,69,64
Blasho,ragnaros,1312,shaman,enhancement,110,50,60
Shamorrhoids,frostmourne,1311,shaman,enhancement,118,62,56
Dugomik,malganis,1311,shaman,enhancement,100,49,51
Harvesting,azralon,1311,shaman,enhancement,30,14,16
Beogar,moon-guard,1310,shaman,enhancement,27,15,12
Mairn,tichondrius,1310,shaman,enhancement,66,33,33
Piffenstien,malganis,1310,shaman,enhancement,66,32,34
Sasori,stormrage,1309,shaman,enhancement,48,31,17
Hanhze,quelthalas,1306,shaman,enhancement,93,54,39
Yâmz,area-52,1306,shaman,enhancement,57,25,32
Burrst,thrall,1305,shaman,enhancement,24,14,10
Vöödooranger,stormrage,1305,shaman,enhancement,24,14,10
Emelectric,quelthalas,1304,shaman,enhancement,66,31,35
Tabellarium,tichondrius,1303,shaman,enhancement,36,21,15
Whichdoctah,proudmoore,1302,shaman,enhancement,30,14,16
Cbomberz,tichondrius,1301,shaman,enhancement,85,42,43
Pumpz,magtheridon,1301,shaman,enhancement,30,14,16
Lightnessx,stormrage,1301,shaman,enhancement,42,17,25
Microwavbakn,emerald-dream,1300,shaman,enhancement,70,38,32
Astrò,illidan,1299,shaman,enhancement,18,14,4
Triní,ragnaros,1296,shaman,enhancement,69,40,29
Rongkhan,tichondrius,1296,shaman,enhancement,41,23,18
Shrektar,cenarius,1296,shaman,enhancement,48,21,27
Neyavv,tichondrius,1294,shaman,enhancement,181,87,94
Kasukaga,shadowmoon,1291,shaman,enhancement,72,34,38
Sigir,darrowmere,1290,shaman,enhancement,48,22,26
Obeilius,illidan,1288,shaman,enhancement,61,31,30
Kulnash,auchindoun,1287,shaman,enhancement,28,17,11
Pandashamnda,area-52,1287,shaman,enhancement,58,31,27
Forgediniron,stormrage,1286,shaman,enhancement,53,27,26
Dàfèng,wyrmrest-accord,1286,shaman,enhancement,41,14,27
Jackofstorms,veknilash,1285,shaman,enhancement,56,25,31
Taò,tichondrius,1283,shaman,enhancement,87,44,43
Thorodinsson,proudmoore,1280,shaman,enhancement,55,21,34
Bobaflexqt,korgath,1279,shaman,enhancement,24,15,9
Vanmaichet,azshara,1276,shaman,enhancement,29,14,15
Parallels,blackrock,1275,shaman,enhancement,112,54,58
Beardcramps,tichondrius,1275,shaman,enhancement,75,29,46
Zerium,nemesis,1274,shaman,enhancement,42,25,17
Zechary,proudmoore,1273,shaman,enhancement,54,33,21
Flaméy,stormrage,1273,shaman,enhancement,51,21,30
Kigorami,nerzhul,1271,shaman,enhancement,42,21,21
Thorlottie,stormrage,1269,shaman,enhancement,30,15,15
Majhrakova,stormrage,1266,shaman,enhancement,30,15,15
Popsmoke,gnomeregan,1265,shaman,enhancement,23,14,9
Datblueboi,dalaran,1263,shaman,enhancement,76,39,37
Dì,barthilas,1262,shaman,enhancement,30,19,11
Umbrood,area-52,1262,shaman,enhancement,48,23,25
Gorebog,feathermoon,1259,shaman,enhancement,42,23,19
Obrahma,burning-legion,1258,shaman,enhancement,24,16,8
Chalked,stormrage,1257,shaman,enhancement,103,48,55
Deathjoker,icecrown,1255,shaman,enhancement,66,34,32
Holosoul,bleeding-hollow,1254,shaman,enhancement,67,27,40
Lerajje,tichondrius,1251,shaman,enhancement,42,22,20
Rikswordfire,wyrmrest-accord,1251,shaman,enhancement,35,16,19
Extraguacpls,tichondrius,1249,shaman,enhancement,23,14,9
Hexoffnder,zuljin,1246,shaman,enhancement,18,13,5
Lizardhusk,barthilas,1246,shaman,enhancement,24,13,11
Lilpump,boulderfist,1246,shaman,enhancement,66,34,32
Care,silvermoon,1245,shaman,enhancement,18,13,5
Arckos,thrall,1245,shaman,enhancement,18,13,5
Torvi,saurfang,1244,shaman,enhancement,18,13,5
Doitclap,stormrage,1243,shaman,enhancement,18,15,3
Zêûs,moon-guard,1240,shaman,enhancement,24,13,11
Dalthragoz,tichondrius,1239,shaman,enhancement,24,13,11
Dylangs,frostmourne,1238,shaman,enhancement,24,13,11
Dalsun,turalyon,1237,shaman,enhancement,30,13,17
Shokaria,frostwolf,1237,shaman,enhancement,35,14,21
Eze,tichondrius,1234,shaman,enhancement,64,36,28
Githealed,kelthuzad,1234,shaman,enhancement,27,15,12
Zugxo,area-52,1233,shaman,enhancement,20,15,5
Vozs,proudmoore,1233,shaman,enhancement,60,34,26
Argena,bonechewer,1233,shaman,enhancement,24,13,11
Twansom,tichondrius,1233,shaman,enhancement,66,35,31
Thromir,blackwing-lair,1233,shaman,enhancement,48,22,26
Slowgrath,burning-legion,1232,shaman,enhancement,45,26,19
Manthozshami,ragnaros,1232,shaman,enhancement,30,13,17
Shamwickk,tichondrius,1231,shaman,enhancement,48,26,22
Willy,icecrown,1230,shaman,enhancement,23,13,10
Shamikkazee,illidan,1228,shaman,enhancement,67,36,31
Drahlos,tichondrius,1227,shaman,enhancement,30,13,17
Shamgoddam,illidan,1225,shaman,enhancement,58,24,34
Shawhammy,illidan,1225,shaman,enhancement,48,19,29
Uglykunt,barthilas,1224,shaman,enhancement,111,62,49
Bhaelfury,moon-guard,1224,shaman,enhancement,36,20,16
Netherfury,illidan,1224,shaman,enhancement,51,28,23
Shamantwo,windrunner,1223,shaman,enhancement,24,13,11
Súrtr,sargeras,1221,shaman,enhancement,24,13,11
Gdiafplox,thunderhorn,1220,shaman,enhancement,66,34,32
Mullten,sargeras,1219,shaman,enhancement,36,15,21
Crigga,dalaran,1216,shaman,enhancement,24,13,11
Taowth,area-52,1214,shaman,enhancement,35,13,22
Sevare,area-52,1213,shaman,enhancement,27,14,13
Spicyballs,coilfang,1213,shaman,enhancement,30,13,17
Hammeredd,hyjal,1212,shaman,enhancement,36,18,18
Fireclaws,bleeding-hollow,1206,shaman,enhancement,36,16,20
Lutheran,dragonmaw,1200,shaman,enhancement,47,21,26
Sinsar,illidan,1200,shaman,enhancement,35,13,22
Zaxibow,area-52,1196,shaman,enhancement,34,15,19
Iamegirl,moon-guard,1191,shaman,enhancement,29,13,16
Djshammy,barthilas,1183,shaman,enhancement,28,15,13
Helohk,wyrmrest-accord,1182,shaman,enhancement,22,13,9
Amärök,area-52,1181,shaman,enhancement,62,26,36
ßigðåddy,ghostlands,1179,shaman,enhancement,60,19,41
Spiderjohn,sargeras,1177,shaman,enhancement,36,20,16
Enhancementz,azralon,1174,shaman,enhancement,68,37,31
Thorre,the-scryers,1171,shaman,enhancement,30,19,11
Litchuckie,thrall,1169,shaman,enhancement,46,25,21
Keytürnz,frostmourne,1167,shaman,enhancement,48,21,27
Bluëwafflë,tichondrius,1165,shaman,enhancement,31,16,15
Cseril,bonechewer,1164,shaman,enhancement,83,49,34
Yelpreviewer,dalaran,1164,shaman,enhancement,29,14,15
Shometrin,tichondrius,1164,shaman,enhancement,59,21,38
Finnaburstt,tichondrius,1162,shaman,enhancement,54,29,25
Tarresh,azralon,1161,shaman,enhancement,42,16,26
Splendapapi,stormrage,1155,shaman,enhancement,38,13,25
Onezap,trollbane,1153,shaman,enhancement,55,21,34
Tactíc,chromaggus,1152,shaman,enhancement,18,12,6
Gangmember,shadowmoon,1152,shaman,enhancement,18,12,6
Shamakhazi,stormrage,1151,shaman,enhancement,18,12,6
Scrib,dawnbringer,1151,shaman,enhancement,18,12,6
Deixw,tichondrius,1151,shaman,enhancement,18,12,6
Jinxicle,illidan,1151,shaman,enhancement,18,12,6
Purgegodryuu,area-52,1151,shaman,enhancement,24,12,12
Mcb,barthilas,1151,shaman,enhancement,24,12,12
Nyknicks,tichondrius,1150,shaman,enhancement,18,12,6
Dialtone,blackrock,1150,shaman,enhancement,30,12,18
Angrymán,ragnaros,1149,shaman,enhancement,12,12,0
Rainjig,emerald-dream,1149,shaman,enhancement,21,12,9
Hordeymaori,jubeithos,1149,shaman,enhancement,156,82,74
Stoneseed,steamwheedle-cartel,1147,shaman,enhancement,30,12,18
Zèus,draka,1146,shaman,enhancement,24,12,12
Tosil,tichondrius,1144,shaman,enhancement,24,12,12
Têach,ragnaros,1142,shaman,enhancement,18,12,6
Saraguthix,dalaran,1141,shaman,enhancement,18,12,6
Fourstorms,gundrak,1141,shaman,enhancement,37,19,18
Vokxulsin,tichondrius,1139,shaman,enhancement,30,12,18
Wagar,dawnbringer,1139,shaman,enhancement,36,12,24
Corkrain,sargeras,1138,shaman,enhancement,30,12,18
Sydstorm,frostmourne,1137,shaman,enhancement,18,12,6
Beanerburst,frostwolf,1136,shaman,enhancement,48,26,22
Ashida,stormrage,1129,shaman,enhancement,43,22,21
Popz,dark-iron,1128,shaman,enhancement,18,12,6
ßøn,altar-of-storms,1125,shaman,enhancement,33,16,17
Astroglyde,emerald-dream,1123,shaman,enhancement,24,12,12
Camdoc,destromath,1122,shaman,enhancement,53,24,29
Skizzymars,malganis,1120,shaman,enhancement,30,12,18
Lukora,stonemaul,1119,shaman,enhancement,18,12,6
Ryb,sargeras,1119,shaman,enhancement,20,13,7
Shøxic,perenolde,1118,shaman,enhancement,18,12,6
Googurt,barthilas,1118,shaman,enhancement,23,12,11
Drokron,azralon,1118,shaman,enhancement,48,23,25
Cydarta,ragnaros,1117,shaman,enhancement,60,34,26
Catiçero,azralon,1117,shaman,enhancement,30,12,18
Floon,barthilas,1116,shaman,enhancement,66,27,39
Schlemiel,barthilas,1112,shaman,enhancement,82,36,46
Lassoway,illidan,1110,shaman,enhancement,30,12,18
Golkork,quelthalas,1108,shaman,enhancement,24,13,11
Blaçktide,thrall,1104,shaman,enhancement,26,16,10
Shaminism,chromaggus,1103,shaman,enhancement,23,12,11
Wigwog,hyjal,1102,shaman,enhancement,61,35,26
Shayymann,exodar,1101,shaman,enhancement,60,28,32
Robis,thrall,1096,shaman,enhancement,90,39,51
Ahzar,stormrage,1093,shaman,enhancement,60,26,34
Hazak,nemesis,1088,shaman,enhancement,78,39,39
Oreahsham,tichondrius,1085,shaman,enhancement,30,12,18
Karlpoppa,thunderhorn,1081,shaman,enhancement,30,17,13
Kalashnikov,maiev,1081,shaman,enhancement,36,14,22
Nîghtstalker,vashj,1081,shaman,enhancement,52,20,32
Shammybreakx,malganis,1067,shaman,enhancement,74,43,31
Lovetides,area-52,1060,shaman,enhancement,30,18,12
Tekashi,muradin,1060,shaman,enhancement,31,12,19
Okïòmó,proudmoore,1056,shaman,enhancement,18,11,7
Gamergirlx,area-52,1056,shaman,enhancement,18,11,7
Jyster,area-52,1056,shaman,enhancement,65,27,38
Shambostik,thrall,1056,shaman,enhancement,36,13,23
Shamawolf,stormrage,1055,shaman,enhancement,12,11,1
Zelinsky,sargeras,1055,shaman,enhancement,18,11,7
Jayes,zuljin,1055,shaman,enhancement,18,11,7
Blöw,tichondrius,1055,shaman,enhancement,18,11,7
Bigboorst,tichondrius,1055,shaman,enhancement,18,11,7
Shampowl,jaedenar,1055,shaman,enhancement,30,11,19
Möuthbläster,malganis,1054,shaman,enhancement,12,11,1
Syraak,elune,1054,shaman,enhancement,15,12,3
Fishsham,zuljin,1054,shaman,enhancement,18,11,7
Totemclass,bleeding-hollow,1054,shaman,enhancement,18,11,7
Jirig,tichondrius,1054,shaman,enhancement,18,11,7
Kyrz,ragnaros,1054,shaman,enhancement,18,11,7
Hagie,moon-guard,1053,shaman,enhancement,21,11,10
Slowdown,malganis,1053,shaman,enhancement,30,11,19
Windzorn,tichondrius,1052,shaman,enhancement,18,11,7
Peepingtotem,tichondrius,1052,shaman,enhancement,24,11,13
Buffdudé,illidan,1052,shaman,enhancement,24,11,13
Kuull,thunderlord,1052,shaman,enhancement,30,11,19
Faminex,dragonmaw,1051,shaman,enhancement,12,11,1
Swapxylee,tichondrius,1051,shaman,enhancement,24,11,13
Naesala,thunderlord,1050,shaman,enhancement,24,11,13
Dronesum,tichondrius,1050,shaman,enhancement,24,11,13
Scams,bleeding-hollow,1049,shaman,enhancement,30,18,12
Grindl,stormrage,1047,shaman,enhancement,18,11,7
Sparkqt,sargeras,1047,shaman,enhancement,18,11,7
Emptyy,azralon,1047,shaman,enhancement,24,11,13
Johnnygeh,stormrage,1047,shaman,enhancement,30,11,19
Îvôry,bloodhoof,1046,shaman,enhancement,24,11,13
Ctrlaltelite,burning-blade,1044,shaman,enhancement,76,30,46
Svddëndëath,sargeras,1044,shaman,enhancement,72,27,45
Jamblee,sargeras,1043,shaman,enhancement,18,11,7
Cvoa,bonechewer,1043,shaman,enhancement,24,11,13
Trulos,stormrage,1041,shaman,enhancement,18,11,7
Thunderfuri,thrall,1037,shaman,enhancement,18,11,7
Hannibol,tichondrius,1036,shaman,enhancement,72,25,47
Allmeatie,hyjal,1035,shaman,enhancement,18,11,7
Zalkran,area-52,1034,shaman,enhancement,24,15,9
Currentx,darkspear,1030,shaman,enhancement,33,12,21
Goondruka,area-52,1023,shaman,enhancement,20,12,8
Bigbólts,emerald-dream,1021,shaman,enhancement,20,13,7
Felbrick,area-52,1021,shaman,enhancement,36,18,18
Morderus,aegwynn,1021,shaman,enhancement,24,11,13
Tøtëm,tichondrius,1021,shaman,enhancement,28,12,16
Facebooksux,sargeras,1019,shaman,enhancement,18,13,5
Dizzytotem,dalaran,1013,shaman,enhancement,30,17,13
Pùffball,anvilmar,1011,shaman,enhancement,75,38,37
Xapoxy,nemesis,1008,shaman,enhancement,20,12,8
Rhagnar,warsong,1004,shaman,enhancement,17,11,6
Dedlystorm,dalaran,1003,shaman,enhancement,18,12,6
PlayerJRRTZR,tichondrius,1002,shaman,enhancement,23,11,12
Stroheim,warsong,1000,shaman,enhancement,21,12,9
Poseidonxd,lightbringer,1000,shaman,enhancement,23,13,10
Korgen,area-52,999,shaman,enhancement,25,12,13
Bloodytotemz,emerald-dream,999,shaman,enhancement,24,11,13
Slaughterdog,coilfang,995,shaman,enhancement,22,13,9
Prinkipíssa,tichondrius,995,shaman,enhancement,48,22,26
Reavs,illidan,995,shaman,enhancement,40,12,28
Synshenrongt,thrall,990,shaman,enhancement,178,70,108
Pwnôgraphy,kelthuzad,989,shaman,enhancement,14,11,3
Zelzus,moon-guard,989,shaman,enhancement,22,11,11
Megumi,aggramar,988,shaman,enhancement,26,11,15
Deckìn,proudmoore,987,shaman,enhancement,14,11,3
Mudpwet,borean-tundra,982,shaman,enhancement,54,30,24
Shamvandám,kiljaeden,978,shaman,enhancement,30,13,17
Stormwolf,azjolnerub,976,shaman,enhancement,60,30,30
Kyness,area-52,963,shaman,enhancement,31,17,14
Violat,area-52,960,shaman,enhancement,12,10,2
Enhance,sargeras,960,shaman,enhancement,18,10,8
Zatchbell,lightnings-blade,960,shaman,enhancement,30,13,17
Lokrath,zangarmarsh,959,shaman,enhancement,12,10,2
Pikachil,tichondrius,959,shaman,enhancement,15,11,4
Electrik,stormrage,959,shaman,enhancement,18,10,8
Anlukla,gilneas,959,shaman,enhancement,18,10,8
Daddyzmilk,bleeding-hollow,959,shaman,enhancement,18,10,8
Kumboi,frostmourne,959,shaman,enhancement,24,10,14
Ambevsulfr,deathwing,958,shaman,enhancement,12,10,2
Igarmaul,bonechewer,958,shaman,enhancement,18,10,8
Marginalized,tichondrius,958,shaman,enhancement,18,10,8
Ggsggs,akama,958,shaman,enhancement,18,10,8
Jimorrison,wyrmrest-accord,958,shaman,enhancement,18,10,8
Thoramgar,malganis,958,shaman,enhancement,18,10,8
Kelce,stormrage,958,shaman,enhancement,18,10,8
Evidence,thrall,958,shaman,enhancement,18,10,8
Stormsanta,emerald-dream,958,shaman,enhancement,24,10,14
Chesos,tichondrius,958,shaman,enhancement,90,33,57
Chavezlives,area-52,957,shaman,enhancement,18,10,8
Leotis,tichondrius,957,shaman,enhancement,18,10,8
Ffaísca,azralon,956,shaman,enhancement,12,10,2
Keroh,blackrock,956,shaman,enhancement,18,10,8
Azl,guldan,956,shaman,enhancement,27,11,16
Tukkutz,moon-guard,955,shaman,enhancement,48,19,29
Aelpian,emerald-dream,954,shaman,enhancement,18,10,8
Smokedemtree,stormrage,954,shaman,enhancement,18,10,8
Painfury,zuljin,954,shaman,enhancement,18,10,8
Ryntyntyn,blood-furnace,954,shaman,enhancement,24,10,14
Shomminn,tichondrius,953,shaman,enhancement,18,10,8
Rhez,frostmourne,951,shaman,enhancement,24,10,14
Mcgraff,frostmourne,949,shaman,enhancement,18,10,8
Loec,thrall,947,shaman,enhancement,18,10,8
Esko,magtheridon,943,shaman,enhancement,24,10,14
Thanwirn,ragnaros,932,shaman,enhancement,42,19,23
Orfelix,nemesis,925,shaman,enhancement,42,17,25
Zandya,nemesis,924,shaman,enhancement,30,10,20
Golozok,zuljin,923,shaman,enhancement,22,12,10
Wälee,sargeras,921,shaman,enhancement,18,10,8
Gammacide,sargeras,921,shaman,enhancement,29,10,19
Oct,thrall,912,shaman,enhancement,36,18,18
Shockshack,illidan,911,shaman,enhancement,17,10,7
Grimlên,skullcrusher,910,shaman,enhancement,32,12,20
Duality,shattered-halls,909,shaman,enhancement,23,10,13
Garabashi,boulderfist,908,shaman,enhancement,24,11,13
Thanen,the-scryers,897,shaman,enhancement,48,21,27
Bqo,nemesis,892,shaman,enhancement,14,10,4
Icedogg,malganis,889,shaman,enhancement,42,20,22
Poagrious,bonechewer,876,shaman,enhancement,40,17,23
Vekku,ragnaros,872,shaman,enhancement,19,10,9
Fiercegoblin,drakkari,866,shaman,enhancement,25,10,15
Shakazz,malganis,864,shaman,enhancement,12,9,3
Elefusion,sargeras,864,shaman,enhancement,12,9,3
Kaandel,nemesis,864,shaman,enhancement,12,9,3
Mílkthis,tichondrius,864,shaman,enhancement,12,9,3
Conorfotm,tichondrius,864,shaman,enhancement,12,9,3
Twotapped,sargeras,864,shaman,enhancement,12,9,3
Frantìk,tichondrius,864,shaman,enhancement,12,9,3
Raídyn,sargeras,864,shaman,enhancement,12,9,3
Solbis,tichondrius,864,shaman,enhancement,12,9,3
Gódsgíft,tichondrius,864,shaman,enhancement,18,9,9
Shlongers,illidan,864,shaman,enhancement,18,9,9
Yejinok,tichondrius,864,shaman,enhancement,18,9,9
Luluzada,azralon,864,shaman,enhancement,18,9,9
Sethbrogen,vashj,864,shaman,enhancement,24,9,15
Lickerman,stormreaver,863,shaman,enhancement,12,9,3
Thicctotes,tichondrius,863,shaman,enhancement,12,9,3
Crnosham,area-52,863,shaman,enhancement,12,9,3
Cluffatty,tichondrius,863,shaman,enhancement,12,9,3
Biggem,nazjatar,863,shaman,enhancement,18,9,9
Flukz,nazjatar,863,shaman,enhancement,18,9,9
Dreamers,anvilmar,863,shaman,enhancement,18,9,9
Sluggox,bleeding-hollow,863,shaman,enhancement,18,9,9
Rubious,cenarius,863,shaman,enhancement,19,9,10
Okkoto,malfurion,862,shaman,enhancement,12,9,3
Kakiscala,proudmoore,862,shaman,enhancement,17,9,8
Murdokr,quelthalas,862,shaman,enhancement,18,9,9
Stankydad,tichondrius,862,shaman,enhancement,18,9,9
Bioshocked,korgath,862,shaman,enhancement,18,9,9
Bjôrn,bonechewer,862,shaman,enhancement,18,9,9
Kelx,stormreaver,862,shaman,enhancement,36,9,27
Chiëfslapaho,tichondrius,861,shaman,enhancement,12,9,3
Gorgrom,thunderlord,861,shaman,enhancement,12,9,3
Nuofu,illidan,861,shaman,enhancement,22,10,12
Bargen,thunderlord,860,shaman,enhancement,12,9,3
Hoann,tichondrius,860,shaman,enhancement,18,9,9
Shocksqt,malganis,860,shaman,enhancement,24,9,15
Schnellhund,tichondrius,859,shaman,enhancement,18,9,9
Bôjack,stormrage,858,shaman,enhancement,12,9,3
Denki,nesingwary,858,shaman,enhancement,18,9,9
Hazorele,nagrand,857,shaman,enhancement,18,9,9
Mydus,kiljaeden,855,shaman,enhancement,18,9,9
Bilbobaggenz,sargeras,854,shaman,enhancement,18,9,9
Windfuryshm,emerald-dream,853,shaman,enhancement,18,9,9
Cdont,zuljin,853,shaman,enhancement,18,9,9
Srgarrobo,drakkari,850,shaman,enhancement,30,14,16
Halajo,thrall,849,shaman,enhancement,27,10,17
Catchclause,eonar,846,shaman,enhancement,18,10,8
Ongruge,hyjal,846,shaman,enhancement,83,33,50
Charr,nemesis,838,shaman,enhancement,18,9,9
Columan,frostmourne,834,shaman,enhancement,137,68,69
Scherzer,frostwolf,831,shaman,enhancement,20,10,10
Grosgars,burning-blade,830,shaman,enhancement,20,10,10
Relyts,tichondrius,825,shaman,enhancement,24,11,13
Britisy,stormrage,825,shaman,enhancement,24,10,14
Sharmut,bleeding-hollow,816,shaman,enhancement,21,10,11
Azzula,tichondrius,809,shaman,enhancement,25,10,15
Maicer,goldrinn,809,shaman,enhancement,35,9,26
Gesundrian,kelthuzad,800,shaman,enhancement,16,9,7
Notglads,thrall,799,shaman,enhancement,14,9,5
Thorael,borean-tundra,798,shaman,enhancement,11,9,2
Shamtopus,anubarak,798,shaman,enhancement,17,9,8
Slumb,stormrage,781,shaman,enhancement,19,9,10
Jamz,lightbringer,768,shaman,enhancement,12,8,4
Ennoku,khadgar,768,shaman,enhancement,12,8,4
Plznostepmom,tichondrius,768,shaman,enhancement,12,8,4
Humiliated,stormrage,768,shaman,enhancement,12,8,4
Onamakawash,black-dragonflight,768,shaman,enhancement,12,8,4
Aceventuura,hyjal,768,shaman,enhancement,12,8,4
Mazaar,kul-tiras,768,shaman,enhancement,12,8,4
Cinderfury,magtheridon,768,shaman,enhancement,12,8,4
Illchayqt,frostmourne,768,shaman,enhancement,12,8,4
Botu,malorne,768,shaman,enhancement,12,8,4
Jelebeans,tichondrius,768,shaman,enhancement,12,8,4
Còsmos,illidan,768,shaman,enhancement,12,8,4
Lindsanx,illidan,768,shaman,enhancement,18,8,10
Neeman,malganis,768,shaman,enhancement,18,8,10
Mastrioni,dragonmaw,768,shaman,enhancement,18,8,10
Athropos,malganis,768,shaman,enhancement,18,8,10
Muyg,staghelm,768,shaman,enhancement,24,8,16
Nekorii,bleeding-hollow,767,shaman,enhancement,12,8,4
Barrakum,darrowmere,767,shaman,enhancement,12,8,4
Zunjix,tichondrius,767,shaman,enhancement,12,8,4
Elevatezxo,stormrage,767,shaman,enhancement,12,8,4
Troon,lightbringer,767,shaman,enhancement,12,8,4
Lohnash,area-52,767,shaman,enhancement,12,8,4
Xamaobomberø,azralon,767,shaman,enhancement,12,8,4
Dontbeshockd,nagrand,767,shaman,enhancement,14,8,6
Obombyas,sargeras,767,shaman,enhancement,18,8,10
Finaplex,spirestone,767,shaman,enhancement,18,8,10
Cuban,kelthuzad,767,shaman,enhancement,18,8,10
Doughchino,darkspear,767,shaman,enhancement,18,8,10
Lamorandrict,icecrown,767,shaman,enhancement,18,8,10
Suejitsue,malganis,767,shaman,enhancement,18,8,10
Jags,baelgun,767,shaman,enhancement,18,8,10
Wæver,tichondrius,767,shaman,enhancement,18,8,10
Volrog,magtheridon,767,shaman,enhancement,18,8,10
Beast,mannoroth,767,shaman,enhancement,18,8,10
Loliqueenfae,illidan,767,shaman,enhancement,18,8,10
Cutedraenei,destromath,767,shaman,enhancement,24,8,16
Reptimus,sargeras,767,shaman,enhancement,24,8,16
Pipers,frostmourne,767,shaman,enhancement,30,8,22
Bigtotempole,stormreaver,766,shaman,enhancement,12,8,4
Chamxz,ragnaros,766,shaman,enhancement,12,8,4
Xhenra,proudmoore,766,shaman,enhancement,12,8,4
Adhdeeznuts,frostmourne,766,shaman,enhancement,18,8,10
Gluestick,shadowmoon,766,shaman,enhancement,24,8,16
Weatherboy,dalaran,765,shaman,enhancement,18,8,10
Jonatasele,stormrage,765,shaman,enhancement,24,8,16
Beul,wyrmrest-accord,764,shaman,enhancement,18,8,10
Shaminja,kiljaeden,763,shaman,enhancement,12,8,4
Meatballman,malganis,763,shaman,enhancement,24,8,16
Endme,zuljin,758,shaman,enhancement,12,8,4
Orendail,jubeithos,758,shaman,enhancement,24,8,16
Rocktor,alleria,757,shaman,enhancement,12,8,4
Shimshak,destromath,756,shaman,enhancement,18,8,10
Kumu,stormscale,735,shaman,enhancement,11,8,3
Morgoph,bleeding-hollow,735,shaman,enhancement,14,9,5
Rakfnaruk,zuljin,735,shaman,enhancement,16,8,8
Radan,kelthuzad,735,shaman,enhancement,17,8,9
Darshidarsh,emerald-dream,735,shaman,enhancement,22,8,14
Emaric,sargeras,735,shaman,enhancement,23,8,15
Vinara,drenden,732,shaman,enhancement,18,8,10
Omnipresent,malganis,719,shaman,enhancement,17,8,9
Succies,emerald-dream,719,shaman,enhancement,17,8,9
Blackshami,quelthalas,718,shaman,enhancement,18,8,10
Shockedya,destromath,714,shaman,enhancement,23,10,13
Pwnskillz,area-52,712,shaman,enhancement,17,8,9
Hammerdog,illidan,703,shaman,enhancement,16,8,8
Paulenia,quelthalas,699,shaman,enhancement,29,8,21
Õhmÿ,emerald-dream,687,shaman,enhancement,11,8,3
Grìmlock,lightbringer,687,shaman,enhancement,13,8,5
Eimear,kelthuzad,672,shaman,enhancement,12,7,5
Akwar,greymane,672,shaman,enhancement,12,7,5
Shòckaholic,bleeding-hollow,672,shaman,enhancement,12,7,5
Wojnar,zuljin,672,shaman,enhancement,12,7,5
Olujakal,emerald-dream,672,shaman,enhancement,12,7,5
Battleimp,kelthuzad,672,shaman,enhancement,12,7,5
Windführer,illidan,672,shaman,enhancement,12,7,5
Vlal,tichondrius,672,shaman,enhancement,12,7,5
Oneripemango,illidan,672,shaman,enhancement,12,7,5
Zapstrike,stormrage,672,shaman,enhancement,12,7,5
Bawkbagawk,bleeding-hollow,672,shaman,enhancement,12,7,5
Asy,tichondrius,672,shaman,enhancement,12,7,5
Yaytotems,sargeras,672,shaman,enhancement,12,7,5
Lïnc,sargeras,672,shaman,enhancement,12,7,5
Dwârf,tichondrius,672,shaman,enhancement,12,7,5
Lavalinks,malganis,672,shaman,enhancement,12,7,5
Sourcreamqtx,stormrage,672,shaman,enhancement,12,7,5
Ogsmolsham,zuljin,672,shaman,enhancement,12,7,5
Skylîne,sargeras,672,shaman,enhancement,12,7,5
Xoxoxø,area-52,672,shaman,enhancement,12,7,5
Mattzander,kiljaeden,672,shaman,enhancement,12,7,5
Ftp,kelthuzad,672,shaman,enhancement,12,7,5
Ceromental,frostmane,672,shaman,enhancement,12,7,5
Yungcreampie,bleeding-hollow,672,shaman,enhancement,18,7,11
Ayahuaskah,illidan,672,shaman,enhancement,18,7,11
Jeuno,gnomeregan,672,shaman,enhancement,18,7,11
Kidkovid,illidan,672,shaman,enhancement,18,7,11
Raywhiter,tichondrius,672,shaman,enhancement,22,8,14
Yudo,stormrage,672,shaman,enhancement,24,7,17
Hexondabeach,barthilas,671,shaman,enhancement,12,7,5
Ayahuaska,darkspear,671,shaman,enhancement,12,7,5
Gonarosh,area-52,671,shaman,enhancement,12,7,5
Jigawatt,doomhammer,671,shaman,enhancement,12,7,5
Thiccpedro,andorhal,671,shaman,enhancement,12,7,5
Jènova,whisperwind,671,shaman,enhancement,12,7,5
Hypersomnia,icecrown,671,shaman,enhancement,12,7,5
Killercam,maiev,671,shaman,enhancement,12,7,5
Murm,burning-blade,671,shaman,enhancement,12,7,5
Checkmâte,emerald-dream,671,shaman,enhancement,12,7,5
Garshok,tichondrius,671,shaman,enhancement,12,7,5
Nondracil,ragnaros,671,shaman,enhancement,18,7,11
Gwyste,moon-guard,671,shaman,enhancement,18,7,11
Hellothere,drenden,671,shaman,enhancement,18,7,11
Enhancee,bonechewer,671,shaman,enhancement,18,7,11
Atlli,zuljin,671,shaman,enhancement,18,7,11
Coronavirrus,hydraxis,671,shaman,enhancement,18,7,11
Jëks,azjolnerub,671,shaman,enhancement,18,7,11
Sâxman,stormreaver,671,shaman,enhancement,18,7,11
Hroth,tanaris,671,shaman,enhancement,18,7,11
Wickyz,moon-guard,671,shaman,enhancement,18,7,11
Hrotah,wyrmrest-accord,671,shaman,enhancement,18,7,11
Zald,shattered-halls,671,shaman,enhancement,18,7,11
Wildslammer,khazgoroth,671,shaman,enhancement,18,7,11
Velekar,moon-guard,671,shaman,enhancement,21,8,13
Hablarocas,ragnaros,671,shaman,enhancement,24,7,17
Radiology,garithos,670,shaman,enhancement,12,7,5
Drewshammy,zuljin,670,shaman,enhancement,12,7,5
Morehammeerr,thunderlord,670,shaman,enhancement,12,7,5
Spankì,kelthuzad,670,shaman,enhancement,12,7,5
Orcgirth,kiljaeden,670,shaman,enhancement,21,8,13
Hexoffénder,tichondrius,669,shaman,enhancement,9,8,1
Thunderod,destromath,669,shaman,enhancement,12,7,5
Vladd,hellscream,669,shaman,enhancement,18,7,11
Motylek,ragnaros,669,shaman,enhancement,18,7,11
Helljumper,illidan,669,shaman,enhancement,21,8,13
Zeebouzy,illidan,669,shaman,enhancement,21,8,13
Mugnar,alleria,669,shaman,enhancement,24,7,17
Jacniclstorm,frostmourne,668,shaman,enhancement,12,7,5
Funkyshock,dalaran,667,shaman,enhancement,18,7,11
Karisaatara,moon-guard,665,shaman,enhancement,15,8,7
Gbankzz,ghostlands,664,shaman,enhancement,24,7,17
Lobovulpino,quelthalas,663,shaman,enhancement,12,7,5
Shammich,vashj,655,shaman,enhancement,11,7,4
Speedmonster,hellscream,655,shaman,enhancement,19,8,11
Shablam,daggerspine,640,shaman,enhancement,28,7,21
Creamcheeser,tichondrius,639,shaman,enhancement,11,7,4
Fligmos,llane,639,shaman,enhancement,20,8,12
Shampainn,demon-soul,638,shaman,enhancement,20,8,12
Cram,frostmourne,638,shaman,enhancement,23,7,16
Heaties,tichondrius,623,shaman,enhancement,11,7,4
Smeeza,frostmourne,617,shaman,enhancement,21,9,12
Intress,moon-guard,607,shaman,enhancement,10,7,3
Eanne,moon-guard,592,shaman,enhancement,19,7,12
Vuduü,stormrage,576,shaman,enhancement,6,6,0
Meadamemnon,tichondrius,576,shaman,enhancement,6,6,0
Dånydevito,moonrunner,576,shaman,enhancement,6,6,0
Chachmon,ursin,576,shaman,enhancement,6,6,0
Clear,darkspear,576,shaman,enhancement,6,6,0
Mèrkk,misha,576,shaman,enhancement,6,6,0
Ftierspec,frostmourne,576,shaman,enhancement,6,6,0
Shockpanda,zuljin,576,shaman,enhancement,6,6,0
Shamane,onyxia,576,shaman,enhancement,6,6,0
Spotbeard,shadowsong,576,shaman,enhancement,6,6,0
Pikoom,tichondrius,576,shaman,enhancement,6,6,0
Mcumshot,ragnaros,576,shaman,enhancement,12,6,6
Stormdancer,elune,576,shaman,enhancement,12,6,6
Stylebenderx,frostmourne,576,shaman,enhancement,12,6,6
Fischerman,barthilas,576,shaman,enhancement,12,6,6
Orkshammy,illidan,576,shaman,enhancement,12,6,6
Uggoluga,dalaran,576,shaman,enhancement,12,6,6
Agpx,tichondrius,576,shaman,enhancement,12,6,6
Kêtchpup,wyrmrest-accord,576,shaman,enhancement,12,6,6
Cooperation,kelthuzad,576,shaman,enhancement,12,6,6
Nyvka,ragnaros,576,shaman,enhancement,12,6,6
Skrankles,illidan,576,shaman,enhancement,12,6,6
Onlyfanslink,darkspear,576,shaman,enhancement,12,6,6
Kyzen,tichondrius,576,shaman,enhancement,12,6,6
Strønklesøn,drakthul,576,shaman,enhancement,12,6,6
Crucybletv,korgath,576,shaman,enhancement,12,6,6
Måståçåstå,bleeding-hollow,576,shaman,enhancement,12,6,6
Owtyobwol,area-52,576,shaman,enhancement,12,6,6
Coraamia,nerzhul,576,shaman,enhancement,12,6,6
Scarlo,bleeding-hollow,576,shaman,enhancement,12,6,6
Karagra,tichondrius,576,shaman,enhancement,12,6,6
Blazefury,stormrage,576,shaman,enhancement,12,6,6
Firetrucks,area-52,576,shaman,enhancement,12,6,6
Xaspen,skullcrusher,576,shaman,enhancement,12,6,6
Enhpower,area-52,576,shaman,enhancement,12,6,6
Gamba,kargath,576,shaman,enhancement,12,6,6
Thunderøus,stormrage,576,shaman,enhancement,12,6,6
Hruggol,bleeding-hollow,576,shaman,enhancement,12,6,6
Stnky,cairne,576,shaman,enhancement,12,6,6
Dtrumpx,tichondrius,576,shaman,enhancement,12,6,6
Cptsnarf,tichondrius,576,shaman,enhancement,12,6,6
Bussybutter,sargeras,576,shaman,enhancement,12,6,6
Trashcam,illidan,576,shaman,enhancement,12,6,6
Neuralînk,tichondrius,576,shaman,enhancement,15,7,8
Unrezolved,hyjal,576,shaman,enhancement,13,6,7
Groovesh,thrall,576,shaman,enhancement,14,6,8
Ikiteforlsd,zuljin,576,shaman,enhancement,14,6,8
Washedupty,illidan,576,shaman,enhancement,18,6,12
Ferdashock,tichondrius,576,shaman,enhancement,18,6,12
Earthclap,tichondrius,576,shaman,enhancement,24,6,18
Somethingdop,sargeras,575,shaman,enhancement,12,6,6
Argues,tichondrius,575,shaman,enhancement,12,6,6
Royvaz,guldan,575,shaman,enhancement,12,6,6
Darkvx,quelthalas,575,shaman,enhancement,12,6,6
Naextramus,ragnaros,575,shaman,enhancement,12,6,6
Tumble,barthilas,575,shaman,enhancement,12,6,6
Oaktar,bleeding-hollow,575,shaman,enhancement,12,6,6
Dacota,emerald-dream,575,shaman,enhancement,12,6,6
Eternalife,khazgoroth,575,shaman,enhancement,12,6,6
Gingeroo,stonemaul,575,shaman,enhancement,12,6,6
Frèya,uldaman,575,shaman,enhancement,12,6,6
Fevolution,dreadmaul,575,shaman,enhancement,12,6,6
Kobeshio,destromath,575,shaman,enhancement,21,7,14
Møp,spirestone,575,shaman,enhancement,18,6,12
Regeneration,darkspear,575,shaman,enhancement,18,6,12
Rockbass,sargeras,575,shaman,enhancement,18,6,12
Zentius,thunderhorn,575,shaman,enhancement,18,6,12
Sartikiria,wyrmrest-accord,575,shaman,enhancement,18,6,12
Ummyea,dreadmaul,574,shaman,enhancement,12,6,6
Okdopey,area-52,574,shaman,enhancement,18,6,12
Størmbreäker,tichondrius,572,shaman,enhancement,12,6,6
Hazreti,zuljin,572,shaman,enhancement,18,6,12
Fadesrp,moon-guard,571,shaman,enhancement,12,6,6
Kylnadra,silvermoon,571,shaman,enhancement,12,6,6
Ðg,tichondrius,569,shaman,enhancement,18,6,12
Maxsimiliano,emerald-dream,559,shaman,enhancement,18,6,12
Rykutu,lightbringer,544,shaman,enhancement,10,7,3
Meshrek,tichondrius,543,shaman,enhancement,11,6,5
Toastsshaman,tichondrius,528,shaman,enhancement,9,6,3
Partypurge,malganis,527,shaman,enhancement,11,6,5
Boozecruz,silvermoon,527,shaman,enhancement,11,6,5
Noveske,arthas,522,shaman,enhancement,15,7,8
Ayangat,darkspear,511,shaman,enhancement,10,6,4
Beelzeburst,sargeras,511,shaman,enhancement,11,6,5
Streetacus,tichondrius,510,shaman,enhancement,20,6,14
Dangguagua,illidan,480,shaman,enhancement,6,5,1
Krunggar,azralon,480,shaman,enhancement,6,5,1
Bluepenguin,kelthuzad,480,shaman,enhancement,6,5,1
Arrok,bleeding-hollow,480,shaman,enhancement,6,5,1
Remi,tichondrius,480,shaman,enhancement,6,5,1
Iava,dalaran,480,shaman,enhancement,6,5,1
Tremordrfear,lightbringer,480,shaman,enhancement,6,5,1
Dörnèr,malganis,480,shaman,enhancement,6,5,1
Fwap,bleeding-hollow,480,shaman,enhancement,6,5,1
Guybeingdude,sargeras,480,shaman,enhancement,6,5,1
Rokudo,dragonmaw,480,shaman,enhancement,6,5,1
Taintvapor,stormrage,480,shaman,enhancement,6,5,1
Bofah,draktharon,480,shaman,enhancement,6,5,1
Zappiiboii,malganis,480,shaman,enhancement,6,5,1
Beatmán,blades-edge,480,shaman,enhancement,6,5,1
Durkh,ragnaros,480,shaman,enhancement,6,5,1
Mynigabob,zuljin,480,shaman,enhancement,6,5,1
Wugmuk,illidan,480,shaman,enhancement,6,5,1
Seraøth,area-52,480,shaman,enhancement,6,5,1
Nakamora,tichondrius,480,shaman,enhancement,6,5,1
Setek,barthilas,480,shaman,enhancement,6,5,1
Tekdar,kiljaeden,480,shaman,enhancement,10,6,4
Gohsham,hyjal,480,shaman,enhancement,12,5,7
Kamisenhance,illidan,480,shaman,enhancement,12,5,7
Sleepysham,anubarak,480,shaman,enhancement,12,5,7
Keltarget,malganis,480,shaman,enhancement,12,5,7
Meatlog,dalaran,480,shaman,enhancement,12,5,7
Berasham,aerie-peak,480,shaman,enhancement,12,5,7
Osunutai,ragnaros,480,shaman,enhancement,12,5,7
Mustachex,kelthuzad,480,shaman,enhancement,12,5,7
Mawcus,zuljin,480,shaman,enhancement,12,5,7
Tótemicotl,quelthalas,480,shaman,enhancement,12,5,7
Macumbolo,nemesis,480,shaman,enhancement,12,5,7
Rabbitlol,tichondrius,480,shaman,enhancement,12,5,7
Killamanjaro,alterac-mountains,480,shaman,enhancement,12,5,7
Hornyratchet,bleeding-hollow,480,shaman,enhancement,12,5,7
Electrikz,moonrunner,480,shaman,enhancement,12,5,7
Kultirio,quelthalas,480,shaman,enhancement,12,5,7
Scrototæm,area-52,480,shaman,enhancement,12,5,7
Sèktor,dalaran,480,shaman,enhancement,12,5,7
Spencesham,sargeras,480,shaman,enhancement,12,5,7
Tiostroke,stormrage,480,shaman,enhancement,12,5,7
Dennwoop,sargeras,480,shaman,enhancement,12,5,7
Gorehouse,kiljaeden,480,shaman,enhancement,12,5,7
Nordstorm,stormrage,480,shaman,enhancement,12,5,7
Choquinho,azralon,480,shaman,enhancement,12,5,7
Shango,kalecgos,480,shaman,enhancement,12,5,7
Jorgim,frostmourne,480,shaman,enhancement,12,5,7
Waterground,tichondrius,480,shaman,enhancement,12,5,7
Laquica,sargeras,480,shaman,enhancement,12,5,7
Bôrghâ,sargeras,480,shaman,enhancement,12,5,7
Indaka,kiljaeden,480,shaman,enhancement,12,5,7
Kwizal,stormrage,480,shaman,enhancement,12,5,7
Capivarãão,stormrage,480,shaman,enhancement,12,5,7
Matzahmeal,skywall,480,shaman,enhancement,12,5,7
Gyokuken,stormrage,480,shaman,enhancement,18,5,13
Fíren,area-52,480,shaman,enhancement,18,5,13
Zarzlek,destromath,480,shaman,enhancement,25,5,20
Wokoe,tichondrius,479,shaman,enhancement,6,5,1
Tugnar,ragnaros,479,shaman,enhancement,12,5,7
Dushkanar,barthilas,479,shaman,enhancement,12,5,7
Bwandamian,emerald-dream,479,shaman,enhancement,12,5,7
Böc,tichondrius,479,shaman,enhancement,12,5,7
Youngthùg,frostmourne,479,shaman,enhancement,18,5,13
Aegaeonlol,tichondrius,479,shaman,enhancement,18,5,13
Tirtok,laughing-skull,479,shaman,enhancement,18,5,13
Brorogan,aerie-peak,478,shaman,enhancement,12,5,7
Ellynnu,frostmourne,478,shaman,enhancement,12,5,7
Flie,tichondrius,478,shaman,enhancement,18,5,13
Enkkiz,ragnaros,477,shaman,enhancement,12,5,7
Curtrex,amanthul,472,shaman,enhancement,19,8,11
Grogakk,moon-guard,447,shaman,enhancement,12,6,6
Shazikial,illidan,447,shaman,enhancement,11,5,6
Jazzyy,korgath,447,shaman,enhancement,11,5,6
Flamestrife,illidan,426,shaman,enhancement,28,8,20
Totojar,alexstrasza,426,shaman,enhancement,22,6,16
Furiousnick,stormrage,415,shaman,enhancement,8,5,3
Rykku,illidan,400,shaman,enhancement,7,5,2
Bigbb,tichondrius,400,shaman,enhancement,10,6,4
Touchovlife,dragonblight,384,shaman,enhancement,6,4,2
Protoaster,tichondrius,384,shaman,enhancement,6,4,2
Ezzroz,guldan,384,shaman,enhancement,6,4,2
Skybender,silvermoon,384,shaman,enhancement,6,4,2
Meramin,illidan,384,shaman,enhancement,6,4,2
Sorgal,area-52,384,shaman,enhancement,6,4,2
Tokyotimxxo,malganis,384,shaman,enhancement,6,4,2
Bigboyjones,thrall,384,shaman,enhancement,6,4,2
Thegil,tichondrius,384,shaman,enhancement,6,4,2
Donogal,aerie-peak,384,shaman,enhancement,6,4,2
Drmn,frostmourne,384,shaman,enhancement,6,4,2
Elemastery,windrunner,384,shaman,enhancement,6,4,2
Urao,stormrage,384,shaman,enhancement,6,4,2
Wools,frostmourne,384,shaman,enhancement,6,4,2
Anime,azralon,384,shaman,enhancement,6,4,2
Utilitytotem,moon-guard,384,shaman,enhancement,6,4,2
Drugdòér,tichondrius,384,shaman,enhancement,6,4,2
Stormysteve,hyjal,384,shaman,enhancement,6,4,2
Heavy,ragnaros,384,shaman,enhancement,6,4,2
Dingfu,sargeras,384,shaman,enhancement,6,4,2
Omomo,shadowmoon,384,shaman,enhancement,6,4,2
Slurslinger,area-52,384,shaman,enhancement,6,4,2
Birkenshock,tichondrius,384,shaman,enhancement,6,4,2
Angrytotems,ragnaros,384,shaman,enhancement,6,4,2
Crowingraven,queldorei,384,shaman,enhancement,6,4,2
Kylani,thrall,384,shaman,enhancement,6,4,2
Wheath,tichondrius,384,shaman,enhancement,6,4,2
Kisseyfaçaí,kelthuzad,384,shaman,enhancement,6,4,2
Goldshîre,tichondrius,384,shaman,enhancement,6,4,2
Bronzers,tichondrius,384,shaman,enhancement,6,4,2
Mastrionilol,dragonmaw,384,shaman,enhancement,6,4,2
Orcswole,tichondrius,384,shaman,enhancement,6,4,2
Grimwind,tichondrius,384,shaman,enhancement,6,4,2
Skipler,stormrage,384,shaman,enhancement,6,4,2
Aureal,malganis,384,shaman,enhancement,6,4,2
Eleshortal,azuremyst,384,shaman,enhancement,9,4,5
Bloudabadee,emerald-dream,384,shaman,enhancement,12,4,8
Gaurudon,zuljin,384,shaman,enhancement,12,4,8
Nehrakgu,wyrmrest-accord,384,shaman,enhancement,12,4,8
Merrìtt,area-52,384,shaman,enhancement,12,4,8
Gangdan,emerald-dream,384,shaman,enhancement,12,4,8
Flamefüry,azralon,384,shaman,enhancement,12,4,8
Ironloins,kelthuzad,384,shaman,enhancement,12,4,8
Smackzs,sargeras,384,shaman,enhancement,12,4,8
Cariix,maelstrom,384,shaman,enhancement,12,4,8
Globad,tichondrius,384,shaman,enhancement,12,4,8
Kinnarlan,sargeras,384,shaman,enhancement,12,4,8
Emppege,tichondrius,384,shaman,enhancement,12,4,8
Newele,thrall,384,shaman,enhancement,12,4,8
Kaalyssia,moon-guard,384,shaman,enhancement,12,4,8
Piril,moon-guard,384,shaman,enhancement,12,4,8
Doorti,area-52,384,shaman,enhancement,12,4,8
Bigstormz,fenris,384,shaman,enhancement,12,4,8
Wabfurrie,twisting-nether,384,shaman,enhancement,12,4,8
Kooj,frostmourne,384,shaman,enhancement,12,4,8
Nokrosao,aegwynn,384,shaman,enhancement,12,4,8
Vertrág,malganis,384,shaman,enhancement,12,4,8
Tictactotem,lothar,384,shaman,enhancement,12,4,8
Omaboa,azgalor,384,shaman,enhancement,12,4,8
Enanomka,drakkari,384,shaman,enhancement,12,4,8
Naturebøy,bleeding-hollow,384,shaman,enhancement,12,4,8
Odhin,mannoroth,384,shaman,enhancement,12,4,8
Foray,barthilas,384,shaman,enhancement,12,4,8
Styrmic,frostmourne,384,shaman,enhancement,12,4,8
Brenqt,nemesis,384,shaman,enhancement,18,4,14
Xoelement,borean-tundra,384,shaman,enhancement,18,4,14
Stormmän,stormrage,384,shaman,enhancement,18,4,14
Illdelph,crushridge,384,shaman,enhancement,18,4,14
Çatastrophe,dalaran,384,shaman,enhancement,18,4,14
Grimdil,quelthalas,384,shaman,enhancement,18,4,14
Ipponhim,saurfang,383,shaman,enhancement,6,4,2
Vectos,bleeding-hollow,383,shaman,enhancement,6,4,2
Rhal,ragnaros,383,shaman,enhancement,6,4,2
Ugaboogah,thrall,383,shaman,enhancement,6,4,2
Toeto,darrowmere,383,shaman,enhancement,6,4,2
Cakinha,stormrage,383,shaman,enhancement,6,4,2
Ghogann,bleeding-hollow,383,shaman,enhancement,6,4,2
Kurzee,kelthuzad,383,shaman,enhancement,12,4,8
Smolder,magtheridon,383,shaman,enhancement,12,4,8
Drokán,ragnaros,383,shaman,enhancement,20,5,15
Ikora,crushridge,381,shaman,enhancement,12,4,8
Notahealz,zuljin,367,shaman,enhancement,11,4,7
Jonfckingear,zuljin,351,shaman,enhancement,8,5,3
Pyanir,thrall,351,shaman,enhancement,11,4,7
Engorgdshock,tichondrius,351,shaman,enhancement,14,5,9
Admetis,vashj,351,shaman,enhancement,17,4,13
Airiem,tichondrius,336,shaman,enhancement,9,5,4
Thorsén,ursin,335,shaman,enhancement,17,4,13
Jeaunoo,darkspear,330,shaman,enhancement,14,5,9
Ýup,tichondrius,320,shaman,enhancement,10,4,6
Lardaz,darkspear,319,shaman,enhancement,5,4,1
Xulangshammy,illidan,319,shaman,enhancement,11,4,7
Habrith,proudmoore,319,shaman,enhancement,11,4,7
Tempestsmash,tichondrius,304,shaman,enhancement,7,4,3
Bimbly,eitrigg,303,shaman,enhancement,13,4,9
Toyletpaper,mugthol,288,shaman,enhancement,6,3,3
Trickytotems,stormrage,288,shaman,enhancement,6,3,3
Shear,bleeding-hollow,288,shaman,enhancement,6,3,3
Ulala,azshara,288,shaman,enhancement,6,3,3
Zeroshears,tichondrius,288,shaman,enhancement,6,3,3
Tideqt,tichondrius,288,shaman,enhancement,6,3,3
Beefdrapesz,tichondrius,288,shaman,enhancement,6,3,3
Sabtifa,proudmoore,288,shaman,enhancement,6,3,3
Drgreek,barthilas,288,shaman,enhancement,6,3,3
Ethikas,tichondrius,288,shaman,enhancement,6,3,3
Freshoranges,blood-furnace,288,shaman,enhancement,6,3,3
Thunnor,tichondrius,288,shaman,enhancement,6,3,3
Zoma,elune,288,shaman,enhancement,6,3,3
Puffjin,zuljin,288,shaman,enhancement,6,3,3
Ëvëlyn,chogall,288,shaman,enhancement,6,3,3
Vøødøøboy,hyjal,288,shaman,enhancement,6,3,3
Glexhex,tichondrius,288,shaman,enhancement,6,3,3
Plebshammy,bleeding-hollow,288,shaman,enhancement,6,3,3
Sanachan,blood-furnace,288,shaman,enhancement,6,3,3
Lennylemons,stormrage,288,shaman,enhancement,6,3,3
Kubisham,warsong,288,shaman,enhancement,6,3,3
Hottesthands,barthilas,288,shaman,enhancement,6,3,3
Dogcompany,tichondrius,288,shaman,enhancement,6,3,3
Jumanji,zuljin,288,shaman,enhancement,6,3,3
Mzzar,tichondrius,288,shaman,enhancement,6,3,3
Harshest,stormrage,288,shaman,enhancement,6,3,3
Shambergler,tichondrius,288,shaman,enhancement,6,3,3
Subbyxd,tichondrius,288,shaman,enhancement,6,3,3
Gojiras,barthilas,288,shaman,enhancement,6,3,3
Totemtantrum,tichondrius,288,shaman,enhancement,6,3,3
Jibbajabber,laughing-skull,288,shaman,enhancement,6,3,3
Haititnahtou,kaelthas,288,shaman,enhancement,6,3,3
Antahanu,ragnaros,288,shaman,enhancement,6,3,3
Emtflakes,darkspear,288,shaman,enhancement,6,3,3
Wreçkitralph,sargeras,288,shaman,enhancement,6,3,3
Nirmek,amanthul,288,shaman,enhancement,6,3,3
Ezpzprime,bloodscalp,288,shaman,enhancement,6,3,3
Bovinefony,blackrock,288,shaman,enhancement,6,3,3
Nkrumah,sargeras,288,shaman,enhancement,6,3,3
Charleschwab,proudmoore,288,shaman,enhancement,6,3,3
Popsoot,area-52,288,shaman,enhancement,6,3,3
Getwetand,quelthalas,288,shaman,enhancement,6,3,3
Redpocket,zuluhed,288,shaman,enhancement,6,3,3
Helapoon,area-52,288,shaman,enhancement,6,3,3
Slowkeeper,azralon,288,shaman,enhancement,6,3,3
Grimmick,area-52,288,shaman,enhancement,6,3,3
Ban,blackrock,288,shaman,enhancement,6,3,3
Mhuns,malganis,288,shaman,enhancement,6,3,3
Shammateur,malganis,288,shaman,enhancement,6,3,3
Xantíd,wyrmrest-accord,288,shaman,enhancement,6,3,3
Owiez,sargeras,288,shaman,enhancement,6,3,3
Shamaro,malganis,288,shaman,enhancement,6,3,3
Cars,jaedenar,288,shaman,enhancement,6,3,3
Thiccwater,frostmourne,288,shaman,enhancement,6,3,3
Gumballin,sargeras,288,shaman,enhancement,6,3,3
Gimpanzee,kiljaeden,288,shaman,enhancement,6,3,3
Aruçar,drakkari,288,shaman,enhancement,6,3,3
Swifteyy,area-52,288,shaman,enhancement,6,3,3
Playdohz,frostmourne,288,shaman,enhancement,6,3,3
Mundi,madoran,288,shaman,enhancement,6,3,3
Gorszu,proudmoore,288,shaman,enhancement,6,3,3
Vivean,kelthuzad,288,shaman,enhancement,6,3,3
Sleekshammy,frostmourne,288,shaman,enhancement,6,3,3
Failsy,darkspear,288,shaman,enhancement,6,3,3
Luxenor,kelthuzad,288,shaman,enhancement,6,3,3
Zapmavz,area-52,288,shaman,enhancement,6,3,3
Dwarfmaro,sargeras,288,shaman,enhancement,6,3,3
Puddlecakes,lightbringer,288,shaman,enhancement,6,3,3
Sleepysham,kelthuzad,288,shaman,enhancement,6,3,3
Gulgortz,ragnaros,288,shaman,enhancement,6,3,3
Robot,illidan,288,shaman,enhancement,6,3,3
Bottlez,sargeras,288,shaman,enhancement,6,3,3
Humper,korgath,288,shaman,enhancement,6,3,3
Xzxz,sargeras,288,shaman,enhancement,6,3,3
Wildernez,whisperwind,288,shaman,enhancement,6,3,3
Tempestarii,ragnaros,288,shaman,enhancement,6,3,3
Littleshammy,aggramar,288,shaman,enhancement,6,3,3
Fadeshy,illidan,288,shaman,enhancement,6,3,3
Bon,ravencrest,288,shaman,enhancement,6,3,3
Jaftter,quelthalas,288,shaman,enhancement,9,4,5
Putinsdad,tichondrius,288,shaman,enhancement,10,4,6
Gudac,tichondrius,288,shaman,enhancement,12,3,9
Drekkhal,area-52,288,shaman,enhancement,12,3,9
Mambaz,tichondrius,288,shaman,enhancement,12,3,9
Fishmoley,zuljin,288,shaman,enhancement,12,3,9
Drgiggleheim,tichondrius,288,shaman,enhancement,12,3,9
Smeagðl,tichondrius,288,shaman,enhancement,12,3,9
Bobbymooshay,area-52,288,shaman,enhancement,12,3,9
Actios,stormrage,288,shaman,enhancement,12,3,9
Samo,the-underbog,288,shaman,enhancement,12,3,9
Immunize,tichondrius,288,shaman,enhancement,12,3,9
Thunderblood,nerzhul,288,shaman,enhancement,12,3,9
Shockfreak,stormrage,288,shaman,enhancement,12,3,9
Jireñ,area-52,288,shaman,enhancement,12,3,9
Jajxshammy,rivendare,288,shaman,enhancement,12,3,9
Yaazz,frostmourne,288,shaman,enhancement,12,3,9
Jhivone,tichondrius,288,shaman,enhancement,12,3,9
Azão,stormrage,288,shaman,enhancement,12,3,9
Malsturm,stormrage,288,shaman,enhancement,12,3,9
Hammaam,illidan,288,shaman,enhancement,12,3,9
Unhapintadaa,azralon,288,shaman,enhancement,12,3,9
Xrag,sargeras,288,shaman,enhancement,12,3,9
Faelzão,nemesis,288,shaman,enhancement,12,3,9
Silverwolf,eredar,288,shaman,enhancement,12,3,9
Shocksnbonds,zuljin,288,shaman,enhancement,12,3,9
Khazy,skullcrusher,288,shaman,enhancement,12,3,9
Melåån,jubeithos,288,shaman,enhancement,12,3,9
Aerôv,area-52,288,shaman,enhancement,18,3,15
Xaryu,shuhalo,287,shaman,enhancement,12,3,9
Dnttazemebro,area-52,286,shaman,enhancement,6,3,3
Nargen,tichondrius,271,shaman,enhancement,11,3,8
Lagamental,frostmourne,240,shaman,enhancement,9,3,6
ßodycount,area-52,240,shaman,enhancement,9,3,6
Elementalqti,frostmourne,239,shaman,enhancement,5,3,2
Deeznuts,the-forgotten-coast,239,shaman,enhancement,5,3,2
Caobuloso,azralon,239,shaman,enhancement,5,3,2
Sølbi,tichondrius,239,shaman,enhancement,5,3,2
Kryms,chogall,234,shaman,enhancement,17,6,11
Smooths,bloodscalp,234,shaman,enhancement,19,5,14
Forge,maelstrom,223,shaman,enhancement,8,3,5
Kayadee,stormrage,192,shaman,enhancement,9,3,6
Shamnick,malganis,192,shaman,enhancement,6,2,4
Jamsham,tichondrius,192,shaman,enhancement,6,2,4
Detair,malganis,192,shaman,enhancement,6,2,4
Thünderstrük,tichondrius,192,shaman,enhancement,6,2,4
Ôprawindfury,mugthol,192,shaman,enhancement,6,2,4
Pissticles,bleeding-hollow,192,shaman,enhancement,6,2,4
Víì,tichondrius,192,shaman,enhancement,6,2,4
Afri,tichondrius,192,shaman,enhancement,6,2,4
Picolö,bleeding-hollow,192,shaman,enhancement,6,2,4
Vywolf,frostmourne,192,shaman,enhancement,6,2,4
Texaspumper,sargeras,192,shaman,enhancement,6,2,4
Daiablo,barthilas,192,shaman,enhancement,6,2,4
Sparklebunny,dark-iron,192,shaman,enhancement,6,2,4
Elecpod,frostmourne,192,shaman,enhancement,6,2,4
Jbahr,hyjal,192,shaman,enhancement,6,2,4
Galarix,nerzhul,192,shaman,enhancement,6,2,4
Ageegee,sargeras,192,shaman,enhancement,6,2,4
Freesolo,barthilas,192,shaman,enhancement,6,2,4
Scarshamxn,frostmourne,192,shaman,enhancement,6,2,4
Moisttaco,azshara,192,shaman,enhancement,6,2,4
Xantorn,illidan,192,shaman,enhancement,6,2,4
Furywolf,bleeding-hollow,192,shaman,enhancement,6,2,4
Bearmanshrek,tichondrius,192,shaman,enhancement,6,2,4
Buttermelk,bleeding-hollow,192,shaman,enhancement,6,2,4
Maxchiquito,ragnaros,192,shaman,enhancement,6,2,4
Khuufu,fizzcrank,192,shaman,enhancement,6,2,4
Kumer,tichondrius,192,shaman,enhancement,6,2,4
Stallos,zuljin,192,shaman,enhancement,6,2,4
Dadajuju,azralon,192,shaman,enhancement,6,2,4
Twistër,illidan,192,shaman,enhancement,6,2,4
Jammylol,frostmourne,192,shaman,enhancement,6,2,4
Meatyball,tichondrius,192,shaman,enhancement,6,2,4
Shamflu,tichondrius,192,shaman,enhancement,6,2,4
Friedshammy,frostmourne,192,shaman,enhancement,6,2,4
Milkmeforhp,frostmourne,192,shaman,enhancement,6,2,4
Mishalla,tichondrius,192,shaman,enhancement,6,2,4
Totemzie,illidan,192,shaman,enhancement,6,2,4
Huiracøcha,quelthalas,192,shaman,enhancement,6,2,4
Kermut,frostmourne,192,shaman,enhancement,6,2,4
Raidjin,tichondrius,192,shaman,enhancement,6,2,4
Szael,durotan,192,shaman,enhancement,6,2,4
Jahahahamon,arthas,192,shaman,enhancement,6,2,4
Boj,magtheridon,192,shaman,enhancement,6,2,4
Eraali,stormrage,192,shaman,enhancement,6,2,4
Saltt,proudmoore,192,shaman,enhancement,6,2,4
Ârcanjo,azralon,192,shaman,enhancement,6,2,4
Skyshamy,azralon,192,shaman,enhancement,6,2,4
Slugstout,moon-guard,192,shaman,enhancement,6,2,4
Hothandxo,illidan,192,shaman,enhancement,6,2,4
Contraponto,azralon,192,shaman,enhancement,6,2,4
Skyten,quelthalas,192,shaman,enhancement,6,2,4
Thrallzballz,firetree,192,shaman,enhancement,6,2,4
Loused,wyrmrest-accord,192,shaman,enhancement,6,2,4
Quequin,quelthalas,192,shaman,enhancement,6,2,4
Pozcaster,tichondrius,192,shaman,enhancement,6,2,4
Shamutari,sargeras,192,shaman,enhancement,6,2,4
Fatluma,zuljin,192,shaman,enhancement,6,2,4
Netflixnfeet,moonrunner,192,shaman,enhancement,6,2,4
Amzurs,area-52,192,shaman,enhancement,6,2,4
Ectomee,tichondrius,192,shaman,enhancement,6,2,4
Blooddtears,stormrage,192,shaman,enhancement,6,2,4
Durogh,darkspear,192,shaman,enhancement,6,2,4
Jungsa,tichondrius,192,shaman,enhancement,6,2,4
Brofessor,frostwolf,192,shaman,enhancement,6,2,4
Shockazulu,vashj,192,shaman,enhancement,6,2,4
Soapmactavis,sargeras,192,shaman,enhancement,6,2,4
Pandancement,thrall,192,shaman,enhancement,6,2,4
Spoke,emerald-dream,192,shaman,enhancement,6,2,4
Bullcowsby,darkspear,192,shaman,enhancement,6,2,4
Swigadee,tichondrius,192,shaman,enhancement,6,2,4
Virô,sargeras,192,shaman,enhancement,6,2,4
Bootsix,area-52,192,shaman,enhancement,6,2,4
Stormfronts,kelthuzad,192,shaman,enhancement,6,2,4
Ceedlamb,kelthuzad,192,shaman,enhancement,6,2,4
Pericazo,sargeras,192,shaman,enhancement,6,2,4
Bitxxnumber,tichondrius,192,shaman,enhancement,6,2,4
Shamanakin,emerald-dream,192,shaman,enhancement,6,2,4
Totemrecalld,zuljin,192,shaman,enhancement,6,2,4
Hèllzpyro,sargeras,192,shaman,enhancement,6,2,4
Jashiik,tichondrius,192,shaman,enhancement,6,2,4
Insanelol,tichondrius,192,shaman,enhancement,6,2,4
Møostrom,thrall,192,shaman,enhancement,6,2,4
Thejoshuwua,icecrown,192,shaman,enhancement,6,2,4
Uwitduhfeds,moon-guard,192,shaman,enhancement,6,2,4
Zeldrys,emerald-dream,192,shaman,enhancement,6,2,4
Zenitsue,sargeras,192,shaman,enhancement,6,2,4
Whameradetu,suramar,192,shaman,enhancement,6,2,4
Badjujubruh,thrall,192,shaman,enhancement,6,2,4
Valcannos,area-52,192,shaman,enhancement,6,2,4
Rayjamalblk,tichondrius,192,shaman,enhancement,6,2,4
ßeesy,emerald-dream,192,shaman,enhancement,6,2,4
Brewstoned,kargath,192,shaman,enhancement,6,2,4
Jasonnworb,tichondrius,192,shaman,enhancement,6,2,4
Olboy,thrall,192,shaman,enhancement,6,2,4
Crankzilla,area-52,192,shaman,enhancement,6,2,4
Dibbydogtote,tichondrius,192,shaman,enhancement,6,2,4
Wìzz,zuljin,192,shaman,enhancement,6,2,4
Synyshok,tichondrius,192,shaman,enhancement,6,2,4
Kass,area-52,192,shaman,enhancement,6,2,4
Käshqt,tichondrius,192,shaman,enhancement,6,2,4
Stèpbro,sargeras,192,shaman,enhancement,6,2,4
Rinjio,zuljin,192,shaman,enhancement,6,2,4
Vitaminc,garona,192,shaman,enhancement,6,2,4
Jwondo,area-52,192,shaman,enhancement,6,2,4
Girthquake,agamaggan,192,shaman,enhancement,6,2,4
Nawoma,quelthalas,192,shaman,enhancement,8,2,6
Feär,ysera,192,shaman,enhancement,9,2,7
Feels,arthas,192,shaman,enhancement,16,3,13
Manemon,quelthalas,192,shaman,enhancement,12,2,10
Gunai,malganis,192,shaman,enhancement,12,2,10
Legendmatic,illidan,192,shaman,enhancement,12,2,10
Zuljiba,illidan,192,shaman,enhancement,12,2,10
Gusgusgus,laughing-skull,192,shaman,enhancement,12,2,10
Îlikêdinos,aggramar,192,shaman,enhancement,12,2,10
Rhazer,cenarion-circle,192,shaman,enhancement,12,2,10
Vashidda,stormrage,192,shaman,enhancement,12,2,10
Stylebend,area-52,192,shaman,enhancement,12,2,10
Chontu,area-52,192,shaman,enhancement,12,2,10
Tictactotum,hyjal,192,shaman,enhancement,12,2,10
Ophine,illidan,191,shaman,enhancement,6,2,4
Dahmerjr,area-52,191,shaman,enhancement,6,2,4
Calmconflict,daggerspine,191,shaman,enhancement,6,2,4
Baktolumby,tichondrius,175,shaman,enhancement,11,2,9
Dønßlack,thunderhorn,159,shaman,enhancement,5,2,3
Healingtime,nerzhul,159,shaman,enhancement,5,2,3
Skuffedx,spirestone,159,shaman,enhancement,5,2,3
Nuggitz,tichondrius,159,shaman,enhancement,5,2,3
Shamto,zuljin,144,shaman,enhancement,3,3,0
Khaylaa,tichondrius,138,shaman,enhancement,11,6,5
Bogz,korgath,128,shaman,enhancement,4,2,2
Badgeshock,area-52,128,shaman,enhancement,4,2,2
Flashyjoe,tichondrius,128,shaman,enhancement,4,2,2
Ludacrìtz,stormrage,112,shaman,enhancement,7,2,5
Tsuchekk,tichondrius,111,shaman,enhancement,5,3,2
Hephæstus,maiev,96,shaman,enhancement,3,2,1
Shamcakes,kilrogg,96,shaman,enhancement,17,3,14
Adosistoxic,zuljin,96,shaman,enhancement,6,1,5
Meatballbag,thrall,96,shaman,enhancement,6,1,5
Zapsquidzap,illidan,96,shaman,enhancement,6,1,5
Shockd,icecrown,96,shaman,enhancement,6,1,5
Nommymilkers,stormrage,96,shaman,enhancement,6,1,5
Trynr,ragnaros,96,shaman,enhancement,6,1,5
Youliuhua,tichondrius,96,shaman,enhancement,6,1,5
Saesenthesis,barthilas,96,shaman,enhancement,6,1,5
Alferian,moon-guard,96,shaman,enhancement,6,1,5
Aiggiggigne,sargeras,96,shaman,enhancement,6,1,5
Sureofname,frostmourne,96,shaman,enhancement,6,1,5
Firefíst,area-52,96,shaman,enhancement,6,1,5
Beazel,moon-guard,96,shaman,enhancement,6,1,5
Bunnyele,tichondrius,96,shaman,enhancement,6,1,5
Paramecium,sargeras,96,shaman,enhancement,6,1,5
Trøuble,deathwing,96,shaman,enhancement,6,1,5
Karmar,proudmoore,96,shaman,enhancement,6,1,5
Kàrlx,tichondrius,96,shaman,enhancement,6,1,5
Killuminatti,nathrezim,96,shaman,enhancement,6,1,5
Sweettooth,area-52,96,shaman,enhancement,6,1,5
Ohtoro,zuljin,96,shaman,enhancement,6,1,5
Tritun,proudmoore,96,shaman,enhancement,6,1,5
Pileef,thrall,96,shaman,enhancement,6,1,5
Sandmanatee,crushridge,96,shaman,enhancement,6,1,5
Neveroom,cenarius,96,shaman,enhancement,6,1,5
Chopmynuts,illidan,96,shaman,enhancement,6,1,5
Frostyshock,hellscream,96,shaman,enhancement,6,1,5
Udÿr,drakkari,96,shaman,enhancement,6,1,5
Juvîa,emerald-dream,96,shaman,enhancement,6,1,5
Totemtîme,frostmourne,96,shaman,enhancement,6,1,5
Zugnuz,sargeras,96,shaman,enhancement,6,1,5
Zuitianshi,tichondrius,96,shaman,enhancement,6,1,5
Kranif,tichondrius,96,shaman,enhancement,6,1,5
Beefsham,eitrigg,96,shaman,enhancement,6,1,5
Spaceghost,illidan,96,shaman,enhancement,6,1,5
Toyotatron,tichondrius,96,shaman,enhancement,6,1,5
Axshaman,darkspear,96,shaman,enhancement,6,1,5
Baelgoth,moon-guard,96,shaman,enhancement,6,1,5
Geladoo,gallywix,96,shaman,enhancement,6,1,5
Mugiwärä,area-52,96,shaman,enhancement,6,1,5
Aezst,illidan,96,shaman,enhancement,6,1,5
Zoeyzour,illidan,96,shaman,enhancement,6,1,5
Shamamas,area-52,96,shaman,enhancement,6,1,5
Ulfgarn,stormrage,96,shaman,enhancement,6,1,5
Feuerbart,dalaran,96,shaman,enhancement,6,1,5
Javinoo,tichondrius,96,shaman,enhancement,6,1,5
Uttertrash,illidan,96,shaman,enhancement,6,1,5
Hangellyca,azralon,96,shaman,enhancement,6,1,5
Boogey,khazgoroth,96,shaman,enhancement,6,1,5
Littz,malganis,96,shaman,enhancement,6,1,5
Trouvaille,tichondrius,96,shaman,enhancement,6,1,5
Fourever,ragnaros,96,shaman,enhancement,6,1,5
Volaarn,area-52,96,shaman,enhancement,6,1,5
Shamofshame,garrosh,96,shaman,enhancement,6,1,5
Blackjackxx,frostmourne,96,shaman,enhancement,6,1,5
Tetonka,tichondrius,96,shaman,enhancement,6,1,5
Wangbangjr,mugthol,96,shaman,enhancement,6,1,5
Kinjin,dragonmaw,96,shaman,enhancement,6,1,5
Yungmeaty,tichondrius,96,shaman,enhancement,7,1,6
Threehandz,bleeding-hollow,96,shaman,enhancement,8,1,7
Immutef,tichondrius,96,shaman,enhancement,12,1,11
Chäningtotem,kiljaeden,96,shaman,enhancement,12,1,11
Thallor,stormrage,96,shaman,enhancement,12,1,11
Smokeymcpots,khazgoroth,95,shaman,enhancement,6,1,5
Dilldoughnut,sargeras,79,shaman,enhancement,5,1,4
Oakshield,darkspear,64,shaman,enhancement,4,1,3
Stórmfuryz,tichondrius,64,shaman,enhancement,4,1,3
Njórd,sargeras,63,shaman,enhancement,2,2,0
Bluberi,nazjatar,48,shaman,enhancement,3,1,2
Ekatonkiro,ragnaros,48,shaman,enhancement,3,1,2
Grauldron,illidan,48,shaman,enhancement,3,1,2
Rondru,zuljin,48,shaman,enhancement,3,1,2
Pocoloco,blades-edge,48,shaman,enhancement,3,1,2
Splewtsham,thrall,48,shaman,enhancement,3,1,2
Totemlord,lightnings-blade,31,shaman,enhancement,2,1,1
Stumpyjoe,terokkar,16,shaman,enhancement,7,1,6
Cidkagenou,sargeras,2353,warlock,demonology,63,47,16
Bronzerl,tichondrius,2347,warlock,demonology,69,47,22
Wildimp,aerie-peak,2323,warlock,demonology,108,66,42
Wildimpx,sargeras,2322,warlock,demonology,208,113,95
Btsfangirl,moon-guard,2267,warlock,demonology,110,63,47
Xygg,tichondrius,2256,warlock,demonology,78,48,30
Iordozzy,malganis,2245,warlock,demonology,84,56,28
Bahamas,bleeding-hollow,2236,warlock,demonology,84,50,34
Miredö,tichondrius,2223,warlock,demonology,84,48,36
Wzxx,tichondrius,2222,warlock,demonology,84,46,38
Lilballz,tichondrius,2221,warlock,demonology,65,39,26
Ediya,tichondrius,2203,warlock,demonology,178,94,84
Babyaga,illidan,2201,warlock,demonology,84,47,37
Beyourselff,tichondrius,2195,warlock,demonology,151,80,71
Hrrpeuh,zuljin,2191,warlock,demonology,66,40,26
Mixtape,stormrage,2178,warlock,demonology,77,47,30
Mlx,proudmoore,2176,warlock,demonology,149,81,68
Bigfatballz,tichondrius,2171,warlock,demonology,76,48,28
Jojofann,nemesis,2165,warlock,demonology,53,37,16
Newmanz,nerzhul,2155,warlock,demonology,71,41,30
Evildeath,tichondrius,2154,warlock,demonology,78,44,34
Gentleq,tichondrius,2149,warlock,demonology,99,53,46
Gianni,chogall,2149,warlock,demonology,107,57,50
Abrocket,alleria,2143,warlock,demonology,72,45,27
Erock,korgath,2138,warlock,demonology,60,47,13
Shinyballz,tichondrius,2133,warlock,demonology,71,41,30
Wesyane,anetheron,2130,warlock,demonology,148,78,70
Xadge,tichondrius,2128,warlock,demonology,79,43,36
Fishorz,tichondrius,2128,warlock,demonology,89,47,42
Harambê,sargeras,2127,warlock,demonology,36,27,9
Lemmefear,illidan,2127,warlock,demonology,47,32,15
Chanigay,tichondrius,2127,warlock,demonology,65,39,26
Kaossqt,azralon,2121,warlock,demonology,120,64,56
Bigdaddylol,ragnaros,2120,warlock,demonology,83,45,38
Ziffy,emerald-dream,2118,warlock,demonology,78,41,37
Maadhum,illidan,2116,warlock,demonology,92,50,42
Zuelu,tichondrius,2116,warlock,demonology,163,88,75
Fatass,cairne,2114,warlock,demonology,66,38,28
Awdam,tichondrius,2114,warlock,demonology,96,50,46
Ensebado,azralon,2111,warlock,demonology,140,78,62
Falco,azshara,2110,warlock,demonology,66,38,28
Synkz,blood-furnace,2110,warlock,demonology,72,38,34
Cosmosxx,illidan,2110,warlock,demonology,112,58,54
Ogchaos,tichondrius,2107,warlock,demonology,78,45,33
Erlandesher,tichondrius,2107,warlock,demonology,149,75,74
Tessarath,area-52,2106,warlock,demonology,59,38,21
Boltqt,tichondrius,2103,warlock,demonology,60,36,24
Spicyfingers,illidan,2103,warlock,demonology,78,44,34
Nðm,tichondrius,2100,warlock,demonology,72,44,28
Aoepump,tichondrius,2094,warlock,demonology,78,43,35
Unhòólylck,ragnaros,2082,warlock,demonology,105,56,49
Kymochaos,sargeras,2080,warlock,demonology,53,27,26
Ofc,malganis,2068,warlock,demonology,60,35,25
Patoquenn,azralon,2061,warlock,demonology,66,37,29
Toiletghost,tichondrius,2060,warlock,demonology,86,54,32
Persistencss,tichondrius,2047,warlock,demonology,48,29,19
Oymmander,illidan,2046,warlock,demonology,56,37,19
Coèrce,tichondrius,2040,warlock,demonology,53,35,18
Broccoleh,area-52,2033,warlock,demonology,59,36,23
Etuskaa,tichondrius,2032,warlock,demonology,167,83,84
Eazyw,stormrage,2024,warlock,demonology,95,47,48
Iselltacos,dalaran,2015,warlock,demonology,43,29,14
Debao,malganis,2014,warlock,demonology,107,51,56
Cosmosxi,illidan,2008,warlock,demonology,91,50,41
Sslock,sargeras,2008,warlock,demonology,71,37,34
Nocrackrocks,stormrage,2007,warlock,demonology,117,66,51
Atheô,ragnaros,2004,warlock,demonology,106,57,49
Vexxes,malganis,2002,warlock,demonology,246,126,120
Ztlivid,area-52,2000,warlock,demonology,175,91,84
Awangdemon,tichondrius,1997,warlock,demonology,54,27,27
Dotman,tichondrius,1991,warlock,demonology,70,39,31
Teivlol,mugthol,1980,warlock,demonology,96,51,45
Extreme,blackwing-lair,1978,warlock,demonology,78,53,25
Spreadlove,emerald-dream,1978,warlock,demonology,234,129,105
Bwonsamdijin,tichondrius,1970,warlock,demonology,142,70,72
Procalypse,stormrage,1966,warlock,demonology,54,32,22
Canobio,tichondrius,1957,warlock,demonology,65,43,22
Megamindx,tichondrius,1957,warlock,demonology,48,31,17
Voidbb,tichondrius,1957,warlock,demonology,53,30,23
Snuufels,area-52,1950,warlock,demonology,60,37,23
Ihaveapowers,maiev,1944,warlock,demonology,120,60,60
Naughtybolts,sargeras,1941,warlock,demonology,80,46,34
Rôsé,tichondrius,1941,warlock,demonology,130,73,57
Baka,moon-guard,1938,warlock,demonology,60,32,28
Precogfear,tichondrius,1936,warlock,demonology,78,39,39
Littlerod,tichondrius,1934,warlock,demonology,90,48,42
Stopdot,lightnings-blade,1934,warlock,demonology,76,38,38
Paygo,tichondrius,1930,warlock,demonology,57,32,25
Arckádia,stormrage,1923,warlock,demonology,66,31,35
Shadowmoonon,tichondrius,1921,warlock,demonology,43,21,22
Bronzel,tichondrius,1920,warlock,demonology,48,30,18
Ketahole,warsong,1918,warlock,demonology,117,58,59
Bleachkk,tichondrius,1915,warlock,demonology,95,56,39
Invalid,frostmourne,1914,warlock,demonology,36,25,11
Ceeloftw,tichondrius,1914,warlock,demonology,113,60,53
Ökïlôck,proudmoore,1912,warlock,demonology,48,27,21
Iruffcarla,cairne,1909,warlock,demonology,54,32,22
Lilgigs,stormrage,1909,warlock,demonology,60,30,30
Zjxy,tichondrius,1908,warlock,demonology,30,20,10
Inmøtion,tichondrius,1906,warlock,demonology,60,33,27
Scalpelexis,stormrage,1905,warlock,demonology,36,23,13
Sofan,dalaran,1905,warlock,demonology,58,33,25
Dyenamik,stormrage,1904,warlock,demonology,30,24,6
Lockedinn,mannoroth,1904,warlock,demonology,91,54,37
Huajianmanwu,tichondrius,1904,warlock,demonology,286,148,138
Daerde,malganis,1900,warlock,demonology,47,27,20
Siphoned,darkspear,1900,warlock,demonology,53,27,26
Deadlpoo,stormscale,1899,warlock,demonology,81,41,40
Xiyangpvp,tichondrius,1898,warlock,demonology,54,31,23
Elbrujon,sargeras,1897,warlock,demonology,142,69,73
Lemmepvponu,illidan,1896,warlock,demonology,48,30,18
Alisa,moon-guard,1896,warlock,demonology,60,28,32
Lowrcase,zuljin,1895,warlock,demonology,48,28,20
Lrry,dalaran,1893,warlock,demonology,144,84,60
Gamecover,azralon,1889,warlock,demonology,122,72,50
Rakshama,chogall,1885,warlock,demonology,42,25,17
Percadu,barthilas,1885,warlock,demonology,97,50,47
Mongobros,illidan,1881,warlock,demonology,54,33,21
Maral,kelthuzad,1878,warlock,demonology,63,35,28
Petattack,nerzhul,1878,warlock,demonology,125,60,65
Kimchiblast,tichondrius,1876,warlock,demonology,48,28,20
Avery,mannoroth,1876,warlock,demonology,42,22,20
Lambe,tichondrius,1874,warlock,demonology,53,31,22
Demondisco,tichondrius,1873,warlock,demonology,95,45,50
Zydiva,sargeras,1872,warlock,demonology,118,62,56
Dätura,tichondrius,1871,warlock,demonology,68,43,25
Sàill,tichondrius,1871,warlock,demonology,35,22,13
Lockiator,moon-guard,1870,warlock,demonology,71,35,36
Dowal,whisperwind,1866,warlock,demonology,60,31,29
Scatach,area-52,1864,warlock,demonology,60,32,28
Klol,proudmoore,1861,warlock,demonology,54,26,28
Thranlock,area-52,1860,warlock,demonology,156,77,79
ßøßßÿßøûçhêr,tichondrius,1859,warlock,demonology,48,32,16
Ministàff,ursin,1857,warlock,demonology,60,32,28
Voidxx,tichondrius,1856,warlock,demonology,30,21,9
Mhael,lightninghoof,1856,warlock,demonology,54,32,22
Playßøy,area-52,1856,warlock,demonology,42,24,18
Playtoy,moon-guard,1856,warlock,demonology,154,78,76
Amazingamez,sargeras,1855,warlock,demonology,149,69,80
Atheø,ragnaros,1854,warlock,demonology,42,23,19
Aramith,tichondrius,1854,warlock,demonology,118,60,58
Demyo,tichondrius,1849,warlock,demonology,38,21,17
Díablo,bleeding-hollow,1848,warlock,demonology,53,36,17
Redfish,tichondrius,1847,warlock,demonology,34,20,14
Buymymixtåpe,ursin,1846,warlock,demonology,57,34,23
Xitokaiba,tichondrius,1844,warlock,demonology,67,46,21
Phóbòs,tichondrius,1843,warlock,demonology,54,40,14
Feldren,wyrmrest-accord,1843,warlock,demonology,85,50,35
Metic,firetree,1842,warlock,demonology,48,33,15
Kerrigan,the-venture-co,1842,warlock,demonology,66,38,28
Larixpotanin,tichondrius,1842,warlock,demonology,102,58,44
Darkzell,azralon,1841,warlock,demonology,48,30,18
Dlhmlock,tichondrius,1840,warlock,demonology,41,25,16
Juleno,quelthalas,1837,warlock,demonology,57,31,26
Alndron,thrall,1837,warlock,demonology,78,38,40
Ccona,tichondrius,1835,warlock,demonology,42,23,19
Speakeasy,malygos,1835,warlock,demonology,58,29,29
Beatinu,draenor,1834,warlock,demonology,54,32,22
Domenic,sentinels,1833,warlock,demonology,58,32,26
Necronemesis,arthas,1833,warlock,demonology,162,88,74
Bbangtimo,tichondrius,1833,warlock,demonology,77,40,37
Åmön,zuljin,1832,warlock,demonology,66,32,34
Drakatattwo,tichondrius,1831,warlock,demonology,42,23,19
Bic,thrall,1828,warlock,demonology,66,45,21
Xoboroz,moon-guard,1827,warlock,demonology,60,29,31
Cendit,malganis,1825,warlock,demonology,54,34,20
Jerclard,proudmoore,1825,warlock,demonology,90,51,39
Castingfear,barthilas,1825,warlock,demonology,48,27,21
Tazlock,blackrock,1825,warlock,demonology,64,32,32
Greasymario,area-52,1824,warlock,demonology,60,42,18
Malatharr,quelthalas,1824,warlock,demonology,52,34,18
Axelrodx,tichondrius,1824,warlock,demonology,54,35,19
Actualjoke,frostmourne,1824,warlock,demonology,59,31,28
Douzz,frostmourne,1821,warlock,demonology,47,28,19
Idoovoodoo,burning-legion,1820,warlock,demonology,36,23,13
Sharaßha,moon-guard,1820,warlock,demonology,69,41,28
Scarysherri,aggramar,1819,warlock,demonology,54,36,18
Búmchúm,frostmourne,1818,warlock,demonology,60,38,22
Dëvïl,ragnaros,1818,warlock,demonology,92,58,34
Dapete,malorne,1818,warlock,demonology,53,30,23
Lockedlock,nemesis,1818,warlock,demonology,48,27,21
Villaìn,moon-guard,1818,warlock,demonology,117,55,62
Arcinian,kelthuzad,1817,warlock,demonology,66,39,27
Wls,frostmourne,1817,warlock,demonology,89,50,39
Hellbraive,queldorei,1817,warlock,demonology,54,30,24
Overlard,illidan,1816,warlock,demonology,42,24,18
Gigabiga,area-52,1815,warlock,demonology,36,23,13
Flocka,agamaggan,1814,warlock,demonology,54,41,13
Tít,malganis,1814,warlock,demonology,41,31,10
Wearelegionx,frostmourne,1814,warlock,demonology,84,49,35
Tinkerfell,sargeras,1814,warlock,demonology,72,36,36
Fearmebro,bleeding-hollow,1813,warlock,demonology,114,75,39
Richards,thrall,1812,warlock,demonology,42,32,10
Ltr,moon-guard,1811,warlock,demonology,30,22,8
Kronii,jubeithos,1811,warlock,demonology,35,25,10
Voidxo,tichondrius,1811,warlock,demonology,36,22,14
Krumlax,thrall,1810,warlock,demonology,60,42,18
Deboltzaru,ragnaros,1810,warlock,demonology,36,20,16
Errogant,area-52,1810,warlock,demonology,60,30,30
Nüts,blackrock,1810,warlock,demonology,50,23,27
Beckypls,zuljin,1809,warlock,demonology,36,27,9
Mcjoy,akama,1809,warlock,demonology,145,91,54
Dounutlock,area-52,1809,warlock,demonology,54,33,21
Saevitar,area-52,1809,warlock,demonology,45,24,21
Gengar,dalaran,1809,warlock,demonology,186,97,89
Zzooxxqt,area-52,1809,warlock,demonology,48,25,23
Hadoukën,hyjal,1809,warlock,demonology,108,56,52
Chilipeppa,wyrmrest-accord,1808,warlock,demonology,60,34,26
Mälwaré,tichondrius,1808,warlock,demonology,58,29,29
Qwêrty,ursin,1807,warlock,demonology,47,32,15
Chaosthekid,malganis,1807,warlock,demonology,40,25,15
Reneqtxo,jubeithos,1806,warlock,demonology,30,19,11
Evelyne,tichondrius,1805,warlock,demonology,30,19,11
Xacayth,ragnaros,1804,warlock,demonology,80,47,33
Cappadonna,azralon,1804,warlock,demonology,118,69,49
Rakudemon,ragnaros,1804,warlock,demonology,147,77,70
Darkborkain,tichondrius,1803,warlock,demonology,30,19,11
Mbhlol,illidan,1803,warlock,demonology,42,23,19
Wachifurro,drakkari,1802,warlock,demonology,53,28,25
Quetzâlcoâtl,sargeras,1801,warlock,demonology,47,28,19
Lockeslock,sargeras,1801,warlock,demonology,118,62,56
Thelockzx,azralon,1801,warlock,demonology,60,28,32
Bonetangler,thrall,1798,warlock,demonology,119,54,65
Salaszar,illidan,1797,warlock,demonology,48,31,17
Raegon,kiljaeden,1797,warlock,demonology,44,25,19
Tarth,sargeras,1797,warlock,demonology,102,51,51
Zehzet,area-52,1796,warlock,demonology,36,26,10
Lcomi,tichondrius,1796,warlock,demonology,54,30,24
Tiná,tichondrius,1796,warlock,demonology,51,27,24
Overclocked,destromath,1795,warlock,demonology,30,21,9
Hugebolt,tichondrius,1793,warlock,demonology,48,28,20
Jaganshi,tichondrius,1791,warlock,demonology,52,29,23
Dreadlock,tichondrius,1789,warlock,demonology,42,24,18
Babydots,stormreaver,1786,warlock,demonology,136,67,69
Keylloggz,sargeras,1780,warlock,demonology,126,65,61
Hitwarlock,tichondrius,1775,warlock,demonology,78,39,39
Amgs,frostmourne,1773,warlock,demonology,54,38,16
Qp,thrall,1771,warlock,demonology,38,28,10
Abomasnow,frostmourne,1768,warlock,demonology,67,32,35
Dogegg,tichondrius,1765,warlock,demonology,84,40,44
Sicksick,tichondrius,1762,warlock,demonology,45,22,23
Döremi,tichondrius,1760,warlock,demonology,35,21,14
Wrathh,stormscale,1753,warlock,demonology,51,24,27
Aidadeshu,tichondrius,1750,warlock,demonology,72,33,39
Zörkô,zuljin,1748,warlock,demonology,114,54,60
ßállin,illidan,1745,warlock,demonology,35,22,13
Graendol,tichondrius,1745,warlock,demonology,36,22,14
Melisândre,kiljaeden,1744,warlock,demonology,53,26,27
Eastwitch,ragnaros,1743,warlock,demonology,120,55,65
Magë,ursin,1743,warlock,demonology,114,50,64
Orgcontroler,hyjal,1742,warlock,demonology,67,29,38
Mcpickls,illidan,1740,warlock,demonology,48,26,22
Michae,tichondrius,1740,warlock,demonology,48,25,23
Arityy,tichondrius,1738,warlock,demonology,33,23,10
Missalice,nesingwary,1738,warlock,demonology,42,23,19
Dreadlõck,malganis,1737,warlock,demonology,78,39,39
Saeph,burning-legion,1731,warlock,demonology,72,41,31
Ðëâthløck,tichondrius,1729,warlock,demonology,47,25,22
Brightmoonhw,tichondrius,1729,warlock,demonology,54,27,27
Skullsoul,arthas,1725,warlock,demonology,88,49,39
Lemmewin,illidan,1724,warlock,demonology,24,18,6
Eriebos,area-52,1724,warlock,demonology,60,35,25
Slantsix,tichondrius,1722,warlock,demonology,36,21,15
Lazymongoose,frostmourne,1721,warlock,demonology,167,91,76
Kogath,thunderlord,1721,warlock,demonology,63,32,31
Devilman,darkspear,1720,warlock,demonology,129,64,65
Muchas,area-52,1717,warlock,demonology,30,18,12
Fadedemon,area-52,1716,warlock,demonology,42,32,10
Doomdm,zuljin,1710,warlock,demonology,30,18,12
Sasaology,frostmourne,1706,warlock,demonology,78,41,37
Milkybøng,area-52,1705,warlock,demonology,99,61,38
Shooterg,tichondrius,1704,warlock,demonology,66,32,34
Dìablo,area-52,1702,warlock,demonology,78,43,35
Nethron,the-venture-co,1700,warlock,demonology,72,35,37
Cinderwhip,moon-guard,1696,warlock,demonology,225,112,113
Ourlegacy,tichondrius,1695,warlock,demonology,40,24,16
Necroabuser,area-52,1692,warlock,demonology,40,24,16
Fksm,tichondrius,1692,warlock,demonology,36,20,16
Stopdottroll,zuljin,1690,warlock,demonology,30,18,12
Hulkyy,illidan,1690,warlock,demonology,95,55,40
Tazerr,sargeras,1690,warlock,demonology,57,26,31
Metrow,area-52,1688,warlock,demonology,30,18,12
Leeka,tichondrius,1687,warlock,demonology,48,23,25
Gørb,wyrmrest-accord,1686,warlock,demonology,48,30,18
Notomorrow,tichondrius,1686,warlock,demonology,146,87,59
Ciprýan,azralon,1684,warlock,demonology,82,37,45
Paparoxy,illidan,1681,warlock,demonology,65,30,35
Almostoogood,illidan,1680,warlock,demonology,36,24,12
Scalpelx,tichondrius,1677,warlock,demonology,29,18,11
Daxxter,tichondrius,1677,warlock,demonology,54,28,26
Døtyou,area-52,1676,warlock,demonology,35,18,17
Juswannarock,tichondrius,1676,warlock,demonology,51,25,26
Dlchem,tichondrius,1674,warlock,demonology,88,47,41
Spicyfingerx,illidan,1673,warlock,demonology,36,22,14
Narmazulnn,area-52,1673,warlock,demonology,53,31,22
Fearedu,thunderhorn,1671,warlock,demonology,149,73,76
Zver,drakkari,1669,warlock,demonology,108,57,51
Gløcked,area-52,1666,warlock,demonology,48,26,22
Altairo,illidan,1666,warlock,demonology,82,42,40
Gromy,lightnings-blade,1664,warlock,demonology,113,71,42
Aroug,aggramar,1664,warlock,demonology,102,50,52
Lamdyn,moon-guard,1663,warlock,demonology,84,51,33
Doties,bleeding-hollow,1663,warlock,demonology,42,23,19
Møbscene,bleeding-hollow,1662,warlock,demonology,43,22,21
Mcpickl,illidan,1662,warlock,demonology,54,25,29
Houdneeznuts,tichondrius,1659,warlock,demonology,162,86,76
Eatsleepgame,barthilas,1657,warlock,demonology,50,20,30
Edzeá,frostmourne,1656,warlock,demonology,48,24,24
Archibalding,area-52,1654,warlock,demonology,66,38,28
Rathul,bonechewer,1654,warlock,demonology,61,30,31
Yuengling,illidan,1653,warlock,demonology,144,73,71
Vcain,stormrage,1652,warlock,demonology,66,31,35
Gimmeprecog,tichondrius,1651,warlock,demonology,30,21,9
Fears,norgannon,1651,warlock,demonology,48,29,19
Gihaewon,tichondrius,1650,warlock,demonology,30,20,10
Pikme,bleeding-hollow,1650,warlock,demonology,48,22,26
Bosongo,boulderfist,1648,warlock,demonology,52,31,21
Exofilth,thrall,1648,warlock,demonology,92,54,38
Minichompei,frostmourne,1645,warlock,demonology,41,24,17
Funkminot,illidan,1644,warlock,demonology,295,153,142
Phogy,bleeding-hollow,1644,warlock,demonology,71,35,36
Shuffler,tichondrius,1643,warlock,demonology,36,24,12
Ðåntë,thrall,1643,warlock,demonology,36,22,14
Invisibles,barthilas,1642,warlock,demonology,35,20,15
Juxsr,nerzhul,1642,warlock,demonology,42,22,20
Skanckqt,malganis,1638,warlock,demonology,59,31,28
Bigdotenergi,tichondrius,1637,warlock,demonology,36,25,11
Thelocker,stormrage,1637,warlock,demonology,83,48,35
Torghast,bloodhoof,1637,warlock,demonology,42,21,21
Sobadhahaha,azralon,1635,warlock,demonology,36,23,13
Suzüki,tichondrius,1635,warlock,demonology,36,19,17
Theseance,dalaran,1635,warlock,demonology,60,31,29
Geauxst,tichondrius,1633,warlock,demonology,56,29,27
Oluluo,andorhal,1633,warlock,demonology,41,21,20
Ptwo,illidan,1632,warlock,demonology,30,18,12
Venticm,tichondrius,1631,warlock,demonology,24,17,7
Harrydotterr,bonechewer,1629,warlock,demonology,71,36,35
Azrezzael,area-52,1628,warlock,demonology,36,22,14
Discordance,zuljin,1628,warlock,demonology,30,17,13
Badstepbro,sargeras,1627,warlock,demonology,30,17,13
Ggooudan,tichondrius,1625,warlock,demonology,29,21,8
Turbocleave,blackwater-raiders,1624,warlock,demonology,24,17,7
Jokerxks,tichondrius,1624,warlock,demonology,24,17,7
Séptima,illidan,1623,warlock,demonology,24,17,7
Kreâtor,tichondrius,1623,warlock,demonology,83,46,37
Demonicsmoke,darrowmere,1622,warlock,demonology,104,56,48
Omertà,staghelm,1621,warlock,demonology,64,36,28
Bagn,tichondrius,1620,warlock,demonology,42,23,19
Doombaby,zuljin,1619,warlock,demonology,66,40,26
Mcpickles,illidan,1618,warlock,demonology,30,19,11
Säbrine,zuljin,1617,warlock,demonology,79,36,43
Epinetheus,stormrage,1617,warlock,demonology,54,23,31
Soreanus,illidan,1615,warlock,demonology,48,30,18
Dotzor,area-52,1615,warlock,demonology,52,32,20
Zantology,frostmourne,1615,warlock,demonology,54,31,23
Krýptizl,frostmourne,1615,warlock,demonology,81,45,36
Raisa,chogall,1615,warlock,demonology,48,23,25
Perfectíon,tichondrius,1614,warlock,demonology,30,19,11
Xlilgee,kelthuzad,1614,warlock,demonology,30,17,13
Abismoarmdr,ragnaros,1613,warlock,demonology,115,66,49
Sickmade,zuljin,1612,warlock,demonology,126,72,54
Eternalsmile,tichondrius,1612,warlock,demonology,48,27,21
Garcheros,ragnaros,1612,warlock,demonology,51,27,24
Yükina,stormrage,1611,warlock,demonology,54,29,25
Xanetor,illidan,1611,warlock,demonology,58,31,27
Vawns,zuljin,1611,warlock,demonology,47,24,23
Rasildur,ragnaros,1611,warlock,demonology,61,27,34
Celestialock,tichondrius,1609,warlock,demonology,55,38,17
Hers,vashj,1608,warlock,demonology,54,34,20
Hentry,sargeras,1608,warlock,demonology,47,25,22
Gulßad,tichondrius,1607,warlock,demonology,36,24,12
Diabolock,proudmoore,1607,warlock,demonology,48,26,22
Kronicdotz,bleeding-hollow,1606,warlock,demonology,38,20,18
Vews,firetree,1606,warlock,demonology,36,18,18
Mamabolts,kelthuzad,1605,warlock,demonology,29,18,11
Georky,ragnaros,1605,warlock,demonology,60,36,24
Varian,quelthalas,1604,warlock,demonology,93,53,40
Cambolts,tichondrius,1604,warlock,demonology,36,20,16
Ktlock,frostmourne,1603,warlock,demonology,114,65,49
Emperator,quelthalas,1603,warlock,demonology,46,25,21
Sarcophagus,duskwood,1602,warlock,demonology,33,18,15
Innocentius,illidan,1602,warlock,demonology,82,42,40
Middot,area-52,1601,warlock,demonology,83,39,44
Toestye,lightbringer,1600,warlock,demonology,108,56,52
Pollodelight,deathwing,1598,warlock,demonology,30,21,9
Th,kiljaeden,1596,warlock,demonology,71,33,38
Valkynaris,chogall,1594,warlock,demonology,30,20,10
Warlocklmao,malganis,1594,warlock,demonology,36,19,17
Stonelocke,area-52,1594,warlock,demonology,79,40,39
Thalsiani,moon-guard,1592,warlock,demonology,51,27,24
Yanlexx,stormrage,1592,warlock,demonology,86,44,42
Amour,wyrmrest-accord,1592,warlock,demonology,58,26,32
Yazonics,area-52,1585,warlock,demonology,91,49,42
Creepydotman,mannoroth,1584,warlock,demonology,28,18,10
Ioroselmi,illidan,1583,warlock,demonology,68,45,23
Tsunamibaby,anvilmar,1583,warlock,demonology,138,77,61
Raidspot,bleeding-hollow,1581,warlock,demonology,72,40,32
Goorock,area-52,1581,warlock,demonology,78,40,38
Silentfears,tichondrius,1580,warlock,demonology,39,26,13
Curseifier,frostmourne,1579,warlock,demonology,62,33,29
Dreamsw,frostmourne,1578,warlock,demonology,36,18,18
Agertis,frostmourne,1578,warlock,demonology,42,18,24
Ashlëen,ragnaros,1577,warlock,demonology,114,54,60
Condevil,quelthalas,1576,warlock,demonology,72,39,33
Smallj,zuljin,1576,warlock,demonology,54,27,27
Uwantpeach,tichondrius,1576,warlock,demonology,35,17,18
Nttslock,tichondrius,1575,warlock,demonology,48,24,24
Sadgellation,arthas,1574,warlock,demonology,42,27,15
Redbullsz,bleeding-hollow,1573,warlock,demonology,68,34,34
Wawrlock,stormrage,1572,warlock,demonology,38,27,11
Seekma,gallywix,1572,warlock,demonology,42,25,17
Davekoresh,dunemaul,1571,warlock,demonology,50,27,23
Empiratore,quelthalas,1569,warlock,demonology,59,26,33
Xephostwo,area-52,1567,warlock,demonology,42,20,22
Xaryl,stormrage,1564,warlock,demonology,108,52,56
Caesaros,quelthalas,1563,warlock,demonology,87,40,47
Miryem,illidan,1556,warlock,demonology,67,36,31
Blastfinger,tichondrius,1556,warlock,demonology,66,33,33
Spicyfingerx,zangarmarsh,1554,warlock,demonology,30,17,13
Rococo,emerald-dream,1554,warlock,demonology,30,17,13
Smartpimp,tichondrius,1553,warlock,demonology,44,25,19
Fullxd,quelthalas,1551,warlock,demonology,54,31,23
Voltshot,tichondrius,1549,warlock,demonology,475,242,233
Kìllèrgf,area-52,1549,warlock,demonology,249,124,125
Spooknjuke,bleeding-hollow,1546,warlock,demonology,41,26,15
Wickdways,daggerspine,1546,warlock,demonology,54,32,22
Bauchalain,area-52,1541,warlock,demonology,36,21,15
Nyhn,bleeding-hollow,1540,warlock,demonology,32,21,11
Spookyfurry,area-52,1538,warlock,demonology,89,52,37
Lamo,dawnbringer,1537,warlock,demonology,232,117,115
Maldinath,sargeras,1535,warlock,demonology,24,16,8
Soulrulerxc,tichondrius,1534,warlock,demonology,30,16,14
Isometrics,barthilas,1534,warlock,demonology,30,16,14
Heartpvp,tichondrius,1532,warlock,demonology,92,48,44
Cilium,illidan,1531,warlock,demonology,62,33,29
Forsâken,tichondrius,1531,warlock,demonology,95,42,53
Giantgobrin,zuljin,1529,warlock,demonology,30,16,14
Gigagnomer,kelthuzad,1528,warlock,demonology,65,30,35
Deathcyth,crushridge,1523,warlock,demonology,179,96,83
Wollylock,dark-iron,1520,warlock,demonology,52,25,27
Volanti,bleeding-hollow,1516,warlock,demonology,42,24,18
Fãttyqt,sargeras,1513,warlock,demonology,52,35,17
Kandrus,moon-guard,1508,warlock,demonology,158,79,79
Comina,kelthuzad,1507,warlock,demonology,36,16,20
Krolczdots,tichondrius,1505,warlock,demonology,30,18,12
Proletariat,moon-guard,1503,warlock,demonology,64,38,26
Parmenides,tichondrius,1502,warlock,demonology,112,56,56
Icemanliddel,area-52,1500,warlock,demonology,35,16,19
Hoana,azralon,1495,warlock,demonology,111,60,51
Thekook,illidan,1495,warlock,demonology,43,21,22
Shigero,tichondrius,1494,warlock,demonology,30,19,11
Reczy,azralon,1494,warlock,demonology,30,16,14
Prägä,drakkari,1493,warlock,demonology,51,27,24
Zuulusi,stormrage,1491,warlock,demonology,36,16,20
Damerus,illidan,1487,warlock,demonology,57,24,33
Dárklórd,dalaran,1485,warlock,demonology,214,110,104
Eriand,nordrassil,1482,warlock,demonology,108,54,54
Mindfulchimp,sargeras,1480,warlock,demonology,49,27,22
Zhoull,thrall,1479,warlock,demonology,48,23,25
Grixis,zuluhed,1478,warlock,demonology,36,23,13
Sacrilege,zuljin,1474,warlock,demonology,30,18,12
Fabriziø,ragnaros,1472,warlock,demonology,31,21,10
Mssy,illidan,1470,warlock,demonology,29,16,13
Kyller,quelthalas,1470,warlock,demonology,30,16,14
Jyhoona,chromaggus,1468,warlock,demonology,473,237,236
Tubarão,azralon,1467,warlock,demonology,42,26,16
Fluffylockk,bloodscalp,1466,warlock,demonology,58,32,26
Khanaan,illidan,1466,warlock,demonology,30,16,14
Dcpwns,arthas,1461,warlock,demonology,96,47,49
Blavindy,illidan,1461,warlock,demonology,54,26,28
Sugarwaffles,area-52,1460,warlock,demonology,60,33,27
Immortallock,tichondrius,1454,warlock,demonology,96,48,48
Kothoped,wyrmrest-accord,1451,warlock,demonology,41,20,21
Musgrin,gallywix,1448,warlock,demonology,76,38,38
Malegnant,proudmoore,1442,warlock,demonology,42,20,22
Imgxyz,frostmourne,1441,warlock,demonology,54,32,22
Shadowsloc,tichondrius,1439,warlock,demonology,18,15,3
Darkwîngduck,illidan,1439,warlock,demonology,24,15,9
Epícburn,illidan,1439,warlock,demonology,28,16,12
Exuslock,tichondrius,1438,warlock,demonology,24,15,9
Ötì,altar-of-storms,1437,warlock,demonology,30,18,12
Sosahawk,stormrage,1437,warlock,demonology,30,15,15
Dottcha,blackrock,1436,warlock,demonology,24,15,9
Zorah,quelthalas,1436,warlock,demonology,42,22,20
Chaosboltlol,tichondrius,1436,warlock,demonology,30,15,15
Helyana,illidan,1433,warlock,demonology,53,31,22
Feinnx,dalaran,1433,warlock,demonology,36,15,21
Synisterlock,moon-guard,1432,warlock,demonology,36,18,18
Eminence,stormrage,1428,warlock,demonology,30,15,15
Aomniloltv,zuljin,1426,warlock,demonology,24,15,9
Zxyastra,hyjal,1426,warlock,demonology,30,17,13
Mothapucka,thrall,1426,warlock,demonology,47,21,26
Løcalplugxø,barthilas,1425,warlock,demonology,24,15,9
Boltsfordays,dalaran,1423,warlock,demonology,42,16,26
Diosban,malganis,1422,warlock,demonology,36,16,20
Hibíky,ragnaros,1422,warlock,demonology,36,15,21
Arlenna,sargeras,1419,warlock,demonology,128,60,68
Zrò,bleeding-hollow,1416,warlock,demonology,24,15,9
Mixolydian,malganis,1416,warlock,demonology,30,15,15
Bïcho,queldorei,1414,warlock,demonology,30,15,15
Mysteryannie,tichondrius,1411,warlock,demonology,88,53,35
Kuyog,illidan,1411,warlock,demonology,60,30,30
Ganknãmstyle,illidan,1411,warlock,demonology,65,31,34
Laggyturbo,barthilas,1409,warlock,demonology,66,38,28
Rotsndotss,thrall,1408,warlock,demonology,48,20,28
Valerik,azralon,1407,warlock,demonology,60,28,32
Guisls,azralon,1407,warlock,demonology,60,26,34
Siaokuai,tichondrius,1403,warlock,demonology,36,15,21
Adlfcritler,emerald-dream,1402,warlock,demonology,36,19,17
Lockeem,jubeithos,1397,warlock,demonology,42,24,18
Monstir,sargeras,1396,warlock,demonology,31,16,15
Munick,spirestone,1394,warlock,demonology,30,21,9
Suminl,tichondrius,1392,warlock,demonology,24,15,9
Kuroyt,drakkari,1390,warlock,demonology,67,32,35
Avoidence,tanaris,1389,warlock,demonology,36,19,17
Intura,burning-legion,1386,warlock,demonology,30,17,13
Marowyth,ragnaros,1380,warlock,demonology,36,20,16
Kotica,stormrage,1377,warlock,demonology,34,17,17
Gandorf,alleria,1376,warlock,demonology,36,17,19
Guldorum,kiljaeden,1375,warlock,demonology,48,28,20
Nezsarek,sargeras,1373,warlock,demonology,41,22,19
Sayatar,ragnaros,1373,warlock,demonology,30,16,14
Destrokk,gorefiend,1372,warlock,demonology,42,24,18
Catarina,kaelthas,1371,warlock,demonology,28,15,13
Mocreia,azralon,1370,warlock,demonology,34,16,18
Medallok,laughing-skull,1363,warlock,demonology,119,58,61
Felorc,wyrmrest-accord,1358,warlock,demonology,63,39,24
Narcan,arthas,1358,warlock,demonology,35,16,19
Tizzy,malganis,1356,warlock,demonology,38,25,13
Conilus,malganis,1354,warlock,demonology,48,20,28
Lintlickin,bonechewer,1353,warlock,demonology,20,15,5
Lemongillo,stormrage,1349,warlock,demonology,47,25,22
Ellynaria,nemesis,1343,warlock,demonology,18,14,4
Gnomechomski,magtheridon,1343,warlock,demonology,24,14,10
Biubius,tichondrius,1343,warlock,demonology,24,14,10
Haunt,mugthol,1343,warlock,demonology,24,14,10
Idotû,tichondrius,1343,warlock,demonology,30,14,16
Joung,tichondrius,1342,warlock,demonology,24,14,10
Slothycrip,emerald-dream,1342,warlock,demonology,36,14,22
Demonalien,malganis,1339,warlock,demonology,18,14,4
Fearbarx,illidan,1339,warlock,demonology,24,14,10
Tickleskin,windrunner,1337,warlock,demonology,111,57,54
Sphîñx,sargeras,1337,warlock,demonology,50,21,29
Antigotenent,sargeras,1336,warlock,demonology,24,14,10
Djvetis,blackhand,1336,warlock,demonology,24,14,10
Ezgamejr,tichondrius,1334,warlock,demonology,18,14,4
Jamesiyah,moon-guard,1333,warlock,demonology,60,29,31
Smôkedsôul,area-52,1330,warlock,demonology,24,14,10
Ézman,tichondrius,1330,warlock,demonology,24,14,10
Bestwarlock,skywall,1328,warlock,demonology,30,14,16
Eldriptch,kelthuzad,1325,warlock,demonology,27,15,12
Stormrift,sargeras,1325,warlock,demonology,36,14,22
Memon,frostmane,1324,warlock,demonology,65,29,36
Es,velen,1321,warlock,demonology,144,74,70
Superjuno,sargeras,1319,warlock,demonology,18,14,4
Warlockluo,tichondrius,1319,warlock,demonology,24,14,10
Dawdrax,gallywix,1313,warlock,demonology,22,15,7
Jokerks,tichondrius,1310,warlock,demonology,23,14,9
Mechamaca,black-dragonflight,1308,warlock,demonology,96,45,51
Andlerock,emerald-dream,1305,warlock,demonology,37,22,15
Brawndelock,stormrage,1304,warlock,demonology,60,26,34
Sû,stormrage,1301,warlock,demonology,84,40,44
Bashel,sargeras,1300,warlock,demonology,24,15,9
Shadowflame,skullcrusher,1299,warlock,demonology,91,48,43
Critthis,illidan,1297,warlock,demonology,30,14,16
Daesire,moon-guard,1295,warlock,demonology,30,14,16
Valerilma,azralon,1284,warlock,demonology,40,18,22
Warlockdelux,thrall,1282,warlock,demonology,54,20,34
Gauul,illidan,1281,warlock,demonology,70,39,31
Heathncraig,illidan,1279,warlock,demonology,50,29,21
Screampied,sargeras,1279,warlock,demonology,53,24,29
Yoyoling,illidan,1277,warlock,demonology,258,129,129
Regime,deathwing,1275,warlock,demonology,24,14,10
Cornboil,tichondrius,1274,warlock,demonology,57,27,30
Dôctor,tichondrius,1274,warlock,demonology,64,30,34
Voidwarlord,tichondrius,1271,warlock,demonology,107,56,51
Spicydots,arthas,1270,warlock,demonology,54,28,26
Willsayan,ragnaros,1266,warlock,demonology,42,16,26
Bluffzlock,boulderfist,1260,warlock,demonology,23,14,9
Owwie,malganis,1258,warlock,demonology,22,14,8
Bänno,bleeding-hollow,1256,warlock,demonology,29,14,15
Wazog,jubeithos,1250,warlock,demonology,30,16,14
Salacia,chogall,1249,warlock,demonology,171,83,88
Adonege,tichondrius,1248,warlock,demonology,24,13,11
Drakatat,tichondrius,1248,warlock,demonology,24,13,11
Deathboltx,zuljin,1248,warlock,demonology,24,13,11
Welpxd,tichondrius,1247,warlock,demonology,18,13,5
Pfhear,area-52,1247,warlock,demonology,24,13,11
Mukkamuk,shadowmoon,1246,warlock,demonology,18,13,5
Evianne,skywall,1244,warlock,demonology,30,13,17
Homeschooler,darkspear,1243,warlock,demonology,24,13,11
Warlockafk,darkspear,1242,warlock,demonology,24,17,7
Beerbolt,dalaran,1242,warlock,demonology,24,13,11
Pardoned,stormrage,1241,warlock,demonology,36,13,23
Demonkiiller,kelthuzad,1237,warlock,demonology,30,13,17
Esdreel,ragnaros,1236,warlock,demonology,24,13,11
Drain,proudmoore,1233,warlock,demonology,18,13,5
Tomzombe,durotan,1233,warlock,demonology,18,13,5
Lpharji,tichondrius,1231,warlock,demonology,24,13,11
Alaren,korgath,1231,warlock,demonology,36,13,23
Welendiock,malganis,1228,warlock,demonology,43,21,22
Ipickcotton,barthilas,1223,warlock,demonology,30,13,17
Gotfear,zuljin,1222,warlock,demonology,280,139,141
Symplicìty,area-52,1219,warlock,demonology,24,13,11
Naydene,moon-guard,1219,warlock,demonology,66,31,35
Aniie,nemesis,1212,warlock,demonology,78,35,43
Arcaangell,sargeras,1206,warlock,demonology,69,36,33
Zeeref,stormrage,1206,warlock,demonology,30,13,17
Demophile,bleeding-hollow,1204,warlock,demonology,24,18,6
Lockdlhm,tichondrius,1197,warlock,demonology,23,13,10
Bazeni,frostmourne,1193,warlock,demonology,24,13,11
Jezzika,azralon,1183,warlock,demonology,57,22,35
Adistril,bleeding-hollow,1182,warlock,demonology,48,14,34
Syndrielle,emerald-dream,1181,warlock,demonology,54,22,32
Artmaster,nordrassil,1174,warlock,demonology,30,20,10
Snuffer,detheroc,1164,warlock,demonology,30,13,17
Stankidanky,illidan,1156,warlock,demonology,30,18,12
Thefunk,tichondrius,1152,warlock,demonology,18,12,6
Voidxz,tichondrius,1152,warlock,demonology,18,12,6
Medzor,tichondrius,1152,warlock,demonology,24,12,12
Blliizz,aegwynn,1151,warlock,demonology,18,12,6
Demise,azuremyst,1151,warlock,demonology,24,12,12
Demonia,dathremar,1151,warlock,demonology,30,12,18
Spectaclol,crushridge,1150,warlock,demonology,18,12,6
Lentil,zuljin,1150,warlock,demonology,18,12,6
Emurog,icecrown,1150,warlock,demonology,18,12,6
Bellatriks,nemesis,1149,warlock,demonology,18,12,6
Chipt,kelthuzad,1149,warlock,demonology,30,12,18
Urfucct,burning-blade,1148,warlock,demonology,18,12,6
Drkdestro,boulderfist,1148,warlock,demonology,42,12,30
Moryan,malfurion,1136,warlock,demonology,33,13,20
Bizcochito,thrall,1134,warlock,demonology,24,12,12
Saltiernuts,malganis,1128,warlock,demonology,48,22,26
Xtralyfe,hyjal,1117,warlock,demonology,22,12,10
Löksöflöve,sargeras,1101,warlock,demonology,60,25,35
Nellon,azralon,1087,warlock,demonology,26,13,13
Elipsis,bloodhoof,1086,warlock,demonology,23,12,11
Sumondeznuts,wyrmrest-accord,1080,warlock,demonology,23,12,11
Politepvperx,kelthuzad,1070,warlock,demonology,17,12,5
Maroth,elune,1070,warlock,demonology,30,12,18
Lilmollyboy,demon-soul,1068,warlock,demonology,13,12,1
Netherhigh,tichondrius,1061,warlock,demonology,66,32,34
Bøltqt,tichondrius,1056,warlock,demonology,12,11,1
Igortrikadva,zuljin,1056,warlock,demonology,12,11,1
Waii,emerald-dream,1056,warlock,demonology,12,11,1
Starta,tichondrius,1056,warlock,demonology,18,11,7
Itzlandox,emerald-dream,1056,warlock,demonology,18,11,7
Samsara,akama,1056,warlock,demonology,18,11,7
Betterone,azralon,1055,warlock,demonology,18,11,7
Decolock,tichondrius,1055,warlock,demonology,18,11,7
Blastyboat,terenas,1055,warlock,demonology,18,11,7
Fotmspec,area-52,1055,warlock,demonology,18,11,7
Minervini,kiljaeden,1054,warlock,demonology,12,11,1
Praemonium,dalaran,1054,warlock,demonology,18,11,7
Jblock,zuljin,1053,warlock,demonology,21,12,9
Devilin,drakkari,1052,warlock,demonology,24,11,13
Choas,jaedenar,1051,warlock,demonology,18,11,7
Menedemus,amanthul,1050,warlock,demonology,24,11,13
Mêdìvh,tichondrius,1050,warlock,demonology,24,11,13
Zinkro,quelthalas,1049,warlock,demonology,22,12,10
Tròll,moon-guard,1049,warlock,demonology,54,25,29
Prahvstein,shuhalo,1047,warlock,demonology,18,11,7
Tartamuda,ragnaros,1037,warlock,demonology,30,11,19
Yozzik,illidan,1036,warlock,demonology,29,11,18
Rickrock,gnomeregan,1034,warlock,demonology,18,11,7
Teron,stonemaul,1031,warlock,demonology,18,11,7
Westhøf,sargeras,1023,warlock,demonology,17,11,6
Rannieck,dark-iron,1022,warlock,demonology,16,12,4
Elyshia,illidan,1008,warlock,demonology,33,12,21
Tichondrus,ragnaros,1007,warlock,demonology,29,11,18
Lukelock,azralon,990,warlock,demonology,22,11,11
Uzag,mugthol,975,warlock,demonology,26,11,15
Hecataeus,stormrage,960,warlock,demonology,12,10,2
Phyxylock,stormrage,960,warlock,demonology,12,10,2
Meltlordqt,mannoroth,960,warlock,demonology,12,10,2
Suwook,tichondrius,960,warlock,demonology,12,10,2
Felegance,proudmoore,960,warlock,demonology,18,10,8
Spacedots,illidan,960,warlock,demonology,18,10,8
Idiocy,stormrage,960,warlock,demonology,18,10,8
Vexice,firetree,960,warlock,demonology,18,10,8
Xyguoguo,tichondrius,960,warlock,demonology,18,10,8
Wdc,illidan,960,warlock,demonology,24,10,14
Millions,barthilas,960,warlock,demonology,24,10,14
Syraxi,illidan,959,warlock,demonology,18,10,8
Tesil,tichondrius,959,warlock,demonology,18,10,8
Purraisa,tichondrius,959,warlock,demonology,18,10,8
Firemarshall,stormrage,959,warlock,demonology,18,10,8
Lockman,frostwolf,959,warlock,demonology,24,12,12
Criptix,bleeding-hollow,959,warlock,demonology,24,10,14
Lefteexd,tichondrius,959,warlock,demonology,24,10,14
Conely,barthilas,959,warlock,demonology,24,10,14
Hâm,dalaran,959,warlock,demonology,36,10,26
Nêlson,area-52,958,warlock,demonology,18,10,8
Lynnha,wyrmrest-accord,958,warlock,demonology,24,10,14
Shâdowman,stormrage,957,warlock,demonology,18,10,8
Nurglea,proudmoore,957,warlock,demonology,18,10,8
Lockswagger,stormrage,956,warlock,demonology,18,10,8
Zaintv,illidan,955,warlock,demonology,18,10,8
Kaertis,emerald-dream,955,warlock,demonology,21,11,10
Anjkh,skullcrusher,955,warlock,demonology,24,10,14
Leine,proudmoore,955,warlock,demonology,24,10,14
Sytrick,bleeding-hollow,955,warlock,demonology,24,10,14
Canning,shuhalo,954,warlock,demonology,24,10,14
Methrocks,emerald-dream,953,warlock,demonology,24,10,14
Sørceress,bonechewer,948,warlock,demonology,18,10,8
Shadowndko,ragnaros,937,warlock,demonology,18,10,8
Bugbugg,tichondrius,927,warlock,demonology,17,10,7
Pellah,malganis,926,warlock,demonology,20,11,9
Voldamorte,tichondrius,925,warlock,demonology,23,10,13
Voodootidies,proudmoore,922,warlock,demonology,27,13,14
Demonicdayer,area-52,921,warlock,demonology,19,11,8
Sheara,silver-hand,905,warlock,demonology,24,10,14
Cslice,magtheridon,896,warlock,demonology,16,10,6
Twinklockxx,mannoroth,895,warlock,demonology,23,10,13
Apples,ravencrest,894,warlock,demonology,17,10,7
Idoturmum,frostmourne,889,warlock,demonology,27,11,16
Muchø,emerald-dream,864,warlock,demonology,12,9,3
Leleth,nordrassil,864,warlock,demonology,12,9,3
Maxice,zuljin,864,warlock,demonology,12,9,3
Impenjoyer,tichondrius,864,warlock,demonology,12,9,3
Wamage,malganis,864,warlock,demonology,12,9,3
Peterdotz,whisperwind,864,warlock,demonology,13,9,4
Soorisoori,tichondrius,864,warlock,demonology,18,9,9
Djdemolordx,bleeding-hollow,864,warlock,demonology,18,9,9
Bewær,deathwing,864,warlock,demonology,18,9,9
Luku,kiljaeden,864,warlock,demonology,18,9,9
Caduz,stormrage,864,warlock,demonology,18,9,9
Evanylock,proudmoore,864,warlock,demonology,18,9,9
Dxhusky,tichondrius,864,warlock,demonology,18,9,9
Jæja,wyrmrest-accord,864,warlock,demonology,18,9,9
Imbooms,blackrock,864,warlock,demonology,18,9,9
Louu,emerald-dream,864,warlock,demonology,18,9,9
Jorloz,ragnaros,863,warlock,demonology,12,9,3
Crujonez,sargeras,863,warlock,demonology,12,9,3
Fatals,thrall,863,warlock,demonology,12,9,3
Demic,thrall,863,warlock,demonology,18,9,9
Dudebrø,zuluhed,863,warlock,demonology,18,9,9
Hermania,sargeras,863,warlock,demonology,18,9,9
Criticalpets,stormrage,863,warlock,demonology,18,9,9
Freadle,sargeras,863,warlock,demonology,24,9,15
Päpï,tichondrius,862,warlock,demonology,12,9,3
Harleyjames,ravenholdt,862,warlock,demonology,12,9,3
Oopsíe,nagrand,860,warlock,demonology,24,9,15
Easymac,thunderlord,860,warlock,demonology,24,9,15
Mementomøri,quelthalas,858,warlock,demonology,24,9,15
Braylon,azuremyst,856,warlock,demonology,18,9,9
Wakkundoe,tichondrius,846,warlock,demonology,17,9,8
Orbvoid,sargeras,845,warlock,demonology,24,9,15
Demoniclily,kiljaeden,816,warlock,demonology,21,9,12
Cleavüs,stormrage,815,warlock,demonology,11,9,2
Keturáh,garrosh,794,warlock,demonology,28,12,16
Westhofs,sargeras,768,warlock,demonology,12,8,4
Asmion,earthen-ring,768,warlock,demonology,12,8,4
Menemies,malganis,768,warlock,demonology,12,8,4
Pvtpotato,tichondrius,768,warlock,demonology,12,8,4
Gnumbnutz,blades-edge,768,warlock,demonology,12,8,4
Famelol,tichondrius,768,warlock,demonology,12,8,4
Lhordeign,area-52,768,warlock,demonology,12,8,4
Vølt,illidan,768,warlock,demonology,12,8,4
Bigboltkazar,tichondrius,768,warlock,demonology,12,8,4
Rizzofsparta,stormrage,768,warlock,demonology,12,8,4
Tydar,bleeding-hollow,768,warlock,demonology,12,8,4
Gigabiga,tol-barad,768,warlock,demonology,12,8,4
Marshyxd,tichondrius,768,warlock,demonology,12,8,4
Moramont,stormrage,768,warlock,demonology,12,8,4
Wrathzn,azralon,768,warlock,demonology,12,8,4
Possapp,azralon,768,warlock,demonology,12,8,4
Dunni,area-52,768,warlock,demonology,18,8,10
Vasqu,stormrage,768,warlock,demonology,18,8,10
Niava,tichondrius,768,warlock,demonology,18,8,10
Joseph,draktharon,768,warlock,demonology,18,8,10
Nismo,trollbane,768,warlock,demonology,18,8,10
Torowasabi,tichondrius,768,warlock,demonology,21,8,13
Puchador,sargeras,768,warlock,demonology,24,8,16
Neutrinowal,tichondrius,768,warlock,demonology,24,8,16
Rosacrutian,tichondrius,767,warlock,demonology,12,8,4
Gibberishss,tichondrius,767,warlock,demonology,12,8,4
Grendael,area-52,767,warlock,demonology,12,8,4
Juankkii,bonechewer,767,warlock,demonology,12,8,4
Aboode,blackrock,767,warlock,demonology,18,8,10
Fullmelt,azjolnerub,767,warlock,demonology,18,8,10
Ritzhul,nordrassil,766,warlock,demonology,12,8,4
Bojàck,stormrage,766,warlock,demonology,12,8,4
Elioknight,area-52,766,warlock,demonology,18,8,10
Lustyclam,tichondrius,765,warlock,demonology,12,8,4
Xenagos,antonidas,765,warlock,demonology,18,8,10
Cvntpvntcans,kelthuzad,764,warlock,demonology,18,8,10
Pulentinskin,quelthalas,764,warlock,demonology,24,8,16
Grimrizz,ragnaros,763,warlock,demonology,12,8,4
Griffoz,frostwolf,763,warlock,demonology,18,8,10
Dundreavan,area-52,763,warlock,demonology,18,8,10
Eeso,stormrage,754,warlock,demonology,24,8,16
Pestileus,bleeding-hollow,749,warlock,demonology,12,8,4
Doobielock,kelthuzad,734,warlock,demonology,14,9,5
Getavoided,azralon,714,warlock,demonology,13,9,4
Bâppo,antonidas,714,warlock,demonology,24,11,13
Eklypso,kelthuzad,714,warlock,demonology,20,9,11
Nurnok,ragnaros,713,warlock,demonology,18,9,9
Tikz,magtheridon,703,warlock,demonology,11,8,3
Demofliction,stormrage,687,warlock,demonology,11,8,3
Nockdreal,azralon,672,warlock,demonology,12,7,5
Løckyun,tichondrius,672,warlock,demonology,12,7,5
Bestcookies,malganis,672,warlock,demonology,12,7,5
Jweezy,malganis,672,warlock,demonology,12,7,5
Lánathel,ragnaros,672,warlock,demonology,12,7,5
Agla,quelthalas,672,warlock,demonology,12,7,5
Lifeinsuranc,tichondrius,672,warlock,demonology,12,7,5
Syen,quelthalas,672,warlock,demonology,12,7,5
Dadtired,tichondrius,672,warlock,demonology,12,7,5
Aruotnof,nemesis,672,warlock,demonology,12,7,5
Blaxzlock,stormscale,672,warlock,demonology,12,7,5
Sauronne,illidan,672,warlock,demonology,12,7,5
Smoogzi,tichondrius,672,warlock,demonology,12,7,5
Gearboxx,tichondrius,672,warlock,demonology,12,7,5
Demonmal,frostmourne,672,warlock,demonology,12,7,5
Playandlock,illidan,672,warlock,demonology,12,7,5
Drix,wyrmrest-accord,672,warlock,demonology,12,7,5
Isömetrics,barthilas,672,warlock,demonology,12,7,5
Deammon,tichondrius,672,warlock,demonology,12,7,5
Juppup,tichondrius,672,warlock,demonology,12,7,5
Zeexi,illidan,672,warlock,demonology,12,7,5
Ðamndaddy,sargeras,672,warlock,demonology,12,7,5
Laiquisha,zuljin,672,warlock,demonology,12,7,5
Fearmore,bleeding-hollow,672,warlock,demonology,12,7,5
Expiredonion,bleeding-hollow,672,warlock,demonology,12,7,5
Sorenbjerga,zuljin,672,warlock,demonology,12,7,5
Protomán,agamaggan,672,warlock,demonology,12,7,5
Matrriixx,proudmoore,672,warlock,demonology,18,7,11
Nefertarie,illidan,672,warlock,demonology,18,7,11
Staywrong,malganis,672,warlock,demonology,18,7,11
Acejerk,the-forgotten-coast,672,warlock,demonology,18,7,11
Demodar,tol-barad,672,warlock,demonology,18,7,11
Urïk,stormrage,672,warlock,demonology,18,7,11
Evarona,gorefiend,672,warlock,demonology,18,7,11
Ranil,mannoroth,672,warlock,demonology,18,7,11
Nigthdeath,nemesis,671,warlock,demonology,12,7,5
Saldori,malganis,671,warlock,demonology,12,7,5
Snoosnoo,exodar,671,warlock,demonology,12,7,5
Lockmau,azralon,671,warlock,demonology,12,7,5
Celindeyn,stormrage,671,warlock,demonology,12,7,5
Faraday,laughing-skull,671,warlock,demonology,12,7,5
Felynrith,khadgar,671,warlock,demonology,12,7,5
Nëcrophil,area-52,671,warlock,demonology,12,7,5
Damagexx,the-underbog,671,warlock,demonology,12,7,5
Glortheeb,spirestone,671,warlock,demonology,12,7,5
Dotsfired,crushridge,671,warlock,demonology,18,7,11
Chelythalle,tichondrius,671,warlock,demonology,19,7,12
Sanastik,laughing-skull,670,warlock,demonology,12,7,5
Deanwarlock,sargeras,670,warlock,demonology,12,7,5
Belloch,frostmourne,669,warlock,demonology,12,7,5
Lokiiee,azuremyst,664,warlock,demonology,12,7,5
Tsmcfker,tichondrius,654,warlock,demonology,17,7,10
Blunder,frostmourne,623,warlock,demonology,11,7,4
Heilcyon,illidan,622,warlock,demonology,11,7,4
Chlomakï,azralon,622,warlock,demonology,11,7,4
Chaosboltex,tichondrius,618,warlock,demonology,14,8,6
Mssyy,illidan,608,warlock,demonology,10,7,3
Vueltoachote,stormrage,592,warlock,demonology,13,7,6
Comply,frostmane,592,warlock,demonology,13,7,6
Hof,bloodscalp,576,warlock,demonology,6,6,0
Dazevil,burning-blade,576,warlock,demonology,6,6,0
Spectro,laughing-skull,576,warlock,demonology,6,6,0
Spook,steamwheedle-cartel,576,warlock,demonology,6,6,0
Grimløck,khadgar,576,warlock,demonology,6,6,0
Fakemagician,tichondrius,576,warlock,demonology,6,6,0
Vìqtìm,kelthuzad,576,warlock,demonology,6,6,0
Lillpfudd,area-52,576,warlock,demonology,6,6,0
Toxik,zuljin,576,warlock,demonology,6,6,0
Wâg,moon-guard,576,warlock,demonology,6,6,0
Dingis,bloodscalp,576,warlock,demonology,6,6,0
Hank,azgalor,576,warlock,demonology,6,6,0
Honne,sargeras,576,warlock,demonology,10,7,3
Backseatn,tichondrius,576,warlock,demonology,12,6,6
Graveland,frostwolf,576,warlock,demonology,12,6,6
Marothredd,nathrezim,576,warlock,demonology,12,6,6
Exxosl,tichondrius,576,warlock,demonology,12,6,6
Bellath,azralon,576,warlock,demonology,12,6,6
Sorath,blackrock,576,warlock,demonology,12,6,6
Oniyooshi,kelthuzad,576,warlock,demonology,12,6,6
Hoonjojjyanl,tichondrius,576,warlock,demonology,12,6,6
Zoerina,fizzcrank,576,warlock,demonology,12,6,6
Westhofz,tichondrius,576,warlock,demonology,12,6,6
Destructio,tichondrius,576,warlock,demonology,12,6,6
Pumpkeenky,hyjal,576,warlock,demonology,12,6,6
Dalah,illidan,576,warlock,demonology,12,6,6
Eddybigbolts,tichondrius,576,warlock,demonology,12,6,6
Babybolt,frostmourne,576,warlock,demonology,12,6,6
Rottenhell,kelthuzad,576,warlock,demonology,12,6,6
Projectpump,kelthuzad,576,warlock,demonology,12,6,6
Davidofbowie,burning-legion,576,warlock,demonology,12,6,6
Kyralena,stormrage,576,warlock,demonology,12,6,6
Linestrazsa,daggerspine,576,warlock,demonology,12,6,6
Yaldin,nemesis,576,warlock,demonology,12,6,6
Scarletdemon,malganis,576,warlock,demonology,12,6,6
Threedotfivu,proudmoore,576,warlock,demonology,12,6,6
Radii,bladefist,576,warlock,demonology,12,6,6
Chaosblade,burning-blade,576,warlock,demonology,12,6,6
Kossnen,shandris,576,warlock,demonology,12,6,6
Conboii,tichondrius,576,warlock,demonology,12,6,6
Therru,tichondrius,576,warlock,demonology,12,6,6
Meelady,tichondrius,576,warlock,demonology,12,6,6
Vexria,wyrmrest-accord,576,warlock,demonology,12,6,6
Nolb,tichondrius,576,warlock,demonology,12,6,6
Diabhlaí,tichondrius,576,warlock,demonology,12,6,6
Muchopower,ragnaros,576,warlock,demonology,12,6,6
Artzul,tichondrius,576,warlock,demonology,15,7,8
Mucholock,azralon,576,warlock,demonology,18,6,12
Tribulatiön,moon-guard,576,warlock,demonology,18,6,12
Shadowhax,area-52,576,warlock,demonology,18,6,12
Dreadful,frostmourne,576,warlock,demonology,18,6,12
Yungwilly,silvermoon,576,warlock,demonology,18,6,12
Ragnalock,laughing-skull,576,warlock,demonology,20,6,14
Shadü,tichondrius,576,warlock,demonology,25,6,19
Lockazo,quelthalas,575,warlock,demonology,6,6,0
Sylvanes,emerald-dream,575,warlock,demonology,12,6,6
Lollilock,area-52,575,warlock,demonology,12,6,6
Ronacq,norgannon,575,warlock,demonology,12,6,6
Sinaman,barthilas,575,warlock,demonology,12,6,6
Twototheone,illidan,575,warlock,demonology,12,6,6
Abantes,area-52,575,warlock,demonology,12,6,6
Voidgown,moon-guard,575,warlock,demonology,12,6,6
Syndel,drakkari,575,warlock,demonology,12,6,6
Doomczar,frostmane,575,warlock,demonology,12,6,6
Szell,caelestrasz,575,warlock,demonology,12,6,6
Daliadark,sargeras,575,warlock,demonology,21,6,15
Xanlel,deathwing,574,warlock,demonology,18,6,12
Nécromonster,illidan,574,warlock,demonology,18,6,12
Yury,scarlet-crusade,574,warlock,demonology,18,6,12
Undeadcurse,frostmourne,574,warlock,demonology,24,6,18
Algard,emerald-dream,573,warlock,demonology,12,6,6
Däemön,area-52,573,warlock,demonology,12,6,6
Velondris,illidan,566,warlock,demonology,24,6,18
Thoroxa,stormrage,558,warlock,demonology,17,6,11
ßaphomet,blackrock,543,warlock,demonology,11,6,5
Jafi,coilfang,543,warlock,demonology,17,6,11
Penzer,stormrage,528,warlock,demonology,15,6,9
Ceeloww,illidan,527,warlock,demonology,11,6,5
Constantine,exodar,527,warlock,demonology,17,6,11
Mourdera,ragnaros,522,warlock,demonology,14,7,7
Nostractus,azralon,517,warlock,demonology,15,7,8
Sixv,barthilas,480,warlock,demonology,6,5,1
Salsong,draka,480,warlock,demonology,6,5,1
Necrotko,malganis,480,warlock,demonology,6,5,1
Charlieo,barthilas,480,warlock,demonology,6,5,1
Dodgebolts,khaz-modan,480,warlock,demonology,6,5,1
Valraths,arthas,480,warlock,demonology,6,5,1
Conboi,tichondrius,480,warlock,demonology,6,5,1
Sinixx,tichondrius,480,warlock,demonology,6,5,1
Floorlamp,anvilmar,480,warlock,demonology,6,5,1
Conboee,tichondrius,480,warlock,demonology,6,5,1
Gavvi,frostmourne,480,warlock,demonology,6,5,1
Rotkid,barthilas,480,warlock,demonology,6,5,1
Mitchosx,frostmourne,480,warlock,demonology,6,5,1
Aînzooalgown,ragnaros,480,warlock,demonology,6,5,1
Khaozx,ragnaros,480,warlock,demonology,6,5,1
Reneqtxo,frostmourne,480,warlock,demonology,6,5,1
Niadmer,gnomeregan,480,warlock,demonology,6,5,1
Leyzer,stormrage,480,warlock,demonology,6,5,1
Seutóóbinha,stormrage,480,warlock,demonology,6,5,1
Velrose,thrall,480,warlock,demonology,6,5,1
Tiatiatia,illidan,480,warlock,demonology,6,5,1
Huloo,blades-edge,480,warlock,demonology,6,5,1
Viralwashbrn,illidan,480,warlock,demonology,6,5,1
Wybbukk,wyrmrest-accord,480,warlock,demonology,6,5,1
Drainedd,blades-edge,480,warlock,demonology,6,5,1
Justganmore,tichondrius,480,warlock,demonology,6,5,1
Vapeboi,bleeding-hollow,480,warlock,demonology,6,5,1
Igniz,tichondrius,480,warlock,demonology,6,5,1
Sêrok,tichondrius,480,warlock,demonology,6,5,1
Druzzaj,thrall,480,warlock,demonology,6,5,1
Lafuke,tichondrius,480,warlock,demonology,6,5,1
Linctowncar,sargeras,480,warlock,demonology,6,5,1
Nos,bleeding-hollow,480,warlock,demonology,6,5,1
Bepis,emerald-dream,480,warlock,demonology,12,5,7
Grandpapapa,tichondrius,480,warlock,demonology,12,5,7
Evilmilf,tichondrius,480,warlock,demonology,12,5,7
Dkdakìng,dalaran,480,warlock,demonology,12,5,7
Beaknstein,sargeras,480,warlock,demonology,12,5,7
Dewandoritos,kelthuzad,480,warlock,demonology,12,5,7
Sinápsís,ragnaros,480,warlock,demonology,12,5,7
Aniuk,bloodhoof,480,warlock,demonology,12,5,7
Beaknasty,sargeras,480,warlock,demonology,12,5,7
Demonâ,ragnaros,480,warlock,demonology,12,5,7
Rumpology,illidan,480,warlock,demonology,12,5,7
Rooms,sargeras,480,warlock,demonology,12,5,7
Breeak,sargeras,480,warlock,demonology,12,5,7
Wheremyshoes,area-52,480,warlock,demonology,12,5,7
Aellorie,proudmoore,480,warlock,demonology,12,5,7
Meisy,quelthalas,480,warlock,demonology,12,5,7
Zarinista,veknilash,480,warlock,demonology,12,5,7
Mânuel,akama,480,warlock,demonology,12,5,7
Lockonthc,korgath,480,warlock,demonology,12,5,7
Grineed,emerald-dream,480,warlock,demonology,12,5,7
Dapperdanxy,tichondrius,480,warlock,demonology,12,5,7
Alataar,sargeras,480,warlock,demonology,12,5,7
Démoniaque,garrosh,480,warlock,demonology,12,5,7
Ragdoll,illidan,480,warlock,demonology,12,5,7
Klumzey,tichondrius,480,warlock,demonology,12,5,7
Fshi,frostmourne,480,warlock,demonology,12,5,7
Zelxor,tichondrius,480,warlock,demonology,12,5,7
Liuh,tichondrius,480,warlock,demonology,12,5,7
Perkz,moon-guard,480,warlock,demonology,12,5,7
Søcks,tichondrius,480,warlock,demonology,12,5,7
Gandreleda,wyrmrest-accord,480,warlock,demonology,16,6,10
Flangy,kiljaeden,480,warlock,demonology,14,5,9
Paleontology,moon-guard,480,warlock,demonology,14,5,9
Durgamon,kirin-tor,480,warlock,demonology,18,5,13
Sagaema,silvermoon,479,warlock,demonology,6,5,1
Eflock,barthilas,479,warlock,demonology,12,5,7
Damelon,gurubashi,479,warlock,demonology,12,5,7
Deathlowkz,area-52,479,warlock,demonology,12,5,7
Stinkmeaner,chogall,479,warlock,demonology,12,5,7
Lockybalbowa,amanthul,479,warlock,demonology,18,5,13
Omegawarlock,quelthalas,479,warlock,demonology,18,5,13
Iolitee,khazgoroth,477,warlock,demonology,12,5,7
Sathorastus,spirestone,448,warlock,demonology,10,6,4
Rentacletape,kelthuzad,447,warlock,demonology,9,6,3
Agaros,zuljin,426,warlock,demonology,17,6,11
Rosalynda,azralon,398,warlock,demonology,10,5,5
Quonton,tichondrius,384,warlock,demonology,6,4,2
Famington,tichondrius,384,warlock,demonology,6,4,2
Sakuin,bonechewer,384,warlock,demonology,6,4,2
Kernlberton,tichondrius,384,warlock,demonology,6,4,2
Jorit,argent-dawn,384,warlock,demonology,6,4,2
Drekka,bleeding-hollow,384,warlock,demonology,6,4,2
Vesaloth,zuljin,384,warlock,demonology,6,4,2
Curpt,the-scryers,384,warlock,demonology,6,4,2
Mädzy,azralon,384,warlock,demonology,6,4,2
Helheim,haomarush,384,warlock,demonology,6,4,2
Khalamar,steamwheedle-cartel,384,warlock,demonology,6,4,2
Fokâi,sargeras,384,warlock,demonology,6,4,2
Poppadot,korgath,384,warlock,demonology,6,4,2
Leekeeaynis,frostmourne,384,warlock,demonology,6,4,2
Brujever,ragnaros,384,warlock,demonology,6,4,2
Vilebrute,illidan,384,warlock,demonology,6,4,2
Ethero,emerald-dream,384,warlock,demonology,6,4,2
Bigmancam,illidan,384,warlock,demonology,6,4,2
Mazzaleen,area-52,384,warlock,demonology,6,4,2
Lhorgainz,area-52,384,warlock,demonology,6,4,2
Il,nerzhul,384,warlock,demonology,6,4,2
Meep,madoran,384,warlock,demonology,6,4,2
Frustration,darkspear,384,warlock,demonology,6,4,2
Dashaad,illidan,384,warlock,demonology,6,4,2
Hordefella,malganis,384,warlock,demonology,6,4,2
Lockniel,skullcrusher,384,warlock,demonology,6,4,2
Karmalock,malganis,384,warlock,demonology,6,4,2
Zidus,tichondrius,384,warlock,demonology,6,4,2
Nerolock,frostmourne,384,warlock,demonology,6,4,2
Lizlock,stormrage,384,warlock,demonology,6,4,2
Conjur,barthilas,384,warlock,demonology,6,4,2
Ardam,cenarion-circle,384,warlock,demonology,6,4,2
Coomerdoomer,stormrage,384,warlock,demonology,6,4,2
Movvo,queldorei,384,warlock,demonology,6,4,2
Retaruko,illidan,384,warlock,demonology,6,4,2
Moräl,frostmourne,384,warlock,demonology,6,4,2
Tiddliwinx,nordrassil,384,warlock,demonology,6,4,2
Alchan,tichondrius,384,warlock,demonology,6,4,2
Nightblloom,illidan,384,warlock,demonology,6,4,2
Hélà,sargeras,384,warlock,demonology,6,4,2
Remusdark,exodar,384,warlock,demonology,6,4,2
Crayonchewer,alleria,384,warlock,demonology,6,4,2
Fanzhiyi,illidan,384,warlock,demonology,6,4,2
Kyrionn,azralon,384,warlock,demonology,6,4,2
Thanock,illidan,384,warlock,demonology,6,4,2
Hauntedhøuse,area-52,384,warlock,demonology,6,4,2
Xekk,wyrmrest-accord,384,warlock,demonology,6,4,2
Ahp,stormrage,384,warlock,demonology,6,4,2
Viejitaa,quelthalas,384,warlock,demonology,6,4,2
Rodneyjones,emerald-dream,384,warlock,demonology,6,4,2
Deatthmoon,stormrage,384,warlock,demonology,6,4,2
Logixo,sargeras,384,warlock,demonology,7,4,3
Warlooch,area-52,384,warlock,demonology,9,5,4
Woudini,malganis,384,warlock,demonology,10,5,5
Jvilla,tichondrius,384,warlock,demonology,8,4,4
Diekast,tichondrius,384,warlock,demonology,12,4,8
Ven,dalaran,384,warlock,demonology,12,4,8
Bigdaddyborr,arthas,384,warlock,demonology,12,4,8
Dogcookie,moon-guard,384,warlock,demonology,12,4,8
Çheesestick,dalaran,384,warlock,demonology,12,4,8
Monstermime,wildhammer,384,warlock,demonology,12,4,8
Frezy,stormrage,384,warlock,demonology,12,4,8
Naz,shadowsong,384,warlock,demonology,12,4,8
Warlack,jubeithos,384,warlock,demonology,12,4,8
Ddorangmoon,tichondrius,384,warlock,demonology,12,4,8
Tahmrin,quelthalas,384,warlock,demonology,12,4,8
Kytae,malygos,384,warlock,demonology,12,4,8
Picklecatz,barthilas,384,warlock,demonology,12,4,8
Nazare,tichondrius,384,warlock,demonology,12,4,8
Dotsandpot,malfurion,384,warlock,demonology,12,4,8
Rumjugs,barthilas,384,warlock,demonology,12,4,8
Rylal,illidan,384,warlock,demonology,12,4,8
Pìnto,illidan,384,warlock,demonology,12,4,8
Uarus,tichondrius,384,warlock,demonology,12,4,8
Soulrman,tichondrius,384,warlock,demonology,12,4,8
Srz,stormrage,384,warlock,demonology,12,4,8
Shadococo,tichondrius,384,warlock,demonology,12,4,8
Arsaurelica,blackrock,384,warlock,demonology,12,4,8
Deatt,deathwing,384,warlock,demonology,12,4,8
Xoxoxu,frostmourne,384,warlock,demonology,12,4,8
Tofulery,tichondrius,384,warlock,demonology,18,4,14
Dagadon,arathor,384,warlock,demonology,24,4,20
Trilleon,eldrethalas,383,warlock,demonology,6,4,2
Greems,tichondrius,383,warlock,demonology,6,4,2
Meminissemus,ragnaros,383,warlock,demonology,12,4,8
Xandemic,tichondrius,383,warlock,demonology,12,4,8
Daggondai,tichondrius,383,warlock,demonology,12,4,8
Freshimps,blood-furnace,367,warlock,demonology,11,4,7
Sharee,azuremyst,363,warlock,demonology,11,4,7
Ärminvßuurën,barthilas,351,warlock,demonology,11,4,7
Manosverdes,tichondrius,336,warlock,demonology,9,4,5
Rycho,tichondrius,319,warlock,demonology,5,4,1
Pizzanipple,illidan,319,warlock,demonology,5,4,1
Pulpfliction,kiljaeden,304,warlock,demonology,13,4,9
Shìnedown,eonar,288,warlock,demonology,6,3,3
Naokishi,stormrage,288,warlock,demonology,6,3,3
Crtyodautr,skullcrusher,288,warlock,demonology,6,3,3
Soulruler,tichondrius,288,warlock,demonology,6,3,3
Feartool,stormrage,288,warlock,demonology,6,3,3
Zhul,nerzhul,288,warlock,demonology,6,3,3
Ëfera,nemesis,288,warlock,demonology,6,3,3
Darthael,stormrage,288,warlock,demonology,6,3,3
Keezus,area-52,288,warlock,demonology,6,3,3
Capslock,arthas,288,warlock,demonology,6,3,3
Areolaz,kelthuzad,288,warlock,demonology,6,3,3
Aeonss,stormrage,288,warlock,demonology,6,3,3
Diebydots,blackrock,288,warlock,demonology,6,3,3
Malthaél,kelthuzad,288,warlock,demonology,6,3,3
Wasca,kelthuzad,288,warlock,demonology,6,3,3
Superbroly,area-52,288,warlock,demonology,6,3,3
Chaøsbolt,area-52,288,warlock,demonology,6,3,3
Bertnasty,tichondrius,288,warlock,demonology,6,3,3
Gotty,stormrage,288,warlock,demonology,6,3,3
Domwarlock,uther,288,warlock,demonology,6,3,3
Locksoul,area-52,288,warlock,demonology,6,3,3
Emeary,kelthuzad,288,warlock,demonology,6,3,3
Azland,proudmoore,288,warlock,demonology,6,3,3
Élio,quelthalas,288,warlock,demonology,6,3,3
Tynks,mannoroth,288,warlock,demonology,6,3,3
Leonito,tichondrius,288,warlock,demonology,6,3,3
Asiopdu,tichondrius,288,warlock,demonology,6,3,3
Wiredftwx,illidan,288,warlock,demonology,6,3,3
Viejita,quelthalas,288,warlock,demonology,6,3,3
Hauntsin,hyjal,288,warlock,demonology,6,3,3
Disgustingfk,illidan,288,warlock,demonology,6,3,3
Bral,hyjal,288,warlock,demonology,6,3,3
Muldan,stormrage,288,warlock,demonology,6,3,3
Wiredftw,illidan,288,warlock,demonology,6,3,3
Hgma,tichondrius,288,warlock,demonology,6,3,3
Kodyconner,darkspear,288,warlock,demonology,6,3,3
Fancynuts,kiljaeden,288,warlock,demonology,6,3,3
Drerrday,kelthuzad,288,warlock,demonology,6,3,3
Gholra,wyrmrest-accord,288,warlock,demonology,6,3,3
Sooshi,malganis,288,warlock,demonology,6,3,3
Shutupthug,illidan,288,warlock,demonology,6,3,3
Dispator,tichondrius,288,warlock,demonology,6,3,3
Dotomizer,moonrunner,288,warlock,demonology,6,3,3
Sangala,malganis,288,warlock,demonology,6,3,3
Agonie,tichondrius,288,warlock,demonology,6,3,3
Jèdi,drenden,288,warlock,demonology,6,3,3
Greenbukakky,tichondrius,288,warlock,demonology,6,3,3
Neruvian,tichondrius,288,warlock,demonology,6,3,3
Asmodeun,malganis,288,warlock,demonology,6,3,3
Feelthefearx,ragnaros,288,warlock,demonology,6,3,3
Guldylox,kiljaeden,288,warlock,demonology,6,3,3
Fëlgibson,illidan,288,warlock,demonology,6,3,3
Molguzano,ragnaros,288,warlock,demonology,6,3,3
Poggun,tichondrius,288,warlock,demonology,6,3,3
Impbiscuit,stormrage,288,warlock,demonology,6,3,3
Brothadoinks,zuljin,288,warlock,demonology,6,3,3
Iamfear,shuhalo,288,warlock,demonology,6,3,3
Archleon,smolderthorn,288,warlock,demonology,6,3,3
Gulvandan,dathremar,288,warlock,demonology,6,3,3
Zanlockos,dalaran,288,warlock,demonology,6,3,3
Dippndotz,bleeding-hollow,288,warlock,demonology,6,3,3
Drelgun,aerie-peak,288,warlock,demonology,6,3,3
Ðemented,bleeding-hollow,288,warlock,demonology,6,3,3
Nightterrour,frostmourne,288,warlock,demonology,6,3,3
Psyløck,bleeding-hollow,288,warlock,demonology,6,3,3
Pikslol,bleeding-hollow,288,warlock,demonology,6,3,3
Khamzatt,proudmoore,288,warlock,demonology,6,3,3
Stargasms,blackrock,288,warlock,demonology,6,3,3
Yanned,hakkar,288,warlock,demonology,6,3,3
Deadlylock,gilneas,288,warlock,demonology,6,3,3
Okul,frostmourne,288,warlock,demonology,6,3,3
Nerfdemo,chogall,288,warlock,demonology,6,3,3
Schrader,sargeras,288,warlock,demonology,6,3,3
Chody,sargeras,288,warlock,demonology,6,3,3
Lilthicy,sargeras,288,warlock,demonology,6,3,3
Jennifear,sargeras,288,warlock,demonology,6,3,3
Nipz,korialstrasz,288,warlock,demonology,6,3,3
Whydemono,tichondrius,288,warlock,demonology,6,3,3
Drsauce,sargeras,288,warlock,demonology,6,3,3
Fatuglyegirl,sargeras,288,warlock,demonology,6,3,3
Notprint,sargeras,288,warlock,demonology,6,3,3
Elementzero,malorne,288,warlock,demonology,6,3,3
Saffuky,frostmourne,288,warlock,demonology,6,3,3
Widenose,agamaggan,288,warlock,demonology,6,3,3
Srcorvo,azralon,288,warlock,demonology,6,3,3
Voldmorto,azralon,288,warlock,demonology,6,3,3
Symaitiel,azralon,288,warlock,demonology,6,3,3
Khatrat,azralon,288,warlock,demonology,6,3,3
Nookíe,azralon,288,warlock,demonology,6,3,3
Cyrillus,moon-guard,288,warlock,demonology,6,3,3
Lockinha,azralon,288,warlock,demonology,6,3,3
Insanemids,tichondrius,288,warlock,demonology,6,3,3
Sweetmeat,madoran,288,warlock,demonology,6,3,3
Devi,executus,288,warlock,demonology,6,3,3
Alprazoläm,illidan,288,warlock,demonology,14,6,8
Ofcurse,stormrage,288,warlock,demonology,10,3,7
Xephine,proudmoore,288,warlock,demonology,12,3,9
Reckluss,shattered-hand,288,warlock,demonology,12,3,9
Legïõn,uldaman,288,warlock,demonology,12,3,9
Laklin,stormscale,288,warlock,demonology,12,3,9
Jagni,stormrage,288,warlock,demonology,12,3,9
Albbanoo,tichondrius,288,warlock,demonology,12,3,9
Iamlavon,area-52,288,warlock,demonology,12,3,9
Pachips,zuljin,288,warlock,demonology,12,3,9
Westhofs,tichondrius,288,warlock,demonology,12,3,9
Tatemor,barthilas,288,warlock,demonology,12,3,9
Dàmagicman,drakthul,288,warlock,demonology,12,3,9
Wineburger,frostmourne,288,warlock,demonology,12,3,9
Erc,alterac-mountains,288,warlock,demonology,12,3,9
Killvilock,kelthuzad,288,warlock,demonology,12,3,9
Crispee,azuremyst,288,warlock,demonology,12,3,9
Strax,shattered-hand,288,warlock,demonology,12,3,9
Kajayak,nazjatar,288,warlock,demonology,12,3,9
Kwrhitom,zuljin,288,warlock,demonology,12,3,9
Didntflush,blood-furnace,288,warlock,demonology,18,3,15
Gbow,malygos,287,warlock,demonology,6,3,3
Ijustsharded,area-52,255,warlock,demonology,11,3,8
Tenletters,kirin-tor,239,warlock,demonology,5,3,2
Slugworth,rivendare,239,warlock,demonology,5,3,2
Frankandbean,dawnbringer,234,warlock,demonology,7,4,3
Predictions,sargeras,234,warlock,demonology,10,5,5
Apøçàlÿpsè,firetree,234,warlock,demonology,11,5,6
Schofen,tichondrius,234,warlock,demonology,13,4,9
Annubyz,quelthalas,208,warlock,demonology,7,3,4
Cocoabuttâ,stormrage,192,warlock,demonology,4,3,1
Squibley,sargeras,192,warlock,demonology,4,3,1
Javirr,ragnaros,192,warlock,demonology,15,5,10
Knobbynobbas,stormrage,192,warlock,demonology,6,2,4
Infecçäo,stormrage,192,warlock,demonology,6,2,4
Xblessed,stormrage,192,warlock,demonology,6,2,4
Xuker,tichondrius,192,warlock,demonology,6,2,4
Sheshð,stormrage,192,warlock,demonology,6,2,4
Marty,stormrage,192,warlock,demonology,6,2,4
Shipmatelock,stormrage,192,warlock,demonology,6,2,4
Reckzet,stormrage,192,warlock,demonology,6,2,4
Cursedkash,stormrage,192,warlock,demonology,6,2,4
Incaseoffire,moon-guard,192,warlock,demonology,6,2,4
Leônidos,ghostlands,192,warlock,demonology,6,2,4
Tomathus,moon-guard,192,warlock,demonology,6,2,4
Koffay,bleeding-hollow,192,warlock,demonology,6,2,4
Zerowarlock,stormrage,192,warlock,demonology,6,2,4
Lilbiackguy,stormrage,192,warlock,demonology,6,2,4
Feardr,frostmourne,192,warlock,demonology,6,2,4
Trippednfel,stormrage,192,warlock,demonology,6,2,4
Boon,spirestone,192,warlock,demonology,6,2,4
Buboñic,area-52,192,warlock,demonology,6,2,4
Cozu,tichondrius,192,warlock,demonology,6,2,4
Darkboltz,area-52,192,warlock,demonology,6,2,4
Shadow,frostwolf,192,warlock,demonology,6,2,4
Vexidus,moon-guard,192,warlock,demonology,6,2,4
Vendareth,earthen-ring,192,warlock,demonology,6,2,4
Bagelandlock,tichondrius,192,warlock,demonology,6,2,4
Pinkypay,ragnaros,192,warlock,demonology,6,2,4
Tikdotlock,silvermoon,192,warlock,demonology,6,2,4
Sinissa,ysondre,192,warlock,demonology,6,2,4
Ceelowtf,sargeras,192,warlock,demonology,6,2,4
Barbieelf,sargeras,192,warlock,demonology,6,2,4
Wreckquiem,draka,192,warlock,demonology,6,2,4
Draindeez,sargeras,192,warlock,demonology,6,2,4
Kelifan,sargeras,192,warlock,demonology,6,2,4
Ggaayyooii,anubarak,192,warlock,demonology,6,2,4
Caesis,illidan,192,warlock,demonology,6,2,4
Síkaría,malganis,192,warlock,demonology,6,2,4
Ðeimøn,azralon,192,warlock,demonology,6,2,4
Karlangax,illidan,192,warlock,demonology,6,2,4
Pikkon,malorne,192,warlock,demonology,6,2,4
Frodosagginz,illidan,192,warlock,demonology,6,2,4
Felnoxx,dragonmaw,192,warlock,demonology,6,2,4
Irene,nagrand,192,warlock,demonology,6,2,4
Albright,azralon,192,warlock,demonology,6,2,4
Felforyouu,illidan,192,warlock,demonology,6,2,4
Capïrota,nemesis,192,warlock,demonology,6,2,4
Zevoc,tichondrius,192,warlock,demonology,6,2,4
Kaosqt,nemesis,192,warlock,demonology,6,2,4
Feldotz,illidan,192,warlock,demonology,6,2,4
Jiiggyjones,sargeras,192,warlock,demonology,6,2,4
Doomtome,moon-guard,192,warlock,demonology,6,2,4
Greenbeanzs,tichondrius,192,warlock,demonology,6,2,4
Destructo,illidan,192,warlock,demonology,6,2,4
Réliok,quelthalas,192,warlock,demonology,6,2,4
Ziroken,crushridge,192,warlock,demonology,6,2,4
Wtb,blackrock,192,warlock,demonology,6,2,4
Isømetrics,frostmourne,192,warlock,demonology,6,2,4
Stuffs,wyrmrest-accord,192,warlock,demonology,6,2,4
Warfeen,malganis,192,warlock,demonology,6,2,4
Hootenanny,korialstrasz,192,warlock,demonology,6,2,4
Firemike,kelthuzad,192,warlock,demonology,6,2,4
Brough,illidan,192,warlock,demonology,6,2,4
Jkun,malganis,192,warlock,demonology,6,2,4
Zelnokt,thrall,192,warlock,demonology,6,2,4
Agamendoir,frostmane,192,warlock,demonology,6,2,4
Borudo,thrall,192,warlock,demonology,6,2,4
Rokdas,area-52,192,warlock,demonology,6,2,4
Wesy,earthen-ring,192,warlock,demonology,6,2,4
Zalissel,proudmoore,192,warlock,demonology,6,2,4
Hentailust,kiljaeden,192,warlock,demonology,6,2,4
Dedology,area-52,192,warlock,demonology,6,2,4
Lopenx,korgath,192,warlock,demonology,6,2,4
Soulbane,tol-barad,192,warlock,demonology,6,2,4
Watchmeport,onyxia,192,warlock,demonology,6,2,4
Felpuppet,barthilas,192,warlock,demonology,6,2,4
Promancer,drakkari,192,warlock,demonology,6,2,4
Sakyameil,area-52,192,warlock,demonology,6,2,4
Qic,runetotem,192,warlock,demonology,6,2,4
Aceej,nazgrel,192,warlock,demonology,6,2,4
Anukh,emerald-dream,192,warlock,demonology,6,2,4
Yuckytoetoe,emerald-dream,192,warlock,demonology,6,2,4
Xmogfarmer,sargeras,192,warlock,demonology,6,2,4
Shadows,arygos,192,warlock,demonology,6,2,4
Draino,tichondrius,192,warlock,demonology,6,2,4
Phylox,cenarius,192,warlock,demonology,6,2,4
Psykana,barthilas,192,warlock,demonology,6,2,4
Evilempire,sargeras,192,warlock,demonology,6,2,4
Nanicide,kelthuzad,192,warlock,demonology,6,2,4
Starwitch,darkspear,192,warlock,demonology,12,2,10
Umadbruhh,tichondrius,192,warlock,demonology,12,2,10
Gàtór,kiljaeden,192,warlock,demonology,12,2,10
Miamarin,ragnaros,192,warlock,demonology,12,2,10
Vielkä,ragnaros,192,warlock,demonology,12,2,10
Sinful,darkspear,192,warlock,demonology,12,2,10
Nameflagged,arathor,192,warlock,demonology,12,2,10
Timerad,maelstrom,192,warlock,demonology,14,2,12
Taeden,jubeithos,175,warlock,demonology,11,3,8
Wårloçk,tichondrius,159,warlock,demonology,5,2,3
Tunacanthicc,moon-guard,159,warlock,demonology,5,2,3
Gartlarrey,daggerspine,158,warlock,demonology,14,3,11
Urmami,frostwolf,127,warlock,demonology,8,2,6
Africanlock,sargeras,96,warlock,demonology,3,2,1
Malleus,drakkari,96,warlock,demonology,3,2,1
Quinsnyder,zuljin,96,warlock,demonology,6,1,5
Fashon,barthilas,96,warlock,demonology,6,1,5
Injera,tichondrius,96,warlock,demonology,6,1,5
Felsparkz,tichondrius,96,warlock,demonology,6,1,5
Asetiks,tichondrius,96,warlock,demonology,6,1,5
Somethingud,tichondrius,96,warlock,demonology,6,1,5
Bfaclâssic,zuljin,96,warlock,demonology,6,1,5
Clarton,tichondrius,96,warlock,demonology,6,1,5
Halloweèn,kelthuzad,96,warlock,demonology,6,1,5
Fearedit,bleeding-hollow,96,warlock,demonology,6,1,5
Sidiouss,dreadmaul,96,warlock,demonology,6,1,5
Lazzarros,area-52,96,warlock,demonology,6,1,5
Jessewheels,tichondrius,96,warlock,demonology,6,1,5
Harukay,tichondrius,96,warlock,demonology,6,1,5
Tonyxx,tichondrius,96,warlock,demonology,6,1,5
Hsxcx,stonemaul,96,warlock,demonology,6,1,5
Osteogenesis,quelthalas,96,warlock,demonology,6,1,5
Solöw,tichondrius,96,warlock,demonology,6,1,5
Eriss,exodar,96,warlock,demonology,6,1,5
Repláced,thrall,96,warlock,demonology,6,1,5
Glizzÿ,thrall,96,warlock,demonology,6,1,5
Tormentor,malganis,96,warlock,demonology,6,1,5
Isthismeta,tichondrius,96,warlock,demonology,6,1,5
Amauder,moon-guard,96,warlock,demonology,6,1,5
Hutchyw,tichondrius,96,warlock,demonology,6,1,5
Yora,illidan,96,warlock,demonology,6,1,5
Uggaboogga,malganis,96,warlock,demonology,6,1,5
Oreo,velen,96,warlock,demonology,6,1,5
Zerosix,sargeras,96,warlock,demonology,6,1,5
Krilkore,kiljaeden,96,warlock,demonology,6,1,5
Skured,maiev,96,warlock,demonology,6,1,5
Lockz,illidan,96,warlock,demonology,6,1,5
Damdochael,bleeding-hollow,96,warlock,demonology,6,1,5
Shortbuhz,tichondrius,96,warlock,demonology,6,1,5
Borthrel,moon-guard,96,warlock,demonology,6,1,5
Thinkchair,sargeras,96,warlock,demonology,6,1,5
Bilidin,azralon,96,warlock,demonology,6,1,5
Hâunted,khazgoroth,96,warlock,demonology,6,1,5
Thugpenus,frostmane,96,warlock,demonology,6,1,5
Jazzycj,bleeding-hollow,96,warlock,demonology,6,1,5
Decrepticus,kargath,96,warlock,demonology,6,1,5
Halsonis,smolderthorn,96,warlock,demonology,6,1,5
Zíppen,proudmoore,96,warlock,demonology,6,1,5
Nùts,frostmourne,96,warlock,demonology,6,1,5
Bmó,stormrage,96,warlock,demonology,6,1,5
Erimegara,ragnaros,96,warlock,demonology,6,1,5
Wakingdead,mugthol,96,warlock,demonology,6,1,5
Cynnd,tichondrius,96,warlock,demonology,6,1,5
Malzahard,ragnaros,96,warlock,demonology,6,1,5
Varvanta,proudmoore,96,warlock,demonology,6,1,5
Ñinelyfe,frostmourne,96,warlock,demonology,6,1,5
Xalithra,moon-guard,96,warlock,demonology,6,1,5
Fluximilian,azralon,96,warlock,demonology,7,1,6
Vèigarr,frostmourne,96,warlock,demonology,9,1,8
Albus,skywall,96,warlock,demonology,12,1,11
Resima,stormscale,96,warlock,demonology,13,1,12
Kecca,azralon,96,warlock,demonology,15,1,14
Jancilianna,stormrage,96,warlock,demonology,18,1,17
Hecataeus,proudmoore,63,warlock,demonology,8,2,6
Aerindell,dalaran,48,warlock,demonology,3,1,2
Shaurial,zuljin,48,warlock,demonology,3,1,2
Eternitty,nemesis,42,warlock,demonology,11,3,8
Synysta,tichondrius,31,warlock,demonology,2,1,1
Locksyy,tichondrius,31,warlock,demonology,2,1,1
Warlow,mugthol,31,warlock,demonology,8,1,7
Camila,lightnings-blade,16,warlock,demonology,1,1,0
Nosw,bleeding-hollow,2395,warlock,destruction,114,72,42
Voidchaos,whisperwind,2392,warlock,destruction,241,144,97
Slipnslide,malganis,2357,warlock,destruction,83,55,28
Hahahahahha,stormrage,2357,warlock,destruction,95,62,33
Nos,bleeding-hollow,2351,warlock,destruction,100,64,36
Drexia,tichondrius,2349,warlock,destruction,131,88,43
Rightwaylovê,illidan,2334,warlock,destruction,203,121,82
Reverence,tichondrius,2283,warlock,destruction,101,64,37
Mengqil,tichondrius,2267,warlock,destruction,114,64,50
Solwl,shandris,2256,warlock,destruction,66,37,29
Singleaf,stormrage,2255,warlock,destruction,98,57,41
Isodjdojk,sargeras,2246,warlock,destruction,100,56,44
Dannyl,tichondrius,2241,warlock,destruction,78,50,28
Turiggyjr,tichondrius,2221,warlock,destruction,94,52,42
Diabolicalz,sargeras,2220,warlock,destruction,123,69,54
Quinsnyder,zuljin,2219,warlock,destruction,258,135,123
Demonicxs,area-52,2218,warlock,destruction,185,101,84
Mclovn,suramar,2217,warlock,destruction,221,118,103
Alucarduo,emerald-dream,2216,warlock,destruction,108,61,47
Ihavestds,tichondrius,2213,warlock,destruction,66,40,26
Kamohoalii,bleeding-hollow,2210,warlock,destruction,102,62,40
Slantsix,tichondrius,2198,warlock,destruction,90,50,40
Mcdudebro,malganis,2192,warlock,destruction,72,45,27
Butteredbun,stormrage,2179,warlock,destruction,192,111,81
Stingzz,azralon,2169,warlock,destruction,72,45,27
Heckindoggø,tichondrius,2165,warlock,destruction,87,48,39
Disgustingfk,illidan,2162,warlock,destruction,120,74,46
Søülætër,bleeding-hollow,2161,warlock,destruction,66,42,24
Sourslock,shadowsong,2158,warlock,destruction,108,70,38
Impenjoyer,tichondrius,2154,warlock,destruction,66,41,25
Playßøy,area-52,2154,warlock,destruction,78,45,33
Sonlyc,tichondrius,2153,warlock,destruction,114,60,54
Cc,hellscream,2152,warlock,destruction,202,123,79
Rizzofsparta,stormrage,2148,warlock,destruction,72,45,27
Forestfruit,tichondrius,2147,warlock,destruction,54,35,19
Truetime,tichondrius,2147,warlock,destruction,84,46,38
Woahlock,thrall,2146,warlock,destruction,64,40,24
Ihatemyson,tichondrius,2144,warlock,destruction,59,33,26
Gimmeprecog,tichondrius,2143,warlock,destruction,74,45,29
Ellynaria,nemesis,2142,warlock,destruction,78,51,27
Usainboltzz,tichondrius,2137,warlock,destruction,71,49,22
Notprint,sargeras,2136,warlock,destruction,66,42,24
Tomatobob,thrall,2136,warlock,destruction,84,44,40
Pillçosby,bleeding-hollow,2136,warlock,destruction,234,120,114
Igortrikadva,zuljin,2135,warlock,destruction,72,43,29
Leredi,stormrage,2135,warlock,destruction,146,78,68
Yifaruhún,illidan,2132,warlock,destruction,78,58,20
Bakko,tichondrius,2131,warlock,destruction,89,59,30
Cux,malganis,2131,warlock,destruction,89,47,42
Deideimeow,illidan,2130,warlock,destruction,65,42,23
Darthael,stormrage,2130,warlock,destruction,188,112,76
Butterboyx,stormrage,2129,warlock,destruction,83,51,32
Drâkedog,illidan,2128,warlock,destruction,66,38,28
Medzor,tichondrius,2128,warlock,destruction,93,53,40
Etuskaa,tichondrius,2128,warlock,destruction,199,110,89
Loopsy,stormrage,2126,warlock,destruction,115,64,51
Sockems,guldan,2125,warlock,destruction,90,51,39
Demonman,kirin-tor,2124,warlock,destruction,72,41,31
Rizzard,lightnings-blade,2123,warlock,destruction,107,64,43
Oopsprecog,tichondrius,2123,warlock,destruction,120,64,56
Horror,moon-guard,2123,warlock,destruction,93,47,46
Zyzx,malganis,2120,warlock,destruction,59,37,22
Ztlivid,area-52,2120,warlock,destruction,173,103,70
Neruvian,tichondrius,2120,warlock,destruction,66,39,27
Insanetroll,stormrage,2119,warlock,destruction,78,54,24
Hudwinx,illidan,2119,warlock,destruction,78,47,31
Drakedogee,illidan,2119,warlock,destruction,66,35,31
Äran,azralon,2119,warlock,destruction,72,36,36
Drböb,area-52,2118,warlock,destruction,70,43,27
Jonboyy,illidan,2118,warlock,destruction,189,97,92
Ðlrwêcïûj,stormrage,2117,warlock,destruction,84,56,28
Bananapan,tichondrius,2116,warlock,destruction,66,44,22
Starta,tichondrius,2116,warlock,destruction,66,39,27
Kyranu,tichondrius,2116,warlock,destruction,138,77,61
Dyenamik,stormrage,2116,warlock,destruction,65,36,29
Realization,illidan,2115,warlock,destruction,42,30,12
Epícburn,illidan,2115,warlock,destruction,66,40,26
Minglocked,proudmoore,2114,warlock,destruction,54,37,17
Usurpest,bleeding-hollow,2114,warlock,destruction,79,50,29
Realgodlock,proudmoore,2114,warlock,destruction,170,94,76
Luvana,kelthuzad,2111,warlock,destruction,143,83,60
Dean,frostmourne,2111,warlock,destruction,66,33,33
Instabilityx,tichondrius,2110,warlock,destruction,77,48,29
Ghoul,demon-soul,2109,warlock,destruction,60,35,25
Dxxz,tichondrius,2109,warlock,destruction,115,63,52
Thumperrz,frostmourne,2108,warlock,destruction,89,47,42
Xavier,wyrmrest-accord,2107,warlock,destruction,111,62,49
Mjn,tichondrius,2107,warlock,destruction,100,51,49
Chaosboltex,tichondrius,2106,warlock,destruction,72,41,31
Vapeboi,bleeding-hollow,2106,warlock,destruction,84,47,37
Jcm,hyjal,2104,warlock,destruction,59,41,18
Dottle,frostmourne,2104,warlock,destruction,66,39,27
Whodatman,illidan,2103,warlock,destruction,60,41,19
Dae,burning-legion,2103,warlock,destruction,59,38,21
Bufflockmore,tichondrius,2103,warlock,destruction,112,62,50
Kaytoxic,tichondrius,2103,warlock,destruction,72,39,33
Ohmend,thrall,2102,warlock,destruction,69,45,24
Disembolt,illidan,2102,warlock,destruction,66,41,25
Breeped,tichondrius,2102,warlock,destruction,150,91,59
Rainbowdate,tichondrius,2101,warlock,destruction,36,29,7
Felfeels,area-52,2101,warlock,destruction,114,68,46
Abrocket,alleria,2101,warlock,destruction,112,58,54
Implify,tichondrius,2101,warlock,destruction,142,73,69
Dodgeykun,khaz-modan,2100,warlock,destruction,89,55,34
Kryl,kiljaeden,2100,warlock,destruction,66,39,27
Grandmama,tichondrius,2095,warlock,destruction,77,47,30
Colombø,gallywix,2090,warlock,destruction,175,93,82
Spicywhite,tichondrius,2089,warlock,destruction,126,65,61
Drugmuffin,tichondrius,2084,warlock,destruction,77,43,34
Marcelium,greymane,2082,warlock,destruction,59,38,21
Xiyangpvp,tichondrius,2079,warlock,destruction,90,46,44
Locean,tichondrius,2074,warlock,destruction,112,60,52
Babyaga,illidan,2073,warlock,destruction,103,50,53
Hollowl,tichondrius,2072,warlock,destruction,95,64,31
Thugonomicz,demon-soul,2071,warlock,destruction,54,37,17
Sinápsís,ragnaros,2067,warlock,destruction,60,38,22
Mayelinvail,moon-guard,2067,warlock,destruction,166,94,72
Warzog,wyrmrest-accord,2066,warlock,destruction,96,54,42
Mjndewb,tichondrius,2064,warlock,destruction,78,58,20
Demofire,tichondrius,2063,warlock,destruction,63,39,24
Ribman,stormrage,2061,warlock,destruction,78,38,40
Nightmanx,sargeras,2057,warlock,destruction,101,54,47
Revenid,tichondrius,2049,warlock,destruction,72,42,30
Scørrgx,azralon,2049,warlock,destruction,102,53,49
Alchandil,tichondrius,2047,warlock,destruction,60,39,21
Koitis,tichondrius,2046,warlock,destruction,74,45,29
Tichonkimc,tichondrius,2045,warlock,destruction,101,54,47
Foresthills,sargeras,2044,warlock,destruction,102,53,49
Uwantpeach,tichondrius,2043,warlock,destruction,46,34,12
Brainless,tichondrius,2040,warlock,destruction,109,66,43
Marshyw,tichondrius,2039,warlock,destruction,54,31,23
Napiersdot,tichondrius,2039,warlock,destruction,78,41,37
Salanzø,bleeding-hollow,2030,warlock,destruction,60,35,25
Payn,kiljaeden,2030,warlock,destruction,138,71,67
Idotû,tichondrius,2025,warlock,destruction,221,116,105
Nvlnx,tichondrius,2023,warlock,destruction,143,77,66
Destroyy,greymane,2021,warlock,destruction,60,33,27
Hrrpeuh,zuljin,2017,warlock,destruction,88,46,42
Sweatystain,tichondrius,2015,warlock,destruction,129,77,52
Duukka,malganis,2015,warlock,destruction,96,53,43
Zeari,sargeras,2014,warlock,destruction,115,59,56
Genzy,tichondrius,2010,warlock,destruction,148,76,72
Reallymagic,malganis,2008,warlock,destruction,167,100,67
Kaidow,tichondrius,2006,warlock,destruction,114,67,47
Babybolt,frostmourne,2005,warlock,destruction,102,50,52
Biubius,tichondrius,2001,warlock,destruction,86,56,30
Vyrecks,hyjal,2001,warlock,destruction,83,47,36
Eqx,illidan,2000,warlock,destruction,86,52,34
Venticm,tichondrius,1997,warlock,destruction,60,36,24
Dàmagicman,drakthul,1996,warlock,destruction,84,52,32
Darkmagicc,tichondrius,1995,warlock,destruction,96,48,48
Eav,area-52,1991,warlock,destruction,66,41,25
Xertling,sargeras,1990,warlock,destruction,67,46,21
Qp,thrall,1989,warlock,destruction,36,27,9
Kaytoxics,tichondrius,1988,warlock,destruction,24,21,3
Sarcophagus,duskwood,1987,warlock,destruction,168,83,85
Kruxxqt,illidan,1986,warlock,destruction,337,174,163
Sitomey,emerald-dream,1982,warlock,destruction,66,38,28
Dragonixs,ragnaros,1980,warlock,destruction,136,78,58
Tacobelf,magtheridon,1980,warlock,destruction,129,73,56
Zhul,nerzhul,1979,warlock,destruction,63,40,23
Sereniaa,sargeras,1977,warlock,destruction,56,32,24
Fotmspec,area-52,1976,warlock,destruction,66,46,20
Narila,firetree,1976,warlock,destruction,48,29,19
Zuelu,tichondrius,1975,warlock,destruction,84,54,30
Hàrrydotter,darkspear,1975,warlock,destruction,94,52,42
Maureenn,mannoroth,1973,warlock,destruction,109,57,52
Stankybootie,malganis,1970,warlock,destruction,79,53,26
Calvarr,bleeding-hollow,1970,warlock,destruction,77,45,32
Marware,quelthalas,1970,warlock,destruction,72,37,35
Trengodx,area-52,1968,warlock,destruction,66,47,19
Pigii,tichondrius,1967,warlock,destruction,42,28,14
Salival,chogall,1965,warlock,destruction,51,36,15
Dazu,illidan,1965,warlock,destruction,125,66,59
Mizmagius,moon-guard,1965,warlock,destruction,65,31,34
Hellsparks,malganis,1964,warlock,destruction,54,33,21
Boltsnhoes,illidan,1961,warlock,destruction,78,46,32
Radicalz,ragnaros,1959,warlock,destruction,55,30,25
Blackyeonnam,tichondrius,1959,warlock,destruction,86,46,40
Cvoaw,bonechewer,1958,warlock,destruction,90,49,41
Albbanoo,tichondrius,1958,warlock,destruction,149,78,71
Vexe,tichondrius,1957,warlock,destruction,110,67,43
Wzxx,tichondrius,1956,warlock,destruction,206,112,94
Mazewl,illidan,1955,warlock,destruction,117,71,46
Seangnong,tichondrius,1953,warlock,destruction,54,34,20
Soulbane,tol-barad,1951,warlock,destruction,33,22,11
Deadlpoo,stormscale,1951,warlock,destruction,188,97,91
Truenatestes,proudmoore,1950,warlock,destruction,175,88,87
Daddybolt,blackrock,1948,warlock,destruction,52,28,24
Heresucacok,frostmourne,1947,warlock,destruction,36,22,14
Rakshama,chogall,1944,warlock,destruction,45,26,19
Zyltan,tichondrius,1938,warlock,destruction,36,25,11
Vileröze,zuljin,1938,warlock,destruction,114,62,52
Balveer,tichondrius,1937,warlock,destruction,35,21,14
Demondisco,tichondrius,1937,warlock,destruction,57,34,23
Zchenboom,tichondrius,1935,warlock,destruction,48,32,16
Sosahawk,stormrage,1933,warlock,destruction,149,94,55
Roxmysox,darkspear,1930,warlock,destruction,102,54,48
Beegbeechy,nesingwary,1929,warlock,destruction,72,41,31
Dommön,ragnaros,1929,warlock,destruction,96,50,46
Bismorc,frostmourne,1928,warlock,destruction,52,31,21
Dazedl,stormrage,1928,warlock,destruction,39,23,16
Chaosbolt,bloodhoof,1927,warlock,destruction,96,50,46
Yuoalx,tichondrius,1922,warlock,destruction,72,38,34
Intentionz,sargeras,1921,warlock,destruction,65,39,26
Deathair,tichondrius,1918,warlock,destruction,54,31,23
Il,nerzhul,1915,warlock,destruction,30,25,5
Warlockwars,amanthul,1915,warlock,destruction,267,134,133
Ignorai,illidan,1913,warlock,destruction,148,82,66
Dxhusky,tichondrius,1912,warlock,destruction,66,37,29
Nðm,tichondrius,1912,warlock,destruction,120,58,62
Freddiewill,tichondrius,1911,warlock,destruction,113,67,46
Feetsampler,stormrage,1911,warlock,destruction,87,44,43
Skynflute,tichondrius,1910,warlock,destruction,40,21,19
Audition,ragnaros,1910,warlock,destruction,114,55,59
Dreadful,frostmourne,1907,warlock,destruction,81,49,32
Reneqtxo,frostmourne,1906,warlock,destruction,92,60,32
Whatisthis,tichondrius,1906,warlock,destruction,36,20,16
Bronzel,tichondrius,1905,warlock,destruction,30,23,7
Yoyoyosup,stormrage,1905,warlock,destruction,48,32,16
Coilsinfive,tichondrius,1904,warlock,destruction,42,27,15
Famerap,tichondrius,1902,warlock,destruction,42,29,13
Almostoogood,illidan,1902,warlock,destruction,42,25,17
Laiquisha,zuljin,1900,warlock,destruction,49,29,20
Ozmat,spirestone,1900,warlock,destruction,36,20,16
Amez,grizzly-hills,1900,warlock,destruction,60,33,27
Bigjmmywiggl,illidan,1898,warlock,destruction,109,67,42
Tott,hellscream,1898,warlock,destruction,50,26,24
Scatz,sargeras,1897,warlock,destruction,36,33,3
Fingerslock,malganis,1897,warlock,destruction,102,52,50
Bod,bleeding-hollow,1896,warlock,destruction,59,34,25
Boxtrolls,ragnaros,1896,warlock,destruction,54,31,23
Jaspieno,illidan,1895,warlock,destruction,54,34,20
Belandyr,stormrage,1893,warlock,destruction,36,20,16
Stilltrilly,tichondrius,1892,warlock,destruction,36,25,11
Oldwing,illidan,1892,warlock,destruction,143,75,68
Moosejockey,stormrage,1890,warlock,destruction,30,20,10
Warsmock,tichondrius,1887,warlock,destruction,49,28,21
Wwlock,area-52,1887,warlock,destruction,164,86,78
Naughtybolts,sargeras,1884,warlock,destruction,59,41,18
Toggafputuhs,illidan,1884,warlock,destruction,42,26,16
Darkjambii,tichondrius,1884,warlock,destruction,76,46,30
Madthelock,sargeras,1884,warlock,destruction,42,20,22
Maadhum,illidan,1884,warlock,destruction,78,33,45
Jfet,sargeras,1883,warlock,destruction,35,24,11
Zettian,quelthalas,1883,warlock,destruction,54,30,24
Warcalk,stormrage,1882,warlock,destruction,60,37,23
Benafflockz,kelthuzad,1882,warlock,destruction,77,46,31
Wampeter,azshara,1882,warlock,destruction,92,50,42
Bigulinhos,nemesis,1881,warlock,destruction,48,27,21
Çxb,tichondrius,1879,warlock,destruction,89,50,39
Humanwarlock,spirestone,1879,warlock,destruction,57,32,25
Neverending,malganis,1878,warlock,destruction,49,28,21
Drazh,area-52,1876,warlock,destruction,63,36,27
Tommybahama,velen,1875,warlock,destruction,76,45,31
Evilclass,tichondrius,1874,warlock,destruction,60,42,18
Illinkin,illidan,1874,warlock,destruction,144,84,60
Pikslol,bleeding-hollow,1874,warlock,destruction,48,27,21
Løckyun,tichondrius,1873,warlock,destruction,30,24,6
Shinjuro,stormrage,1873,warlock,destruction,60,37,23
Dottcha,blackrock,1873,warlock,destruction,90,48,42
Locodwarf,frostmourne,1873,warlock,destruction,274,136,138
Zarinista,veknilash,1872,warlock,destruction,91,47,44
Twinklockxx,mannoroth,1872,warlock,destruction,143,66,77
Millidots,bleeding-hollow,1871,warlock,destruction,60,35,25
Hommer,tichondrius,1870,warlock,destruction,57,34,23
Bigdamege,tichondrius,1870,warlock,destruction,67,39,28
Ñpç,bleeding-hollow,1870,warlock,destruction,89,48,41
Gucciflops,bleeding-hollow,1870,warlock,destruction,66,33,33
Espanyolo,zuljin,1868,warlock,destruction,84,58,26
Nasn,black-dragonflight,1868,warlock,destruction,80,51,29
Slurper,frostwolf,1867,warlock,destruction,36,23,13
Amazingamez,sargeras,1867,warlock,destruction,78,42,36
Inmøtion,tichondrius,1867,warlock,destruction,48,25,23
Lopenx,korgath,1866,warlock,destruction,182,91,91
Farathos,ragnaros,1865,warlock,destruction,166,98,68
Pheadas,deathwing,1865,warlock,destruction,42,20,22
Footyl,stormrage,1864,warlock,destruction,54,39,15
Palumorl,deathwing,1864,warlock,destruction,36,23,13
Darkwidow,sargeras,1863,warlock,destruction,200,102,98
Scathey,area-52,1862,warlock,destruction,168,99,69
Headbolterx,tichondrius,1860,warlock,destruction,39,24,15
Drakwlya,tichondrius,1859,warlock,destruction,48,30,18
Shutkax,sargeras,1858,warlock,destruction,42,30,12
Necrosade,tichondrius,1858,warlock,destruction,48,30,18
Aryoc,ragnaros,1857,warlock,destruction,126,74,52
Dottx,frostmourne,1856,warlock,destruction,48,32,16
Luhgëek,tichondrius,1856,warlock,destruction,47,29,18
Zadelyn,whisperwind,1855,warlock,destruction,30,23,7
Snerp,frostmourne,1855,warlock,destruction,135,78,57
Soulrulerxc,tichondrius,1854,warlock,destruction,42,27,15
Aeaea,bleeding-hollow,1854,warlock,destruction,89,52,37
Mongobros,illidan,1853,warlock,destruction,54,35,19
Darksummoner,kaelthas,1853,warlock,destruction,84,46,38
Immolate,eitrigg,1852,warlock,destruction,48,29,19
Odjure,zuljin,1852,warlock,destruction,47,27,20
Milkdrunk,blackrock,1852,warlock,destruction,119,61,58
Dragoska,kiljaeden,1851,warlock,destruction,60,38,22
Homeboyardee,the-venture-co,1851,warlock,destruction,72,37,35
Naughtybôlts,sargeras,1850,warlock,destruction,57,39,18
Ændrew,darkspear,1850,warlock,destruction,59,37,22
Wodwarlock,thrall,1850,warlock,destruction,45,27,18
Mistrnesbitt,malganis,1850,warlock,destruction,48,25,23
Panna,tichondrius,1850,warlock,destruction,296,148,148
Synkz,blood-furnace,1849,warlock,destruction,42,24,18
Pernicious,bladefist,1849,warlock,destruction,221,104,117
Gløcked,area-52,1848,warlock,destruction,30,20,10
Lamaso,area-52,1848,warlock,destruction,78,50,28
Róckroad,lightnings-blade,1848,warlock,destruction,54,33,21
Threeinches,kelthuzad,1848,warlock,destruction,170,100,70
Mycelium,greymane,1848,warlock,destruction,34,20,14
Kaelith,kelthuzad,1848,warlock,destruction,109,53,56
Löcked,illidan,1846,warlock,destruction,42,36,6
Brazlem,blackrock,1846,warlock,destruction,49,34,15
Verbzz,tichondrius,1846,warlock,destruction,36,23,13
Krokusx,illidan,1846,warlock,destruction,156,88,68
Corkeý,azuremyst,1846,warlock,destruction,90,49,41
Lemmepvponu,illidan,1846,warlock,destruction,59,28,31
Demonicsnap,bleeding-hollow,1845,warlock,destruction,130,75,55
Barbieelf,sargeras,1845,warlock,destruction,226,120,106
Omegapasta,illidan,1845,warlock,destruction,84,42,42
Eskyx,tichondrius,1845,warlock,destruction,53,26,27
Eldenjohn,proudmoore,1844,warlock,destruction,30,24,6
Zírds,stormrage,1844,warlock,destruction,60,33,27
Destructo,illidan,1844,warlock,destruction,72,37,35
Kartharian,wyrmrest-accord,1844,warlock,destruction,184,93,91
Sithaholic,wildhammer,1843,warlock,destruction,72,39,33
Chilipeppa,wyrmrest-accord,1842,warlock,destruction,36,27,9
Jierd,tichondrius,1842,warlock,destruction,52,32,20
Herpalock,illidan,1842,warlock,destruction,78,34,44
Rocketman,hydraxis,1841,warlock,destruction,48,32,16
Vialdkaseun,muradin,1841,warlock,destruction,47,28,19
Kayersoul,tichondrius,1841,warlock,destruction,36,20,16
Cosmosxx,illidan,1840,warlock,destruction,54,37,17
Benafflockzz,kelthuzad,1840,warlock,destruction,66,44,22
Mindheist,stormrage,1840,warlock,destruction,48,29,19
Indelock,drenden,1840,warlock,destruction,42,24,18
Rotfull,burning-legion,1840,warlock,destruction,51,29,22
Razlock,moon-guard,1839,warlock,destruction,224,123,101
Enter,saurfang,1838,warlock,destruction,36,24,12
Zimer,moon-guard,1837,warlock,destruction,84,52,32
Philsbad,lightbringer,1837,warlock,destruction,122,70,52
Dxhusky,illidan,1837,warlock,destruction,60,32,28
Kekbolt,tichondrius,1836,warlock,destruction,53,33,20
Deathcoill,frostmourne,1836,warlock,destruction,54,32,22
Wife,bleeding-hollow,1836,warlock,destruction,60,31,29
Sibëria,quelthalas,1835,warlock,destruction,48,35,13
Klumzey,tichondrius,1835,warlock,destruction,67,42,25
Badstep,tichondrius,1835,warlock,destruction,51,30,21
Charlieo,barthilas,1835,warlock,destruction,132,74,58
Tonyxx,tichondrius,1835,warlock,destruction,112,58,54
Goal,malganis,1835,warlock,destruction,50,25,25
Gigabiga,area-52,1834,warlock,destruction,24,20,4
Soragen,barthilas,1834,warlock,destruction,54,37,17
Curse,agamaggan,1834,warlock,destruction,120,69,51
Gotthmog,nerzhul,1833,warlock,destruction,48,30,18
Dustywlx,area-52,1833,warlock,destruction,79,46,33
Dotorama,sargeras,1832,warlock,destruction,53,33,20
Sidgnosis,stormrage,1831,warlock,destruction,237,127,110
Cumbledor,bleeding-hollow,1831,warlock,destruction,44,23,21
Shadowhax,area-52,1831,warlock,destruction,122,60,62
Scarified,illidan,1831,warlock,destruction,72,34,38
Barovir,tichondrius,1830,warlock,destruction,54,33,21
Buu,veknilash,1830,warlock,destruction,54,33,21
Rhelialock,stormrage,1830,warlock,destruction,36,21,15
Gigglywiggly,illidan,1829,warlock,destruction,48,33,15
Brillina,windrunner,1829,warlock,destruction,60,30,30
Nezlock,moon-guard,1829,warlock,destruction,92,45,47
Denotate,zuljin,1828,warlock,destruction,115,65,50
Koramoz,area-52,1828,warlock,destruction,176,92,84
Chaosbôlt,proudmoore,1827,warlock,destruction,120,66,54
Evanylock,proudmoore,1826,warlock,destruction,75,45,30
Shequita,stormrage,1825,warlock,destruction,48,37,11
Agaros,zuljin,1825,warlock,destruction,49,30,19
Necroboi,alterac-mountains,1825,warlock,destruction,52,29,23
Kissmybolts,frostmourne,1825,warlock,destruction,83,42,41
Vulcke,kelthuzad,1825,warlock,destruction,59,29,30
Emospec,chogall,1824,warlock,destruction,54,35,19
Exilegd,proudmoore,1824,warlock,destruction,89,57,32
Dipicrowcaw,tichondrius,1822,warlock,destruction,24,19,5
Vilebeing,frostmourne,1822,warlock,destruction,66,46,20
Hakai,bleeding-hollow,1822,warlock,destruction,92,57,35
Badhombre,tichondrius,1821,warlock,destruction,48,31,17
Dadtired,tichondrius,1820,warlock,destruction,54,37,17
Chaøz,bleeding-hollow,1820,warlock,destruction,48,32,16
Tm,dalaran,1820,warlock,destruction,53,34,19
Soulbane,jubeithos,1820,warlock,destruction,30,19,11
Evilempire,sargeras,1820,warlock,destruction,54,30,24
Nahalmaeim,tichondrius,1819,warlock,destruction,37,25,12
Azaradx,sargeras,1819,warlock,destruction,84,54,30
Yipláw,stormrage,1819,warlock,destruction,36,23,13
Puginlock,illidan,1819,warlock,destruction,60,38,22
Chazzlock,area-52,1819,warlock,destruction,30,19,11
Slurpme,stormscale,1819,warlock,destruction,48,30,18
Thegodd,nemesis,1819,warlock,destruction,66,31,35
Vamprixlz,illidan,1818,warlock,destruction,49,34,15
Haì,illidan,1818,warlock,destruction,60,37,23
Veklen,tichondrius,1818,warlock,destruction,64,36,28
Bumbleebolt,azralon,1817,warlock,destruction,24,19,5
Firenzy,dalaran,1817,warlock,destruction,67,39,28
Antinurse,bleeding-hollow,1817,warlock,destruction,78,45,33
Dralok,area-52,1817,warlock,destruction,66,38,28
Lockonomicz,tichondrius,1817,warlock,destruction,42,24,18
Feinnx,dalaran,1817,warlock,destruction,70,38,32
Zehoc,thrall,1817,warlock,destruction,102,55,47
Derok,bleeding-hollow,1817,warlock,destruction,277,144,133
Dampenedx,bleeding-hollow,1817,warlock,destruction,58,30,28
Wraithlord,chogall,1816,warlock,destruction,51,32,19
Screampies,tichondrius,1816,warlock,destruction,52,30,22
Brujoalfa,ragnaros,1816,warlock,destruction,169,95,74
Doclove,destromath,1816,warlock,destruction,149,83,66
Tribulatiön,moon-guard,1816,warlock,destruction,440,235,205
Noxfear,azralon,1815,warlock,destruction,72,51,21
Dunnin,dalaran,1815,warlock,destruction,36,22,14
Savlonicsego,stormrage,1815,warlock,destruction,78,45,33
Frappucino,wyrmrest-accord,1814,warlock,destruction,30,23,7
Nozyroh,emerald-dream,1814,warlock,destruction,41,25,16
Slpxoxo,sargeras,1814,warlock,destruction,54,30,24
Mythdot,ragnaros,1814,warlock,destruction,245,133,112
Crayonchewer,alleria,1814,warlock,destruction,60,31,29
Zaef,kelthuzad,1814,warlock,destruction,88,45,43
Starwitch,darkspear,1814,warlock,destruction,125,59,66
Archimondee,rivendare,1814,warlock,destruction,114,53,61
Kymamd,sargeras,1813,warlock,destruction,32,21,11
Wiredftw,illidan,1813,warlock,destruction,30,19,11
Sacalawia,drakkari,1813,warlock,destruction,45,27,18
Monika,anetheron,1813,warlock,destruction,58,32,26
Lokintots,darkspear,1812,warlock,destruction,36,29,7
Bodhisage,kelthuzad,1812,warlock,destruction,24,19,5
Zauber,magtheridon,1812,warlock,destruction,44,29,15
Destructio,tichondrius,1812,warlock,destruction,54,31,23
Galfear,malganis,1812,warlock,destruction,207,116,91
Deammon,tichondrius,1811,warlock,destruction,60,40,20
Bellaswans,hyjal,1811,warlock,destruction,54,33,21
Naroy,malygos,1811,warlock,destruction,38,21,17
Mcrfan,illidan,1810,warlock,destruction,29,24,5
Fenriakshog,zuljin,1810,warlock,destruction,36,23,13
Tìdals,zuljin,1810,warlock,destruction,44,28,16
Alchan,tichondrius,1810,warlock,destruction,65,38,27
Fartymårty,tichondrius,1810,warlock,destruction,36,21,15
Embrz,area-52,1810,warlock,destruction,54,31,23
Omnireaper,tichondrius,1810,warlock,destruction,54,29,25
Berkz,stormrage,1810,warlock,destruction,66,33,33
Oof,dalaran,1809,warlock,destruction,30,22,8
Ashlet,kelthuzad,1809,warlock,destruction,48,30,18
Brutalsummon,frostmourne,1809,warlock,destruction,105,59,46
Kyrmax,malganis,1809,warlock,destruction,138,68,70
Emeraldflame,turalyon,1808,warlock,destruction,60,44,16
Fanzhiyi,illidan,1808,warlock,destruction,43,27,16
Daimonic,bronzebeard,1808,warlock,destruction,84,52,32
Blackchinese,zuljin,1808,warlock,destruction,138,73,65
Niava,tichondrius,1808,warlock,destruction,54,28,26
Drthiccbolts,malganis,1807,warlock,destruction,47,29,18
Drdoom,sargeras,1807,warlock,destruction,36,22,14
Cheqmate,moon-guard,1807,warlock,destruction,61,36,25
Xivra,thrall,1807,warlock,destruction,59,34,25
Aidadeshu,tichondrius,1807,warlock,destruction,60,32,28
Elfwarlock,aerie-peak,1806,warlock,destruction,40,25,15
Zakhim,zuljin,1806,warlock,destruction,124,74,50
Åbyssal,stormrage,1806,warlock,destruction,159,94,65
Belenas,tichondrius,1806,warlock,destruction,48,28,20
Amgs,frostmourne,1806,warlock,destruction,167,88,79
Nigthdeath,nemesis,1806,warlock,destruction,173,91,82
Rotshtëin,tichondrius,1806,warlock,destruction,173,91,82
Döremi,tichondrius,1805,warlock,destruction,48,28,20
Veleza,kiljaeden,1805,warlock,destruction,82,47,35
Cenich,darkspear,1804,warlock,destruction,67,43,24
Trixtah,illidan,1804,warlock,destruction,36,23,13
Meatmanxtrem,sargeras,1804,warlock,destruction,60,33,27
Xhrine,frostmourne,1803,warlock,destruction,47,31,16
Expiredfood,stormreaver,1803,warlock,destruction,42,26,16
Pillçosby,tichondrius,1803,warlock,destruction,36,22,14
Neghros,illidan,1803,warlock,destruction,101,52,49
Scârecrow,stormrage,1802,warlock,destruction,72,46,26
Vexidus,moon-guard,1802,warlock,destruction,102,60,42
Mamosa,stormrage,1801,warlock,destruction,72,52,20
Romdi,tichondrius,1801,warlock,destruction,52,32,20
Geekmonster,tichondrius,1801,warlock,destruction,54,33,21
Ghettobeluga,area-52,1801,warlock,destruction,53,30,23
Rettek,bleeding-hollow,1801,warlock,destruction,48,27,21
Karimbenzema,tichondrius,1801,warlock,destruction,54,30,24
Frightbright,sargeras,1801,warlock,destruction,45,25,20
Enkryption,dalaran,1801,warlock,destruction,42,23,19
Seltzi,illidan,1801,warlock,destruction,47,25,22
Dauntx,proudmoore,1801,warlock,destruction,66,33,33
Necrochemist,frostmane,1800,warlock,destruction,24,19,5
Xervas,frostmourne,1800,warlock,destruction,54,33,21
Soulbane,nemesis,1800,warlock,destruction,36,22,14
Warmstreak,blackrock,1800,warlock,destruction,48,28,20
Lapidate,malganis,1800,warlock,destruction,59,33,26
Leruss,zangarmarsh,1800,warlock,destruction,55,30,25
Matafé,kelthuzad,1799,warlock,destruction,42,28,14
Cowboydann,malganis,1799,warlock,destruction,30,19,11
Missinhim,shattered-halls,1798,warlock,destruction,24,19,5
Doughnut,mugthol,1798,warlock,destruction,90,50,40
Gianni,chogall,1798,warlock,destruction,66,36,30
Sherlóck,duskwood,1798,warlock,destruction,54,28,26
Cróhns,bleeding-hollow,1797,warlock,destruction,139,86,53
Glôck,lightbringer,1797,warlock,destruction,103,51,52
Kogath,thunderlord,1796,warlock,destruction,116,66,50
Vonsteevan,area-52,1795,warlock,destruction,51,33,18
Ruination,cenarius,1795,warlock,destruction,42,22,20
Puchador,sargeras,1795,warlock,destruction,144,74,70
Krikxy,tichondrius,1793,warlock,destruction,56,31,25
Feardotjpg,stormrage,1791,warlock,destruction,42,29,13
Shadøwy,nemesis,1791,warlock,destruction,184,102,82
Kyleslock,illidan,1790,warlock,destruction,29,21,8
Daylyt,sargeras,1790,warlock,destruction,33,22,11
Lockdotsftw,illidan,1790,warlock,destruction,54,28,26
Løcalplugxø,barthilas,1786,warlock,destruction,137,86,51
Whitexzz,tichondrius,1786,warlock,destruction,42,24,18
Leeroydots,area-52,1785,warlock,destruction,66,42,24
Yeepzbytre,bleeding-hollow,1785,warlock,destruction,102,62,40
Birez,kelthuzad,1785,warlock,destruction,104,58,46
Deathhawkz,ravencrest,1784,warlock,destruction,36,24,12
Wreyz,mannoroth,1783,warlock,destruction,72,39,33
Nevermindxd,barthilas,1783,warlock,destruction,66,32,34
Finalboss,tichondrius,1782,warlock,destruction,48,33,15
Positivity,thunderhorn,1782,warlock,destruction,48,30,18
Øutbreak,thrall,1782,warlock,destruction,56,33,23
Tonnon,stormrage,1782,warlock,destruction,84,47,37
Killabeesack,tichondrius,1780,warlock,destruction,73,45,28
Duckboji,tichondrius,1780,warlock,destruction,56,33,23
Latchlock,malganis,1780,warlock,destruction,203,109,94
Dupapad,stormrage,1780,warlock,destruction,65,31,34
Wineburger,frostmourne,1779,warlock,destruction,60,40,20
Nahz,tichondrius,1779,warlock,destruction,42,24,18
Jakjub,kelthuzad,1778,warlock,destruction,54,31,23
Eggpower,tichondrius,1776,warlock,destruction,52,27,25
Ralerhard,kelthuzad,1775,warlock,destruction,64,40,24
Grq,stormrage,1775,warlock,destruction,69,43,26
Hellparks,malganis,1774,warlock,destruction,42,27,15
Suaveaye,tichondrius,1774,warlock,destruction,60,32,28
Loksoflove,tichondrius,1773,warlock,destruction,30,21,9
Screwed,tichondrius,1773,warlock,destruction,96,49,47
Tenaciousd,malganis,1772,warlock,destruction,42,21,21
Alùcärd,tichondrius,1772,warlock,destruction,54,25,29
Azlloa,tichondrius,1771,warlock,destruction,42,27,15
Plasticware,korgath,1771,warlock,destruction,48,29,19
Andelaylas,tichondrius,1771,warlock,destruction,95,57,38
Twilson,moon-guard,1771,warlock,destruction,54,29,25
Anujy,moon-guard,1769,warlock,destruction,78,53,25
Nùts,frostmourne,1769,warlock,destruction,42,27,15
Urukái,dalaran,1769,warlock,destruction,117,65,52
Gladyr,frostmourne,1768,warlock,destruction,54,28,26
Lifeinsuranc,tichondrius,1767,warlock,destruction,30,19,11
Donutd,stormrage,1767,warlock,destruction,36,22,14
Zunexx,malganis,1764,warlock,destruction,48,27,21
Punstable,tichondrius,1763,warlock,destruction,121,65,56
Kakistocracy,kelthuzad,1761,warlock,destruction,30,23,7
Mursay,tichondrius,1761,warlock,destruction,42,30,12
Paparoxy,illidan,1761,warlock,destruction,60,30,30
Marshyxd,tichondrius,1759,warlock,destruction,48,23,25
Gottawiz,illidan,1758,warlock,destruction,60,32,28
Nick,llane,1757,warlock,destruction,36,23,13
Eggós,sargeras,1757,warlock,destruction,333,164,169
Chêrrypopper,proudmoore,1755,warlock,destruction,67,41,26
Squishyboy,tichondrius,1755,warlock,destruction,57,30,27
Ravëncläw,quelthalas,1755,warlock,destruction,67,35,32
Isoldmysoul,stormrage,1755,warlock,destruction,114,54,60
Flattsl,tichondrius,1755,warlock,destruction,84,39,45
Obliceress,crushridge,1754,warlock,destruction,42,26,16
Ibrroski,proudmoore,1753,warlock,destruction,24,20,4
Symaitiel,azralon,1751,warlock,destruction,96,51,45
Éx,jubeithos,1748,warlock,destruction,47,30,17
Bolsheivik,dentarg,1748,warlock,destruction,94,52,42
Lockfaceguy,agamaggan,1747,warlock,destruction,75,39,36
Qualio,thrall,1746,warlock,destruction,129,62,67
Devi,executus,1745,warlock,destruction,30,19,11
Magnetix,arthas,1744,warlock,destruction,181,93,88
Podda,shuhalo,1743,warlock,destruction,53,33,20
Thinktank,tichondrius,1743,warlock,destruction,42,25,17
Kairiesmirk,illidan,1743,warlock,destruction,123,65,58
Raxxis,moon-guard,1742,warlock,destruction,29,19,10
Dewandoritos,kelthuzad,1742,warlock,destruction,36,22,14
Flake,kelthuzad,1741,warlock,destruction,62,37,25
Halloweèn,kelthuzad,1741,warlock,destruction,131,74,57
Pkzy,azralon,1741,warlock,destruction,36,19,17
Vallàx,area-52,1741,warlock,destruction,150,78,72
Bouldrlickr,dragonmaw,1740,warlock,destruction,48,30,18
Darknessgodd,goldrinn,1739,warlock,destruction,121,75,46
Jeffreyw,tichondrius,1738,warlock,destruction,65,38,27
Zrok,bleeding-hollow,1738,warlock,destruction,60,29,31
Rollup,turalyon,1737,warlock,destruction,36,20,16
Darkmagician,kelthuzad,1735,warlock,destruction,30,22,8
Radalyn,icecrown,1735,warlock,destruction,37,22,15
Chaoticchaos,kelthuzad,1735,warlock,destruction,35,20,15
Hädes,frostwolf,1734,warlock,destruction,45,31,14
Plaintive,moon-guard,1733,warlock,destruction,48,27,21
Mânuel,akama,1731,warlock,destruction,30,22,8
Keniiwood,quelthalas,1730,warlock,destruction,42,21,21
Midoolock,proudmoore,1729,warlock,destruction,60,40,20
Sdiaz,illidan,1729,warlock,destruction,42,26,16
Loadybigbolt,dalaran,1729,warlock,destruction,89,51,38
Teesolinia,stormrage,1728,warlock,destruction,75,50,25
Harmfuul,illidan,1728,warlock,destruction,45,28,17
Painful,mannoroth,1728,warlock,destruction,162,86,76
Swapsfour,area-52,1727,warlock,destruction,30,19,11
Cloudynightz,tichondrius,1727,warlock,destruction,161,88,73
Uarus,tichondrius,1725,warlock,destruction,42,26,16
Popdotdropit,frostwolf,1725,warlock,destruction,84,48,36
Perfidious,altar-of-storms,1723,warlock,destruction,40,30,10
Mindrekt,azralon,1723,warlock,destruction,60,44,16
Ensanaty,dalaran,1721,warlock,destruction,48,27,21
Destructing,hyjal,1721,warlock,destruction,48,25,23
Covidmaster,frostmourne,1720,warlock,destruction,118,63,55
Drwongmd,sargeras,1719,warlock,destruction,30,21,9
Michae,tichondrius,1718,warlock,destruction,24,18,6
Verminosa,nemesis,1718,warlock,destruction,30,19,11
Agni,gurubashi,1718,warlock,destruction,126,66,60
Jenda,blackrock,1717,warlock,destruction,128,67,61
Chaosjedi,stormrage,1717,warlock,destruction,117,53,64
Spooked,khadgar,1716,warlock,destruction,36,24,12
Naiyuan,tichondrius,1716,warlock,destruction,36,18,18
Drakedog,ragnaros,1714,warlock,destruction,30,21,9
Lockfoxyy,tichondrius,1714,warlock,destruction,30,21,9
Carcøsa,malganis,1714,warlock,destruction,72,40,32
Sixv,barthilas,1713,warlock,destruction,48,32,16
Richãrdjr,area-52,1713,warlock,destruction,36,22,14
Lotussama,anetheron,1712,warlock,destruction,24,18,6
Evatar,malganis,1712,warlock,destruction,36,21,15
Keylloggz,sargeras,1712,warlock,destruction,102,56,46
Hehimx,bleeding-hollow,1711,warlock,destruction,24,18,6
Mchawi,tichondrius,1711,warlock,destruction,59,35,24
Crimpy,dathremar,1711,warlock,destruction,59,34,25
Trundle,area-52,1711,warlock,destruction,59,34,25
Mastasnipah,illidan,1711,warlock,destruction,42,22,20
Serveq,tichondrius,1710,warlock,destruction,103,58,45
Nt,burning-legion,1709,warlock,destruction,44,36,8
Richãrd,area-52,1709,warlock,destruction,49,26,23
Ercaz,frostmourne,1709,warlock,destruction,48,20,28
Shulol,tichondrius,1708,warlock,destruction,30,18,12
Pigmahz,malganis,1708,warlock,destruction,72,39,33
Wårløck,stormrage,1707,warlock,destruction,24,18,6
Cokeparty,tichondrius,1707,warlock,destruction,53,29,24
Dbf,sargeras,1706,warlock,destruction,90,45,45
Tacticalderp,bleeding-hollow,1706,warlock,destruction,36,18,18
Freejakejone,tichondrius,1704,warlock,destruction,34,20,14
Wolfstein,tichondrius,1699,warlock,destruction,24,18,6
Conradlenoir,illidan,1699,warlock,destruction,36,23,13
Giantgobrin,zuljin,1699,warlock,destruction,60,31,29
Struggles,emerald-dream,1699,warlock,destruction,183,94,89
Daartaru,quelthalas,1698,warlock,destruction,90,48,42
Sairic,azralon,1697,warlock,destruction,78,51,27
Azazil,malganis,1697,warlock,destruction,36,22,14
Fredwinsta,laughing-skull,1697,warlock,destruction,54,29,25
Harukay,tichondrius,1696,warlock,destruction,29,20,9
Hiddentech,saurfang,1696,warlock,destruction,36,20,16
Teivlol,mugthol,1696,warlock,destruction,36,18,18
Ägnar,nemesis,1693,warlock,destruction,28,19,9
Viralwashbrn,illidan,1693,warlock,destruction,60,31,29
Pk,azralon,1691,warlock,destruction,24,18,6
Dotandforget,tichondrius,1691,warlock,destruction,36,24,12
Chrönic,azralon,1691,warlock,destruction,45,26,19
Cbx,kelthuzad,1690,warlock,destruction,36,28,8
Aluaris,earthen-ring,1690,warlock,destruction,30,23,7
Chaosbeard,korgath,1690,warlock,destruction,62,36,26
Taneverah,wyrmrest-accord,1689,warlock,destruction,47,30,17
Yidhra,aerie-peak,1689,warlock,destruction,105,57,48
Missmonday,tichondrius,1689,warlock,destruction,83,44,39
Hauntsin,hyjal,1689,warlock,destruction,42,21,21
Aggrodesiac,wyrmrest-accord,1688,warlock,destruction,66,36,30
Kâyn,area-52,1687,warlock,destruction,89,46,43
Lønewølf,sargeras,1687,warlock,destruction,90,45,45
Wafflezcb,frostmourne,1687,warlock,destruction,43,21,22
Dautenit,illidan,1687,warlock,destruction,66,32,34
Bfadestro,tichondrius,1686,warlock,destruction,36,24,12
Drain,proudmoore,1686,warlock,destruction,60,38,22
Bobbyshmurdå,frostmourne,1686,warlock,destruction,48,29,19
Contagion,dragonmaw,1685,warlock,destruction,36,20,16
Veerdz,area-52,1685,warlock,destruction,54,24,30
Melôck,area-52,1684,warlock,destruction,42,28,14
Urukaix,sargeras,1683,warlock,destruction,36,23,13
Maggotworm,sargeras,1683,warlock,destruction,189,104,85
Droptopp,malganis,1680,warlock,destruction,42,27,15
Guldansbicep,illidan,1679,warlock,destruction,45,26,19
Yaresly,kelthuzad,1678,warlock,destruction,38,25,13
Gavrhin,area-52,1678,warlock,destruction,41,26,15
Sakyameil,area-52,1678,warlock,destruction,42,25,17
Lïttle,stormrage,1678,warlock,destruction,81,48,33
Chaotixbolt,sargeras,1677,warlock,destruction,30,20,10
Getoffmedawg,illidan,1677,warlock,destruction,66,38,28
Breeak,sargeras,1676,warlock,destruction,48,31,17
Gekku,ragnaros,1676,warlock,destruction,36,22,14
Kbolt,barthilas,1676,warlock,destruction,95,55,40
Terrorbytes,frostmourne,1676,warlock,destruction,114,61,53
Dipixd,tichondrius,1675,warlock,destruction,24,22,2
Revenus,tichondrius,1675,warlock,destruction,195,97,98
Feardadots,tichondrius,1674,warlock,destruction,69,46,23
Gasgrassnass,sargeras,1674,warlock,destruction,83,46,37
Jpepps,perenolde,1673,warlock,destruction,77,48,29
Knockknock,llane,1673,warlock,destruction,42,22,20
Razzakka,stormrage,1673,warlock,destruction,171,87,84
Juicestarr,barthilas,1673,warlock,destruction,93,44,49
Booßiemiles,area-52,1672,warlock,destruction,157,92,65
Bytezlk,area-52,1672,warlock,destruction,36,21,15
Cairo,emerald-dream,1672,warlock,destruction,225,119,106
Gëngar,malganis,1671,warlock,destruction,31,23,8
Pyatpree,bleeding-hollow,1671,warlock,destruction,30,19,11
Mlxd,tichondrius,1670,warlock,destruction,24,19,5
Critthis,illidan,1670,warlock,destruction,47,32,15
Nocrackrocks,stormrage,1670,warlock,destruction,34,22,12
Ðòm,tichondrius,1670,warlock,destruction,42,24,18
Balepyre,moon-guard,1670,warlock,destruction,94,51,43
Ðiêsel,malganis,1668,warlock,destruction,57,32,25
Manapouli,area-52,1667,warlock,destruction,33,21,12
Levantine,barthilas,1667,warlock,destruction,45,24,21
Drksøul,barthilas,1666,warlock,destruction,77,52,25
Ifearjoo,vashj,1666,warlock,destruction,48,25,23
Iskiplegday,illidan,1666,warlock,destruction,107,45,62
Làsko,area-52,1665,warlock,destruction,102,51,51
Degred,tichondrius,1664,warlock,destruction,45,34,11
Nocchi,amanthul,1664,warlock,destruction,40,19,21
Sauzith,area-52,1663,warlock,destruction,36,26,10
Olgee,tortheldrin,1663,warlock,destruction,53,30,23
Chnos,mugthol,1663,warlock,destruction,41,23,18
Lockz,illidan,1662,warlock,destruction,54,27,27
Khølek,ragnaros,1661,warlock,destruction,41,30,11
Dartthvader,azralon,1661,warlock,destruction,92,45,47
Silone,tichondrius,1659,warlock,destruction,30,24,6
Scxut,zuljin,1658,warlock,destruction,24,19,5
Fabiusbilex,tichondrius,1658,warlock,destruction,39,23,16
Sendnudez,nemesis,1657,warlock,destruction,53,30,23
Sîthfu,tichondrius,1657,warlock,destruction,195,105,90
Cbolt,tichondrius,1656,warlock,destruction,90,52,38
Pikme,bleeding-hollow,1656,warlock,destruction,42,23,19
Mephizar,moon-guard,1656,warlock,destruction,56,30,26
Deangood,tichondrius,1656,warlock,destruction,152,77,75
Steebi,tichondrius,1655,warlock,destruction,36,23,13
Favorite,malfurion,1655,warlock,destruction,36,21,15
Nooko,frostmourne,1655,warlock,destruction,48,25,23
Zhvim,stormrage,1654,warlock,destruction,41,23,18
Hellwish,tichondrius,1654,warlock,destruction,108,53,55
Egirlgamer,sargeras,1653,warlock,destruction,72,43,29
Nickie,azralon,1653,warlock,destruction,60,33,27
Dobbythelock,zuljin,1653,warlock,destruction,42,23,19
Wayce,burning-blade,1653,warlock,destruction,166,88,78
Fece,area-52,1652,warlock,destruction,38,24,14
Warmandei,dalaran,1652,warlock,destruction,72,42,30
Jennifear,sargeras,1652,warlock,destruction,60,35,25
Fearlord,shattered-hand,1651,warlock,destruction,54,28,26
Zoagen,ragnaros,1650,warlock,destruction,28,20,8
Doombaby,zuljin,1650,warlock,destruction,138,79,59
Lemonfire,area-52,1650,warlock,destruction,49,26,23
Lockniel,skullcrusher,1649,warlock,destruction,60,37,23
Absoluté,nemesis,1649,warlock,destruction,36,19,17
Royalmace,dethecus,1648,warlock,destruction,46,25,21
Jaythuzad,stormrage,1648,warlock,destruction,146,79,67
Teefgap,sargeras,1648,warlock,destruction,36,19,17
Uranusa,proudmoore,1648,warlock,destruction,108,50,58
Trewlocke,sargeras,1647,warlock,destruction,42,25,17
Noggét,frostmourne,1647,warlock,destruction,114,67,47
Muffîn,moon-guard,1647,warlock,destruction,109,64,45
Reppedlock,illidan,1647,warlock,destruction,94,55,39
Javirr,ragnaros,1645,warlock,destruction,65,39,26
Neverportx,kirin-tor,1645,warlock,destruction,36,21,15
Jussmollett,arygos,1645,warlock,destruction,119,63,56
Dëstró,tichondrius,1645,warlock,destruction,65,34,31
Misolock,sargeras,1644,warlock,destruction,105,56,49
Revérence,sargeras,1644,warlock,destruction,41,21,20
Oblivious,firetree,1644,warlock,destruction,195,98,97
Ðemented,bleeding-hollow,1643,warlock,destruction,33,19,14
Sagatt,illidan,1643,warlock,destruction,71,39,32
Debigbolt,area-52,1642,warlock,destruction,30,22,8
Fiddlesticks,draka,1642,warlock,destruction,54,36,18
Tahmrin,quelthalas,1642,warlock,destruction,58,30,28
Skrublockz,area-52,1642,warlock,destruction,41,21,20
Imports,tichondrius,1641,warlock,destruction,34,21,13
Chaosage,sargeras,1640,warlock,destruction,42,28,14
Luckehlock,firetree,1640,warlock,destruction,65,34,31
Fearmebro,bleeding-hollow,1639,warlock,destruction,139,72,67
Thirsts,tichondrius,1638,warlock,destruction,46,27,19
Belford,tichondrius,1638,warlock,destruction,67,35,32
Pyralock,malfurion,1638,warlock,destruction,48,25,23
Demonclock,sargeras,1637,warlock,destruction,39,24,15
Kurifodo,illidan,1637,warlock,destruction,77,43,34
Ardentia,malganis,1637,warlock,destruction,54,30,24
Reficul,frostmourne,1637,warlock,destruction,50,23,27
Parishiltoon,frostmourne,1637,warlock,destruction,52,22,30
Arenis,stormrage,1636,warlock,destruction,36,25,11
Xylâ,emerald-dream,1636,warlock,destruction,39,22,17
Eyoeyo,tichondrius,1636,warlock,destruction,42,18,24
Cursedstales,stormrage,1635,warlock,destruction,42,30,12
Flággedname,area-52,1635,warlock,destruction,36,21,15
Sëcond,azralon,1635,warlock,destruction,36,19,17
Kylaria,emerald-dream,1635,warlock,destruction,48,24,24
Hugechungusw,frostmourne,1634,warlock,destruction,50,31,19
Bénâfflock,area-52,1634,warlock,destruction,54,32,22
Ezdagor,quelthalas,1634,warlock,destruction,152,85,67
Identiti,tichondrius,1634,warlock,destruction,49,27,22
Iconicxo,thrall,1634,warlock,destruction,84,43,41
Dìpndots,wyrmrest-accord,1633,warlock,destruction,54,32,22
Zhaphrax,frostmourne,1633,warlock,destruction,85,43,42
Meraz,zuljin,1632,warlock,destruction,34,20,14
Evapilot,tichondrius,1632,warlock,destruction,54,31,23
Siellisele,illidan,1632,warlock,destruction,60,29,31
Azaradx,azralon,1632,warlock,destruction,79,33,46
Guldoom,tichondrius,1631,warlock,destruction,18,17,1
Demonista,illidan,1631,warlock,destruction,31,22,9
Oxylock,magtheridon,1631,warlock,destruction,42,24,18
Lóckdówn,frostmourne,1631,warlock,destruction,60,32,28
Shendù,stormrage,1631,warlock,destruction,48,23,25
Hynnis,nemesis,1630,warlock,destruction,60,37,23
Ddorangmoon,tichondrius,1630,warlock,destruction,42,25,17
Dipixyz,tichondrius,1630,warlock,destruction,30,17,13
Infecçäo,stormrage,1630,warlock,destruction,131,73,58
Kjazz,tichondrius,1630,warlock,destruction,42,23,19
Holunging,illidan,1630,warlock,destruction,36,19,17
Stormrift,sargeras,1629,warlock,destruction,74,39,35
Ltoplaylock,area-52,1628,warlock,destruction,24,17,7
Soranpotter,tichondrius,1628,warlock,destruction,24,17,7
Tuugadark,echo-isles,1628,warlock,destruction,85,51,34
Exgenshinpro,proudmoore,1628,warlock,destruction,30,17,13
Dmacxl,tichondrius,1627,warlock,destruction,36,20,16
Cöpeñhagen,illidan,1627,warlock,destruction,48,26,22
Undeadzx,tichondrius,1627,warlock,destruction,36,19,17
Devilman,darkspear,1627,warlock,destruction,163,83,80
Shadowlifts,kelthuzad,1626,warlock,destruction,48,29,19
Meep,madoran,1626,warlock,destruction,59,35,24
Katastrophïk,area-52,1626,warlock,destruction,36,20,16
Døomsday,hyjal,1626,warlock,destruction,42,21,21
Zandõx,jubeithos,1625,warlock,destruction,48,30,18
Byndedlock,dragonmaw,1625,warlock,destruction,33,20,13
Vvivienx,tichondrius,1625,warlock,destruction,30,17,13
Babydots,stormreaver,1625,warlock,destruction,80,44,36
Dovahkini,stormrage,1625,warlock,destruction,47,23,24
Shadowsloc,tichondrius,1625,warlock,destruction,48,22,26
Stølo,deathwing,1624,warlock,destruction,112,73,39
Ruknài,barthilas,1624,warlock,destruction,36,21,15
Coomerius,zuljin,1624,warlock,destruction,54,29,25
Xephine,proudmoore,1623,warlock,destruction,46,30,16
Alizondemdik,azralon,1623,warlock,destruction,67,37,30
Thotblood,stormrage,1622,warlock,destruction,24,18,6
Friendd,frostmourne,1622,warlock,destruction,41,30,11
Doomswitch,sargeras,1622,warlock,destruction,48,33,15
Permaslowed,kiljaeden,1622,warlock,destruction,40,22,18
Golock,tichondrius,1621,warlock,destruction,24,17,7
Deathmask,alleria,1621,warlock,destruction,52,30,22
Ticklebolts,tichondrius,1621,warlock,destruction,52,21,31
Elmobolt,thrall,1620,warlock,destruction,37,27,10
Flûké,tichondrius,1620,warlock,destruction,30,17,13
Annereyn,stormrage,1620,warlock,destruction,119,62,57
Tít,malganis,1619,warlock,destruction,90,46,44
Tougetsu,tichondrius,1618,warlock,destruction,42,26,16
Penzer,stormrage,1618,warlock,destruction,36,20,16
Sundrín,mugthol,1618,warlock,destruction,37,17,20
Dolut,azralon,1617,warlock,destruction,54,31,23
Restolock,destromath,1617,warlock,destruction,60,34,26
Resuah,tichondrius,1617,warlock,destruction,124,65,59
Wickedry,antonidas,1617,warlock,destruction,48,23,25
Rainymood,frostmourne,1616,warlock,destruction,85,53,32
Ðarkñess,burning-legion,1615,warlock,destruction,66,38,28
Malagas,tichondrius,1615,warlock,destruction,81,46,35
Dotgonewrong,malganis,1615,warlock,destruction,71,32,39
Notspeedy,tichondrius,1615,warlock,destruction,91,41,50
Ãids,khadgar,1614,warlock,destruction,54,36,18
Trastham,malganis,1614,warlock,destruction,90,46,44
Saltiez,sargeras,1613,warlock,destruction,24,18,6
Shïrõ,tichondrius,1613,warlock,destruction,30,22,8
Mokulock,tichondrius,1613,warlock,destruction,54,31,23
Avelmi,daggerspine,1613,warlock,destruction,120,64,56
Belzebud,area-52,1612,warlock,destruction,99,59,40
Ko,nordrassil,1612,warlock,destruction,66,34,32
Grandpa,daggerspine,1612,warlock,destruction,97,49,48
Hypnotikal,illidan,1611,warlock,destruction,30,22,8
Draenil,eredar,1611,warlock,destruction,24,17,7
Corruptblxck,tichondrius,1611,warlock,destruction,45,28,17
Escapefromtw,tichondrius,1611,warlock,destruction,42,24,18
Chrishasnen,moon-guard,1611,warlock,destruction,54,27,27
Idrannell,illidan,1610,warlock,destruction,98,56,42
Cptsaveahoe,skullcrusher,1610,warlock,destruction,36,20,16
Omleaf,malganis,1610,warlock,destruction,36,18,18
Gigabiga,tol-barad,1609,warlock,destruction,24,17,7
Funnysoxx,caelestrasz,1609,warlock,destruction,52,30,22
Momshutup,sargeras,1609,warlock,destruction,35,20,15
Horloc,moon-guard,1609,warlock,destruction,74,41,33
Stocktonslap,saurfang,1609,warlock,destruction,145,80,65
Nightshan,draenor,1609,warlock,destruction,66,32,34
Isarac,zuljin,1608,warlock,destruction,78,50,28
Zuyumin,ragnaros,1608,warlock,destruction,89,57,32
Ayrr,zuljin,1608,warlock,destruction,30,17,13
Gnomlette,smolderthorn,1608,warlock,destruction,98,53,45
Kály,azralon,1608,warlock,destruction,69,37,32
Lhandus,drakkari,1608,warlock,destruction,86,42,44
Saruon,proudmoore,1607,warlock,destruction,24,17,7
Pugnatwo,kelthuzad,1607,warlock,destruction,42,18,24
Soloart,tichondrius,1606,warlock,destruction,54,30,24
Katrisse,aegwynn,1606,warlock,destruction,72,37,35
Bugha,ravencrest,1605,warlock,destruction,31,21,10
Macdeezylock,sargeras,1605,warlock,destruction,36,23,13
Vugaddi,illidan,1605,warlock,destruction,30,19,11
Brdsflynhigh,garrosh,1604,warlock,destruction,33,23,10
Dferreira,azralon,1604,warlock,destruction,117,64,53
Darkÿoda,malganis,1604,warlock,destruction,86,47,39
Hordeadlock,illidan,1604,warlock,destruction,60,31,29
Powertrîp,sargeras,1604,warlock,destruction,36,18,18
Brickedx,malfurion,1604,warlock,destruction,101,50,51
Honchoe,illidan,1603,warlock,destruction,42,29,13
Nosferatu,arthas,1602,warlock,destruction,26,20,6
Bourrasq,illidan,1602,warlock,destruction,24,17,7
Sslock,sargeras,1602,warlock,destruction,46,26,20
Khurze,area-52,1602,warlock,destruction,97,51,46
Espyn,silvermoon,1602,warlock,destruction,105,51,54
Gavlock,tichondrius,1602,warlock,destruction,42,17,25
Vafa,kelthuzad,1601,warlock,destruction,32,21,11
Chachanoobx,sargeras,1601,warlock,destruction,132,82,50
Lyonesse,frostmourne,1601,warlock,destruction,34,21,13
Reportmenerd,tichondrius,1601,warlock,destruction,126,71,55
Daenon,kiljaeden,1601,warlock,destruction,42,23,19
Lafourche,tichondrius,1601,warlock,destruction,60,31,29
Pauldiesel,ragnaros,1601,warlock,destruction,42,21,21
Hâm,dalaran,1601,warlock,destruction,96,46,50
Dapete,malorne,1600,warlock,destruction,36,26,10
Watchmegate,darkspear,1600,warlock,destruction,72,45,27
Locknug,tichondrius,1600,warlock,destruction,132,74,58
Dapperdanxy,tichondrius,1600,warlock,destruction,38,21,17
Adouken,ragnaros,1600,warlock,destruction,36,19,17
Sauromann,sargeras,1599,warlock,destruction,108,62,46
Xdta,frostmourne,1599,warlock,destruction,72,38,34
Rxjr,sargeras,1599,warlock,destruction,81,39,42
Johnnybegood,frostmourne,1598,warlock,destruction,54,32,22
Boltsnhoez,tichondrius,1598,warlock,destruction,34,20,14
Xoxoxu,frostmourne,1597,warlock,destruction,44,25,19
Predictions,sargeras,1597,warlock,destruction,77,40,37
Closetslut,moon-guard,1596,warlock,destruction,24,20,4
Lifelock,auchindoun,1596,warlock,destruction,34,23,11
Maddotts,malganis,1596,warlock,destruction,42,28,14
Guula,alexstrasza,1595,warlock,destruction,42,22,20
Dotcoin,tichondrius,1594,warlock,destruction,30,17,13
Lockforyou,frostmourne,1594,warlock,destruction,66,37,29
Jnxzlock,sargeras,1593,warlock,destruction,67,37,30
Wheremyshoes,area-52,1593,warlock,destruction,141,68,73
Jerearderedo,thrall,1592,warlock,destruction,54,30,24
Kernlberton,tichondrius,1592,warlock,destruction,48,25,23
Necrotic,mannoroth,1592,warlock,destruction,107,48,59
Larryfisher,drenden,1591,warlock,destruction,30,19,11
Yisuschríst,quelthalas,1591,warlock,destruction,41,21,20
Akolite,tichondrius,1591,warlock,destruction,62,31,31
Demonkiiller,kelthuzad,1591,warlock,destruction,48,19,29
Romminus,zuljin,1589,warlock,destruction,43,30,13
Lockdogg,mannoroth,1588,warlock,destruction,36,22,14
Sladez,tichondrius,1588,warlock,destruction,47,20,27
Caustikk,malganis,1587,warlock,destruction,44,25,19
Buffwarlocks,senjin,1587,warlock,destruction,48,26,22
Raykun,quelthalas,1587,warlock,destruction,66,34,32
Doobielock,kelthuzad,1586,warlock,destruction,57,33,24
Calidaze,tichondrius,1586,warlock,destruction,122,64,58
Dots,haomarush,1586,warlock,destruction,96,49,47
Tothegrave,sargeras,1585,warlock,destruction,35,22,13
Rottenhell,kelthuzad,1585,warlock,destruction,108,61,47
Webrar,frostmourne,1584,warlock,destruction,42,24,18
Kuroyt,drakkari,1583,warlock,destruction,42,26,16
Caseau,frostmourne,1581,warlock,destruction,30,19,11
Dewars,aggramar,1580,warlock,destruction,108,60,48
Brockdot,tichondrius,1579,warlock,destruction,38,27,11
Gerthclas,aggramar,1579,warlock,destruction,35,24,11
Bbclover,thrall,1579,warlock,destruction,29,19,10
Matilla,tichondrius,1579,warlock,destruction,30,19,11
Evilmilf,tichondrius,1579,warlock,destruction,73,39,34
Yanned,hakkar,1579,warlock,destruction,201,107,94
Grindwald,echo-isles,1579,warlock,destruction,85,44,41
Lostanubis,tichondrius,1578,warlock,destruction,51,29,22
Yaldin,nemesis,1578,warlock,destruction,197,109,88
Woezz,tichondrius,1578,warlock,destruction,105,55,50
Gluestik,shadowmoon,1578,warlock,destruction,84,42,42
Thirdsol,stormrage,1577,warlock,destruction,59,31,28
Charnoob,kelthuzad,1577,warlock,destruction,54,26,28
Soreanus,illidan,1576,warlock,destruction,28,20,8
Harambê,sargeras,1576,warlock,destruction,34,19,15
Flor,khadgar,1575,warlock,destruction,237,122,115
Kliera,stormscale,1574,warlock,destruction,36,20,16
Tanskeeh,sargeras,1574,warlock,destruction,70,36,34
Leônidos,ghostlands,1574,warlock,destruction,120,61,59
Borthrel,moon-guard,1573,warlock,destruction,132,75,57
Xiáoyan,tichondrius,1571,warlock,destruction,54,34,20
Bunnyhugs,gorefiend,1571,warlock,destruction,36,22,14
Stankbigly,thrall,1571,warlock,destruction,38,23,15
Carmelasin,moon-guard,1570,warlock,destruction,60,39,21
Versariki,frostmourne,1568,warlock,destruction,72,39,33
Spliffxl,stormrage,1568,warlock,destruction,36,19,17
Burnzul,bleeding-hollow,1567,warlock,destruction,42,22,20
Khrom,illidan,1565,warlock,destruction,64,32,32
Widdleywahh,area-52,1564,warlock,destruction,137,74,63
Whathurts,tichondrius,1564,warlock,destruction,86,42,44
Uow,stormrage,1564,warlock,destruction,42,20,22
Fenexia,hyjal,1563,warlock,destruction,83,52,31
Felnightz,area-52,1562,warlock,destruction,48,23,25
Alfaflux,tol-barad,1562,warlock,destruction,65,30,35
Juswannarock,tichondrius,1561,warlock,destruction,45,26,19
Canobio,tichondrius,1559,warlock,destruction,36,18,18
Blklavender,darkspear,1558,warlock,destruction,37,20,17
Vasago,jubeithos,1558,warlock,destruction,71,36,35
Ìzanamí,area-52,1558,warlock,destruction,36,18,18
Deathteller,tichondrius,1558,warlock,destruction,35,17,18
Jarasseck,malganis,1557,warlock,destruction,109,54,55
Mattypatty,the-forgotten-coast,1557,warlock,destruction,42,20,22
Boodizz,frostmourne,1557,warlock,destruction,36,17,19
Promethian,proudmoore,1556,warlock,destruction,59,26,33
Lilbiackguy,stormrage,1555,warlock,destruction,72,45,27
Jerclard,proudmoore,1555,warlock,destruction,48,23,25
Josaith,moon-guard,1554,warlock,destruction,101,55,46
Niked,sargeras,1553,warlock,destruction,114,67,47
Brettmackson,area-52,1552,warlock,destruction,99,53,46
Tunacangirth,mannoroth,1551,warlock,destruction,24,17,7
Wiildgoose,area-52,1551,warlock,destruction,42,27,15
Xêlsnåp,steamwheedle-cartel,1551,warlock,destruction,97,57,40
Magiaoscurax,quelthalas,1551,warlock,destruction,123,68,55
Løvesick,zuljin,1550,warlock,destruction,58,30,28
Cioxius,stormrage,1550,warlock,destruction,57,28,29
Kossnen,shandris,1550,warlock,destruction,76,35,41
Ciprýan,azralon,1549,warlock,destruction,36,19,17
Neph,malganis,1549,warlock,destruction,38,19,19
Kyoarnez,quelthalas,1547,warlock,destruction,54,29,25
Forsâken,tichondrius,1547,warlock,destruction,67,35,32
Darksolace,dalaran,1547,warlock,destruction,42,21,21
Medusaqn,tichondrius,1547,warlock,destruction,36,18,18
Domson,area-52,1546,warlock,destruction,60,42,18
Pestilocks,area-52,1546,warlock,destruction,61,40,21
Beelzibub,firetree,1546,warlock,destruction,65,41,24
Bayfayth,zuljin,1546,warlock,destruction,92,52,40
Agonie,tichondrius,1546,warlock,destruction,279,144,135
Buboñic,area-52,1545,warlock,destruction,77,36,41
Sidious,jubeithos,1544,warlock,destruction,49,30,19
Plexwl,sargeras,1544,warlock,destruction,75,37,38
Gorontar,kelthuzad,1544,warlock,destruction,62,30,32
Mixolydian,malganis,1543,warlock,destruction,30,19,11
Strykerliath,bleeding-hollow,1541,warlock,destruction,55,29,26
Remua,tichondrius,1540,warlock,destruction,29,18,11
Warlockmf,sargeras,1540,warlock,destruction,121,66,55
Impdad,destromath,1539,warlock,destruction,96,61,35
Nybeth,malganis,1539,warlock,destruction,80,39,41
Cryptos,kalecgos,1538,warlock,destruction,38,22,16
Flxmin,area-52,1538,warlock,destruction,58,29,29
Kazinox,area-52,1538,warlock,destruction,42,20,22
Rerolledfotm,sargeras,1537,warlock,destruction,60,36,24
Hadouh,stormrage,1537,warlock,destruction,29,17,12
Manthos,sargeras,1537,warlock,destruction,63,24,39
Celistia,wyrmrest-accord,1535,warlock,destruction,24,17,7
Chadica,malganis,1534,warlock,destruction,18,16,2
Threk,quelthalas,1534,warlock,destruction,30,16,14
Littledúck,azralon,1533,warlock,destruction,18,16,2
Scarletdemon,malganis,1532,warlock,destruction,65,35,30
Excusey,tichondrius,1532,warlock,destruction,30,16,14
Shatteroidz,darkspear,1531,warlock,destruction,24,16,8
Fearem,tichondrius,1530,warlock,destruction,27,17,10
Youkeyoh,illidan,1530,warlock,destruction,36,21,15
Badmagic,area-52,1529,warlock,destruction,81,44,37
Beetlejoos,stormreaver,1529,warlock,destruction,30,16,14
Shadowmoonon,tichondrius,1529,warlock,destruction,30,16,14
Nattydots,sargeras,1529,warlock,destruction,71,37,34
Brucelock,proudmoore,1528,warlock,destruction,24,16,8
Gharlock,tichondrius,1528,warlock,destruction,62,36,26
Zalord,mannoroth,1528,warlock,destruction,124,54,70
Daracon,thrall,1527,warlock,destruction,36,21,15
Lustyclam,tichondrius,1527,warlock,destruction,95,55,40
Liritasu,illidan,1527,warlock,destruction,30,16,14
Asetiks,tichondrius,1526,warlock,destruction,30,16,14
Babyhzz,tichondrius,1525,warlock,destruction,18,16,2
Repláced,thrall,1525,warlock,destruction,101,58,43
Tulu,muradin,1524,warlock,destruction,53,35,18
Darthðotspam,mugthol,1524,warlock,destruction,102,60,42
Kevin,moon-guard,1524,warlock,destruction,111,59,52
Warluckie,zuljin,1523,warlock,destruction,24,18,6
Hadit,malganis,1523,warlock,destruction,55,30,25
Zetsu,zuljin,1523,warlock,destruction,263,135,128
Obscurity,tichondrius,1523,warlock,destruction,72,36,36
Conspiration,sargeras,1522,warlock,destruction,24,19,5
Cesily,frostmourne,1522,warlock,destruction,30,16,14
Tunacanthicc,moon-guard,1522,warlock,destruction,136,70,66
Morcegø,azralon,1522,warlock,destruction,63,32,31
Yungncapable,malganis,1521,warlock,destruction,27,22,5
Killvilock,kelthuzad,1521,warlock,destruction,79,37,42
Baldandugly,illidan,1520,warlock,destruction,30,18,12
Kascade,drakkari,1520,warlock,destruction,50,27,23
Warlockgomes,azralon,1520,warlock,destruction,228,116,112
Numerical,frostmourne,1519,warlock,destruction,24,16,8
Azracore,illidan,1519,warlock,destruction,51,31,20
Hellbòund,mugthol,1519,warlock,destruction,42,24,18
Blorgaflob,thaurissan,1518,warlock,destruction,19,16,3
Thravis,tichondrius,1518,warlock,destruction,36,20,16
Katsby,moon-guard,1518,warlock,destruction,35,19,16
Aliciayd,andorhal,1517,warlock,destruction,30,19,11
Glad,fenris,1517,warlock,destruction,55,31,24
Kajayak,nazjatar,1517,warlock,destruction,59,33,26
Grammapatty,tichondrius,1517,warlock,destruction,30,16,14
Iockgodtkoz,tichondrius,1516,warlock,destruction,54,27,27
Rotsndotss,thrall,1516,warlock,destruction,39,18,21
Sylrath,illidan,1516,warlock,destruction,69,30,39
Austeeny,wyrmrest-accord,1513,warlock,destruction,31,21,10
Politex,malganis,1513,warlock,destruction,64,40,24
Freggen,shadowsong,1513,warlock,destruction,48,29,19
Squatchamp,sargeras,1512,warlock,destruction,54,31,23
Kongal,tichondrius,1512,warlock,destruction,30,16,14
Adelrinn,frostmourne,1512,warlock,destruction,181,96,85
Psyløck,bleeding-hollow,1511,warlock,destruction,72,37,35
Hootenanny,korialstrasz,1511,warlock,destruction,72,34,38
Grimby,malganis,1511,warlock,destruction,42,18,24
Hawklock,ragnaros,1510,warlock,destruction,24,17,7
Stonnerz,ragnaros,1509,warlock,destruction,81,46,35
Valvravé,malganis,1509,warlock,destruction,41,22,19
Joseph,draktharon,1509,warlock,destruction,66,35,31
Lockybalboah,turalyon,1509,warlock,destruction,120,63,57
Fearsntears,stormrage,1509,warlock,destruction,42,16,26
Chaosmorty,tichondrius,1508,warlock,destruction,51,32,19
Guldåniel,tichondrius,1508,warlock,destruction,30,16,14
Honne,sargeras,1507,warlock,destruction,32,19,13
Shaneyxd,bleeding-hollow,1504,warlock,destruction,24,16,8
Pyresworn,wyrmrest-accord,1504,warlock,destruction,48,31,17
Thralord,blackrock,1503,warlock,destruction,36,23,13
Dinglerdots,tichondrius,1502,warlock,destruction,27,21,6
Jugaa,arthas,1502,warlock,destruction,41,29,12
Bosongo,boulderfist,1501,warlock,destruction,65,37,28
Deboltzaru,ragnaros,1501,warlock,destruction,91,45,46
Mordranan,thrall,1500,warlock,destruction,48,29,19
Marcedlc,ragnaros,1500,warlock,destruction,72,41,31
Ironsightsl,dalaran,1499,warlock,destruction,42,21,21
Soulicit,kelthuzad,1499,warlock,destruction,64,30,34
Odiums,area-52,1498,warlock,destruction,77,44,33
Korose,tichondrius,1498,warlock,destruction,183,90,93
Dippidydot,illidan,1497,warlock,destruction,84,39,45
Destruição,zuljin,1496,warlock,destruction,35,20,15
Firewõrks,moon-guard,1496,warlock,destruction,30,17,13
Mateekabr,malganis,1495,warlock,destruction,24,16,8
Lessance,dalaran,1495,warlock,destruction,36,21,15
Daremyth,azralon,1494,warlock,destruction,36,24,12
Trobgol,bleeding-hollow,1494,warlock,destruction,30,19,11
Mongdot,frostmourne,1494,warlock,destruction,51,30,21
Memnøch,emerald-dream,1492,warlock,destruction,41,24,17
Wizlox,illidan,1491,warlock,destruction,160,79,81
Goomgoom,doomhammer,1489,warlock,destruction,114,50,64
Titusvorenus,runetotem,1488,warlock,destruction,50,30,20
Dunbu,illidan,1488,warlock,destruction,139,76,63
Terrival,illidan,1487,warlock,destruction,41,22,19
Lockssy,tichondrius,1486,warlock,destruction,141,82,59
Dotte,tichondrius,1486,warlock,destruction,59,31,28
Vigius,dalaran,1486,warlock,destruction,53,24,29
Nytefels,skullcrusher,1485,warlock,destruction,30,20,10
Daddybolt,stormrage,1485,warlock,destruction,30,17,13
Hornetbee,tichondrius,1483,warlock,destruction,24,16,8
Kalellock,azralon,1483,warlock,destruction,120,63,57
Dynamó,tichondrius,1483,warlock,destruction,74,37,37
Ellneggro,zuljin,1482,warlock,destruction,36,25,11
Chaoticman,tichondrius,1482,warlock,destruction,63,38,25
Fshi,frostmourne,1482,warlock,destruction,102,58,44
Gingery,the-underbog,1482,warlock,destruction,125,61,64
Cutewarlock,draktharon,1481,warlock,destruction,50,30,20
Aomniloltv,zuljin,1481,warlock,destruction,106,59,47
Barathron,tichondrius,1480,warlock,destruction,84,40,44
Pescador,tichondrius,1479,warlock,destruction,37,22,15
Voltshot,tichondrius,1479,warlock,destruction,96,52,44
Beyourselff,tichondrius,1479,warlock,destruction,35,16,19
Dloq,azgalor,1478,warlock,destruction,117,70,47
Kecca,azralon,1477,warlock,destruction,190,101,89
Chàõs,tichondrius,1477,warlock,destruction,54,27,27
Avae,frostmourne,1476,warlock,destruction,108,61,47
Boltybarnes,area-52,1475,warlock,destruction,42,31,11
Nefandous,malganis,1475,warlock,destruction,179,95,84
Ioroselmi,illidan,1475,warlock,destruction,131,64,67
Tofulery,tichondrius,1475,warlock,destruction,50,23,27
Hargol,azralon,1475,warlock,destruction,42,19,23
Wdc,illidan,1474,warlock,destruction,54,27,27
Bauchalain,area-52,1474,warlock,destruction,38,19,19
Doublebolt,illidan,1473,warlock,destruction,123,72,51
Warwand,tichondrius,1472,warlock,destruction,24,16,8
Priiscilá,drakkari,1472,warlock,destruction,66,32,34
Raizël,ragnaros,1471,warlock,destruction,56,34,22
Privin,sargeras,1471,warlock,destruction,36,18,18
Demondots,sargeras,1469,warlock,destruction,54,31,23
Medeia,tichondrius,1469,warlock,destruction,29,16,13
Celash,barthilas,1469,warlock,destruction,60,32,28
Laylowl,tichondrius,1468,warlock,destruction,36,22,14
Shadowxlock,misha,1468,warlock,destruction,95,51,44
Slipfallx,tichondrius,1468,warlock,destruction,64,33,31
Magy,deathwing,1467,warlock,destruction,48,30,18
Dialalock,frostmourne,1467,warlock,destruction,54,29,25
Addonic,hyjal,1466,warlock,destruction,48,26,22
Dotsnrots,frostmourne,1466,warlock,destruction,42,20,22
Esså,jaedenar,1466,warlock,destruction,47,20,27
Pwz,azralon,1465,warlock,destruction,108,60,48
Noxdolor,stormreaver,1465,warlock,destruction,36,20,16
Prelick,illidan,1465,warlock,destruction,41,17,24
Zver,drakkari,1464,warlock,destruction,24,16,8
Lotusx,tichondrius,1464,warlock,destruction,48,30,18
Swaelee,area-52,1464,warlock,destruction,54,27,27
Zemphius,illidan,1463,warlock,destruction,55,27,28
Vindicated,azgalor,1462,warlock,destruction,49,33,16
Kkokko,tichondrius,1462,warlock,destruction,78,39,39
Shipmatelock,stormrage,1461,warlock,destruction,54,36,18
Jakeyboii,frostmourne,1459,warlock,destruction,51,33,18
Falcorr,area-52,1459,warlock,destruction,34,19,15
Garbagefarts,aegwynn,1459,warlock,destruction,94,48,46
Captrollol,tichondrius,1459,warlock,destruction,100,47,53
Jezwazerox,area-52,1458,warlock,destruction,93,50,43
Sñeed,sargeras,1456,warlock,destruction,55,31,24
Filthypumper,proudmoore,1455,warlock,destruction,43,28,15
Tharki,darkspear,1453,warlock,destruction,245,122,123
Loçk,zuljin,1453,warlock,destruction,117,57,60
Cozu,tichondrius,1450,warlock,destruction,30,20,10
Monkeylock,dathremar,1449,warlock,destruction,33,22,11
Perfectylock,azralon,1447,warlock,destruction,34,17,17
Gatewayoncd,frostmourne,1447,warlock,destruction,102,48,54
Eriess,burning-blade,1447,warlock,destruction,54,24,30
Ðeãdman,bleeding-hollow,1446,warlock,destruction,26,17,9
Sickmade,zuljin,1445,warlock,destruction,24,16,8
Demonicus,thunderlord,1445,warlock,destruction,51,24,27
Maleficmango,tichondrius,1444,warlock,destruction,36,23,13
Mcjoy,akama,1444,warlock,destruction,242,123,119
Dotsfired,crushridge,1442,warlock,destruction,63,38,25
Munar,quelthalas,1442,warlock,destruction,93,47,46
Atrofourth,tichondrius,1442,warlock,destruction,54,26,28
Xbqss,illidan,1442,warlock,destruction,36,16,20
Newty,zuljin,1441,warlock,destruction,24,19,5
Jaboltz,tichondrius,1441,warlock,destruction,25,16,9
Mantis,proudmoore,1441,warlock,destruction,43,23,20
Nttslock,tichondrius,1441,warlock,destruction,42,22,20
Eldriptch,kelthuzad,1441,warlock,destruction,47,23,24
Elcidoo,tichondrius,1440,warlock,destruction,24,15,9
Badufin,azralon,1440,warlock,destruction,30,18,12
Zezkin,alexstrasza,1440,warlock,destruction,39,21,18
Newmanz,nerzhul,1439,warlock,destruction,18,15,3
Printwo,sargeras,1439,warlock,destruction,24,15,9
Maldivà,tichondrius,1439,warlock,destruction,24,15,9
Dimanel,moon-guard,1439,warlock,destruction,24,15,9
Janeciap,tichondrius,1439,warlock,destruction,24,15,9
Discordant,trollbane,1439,warlock,destruction,48,29,19
Twototheone,illidan,1439,warlock,destruction,131,67,64
Manã,wyrmrest-accord,1439,warlock,destruction,36,18,18
Danaowns,spirestone,1439,warlock,destruction,30,15,15
Beastsuper,tichondrius,1439,warlock,destruction,30,15,15
Sâlâñzø,bleeding-hollow,1438,warlock,destruction,18,15,3
Selwitch,dalaran,1438,warlock,destruction,18,15,3
Spectro,laughing-skull,1438,warlock,destruction,18,15,3
Mykiel,sargeras,1438,warlock,destruction,42,21,21
Goofycupcake,drakthul,1437,warlock,destruction,18,15,3
Lostlock,sargeras,1437,warlock,destruction,18,15,3
Deathmásk,ragnaros,1437,warlock,destruction,18,15,3
Krokodiil,tichondrius,1437,warlock,destruction,56,35,21
Wildimp,aerie-peak,1437,warlock,destruction,24,15,9
Phreekish,bleeding-hollow,1437,warlock,destruction,24,15,9
Amoranlenus,sargeras,1437,warlock,destruction,36,21,15
Imbooms,blackrock,1437,warlock,destruction,30,15,15
Rzlrot,tichondrius,1436,warlock,destruction,30,18,12
Nebulox,stormrage,1436,warlock,destruction,42,24,18
Jämeson,tichondrius,1436,warlock,destruction,30,15,15
Artzul,tichondrius,1436,warlock,destruction,60,25,35
Zerfall,area-52,1435,warlock,destruction,24,15,9
Sonnagalook,sargeras,1435,warlock,destruction,48,27,21
Mikaelbolton,tichondrius,1435,warlock,destruction,52,24,28
Stizzy,eredar,1434,warlock,destruction,24,15,9
Plagueîs,area-52,1434,warlock,destruction,33,18,15
Év,azralon,1434,warlock,destruction,53,27,26
Kuoma,boulderfist,1434,warlock,destruction,121,57,64
Loçky,area-52,1433,warlock,destruction,24,15,9
Felacid,tichondrius,1433,warlock,destruction,48,28,20
Picklepuller,arthas,1433,warlock,destruction,60,34,26
Mldxd,undermine,1432,warlock,destruction,34,17,17
Dance,sargeras,1431,warlock,destruction,18,15,3
Jokerzz,tichondrius,1431,warlock,destruction,24,16,8
Domwarlock,uther,1431,warlock,destruction,30,15,15
Masefield,moon-guard,1431,warlock,destruction,68,33,35
Spaceghóst,bleeding-hollow,1430,warlock,destruction,291,142,149
Kyle,shandris,1429,warlock,destruction,63,36,27
Dotsyu,frostmourne,1429,warlock,destruction,50,28,22
Javaspooky,nemesis,1429,warlock,destruction,39,18,21
Conorloco,tichondrius,1429,warlock,destruction,36,15,21
Soukinomicz,sargeras,1428,warlock,destruction,24,15,9
Naome,cenarius,1428,warlock,destruction,36,16,20
Yükina,stormrage,1427,warlock,destruction,176,86,90
Ledrlpxlx,bleeding-hollow,1426,warlock,destruction,65,31,34
Humanreapers,malganis,1425,warlock,destruction,43,26,17
Shadowfork,illidan,1424,warlock,destruction,24,15,9
Dercair,korgath,1424,warlock,destruction,48,25,23
Straightlock,sargeras,1424,warlock,destruction,53,22,31
Arthyr,twisting-nether,1424,warlock,destruction,41,17,24
Kanekiskid,mannoroth,1423,warlock,destruction,42,29,13
Saddestboi,proudmoore,1423,warlock,destruction,66,40,26
Gvvo,tichondrius,1423,warlock,destruction,30,15,15
Çrayoneater,tichondrius,1423,warlock,destruction,52,22,30
Soiedentaire,illidan,1422,warlock,destruction,36,30,6
Ptheven,area-52,1422,warlock,destruction,64,40,24
Chéztér,proudmoore,1422,warlock,destruction,124,62,62
Jhivtwo,tichondrius,1422,warlock,destruction,36,18,18
Rickyspanish,malygos,1422,warlock,destruction,47,21,26
Yarrz,kelthuzad,1421,warlock,destruction,36,25,11
Wediditjoe,kelthuzad,1421,warlock,destruction,24,15,9
Nergoul,stormrage,1421,warlock,destruction,30,16,14
Yuh,moon-guard,1420,warlock,destruction,18,15,3
Boltster,destromath,1420,warlock,destruction,69,43,26
Toonbolt,sargeras,1420,warlock,destruction,48,28,20
Fearloom,tichondrius,1420,warlock,destruction,151,78,73
Valrena,rivendare,1419,warlock,destruction,24,15,9
Decrepticus,kargath,1419,warlock,destruction,44,26,18
Vandammed,silvermoon,1419,warlock,destruction,30,15,15
Destruction,frostmourne,1418,warlock,destruction,45,25,20
Memon,frostmane,1418,warlock,destruction,102,55,47
Wawfw,bleeding-hollow,1417,warlock,destruction,27,18,9
Fiftydkps,azralon,1417,warlock,destruction,87,51,36
Desconjuro,nemesis,1416,warlock,destruction,50,29,21
Mickylock,tichondrius,1416,warlock,destruction,222,120,102
Apøçàlÿpsè,firetree,1416,warlock,destruction,75,37,38
Deatthmoon,stormrage,1415,warlock,destruction,24,15,9
Evillyñ,tichondrius,1415,warlock,destruction,66,35,31
Locker,lightnings-blade,1414,warlock,destruction,30,18,12
Exofilth,thrall,1414,warlock,destruction,58,25,33
Budgetkroozz,illidan,1413,warlock,destruction,30,15,15
Bilidin,azralon,1413,warlock,destruction,93,41,52
Sharkweek,zuljin,1412,warlock,destruction,24,15,9
Overlock,ragnaros,1412,warlock,destruction,74,43,31
Yorchziel,ragnaros,1412,warlock,destruction,88,47,41
Jhop,sargeras,1411,warlock,destruction,92,52,40
Greedy,garrosh,1410,warlock,destruction,24,15,9
Thicclöcc,tichondrius,1410,warlock,destruction,30,15,15
Caplock,barthilas,1410,warlock,destruction,67,31,36
Parmenides,tichondrius,1410,warlock,destruction,42,19,23
Becà,stormrage,1408,warlock,destruction,30,19,11
Lôrdslug,bleeding-hollow,1408,warlock,destruction,24,15,9
Nazgal,tichondrius,1408,warlock,destruction,35,21,14
Basicwitch,malganis,1406,warlock,destruction,23,15,8
Yahihlock,silver-hand,1406,warlock,destruction,30,17,13
Blackguldan,illidan,1405,warlock,destruction,24,15,9
Meatybolts,nagrand,1405,warlock,destruction,84,46,38
Exupery,emerald-dream,1405,warlock,destruction,101,53,48
Lightname,arthas,1404,warlock,destruction,24,17,7
Catdog,bleeding-hollow,1404,warlock,destruction,30,15,15
Fatals,thrall,1404,warlock,destruction,30,15,15
Daliron,moon-guard,1404,warlock,destruction,30,15,15
Bellanomikus,stormrage,1404,warlock,destruction,60,25,35
Nezsarek,sargeras,1403,warlock,destruction,187,84,103
Adderall,altar-of-storms,1402,warlock,destruction,42,20,22
Vacuole,uther,1401,warlock,destruction,24,15,9
Killafornia,runetotem,1401,warlock,destruction,48,28,20
Balfast,quelthalas,1401,warlock,destruction,93,42,51
Chuwhee,sargeras,1401,warlock,destruction,54,18,36
Cynwise,arathor,1400,warlock,destruction,30,20,10
Antistar,barthilas,1400,warlock,destruction,43,27,16
Perples,dalaran,1399,warlock,destruction,60,30,30
Shadow,frostwolf,1399,warlock,destruction,44,17,27
Azöd,tichondrius,1398,warlock,destruction,117,69,48
Jaydow,illidan,1398,warlock,destruction,29,15,14
Drudotzz,hyjal,1398,warlock,destruction,36,18,18
Kurudios,ragnaros,1397,warlock,destruction,30,18,12
Georky,ragnaros,1397,warlock,destruction,67,32,35
Iongestpp,bleeding-hollow,1395,warlock,destruction,42,22,20
Soultrain,sargeras,1394,warlock,destruction,26,16,10
Crashcrash,area-52,1394,warlock,destruction,30,15,15
Notchinese,kiljaeden,1394,warlock,destruction,64,31,33
Glenfarclas,tichondrius,1394,warlock,destruction,79,34,45
Shadococo,tichondrius,1393,warlock,destruction,36,16,20
Pvping,illidan,1392,warlock,destruction,26,18,8
Mariscoveloz,stormrage,1392,warlock,destruction,108,58,50
Hellcon,area-52,1391,warlock,destruction,88,51,37
Vexedconvex,area-52,1391,warlock,destruction,365,179,186
Adhauto,illidan,1390,warlock,destruction,113,62,51
Sauronne,illidan,1390,warlock,destruction,54,24,30
Esteedees,moon-guard,1389,warlock,destruction,48,20,28
Bustednut,nerzhul,1388,warlock,destruction,92,53,39
Wadoom,tichondrius,1388,warlock,destruction,62,33,29
Gnomerky,stormrage,1388,warlock,destruction,42,19,23
Dvorakk,frostmourne,1387,warlock,destruction,27,17,10
Nazzlock,bleeding-hollow,1387,warlock,destruction,29,16,13
Blayzen,elune,1386,warlock,destruction,35,16,19
Umdur,zuljin,1385,warlock,destruction,74,35,39
Rangmar,ragnaros,1385,warlock,destruction,39,18,21
Gorelami,tichondrius,1384,warlock,destruction,42,23,19
Iceameri,tichondrius,1384,warlock,destruction,68,36,32
Spreadnhiv,thrall,1383,warlock,destruction,66,31,35
Poxnhub,tichondrius,1381,warlock,destruction,23,15,8
Neodron,thrall,1380,warlock,destruction,69,45,24
Necrotic,antonidas,1379,warlock,destruction,66,33,33
Warlo,moonrunner,1378,warlock,destruction,30,20,10
Coreleron,proudmoore,1378,warlock,destruction,61,29,32
Siccwidit,area-52,1378,warlock,destruction,74,34,40
Mèrlin,aerie-peak,1377,warlock,destruction,42,26,16
Aksness,stormrage,1377,warlock,destruction,48,21,27
Theporkchunk,nordrassil,1376,warlock,destruction,100,62,38
Blankdots,sargeras,1375,warlock,destruction,42,27,15
Sunkuna,aerie-peak,1375,warlock,destruction,176,89,87
Lockonthc,korgath,1375,warlock,destruction,32,16,16
Wasrenai,tichondrius,1375,warlock,destruction,47,21,26
Dealcloud,tichondrius,1374,warlock,destruction,83,44,39
Hobblefoòt,proudmoore,1374,warlock,destruction,46,23,23
Nmelock,malganis,1374,warlock,destruction,30,15,15
Demontos,darkspear,1374,warlock,destruction,66,31,35
Zinkro,quelthalas,1374,warlock,destruction,77,32,45
Batär,area-52,1372,warlock,destruction,36,26,10
Connect,borean-tundra,1371,warlock,destruction,35,18,17
Dessoft,ragnaros,1371,warlock,destruction,36,17,19
Somethingud,tichondrius,1370,warlock,destruction,79,31,48
Foxfoxfel,thrall,1369,warlock,destruction,24,16,8
Lockerdoo,aegwynn,1369,warlock,destruction,78,39,39
Ravikk,dalaran,1369,warlock,destruction,48,21,27
Regent,nemesis,1368,warlock,destruction,60,31,29
Ppoonlock,tichondrius,1367,warlock,destruction,35,15,20
Ebølarot,tichondrius,1365,warlock,destruction,24,15,9
Getpissed,emerald-dream,1365,warlock,destruction,65,32,33
Critneyfearz,stormscale,1365,warlock,destruction,53,25,28
Ilvvll,proudmoore,1365,warlock,destruction,65,30,35
Blindingsun,kiljaeden,1365,warlock,destruction,72,27,45
Gilgameshs,stormrage,1364,warlock,destruction,41,20,21
Lynnilock,area-52,1363,warlock,destruction,24,15,9
Luxenna,malganis,1363,warlock,destruction,84,40,44
Wackykid,azralon,1360,warlock,destruction,86,39,47
Buildsuccess,tichondrius,1359,warlock,destruction,41,16,25
Lafuke,tichondrius,1358,warlock,destruction,25,15,10
Fireballingx,illidan,1358,warlock,destruction,26,15,11
Locksyy,tichondrius,1357,warlock,destruction,59,24,35
Kelifan,sargeras,1356,warlock,destruction,96,52,44
Matdamon,barthilas,1354,warlock,destruction,60,33,27
Sylestrio,feathermoon,1354,warlock,destruction,54,27,27
Stunresistin,tichondrius,1353,warlock,destruction,132,66,66
Laklin,stormscale,1353,warlock,destruction,122,58,64
Finnickk,blackrock,1353,warlock,destruction,36,16,20
Methandmmkay,illidan,1352,warlock,destruction,27,18,9
Skazza,bleeding-hollow,1352,warlock,destruction,29,16,13
Patagucci,bleeding-hollow,1351,warlock,destruction,40,21,19
Ørfna,zuljin,1351,warlock,destruction,66,33,33
Davnport,frostmourne,1351,warlock,destruction,62,27,35
Sugmabone,zuluhed,1349,warlock,destruction,42,26,16
Zénth,kiljaeden,1349,warlock,destruction,52,28,24
Karadelice,stormrage,1349,warlock,destruction,54,29,25
Nøvah,tichondrius,1348,warlock,destruction,25,15,10
Lagcursed,frostmourne,1347,warlock,destruction,30,20,10
Pruevolf,tichondrius,1346,warlock,destruction,116,57,59
Jannus,wyrmrest-accord,1346,warlock,destruction,62,30,32
Razizzles,malganis,1345,warlock,destruction,72,42,30
Stallrooks,moon-guard,1345,warlock,destruction,29,16,13
Retwarr,tichondrius,1344,warlock,destruction,18,14,4
Shortstacki,tichondrius,1344,warlock,destruction,24,17,7
Soulruler,tichondrius,1344,warlock,destruction,24,14,10
Felpsychosis,illidan,1344,warlock,destruction,134,71,63
Súpersonic,tichondrius,1343,warlock,destruction,24,14,10
Sktfäker,sargeras,1343,warlock,destruction,24,14,10
Cælohin,tichondrius,1343,warlock,destruction,36,18,18
Austen,tichondrius,1343,warlock,destruction,55,24,31
Ganosh,aggramar,1341,warlock,destruction,134,73,61
Miniime,azgalor,1341,warlock,destruction,50,23,27
Mocreia,azralon,1340,warlock,destruction,164,84,80
Bobbygoulant,tichondrius,1340,warlock,destruction,259,128,131
Haxlock,azralon,1339,warlock,destruction,64,26,38
Aemma,proudmoore,1338,warlock,destruction,18,14,4
Extinção,azralon,1338,warlock,destruction,64,39,25
Pantypeeler,barthilas,1338,warlock,destruction,60,35,25
Sofan,dalaran,1338,warlock,destruction,24,14,10
Asiloas,shattered-hand,1338,warlock,destruction,24,14,10
Xlilgee,kelthuzad,1337,warlock,destruction,18,14,4
Jackscar,windrunner,1337,warlock,destruction,23,16,7
Punishment,jubeithos,1337,warlock,destruction,23,15,8
Sketchytat,stormrage,1337,warlock,destruction,24,14,10
Lladyyheartt,nesingwary,1337,warlock,destruction,66,34,32
Gingerspise,nathrezim,1337,warlock,destruction,30,14,16
Devastation,senjin,1336,warlock,destruction,21,15,6
Scãryz,jubeithos,1336,warlock,destruction,62,35,27
Pabloescobr,tichondrius,1335,warlock,destruction,24,14,10
Nueleth,frostmourne,1335,warlock,destruction,75,35,40
Theredwoman,emerald-dream,1335,warlock,destruction,30,14,16
Condevil,quelthalas,1334,warlock,destruction,119,64,55
Lòthloria,mannoroth,1334,warlock,destruction,149,74,75
Majinbuû,malganis,1334,warlock,destruction,30,14,16
Atrabiliario,quelthalas,1334,warlock,destruction,42,17,25
Bcxz,illidan,1333,warlock,destruction,24,14,10
Fazzlock,nagrand,1333,warlock,destruction,52,28,24
Aroris,silver-hand,1333,warlock,destruction,30,15,15
Staudt,mugthol,1332,warlock,destruction,24,16,8
Mailerdaemön,proudmoore,1332,warlock,destruction,30,14,16
Brenda,bleeding-hollow,1331,warlock,destruction,48,29,19
Yibbel,area-52,1331,warlock,destruction,24,14,10
Gukky,misha,1331,warlock,destruction,137,79,58
Spongebobjrj,tichondrius,1331,warlock,destruction,36,20,16
Ahp,stormrage,1331,warlock,destruction,27,15,12
Avadakedavra,warsong,1330,warlock,destruction,30,18,12
Lefteexd,tichondrius,1330,warlock,destruction,24,14,10
Chamansy,darkspear,1330,warlock,destruction,54,28,26
Grandpapapa,tichondrius,1330,warlock,destruction,60,25,35
Zogs,stonemaul,1330,warlock,destruction,36,14,22
Freestyle,blackwater-raiders,1328,warlock,destruction,54,34,20
Gingerlocky,barthilas,1328,warlock,destruction,106,50,56
Oony,quelthalas,1328,warlock,destruction,66,27,39
Celeden,emerald-dream,1327,warlock,destruction,30,18,12
Monson,warsong,1327,warlock,destruction,30,14,16
Cursedoll,ragnaros,1327,warlock,destruction,36,15,21
Salties,magtheridon,1326,warlock,destruction,24,14,10
Dasati,frostmourne,1324,warlock,destruction,24,16,8
Tergale,illidan,1323,warlock,destruction,96,41,55
Drcameron,zuljin,1322,warlock,destruction,24,15,9
Musgrin,gallywix,1322,warlock,destruction,24,14,10
Lockednloade,tichondrius,1322,warlock,destruction,57,33,24
Zephee,queldorei,1322,warlock,destruction,60,34,26
Wizdom,turalyon,1322,warlock,destruction,33,17,16
Jill,thunderhorn,1322,warlock,destruction,36,17,19
Gòtti,frostmourne,1320,warlock,destruction,24,14,10
Jugerdotz,sargeras,1320,warlock,destruction,30,14,16
Spite,thrall,1319,warlock,destruction,18,14,4
Sweetmeat,madoran,1319,warlock,destruction,37,14,23
Strawberryz,boulderfist,1318,warlock,destruction,24,14,10
Provilock,moon-guard,1318,warlock,destruction,31,17,14
Munick,spirestone,1317,warlock,destruction,30,15,15
Jeramie,darkspear,1317,warlock,destruction,38,17,21
Zyhq,stormrage,1317,warlock,destruction,48,18,30
Castngcouch,tichondrius,1316,warlock,destruction,69,35,34
Sepültüra,quelthalas,1316,warlock,destruction,97,44,53
Undies,demon-soul,1314,warlock,destruction,72,39,33
Ganknãmstyle,illidan,1313,warlock,destruction,89,42,47
Sickgurl,stormrage,1312,warlock,destruction,65,37,28
Jecklez,tichondrius,1312,warlock,destruction,135,70,65
Shedara,ragnaros,1311,warlock,destruction,23,14,9
Kabroom,boulderfist,1311,warlock,destruction,24,14,10
Buttkins,tichondrius,1311,warlock,destruction,36,18,18
Covírus,azralon,1310,warlock,destruction,29,18,11
Epicgaymer,zuljin,1310,warlock,destruction,32,15,17
Unstablê,ragnaros,1309,warlock,destruction,37,19,18
Striga,staghelm,1309,warlock,destruction,65,28,37
Dotyoazz,tichondrius,1308,warlock,destruction,38,22,16
Sayatar,ragnaros,1308,warlock,destruction,30,14,16
Covenslave,nemesis,1307,warlock,destruction,323,160,163
Muchoprecogo,tichondrius,1306,warlock,destruction,24,14,10
Sû,stormrage,1306,warlock,destruction,72,31,41
Downbad,ysera,1305,warlock,destruction,37,16,21
Thizzmaa,area-52,1304,warlock,destruction,119,61,58
Gscar,area-52,1303,warlock,destruction,48,28,20
Drdotngo,tichondrius,1301,warlock,destruction,32,15,17
Voidchaos,korgath,1300,warlock,destruction,18,14,4
Tsmcfker,tichondrius,1298,warlock,destruction,24,14,10
Shivalx,tichondrius,1292,warlock,destruction,30,15,15
Rauwërrs,azralon,1292,warlock,destruction,55,26,29
Kombat,amanthul,1292,warlock,destruction,71,32,39
Bigdoinks,nagrand,1290,warlock,destruction,34,19,15
Boltsfordays,dalaran,1289,warlock,destruction,104,55,49
Cvntpvntcans,kelthuzad,1289,warlock,destruction,36,16,20
Dogetrash,tichondrius,1287,warlock,destruction,39,25,14
Lolimalock,bleeding-hollow,1286,warlock,destruction,35,19,16
Sevokk,stormrage,1285,warlock,destruction,36,17,19
Darkboltz,area-52,1283,warlock,destruction,45,26,19
Malchiev,area-52,1282,warlock,destruction,36,17,19
Awfeelya,sargeras,1281,warlock,destruction,29,17,12
Zuldar,tichondrius,1281,warlock,destruction,36,21,15
Zoluraan,proudmoore,1280,warlock,destruction,51,33,18
Hurriicane,stormrage,1280,warlock,destruction,92,48,44
Imprecátion,tichondrius,1279,warlock,destruction,65,24,41
Rustý,illidan,1278,warlock,destruction,71,41,30
Ozgwad,thunderhorn,1277,warlock,destruction,42,19,23
Ahrimus,area-52,1275,warlock,destruction,28,14,14
Lilibe,tichondrius,1275,warlock,destruction,66,29,37
Potatostew,dalaran,1273,warlock,destruction,36,14,22
Deseo,moon-guard,1272,warlock,destruction,48,30,18
Telvanni,sargeras,1270,warlock,destruction,43,24,19
Derfflinger,tichondrius,1270,warlock,destruction,118,49,69
Felryssa,kiljaeden,1269,warlock,destruction,60,29,31
Juwi,frostmourne,1269,warlock,destruction,36,17,19
Tartamuda,ragnaros,1269,warlock,destruction,42,16,26
Tiqs,stormrage,1268,warlock,destruction,23,14,9
Prinzheinric,quelthalas,1267,warlock,destruction,33,21,12
Gyxx,exodar,1267,warlock,destruction,27,14,13
Diabhlaí,tichondrius,1266,warlock,destruction,108,57,51
Griget,runetotem,1265,warlock,destruction,59,28,31
Klapincheeks,malganis,1262,warlock,destruction,87,31,56
Zehr,malganis,1261,warlock,destruction,58,32,26
Alktrz,azralon,1260,warlock,destruction,25,14,11
Stinkychef,hyjal,1259,warlock,destruction,30,19,11
Melodyh,laughing-skull,1259,warlock,destruction,36,14,22
Gattsonn,kiljaeden,1259,warlock,destruction,42,15,27
Pikkon,malorne,1258,warlock,destruction,30,15,15
Dotdoctor,thrall,1257,warlock,destruction,69,34,35
Mordekhay,tichondrius,1255,warlock,destruction,62,30,32
Felancholy,illidan,1254,warlock,destruction,32,22,10
Ticktóck,ghostlands,1253,warlock,destruction,19,14,5
Ogawalation,stormrage,1253,warlock,destruction,24,14,10
Siliconsnipe,tichondrius,1252,warlock,destruction,24,17,7
Kortinanga,tichondrius,1252,warlock,destruction,54,30,24
Eurygnomous,thrall,1252,warlock,destruction,30,14,16
Krýstál,ragnaros,1251,warlock,destruction,61,32,29
Drwolfman,bonechewer,1251,warlock,destruction,66,32,34
Xtwistedteas,tichondrius,1249,warlock,destruction,31,14,17
Dottzie,malganis,1247,warlock,destruction,18,13,5
Pressurë,tichondrius,1247,warlock,destruction,18,13,5
Drainerx,kelthuzad,1247,warlock,destruction,18,13,5
Voqo,shandris,1247,warlock,destruction,18,13,5
Cyrus,akama,1247,warlock,destruction,24,16,8
Moonsoaps,moon-guard,1247,warlock,destruction,24,13,11
Rèdrùm,tichondrius,1247,warlock,destruction,24,13,11
Oymmander,illidan,1247,warlock,destruction,24,13,11
Thragèqt,sargeras,1247,warlock,destruction,24,13,11
Kimsoul,zuljin,1247,warlock,destruction,24,13,11
Jandorace,anetheron,1247,warlock,destruction,24,13,11
Grenswood,arathor,1247,warlock,destruction,27,14,13
Djdemolordx,bleeding-hollow,1246,warlock,destruction,18,13,5
Synmari,tichondrius,1246,warlock,destruction,18,13,5
Felqueenn,windrunner,1246,warlock,destruction,48,26,22
Skanckqt,malganis,1246,warlock,destruction,24,13,11
Mitryc,illidan,1246,warlock,destruction,24,13,11
Inaane,thrall,1246,warlock,destruction,24,13,11
Stainn,gallywix,1245,warlock,destruction,27,17,10
Toastwl,tichondrius,1244,warlock,destruction,18,13,5
Riptyler,illidan,1244,warlock,destruction,24,13,11
Dreadxbolts,stormrage,1244,warlock,destruction,24,13,11
Kemchaos,illidan,1244,warlock,destruction,94,46,48
Catodo,ragnaros,1244,warlock,destruction,36,13,23
Luciffer,windrunner,1242,warlock,destruction,22,16,6
Nigsy,nagrand,1242,warlock,destruction,24,13,11
Spòngwò,tichondrius,1242,warlock,destruction,24,13,11
Kvxkxvxvk,bleeding-hollow,1242,warlock,destruction,31,13,18
Tirzah,frostmourne,1241,warlock,destruction,18,13,5
Sutra,tichondrius,1241,warlock,destruction,29,19,10
Mothmayhem,moon-guard,1241,warlock,destruction,24,13,11
Soulwipe,dethecus,1241,warlock,destruction,24,13,11
Badmir,area-52,1241,warlock,destruction,24,13,11
Shadü,tichondrius,1241,warlock,destruction,36,14,22
Rodimus,hyjal,1240,warlock,destruction,221,120,101
Jnzi,area-52,1239,warlock,destruction,18,13,5
Darthzugzug,gorefiend,1239,warlock,destruction,48,28,20
Bowltz,chogall,1239,warlock,destruction,24,13,11
Insanemids,tichondrius,1239,warlock,destruction,26,14,12
Teahourse,tichondrius,1239,warlock,destruction,31,14,17
Abracadavers,ragnaros,1237,warlock,destruction,33,16,17
Léarníng,nemesis,1236,warlock,destruction,18,13,5
Hazbussy,kelthuzad,1236,warlock,destruction,24,13,11
Fearndot,draenor,1236,warlock,destruction,63,29,34
Azrezzael,area-52,1233,warlock,destruction,24,13,11
Blastyboat,terenas,1233,warlock,destruction,39,15,24
Dalruk,wyrmrest-accord,1232,warlock,destruction,18,13,5
Klatuu,stonemaul,1232,warlock,destruction,24,15,9
Ehcsrop,doomhammer,1232,warlock,destruction,92,44,48
Keraj,quelthalas,1232,warlock,destruction,30,14,16
Sylvine,korgath,1232,warlock,destruction,30,13,17
Kärên,proudmoore,1231,warlock,destruction,31,23,8
Millyvanilly,tichondrius,1231,warlock,destruction,24,13,11
Iiferna,sargeras,1231,warlock,destruction,179,86,93
Jelluz,ghostlands,1230,warlock,destruction,33,16,17
Mcscrotie,tichondrius,1229,warlock,destruction,28,14,14
Heathncraig,illidan,1229,warlock,destruction,179,83,96
Dmox,darkspear,1229,warlock,destruction,30,13,17
Radamantîs,ragnaros,1229,warlock,destruction,36,13,23
Thotsanddots,area-52,1228,warlock,destruction,18,13,5
Bénn,moon-guard,1228,warlock,destruction,77,49,28
Graced,dalaran,1228,warlock,destruction,24,13,11
Jjesie,tichondrius,1228,warlock,destruction,30,13,17
Sumondeznuts,wyrmrest-accord,1228,warlock,destruction,33,14,19
Impieties,emerald-dream,1228,warlock,destruction,36,14,22
Faldoras,kalecgos,1227,warlock,destruction,18,13,5
Shaggster,stormrage,1226,warlock,destruction,72,39,33
Xdyourd,tichondrius,1225,warlock,destruction,18,13,5
Kyrionn,azralon,1225,warlock,destruction,24,13,11
Dirtybóy,tichondrius,1224,warlock,destruction,24,13,11
Candykrush,tichondrius,1224,warlock,destruction,26,13,13
Raebolts,area-52,1222,warlock,destruction,24,13,11
Pancakestack,stormrage,1222,warlock,destruction,119,62,57
Pocserlock,drakkari,1221,warlock,destruction,21,13,8
Vikkter,tichondrius,1221,warlock,destruction,30,14,16
Florryn,barthilas,1220,warlock,destruction,30,14,16
Enaria,queldorei,1218,warlock,destruction,24,13,11
Ktlock,frostmourne,1217,warlock,destruction,42,20,22
Gambel,duskwood,1217,warlock,destruction,36,16,20
Cursedtool,quelthalas,1216,warlock,destruction,21,14,7
Schmok,terenas,1216,warlock,destruction,64,33,31
Hawkstalker,thaurissan,1215,warlock,destruction,82,42,40
Totti,tol-barad,1214,warlock,destruction,30,17,13
Erevas,area-52,1213,warlock,destruction,24,14,10
Tatemor,barthilas,1213,warlock,destruction,36,13,23
Prototyp,azralon,1212,warlock,destruction,18,13,5
Felinå,hyjal,1206,warlock,destruction,39,24,15
Superbroly,area-52,1204,warlock,destruction,30,16,14
Daeykras,crushridge,1203,warlock,destruction,45,25,20
Luulloo,proudmoore,1203,warlock,destruction,60,32,28
Semyaza,zuluhed,1202,warlock,destruction,24,14,10
Gouldon,sargeras,1202,warlock,destruction,40,20,20
Dotess,illidan,1202,warlock,destruction,35,16,19
Verybaked,sargeras,1201,warlock,destruction,33,21,12
Blew,bleeding-hollow,1200,warlock,destruction,15,14,1
Mysophobia,frostmourne,1200,warlock,destruction,131,67,64
Alyarn,greymane,1198,warlock,destruction,24,13,11
Burnedout,proudmoore,1196,warlock,destruction,26,17,9
Sitra,ragnaros,1196,warlock,destruction,24,15,9
Dokue,kaelthas,1195,warlock,destruction,15,14,1
Rentblod,azralon,1195,warlock,destruction,23,13,10
Zydaria,stormrage,1195,warlock,destruction,36,20,16
Zaeloc,ragnaros,1195,warlock,destruction,42,13,29
Goldieloc,sargeras,1192,warlock,destruction,42,26,16
Spookyfurry,area-52,1192,warlock,destruction,30,13,17
Aboode,blackrock,1190,warlock,destruction,59,26,33
Cørruption,emerald-dream,1188,warlock,destruction,47,22,25
Arredivh,blackhand,1183,warlock,destruction,17,13,4
Chodetamer,lethon,1180,warlock,destruction,29,18,11
Necrodeath,malygos,1180,warlock,destruction,30,15,15
Maldíta,quelthalas,1180,warlock,destruction,117,52,65
Kidsoul,illidan,1178,warlock,destruction,97,46,51
Nanodingo,tichondrius,1176,warlock,destruction,59,30,29
Notäçultist,nagrand,1173,warlock,destruction,110,57,53
Tarnish,medivh,1173,warlock,destruction,90,38,52
Prinsessdie,proudmoore,1173,warlock,destruction,36,15,21
Phreaky,area-52,1169,warlock,destruction,75,40,35
Cascades,icecrown,1169,warlock,destruction,132,61,71
Ilovedemons,aegwynn,1168,warlock,destruction,42,26,16
Vamperro,thrall,1168,warlock,destruction,22,13,9
Westy,drenden,1167,warlock,destruction,24,16,8
Bawldimort,stormrage,1165,warlock,destruction,89,46,43
Juniorsalanu,quelthalas,1164,warlock,destruction,48,27,21
Fearlok,malorne,1164,warlock,destruction,28,13,15
Aerozyn,wyrmrest-accord,1161,warlock,destruction,30,16,14
Scaryðreams,malganis,1155,warlock,destruction,62,22,40
Dudda,sargeras,1152,warlock,destruction,12,12,0
Osmatz,area-52,1152,warlock,destruction,18,12,6
Falsaqt,area-52,1152,warlock,destruction,18,12,6
Livinpink,zuljin,1152,warlock,destruction,18,12,6
Ztc,dalaran,1152,warlock,destruction,18,12,6
Sphoo,tichondrius,1152,warlock,destruction,18,12,6
Blodrain,tichondrius,1152,warlock,destruction,18,12,6
Kazam,quelthalas,1152,warlock,destruction,30,17,13
Koei,tichondrius,1152,warlock,destruction,24,12,12
Shutupthug,illidan,1151,warlock,destruction,18,12,6
Soulfinder,tichondrius,1151,warlock,destruction,18,12,6
Liuh,tichondrius,1151,warlock,destruction,18,12,6
Angrydestro,tichondrius,1151,warlock,destruction,18,12,6
Wargllock,tichondrius,1151,warlock,destruction,18,12,6
Crucyblettv,korgath,1151,warlock,destruction,18,12,6
Blastamastah,tichondrius,1151,warlock,destruction,18,12,6
Oceangrownx,emerald-dream,1151,warlock,destruction,24,12,12
Asmit,firetree,1151,warlock,destruction,28,13,15
Zaiocian,tichondrius,1151,warlock,destruction,26,12,14
Pndasrntlegt,burning-blade,1150,warlock,destruction,12,12,0
Ggooudan,tichondrius,1150,warlock,destruction,18,12,6
Dëception,ragnaros,1150,warlock,destruction,18,12,6
Ñigorshedøn,area-52,1150,warlock,destruction,18,12,6
Pratticus,stormrage,1150,warlock,destruction,18,12,6
Soulripped,area-52,1150,warlock,destruction,24,12,12
Khalynd,azralon,1150,warlock,destruction,47,22,25
Kracky,tichondrius,1149,warlock,destruction,216,114,102
Iggyiggy,sargeras,1149,warlock,destruction,24,12,12
Hávìk,malganis,1149,warlock,destruction,24,12,12
Árkadiano,drakkari,1149,warlock,destruction,24,12,12
Ole,area-52,1149,warlock,destruction,27,13,14
Beldiinlock,khazgoroth,1149,warlock,destruction,75,36,39
Pardoned,stormrage,1149,warlock,destruction,30,12,18
Poock,goldrinn,1148,warlock,destruction,18,12,6
Omarlil,kelthuzad,1147,warlock,destruction,18,12,6
Joromojo,zuljin,1146,warlock,destruction,18,12,6
Nadirius,shadowmoon,1146,warlock,destruction,18,12,6
Superbvious,lothar,1145,warlock,destruction,83,40,43
Mordror,azralon,1145,warlock,destruction,53,25,28
Deebeel,sargeras,1145,warlock,destruction,30,12,18
Alyndraxia,malganis,1144,warlock,destruction,18,13,5
Soulsurvivor,tichondrius,1144,warlock,destruction,30,12,18
Thânàtös,malganis,1144,warlock,destruction,30,12,18
Carcine,frostwolf,1143,warlock,destruction,24,12,12
Adramelech,thrall,1143,warlock,destruction,24,12,12
Mispickle,kelthuzad,1143,warlock,destruction,24,12,12
Handler,earthen-ring,1142,warlock,destruction,42,28,14
Yëët,wildhammer,1142,warlock,destruction,18,12,6
Escro,azgalor,1142,warlock,destruction,80,47,33
Gridwild,drakkari,1142,warlock,destruction,24,12,12
Nadek,tichondrius,1140,warlock,destruction,24,12,12
Bmó,stormrage,1139,warlock,destruction,18,12,6
Nhen,daggerspine,1138,warlock,destruction,143,76,67
Cogitoergo,stormrage,1136,warlock,destruction,18,12,6
Klaríon,ragnaros,1136,warlock,destruction,21,13,8
Taylôr,proudmoore,1136,warlock,destruction,30,12,18
Saraphina,maiev,1135,warlock,destruction,375,181,194
Sankestones,burning-legion,1134,warlock,destruction,30,12,18
Skullsoul,arthas,1132,warlock,destruction,24,12,12
Dlchem,tichondrius,1126,warlock,destruction,18,12,6
Huskir,tichondrius,1125,warlock,destruction,30,12,18
Rageraff,trollbane,1121,warlock,destruction,30,18,12
Sylorelol,stormreaver,1121,warlock,destruction,42,15,27
Viejitaa,quelthalas,1118,warlock,destruction,22,13,9
Zêphyr,gilneas,1117,warlock,destruction,18,12,6
Trïnîty,tichondrius,1117,warlock,destruction,71,31,40
Dettocs,emerald-dream,1116,warlock,destruction,26,13,13
Hookslinger,barthilas,1116,warlock,destruction,24,12,12
Josemb,ragnaros,1114,warlock,destruction,26,14,12
Marvolö,darkspear,1112,warlock,destruction,24,15,9
Mshyde,gurubashi,1107,warlock,destruction,30,17,13
Esomy,sargeras,1107,warlock,destruction,33,17,16
Gentleq,tichondrius,1104,warlock,destruction,21,12,9
Anstik,area-52,1103,warlock,destruction,15,13,2
Infortunium,sargeras,1103,warlock,destruction,18,12,6
Hulion,kiljaeden,1100,warlock,destruction,54,21,33
Gwar,khazgoroth,1099,warlock,destruction,177,81,96
Myshadow,gorefiend,1097,warlock,destruction,42,19,23
Tempestzone,barthilas,1096,warlock,destruction,29,16,13
Darthlockz,illidan,1095,warlock,destruction,24,13,11
Madgettike,stormrage,1094,warlock,destruction,36,22,14
Ðòt,nagrand,1094,warlock,destruction,28,13,15
Cãsh,aegwynn,1094,warlock,destruction,41,14,27
Varuuss,ragnaros,1092,warlock,destruction,21,12,9
Mindfulchimp,sargeras,1092,warlock,destruction,23,12,11
Timmerstar,tichondrius,1091,warlock,destruction,54,25,29
Blockk,moknathal,1091,warlock,destruction,127,55,72
Lerooux,hyjal,1090,warlock,destruction,66,28,38
Snéed,sargeras,1088,warlock,destruction,29,15,14
Taìnted,lightbringer,1088,warlock,destruction,28,12,16
Ctierwarlock,tichondrius,1087,warlock,destruction,16,12,4
Ilfucyobit,kelthuzad,1087,warlock,destruction,77,24,53
Necrotiá,tichondrius,1085,warlock,destruction,17,12,5
Dualipy,ragnaros,1084,warlock,destruction,20,12,8
Rentacletape,kelthuzad,1084,warlock,destruction,22,12,10
Spicý,sargeras,1084,warlock,destruction,63,31,32
Liltoastii,illidan,1084,warlock,destruction,27,13,14
Nathalyâ,drakkari,1077,warlock,destruction,72,36,36
Glifosáto,quelthalas,1075,warlock,destruction,22,14,8
Valval,moon-guard,1074,warlock,destruction,72,22,50
Wolfib,tichondrius,1072,warlock,destruction,19,12,7
Caramelgodx,stormrage,1072,warlock,destruction,34,12,22
Merji,area-52,1071,warlock,destruction,23,12,11
Lockedyaup,skullcrusher,1068,warlock,destruction,30,13,17
Toby,azralon,1066,warlock,destruction,25,12,13
Luke,lightnings-blade,1062,warlock,destruction,18,12,6
Mogran,twisting-nether,1059,warlock,destruction,30,15,15
Caesaros,quelthalas,1057,warlock,destruction,25,12,13
Bumbleebolts,azralon,1056,warlock,destruction,12,11,1
Redsolojdc,tichondrius,1056,warlock,destruction,12,11,1
Rubybestlol,tichondrius,1056,warlock,destruction,12,11,1
Lockâsf,tichondrius,1056,warlock,destruction,18,11,7
Søulswap,tichondrius,1056,warlock,destruction,18,11,7
Xidothewitch,stormrage,1056,warlock,destruction,18,11,7
Thinkchair,sargeras,1056,warlock,destruction,18,11,7
Hdys,tichondrius,1056,warlock,destruction,18,11,7
Drsmegmaz,dreadmaul,1056,warlock,destruction,24,11,13
Bbangtimo,tichondrius,1056,warlock,destruction,24,11,13
Edeklock,frostmourne,1055,warlock,destruction,12,11,1
Feardotzrun,illidan,1055,warlock,destruction,18,11,7
Fatass,cairne,1055,warlock,destruction,18,11,7
Tuzadin,tichondrius,1055,warlock,destruction,18,11,7
Pedestal,bleeding-hollow,1055,warlock,destruction,18,11,7
Hellfires,ragnaros,1055,warlock,destruction,18,11,7
Sahdude,illidan,1055,warlock,destruction,18,11,7
Shadowflux,winterhoof,1055,warlock,destruction,18,11,7
Itstista,proudmoore,1055,warlock,destruction,24,11,13
Virûs,vashj,1054,warlock,destruction,12,11,1
Vasqu,stormrage,1054,warlock,destruction,18,11,7
Friggus,azralon,1054,warlock,destruction,18,11,7
Yze,sargeras,1054,warlock,destruction,18,11,7
Dunkindots,dalaran,1054,warlock,destruction,18,11,7
Aureboros,sargeras,1054,warlock,destruction,18,11,7
Locksolo,tichondrius,1054,warlock,destruction,18,11,7
Spudzies,bleeding-hollow,1054,warlock,destruction,24,11,13
Liability,zuljin,1054,warlock,destruction,24,11,13
Brough,illidan,1054,warlock,destruction,36,11,25
Buffwarlockz,stormrage,1053,warlock,destruction,18,11,7
Faënn,zuljin,1053,warlock,destruction,18,11,7
Dipz,zuljin,1053,warlock,destruction,18,11,7
Dëvïl,ragnaros,1053,warlock,destruction,24,11,13
Thotorina,tichondrius,1053,warlock,destruction,29,12,17
Nibala,aegwynn,1053,warlock,destruction,30,11,19
Ranil,mannoroth,1052,warlock,destruction,18,11,7
Vocarion,stormrage,1052,warlock,destruction,18,11,7
Aashes,doomhammer,1052,warlock,destruction,24,11,13
Blanklee,tichondrius,1051,warlock,destruction,12,11,1
Nessro,stormrage,1051,warlock,destruction,18,15,3
Domenic,sentinels,1051,warlock,destruction,16,12,4
Flemball,aegwynn,1051,warlock,destruction,21,12,9
Windwolff,dalvengyr,1051,warlock,destruction,24,11,13
Glortheeb,spirestone,1051,warlock,destruction,24,11,13
Kurmenos,uldum,1050,warlock,destruction,50,31,19
Microd,tichondrius,1050,warlock,destruction,18,11,7
Toxec,barthilas,1050,warlock,destruction,18,11,7
Sathorastus,spirestone,1050,warlock,destruction,24,11,13
Unprønuncea,azralon,1050,warlock,destruction,25,11,14
Dotsandchill,dalaran,1049,warlock,destruction,24,11,13
Nobuyori,tichondrius,1049,warlock,destruction,36,13,23
Lindrasta,proudmoore,1048,warlock,destruction,12,11,1
Aswrislock,tichondrius,1048,warlock,destruction,12,11,1
Shadowy,dragonblight,1048,warlock,destruction,18,11,7
Tirp,illidan,1048,warlock,destruction,24,11,13
Irunaways,stormrage,1047,warlock,destruction,18,11,7
Pokemebutt,hydraxis,1046,warlock,destruction,18,11,7
Dex,jubeithos,1046,warlock,destruction,159,60,99
Altazor,thunderlord,1046,warlock,destruction,30,11,19
Ltr,moon-guard,1045,warlock,destruction,18,11,7
Haloren,moon-guard,1044,warlock,destruction,18,11,7
Veditä,goldrinn,1043,warlock,destruction,18,11,7
Xenagos,antonidas,1043,warlock,destruction,30,11,19
Xmochahollic,tichondrius,1040,warlock,destruction,152,65,87
Seeword,sargeras,1039,warlock,destruction,18,11,7
Baiss,tichondrius,1030,warlock,destruction,18,11,7
Danoinfelizz,nemesis,1029,warlock,destruction,15,12,3
Fidobiu,stormrage,1028,warlock,destruction,42,20,22
Neurotoxiina,azralon,1027,warlock,destruction,84,28,56
Noriaeradra,illidan,1025,warlock,destruction,24,13,11
Valintine,khadgar,1024,warlock,destruction,21,12,9
Getsmoked,moknathal,1023,warlock,destruction,23,11,12
Consumed,area-52,1022,warlock,destruction,21,12,9
Plaugewolf,azgalor,1021,warlock,destruction,24,13,11
Sìddy,frostmourne,1019,warlock,destruction,18,12,6
Locksoul,area-52,1019,warlock,destruction,54,25,29
Sylersa,malganis,1018,warlock,destruction,30,11,19
Cheiff,tichondrius,1017,warlock,destruction,63,24,39
Rnicu,bonechewer,1016,warlock,destruction,99,49,50
Bobthedoc,sargeras,1011,warlock,destruction,23,11,12
Solrad,illidan,1010,warlock,destruction,78,38,40
Kklock,frostmourne,1007,warlock,destruction,45,26,19
Thugpenus,frostmane,1006,warlock,destruction,24,11,13
Faliceu,sargeras,1006,warlock,destruction,26,11,15
Plagué,barthilas,1004,warlock,destruction,21,11,10
Docwildest,area-52,1003,warlock,destruction,17,11,6
Zhujiu,illidan,1002,warlock,destruction,23,12,11
Panyc,tichondrius,1002,warlock,destruction,23,11,12
Valerilma,azralon,998,warlock,destruction,23,11,12
Shardgodx,barthilas,997,warlock,destruction,23,11,12
Lowkei,stonemaul,997,warlock,destruction,48,16,32
Gwarlocassh,quelthalas,992,warlock,destruction,33,11,22
Wingzerø,tichondrius,988,warlock,destruction,23,11,12
Ozric,quelthalas,987,warlock,destruction,20,12,8
Nevermorde,area-52,986,warlock,destruction,23,11,12
Wìckedelf,area-52,986,warlock,destruction,81,38,43
Mystikcloak,lightbringer,980,warlock,destruction,19,13,6
Hanoaa,tichondrius,975,warlock,destruction,11,11,0
Zíppen,proudmoore,970,warlock,destruction,61,30,31
Plagueis,zuluhed,969,warlock,destruction,25,11,14
Kimis,azralon,963,warlock,destruction,24,14,10
Afrikenx,tichondrius,960,warlock,destruction,12,10,2
Lilshedon,kelthuzad,960,warlock,destruction,12,10,2
Letmecastpls,tichondrius,960,warlock,destruction,12,10,2
Defukd,proudmoore,960,warlock,destruction,12,10,2
Lockbtw,altar-of-storms,960,warlock,destruction,12,10,2
Fxckyuo,tichondrius,960,warlock,destruction,12,10,2
Goldielocks,eredar,960,warlock,destruction,12,10,2
Kammuany,sargeras,960,warlock,destruction,12,10,2
Nino,barthilas,960,warlock,destruction,12,10,2
Wolfibi,tichondrius,960,warlock,destruction,12,10,2
Jaboy,dragonmaw,960,warlock,destruction,12,10,2
Mesw,tichondrius,960,warlock,destruction,12,10,2
Icecokepeach,black-dragonflight,960,warlock,destruction,12,10,2
Adonegege,tichondrius,960,warlock,destruction,12,10,2
Wanglock,blackrock,960,warlock,destruction,12,10,2
Renatis,malganis,960,warlock,destruction,15,11,4
Areufearious,sargeras,960,warlock,destruction,18,10,8
Asamsbinladn,illidan,960,warlock,destruction,18,10,8
Extreme,blackwing-lair,960,warlock,destruction,18,10,8
Yuvirayz,illidan,960,warlock,destruction,18,10,8
Klol,proudmoore,960,warlock,destruction,18,10,8
Baka,moon-guard,960,warlock,destruction,18,10,8
Veryezgame,tichondrius,960,warlock,destruction,18,10,8
Phøbøs,hyjal,960,warlock,destruction,18,10,8
Busterbob,tichondrius,960,warlock,destruction,18,10,8
Spicyfingerx,illidan,960,warlock,destruction,18,10,8
Tjdotter,stormrage,960,warlock,destruction,21,11,10
Gneçro,area-52,960,warlock,destruction,24,10,14
Contägion,bleeding-hollow,960,warlock,destruction,24,10,14
Foxar,stormrage,959,warlock,destruction,12,10,2
Dkdakìng,dalaran,959,warlock,destruction,12,10,2
Hexxorcism,bleeding-hollow,959,warlock,destruction,12,10,2
Daisyridley,frostmourne,959,warlock,destruction,12,10,2
Candylock,blackrock,959,warlock,destruction,12,10,2
Percaddict,illidan,959,warlock,destruction,12,10,2
Gregfearnrun,area-52,959,warlock,destruction,16,11,5
Zazyi,azralon,959,warlock,destruction,16,11,5
Juiçédaddy,aggramar,959,warlock,destruction,18,10,8
Bktheruler,tichondrius,959,warlock,destruction,18,10,8
Shequita,thrall,959,warlock,destruction,18,10,8
Maral,kelthuzad,959,warlock,destruction,18,10,8
Years,moon-guard,959,warlock,destruction,18,10,8
Tevonsonte,tichondrius,959,warlock,destruction,18,10,8
Sixonenine,boulderfist,959,warlock,destruction,18,10,8
Neccross,azralon,959,warlock,destruction,18,10,8
Peeberson,tichondrius,959,warlock,destruction,18,10,8
Dotnrunn,kelthuzad,959,warlock,destruction,18,10,8
Kxäs,ragnaros,959,warlock,destruction,18,10,8
Maquedonia,quelthalas,959,warlock,destruction,18,10,8
Roblockz,illidan,959,warlock,destruction,18,10,8
Zelophobiaz,crushridge,959,warlock,destruction,18,10,8
Notatryhard,emerald-dream,959,warlock,destruction,18,10,8
Pykorrg,ragnaros,959,warlock,destruction,24,10,14
Delarae,frostmourne,958,warlock,destruction,12,10,2
Helraz,darkspear,958,warlock,destruction,12,10,2
Metafin,quelthalas,958,warlock,destruction,18,10,8
Wondon,tichondrius,958,warlock,destruction,18,10,8
Taye,barthilas,958,warlock,destruction,18,10,8
Meleemetabtw,emerald-dream,958,warlock,destruction,18,10,8
Mørgoth,thrall,958,warlock,destruction,18,10,8
Sourmilkz,zuljin,958,warlock,destruction,24,10,14
Diabolous,malganis,957,warlock,destruction,18,10,8
Hellwalker,illidan,957,warlock,destruction,18,10,8
Dercrow,quelthalas,957,warlock,destruction,18,10,8
Kåos,kelthuzad,957,warlock,destruction,18,10,8
Shelocks,sargeras,957,warlock,destruction,18,10,8
Daesire,moon-guard,957,warlock,destruction,18,10,8
Xerozus,tichondrius,957,warlock,destruction,18,10,8
Dragonlordy,proudmoore,957,warlock,destruction,18,10,8
Greasymario,area-52,957,warlock,destruction,22,11,11
Sieghert,frostmourne,957,warlock,destruction,24,10,14
Tromeo,sargeras,957,warlock,destruction,24,10,14
Pøwertrîp,sargeras,957,warlock,destruction,30,10,20
Sacrifices,sargeras,956,warlock,destruction,12,10,2
Creambun,barthilas,956,warlock,destruction,18,10,8
Wømanizer,azralon,956,warlock,destruction,18,10,8
Ragnalock,laughing-skull,956,warlock,destruction,18,10,8
Dårkfyre,kiljaeden,956,warlock,destruction,18,10,8
Raidspot,bleeding-hollow,956,warlock,destruction,24,10,14
Zaintv,illidan,955,warlock,destruction,18,10,8
Chaoticstorm,area-52,955,warlock,destruction,18,10,8
Hellslayer,frostmourne,955,warlock,destruction,24,10,14
Pachips,zuljin,955,warlock,destruction,24,10,14
Thediaz,quelthalas,954,warlock,destruction,24,12,12
Mybadyo,dalaran,953,warlock,destruction,16,11,5
Harleyjames,ravenholdt,953,warlock,destruction,18,10,8
Punjj,jubeithos,952,warlock,destruction,18,10,8
Jezzabell,amanthul,952,warlock,destruction,24,10,14
Huuchie,moon-guard,951,warlock,destruction,18,10,8
Puscifear,azralon,951,warlock,destruction,30,10,20
Sojupain,kaelthas,950,warlock,destruction,12,10,2
Mäléficø,nemesis,950,warlock,destruction,30,10,20
Yury,scarlet-crusade,949,warlock,destruction,24,10,14
Moreedotss,malganis,947,warlock,destruction,30,10,20
Hamadan,azralon,946,warlock,destruction,24,10,14
Cursé,stormrage,944,warlock,destruction,18,10,8
Zudre,tanaris,942,warlock,destruction,16,11,5
Dista,bleeding-hollow,941,warlock,destruction,31,10,21
Jonuts,korgath,939,warlock,destruction,67,30,37
Albus,skywall,933,warlock,destruction,24,10,14
Imsupercool,bleeding-hollow,927,warlock,destruction,17,10,7
Aliceðupree,darkspear,927,warlock,destruction,69,29,40
Astarõth,zuljin,926,warlock,destruction,26,11,15
Twohandedkil,stormrage,920,warlock,destruction,26,11,15
Keleiron,velen,916,warlock,destruction,18,10,8
Xekk,wyrmrest-accord,910,warlock,destruction,23,10,13
Lockyy,khaz-modan,904,warlock,destruction,26,11,15
Earllock,sargeras,895,warlock,destruction,14,10,4
Steav,quelthalas,894,warlock,destruction,16,10,6
Fiennx,dalaran,894,warlock,destruction,17,10,7
Rakudemon,ragnaros,894,warlock,destruction,20,10,10
Prägä,drakkari,892,warlock,destruction,14,10,4
Zzat,area-52,892,warlock,destruction,14,10,4
Marlett,destromath,890,warlock,destruction,113,58,55
Ilovedabs,aerie-peak,890,warlock,destruction,22,10,12
Savagetheron,korgath,887,warlock,destruction,18,10,8
Pyria,boulderfist,877,warlock,destruction,13,10,3
Nikôlas,stormrage,871,warlock,destruction,66,26,40
Moóndust,bleeding-hollow,864,warlock,destruction,12,9,3
Voidsoda,whisperwind,864,warlock,destruction,12,9,3
Frustration,darkspear,864,warlock,destruction,12,9,3
Bonita,garona,864,warlock,destruction,12,9,3
Lysitheä,moon-guard,864,warlock,destruction,12,9,3
Demoabuser,lightnings-blade,864,warlock,destruction,12,9,3
Matthewx,stormrage,864,warlock,destruction,12,9,3
Animarex,tichondrius,864,warlock,destruction,12,9,3
Baddummy,tichondrius,864,warlock,destruction,12,9,3
Grendaldots,tichondrius,864,warlock,destruction,12,9,3
Tstlsl,area-52,864,warlock,destruction,12,9,3
Drezx,frostmourne,864,warlock,destruction,12,9,3
Wtfcowisownz,illidan,864,warlock,destruction,12,9,3
Dabú,tichondrius,864,warlock,destruction,12,9,3
Lokiy,ragnaros,864,warlock,destruction,12,9,3
Alphaeus,hydraxis,864,warlock,destruction,12,9,3
Whaad,tichondrius,864,warlock,destruction,12,9,3
Zipanadblcup,thrall,864,warlock,destruction,12,9,3
Nynx,stormrage,864,warlock,destruction,12,9,3
Rice,lothar,864,warlock,destruction,12,9,3
Crnowarlock,area-52,864,warlock,destruction,12,9,3
Shokran,frostmourne,864,warlock,destruction,12,9,3
Rumplefust,thrall,864,warlock,destruction,12,9,3
Pengliyuaner,illidan,864,warlock,destruction,12,9,3
Quickzmaster,blackrock,864,warlock,destruction,12,9,3
Cirï,hellscream,864,warlock,destruction,12,9,3
Particles,proudmoore,864,warlock,destruction,16,10,6
Deatthwish,ragnaros,864,warlock,destruction,21,11,10
Voidxo,tichondrius,864,warlock,destruction,18,9,9
Reflexlock,malganis,864,warlock,destruction,18,9,9
Truepain,tichondrius,864,warlock,destruction,18,9,9
Bigolehogger,area-52,864,warlock,destruction,18,9,9
Biggbolts,tichondrius,864,warlock,destruction,18,9,9
Eazyw,stormrage,864,warlock,destruction,18,9,9
Rezial,illidan,864,warlock,destruction,18,9,9
Doties,bleeding-hollow,864,warlock,destruction,18,9,9
Blair,wildhammer,864,warlock,destruction,18,9,9
Enmama,malganis,864,warlock,destruction,18,9,9
Rorvask,area-52,864,warlock,destruction,18,9,9
Drossx,illidan,864,warlock,destruction,18,9,9
Miroir,illidan,864,warlock,destruction,18,9,9
Woopie,malfurion,864,warlock,destruction,18,9,9
Sonovabeech,winterhoof,864,warlock,destruction,18,9,9
Stuffs,wyrmrest-accord,864,warlock,destruction,18,9,9
Ezgamejr,tichondrius,864,warlock,destruction,24,9,15
Dottemup,dalvengyr,863,warlock,destruction,12,9,3
Ahrimaan,illidan,863,warlock,destruction,12,9,3
Skrunkz,illidan,863,warlock,destruction,12,9,3
Slicktrik,stormrage,863,warlock,destruction,12,9,3
Kathriss,frostmane,863,warlock,destruction,12,9,3
Gent,stormrage,863,warlock,destruction,12,9,3
Shooff,area-52,863,warlock,destruction,12,9,3
Pacopico,illidan,863,warlock,destruction,12,9,3
Pleaseno,tichondrius,863,warlock,destruction,12,9,3
Zycas,tichondrius,863,warlock,destruction,12,9,3
Glergarby,stormscale,863,warlock,destruction,15,10,5
Manethail,aegwynn,863,warlock,destruction,18,9,9
Kunshii,bleeding-hollow,863,warlock,destruction,18,9,9
Firemike,kelthuzad,863,warlock,destruction,18,9,9
Lessthanjake,zuljin,863,warlock,destruction,18,9,9
Arremon,thrall,863,warlock,destruction,18,9,9
Minzyw,illidan,863,warlock,destruction,18,9,9
Cyio,zuljin,863,warlock,destruction,18,9,9
Nethron,the-venture-co,863,warlock,destruction,18,9,9
Rhabdo,ravenholdt,863,warlock,destruction,18,9,9
Fearedit,bleeding-hollow,863,warlock,destruction,18,9,9
Durgamon,kirin-tor,863,warlock,destruction,18,9,9
Notdiesel,thrall,863,warlock,destruction,18,9,9
Ðarkbat,ragnaros,863,warlock,destruction,18,9,9
Maxdamage,blackwater-raiders,863,warlock,destruction,18,9,9
Rothmar,bleeding-hollow,863,warlock,destruction,18,9,9
Goarage,tichondrius,863,warlock,destruction,22,10,12
Rokdas,area-52,863,warlock,destruction,24,9,15
Cigárillo,thrall,863,warlock,destruction,24,9,15
Namig,aerie-peak,862,warlock,destruction,12,9,3
Çhåos,destromath,862,warlock,destruction,12,9,3
Locklockdead,earthen-ring,862,warlock,destruction,12,9,3
Mourinhoftw,illidan,862,warlock,destruction,12,9,3
Thewkama,tichondrius,862,warlock,destruction,18,9,9
Artheás,azralon,862,warlock,destruction,18,9,9
Duhdotsbruh,trollbane,862,warlock,destruction,18,9,9
Sanzofunke,area-52,862,warlock,destruction,18,9,9
Rainali,tichondrius,862,warlock,destruction,18,9,9
Dìabolos,frostmourne,862,warlock,destruction,18,9,9
Breaad,tichondrius,862,warlock,destruction,24,9,15
Tanathoz,thrall,862,warlock,destruction,28,10,18
Aveeda,malganis,861,warlock,destruction,12,9,3
Frdchickiana,tichondrius,861,warlock,destruction,18,9,9
Funnelcakies,area-52,861,warlock,destruction,18,9,9
Snapp,kelthuzad,861,warlock,destruction,24,9,15
Morganith,ravenholdt,861,warlock,destruction,30,9,21
Damdochael,bleeding-hollow,860,warlock,destruction,24,9,15
Botoslap,dragonmaw,860,warlock,destruction,24,9,15
Githany,hyjal,859,warlock,destruction,18,9,9
Gorskij,frostwolf,859,warlock,destruction,19,9,10
Damerus,illidan,859,warlock,destruction,24,9,15
Wybbukk,wyrmrest-accord,858,warlock,destruction,12,9,3
Lestant,moon-guard,858,warlock,destruction,18,9,9
Anubrikhan,wyrmrest-accord,858,warlock,destruction,18,9,9
Thulium,dawnbringer,857,warlock,destruction,12,9,3
Rudeuss,kiljaeden,857,warlock,destruction,18,9,9
Sykosenpai,zuljin,856,warlock,destruction,12,9,3
Shadohz,lightnings-blade,855,warlock,destruction,12,9,3
Shickeri,thunderlord,855,warlock,destruction,12,9,3
Scentient,jubeithos,855,warlock,destruction,12,9,3
Klummzy,tichondrius,850,warlock,destruction,18,9,9
Vampir,hellscream,850,warlock,destruction,24,9,15
Juan,borean-tundra,850,warlock,destruction,24,9,15
Doomtome,moon-guard,850,warlock,destruction,38,9,29
Elyzier,gallywix,839,warlock,destruction,48,20,28
Freakdoa,blades-edge,834,warlock,destruction,53,20,33
Hayhatchie,nagrand,831,warlock,destruction,17,9,8
Ovosound,tichondrius,815,warlock,destruction,11,9,2
Chaospump,frostmourne,815,warlock,destruction,17,9,8
Cheêsyx,tichondrius,815,warlock,destruction,17,9,8
Üziel,nemesis,814,warlock,destruction,15,9,6
Brútek,moon-guard,811,warlock,destruction,23,9,14
Metamòrph,malganis,810,warlock,destruction,16,10,6
Richactress,tichondrius,799,warlock,destruction,17,9,8
Conboii,tichondrius,768,warlock,destruction,10,9,1
Annantu,area-52,768,warlock,destruction,12,8,4
Elldiablo,darkspear,768,warlock,destruction,12,8,4
Ceeloftw,tichondrius,768,warlock,destruction,12,8,4
Clorvenna,zuljin,768,warlock,destruction,12,8,4
Smeezles,frostmourne,768,warlock,destruction,12,8,4
Diznei,nemesis,768,warlock,destruction,12,8,4
Elcidz,tichondrius,768,warlock,destruction,12,8,4
Bhalthazar,staghelm,768,warlock,destruction,12,8,4
Kápz,darkspear,768,warlock,destruction,12,8,4
Stíngz,nemesis,768,warlock,destruction,12,8,4
Shinagae,tichondrius,768,warlock,destruction,12,8,4
Necroferal,whisperwind,768,warlock,destruction,12,8,4
Flavakid,malganis,768,warlock,destruction,12,8,4
Aexsion,moon-guard,768,warlock,destruction,12,8,4
Searinox,scilla,768,warlock,destruction,12,8,4
Rebolting,tichondrius,768,warlock,destruction,12,8,4
Aptukk,archimonde,768,warlock,destruction,12,8,4
Levee,spirestone,768,warlock,destruction,12,8,4
Xevari,zuljin,768,warlock,destruction,12,8,4
Korash,kilrogg,768,warlock,destruction,12,8,4
Slackjaww,kiljaeden,768,warlock,destruction,12,8,4
Warcoc,bleeding-hollow,768,warlock,destruction,12,8,4
Fearsponce,dragonmaw,768,warlock,destruction,12,8,4
Idoovoodoo,burning-legion,768,warlock,destruction,12,8,4
Ayedss,dalaran,768,warlock,destruction,12,8,4
Wickiedalice,vashj,768,warlock,destruction,12,8,4
Narzhul,drakkari,768,warlock,destruction,12,8,4
Flackory,tichondrius,768,warlock,destruction,12,8,4
Bopplock,tichondrius,768,warlock,destruction,12,8,4
Rhelialock,icecrown,768,warlock,destruction,12,8,4
Dumbfknclass,malganis,768,warlock,destruction,12,8,4
Munje,bleeding-hollow,768,warlock,destruction,12,8,4
Cheylock,stormrage,768,warlock,destruction,12,8,4
Pandasrlegit,burning-blade,768,warlock,destruction,12,8,4
Chaoscoach,sargeras,768,warlock,destruction,12,8,4
Discordance,zuljin,768,warlock,destruction,12,8,4
Famington,tichondrius,768,warlock,destruction,12,8,4
Beckypls,zuljin,768,warlock,destruction,12,8,4
Esolock,malganis,768,warlock,destruction,12,8,4
Wizxin,emerald-dream,768,warlock,destruction,12,8,4
Fischh,hyjal,768,warlock,destruction,12,8,4
Warlocknroll,frostmourne,768,warlock,destruction,12,8,4
Felegance,proudmoore,768,warlock,destruction,12,8,4
Soliaa,stormrage,768,warlock,destruction,12,8,4
Hipnus,drakkari,768,warlock,destruction,12,8,4
Elprup,tichondrius,768,warlock,destruction,12,8,4
Nicorot,malganis,768,warlock,destruction,12,8,4
Westtung,tichondrius,768,warlock,destruction,13,8,5
Nyhn,bleeding-hollow,768,warlock,destruction,13,8,5
Metic,firetree,768,warlock,destruction,16,9,7
Pãni,area-52,768,warlock,destruction,18,8,10
Joung,tichondrius,768,warlock,destruction,18,8,10
Iniboltquity,tichondrius,768,warlock,destruction,18,8,10
Demfearslol,terokkar,768,warlock,destruction,18,8,10
Kallym,azralon,768,warlock,destruction,18,8,10
Dethknell,stormrage,768,warlock,destruction,18,8,10
Tarth,sargeras,768,warlock,destruction,18,8,10
Oppaijuggler,tichondrius,768,warlock,destruction,18,8,10
Rashiko,bleeding-hollow,768,warlock,destruction,18,8,10
Westhofxx,sargeras,768,warlock,destruction,18,8,10
Vexxes,malganis,768,warlock,destruction,18,8,10
Digylock,kelthuzad,768,warlock,destruction,30,8,22
Doman,thorium-brotherhood,767,warlock,destruction,12,8,4
Feldune,sargeras,767,warlock,destruction,12,8,4
Alastoorx,ragnaros,767,warlock,destruction,12,8,4
Coil,kiljaeden,767,warlock,destruction,12,8,4
Kboydots,sargeras,767,warlock,destruction,12,8,4
Matrriixx,proudmoore,767,warlock,destruction,12,8,4
Accentuate,tichondrius,767,warlock,destruction,12,8,4
Kruder,tichondrius,767,warlock,destruction,12,8,4
Yonz,area-52,767,warlock,destruction,12,8,4
Imadotyasan,shandris,767,warlock,destruction,12,8,4
Rickthelock,tichondrius,767,warlock,destruction,12,8,4
Darthtequila,stormrage,767,warlock,destruction,12,8,4
Haardmode,area-52,767,warlock,destruction,12,8,4
Char,jubeithos,767,warlock,destruction,12,8,4
Xaviier,sargeras,767,warlock,destruction,12,8,4
Blackwlk,tichondrius,767,warlock,destruction,12,8,4
Lokkup,dalaran,767,warlock,destruction,18,8,10
Redbro,darkspear,767,warlock,destruction,18,8,10
Shikyo,lightnings-blade,767,warlock,destruction,18,8,10
Mêdìvh,tichondrius,767,warlock,destruction,18,8,10
Vlk,barthilas,767,warlock,destruction,18,8,10
Misscháos,malganis,767,warlock,destruction,18,8,10
Plutö,thrall,767,warlock,destruction,18,8,10
Mangdaemon,silvermoon,767,warlock,destruction,18,8,10
Says,gorefiend,767,warlock,destruction,18,8,10
Aldaill,moon-guard,767,warlock,destruction,18,8,10
Babubabub,azralon,767,warlock,destruction,18,8,10
Felpuppet,barthilas,767,warlock,destruction,18,8,10
Katsurägi,tichondrius,767,warlock,destruction,18,8,10
Abramerlin,tichondrius,767,warlock,destruction,18,8,10
Síkaría,malganis,767,warlock,destruction,18,8,10
Slysdexia,sargeras,767,warlock,destruction,18,8,10
Bohnd,elune,767,warlock,destruction,18,8,10
Draxxus,barthilas,767,warlock,destruction,18,8,10
Spicytaters,malganis,767,warlock,destruction,24,8,16
Necrófear,tichondrius,767,warlock,destruction,24,8,16
Itsmeagain,area-52,767,warlock,destruction,24,8,16
Feoona,hyjal,767,warlock,destruction,24,8,16
Veleseth,stormrage,767,warlock,destruction,24,8,16
Raglans,amanthul,766,warlock,destruction,12,8,4
Opëth,thrall,766,warlock,destruction,12,8,4
Enur,malganis,766,warlock,destruction,12,8,4
Razdarin,proudmoore,766,warlock,destruction,12,8,4
Doomers,frostmourne,766,warlock,destruction,12,8,4
Dinkydeen,area-52,766,warlock,destruction,12,8,4
Dmgcrit,destromath,766,warlock,destruction,12,8,4
Assaulttron,wyrmrest-accord,766,warlock,destruction,12,8,4
Devdolittle,tichondrius,766,warlock,destruction,12,8,4
Abyssamcdoom,sargeras,766,warlock,destruction,18,8,10
Mandley,nazgrel,766,warlock,destruction,18,8,10
Seniorshneef,emerald-dream,766,warlock,destruction,18,8,10
Corezach,proudmoore,766,warlock,destruction,24,8,16
Spiritofodin,grizzly-hills,765,warlock,destruction,12,8,4
Rurnt,bloodhoof,765,warlock,destruction,12,8,4
Pipeo,quelthalas,765,warlock,destruction,12,8,4
Rottgodqt,area-52,765,warlock,destruction,24,8,16
Lilitht,drakkari,764,warlock,destruction,18,8,10
Guinegobbler,hyjal,764,warlock,destruction,20,8,12
Esoo,kul-tiras,763,warlock,destruction,12,8,4
Caryn,dalaran,763,warlock,destruction,18,8,10
Disrespex,kelthuzad,762,warlock,destruction,18,8,10
Djfear,tichondrius,762,warlock,destruction,18,8,10
Terminall,quelthalas,762,warlock,destruction,18,8,10
Nightblloom,illidan,762,warlock,destruction,18,8,10
Degynlock,wyrmrest-accord,762,warlock,destruction,24,8,16
Shooterg,tichondrius,761,warlock,destruction,18,8,10
Feladrae,wyrmrest-accord,761,warlock,destruction,30,8,22
Valyona,moon-guard,760,warlock,destruction,12,8,4
Schwaan,bladefist,757,warlock,destruction,12,8,4
Voidsoul,garithos,754,warlock,destruction,18,8,10
Shendotigans,illidan,735,warlock,destruction,23,8,15
Fellraiser,bleeding-hollow,720,warlock,destruction,15,8,7
Notoriusmma,illidan,720,warlock,destruction,19,10,9
Thuglovex,sargeras,719,warlock,destruction,11,8,3
Sotera,bleeding-hollow,719,warlock,destruction,11,8,3
Lökdown,dalaran,714,warlock,destruction,15,11,4
Júbeka,drakkari,714,warlock,destruction,20,9,11
Lilsquirts,kelthuzad,704,warlock,destruction,16,8,8
Ihaveapowers,maiev,703,warlock,destruction,11,8,3
Bäbz,barthilas,703,warlock,destruction,11,8,3
Tinyjo,sargeras,703,warlock,destruction,11,8,3
Demotional,wyrmrest-accord,703,warlock,destruction,14,8,6
Yikës,stormrage,703,warlock,destruction,14,8,6
Celestîne,sargeras,703,warlock,destruction,16,8,8
Liljamie,stormrage,703,warlock,destruction,17,8,9
Darchrow,frostmourne,703,warlock,destruction,23,8,15
Screampied,sargeras,699,warlock,destruction,20,8,12
Surleshilla,malganis,688,warlock,destruction,19,8,11
Dihva,malganis,687,warlock,destruction,17,9,8
Getfeared,emerald-dream,672,warlock,destruction,10,8,2
Zlippery,barthilas,672,warlock,destruction,10,8,2
Bigjersey,illidan,672,warlock,destruction,12,7,5
Tomathus,moon-guard,672,warlock,destruction,12,7,5
Synisterlock,moon-guard,672,warlock,destruction,12,7,5
Méphisto,emerald-dream,672,warlock,destruction,12,7,5
Drakatat,tichondrius,672,warlock,destruction,12,7,5
Dealindoug,bonechewer,672,warlock,destruction,12,7,5
Furryfears,gurubashi,672,warlock,destruction,12,7,5
Glizzÿ,thrall,672,warlock,destruction,12,7,5
Flicks,arthas,672,warlock,destruction,12,7,5
Puvvo,tichondrius,672,warlock,destruction,12,7,5
Revdog,sargeras,672,warlock,destruction,12,7,5
Fantumz,illidan,672,warlock,destruction,12,7,5
Suminl,tichondrius,672,warlock,destruction,12,7,5
Phishdots,tichondrius,672,warlock,destruction,12,7,5
Mokfernal,tichondrius,672,warlock,destruction,12,7,5
Pillock,bleeding-hollow,672,warlock,destruction,12,7,5
Luciusvrenus,tichondrius,672,warlock,destruction,12,7,5
Snikpan,silver-hand,672,warlock,destruction,12,7,5
Rockalock,burning-blade,672,warlock,destruction,12,7,5
Afflackxl,sargeras,672,warlock,destruction,12,7,5
Buypork,tichondrius,672,warlock,destruction,12,7,5
Callofzevoid,tichondrius,672,warlock,destruction,12,7,5
Dotlockndrop,stormreaver,672,warlock,destruction,12,7,5
Milkybøng,area-52,672,warlock,destruction,12,7,5
Monkeyasslol,sargeras,672,warlock,destruction,12,7,5
Dipgodx,bleeding-hollow,672,warlock,destruction,12,7,5
Uggaboogga,malganis,672,warlock,destruction,12,7,5
Alterity,kelthuzad,672,warlock,destruction,12,7,5
Kuaa,illidan,672,warlock,destruction,12,7,5
Clingrita,tichondrius,672,warlock,destruction,12,7,5
Tamzin,kelthuzad,672,warlock,destruction,12,7,5
Stîgz,stormrage,672,warlock,destruction,12,7,5
Aegywn,gorgonnash,672,warlock,destruction,12,7,5
Fsx,malganis,672,warlock,destruction,12,7,5
Insànity,bleeding-hollow,672,warlock,destruction,12,7,5
Brujoroba,drakkari,672,warlock,destruction,12,7,5
Tatordotzz,tichondrius,672,warlock,destruction,12,7,5
Cancer,bloodscalp,672,warlock,destruction,12,7,5
Sylvarri,stormrage,672,warlock,destruction,12,7,5
Qayin,azralon,672,warlock,destruction,12,7,5
Iboltudie,tichondrius,672,warlock,destruction,12,7,5
Elanfel,thrall,672,warlock,destruction,12,7,5
Morganach,moon-guard,672,warlock,destruction,12,7,5
Warpstar,area-52,672,warlock,destruction,12,7,5
Demí,zuljin,672,warlock,destruction,12,7,5
Shredlock,tichondrius,672,warlock,destruction,12,7,5
Walleyemike,kelthuzad,672,warlock,destruction,12,7,5
Dplexs,jubeithos,672,warlock,destruction,12,7,5
Westhofz,sargeras,672,warlock,destruction,12,7,5
Sasaology,frostmourne,672,warlock,destruction,12,7,5
Rothslock,tichondrius,672,warlock,destruction,12,7,5
Schlutty,malganis,672,warlock,destruction,12,7,5
Karmalock,malganis,672,warlock,destruction,12,7,5
Kountdrakula,tichondrius,672,warlock,destruction,12,7,5
Alìen,barthilas,672,warlock,destruction,12,7,5
Dötkill,illidan,672,warlock,destruction,12,7,5
Dotcòm,illidan,672,warlock,destruction,12,7,5
Felforyouu,illidan,672,warlock,destruction,12,7,5
Cilium,illidan,672,warlock,destruction,12,7,5
Locker,darkspear,672,warlock,destruction,12,7,5
Nicsb,caelestrasz,672,warlock,destruction,12,7,5
Lorenzojrr,sargeras,672,warlock,destruction,12,7,5
Bosswarlock,tichondrius,672,warlock,destruction,13,7,6
Axetoss,stormrage,672,warlock,destruction,17,9,8
Anasúi,quelthalas,672,warlock,destruction,18,7,11
Lilintrovert,illidan,672,warlock,destruction,18,7,11
Dilonlock,area-52,672,warlock,destruction,18,7,11
Spacedots,illidan,672,warlock,destruction,18,7,11
Zareke,silvermoon,672,warlock,destruction,18,7,11
Vihxy,moon-guard,672,warlock,destruction,18,7,11
Ivanux,quelthalas,672,warlock,destruction,18,7,11
Modot,tichondrius,672,warlock,destruction,18,7,11
Butterbolts,aerie-peak,672,warlock,destruction,18,7,11
Sibome,stormrage,672,warlock,destruction,18,7,11
Gritzixx,frostmourne,672,warlock,destruction,18,7,11
Dedremus,korialstrasz,672,warlock,destruction,18,7,11
Zantology,frostmourne,672,warlock,destruction,18,7,11
Marshyl,tichondrius,672,warlock,destruction,18,7,11
Evalovia,hyjal,672,warlock,destruction,24,7,17
Grimzo,mugthol,671,warlock,destruction,12,7,5
Drskeeters,malganis,671,warlock,destruction,12,7,5
Darthgoku,area-52,671,warlock,destruction,12,7,5
Valthorion,dathremar,671,warlock,destruction,12,7,5
Leroybrown,alterac-mountains,671,warlock,destruction,12,7,5
Azâziel,ragnaros,671,warlock,destruction,12,7,5
Demosthenes,nazjatar,671,warlock,destruction,12,7,5
Saicinxd,darkspear,671,warlock,destruction,12,7,5
Bhupzy,barthilas,671,warlock,destruction,12,7,5
Bradella,proudmoore,671,warlock,destruction,12,7,5
Fapchat,silvermoon,671,warlock,destruction,12,7,5
Zhing,frostmourne,671,warlock,destruction,12,7,5
Mérli,quelthalas,671,warlock,destruction,12,7,5
Boltondahoes,sargeras,671,warlock,destruction,12,7,5
Krillz,quelthalas,671,warlock,destruction,12,7,5
Actiow,stormrage,671,warlock,destruction,12,7,5
Zyraxx,moon-guard,671,warlock,destruction,12,7,5
Choas,jaedenar,671,warlock,destruction,12,7,5
Shadowpainn,the-underbog,671,warlock,destruction,12,7,5
Briside,malganis,671,warlock,destruction,12,7,5
Zms,ragnaros,671,warlock,destruction,12,7,5
Pendïng,area-52,671,warlock,destruction,12,7,5
Cytosine,medivh,671,warlock,destruction,12,7,5
Naba,malorne,671,warlock,destruction,12,7,5
Hudsonse,eitrigg,671,warlock,destruction,12,7,5
Soulinite,fizzcrank,671,warlock,destruction,18,7,11
Vetislock,thrall,671,warlock,destruction,18,7,11
Purplehatred,area-52,671,warlock,destruction,18,7,11
Fulc,area-52,671,warlock,destruction,18,7,11
Wollylock,dark-iron,671,warlock,destruction,18,7,11
Acribal,quelthalas,671,warlock,destruction,18,7,11
Jvilla,tichondrius,671,warlock,destruction,18,7,11
Kachauwoo,kiljaeden,671,warlock,destruction,18,7,11
Yungwilly,silvermoon,671,warlock,destruction,18,7,11
Deadlockz,stormrage,671,warlock,destruction,18,7,11
Trìplock,area-52,671,warlock,destruction,18,7,11
Lübelock,illidan,671,warlock,destruction,18,7,11
Vorituuray,moon-guard,671,warlock,destruction,18,7,11
Tørturë,tichondrius,670,warlock,destruction,12,7,5
Iamfear,shuhalo,670,warlock,destruction,12,7,5
Amilkman,area-52,670,warlock,destruction,12,7,5
Dipndøtz,illidan,670,warlock,destruction,12,7,5
Noteko,korgath,670,warlock,destruction,12,7,5
Cynissel,sargeras,670,warlock,destruction,13,7,6
Cazadorius,jubeithos,670,warlock,destruction,13,7,6
Kurtcodrain,blackhand,670,warlock,destruction,18,7,11
Siphos,proudmoore,670,warlock,destruction,18,7,11
Heartpvp,tichondrius,670,warlock,destruction,18,7,11
Graced,stormrage,670,warlock,destruction,18,7,11
Revenancer,smolderthorn,669,warlock,destruction,12,7,5
Kristenßell,senjin,669,warlock,destruction,12,7,5
Otus,echo-isles,669,warlock,destruction,12,7,5
Sumonníng,tichondrius,669,warlock,destruction,18,7,11
Esmaldo,tichondrius,669,warlock,destruction,19,7,12
Llu,tichondrius,668,warlock,destruction,12,7,5
Sneakywarlok,dalaran,668,warlock,destruction,19,7,12
Anahaldever,fenris,667,warlock,destruction,12,7,5
Deathjerky,thrall,667,warlock,destruction,12,7,5
Xargeras,emerald-dream,667,warlock,destruction,18,7,11
Nicestrike,barthilas,666,warlock,destruction,12,7,5
Markov,goldrinn,666,warlock,destruction,30,7,23
Giiada,korgath,665,warlock,destruction,15,8,7
Fartonomus,illidan,658,warlock,destruction,18,7,11
Saltboi,azjolnerub,640,warlock,destruction,16,7,9
Truffleseed,tichondrius,640,warlock,destruction,16,7,9
Felse,stormrage,640,warlock,destruction,22,7,15
Voidxx,tichondrius,639,warlock,destruction,11,7,4
Greenwarlock,bleeding-hollow,639,warlock,destruction,14,8,6
Demondan,magtheridon,638,warlock,destruction,23,7,16
Hateslocks,bladefist,637,warlock,destruction,22,7,15
Pandemone,proudmoore,624,warlock,destruction,15,7,8
Seregå,skywall,623,warlock,destruction,11,7,4
Conboee,tichondrius,623,warlock,destruction,11,7,4
Cassetes,tichondrius,622,warlock,destruction,11,7,4
Helpimdýing,sargeras,622,warlock,destruction,21,7,14
Ashdan,area-52,621,warlock,destruction,17,7,10
Ganondolph,sargeras,618,warlock,destruction,15,8,7
Lazzarros,area-52,618,warlock,destruction,22,8,14
Pontoontim,mugthol,617,warlock,destruction,20,8,12
Fancynuts,kiljaeden,607,warlock,destruction,11,7,4
Perfsx,bleeding-hollow,607,warlock,destruction,14,7,7
Furrlokc,tichondrius,607,warlock,destruction,16,7,9
Prahvstein,shuhalo,602,warlock,destruction,14,7,7
Studathlete,tichondrius,592,warlock,destruction,13,7,6
Pandemik,turalyon,591,warlock,destruction,11,8,3
Freyanna,moon-guard,588,warlock,destruction,19,7,12
Jblock,zuljin,576,warlock,destruction,6,6,0
Damn,stormreaver,576,warlock,destruction,6,6,0
Raghnor,illidan,576,warlock,destruction,6,6,0
Gretlock,emerald-dream,576,warlock,destruction,6,6,0
Fears,norgannon,576,warlock,destruction,6,6,0
Lockoutz,illidan,576,warlock,destruction,6,6,0
Baiw,tichondrius,576,warlock,destruction,6,6,0
Winipuhmalo,quelthalas,576,warlock,destruction,6,6,0
Magik,balnazzar,576,warlock,destruction,6,6,0
Baconmuffin,tichondrius,576,warlock,destruction,6,6,0
Dancedark,tichondrius,576,warlock,destruction,6,6,0
Mitchosx,frostmourne,576,warlock,destruction,6,6,0
Usainboltzz,kelthuzad,576,warlock,destruction,6,6,0
Gabbagoul,sargeras,576,warlock,destruction,6,6,0
Guitarpick,kelthuzad,576,warlock,destruction,6,6,0
Yzqer,stormrage,576,warlock,destruction,6,6,0
Hypexis,area-52,576,warlock,destruction,6,6,0
Lockhippo,illidan,576,warlock,destruction,6,6,0
Bivvix,malganis,576,warlock,destruction,6,6,0
Impbisqit,stormrage,576,warlock,destruction,6,6,0
Malevolent,velen,576,warlock,destruction,6,6,0
Alexiosy,area-52,576,warlock,destruction,6,6,0
Kòngal,tichondrius,576,warlock,destruction,6,6,0
Schrader,sargeras,576,warlock,destruction,6,6,0
Menggoth,tichondrius,576,warlock,destruction,6,6,0
Paratex,thrall,576,warlock,destruction,6,6,0
Paddywacker,azgalor,576,warlock,destruction,6,6,0
Notstingz,azralon,576,warlock,destruction,6,6,0
Deliverances,kelthuzad,576,warlock,destruction,9,7,2
Crewee,tichondrius,576,warlock,destruction,9,6,3
Broovid,tichondrius,576,warlock,destruction,13,7,6
Kerës,sargeras,576,warlock,destruction,12,6,6
Maèlstrom,area-52,576,warlock,destruction,12,6,6
Ðáyshéll,kelthuzad,576,warlock,destruction,12,6,6
Athronak,malganis,576,warlock,destruction,12,6,6
Beamin,dentarg,576,warlock,destruction,12,6,6
Zedonius,dragonmaw,576,warlock,destruction,12,6,6
Vravras,kelthuzad,576,warlock,destruction,12,6,6
Chipt,kelthuzad,576,warlock,destruction,12,6,6
Zephidel,thrall,576,warlock,destruction,12,6,6
Sumrule,dreadmaul,576,warlock,destruction,12,6,6
Gagitha,black-dragonflight,576,warlock,destruction,12,6,6
Riskydemon,azralon,576,warlock,destruction,12,6,6
Porsimorgis,firetree,576,warlock,destruction,12,6,6
Lüçian,ragnaros,576,warlock,destruction,12,6,6
Kreemy,ysera,576,warlock,destruction,12,6,6
Cunalia,sargeras,576,warlock,destruction,12,6,6
Beerbolt,dalaran,576,warlock,destruction,12,6,6
Sn,dalaran,576,warlock,destruction,12,6,6
Salentsia,malganis,576,warlock,destruction,12,6,6
Chabolt,tichondrius,576,warlock,destruction,12,6,6
Imortalchaos,dentarg,576,warlock,destruction,12,6,6
Innerforce,tichondrius,576,warlock,destruction,12,6,6
Massivebolts,area-52,576,warlock,destruction,12,6,6
Charmandfarm,nerzhul,576,warlock,destruction,12,6,6
Velvalla,chogall,576,warlock,destruction,12,6,6
Tlock,azjolnerub,576,warlock,destruction,12,6,6
Zeromech,sargeras,576,warlock,destruction,12,6,6
Imbadatpvp,tichondrius,576,warlock,destruction,12,6,6
Graingrippin,malganis,576,warlock,destruction,12,6,6
Kmüz,drakkari,576,warlock,destruction,12,6,6
Tomato,azjolnerub,576,warlock,destruction,12,6,6
Eboknight,area-52,576,warlock,destruction,12,6,6
Bolèyn,moon-guard,576,warlock,destruction,12,6,6
Smashfacelck,tichondrius,576,warlock,destruction,12,6,6
Lockmeupuwu,malganis,576,warlock,destruction,12,6,6
Emptysoul,illidan,576,warlock,destruction,12,6,6
Lucíela,ragnaros,576,warlock,destruction,12,6,6
Hiro,steamwheedle-cartel,576,warlock,destruction,12,6,6
Cosmosxi,illidan,576,warlock,destruction,12,6,6
Lri,frostmourne,576,warlock,destruction,12,6,6
Aikus,quelthalas,576,warlock,destruction,12,6,6
Pavél,ragnaros,576,warlock,destruction,12,6,6
Ryzhen,area-52,576,warlock,destruction,12,6,6
Iemonv,vashj,576,warlock,destruction,12,6,6
Bhris,wildhammer,576,warlock,destruction,12,6,6
Nutgobblerxo,sargeras,576,warlock,destruction,12,6,6
Doomhauzer,kiljaeden,576,warlock,destruction,12,6,6
Gengar,dalaran,576,warlock,destruction,12,6,6
Ritua,dragonmaw,576,warlock,destruction,12,6,6
Viejita,quelthalas,576,warlock,destruction,12,6,6
Sadist,area-52,576,warlock,destruction,12,6,6
Geegas,malganis,576,warlock,destruction,12,6,6
Coffeezx,malganis,576,warlock,destruction,12,6,6
Wrongname,hakkar,576,warlock,destruction,12,6,6
Kulgar,aerie-peak,576,warlock,destruction,12,6,6
Souldrain,malganis,576,warlock,destruction,12,6,6
Adøràßøltz,tichondrius,576,warlock,destruction,12,6,6
Girthlock,tichondrius,576,warlock,destruction,12,6,6
Shigero,tichondrius,576,warlock,destruction,12,6,6
Flu,darkspear,576,warlock,destruction,12,6,6
Ïmpdance,tichondrius,576,warlock,destruction,12,6,6
Ronnietherat,tichondrius,576,warlock,destruction,12,6,6
Jessewheels,tichondrius,576,warlock,destruction,12,6,6
Lambe,tichondrius,576,warlock,destruction,12,6,6
Justignoreme,tichondrius,576,warlock,destruction,12,6,6
Chaosboltss,tichondrius,576,warlock,destruction,12,6,6
Limeriax,emerald-dream,576,warlock,destruction,12,6,6
Vietoutlaw,bronzebeard,576,warlock,destruction,12,6,6
Tinked,stormrage,576,warlock,destruction,12,6,6
Quadrillion,stormrage,576,warlock,destruction,12,6,6
Huajianmanwu,tichondrius,576,warlock,destruction,12,6,6
Srcorvo,azralon,576,warlock,destruction,12,6,6
Andrewpg,zuljin,576,warlock,destruction,12,6,6
Crimsonela,emerald-dream,576,warlock,destruction,12,6,6
Betrili,tichondrius,576,warlock,destruction,12,6,6
Kentus,moonrunner,576,warlock,destruction,12,6,6
Gagh,tichondrius,576,warlock,destruction,12,6,6
Legallydan,tichondrius,576,warlock,destruction,12,6,6
Tonifortnite,emerald-dream,576,warlock,destruction,12,6,6
Pepperbolt,emerald-dream,576,warlock,destruction,12,6,6
Manalis,zuljin,576,warlock,destruction,12,6,6
Baconmarty,emerald-dream,576,warlock,destruction,12,6,6
Gibkii,tichondrius,576,warlock,destruction,15,7,8
Ellipsispain,bleeding-hollow,576,warlock,destruction,13,6,7
Marinw,azralon,576,warlock,destruction,16,7,9
Indrah,tichondrius,576,warlock,destruction,14,6,8
Møs,proudmoore,576,warlock,destruction,18,6,12
Wzrdtrx,deathwing,576,warlock,destruction,18,6,12
Tenletters,kirin-tor,576,warlock,destruction,18,6,12
Plutheros,stormrage,576,warlock,destruction,18,6,12
Esoteríc,sargeras,576,warlock,destruction,18,6,12
Jinxdacat,shandris,576,warlock,destruction,18,6,12
Lõck,tichondrius,576,warlock,destruction,18,6,12
Tharax,moon-guard,576,warlock,destruction,18,6,12
Lenestus,stormrage,576,warlock,destruction,18,6,12
Klisman,azralon,576,warlock,destruction,18,6,12
Coviddotsrot,sargeras,576,warlock,destruction,18,6,12
Familjia,nagrand,576,warlock,destruction,18,6,12
Bêlthazor,kelthuzad,576,warlock,destruction,18,6,12
Berszerk,quelthalas,576,warlock,destruction,18,6,12
Lamdyn,moon-guard,576,warlock,destruction,18,6,12
Kkuldan,tichondrius,576,warlock,destruction,24,6,18
Muldan,stormrage,575,warlock,destruction,6,6,0
Rosebolt,nemesis,575,warlock,destruction,6,6,0
Drlocktastic,vashj,575,warlock,destruction,6,6,0
Spamfearftw,sargeras,575,warlock,destruction,6,6,0
Gauul,illidan,575,warlock,destruction,12,6,6
Feldubya,illidan,575,warlock,destruction,12,6,6
Deathage,crushridge,575,warlock,destruction,12,6,6
Ifeludead,sargeras,575,warlock,destruction,12,6,6
Williwallace,stormrage,575,warlock,destruction,12,6,6
Méhoe,bleeding-hollow,575,warlock,destruction,12,6,6
Rathianna,sargeras,575,warlock,destruction,12,6,6
Naparima,stormreaver,575,warlock,destruction,12,6,6
Mium,bronzebeard,575,warlock,destruction,12,6,6
Baphomët,tichondrius,575,warlock,destruction,12,6,6
Edielyth,proudmoore,575,warlock,destruction,12,6,6
Crankshaft,nordrassil,575,warlock,destruction,12,6,6
Lockswagger,stormrage,575,warlock,destruction,12,6,6
Daimon,kaelthas,575,warlock,destruction,12,6,6
Pactman,sargeras,575,warlock,destruction,12,6,6
Cheekzz,illidan,575,warlock,destruction,12,6,6
Kdoggydogg,azshara,575,warlock,destruction,12,6,6
Mastroguise,illidan,575,warlock,destruction,15,6,9
Leno,twisting-nether,575,warlock,destruction,18,6,12
Oluluo,andorhal,575,warlock,destruction,18,6,12
Yetiaids,tichondrius,575,warlock,destruction,18,6,12
Selitose,illidan,575,warlock,destruction,18,6,12
Ëliphas,tichondrius,575,warlock,destruction,24,6,18
Trayga,illidan,574,warlock,destruction,6,6,0
Tesdeez,tichondrius,574,warlock,destruction,12,6,6
Kronman,zuluhed,574,warlock,destruction,12,6,6
Ggumx,tichondrius,574,warlock,destruction,12,6,6
Persephoné,blackrock,574,warlock,destruction,12,6,6
Hungovermate,barthilas,574,warlock,destruction,12,6,6
Anúbis,farstriders,574,warlock,destruction,18,6,12
Träzyn,kiljaeden,574,warlock,destruction,18,6,12
Zahba,stormrage,572,warlock,destruction,12,6,6
Supercracker,bleeding-hollow,572,warlock,destruction,18,6,12
Chewpawcabra,tichondrius,569,warlock,destruction,17,8,9
Rôver,crushridge,568,warlock,destruction,12,6,6
Expiredonion,bleeding-hollow,559,warlock,destruction,11,6,5
Friend,frostmourne,559,warlock,destruction,17,6,11
Mìrä,kelthuzad,558,warlock,destruction,17,6,11
Märshall,quelthalas,543,warlock,destruction,10,7,3
Aoepump,tichondrius,543,warlock,destruction,12,6,6
Promancer,drakkari,528,warlock,destruction,9,6,3
Loch,destromath,527,warlock,destruction,11,6,5
Exillis,barthilas,527,warlock,destruction,17,6,11
Ebo,bloodscalp,527,warlock,destruction,21,6,15
Tangslock,skullcrusher,526,warlock,destruction,17,6,11
Catraca,sargeras,524,warlock,destruction,15,7,8
Tesowenn,tichondrius,522,warlock,destruction,15,7,8
Marty,stormrage,522,warlock,destruction,15,7,8
Dotznfearz,zuljin,521,warlock,destruction,16,8,8
Redmil,quelthalas,520,warlock,destruction,35,7,28
Locdup,sargeras,512,warlock,destruction,22,6,16
Cs,icecrown,511,warlock,destruction,9,7,2
Lunazz,tichondrius,511,warlock,destruction,11,7,4
Dixynormis,zuljin,510,warlock,destruction,11,6,5
Ràistlin,madoran,494,warlock,destruction,11,6,5
Leîa,tichondrius,480,warlock,destruction,6,5,1
Onidium,area-52,480,warlock,destruction,6,5,1
Vuittøn,barthilas,480,warlock,destruction,6,5,1
Babyvet,stormreaver,480,warlock,destruction,6,5,1
Mørøs,tichondrius,480,warlock,destruction,6,5,1
Unicornspit,tichondrius,480,warlock,destruction,6,5,1
Johndazombie,zuljin,480,warlock,destruction,6,5,1
Jalean,illidan,480,warlock,destruction,6,5,1
Patoquenz,azralon,480,warlock,destruction,6,5,1
Ohthemisery,sargeras,480,warlock,destruction,6,5,1
Akudama,dalaran,480,warlock,destruction,6,5,1
Wakøzi,mugthol,480,warlock,destruction,6,5,1
Kopium,tichondrius,480,warlock,destruction,6,5,1
Theovohn,thrall,480,warlock,destruction,6,5,1
Frogdance,stormrage,480,warlock,destruction,6,5,1
Paindge,senjin,480,warlock,destruction,6,5,1
Púp,bleeding-hollow,480,warlock,destruction,6,5,1
Ikite,zuljin,480,warlock,destruction,6,5,1
Malékíth,ragnaros,480,warlock,destruction,6,5,1
Oreganow,icecrown,480,warlock,destruction,6,5,1
Zoljinn,frostwolf,480,warlock,destruction,6,5,1
Evilforce,area-52,480,warlock,destruction,6,5,1
Poonanifotm,gundrak,480,warlock,destruction,6,5,1
Novah,balnazzar,480,warlock,destruction,6,5,1
Yuckytoetoe,emerald-dream,480,warlock,destruction,6,5,1
Yateshall,illidan,480,warlock,destruction,6,5,1
Meddsurgx,emerald-dream,480,warlock,destruction,6,5,1
Cloperry,area-52,480,warlock,destruction,6,5,1
Efuc,tichondrius,480,warlock,destruction,6,5,1
Panndadots,tichondrius,480,warlock,destruction,6,5,1
Djae,frostmourne,480,warlock,destruction,6,5,1
Awdam,tichondrius,480,warlock,destruction,6,5,1
Pickles,kaelthas,480,warlock,destruction,6,5,1
Nerflocks,azralon,480,warlock,destruction,6,5,1
Chewybolt,illidan,480,warlock,destruction,6,5,1
Cheesëbolt,illidan,480,warlock,destruction,6,5,1
Destructium,stormrage,480,warlock,destruction,6,5,1
Beranflakes,darkspear,480,warlock,destruction,6,5,1
Geeßoogie,laughing-skull,480,warlock,destruction,6,5,1
Ricemachinex,grizzly-hills,480,warlock,destruction,6,5,1
Humblegodd,illidan,480,warlock,destruction,6,5,1
Evierine,zuljin,480,warlock,destruction,6,5,1
Khaozx,ragnaros,480,warlock,destruction,6,5,1
Zerefel,stormrage,480,warlock,destruction,6,5,1
Cuteasianpov,kiljaeden,480,warlock,destruction,6,5,1
Phyxylock,stormrage,480,warlock,destruction,6,5,1
Mathindis,ragnaros,480,warlock,destruction,6,5,1
Cannaboltzz,icecrown,480,warlock,destruction,6,5,1
Frylockx,mugthol,480,warlock,destruction,6,5,1
Dingis,bloodscalp,480,warlock,destruction,6,5,1
Popnloc,tichondrius,480,warlock,destruction,6,5,1
Bâppo,antonidas,480,warlock,destruction,6,5,1
Dippindotz,scilla,480,warlock,destruction,6,5,1
Shortnproud,tichondrius,480,warlock,destruction,6,5,1
Matdemonn,barthilas,480,warlock,destruction,6,5,1
Arnan,korgath,480,warlock,destruction,6,5,1
Foxbolt,tichondrius,480,warlock,destruction,6,5,1
Kimchiblast,tichondrius,480,warlock,destruction,6,5,1
Balencinaga,frostmourne,480,warlock,destruction,6,5,1
Donutx,illidan,480,warlock,destruction,6,5,1
Lucro,emerald-dream,480,warlock,destruction,6,5,1
Pantubølt,stormrage,480,warlock,destruction,6,5,1
Halftism,sargeras,480,warlock,destruction,6,5,1
Salaszar,illidan,480,warlock,destruction,6,5,1
Kargos,bonechewer,480,warlock,destruction,6,5,1
Wartoyy,uldum,480,warlock,destruction,6,5,1
Nutted,dentarg,480,warlock,destruction,6,5,1
Zerocastspec,tichondrius,480,warlock,destruction,6,5,1
Tiddliwinx,nordrassil,480,warlock,destruction,7,5,2
Elementzero,malorne,480,warlock,destruction,11,5,6
Chaoz,aggramar,480,warlock,destruction,12,5,7
Eneraxg,proudmoore,480,warlock,destruction,12,5,7
Pikvas,darkspear,480,warlock,destruction,12,5,7
Nelamona,moon-guard,480,warlock,destruction,12,5,7
Gruldan,drakkari,480,warlock,destruction,12,5,7
Smokiilock,proudmoore,480,warlock,destruction,12,5,7
Zalurk,emerald-dream,480,warlock,destruction,12,5,7
Locknes,kiljaeden,480,warlock,destruction,12,5,7
Warcrimes,silvermoon,480,warlock,destruction,12,5,7
Dalanllan,wyrmrest-accord,480,warlock,destruction,12,5,7
Gameface,garrosh,480,warlock,destruction,12,5,7
Soulswap,deathwing,480,warlock,destruction,12,5,7
Curaven,emerald-dream,480,warlock,destruction,12,5,7
Yurick,frostmourne,480,warlock,destruction,12,5,7
Seraphserius,laughing-skull,480,warlock,destruction,12,5,7
Toxishk,tichondrius,480,warlock,destruction,12,5,7
Gabagøøl,illidan,480,warlock,destruction,12,5,7
Darezs,frostmourne,480,warlock,destruction,12,5,7
Ascendant,amanthul,480,warlock,destruction,12,5,7
Lockandload,malfurion,480,warlock,destruction,12,5,7
Aurdra,thunderhorn,480,warlock,destruction,12,5,7
Archleon,smolderthorn,480,warlock,destruction,12,5,7
Virt,anubarak,480,warlock,destruction,12,5,7
Cycaeria,moon-guard,480,warlock,destruction,12,5,7
Qfear,tichondrius,480,warlock,destruction,12,5,7
Hellweaver,amanthul,480,warlock,destruction,12,5,7
Gallynna,moon-guard,480,warlock,destruction,12,5,7
Imhereforrbg,moon-guard,480,warlock,destruction,12,5,7
Gnimms,sargeras,480,warlock,destruction,12,5,7
Jakd,frostmourne,480,warlock,destruction,12,5,7
Vansa,caelestrasz,480,warlock,destruction,12,5,7
Skirnir,tichondrius,480,warlock,destruction,12,5,7
Hyjixy,stormrage,480,warlock,destruction,12,5,7
Souljäboy,bleeding-hollow,480,warlock,destruction,12,5,7
Halfmade,tichondrius,480,warlock,destruction,12,5,7
Hoonjojjyanl,tichondrius,480,warlock,destruction,12,5,7
Bludlock,illidan,480,warlock,destruction,12,5,7
Psionyde,barthilas,480,warlock,destruction,12,5,7
Geists,emerald-dream,480,warlock,destruction,12,5,7
Richards,thrall,480,warlock,destruction,12,5,7
Rytaint,emerald-dream,480,warlock,destruction,12,5,7
Respecter,kelthuzad,480,warlock,destruction,12,5,7
Actualjoke,frostmourne,480,warlock,destruction,12,5,7
Lockmycawk,stormrage,480,warlock,destruction,12,5,7
Daemonixx,vashj,480,warlock,destruction,12,5,7
Pabloqlx,ragnaros,480,warlock,destruction,12,5,7
Speakeasy,malygos,480,warlock,destruction,12,5,7
Totsdots,blackrock,480,warlock,destruction,12,5,7
Justganmore,tichondrius,480,warlock,destruction,12,5,7
Topboypepito,tichondrius,480,warlock,destruction,12,5,7
Balden,fenris,480,warlock,destruction,12,5,7
Avoidahoe,sargeras,480,warlock,destruction,12,5,7
Icemanliddel,area-52,480,warlock,destruction,12,5,7
Wombogombo,malganis,480,warlock,destruction,12,5,7
Darksdot,barthilas,480,warlock,destruction,12,5,7
Shadowflame,skullcrusher,480,warlock,destruction,12,5,7
Murphyslawl,skullcrusher,480,warlock,destruction,12,5,7
Gundrillas,area-52,480,warlock,destruction,12,5,7
Zugzor,shadowmoon,480,warlock,destruction,12,5,7
Enforcer,hellscream,480,warlock,destruction,12,5,7
Kubera,mannoroth,480,warlock,destruction,12,5,7
Jankity,kelthuzad,480,warlock,destruction,12,5,7
Bellgrande,shadowmoon,480,warlock,destruction,12,5,7
Errogant,area-52,480,warlock,destruction,12,5,7
Marbuldan,frostmourne,480,warlock,destruction,12,5,7
Macnab,malganis,480,warlock,destruction,12,5,7
Pveisboring,tichondrius,480,warlock,destruction,12,5,7
Exitiumm,malygos,480,warlock,destruction,12,5,7
Lockwell,tichondrius,480,warlock,destruction,12,5,7
Lildottythot,malganis,480,warlock,destruction,12,5,7
Galeirria,stormrage,480,warlock,destruction,12,5,7
Dôkgo,tichondrius,480,warlock,destruction,12,5,7
Myidas,quelthalas,480,warlock,destruction,12,5,7
Arkangel,dalvengyr,480,warlock,destruction,12,5,7
Jenová,uldaman,480,warlock,destruction,12,5,7
Sukmalock,proudmoore,480,warlock,destruction,15,6,9
Maarzil,malygos,480,warlock,destruction,16,6,10
Vicnutz,tichondrius,480,warlock,destruction,18,5,13
Ionithvia,tichondrius,480,warlock,destruction,18,5,13
Crypticwl,proudmoore,480,warlock,destruction,24,5,19
Yelabanxtown,thaurissan,479,warlock,destruction,6,5,1
Skrillhex,dragonmaw,479,warlock,destruction,6,5,1
Dipindottz,tichondrius,479,warlock,destruction,6,5,1
Lockystar,malganis,479,warlock,destruction,6,5,1
Clizarisa,moon-guard,479,warlock,destruction,6,5,1
Osteogenesis,quelthalas,479,warlock,destruction,12,5,7
Aluridan,azralon,479,warlock,destruction,12,5,7
Grix,uldaman,479,warlock,destruction,12,5,7
Vordz,amanthul,479,warlock,destruction,12,5,7
Apothokary,stormrage,479,warlock,destruction,12,5,7
Kelici,borean-tundra,479,warlock,destruction,12,5,7
Loccdawg,laughing-skull,479,warlock,destruction,12,5,7
Karkloc,stormrage,479,warlock,destruction,18,5,13
Daemonddred,hakkar,479,warlock,destruction,18,5,13
Moorrt,dragonblight,478,warlock,destruction,12,5,7
Giled,runetotem,478,warlock,destruction,12,5,7
Saintvil,drakkari,477,warlock,destruction,6,5,1
Warrogoblin,ragnaros,476,warlock,destruction,9,6,3
Blázê,illidan,476,warlock,destruction,12,5,7
Raven,baelgun,463,warlock,destruction,11,5,6
Anubís,vashj,462,warlock,destruction,11,5,6
Bitblack,tichondrius,453,warlock,destruction,13,7,6
Magniwl,zuljin,447,warlock,destruction,11,5,6
Døtbomb,stormrage,447,warlock,destruction,11,5,6
Theshattered,kiljaeden,447,warlock,destruction,11,5,6
Britnyfears,korgath,447,warlock,destruction,16,5,11
Djvetis,blackhand,442,warlock,destruction,15,7,8
Fengfeiss,tichondrius,432,warlock,destruction,15,6,9
Heizx,area-52,432,warlock,destruction,15,5,10
Silverfire,ragnaros,431,warlock,destruction,11,5,6
Berathelok,aerie-peak,426,warlock,destruction,17,6,11
Empowerdlock,garrosh,416,warlock,destruction,10,5,5
Velsona,moon-guard,415,warlock,destruction,14,5,9
Dysxliea,dalaran,415,warlock,destruction,14,5,9
Krozu,bleeding-hollow,415,warlock,destruction,14,5,9
Lockdlhm,tichondrius,400,warlock,destruction,13,5,8
ßenafflock,wyrmrest-accord,399,warlock,destruction,14,5,9
Wiredftwx,illidan,384,warlock,destruction,6,4,2
Sylvahh,sargeras,384,warlock,destruction,6,4,2
Darkfæ,kaelthas,384,warlock,destruction,6,4,2
Carielict,sargeras,384,warlock,destruction,6,4,2
Zuroghar,azralon,384,warlock,destruction,6,4,2
Sprenn,bleeding-hollow,384,warlock,destruction,6,4,2
Necrotko,malganis,384,warlock,destruction,6,4,2
Smnslock,emerald-dream,384,warlock,destruction,6,4,2
Wrathfull,malganis,384,warlock,destruction,6,4,2
Woofbolt,malganis,384,warlock,destruction,6,4,2
Pegorn,illidan,384,warlock,destruction,6,4,2
Rodneyjones,emerald-dream,384,warlock,destruction,6,4,2
Warfeen,malganis,384,warlock,destruction,6,4,2
Crackhammer,sargeras,384,warlock,destruction,6,4,2
Quetzâlcoâtl,sargeras,384,warlock,destruction,6,4,2
Zonss,tichondrius,384,warlock,destruction,6,4,2
Demonchurch,area-52,384,warlock,destruction,6,4,2
Gordoxin,area-52,384,warlock,destruction,6,4,2
Ceeloww,illidan,384,warlock,destruction,6,4,2
Apoklock,area-52,384,warlock,destruction,6,4,2
Wallzz,gnomeregan,384,warlock,destruction,6,4,2
Bertnasty,tichondrius,384,warlock,destruction,6,4,2
Outkãst,illidan,384,warlock,destruction,6,4,2
Asukakira,tichondrius,384,warlock,destruction,6,4,2
Vilebrute,illidan,384,warlock,destruction,6,4,2
Syraxi,illidan,384,warlock,destruction,6,4,2
Biger,nemesis,384,warlock,destruction,6,4,2
Hawtchili,illidan,384,warlock,destruction,6,4,2
Eatmybeef,ravencrest,384,warlock,destruction,6,4,2
Lazarùs,zuljin,384,warlock,destruction,6,4,2
Fatuglyegirl,sargeras,384,warlock,destruction,6,4,2
Lockiana,zuljin,384,warlock,destruction,6,4,2
Alwysoom,aegwynn,384,warlock,destruction,6,4,2
Ardamelech,quelthalas,384,warlock,destruction,6,4,2
Mithlock,azralon,384,warlock,destruction,6,4,2
Dematic,illidan,384,warlock,destruction,6,4,2
Methrocks,emerald-dream,384,warlock,destruction,6,4,2
Sakeer,quelthalas,384,warlock,destruction,6,4,2
Marrowsipper,tichondrius,384,warlock,destruction,6,4,2
Kractdlk,tichondrius,384,warlock,destruction,6,4,2
Roota,dalaran,384,warlock,destruction,6,4,2
Cursebolt,tichondrius,384,warlock,destruction,6,4,2
Ozidus,tichondrius,384,warlock,destruction,6,4,2
Gamenine,tichondrius,384,warlock,destruction,6,4,2
Tumßle,stormreaver,384,warlock,destruction,6,4,2
Oldgodkiller,kelthuzad,384,warlock,destruction,6,4,2
Moramont,stormrage,384,warlock,destruction,6,4,2
Chumbing,sargeras,384,warlock,destruction,6,4,2
Anthaxel,dalaran,384,warlock,destruction,6,4,2
Saitibolty,dalaran,384,warlock,destruction,6,4,2
Rendori,the-scryers,384,warlock,destruction,6,4,2
Mattybolts,tichondrius,384,warlock,destruction,6,4,2
Evolda,tichondrius,384,warlock,destruction,6,4,2
Moistpoodle,the-underbog,384,warlock,destruction,6,4,2
Laytome,stormreaver,384,warlock,destruction,6,4,2
Tizzy,malganis,384,warlock,destruction,6,4,2
Slappndemons,mugthol,384,warlock,destruction,6,4,2
Tichondrus,ragnaros,384,warlock,destruction,6,4,2
Agla,quelthalas,384,warlock,destruction,6,4,2
Asalaviik,illidan,384,warlock,destruction,6,4,2
Zërlina,area-52,384,warlock,destruction,6,4,2
Arckádia,stormrage,384,warlock,destruction,6,4,2
Cønsfèáracy,sargeras,384,warlock,destruction,6,4,2
Drgiggles,tichondrius,384,warlock,destruction,6,4,2
Leyzer,stormrage,384,warlock,destruction,6,4,2
Asiopdu,tichondrius,384,warlock,destruction,6,4,2
Naginikill,zuljin,384,warlock,destruction,6,4,2
Instababe,stormrage,384,warlock,destruction,6,4,2
Gilfhunter,hellscream,384,warlock,destruction,6,4,2
Dçíöçk,tichondrius,384,warlock,destruction,6,4,2
Fearoshimá,thrall,384,warlock,destruction,6,4,2
Warlocksz,kelthuzad,384,warlock,destruction,6,4,2
Bugbugg,tichondrius,384,warlock,destruction,6,4,2
Fyahwalka,aggramar,384,warlock,destruction,6,4,2
Décalisse,eonar,384,warlock,destruction,6,4,2
Zevoc,tichondrius,384,warlock,destruction,6,4,2
Litemeatlary,kelthuzad,384,warlock,destruction,6,4,2
Brokenaf,stormrage,384,warlock,destruction,6,4,2
Sheetzlock,azgalor,384,warlock,destruction,6,4,2
Fearann,ragnaros,384,warlock,destruction,6,4,2
Incantation,moon-guard,384,warlock,destruction,6,4,2
Mmrceo,azgalor,384,warlock,destruction,6,4,2
Galtur,azralon,384,warlock,destruction,6,4,2
Hoana,azralon,384,warlock,destruction,6,4,2
Toomanymind,stormrage,384,warlock,destruction,6,4,2
Flayaz,bleeding-hollow,384,warlock,destruction,6,4,2
Espanol,magtheridon,384,warlock,destruction,6,4,2
Antagony,bleeding-hollow,384,warlock,destruction,6,4,2
Solöw,tichondrius,384,warlock,destruction,6,4,2
Norastrum,area-52,384,warlock,destruction,6,4,2
Stambye,ragnaros,384,warlock,destruction,6,4,2
Smallj,zuljin,384,warlock,destruction,6,4,2
Xijp,illidan,384,warlock,destruction,6,4,2
Thelynx,chogall,384,warlock,destruction,6,4,2
Frem,eonar,384,warlock,destruction,6,4,2
Donttouchme,azralon,384,warlock,destruction,6,4,2
Fatherbolt,tichondrius,384,warlock,destruction,6,4,2
Bedtimes,tichondrius,384,warlock,destruction,6,4,2
Dottcom,laughing-skull,384,warlock,destruction,6,4,2
Magvezx,kelthuzad,384,warlock,destruction,6,4,2
Deathtones,moon-guard,384,warlock,destruction,6,4,2
Doubledigit,tichondrius,384,warlock,destruction,6,4,2
Calcadius,zuljin,384,warlock,destruction,6,4,2
Kroshuto,ragnaros,384,warlock,destruction,6,4,2
Lîlý,bleeding-hollow,384,warlock,destruction,6,4,2
Gamecover,azralon,384,warlock,destruction,6,4,2
Pokendot,illidan,384,warlock,destruction,6,4,2
Wreckquiem,burning-blade,384,warlock,destruction,6,4,2
Khaos,norgannon,384,warlock,destruction,6,4,2
Erock,korgath,384,warlock,destruction,6,4,2
Underchicken,blackrock,384,warlock,destruction,6,4,2
Darkguile,kiljaeden,384,warlock,destruction,6,4,2
Kerrigan,the-venture-co,384,warlock,destruction,6,4,2
Damienn,wyrmrest-accord,384,warlock,destruction,6,4,2
Siltharious,senjin,384,warlock,destruction,6,4,2
Leekeeaynis,frostmourne,384,warlock,destruction,6,4,2
Charognart,lightninghoof,384,warlock,destruction,6,4,2
Ñever,winterhoof,384,warlock,destruction,6,4,2
Vaynnei,kiljaeden,384,warlock,destruction,6,4,2
Menedemus,amanthul,384,warlock,destruction,6,4,2
Buccs,barthilas,384,warlock,destruction,6,4,2
Jerothia,lethon,384,warlock,destruction,6,4,2
Clamdischarg,frostmourne,384,warlock,destruction,6,4,2
Eliquis,frostmane,384,warlock,destruction,6,4,2
Souwantwar,kiljaeden,384,warlock,destruction,6,4,2
Deathboltx,zuljin,384,warlock,destruction,9,5,4
Meathat,gorefiend,384,warlock,destruction,9,5,4
Soulfired,kiljaeden,384,warlock,destruction,11,5,6
Rhaègar,kiljaeden,384,warlock,destruction,15,5,10
Fullmelt,azjolnerub,384,warlock,destruction,12,4,8
Medraut,wyrmrest-accord,384,warlock,destruction,12,4,8
Offendor,stormrage,384,warlock,destruction,12,4,8
Blumercricet,stormrage,384,warlock,destruction,12,4,8
Demowolock,area-52,384,warlock,destruction,12,4,8
Veyra,malganis,384,warlock,destruction,12,4,8
Darksòúl,stormrage,384,warlock,destruction,12,4,8
Poisondeepnu,malganis,384,warlock,destruction,12,4,8
Bjarke,malganis,384,warlock,destruction,12,4,8
Crafterism,barthilas,384,warlock,destruction,12,4,8
Kelthutard,area-52,384,warlock,destruction,12,4,8
Madamenapalm,wyrmrest-accord,384,warlock,destruction,12,4,8
Dotington,frostmourne,384,warlock,destruction,12,4,8
Lockandestro,tichondrius,384,warlock,destruction,12,4,8
Catastrophk,malganis,384,warlock,destruction,12,4,8
Mostlyundead,darkspear,384,warlock,destruction,12,4,8
Nintendøt,malganis,384,warlock,destruction,12,4,8
Nazrakin,malganis,384,warlock,destruction,12,4,8
Snailbite,tichondrius,384,warlock,destruction,12,4,8
Daedayus,frostwolf,384,warlock,destruction,12,4,8
Capïrota,nemesis,384,warlock,destruction,12,4,8
Greenbolts,area-52,384,warlock,destruction,12,4,8
Sailuhh,frostwolf,384,warlock,destruction,12,4,8
Jxstinl,tichondrius,384,warlock,destruction,12,4,8
Letsfckingo,tichondrius,384,warlock,destruction,12,4,8
Freezâ,stormrage,384,warlock,destruction,12,4,8
Panicmode,darkspear,384,warlock,destruction,12,4,8
Perfidien,tichondrius,384,warlock,destruction,12,4,8
Stonelocke,area-52,384,warlock,destruction,12,4,8
Fowll,frostwolf,384,warlock,destruction,12,4,8
Lila,kaelthas,384,warlock,destruction,12,4,8
Lockeando,ragnaros,384,warlock,destruction,12,4,8
Mokushiroku,trollbane,384,warlock,destruction,12,4,8
Kholdstarev,thunderlord,384,warlock,destruction,12,4,8
Puddulz,thrall,384,warlock,destruction,12,4,8
Alexmeister,jubeithos,384,warlock,destruction,12,4,8
Evarona,gorefiend,384,warlock,destruction,12,4,8
Jáws,zuljin,384,warlock,destruction,12,4,8
Pitou,akama,384,warlock,destruction,12,4,8
Antigotenent,sargeras,384,warlock,destruction,12,4,8
Dotsamoray,frostmourne,384,warlock,destruction,12,4,8
Aededa,proudmoore,384,warlock,destruction,12,4,8
Persianloc,tichondrius,384,warlock,destruction,12,4,8
Awangdemon,tichondrius,384,warlock,destruction,12,4,8
Capslockfury,frostmourne,384,warlock,destruction,12,4,8
Speedlock,daggerspine,384,warlock,destruction,12,4,8
Maleficist,bleeding-hollow,384,warlock,destruction,12,4,8
Overlard,illidan,384,warlock,destruction,12,4,8
Flocka,agamaggan,384,warlock,destruction,12,4,8
Malavik,moon-guard,384,warlock,destruction,12,4,8
Syileria,frostmourne,384,warlock,destruction,12,4,8
Dpz,darkspear,384,warlock,destruction,12,4,8
Stepmommie,moon-guard,384,warlock,destruction,12,4,8
Giggideez,bleeding-hollow,384,warlock,destruction,12,4,8
Rumpology,illidan,384,warlock,destruction,12,4,8
Praemonium,dalaran,384,warlock,destruction,12,4,8
Twospliff,sargeras,384,warlock,destruction,16,5,11
Mozbet,kiljaeden,384,warlock,destruction,13,4,9
Pvman,onyxia,384,warlock,destruction,18,4,14
Destroyaz,stormreaver,383,warlock,destruction,6,4,2
Pointproven,tichondrius,383,warlock,destruction,6,4,2
Stonelocker,stormrage,383,warlock,destruction,6,4,2
Fëâr,trollbane,383,warlock,destruction,6,4,2
Halkroz,nathrezim,383,warlock,destruction,6,4,2
Gorski,frostwolf,383,warlock,destruction,6,4,2
Gängrëna,azralon,383,warlock,destruction,12,4,8
Asheräh,stormrage,383,warlock,destruction,12,4,8
Eliphas,bronzebeard,383,warlock,destruction,12,4,8
Loçkshow,hyjal,383,warlock,destruction,12,4,8
Fearanddots,moon-guard,383,warlock,destruction,12,4,8
Coheatt,hyjal,383,warlock,destruction,12,4,8
Arthürr,thrall,383,warlock,destruction,12,4,8
Downing,drakkari,383,warlock,destruction,12,4,8
Albuuss,daggerspine,383,warlock,destruction,12,4,8
Covidbussin,cenarius,383,warlock,destruction,12,4,8
Trilleon,eldrethalas,383,warlock,destruction,12,4,8
Yesmistress,thrall,383,warlock,destruction,14,4,10
Necromaniac,nerzhul,383,warlock,destruction,18,4,14
Mageline,thrall,382,warlock,destruction,18,4,14
Sargrath,ragnaros,381,warlock,destruction,12,4,8
Ðêcimatê,frostmourne,361,warlock,destruction,12,6,6
Plaguelnc,illidan,352,warlock,destruction,10,5,5
Startx,tichondrius,351,warlock,destruction,11,4,7
Voodoowan,bleeding-hollow,351,warlock,destruction,11,4,7
Vanvídd,ragnaros,351,warlock,destruction,11,4,7
Vetic,area-52,351,warlock,destruction,11,4,7
Cyrillus,moon-guard,351,warlock,destruction,11,4,7
Auntzhang,tichondrius,351,warlock,destruction,23,4,19
Gobbledeez,moknathal,349,warlock,destruction,19,5,14
Kidneystone,emerald-dream,346,warlock,destruction,17,8,9
Amaroth,spinebreaker,335,warlock,destruction,11,4,7
Sooshi,malganis,330,warlock,destruction,11,6,5
Lockazo,quelthalas,330,warlock,destruction,11,6,5
Casusita,area-52,322,warlock,destruction,16,6,10
Sojulord,sargeras,320,warlock,destruction,10,4,6
Nozixx,thrall,320,warlock,destruction,16,4,12
Saintläurent,bleeding-hollow,319,warlock,destruction,5,4,1
Valkynaris,chogall,319,warlock,destruction,14,4,10
Nòpê,tichondrius,288,warlock,destruction,6,3,3
Geofar,bleeding-hollow,288,warlock,destruction,6,3,3
Shädowflame,bleeding-hollow,288,warlock,destruction,6,3,3
Reallygud,tichondrius,288,warlock,destruction,6,3,3
Uncann,bleeding-hollow,288,warlock,destruction,6,3,3
Demtros,tichondrius,288,warlock,destruction,6,3,3
Oleg,bleeding-hollow,288,warlock,destruction,6,3,3
Mystrix,illidan,288,warlock,destruction,6,3,3
Jangbii,tichondrius,288,warlock,destruction,6,3,3
Chaosßolts,illidan,288,warlock,destruction,6,3,3
Minos,tichondrius,288,warlock,destruction,6,3,3
Kiami,destromath,288,warlock,destruction,6,3,3
ßolts,frostmourne,288,warlock,destruction,6,3,3
Dashaad,illidan,288,warlock,destruction,6,3,3
Dohmie,argent-dawn,288,warlock,destruction,6,3,3
Rexington,hyjal,288,warlock,destruction,6,3,3
Marothredd,nathrezim,288,warlock,destruction,6,3,3
Xoroth,crushridge,288,warlock,destruction,6,3,3
Skýnët,tichondrius,288,warlock,destruction,6,3,3
Weaselherder,illidan,288,warlock,destruction,6,3,3
Papablasty,nagrand,288,warlock,destruction,6,3,3
Anastadora,proudmoore,288,warlock,destruction,6,3,3
Ratedtorgast,illidan,288,warlock,destruction,6,3,3
Feeltheviibe,zuljin,288,warlock,destruction,6,3,3
Sàill,tichondrius,288,warlock,destruction,6,3,3
Famouslos,anetheron,288,warlock,destruction,6,3,3
Begelock,illidan,288,warlock,destruction,6,3,3
Bunami,kiljaeden,288,warlock,destruction,6,3,3
Meltingface,bleeding-hollow,288,warlock,destruction,6,3,3
Karter,anetheron,288,warlock,destruction,6,3,3
Felsgoodman,illidan,288,warlock,destruction,6,3,3
Noslock,aegwynn,288,warlock,destruction,6,3,3
Conboi,tichondrius,288,warlock,destruction,6,3,3
Jishtructo,frostmourne,288,warlock,destruction,6,3,3
Thelock,tichondrius,288,warlock,destruction,6,3,3
Worstname,hakkar,288,warlock,destruction,6,3,3
Gümbÿ,illidan,288,warlock,destruction,6,3,3
Tiptonb,tichondrius,288,warlock,destruction,6,3,3
Massta,tichondrius,288,warlock,destruction,6,3,3
Xocxusegeic,illidan,288,warlock,destruction,6,3,3
Amuros,illidan,288,warlock,destruction,6,3,3
Drelgun,aerie-peak,288,warlock,destruction,6,3,3
Gurlock,illidan,288,warlock,destruction,6,3,3
Voldamorte,tichondrius,288,warlock,destruction,6,3,3
Gotfear,zuljin,288,warlock,destruction,6,3,3
Jaazmin,ragnaros,288,warlock,destruction,6,3,3
Æsidius,tichondrius,288,warlock,destruction,6,3,3
Râsh,tichondrius,288,warlock,destruction,6,3,3
Sweetjezuz,barthilas,288,warlock,destruction,6,3,3
Nbayoungbolt,altar-of-storms,288,warlock,destruction,6,3,3
Unquit,frostmourne,288,warlock,destruction,6,3,3
Borudo,thrall,288,warlock,destruction,6,3,3
Signalnine,thrall,288,warlock,destruction,6,3,3
Shawzyy,tichondrius,288,warlock,destruction,6,3,3
Nihilus,anvilmar,288,warlock,destruction,6,3,3
Bonermarrow,tichondrius,288,warlock,destruction,6,3,3
Lockabeesha,chogall,288,warlock,destruction,6,3,3
Atheô,ragnaros,288,warlock,destruction,6,3,3
Hëctic,nerzhul,288,warlock,destruction,6,3,3
Vetadul,proudmoore,288,warlock,destruction,6,3,3
Eiram,ragnaros,288,warlock,destruction,6,3,3
Eh,laughing-skull,288,warlock,destruction,6,3,3
Nismo,trollbane,288,warlock,destruction,6,3,3
Deejaye,frostmourne,288,warlock,destruction,6,3,3
Muchopower,ragnaros,288,warlock,destruction,6,3,3
Ladaa,tichondrius,288,warlock,destruction,6,3,3
Ragnorök,medivh,288,warlock,destruction,6,3,3
Neversoft,bleeding-hollow,288,warlock,destruction,6,3,3
Souldotz,proudmoore,288,warlock,destruction,6,3,3
Slothdots,tichondrius,288,warlock,destruction,6,3,3
Feardr,frostmourne,288,warlock,destruction,6,3,3
Coret,moonrunner,288,warlock,destruction,6,3,3
Toastyybone,hellscream,288,warlock,destruction,6,3,3
Ökïlôck,proudmoore,288,warlock,destruction,6,3,3
Bléssédx,tichondrius,288,warlock,destruction,6,3,3
Blastindotz,frostmane,288,warlock,destruction,6,3,3
Aruotnof,nemesis,288,warlock,destruction,6,3,3
Xbendover,proudmoore,288,warlock,destruction,6,3,3
Cleptomain,tichondrius,288,warlock,destruction,6,3,3
Bazeni,frostmourne,288,warlock,destruction,6,3,3
Xblessed,stormrage,288,warlock,destruction,6,3,3
Krazyjay,bleeding-hollow,288,warlock,destruction,6,3,3
Astarothe,proudmoore,288,warlock,destruction,6,3,3
Pennydrop,barthilas,288,warlock,destruction,6,3,3
Cocoabuttâ,stormrage,288,warlock,destruction,6,3,3
Carpedemon,malganis,288,warlock,destruction,6,3,3
Hamdulla,tichondrius,288,warlock,destruction,6,3,3
Warlockluo,tichondrius,288,warlock,destruction,6,3,3
Peterdotz,whisperwind,288,warlock,destruction,6,3,3
Maledictivus,stormrage,288,warlock,destruction,6,3,3
Bellwulf,goldrinn,288,warlock,destruction,6,3,3
Metaphors,stormrage,288,warlock,destruction,6,3,3
Saffuky,frostmourne,288,warlock,destruction,6,3,3
Picklecatz,barthilas,288,warlock,destruction,6,3,3
Voldormort,uldaman,288,warlock,destruction,6,3,3
Moxilli,malganis,288,warlock,destruction,6,3,3
Ärminvßuurën,barthilas,288,warlock,destruction,6,3,3
Feartool,stormrage,288,warlock,destruction,6,3,3
Hairydottr,malganis,288,warlock,destruction,6,3,3
Gingerlock,stonemaul,288,warlock,destruction,6,3,3
Lillpfudd,area-52,288,warlock,destruction,6,3,3
Stretchmark,stormrage,288,warlock,destruction,6,3,3
Hauntgød,tichondrius,288,warlock,destruction,6,3,3
Nvmb,frostmourne,288,warlock,destruction,6,3,3
Spacemonkey,malganis,288,warlock,destruction,6,3,3
Shâdowman,stormrage,288,warlock,destruction,6,3,3
Embraces,tichondrius,288,warlock,destruction,6,3,3
Babylung,bleeding-hollow,288,warlock,destruction,6,3,3
Crucifieds,tichondrius,288,warlock,destruction,6,3,3
Poggyjones,tichondrius,288,warlock,destruction,6,3,3
Itsawarlock,thunderlord,288,warlock,destruction,6,3,3
Chesterfear,quelthalas,288,warlock,destruction,6,3,3
Vampydark,quelthalas,288,warlock,destruction,6,3,3
Phénom,tichondrius,288,warlock,destruction,6,3,3
Pennÿ,quelthalas,288,warlock,destruction,6,3,3
Shadøwcrits,quelthalas,288,warlock,destruction,6,3,3
Ovoíd,area-52,288,warlock,destruction,6,3,3
Warlooch,area-52,288,warlock,destruction,6,3,3
Vìqtìm,kelthuzad,288,warlock,destruction,6,3,3
Sorath,blackrock,288,warlock,destruction,6,3,3
Lcomi,tichondrius,288,warlock,destruction,6,3,3
Xephostwo,area-52,288,warlock,destruction,6,3,3
Attackbird,area-52,288,warlock,destruction,6,3,3
Odelgabiana,area-52,288,warlock,destruction,6,3,3
Ðëâthløck,tichondrius,288,warlock,destruction,6,3,3
Devi,destromath,288,warlock,destruction,6,3,3
Thisisturtle,area-52,288,warlock,destruction,6,3,3
Ijustsharded,area-52,288,warlock,destruction,6,3,3
Bushmelded,tichondrius,288,warlock,destruction,6,3,3
Drßöb,area-52,288,warlock,destruction,6,3,3
Fungiforest,kelthuzad,288,warlock,destruction,6,3,3
Mylock,andorhal,288,warlock,destruction,6,3,3
Tacolock,azshara,288,warlock,destruction,6,3,3
Merlinsbeard,zuluhed,288,warlock,destruction,6,3,3
Mamabolts,kelthuzad,288,warlock,destruction,6,3,3
Mileyswift,kelthuzad,288,warlock,destruction,6,3,3
Vxms,barthilas,288,warlock,destruction,6,3,3
Famelol,tichondrius,288,warlock,destruction,6,3,3
Lochek,stonemaul,288,warlock,destruction,6,3,3
Ÿoucantwin,kiljaeden,288,warlock,destruction,6,3,3
Tamzlock,the-forgotten-coast,288,warlock,destruction,6,3,3
Päinoth,wyrmrest-accord,288,warlock,destruction,6,3,3
Nutzosaurus,darkspear,288,warlock,destruction,6,3,3
Watchdatfear,dragonmaw,288,warlock,destruction,6,3,3
Toxicatedz,azralon,288,warlock,destruction,6,3,3
Héllboy,akama,288,warlock,destruction,6,3,3
Homeschooler,darkspear,288,warlock,destruction,6,3,3
Turbocleave,blackwater-raiders,288,warlock,destruction,6,3,3
Lockhomes,azralon,288,warlock,destruction,6,3,3
Shifulock,azralon,288,warlock,destruction,6,3,3
Evianne,skywall,288,warlock,destruction,6,3,3
Trainwreck,sargeras,288,warlock,destruction,6,3,3
Pheríe,sargeras,288,warlock,destruction,6,3,3
Niétzsché,emerald-dream,288,warlock,destruction,6,3,3
Blaxzlock,stormscale,288,warlock,destruction,6,3,3
Háydn,azuremyst,288,warlock,destruction,6,3,3
Larsiezwei,spirestone,288,warlock,destruction,6,3,3
Siphoned,darkspear,288,warlock,destruction,6,3,3
Dluttysots,emerald-dream,288,warlock,destruction,6,3,3
Ñevaeh,emerald-dream,288,warlock,destruction,6,3,3
Ashtak,coilfang,288,warlock,destruction,6,3,3
Graveland,frostwolf,288,warlock,destruction,6,3,3
Amauder,moon-guard,288,warlock,destruction,6,3,3
Gouzenko,emerald-dream,288,warlock,destruction,6,3,3
Lockaloga,azralon,288,warlock,destruction,6,3,3
Mfcalamity,uldum,288,warlock,destruction,6,3,3
Dotbot,blades-edge,288,warlock,destruction,6,3,3
Dogcookie,moon-guard,288,warlock,destruction,6,3,3
Silkxy,frostwolf,288,warlock,destruction,6,3,3
Reyaena,moon-guard,288,warlock,destruction,6,3,3
Dolcex,sargeras,288,warlock,destruction,6,3,3
Miratrix,moon-guard,288,warlock,destruction,6,3,3
Youngblood,maelstrom,288,warlock,destruction,6,3,3
Creedmore,sargeras,288,warlock,destruction,6,3,3
Uwubolt,moon-guard,288,warlock,destruction,6,3,3
Ouijafaps,sargeras,288,warlock,destruction,6,3,3
Ministàff,ursin,288,warlock,destruction,9,4,5
Lycanthropi,illidan,288,warlock,destruction,9,4,5
Taldaroth,moon-guard,288,warlock,destruction,7,3,4
Cult,smolderthorn,288,warlock,destruction,7,3,4
Fluximilian,azralon,288,warlock,destruction,10,4,6
Amidone,bleeding-hollow,288,warlock,destruction,10,4,6
Malleus,drakkari,288,warlock,destruction,8,3,5
Fex,hyjal,288,warlock,destruction,8,3,5
Verminperson,illidan,288,warlock,destruction,8,3,5
Trotndot,dragonmaw,288,warlock,destruction,12,3,9
Shaddaj,illidan,288,warlock,destruction,12,3,9
Wyrelock,hyjal,288,warlock,destruction,12,3,9
Amour,wyrmrest-accord,288,warlock,destruction,12,3,9
Reluxify,dalaran,288,warlock,destruction,12,3,9
Methology,wyrmrest-accord,288,warlock,destruction,12,3,9
Mireffect,auchindoun,288,warlock,destruction,12,3,9
Sulívan,azralon,288,warlock,destruction,12,3,9
Fearfactory,lethon,288,warlock,destruction,12,3,9
Rabiesdot,tichondrius,288,warlock,destruction,12,3,9
Huskee,sargeras,288,warlock,destruction,12,3,9
Gotty,stormrage,288,warlock,destruction,12,3,9
Belfomént,ragnaros,288,warlock,destruction,12,3,9
Teedub,thrall,288,warlock,destruction,12,3,9
Wickedt,ragnaros,288,warlock,destruction,12,3,9
Gorgaron,zuljin,288,warlock,destruction,12,3,9
Demonâ,ragnaros,288,warlock,destruction,12,3,9
Vickerzz,barthilas,288,warlock,destruction,12,3,9
Zeshlo,firetree,288,warlock,destruction,12,3,9
Gdpx,malganis,288,warlock,destruction,12,3,9
Demondays,sargeras,288,warlock,destruction,12,3,9
Hachiui,galakrond,288,warlock,destruction,12,3,9
Héstia,area-52,288,warlock,destruction,12,3,9
Sambodeemon,proudmoore,288,warlock,destruction,12,3,9
Dopamine,antonidas,288,warlock,destruction,12,3,9
Mageus,blood-furnace,288,warlock,destruction,12,3,9
Darkhadouken,sargeras,288,warlock,destruction,12,3,9
Voidmãngõ,stormrage,288,warlock,destruction,12,3,9
Zeeref,stormrage,288,warlock,destruction,12,3,9
Taoloni,stormrage,288,warlock,destruction,12,3,9
Cexdragon,tichondrius,288,warlock,destruction,14,3,11
Gulliftonan,zuljin,288,warlock,destruction,18,3,15
Báál,bleeding-hollow,288,warlock,destruction,18,3,15
Sykolock,lethon,287,warlock,destruction,6,3,3
Izmadara,frostmane,287,warlock,destruction,6,3,3
Brenmen,tichondrius,287,warlock,destruction,6,3,3
Trrolling,jubeithos,287,warlock,destruction,12,5,7
Alvatio,tichondrius,287,warlock,destruction,12,3,9
Evilbacon,stormrage,287,warlock,destruction,12,3,9
Deathwishiz,tichondrius,287,warlock,destruction,12,3,9
Drunklockdot,tichondrius,271,warlock,destruction,11,3,8
Ainzeal,nagrand,256,warlock,destruction,10,4,6
Sophia,wildhammer,255,warlock,destruction,8,4,4
Mikejones,dawnbringer,255,warlock,destruction,14,4,10
Draisien,moon-guard,250,warlock,destruction,7,5,2
Warakaso,ragnaros,240,warlock,destruction,9,3,6
Nawtychannel,aegwynn,239,warlock,destruction,5,3,2
Blightbeast,area-52,239,warlock,destruction,5,3,2
Infectionl,ragnaros,239,warlock,destruction,5,3,2
Alliciia,area-52,234,warlock,destruction,11,5,6
Wàtchmebolt,dalvengyr,223,warlock,destruction,8,3,5
Nokturnal,norgannon,208,warlock,destruction,7,3,4
Amaia,nathrezim,207,warlock,destruction,7,3,4
Portalgun,tichondrius,192,warlock,destruction,4,3,1
Draindeez,sargeras,192,warlock,destruction,9,3,6
Benbuttons,sargeras,192,warlock,destruction,9,3,6
Demiloy,stormrage,192,warlock,destruction,9,3,6
Dramylock,sargeras,192,warlock,destruction,6,2,4
Outlanderr,tichondrius,192,warlock,destruction,6,2,4
Nolb,tichondrius,192,warlock,destruction,6,2,4
Srz,stormrage,192,warlock,destruction,6,2,4
Zivira,stormrage,192,warlock,destruction,6,2,4
Jaydero,lightbringer,192,warlock,destruction,6,2,4
Nüts,blackrock,192,warlock,destruction,6,2,4
Gadalann,area-52,192,warlock,destruction,6,2,4
Locksama,area-52,192,warlock,destruction,6,2,4
Lhorgainz,area-52,192,warlock,destruction,6,2,4
Tirisfel,tichondrius,192,warlock,destruction,6,2,4
Riiselock,shadow-council,192,warlock,destruction,6,2,4
Bigballslock,ragnaros,192,warlock,destruction,6,2,4
Yordich,kelthuzad,192,warlock,destruction,6,2,4
Afflicmindz,azralon,192,warlock,destruction,6,2,4
Cronobolts,stormrage,192,warlock,destruction,6,2,4
Montaine,malganis,192,warlock,destruction,6,2,4
Oprahofbolts,area-52,192,warlock,destruction,6,2,4
Msdotfire,nazjatar,192,warlock,destruction,6,2,4
Guisls,azralon,192,warlock,destruction,6,2,4
Dotzlol,jubeithos,192,warlock,destruction,6,2,4
Medusablood,area-52,192,warlock,destruction,6,2,4
Konarik,nagrand,192,warlock,destruction,6,2,4
Zephiy,kelthuzad,192,warlock,destruction,6,2,4
Oopsíe,nagrand,192,warlock,destruction,6,2,4
Drkdestro,boulderfist,192,warlock,destruction,6,2,4
Biznam,tichondrius,192,warlock,destruction,6,2,4
Omegawarlock,quelthalas,192,warlock,destruction,6,2,4
Njunx,queldorei,192,warlock,destruction,6,2,4
Mortallicus,proudmoore,192,warlock,destruction,6,2,4
Seizuresauce,stormrage,192,warlock,destruction,6,2,4
Lexist,darkspear,192,warlock,destruction,6,2,4
Sinsky,darkspear,192,warlock,destruction,6,2,4
Gaijin,stormrage,192,warlock,destruction,6,2,4
Hadeys,amanthul,192,warlock,destruction,6,2,4
Demonia,dathremar,192,warlock,destruction,6,2,4
Fluffylockk,bloodscalp,192,warlock,destruction,6,2,4
Bleachkk,tichondrius,192,warlock,destruction,6,2,4
Gvz,tichondrius,192,warlock,destruction,6,2,4
Percadu,barthilas,192,warlock,destruction,6,2,4
Hollows,burning-blade,192,warlock,destruction,6,2,4
Moistdank,tichondrius,192,warlock,destruction,6,2,4
Brawndelock,stormrage,192,warlock,destruction,6,2,4
Ganggu,tichondrius,192,warlock,destruction,6,2,4
Ðamndaddy,sargeras,192,warlock,destruction,6,2,4
Lilthicy,sargeras,192,warlock,destruction,6,2,4
Diablox,silvermoon,192,warlock,destruction,6,2,4
Mlx,proudmoore,192,warlock,destruction,6,2,4
Fstndantilus,moonrunner,192,warlock,destruction,6,2,4
Theyfearbuda,kelthuzad,192,warlock,destruction,6,2,4
Amz,grizzly-hills,192,warlock,destruction,6,2,4
Aksanaa,area-52,192,warlock,destruction,6,2,4
Corruptious,frostmourne,192,warlock,destruction,6,2,4
Reckzet,stormrage,192,warlock,destruction,6,2,4
Mutexlock,whisperwind,192,warlock,destruction,6,2,4
Dedrae,silvermoon,192,warlock,destruction,6,2,4
Ðuckworth,azralon,192,warlock,destruction,6,2,4
Înfèçtìön,emerald-dream,192,warlock,destruction,6,2,4
Maxice,zuljin,192,warlock,destruction,6,2,4
Herewegoagai,zuljin,192,warlock,destruction,6,2,4
Nightterrour,frostmourne,192,warlock,destruction,6,2,4
Flixon,tichondrius,192,warlock,destruction,6,2,4
Valydri,stormrage,192,warlock,destruction,6,2,4
Cthuga,frostmourne,192,warlock,destruction,6,2,4
Theredwolf,zuljin,192,warlock,destruction,6,2,4
Cauldron,tichondrius,192,warlock,destruction,6,2,4
Yêrfdog,proudmoore,192,warlock,destruction,6,2,4
Diabolock,proudmoore,192,warlock,destruction,6,2,4
Lolokayhaha,vashj,192,warlock,destruction,6,2,4
Toxik,zuljin,192,warlock,destruction,6,2,4
Checkit,zuljin,192,warlock,destruction,6,2,4
Sugarfire,nemesis,192,warlock,destruction,6,2,4
Dchichi,tichondrius,192,warlock,destruction,6,2,4
Geauxst,tichondrius,192,warlock,destruction,6,2,4
Disapoin,stormrage,192,warlock,destruction,6,2,4
Itzlandox,emerald-dream,192,warlock,destruction,6,2,4
Leine,proudmoore,192,warlock,destruction,6,2,4
Sorenbjerga,zuljin,192,warlock,destruction,6,2,4
Zoboo,zuljin,192,warlock,destruction,6,2,4
Cityswimmer,malganis,192,warlock,destruction,6,2,4
Qbl,wyrmrest-accord,192,warlock,destruction,6,2,4
Baalock,frostmourne,192,warlock,destruction,6,2,4
Adalaya,emerald-dream,192,warlock,destruction,6,2,4
Gihaewon,tichondrius,192,warlock,destruction,6,2,4
Zlocks,scilla,192,warlock,destruction,6,2,4
Rickystuart,tichondrius,192,warlock,destruction,6,2,4
Fbgmel,emerald-dream,192,warlock,destruction,6,2,4
Imindanger,frostmourne,192,warlock,destruction,6,2,4
Pepzz,emerald-dream,192,warlock,destruction,6,2,4
Rococo,emerald-dream,192,warlock,destruction,6,2,4
Fjklock,nemesis,192,warlock,destruction,6,2,4
Xalcezar,sargeras,192,warlock,destruction,6,2,4
Pinguswalrus,stormrage,192,warlock,destruction,6,2,4
Petez,sargeras,192,warlock,destruction,6,2,4
Asaveyous,wyrmrest-accord,192,warlock,destruction,6,2,4
Dach,moon-guard,192,warlock,destruction,6,2,4
Ibanez,bleeding-hollow,192,warlock,destruction,6,2,4
Deiformis,malganis,192,warlock,destruction,6,2,4
Mothapucka,thrall,192,warlock,destruction,6,2,4
Lynnha,wyrmrest-accord,192,warlock,destruction,6,2,4
Åchse,ragnaros,192,warlock,destruction,6,2,4
Vorkaz,moon-guard,192,warlock,destruction,6,2,4
Nonamehero,tichondrius,192,warlock,destruction,6,2,4
Lazzie,thrall,192,warlock,destruction,6,2,4
Encanis,dalaran,192,warlock,destruction,6,2,4
Darkbaron,khadgar,192,warlock,destruction,6,2,4
Maniacal,shattered-halls,192,warlock,destruction,6,2,4
Xaraki,skullcrusher,192,warlock,destruction,6,2,4
Plzdont,blades-edge,192,warlock,destruction,6,2,4
Ourlegacy,tichondrius,192,warlock,destruction,6,2,4
Amazeus,tichondrius,192,warlock,destruction,6,2,4
Idoturmum,frostmourne,192,warlock,destruction,6,2,4
Apokálipse,frostmourne,192,warlock,destruction,6,2,4
Raisa,chogall,192,warlock,destruction,6,2,4
Infant,agamaggan,192,warlock,destruction,6,2,4
Ozie,proudmoore,192,warlock,destruction,6,2,4
Constantine,exodar,192,warlock,destruction,6,2,4
Nazug,dark-iron,192,warlock,destruction,6,2,4
Erimegara,ragnaros,192,warlock,destruction,6,2,4
Sinissa,ysondre,192,warlock,destruction,6,2,4
Gschism,ragnaros,192,warlock,destruction,6,2,4
Theboss,arygos,192,warlock,destruction,6,2,4
Nianas,ysondre,192,warlock,destruction,6,2,4
Ruellia,tichondrius,192,warlock,destruction,6,2,4
Wodinskol,sargeras,192,warlock,destruction,6,2,4
Ðemõn,area-52,192,warlock,destruction,6,2,4
Ballpain,sargeras,192,warlock,destruction,6,2,4
Raghog,kelthuzad,192,warlock,destruction,6,2,4
Savemykoalas,tichondrius,192,warlock,destruction,6,2,4
Shanelle,korgath,192,warlock,destruction,6,2,4
Blliizz,aegwynn,192,warlock,destruction,6,2,4
Yellowfevr,thrall,192,warlock,destruction,6,2,4
Cynnd,tichondrius,192,warlock,destruction,6,2,4
Spicyfingers,illidan,192,warlock,destruction,6,2,4
Æonas,bladefist,192,warlock,destruction,6,2,4
Cholock,anubarak,192,warlock,destruction,6,2,4
Gradek,dalaran,192,warlock,destruction,6,2,4
Lostlove,moon-guard,192,warlock,destruction,6,2,4
Dôctor,tichondrius,192,warlock,destruction,6,2,4
Iadminl,moon-guard,192,warlock,destruction,6,2,4
Muffinlol,frostmourne,192,warlock,destruction,6,2,4
Abbyshapiro,kelthuzad,192,warlock,destruction,6,2,4
Diabloisekai,ragnaros,192,warlock,destruction,6,2,4
Deanwarlock,sargeras,192,warlock,destruction,6,2,4
Nefertarie,illidan,192,warlock,destruction,6,2,4
Nameflagged,arathor,192,warlock,destruction,6,2,4
Eliraa,frostmourne,192,warlock,destruction,6,2,4
Dotsin,wyrmrest-accord,192,warlock,destruction,6,2,4
Sinnâcle,illidan,192,warlock,destruction,6,2,4
Camila,lightnings-blade,192,warlock,destruction,6,2,4
Ricklock,aggramar,192,warlock,destruction,6,2,4
Mythh,hyjal,192,warlock,destruction,6,2,4
Nuradzec,illidan,192,warlock,destruction,6,2,4
Poltergiiest,korgath,192,warlock,destruction,6,2,4
Ramone,turalyon,192,warlock,destruction,6,2,4
Lîch,thunderlord,192,warlock,destruction,8,2,6
Altairo,illidan,192,warlock,destruction,8,2,6
Tsunamibaby,anvilmar,192,warlock,destruction,9,2,7
Whydemono,tichondrius,192,warlock,destruction,10,2,8
Daggondai,tichondrius,192,warlock,destruction,12,2,10
Bladebank,kirin-tor,192,warlock,destruction,12,2,10
Asumi,nemesis,192,warlock,destruction,12,2,10
Hadés,aerie-peak,192,warlock,destruction,12,2,10
Moknuhg,emerald-dream,192,warlock,destruction,12,2,10
Luntrazz,arthas,192,warlock,destruction,12,2,10
Wizie,arthas,192,warlock,destruction,12,2,10
Kandrus,moon-guard,192,warlock,destruction,12,2,10
Beamac,cenarius,192,warlock,destruction,14,2,12
Ledmann,tichondrius,192,warlock,destruction,18,2,16
Pangppi,tichondrius,192,warlock,destruction,24,2,22
Mystickittie,aerie-peak,191,warlock,destruction,6,2,4
Eldrien,spirestone,191,warlock,destruction,12,2,10
Erindevil,demon-soul,191,warlock,destruction,12,2,10
Lowvalue,illidan,159,warlock,destruction,5,2,3
Lockycharms,sargeras,159,warlock,destruction,5,2,3
Zarson,illidan,159,warlock,destruction,5,2,3
Eatmyboltz,hyjal,159,warlock,destruction,5,2,3
Prds,illidan,159,warlock,destruction,5,2,3
Dotyoazz,stormrage,159,warlock,destruction,5,2,3
Fearfeaster,tichondrius,159,warlock,destruction,5,2,3
Katarameni,tortheldrin,138,warlock,destruction,7,4,3
Blakedogx,tichondrius,138,warlock,destruction,8,3,5
Gildedknight,arthas,138,warlock,destruction,10,3,7
Thegoatmen,stormrage,128,warlock,destruction,4,2,2
Catarina,kaelthas,128,warlock,destruction,4,2,2
Miggazzizle,senjin,128,warlock,destruction,4,2,2
Conilus,malganis,128,warlock,destruction,4,2,2
Hentailust,kiljaeden,128,warlock,destruction,4,2,2
Rosacrutian,tichondrius,128,warlock,destruction,4,2,2
Disclamer,tichondrius,128,warlock,destruction,4,2,2
Oreo,velen,112,warlock,destruction,7,2,5
Savubaloo,blackrock,96,warlock,destruction,3,2,1
Goodforyou,stormscale,96,warlock,destruction,3,2,1
Crankak,zuljin,96,warlock,destruction,3,2,1
Willsayan,ragnaros,96,warlock,destruction,3,2,1
Lukgar,azralon,96,warlock,destruction,3,2,1
Darkestholy,illidan,96,warlock,destruction,6,1,5
Ursuxus,moon-guard,96,warlock,destruction,6,1,5
Chilevael,sargeras,96,warlock,destruction,6,1,5
Yuengling,illidan,96,warlock,destruction,6,1,5
Proletariat,moon-guard,96,warlock,destruction,6,1,5
Kraguenöth,drakkari,96,warlock,destruction,6,1,5
Sheara,silver-hand,96,warlock,destruction,6,1,5
Rennik,haomarush,96,warlock,destruction,6,1,5
Lánathel,ragnaros,96,warlock,destruction,6,1,5
Druzzaj,thrall,96,warlock,destruction,6,1,5
Radii,bladefist,96,warlock,destruction,6,1,5
Wetweenies,illidan,96,warlock,destruction,6,1,5
Pspot,kiljaeden,96,warlock,destruction,6,1,5
Heffyboi,frostmourne,96,warlock,destruction,6,1,5
Toelickerx,illidan,96,warlock,destruction,6,1,5
Monstir,sargeras,96,warlock,destruction,6,1,5
Spellbøund,malorne,96,warlock,destruction,6,1,5
Yallsdead,frostmourne,96,warlock,destruction,6,1,5
Rëappér,ragnaros,96,warlock,destruction,6,1,5
Siaokuai,tichondrius,96,warlock,destruction,6,1,5
Basticor,moon-guard,96,warlock,destruction,6,1,5
Pwnasaurus,barthilas,96,warlock,destruction,6,1,5
Darkmatter,frostmourne,96,warlock,destruction,6,1,5
Medivhz,tichondrius,96,warlock,destruction,6,1,5
Cursenkill,sargeras,96,warlock,destruction,6,1,5
Lawkdown,dark-iron,96,warlock,destruction,6,1,5
Wesyane,anetheron,96,warlock,destruction,6,1,5
Robertloblah,sargeras,96,warlock,destruction,6,1,5
Demonellea,frostmourne,96,warlock,destruction,6,1,5
Projecto,tichondrius,96,warlock,destruction,6,1,5
Winstonblack,moon-guard,96,warlock,destruction,6,1,5
Karpawarlock,ragnaros,96,warlock,destruction,6,1,5
Wickedicky,alleria,96,warlock,destruction,6,1,5
Varix,frostmourne,96,warlock,destruction,6,1,5
Mcpickl,illidan,96,warlock,destruction,6,1,5
Demonist,moon-guard,96,warlock,destruction,6,1,5
Alcorick,moon-guard,96,warlock,destruction,6,1,5
Vexria,wyrmrest-accord,96,warlock,destruction,6,1,5
Vendareth,earthen-ring,96,warlock,destruction,6,1,5
Koillock,bleeding-hollow,96,warlock,destruction,6,1,5
Delaye,tichondrius,96,warlock,destruction,6,1,5
Brothadoinks,zuljin,96,warlock,destruction,6,1,5
Bfaclâssic,zuljin,96,warlock,destruction,6,1,5
Mílkduds,zuljin,96,warlock,destruction,6,1,5
Lilcarmy,emerald-dream,96,warlock,destruction,6,1,5
Thehempress,magtheridon,96,warlock,destruction,6,1,5
Bosshoglock,whisperwind,96,warlock,destruction,6,1,5
Saytiri,tichondrius,96,warlock,destruction,6,1,5
Adlfcritler,emerald-dream,96,warlock,destruction,6,1,5
Bitrot,jubeithos,96,warlock,destruction,6,1,5
Voky,whisperwind,96,warlock,destruction,6,1,5
Skeemer,azuremyst,96,warlock,destruction,6,1,5
Kuasta,shadowmoon,96,warlock,destruction,6,1,5
Mazip,vashj,96,warlock,destruction,6,1,5
Dotomizer,moonrunner,96,warlock,destruction,6,1,5
Lucifuhrerr,tichondrius,96,warlock,destruction,6,1,5
Jiwonpark,goldrinn,96,warlock,destruction,6,1,5
Seutóóbinha,stormrage,96,warlock,destruction,6,1,5
Crushbucket,stormreaver,96,warlock,destruction,6,1,5
Lizlock,stormrage,96,warlock,destruction,6,1,5
Charlîe,vashj,96,warlock,destruction,6,1,5
Resima,stormscale,96,warlock,destruction,6,1,5
Clias,galakrond,96,warlock,destruction,6,1,5
Gamecobra,greymane,96,warlock,destruction,6,1,5
Réliok,quelthalas,96,warlock,destruction,6,1,5
Ilxxllxxll,area-52,96,warlock,destruction,6,1,5
Eldïablo,stormrage,96,warlock,destruction,6,1,5
Kothoped,wyrmrest-accord,96,warlock,destruction,6,1,5
Hinatasu,greymane,96,warlock,destruction,6,1,5
Meinhundin,stormrage,96,warlock,destruction,6,1,5
Plaguedoctor,stormrage,96,warlock,destruction,6,1,5
Alyxandros,illidan,96,warlock,destruction,6,1,5
Niubeelol,tichondrius,96,warlock,destruction,6,1,5
Lokinzz,tichondrius,96,warlock,destruction,6,1,5
Däemön,area-52,96,warlock,destruction,6,1,5
Tubarão,azralon,96,warlock,destruction,6,1,5
Lazymongoose,frostmourne,96,warlock,destruction,6,1,5
Lokiiee,azuremyst,96,warlock,destruction,6,1,5
Vandenso,stormrage,96,warlock,destruction,6,1,5
Kaotiq,area-52,96,warlock,destruction,6,1,5
Gsr,bleeding-hollow,96,warlock,destruction,6,1,5
Siinistuh,tichondrius,96,warlock,destruction,6,1,5
Shidded,lightbringer,96,warlock,destruction,6,1,5
Chermonalbur,draka,96,warlock,destruction,6,1,5
Lockedinn,mannoroth,96,warlock,destruction,6,1,5
Elaïla,area-52,96,warlock,destruction,6,1,5
Meanda,boulderfist,96,warlock,destruction,6,1,5
Xaryus,barthilas,96,warlock,destruction,6,1,5
Fearxd,maiev,96,warlock,destruction,6,1,5
Aflictiyon,azralon,96,warlock,destruction,6,1,5
Cornboil,tichondrius,96,warlock,destruction,6,1,5
Killulock,area-52,96,warlock,destruction,6,1,5
Taddedlock,kelthuzad,96,warlock,destruction,6,1,5
Gulgrin,eldrethalas,96,warlock,destruction,6,1,5
Infear,area-52,96,warlock,destruction,6,1,5
Mônkêy,kelthuzad,96,warlock,destruction,6,1,5
Scatach,area-52,96,warlock,destruction,6,1,5
Biigdaddyy,kelthuzad,96,warlock,destruction,6,1,5
Wherelock,area-52,96,warlock,destruction,7,1,6
Nekranis,thrall,96,warlock,destruction,12,1,11
Diddy,arygos,96,warlock,destruction,12,1,11
Ashlëen,ragnaros,96,warlock,destruction,12,1,11
Mythsubpar,tichondrius,96,warlock,destruction,12,1,11
Moz,sargeras,79,warlock,destruction,5,1,4
Thiccdoinkz,tichondrius,63,warlock,destruction,2,2,0
Bagn,tichondrius,63,warlock,destruction,2,2,0
Cokelime,sargeras,63,warlock,destruction,2,2,0
Aoneandatwo,proudmoore,48,warlock,destruction,3,1,2
Clevingert,frostmourne,48,warlock,destruction,3,1,2
Kosugi,kelthuzad,42,warlock,destruction,8,2,6
Jusmessin,tichondrius,31,warlock,destruction,2,1,1
Morêdots,malganis,31,warlock,destruction,2,1,1
Amarexd,stormrage,31,warlock,destruction,2,1,1
Moräl,frostmourne,31,warlock,destruction,2,1,1
Emurog,icecrown,30,warlock,destruction,12,6,6
Amonthuzad,blackrock,16,warlock,destruction,1,1,0
Lazygnom,azshara,16,warlock,destruction,1,1,0
Goofhu,sargeras,2270,warlock,affliction,102,62,40
Exgenshinpro,proudmoore,2257,warlock,affliction,160,89,71
Yandhi,bronzebeard,2129,warlock,affliction,46,30,16
Dewandoritos,kelthuzad,2127,warlock,affliction,153,76,77
Dotdzdotdoze,tichondrius,2106,warlock,affliction,245,131,114
Goofgg,sargeras,1987,warlock,affliction,335,162,173
Rangz,tichondrius,1983,warlock,affliction,84,45,39
Tcchiu,tichondrius,1982,warlock,affliction,35,24,11
Sphoo,tichondrius,1974,warlock,affliction,94,48,46
Kålêïðøsçøpê,sargeras,1965,warlock,affliction,42,24,18
Exódia,tichondrius,1961,warlock,affliction,195,100,95
Shanyanghuxu,tichondrius,1933,warlock,affliction,42,26,16
Diminish,sargeras,1923,warlock,affliction,108,54,54
Gekku,ragnaros,1917,warlock,affliction,83,49,34
Dyenamik,stormrage,1891,warlock,affliction,60,33,27
Arityy,tichondrius,1887,warlock,affliction,90,46,44
Cumbledora,kelthuzad,1878,warlock,affliction,48,30,18
Rangrang,tichondrius,1873,warlock,affliction,108,51,57
Octopus,nerzhul,1872,warlock,affliction,64,33,31
Yellowfevr,thrall,1870,warlock,affliction,48,27,21
Hyoozy,illidan,1869,warlock,affliction,105,58,47
Jukethisxo,tichondrius,1866,warlock,affliction,105,62,43
Pardoned,stormrage,1859,warlock,affliction,41,20,21
Oymmander,illidan,1850,warlock,affliction,36,25,11
Prnhbgødx,sargeras,1850,warlock,affliction,48,26,22
Lostlock,sargeras,1847,warlock,affliction,120,68,52
Beetlejoos,stormreaver,1843,warlock,affliction,116,65,51
Hiro,steamwheedle-cartel,1829,warlock,affliction,99,56,43
Burtreynolds,shattered-hand,1827,warlock,affliction,60,31,29
Fallenis,proudmoore,1825,warlock,affliction,54,31,23
Forestfruit,tichondrius,1819,warlock,affliction,58,31,27
Renosa,illidan,1818,warlock,affliction,57,32,25
Lockhippo,illidan,1818,warlock,affliction,58,30,28
Widenose,agamaggan,1817,warlock,affliction,53,30,23
Bugbugg,tichondrius,1814,warlock,affliction,51,38,13
Woopie,malfurion,1809,warlock,affliction,53,29,24
Knothy,proudmoore,1807,warlock,affliction,78,36,42
Dotplaystyle,blackrock,1806,warlock,affliction,90,42,48
Warlocknroll,frostmourne,1803,warlock,affliction,47,21,26
Dröwzy,sargeras,1801,warlock,affliction,48,25,23
Conradlenoir,illidan,1800,warlock,affliction,41,24,17
Phlares,stormrage,1798,warlock,affliction,71,30,41
Wardyn,dragonmaw,1795,warlock,affliction,72,29,43
Slendyman,stormrage,1794,warlock,affliction,42,25,17
Limeriax,emerald-dream,1782,warlock,affliction,120,65,55
Lockprocz,kirin-tor,1779,warlock,affliction,48,24,24
Lucyloux,sargeras,1775,warlock,affliction,40,23,17
Strudelfears,tichondrius,1772,warlock,affliction,95,66,29
Gry,malganis,1767,warlock,affliction,34,19,15
Purp,vashj,1767,warlock,affliction,44,23,21
Portalgun,tichondrius,1764,warlock,affliction,54,30,24
Duukka,malganis,1763,warlock,affliction,47,28,19
Fancynuts,kiljaeden,1754,warlock,affliction,54,27,27
Salival,chogall,1748,warlock,affliction,72,38,34
Ezgamejr,tichondrius,1740,warlock,affliction,52,30,22
Baxmoney,malganis,1740,warlock,affliction,48,19,29
Fatals,thrall,1737,warlock,affliction,72,39,33
Jimmyvagene,area-52,1736,warlock,affliction,59,26,33
Boyahancook,tichondrius,1735,warlock,affliction,136,67,69
Matrielan,azshara,1730,warlock,affliction,114,70,44
Àfflìction,tichondrius,1719,warlock,affliction,149,79,70
Eh,laughing-skull,1717,warlock,affliction,138,68,70
Înfy,sargeras,1703,warlock,affliction,30,18,12
Imadotyasan,shandris,1702,warlock,affliction,60,31,29
Swath,firetree,1700,warlock,affliction,60,30,30
Locklist,frostmourne,1695,warlock,affliction,78,41,37
Cslice,magtheridon,1686,warlock,affliction,36,20,16
Leach,draktharon,1685,warlock,affliction,60,31,29
Beamin,dentarg,1683,warlock,affliction,42,27,15
Hilzin,area-52,1679,warlock,affliction,90,47,43
Amazeus,tichondrius,1677,warlock,affliction,30,18,12
Bigdammich,bleeding-hollow,1674,warlock,affliction,54,29,25
Liarz,tichondrius,1667,warlock,affliction,72,36,36
Sâltylôck,tichondrius,1651,warlock,affliction,41,21,20
Kopium,tichondrius,1645,warlock,affliction,36,24,12
Dpz,spirestone,1645,warlock,affliction,30,18,12
Dottcha,blackrock,1643,warlock,affliction,60,37,23
Ticktickdoom,sargeras,1641,warlock,affliction,80,38,42
Wojii,kelthuzad,1636,warlock,affliction,44,24,20
Hauntx,bonechewer,1632,warlock,affliction,45,22,23
Blackchinese,zuljin,1627,warlock,affliction,119,69,50
Vardros,moon-guard,1626,warlock,affliction,60,33,27
Venticm,tichondrius,1623,warlock,affliction,24,17,7
Unsee,sargeras,1623,warlock,affliction,54,33,21
Grimdreams,malganis,1622,warlock,affliction,37,21,16
Cuteboy,tichondrius,1611,warlock,affliction,84,57,27
Cokeparty,tichondrius,1611,warlock,affliction,108,52,56
Lessthanjake,zuljin,1610,warlock,affliction,48,31,17
Urwjoa,tichondrius,1609,warlock,affliction,74,39,35
Mornnah,dalaran,1609,warlock,affliction,204,91,113
Jkun,malganis,1608,warlock,affliction,126,70,56
Slothycrip,emerald-dream,1606,warlock,affliction,59,33,26
Catarina,kaelthas,1605,warlock,affliction,33,18,15
Muffîn,moon-guard,1604,warlock,affliction,55,31,24
Fasteddywow,arygos,1603,warlock,affliction,71,41,30
Autotheism,whisperwind,1601,warlock,affliction,48,24,24
Tjdotter,stormrage,1600,warlock,affliction,30,19,11
Pykorrg,ragnaros,1600,warlock,affliction,47,23,24
Sventka,ragnaros,1599,warlock,affliction,352,178,174
Chilipeppa,wyrmrest-accord,1598,warlock,affliction,94,47,47
Demonkiiller,kelthuzad,1597,warlock,affliction,49,25,24
Uggaboogga,malganis,1597,warlock,affliction,36,17,19
Waifucandy,tichondrius,1588,warlock,affliction,60,29,31
Mechnite,sargeras,1586,warlock,affliction,67,31,36
Xentzor,auchindoun,1585,warlock,affliction,90,45,45
Parmenides,tichondrius,1584,warlock,affliction,210,110,100
Damage,khadgar,1584,warlock,affliction,66,33,33
Babydots,stormreaver,1579,warlock,affliction,29,18,11
Nightkiss,sargeras,1578,warlock,affliction,48,22,26
Deangood,tichondrius,1576,warlock,affliction,42,27,15
Aroug,aggramar,1574,warlock,affliction,92,52,40
Vialdkaseun,muradin,1572,warlock,affliction,138,63,75
Felegance,proudmoore,1570,warlock,affliction,37,18,19
Sìnister,nazgrel,1569,warlock,affliction,77,49,28
Evarona,gorefiend,1568,warlock,affliction,72,34,38
Mørøs,tichondrius,1566,warlock,affliction,102,65,37
Stalezz,barthilas,1559,warlock,affliction,62,33,29
Aomniloltv,zuljin,1559,warlock,affliction,140,74,66
Hauntgød,tichondrius,1558,warlock,affliction,66,38,28
Freddiewill,tichondrius,1557,warlock,affliction,41,26,15
Laurela,aegwynn,1553,warlock,affliction,96,48,48
Soulripped,area-52,1544,warlock,affliction,70,40,30
Squirtwee,frostmourne,1542,warlock,affliction,72,33,39
Mitryc,illidan,1540,warlock,affliction,55,26,29
Zeraedify,bleeding-hollow,1540,warlock,affliction,36,17,19
Disneytoon,moon-guard,1536,warlock,affliction,36,18,18
Elend,elune,1534,warlock,affliction,36,25,11
Ðåntë,thrall,1532,warlock,affliction,62,32,30
Methrocks,emerald-dream,1529,warlock,affliction,64,39,25
Idotû,tichondrius,1526,warlock,affliction,36,16,20
Zod,burning-legion,1525,warlock,affliction,36,17,19
Dirtydotting,nerzhul,1524,warlock,affliction,30,17,13
Thecat,shattered-hand,1523,warlock,affliction,18,16,2
Stopdot,lightnings-blade,1522,warlock,affliction,77,41,36
Erolidra,blackrock,1519,warlock,affliction,30,16,14
Dotte,tichondrius,1514,warlock,affliction,42,27,15
Yanned,hakkar,1514,warlock,affliction,99,51,48
Xoxoxoxoxo,lightnings-blade,1513,warlock,affliction,70,33,37
Tyicuslok,tichondrius,1510,warlock,affliction,60,31,29
Sheboy,moon-guard,1509,warlock,affliction,96,52,44
Glifosáto,quelthalas,1508,warlock,affliction,42,24,18
Forcedbeejay,sargeras,1502,warlock,affliction,48,24,24
Lemdul,thrall,1494,warlock,affliction,26,17,9
Loodle,moon-guard,1494,warlock,affliction,47,23,24
Arcziz,tichondrius,1490,warlock,affliction,42,21,21
Dautenit,illidan,1490,warlock,affliction,71,34,37
Razlock,moon-guard,1489,warlock,affliction,48,27,21
Dghuldahn,bleeding-hollow,1486,warlock,affliction,66,40,26
Tsalagi,sargeras,1478,warlock,affliction,145,78,67
Adeadsaint,boulderfist,1475,warlock,affliction,35,19,16
Locker,lightnings-blade,1471,warlock,affliction,30,20,10
Moräl,frostmourne,1470,warlock,affliction,51,25,26
Mattypatty,the-forgotten-coast,1466,warlock,affliction,68,38,30
Juleno,quelthalas,1458,warlock,affliction,30,17,13
Infecçäo,stormrage,1455,warlock,affliction,46,23,23
Yisuschríst,quelthalas,1453,warlock,affliction,39,23,16
Justganmore,tichondrius,1449,warlock,affliction,54,29,25
Sillyrabbut,kelthuzad,1449,warlock,affliction,192,96,96
Fowll,frostwolf,1440,warlock,affliction,109,67,42
Benaffllock,turalyon,1439,warlock,affliction,30,18,12
Xicó,tichondrius,1435,warlock,affliction,64,31,33
Crazikrix,area-52,1434,warlock,affliction,79,40,39
Fatherbolt,tichondrius,1433,warlock,affliction,24,15,9
Fearfaze,tichondrius,1433,warlock,affliction,60,27,33
Snuffe,vashj,1432,warlock,affliction,103,60,43
Dlarenn,kelthuzad,1432,warlock,affliction,30,15,15
Torowasabi,tichondrius,1432,warlock,affliction,65,29,36
Wizxin,emerald-dream,1431,warlock,affliction,60,27,33
Percadu,barthilas,1431,warlock,affliction,36,16,20
Livingdead,dreadmaul,1429,warlock,affliction,35,18,17
Maxcorrupted,sargeras,1428,warlock,affliction,41,23,18
Sinápsís,ragnaros,1423,warlock,affliction,24,15,9
Daëmön,stormrage,1421,warlock,affliction,30,15,15
Kimis,proudmoore,1421,warlock,affliction,42,20,22
Vaalac,tichondrius,1420,warlock,affliction,450,216,234
Varvanta,proudmoore,1420,warlock,affliction,48,18,30
Droppindots,frostmane,1419,warlock,affliction,42,23,19
Garthbrookz,bleeding-hollow,1418,warlock,affliction,63,29,34
Soulcore,area-52,1416,warlock,affliction,24,15,9
Nutzosaurus,darkspear,1414,warlock,affliction,42,23,19
Tizl,tichondrius,1411,warlock,affliction,162,79,83
Skoobler,tichondrius,1409,warlock,affliction,99,54,45
Sîthfu,tichondrius,1409,warlock,affliction,71,34,37
Marà,ragnaros,1409,warlock,affliction,45,18,27
Benafflock,kaelthas,1408,warlock,affliction,30,15,15
Dårkfyre,kiljaeden,1406,warlock,affliction,24,15,9
Elliarquet,akama,1404,warlock,affliction,106,52,54
Yuckytoetoe,emerald-dream,1400,warlock,affliction,42,24,18
Cantibor,illidan,1398,warlock,affliction,112,60,52
Buckéthéad,arathor,1397,warlock,affliction,30,15,15
Nookíe,azralon,1394,warlock,affliction,60,31,29
Hottyscotty,tichondrius,1392,warlock,affliction,42,18,24
Tuerie,illidan,1391,warlock,affliction,43,26,17
Diosban,malganis,1391,warlock,affliction,48,20,28
Äffie,aerie-peak,1390,warlock,affliction,144,70,74
Morgil,suramar,1389,warlock,affliction,39,20,19
Chachanoobx,sargeras,1387,warlock,affliction,48,23,25
Munch,khadgar,1386,warlock,affliction,36,17,19
Captrollol,tichondrius,1385,warlock,affliction,44,27,17
Soloart,tichondrius,1385,warlock,affliction,36,15,21
Winipuhmalo,quelthalas,1384,warlock,affliction,59,33,26
Sweetjuly,area-52,1378,warlock,affliction,48,31,17
Aerumna,barthilas,1378,warlock,affliction,30,15,15
Gordaroth,barthilas,1376,warlock,affliction,41,24,17
Boreo,ragnaros,1376,warlock,affliction,42,20,22
Frylock,frostmourne,1372,warlock,affliction,74,33,41
Lockneo,stormrage,1370,warlock,affliction,138,77,61
Nicodareus,hellscream,1369,warlock,affliction,45,25,20
Søül,tichondrius,1368,warlock,affliction,42,21,21
Zinkro,quelthalas,1367,warlock,affliction,124,72,52
Hairydotter,doomhammer,1365,warlock,affliction,42,24,18
Dankdôtz,stormrage,1365,warlock,affliction,42,18,24
Arillus,thrall,1364,warlock,affliction,53,29,24
Bbangtimo,tichondrius,1363,warlock,affliction,26,15,11
Jumlock,illidan,1363,warlock,affliction,43,24,19
Koiboii,tichondrius,1362,warlock,affliction,24,16,8
Acceptdeath,stormrage,1362,warlock,affliction,30,17,13
Sinesta,bleeding-hollow,1355,warlock,affliction,36,20,16
Feoona,hyjal,1354,warlock,affliction,72,41,31
Chadre,feathermoon,1353,warlock,affliction,40,19,21
Eilethen,cenarion-circle,1350,warlock,affliction,34,15,19
Nutted,dentarg,1342,warlock,affliction,24,14,10
Steven,firetree,1342,warlock,affliction,24,14,10
Dotpocket,runetotem,1342,warlock,affliction,36,14,22
Irene,nagrand,1341,warlock,affliction,37,23,14
Albright,azralon,1340,warlock,affliction,24,14,10
Ialfizzle,dethecus,1340,warlock,affliction,72,33,39
Karpawarlock,ragnaros,1334,warlock,affliction,66,36,30
Nazrakin,malganis,1333,warlock,affliction,54,26,28
Fatuglyegirl,sargeras,1331,warlock,affliction,63,30,33
Mèsut,malganis,1327,warlock,affliction,36,24,12
Warakaso,ragnaros,1327,warlock,affliction,60,37,23
Pepzz,emerald-dream,1327,warlock,affliction,48,23,25
Aights,zuljin,1325,warlock,affliction,92,38,54
Dippindots,boulderfist,1324,warlock,affliction,104,49,55
Yyoyo,tichondrius,1318,warlock,affliction,36,24,12
Munick,spirestone,1318,warlock,affliction,54,27,27
Mïer,tichondrius,1315,warlock,affliction,89,47,42
Dercrow,quelthalas,1314,warlock,affliction,38,21,17
Valtimorh,ragnaros,1309,warlock,affliction,36,19,17
Hemmlock,moknathal,1306,warlock,affliction,57,26,31
Atraedes,moon-guard,1305,warlock,affliction,80,43,37
Côp,tichondrius,1303,warlock,affliction,71,31,40
Violentx,tichondrius,1301,warlock,affliction,45,20,25
Castngcouch,tichondrius,1296,warlock,affliction,117,62,55
Fluffylockk,bloodscalp,1295,warlock,affliction,52,26,26
Punished,arthas,1293,warlock,affliction,56,30,26
Pipeo,quelthalas,1288,warlock,affliction,126,72,54
Whathurts,tichondrius,1287,warlock,affliction,32,23,9
Eyedot,stormscale,1285,warlock,affliction,24,18,6
Ouijafaps,sargeras,1285,warlock,affliction,30,14,16
Ysnou,nemesis,1283,warlock,affliction,42,24,18
Avatar,uldum,1283,warlock,affliction,60,26,34
Beelzismurph,emerald-dream,1281,warlock,affliction,63,31,32
Gregg,laughing-skull,1276,warlock,affliction,150,80,70
Novichok,amanthul,1276,warlock,affliction,36,15,21
Moxz,garona,1275,warlock,affliction,54,20,34
Aalkaid,dathremar,1273,warlock,affliction,54,31,23
Zamorakk,nemesis,1272,warlock,affliction,58,33,25
Ragnalock,laughing-skull,1270,warlock,affliction,24,14,10
Volsace,moon-guard,1267,warlock,affliction,30,14,16
Fshi,frostmourne,1266,warlock,affliction,50,30,20
Baiano,nagrand,1265,warlock,affliction,46,19,27
Lisaleda,stormrage,1263,warlock,affliction,30,16,14
Wallow,thunderhorn,1258,warlock,affliction,65,34,31
Snuzzock,darkspear,1254,warlock,affliction,35,14,21
Aikonor,stormrage,1253,warlock,affliction,72,33,39
Spi,chogall,1250,warlock,affliction,134,63,71
Squasum,sargeras,1249,warlock,affliction,147,77,70
Barovir,tichondrius,1247,warlock,affliction,18,13,5
Gurlock,illidan,1246,warlock,affliction,42,26,16
Mindfulchimp,sargeras,1246,warlock,affliction,50,21,29
Quitxmanlm,tichondrius,1245,warlock,affliction,24,13,11
Kreatur,ragnaros,1244,warlock,affliction,60,28,32
Balveer,tichondrius,1243,warlock,affliction,28,14,14
Stonelocke,area-52,1242,warlock,affliction,30,14,16
Eraticlock,illidan,1237,warlock,affliction,25,13,12
Lotdon,blackrock,1235,warlock,affliction,89,38,51
Reckzet,stormrage,1234,warlock,affliction,24,13,11
Lilliara,korgath,1232,warlock,affliction,41,16,25
Onmyioji,dalaran,1228,warlock,affliction,18,13,5
Cascades,icecrown,1228,warlock,affliction,37,19,18
Dotsarehot,dreadmaul,1227,warlock,affliction,30,13,17
Aeonss,stormrage,1222,warlock,affliction,48,22,26
Killernix,drakkari,1219,warlock,affliction,54,29,25
Juniorsalanu,quelthalas,1219,warlock,affliction,97,43,54
Ciprýan,azralon,1218,warlock,affliction,24,14,10
Mysoultotake,sargeras,1212,warlock,affliction,24,13,11
Kogath,thunderlord,1209,warlock,affliction,53,29,24
Tohkisaeki,dalaran,1209,warlock,affliction,60,31,29
Phelly,frostmourne,1205,warlock,affliction,75,41,34
Coolwipp,demon-soul,1201,warlock,affliction,157,76,81
Yoyoling,illidan,1200,warlock,affliction,82,43,39
Zaliki,hellscream,1191,warlock,affliction,30,20,10
Curaven,emerald-dream,1189,warlock,affliction,29,13,16
Bashel,sargeras,1185,warlock,affliction,51,32,19
Thoxy,barthilas,1182,warlock,affliction,36,14,22
Slakiejr,darkspear,1180,warlock,affliction,22,13,9
Eightyfall,barthilas,1180,warlock,affliction,40,17,23
Critthis,illidan,1175,warlock,affliction,42,21,21
Candykrush,tichondrius,1173,warlock,affliction,30,18,12
Batär,area-52,1171,warlock,affliction,62,26,36
Saltyfries,wildhammer,1165,warlock,affliction,42,14,28
Poltergiiest,korgath,1164,warlock,affliction,24,13,11
Khatrat,azralon,1164,warlock,affliction,106,43,63
Sammythebull,frostwolf,1159,warlock,affliction,32,17,15
Mymmic,ragnaros,1158,warlock,affliction,88,37,51
Finnek,moon-guard,1155,warlock,affliction,30,17,13
Lilpewpeww,bleeding-hollow,1154,warlock,affliction,123,60,63
Promann,drakkari,1151,warlock,affliction,12,12,0
Háydn,azuremyst,1151,warlock,affliction,18,12,6
Guldåniel,tichondrius,1150,warlock,affliction,18,12,6
Kruxxqt,illidan,1150,warlock,affliction,24,12,12
Nestpas,tichondrius,1150,warlock,affliction,33,14,19
Kyugin,goldrinn,1148,warlock,affliction,24,12,12
Rakshama,chogall,1148,warlock,affliction,24,12,12
Zeviaem,quelthalas,1146,warlock,affliction,24,12,12
Necroñomicon,malganis,1145,warlock,affliction,18,12,6
Iainmbanks,barthilas,1143,warlock,affliction,226,104,122
Fyahwalka,aggramar,1143,warlock,affliction,48,19,29
Millyvanilly,tichondrius,1140,warlock,affliction,24,12,12
Studious,sargeras,1139,warlock,affliction,26,15,11
Skrufenjoyer,sargeras,1137,warlock,affliction,81,38,43
Buucocky,proudmoore,1136,warlock,affliction,30,16,14
Sugarwaffles,area-52,1135,warlock,affliction,18,12,6
Ikis,cenarion-circle,1134,warlock,affliction,24,15,9
Fearocity,argent-dawn,1130,warlock,affliction,33,15,18
Azâziel,ragnaros,1128,warlock,affliction,35,17,18
Doombaby,zuljin,1124,warlock,affliction,24,12,12
Flangy,kiljaeden,1123,warlock,affliction,84,33,51
Mothapucka,thrall,1123,warlock,affliction,36,12,24
Päinoth,wyrmrest-accord,1122,warlock,affliction,42,26,16
Nedrien,moon-guard,1120,warlock,affliction,54,28,26
Drskeeters,malganis,1116,warlock,affliction,26,13,13
Zrx,proudmoore,1115,warlock,affliction,69,27,42
Beetlegiese,doomhammer,1114,warlock,affliction,40,19,21
Sylencia,demon-soul,1107,warlock,affliction,36,13,23
Kokoto,azralon,1102,warlock,affliction,60,37,23
Auntzhang,tichondrius,1101,warlock,affliction,29,12,17
Phøbøs,hyjal,1099,warlock,affliction,24,13,11
Dipdip,illidan,1097,warlock,affliction,63,25,38
Yosuljaengi,stormrage,1095,warlock,affliction,84,38,46
Rickrock,gnomeregan,1091,warlock,affliction,34,16,18
Littlepain,goldrinn,1071,warlock,affliction,30,14,16
Elander,azuremyst,1067,warlock,affliction,30,17,13
Swinefrommud,zuljin,1056,warlock,affliction,24,11,13
Calculator,tichondrius,1055,warlock,affliction,24,11,13
Wreyz,mannoroth,1053,warlock,affliction,18,11,7
Asetiks,tichondrius,1052,warlock,affliction,24,11,13
Gateor,zuljin,1051,warlock,affliction,24,11,13
Belaflore,moon-guard,1050,warlock,affliction,24,11,13
Beitrice,barthilas,1050,warlock,affliction,30,11,19
Psx,frostmourne,1049,warlock,affliction,24,11,13
Naburn,tichondrius,1049,warlock,affliction,24,11,13
Eastwitch,ragnaros,1048,warlock,affliction,24,11,13
Pauldiesel,ragnaros,1048,warlock,affliction,26,11,15
Guacamolock,drakkari,1045,warlock,affliction,24,11,13
Cozu,tichondrius,1045,warlock,affliction,30,11,19
Mangku,frostmourne,1042,warlock,affliction,46,19,27
Teaset,hellscream,1039,warlock,affliction,66,33,33
Krïttzïe,proudmoore,1039,warlock,affliction,58,28,30
Deusita,kelthuzad,1039,warlock,affliction,24,11,13
Rorrlex,muradin,1037,warlock,affliction,42,20,22
Berszerk,quelthalas,1037,warlock,affliction,30,11,19
Hungovermate,barthilas,1036,warlock,affliction,18,13,5
Donnellus,frostmane,1028,warlock,affliction,24,14,10
Basticor,moon-guard,1024,warlock,affliction,42,18,24
Medallok,laughing-skull,1021,warlock,affliction,54,28,26
Aerozyn,wyrmrest-accord,1013,warlock,affliction,30,17,13
Dirtydeikan,stormrage,1010,warlock,affliction,65,29,36
Duuka,malganis,1008,warlock,affliction,15,12,3
Halzarn,agamaggan,1008,warlock,affliction,36,19,17
Darkestholy,illidan,1006,warlock,affliction,23,11,12
Shadöwdancer,uldum,1005,warlock,affliction,24,16,8
Corvos,garrosh,1001,warlock,affliction,32,12,20
Medran,azralon,996,warlock,affliction,62,34,28
Wizlox,illidan,996,warlock,affliction,33,11,22
Miredö,tichondrius,991,warlock,affliction,23,11,12
Whydemono,tichondrius,982,warlock,affliction,26,11,15
Dreadloxx,whisperwind,979,warlock,affliction,48,23,25
Malleus,drakkari,975,warlock,affliction,24,11,13
Avelmi,daggerspine,964,warlock,affliction,31,11,20
Wardocc,sargeras,962,warlock,affliction,66,31,35
Dotymania,aegwynn,959,warlock,affliction,18,10,8
Lapandemica,gorefiend,959,warlock,affliction,24,10,14
Shadowhax,area-52,959,warlock,affliction,24,10,14
Niubeelol,tichondrius,959,warlock,affliction,24,10,14
Cvoaw,bonechewer,958,warlock,affliction,12,10,2
Bobbyross,garrosh,958,warlock,affliction,16,11,5
Wtb,blackrock,958,warlock,affliction,18,10,8
Malagas,tichondrius,958,warlock,affliction,18,10,8
Makumbeiro,sargeras,958,warlock,affliction,18,10,8
Mxd,ragnaros,958,warlock,affliction,18,10,8
Downing,drakkari,958,warlock,affliction,71,26,45
Xdq,malganis,957,warlock,affliction,27,12,15
Qualio,thrall,957,warlock,affliction,24,10,14
Caustikk,malganis,956,warlock,affliction,18,10,8
Arzenexx,malganis,954,warlock,affliction,36,20,16
Lockinha,azralon,953,warlock,affliction,18,10,8
Jennifear,sargeras,952,warlock,affliction,18,10,8
Victani,gallywix,946,warlock,affliction,18,10,8
Oreo,velen,942,warlock,affliction,30,10,20
Avadakedávra,darkspear,941,warlock,affliction,18,10,8
Mpm,dragonmaw,906,warlock,affliction,30,15,15
Thetopg,bronzebeard,896,warlock,affliction,21,11,10
Popdotdropit,frostwolf,895,warlock,affliction,17,10,7
Britainwl,azshara,892,warlock,affliction,30,13,17
Ioroselmi,illidan,871,warlock,affliction,25,10,15
Ruphilin,fizzcrank,864,warlock,affliction,12,9,3
Conboee,tichondrius,864,warlock,affliction,12,9,3
Nöxïöüs,sargeras,864,warlock,affliction,12,9,3
Quitxman,tichondrius,864,warlock,affliction,12,9,3
Minglocked,proudmoore,864,warlock,affliction,18,9,9
Crayonchewer,alleria,864,warlock,affliction,18,9,9
Jfet,sargeras,864,warlock,affliction,18,9,9
Dejagu,tichondrius,864,warlock,affliction,24,9,15
Halloweèn,kelthuzad,863,warlock,affliction,12,9,3
Demonycc,archimonde,863,warlock,affliction,12,9,3
Bjarke,malganis,863,warlock,affliction,12,9,3
Búmchúm,frostmourne,863,warlock,affliction,18,9,9
Sslock,sargeras,863,warlock,affliction,18,9,9
Devdolittle,tichondrius,863,warlock,affliction,18,9,9
Twilson,moon-guard,863,warlock,affliction,18,9,9
Nerd,fizzcrank,862,warlock,affliction,12,9,3
Astralrunner,moon-guard,862,warlock,affliction,18,9,9
Sesyid,tichondrius,862,warlock,affliction,18,9,9
Scarysherri,aggramar,862,warlock,affliction,24,9,15
Sarkahn,sargeras,862,warlock,affliction,24,9,15
Thisist,kiljaeden,861,warlock,affliction,12,9,3
Vyntras,kelthuzad,861,warlock,affliction,18,9,9
Bignoselock,illidan,861,warlock,affliction,18,9,9
Abyssisle,malygos,860,warlock,affliction,20,10,10
Awp,malganis,860,warlock,affliction,18,9,9
Holloch,bonechewer,860,warlock,affliction,18,9,9
Smockalock,proudmoore,857,warlock,affliction,18,9,9
Tinydotz,hydraxis,856,warlock,affliction,18,10,8
Mörgana,quelthalas,856,warlock,affliction,19,10,9
Yratiprocs,ysera,853,warlock,affliction,18,9,9
Obertito,kelthuzad,828,warlock,affliction,16,9,7
Mustacheguy,tichondrius,805,warlock,affliction,29,9,20
Buccs,barthilas,799,warlock,affliction,11,9,2
Maelganis,thrall,796,warlock,affliction,17,9,8
Handlevil,stormrage,787,warlock,affliction,16,9,7
Hexxüs,area-52,784,warlock,affliction,19,9,10
Kåléïðøsçøpè,sargeras,768,warlock,affliction,12,8,4
Dötsonurpp,stormrage,768,warlock,affliction,12,8,4
Hutchyw,tichondrius,768,warlock,affliction,12,8,4
Púp,bleeding-hollow,768,warlock,affliction,12,8,4
Sadoldman,malganis,768,warlock,affliction,12,8,4
Dethklokx,tichondrius,768,warlock,affliction,12,8,4
Slothdots,tichondrius,768,warlock,affliction,12,8,4
Richãrdjr,area-52,768,warlock,affliction,12,8,4
Herladytha,aegwynn,767,warlock,affliction,12,8,4
Antigotenent,sargeras,767,warlock,affliction,12,8,4
Wreckquiem,draka,767,warlock,affliction,12,8,4
Losecontrol,illidan,767,warlock,affliction,12,8,4
Brujoalfa,ragnaros,767,warlock,affliction,12,8,4
Pokendot,illidan,767,warlock,affliction,18,8,10
Yeepzbytre,bleeding-hollow,767,warlock,affliction,18,8,10
Buboñic,area-52,767,warlock,affliction,18,8,10
Oblivious,firetree,767,warlock,affliction,18,8,10
Fearharder,stormrage,767,warlock,affliction,24,8,16
Arkterris,doomhammer,766,warlock,affliction,18,8,10
Flixon,tichondrius,765,warlock,affliction,12,8,4
Çheesestick,dalaran,765,warlock,affliction,18,8,10
Bëëlzebub,crushridge,765,warlock,affliction,18,8,10
Aksness,stormrage,765,warlock,affliction,24,8,16
Dowglips,area-52,763,warlock,affliction,18,8,10
Cássandra,ragnaros,761,warlock,affliction,12,8,4
Radamantîs,ragnaros,761,warlock,affliction,18,8,10
Jakedbtw,crushridge,759,warlock,affliction,12,8,4
Covidkillerr,tichondrius,759,warlock,affliction,13,8,5
Rotfull,burning-legion,751,warlock,affliction,17,8,9
Seecurse,kelthuzad,735,warlock,affliction,17,8,9
Hiddentech,saurfang,719,warlock,affliction,11,8,3
Apéx,frostmourne,716,warlock,affliction,17,8,9
Amgs,frostmourne,714,warlock,affliction,23,11,12
Nuckz,whisperwind,687,warlock,affliction,14,9,5
Modot,tichondrius,685,warlock,affliction,23,9,14
Charïs,ragnaros,679,warlock,affliction,13,8,5
Dotfearspam,alterac-mountains,679,warlock,affliction,21,8,13
Miratrix,moon-guard,672,warlock,affliction,12,7,5
Bakko,tichondrius,672,warlock,affliction,12,7,5
Geofar,bleeding-hollow,672,warlock,affliction,12,7,5
Delaye,tichondrius,672,warlock,affliction,12,7,5
Ellneggro,zuljin,672,warlock,affliction,12,7,5
Casslight,tichondrius,672,warlock,affliction,12,7,5
Halethadro,emerald-dream,672,warlock,affliction,12,7,5
Drowzy,undermine,672,warlock,affliction,12,7,5
Kuhio,korgath,672,warlock,affliction,12,7,5
Garbocan,area-52,672,warlock,affliction,12,7,5
Glortheeb,spirestone,672,warlock,affliction,18,7,11
Necromâncer,stormreaver,672,warlock,affliction,18,7,11
Icemanliddel,area-52,672,warlock,affliction,18,7,11
Oogren,korgath,672,warlock,affliction,18,7,11
Djminuterice,bleeding-hollow,671,warlock,affliction,12,7,5
Killhorde,thunderlord,671,warlock,affliction,12,7,5
Zurp,wyrmrest-accord,671,warlock,affliction,12,7,5
Ãids,khadgar,671,warlock,affliction,12,7,5
Aruotnof,nemesis,671,warlock,affliction,12,7,5
Tekkiez,barthilas,671,warlock,affliction,12,7,5
Foxyloxy,hakkar,671,warlock,affliction,14,7,7
Korguji,tichondrius,671,warlock,affliction,18,7,11
Jìbril,stormrage,671,warlock,affliction,18,7,11
Skyvre,tichondrius,670,warlock,affliction,12,7,5
Lockaloga,azralon,670,warlock,affliction,12,7,5
Afflicmindz,azralon,670,warlock,affliction,12,7,5
Kuoma,boulderfist,670,warlock,affliction,12,7,5
Miermortal,tichondrius,670,warlock,affliction,18,7,11
Magicbones,tichondrius,669,warlock,affliction,15,8,7
Tsmcfker,tichondrius,669,warlock,affliction,22,9,13
Mefound,nerzhul,668,warlock,affliction,12,7,5
Larlock,black-dragonflight,667,warlock,affliction,12,7,5
Zipstream,dark-iron,667,warlock,affliction,24,7,17
Balmir,tichondrius,658,warlock,affliction,18,7,11
Gummylock,frostmourne,623,warlock,affliction,11,7,4
Paparoxy,illidan,623,warlock,affliction,15,8,7
Bludshadow,duskwood,620,warlock,affliction,21,7,14
Radiscul,dragonmaw,619,warlock,affliction,17,7,10
Yury,scarlet-crusade,617,warlock,affliction,17,7,10
Cezarz,tichondrius,592,warlock,affliction,13,7,6
Sikmagic,kelthuzad,576,warlock,affliction,12,6,6
Brunemon,proudmoore,576,warlock,affliction,12,6,6
Xtremegirth,zuljin,576,warlock,affliction,12,6,6
Lilcarmy,emerald-dream,576,warlock,affliction,12,6,6
Løcalplugxø,barthilas,576,warlock,affliction,12,6,6
Sluglishphsh,stormrage,576,warlock,affliction,12,6,6
Khil,darkspear,576,warlock,affliction,12,6,6
Biubius,tichondrius,576,warlock,affliction,12,6,6
Parishiltoon,frostmourne,576,warlock,affliction,12,6,6
Kryllua,tichondrius,576,warlock,affliction,12,6,6
Lokkup,dalaran,576,warlock,affliction,12,6,6
Gianni,chogall,576,warlock,affliction,12,6,6
Rainmakers,moon-guard,576,warlock,affliction,12,6,6
Shadøwy,nemesis,576,warlock,affliction,12,6,6
Toelickerx,illidan,576,warlock,affliction,12,6,6
Goofgoof,sargeras,576,warlock,affliction,12,6,6
Neevius,barthilas,576,warlock,affliction,12,6,6
Fearophobic,illidan,576,warlock,affliction,12,6,6
Chrishasnen,moon-guard,576,warlock,affliction,12,6,6
Nihilus,anvilmar,576,warlock,affliction,12,6,6
Dogfiend,spirestone,576,warlock,affliction,12,6,6
Nadablast,tichondrius,576,warlock,affliction,12,6,6
Abrocket,alleria,576,warlock,affliction,12,6,6
Datazdotcom,illidan,576,warlock,affliction,12,6,6
Haross,darkspear,576,warlock,affliction,18,6,12
Demiloy,stormrage,576,warlock,affliction,18,6,12
Catdrugs,kelthuzad,576,warlock,affliction,18,6,12
Muchø,emerald-dream,576,warlock,affliction,24,6,18
Infortunium,sargeras,575,warlock,affliction,12,6,6
Drivercurses,terenas,575,warlock,affliction,12,6,6
Lomeron,sargeras,575,warlock,affliction,12,6,6
Leroybrown,alterac-mountains,575,warlock,affliction,12,6,6
Shadowbo,aggramar,575,warlock,affliction,12,6,6
Jhop,sargeras,575,warlock,affliction,12,6,6
Kunozonbi,malganis,575,warlock,affliction,12,6,6
Deatthmoon,stormrage,575,warlock,affliction,12,6,6
Gødmôde,tichondrius,575,warlock,affliction,12,6,6
Valvravé,malganis,575,warlock,affliction,12,6,6
Blacadder,azgalor,575,warlock,affliction,18,6,12
Zuldar,tichondrius,575,warlock,affliction,18,6,12
Holdmybeard,senjin,575,warlock,affliction,18,6,12
Bloodybooger,area-52,574,warlock,affliction,12,6,6
Conrii,burning-blade,574,warlock,affliction,18,6,12
Sind,garona,573,warlock,affliction,12,6,6
Lockë,thunderlord,572,warlock,affliction,12,6,6
Hâunted,khazgoroth,571,warlock,affliction,12,6,6
Justero,kelthuzad,569,warlock,affliction,12,6,6
Kflexxpt,hydraxis,569,warlock,affliction,12,6,6
Socketriver,bleeding-hollow,568,warlock,affliction,18,6,12
Gnock,garona,543,warlock,affliction,11,6,5
Raff,detheroc,527,warlock,affliction,11,6,5
Louuis,barthilas,521,warlock,affliction,13,7,6
Vrajitor,ragnaros,511,warlock,affliction,11,6,5
Markuss,boulderfist,511,warlock,affliction,14,6,8
Dotdoctor,thrall,511,warlock,affliction,16,6,10
Oluluo,andorhal,510,warlock,affliction,8,6,2
Beexy,sargeras,510,warlock,affliction,14,6,8
Halciyon,dalvengyr,495,warlock,affliction,19,6,13
Misolock,sargeras,480,warlock,affliction,6,5,1
Satunir,shadowsong,480,warlock,affliction,6,5,1
Varix,frostmourne,480,warlock,affliction,6,5,1
Bigdamege,tichondrius,480,warlock,affliction,6,5,1
Lucro,emerald-dream,480,warlock,affliction,6,5,1
Bobthedragqn,proudmoore,480,warlock,affliction,6,5,1
Lunazz,tichondrius,480,warlock,affliction,6,5,1
Flòwstate,tichondrius,480,warlock,affliction,6,5,1
Fruityß,kaelthas,480,warlock,affliction,6,5,1
Ttub,stormrage,480,warlock,affliction,6,5,1
Conkeldurr,tichondrius,480,warlock,affliction,6,5,1
Faschom,tichondrius,480,warlock,affliction,6,5,1
Ribman,stormrage,480,warlock,affliction,6,5,1
Perfectwar,tichondrius,480,warlock,affliction,12,5,7
Poogâ,tichondrius,480,warlock,affliction,12,5,7
Rexuss,velen,480,warlock,affliction,12,5,7
Artzul,tichondrius,480,warlock,affliction,12,5,7
Chaoz,aggramar,480,warlock,affliction,12,5,7
Andrewpg,zuljin,480,warlock,affliction,12,5,7
Goldface,frostmourne,480,warlock,affliction,12,5,7
Cryolock,nagrand,480,warlock,affliction,12,5,7
Yogurtslingr,tichondrius,480,warlock,affliction,12,5,7
Prarkmur,illidan,480,warlock,affliction,12,5,7
Itsmedirt,malganis,480,warlock,affliction,12,5,7
Frylockk,mugthol,480,warlock,affliction,12,5,7
Tvfazedorito,kelthuzad,480,warlock,affliction,12,5,7
Bwup,tichondrius,480,warlock,affliction,12,5,7
Wanglock,blackrock,480,warlock,affliction,12,5,7
Necrosith,ragnaros,480,warlock,affliction,15,6,9
Lockboxx,stormscale,480,warlock,affliction,18,5,13
Lockring,zuljin,480,warlock,affliction,18,5,13
Daesire,moon-guard,480,warlock,affliction,18,5,13
Symplicìty,area-52,479,warlock,affliction,6,5,1
Tatemor,barthilas,479,warlock,affliction,12,5,7
Ruegger,stormscale,479,warlock,affliction,12,5,7
Pruevolf,tichondrius,479,warlock,affliction,12,5,7
Morepetss,saurfang,479,warlock,affliction,12,5,7
Hélà,sargeras,479,warlock,affliction,18,5,13
Whitchpoison,nagrand,479,warlock,affliction,30,5,25
Fearfactory,lethon,478,warlock,affliction,12,5,7
Cityswimmer,malganis,478,warlock,affliction,12,5,7
Redbro,darkspear,478,warlock,affliction,12,5,7
Dravin,alleria,478,warlock,affliction,12,5,7
Skellisama,moon-guard,478,warlock,affliction,18,5,13
Suzüki,tichondrius,463,warlock,affliction,11,5,6
Demfearslol,terokkar,447,warlock,affliction,11,5,6
Puddlepiimp,illidan,431,warlock,affliction,11,5,6
Verrøkel,sargeras,426,warlock,affliction,11,7,4
Khaozx,ragnaros,416,warlock,affliction,10,5,5
Fublizz,black-dragonflight,416,warlock,affliction,10,5,5
Onlytoez,tichondrius,416,warlock,affliction,16,5,11
Kuroyt,drakkari,415,warlock,affliction,12,6,6
Amaroth,spinebreaker,415,warlock,affliction,20,5,15
Calvärr,bleeding-hollow,384,warlock,affliction,6,4,2
Demoiceman,bleeding-hollow,384,warlock,affliction,6,4,2
Siller,azralon,384,warlock,affliction,6,4,2
Cowboydann,malganis,384,warlock,affliction,6,4,2
Jotkbe,ragnaros,384,warlock,affliction,6,4,2
Purplelambox,illidan,384,warlock,affliction,6,4,2
Tonickush,area-52,384,warlock,affliction,6,4,2
Vamperro,thrall,384,warlock,affliction,6,4,2
Astarõth,zuljin,384,warlock,affliction,6,4,2
Bliztivision,proudmoore,384,warlock,affliction,6,4,2
Discordance,zuljin,384,warlock,affliction,6,4,2
Bänno,bleeding-hollow,384,warlock,affliction,6,4,2
Soulrman,tichondrius,384,warlock,affliction,6,4,2
Blliizz,aegwynn,384,warlock,affliction,6,4,2
Gasgrassnass,sargeras,384,warlock,affliction,6,4,2
Methrocks,tichondrius,384,warlock,affliction,6,4,2
Gümbÿ,illidan,384,warlock,affliction,6,4,2
Celin,rivendare,384,warlock,affliction,6,4,2
Omleaf,malganis,384,warlock,affliction,6,4,2
Eupheriia,thaurissan,384,warlock,affliction,6,4,2
Demonug,area-52,384,warlock,affliction,6,4,2
Breeped,tichondrius,384,warlock,affliction,6,4,2
Flippinfear,illidan,384,warlock,affliction,6,4,2
Superbroly,area-52,384,warlock,affliction,6,4,2
Omegapasta,illidan,384,warlock,affliction,6,4,2
Walterrør,nemesis,384,warlock,affliction,6,4,2
Plsdontcrit,tichondrius,384,warlock,affliction,6,4,2
Tylandér,nordrassil,384,warlock,affliction,6,4,2
Jessndistres,stormrage,384,warlock,affliction,6,4,2
Rbnz,kiljaeden,384,warlock,affliction,6,4,2
Torchie,moon-guard,384,warlock,affliction,6,4,2
Silkxy,frostwolf,384,warlock,affliction,6,4,2
Locker,darkspear,384,warlock,affliction,6,4,2
Hypnotikal,illidan,384,warlock,affliction,6,4,2
Redmist,arthas,384,warlock,affliction,6,4,2
Åbyssal,stormrage,384,warlock,affliction,6,4,2
Necroraise,boulderfist,384,warlock,affliction,9,5,4
Lockie,skywall,384,warlock,affliction,12,4,8
Bharim,quelthalas,384,warlock,affliction,12,4,8
Bmó,stormrage,384,warlock,affliction,12,4,8
Nethron,the-venture-co,384,warlock,affliction,12,4,8
Afflicktion,frostmourne,384,warlock,affliction,12,4,8
Yagumi,crushridge,384,warlock,affliction,12,4,8
Sosomaa,kelthuzad,384,warlock,affliction,12,4,8
Fearedit,bleeding-hollow,384,warlock,affliction,12,4,8
Bigheadjr,gorgonnash,384,warlock,affliction,12,4,8
Bïcho,queldorei,384,warlock,affliction,12,4,8
Emptysoul,illidan,384,warlock,affliction,12,4,8
Dotsfìred,tichondrius,384,warlock,affliction,12,4,8
Tichonkimc,tichondrius,384,warlock,affliction,12,4,8
Duckboji,tichondrius,384,warlock,affliction,12,4,8
Promancer,drakkari,384,warlock,affliction,12,4,8
Velanthra,skullcrusher,384,warlock,affliction,12,4,8
Punstable,tichondrius,384,warlock,affliction,12,4,8
Emptyx,tichondrius,384,warlock,affliction,12,4,8
Fksm,tichondrius,384,warlock,affliction,12,4,8
Necromaniac,nerzhul,384,warlock,affliction,18,4,14
Lockazo,quelthalas,383,warlock,affliction,6,4,2
Persianloc,tichondrius,383,warlock,affliction,12,4,8
Luciffer,windrunner,383,warlock,affliction,12,4,8
Wirthless,area-52,383,warlock,affliction,12,4,8
Slord,bonechewer,382,warlock,affliction,6,4,2
Darkdestine,emerald-dream,382,warlock,affliction,12,4,8
Damint,sargeras,351,warlock,affliction,11,4,7
Xaemog,tichondrius,351,warlock,affliction,17,4,13
Gattsonn,kiljaeden,350,warlock,affliction,12,5,7
Felmort,bleeding-hollow,319,warlock,affliction,17,4,13
Marinw,azralon,304,warlock,affliction,7,4,3
Brujildå,area-52,304,warlock,affliction,13,4,9
Shadows,arygos,288,warlock,affliction,6,3,3
Impbiscuit,stormrage,288,warlock,affliction,6,3,3
Vintagepoop,sargeras,288,warlock,affliction,6,3,3
Bajheerafan,illidan,288,warlock,affliction,6,3,3
Kamai,frostwolf,288,warlock,affliction,6,3,3
Leônidos,ghostlands,288,warlock,affliction,6,3,3
Chaôtic,daggerspine,288,warlock,affliction,6,3,3
Warlockmf,sargeras,288,warlock,affliction,6,3,3
Warfeen,malganis,288,warlock,affliction,6,3,3
Freseate,quelthalas,288,warlock,affliction,6,3,3
Berathelok,aerie-peak,288,warlock,affliction,6,3,3
Róckroad,lightnings-blade,288,warlock,affliction,6,3,3
Blockk,moknathal,288,warlock,affliction,6,3,3
Yanlexx,stormrage,288,warlock,affliction,6,3,3
Emurog,icecrown,288,warlock,affliction,6,3,3
Diablox,silvermoon,288,warlock,affliction,6,3,3
Frylockx,mugthol,288,warlock,affliction,6,3,3
Stepzxo,sargeras,288,warlock,affliction,6,3,3
Tìdals,zuljin,288,warlock,affliction,6,3,3
Sinaman,barthilas,288,warlock,affliction,6,3,3
Drdoom,sargeras,288,warlock,affliction,6,3,3
Hachiui,galakrond,288,warlock,affliction,6,3,3
Chåndler,nemesis,288,warlock,affliction,6,3,3
Nozyroh,emerald-dream,288,warlock,affliction,6,3,3
Hauntu,stormreaver,288,warlock,affliction,6,3,3
Sidiouss,dreadmaul,288,warlock,affliction,6,3,3
Kokushu,burning-legion,288,warlock,affliction,6,3,3
Kossnen,shandris,288,warlock,affliction,6,3,3
Arnan,korgath,288,warlock,affliction,6,3,3
Conboii,tichondrius,288,warlock,affliction,6,3,3
Capïrota,nemesis,288,warlock,affliction,6,3,3
Alarauca,nerzhul,288,warlock,affliction,6,3,3
Crucifieds,tichondrius,288,warlock,affliction,6,3,3
Feldubya,illidan,288,warlock,affliction,6,3,3
Naag,tichondrius,288,warlock,affliction,6,3,3
Lockfold,illidan,288,warlock,affliction,6,3,3
Knäbue,tichondrius,288,warlock,affliction,6,3,3
Boltqt,tichondrius,288,warlock,affliction,6,3,3
Wizie,arthas,288,warlock,affliction,6,3,3
Harleyjames,ravenholdt,288,warlock,affliction,6,3,3
Liliasintera,dentarg,288,warlock,affliction,6,3,3
Aanx,dark-iron,288,warlock,affliction,6,3,3
Redsolojdc,tichondrius,288,warlock,affliction,6,3,3
Stormrift,sargeras,288,warlock,affliction,6,3,3
Dodgebolts,khaz-modan,288,warlock,affliction,6,3,3
Phishdots,tichondrius,288,warlock,affliction,6,3,3
Voltshot,tichondrius,288,warlock,affliction,6,3,3
Schofen,tichondrius,288,warlock,affliction,6,3,3
Chermonalbur,draka,288,warlock,affliction,9,3,6
Imien,moknathal,288,warlock,affliction,9,3,6
Felno,emerald-dream,288,warlock,affliction,12,3,9
Aluridan,azralon,288,warlock,affliction,12,3,9
Denji,galakrond,288,warlock,affliction,12,3,9
Avii,drakthul,288,warlock,affliction,12,3,9
Culture,arthas,288,warlock,affliction,12,3,9
Ezzako,area-52,288,warlock,affliction,12,3,9
Camila,lightnings-blade,288,warlock,affliction,12,3,9
Mynerve,velen,288,warlock,affliction,12,3,9
Davnport,frostmourne,288,warlock,affliction,12,3,9
Lithani,ragnaros,288,warlock,affliction,12,3,9
Llkoreall,tichondrius,288,warlock,affliction,12,3,9
Provilock,moon-guard,288,warlock,affliction,12,3,9
Ÿoucantwin,kiljaeden,288,warlock,affliction,12,3,9
Feelthefearx,ragnaros,288,warlock,affliction,12,3,9
Tromeo,sargeras,288,warlock,affliction,12,3,9
Grendaldots,tichondrius,288,warlock,affliction,12,3,9
Castshadow,nordrassil,288,warlock,affliction,18,3,15
Jjesie,tichondrius,288,warlock,affliction,18,3,15
Condevil,quelthalas,288,warlock,affliction,18,3,15
Angel,sargeras,288,warlock,affliction,18,3,15
Vizkopnik,bleeding-hollow,287,warlock,affliction,6,3,3
Nhen,daggerspine,287,warlock,affliction,6,3,3
Nessima,jubeithos,287,warlock,affliction,12,3,9
Lowkei,stonemaul,286,warlock,affliction,6,3,3
Lilthicy,sargeras,271,warlock,affliction,14,3,11
Kentus,moonrunner,255,warlock,affliction,14,4,10
Niava,tichondrius,239,warlock,affliction,5,3,2
Matzoball,zuljin,234,warlock,affliction,14,4,10
Hoana,azralon,233,warlock,affliction,8,4,4
Siltharious,dalaran,232,warlock,affliction,15,5,10
Lifelock,auchindoun,223,warlock,affliction,8,3,5
Spookytrev,stormrage,223,warlock,affliction,14,3,11
Meelady,tichondrius,192,warlock,affliction,6,2,4
Thumperrz,frostmourne,192,warlock,affliction,6,2,4
Bóózér,tichondrius,192,warlock,affliction,6,2,4
Fearsntears,stormrage,192,warlock,affliction,6,2,4
Soularonomy,tichondrius,192,warlock,affliction,6,2,4
Karmalock,malganis,192,warlock,affliction,6,2,4
Lcomi,tichondrius,192,warlock,affliction,6,2,4
Xoxoxu,frostmourne,192,warlock,affliction,6,2,4
Noggét,frostmourne,192,warlock,affliction,6,2,4
Nerolock,frostmourne,192,warlock,affliction,6,2,4
Hellfires,ragnaros,192,warlock,affliction,6,2,4
Yurick,frostmourne,192,warlock,affliction,6,2,4
Dawaatisme,zuljin,192,warlock,affliction,6,2,4
Lilitht,drakkari,192,warlock,affliction,6,2,4
Narsdemons,tichondrius,192,warlock,affliction,6,2,4
Asmodeun,malganis,192,warlock,affliction,6,2,4
Khurze,area-52,192,warlock,affliction,6,2,4
Veerdz,area-52,192,warlock,affliction,6,2,4
Raínstilted,area-52,192,warlock,affliction,6,2,4
Lockednloade,tichondrius,192,warlock,affliction,6,2,4
Abomasnow,frostmourne,192,warlock,affliction,6,2,4
Zörkô,zuljin,192,warlock,affliction,6,2,4
Plaguedoctor,stormrage,192,warlock,affliction,6,2,4
Yolandahadid,gilneas,192,warlock,affliction,6,2,4
Apolodys,garona,192,warlock,affliction,6,2,4
Screwed,tichondrius,192,warlock,affliction,6,2,4
Leruss,zangarmarsh,192,warlock,affliction,6,2,4
Ðeãdman,bleeding-hollow,192,warlock,affliction,6,2,4
Vorlos,bonechewer,192,warlock,affliction,6,2,4
Jacorian,illidan,192,warlock,affliction,6,2,4
Grixis,zuluhed,192,warlock,affliction,6,2,4
Mhael,lightninghoof,192,warlock,affliction,6,2,4
Willogan,gurubashi,192,warlock,affliction,6,2,4
Damerus,illidan,192,warlock,affliction,6,2,4
Scepti,area-52,192,warlock,affliction,6,2,4
Ministàff,ursin,192,warlock,affliction,6,2,4
Pk,azralon,192,warlock,affliction,6,2,4
Sylorelol,stormreaver,192,warlock,affliction,6,2,4
Døtyou,area-52,192,warlock,affliction,6,2,4
Es,velen,192,warlock,affliction,6,2,4
Anastadora,proudmoore,192,warlock,affliction,6,2,4
Sebss,proudmoore,192,warlock,affliction,6,2,4
Jèdi,drenden,192,warlock,affliction,6,2,4
Nightterrour,frostmourne,192,warlock,affliction,6,2,4
Yahihlock,silver-hand,192,warlock,affliction,6,2,4
Fondlemydot,stormscale,192,warlock,affliction,6,2,4
Rerollx,firetree,192,warlock,affliction,6,2,4
Payn,kiljaeden,192,warlock,affliction,6,2,4
Trillas,illidan,192,warlock,affliction,6,2,4
Charmandfarm,nerzhul,192,warlock,affliction,6,2,4
Cheesëbolt,illidan,192,warlock,affliction,6,2,4
Carcine,frostwolf,192,warlock,affliction,6,2,4
Fearanddots,moon-guard,192,warlock,affliction,6,2,4
Dotdottgoose,kiljaeden,192,warlock,affliction,6,2,4
Destructo,illidan,192,warlock,affliction,6,2,4
Vessires,darkspear,192,warlock,affliction,6,2,4
Thralord,blackrock,192,warlock,affliction,6,2,4
Deanwarlock,sargeras,192,warlock,affliction,6,2,4
Omagg,malorne,192,warlock,affliction,12,2,10
Refîk,sargeras,192,warlock,affliction,12,2,10
Sürfacing,malganis,192,warlock,affliction,12,2,10
Leviathen,shattered-hand,192,warlock,affliction,12,2,10
Tribulatiön,moon-guard,192,warlock,affliction,12,2,10
Dloq,azgalor,192,warlock,affliction,12,2,10
Tormentedcat,nazjatar,192,warlock,affliction,12,2,10
Rurnt,bloodhoof,192,warlock,affliction,13,2,11
Ferich,azralon,159,warlock,affliction,5,2,3
Ramone,turalyon,159,warlock,affliction,5,2,3
Dotlockndrop,stormreaver,159,warlock,affliction,5,2,3
Gutterxfox,malganis,159,warlock,affliction,11,2,9
Pwnasaurus,barthilas,128,warlock,affliction,10,2,8
Mickylock,tichondrius,96,warlock,affliction,6,1,5
Frdchickiana,tichondrius,96,warlock,affliction,6,1,5
Apocryphh,stormrage,96,warlock,affliction,6,1,5
Cornboil,tichondrius,96,warlock,affliction,6,1,5
Sylvahh,sargeras,96,warlock,affliction,6,1,5
Mobilecherpn,frostmourne,96,warlock,affliction,6,1,5
Ailliforlune,illidan,96,warlock,affliction,6,1,5
Guinegobbler,hyjal,96,warlock,affliction,6,1,5
Gamecobra,greymane,96,warlock,affliction,6,1,5
Olgreg,daggerspine,96,warlock,affliction,6,1,5
Carabelois,aegwynn,96,warlock,affliction,6,1,5
Haedn,stormrage,96,warlock,affliction,6,1,5
Tailsy,proudmoore,96,warlock,affliction,6,1,5
Sunkuna,aerie-peak,96,warlock,affliction,6,1,5
Alfemale,dalaran,96,warlock,affliction,6,1,5
Imhereforrbg,moon-guard,96,warlock,affliction,6,1,5
Smôkedsôul,area-52,96,warlock,affliction,6,1,5
Volturnus,wildhammer,96,warlock,affliction,6,1,5
Drainedd,blades-edge,96,warlock,affliction,6,1,5
Superbvious,lothar,96,warlock,affliction,6,1,5
Fabiusbilex,tichondrius,96,warlock,affliction,6,1,5
Efg,illidan,96,warlock,affliction,6,1,5
Malchiev,area-52,96,warlock,affliction,6,1,5
Nêcro,moon-guard,96,warlock,affliction,6,1,5
Menedemus,amanthul,96,warlock,affliction,6,1,5
Tuhdah,frostwolf,96,warlock,affliction,6,1,5
Pinkypay,ragnaros,96,warlock,affliction,6,1,5
Conspiration,sargeras,96,warlock,affliction,6,1,5
Atticassasin,stormrage,96,warlock,affliction,6,1,5
Chaøsbolt,area-52,96,warlock,affliction,6,1,5
Ehcsrop,doomhammer,96,warlock,affliction,6,1,5
Locktimes,ragnaros,96,warlock,affliction,6,1,5
Kammuany,sargeras,96,warlock,affliction,6,1,5
Bluffzlock,boulderfist,96,warlock,affliction,6,1,5
Ørthox,malganis,96,warlock,affliction,6,1,5
Shennaniganz,bleeding-hollow,96,warlock,affliction,6,1,5
Malignant,tichondrius,96,warlock,affliction,6,1,5
Feár,emerald-dream,96,warlock,affliction,6,1,5
Frem,eonar,96,warlock,affliction,6,1,5
Krozu,bleeding-hollow,96,warlock,affliction,6,1,5
Joseph,draktharon,96,warlock,affliction,6,1,5
Aedarine,uldum,96,warlock,affliction,6,1,5
Xylõck,sargeras,96,warlock,affliction,6,1,5
Fenrinozil,tichondrius,96,warlock,affliction,12,1,11
Shendù,stormrage,79,warlock,affliction,5,1,4
Zuelu,tichondrius,64,warlock,affliction,4,1,3
Amaia,nathrezim,48,warlock,affliction,3,1,2
Mìrä,kelthuzad,48,warlock,affliction,3,1,2
Voldmorto,azralon,42,warlock,affliction,8,2,6
Delete,greymane,16,warlock,affliction,1,1,0
Halix,emerald-dream,16,warlock,affliction,1,1,0
Ttvdjrio,area-52,2200,warrior,fury,84,54,30
Grimgrip,frostmane,2131,warrior,fury,92,53,39
Joshiman,area-52,2124,warrior,fury,78,42,36
Cabelastwo,tichondrius,2124,warrior,fury,87,46,41
Americanbull,moon-guard,2119,warrior,fury,253,134,119
Takeda,sargeras,2117,warrior,fury,107,61,46
Cabelas,tichondrius,2112,warrior,fury,89,45,44
Thrator,wyrmrest-accord,2110,warrior,fury,108,55,53
Braxxínn,tichondrius,2107,warrior,fury,54,39,15
Riproarin,stormrage,2105,warrior,fury,92,53,39
Coldlòve,akama,2076,warrior,fury,106,61,45
Furrytakeda,kelthuzad,2063,warrior,fury,140,78,62
Orclog,illidan,2058,warrior,fury,107,57,50
Biaa,tichondrius,2055,warrior,fury,78,38,40
Eazyc,tichondrius,2034,warrior,fury,207,112,95
Ðêed,area-52,2023,warrior,fury,66,37,29
Sworda,sargeras,2018,warrior,fury,89,54,35
Warqt,kelthuzad,2011,warrior,fury,105,58,47
Veevz,proudmoore,2010,warrior,fury,114,52,62
Notwarried,sargeras,1994,warrior,fury,89,41,48
Rôxi,malganis,1987,warrior,fury,246,130,116
Chillawigs,kelthuzad,1983,warrior,fury,84,47,37
Lahired,drakkari,1973,warrior,fury,227,112,115
Wienertoes,tichondrius,1963,warrior,fury,114,63,51
Ragwreck,bleeding-hollow,1959,warrior,fury,68,35,33
Taras,blackhand,1948,warrior,fury,147,68,79
Hìm,tichondrius,1939,warrior,fury,66,36,30
Sandronb,illidan,1938,warrior,fury,83,41,42
Eno,ragnaros,1937,warrior,fury,69,46,23
Gazzef,thrall,1935,warrior,fury,120,63,57
Cannabiddies,illidan,1932,warrior,fury,60,31,29
Alabamá,sargeras,1925,warrior,fury,36,21,15
Chopemupp,area-52,1912,warrior,fury,89,55,34
Turboboy,tichondrius,1911,warrior,fury,36,24,12
Tøpg,sargeras,1897,warrior,fury,67,39,28
Vèév,proudmoore,1894,warrior,fury,62,41,21
Blgjb,tichondrius,1894,warrior,fury,90,41,49
Mphx,tichondrius,1888,warrior,fury,48,30,18
Okme,tichondrius,1882,warrior,fury,66,36,30
Killbørn,azralon,1880,warrior,fury,48,29,19
Ásúrá,quelthalas,1879,warrior,fury,48,29,19
Brodestar,sargeras,1874,warrior,fury,48,31,17
Badvelic,tichondrius,1874,warrior,fury,46,28,18
Zanzaa,sargeras,1870,warrior,fury,85,47,38
Hlt,tichondrius,1869,warrior,fury,66,38,28
Shîzu,moon-guard,1868,warrior,fury,102,67,35
Trackstarz,llane,1862,warrior,fury,60,39,21
Negleçt,stormrage,1861,warrior,fury,36,23,13
Kevy,arygos,1860,warrior,fury,54,33,21
ßdm,illidan,1860,warrior,fury,54,26,28
Damonadrann,proudmoore,1859,warrior,fury,66,34,32
Nilah,tichondrius,1858,warrior,fury,112,66,46
Zak,feathermoon,1852,warrior,fury,41,30,11
Dowser,goldrinn,1852,warrior,fury,131,69,62
Gorehardt,illidan,1848,warrior,fury,54,26,28
Mchamstring,stormrage,1846,warrior,fury,51,30,21
Gromkhor,tichondrius,1840,warrior,fury,36,22,14
Esilox,area-52,1836,warrior,fury,42,28,14
Ethyrie,ragnaros,1836,warrior,fury,61,34,27
Lokityr,tichondrius,1834,warrior,fury,36,26,10
Jenjang,proudmoore,1834,warrior,fury,83,52,31
Brainhaze,tichondrius,1829,warrior,fury,36,21,15
Ggull,tichondrius,1827,warrior,fury,47,28,19
Kennäy,azralon,1827,warrior,fury,52,29,23
Ragwreckz,bleeding-hollow,1826,warrior,fury,52,32,20
Soymong,frostmourne,1825,warrior,fury,116,74,42
Mty,tichondrius,1824,warrior,fury,54,35,19
Szauren,stormrage,1824,warrior,fury,63,31,32
Cleavxy,sargeras,1823,warrior,fury,54,37,17
Gooberbear,frostmourne,1823,warrior,fury,145,82,63
Lingho,illidan,1822,warrior,fury,36,20,16
Apocalyptist,stormrage,1821,warrior,fury,99,58,41
Thadamaja,kiljaeden,1821,warrior,fury,48,26,22
Bosswin,tichondrius,1820,warrior,fury,53,28,25
Skyja,quelthalas,1820,warrior,fury,42,22,20
Druzhinik,moon-guard,1819,warrior,fury,137,78,59
Illmindofpoo,kelthuzad,1818,warrior,fury,42,28,14
Sayjaki,stormrage,1818,warrior,fury,102,62,40
Veyrin,stormrage,1818,warrior,fury,138,81,57
Isahri,moon-guard,1818,warrior,fury,110,64,46
Orchilles,illidan,1817,warrior,fury,60,35,25
Damiansuv,moon-guard,1817,warrior,fury,154,89,65
Openhardest,stormrage,1816,warrior,fury,41,27,14
Jírky,ragnaros,1816,warrior,fury,240,134,106
Zujuzo,moon-guard,1815,warrior,fury,111,64,47
Neôn,frostmourne,1815,warrior,fury,66,37,29
Onionsauce,frostmourne,1815,warrior,fury,161,90,71
Unbreakkable,tichondrius,1815,warrior,fury,78,43,35
Slughorn,moon-guard,1814,warrior,fury,102,53,49
Kazora,zuljin,1813,warrior,fury,48,33,15
Darkduke,tichondrius,1813,warrior,fury,33,21,12
Gentlehugs,illidan,1813,warrior,fury,35,20,15
Donutwar,proudmoore,1813,warrior,fury,54,30,24
Crankyhorn,stormrage,1813,warrior,fury,60,31,29
Duxor,sargeras,1811,warrior,fury,70,41,29
Barafang,wyrmrest-accord,1811,warrior,fury,234,125,109
Ragemane,illidan,1811,warrior,fury,90,47,43
Psychogenic,barthilas,1810,warrior,fury,102,60,42
Zyzz,scarlet-crusade,1807,warrior,fury,72,41,31
Killuall,sargeras,1807,warrior,fury,42,23,19
Wagù,moon-guard,1805,warrior,fury,48,32,16
Yawdamper,illidan,1805,warrior,fury,51,32,19
Starshattr,bleeding-hollow,1805,warrior,fury,108,64,44
Seoní,wyrmrest-accord,1805,warrior,fury,76,43,33
Maximad,moon-guard,1805,warrior,fury,108,58,50
Girioo,thrall,1802,warrior,fury,24,19,5
Franticlol,tichondrius,1802,warrior,fury,90,59,31
Cubie,malganis,1802,warrior,fury,89,47,42
Burger,the-underbog,1800,warrior,fury,24,19,5
Saîyanroyce,barthilas,1793,warrior,fury,113,64,49
Shadax,bleeding-hollow,1793,warrior,fury,263,139,124
Zoldian,tichondrius,1792,warrior,fury,89,49,40
Smexxin,tichondrius,1790,warrior,fury,36,21,15
Melifehorde,tichondrius,1790,warrior,fury,222,111,111
Jimjinjin,tichondrius,1787,warrior,fury,90,45,45
Nailah,illidan,1783,warrior,fury,116,62,54
Rekatron,area-52,1783,warrior,fury,49,25,24
Rynkae,moon-guard,1782,warrior,fury,42,21,21
Onîkudakì,sargeras,1775,warrior,fury,109,67,42
Sàndman,malganis,1775,warrior,fury,39,23,16
Larrybiscuit,moon-guard,1771,warrior,fury,180,105,75
Volgarr,zuljin,1767,warrior,fury,51,30,21
Choppiechop,area-52,1763,warrior,fury,42,26,16
Holuntung,illidan,1763,warrior,fury,73,38,35
Dahakawar,malganis,1757,warrior,fury,53,32,21
Elkojack,nemesis,1757,warrior,fury,35,21,14
Crøm,tichondrius,1752,warrior,fury,96,50,46
Basedaf,frostmourne,1751,warrior,fury,171,92,79
Chopped,wyrmrest-accord,1750,warrior,fury,93,43,50
Cheiftain,dalaran,1747,warrior,fury,48,26,22
Lootacris,illidan,1746,warrior,fury,42,20,22
Zugyu,tichondrius,1745,warrior,fury,24,19,5
Alarìon,malganis,1745,warrior,fury,45,31,14
Sonyanalogue,frostmourne,1745,warrior,fury,54,29,25
Bigfatork,area-52,1739,warrior,fury,94,47,47
Sixtydolla,kelthuzad,1738,warrior,fury,45,26,19
Dripgodx,malganis,1736,warrior,fury,54,30,24
Illaedan,quelthalas,1733,warrior,fury,95,47,48
Invinciblé,tichondrius,1730,warrior,fury,36,22,14
Kinseb,doomhammer,1730,warrior,fury,78,47,31
Beanstrom,tichondrius,1729,warrior,fury,77,39,38
Escånor,moon-guard,1728,warrior,fury,25,19,6
Akaínu,area-52,1728,warrior,fury,48,27,21
Daedrion,dalaran,1726,warrior,fury,90,49,41
Splasch,kelthuzad,1725,warrior,fury,65,29,36
Statistic,skullcrusher,1724,warrior,fury,52,25,27
Giannï,chogall,1723,warrior,fury,66,36,30
Budgetclap,nordrassil,1723,warrior,fury,72,36,36
Moelolita,illidan,1723,warrior,fury,41,19,22
Bigdude,frostwolf,1721,warrior,fury,48,24,24
Slamurai,moon-guard,1719,warrior,fury,24,18,6
Duochuanjun,illidan,1719,warrior,fury,48,26,22
Tastý,moon-guard,1716,warrior,fury,36,23,13
Noramed,moon-guard,1715,warrior,fury,113,63,50
Smache,tichondrius,1714,warrior,fury,29,19,10
Mulish,frostmourne,1712,warrior,fury,79,47,32
Wång,bonechewer,1710,warrior,fury,30,19,11
Käggai,khadgar,1709,warrior,fury,89,48,41
Ágsgøðx,bleeding-hollow,1707,warrior,fury,132,69,63
Riggs,stonemaul,1706,warrior,fury,59,32,27
Thänatøs,nemesis,1706,warrior,fury,68,35,33
Oddyseey,moon-guard,1706,warrior,fury,54,27,27
Warroiser,quelthalas,1705,warrior,fury,135,73,62
Bulgrim,moon-guard,1705,warrior,fury,103,52,51
Pepétí,azralon,1704,warrior,fury,90,53,37
Modì,sargeras,1703,warrior,fury,125,69,56
Faytful,thrall,1703,warrior,fury,60,27,33
Flarkin,area-52,1699,warrior,fury,30,18,12
Blazingfury,area-52,1699,warrior,fury,115,59,56
Mezw,tichondrius,1698,warrior,fury,77,42,35
Márcellus,illidan,1696,warrior,fury,90,51,39
Mochigome,moon-guard,1696,warrior,fury,97,49,48
Scolpi,stormrage,1695,warrior,fury,76,42,34
Âragorn,tichondrius,1693,warrior,fury,76,39,37
Keltanas,quelthalas,1692,warrior,fury,119,63,56
Nordama,stormrage,1691,warrior,fury,48,33,15
Eggroll,emerald-dream,1691,warrior,fury,183,100,83
Brimstoné,wyrmrest-accord,1685,warrior,fury,84,47,37
Berawar,tichondrius,1683,warrior,fury,78,41,37
Ciege,illidan,1682,warrior,fury,48,27,21
Ðowser,area-52,1680,warrior,fury,24,18,6
Scrotedog,area-52,1680,warrior,fury,55,24,31
Tyroe,thunderhorn,1679,warrior,fury,36,22,14
Moistmoocow,thrall,1678,warrior,fury,61,35,26
Torbajhorn,moon-guard,1676,warrior,fury,66,34,32
Thugdorr,sargeras,1675,warrior,fury,102,53,49
Furíous,thunderhorn,1675,warrior,fury,90,46,44
Ediann,elune,1674,warrior,fury,95,56,39
Coldshots,stormreaver,1674,warrior,fury,96,54,42
Morfoggore,ragnaros,1673,warrior,fury,55,25,30
Bwandøn,moon-guard,1671,warrior,fury,41,26,15
Nikon,bleeding-hollow,1671,warrior,fury,48,28,20
Tigas,icecrown,1671,warrior,fury,56,30,26
Koei,illidan,1670,warrior,fury,48,28,20
Youaredafeds,moon-guard,1669,warrior,fury,131,75,56
Oxitowocina,quelthalas,1667,warrior,fury,42,25,17
Raveve,area-52,1665,warrior,fury,38,25,13
Bopwar,malganis,1665,warrior,fury,48,29,19
Påpi,sargeras,1663,warrior,fury,90,54,36
Vinvivenna,emerald-dream,1663,warrior,fury,40,23,17
Moistt,nesingwary,1662,warrior,fury,44,28,16
Râvik,illidan,1662,warrior,fury,69,35,34
Velarrine,illidan,1661,warrior,fury,121,64,57
Sperow,malygos,1660,warrior,fury,62,37,25
Alteryx,sargeras,1658,warrior,fury,244,132,112
Gladheateher,bonechewer,1658,warrior,fury,60,28,32
Onionlord,wyrmrest-accord,1657,warrior,fury,41,26,15
Calder,malganis,1656,warrior,fury,72,36,36
Gaazhel,quelthalas,1655,warrior,fury,109,57,52
Zuggrok,zuljin,1655,warrior,fury,196,97,99
Kolosaltwo,tichondrius,1654,warrior,fury,77,41,36
Swiftslaýer,vashj,1654,warrior,fury,117,61,56
Gnomageddon,anetheron,1653,warrior,fury,82,39,43
Aotha,moon-guard,1652,warrior,fury,38,23,15
Conflíct,illidan,1652,warrior,fury,88,52,36
Graverot,burning-legion,1651,warrior,fury,46,22,24
Zoomgar,barthilas,1650,warrior,fury,36,23,13
Rinima,tichondrius,1650,warrior,fury,124,65,59
Coalpit,emerald-dream,1650,warrior,fury,66,31,35
Jarheadz,bleeding-hollow,1649,warrior,fury,48,32,16
Rikki,frostmourne,1649,warrior,fury,60,32,28
Oiledman,emerald-dream,1649,warrior,fury,46,24,22
Axesage,tichondrius,1648,warrior,fury,72,41,31
Ashwalker,malganis,1648,warrior,fury,56,30,26
Eggdoubles,sargeras,1647,warrior,fury,33,19,14
Eregor,sargeras,1647,warrior,fury,54,27,27
Tinyexcute,tichondrius,1644,warrior,fury,48,25,23
Agragar,zuljin,1643,warrior,fury,30,18,12
Ssamba,shattered-hand,1643,warrior,fury,36,20,16
Faren,agamaggan,1643,warrior,fury,167,91,76
Traka,stormrage,1642,warrior,fury,36,19,17
Mandragorn,kelthuzad,1642,warrior,fury,71,37,34
Lowz,hyjal,1641,warrior,fury,32,23,9
Wangjianguo,illidan,1641,warrior,fury,53,28,25
Larosfan,tichondrius,1640,warrior,fury,42,24,18
Tádakatsu,sargeras,1640,warrior,fury,147,79,68
Jhalma,stormrage,1640,warrior,fury,42,20,22
Smarthulk,tichondrius,1639,warrior,fury,60,34,26
Nogèt,frostmourne,1638,warrior,fury,47,28,19
Cupper,tichondrius,1638,warrior,fury,47,25,22
Festergrin,area-52,1637,warrior,fury,66,34,32
Vuraxx,area-52,1635,warrior,fury,30,22,8
Drashi,nazjatar,1635,warrior,fury,72,42,30
Ohdang,dark-iron,1635,warrior,fury,209,114,95
Dardash,ragnaros,1634,warrior,fury,30,21,9
Udmwarrior,zuljin,1633,warrior,fury,54,24,30
Ianprime,the-scryers,1632,warrior,fury,48,27,21
Fearlessxq,tichondrius,1631,warrior,fury,148,85,63
Thiccyb,area-52,1628,warrior,fury,24,17,7
Skollyd,tichondrius,1628,warrior,fury,32,20,12
Hoodlark,lightbringer,1628,warrior,fury,69,42,27
Fearlessly,moon-guard,1628,warrior,fury,209,113,96
Naelynh,quelthalas,1628,warrior,fury,54,26,28
Kellyboitv,frostmourne,1628,warrior,fury,42,20,22
Darkbunny,thaurissan,1627,warrior,fury,84,44,40
Colorx,sargeras,1625,warrior,fury,52,30,22
Kintarra,malygos,1625,warrior,fury,41,22,19
Feetmann,illidan,1624,warrior,fury,84,53,31
Ugriker,skullcrusher,1623,warrior,fury,42,26,16
Scrümp,illidan,1622,warrior,fury,65,41,24
Quinntis,anvilmar,1622,warrior,fury,42,23,19
Klieterious,bleeding-hollow,1622,warrior,fury,78,41,37
Ðåddý,stormrage,1620,warrior,fury,149,73,76
Joog,kalecgos,1619,warrior,fury,52,23,29
Warrmachine,mannoroth,1618,warrior,fury,197,111,86
Zarxc,quelthalas,1618,warrior,fury,60,31,29
Akkar,gilneas,1617,warrior,fury,49,25,24
Snugglebuggs,stormrage,1615,warrior,fury,101,51,50
Hârambe,kiljaeden,1614,warrior,fury,41,25,16
Dawx,thrall,1614,warrior,fury,30,17,13
Hairygrundel,area-52,1614,warrior,fury,101,55,46
Evilkorean,tichondrius,1614,warrior,fury,146,78,68
Andorane,bleeding-hollow,1614,warrior,fury,60,32,28
Råmpågë,tichondrius,1613,warrior,fury,42,26,16
Zangetsy,sargeras,1612,warrior,fury,111,59,52
Rücküs,tichondrius,1611,warrior,fury,110,68,42
Damburga,tichondrius,1609,warrior,fury,48,30,18
Khrull,khazgoroth,1609,warrior,fury,74,40,34
Kholusia,kul-tiras,1609,warrior,fury,148,70,78
Misakizs,sargeras,1609,warrior,fury,36,17,19
Guerreraa,ragnaros,1609,warrior,fury,83,37,46
Wrniss,tichondrius,1608,warrior,fury,48,31,17
Leviqt,moon-guard,1606,warrior,fury,36,21,15
Trôca,ragnaros,1603,warrior,fury,54,29,25
Fearless,moon-guard,1603,warrior,fury,132,68,64
Lilgucci,stonemaul,1602,warrior,fury,36,20,16
Islik,stormrage,1601,warrior,fury,30,17,13
Genesisblade,illidan,1601,warrior,fury,58,25,33
Krovikân,area-52,1600,warrior,fury,30,19,11
Soulfang,stormscale,1600,warrior,fury,36,20,16
Gorrtog,stormrage,1600,warrior,fury,213,108,105
Ystk,tichondrius,1598,warrior,fury,29,23,6
Brutality,kirin-tor,1598,warrior,fury,107,57,50
Jimseung,tichondrius,1598,warrior,fury,60,29,31
Strëngth,aggramar,1597,warrior,fury,88,48,40
Flexid,tichondrius,1597,warrior,fury,80,41,39
Koffray,malfurion,1596,warrior,fury,59,30,29
Filamon,dentarg,1595,warrior,fury,71,30,41
Neurötic,ragnaros,1594,warrior,fury,30,20,10
Gigatroll,tichondrius,1592,warrior,fury,59,30,29
Vapyr,moon-guard,1591,warrior,fury,41,20,21
Wampzug,azshara,1591,warrior,fury,78,37,41
Easons,tichondrius,1591,warrior,fury,71,33,38
Hammerock,ragnaros,1587,warrior,fury,35,18,17
Jadeemerald,kelthuzad,1585,warrior,fury,66,34,32
Shapur,tichondrius,1583,warrior,fury,41,22,19
Torv,frostmourne,1581,warrior,fury,68,38,30
Kroozy,thrall,1580,warrior,fury,42,24,18
Cokespoon,frostmourne,1579,warrior,fury,72,44,28
Shaøkahn,azralon,1579,warrior,fury,68,40,28
Tithousand,tichondrius,1578,warrior,fury,65,38,27
Zugzugtime,tichondrius,1577,warrior,fury,52,29,23
Ezeji,area-52,1577,warrior,fury,42,23,19
Sithlõrd,moon-guard,1577,warrior,fury,84,42,42
Fluffyarm,sargeras,1576,warrior,fury,115,62,53
Brøsk,azralon,1574,warrior,fury,108,58,50
Mers,garrosh,1572,warrior,fury,54,30,24
Wolfcultist,moon-guard,1572,warrior,fury,117,54,63
Baeowar,area-52,1572,warrior,fury,87,40,47
Sálieri,ragnaros,1570,warrior,fury,84,49,35
Sigiswald,cenarion-circle,1570,warrior,fury,48,23,25
Dann,ragnaros,1569,warrior,fury,59,35,24
Bloodfist,tichondrius,1568,warrior,fury,30,19,11
Dcashmoney,moon-guard,1566,warrior,fury,85,48,37
Gûard,stormrage,1566,warrior,fury,121,62,59
Dwarlan,stormrage,1563,warrior,fury,71,44,27
Philsbbqnow,dark-iron,1563,warrior,fury,36,18,18
Tanorai,area-52,1562,warrior,fury,48,29,19
Romus,spirestone,1562,warrior,fury,48,29,19
Rekill,emerald-dream,1562,warrior,fury,36,19,17
Mäjka,dalaran,1560,warrior,fury,36,20,16
Jimmfro,zuljin,1559,warrior,fury,64,33,31
Nvzah,area-52,1556,warrior,fury,66,28,38
Igoboom,bleeding-hollow,1555,warrior,fury,52,27,25
Arágorn,sargeras,1554,warrior,fury,60,33,27
Khargrok,ragnaros,1554,warrior,fury,147,80,67
Æwarrìor,tichondrius,1554,warrior,fury,36,19,17
Bigßiceps,tichondrius,1552,warrior,fury,42,23,19
Garobber,stormrage,1552,warrior,fury,36,17,19
Harkeigh,wyrmrest-accord,1551,warrior,fury,60,33,27
Stavsie,tichondrius,1548,warrior,fury,35,18,17
Tempusbane,proudmoore,1548,warrior,fury,56,24,32
Kombatwombat,kaelthas,1547,warrior,fury,32,20,12
Wöûlöû,trollbane,1546,warrior,fury,91,48,43
Morguez,tichondrius,1545,warrior,fury,84,46,38
Sugmad,area-52,1545,warrior,fury,48,22,26
Pitchman,tichondrius,1544,warrior,fury,59,32,27
Zuggyboi,moon-guard,1544,warrior,fury,48,25,23
Raggnarsøøn,ragnaros,1543,warrior,fury,101,47,54
Bigbungus,frostmourne,1542,warrior,fury,50,27,23
Varrian,rivendare,1539,warrior,fury,36,21,15
Zibby,malganis,1539,warrior,fury,36,18,18
Thraig,moon-guard,1538,warrior,fury,36,17,19
Mezmer,sargeras,1537,warrior,fury,36,25,11
Pootyspootz,warsong,1536,warrior,fury,53,31,22
Antei,thunderlord,1535,warrior,fury,53,31,22
Jingson,moon-guard,1535,warrior,fury,39,21,18
Iceice,dalaran,1535,warrior,fury,76,38,38
Wouili,zuljin,1533,warrior,fury,48,24,24
Clumhaku,dalaran,1533,warrior,fury,37,17,20
Ballinx,illidan,1533,warrior,fury,36,16,20
Impalle,nazjatar,1531,warrior,fury,54,33,21
Shibaraku,tichondrius,1531,warrior,fury,381,186,195
Sleazedog,kelthuzad,1529,warrior,fury,36,21,15
Zombad,azralon,1529,warrior,fury,62,34,28
Linker,ragnaros,1528,warrior,fury,48,28,20
Sensho,azralon,1527,warrior,fury,70,40,30
Ðow,burning-blade,1526,warrior,fury,47,25,22
Hellamoist,tichondrius,1526,warrior,fury,66,30,36
Tctc,emerald-dream,1524,warrior,fury,41,22,19
Cornmaster,darkspear,1524,warrior,fury,104,50,54
Getthechoppa,aegwynn,1523,warrior,fury,57,31,26
Cohëëd,kelthuzad,1523,warrior,fury,119,64,55
Horvv,frostmourne,1520,warrior,fury,54,31,23
Gomachi,moon-guard,1520,warrior,fury,60,25,35
Abomlnatlon,tichondrius,1517,warrior,fury,60,34,26
Hazknar,azralon,1517,warrior,fury,54,27,27
Invdeath,azralon,1517,warrior,fury,46,23,23
Orphasmic,moon-guard,1515,warrior,fury,29,17,12
Celere,azralon,1515,warrior,fury,66,32,34
Zitfrlt,wildhammer,1515,warrior,fury,87,39,48
Rafurk,area-52,1514,warrior,fury,48,28,20
Rendwarchief,garrosh,1514,warrior,fury,155,80,75
Magnis,stormrage,1514,warrior,fury,78,39,39
Playbox,area-52,1514,warrior,fury,83,37,46
Kârzâ,dawnbringer,1513,warrior,fury,113,61,52
Rikbielo,dragonmaw,1513,warrior,fury,73,39,34
Vhalden,quelthalas,1512,warrior,fury,24,16,8
Fkt,frostmourne,1512,warrior,fury,31,17,14
Mytharion,sargeras,1511,warrior,fury,30,18,12
Machomanran,zuljin,1509,warrior,fury,89,47,42
Mayonnaise,ragnaros,1509,warrior,fury,36,18,18
Grumok,tichondrius,1509,warrior,fury,44,20,24
Gurukakko,ragnaros,1508,warrior,fury,42,24,18
Jorked,drakkari,1508,warrior,fury,80,41,39
Líl,gorgonnash,1508,warrior,fury,48,20,28
Hôdû,tichondrius,1505,warrior,fury,85,48,37
Zerkxi,kelthuzad,1504,warrior,fury,45,25,20
Crohdey,madoran,1504,warrior,fury,148,78,70
Anandamide,frostwolf,1503,warrior,fury,51,27,24
Statistical,area-52,1500,warrior,fury,24,19,5
Rodahn,emerald-dream,1500,warrior,fury,54,31,23
Grômm,tichondrius,1500,warrior,fury,63,33,30
Nimna,moon-guard,1499,warrior,fury,59,29,30
Panterra,azralon,1497,warrior,fury,64,34,30
Koppo,kelthuzad,1496,warrior,fury,42,18,24
Lujzika,stormreaver,1495,warrior,fury,80,47,33
Venirith,moon-guard,1495,warrior,fury,82,43,39
Stoopkid,uldum,1494,warrior,fury,58,29,29
Wardeád,quelthalas,1493,warrior,fury,36,21,15
Varith,sargeras,1493,warrior,fury,54,26,28
Thunderfurry,drakkari,1491,warrior,fury,87,42,45
Albinosword,azralon,1488,warrior,fury,74,37,37
Wolurog,emerald-dream,1485,warrior,fury,30,21,9
Viagraliker,tichondrius,1484,warrior,fury,93,52,41
Carnemølida,thrall,1484,warrior,fury,58,28,30
Goon,frostmourne,1483,warrior,fury,48,26,22
Grommrosh,azralon,1482,warrior,fury,30,16,14
Hjomura,quelthalas,1482,warrior,fury,48,24,24
Ronok,ghostlands,1481,warrior,fury,42,26,16
Know,anetheron,1480,warrior,fury,39,25,14
Daelganis,blood-furnace,1480,warrior,fury,83,40,43
Berthibar,dalaran,1480,warrior,fury,111,52,59
Shádo,darkspear,1479,warrior,fury,48,29,19
Genrÿuusai,azralon,1478,warrior,fury,35,19,16
Lavablood,moon-guard,1478,warrior,fury,48,22,26
Warborn,agamaggan,1475,warrior,fury,54,24,30
Benchpress,bleeding-hollow,1474,warrior,fury,72,35,37
Karusuke,stormrage,1472,warrior,fury,36,21,15
Dieselsauce,stormscale,1470,warrior,fury,29,16,13
Ruuthless,sargeras,1470,warrior,fury,121,60,61
Hughmungús,frostmourne,1469,warrior,fury,36,20,16
Headsour,thunderhorn,1469,warrior,fury,71,37,34
Himiko,kaelthas,1469,warrior,fury,69,34,35
Rageorade,area-52,1467,warrior,fury,48,32,16
Braxtön,moon-guard,1467,warrior,fury,66,32,34
Badoosh,kaelthas,1466,warrior,fury,40,26,14
Xannypatrol,tichondrius,1466,warrior,fury,125,68,57
Jubeithos,draktharon,1466,warrior,fury,60,28,32
Iskandr,amanthul,1465,warrior,fury,111,56,55
Cliveswife,frostmourne,1462,warrior,fury,23,16,7
Selathiel,burning-blade,1462,warrior,fury,101,55,46
Teyroporah,azralon,1462,warrior,fury,63,34,29
Eatmyblade,wyrmrest-accord,1462,warrior,fury,283,137,146
Violençe,malganis,1462,warrior,fury,42,19,23
Azázyel,quelthalas,1461,warrior,fury,54,23,31
Mág,burning-legion,1460,warrior,fury,33,20,13
Commandó,proudmoore,1460,warrior,fury,71,42,29
Mòrgo,agamaggan,1458,warrior,fury,30,20,10
Nornogin,tichondrius,1458,warrior,fury,48,24,24
Dtrumpo,moon-guard,1457,warrior,fury,48,22,26
Mandremin,moon-guard,1456,warrior,fury,24,17,7
Cogsbixby,aerie-peak,1455,warrior,fury,30,21,9
Rhann,kelthuzad,1454,warrior,fury,44,23,21
Corbray,frostmourne,1454,warrior,fury,42,20,22
Bruttallis,frostmane,1452,warrior,fury,38,20,18
Murderwalk,shadowmoon,1452,warrior,fury,45,23,22
Bigjier,proudmoore,1452,warrior,fury,104,53,51
Ragnararagor,ragnaros,1452,warrior,fury,257,126,131
Machâ,illidan,1451,warrior,fury,35,17,18
Calzonez,bloodscalp,1449,warrior,fury,53,31,22
Kortera,malganis,1449,warrior,fury,59,33,26
Wazy,ragnaros,1448,warrior,fury,66,31,35
Connero,stormrage,1448,warrior,fury,54,25,29
Bestgrunt,tichondrius,1446,warrior,fury,102,46,56
Moriax,azralon,1445,warrior,fury,136,71,65
Siegfriéd,bleeding-hollow,1444,warrior,fury,48,28,20
Biggbudzz,sargeras,1441,warrior,fury,47,23,24
Bòne,frostmourne,1440,warrior,fury,36,17,19
Monreale,area-52,1439,warrior,fury,24,16,8
Saabre,tichondrius,1438,warrior,fury,72,36,36
Sarovek,thrall,1437,warrior,fury,48,27,21
Nikomasked,kelthuzad,1436,warrior,fury,24,15,9
Vheraxes,sargeras,1435,warrior,fury,24,15,9
Xenogears,boulderfist,1435,warrior,fury,60,23,37
Elken,haomarush,1434,warrior,fury,48,26,22
Kenpachì,kelthuzad,1433,warrior,fury,25,16,9
Trco,quelthalas,1433,warrior,fury,48,28,20
Lemondrake,sargeras,1432,warrior,fury,24,15,9
Døppiø,area-52,1432,warrior,fury,28,16,12
Cenanuandra,gnomeregan,1432,warrior,fury,70,39,31
Mankus,tichondrius,1432,warrior,fury,90,45,45
Apeal,skullcrusher,1431,warrior,fury,96,51,45
Chlord,proudmoore,1430,warrior,fury,30,15,15
Wishayzka,drakkari,1430,warrior,fury,42,20,22
Progesterone,bleeding-hollow,1429,warrior,fury,36,15,21
Impaling,moon-guard,1428,warrior,fury,59,35,24
Décapitator,area-52,1428,warrior,fury,36,15,21
Vnw,illidan,1427,warrior,fury,24,15,9
Toberino,illidan,1427,warrior,fury,24,15,9
Kaladbolg,tichondrius,1427,warrior,fury,84,47,37
Thyssara,moon-guard,1427,warrior,fury,99,51,48
Limpninny,dalaran,1426,warrior,fury,39,17,22
Ikoré,saurfang,1425,warrior,fury,87,45,42
Dözer,icecrown,1424,warrior,fury,36,20,16
Extremerogu,tichondrius,1423,warrior,fury,47,25,22
Tenger,velen,1422,warrior,fury,101,56,45
Maciste,exodar,1422,warrior,fury,30,15,15
Ruktar,akama,1422,warrior,fury,89,43,46
Aarmii,ragnaros,1421,warrior,fury,77,38,39
Nixe,caelestrasz,1421,warrior,fury,92,43,49
Attractive,silvermoon,1420,warrior,fury,103,57,46
Gokkuu,dragonblight,1420,warrior,fury,60,33,27
Asuna,burning-blade,1420,warrior,fury,46,24,22
Heenguer,azralon,1420,warrior,fury,60,31,29
Äléx,frostmourne,1418,warrior,fury,36,22,14
Majindoom,illidan,1418,warrior,fury,47,27,20
Gromarth,wyrmrest-accord,1418,warrior,fury,70,38,32
Lechonk,suramar,1415,warrior,fury,30,16,14
Bhutjolokia,ragnaros,1415,warrior,fury,48,23,25
Zareshi,sargeras,1412,warrior,fury,140,71,69
Eamonvalda,dalaran,1410,warrior,fury,45,25,20
Warsongwolf,tichondrius,1409,warrior,fury,78,36,42
Galigiggs,emerald-dream,1407,warrior,fury,24,15,9
Burtiera,wyrmrest-accord,1407,warrior,fury,60,36,24
Noppô,tichondrius,1406,warrior,fury,47,30,17
Errejota,illidan,1406,warrior,fury,54,26,28
Bloodhârdt,area-52,1404,warrior,fury,70,35,35
Howlofang,bleeding-hollow,1404,warrior,fury,54,23,31
Exëqt,area-52,1404,warrior,fury,60,25,35
Alecsten,tichondrius,1403,warrior,fury,30,15,15
Tacomeat,malorne,1403,warrior,fury,46,22,24
Cevadix,azralon,1402,warrior,fury,42,22,20
Noten,thunderlord,1401,warrior,fury,76,42,34
Sindarin,eitrigg,1400,warrior,fury,54,32,22
Kolgrim,hyjal,1400,warrior,fury,27,16,11
Xurug,zuljin,1400,warrior,fury,30,15,15
Panicbutton,proudmoore,1397,warrior,fury,66,35,31
Lovehandlez,proudmoore,1396,warrior,fury,54,30,24
Thren,tichondrius,1396,warrior,fury,30,15,15
Fluffytaco,illidan,1395,warrior,fury,60,32,28
Modzilla,aerie-peak,1395,warrior,fury,60,28,32
Lyonele,moon-guard,1394,warrior,fury,50,28,22
Mervyn,aegwynn,1393,warrior,fury,24,15,9
Ourhero,malganis,1392,warrior,fury,27,16,11
Zekken,blades-edge,1392,warrior,fury,77,39,38
Destructör,nagrand,1392,warrior,fury,72,34,38
Sïxsnacks,stormrage,1389,warrior,fury,26,16,10
Youserg,khazgoroth,1386,warrior,fury,117,59,58
Tinyterror,sargeras,1386,warrior,fury,48,22,26
Zerríck,moon-guard,1385,warrior,fury,78,38,40
Spaceburied,illidan,1385,warrior,fury,129,59,70
Rhohan,ysera,1384,warrior,fury,52,28,24
Quuavo,tichondrius,1384,warrior,fury,48,25,23
Ayrifik,tichondrius,1383,warrior,fury,21,15,6
Rageinc,jubeithos,1383,warrior,fury,62,28,34
Perserve,thunderlord,1383,warrior,fury,96,41,55
Vedrikk,ragnaros,1382,warrior,fury,30,16,14
Kratøz,tichondrius,1382,warrior,fury,36,18,18
Whitetaure,arthas,1382,warrior,fury,60,24,36
Thywub,proudmoore,1380,warrior,fury,36,17,19
Weesten,aerie-peak,1378,warrior,fury,178,99,79
Swiffy,stormrage,1375,warrior,fury,46,29,17
Brugo,area-52,1374,warrior,fury,91,56,35
Originalkhan,stormrage,1373,warrior,fury,54,23,31
Aladrynne,dalaran,1372,warrior,fury,183,88,95
Jarvîs,moon-guard,1371,warrior,fury,55,25,30
Zootonius,bloodscalp,1368,warrior,fury,36,20,16
Kross,illidan,1368,warrior,fury,80,39,41
Firmware,illidan,1368,warrior,fury,34,15,19
Chounshiryu,drakkari,1367,warrior,fury,283,142,141
Áres,spinebreaker,1366,warrior,fury,48,24,24
Hêllseeker,ragnaros,1365,warrior,fury,52,24,28
Crushanater,tichondrius,1364,warrior,fury,33,17,16
Ísrafel,ragnaros,1363,warrior,fury,36,21,15
Rageraz,trollbane,1362,warrior,fury,30,19,11
Valkwar,tichondrius,1362,warrior,fury,54,28,26
Nebgleb,bleeding-hollow,1360,warrior,fury,24,16,8
Reesse,eonar,1360,warrior,fury,30,17,13
Emotionaldps,malygos,1360,warrior,fury,141,74,67
Ivanzaytsev,ragnaros,1360,warrior,fury,78,40,38
Johnnysnowx,sargeras,1359,warrior,fury,107,54,53
Barntley,illidan,1358,warrior,fury,44,24,20
Matthegreat,area-52,1354,warrior,fury,51,25,26
Arbeon,emerald-dream,1348,warrior,fury,19,15,4
Ryukendo,stormrage,1346,warrior,fury,123,65,58
Ghostwalker,akama,1344,warrior,fury,56,27,29
Rerollrogue,thrall,1344,warrior,fury,95,42,53
Contradict,thrall,1343,warrior,fury,42,20,22
Rawheadrex,sargeras,1342,warrior,fury,24,14,10
Varlekt,frostmourne,1342,warrior,fury,65,34,31
Elbetoques,ragnaros,1341,warrior,fury,53,32,21
Fendimonster,tichondrius,1341,warrior,fury,226,123,103
Slughörn,moon-guard,1341,warrior,fury,30,14,16
Deseroth,illidan,1341,warrior,fury,30,14,16
Setseno,stormrage,1340,warrior,fury,32,16,16
Noteko,tichondrius,1340,warrior,fury,30,15,15
Teresabelle,proudmoore,1338,warrior,fury,40,20,20
Xiaoyujin,proudmoore,1337,warrior,fury,24,14,10
Michaela,moon-guard,1336,warrior,fury,24,14,10
Ciellë,proudmoore,1334,warrior,fury,27,17,10
Ensïs,moon-guard,1333,warrior,fury,72,31,41
Shino,garona,1332,warrior,fury,22,15,7
Zartren,khazgoroth,1331,warrior,fury,24,14,10
Breaker,undermine,1331,warrior,fury,30,14,16
Rusteazy,bleeding-hollow,1331,warrior,fury,36,15,21
Kelandrin,illidan,1330,warrior,fury,36,21,15
Sulze,tichondrius,1330,warrior,fury,27,15,12
Alysson,moon-guard,1329,warrior,fury,24,14,10
Dabier,bleeding-hollow,1329,warrior,fury,68,30,38
Ludicrous,dreadmaul,1327,warrior,fury,74,40,34
Bingin,stormrage,1327,warrior,fury,36,17,19
Timer,nagrand,1325,warrior,fury,30,18,12
Samuwrigh,tichondrius,1325,warrior,fury,30,17,13
Bondeye,stormrage,1325,warrior,fury,83,38,45
Arfzz,zangarmarsh,1325,warrior,fury,42,17,25
Boryndin,caelestrasz,1324,warrior,fury,18,14,4
Leturen,area-52,1324,warrior,fury,35,19,16
Hewman,aerie-peak,1321,warrior,fury,30,17,13
Uggtrick,zuljin,1321,warrior,fury,86,41,45
Galaxarr,bonechewer,1319,warrior,fury,65,32,33
Venóm,moon-guard,1317,warrior,fury,24,14,10
Cougaloo,sargeras,1317,warrior,fury,66,31,35
Slaggdad,illidan,1317,warrior,fury,132,60,72
Jichelei,tichondrius,1316,warrior,fury,30,14,16
Maarilayne,wyrmrest-accord,1315,warrior,fury,36,20,16
Zenrrei,ragnaros,1315,warrior,fury,31,15,16
Hellframe,ysondre,1315,warrior,fury,42,17,25
Kahuwuna,tichondrius,1314,warrior,fury,30,14,16
Wurrukattezz,tichondrius,1314,warrior,fury,62,28,34
Dissx,illidan,1308,warrior,fury,54,23,31
Crixsullus,sargeras,1307,warrior,fury,36,20,16
Tüssèll,khazgoroth,1306,warrior,fury,97,48,49
Assaulttank,drenden,1306,warrior,fury,48,20,28
Eatafrank,tichondrius,1305,warrior,fury,37,20,17
Makcumba,ragnaros,1305,warrior,fury,41,19,22
Sansãocore,nemesis,1304,warrior,fury,70,30,40
Lighttaker,proudmoore,1302,warrior,fury,96,51,45
Washim,area-52,1301,warrior,fury,49,27,22
Osannd,tichondrius,1301,warrior,fury,66,31,35
Kujø,wyrmrest-accord,1301,warrior,fury,66,28,38
Dhaemom,azralon,1300,warrior,fury,108,53,55
Arrad,sargeras,1299,warrior,fury,74,38,36
Goleus,emerald-dream,1299,warrior,fury,42,17,25
Tranos,zuljin,1299,warrior,fury,36,14,22
Maytrix,bleeding-hollow,1298,warrior,fury,66,33,33
Xeto,ragnaros,1296,warrior,fury,34,20,14
Fabian,kelthuzad,1296,warrior,fury,76,40,36
Vornicar,moon-guard,1296,warrior,fury,50,23,27
Chash,frostmourne,1293,warrior,fury,24,14,10
Joxer,nordrassil,1293,warrior,fury,48,25,23
Farklesnarf,tichondrius,1292,warrior,fury,30,14,16
Ganzar,nesingwary,1292,warrior,fury,35,14,21
Spicywagyu,tichondrius,1291,warrior,fury,36,22,14
Iblith,sargeras,1291,warrior,fury,42,23,19
Mcburger,barthilas,1290,warrior,fury,36,18,18
Bdm,mugthol,1290,warrior,fury,34,15,19
Hup,dethecus,1290,warrior,fury,36,14,22
Syaon,moon-guard,1288,warrior,fury,36,21,15
Wuushang,area-52,1288,warrior,fury,62,31,31
Grommasth,jubeithos,1286,warrior,fury,30,17,13
Hescobarrier,dalaran,1286,warrior,fury,30,16,14
Heavymetalyo,sargeras,1285,warrior,fury,36,20,16
Raskmeth,zuljin,1285,warrior,fury,36,20,16
Funk,illidan,1285,warrior,fury,42,14,28
Zweihänder,nemesis,1284,warrior,fury,23,14,9
Chippurrz,illidan,1284,warrior,fury,77,43,34
Ironpanzer,thrall,1283,warrior,fury,92,45,47
Metalstorms,firetree,1283,warrior,fury,72,35,37
Sheerwill,wyrmrest-accord,1281,warrior,fury,42,18,24
Smasher,garona,1277,warrior,fury,36,16,20
Kitto,malganis,1277,warrior,fury,56,22,34
Blackpro,sargeras,1275,warrior,fury,48,30,18
Slashen,sargeras,1274,warrior,fury,23,14,9
Leviathanl,bleeding-hollow,1274,warrior,fury,37,21,16
Rsage,lightbringer,1274,warrior,fury,116,59,57
Warföx,stormrage,1273,warrior,fury,54,23,31
Thorfjin,stormrage,1272,warrior,fury,30,15,15
Spaceguybro,whisperwind,1272,warrior,fury,47,20,27
Mikejustice,kelthuzad,1269,warrior,fury,142,65,77
Ivoryana,kelthuzad,1266,warrior,fury,48,25,23
Orrof,antonidas,1266,warrior,fury,135,61,74
Paí,nemesis,1265,warrior,fury,24,15,9
Ghazzghkull,illidan,1263,warrior,fury,53,27,26
Lilcha,stormrage,1258,warrior,fury,36,15,21
Tiqokz,sargeras,1257,warrior,fury,24,14,10
Swággýc,tichondrius,1257,warrior,fury,46,25,21
Savikk,earthen-ring,1256,warrior,fury,42,23,19
Rakshata,destromath,1256,warrior,fury,30,15,15
Garce,aerie-peak,1253,warrior,fury,31,16,15
Splints,nesingwary,1252,warrior,fury,44,25,19
Vandrad,stormrage,1252,warrior,fury,123,56,67
Renseven,frostmourne,1251,warrior,fury,42,23,19
Kurishjadar,tichondrius,1251,warrior,fury,66,31,35
Elonownesme,zuljin,1251,warrior,fury,56,26,30
Wiimaann,quelthalas,1250,warrior,fury,31,14,17
Nezzarek,sargeras,1250,warrior,fury,97,40,57
Wariorphilip,moon-guard,1248,warrior,fury,33,19,14
Wakkawar,stormrage,1248,warrior,fury,48,24,24
Cryposlice,malganis,1247,warrior,fury,30,13,17
Carnemontana,shadowsong,1246,warrior,fury,24,17,7
Jutank,sargeras,1245,warrior,fury,18,13,5
Verigan,barthilas,1244,warrior,fury,18,13,5
Draxxarlol,zuljin,1244,warrior,fury,24,13,11
Taiine,moon-guard,1243,warrior,fury,24,13,11
Torkscreww,bleeding-hollow,1243,warrior,fury,24,13,11
Liltom,sargeras,1242,warrior,fury,24,13,11
Buckleboot,illidan,1242,warrior,fury,24,13,11
Rendard,sargeras,1242,warrior,fury,24,13,11
Ironsavage,frostmourne,1242,warrior,fury,24,13,11
Mammo,khazgoroth,1241,warrior,fury,24,13,11
Warhand,frostmourne,1241,warrior,fury,30,13,17
Tripichin,sargeras,1240,warrior,fury,22,16,6
Icrìtmypants,dragonmaw,1240,warrior,fury,18,13,5
Cidrick,stormrage,1240,warrior,fury,18,13,5
Copinhodagua,azralon,1240,warrior,fury,25,15,10
Smeshyou,kelthuzad,1240,warrior,fury,24,13,11
Robocöp,quelthalas,1239,warrior,fury,24,13,11
Derr,tichondrius,1239,warrior,fury,30,13,17
Bártho,area-52,1237,warrior,fury,24,13,11
Skipowawa,area-52,1237,warrior,fury,30,16,14
Phandrosa,ragnaros,1237,warrior,fury,31,14,17
Lucicicia,bronzebeard,1236,warrior,fury,18,13,5
Atracasöl,ragnaros,1236,warrior,fury,24,13,11
Agonistes,emerald-dream,1236,warrior,fury,42,16,26
Maydie,illidan,1235,warrior,fury,24,13,11
Xanåtos,moon-guard,1234,warrior,fury,36,21,15
Kaíroz,quelthalas,1233,warrior,fury,54,31,23
Therealflex,zuljin,1233,warrior,fury,24,13,11
Zephyron,moonrunner,1231,warrior,fury,38,18,20
Murotamaka,malganis,1231,warrior,fury,30,13,17
Greenugly,tichondrius,1229,warrior,fury,54,24,30
Chilledflex,stormrage,1229,warrior,fury,30,13,17
Cjay,bleeding-hollow,1229,warrior,fury,30,13,17
Tlâloque,quelthalas,1228,warrior,fury,42,21,21
Kyle,kargath,1227,warrior,fury,34,21,13
Groggam,illidan,1226,warrior,fury,24,13,11
Tupacsback,stormrage,1224,warrior,fury,48,26,22
Tdaddy,lightbringer,1224,warrior,fury,168,84,84
Furiousangel,area-52,1223,warrior,fury,36,19,17
Mnoga,azralon,1222,warrior,fury,58,27,31
Beryrn,farstriders,1220,warrior,fury,47,28,19
Warbane,barthilas,1220,warrior,fury,36,19,17
Zerkules,frostmane,1220,warrior,fury,30,13,17
Grosjambes,turalyon,1214,warrior,fury,30,18,12
Screwz,blackrock,1214,warrior,fury,104,52,52
Tenebrocity,stormrage,1213,warrior,fury,42,19,23
Tryndamere,nagrand,1212,warrior,fury,41,18,23
Tayne,ragnaros,1208,warrior,fury,30,14,16
Wyrmscream,moon-guard,1207,warrior,fury,138,73,65
Breinan,ragnaros,1205,warrior,fury,51,26,25
Dawrzel,tichondrius,1201,warrior,fury,51,23,28
Zèldris,gallywix,1199,warrior,fury,121,68,53
Rendus,hyjal,1198,warrior,fury,54,21,33
Bigglyjoobs,tichondrius,1195,warrior,fury,23,13,10
Wraithvlad,moon-guard,1194,warrior,fury,97,43,54
Lidia,windrunner,1194,warrior,fury,38,14,24
Tinycutty,frostmourne,1189,warrior,fury,23,13,10
Koraciá,illidan,1188,warrior,fury,42,19,23
Kevinhårt,sargeras,1186,warrior,fury,36,13,23
Akusenshi,dragonblight,1184,warrior,fury,114,54,60
Nemesioh,tichondrius,1184,warrior,fury,59,25,34
Honduranhary,sargeras,1183,warrior,fury,34,17,17
Serviettski,zuljin,1181,warrior,fury,36,19,17
Furyknight,velen,1180,warrior,fury,79,41,38
Freakin,ragnaros,1180,warrior,fury,58,27,31
Ragemarley,dalaran,1180,warrior,fury,41,19,22
Ventréss,bleeding-hollow,1179,warrior,fury,29,14,15
Akarì,emerald-dream,1176,warrior,fury,30,15,15
Liljon,windrunner,1166,warrior,fury,36,17,19
Zorhn,skywall,1161,warrior,fury,24,18,6
Lucymay,kelthuzad,1159,warrior,fury,48,28,20
Darthwarr,bleeding-hollow,1156,warrior,fury,35,23,12
Lawyer,quelthalas,1152,warrior,fury,48,20,28
Yepkorean,tichondrius,1151,warrior,fury,18,12,6
Notfaytful,thrall,1151,warrior,fury,21,13,8
Líliúm,ragnaros,1151,warrior,fury,31,19,12
Calmebigfeet,tichondrius,1151,warrior,fury,24,12,12
Skrognoth,malganis,1150,warrior,fury,18,12,6
Brutalloli,thrall,1150,warrior,fury,25,13,12
Choppin,sargeras,1150,warrior,fury,24,12,12
Ganzism,tichondrius,1150,warrior,fury,24,12,12
Notcoverage,tichondrius,1150,warrior,fury,24,12,12
Ganzi,tichondrius,1150,warrior,fury,24,12,12
Lethu,tichondrius,1149,warrior,fury,18,12,6
Vulnscan,tichondrius,1149,warrior,fury,30,12,18
Flaapjack,malganis,1147,warrior,fury,18,12,6
Justicwar,area-52,1147,warrior,fury,24,12,12
Synalia,sargeras,1147,warrior,fury,24,12,12
Stånnis,moon-guard,1146,warrior,fury,18,12,6
Lòrdnasher,tichondrius,1146,warrior,fury,21,13,8
Faywarsong,area-52,1145,warrior,fury,24,12,12
Midweststuna,kul-tiras,1144,warrior,fury,18,12,6
Okkin,cairne,1143,warrior,fury,18,12,6
Reäl,dalaran,1143,warrior,fury,24,12,12
Kanekhy,ragnaros,1143,warrior,fury,28,13,15
Casmier,tichondrius,1141,warrior,fury,18,12,6
Sixtyboost,tichondrius,1139,warrior,fury,24,12,12
Balbyo,shattered-hand,1139,warrior,fury,30,12,18
Shééylias,moon-guard,1137,warrior,fury,30,12,18
Aitadon,sargeras,1136,warrior,fury,24,12,12
Kaladïn,ragnaros,1135,warrior,fury,18,12,6
Talismantate,quelthalas,1135,warrior,fury,18,12,6
Madaroy,stormrage,1135,warrior,fury,38,19,19
Curvinito,emerald-dream,1135,warrior,fury,24,12,12
Kreyonz,hyjal,1129,warrior,fury,24,12,12
Stinkyfuq,area-52,1128,warrior,fury,18,12,6
Valdemär,stormrage,1128,warrior,fury,30,12,18
Icon,tichondrius,1128,warrior,fury,30,12,18
Lykon,echo-isles,1127,warrior,fury,30,17,13
Chahta,shadowsong,1125,warrior,fury,18,12,6
Nondracio,ragnaros,1125,warrior,fury,36,12,24
Nutwax,korgath,1123,warrior,fury,36,14,22
Warkinit,proudmoore,1120,warrior,fury,68,30,38
Trendxx,stormrage,1118,warrior,fury,42,14,28
Rekitralph,tichondrius,1116,warrior,fury,30,13,17
Evergardens,saurfang,1115,warrior,fury,30,15,15
Irontarkus,garrosh,1112,warrior,fury,18,12,6
Welgo,moon-guard,1112,warrior,fury,24,13,11
Starplatinum,aerie-peak,1112,warrior,fury,60,26,34
Legionário,sargeras,1111,warrior,fury,29,15,14
Droun,rexxar,1110,warrior,fury,75,37,38
Awell,azralon,1109,warrior,fury,42,21,21
Sphílly,thrall,1107,warrior,fury,36,19,17
Garmeg,nemesis,1105,warrior,fury,78,36,42
Tyraelius,kiljaeden,1103,warrior,fury,39,24,15
Brolgo,quelthalas,1103,warrior,fury,54,22,32
Danastus,icecrown,1102,warrior,fury,63,27,36
Zokrásh,quelthalas,1102,warrior,fury,42,13,29
Jankalmojo,proudmoore,1101,warrior,fury,32,12,20
Jellyjamz,zuljin,1100,warrior,fury,36,19,17
Rocketcayton,veknilash,1096,warrior,fury,54,30,24
Warriorlee,jubeithos,1096,warrior,fury,27,13,14
Roxon,hellscream,1095,warrior,fury,95,47,48
Hyperdevil,ragnaros,1094,warrior,fury,30,14,16
Outrage,the-forgotten-coast,1093,warrior,fury,26,13,13
Goinberserk,tichondrius,1093,warrior,fury,34,16,18
Xfootman,quelthalas,1092,warrior,fury,42,25,17
Dodiru,azralon,1084,warrior,fury,27,13,14
Brodîn,tichondrius,1083,warrior,fury,54,30,24
Elsee,drakkari,1080,warrior,fury,26,12,14
Undmyaxe,shattered-halls,1078,warrior,fury,24,13,11
Assmut,stormrage,1074,warrior,fury,35,15,20
Fatguy,tichondrius,1067,warrior,fury,84,41,43
Creedz,dreadmaul,1064,warrior,fury,48,21,27
Zankets,area-52,1056,warrior,fury,12,11,1
Yermalx,tichondrius,1055,warrior,fury,18,11,7
Xgraves,sargeras,1055,warrior,fury,18,11,7
Ragingboner,aggramar,1055,warrior,fury,18,11,7
Nertharul,zuljin,1055,warrior,fury,18,11,7
Xcuses,area-52,1055,warrior,fury,18,11,7
Nicfury,alterac-mountains,1055,warrior,fury,18,11,7
Flaco,tichondrius,1055,warrior,fury,21,12,9
Gorbagglúk,azralon,1055,warrior,fury,30,15,15
Uhtred,moonrunner,1055,warrior,fury,24,12,12
Bobu,area-52,1055,warrior,fury,24,11,13
Bornclueless,illidan,1055,warrior,fury,24,11,13
Bearlornan,frostmourne,1054,warrior,fury,18,11,7
Claymation,tichondrius,1054,warrior,fury,18,11,7
Madwolf,tichondrius,1053,warrior,fury,18,11,7
Mogghul,azralon,1053,warrior,fury,18,11,7
Sako,amanthul,1052,warrior,fury,18,11,7
Chumbinhu,stormrage,1052,warrior,fury,18,11,7
Mightypikel,illidan,1051,warrior,fury,16,12,4
Cptnchocmilk,thrall,1051,warrior,fury,18,11,7
Hydrolisk,area-52,1051,warrior,fury,18,11,7
Radisa,sargeras,1051,warrior,fury,30,11,19
Orson,lothar,1050,warrior,fury,18,11,7
Xakp,tichondrius,1050,warrior,fury,27,12,15
Shrekshomie,zuljin,1049,warrior,fury,18,11,7
Villäïness,daggerspine,1049,warrior,fury,22,13,9
Ráionshin,quelthalas,1049,warrior,fury,24,11,13
Marcuss,bonechewer,1043,warrior,fury,18,11,7
Cåfe,tichondrius,1043,warrior,fury,18,11,7
Mercurial,mugthol,1042,warrior,fury,18,12,6
Djfredsd,tichondrius,1041,warrior,fury,24,11,13
Offthecharts,mannoroth,1040,warrior,fury,44,22,22
Smallestwar,zuljin,1040,warrior,fury,89,37,52
Owwycowwy,area-52,1032,warrior,fury,36,15,21
Studsrus,aegwynn,1030,warrior,fury,92,46,46
Nelissa,runetotem,1030,warrior,fury,24,12,12
Shoteiotoshi,ragnaros,1028,warrior,fury,47,25,22
Learila,moon-guard,1027,warrior,fury,30,14,16
Munanio,stormrage,1024,warrior,fury,24,11,13
Axekill,bleeding-hollow,1019,warrior,fury,30,11,19
Lodog,proudmoore,1012,warrior,fury,28,12,16
Bothar,sargeras,1012,warrior,fury,30,11,19
Markodarko,gilneas,1011,warrior,fury,29,16,13
Grimfàng,moon-guard,1009,warrior,fury,44,19,25
Éeu,anubarak,1008,warrior,fury,112,58,54
Shiddoshi,ragnaros,1006,warrior,fury,24,14,10
Crazysharpz,thaurissan,1001,warrior,fury,29,12,17
Xauce,queldorei,999,warrior,fury,42,12,30
Warchine,malganis,994,warrior,fury,27,12,15
Splurger,thrall,991,warrior,fury,17,11,6
Yêawen,tichondrius,990,warrior,fury,20,11,9
Tyranatusk,malganis,989,warrior,fury,18,12,6
Jonÿ,sargeras,989,warrior,fury,84,44,40
Muufasa,nerzhul,988,warrior,fury,24,13,11
Curacao,dark-iron,987,warrior,fury,26,11,15
Rahj,caelestrasz,985,warrior,fury,23,11,12
Bèèfcake,shattered-hand,984,warrior,fury,20,11,9
Bonebreakr,tichondrius,982,warrior,fury,48,18,30
Pulp,sargeras,976,warrior,fury,19,11,8
Elmosmash,thrall,974,warrior,fury,25,11,14
Judessi,kiljaeden,971,warrior,fury,20,11,9
Alexthar,drakkari,967,warrior,fury,86,37,49
Painfulangel,nesingwary,966,warrior,fury,50,29,21
Wargoph,burning-legion,960,warrior,fury,12,10,2
Youngmoneyd,illidan,960,warrior,fury,12,10,2
Gavrien,wyrmrest-accord,960,warrior,fury,12,10,2
Ramseyx,dalaran,960,warrior,fury,16,11,5
Warreeper,area-52,959,warrior,fury,12,10,2
Ooze,darkspear,959,warrior,fury,12,10,2
Dontlookup,tichondrius,959,warrior,fury,15,11,4
Jonhy,illidan,959,warrior,fury,18,10,8
Orrkky,jubeithos,959,warrior,fury,18,10,8
Tigo,khaz-modan,959,warrior,fury,18,10,8
Ankhxiety,sargeras,959,warrior,fury,18,10,8
Vaider,bleeding-hollow,959,warrior,fury,18,10,8
Gryl,stormrage,959,warrior,fury,18,10,8
Akenox,area-52,959,warrior,fury,18,10,8
Hasbullaa,proudmoore,959,warrior,fury,18,10,8
Prestico,ragnaros,959,warrior,fury,24,10,14
Ymìr,moon-guard,959,warrior,fury,24,10,14
Gahenk,chogall,958,warrior,fury,12,10,2
Worclin,illidan,958,warrior,fury,18,10,8
Bigshett,sargeras,958,warrior,fury,18,10,8
Blxckbeard,hyjal,958,warrior,fury,24,10,14
Squishmello,hyjal,957,warrior,fury,12,10,2
Semiru,zuljin,957,warrior,fury,12,10,2
Qicha,tichondrius,957,warrior,fury,24,10,14
Gorcker,hellscream,955,warrior,fury,18,10,8
Sinkale,moon-guard,955,warrior,fury,18,10,8
Harlow,spirestone,955,warrior,fury,24,10,14
Aggravation,bleeding-hollow,955,warrior,fury,24,10,14
Lessandro,quelthalas,954,warrior,fury,18,10,8
Luckychaos,bleeding-hollow,954,warrior,fury,18,10,8
Alerish,quelthalas,954,warrior,fury,18,10,8
Lurtras,exodar,954,warrior,fury,24,10,14
Jcßot,exodar,954,warrior,fury,24,10,14
Nordrages,stormrage,953,warrior,fury,18,10,8
Zépileque,azralon,953,warrior,fury,30,10,20
Brutalpløx,illidan,953,warrior,fury,30,10,20
Ironbark,elune,952,warrior,fury,18,10,8
Hadowar,thrall,952,warrior,fury,18,10,8
Mfgodofwar,kelthuzad,951,warrior,fury,24,10,14
Maytrixx,stormrage,950,warrior,fury,12,10,2
Jellybomb,sargeras,950,warrior,fury,24,10,14
Slumdawgg,andorhal,948,warrior,fury,24,10,14
Cannan,the-underbog,948,warrior,fury,81,28,53
Rumka,draktharon,943,warrior,fury,71,26,45
Croxxs,aegwynn,934,warrior,fury,18,10,8
Gushee,medivh,927,warrior,fury,23,12,11
Darkarus,drakkari,925,warrior,fury,36,14,22
Hùlksmâsh,zuljin,924,warrior,fury,23,13,10
Afelhia,moon-guard,924,warrior,fury,25,11,14
Ghostlyedge,turalyon,918,warrior,fury,72,25,47
Qfiend,stormrage,911,warrior,fury,17,10,7
Obiwun,azgalor,910,warrior,fury,17,10,7
Nïckböï,misha,909,warrior,fury,41,21,20
Dolsorae,malganis,905,warrior,fury,28,11,17
Pigonhae,zuljin,904,warrior,fury,25,12,13
Lokiullr,tichondrius,900,warrior,fury,27,11,16
Samdarkblade,kilrogg,898,warrior,fury,33,10,23
Shyliar,thrall,896,warrior,fury,20,10,10
Grievouz,nemesis,894,warrior,fury,17,10,7
Xtargaryen,stormrage,893,warrior,fury,20,10,10
Tankieone,aggramar,883,warrior,fury,85,31,54
Zambonibob,eonar,876,warrior,fury,54,25,29
Urnitemare,hyjal,872,warrior,fury,66,22,44
Gbrz,stormrage,864,warrior,fury,12,9,3
Beifong,barthilas,864,warrior,fury,12,9,3
Shadowstingg,tichondrius,864,warrior,fury,12,9,3
Pkgdtko,tichondrius,864,warrior,fury,12,9,3
Notacop,malygos,864,warrior,fury,12,9,3
Genderfluuid,trollbane,864,warrior,fury,12,9,3
Nukemdown,darkspear,864,warrior,fury,18,9,9
Chainsa,stormrage,864,warrior,fury,18,9,9
Riftgar,hyjal,864,warrior,fury,18,9,9
Astrëa,quelthalas,864,warrior,fury,18,9,9
Fayttful,area-52,864,warrior,fury,18,9,9
Lindsanv,illidan,864,warrior,fury,18,9,9
Baylîfe,illidan,864,warrior,fury,18,9,9
Shimizuken,tichondrius,864,warrior,fury,24,9,15
Verrynasty,area-52,863,warrior,fury,12,9,3
Virillius,wyrmrest-accord,863,warrior,fury,12,9,3
Ishtalar,sargeras,863,warrior,fury,12,9,3
Flanrych,illidan,863,warrior,fury,12,9,3
Likelygood,tichondrius,863,warrior,fury,12,9,3
Squonks,kelthuzad,863,warrior,fury,12,9,3
Mywarr,andorhal,863,warrior,fury,18,9,9
Zastrow,dalaran,863,warrior,fury,18,9,9
Tyrannus,chogall,863,warrior,fury,18,9,9
Broksampson,stormrage,863,warrior,fury,18,9,9
Elfdestroyer,wyrmrest-accord,863,warrior,fury,18,9,9
Kiladrew,korgath,863,warrior,fury,18,9,9
Youjumpijump,frostmourne,863,warrior,fury,24,9,15
Xclusive,area-52,863,warrior,fury,24,9,15
Yahnjee,stormrage,863,warrior,fury,24,9,15
Gzilla,queldorei,863,warrior,fury,24,9,15
Orsex,ragnaros,863,warrior,fury,24,9,15
Tylerdurdenx,dalaran,862,warrior,fury,12,9,3
Iskandër,quelthalas,862,warrior,fury,12,9,3
Nowarriororc,thrall,862,warrior,fury,18,9,9
Lox,blades-edge,862,warrior,fury,18,9,9
Kåyotix,proudmoore,862,warrior,fury,18,9,9
Archibaldo,darkspear,862,warrior,fury,18,9,9
Kreigër,area-52,862,warrior,fury,18,9,9
Exsolacyst,sargeras,862,warrior,fury,18,9,9
Kiaonlinn,ragnaros,862,warrior,fury,18,9,9
Crammed,tichondrius,862,warrior,fury,24,9,15
Cannonballz,sargeras,861,warrior,fury,18,9,9
Virrainy,stormrage,861,warrior,fury,18,9,9
Painquin,boulderfist,861,warrior,fury,24,9,15
Hamandaxe,amanthul,861,warrior,fury,24,9,15
Nerjinzul,bloodscalp,860,warrior,fury,15,10,5
Maddzspin,tichondrius,860,warrior,fury,18,9,9
Jarmog,tichondrius,860,warrior,fury,18,9,9
Rodorn,frostmourne,860,warrior,fury,22,10,12
Groguu,windrunner,859,warrior,fury,18,9,9
Fartden,tichondrius,859,warrior,fury,18,9,9
Stunninchaos,shattered-hand,859,warrior,fury,24,9,15
Figurefour,tichondrius,858,warrior,fury,12,9,3
Papasmurff,zuljin,858,warrior,fury,18,9,9
Melankoma,sargeras,856,warrior,fury,18,9,9
Jendal,ragnaros,856,warrior,fury,24,11,13
Kræzee,kelthuzad,856,warrior,fury,24,9,15
Nukee,tichondrius,853,warrior,fury,24,9,15
Cüba,nemesis,851,warrior,fury,36,14,22
Boitoróh,azralon,850,warrior,fury,24,9,15
Altharos,drakkari,845,warrior,fury,19,9,10
Trufsoturi,bleeding-hollow,845,warrior,fury,23,9,14
Xiing,azshara,842,warrior,fury,24,9,15
Flywar,nesingwary,838,warrior,fury,60,25,35
Kajing,boulderfist,836,warrior,fury,19,10,9
Cønan,stormrage,830,warrior,fury,14,10,4
Ghonad,windrunner,821,warrior,fury,23,9,14
Kessahh,moon-guard,820,warrior,fury,18,9,9
Likeachimpx,sargeras,816,warrior,fury,15,10,5
Magdar,daggerspine,813,warrior,fury,28,9,19
Haelerostus,moon-guard,811,warrior,fury,60,25,35
Futtmebuck,emerald-dream,810,warrior,fury,18,10,8
Franklinmvrd,stormrage,810,warrior,fury,18,10,8
Rediger,aggramar,805,warrior,fury,40,16,24
Bargorengar,skullcrusher,797,warrior,fury,108,48,60
Liquidbagel,frostmourne,794,warrior,fury,22,9,13
Stompgnomes,malganis,791,warrior,fury,20,9,11
Doominustwo,tichondrius,784,warrior,fury,19,9,10
Verallyn,area-52,783,warrior,fury,19,9,10
Klim,grizzly-hills,781,warrior,fury,25,9,16
Stimm,blood-furnace,768,warrior,fury,12,8,4
Colonclogger,proudmoore,768,warrior,fury,12,8,4
Controlololx,hyjal,768,warrior,fury,12,8,4
Bamag,dethecus,768,warrior,fury,12,8,4
Collosalx,stormrage,768,warrior,fury,12,8,4
Thelma,archimonde,768,warrior,fury,12,8,4
Zadrak,whisperwind,768,warrior,fury,12,8,4
Swìll,illidan,768,warrior,fury,12,8,4
Humanlog,illidan,768,warrior,fury,12,8,4
Angryexe,zuljin,768,warrior,fury,12,8,4
Narwhål,tichondrius,768,warrior,fury,12,8,4
Beforever,kiljaeden,768,warrior,fury,12,8,4
Kruma,stormscale,768,warrior,fury,12,8,4
Baultenaz,draenor,768,warrior,fury,12,8,4
Ryse,aegwynn,768,warrior,fury,12,8,4
Bbcapitalist,blackrock,768,warrior,fury,12,8,4
Beerstorm,stormrage,768,warrior,fury,12,8,4
Rimshotts,sargeras,768,warrior,fury,12,8,4
Idranel,nordrassil,768,warrior,fury,12,8,4
Tehsuperhero,norgannon,768,warrior,fury,12,8,4
Bozwar,tichondrius,768,warrior,fury,18,8,10
Doczz,malganis,768,warrior,fury,18,8,10
Oohsht,tichondrius,768,warrior,fury,18,8,10
Asstastic,bonechewer,768,warrior,fury,18,8,10
Coltyn,illidan,768,warrior,fury,18,8,10
Seanpaiuwu,zuljin,768,warrior,fury,24,8,16
Icebringer,frostmourne,768,warrior,fury,24,8,16
Kyres,moon-guard,767,warrior,fury,12,8,4
Trickyshield,durotan,767,warrior,fury,12,8,4
Spraten,bonechewer,767,warrior,fury,12,8,4
Drunkwarriôr,malygos,767,warrior,fury,12,8,4
Zhangetsu,emerald-dream,767,warrior,fury,12,8,4
Mittyroar,khazgoroth,767,warrior,fury,12,8,4
Moggos,firetree,767,warrior,fury,12,8,4
Varenkä,drakkari,767,warrior,fury,12,8,4
Dagrone,drakkari,767,warrior,fury,12,8,4
Mlau,tichondrius,767,warrior,fury,12,8,4
Enzothebaker,thrall,767,warrior,fury,12,8,4
Wíldcat,illidan,767,warrior,fury,18,8,10
Furyann,frostmourne,767,warrior,fury,18,8,10
Zêtt,drakkari,767,warrior,fury,18,8,10
Gízzmo,tichondrius,767,warrior,fury,18,8,10
Warriorox,illidan,767,warrior,fury,18,8,10
Gorethrax,tichondrius,767,warrior,fury,18,8,10
Maintarget,malganis,767,warrior,fury,18,8,10
Stoneball,kiljaeden,767,warrior,fury,18,8,10
Irallianaa,daggerspine,767,warrior,fury,18,8,10
Potan,thrall,767,warrior,fury,18,8,10
Ungabunga,frostwolf,767,warrior,fury,18,8,10
Zaràki,area-52,767,warrior,fury,18,8,10
Erdres,kelthuzad,767,warrior,fury,22,9,13
Darkirondadi,frostmourne,766,warrior,fury,12,8,4
Theßull,frostmourne,766,warrior,fury,12,8,4
Ugrak,frostmourne,766,warrior,fury,12,8,4
Menelaau,nemesis,766,warrior,fury,12,8,4
Alrekur,moon-guard,766,warrior,fury,12,8,4
Droggo,cenarius,766,warrior,fury,12,8,4
Drumann,hyjal,766,warrior,fury,12,8,4
Gromtalin,sargeras,766,warrior,fury,18,8,10
Genjis,quelthalas,766,warrior,fury,18,8,10
Arågòrn,stormrage,766,warrior,fury,18,8,10
Ayn,llane,766,warrior,fury,18,8,10
Åsc,area-52,766,warrior,fury,18,8,10
Warpaint,azuremyst,766,warrior,fury,18,8,10
Racknon,ragnaros,766,warrior,fury,24,9,15
Alanoria,skywall,765,warrior,fury,18,8,10
Xanthchaser,stormrage,765,warrior,fury,18,8,10
Lourdadmiwal,aegwynn,765,warrior,fury,35,11,24
Hellsinga,stormrage,764,warrior,fury,18,8,10
Zeerohkool,tichondrius,764,warrior,fury,24,8,16
Hishika,quelthalas,763,warrior,fury,15,9,6
Huri,nemesis,763,warrior,fury,30,8,22
Frettyhooman,blood-furnace,762,warrior,fury,12,8,4
Çampbêll,area-52,762,warrior,fury,24,8,16
Buffygramp,kelthuzad,762,warrior,fury,24,8,16
Alandris,icecrown,760,warrior,fury,18,10,8
Vicegripp,misha,759,warrior,fury,18,8,10
Kilp,thrall,751,warrior,fury,17,8,9
Riddickx,dragonblight,746,warrior,fury,30,10,20
Marleau,bleeding-hollow,742,warrior,fury,21,9,12
Slughórn,moon-guard,735,warrior,fury,14,9,5
Arngrimm,area-52,735,warrior,fury,14,9,5
Heater,stormrage,735,warrior,fury,16,8,8
Azmael,sargeras,735,warrior,fury,17,8,9
Alaricck,quelthalas,735,warrior,fury,26,9,17
Vlark,eredar,725,warrior,fury,18,8,10
Sedition,borean-tundra,719,warrior,fury,11,8,3
Zaraki,moon-guard,704,warrior,fury,16,8,8
Eleronogoth,draka,704,warrior,fury,16,8,8
Akj,sargeras,701,warrior,fury,23,9,14
Dagaraha,quelthalas,693,warrior,fury,22,8,14
Cjz,tichondrius,672,warrior,fury,12,7,5
Ðrëäd,area-52,672,warrior,fury,12,7,5
Stonksi,shadowmoon,672,warrior,fury,12,7,5
Notzyeal,area-52,672,warrior,fury,12,7,5
Executefreak,illidan,672,warrior,fury,12,7,5
Tnknspnk,magtheridon,672,warrior,fury,12,7,5
Gazah,skullcrusher,672,warrior,fury,12,7,5
Heyzulnut,whisperwind,672,warrior,fury,12,7,5
Grandorth,moon-guard,672,warrior,fury,12,7,5
Ruckw,stormrage,672,warrior,fury,12,7,5
Funsyze,garona,672,warrior,fury,12,7,5
Dós,emerald-dream,672,warrior,fury,12,7,5
Nylissia,blood-furnace,672,warrior,fury,12,7,5
Tonios,stormrage,672,warrior,fury,12,7,5
Linara,shandris,672,warrior,fury,12,7,5
Ladderx,area-52,672,warrior,fury,12,7,5
Canduin,queldorei,672,warrior,fury,12,7,5
Showtimè,thrall,672,warrior,fury,12,7,5
Riechst,quelthalas,672,warrior,fury,12,7,5
Evanx,sargeras,672,warrior,fury,12,7,5
Maar,lightbringer,672,warrior,fury,12,7,5
Krunas,quelthalas,672,warrior,fury,12,7,5
Kryptonite,illidan,672,warrior,fury,12,7,5
Malatov,moon-guard,672,warrior,fury,12,7,5
Vongrave,moonrunner,672,warrior,fury,12,7,5
Vvarcry,sargeras,672,warrior,fury,12,7,5
Mereleona,quelthalas,672,warrior,fury,12,7,5
Liltotey,frostmourne,672,warrior,fury,12,7,5
Sypii,malganis,672,warrior,fury,12,7,5
Dustywx,area-52,672,warrior,fury,12,7,5
Xårren,stormrage,672,warrior,fury,12,7,5
Oggrend,dalaran,672,warrior,fury,12,7,5
Eino,llane,672,warrior,fury,12,7,5
Souserkill,ragnaros,672,warrior,fury,12,7,5
Iinnocence,frostmourne,672,warrior,fury,12,7,5
Kowboy,stormrage,672,warrior,fury,12,7,5
Mardrex,korgath,672,warrior,fury,18,7,11
Endlesskilla,destromath,672,warrior,fury,18,7,11
Okgotchax,kelthuzad,672,warrior,fury,18,7,11
Belena,barthilas,672,warrior,fury,18,7,11
Ëdwärd,moon-guard,672,warrior,fury,18,7,11
Ðìbs,moon-guard,672,warrior,fury,18,7,11
Rustylugnut,area-52,672,warrior,fury,18,7,11
Radnod,tichondrius,672,warrior,fury,18,7,11
Iwillcrushyo,darkspear,672,warrior,fury,18,7,11
Goaco,drakkari,672,warrior,fury,18,7,11
Dotlom,wyrmrest-accord,672,warrior,fury,24,7,17
Kwelve,proudmoore,671,warrior,fury,12,7,5
Zikeno,dalaran,671,warrior,fury,12,7,5
Bjarkyy,azralon,671,warrior,fury,12,7,5
Demobox,malganis,671,warrior,fury,12,7,5
Greenmachine,twisting-nether,671,warrior,fury,12,7,5
Pancárcho,quelthalas,671,warrior,fury,12,7,5
Nokak,borean-tundra,671,warrior,fury,12,7,5
Lísterfiend,illidan,671,warrior,fury,12,7,5
Ahmorok,moon-guard,671,warrior,fury,12,7,5
Quintonious,dark-iron,671,warrior,fury,12,7,5
Potjiekos,lightninghoof,671,warrior,fury,12,7,5
Gigantx,tichondrius,671,warrior,fury,12,7,5
Yagluth,illidan,671,warrior,fury,12,7,5
Idestroy,exodar,671,warrior,fury,12,7,5
Cellyndia,area-52,671,warrior,fury,12,7,5
Seksyme,darkspear,671,warrior,fury,12,7,5
Methodicaly,aerie-peak,671,warrior,fury,12,7,5
Pelikanesis,arthas,671,warrior,fury,12,7,5
Mullf,stormrage,671,warrior,fury,12,7,5
Iorak,queldorei,671,warrior,fury,12,7,5
Chacca,suramar,671,warrior,fury,18,7,11
Smokiiwar,proudmoore,671,warrior,fury,18,7,11
Neak,kelthuzad,671,warrior,fury,18,7,11
Wårrior,kelthuzad,671,warrior,fury,18,7,11
Rockadoodle,tichondrius,671,warrior,fury,18,7,11
Barsol,ragnaros,671,warrior,fury,18,7,11
Xochicotzin,mugthol,671,warrior,fury,18,7,11
Ragnir,kelthuzad,671,warrior,fury,18,7,11
Ghurrk,hyjal,671,warrior,fury,18,7,11
Chieef,illidan,671,warrior,fury,18,7,11
Hurtless,area-52,671,warrior,fury,18,7,11
Cthumoo,moonrunner,671,warrior,fury,18,7,11
Remudan,tichondrius,671,warrior,fury,18,7,11
Xiosè,ragnaros,671,warrior,fury,24,7,17
Thradek,proudmoore,671,warrior,fury,24,7,17
Dragnol,quelthalas,670,warrior,fury,12,7,5
Chaiwar,ghostlands,670,warrior,fury,12,7,5
Ganon,garrosh,670,warrior,fury,12,7,5
Boneskull,zuljin,669,warrior,fury,12,7,5
Stoneddragon,spinebreaker,669,warrior,fury,12,7,5
Rafaeldantas,azralon,669,warrior,fury,12,7,5
Lyzan,stormrage,669,warrior,fury,12,7,5
Sealee,area-52,669,warrior,fury,12,7,5
Khorvesh,burning-legion,669,warrior,fury,18,7,11
Gamoosh,illidan,669,warrior,fury,20,7,13
Deáthwing,steamwheedle-cartel,669,warrior,fury,24,7,17
Shadowtitanx,korgath,669,warrior,fury,30,7,23
Misgnomer,farstriders,667,warrior,fury,12,7,5
Genesis,zangarmarsh,667,warrior,fury,12,7,5
Sworne,nordrassil,667,warrior,fury,12,7,5
Siiss,stormrage,665,warrior,fury,21,9,12
Keateane,frostmourne,662,warrior,fury,12,7,5
Shhiraq,zuljin,661,warrior,fury,30,7,23
Nighttoker,lightnings-blade,659,warrior,fury,12,7,5
Crashacorn,stormrage,659,warrior,fury,18,7,11
Trailsend,dalaran,658,warrior,fury,12,7,5
Damnge,zuljin,656,warrior,fury,24,10,14
Ayvha,wyrmrest-accord,654,warrior,fury,18,7,11
Naughtytwat,tichondrius,639,warrior,fury,14,8,6
Beardedretz,durotan,639,warrior,fury,16,7,9
Ngu,eldrethalas,639,warrior,fury,17,7,10
Zovudo,area-52,638,warrior,fury,14,8,6
Wintz,dreadmaul,638,warrior,fury,14,8,6
Donjuan,skullcrusher,637,warrior,fury,20,8,12
Nanor,zuljin,635,warrior,fury,14,8,6
Fenmok,khazgoroth,623,warrior,fury,11,7,4
Starcade,executus,623,warrior,fury,11,7,4
Greenwell,area-52,623,warrior,fury,15,7,8
Soypingu,the-scryers,623,warrior,fury,21,7,14
Leónard,moon-guard,622,warrior,fury,17,7,10
Iozhua,wyrmrest-accord,617,warrior,fury,22,9,13
Furryhorv,frostmourne,608,warrior,fury,22,7,15
Rohkvan,illidan,607,warrior,fury,14,7,7
Vorthax,korgath,607,warrior,fury,14,7,7
Riguini,tol-barad,606,warrior,fury,14,7,7
Lilreese,tichondrius,592,warrior,fury,13,7,6
Noktyn,haomarush,591,warrior,fury,11,7,4
Grimfate,boulderfist,576,warrior,fury,6,6,0
Grïnk,stormrage,576,warrior,fury,6,6,0
Seulrene,sargeras,576,warrior,fury,6,6,0
Contented,illidan,576,warrior,fury,9,7,2
Yükana,quelthalas,576,warrior,fury,12,6,6
Disarmed,proudmoore,576,warrior,fury,12,6,6
Gtrain,barthilas,576,warrior,fury,12,6,6
Majaya,area-52,576,warrior,fury,12,6,6
Bigmagron,azralon,576,warrior,fury,12,6,6
Erogorn,dawnbringer,576,warrior,fury,12,6,6
Rigil,the-forgotten-coast,576,warrior,fury,12,6,6
Timbermack,moon-guard,576,warrior,fury,12,6,6
Marfas,hyjal,576,warrior,fury,12,6,6
Benieswar,frostmourne,576,warrior,fury,12,6,6
Shieldchain,dalaran,576,warrior,fury,12,6,6
Râgê,moon-guard,576,warrior,fury,12,6,6
Skoll,illidan,576,warrior,fury,12,6,6
Zatarra,azralon,576,warrior,fury,12,6,6
Ðrënch,tichondrius,576,warrior,fury,12,6,6
Zertok,ravencrest,576,warrior,fury,12,6,6
Emv,area-52,576,warrior,fury,12,6,6
Kennie,malganis,576,warrior,fury,12,6,6
Tortag,malganis,576,warrior,fury,12,6,6
Youngmop,eitrigg,576,warrior,fury,12,6,6
Durrandal,stormrage,576,warrior,fury,12,6,6
Shaolin,duskwood,576,warrior,fury,12,6,6
Kaivax,tichondrius,576,warrior,fury,12,6,6
Ezcharger,kelthuzad,576,warrior,fury,12,6,6
Dangerousd,kiljaeden,576,warrior,fury,12,6,6
Dëåth,azgalor,576,warrior,fury,12,6,6
Yadiig,illidan,576,warrior,fury,12,6,6
Krispykreme,uldum,576,warrior,fury,12,6,6
Freÿdis,zuljin,576,warrior,fury,12,6,6
Atruis,area-52,576,warrior,fury,12,6,6
Snowflakee,jaedenar,576,warrior,fury,12,6,6
Feedzz,area-52,576,warrior,fury,12,6,6
Whateverzhan,tichondrius,576,warrior,fury,12,6,6
Tacrolimus,thrall,576,warrior,fury,12,6,6
Strongerjaw,tichondrius,576,warrior,fury,12,6,6
Gamelagged,area-52,576,warrior,fury,12,6,6
Bestseason,kelthuzad,576,warrior,fury,12,6,6
Mordoo,zuljin,576,warrior,fury,12,6,6
Sunamys,illidan,576,warrior,fury,12,6,6
Fooko,lethon,576,warrior,fury,12,6,6
Matrias,tichondrius,576,warrior,fury,12,6,6
Whittyxc,tichondrius,576,warrior,fury,12,6,6
Raeyth,twisting-nether,576,warrior,fury,12,6,6
Ggludan,area-52,576,warrior,fury,12,6,6
Serzull,area-52,576,warrior,fury,12,6,6
New,sargeras,576,warrior,fury,12,6,6
Bonafidesimp,stormrage,576,warrior,fury,12,6,6
Rezhan,area-52,576,warrior,fury,12,6,6
Iluvhugz,tichondrius,576,warrior,fury,12,6,6
Endurefen,sargeras,576,warrior,fury,12,6,6
Lilkrome,illidan,576,warrior,fury,12,6,6
Oppos,lightnings-blade,576,warrior,fury,12,6,6
Flynnstone,tichondrius,576,warrior,fury,12,6,6
Assamith,nemesis,576,warrior,fury,18,6,12
Kritsg,azgalor,576,warrior,fury,18,6,12
Himer,tichondrius,576,warrior,fury,18,6,12
Flexo,moon-guard,576,warrior,fury,18,6,12
Forks,malganis,576,warrior,fury,18,6,12
Tinfinitee,frostwolf,576,warrior,fury,18,6,12
Digitaldj,frostmourne,576,warrior,fury,18,6,12
Elleaux,bloodscalp,575,warrior,fury,12,6,6
Lorelie,malganis,575,warrior,fury,12,6,6
Kratthos,azralon,575,warrior,fury,12,6,6
Trackhawk,moon-guard,575,warrior,fury,12,6,6
Plidan,shuhalo,575,warrior,fury,12,6,6
Isitorganic,nesingwary,575,warrior,fury,12,6,6
Mordelona,ragnaros,575,warrior,fury,12,6,6
Berario,garrosh,575,warrior,fury,12,6,6
Hoarahløux,trollbane,575,warrior,fury,12,6,6
Xenyn,malganis,575,warrior,fury,12,6,6
Burninated,tichondrius,575,warrior,fury,12,6,6
Redblade,bleeding-hollow,575,warrior,fury,18,6,12
Docmoriarty,malygos,575,warrior,fury,18,6,12
Honorloxo,bleeding-hollow,575,warrior,fury,24,6,18
Betametazone,ragnaros,574,warrior,fury,13,8,5
Waterboylol,malganis,574,warrior,fury,12,6,6
Rageroni,tichondrius,574,warrior,fury,12,6,6
Badairplane,gilneas,574,warrior,fury,12,6,6
Oralo,tichondrius,574,warrior,fury,18,6,12
Siegeshatter,moon-guard,574,warrior,fury,24,6,18
Vethronis,dalaran,572,warrior,fury,12,6,6
Worc,aggramar,572,warrior,fury,12,6,6
Olokrash,dalaran,570,warrior,fury,12,6,6
Deltong,bonechewer,569,warrior,fury,12,6,6
Beccabutcher,tichondrius,566,warrior,fury,12,6,6
Boothtowolf,the-forgotten-coast,566,warrior,fury,12,6,6
Finnin,nathrezim,559,warrior,fury,11,6,5
Tochixchaos,illidan,543,warrior,fury,14,7,7
Surge,eredar,543,warrior,fury,16,6,10
Loosypoosy,magtheridon,542,warrior,fury,11,6,5
Sheluh,illidan,542,warrior,fury,17,6,11
Thorkéll,proudmoore,541,warrior,fury,23,6,17
Dionran,nemesis,533,warrior,fury,16,6,10
Tatërs,zuljin,527,warrior,fury,11,6,5
Sinbãd,sargeras,527,warrior,fury,11,6,5
Agarto,illidan,526,warrior,fury,11,6,5
Coffeebottom,wyrmrest-accord,526,warrior,fury,11,6,5
Dhefinator,moknathal,512,warrior,fury,10,6,4
Ángron,ragnaros,511,warrior,fury,11,6,5
Noblêsix,dalaran,480,warrior,fury,6,5,1
Onyx,auchindoun,480,warrior,fury,6,5,1
Vennoe,proudmoore,480,warrior,fury,6,5,1
Orkussw,illidan,480,warrior,fury,6,5,1
Kiritarokila,area-52,480,warrior,fury,6,5,1
Devaya,ragnaros,480,warrior,fury,6,5,1
Àxcx,moon-guard,480,warrior,fury,6,5,1
Soggynapkin,proudmoore,480,warrior,fury,6,5,1
Çhloee,the-underbog,480,warrior,fury,6,5,1
Sinjino,proudmoore,480,warrior,fury,6,5,1
Smorc,stormrage,480,warrior,fury,6,5,1
Kaitlanzhan,malganis,480,warrior,fury,6,5,1
Swingretzky,zuljin,480,warrior,fury,6,5,1
Tryhardr,sargeras,480,warrior,fury,6,5,1
Thorado,nemesis,480,warrior,fury,6,5,1
Dex,saurfang,480,warrior,fury,6,5,1
Tazmanianfur,akama,480,warrior,fury,6,5,1
Korsarro,frostmourne,480,warrior,fury,6,5,1
Balrog,firetree,480,warrior,fury,6,5,1
Theseuse,tichondrius,480,warrior,fury,6,5,1
Falconheart,wyrmrest-accord,480,warrior,fury,6,5,1
Didinosaur,azralon,480,warrior,fury,6,5,1
Bromgarr,crushridge,480,warrior,fury,6,5,1
Beleña,dalaran,480,warrior,fury,6,5,1
Ramranch,dawnbringer,480,warrior,fury,8,5,3
Victoriaöus,emerald-dream,480,warrior,fury,9,5,4
Trekk,azralon,480,warrior,fury,12,5,7
Testees,senjin,480,warrior,fury,12,5,7
Warkaiser,ragnaros,480,warrior,fury,12,5,7
Buhurt,sargeras,480,warrior,fury,12,5,7
Marimadelene,aegwynn,480,warrior,fury,12,5,7
Izhansheni,illidan,480,warrior,fury,12,5,7
Angrystepdad,moon-guard,480,warrior,fury,12,5,7
Zultråk,quelthalas,480,warrior,fury,12,5,7
Cubanßûrst,stormrage,480,warrior,fury,12,5,7
Arthurston,tichondrius,480,warrior,fury,12,5,7
Kiingkratoz,ragnaros,480,warrior,fury,12,5,7
Hexmaul,zuljin,480,warrior,fury,12,5,7
Pneumasmash,tichondrius,480,warrior,fury,12,5,7
Crímewave,zuljin,480,warrior,fury,12,5,7
Resize,wyrmrest-accord,480,warrior,fury,12,5,7
Zelglory,dalaran,480,warrior,fury,12,5,7
Rowdyanders,area-52,480,warrior,fury,12,5,7
Lilsweet,moon-guard,480,warrior,fury,12,5,7
Dtherockj,kiljaeden,480,warrior,fury,12,5,7
Slamuëladams,bleeding-hollow,480,warrior,fury,12,5,7
Grantlol,illidan,480,warrior,fury,12,5,7
Carnith,arthas,480,warrior,fury,12,5,7
Dalinare,area-52,480,warrior,fury,12,5,7
Maltrate,hyjal,480,warrior,fury,12,5,7
Río,area-52,480,warrior,fury,12,5,7
Oprampage,illidan,480,warrior,fury,12,5,7
Teqniq,kelthuzad,480,warrior,fury,12,5,7
Vvârriôr,barthilas,480,warrior,fury,12,5,7
Momlover,area-52,480,warrior,fury,12,5,7
Swollenbicep,tichondrius,480,warrior,fury,12,5,7
Genesisxp,barthilas,480,warrior,fury,12,5,7
Loktarmabras,dreadmaul,480,warrior,fury,12,5,7
Sabers,mannoroth,480,warrior,fury,12,5,7
Clansy,moon-guard,480,warrior,fury,12,5,7
Bgwinnier,shuhalo,480,warrior,fury,12,5,7
Pápý,ragnaros,480,warrior,fury,12,5,7
Aladarith,moon-guard,480,warrior,fury,12,5,7
Axesomebody,tichondrius,480,warrior,fury,12,5,7
Còlòssal,moknathal,480,warrior,fury,12,5,7
Klen,kelthuzad,480,warrior,fury,12,5,7
Taurenosaur,illidan,480,warrior,fury,12,5,7
Outo,stormrage,480,warrior,fury,12,5,7
Pisini,illidan,480,warrior,fury,12,5,7
Vallkÿria,goldrinn,480,warrior,fury,12,5,7
Pingolona,nemesis,480,warrior,fury,12,5,7
Chop,khadgar,480,warrior,fury,12,5,7
Orcveinz,tichondrius,480,warrior,fury,17,7,10
Caststeel,nordrassil,480,warrior,fury,15,6,9
Zoowarr,illidan,480,warrior,fury,15,6,9
Àndrewceo,illidan,480,warrior,fury,16,6,10
Gadlfuerte,ragnaros,480,warrior,fury,14,5,9
Georgedubya,illidan,480,warrior,fury,18,5,13
Rampagejin,tichondrius,480,warrior,fury,18,5,13
Thiccsauce,wyrmrest-accord,480,warrior,fury,18,5,13
Saltyniples,aegwynn,480,warrior,fury,18,5,13
Laloman,ragnaros,480,warrior,fury,18,5,13
Spinspin,borean-tundra,480,warrior,fury,18,5,13
Dragonrage,tanaris,480,warrior,fury,18,5,13
Zulex,dathremar,480,warrior,fury,18,5,13
Vonkinky,sargeras,479,warrior,fury,6,5,1
Morshaz,drakkari,479,warrior,fury,6,5,1
Zirtag,proudmoore,479,warrior,fury,6,5,1
Buckets,chogall,479,warrior,fury,12,5,7
Butterbutt,area-52,479,warrior,fury,12,5,7
Guantid,sargeras,479,warrior,fury,12,5,7
Morasar,area-52,479,warrior,fury,12,5,7
Olegg,laughing-skull,479,warrior,fury,12,5,7
Warsero,tichondrius,479,warrior,fury,12,5,7
Liavana,jubeithos,479,warrior,fury,12,5,7
Ksubîî,frostmourne,479,warrior,fury,12,5,7
Vengxdor,stormrage,479,warrior,fury,12,5,7
Gros,exodar,479,warrior,fury,12,5,7
Yasser,ragnaros,479,warrior,fury,12,5,7
Cômmander,ragnaros,479,warrior,fury,12,5,7
Shoresy,korgath,479,warrior,fury,12,5,7
Dorathorn,azralon,479,warrior,fury,18,5,13
Supersquish,moon-guard,479,warrior,fury,18,5,13
Màgs,moon-guard,479,warrior,fury,18,5,13
Døøm,malganis,478,warrior,fury,12,5,7
Beilian,quelthalas,478,warrior,fury,24,5,19
Drovik,malygos,477,warrior,fury,18,5,13
Dathrand,aerie-peak,476,warrior,fury,12,5,7
Fabszord,nemesis,476,warrior,fury,12,5,7
Faladoris,thrall,476,warrior,fury,12,5,7
Leotonywar,tichondrius,476,warrior,fury,12,5,7
Áryon,stormrage,474,warrior,fury,12,5,7
Veganwarrior,quelthalas,469,warrior,fury,18,5,13
Blazeowlglad,area-52,463,warrior,fury,17,5,12
Erdnase,ragnaros,447,warrior,fury,11,5,6
Rageverd,malganis,432,warrior,fury,9,5,4
Chiffonade,kelthuzad,432,warrior,fury,11,6,5
Kitiará,area-52,432,warrior,fury,15,6,9
Thalloom,thaurissan,432,warrior,fury,15,5,10
Avatarl,ragnaros,432,warrior,fury,15,5,10
Hugz,thrall,431,warrior,fury,11,5,6
Daydayfight,illidan,431,warrior,fury,11,5,6
Sukstofuk,frostmourne,431,warrior,fury,11,5,6
Glaros,blood-furnace,431,warrior,fury,11,5,6
Stealheads,dalaran,431,warrior,fury,15,6,9
Forerunner,tichondrius,416,warrior,fury,10,5,5
Akêwñon,stormrage,416,warrior,fury,10,5,5
Israelelel,azralon,416,warrior,fury,10,5,5
Digitalblade,illidan,415,warrior,fury,14,5,9
Husyuzhi,tichondrius,400,warrior,fury,7,5,2
Janoski,chogall,384,warrior,fury,6,4,2
Machutron,quelthalas,384,warrior,fury,6,4,2
Painedd,stormrage,384,warrior,fury,6,4,2
Pz,ravencrest,384,warrior,fury,6,4,2
Brendan,llane,384,warrior,fury,6,4,2
Scripper,stormrage,384,warrior,fury,6,4,2
Tomatogodx,sargeras,384,warrior,fury,6,4,2
Fornido,quelthalas,384,warrior,fury,6,4,2
Hasbullá,ragnaros,384,warrior,fury,6,4,2
Nunu,firetree,384,warrior,fury,6,4,2
Vilgaxx,area-52,384,warrior,fury,6,4,2
Axazel,drakkari,384,warrior,fury,6,4,2
Sickwidit,kiljaeden,384,warrior,fury,6,4,2
Smokes,sargeras,384,warrior,fury,6,4,2
Tobaccocat,stormreaver,384,warrior,fury,6,4,2
Amphyctionis,zuljin,384,warrior,fury,6,4,2
Techanina,aerie-peak,384,warrior,fury,6,4,2
Atuey,area-52,384,warrior,fury,6,4,2
Mommystrasza,kelthuzad,384,warrior,fury,6,4,2
Tazgar,draka,384,warrior,fury,6,4,2
Mortalstrike,chogall,384,warrior,fury,6,4,2
Inocencius,ragnaros,384,warrior,fury,6,4,2
Bloodscream,magtheridon,384,warrior,fury,6,4,2
Dualslong,malygos,384,warrior,fury,6,4,2
Greeplol,arthas,384,warrior,fury,6,4,2
Trashman,frostwolf,384,warrior,fury,6,4,2
Antecubital,burning-blade,384,warrior,fury,6,4,2
Thistou,quelthalas,384,warrior,fury,6,4,2
Iwooglybool,icecrown,384,warrior,fury,6,4,2
Ymirock,area-52,384,warrior,fury,6,4,2
Cujø,tichondrius,384,warrior,fury,6,4,2
Walterwhîte,tichondrius,384,warrior,fury,6,4,2
Youdumbaut,tichondrius,384,warrior,fury,6,4,2
Kamidaren,tichondrius,384,warrior,fury,6,4,2
Superbest,tichondrius,384,warrior,fury,6,4,2
Mcfatstuffs,boulderfist,384,warrior,fury,6,4,2
Affeine,malganis,384,warrior,fury,6,4,2
Sarachnis,area-52,384,warrior,fury,6,4,2
Hêroìnê,tichondrius,384,warrior,fury,6,4,2
Glowstick,tichondrius,384,warrior,fury,6,4,2
Suzushi,tichondrius,384,warrior,fury,6,4,2
Joshiguy,area-52,384,warrior,fury,6,4,2
Xirexa,bleeding-hollow,384,warrior,fury,6,4,2
Psyrush,area-52,384,warrior,fury,6,4,2
Samuluo,tichondrius,384,warrior,fury,6,4,2
Unpaused,kelthuzad,384,warrior,fury,6,4,2
Willcharge,tichondrius,384,warrior,fury,6,4,2
Carfal,spirestone,384,warrior,fury,6,4,2
Gorgoz,area-52,384,warrior,fury,6,4,2
Braxxinn,tichondrius,384,warrior,fury,6,4,2
Murghol,malganis,384,warrior,fury,6,4,2
Jàmiè,wyrmrest-accord,384,warrior,fury,6,4,2
Iripuanewone,illidan,384,warrior,fury,6,4,2
Biggwall,sargeras,384,warrior,fury,6,4,2
Darkoil,illidan,384,warrior,fury,6,4,2
Brogdar,moon-guard,384,warrior,fury,6,4,2
Eor,greymane,384,warrior,fury,6,4,2
Olaqwarraso,sargeras,384,warrior,fury,6,4,2
Wolfdurotan,azralon,384,warrior,fury,6,4,2
Skarkla,thrall,384,warrior,fury,6,4,2
Varkiren,moon-guard,384,warrior,fury,6,4,2
Qram,illidan,384,warrior,fury,6,4,2
Laferrari,illidan,384,warrior,fury,6,4,2
Sbplaywar,akama,384,warrior,fury,6,4,2
Speakeassy,dalaran,384,warrior,fury,6,4,2
Hamcan,dalaran,384,warrior,fury,6,4,2
Daemòn,dalaran,384,warrior,fury,6,4,2
Wooney,emerald-dream,384,warrior,fury,6,4,2
Tjuanalpha,illidan,384,warrior,fury,6,4,2
Bakadoom,illidan,384,warrior,fury,6,4,2
Joebo,thrall,384,warrior,fury,6,4,2
Vlaren,stormrage,384,warrior,fury,6,4,2
Junaid,frostmourne,384,warrior,fury,6,4,2
Xjpig,frostmourne,384,warrior,fury,6,4,2
Vaughan,azuremyst,384,warrior,fury,6,4,2
Ludakritz,moon-guard,384,warrior,fury,6,4,2
Ricksanches,shadowmoon,384,warrior,fury,6,4,2
Blackbaba,illidan,384,warrior,fury,6,4,2
Breké,moon-guard,384,warrior,fury,6,4,2
Danield,illidan,384,warrior,fury,11,4,7
Negrus,sargeras,384,warrior,fury,11,4,7
Beetcoyne,azuremyst,384,warrior,fury,12,4,8
Avoraçado,nemesis,384,warrior,fury,12,4,8
Pigblind,azralon,384,warrior,fury,12,4,8
Goremack,hellscream,384,warrior,fury,12,4,8
Metalhaed,thrall,384,warrior,fury,12,4,8
Wanderlie,zangarmarsh,384,warrior,fury,12,4,8
Goatmanee,tichondrius,384,warrior,fury,12,4,8
Gallowes,elune,384,warrior,fury,12,4,8
Shinshido,tichondrius,384,warrior,fury,12,4,8
Gorm,greymane,384,warrior,fury,12,4,8
Apollos,alleria,384,warrior,fury,12,4,8
Drengarusk,area-52,384,warrior,fury,12,4,8
Rezzett,wyrmrest-accord,384,warrior,fury,12,4,8
Muradinpica,stormrage,384,warrior,fury,12,4,8
Sakutarou,lightbringer,384,warrior,fury,12,4,8
Hukzula,illidan,384,warrior,fury,12,4,8
Nasrôth,korialstrasz,384,warrior,fury,12,4,8
Truegit,illidan,384,warrior,fury,12,4,8
Cýnz,frostmourne,384,warrior,fury,12,4,8
Luosifen,tichondrius,384,warrior,fury,12,4,8
Nobowar,tichondrius,384,warrior,fury,12,4,8
Gravo,ragnaros,384,warrior,fury,12,4,8
Syntra,area-52,384,warrior,fury,12,4,8
Kanosukai,emerald-dream,384,warrior,fury,12,4,8
Jhalakni,quelthalas,384,warrior,fury,12,4,8
Aislistraee,moon-guard,384,warrior,fury,12,4,8
Empriux,quelthalas,384,warrior,fury,12,4,8
Bighamm,tichondrius,384,warrior,fury,12,4,8
Kevinersaa,frostmourne,384,warrior,fury,12,4,8
Dáïñ,sargeras,384,warrior,fury,12,4,8
Agamere,stormrage,384,warrior,fury,12,4,8
Sîn,sargeras,384,warrior,fury,12,4,8
Appleleon,ragnaros,384,warrior,fury,12,4,8
Skrot,stormrage,384,warrior,fury,12,4,8
Corazondleón,ragnaros,384,warrior,fury,12,4,8
Rägnarök,stormrage,384,warrior,fury,12,4,8
Bladetko,tichondrius,384,warrior,fury,12,4,8
Krodah,quelthalas,384,warrior,fury,12,4,8
Worgasum,black-dragonflight,384,warrior,fury,12,4,8
Seppukush,quelthalas,384,warrior,fury,18,4,14
Lsays,tichondrius,384,warrior,fury,18,4,14
Kuragdem,trollbane,384,warrior,fury,18,4,14
Captnwrink,ysera,383,warrior,fury,6,4,2
Galvar,frostmourne,383,warrior,fury,6,4,2
Dalînar,quelthalas,383,warrior,fury,6,4,2
Hæmomancy,moon-guard,383,warrior,fury,12,4,8
Greggor,frostmourne,383,warrior,fury,12,4,8
Rahmholz,bonechewer,383,warrior,fury,12,4,8
Galadon,amanthul,383,warrior,fury,12,4,8
Anger,zuljin,383,warrior,fury,24,4,20
Ünö,proudmoore,382,warrior,fury,6,4,2
Fangerbiter,destromath,382,warrior,fury,6,4,2
Lámuérté,frostmourne,382,warrior,fury,6,4,2
Buakaaw,gallywix,382,warrior,fury,6,4,2
Solveighelga,drakkari,381,warrior,fury,12,4,8
Glennyballs,dalaran,379,warrior,fury,12,4,8
Baxel,arthas,367,warrior,fury,11,4,7
Gotrekson,azralon,351,warrior,fury,11,4,7
Pappin,malganis,351,warrior,fury,11,4,7
Snowwsaint,sargeras,351,warrior,fury,11,4,7
Koaltank,illidan,351,warrior,fury,14,5,9
Weepingdeath,burning-legion,336,warrior,fury,15,4,11
Darkrevel,dalvengyr,335,warrior,fury,11,4,7
Boonn,frostmourne,330,warrior,fury,13,7,6
Kíngkaisér,azralon,330,warrior,fury,15,6,9
Huleo,tichondrius,330,warrior,fury,14,5,9
Mataviejitos,ragnaros,329,warrior,fury,16,7,9
Rohde,nemesis,319,warrior,fury,8,4,4
Fancyboo,malganis,319,warrior,fury,8,4,4
Wallzar,sargeras,304,warrior,fury,13,4,9
Thaann,illidan,288,warrior,fury,6,3,3
Goyqqw,illidan,288,warrior,fury,6,3,3
Brøly,sargeras,288,warrior,fury,6,3,3
Govosh,thrall,288,warrior,fury,6,3,3
Chubw,tichondrius,288,warrior,fury,6,3,3
Cocó,sargeras,288,warrior,fury,6,3,3
Taywar,sargeras,288,warrior,fury,6,3,3
Heavydoody,moon-guard,288,warrior,fury,6,3,3
Kreamyumyums,tichondrius,288,warrior,fury,6,3,3
Warriorbrain,wyrmrest-accord,288,warrior,fury,6,3,3
Durres,tichondrius,288,warrior,fury,6,3,3
Xragnar,area-52,288,warrior,fury,6,3,3
Grimlòck,area-52,288,warrior,fury,6,3,3
Ruffless,skullcrusher,288,warrior,fury,6,3,3
Madblackcat,illidan,288,warrior,fury,6,3,3
Zerrekarr,wyrmrest-accord,288,warrior,fury,6,3,3
Raygé,malygos,288,warrior,fury,6,3,3
Guillotinè,area-52,288,warrior,fury,6,3,3
Wolfsbanne,khadgar,288,warrior,fury,6,3,3
Akrian,hellscream,288,warrior,fury,6,3,3
Júmmy,area-52,288,warrior,fury,6,3,3
Scylall,area-52,288,warrior,fury,6,3,3
Çhocothunder,area-52,288,warrior,fury,6,3,3
Decimateme,tichondrius,288,warrior,fury,6,3,3
Cassetto,icecrown,288,warrior,fury,6,3,3
Jethrix,kelthuzad,288,warrior,fury,6,3,3
Tobyrendrson,area-52,288,warrior,fury,6,3,3
Skynitez,area-52,288,warrior,fury,6,3,3
Corvesio,wyrmrest-accord,288,warrior,fury,6,3,3
Zugsok,thrall,288,warrior,fury,6,3,3
Kahn,andorhal,288,warrior,fury,6,3,3
Swíshersweét,kelthuzad,288,warrior,fury,6,3,3
Durist,tichondrius,288,warrior,fury,6,3,3
Aùstin,moon-guard,288,warrior,fury,6,3,3
Morelz,stormrage,288,warrior,fury,6,3,3
Kàli,kiljaeden,288,warrior,fury,6,3,3
Executie,duskwood,288,warrior,fury,6,3,3
Bloodthornx,quelthalas,288,warrior,fury,6,3,3
Kazek,sargeras,288,warrior,fury,6,3,3
Strongboii,tichondrius,288,warrior,fury,6,3,3
Goywarr,illidan,288,warrior,fury,6,3,3
Vodak,daggerspine,288,warrior,fury,6,3,3
Hijjiup,ysera,288,warrior,fury,6,3,3
Nukeworker,durotan,288,warrior,fury,6,3,3
Shadalloo,azralon,288,warrior,fury,6,3,3
Zemi,sargeras,288,warrior,fury,6,3,3
Brôm,emerald-dream,288,warrior,fury,6,3,3
Swiftÿ,gurubashi,288,warrior,fury,6,3,3
Warmaghar,azralon,288,warrior,fury,6,3,3
Tenfury,proudmoore,288,warrior,fury,6,3,3
Seymourbot,illidan,288,warrior,fury,6,3,3
Tâlos,ysondre,288,warrior,fury,6,3,3
Tâlos,magtheridon,288,warrior,fury,6,3,3
Santhvel,jubeithos,288,warrior,fury,6,3,3
Corgii,khaz-modan,288,warrior,fury,6,3,3
Aruia,proudmoore,288,warrior,fury,6,3,3
Warbringerr,hydraxis,288,warrior,fury,6,3,3
Kamigoroshi,crushridge,288,warrior,fury,6,3,3
Satedqq,illidan,288,warrior,fury,6,3,3
Cronrow,thunderlord,288,warrior,fury,6,3,3
Miyamashi,stormrage,288,warrior,fury,6,3,3
Deepsplitter,illidan,288,warrior,fury,6,3,3
Hithen,quelthalas,288,warrior,fury,6,3,3
Abuse,nordrassil,288,warrior,fury,6,3,3
Mildsauce,illidan,288,warrior,fury,6,3,3
Glexecute,sargeras,288,warrior,fury,6,3,3
Smxrf,hyjal,288,warrior,fury,6,3,3
Mcdowëll,moon-guard,288,warrior,fury,6,3,3
Barbarìan,bleeding-hollow,288,warrior,fury,6,3,3
Milkmebby,bleeding-hollow,288,warrior,fury,6,3,3
Victoria,malganis,288,warrior,fury,6,3,3
Ciz,emerald-dream,288,warrior,fury,6,3,3
Dunkmate,malganis,288,warrior,fury,6,3,3
Uncritable,dalaran,288,warrior,fury,6,3,3
Nginx,queldorei,288,warrior,fury,6,3,3
Dirtypin,shadowmoon,288,warrior,fury,6,3,3
Oven,tichondrius,288,warrior,fury,6,3,3
Protstitute,hyjal,288,warrior,fury,6,3,3
Rí,moon-guard,288,warrior,fury,6,3,3
Griimhoof,malganis,288,warrior,fury,6,3,3
Peterheater,emerald-dream,288,warrior,fury,6,3,3
Egoist,malganis,288,warrior,fury,6,3,3
Thegoodson,zuljin,288,warrior,fury,6,3,3
Kénblock,tichondrius,288,warrior,fury,6,3,3
Kimed,nordrassil,288,warrior,fury,6,3,3
Säbeër,ragnaros,288,warrior,fury,6,3,3
Anticiðe,zuljin,288,warrior,fury,6,3,3
Scran,sargeras,288,warrior,fury,6,3,3
Joarmyman,proudmoore,288,warrior,fury,6,3,3
Lechee,silvermoon,288,warrior,fury,6,3,3
Benw,dawnbringer,288,warrior,fury,6,3,3
Wargasms,alterac-mountains,288,warrior,fury,6,3,3
Razzik,emerald-dream,288,warrior,fury,6,3,3
Fury,frostmourne,288,warrior,fury,6,3,3
Tsathoggua,kiljaeden,288,warrior,fury,6,3,3
Painfulsin,tichondrius,288,warrior,fury,6,3,3
Gongos,doomhammer,288,warrior,fury,6,3,3
Galachad,jubeithos,288,warrior,fury,6,3,3
Verydanger,emerald-dream,288,warrior,fury,6,3,3
Beârz,the-underbog,288,warrior,fury,6,3,3
Gläedr,dalaran,288,warrior,fury,6,3,3
Wescer,frostmourne,288,warrior,fury,6,3,3
Orcly,kilrogg,288,warrior,fury,6,3,3
Peeb,tichondrius,288,warrior,fury,6,3,3
Slãmpiece,stormrage,288,warrior,fury,6,3,3
Carborr,frostmourne,288,warrior,fury,6,3,3
Wwesheamus,frostmourne,288,warrior,fury,6,3,3
Slitt,azralon,288,warrior,fury,6,3,3
Instakill,garrosh,288,warrior,fury,6,3,3
Mubun,tichondrius,288,warrior,fury,6,3,3
Smashr,tichondrius,288,warrior,fury,6,3,3
Wisslogia,ragnaros,288,warrior,fury,6,3,3
Herkja,barthilas,288,warrior,fury,6,3,3
Zangre,stormrage,288,warrior,fury,6,3,3
Elix,stormscale,288,warrior,fury,6,3,3
Makeranbing,barthilas,288,warrior,fury,6,3,3
Bigdickgomez,frostmourne,288,warrior,fury,6,3,3
Chapublin,ragnaros,288,warrior,fury,6,3,3
Demøletiøn,stormrage,288,warrior,fury,6,3,3
Malystik,ragnaros,288,warrior,fury,6,3,3
Colössal,moon-guard,288,warrior,fury,6,3,3
Pongk,tichondrius,288,warrior,fury,6,3,3
Kurowar,drakkari,288,warrior,fury,6,3,3
Unng,emerald-dream,288,warrior,fury,6,3,3
Daddyd,sargeras,288,warrior,fury,6,3,3
Bruzerk,ragnaros,288,warrior,fury,6,3,3
Lightswords,stormrage,288,warrior,fury,6,3,3
Caynos,stormrage,288,warrior,fury,6,3,3
Harthan,stormscale,288,warrior,fury,6,3,3
Aeros,winterhoof,288,warrior,fury,6,3,3
Sejunz,ragnaros,288,warrior,fury,6,3,3
Terazova,tichondrius,288,warrior,fury,6,3,3
Rogorof,azralon,288,warrior,fury,6,3,3
Nikey,tichondrius,288,warrior,fury,6,3,3
Stellabear,aggramar,288,warrior,fury,6,3,3
Martrek,amanthul,288,warrior,fury,6,3,3
Crowsfall,aggramar,288,warrior,fury,6,3,3
Twilightrain,tichondrius,288,warrior,fury,6,3,3
Korland,aerie-peak,288,warrior,fury,6,3,3
Bled,quelthalas,288,warrior,fury,10,4,6
Loadmaster,dragonmaw,288,warrior,fury,8,3,5
Duudoo,stormrage,288,warrior,fury,8,3,5
Cøpperpøt,bleeding-hollow,288,warrior,fury,9,3,6
Urion,illidan,288,warrior,fury,11,3,8
Warseed,ragnaros,288,warrior,fury,12,3,9
Krilles,tichondrius,288,warrior,fury,12,3,9
Davien,tichondrius,288,warrior,fury,12,3,9
Kromgrall,tichondrius,288,warrior,fury,12,3,9
Rageroidz,area-52,288,warrior,fury,12,3,9
Bladeweaver,illidan,288,warrior,fury,12,3,9
Rólex,tichondrius,288,warrior,fury,12,3,9
Shínkicker,area-52,288,warrior,fury,12,3,9
Gristly,sargeras,288,warrior,fury,12,3,9
Stromkiller,stormrage,288,warrior,fury,12,3,9
Pastorpeen,thrall,288,warrior,fury,12,3,9
Barcëlð,frostmourne,288,warrior,fury,12,3,9
Tríxman,moon-guard,288,warrior,fury,12,3,9
Kimuraa,hyjal,288,warrior,fury,12,3,9
Ratface,frostmourne,288,warrior,fury,12,3,9
Flexìn,tichondrius,288,warrior,fury,12,3,9
Zelekron,emerald-dream,288,warrior,fury,12,3,9
Krimmjðw,sargeras,288,warrior,fury,12,3,9
Leonz,undermine,288,warrior,fury,12,3,9
Blackscale,grizzly-hills,288,warrior,fury,12,3,9
Andro,arthas,288,warrior,fury,12,3,9
Banggo,frostmourne,288,warrior,fury,12,3,9
Monkeybrain,azralon,288,warrior,fury,12,3,9
Lynn,zangarmarsh,288,warrior,fury,12,3,9
Serrabella,illidan,288,warrior,fury,12,3,9
Apolio,magtheridon,288,warrior,fury,12,3,9
Jujuassgeter,darkspear,288,warrior,fury,18,3,15
Norru,moon-guard,288,warrior,fury,18,3,15
Halobender,emerald-dream,287,warrior,fury,6,3,3
Disclone,tichondrius,287,warrior,fury,6,3,3
Eadsmasher,jubeithos,287,warrior,fury,6,3,3
Monsterpepe,tichondrius,287,warrior,fury,12,3,9
Daymancometh,proudmoore,271,warrior,fury,11,3,8
Zolpidem,nemesis,255,warrior,fury,11,3,8
Bigdaddyzees,bleeding-hollow,255,warrior,fury,11,3,8
Asteríon,sargeras,239,warrior,fury,5,3,2
Chupelo,tichondrius,239,warrior,fury,5,3,2
Ramaraparoo,proudmoore,239,warrior,fury,5,3,2
Gwod,stormrage,239,warrior,fury,5,3,2
Reagzy,stormrage,234,warrior,fury,10,4,6
Schlosh,laughing-skull,223,warrior,fury,8,3,5
Heirel,kelthuzad,208,warrior,fury,7,3,4
Çórý,area-52,192,warrior,fury,4,3,1
Datneck,tichondrius,192,warrior,fury,4,3,1
Gavtini,drakthul,192,warrior,fury,4,3,1
Naekochee,moon-guard,192,warrior,fury,4,3,1
Amaragos,tichondrius,192,warrior,fury,6,4,2
Kushal,sargeras,192,warrior,fury,8,3,5
Drefnor,thunderhorn,192,warrior,fury,9,3,6
Mimiu,ragnaros,192,warrior,fury,6,2,4
Matahorda,darkspear,192,warrior,fury,6,2,4
Aqee,illidan,192,warrior,fury,6,2,4
Andrexion,moon-guard,192,warrior,fury,6,2,4
Iïl,area-52,192,warrior,fury,6,2,4
Melithiae,barthilas,192,warrior,fury,6,2,4
Kachigas,sargeras,192,warrior,fury,6,2,4
Ghostkin,ragnaros,192,warrior,fury,6,2,4
Bachyr,stormrage,192,warrior,fury,6,2,4
Horahloux,ragnaros,192,warrior,fury,6,2,4
Fofefa,ragnaros,192,warrior,fury,6,2,4
Weewarrior,wyrmrest-accord,192,warrior,fury,6,2,4
Ðöminátè,kiljaeden,192,warrior,fury,6,2,4
Erikx,ragnaros,192,warrior,fury,6,2,4
Yeèzy,stormrage,192,warrior,fury,6,2,4
Redrunebar,illidan,192,warrior,fury,6,2,4
Arakod,moon-guard,192,warrior,fury,6,2,4
Hatedßyßlízz,area-52,192,warrior,fury,6,2,4
Franc,kiljaeden,192,warrior,fury,6,2,4
Mussashí,stormrage,192,warrior,fury,6,2,4
Reishera,stormrage,192,warrior,fury,6,2,4
Elchacál,ragnaros,192,warrior,fury,6,2,4
Tepaste,ragnaros,192,warrior,fury,6,2,4
Záshá,ragnaros,192,warrior,fury,6,2,4
Saltyareolas,destromath,192,warrior,fury,6,2,4
Youdiankua,illidan,192,warrior,fury,6,2,4
Rexxunos,ragnaros,192,warrior,fury,6,2,4
Jeyvil,stormrage,192,warrior,fury,6,2,4
Borealiss,ragnaros,192,warrior,fury,6,2,4
Gistid,frostmourne,192,warrior,fury,6,2,4
Beatmeat,frostmourne,192,warrior,fury,6,2,4
Bernardes,stormrage,192,warrior,fury,6,2,4
Koast,aerie-peak,192,warrior,fury,6,2,4
Jäëgër,moon-guard,192,warrior,fury,6,2,4
Azrailz,stormrage,192,warrior,fury,6,2,4
Arx,frostwolf,192,warrior,fury,6,2,4
Elyoy,aerie-peak,192,warrior,fury,6,2,4
Jägernaught,stormrage,192,warrior,fury,6,2,4
Disheartened,wyrmrest-accord,192,warrior,fury,6,2,4
Bobbylee,ravencrest,192,warrior,fury,6,2,4
Ëxecute,darkspear,192,warrior,fury,6,2,4
Blademaw,stormreaver,192,warrior,fury,6,2,4
Shablamm,korgath,192,warrior,fury,6,2,4
Itzyourmom,nazjatar,192,warrior,fury,6,2,4
Kalabawph,area-52,192,warrior,fury,6,2,4
Fetalalcohol,illidan,192,warrior,fury,6,2,4
Uju,lothar,192,warrior,fury,6,2,4
Backtrack,whisperwind,192,warrior,fury,6,2,4
Unterg,ragnaros,192,warrior,fury,6,2,4
Verigislena,moon-guard,192,warrior,fury,6,2,4
Ultraa,lightbringer,192,warrior,fury,6,2,4
ßoris,grizzly-hills,192,warrior,fury,6,2,4
Garagedays,area-52,192,warrior,fury,6,2,4
Tarkvs,ragnaros,192,warrior,fury,6,2,4
Containerbox,korgath,192,warrior,fury,6,2,4
Iapologiz,illidan,192,warrior,fury,6,2,4
Kaniks,dalaran,192,warrior,fury,6,2,4
Wendër,area-52,192,warrior,fury,6,2,4
Cartmain,illidan,192,warrior,fury,6,2,4
Gotcrit,blood-furnace,192,warrior,fury,6,2,4
Jayynorthyy,malganis,192,warrior,fury,6,2,4
Drugdilla,zuljin,192,warrior,fury,6,2,4
Boombop,zuljin,192,warrior,fury,6,2,4
Rundai,zuljin,192,warrior,fury,6,2,4
Prodgio,nemesis,192,warrior,fury,6,2,4
Tappyz,area-52,192,warrior,fury,6,2,4
Kraven,haomarush,192,warrior,fury,6,2,4
Drenzywar,scilla,192,warrior,fury,6,2,4
Torimzor,nemesis,192,warrior,fury,6,2,4
Monstersynde,nemesis,192,warrior,fury,6,2,4
Helder,destromath,192,warrior,fury,6,2,4
Warkahoz,drakkari,192,warrior,fury,6,2,4
Gladicus,zuljin,192,warrior,fury,6,2,4
Tÿ,haomarush,192,warrior,fury,6,2,4
Släughter,zuljin,192,warrior,fury,6,2,4
Sveenn,area-52,192,warrior,fury,6,2,4
Moosoka,malorne,192,warrior,fury,6,2,4
Brewstrike,dalaran,192,warrior,fury,6,2,4
Karukaj,azshara,192,warrior,fury,6,2,4
Threg,malganis,192,warrior,fury,6,2,4
Good,garona,192,warrior,fury,6,2,4
Zarkró,quelthalas,192,warrior,fury,6,2,4
Thrawb,bleeding-hollow,192,warrior,fury,6,2,4
Lôwkeyfix,illidan,192,warrior,fury,6,2,4
Zeroy,bleeding-hollow,192,warrior,fury,6,2,4
Aisinbro,illidan,192,warrior,fury,6,2,4
Warmul,bleeding-hollow,192,warrior,fury,6,2,4
Druckerz,lightnings-blade,192,warrior,fury,6,2,4
Lepzed,area-52,192,warrior,fury,6,2,4
Dragmös,nemesis,192,warrior,fury,6,2,4
Ragetide,illidan,192,warrior,fury,6,2,4
Vaclein,quelthalas,192,warrior,fury,6,2,4
Lubri,azralon,192,warrior,fury,6,2,4
Painstake,illidan,192,warrior,fury,6,2,4
Jéshka,wyrmrest-accord,192,warrior,fury,6,2,4
Zareos,azralon,192,warrior,fury,6,2,4
Peekyblinder,kiljaeden,192,warrior,fury,6,2,4
Twoironfist,azralon,192,warrior,fury,6,2,4
Mekkanic,moon-guard,192,warrior,fury,6,2,4
Valko,ragnaros,192,warrior,fury,6,2,4
Aboveaverage,arthas,192,warrior,fury,6,2,4
Nebraskapete,wyrmrest-accord,192,warrior,fury,6,2,4
Jowesley,azralon,192,warrior,fury,6,2,4
Dagorine,eredar,192,warrior,fury,6,2,4
Ragëqt,windrunner,192,warrior,fury,6,2,4
Gangelx,illidan,192,warrior,fury,6,2,4
Veyronn,stormrage,192,warrior,fury,6,2,4
Halò,thrall,192,warrior,fury,6,2,4
Lokgur,gallywix,192,warrior,fury,6,2,4
Taurwaz,draka,192,warrior,fury,6,2,4
Rahu,thrall,192,warrior,fury,6,2,4
Gakatarc,thrall,192,warrior,fury,6,2,4
Killaen,thrall,192,warrior,fury,6,2,4
Catdestroyer,kelthuzad,192,warrior,fury,6,2,4
Tickletickle,illidan,192,warrior,fury,6,2,4
Deizhul,stormscale,192,warrior,fury,6,2,4
Nsanesavage,kelthuzad,192,warrior,fury,6,2,4
Risingson,argent-dawn,192,warrior,fury,6,2,4
Agram,alleria,192,warrior,fury,6,2,4
Youdeadx,aegwynn,192,warrior,fury,6,2,4
Birddogs,scarlet-crusade,192,warrior,fury,6,2,4
Amberlym,ragnaros,192,warrior,fury,6,2,4
Telynne,frostmourne,192,warrior,fury,6,2,4
Casteleiro,azralon,192,warrior,fury,6,2,4
Oledcktwist,garrosh,192,warrior,fury,6,2,4
Ludøciel,moon-guard,192,warrior,fury,6,2,4
Furyworgen,kiljaeden,192,warrior,fury,6,2,4
Wölf,azralon,192,warrior,fury,6,2,4
Kforti,kiljaeden,192,warrior,fury,6,2,4
Eîghtysîx,sargeras,192,warrior,fury,6,2,4
Hackbbadda,tichondrius,192,warrior,fury,6,2,4
Tigershárk,tichondrius,192,warrior,fury,6,2,4
Mafe,tichondrius,192,warrior,fury,6,2,4
Twilightzza,sargeras,192,warrior,fury,6,2,4
Stugwar,moon-guard,192,warrior,fury,6,2,4
Neifle,tichondrius,192,warrior,fury,6,2,4
Kokixz,tichondrius,192,warrior,fury,6,2,4
Lopotron,sargeras,192,warrior,fury,6,2,4
Clerond,tichondrius,192,warrior,fury,6,2,4
Estrasystole,sargeras,192,warrior,fury,6,2,4
Browngusher,sargeras,192,warrior,fury,6,2,4
Mortaldznuts,tichondrius,192,warrior,fury,6,2,4
Yermalt,tichondrius,192,warrior,fury,6,2,4
Persiancoco,tichondrius,192,warrior,fury,6,2,4
Linios,tichondrius,192,warrior,fury,6,2,4
Sickwar,emerald-dream,192,warrior,fury,6,2,4
Bobisyourmom,tichondrius,192,warrior,fury,6,2,4
Deafwarrior,sargeras,192,warrior,fury,6,2,4
Creepedz,tichondrius,192,warrior,fury,6,2,4
Wqnmlgbd,tichondrius,192,warrior,fury,6,2,4
Warney,tichondrius,192,warrior,fury,6,2,4
Wooters,tichondrius,192,warrior,fury,6,2,4
Bariotyr,the-underbog,192,warrior,fury,6,2,4
Supersteak,tichondrius,192,warrior,fury,6,2,4
Slamspam,the-underbog,192,warrior,fury,6,2,4
Ballbusting,moon-guard,192,warrior,fury,6,2,4
Oohdang,tichondrius,192,warrior,fury,6,2,4
Wariorwang,tichondrius,192,warrior,fury,6,2,4
Onlyslams,sargeras,192,warrior,fury,6,2,4
Jkasdfglkg,tichondrius,192,warrior,fury,6,2,4
Irongiant,blades-edge,192,warrior,fury,6,2,4
Noor,tichondrius,192,warrior,fury,6,2,4
Thevan,dunemaul,192,warrior,fury,6,2,4
Sustantus,emerald-dream,192,warrior,fury,6,2,4
Xorjak,tichondrius,192,warrior,fury,6,2,4
Estrozo,sargeras,192,warrior,fury,6,2,4
Zdokk,sargeras,192,warrior,fury,6,2,4
Shrexecute,tichondrius,192,warrior,fury,6,2,4
Brosèph,sargeras,192,warrior,fury,6,2,4
Illicitiri,sargeras,192,warrior,fury,6,2,4
Swinkyzug,tichondrius,192,warrior,fury,6,2,4
Bigbadaxe,sargeras,192,warrior,fury,6,2,4
Mahievs,area-52,192,warrior,fury,10,3,7
Rayson,saurfang,192,warrior,fury,10,2,8
Bonesheild,ursin,192,warrior,fury,11,2,9
Typenine,proudmoore,192,warrior,fury,12,2,10
Pressd,frostmourne,192,warrior,fury,12,2,10
Shandrar,frostmourne,192,warrior,fury,12,2,10
Osselan,moon-guard,192,warrior,fury,12,2,10
Queterompo,ragnaros,192,warrior,fury,12,2,10
Destrogore,darkspear,192,warrior,fury,12,2,10
Doappy,darkspear,192,warrior,fury,12,2,10
Brummbär,thrall,192,warrior,fury,12,2,10
Thecolor,tichondrius,192,warrior,fury,12,2,10
Alchremo,dalaran,192,warrior,fury,12,2,10
Gymnopolar,barthilas,192,warrior,fury,12,2,10
Mickyplate,tichondrius,192,warrior,fury,12,2,10
Nirvyn,quelthalas,191,warrior,fury,6,2,4
Werrewolf,kul-tiras,191,warrior,fury,6,2,4
Naabii,moon-guard,191,warrior,fury,6,2,4
Wayne,kargath,160,warrior,fury,16,2,14
Mariò,area-52,159,warrior,fury,5,2,3
Orangerzze,hyjal,145,warrior,fury,32,9,23
Finana,illidan,138,warrior,fury,10,4,6
Dräxxär,sargeras,138,warrior,fury,10,3,7
Eldarad,stormrage,128,warrior,fury,4,2,2
Swifty,tichondrius,128,warrior,fury,4,2,2
Fatbarstard,jubeithos,128,warrior,fury,4,2,2
Chadrich,kilrogg,128,warrior,fury,4,2,2
Cowmilk,llane,127,warrior,fury,8,2,6
Bootskrapp,azgalor,112,warrior,fury,7,2,5
Bradockqt,azralon,96,warrior,fury,3,2,1
Nëcrophagist,wyrmrest-accord,96,warrior,fury,3,2,1
Zuzi,korgath,96,warrior,fury,3,2,1
Srze,azralon,96,warrior,fury,6,1,5
Vvengencezz,the-underbog,96,warrior,fury,6,1,5
Mafia,dalaran,96,warrior,fury,6,1,5
Loveføx,stormrage,96,warrior,fury,6,1,5
Arkayla,moon-guard,96,warrior,fury,6,1,5
Chóps,quelthalas,96,warrior,fury,6,1,5
Nerdturd,mannoroth,96,warrior,fury,6,1,5
Radianteyes,quelthalas,96,warrior,fury,6,1,5
Murrdock,nesingwary,96,warrior,fury,6,1,5
Polox,ragnaros,96,warrior,fury,6,1,5
Warritha,ragnaros,96,warrior,fury,6,1,5
Bbyè,tichondrius,96,warrior,fury,6,1,5
Lawlstørm,stormrage,96,warrior,fury,6,1,5
Girthyslaps,frostmourne,96,warrior,fury,6,1,5
Neotico,quelthalas,96,warrior,fury,6,1,5
Schwicker,stormrage,96,warrior,fury,6,1,5
Tamagoshi,kiljaeden,96,warrior,fury,6,1,5
Magarrior,shadowsong,96,warrior,fury,6,1,5
Woponese,veknilash,96,warrior,fury,6,1,5
Bigk,korgath,96,warrior,fury,6,1,5
Fatdiabetic,tichondrius,96,warrior,fury,6,1,5
Ravenxdawnx,tichondrius,96,warrior,fury,6,1,5
Alitalia,thunderlord,96,warrior,fury,6,1,5
Warrbull,spirestone,96,warrior,fury,6,1,5
Lanlorash,barthilas,96,warrior,fury,6,1,5
Quasi,tichondrius,96,warrior,fury,6,1,5
Spartacam,frostmourne,96,warrior,fury,6,1,5
Dabdaddyy,dawnbringer,96,warrior,fury,6,1,5
Xiaohuzi,tichondrius,96,warrior,fury,6,1,5
Igmif,stormrage,96,warrior,fury,6,1,5
Slayabunny,icecrown,96,warrior,fury,6,1,5
Xut,moon-guard,96,warrior,fury,6,1,5
Xehm,tichondrius,96,warrior,fury,6,1,5
Smashkuntz,lightnings-blade,96,warrior,fury,6,1,5
Beray,skullcrusher,96,warrior,fury,6,1,5
Flabergaster,skullcrusher,96,warrior,fury,6,1,5
Lambsy,zuljin,96,warrior,fury,6,1,5
Play,dark-iron,96,warrior,fury,6,1,5
Trollchopo,kiljaeden,96,warrior,fury,6,1,5
Freesubs,sargeras,96,warrior,fury,6,1,5
Kraevok,feathermoon,96,warrior,fury,6,1,5
Augutra,moon-guard,96,warrior,fury,6,1,5
Warrdawg,tichondrius,96,warrior,fury,6,1,5
Pornawar,area-52,96,warrior,fury,6,1,5
Carnagè,area-52,96,warrior,fury,6,1,5
ßlåde,lethon,96,warrior,fury,6,1,5
Grândmâ,zuljin,96,warrior,fury,6,1,5
Rades,sargeras,96,warrior,fury,6,1,5
Nillor,emerald-dream,96,warrior,fury,6,1,5
Dokoba,bleeding-hollow,96,warrior,fury,6,1,5
ßallinjr,illidan,96,warrior,fury,6,1,5
Powerhard,area-52,96,warrior,fury,6,1,5
Ridemepapi,tichondrius,96,warrior,fury,6,1,5
Rexxous,hyjal,96,warrior,fury,6,1,5
Slimeto,area-52,96,warrior,fury,6,1,5
Jazzkiler,azralon,96,warrior,fury,6,1,5
Katsarola,cenarion-circle,96,warrior,fury,6,1,5
Omnislash,proudmoore,96,warrior,fury,6,1,5
Hypëriøn,bleeding-hollow,96,warrior,fury,6,1,5
Freanor,azralon,96,warrior,fury,6,1,5
Soulmerc,turalyon,96,warrior,fury,6,1,5
Fûry,barthilas,96,warrior,fury,6,1,5
Bumrushed,tichondrius,96,warrior,fury,6,1,5
Ezsmash,firetree,96,warrior,fury,6,1,5
Awex,kelthuzad,96,warrior,fury,6,1,5
Ustadbaba,area-52,96,warrior,fury,6,1,5
Broxar,area-52,96,warrior,fury,6,1,5
Keirina,bonechewer,96,warrior,fury,6,1,5
Kaikah,aegwynn,96,warrior,fury,6,1,5
Borahgis,area-52,96,warrior,fury,6,1,5
Handain,malganis,96,warrior,fury,6,1,5
Jotar,goldrinn,96,warrior,fury,6,1,5
Bigwarrior,stonemaul,96,warrior,fury,6,1,5
Cuttin,sargeras,96,warrior,fury,6,1,5
Trén,hydraxis,96,warrior,fury,6,1,5
Draann,kirin-tor,96,warrior,fury,6,1,5
Wapistun,thrall,96,warrior,fury,6,1,5
Aiforix,gorefiend,96,warrior,fury,6,1,5
Lifaen,zangarmarsh,96,warrior,fury,6,1,5
Pcprincipal,khadgar,96,warrior,fury,6,1,5
Aftershóck,daggerspine,96,warrior,fury,6,1,5
Tarviss,exodar,96,warrior,fury,6,1,5
Harattawi,thrall,96,warrior,fury,6,1,5
Horabad,terenas,96,warrior,fury,6,1,5
Warriortimes,ragnaros,96,warrior,fury,6,1,5
Figork,tichondrius,96,warrior,fury,6,1,5
Largegayman,sargeras,96,warrior,fury,6,1,5
Fletçhér,sargeras,96,warrior,fury,7,1,6
Dragvovar,thrall,96,warrior,fury,7,1,6
Nabangle,barthilas,96,warrior,fury,10,1,9
Mawdryn,destromath,96,warrior,fury,12,1,11
Philbert,alexstrasza,96,warrior,fury,12,1,11
Furyofbeans,area-52,96,warrior,fury,12,1,11
Maaxdry,area-52,96,warrior,fury,12,1,11
Zaxari,gurubashi,96,warrior,fury,12,1,11
Mamalonic,ragnaros,96,warrior,fury,12,1,11
Facerollyou,blackrock,96,warrior,fury,12,1,11
Gigglamesh,muradin,64,warrior,fury,4,1,3
Cremosö,azralon,64,warrior,fury,4,1,3
Adonis,burning-blade,64,warrior,fury,10,1,9
Sarmat,undermine,63,warrior,fury,2,2,0
Coverage,frostmourne,63,warrior,fury,2,2,0
Xidaego,tichondrius,63,warrior,fury,2,2,0
Kirikash,illidan,42,warrior,fury,6,2,4
Husurnanny,dalaran,42,warrior,fury,7,2,5
Ztg,tichondrius,42,warrior,fury,11,2,9
Edrelang,bronzebeard,31,warrior,fury,2,1,1
Khàzix,kelthuzad,31,warrior,fury,2,1,1
Spartaacus,windrunner,31,warrior,fury,2,1,1
Vioar,hyjal,31,warrior,fury,2,1,1
Freakdps,stormrage,16,warrior,fury,1,1,0
Sanduin,drakkari,16,warrior,fury,1,1,0
Hapigirl,tichondrius,2283,warrior,arms,66,48,18
Exzistance,area-52,2242,warrior,arms,127,70,57
Río,area-52,2216,warrior,arms,136,72,64
Récksus,tichondrius,2182,warrior,arms,98,58,40
Thiccbiscuit,area-52,2168,warrior,arms,133,67,66
Zhanwudix,tichondrius,2162,warrior,arms,111,62,49
Killbørn,azralon,2156,warrior,arms,90,47,43
Marsshine,tichondrius,2142,warrior,arms,119,63,56
Turtleboy,feathermoon,2141,warrior,arms,79,45,34
Todory,moon-guard,2137,warrior,arms,155,78,77
Ikkyuo,proudmoore,2136,warrior,arms,174,93,81
Ðêed,area-52,2133,warrior,arms,81,46,35
Dpoy,tichondrius,2128,warrior,arms,108,54,54
Kraftyx,bleeding-hollow,2125,warrior,arms,72,44,28
Ssamök,ragnaros,2125,warrior,arms,329,168,161
Toutie,tichondrius,2122,warrior,arms,120,67,53
Buckwar,zuljin,2121,warrior,arms,78,41,37
Huzha,tichondrius,2114,warrior,arms,117,64,53
Warried,sargeras,2113,warrior,arms,66,37,29
Tyranitar,proudmoore,2113,warrior,arms,90,50,40
Strife,sargeras,2112,warrior,arms,56,32,24
Abswar,tichondrius,2110,warrior,arms,171,100,71
Menethíl,tichondrius,2110,warrior,arms,156,82,74
Warrgodlol,illidan,2109,warrior,arms,81,41,40
Nitron,dawnbringer,2108,warrior,arms,89,45,44
Vituu,sargeras,2104,warrior,arms,104,54,50
Killborn,tichondrius,2104,warrior,arms,145,73,72
Edgarllama,sargeras,2103,warrior,arms,87,48,39
ßallinjr,illidan,2103,warrior,arms,90,46,44
Recksus,tichondrius,2102,warrior,arms,119,74,45
Huuzha,tichondrius,2102,warrior,arms,95,55,40
Nikomasked,kelthuzad,2100,warrior,arms,66,37,29
Schonkopf,moon-guard,2100,warrior,arms,90,46,44
Vø,agamaggan,2098,warrior,arms,153,79,74
Nuqipq,tichondrius,2059,warrior,arms,64,36,28
Kfcvivofifty,tichondrius,2052,warrior,arms,72,46,26
Cloudxxy,kiljaeden,2052,warrior,arms,75,43,32
Leans,sargeras,2048,warrior,arms,143,78,65
Salgadoryan,stormrage,2047,warrior,arms,232,118,114
Exespamtwo,area-52,2045,warrior,arms,206,112,94
Bhaldur,sargeras,2037,warrior,arms,182,102,80
Orclog,illidan,2033,warrior,arms,72,37,35
Islonely,tichondrius,2026,warrior,arms,168,81,87
Leoneceo,azralon,2025,warrior,arms,132,82,50
Kimchikick,tichondrius,2017,warrior,arms,203,107,96
Gyracide,area-52,2016,warrior,arms,101,49,52
Tryhardr,sargeras,2006,warrior,arms,260,140,120
Blackpînk,tichondrius,1992,warrior,arms,78,43,35
Icarryrats,tichondrius,1988,warrior,arms,105,52,53
Wutainx,tichondrius,1984,warrior,arms,60,33,27
Szw,tichondrius,1983,warrior,arms,263,150,113
Arthurjlol,tichondrius,1982,warrior,arms,72,33,39
Zankets,area-52,1981,warrior,arms,144,74,70
Boblennon,tichondrius,1977,warrior,arms,72,33,39
Ironbad,sargeras,1975,warrior,arms,94,50,44
Sick,azralon,1973,warrior,arms,94,46,48
Belàrià,tichondrius,1969,warrior,arms,66,39,27
Lyrics,tichondrius,1969,warrior,arms,62,32,30
Pdbq,tichondrius,1968,warrior,arms,114,59,55
Bighamm,tichondrius,1965,warrior,arms,71,40,31
Azaks,drakkari,1965,warrior,arms,58,32,26
Iløveaysla,azralon,1963,warrior,arms,84,39,45
Massacretko,area-52,1962,warrior,arms,88,50,38
Grantlol,illidan,1961,warrior,arms,102,55,47
Og,shattered-hand,1958,warrior,arms,47,29,18
Ddaÿ,tichondrius,1957,warrior,arms,130,62,68
Xîonorc,ragnaros,1955,warrior,arms,225,117,108
Shadowstingg,tichondrius,1954,warrior,arms,77,38,39
Foxxfighter,thrall,1953,warrior,arms,98,49,49
Foraken,dragonmaw,1948,warrior,arms,59,36,23
Belàriá,tichondrius,1948,warrior,arms,66,36,30
Icanfixher,moon-guard,1946,warrior,arms,739,370,369
Exëqt,nemesis,1945,warrior,arms,144,75,69
Yermalx,tichondrius,1941,warrior,arms,54,30,24
Bacchanal,illidan,1935,warrior,arms,215,107,108
Fanglerondz,area-52,1932,warrior,arms,53,28,25
Perfs,bleeding-hollow,1931,warrior,arms,108,53,55
Bigladmike,sargeras,1931,warrior,arms,78,34,44
Huugg,skullcrusher,1930,warrior,arms,165,87,78
Kalpok,tichondrius,1929,warrior,arms,64,33,31
Yermalt,tichondrius,1928,warrior,arms,92,48,44
Kiggs,tichondrius,1925,warrior,arms,66,34,32
Ricorecklezz,korgath,1925,warrior,arms,66,32,34
Marfas,hyjal,1924,warrior,arms,157,86,71
Ushouldnome,tichondrius,1921,warrior,arms,72,40,32
Bigbait,hyjal,1921,warrior,arms,78,38,40
Gormag,sargeras,1917,warrior,arms,60,35,25
Smorc,stormrage,1917,warrior,arms,60,31,29
Trezturbo,tichondrius,1915,warrior,arms,174,92,82
Tankypandazd,stormrage,1911,warrior,arms,294,145,149
Ælilblessedñ,azralon,1909,warrior,arms,172,88,84
Cosmicsteel,tichondrius,1908,warrior,arms,88,51,37
Jadeemerald,kelthuzad,1906,warrior,arms,72,40,32
Solastro,malganis,1906,warrior,arms,74,35,39
Mítos,quelthalas,1904,warrior,arms,198,101,97
Painqt,area-52,1903,warrior,arms,24,20,4
Cutgirl,quelthalas,1903,warrior,arms,74,38,36
Madblackcat,illidan,1902,warrior,arms,58,34,24
Isnlonely,tichondrius,1901,warrior,arms,42,26,16
Míasma,ragnaros,1900,warrior,arms,96,41,55
Lícketysplít,ysondre,1893,warrior,arms,52,29,23
Kydrav,khadgar,1891,warrior,arms,52,28,24
Jgillz,sargeras,1891,warrior,arms,78,41,37
Ruinenlust,zuljin,1891,warrior,arms,78,36,42
Paoxiaolol,tichondrius,1890,warrior,arms,73,47,26
Jdubz,frostmourne,1889,warrior,arms,66,36,30
Joshiguy,area-52,1889,warrior,arms,78,36,42
Etchiasoko,gurubashi,1888,warrior,arms,48,33,15
Hanzmat,illidan,1885,warrior,arms,66,35,31
Betterthanu,azralon,1885,warrior,arms,174,91,83
Wtssap,ragnaros,1884,warrior,arms,42,27,15
Drdalidou,zuljin,1884,warrior,arms,54,25,29
Ttvdjrio,area-52,1883,warrior,arms,36,22,14
Arivok,hyjal,1883,warrior,arms,161,81,80
Everfury,tichondrius,1883,warrior,arms,162,81,81
Baitson,hyjal,1882,warrior,arms,60,30,30
Ochinching,tichondrius,1880,warrior,arms,84,39,45
Ggtk,tichondrius,1880,warrior,arms,72,33,39
Kigame,tichondrius,1879,warrior,arms,102,57,45
Paoxiaoevs,tichondrius,1879,warrior,arms,53,29,24
Samuluo,tichondrius,1879,warrior,arms,72,34,38
Chakø,tichondrius,1878,warrior,arms,96,54,42
Ignid,tichondrius,1878,warrior,arms,126,58,68
Masumura,kaelthas,1877,warrior,arms,62,31,31
Sziw,tichondrius,1875,warrior,arms,204,105,99
Destrey,emerald-dream,1874,warrior,arms,84,46,38
Bùbbájr,emerald-dream,1874,warrior,arms,66,31,35
Blackpinkx,tichondrius,1873,warrior,arms,48,23,25
Kamoo,bonechewer,1871,warrior,arms,54,30,24
Urdem,moon-guard,1869,warrior,arms,156,87,69
Hookahboss,area-52,1869,warrior,arms,64,33,31
Eqztw,tichondrius,1864,warrior,arms,149,90,59
Tyránny,stormrage,1864,warrior,arms,71,35,36
Hoboedd,area-52,1864,warrior,arms,70,32,38
Chupelo,tichondrius,1863,warrior,arms,54,46,8
Dawx,thrall,1862,warrior,arms,65,32,33
Cammerz,area-52,1861,warrior,arms,168,83,85
Musclehead,moon-guard,1860,warrior,arms,135,81,54
Natating,terenas,1860,warrior,arms,54,32,22
Forakenna,dragonmaw,1860,warrior,arms,53,31,22
Venturexone,azralon,1860,warrior,arms,54,31,23
Barrbarossa,stormrage,1860,warrior,arms,157,80,77
Überwältigen,thrall,1860,warrior,arms,53,26,27
Vascoes,alleria,1859,warrior,arms,180,100,80
Wutains,tichondrius,1858,warrior,arms,71,36,35
Pezy,frostmourne,1858,warrior,arms,120,59,61
Sunamys,illidan,1857,warrior,arms,48,23,25
Evach,kelthuzad,1856,warrior,arms,52,30,22
Spìke,thrall,1856,warrior,arms,149,75,74
Zindawg,frostmourne,1856,warrior,arms,325,161,164
Sponsored,argent-dawn,1856,warrior,arms,71,33,38
Pooshshi,illidan,1855,warrior,arms,60,29,31
Falindrah,moon-guard,1854,warrior,arms,66,32,34
Archosaurs,illidan,1854,warrior,arms,48,23,25
Evnine,illidan,1853,warrior,arms,39,29,10
Bakadoom,illidan,1853,warrior,arms,90,53,37
Rafheeki,tichondrius,1853,warrior,arms,90,49,41
Mynameyaff,tichondrius,1852,warrior,arms,199,115,84
Brahmo,kelthuzad,1852,warrior,arms,66,38,28
Coldlòve,akama,1851,warrior,arms,48,27,21
Lebanesemvp,tichondrius,1851,warrior,arms,109,58,51
Ruzoc,frostmourne,1851,warrior,arms,112,50,62
Demetor,skywall,1850,warrior,arms,53,27,26
Yueren,tichondrius,1850,warrior,arms,78,35,43
Goodlikeplay,ragnaros,1849,warrior,arms,60,34,26
Kames,garrosh,1849,warrior,arms,166,85,81
Magicalol,tichondrius,1848,warrior,arms,54,33,21
Wartruë,tichondrius,1848,warrior,arms,316,170,146
Tigima,tichondrius,1848,warrior,arms,66,31,35
Jikith,proudmoore,1847,warrior,arms,48,23,25
Bigbadbaka,thaurissan,1847,warrior,arms,78,36,42
Icon,tichondrius,1846,warrior,arms,46,35,11
Blozar,illidan,1846,warrior,arms,60,30,30
Randydanger,illidan,1845,warrior,arms,66,32,34
Wheyprotein,illidan,1844,warrior,arms,42,22,20
Battousai,kiljaeden,1844,warrior,arms,54,27,27
ßloodshed,frostmourne,1843,warrior,arms,67,44,23
Bladebuster,stormrage,1843,warrior,arms,66,36,30
Veilsidewar,kelthuzad,1843,warrior,arms,453,235,218
Dabaojiàn,illidan,1843,warrior,arms,45,23,22
Dishonorkill,dentarg,1842,warrior,arms,43,27,16
Støne,draktharon,1842,warrior,arms,98,56,42
Sukonamí,draka,1842,warrior,arms,60,33,27
Executeqt,azralon,1842,warrior,arms,161,87,74
Madwolf,tichondrius,1842,warrior,arms,103,51,52
Rageroidz,area-52,1841,warrior,arms,84,44,40
Goonassassin,tichondrius,1841,warrior,arms,60,31,29
Gryffith,bleeding-hollow,1841,warrior,arms,87,40,47
Krunnknator,azralon,1840,warrior,arms,41,26,15
Mixx,bleeding-hollow,1840,warrior,arms,48,26,22
Narwhål,tichondrius,1840,warrior,arms,90,44,46
Orçaos,ragnaros,1839,warrior,arms,126,73,53
Paddyj,illidan,1838,warrior,arms,116,72,44
Uzza,stormrage,1838,warrior,arms,60,34,26
Draus,nemesis,1838,warrior,arms,119,67,52
Ânticide,darkspear,1838,warrior,arms,84,43,41
Kylewalker,tichondrius,1838,warrior,arms,71,32,39
Nïcowo,ragnaros,1837,warrior,arms,158,81,77
Xiaoyujin,proudmoore,1837,warrior,arms,186,95,91
Adaana,kargath,1836,warrior,arms,119,70,49
Mantrà,skullcrusher,1836,warrior,arms,42,24,18
Vatix,sargeras,1836,warrior,arms,50,28,22
Imuti,illidan,1836,warrior,arms,102,54,48
Croc,frostmourne,1834,warrior,arms,32,21,11
Blakeb,area-52,1834,warrior,arms,54,34,20
Yossarrion,frostwolf,1833,warrior,arms,48,25,23
Brilliance,suramar,1832,warrior,arms,60,30,30
Hildemir,tichondrius,1831,warrior,arms,88,52,36
Darrowshire,moon-guard,1831,warrior,arms,41,23,18
Frëdsmite,kelthuzad,1831,warrior,arms,144,77,67
Zira,thrall,1831,warrior,arms,133,69,64
Ðìbs,moon-guard,1831,warrior,arms,65,32,33
Rólex,tichondrius,1831,warrior,arms,63,30,33
Damage,malganis,1829,warrior,arms,48,23,25
Razw,frostmourne,1828,warrior,arms,48,28,20
Elpappa,tichondrius,1827,warrior,arms,48,42,6
Sanquelme,ragnaros,1827,warrior,arms,63,32,31
Jonathann,suramar,1827,warrior,arms,132,65,67
Blaíze,ragnaros,1826,warrior,arms,44,24,20
Grayview,sargeras,1826,warrior,arms,77,41,36
Seblleddo,drakkari,1826,warrior,arms,66,34,32
Rebied,ragnaros,1826,warrior,arms,96,43,53
Warriorbloo,sargeras,1825,warrior,arms,72,39,33
Sandycrack,blackrock,1825,warrior,arms,60,30,30
Salthouse,sargeras,1824,warrior,arms,42,25,17
Këther,tichondrius,1824,warrior,arms,90,43,47
Calthi,moon-guard,1823,warrior,arms,125,75,50
Coby,wildhammer,1823,warrior,arms,65,36,29
Jokerkxs,tichondrius,1823,warrior,arms,53,29,24
Gbar,azralon,1823,warrior,arms,79,42,37
Bigdaddyxo,whisperwind,1823,warrior,arms,47,24,23
Cyster,proudmoore,1822,warrior,arms,42,24,18
Tùngrâu,frostmourne,1822,warrior,arms,190,100,90
Soultarius,area-52,1822,warrior,arms,69,36,33
Nuccî,azralon,1822,warrior,arms,83,42,41
Kurï,duskwood,1822,warrior,arms,51,24,27
Pkkcrisis,archimonde,1822,warrior,arms,60,28,32
Anautumnday,tichondrius,1820,warrior,arms,48,24,24
Aggnilia,proudmoore,1820,warrior,arms,102,50,52
Honock,ragnaros,1820,warrior,arms,72,34,38
Abbastanza,tichondrius,1820,warrior,arms,89,42,47
Boomergodx,stormrage,1819,warrior,arms,96,56,40
Badboyjan,tichondrius,1818,warrior,arms,30,19,11
Nilah,tichondrius,1818,warrior,arms,46,26,20
Yeawen,tichondrius,1818,warrior,arms,42,23,19
Iwillcrushyo,darkspear,1818,warrior,arms,90,46,44
Nozmok,proudmoore,1818,warrior,arms,65,33,32
Thugdorr,sargeras,1818,warrior,arms,70,33,37
Okita,bleeding-hollow,1817,warrior,arms,124,65,59
Smashxx,area-52,1816,warrior,arms,95,55,40
Deadhate,sargeras,1816,warrior,arms,54,28,26
Missrend,hyjal,1816,warrior,arms,114,57,57
Berzek,area-52,1816,warrior,arms,59,23,36
Picarus,thunderhorn,1815,warrior,arms,72,40,32
Warney,tichondrius,1815,warrior,arms,65,35,30
Destram,kelthuzad,1815,warrior,arms,107,57,50
Skolltonxoxo,tichondrius,1815,warrior,arms,54,28,26
Mezdrì,quelthalas,1814,warrior,arms,72,46,26
Anti,nerzhul,1814,warrior,arms,57,30,27
Dissector,ragnaros,1814,warrior,arms,54,28,26
Strongbaby,tichondrius,1814,warrior,arms,72,36,36
Zapatín,quelthalas,1814,warrior,arms,67,32,35
Mäddôx,tichondrius,1814,warrior,arms,126,60,66
Sezariùs,darkspear,1813,warrior,arms,61,42,19
Elimination,tichondrius,1813,warrior,arms,41,27,14
Bigjbs,tichondrius,1813,warrior,arms,36,22,14
Vicioustalol,proudmoore,1812,warrior,arms,57,34,23
Onebraincell,stormrage,1811,warrior,arms,48,34,14
Gohrgroc,quelthalas,1811,warrior,arms,48,30,18
Glocç,sargeras,1811,warrior,arms,112,59,53
Knuklez,tichondrius,1811,warrior,arms,64,33,31
Indominate,tichondrius,1811,warrior,arms,194,98,96
Mecc,tichondrius,1811,warrior,arms,78,39,39
Dangerousd,kiljaeden,1811,warrior,arms,60,30,30
Vergerak,tichondrius,1811,warrior,arms,58,29,29
Dabdaddyy,dawnbringer,1811,warrior,arms,135,66,69
Kaimedran,moon-guard,1810,warrior,arms,48,30,18
Kriloth,frostmourne,1810,warrior,arms,50,30,20
Ppdub,zuljin,1810,warrior,arms,44,26,18
Bussupshut,kelthuzad,1810,warrior,arms,64,32,32
Ürürææae,sargeras,1810,warrior,arms,189,94,95
Darkduet,tichondrius,1810,warrior,arms,70,33,37
Møcat,illidan,1809,warrior,arms,90,52,38
Wulouzhan,tichondrius,1809,warrior,arms,137,77,60
Kazynn,tichondrius,1808,warrior,arms,45,30,15
Aavyrre,moon-guard,1808,warrior,arms,60,34,26
Ciz,emerald-dream,1808,warrior,arms,64,34,30
Smokes,sargeras,1808,warrior,arms,144,73,71
Spartus,kelthuzad,1808,warrior,arms,78,32,46
Crøm,tichondrius,1807,warrior,arms,48,29,19
Crowsfall,aggramar,1807,warrior,arms,268,141,127
Yamadaflash,tichondrius,1806,warrior,arms,55,31,24
Bbyè,tichondrius,1806,warrior,arms,318,168,150
Helrise,sargeras,1806,warrior,arms,54,27,27
Bradockqt,azralon,1806,warrior,arms,54,25,29
Kâdé,malganis,1805,warrior,arms,42,26,16
Sickwidit,kiljaeden,1805,warrior,arms,49,28,21
Rookìe,illidan,1805,warrior,arms,131,73,58
Chaytin,bleeding-hollow,1805,warrior,arms,74,41,33
Noblewinter,sargeras,1805,warrior,arms,36,19,17
Tenskj,proudmoore,1805,warrior,arms,57,30,27
Wootzu,zuljin,1805,warrior,arms,54,27,27
Mildlol,tichondrius,1804,warrior,arms,42,25,17
Peinx,ragnaros,1804,warrior,arms,59,31,28
Bahlahkay,proudmoore,1804,warrior,arms,60,28,32
Ollena,wyrmrest-accord,1803,warrior,arms,78,40,38
Fleegugeegu,malganis,1803,warrior,arms,96,47,49
Ramzeé,kelthuzad,1802,warrior,arms,124,77,47
Storminshock,malganis,1802,warrior,arms,81,46,35
Cgelangdula,tichondrius,1802,warrior,arms,54,28,26
Asstastic,bonechewer,1802,warrior,arms,148,71,77
Matesan,jubeithos,1801,warrior,arms,48,28,20
Illing,tichondrius,1801,warrior,arms,336,178,158
Hìm,tichondrius,1801,warrior,arms,54,28,26
Franticlol,tichondrius,1801,warrior,arms,67,31,36
Yagura,emerald-dream,1800,warrior,arms,70,34,36
Longzhan,tichondrius,1800,warrior,arms,138,65,73
Kustybuckets,korgath,1798,warrior,arms,46,27,19
Comehnrfce,illidan,1798,warrior,arms,122,55,67
Laddèrx,area-52,1796,warrior,arms,47,25,22
Invalidoath,tichondrius,1794,warrior,arms,60,29,31
Ksharer,tichondrius,1794,warrior,arms,89,41,48
Montibello,moon-guard,1793,warrior,arms,186,99,87
Garrmash,hyjal,1793,warrior,arms,259,137,122
Meccsecute,tichondrius,1792,warrior,arms,114,59,55
Kruma,stormscale,1791,warrior,arms,37,22,15
Gorek,illidan,1791,warrior,arms,36,19,17
Facefïster,malganis,1790,warrior,arms,72,37,35
Beanbags,zangarmarsh,1790,warrior,arms,72,36,36
Debbie,bleeding-hollow,1789,warrior,arms,90,44,46
Melifehorde,tichondrius,1787,warrior,arms,48,25,23
Bigglyjoobs,tichondrius,1787,warrior,arms,78,38,40
Ígnatius,malganis,1781,warrior,arms,48,31,17
Samwolok,tichondrius,1780,warrior,arms,36,19,17
Slaten,barthilas,1780,warrior,arms,149,77,72
Arx,frostwolf,1779,warrior,arms,207,112,95
Nanchobo,tichondrius,1778,warrior,arms,66,28,38
Lvlthreemage,fizzcrank,1775,warrior,arms,150,74,76
Hbrandy,tichondrius,1773,warrior,arms,83,42,41
Undefied,moon-guard,1772,warrior,arms,51,29,22
Cushman,tichondrius,1772,warrior,arms,132,73,59
Sharer,tichondrius,1772,warrior,arms,36,19,17
Stáclin,ragnaros,1770,warrior,arms,492,265,227
Krbigcow,tichondrius,1768,warrior,arms,120,62,58
Danceylol,barthilas,1768,warrior,arms,96,47,49
Warginger,malygos,1767,warrior,arms,65,36,29
Dalan,korgath,1766,warrior,arms,48,30,18
Chimbrila,azralon,1765,warrior,arms,126,59,67
Nyloras,illidan,1765,warrior,arms,63,28,35
Tokugawaieya,nemesis,1764,warrior,arms,95,43,52
Tehfury,area-52,1763,warrior,arms,57,26,31
Pipedoctor,kelthuzad,1762,warrior,arms,48,27,21
Sherrywalken,azralon,1762,warrior,arms,133,72,61
Nuvola,tichondrius,1761,warrior,arms,72,38,34
Endstorm,proudmoore,1761,warrior,arms,68,34,34
Dawxw,thrall,1759,warrior,arms,41,24,17
Zenrrei,ragnaros,1759,warrior,arms,175,97,78
Gomachi,moon-guard,1757,warrior,arms,58,26,32
Yonkerss,garrosh,1756,warrior,arms,95,51,44
Marchdream,tichondrius,1756,warrior,arms,60,32,28
Vadio,area-52,1751,warrior,arms,58,28,30
Tutifrutiø,azralon,1750,warrior,arms,108,49,59
Warfuse,illidan,1749,warrior,arms,126,63,63
Nànchobo,tichondrius,1749,warrior,arms,72,31,41
Bigdude,frostwolf,1748,warrior,arms,66,38,28
Partyx,tichondrius,1747,warrior,arms,288,148,140
Polydopam,tichondrius,1747,warrior,arms,130,66,64
Wartrué,tichondrius,1747,warrior,arms,77,27,50
Línfert,stormrage,1746,warrior,arms,196,107,89
Kurodia,quelthalas,1744,warrior,arms,84,35,49
Ogrelurd,malygos,1743,warrior,arms,42,22,20
Brendanshwab,bleeding-hollow,1743,warrior,arms,89,44,45
Utxpia,azralon,1743,warrior,arms,59,26,33
Bûm,sargeras,1742,warrior,arms,123,65,58
Rynrak,tichondrius,1742,warrior,arms,102,52,50
Rflexxo,tichondrius,1742,warrior,arms,54,27,27
Bajheera,sargeras,1741,warrior,arms,41,21,20
Franziskaner,frostmourne,1741,warrior,arms,144,71,73
Purplepiper,ragnaros,1740,warrior,arms,55,30,25
Dogmar,staghelm,1739,warrior,arms,110,54,56
Bigdad,whisperwind,1737,warrior,arms,48,27,21
Ciskokido,illidan,1737,warrior,arms,107,58,49
Oxia,quelthalas,1737,warrior,arms,60,30,30
Unhòólyshy,ragnaros,1733,warrior,arms,48,29,19
Alëwar,quelthalas,1733,warrior,arms,77,37,40
Nightheller,stormrage,1733,warrior,arms,78,33,45
Cokeroom,tichondrius,1732,warrior,arms,97,56,41
Hoobaz,area-52,1732,warrior,arms,34,19,15
Odiseo,ragnaros,1732,warrior,arms,61,34,27
Jdubzr,frostmourne,1732,warrior,arms,60,31,29
Nänchobo,tichondrius,1730,warrior,arms,50,23,27
Elsamok,ragnaros,1729,warrior,arms,34,19,15
Mantistabogn,zuluhed,1726,warrior,arms,82,43,39
Mirado,tichondrius,1726,warrior,arms,78,40,38
Roughknuckle,kelthuzad,1726,warrior,arms,41,19,22
Swifty,anvilmar,1725,warrior,arms,30,18,12
Crushedlol,bleeding-hollow,1725,warrior,arms,42,22,20
Bloodbath,kiljaeden,1725,warrior,arms,47,24,23
Malice,frostmourne,1723,warrior,arms,60,25,35
Daddyßigßeef,malganis,1722,warrior,arms,61,35,26
Relerocker,area-52,1722,warrior,arms,101,53,48
Swìll,illidan,1722,warrior,arms,36,18,18
Itsfall,tichondrius,1721,warrior,arms,42,21,21
Crownzz,tichondrius,1721,warrior,arms,36,18,18
Swordborne,moon-guard,1720,warrior,arms,95,43,52
Cåfe,tichondrius,1719,warrior,arms,149,81,68
Zacharyx,tichondrius,1718,warrior,arms,302,144,158
Soloqandy,moon-guard,1718,warrior,arms,78,33,45
Rocta,tichondrius,1717,warrior,arms,98,54,44
Afrikunt,tichondrius,1717,warrior,arms,72,38,34
Doominus,tichondrius,1717,warrior,arms,36,18,18
Heylol,blackhand,1717,warrior,arms,64,28,36
Ariést,bleeding-hollow,1715,warrior,arms,84,37,47
Milough,nesingwary,1714,warrior,arms,124,71,53
Basedaf,frostmourne,1713,warrior,arms,84,45,39
Bainian,tichondrius,1712,warrior,arms,114,65,49
Killimanjaro,aggramar,1712,warrior,arms,77,35,42
Grômm,tichondrius,1712,warrior,arms,53,22,31
Murderbell,tichondrius,1711,warrior,arms,108,54,54
Hateuu,tichondrius,1709,warrior,arms,60,26,34
Anukhar,emerald-dream,1708,warrior,arms,95,55,40
Pachacutecxx,ragnaros,1708,warrior,arms,75,40,35
Smashies,kelthuzad,1708,warrior,arms,53,27,26
Tatërs,zuljin,1708,warrior,arms,72,36,36
Gromkhor,tichondrius,1708,warrior,arms,72,30,42
Robodad,illidan,1707,warrior,arms,48,25,23
Doublezuglol,tichondrius,1707,warrior,arms,282,142,140
Joebo,thrall,1706,warrior,arms,24,20,4
Ðíablø,tichondrius,1705,warrior,arms,146,78,68
Furyslam,tichondrius,1705,warrior,arms,77,30,47
Niubzs,tichondrius,1704,warrior,arms,53,27,26
Zugprime,dragonmaw,1703,warrior,arms,48,26,22
Kaÿip,tichondrius,1703,warrior,arms,157,79,78
Ådderall,thrall,1702,warrior,arms,72,39,33
Impactw,aerie-peak,1701,warrior,arms,64,37,27
Misakizs,illidan,1701,warrior,arms,61,26,35
Zarrdune,darkspear,1700,warrior,arms,30,21,9
Trágus,azralon,1700,warrior,arms,101,60,41
Thrator,wyrmrest-accord,1699,warrior,arms,42,23,19
Golem,frostmourne,1699,warrior,arms,99,51,48
Hariban,sargeras,1699,warrior,arms,95,46,49
Battlestance,shadowsong,1699,warrior,arms,95,42,53
Tepaste,ragnaros,1698,warrior,arms,66,33,33
Slaught,kelthuzad,1698,warrior,arms,151,73,78
Exorbit,sargeras,1697,warrior,arms,69,39,30
Ramparts,moon-guard,1697,warrior,arms,48,23,25
Ammeh,draka,1696,warrior,arms,48,28,20
Thlam,muradin,1696,warrior,arms,162,82,80
Warkingx,tichondrius,1696,warrior,arms,36,18,18
Lanlorash,barthilas,1696,warrior,arms,36,18,18
Akrono,sargeras,1696,warrior,arms,54,19,35
Ashtonx,sargeras,1694,warrior,arms,36,24,12
Genghiz,azralon,1694,warrior,arms,66,36,30
Noodlezz,moon-guard,1694,warrior,arms,107,49,58
Tastý,moon-guard,1694,warrior,arms,54,22,32
Delphont,stormrage,1693,warrior,arms,107,59,48
Jubeithos,draktharon,1693,warrior,arms,65,33,32
Wolfcultist,moon-guard,1693,warrior,arms,78,35,43
Zaÿne,moon-guard,1692,warrior,arms,87,41,46
Infernae,emerald-dream,1691,warrior,arms,66,40,26
Blaiize,ragnaros,1691,warrior,arms,60,25,35
Littlevarian,ragnaros,1690,warrior,arms,54,30,24
Kolosal,tichondrius,1690,warrior,arms,45,22,23
Bozzy,illidan,1690,warrior,arms,77,34,43
Lostsummer,frostmourne,1689,warrior,arms,58,31,27
Marvachi,moon-guard,1689,warrior,arms,248,126,122
Rogôsh,tichondrius,1689,warrior,arms,60,24,36
Kilgorath,area-52,1688,warrior,arms,90,42,48
Raph,barthilas,1686,warrior,arms,42,25,17
Fumzxy,frostmourne,1686,warrior,arms,50,27,23
Zastrow,dalaran,1686,warrior,arms,84,33,51
Meowdaa,proudmoore,1686,warrior,arms,72,24,48
Sindevelor,tichondrius,1684,warrior,arms,89,50,39
Scoopdog,stormrage,1684,warrior,arms,36,20,16
Bmo,chogall,1684,warrior,arms,87,44,43
Sayîon,zuljin,1684,warrior,arms,126,62,64
Nazraill,aggramar,1683,warrior,arms,75,42,33
Tyrannus,chogall,1683,warrior,arms,113,58,55
Tuggernaut,khadgar,1683,warrior,arms,42,20,22
Omnismash,stormrage,1683,warrior,arms,44,20,24
Zalakan,malganis,1682,warrior,arms,54,34,20
Shinigamix,steamwheedle-cartel,1682,warrior,arms,48,29,19
Janjannodie,tichondrius,1682,warrior,arms,41,20,21
Purrava,tichondrius,1680,warrior,arms,50,25,25
Stonesoup,kelthuzad,1680,warrior,arms,83,33,50
Gravewurm,twisting-nether,1679,warrior,arms,42,24,18
Bøek,area-52,1679,warrior,arms,104,49,55
Kroni,ragnaros,1678,warrior,arms,42,21,21
Warsongwolf,tichondrius,1678,warrior,arms,68,29,39
Swagramarr,area-52,1677,warrior,arms,93,51,42
Johnburns,tichondrius,1677,warrior,arms,53,27,26
Huacai,tichondrius,1676,warrior,arms,54,26,28
Coisini,tichondrius,1675,warrior,arms,130,75,55
Ichirisw,tichondrius,1675,warrior,arms,59,32,27
Heater,stormrage,1675,warrior,arms,95,46,49
Automator,proudmoore,1675,warrior,arms,60,27,33
Hofukumizuki,tichondrius,1675,warrior,arms,60,25,35
Shneakywar,frostmourne,1674,warrior,arms,96,54,42
Mitigated,bleeding-hollow,1673,warrior,arms,48,26,22
Maddawgg,mugthol,1672,warrior,arms,64,31,33
Kromgrall,tichondrius,1671,warrior,arms,167,79,88
Pusspeepers,kelthuzad,1671,warrior,arms,39,18,21
Arkkaine,sargeras,1670,warrior,arms,111,57,54
Winota,frostmourne,1669,warrior,arms,30,22,8
Dodgestrikes,khaz-modan,1669,warrior,arms,48,28,20
Zenchi,nerzhul,1669,warrior,arms,76,36,40
Brøly,sargeras,1669,warrior,arms,84,38,46
Amlahj,stormrage,1668,warrior,arms,53,30,23
Twilightrain,tichondrius,1668,warrior,arms,412,216,196
Sparts,area-52,1667,warrior,arms,53,30,23
Timbermack,moon-guard,1667,warrior,arms,120,66,54
Woth,deathwing,1667,warrior,arms,41,21,20
Zhangye,tichondrius,1667,warrior,arms,48,23,25
Kamoo,gurubashi,1665,warrior,arms,60,46,14
Bilboswagins,agamaggan,1665,warrior,arms,47,25,22
Hickorie,sargeras,1665,warrior,arms,117,60,57
Azeryan,azralon,1665,warrior,arms,83,40,43
Marcellùs,proudmoore,1664,warrior,arms,52,29,23
Bigbadaxe,sargeras,1664,warrior,arms,42,21,21
Hoodrch,azralon,1664,warrior,arms,113,55,58
Oxandrolona,ragnaros,1664,warrior,arms,76,30,46
Legoyoda,zuljin,1663,warrior,arms,54,29,25
Edgárllama,sargeras,1663,warrior,arms,38,20,18
Colössal,moon-guard,1663,warrior,arms,94,48,46
Mightyduck,area-52,1663,warrior,arms,64,29,35
Ystkk,tichondrius,1662,warrior,arms,42,25,17
Jimjinjin,tichondrius,1662,warrior,arms,48,25,23
Warbeshar,area-52,1662,warrior,arms,42,21,21
Ironboar,proudmoore,1662,warrior,arms,72,32,40
Khørnë,ragnaros,1661,warrior,arms,54,30,24
Iwillcrushu,tichondrius,1661,warrior,arms,113,59,54
Killbórn,azralon,1660,warrior,arms,30,19,11
Anticiðe,zuljin,1659,warrior,arms,42,22,20
Vvarríør,tichondrius,1658,warrior,arms,48,31,17
Onecho,tichondrius,1658,warrior,arms,48,24,24
Hiness,tichondrius,1658,warrior,arms,48,20,28
Spinspin,borean-tundra,1657,warrior,arms,64,35,29
Babyogre,thunderlord,1657,warrior,arms,77,42,35
Wurua,tichondrius,1657,warrior,arms,58,30,28
Tzumugi,ragnaros,1657,warrior,arms,383,196,187
Irascible,stormrage,1657,warrior,arms,54,22,32
Sheyshey,quelthalas,1656,warrior,arms,42,25,17
Møønnlight,quelthalas,1655,warrior,arms,111,53,58
Sineatér,frostmourne,1654,warrior,arms,61,30,31
Flexìn,tichondrius,1654,warrior,arms,48,23,25
Maktarax,zuljin,1654,warrior,arms,40,18,22
Thuykieu,barthilas,1653,warrior,arms,36,18,18
Jehocc,tichondrius,1653,warrior,arms,44,21,23
Shrikewing,moon-guard,1652,warrior,arms,100,62,38
Bddg,tichondrius,1652,warrior,arms,36,20,16
Potero,ragnaros,1652,warrior,arms,59,29,30
Athalen,nemesis,1652,warrior,arms,73,33,40
Spartiguss,emerald-dream,1650,warrior,arms,59,32,27
Creøn,silvermoon,1650,warrior,arms,68,35,33
Tiredkev,tichondrius,1649,warrior,arms,107,53,54
Raahjz,sargeras,1649,warrior,arms,102,48,54
Executing,emerald-dream,1649,warrior,arms,54,25,29
Chillimus,tichondrius,1648,warrior,arms,75,41,34
Phabian,frostmourne,1648,warrior,arms,41,22,19
Tatsuujin,sargeras,1648,warrior,arms,110,56,54
Amberlym,ragnaros,1648,warrior,arms,52,26,26
Omnïslash,tichondrius,1647,warrior,arms,54,25,29
Droguernaut,tichondrius,1646,warrior,arms,59,30,29
Kralo,moon-guard,1646,warrior,arms,69,34,35
Coltronitis,kelthuzad,1646,warrior,arms,42,20,22
Xwarz,drakkari,1645,warrior,arms,42,19,23
Fidel,blackrock,1645,warrior,arms,59,19,40
Lokityr,tichondrius,1644,warrior,arms,132,84,48
Rainingblooð,blackrock,1644,warrior,arms,103,53,50
Kekbyemmr,illidan,1644,warrior,arms,48,22,26
Príde,kiljaeden,1643,warrior,arms,66,34,32
Xwoyer,malganis,1642,warrior,arms,82,42,40
Karín,tichondrius,1641,warrior,arms,42,27,15
Alator,gorgonnash,1641,warrior,arms,66,38,28
Stattic,illidan,1641,warrior,arms,54,25,29
Arixos,frostmourne,1640,warrior,arms,36,20,16
Sinsinatra,azralon,1640,warrior,arms,263,136,127
Dramalas,lightbringer,1640,warrior,arms,311,156,155
Wqnmlgbd,tichondrius,1640,warrior,arms,54,27,27
Tatsuu,tichondrius,1640,warrior,arms,270,134,136
Sonjeba,malganis,1640,warrior,arms,70,32,38
Rarefxck,tichondrius,1640,warrior,arms,90,39,51
Fulaixiong,illidan,1639,warrior,arms,51,34,17
Austerö,nemesis,1639,warrior,arms,33,20,13
Kàli,kiljaeden,1639,warrior,arms,54,25,29
Unkultom,stormrage,1638,warrior,arms,99,57,42
Thulsan,emerald-dream,1638,warrior,arms,42,23,19
Izugyou,thrall,1637,warrior,arms,87,45,42
Wargasmx,tichondrius,1637,warrior,arms,70,31,39
Wolfsbanne,khadgar,1636,warrior,arms,156,83,73
Painsoul,illidan,1636,warrior,arms,53,27,26
Ngu,eldrethalas,1636,warrior,arms,53,26,27
Donivan,illidan,1636,warrior,arms,60,29,31
Xtrachrome,stormrage,1635,warrior,arms,36,20,16
Mavrus,malganis,1634,warrior,arms,36,19,17
Lunartime,sargeras,1634,warrior,arms,84,43,41
Trapbois,tichondrius,1633,warrior,arms,36,22,14
Grimjouw,sargeras,1633,warrior,arms,42,23,19
Slamedi,frostmourne,1633,warrior,arms,126,61,65
Ragster,kelthuzad,1632,warrior,arms,65,34,31
Iigotu,tichondrius,1632,warrior,arms,256,133,123
Bigbrick,stormrage,1632,warrior,arms,96,45,51
Baciless,illidan,1632,warrior,arms,48,20,28
Lexíbelle,korgath,1631,warrior,arms,36,21,15
Túrin,quelthalas,1631,warrior,arms,132,71,61
Raveve,area-52,1631,warrior,arms,71,36,35
Groundpound,sargeras,1630,warrior,arms,140,71,69
Shazbøt,tichondrius,1630,warrior,arms,45,19,26
Icrìtmypants,dragonmaw,1629,warrior,arms,48,27,21
Furykets,proudmoore,1629,warrior,arms,38,19,19
Aumni,illidan,1629,warrior,arms,98,47,51
Rhynehardt,scilla,1629,warrior,arms,84,38,46
Okanos,tichondrius,1629,warrior,arms,48,21,27
Bigdumborc,tichondrius,1628,warrior,arms,42,22,20
Bromro,tichondrius,1628,warrior,arms,166,80,86
Alteryx,sargeras,1628,warrior,arms,75,36,39
Yarock,malganis,1628,warrior,arms,90,43,47
Mokron,moon-guard,1628,warrior,arms,74,34,40
Hõdõnsin,tichondrius,1628,warrior,arms,57,26,31
Ikaikasan,illidan,1627,warrior,arms,32,22,10
Sosimi,tichondrius,1627,warrior,arms,78,44,34
Wârtorn,darkspear,1627,warrior,arms,42,22,20
Michaelrossx,bloodhoof,1627,warrior,arms,244,125,119
Çrusha,thrall,1627,warrior,arms,48,20,28
Dreadedbeef,area-52,1626,warrior,arms,36,23,13
Coollelex,proudmoore,1626,warrior,arms,56,29,27
Wewladdie,malganis,1626,warrior,arms,36,18,18
Kazecap,proudmoore,1626,warrior,arms,66,29,37
Orgnosh,tichondrius,1625,warrior,arms,96,52,44
Gutting,moon-guard,1625,warrior,arms,36,18,18
Unitsven,barthilas,1625,warrior,arms,54,26,28
Duxor,sargeras,1625,warrior,arms,54,24,30
Elyll,tichondrius,1624,warrior,arms,47,28,19
Patwong,frostmourne,1624,warrior,arms,102,55,47
Soupwar,moon-guard,1624,warrior,arms,177,90,87
Faelash,stormrage,1624,warrior,arms,67,32,35
Testflight,tichondrius,1623,warrior,arms,54,30,24
Ryängosling,azralon,1623,warrior,arms,168,92,76
Downblow,tichondrius,1623,warrior,arms,36,19,17
Flexid,tichondrius,1623,warrior,arms,78,40,38
Dotlom,wyrmrest-accord,1623,warrior,arms,144,73,71
Lindsanv,illidan,1622,warrior,arms,110,59,51
Swólepetrol,tichondrius,1622,warrior,arms,36,19,17
Larrylurker,proudmoore,1622,warrior,arms,119,62,57
Orahard,illidan,1622,warrior,arms,200,100,100
Brainhaze,tichondrius,1622,warrior,arms,64,29,35
Chadwarr,tichondrius,1621,warrior,arms,31,17,14
Kirown,quelthalas,1621,warrior,arms,98,45,53
Stooklol,tichondrius,1621,warrior,arms,54,22,32
Nerdstompêr,illidan,1620,warrior,arms,78,37,41
Thezboy,tichondrius,1619,warrior,arms,100,56,44
Feiler,ragnaros,1619,warrior,arms,48,21,27
Mcluffin,proudmoore,1618,warrior,arms,57,35,22
Lacorte,ragnaros,1618,warrior,arms,51,23,28
Szeo,tichondrius,1617,warrior,arms,24,17,7
Achilex,sargeras,1617,warrior,arms,127,66,61
Andrès,sargeras,1617,warrior,arms,162,80,82
Thebigmala,azralon,1616,warrior,arms,55,32,23
Theokos,dalaran,1616,warrior,arms,112,56,56
Necroticism,bleeding-hollow,1616,warrior,arms,36,17,19
Slamuëladams,bleeding-hollow,1616,warrior,arms,48,20,28
Delakos,frostmourne,1615,warrior,arms,95,51,44
Zekkenx,azjolnerub,1615,warrior,arms,54,23,31
Axellent,gilneas,1614,warrior,arms,70,44,26
Rittylord,frostmourne,1614,warrior,arms,68,37,31
Stormlørd,frostmourne,1614,warrior,arms,82,44,38
Metalchileno,ragnaros,1614,warrior,arms,48,20,28
Willcharge,tichondrius,1614,warrior,arms,49,17,32
Myndon,area-52,1613,warrior,arms,37,27,10
Wingaling,malganis,1613,warrior,arms,66,29,37
Dashballer,sargeras,1612,warrior,arms,50,27,23
Fluffyarm,sargeras,1612,warrior,arms,198,98,100
Brianucky,thrall,1612,warrior,arms,59,26,33
Thètrùth,duskwood,1612,warrior,arms,54,23,31
Ÿüñí,tichondrius,1612,warrior,arms,60,24,36
Shaõkahn,nemesis,1611,warrior,arms,46,23,23
Mindgoblin,smolderthorn,1611,warrior,arms,59,29,30
Sgtquad,illidan,1611,warrior,arms,39,19,20
Hugeflopper,malganis,1610,warrior,arms,32,19,13
Deathsteelw,zuljin,1610,warrior,arms,36,21,15
Matrias,tichondrius,1610,warrior,arms,177,96,81
Gwlade,sargeras,1610,warrior,arms,210,113,97
Malerick,illidan,1610,warrior,arms,69,31,38
Thombelina,malganis,1610,warrior,arms,44,19,25
Enzoh,zuljin,1610,warrior,arms,86,30,56
Nitechaos,thrall,1609,warrior,arms,37,23,14
Thebigsmash,tichondrius,1609,warrior,arms,42,23,19
Aloregorey,malganis,1609,warrior,arms,138,69,69
Morfoggore,ragnaros,1609,warrior,arms,98,49,49
Darkirondork,bleeding-hollow,1609,warrior,arms,38,18,20
Theseuse,tichondrius,1608,warrior,arms,40,24,16
Tommygunns,area-52,1608,warrior,arms,30,17,13
Ohanaglad,illidan,1608,warrior,arms,165,88,77
Rongor,drakkari,1608,warrior,arms,66,33,33
Liltop,moon-guard,1607,warrior,arms,75,41,34
Furydudz,tichondrius,1607,warrior,arms,42,21,21
Wartrue,tichondrius,1607,warrior,arms,162,74,88
Dicedup,stormrage,1607,warrior,arms,48,20,28
Ottø,area-52,1606,warrior,arms,72,40,32
Aventajadu,ragnaros,1606,warrior,arms,42,20,22
Auzery,emerald-dream,1606,warrior,arms,60,28,32
Maraudertko,area-52,1605,warrior,arms,30,17,13
Myxz,barthilas,1605,warrior,arms,120,59,61
Ethuil,azshara,1605,warrior,arms,65,29,36
Boiled,sargeras,1604,warrior,arms,30,21,9
Morboo,illidan,1604,warrior,arms,48,27,21
Kakamallo,black-dragonflight,1604,warrior,arms,201,109,92
Blodreìna,hyjal,1604,warrior,arms,109,53,56
Lôwkeyfix,illidan,1604,warrior,arms,126,58,68
Sayyaf,moon-guard,1604,warrior,arms,57,20,37
Killaen,thrall,1603,warrior,arms,48,29,19
Bleedx,bleeding-hollow,1603,warrior,arms,51,30,21
Parren,bleeding-hollow,1603,warrior,arms,31,18,13
Crusherr,earthen-ring,1603,warrior,arms,90,47,43
Saleem,tichondrius,1603,warrior,arms,273,142,131
Bugsberserk,tichondrius,1603,warrior,arms,119,61,58
Zaràki,area-52,1603,warrior,arms,186,95,91
Powerbucks,tichondrius,1603,warrior,arms,44,22,22
Bebob,tichondrius,1603,warrior,arms,86,42,44
Mahoogler,hakkar,1603,warrior,arms,66,31,35
Xradull,dawnbringer,1602,warrior,arms,146,85,61
Reave,wyrmrest-accord,1601,warrior,arms,78,42,36
Sheriff,eldrethalas,1600,warrior,arms,54,31,23
Dulapamore,tichondrius,1600,warrior,arms,48,22,26
Galehna,ragnaros,1600,warrior,arms,47,21,26
Draenøk,tichondrius,1600,warrior,arms,54,21,33
Draugus,azralon,1599,warrior,arms,58,31,27
Kilgrah,emerald-dream,1599,warrior,arms,40,21,19
Koberos,queldorei,1599,warrior,arms,66,26,40
Shiv,illidan,1598,warrior,arms,116,60,56
Memorylane,proudmoore,1598,warrior,arms,42,20,22
Raahjv,sargeras,1597,warrior,arms,54,34,20
Tríxman,moon-guard,1597,warrior,arms,124,73,51
Tÿ,haomarush,1597,warrior,arms,77,42,35
Benjiprice,sargeras,1597,warrior,arms,35,19,16
Zeroskill,cenarius,1596,warrior,arms,82,38,44
Shain,thrall,1596,warrior,arms,48,22,26
Xunxie,tichondrius,1595,warrior,arms,113,60,53
Gorez,ragnaros,1595,warrior,arms,48,24,24
Yolo,dunemaul,1594,warrior,arms,78,45,33
Vauquelin,tichondrius,1594,warrior,arms,78,41,37
Qingmei,illidan,1594,warrior,arms,110,48,62
Kolossus,korgath,1593,warrior,arms,52,21,31
Hèphæstús,sargeras,1592,warrior,arms,132,65,67
Vanexx,tichondrius,1590,warrior,arms,43,24,19
Warthok,turalyon,1590,warrior,arms,58,29,29
Legnar,malganis,1590,warrior,arms,42,18,24
Mistrpower,bleeding-hollow,1589,warrior,arms,78,44,34
Warrgawd,illidan,1589,warrior,arms,83,43,40
Mimiovo,tichondrius,1588,warrior,arms,42,23,19
Bobu,area-52,1588,warrior,arms,63,33,30
Lootacris,illidan,1588,warrior,arms,67,34,33
Dre,anubarak,1587,warrior,arms,65,32,33
Ghianna,quelthalas,1586,warrior,arms,65,34,31
Homebody,uldaman,1585,warrior,arms,38,25,13
Hyperdevil,ragnaros,1585,warrior,arms,35,19,16
Brokthard,ragnaros,1585,warrior,arms,36,18,18
Sheetss,tichondrius,1585,warrior,arms,48,23,25
Mortawar,tichondrius,1584,warrior,arms,68,42,26
Dukà,hyjal,1584,warrior,arms,54,30,24
Destructör,nagrand,1584,warrior,arms,93,49,44
Zzchocolate,illidan,1584,warrior,arms,102,46,56
Warriorbod,area-52,1583,warrior,arms,53,33,20
Lyliumn,frostmourne,1583,warrior,arms,66,34,32
Sakutarou,lightbringer,1583,warrior,arms,295,143,152
Yueqingshu,tichondrius,1582,warrior,arms,38,24,14
Cathillex,eonar,1582,warrior,arms,42,25,17
Katre,malorne,1582,warrior,arms,67,30,37
Methwitch,moon-guard,1581,warrior,arms,36,19,17
Marsoc,burning-legion,1581,warrior,arms,52,26,26
Wilric,ragnaros,1581,warrior,arms,54,22,32
Wydstepwar,malganis,1580,warrior,arms,60,38,22
Deadlypsycho,moonrunner,1580,warrior,arms,36,19,17
Perrin,burning-blade,1580,warrior,arms,49,25,24
Uneasyw,tichondrius,1580,warrior,arms,47,20,27
Gannïcûs,drakkari,1580,warrior,arms,77,32,45
Tarók,tichondrius,1579,warrior,arms,26,19,7
Allyer,darkspear,1579,warrior,arms,90,45,45
Erradic,sargeras,1579,warrior,arms,54,26,28
Stick,tichondrius,1578,warrior,arms,125,64,61
Zanjaro,thrall,1578,warrior,arms,35,17,18
Kpc,tichondrius,1578,warrior,arms,110,44,66
Evoltoad,illidan,1578,warrior,arms,71,27,44
Drjuicce,tichondrius,1577,warrior,arms,24,17,7
Bestseason,kelthuzad,1577,warrior,arms,87,48,39
Ragetodef,illidan,1577,warrior,arms,91,45,46
Nipnipz,kelthuzad,1577,warrior,arms,94,40,54
Därkzh,stormrage,1576,warrior,arms,30,20,10
Juuz,frostmourne,1575,warrior,arms,114,56,58
Ferozan,azralon,1575,warrior,arms,42,20,22
Durres,tichondrius,1575,warrior,arms,42,19,23
Dokgö,tichondrius,1575,warrior,arms,64,27,37
Darthbleezy,malygos,1573,warrior,arms,42,22,20
Radox,tichondrius,1573,warrior,arms,78,40,38
Hydrolisk,area-52,1573,warrior,arms,144,71,73
Sinbãd,sargeras,1573,warrior,arms,65,29,36
Vodkalol,bleeding-hollow,1572,warrior,arms,30,20,10
Flexo,moon-guard,1572,warrior,arms,42,24,18
Yabahdabah,stormrage,1572,warrior,arms,93,49,44
Grimus,bleeding-hollow,1571,warrior,arms,179,100,79
Husyuzhi,tichondrius,1571,warrior,arms,36,20,16
Ashantia,stormrage,1571,warrior,arms,90,48,42
Nyle,zuljin,1571,warrior,arms,106,56,50
Raves,quelthalas,1571,warrior,arms,114,54,60
Thistleberry,aegwynn,1571,warrior,arms,41,19,22
Onefourfifty,tichondrius,1570,warrior,arms,30,17,13
Underbite,area-52,1569,warrior,arms,60,37,23
Flexeçute,moon-guard,1569,warrior,arms,78,38,40
Juicylumpia,moon-guard,1568,warrior,arms,48,31,17
Chadblade,tichondrius,1568,warrior,arms,66,34,32
Zuzi,korgath,1567,warrior,arms,55,35,20
Jaybers,malganis,1567,warrior,arms,59,31,28
Fartazz,zuljin,1567,warrior,arms,126,58,68
Gulgosh,stormscale,1566,warrior,arms,59,30,29
Báhamut,area-52,1566,warrior,arms,53,25,28
Soez,tichondrius,1565,warrior,arms,33,23,10
Riggragg,tichondrius,1565,warrior,arms,48,28,20
Rapcherawr,illidan,1565,warrior,arms,51,28,23
Armamortal,kelthuzad,1565,warrior,arms,369,189,180
Radagøn,drakkari,1565,warrior,arms,48,24,24
Xkickaxes,tichondrius,1565,warrior,arms,95,46,49
Scrümp,illidan,1564,warrior,arms,85,45,40
Gnizzmo,sargeras,1564,warrior,arms,48,25,23
Pigzig,nagrand,1564,warrior,arms,36,18,18
Ralphy,lightnings-blade,1563,warrior,arms,94,53,41
Naejwar,ragnaros,1563,warrior,arms,186,97,89
Darkmagno,ragnaros,1563,warrior,arms,42,20,22
Tkazo,tichondrius,1563,warrior,arms,91,41,50
Chogar,proudmoore,1562,warrior,arms,64,34,30
Chañ,tichondrius,1562,warrior,arms,36,19,17
Executie,duskwood,1562,warrior,arms,73,36,37
Titanor,illidan,1562,warrior,arms,63,31,32
Yamatoflash,tichondrius,1562,warrior,arms,43,18,25
Hanadaddy,frostmourne,1560,warrior,arms,282,141,141
Jenkin,korgath,1560,warrior,arms,40,19,21
Vargoth,frostmourne,1560,warrior,arms,83,37,46
Staystrong,tichondrius,1559,warrior,arms,36,24,12
Aranacn,tichondrius,1559,warrior,arms,66,36,30
Hônor,ragnaros,1558,warrior,arms,54,24,30
Claymation,tichondrius,1558,warrior,arms,48,18,30
Cronguin,bleeding-hollow,1557,warrior,arms,54,27,27
Ävdol,emerald-dream,1556,warrior,arms,103,49,54
Amputate,akama,1556,warrior,arms,65,27,38
Firesx,tichondrius,1555,warrior,arms,36,20,16
Skronkar,illidan,1555,warrior,arms,162,82,80
Wargasms,alterac-mountains,1555,warrior,arms,48,21,27
Mardrex,korgath,1555,warrior,arms,48,21,27
Azindar,gilneas,1554,warrior,arms,42,21,21
Flavor,aegwynn,1554,warrior,arms,60,27,33
Sulze,tichondrius,1553,warrior,arms,355,173,182
Arctures,stormrage,1552,warrior,arms,84,51,33
Martyferrari,black-dragonflight,1552,warrior,arms,114,63,51
Morioso,boulderfist,1552,warrior,arms,102,45,57
Twoone,illidan,1552,warrior,arms,44,18,26
Banhaezzi,tichondrius,1551,warrior,arms,160,81,79
Blíding,ragnaros,1551,warrior,arms,75,28,47
Ghóstx,alleria,1550,warrior,arms,53,37,16
Aragorn,mannoroth,1550,warrior,arms,36,19,17
Titanzz,quelthalas,1550,warrior,arms,71,35,36
Rèckit,thrall,1550,warrior,arms,48,21,27
Slyith,shadow-council,1549,warrior,arms,115,61,54
Gorgan,ragnaros,1549,warrior,arms,96,48,48
Itskel,stormreaver,1546,warrior,arms,44,23,21
Ðrex,nagrand,1546,warrior,arms,116,60,56
Muskratz,tichondrius,1546,warrior,arms,194,99,95
Orsex,ragnaros,1546,warrior,arms,50,25,25
Wingedknight,malganis,1546,warrior,arms,104,50,54
Johnnysmizle,kelthuzad,1546,warrior,arms,84,38,46
Riled,barthilas,1546,warrior,arms,42,18,24
Kénjar,tichondrius,1545,warrior,arms,54,32,22
Pachacutec,area-52,1545,warrior,arms,92,42,50
Brostormftw,shattered-halls,1544,warrior,arms,72,43,29
Zyppz,sargeras,1543,warrior,arms,38,26,12
Grumtak,azralon,1543,warrior,arms,59,30,29
Boypartz,onyxia,1543,warrior,arms,66,26,40
Lykemore,moon-guard,1542,warrior,arms,74,41,33
Ginormous,rivendare,1542,warrior,arms,69,35,34
Know,anetheron,1542,warrior,arms,98,45,53
Danield,illidan,1542,warrior,arms,60,23,37
Urscrewed,frostmane,1541,warrior,arms,41,18,23
Kenshín,ragnaros,1540,warrior,arms,161,75,86
Millywhopz,thrall,1539,warrior,arms,48,25,23
Uhttercow,tichondrius,1539,warrior,arms,66,33,33
Slitt,azralon,1538,warrior,arms,78,42,36
Märkdî,quelthalas,1538,warrior,arms,132,71,61
Bwandøn,moon-guard,1538,warrior,arms,88,41,47
Cowtipin,illidan,1538,warrior,arms,110,50,60
Endurefen,sargeras,1537,warrior,arms,30,19,11
Tansozzi,tichondrius,1537,warrior,arms,48,27,21
Gtr,illidan,1536,warrior,arms,68,41,27
Mailløche,bleeding-hollow,1535,warrior,arms,72,41,31
Kwelve,proudmoore,1535,warrior,arms,48,22,26
Áres,malganis,1534,warrior,arms,280,150,130
Mortyy,stormrage,1534,warrior,arms,43,23,20
Rokgral,tichondrius,1534,warrior,arms,80,42,38
Themudcrab,frostmourne,1534,warrior,arms,339,166,173
Twshizgd,proudmoore,1534,warrior,arms,193,91,102
Nornogin,tichondrius,1534,warrior,arms,66,31,35
Burstmacro,garrosh,1534,warrior,arms,60,26,34
Ogeezus,crushridge,1533,warrior,arms,72,36,36
Fraccx,area-52,1533,warrior,arms,76,34,42
Hydranoid,ragnaros,1532,warrior,arms,157,73,84
Malathire,illidan,1531,warrior,arms,58,32,26
Tigris,nesingwary,1531,warrior,arms,30,16,14
Raviax,sargeras,1530,warrior,arms,54,29,25
Anukhos,emerald-dream,1530,warrior,arms,30,16,14
Drèádnought,tichondrius,1530,warrior,arms,38,19,19
Axazel,drakkari,1530,warrior,arms,186,88,98
Bonesaaw,caelestrasz,1530,warrior,arms,48,22,26
Maddorlon,thrall,1530,warrior,arms,59,27,32
Rohta,kiljaeden,1529,warrior,arms,113,55,58
Marzse,sargeras,1529,warrior,arms,54,23,31
Ratfang,zuljin,1528,warrior,arms,28,17,11
Stinkyw,tichondrius,1528,warrior,arms,49,27,22
Meatbone,emerald-dream,1528,warrior,arms,113,61,52
Doves,tichondrius,1528,warrior,arms,45,21,24
Noyel,tichondrius,1528,warrior,arms,70,32,38
Termana,azjolnerub,1527,warrior,arms,30,16,14
Volstraya,frostmourne,1527,warrior,arms,43,22,21
Seukkang,tichondrius,1527,warrior,arms,54,24,30
Jwz,tichondrius,1527,warrior,arms,36,16,20
Ryen,malganis,1527,warrior,arms,87,38,49
Yiplaw,stormrage,1526,warrior,arms,30,16,14
Zaddybear,aerie-peak,1526,warrior,arms,45,23,22
Bìgpoppapump,tichondrius,1526,warrior,arms,195,95,100
Malvadin,stormrage,1526,warrior,arms,66,30,36
Yawdamper,illidan,1525,warrior,arms,30,21,9
Ginthril,magtheridon,1525,warrior,arms,143,67,76
Saelaa,azralon,1525,warrior,arms,36,16,20
Flynnstone,tichondrius,1524,warrior,arms,30,19,11
Bowlingball,darkspear,1524,warrior,arms,48,24,24
Chinamonk,tichondrius,1524,warrior,arms,101,49,52
Dtitanzz,quelthalas,1524,warrior,arms,57,27,30
Executty,stormrage,1524,warrior,arms,36,17,19
Hannibalkng,zangarmarsh,1524,warrior,arms,52,20,32
Lionbuster,ragnaros,1523,warrior,arms,36,22,14
Urion,illidan,1523,warrior,arms,30,17,13
Supersquish,moon-guard,1523,warrior,arms,106,57,49
Varenkä,drakkari,1523,warrior,arms,36,16,20
Genøcide,terenas,1522,warrior,arms,54,23,31
Kimed,nordrassil,1520,warrior,arms,30,16,14
Metalwarr,illidan,1520,warrior,arms,59,30,29
Medusaann,proudmoore,1520,warrior,arms,63,32,31
Spartacam,frostmourne,1520,warrior,arms,166,83,83
Dáinsleif,frostmourne,1520,warrior,arms,48,23,25
Renger,garona,1520,warrior,arms,42,20,22
Elchacál,ragnaros,1520,warrior,arms,66,27,39
Randysnapper,zuljin,1519,warrior,arms,24,16,8
Peacemake,tichondrius,1519,warrior,arms,45,24,21
Traumaj,bleeding-hollow,1519,warrior,arms,141,74,67
Ichigö,gundrak,1519,warrior,arms,57,28,29
Rukittenme,area-52,1519,warrior,arms,72,29,43
Ártorius,sargeras,1518,warrior,arms,138,72,66
Dâvo,area-52,1518,warrior,arms,60,29,31
Malakaimapk,korgath,1517,warrior,arms,30,16,14
Ashbringera,proudmoore,1517,warrior,arms,237,120,117
Byung,terenas,1517,warrior,arms,183,92,91
Môrôdin,area-52,1517,warrior,arms,108,49,59
Doubleturbo,illidan,1517,warrior,arms,59,26,33
Ôn,tichondrius,1516,warrior,arms,279,136,143
Damiansuv,moon-guard,1516,warrior,arms,153,73,80
Rathty,shadowsong,1515,warrior,arms,48,26,22
Retrospex,black-dragonflight,1515,warrior,arms,30,16,14
Dajva,ragnaros,1515,warrior,arms,78,36,42
Bryk,korgath,1514,warrior,arms,36,21,15
Rads,stormscale,1514,warrior,arms,69,39,30
Brayitann,illidan,1514,warrior,arms,49,27,22
Tkavalan,proudmoore,1514,warrior,arms,65,29,36
Gruula,frostmourne,1513,warrior,arms,45,27,18
Nyuk,tichondrius,1513,warrior,arms,51,29,22
Bvrst,area-52,1513,warrior,arms,30,16,14
Dtrumpo,moon-guard,1513,warrior,arms,52,27,25
Monstersynde,nemesis,1513,warrior,arms,143,71,72
Elevate,whisperwind,1513,warrior,arms,36,16,20
Cosmosz,illidan,1512,warrior,arms,101,55,46
Bullmastic,deathwing,1512,warrior,arms,52,26,26
Gwàr,kiljaeden,1511,warrior,arms,36,19,17
Tuvia,malganis,1511,warrior,arms,177,89,88
Raala,cenarius,1510,warrior,arms,51,34,17
Draganovich,aerie-peak,1509,warrior,arms,54,30,24
Torzzen,azralon,1509,warrior,arms,117,59,58
Karrosh,agamaggan,1509,warrior,arms,42,18,24
Himer,tichondrius,1509,warrior,arms,48,20,28
Punknicanor,quelthalas,1508,warrior,arms,84,42,42
Kratosxx,quelthalas,1508,warrior,arms,79,38,41
Asäel,ragnaros,1508,warrior,arms,53,25,28
Ryank,bonechewer,1508,warrior,arms,54,25,29
Kissmyaxê,tichondrius,1508,warrior,arms,63,28,35
Machete,nemesis,1507,warrior,arms,76,40,36
Geñeralguap,tichondrius,1506,warrior,arms,208,110,98
Weildboy,undermine,1506,warrior,arms,71,37,34
Zolotrollo,area-52,1505,warrior,arms,24,16,8
Zewl,barthilas,1505,warrior,arms,42,22,20
Moonär,emerald-dream,1505,warrior,arms,113,55,58
Legbreaker,tichondrius,1504,warrior,arms,70,37,33
Pocserwar,drakkari,1504,warrior,arms,36,16,20
Wouili,zuljin,1503,warrior,arms,97,59,38
Atróx,quelthalas,1503,warrior,arms,84,40,44
Bottlecaps,shadowmoon,1502,warrior,arms,51,25,26
Slvrback,stormrage,1501,warrior,arms,30,16,14
Cagrekk,wyrmrest-accord,1501,warrior,arms,71,37,34
Cúdi,darkspear,1501,warrior,arms,48,23,25
Rallyingcry,illidan,1500,warrior,arms,30,18,12
Devildriver,malganis,1499,warrior,arms,102,53,49
Lilmerman,laughing-skull,1499,warrior,arms,77,39,38
Yunnkel,ragnaros,1499,warrior,arms,128,64,64
Dewbae,whisperwind,1498,warrior,arms,84,40,44
Nagaboner,frostmourne,1497,warrior,arms,113,63,50
Akkar,gilneas,1497,warrior,arms,99,53,46
Stickybladez,frostmourne,1497,warrior,arms,160,80,80
Lilreese,tichondrius,1497,warrior,arms,74,36,38
Slashcry,frostmourne,1497,warrior,arms,58,26,32
Tcchmm,akama,1497,warrior,arms,64,28,36
Enilaw,proudmoore,1496,warrior,arms,62,36,26
Habakkos,firetree,1496,warrior,arms,72,39,33
Crustyfella,stormrage,1496,warrior,arms,52,28,24
Naughtytwat,tichondrius,1496,warrior,arms,207,103,104
Volkz,ragnaros,1496,warrior,arms,83,39,44
Tharsìs,emerald-dream,1496,warrior,arms,51,18,33
Wo,alleria,1495,warrior,arms,42,19,23
Dann,ragnaros,1494,warrior,arms,102,49,53
Crowncrumpah,illidan,1494,warrior,arms,60,28,32
Gale,kelthuzad,1493,warrior,arms,42,24,18
Datneck,tichondrius,1493,warrior,arms,30,16,14
Kastenz,frostmourne,1493,warrior,arms,55,25,30
Horsekok,tichondrius,1492,warrior,arms,30,19,11
Aggorak,illidan,1492,warrior,arms,36,16,20
Blowhoof,azralon,1491,warrior,arms,54,29,25
Kiritos,draktharon,1491,warrior,arms,111,58,53
Sáítámá,tichondrius,1491,warrior,arms,58,30,28
Roidraging,thunderlord,1490,warrior,arms,149,66,83
Theisius,tichondrius,1490,warrior,arms,75,33,42
Garadiels,tichondrius,1490,warrior,arms,73,31,42
Rockstedy,area-52,1489,warrior,arms,68,31,37
Reckonting,moon-guard,1488,warrior,arms,24,16,8
Bozwar,tichondrius,1488,warrior,arms,66,34,32
Taywar,sargeras,1488,warrior,arms,60,29,31
Casablancas,azralon,1488,warrior,arms,42,16,26
Dragvovar,thrall,1488,warrior,arms,42,16,26
Mewpaw,azralon,1487,warrior,arms,24,16,8
Zeldawolfpac,moon-guard,1487,warrior,arms,30,19,11
Gahju,area-52,1487,warrior,arms,36,20,16
Zänn,dalaran,1486,warrior,arms,60,38,22
Beefytheorc,tichondrius,1486,warrior,arms,30,17,13
Linga,bleeding-hollow,1486,warrior,arms,36,19,17
Sìkarío,illidan,1486,warrior,arms,60,31,29
Athin,azralon,1486,warrior,arms,90,46,44
Zxlor,tichondrius,1486,warrior,arms,60,26,34
Lehzera,frostmourne,1485,warrior,arms,104,49,55
Warriordanim,tichondrius,1485,warrior,arms,235,108,127
Karnakk,thrall,1485,warrior,arms,41,16,25
Oppressor,darkspear,1484,warrior,arms,112,54,58
Wmf,frostmourne,1484,warrior,arms,96,44,52
Braxin,dalaran,1483,warrior,arms,77,42,35
Dæthtønes,tichondrius,1483,warrior,arms,86,43,43
Hotdadparty,frostmourne,1483,warrior,arms,115,56,59
Earlsiriuz,tichondrius,1483,warrior,arms,51,23,28
Amaragos,tichondrius,1482,warrior,arms,74,44,30
Tamagoshi,kiljaeden,1482,warrior,arms,185,100,85
Islik,stormrage,1482,warrior,arms,73,35,38
Bâlthor,quelthalas,1481,warrior,arms,126,61,65
Visenyä,mannoroth,1481,warrior,arms,52,21,31
Magnis,stormrage,1480,warrior,arms,72,33,39
Leapgodx,drenden,1479,warrior,arms,48,26,22
Brutallicus,kelthuzad,1479,warrior,arms,33,17,16
Tommytimbo,destromath,1479,warrior,arms,37,16,21
Jäÿ,proudmoore,1478,warrior,arms,75,37,38
Aparentlynot,shattered-hand,1478,warrior,arms,36,17,19
Bêelzebub,aerie-peak,1478,warrior,arms,54,20,34
Shortgoofy,sargeras,1477,warrior,arms,129,61,68
Crystaríum,stormrage,1477,warrior,arms,79,37,42
Lsays,tichondrius,1476,warrior,arms,156,78,78
Rainzy,stormrage,1476,warrior,arms,36,16,20
Ewenki,tichondrius,1475,warrior,arms,298,151,147
Weedow,proudmoore,1474,warrior,arms,29,16,13
Rimz,sargeras,1474,warrior,arms,40,21,19
Gerztok,aggramar,1474,warrior,arms,58,28,30
Saîyanroyce,barthilas,1473,warrior,arms,137,69,68
Armsprotfury,tichondrius,1472,warrior,arms,48,30,18
Furyass,bleeding-hollow,1472,warrior,arms,120,65,55
Vecira,moon-guard,1472,warrior,arms,41,20,21
Belldor,barthilas,1472,warrior,arms,108,47,61
Dazfotm,tichondrius,1472,warrior,arms,41,16,25
Holddapoop,area-52,1471,warrior,arms,78,43,35
Eihn,quelthalas,1471,warrior,arms,53,25,28
Beaerboy,darkspear,1471,warrior,arms,136,63,73
Neotico,quelthalas,1471,warrior,arms,62,27,35
Arthwarf,proudmoore,1470,warrior,arms,60,29,31
Achillescool,tichondrius,1470,warrior,arms,145,70,75
Potalot,draenor,1469,warrior,arms,30,16,14
Baul,area-52,1469,warrior,arms,59,31,28
Tapijuju,stormrage,1468,warrior,arms,33,20,13
Smokedaperc,illidan,1468,warrior,arms,84,44,40
Jeffo,amanthul,1468,warrior,arms,38,18,20
Thurman,spirestone,1467,warrior,arms,44,26,18
Klouddraft,tichondrius,1466,warrior,arms,45,26,19
Jurojin,tichondrius,1466,warrior,arms,29,16,13
Sharpen,terokkar,1465,warrior,arms,30,17,13
Bestid,tichondrius,1465,warrior,arms,60,33,27
Warrimon,nemesis,1465,warrior,arms,78,35,43
Thedin,gorefiend,1465,warrior,arms,84,36,48
Barbatenaz,ragnaros,1465,warrior,arms,48,18,30
Eggroll,emerald-dream,1465,warrior,arms,47,17,30
Torimzor,nemesis,1464,warrior,arms,138,74,64
Asc,barthilas,1464,warrior,arms,264,139,125
Ángron,ragnaros,1464,warrior,arms,92,48,44
Zhânshen,tichondrius,1464,warrior,arms,60,31,29
Scrapx,malganis,1464,warrior,arms,161,83,78
Luosifen,tichondrius,1464,warrior,arms,250,126,124
Toughguts,saurfang,1464,warrior,arms,60,29,31
Bricksquad,mannoroth,1464,warrior,arms,57,25,32
Joesbàr,tichondrius,1464,warrior,arms,78,34,44
Frashes,darkspear,1463,warrior,arms,55,26,29
Bigdingus,frostwolf,1463,warrior,arms,60,28,32
Tekaiatsu,tichondrius,1462,warrior,arms,107,61,46
Vyndronor,illidan,1462,warrior,arms,96,52,44
Dou,barthilas,1462,warrior,arms,41,22,19
Duroxzee,area-52,1462,warrior,arms,187,100,87
Carnith,arthas,1462,warrior,arms,60,27,33
Skollyd,tichondrius,1462,warrior,arms,38,17,21
Sertss,proudmoore,1462,warrior,arms,71,30,41
Golkän,goldrinn,1461,warrior,arms,66,34,32
Ihadnochoice,barthilas,1461,warrior,arms,256,126,130
Noitrak,azralon,1461,warrior,arms,45,18,27
Erynus,malganis,1460,warrior,arms,44,25,19
Nabiouscx,malganis,1460,warrior,arms,101,47,54
Asgaurdius,thunderlord,1459,warrior,arms,70,36,34
Konraad,amanthul,1459,warrior,arms,54,26,28
Riskydevil,azralon,1458,warrior,arms,58,32,26
Koniq,azralon,1458,warrior,arms,29,16,13
Warlow,korgath,1458,warrior,arms,64,29,35
Mommysharky,illidan,1457,warrior,arms,36,26,10
Dathalidus,area-52,1457,warrior,arms,50,32,18
Brotu,nemesis,1457,warrior,arms,163,91,72
Creepi,sargeras,1457,warrior,arms,56,30,26
Smoket,tichondrius,1456,warrior,arms,48,25,23
Brocky,malorne,1456,warrior,arms,659,324,335
Kröh,quelthalas,1456,warrior,arms,42,19,23
Pongk,tichondrius,1456,warrior,arms,57,17,40
Cheeriozz,thrall,1455,warrior,arms,53,30,23
Renegón,ragnaros,1455,warrior,arms,54,28,26
Jotto,zuljin,1455,warrior,arms,36,18,18
Jrod,boulderfist,1455,warrior,arms,204,101,103
Säbeër,ragnaros,1455,warrior,arms,66,32,34
Slamthony,sargeras,1455,warrior,arms,57,27,30
Xaka,tichondrius,1455,warrior,arms,42,19,23
Dropopen,tichondrius,1455,warrior,arms,60,21,39
Bigdickgomez,frostmourne,1454,warrior,arms,30,16,14
Lionssong,bleeding-hollow,1454,warrior,arms,71,31,40
Suprslayer,spirestone,1453,warrior,arms,40,20,20
Xenogears,boulderfist,1452,warrior,arms,96,51,45
Ayath,hyjal,1452,warrior,arms,66,31,35
Babybears,tichondrius,1451,warrior,arms,50,18,32
Cjz,tichondrius,1450,warrior,arms,48,29,19
Zizwe,proudmoore,1450,warrior,arms,83,44,39
Lòrdnasher,tichondrius,1450,warrior,arms,83,43,40
Biznizwar,sargeras,1450,warrior,arms,124,61,63
Isarat,illidan,1450,warrior,arms,48,23,25
Qetimporta,quelthalas,1449,warrior,arms,96,54,42
Erple,eldrethalas,1449,warrior,arms,116,54,62
Himurinha,nemesis,1448,warrior,arms,30,16,14
Wellowarr,moon-guard,1448,warrior,arms,78,34,44
Dcashmoney,moon-guard,1448,warrior,arms,66,28,38
Wapistun,thrall,1447,warrior,arms,48,26,22
Dånkers,sargeras,1447,warrior,arms,44,16,28
Gtatewarr,azjolnerub,1446,warrior,arms,26,16,10
Overswing,tichondrius,1446,warrior,arms,78,32,46
Zeroaxx,ragnaros,1445,warrior,arms,85,50,35
Rárict,moon-guard,1445,warrior,arms,46,26,20
Shawnemd,proudmoore,1445,warrior,arms,54,29,25
Streetdog,stormrage,1445,warrior,arms,60,29,31
Khargrok,ragnaros,1444,warrior,arms,60,28,32
Trackstarz,llane,1443,warrior,arms,250,124,126
Aoste,tichondrius,1442,warrior,arms,61,33,28
Kréix,sargeras,1442,warrior,arms,59,27,32
Destoryhamer,illidan,1441,warrior,arms,96,51,45
Radamäntthys,nemesis,1441,warrior,arms,117,51,66
Akaius,ragnaros,1441,warrior,arms,60,26,34
Frankoiz,quelthalas,1440,warrior,arms,48,20,28
Ðêad,area-52,1439,warrior,arms,24,15,9
Joran,dathremar,1439,warrior,arms,44,23,21
Kror,garona,1439,warrior,arms,75,38,37
Rekatron,area-52,1439,warrior,arms,30,15,15
Emaree,thrall,1438,warrior,arms,98,55,43
Darkfang,icecrown,1438,warrior,arms,48,26,22
Himxp,tichondrius,1438,warrior,arms,70,35,35
Jichelei,tichondrius,1438,warrior,arms,72,35,37
Beatmeat,frostmourne,1438,warrior,arms,55,25,30
Loosz,stormrage,1438,warrior,arms,36,15,21
Moozz,dreadmaul,1438,warrior,arms,42,17,25
Themessiah,stormrage,1437,warrior,arms,59,33,26
Graelus,terenas,1437,warrior,arms,47,26,21
Drekzul,azralon,1437,warrior,arms,71,39,32
Kurdtx,tichondrius,1437,warrior,arms,30,15,15
Handain,malganis,1437,warrior,arms,48,19,29
Raxek,stormrage,1437,warrior,arms,54,19,35
Benkenobi,khaz-modan,1436,warrior,arms,24,15,9
Stufit,emerald-dream,1436,warrior,arms,34,20,14
Sako,amanthul,1436,warrior,arms,36,19,17
Gorenay,nemesis,1436,warrior,arms,48,21,27
Swamphell,barthilas,1436,warrior,arms,68,25,43
Lotsay,tichondrius,1435,warrior,arms,97,50,47
Ikrad,quelthalas,1435,warrior,arms,111,57,54
Threg,malganis,1435,warrior,arms,30,15,15
Nikon,bleeding-hollow,1435,warrior,arms,42,16,26
Valder,akama,1434,warrior,arms,42,23,19
Broodthorne,tichondrius,1434,warrior,arms,36,16,20
Vainamóinen,kelthuzad,1433,warrior,arms,24,15,9
Fòntaine,shandris,1433,warrior,arms,49,28,21
Ygucheng,emerald-dream,1433,warrior,arms,67,33,34
Monowarx,frostmourne,1433,warrior,arms,46,22,24
Ybo,illidan,1432,warrior,arms,87,56,31
Zonkis,kelthuzad,1432,warrior,arms,30,15,15
Brewstrike,dalaran,1432,warrior,arms,54,25,29
Tonesman,tichondrius,1432,warrior,arms,48,22,26
Druckerz,lightnings-blade,1432,warrior,arms,102,43,59
Ôxluck,ragnaros,1432,warrior,arms,92,34,58
Hdkwanwoo,tichondrius,1431,warrior,arms,55,31,24
Painfulsin,tichondrius,1431,warrior,arms,60,26,34
Badguys,illidan,1431,warrior,arms,36,15,21
Recktko,sargeras,1431,warrior,arms,39,16,23
Unstàble,frostmourne,1430,warrior,arms,120,58,62
Jeffe,khadgar,1429,warrior,arms,86,39,47
Kushhy,illidan,1429,warrior,arms,45,19,26
Destroid,zuljin,1428,warrior,arms,24,15,9
Laintimee,tichondrius,1428,warrior,arms,56,30,26
Shiiftybuga,frostmourne,1427,warrior,arms,50,27,23
Hulkbuster,ragnaros,1427,warrior,arms,42,18,24
Kadira,stormrage,1427,warrior,arms,90,37,53
Fraannky,windrunner,1426,warrior,arms,128,64,64
Dysensor,illidan,1426,warrior,arms,120,60,60
Calmebigfeet,tichondrius,1426,warrior,arms,30,15,15
Ermeji,ragnaros,1426,warrior,arms,59,27,32
Arot,bloodhoof,1425,warrior,arms,165,78,87
Santiágo,wyrmrest-accord,1425,warrior,arms,42,15,27
Nervoxztwo,ragnaros,1424,warrior,arms,126,66,60
Kannzox,quelthalas,1424,warrior,arms,103,53,50
Cptstarship,sargeras,1424,warrior,arms,42,21,21
Krimgar,quelthalas,1424,warrior,arms,94,39,55
Maintarget,malganis,1424,warrior,arms,59,21,38
Rayks,tichondrius,1423,warrior,arms,72,42,30
Aesom,wyrmrest-accord,1423,warrior,arms,133,73,60
Ghostmourne,ragnaros,1423,warrior,arms,256,127,129
Tergll,illidan,1423,warrior,arms,51,23,28
Musclecrowe,illidan,1423,warrior,arms,36,15,21
Ooze,darkspear,1422,warrior,arms,138,75,63
Justfair,barthilas,1422,warrior,arms,63,31,32
Guguito,drakkari,1422,warrior,arms,42,17,25
Thalfor,emerald-dream,1422,warrior,arms,77,30,47
Filthyrandy,proudmoore,1421,warrior,arms,42,21,21
Lørdvingador,azralon,1421,warrior,arms,30,15,15
Gritrog,thrall,1420,warrior,arms,56,42,14
Banggo,frostmourne,1420,warrior,arms,72,41,31
Dji,tichondrius,1420,warrior,arms,293,146,147
Mahkrash,quelthalas,1420,warrior,arms,47,22,25
Sleazedog,kelthuzad,1420,warrior,arms,48,21,27
Farquahd,illidan,1420,warrior,arms,84,34,50
Waraze,tichondrius,1420,warrior,arms,42,17,25
Nipparcs,tichondrius,1420,warrior,arms,42,15,27
Fatty,mugthol,1419,warrior,arms,48,28,20
Varyanguard,quelthalas,1419,warrior,arms,47,25,22
Orctiddy,emerald-dream,1419,warrior,arms,32,16,16
Mopwarrior,sargeras,1419,warrior,arms,30,15,15
Elyoy,aerie-peak,1418,warrior,arms,48,26,22
Karrok,zuluhed,1418,warrior,arms,246,117,129
Hundredplus,frostmourne,1418,warrior,arms,36,17,19
Pepétí,azralon,1418,warrior,arms,160,72,88
Balroge,illidan,1418,warrior,arms,54,24,30
Mortalgodtko,ragnaros,1418,warrior,arms,39,17,22
Lisande,sargeras,1417,warrior,arms,106,57,49
Chanchoswar,ragnaros,1417,warrior,arms,126,58,68
Jinsol,illidan,1416,warrior,arms,87,43,44
Tasesino,quelthalas,1415,warrior,arms,70,39,31
Aaryn,caelestrasz,1415,warrior,arms,104,56,48
Rekitralph,tichondrius,1415,warrior,arms,45,23,22
Ughh,bleeding-hollow,1415,warrior,arms,54,27,27
Bâtar,area-52,1415,warrior,arms,47,17,30
Drygen,tichondrius,1414,warrior,arms,60,36,24
Sludgthwaps,stormrage,1414,warrior,arms,65,33,32
Fatnfurious,dunemaul,1414,warrior,arms,100,50,50
Kahuwuna,tichondrius,1414,warrior,arms,30,15,15
Guerra,goldrinn,1414,warrior,arms,30,15,15
Scumrat,frostmourne,1414,warrior,arms,66,32,34
Soltrain,stormrage,1414,warrior,arms,74,33,41
Dizgraceful,malganis,1413,warrior,arms,30,21,9
Imyourdaddy,chogall,1413,warrior,arms,28,16,12
Korboc,malganis,1413,warrior,arms,60,29,31
Slickpapi,area-52,1413,warrior,arms,93,44,49
Slimmjim,malganis,1412,warrior,arms,164,90,74
Muertededios,quelthalas,1412,warrior,arms,141,70,71
Rikuduo,quelthalas,1412,warrior,arms,138,66,72
Steelfist,grizzly-hills,1412,warrior,arms,54,25,29
Ëssex,tichondrius,1412,warrior,arms,83,38,45
Piimpmaster,malganis,1412,warrior,arms,36,15,21
Shadderaz,sargeras,1411,warrior,arms,66,30,36
Shockkwave,tichondrius,1410,warrior,arms,30,15,15
Kanamechan,area-52,1410,warrior,arms,71,28,43
Áustin,sargeras,1409,warrior,arms,24,15,9
Tyzana,illidan,1409,warrior,arms,36,20,16
Slamix,area-52,1409,warrior,arms,81,41,40
Rockadoodle,tichondrius,1409,warrior,arms,60,30,30
Bellonar,stormrage,1408,warrior,arms,32,20,12
Utgarde,stormrage,1408,warrior,arms,200,101,99
Rokó,illidan,1408,warrior,arms,84,41,43
Haxzors,sargeras,1408,warrior,arms,60,26,34
Warthorns,malganis,1408,warrior,arms,49,17,32
Jøq,ragnaros,1407,warrior,arms,30,17,13
Solano,illidan,1405,warrior,arms,48,30,18
Warb,aggramar,1405,warrior,arms,93,48,45
Bruttallis,frostmane,1405,warrior,arms,51,25,26
Hoodlark,lightbringer,1405,warrior,arms,78,30,48
Baix,frostmourne,1404,warrior,arms,63,35,28
Tithousand,tichondrius,1404,warrior,arms,45,24,21
Yummysushi,gorgonnash,1404,warrior,arms,76,31,45
Tdestroy,ragnaros,1403,warrior,arms,45,24,21
Najarath,barthilas,1403,warrior,arms,36,19,17
Xiosè,ragnaros,1403,warrior,arms,66,32,34
Mortalstrike,chogall,1403,warrior,arms,52,25,27
Aloloco,ragnaros,1403,warrior,arms,66,30,36
Zareos,azralon,1403,warrior,arms,40,17,23
Asgér,quelthalas,1403,warrior,arms,114,46,68
Bløødy,lethon,1402,warrior,arms,26,17,9
Gusbus,malganis,1402,warrior,arms,121,65,56
Machineofwar,zuluhed,1402,warrior,arms,150,72,78
Chacca,suramar,1401,warrior,arms,36,25,11
Luckyw,draktharon,1401,warrior,arms,48,27,21
Supremegalek,tichondrius,1401,warrior,arms,88,46,42
Sigfir,ragnaros,1401,warrior,arms,76,36,40
Aión,nemesis,1400,warrior,arms,24,17,7
Thaisyta,tichondrius,1400,warrior,arms,30,19,11
Flintish,moon-guard,1400,warrior,arms,71,43,28
Dubstoob,illidan,1400,warrior,arms,148,77,71
Buntpunt,mannoroth,1400,warrior,arms,109,53,56
Peeb,tichondrius,1399,warrior,arms,30,15,15
Hêllseeker,ragnaros,1399,warrior,arms,78,37,41
Tern,emerald-dream,1398,warrior,arms,82,42,40
Blightscream,bleeding-hollow,1397,warrior,arms,229,109,120
Handkerchief,bleeding-hollow,1397,warrior,arms,37,16,21
Tenebrous,nemesis,1397,warrior,arms,48,20,28
Wanabea,tichondrius,1396,warrior,arms,42,17,25
Grimreáper,bleeding-hollow,1396,warrior,arms,90,35,55
Sokõ,tichondrius,1394,warrior,arms,48,28,20
Varith,sargeras,1394,warrior,arms,36,20,16
Ponchetas,quelthalas,1394,warrior,arms,96,46,50
Fenømenoide,ragnaros,1392,warrior,arms,60,40,20
Vanglorio,azralon,1392,warrior,arms,81,44,37
Zaulgoodman,sargeras,1392,warrior,arms,30,15,15
Zaurka,sargeras,1391,warrior,arms,30,18,12
Bigster,malganis,1391,warrior,arms,30,16,14
Nicegirl,sargeras,1391,warrior,arms,69,36,33
Ayuko,greymane,1391,warrior,arms,47,23,24
Coolade,thunderhorn,1391,warrior,arms,106,51,55
Swordmasters,icecrown,1391,warrior,arms,77,37,40
Zeerohkool,tichondrius,1391,warrior,arms,102,46,56
Yazia,stormrage,1391,warrior,arms,42,17,25
Magnar,zuljin,1389,warrior,arms,60,34,26
Kiranoma,moon-guard,1389,warrior,arms,38,19,19
Alexitwo,ragnaros,1388,warrior,arms,72,38,34
Apallô,tichondrius,1388,warrior,arms,89,40,49
Odrak,ragnaros,1388,warrior,arms,81,35,46
Rekcd,sargeras,1387,warrior,arms,36,23,13
Nãrax,area-52,1387,warrior,arms,40,20,20
Demonsláyer,illidan,1387,warrior,arms,30,15,15
Riderless,ragnaros,1387,warrior,arms,30,15,15
Gilgaméshh,tichondrius,1387,warrior,arms,54,23,31
Topmeoff,bleeding-hollow,1387,warrior,arms,42,16,26
Cecchino,zuluhed,1386,warrior,arms,48,25,23
Stoneshield,senjin,1386,warrior,arms,29,15,14
Ninefingers,madoran,1386,warrior,arms,78,38,40
Momojojo,daggerspine,1385,warrior,arms,26,18,8
Morhgath,bonechewer,1385,warrior,arms,49,26,23
Retros,kelthuzad,1385,warrior,arms,72,37,35
Caupølican,ragnaros,1385,warrior,arms,76,37,39
Soniixz,ragnaros,1385,warrior,arms,62,30,32
Yirko,quelthalas,1385,warrior,arms,74,31,43
Nightshauyia,kelthuzad,1384,warrior,arms,69,37,32
Twobyfuor,sargeras,1383,warrior,arms,65,33,32
Bobandi,tichondrius,1383,warrior,arms,34,16,18
Raygé,malygos,1383,warrior,arms,45,21,24
Disarmiea,cairne,1383,warrior,arms,87,40,47
Fazeo,madoran,1382,warrior,arms,27,15,12
Rongkhunxyz,tichondrius,1382,warrior,arms,54,28,26
Ghostss,tichondrius,1382,warrior,arms,67,29,38
Eîghtysîx,sargeras,1382,warrior,arms,100,43,57
Rivenz,moon-guard,1382,warrior,arms,57,20,37
Ukris,area-52,1381,warrior,arms,119,62,57
Verain,thrall,1381,warrior,arms,36,17,19
Bagur,ragnaros,1380,warrior,arms,114,61,53
Typhön,tichondrius,1380,warrior,arms,77,31,46
Gooshin,sargeras,1379,warrior,arms,127,65,62
Dinogc,barthilas,1379,warrior,arms,44,21,23
Rägar,quelthalas,1378,warrior,arms,67,33,34
Edwiddin,frostmourne,1378,warrior,arms,72,32,40
Killtarget,tichondrius,1377,warrior,arms,82,45,37
Gwendolynl,hyjal,1377,warrior,arms,73,35,38
Bjjorm,malganis,1377,warrior,arms,42,15,27
Tusktrollmon,illidan,1376,warrior,arms,128,63,65
Mafe,tichondrius,1375,warrior,arms,58,28,30
Janlei,quelthalas,1375,warrior,arms,76,35,41
Yoruba,burning-blade,1375,warrior,arms,67,29,38
Beowúlf,burning-blade,1375,warrior,arms,41,16,25
Dolkal,tichondrius,1375,warrior,arms,57,21,36
Hopar,illidan,1374,warrior,arms,54,31,23
Danzohh,dalaran,1374,warrior,arms,33,15,18
Týrodar,moon-guard,1374,warrior,arms,54,24,30
Jottman,tichondrius,1374,warrior,arms,135,54,81
Groxxigore,chogall,1373,warrior,arms,111,62,49
Blokz,arthas,1373,warrior,arms,72,40,32
Rhohan,ysera,1373,warrior,arms,83,40,43
Kowboy,stormrage,1372,warrior,arms,130,66,64
Rushour,quelthalas,1372,warrior,arms,32,15,17
Novastormer,barthilas,1372,warrior,arms,69,30,39
Storkos,moon-guard,1371,warrior,arms,107,57,50
Kantorowicz,goldrinn,1371,warrior,arms,78,40,38
Ragepocket,proudmoore,1371,warrior,arms,66,32,34
Ðarkstar,zuljin,1370,warrior,arms,140,62,78
Northhill,tichondrius,1368,warrior,arms,120,64,56
Budzie,frostwolf,1368,warrior,arms,40,21,19
Zaexx,stormrage,1368,warrior,arms,65,32,33
Pelonna,drakkari,1368,warrior,arms,154,75,79
Powerhard,area-52,1368,warrior,arms,57,26,31
Monkedurant,tichondrius,1367,warrior,arms,30,18,12
Dhakhota,azralon,1367,warrior,arms,42,22,20
Superdah,kiljaeden,1367,warrior,arms,72,36,36
Dhaemom,azralon,1366,warrior,arms,133,69,64
Evilkorean,tichondrius,1366,warrior,arms,59,29,30
Noppô,tichondrius,1366,warrior,arms,42,15,27
Doomreaper,hellscream,1365,warrior,arms,113,57,56
Zugnut,tichondrius,1365,warrior,arms,70,34,36
Xenowar,alleria,1365,warrior,arms,108,48,60
Durko,whisperwind,1365,warrior,arms,36,16,20
Natedógg,tichondrius,1365,warrior,arms,41,17,24
Ragnarwar,azralon,1364,warrior,arms,69,39,30
Looffy,saurfang,1364,warrior,arms,114,59,55
Juicey,burning-blade,1364,warrior,arms,55,28,27
Juggerboo,frostmourne,1364,warrior,arms,131,64,67
Tÿÿr,azralon,1364,warrior,arms,60,26,34
Danzael,quelthalas,1364,warrior,arms,42,18,24
Xampuu,ragnaros,1363,warrior,arms,34,20,14
Theragar,kilrogg,1363,warrior,arms,36,20,16
Sevala,spinebreaker,1363,warrior,arms,58,32,26
Ooktanx,emerald-dream,1363,warrior,arms,38,15,23
Neozsmash,thrall,1362,warrior,arms,58,29,29
Josephcrazy,tichondrius,1362,warrior,arms,30,15,15
Fuknazum,gundrak,1362,warrior,arms,190,92,98
Mjorn,sargeras,1362,warrior,arms,64,30,34
Yummybumbum,barthilas,1362,warrior,arms,60,26,34
Arashikage,malganis,1361,warrior,arms,40,18,22
Mervyn,aegwynn,1360,warrior,arms,48,29,19
Allgas,barthilas,1360,warrior,arms,107,58,49
Tikkò,tichondrius,1360,warrior,arms,62,33,29
Devil,illidan,1360,warrior,arms,33,17,16
Warsaínt,area-52,1360,warrior,arms,65,31,34
Krakitus,azralon,1360,warrior,arms,99,43,56
Klingensturm,thrall,1359,warrior,arms,25,15,10
Lègèndáry,dark-iron,1359,warrior,arms,48,21,27
Tigo,khaz-modan,1358,warrior,arms,87,47,40
Franc,kiljaeden,1358,warrior,arms,41,22,19
Kilrosao,nordrassil,1358,warrior,arms,89,45,44
Davidorco,drakkari,1358,warrior,arms,41,19,22
Saltyundies,tichondrius,1358,warrior,arms,123,56,67
Ightdoex,zuljin,1357,warrior,arms,32,22,10
Kleavage,korgath,1357,warrior,arms,67,31,36
Estivador,kelthuzad,1357,warrior,arms,62,27,35
Pangpou,tichondrius,1355,warrior,arms,156,83,73
Magnusson,kelthuzad,1354,warrior,arms,36,16,20
Lowlow,lightbringer,1354,warrior,arms,36,16,20
Kittybang,quelthalas,1354,warrior,arms,71,29,42
Seariphim,lothar,1353,warrior,arms,45,24,21
Jhave,ragnaros,1353,warrior,arms,44,22,22
Silverkiller,drakkari,1352,warrior,arms,57,29,28
Rapralph,barthilas,1352,warrior,arms,54,26,28
Biloni,ragnaros,1352,warrior,arms,42,18,24
Browneyed,area-52,1352,warrior,arms,36,15,21
Zroz,ragnaros,1351,warrior,arms,63,34,29
Toagrim,azralon,1351,warrior,arms,66,31,35
Nviv,proudmoore,1351,warrior,arms,90,40,50
Pírlo,ragnaros,1351,warrior,arms,42,18,24
Devilsbane,khaz-modan,1350,warrior,arms,84,44,40
Badmanego,illidan,1350,warrior,arms,61,28,33
Hiddensquidd,stormrage,1349,warrior,arms,57,35,22
Mightypower,gurubashi,1349,warrior,arms,30,17,13
Hippy,kiljaeden,1349,warrior,arms,34,19,15
Dreadwarr,stormrage,1349,warrior,arms,56,30,26
Tinydingo,sargeras,1349,warrior,arms,36,19,17
Rampage,azralon,1349,warrior,arms,125,59,66
Vayper,illidan,1349,warrior,arms,71,33,38
Themonsterr,stormrage,1349,warrior,arms,34,15,19
Jellybomb,sargeras,1348,warrior,arms,216,104,112
Jsolucky,thrall,1348,warrior,arms,36,15,21
Thorado,nemesis,1347,warrior,arms,166,81,85
Odrath,tichondrius,1347,warrior,arms,96,46,50
Velarael,stormscale,1347,warrior,arms,46,22,24
Dimus,area-52,1347,warrior,arms,36,15,21
Skrot,stormrage,1346,warrior,arms,64,34,30
Rasgriz,moon-guard,1346,warrior,arms,43,20,23
Sonezwar,thrall,1345,warrior,arms,72,36,36
Taürok,azralon,1345,warrior,arms,48,23,25
Ðuratestön,azralon,1345,warrior,arms,36,16,20
Juff,hakkar,1344,warrior,arms,70,36,34
ßaldbornë,stormrage,1344,warrior,arms,94,47,47
Jeffyd,bleeding-hollow,1344,warrior,arms,48,16,32
Dackøzzt,quelthalas,1343,warrior,arms,24,14,10
Warraaxx,stonemaul,1343,warrior,arms,48,25,23
Lagzistance,area-52,1343,warrior,arms,30,14,16
Notmagnusz,zuljin,1343,warrior,arms,30,14,16
Legday,stormrage,1343,warrior,arms,30,14,16
Orangesoda,tichondrius,1342,warrior,arms,24,14,10
Gorrock,dreadmaul,1342,warrior,arms,72,35,37
Kinzi,quelthalas,1342,warrior,arms,153,67,86
Andeadw,tichondrius,1341,warrior,arms,21,15,6
Mcflury,skullcrusher,1341,warrior,arms,24,14,10
Kurdt,tichondrius,1341,warrior,arms,24,14,10
Rage,uther,1341,warrior,arms,30,14,16
Horcules,kiljaeden,1341,warrior,arms,47,19,28
Xvett,drakkari,1340,warrior,arms,102,57,45
Gentlehugs,illidan,1340,warrior,arms,36,14,22
Nerdstorm,tichondrius,1338,warrior,arms,24,14,10
Garysmalls,kelthuzad,1338,warrior,arms,24,14,10
Gáren,quelthalas,1338,warrior,arms,24,14,10
Eskobar,magtheridon,1338,warrior,arms,29,15,14
Warrmoose,tichondrius,1338,warrior,arms,30,14,16
Gavfields,tichondrius,1337,warrior,arms,24,14,10
Allenwrite,frostmourne,1337,warrior,arms,48,21,27
Småckin,frostmourne,1336,warrior,arms,52,31,21
Suntore,malganis,1336,warrior,arms,24,14,10
Govosh,thrall,1336,warrior,arms,24,14,10
Laygoh,zuljin,1336,warrior,arms,24,14,10
Ketaqt,illidan,1336,warrior,arms,26,15,11
Azog,bleeding-hollow,1336,warrior,arms,48,25,23
Kelidar,kaelthas,1336,warrior,arms,60,31,29
Arm,stormscale,1336,warrior,arms,62,30,32
Viagraliker,tichondrius,1336,warrior,arms,44,19,25
Rhorix,korialstrasz,1336,warrior,arms,36,14,22
Wesih,ragnaros,1336,warrior,arms,60,22,38
Unbeatablezs,tichondrius,1335,warrior,arms,96,51,45
Tooto,kelthuzad,1335,warrior,arms,30,15,15
Xenoblade,wildhammer,1335,warrior,arms,48,21,27
Teedubbs,antonidas,1335,warrior,arms,48,19,29
Bwhaha,frostwolf,1334,warrior,arms,36,26,10
Frosto,nemesis,1334,warrior,arms,24,14,10
Rageinice,tichondrius,1334,warrior,arms,42,21,21
Prodigál,dalaran,1334,warrior,arms,36,15,21
Slammshady,tichondrius,1333,warrior,arms,21,15,6
Thegoochgoon,malorne,1333,warrior,arms,67,36,31
Barricade,velen,1333,warrior,arms,131,64,67
Kolacut,tichondrius,1332,warrior,arms,24,14,10
Jijiyeya,tichondrius,1332,warrior,arms,36,17,19
Blackwulff,korgath,1332,warrior,arms,66,29,37
Waabi,emerald-dream,1331,warrior,arms,30,18,12
Necco,lothar,1331,warrior,arms,36,16,20
Cainne,proudmoore,1330,warrior,arms,30,19,11
Lexxsteele,mugthol,1330,warrior,arms,24,14,10
Carken,kiljaeden,1330,warrior,arms,36,20,16
Doomreaprr,hellscream,1330,warrior,arms,50,27,23
Kilroywar,tichondrius,1329,warrior,arms,30,14,16
Illicitkillz,destromath,1329,warrior,arms,30,14,16
Hadesz,nazjatar,1328,warrior,arms,83,45,38
Nuclearfury,khadgar,1328,warrior,arms,60,31,29
Roitty,proudmoore,1328,warrior,arms,61,28,33
Fixafflock,bleeding-hollow,1327,warrior,arms,24,14,10
Chilicezo,durotan,1327,warrior,arms,65,37,28
Cyllå,frostmourne,1327,warrior,arms,33,18,15
Qookymonster,zuljin,1327,warrior,arms,106,56,50
Kalnor,dark-iron,1327,warrior,arms,50,26,24
Kourny,frostmourne,1327,warrior,arms,87,42,45
Ketasshi,kelthuzad,1327,warrior,arms,36,14,22
Twistwarr,area-52,1326,warrior,arms,24,14,10
Greywo,tichondrius,1326,warrior,arms,67,38,29
Iyamii,hyjal,1326,warrior,arms,35,19,16
Zuljikan,illidan,1326,warrior,arms,47,16,31
Sloppyglucks,moon-guard,1325,warrior,arms,30,15,15
Icarrus,frostmourne,1325,warrior,arms,30,14,16
Boocawkeyy,illidan,1325,warrior,arms,60,23,37
Colosal,drakkari,1324,warrior,arms,33,20,13
Brontok,darkspear,1324,warrior,arms,64,33,31
Tasilia,tichondrius,1324,warrior,arms,30,14,16
Mitered,tichondrius,1323,warrior,arms,39,19,20
Kolossux,ragnaros,1323,warrior,arms,108,50,58
Overfury,azralon,1322,warrior,arms,36,18,18
Datsongz,proudmoore,1322,warrior,arms,120,59,61
Gizzmo,bonechewer,1322,warrior,arms,36,14,22
Venecus,stormrage,1321,warrior,arms,30,14,16
Lelànd,kelthuzad,1320,warrior,arms,30,14,16
Macsen,zuljin,1319,warrior,arms,36,18,18
Semyus,ragnaros,1319,warrior,arms,65,32,33
Linçpin,tichondrius,1319,warrior,arms,60,29,31
Thrawb,bleeding-hollow,1319,warrior,arms,33,15,18
Toragorr,illidan,1318,warrior,arms,24,15,9
Gï,fizzcrank,1318,warrior,arms,24,14,10
Chargeback,zuljin,1318,warrior,arms,63,34,29
Arkayko,quelthalas,1318,warrior,arms,28,15,13
Lujzika,stormreaver,1318,warrior,arms,39,17,22
Calmaah,frostmourne,1317,warrior,arms,63,33,30
Swamis,stormreaver,1315,warrior,arms,54,27,27
Kappis,illidan,1315,warrior,arms,59,29,30
Drippyjones,sargeras,1315,warrior,arms,54,26,28
Bùlk,barthilas,1315,warrior,arms,112,49,63
Dennlss,quelthalas,1315,warrior,arms,114,49,65
Vondrack,ragnaros,1315,warrior,arms,83,34,49
Tribbally,silver-hand,1314,warrior,arms,49,26,23
Tenserr,kiljaeden,1314,warrior,arms,33,17,16
Fuller,kelthuzad,1314,warrior,arms,36,18,18
Ragehir,thrall,1314,warrior,arms,31,15,16
Loothar,goldrinn,1313,warrior,arms,137,68,69
Wreckz,blood-furnace,1312,warrior,arms,78,42,36
Tenchuu,azralon,1312,warrior,arms,130,56,74
Logi,alexstrasza,1312,warrior,arms,42,17,25
Qtcrow,frostmourne,1310,warrior,arms,78,39,39
Sseobeon,tichondrius,1310,warrior,arms,28,14,14
Tunasurprize,stormrage,1310,warrior,arms,33,16,17
Doomtree,zuljin,1309,warrior,arms,18,14,4
Makcumba,ragnaros,1309,warrior,arms,54,29,25
Verigislena,moon-guard,1309,warrior,arms,56,28,28
Jalaskâ,azralon,1309,warrior,arms,82,39,43
Kipqt,frostmourne,1309,warrior,arms,30,14,16
Zeerohkool,malganis,1308,warrior,arms,140,62,78
Daymiian,blackrock,1308,warrior,arms,42,17,25
Mickyplate,tichondrius,1307,warrior,arms,78,39,39
Notsi,ragnaros,1307,warrior,arms,66,28,38
Aldérmach,zuljin,1306,warrior,arms,112,57,55
Syllana,sargeras,1306,warrior,arms,30,15,15
Velarrine,illidan,1306,warrior,arms,89,39,50
Noelglz,quelthalas,1305,warrior,arms,23,14,9
Knghtofseven,nemesis,1305,warrior,arms,72,39,33
Exxic,zuljin,1305,warrior,arms,42,21,21
Vemue,tichondrius,1305,warrior,arms,172,84,88
Fûry,barthilas,1305,warrior,arms,30,14,16
Auxthas,tichondrius,1305,warrior,arms,30,14,16
Timbajimba,silvermoon,1305,warrior,arms,58,27,31
Rhagnael,malganis,1305,warrior,arms,72,30,42
Broxigore,nerzhul,1305,warrior,arms,48,14,34
Raekor,tichondrius,1304,warrior,arms,42,25,17
Zuggarnaught,tichondrius,1304,warrior,arms,82,44,38
Dreweth,altar-of-storms,1304,warrior,arms,30,16,14
Pum,bleeding-hollow,1304,warrior,arms,30,14,16
Marraneitor,quelthalas,1303,warrior,arms,60,29,31
Swiftui,nemesis,1303,warrior,arms,87,39,48
Deadee,aerie-peak,1302,warrior,arms,100,48,52
Akj,sargeras,1302,warrior,arms,54,23,31
Ludicrous,dreadmaul,1302,warrior,arms,85,36,49
Kayaburn,tichondrius,1301,warrior,arms,24,19,5
Donhoolio,illidan,1301,warrior,arms,24,14,10
Ximzhao,quelthalas,1301,warrior,arms,67,32,35
Legolant,uther,1301,warrior,arms,30,14,16
Beserkqt,azralon,1301,warrior,arms,48,20,28
Erdres,kelthuzad,1301,warrior,arms,75,27,48
Warnick,illidan,1300,warrior,arms,72,35,37
Pvpheart,tichondrius,1299,warrior,arms,47,27,20
Krostyx,ragnaros,1299,warrior,arms,72,40,32
Arrozkonlech,proudmoore,1299,warrior,arms,31,17,14
Chawp,emerald-dream,1299,warrior,arms,47,24,23
Bluthammer,wyrmrest-accord,1299,warrior,arms,35,16,19
Babamama,tichondrius,1299,warrior,arms,44,20,24
Stewwar,wyrmrest-accord,1298,warrior,arms,26,16,10
Warrdawg,tichondrius,1298,warrior,arms,36,20,16
Aresmt,illidan,1298,warrior,arms,30,14,16
Ccmeharder,kiljaeden,1298,warrior,arms,30,14,16
Rekem,malganis,1298,warrior,arms,78,35,43
Papaming,tichondrius,1298,warrior,arms,72,32,40
Xufoxpikmin,gurubashi,1298,warrior,arms,106,46,60
Kitonic,proudmoore,1296,warrior,arms,29,18,11
Guitter,nazjatar,1296,warrior,arms,48,20,28
Bustybucky,tichondrius,1296,warrior,arms,42,14,28
Beeny,tichondrius,1295,warrior,arms,33,14,19
Darthbjorn,lethon,1294,warrior,arms,48,28,20
Superpot,bleeding-hollow,1294,warrior,arms,48,22,26
Angertooth,tichondrius,1293,warrior,arms,30,14,16
Crú,stormrage,1293,warrior,arms,30,14,16
Xl,quelthalas,1292,warrior,arms,108,50,58
Weepingdeath,burning-legion,1292,warrior,arms,72,33,39
Lobsterrj,emerald-dream,1292,warrior,arms,48,19,29
Deomer,quelthalas,1291,warrior,arms,36,18,18
Noobslayr,wyrmrest-accord,1290,warrior,arms,30,18,12
Ønì,tichondrius,1289,warrior,arms,48,35,13
Grumok,tichondrius,1289,warrior,arms,57,24,33
Ðigger,rivendare,1288,warrior,arms,42,19,23
Balakay,drenden,1287,warrior,arms,24,15,9
Hikikomori,goldrinn,1287,warrior,arms,65,35,30
Walterwhîte,tichondrius,1287,warrior,arms,30,14,16
Weesten,aerie-peak,1286,warrior,arms,24,16,8
Utheroellin,stormrage,1286,warrior,arms,30,15,15
Terók,stormrage,1286,warrior,arms,48,20,28
Egargiss,malygos,1285,warrior,arms,24,14,10
Hatedßyßlízz,area-52,1285,warrior,arms,48,21,27
Skornnd,malganis,1285,warrior,arms,82,35,47
Ðåddý,stormrage,1285,warrior,arms,41,14,27
Repsey,zuljin,1284,warrior,arms,23,15,8
Sllvrbck,tichondrius,1284,warrior,arms,28,17,11
Niudazhuang,tichondrius,1284,warrior,arms,106,56,50
Valde,stormrage,1284,warrior,arms,27,14,13
Deadhawk,wyrmrest-accord,1284,warrior,arms,84,36,48
Ashrah,emerald-dream,1283,warrior,arms,54,29,25
Dualip,tichondrius,1283,warrior,arms,75,38,37
Excaliburz,frostmourne,1283,warrior,arms,101,48,53
Ñors,spinebreaker,1283,warrior,arms,36,15,21
Rnkman,quelthalas,1282,warrior,arms,25,16,9
Putong,tichondrius,1282,warrior,arms,53,29,24
Homicideted,frostmourne,1282,warrior,arms,66,34,32
Kagerou,ragnaros,1282,warrior,arms,62,28,34
Heals,zuljin,1282,warrior,arms,36,15,21
Shishokun,quelthalas,1281,warrior,arms,88,35,53
Mussashí,stormrage,1280,warrior,arms,70,41,29
Elíte,kelthuzad,1280,warrior,arms,30,14,16
Orz,sargeras,1280,warrior,arms,37,15,22
Menestz,dreadmaul,1279,warrior,arms,71,36,35
Maywarro,ragnaros,1279,warrior,arms,77,35,42
Rhâêgâr,tichondrius,1278,warrior,arms,48,26,22
Onionion,stormrage,1278,warrior,arms,30,14,16
Korsarro,frostmourne,1278,warrior,arms,98,45,53
Gosariw,tichondrius,1278,warrior,arms,33,15,18
Junsus,moon-guard,1278,warrior,arms,65,29,36
Bfrenzy,dalaran,1278,warrior,arms,42,18,24
Mogtash,blackrock,1278,warrior,arms,41,16,25
Zeiyah,quelthalas,1277,warrior,arms,24,14,10
Irix,tichondrius,1277,warrior,arms,129,63,66
Chrosis,norgannon,1277,warrior,arms,71,27,44
Aintou,aegwynn,1276,warrior,arms,42,20,22
Udô,proudmoore,1275,warrior,arms,36,14,22
Toxxel,wyrmrest-accord,1275,warrior,arms,65,23,42
Naxxiki,wyrmrest-accord,1274,warrior,arms,186,91,95
Rickyxp,aggramar,1274,warrior,arms,54,26,28
Squeekzz,frostmane,1273,warrior,arms,62,31,31
Swám,quelthalas,1273,warrior,arms,36,16,20
Amrap,dentarg,1273,warrior,arms,37,16,21
Krazyguerra,bleeding-hollow,1272,warrior,arms,48,26,22
Arox,ghostlands,1272,warrior,arms,60,30,30
Dëkm,quelthalas,1272,warrior,arms,41,18,23
Mfmuggz,thunderlord,1271,warrior,arms,47,23,24
Sneeze,kul-tiras,1271,warrior,arms,52,25,27
Hunnam,illidan,1269,warrior,arms,42,16,26
Azrielsc,vashj,1268,warrior,arms,48,23,25
Thorablade,barthilas,1268,warrior,arms,96,44,52
Loucha,nagrand,1268,warrior,arms,75,32,43
Eudora,stormrage,1267,warrior,arms,72,38,34
Bdubz,moknathal,1266,warrior,arms,29,14,15
Catastrophie,mugthol,1266,warrior,arms,87,39,48
Spartaner,shadowsong,1265,warrior,arms,36,14,22
Seshømaru,quelthalas,1264,warrior,arms,26,15,11
Spitfired,kiljaeden,1264,warrior,arms,36,19,17
Hoodlord,tichondrius,1264,warrior,arms,60,28,32
Timotheapple,stormrage,1264,warrior,arms,32,14,18
Elane,moon-guard,1264,warrior,arms,72,28,44
Ready,laughing-skull,1263,warrior,arms,54,30,24
Thelgrath,quelthalas,1263,warrior,arms,136,66,70
Punnisher,nerzhul,1263,warrior,arms,29,14,15
Krimmjðw,sargeras,1263,warrior,arms,36,14,22
Vamtoro,illidan,1262,warrior,arms,50,28,22
Golinn,aerie-peak,1262,warrior,arms,54,24,30
Babyguns,tichondrius,1262,warrior,arms,66,29,37
Ivanovh,quelthalas,1261,warrior,arms,180,90,90
Viladoht,aegwynn,1261,warrior,arms,30,14,16
Knewty,stormrage,1261,warrior,arms,32,14,18
Hudë,stormrage,1260,warrior,arms,36,19,17
Laynarri,hyjal,1260,warrior,arms,60,28,32
Irongummy,frostmourne,1260,warrior,arms,60,27,33
Golîath,mannoroth,1260,warrior,arms,85,37,48
Beiron,ragnaros,1259,warrior,arms,24,15,9
Monardaid,uldum,1259,warrior,arms,42,17,25
Tämuros,thrall,1258,warrior,arms,64,32,32
Wrathena,khadgar,1258,warrior,arms,55,26,29
Rockystyle,tichondrius,1256,warrior,arms,72,38,34
Selathiel,burning-blade,1256,warrior,arms,40,16,24
Carralee,azralon,1255,warrior,arms,72,42,30
Queterompo,ragnaros,1255,warrior,arms,66,36,30
Cbum,quelthalas,1255,warrior,arms,72,34,38
Aleniá,tichondrius,1255,warrior,arms,79,37,42
Rawlur,zuljin,1255,warrior,arms,41,16,25
Blacksmiff,malganis,1254,warrior,arms,120,64,56
Laint,wyrmrest-accord,1254,warrior,arms,146,73,73
Lilboytroy,korgath,1253,warrior,arms,36,15,21
Croxxs,aegwynn,1253,warrior,arms,50,17,33
Huri,nemesis,1252,warrior,arms,80,45,35
Tyrantwolf,ragnaros,1252,warrior,arms,69,35,34
Magmaheart,lightbringer,1251,warrior,arms,30,14,16
Cauldrin,bleeding-hollow,1251,warrior,arms,132,61,71
Maimif,korgath,1251,warrior,arms,35,16,19
Hblock,barthilas,1251,warrior,arms,45,16,29
Rageoverdose,burning-legion,1250,warrior,arms,135,66,69
Bloodwish,stormrage,1249,warrior,arms,58,32,26
Âmânthul,alexstrasza,1249,warrior,arms,218,116,102
Rodhin,proudmoore,1249,warrior,arms,47,22,25
Brynjah,azralon,1249,warrior,arms,90,40,50
Invinciblé,tichondrius,1248,warrior,arms,24,13,11
Sowavey,korgath,1248,warrior,arms,24,13,11
Bersorcker,ragnaros,1248,warrior,arms,74,29,45
Raizzw,ragnaros,1247,warrior,arms,18,13,5
Areaves,moon-guard,1247,warrior,arms,24,13,11
Codyjones,illidan,1247,warrior,arms,24,13,11
Herey,moon-guard,1247,warrior,arms,24,13,11
Sabotender,suramar,1247,warrior,arms,30,13,17
Scotteh,eredar,1247,warrior,arms,30,13,17
Cowstik,illidan,1246,warrior,arms,24,13,11
Marrago,moon-guard,1246,warrior,arms,24,13,11
Callad,tichondrius,1246,warrior,arms,47,22,25
Lilfookur,dalaran,1246,warrior,arms,82,37,45
Schizogeist,malganis,1246,warrior,arms,40,18,22
Betterwar,zuljin,1246,warrior,arms,30,13,17
Spearmisser,stormrage,1246,warrior,arms,30,13,17
Warhji,malganis,1246,warrior,arms,30,13,17
Sleepypie,tichondrius,1245,warrior,arms,18,13,5
Catwar,tichondrius,1245,warrior,arms,18,13,5
Aqee,illidan,1245,warrior,arms,66,37,29
Hashwar,area-52,1245,warrior,arms,24,13,11
Tankomode,area-52,1245,warrior,arms,30,13,17
Reichbeast,area-52,1244,warrior,arms,18,13,5
Rarelinew,malganis,1244,warrior,arms,18,13,5
Rollz,amanthul,1244,warrior,arms,52,22,30
Nativê,sargeras,1244,warrior,arms,36,13,23
Flèx,stormrage,1243,warrior,arms,24,13,11
Mokrog,bleeding-hollow,1243,warrior,arms,24,13,11
Andorane,bleeding-hollow,1243,warrior,arms,24,13,11
Dutchyy,frostmourne,1243,warrior,arms,24,13,11
Malvicious,proudmoore,1243,warrior,arms,24,13,11
Antoníuz,drakkari,1243,warrior,arms,42,16,26
Flexinbooty,kelthuzad,1243,warrior,arms,36,13,23
Dukagã,tichondrius,1242,warrior,arms,18,13,5
Ystk,tichondrius,1242,warrior,arms,24,13,11
Thunderclapz,stormscale,1242,warrior,arms,30,16,14
Hoshigaki,frostmourne,1242,warrior,arms,65,32,33
Metalbiff,bleeding-hollow,1242,warrior,arms,30,13,17
Gíal,ragnaros,1242,warrior,arms,64,26,38
Titanika,wyrmrest-accord,1242,warrior,arms,72,28,44
Gaydin,eldrethalas,1242,warrior,arms,39,15,24
Ragedump,shadowsong,1241,warrior,arms,26,13,13
Titanrage,tichondrius,1241,warrior,arms,32,14,18
Qtxd,malganis,1240,warrior,arms,24,13,11
Broxhar,ragnaros,1240,warrior,arms,53,26,27
Deamonkiller,kelthuzad,1240,warrior,arms,103,45,58
Rahj,caelestrasz,1240,warrior,arms,30,13,17
Jaminos,frostmourne,1240,warrior,arms,51,22,29
Ðhrâgøn,ragnaros,1239,warrior,arms,18,15,3
Airhood,frostmourne,1239,warrior,arms,18,13,5
Mezi,tichondrius,1239,warrior,arms,62,32,30
Mitigation,hyjal,1239,warrior,arms,34,15,19
Seniorsherk,dalaran,1239,warrior,arms,35,15,20
Retrostorm,illidan,1238,warrior,arms,24,13,11
Depthsii,lightbringer,1238,warrior,arms,30,14,16
Etothed,stormrage,1238,warrior,arms,30,13,17
Rasazghal,darrowmere,1238,warrior,arms,93,32,61
Ragelol,icecrown,1237,warrior,arms,24,13,11
Lokiilloo,drakkari,1237,warrior,arms,97,48,49
Deathengine,area-52,1237,warrior,arms,29,14,15
Torkus,ragnaros,1237,warrior,arms,76,35,41
Nerròk,wyrmrest-accord,1236,warrior,arms,30,13,17
Tallix,smolderthorn,1235,warrior,arms,24,13,11
Macray,proudmoore,1235,warrior,arms,24,13,11
Warrshield,ragnaros,1235,warrior,arms,95,45,50
Rahgnarson,kelthuzad,1235,warrior,arms,42,13,29
Nickfurie,emerald-dream,1234,warrior,arms,24,13,11
Odinsglory,mugthol,1234,warrior,arms,188,89,99
Rockedanger,stormrage,1233,warrior,arms,38,22,16
Dieselsauce,stormscale,1233,warrior,arms,42,24,18
Flycosmos,tichondrius,1233,warrior,arms,121,62,59
Ådolf,sargeras,1233,warrior,arms,38,19,19
Nosfuratuzod,frostmourne,1233,warrior,arms,49,22,27
Standsonkegs,illidan,1233,warrior,arms,30,13,17
Grizzlefish,feathermoon,1233,warrior,arms,72,30,42
Bananae,stormrage,1232,warrior,arms,21,14,7
Pandaniela,area-52,1232,warrior,arms,30,18,12
Goldbêrg,malganis,1232,warrior,arms,24,13,11
Heojae,tichondrius,1232,warrior,arms,24,13,11
Vobiscum,drakkari,1232,warrior,arms,30,14,16
Deesad,azralon,1231,warrior,arms,28,14,14
Hôdû,tichondrius,1231,warrior,arms,87,40,47
Wankcelot,kiljaeden,1231,warrior,arms,48,21,27
Moonsworn,moon-guard,1231,warrior,arms,30,13,17
Ðirtyboy,tichondrius,1231,warrior,arms,36,13,23
Siegfriéd,bleeding-hollow,1231,warrior,arms,47,16,31
Eternalwill,rexxar,1229,warrior,arms,24,13,11
Bloodfx,darkspear,1229,warrior,arms,138,68,70
Gorash,gundrak,1229,warrior,arms,111,54,57
Thunderbash,thrall,1229,warrior,arms,36,13,23
Jrodrick,nemesis,1229,warrior,arms,49,16,33
Awkagar,hyjal,1228,warrior,arms,23,13,10
Jaens,quelthalas,1228,warrior,arms,36,15,21
Asarg,emerald-dream,1227,warrior,arms,36,23,13
Rebelzudo,azralon,1227,warrior,arms,48,29,19
Babyweenis,sargeras,1226,warrior,arms,18,13,5
Lükë,zuluhed,1226,warrior,arms,24,13,11
Pallus,korgath,1226,warrior,arms,24,13,11
Celt,uldum,1226,warrior,arms,31,15,16
Malystik,ragnaros,1225,warrior,arms,93,49,44
Drdrip,shuhalo,1225,warrior,arms,63,29,34
Tunchi,runetotem,1224,warrior,arms,90,47,43
Armorlancer,stormrage,1223,warrior,arms,24,13,11
Warrage,kiljaeden,1223,warrior,arms,103,55,48
Philbert,alexstrasza,1223,warrior,arms,123,65,58
Ahore,illidan,1223,warrior,arms,36,14,22
Spincity,stormrage,1222,warrior,arms,30,16,14
Aelrog,malganis,1222,warrior,arms,188,96,92
Avesielli,dalaran,1221,warrior,arms,24,13,11
Arthknight,ragnaros,1221,warrior,arms,30,15,15
Daddymoist,moon-guard,1220,warrior,arms,60,29,31
Kuchikilla,borean-tundra,1219,warrior,arms,100,48,52
Sugarpanties,moon-guard,1219,warrior,arms,93,42,51
Xowarr,borean-tundra,1219,warrior,arms,29,13,16
Bladereaver,sargeras,1218,warrior,arms,24,13,11
Slivers,stormrage,1218,warrior,arms,30,16,14
Varekai,frostmourne,1218,warrior,arms,74,34,40
Ðwârf,tichondrius,1218,warrior,arms,46,17,29
Royye,blood-furnace,1217,warrior,arms,30,16,14
Zeldrissx,quelthalas,1217,warrior,arms,50,19,31
Rhydonero,azralon,1216,warrior,arms,47,26,21
Baghatur,tichondrius,1216,warrior,arms,30,15,15
Dungs,emerald-dream,1216,warrior,arms,46,22,24
Pangean,sargeras,1216,warrior,arms,42,18,24
Akunaswar,dalaran,1215,warrior,arms,89,41,48
Dsz,nemesis,1215,warrior,arms,53,24,29
Tuf,malygos,1214,warrior,arms,66,31,35
Vâìn,tichondrius,1214,warrior,arms,34,15,19
Dippindabz,area-52,1213,warrior,arms,47,26,21
Colapse,zuljin,1213,warrior,arms,30,13,17
Truongx,kiljaeden,1212,warrior,arms,24,14,10
Ediict,illidan,1212,warrior,arms,29,13,16
Çleåvage,stormrage,1212,warrior,arms,49,18,31
Lilsweet,moon-guard,1211,warrior,arms,39,25,14
Hazorl,zuljin,1210,warrior,arms,30,16,14
Brianya,moon-guard,1210,warrior,arms,30,13,17
Winjerrywin,frostwolf,1209,warrior,arms,46,26,20
Raserei,moonrunner,1209,warrior,arms,136,70,66
Gunnaoffxans,sargeras,1209,warrior,arms,30,14,16
Brozown,wildhammer,1209,warrior,arms,32,14,18
Rageloading,amanthul,1208,warrior,arms,36,18,18
Baadomishram,ragnaros,1208,warrior,arms,30,14,16
Soulcalibur,zuljin,1208,warrior,arms,29,13,16
Kannerhus,quelthalas,1207,warrior,arms,103,49,54
Yiffathon,wyrmrest-accord,1207,warrior,arms,87,37,50
Deadhofe,azuremyst,1205,warrior,arms,33,16,17
Eniaan,khaz-modan,1204,warrior,arms,24,13,11
Hintofmint,tichondrius,1204,warrior,arms,56,30,26
Diamict,wyrmrest-accord,1204,warrior,arms,86,43,43
Demðnslayer,kelthuzad,1204,warrior,arms,67,33,34
Xzqtz,tichondrius,1204,warrior,arms,50,24,26
Aràthor,stormrage,1204,warrior,arms,113,52,61
Hkbdynamus,black-dragonflight,1203,warrior,arms,42,18,24
Toky,malganis,1202,warrior,arms,24,13,11
Rageorade,area-52,1202,warrior,arms,29,13,16
Colnar,stormrage,1202,warrior,arms,30,13,17
Vapòr,frostmourne,1201,warrior,arms,24,14,10
Bigolpeen,sargeras,1201,warrior,arms,42,23,19
Tolette,quelthalas,1201,warrior,arms,24,13,11
Luckybrother,tichondrius,1200,warrior,arms,98,51,47
Newtommi,barthilas,1200,warrior,arms,54,27,27
Kapalua,darkspear,1200,warrior,arms,45,21,24
Aspxt,saurfang,1200,warrior,arms,66,30,36
Dissx,illidan,1200,warrior,arms,55,24,31
Friendnoodle,frostmourne,1199,warrior,arms,59,28,31
Kiddoe,rivendare,1199,warrior,arms,84,39,45
Munchiesxqc,exodar,1199,warrior,arms,68,25,43
Theregulator,area-52,1198,warrior,arms,76,40,36
Aggor,trollbane,1198,warrior,arms,36,13,23
Aclipse,nagrand,1197,warrior,arms,65,34,31
Buliwyff,wyrmrest-accord,1197,warrior,arms,57,28,29
Koteketzu,ragnaros,1196,warrior,arms,47,29,18
Flexakute,malganis,1196,warrior,arms,24,14,10
Darkhorv,frostmourne,1196,warrior,arms,23,13,10
Shotgunzx,tichondrius,1195,warrior,arms,27,13,14
Bootstraps,hyjal,1195,warrior,arms,90,41,49
Rargou,illidan,1194,warrior,arms,23,13,10
Iridikron,dalaran,1194,warrior,arms,30,13,17
Khåyman,illidan,1194,warrior,arms,42,15,27
Saero,ragnaros,1193,warrior,arms,30,13,17
Your,emerald-dream,1192,warrior,arms,24,13,11
Thedargz,trollbane,1191,warrior,arms,134,71,63
Calynn,frostmourne,1191,warrior,arms,288,137,151
Ontull,emerald-dream,1191,warrior,arms,42,13,29
Bazironbeard,ravencrest,1190,warrior,arms,17,13,4
Annaliyah,wyrmrest-accord,1190,warrior,arms,66,36,30
Baroque,darkspear,1190,warrior,arms,24,13,11
Areiden,sargeras,1190,warrior,arms,48,16,32
Aistine,alterac-mountains,1189,warrior,arms,36,18,18
Tomcruisé,ragnaros,1188,warrior,arms,21,15,6
Märx,barthilas,1187,warrior,arms,32,15,17
Gohawn,hyjal,1186,warrior,arms,37,20,17
Axharafuji,dalvengyr,1186,warrior,arms,78,35,43
Lazyclap,nagrand,1185,warrior,arms,41,21,20
Kreyonz,hyjal,1184,warrior,arms,30,14,16
Olgran,drakkari,1183,warrior,arms,71,32,39
Jamajuicedx,thrall,1183,warrior,arms,29,13,16
Cowbøycrytoo,azralon,1182,warrior,arms,88,46,42
Degentradorz,area-52,1182,warrior,arms,111,53,58
Rios,jubeithos,1182,warrior,arms,36,14,22
Avoraçado,nemesis,1181,warrior,arms,127,51,76
Mangler,tichondrius,1180,warrior,arms,48,19,29
Tobiwan,ragnaros,1179,warrior,arms,36,16,20
Bifilar,frostmourne,1178,warrior,arms,54,23,31
Archonian,stormscale,1177,warrior,arms,40,24,16
Amaus,queldorei,1177,warrior,arms,27,14,13
Skumwarr,moon-guard,1177,warrior,arms,64,25,39
Orcbreaker,quelthalas,1176,warrior,arms,38,18,20
Ibizà,tichondrius,1176,warrior,arms,48,18,30
Fkndog,tichondrius,1175,warrior,arms,78,36,42
Zarrock,emerald-dream,1174,warrior,arms,26,14,12
Secsecute,moon-guard,1174,warrior,arms,30,13,17
Süspicious,malfurion,1174,warrior,arms,35,14,21
Dorianfrost,ravenholdt,1173,warrior,arms,102,33,69
Lololosda,quelthalas,1172,warrior,arms,78,42,36
Rrawrr,bleeding-hollow,1172,warrior,arms,44,23,21
Droogust,tichondrius,1172,warrior,arms,30,15,15
Southmariner,malganis,1172,warrior,arms,78,38,40
Badbrain,barthilas,1172,warrior,arms,29,13,16
Rauh,emerald-dream,1171,warrior,arms,22,13,9
Sherway,quelthalas,1171,warrior,arms,240,118,122
Stoul,illidan,1168,warrior,arms,30,22,8
Rockley,mugthol,1168,warrior,arms,48,19,29
Khâi,tichondrius,1168,warrior,arms,33,13,20
Robotríp,illidan,1167,warrior,arms,64,29,35
Kì,moon-guard,1166,warrior,arms,102,53,49
Nosetackle,area-52,1166,warrior,arms,64,31,33
Adunken,ragnaros,1165,warrior,arms,30,17,13
Grömäash,ragnaros,1165,warrior,arms,32,13,19
Tsmcsuckmyd,tichondrius,1163,warrior,arms,35,22,13
Thebruce,nemesis,1163,warrior,arms,130,63,67
Puertorc,ragnaros,1163,warrior,arms,36,17,19
Gongos,doomhammer,1161,warrior,arms,207,107,100
Orcaine,ursin,1160,warrior,arms,44,28,16
Mortilant,perenolde,1160,warrior,arms,75,34,41
Ãleister,stormrage,1160,warrior,arms,63,25,38
Enthria,illidan,1159,warrior,arms,96,49,47
Ogpapabear,stormscale,1158,warrior,arms,63,21,42
Stolz,dragonmaw,1157,warrior,arms,30,13,17
Angryskeever,garona,1156,warrior,arms,48,25,23
Tomatogodx,sargeras,1156,warrior,arms,31,15,16
Elpish,ragnaros,1154,warrior,arms,66,31,35
Magnuszx,zuljin,1152,warrior,arms,18,12,6
Pathelsonsus,stormrage,1152,warrior,arms,30,12,18
Atomiclol,area-52,1151,warrior,arms,18,12,6
Dpsmachinex,tichondrius,1151,warrior,arms,18,12,6
Renaissancex,tichondrius,1151,warrior,arms,24,12,12
Moxxyy,tichondrius,1151,warrior,arms,24,12,12
Varrior,wyrmrest-accord,1151,warrior,arms,24,12,12
Turecw,illidan,1151,warrior,arms,24,12,12
Njjszn,thrall,1151,warrior,arms,226,110,116
Soultarius,sargeras,1151,warrior,arms,33,13,20
Pkgdtko,tichondrius,1150,warrior,arms,18,12,6
Hàru,illidan,1150,warrior,arms,18,12,6
Einnarr,tichondrius,1150,warrior,arms,19,12,7
Vezixx,dragonmaw,1150,warrior,arms,30,17,13
Nexgenwar,destromath,1150,warrior,arms,24,12,12
Ragemane,illidan,1150,warrior,arms,27,13,14
Shewar,ragnaros,1150,warrior,arms,27,12,15
Mercystaling,tichondrius,1150,warrior,arms,30,12,18
Jarheadz,bleeding-hollow,1150,warrior,arms,35,12,23
Jaytoo,illidan,1149,warrior,arms,18,12,6
Gordofofo,azralon,1149,warrior,arms,18,12,6
Iblowloads,illidan,1149,warrior,arms,24,14,10
Aiforix,gorefiend,1149,warrior,arms,45,25,20
Scaredwarr,stormrage,1149,warrior,arms,45,24,21
Doucherocket,kelthuzad,1149,warrior,arms,24,12,12
Zerosends,kelthuzad,1149,warrior,arms,30,12,18
Chestbrook,icecrown,1148,warrior,arms,18,12,6
Kamuwarr,azralon,1148,warrior,arms,24,12,12
Gladìus,area-52,1148,warrior,arms,24,12,12
Fulreck,tichondrius,1148,warrior,arms,24,12,12
Shino,garona,1148,warrior,arms,24,12,12
Pezek,thrall,1148,warrior,arms,26,12,14
Suicider,stormrage,1148,warrior,arms,30,12,18
Vodkagoblin,sargeras,1147,warrior,arms,24,12,12
Misclickëd,dalaran,1147,warrior,arms,24,12,12
Virillius,wyrmrest-accord,1147,warrior,arms,28,13,15
Jianhung,tichondrius,1147,warrior,arms,30,12,18
Hektar,tichondrius,1146,warrior,arms,18,12,6
Stompyocouch,mugthol,1146,warrior,arms,21,13,8
Tramplehaste,barthilas,1146,warrior,arms,30,18,12
Furryhorv,frostmourne,1146,warrior,arms,24,12,12
Maleap,moon-guard,1146,warrior,arms,24,12,12
Nebraskapete,wyrmrest-accord,1146,warrior,arms,24,12,12
Ikitee,zuljin,1146,warrior,arms,24,12,12
Alejandrica,ragnaros,1146,warrior,arms,30,12,18
Plssaveme,ysera,1146,warrior,arms,68,27,41
Ragnarloðbró,tichondrius,1146,warrior,arms,36,12,24
Itskinggrizz,thrall,1145,warrior,arms,22,13,9
Struka,drakkari,1145,warrior,arms,24,12,12
Davlar,ragnaros,1145,warrior,arms,33,14,19
Skizoid,kiljaeden,1144,warrior,arms,18,12,6
Skittlesxo,bleeding-hollow,1144,warrior,arms,24,12,12
Rezzett,wyrmrest-accord,1144,warrior,arms,27,13,14
Dúmßlòwn,tichondrius,1144,warrior,arms,165,76,89
Funderr,eonar,1144,warrior,arms,45,19,26
Awm,wyrmrest-accord,1144,warrior,arms,30,12,18
Sartin,boulderfist,1144,warrior,arms,42,14,28
Invared,stormrage,1143,warrior,arms,18,12,6
Marvél,quelthalas,1143,warrior,arms,173,83,90
Xyazhiro,ragnaros,1143,warrior,arms,90,42,48
Bladeblade,burning-blade,1143,warrior,arms,27,12,15
Matutekz,ragnaros,1143,warrior,arms,36,12,24
Nibbzy,sargeras,1142,warrior,arms,18,12,6
Lucidx,malfurion,1142,warrior,arms,18,12,6
Haldeer,shadow-council,1142,warrior,arms,24,12,12
Realthiccbbw,tichondrius,1142,warrior,arms,24,12,12
Dracossack,ragnaros,1142,warrior,arms,47,17,30
Crnogorac,hakkar,1141,warrior,arms,18,12,6
Elmosmash,thrall,1141,warrior,arms,24,12,12
Yisunshin,azralon,1141,warrior,arms,24,12,12
Strongtall,tichondrius,1141,warrior,arms,36,15,21
Saskouach,stormrage,1140,warrior,arms,26,12,14
Thanitose,bleeding-hollow,1139,warrior,arms,24,12,12
Brocc,tichondrius,1139,warrior,arms,24,12,12
Empriux,quelthalas,1139,warrior,arms,30,12,18
Mnoga,azralon,1139,warrior,arms,55,18,37
Gristly,sargeras,1138,warrior,arms,18,12,6
Baloz,tichondrius,1138,warrior,arms,30,13,17
Tappia,quelthalas,1138,warrior,arms,36,12,24
Plugz,sargeras,1137,warrior,arms,28,14,14
Maxalyss,stormrage,1137,warrior,arms,24,12,12
Aztecvil,drakkari,1137,warrior,arms,30,12,18
Soggynapkin,proudmoore,1136,warrior,arms,30,17,13
Gageoddord,kiljaeden,1136,warrior,arms,24,12,12
Purefury,whisperwind,1136,warrior,arms,99,46,53
Nabii,tichondrius,1136,warrior,arms,30,12,18
Zulgadark,ragnaros,1136,warrior,arms,39,15,24
Èox,barthilas,1135,warrior,arms,18,12,6
Drahconian,aggramar,1134,warrior,arms,24,12,12
Shattering,fizzcrank,1134,warrior,arms,24,12,12
Dhano,drakkari,1134,warrior,arms,60,25,35
Soníco,area-52,1134,warrior,arms,29,12,17
Areuz,azralon,1133,warrior,arms,22,13,9
Angelsantos,sargeras,1133,warrior,arms,24,12,12
Cocainiouz,dalaran,1133,warrior,arms,48,21,27
Yamato,skywall,1133,warrior,arms,30,12,18
Loktarrogar,illidan,1133,warrior,arms,30,12,18
Kilrok,thunderlord,1133,warrior,arms,42,12,30
Diãbel,azralon,1132,warrior,arms,18,12,6
Tripleblack,mugthol,1132,warrior,arms,18,12,6
Isildur,nerzhul,1132,warrior,arms,36,20,16
Otheralex,kiljaeden,1132,warrior,arms,24,12,12
Joed,quelthalas,1132,warrior,arms,96,45,51
Sudavis,alleria,1131,warrior,arms,61,36,25
Édton,area-52,1131,warrior,arms,72,36,36
Bigsvit,trollbane,1131,warrior,arms,60,29,31
Kiayla,quelthalas,1131,warrior,arms,195,87,108
Spritez,malganis,1131,warrior,arms,70,27,43
Diegoreo,drakkari,1130,warrior,arms,32,13,19
Inunotaysho,quelthalas,1129,warrior,arms,54,22,32
Genesisxp,barthilas,1129,warrior,arms,30,12,18
Irishhammer,malfurion,1129,warrior,arms,41,15,26
Lunks,kelthuzad,1128,warrior,arms,18,12,6
Mogruk,stonemaul,1128,warrior,arms,36,14,22
Elix,stormscale,1127,warrior,arms,24,12,12
Bulletfodder,tichondrius,1127,warrior,arms,24,12,12
Angitu,quelthalas,1124,warrior,arms,24,14,10
Úmarth,azralon,1124,warrior,arms,60,29,31
Raharon,chogall,1124,warrior,arms,61,26,35
Demetrïus,moon-guard,1122,warrior,arms,30,12,18
Carrito,perenolde,1120,warrior,arms,47,26,21
Ambiss,azjolnerub,1120,warrior,arms,47,21,26
Slumdawgg,andorhal,1119,warrior,arms,59,32,27
Sarget,ragnaros,1119,warrior,arms,48,24,24
Vaclein,quelthalas,1119,warrior,arms,54,24,30
Swiftynifty,area-52,1118,warrior,arms,48,29,19
Clovê,ragnaros,1118,warrior,arms,36,21,15
Knocks,blackrock,1118,warrior,arms,44,24,20
Aersasi,tichondrius,1117,warrior,arms,24,13,11
Rahtahtas,area-52,1116,warrior,arms,24,12,12
Buffalobob,bronzebeard,1115,warrior,arms,24,12,12
Hemone,frostmourne,1114,warrior,arms,30,15,15
Ereborh,ragnaros,1114,warrior,arms,24,12,12
Containerbox,korgath,1112,warrior,arms,42,18,24
Casteleiro,azralon,1112,warrior,arms,32,13,19
Alejandros,azgalor,1111,warrior,arms,23,12,11
Warriorlee,jubeithos,1111,warrior,arms,44,19,25
Brysontiller,frostmourne,1110,warrior,arms,23,12,11
Turkin,proudmoore,1110,warrior,arms,30,12,18
Tyférious,tichondrius,1110,warrior,arms,68,27,41
Wastenott,area-52,1109,warrior,arms,30,19,11
Thedoofy,blackrock,1109,warrior,arms,39,20,19
Iwishiknew,kargath,1109,warrior,arms,30,12,18
Locotto,ragnaros,1109,warrior,arms,48,16,32
Rineer,tichondrius,1108,warrior,arms,30,12,18
Youtank,kiljaeden,1105,warrior,arms,78,36,42
Dvhwec,tichondrius,1105,warrior,arms,28,12,16
Xandrak,barthilas,1103,warrior,arms,47,25,22
Marcolatus,ragnaros,1103,warrior,arms,102,50,52
Baultenaz,draenor,1102,warrior,arms,23,12,11
Tipincider,perenolde,1100,warrior,arms,21,12,9
Hagud,tichondrius,1099,warrior,arms,65,26,39
Anotee,kelthuzad,1098,warrior,arms,135,68,67
Wtbfriends,malganis,1097,warrior,arms,29,15,14
Riga,tichondrius,1097,warrior,arms,51,25,26
Kreeper,farstriders,1097,warrior,arms,28,13,15
Garìk,moon-guard,1097,warrior,arms,99,41,58
Panzerian,area-52,1097,warrior,arms,37,14,23
Forevercute,proudmoore,1096,warrior,arms,23,14,9
Theøcritus,korgath,1096,warrior,arms,42,25,17
Eiendira,proudmoore,1096,warrior,arms,32,13,19
Jägernaught,stormrage,1095,warrior,arms,29,12,17
Melankoma,sargeras,1094,warrior,arms,30,12,18
Arrogated,emerald-dream,1093,warrior,arms,90,44,46
Nanaru,tichondrius,1090,warrior,arms,41,16,25
Charcharbinx,zuljin,1090,warrior,arms,48,18,30
Racky,dragonmaw,1089,warrior,arms,28,12,16
Padalouh,kelthuzad,1089,warrior,arms,48,19,29
Ujumpijump,andorhal,1089,warrior,arms,84,32,52
Bloren,thrall,1085,warrior,arms,30,14,16
Jiszle,sargeras,1085,warrior,arms,34,12,22
Agresvnapkin,dalaran,1084,warrior,arms,20,12,8
Ragebladë,tichondrius,1083,warrior,arms,89,49,40
Kempachii,ragnaros,1083,warrior,arms,82,40,42
Aquannas,bloodscalp,1082,warrior,arms,24,14,10
Pingorosho,quelthalas,1082,warrior,arms,36,16,20
Malok,deathwing,1082,warrior,arms,57,20,37
Orcopata,ragnaros,1081,warrior,arms,26,12,14
Riuk,goldrinn,1080,warrior,arms,29,16,13
Gorfin,spirestone,1077,warrior,arms,42,12,30
Chisum,gnomeregan,1075,warrior,arms,52,29,23
Several,whisperwind,1073,warrior,arms,39,23,16
Beansgohard,deathwing,1073,warrior,arms,27,12,15
Plsmilkme,zuljin,1072,warrior,arms,24,16,8
Ødïñ,sargeras,1071,warrior,arms,75,37,38
Victorhugo,ragnaros,1071,warrior,arms,28,12,16
Ashanthaa,kelthuzad,1071,warrior,arms,30,12,18
Yuccaleaptus,area-52,1070,warrior,arms,77,31,46
Geoorg,ragnaros,1067,warrior,arms,71,28,43
Karroww,thrall,1066,warrior,arms,24,15,9
Helandas,moknathal,1066,warrior,arms,193,93,100
Axedeity,caelestrasz,1063,warrior,arms,81,45,36
Thebeastwar,area-52,1062,warrior,arms,66,33,33
Krömm,kilrogg,1061,warrior,arms,48,25,23
Ugrundan,zuljin,1061,warrior,arms,48,21,27
Bussundas,azralon,1059,warrior,arms,78,35,43
Outterspace,illidan,1056,warrior,arms,18,11,7
Midorikwa,area-52,1056,warrior,arms,18,11,7
Soyu,tichondrius,1056,warrior,arms,22,12,10
Wizcleavuh,area-52,1056,warrior,arms,24,11,13
Raime,sargeras,1056,warrior,arms,24,11,13
Evanx,sargeras,1056,warrior,arms,24,11,13
Golodiso,mugthol,1056,warrior,arms,24,11,13
Paletona,emerald-dream,1056,warrior,arms,24,11,13
Pkgd,tichondrius,1055,warrior,arms,12,11,1
Hotshótz,kelthuzad,1055,warrior,arms,12,11,1
Sonwar,azralon,1055,warrior,arms,18,11,7
Warronin,kaelthas,1055,warrior,arms,18,11,7
Thuggyfresh,malganis,1055,warrior,arms,18,11,7
Turtlestorm,tichondrius,1055,warrior,arms,18,11,7
Gladiator,azshara,1055,warrior,arms,18,11,7
Jeffesptein,tichondrius,1055,warrior,arms,18,11,7
Breyns,garrosh,1055,warrior,arms,25,12,13
Carriney,illidan,1055,warrior,arms,77,36,41
Sonicboom,whisperwind,1055,warrior,arms,24,11,13
Duckyuwu,tichondrius,1055,warrior,arms,24,11,13
Feedzz,area-52,1055,warrior,arms,24,11,13
Abomlnatlon,tichondrius,1055,warrior,arms,24,11,13
Faronstompz,sargeras,1055,warrior,arms,24,11,13
Imcute,senjin,1055,warrior,arms,78,30,48
Gangdamn,frostmourne,1055,warrior,arms,36,11,25
Vooné,tichondrius,1054,warrior,arms,18,11,7
Chopped,wyrmrest-accord,1054,warrior,arms,18,11,7
Relaxnerdlol,antonidas,1054,warrior,arms,18,11,7
Fallenguardx,sargeras,1054,warrior,arms,18,11,7
Chonbi,tichondrius,1054,warrior,arms,18,11,7
Executiepie,hyjal,1054,warrior,arms,18,11,7
Mikero,terenas,1054,warrior,arms,24,11,13
Vexwar,bleeding-hollow,1054,warrior,arms,24,11,13
Boouuaakk,tichondrius,1054,warrior,arms,24,11,13
Wolfsrage,frostmourne,1054,warrior,arms,30,11,19
Shöthetank,area-52,1054,warrior,arms,30,11,19
Hawkior,moon-guard,1053,warrior,arms,18,11,7
Nfx,tichondrius,1053,warrior,arms,18,11,7
Anabolics,bleeding-hollow,1053,warrior,arms,18,11,7
Ttl,dalaran,1053,warrior,arms,18,11,7
Iwooglybool,icecrown,1053,warrior,arms,18,11,7
Stiffysword,tanaris,1053,warrior,arms,30,14,16
Sawsyy,kelthuzad,1053,warrior,arms,27,11,16
Fortchin,area-52,1053,warrior,arms,30,11,19
Elbelgon,ragnaros,1052,warrior,arms,18,11,7
Adryina,zuljin,1052,warrior,arms,18,11,7
Carrange,moon-guard,1052,warrior,arms,24,11,13
Chiêfatriox,tichondrius,1052,warrior,arms,24,11,13
Kaìju,dragonmaw,1052,warrior,arms,24,11,13
Kàkarot,illidan,1051,warrior,arms,18,11,7
Envision,frostmourne,1051,warrior,arms,24,11,13
Drob,malganis,1051,warrior,arms,24,11,13
Drillbit,wyrmrest-accord,1051,warrior,arms,30,11,19
Humminity,quelthalas,1051,warrior,arms,32,11,21
Georgedubya,illidan,1051,warrior,arms,36,11,25
Slasherman,illidan,1051,warrior,arms,36,11,25
Spacepants,azjolnerub,1050,warrior,arms,16,12,4
Angrybulky,illidan,1050,warrior,arms,18,11,7
Thecolor,tichondrius,1050,warrior,arms,30,11,19
Crul,gurubashi,1050,warrior,arms,31,11,20
Myceliumlog,frostmourne,1049,warrior,arms,18,11,7
Halis,illidan,1049,warrior,arms,27,16,11
Arroezze,earthen-ring,1049,warrior,arms,25,12,13
Plagueis,dark-iron,1049,warrior,arms,24,11,13
Gadderhammer,azgalor,1049,warrior,arms,42,17,25
Clortho,korialstrasz,1049,warrior,arms,40,16,24
Sneakyhand,draktharon,1048,warrior,arms,18,11,7
Wixer,illidan,1048,warrior,arms,18,11,7
Snewdawg,malganis,1048,warrior,arms,22,12,10
Jamil,illidan,1048,warrior,arms,156,75,81
Noktyn,haomarush,1048,warrior,arms,24,11,13
Kanekhy,ragnaros,1048,warrior,arms,24,11,13
Pneumasmash,tichondrius,1048,warrior,arms,24,11,13
Castedien,quelthalas,1048,warrior,arms,36,11,25
Bøgz,kelthuzad,1047,warrior,arms,18,11,7
Peepeeboi,blackrock,1047,warrior,arms,18,11,7
Bouk,bloodscalp,1047,warrior,arms,18,11,7
Dwarfanage,tichondrius,1047,warrior,arms,28,12,16
Rankjuan,area-52,1047,warrior,arms,30,11,19
Prunebery,area-52,1046,warrior,arms,30,16,14
Blaxst,gorgonnash,1046,warrior,arms,30,16,14
Nirax,burning-legion,1046,warrior,arms,26,11,15
Rottlingberg,kelthuzad,1046,warrior,arms,30,11,19
Lögän,azralon,1046,warrior,arms,30,11,19
Jfordnever,area-52,1045,warrior,arms,18,11,7
Warrpool,shadowmoon,1045,warrior,arms,18,11,7
Swàgnáros,area-52,1045,warrior,arms,18,11,7
Hugz,thrall,1045,warrior,arms,30,11,19
Tasërface,hakkar,1045,warrior,arms,36,11,25
Milkshake,stormrage,1045,warrior,arms,36,11,25
Fabszord,nemesis,1044,warrior,arms,40,20,20
Orphasmic,moon-guard,1044,warrior,arms,36,11,25
Walmir,shadow-council,1043,warrior,arms,18,11,7
Eqz,area-52,1043,warrior,arms,18,11,7
Nachobeef,illidan,1043,warrior,arms,24,11,13
Svênd,ragnaros,1042,warrior,arms,30,12,18
Alondir,quelthalas,1042,warrior,arms,30,11,19
Creator,dalaran,1041,warrior,arms,24,11,13
Greenmachine,twisting-nether,1040,warrior,arms,30,11,19
Notakîd,stormrage,1039,warrior,arms,24,11,13
Loaksz,tichondrius,1038,warrior,arms,24,11,13
Rágnárr,ragnaros,1038,warrior,arms,30,13,17
Dylaiin,kelthuzad,1038,warrior,arms,30,11,19
Wrekkshop,tichondrius,1037,warrior,arms,27,13,14
Wrrx,frostmourne,1037,warrior,arms,24,11,13
Ligerii,quelthalas,1036,warrior,arms,24,11,13
Deathsmirk,illidan,1034,warrior,arms,61,32,29
Regthar,illidan,1034,warrior,arms,23,11,12
Indoondabeat,azgalor,1034,warrior,arms,32,15,17
Portersz,korgath,1034,warrior,arms,24,11,13
Layoon,azralon,1033,warrior,arms,25,12,13
Nobowar,tichondrius,1032,warrior,arms,24,11,13
Radeox,ragnaros,1032,warrior,arms,25,11,14
Pegaso,the-underbog,1032,warrior,arms,29,12,17
Beardoff,sargeras,1031,warrior,arms,28,14,14
Raokao,senjin,1031,warrior,arms,30,11,19
Burgdur,sargeras,1031,warrior,arms,54,19,35
Stalecrouton,doomhammer,1030,warrior,arms,18,11,7
Potan,thrall,1030,warrior,arms,60,25,35
Uglycubano,quelthalas,1029,warrior,arms,24,11,13
Märiä,ragnaros,1028,warrior,arms,52,27,25
Thråsh,area-52,1028,warrior,arms,66,33,33
Bradshaw,sargeras,1028,warrior,arms,36,15,21
Cronie,steamwheedle-cartel,1027,warrior,arms,36,16,20
Yerajmiel,proudmoore,1026,warrior,arms,18,11,7
Inuyasha,korgath,1023,warrior,arms,52,31,21
Unterg,ragnaros,1021,warrior,arms,36,17,19
Abidis,tichondrius,1021,warrior,arms,35,11,24
Nøzerker,kelthuzad,1020,warrior,arms,26,12,14
Macdollibee,barthilas,1017,warrior,arms,42,22,20
Guanyúu,tichondrius,1017,warrior,arms,23,11,12
Orcimonde,arthas,1017,warrior,arms,28,11,17
Stygïàn,draenor,1016,warrior,arms,80,45,35
Hazew,kelthuzad,1016,warrior,arms,23,11,12
Nashallo,zuljin,1015,warrior,arms,24,11,13
Galuf,malygos,1014,warrior,arms,18,11,7
Gargameld,stormrage,1012,warrior,arms,53,29,24
Coffetea,area-52,1011,warrior,arms,41,25,16
Psýchótic,tichondrius,1009,warrior,arms,23,11,12
Hexenbæne,tichondrius,1006,warrior,arms,23,11,12
Bingchilly,aegwynn,1004,warrior,arms,21,12,9
Tsebaoth,quelthalas,1004,warrior,arms,78,38,40
Starplatinum,aerie-peak,1004,warrior,arms,32,11,21
Brutallypwnd,tichondrius,1002,warrior,arms,53,29,24
Gorepig,sargeras,1002,warrior,arms,29,11,18
Hugewarrior,area-52,1001,warrior,arms,21,12,9
Imgunnacrum,malganis,1001,warrior,arms,28,14,14
Tandiko,wyrmrest-accord,999,warrior,arms,23,11,12
Borgee,tichondrius,999,warrior,arms,30,12,18
Wasabiz,tichondrius,999,warrior,arms,66,25,41
Lieutemajor,nemesis,998,warrior,arms,55,27,28
Goofyahwok,doomhammer,998,warrior,arms,33,12,21
Fûry,tichondrius,997,warrior,arms,136,63,73
Altruiel,sargeras,995,warrior,arms,40,20,20
Kyritto,azralon,994,warrior,arms,35,18,17
Vicor,ragnaros,993,warrior,arms,42,22,20
Orkuduro,azralon,993,warrior,arms,77,37,40
Ankhxiety,sargeras,993,warrior,arms,26,12,14
Kiggzs,tichondrius,991,warrior,arms,14,11,3
Tmhinfen,tichondrius,991,warrior,arms,16,11,5
Szee,tichondrius,991,warrior,arms,17,11,6
Jragonmaster,borean-tundra,991,warrior,arms,36,13,23
Billy,area-52,990,warrior,arms,14,11,3
Aggripa,kelthuzad,990,warrior,arms,20,11,9
Armada,sargeras,990,warrior,arms,20,11,9
Neekka,tichondrius,990,warrior,arms,28,12,16
Kalaxe,quelthalas,990,warrior,arms,36,11,25
Brownman,saurfang,989,warrior,arms,30,12,18
Ulnaz,stormrage,988,warrior,arms,18,12,6
Ibba,khazgoroth,988,warrior,arms,27,12,15
Wardeád,quelthalas,988,warrior,arms,27,11,16
Midge,proudmoore,987,warrior,arms,83,40,43
Biggieswords,madoran,984,warrior,arms,17,11,6
Brrzrrkrr,twisting-nether,983,warrior,arms,36,18,18
Bionikus,nemesis,982,warrior,arms,108,49,59
Darkthok,drakkari,982,warrior,arms,34,15,19
Sneaknyoface,sargeras,982,warrior,arms,26,11,15
Josiah,frostmourne,979,warrior,arms,27,13,14
Lokiullr,tichondrius,978,warrior,arms,81,35,46
Tucô,skullcrusher,976,warrior,arms,49,22,27
Happywarrior,tichondrius,976,warrior,arms,30,11,19
Sudokubrain,tichondrius,974,warrior,arms,19,11,8
Blackstamp,tichondrius,973,warrior,arms,41,20,21
Hunchless,detheroc,973,warrior,arms,57,25,32
Djfredsd,tichondrius,972,warrior,arms,13,11,2
Ghainemarko,hakkar,970,warrior,arms,30,11,19
Elfmonger,proudmoore,966,warrior,arms,19,11,8
Târtàrûs,tichondrius,966,warrior,arms,60,28,32
Tankdatt,frostmourne,966,warrior,arms,30,12,18
Wondaimon,drakkari,963,warrior,arms,27,12,15
Pvppaul,sargeras,960,warrior,arms,12,10,2
Adios,tichondrius,960,warrior,arms,18,10,8
Szew,tichondrius,960,warrior,arms,18,10,8
Battousäi,kiljaeden,960,warrior,arms,18,10,8
Escanòr,malganis,960,warrior,arms,18,10,8
Åthos,illidan,960,warrior,arms,18,10,8
Nuqupq,tichondrius,960,warrior,arms,18,10,8
Gunjay,sargeras,960,warrior,arms,21,11,10
Swoonmixy,frostmourne,960,warrior,arms,24,10,14
ßdm,illidan,960,warrior,arms,24,10,14
Wargázm,thrall,960,warrior,arms,24,10,14
Americanbull,moon-guard,960,warrior,arms,24,10,14
Choppin,sargeras,960,warrior,arms,24,10,14
Jethrix,kelthuzad,960,warrior,arms,24,10,14
Benw,dawnbringer,960,warrior,arms,24,10,14
Aliminar,zuluhed,960,warrior,arms,24,10,14
Fatalian,proudmoore,960,warrior,arms,30,10,20
Angrymadman,mannoroth,959,warrior,arms,18,10,8
Violence,icecrown,959,warrior,arms,18,10,8
Tantei,moon-guard,959,warrior,arms,18,10,8
Elessarr,moon-guard,959,warrior,arms,18,10,8
Velicah,stormrage,959,warrior,arms,18,10,8
Hellfirearms,tichondrius,959,warrior,arms,18,10,8
Beozerker,thrall,959,warrior,arms,18,10,8
Jelurd,stormrage,959,warrior,arms,18,10,8
Tmjakeful,area-52,959,warrior,arms,18,10,8
Bamxz,sargeras,959,warrior,arms,18,10,8
Warbasher,area-52,959,warrior,arms,18,10,8
Alkír,zuljin,959,warrior,arms,18,10,8
Crysis,malorne,959,warrior,arms,24,10,14
Wóko,tichondrius,959,warrior,arms,24,10,14
Drdelicious,tichondrius,959,warrior,arms,24,10,14
Organge,zuljin,959,warrior,arms,24,10,14
Ggrone,ragnaros,959,warrior,arms,24,10,14
Warfeno,malganis,959,warrior,arms,24,10,14
Mikeoxgreen,zuljin,959,warrior,arms,24,10,14
Chardz,ragnaros,959,warrior,arms,30,10,20
Zugface,tichondrius,959,warrior,arms,36,10,26
Elsee,drakkari,959,warrior,arms,42,10,32
Arrtorias,quelthalas,958,warrior,arms,12,10,2
Est,illidan,958,warrior,arms,12,10,2
Glacierrsz,sargeras,958,warrior,arms,18,10,8
Polox,ragnaros,958,warrior,arms,18,10,8
Kanchy,sargeras,958,warrior,arms,18,10,8
Hauce,illidan,958,warrior,arms,18,10,8
Akylis,tichondrius,958,warrior,arms,18,10,8
Jire,shadowmoon,958,warrior,arms,22,11,11
Icestormray,illidan,958,warrior,arms,24,10,14
Grimspin,tichondrius,958,warrior,arms,24,10,14
Bigdickfever,sargeras,958,warrior,arms,24,10,14
Unwarmas,ragnaros,958,warrior,arms,24,10,14
Kelmor,thunderhorn,958,warrior,arms,30,10,20
Calto,tichondrius,958,warrior,arms,30,10,20
Razakamx,tichondrius,957,warrior,arms,12,10,2
Ghostblood,stormscale,957,warrior,arms,12,10,2
Leapsalp,proudmoore,957,warrior,arms,18,10,8
Whórm,kelthuzad,957,warrior,arms,18,10,8
Atuey,area-52,957,warrior,arms,18,10,8
Fugmaface,sargeras,957,warrior,arms,18,10,8
Pootybeef,daggerspine,957,warrior,arms,24,10,14
Targos,frostwolf,957,warrior,arms,24,10,14
Aberwarr,illidan,956,warrior,arms,18,10,8
Topbel,sargeras,956,warrior,arms,18,10,8
Keffdog,laughing-skull,956,warrior,arms,18,10,8
Lòvex,alterac-mountains,956,warrior,arms,60,32,28
Numb,moon-guard,956,warrior,arms,26,11,15
Kriegsheer,bleeding-hollow,956,warrior,arms,24,10,14
Aisinbro,illidan,956,warrior,arms,24,10,14
Torbajhorn,moon-guard,956,warrior,arms,24,10,14
Barøneza,stormrage,956,warrior,arms,24,10,14
Kushe,moon-guard,956,warrior,arms,24,10,14
Warrbull,spirestone,956,warrior,arms,30,10,20
Xdorkie,area-52,956,warrior,arms,30,10,20
Stromkiller,stormrage,955,warrior,arms,18,10,8
Korlòth,proudmoore,955,warrior,arms,18,10,8
Qtrpndwcheez,area-52,955,warrior,arms,18,10,8
Theestallion,kiljaeden,954,warrior,arms,18,10,8
Starshattr,bleeding-hollow,954,warrior,arms,30,10,20
Zomars,ragnaros,953,warrior,arms,18,10,8
Coffeebottom,wyrmrest-accord,953,warrior,arms,18,10,8
Honanilana,burning-legion,953,warrior,arms,24,10,14
Originalpimp,bleeding-hollow,952,warrior,arms,24,10,14
Turlesoup,proudmoore,952,warrior,arms,24,10,14
Mauler,medivh,952,warrior,arms,24,10,14
Aziz,kiljaeden,952,warrior,arms,25,10,15
Astellios,stormrage,951,warrior,arms,18,10,8
Aaltara,barthilas,951,warrior,arms,18,10,8
Uhredb,aegwynn,951,warrior,arms,30,16,14
Vvârriôr,barthilas,951,warrior,arms,24,10,14
Darroma,bleeding-hollow,950,warrior,arms,18,10,8
Helaume,arathor,950,warrior,arms,18,10,8
Discopogo,nemesis,950,warrior,arms,24,10,14
Spredforbred,area-52,950,warrior,arms,24,10,14
Oppos,lightnings-blade,950,warrior,arms,31,12,19
Rainiki,stormrage,950,warrior,arms,30,11,19
Babybiif,azralon,950,warrior,arms,30,10,20
Tanatos,the-venture-co,949,warrior,arms,42,16,26
Vlix,korgath,948,warrior,arms,24,10,14
Baloraj,barthilas,948,warrior,arms,24,10,14
Digitalpsyko,hyjal,946,warrior,arms,18,10,8
Meatdrps,frostmane,941,warrior,arms,26,11,15
Thing,gorgonnash,941,warrior,arms,24,10,14
Feared,hakkar,940,warrior,arms,23,10,13
Dragmös,nemesis,937,warrior,arms,12,10,2
Stöñè,blackwater-raiders,937,warrior,arms,24,10,14
Haowar,tichondrius,937,warrior,arms,35,10,25
Cizzik,emerald-dream,936,warrior,arms,18,10,8
Hulkspazz,darkspear,936,warrior,arms,39,18,21
Alderr,frostmourne,935,warrior,arms,24,10,14
Mariò,area-52,934,warrior,arms,18,10,8
Tyrantt,malganis,934,warrior,arms,54,22,32
Vlanko,tichondrius,933,warrior,arms,24,10,14
Danielss,ragnaros,930,warrior,arms,29,12,17
Pocketaxe,blackwater-raiders,927,warrior,arms,83,40,43
Phoveros,sargeras,927,warrior,arms,23,10,13
Bruze,hellscream,926,warrior,arms,19,11,8
Dudupápá,tichondrius,926,warrior,arms,22,10,12
Ragesimp,stormrage,926,warrior,arms,23,10,13
Kalusha,ragnaros,926,warrior,arms,72,29,43
Taigola,aggramar,923,warrior,arms,22,11,11
Krokgoldmane,drakkari,921,warrior,arms,48,24,24
Mâmba,thrall,918,warrior,arms,24,10,14
Velliena,tichondrius,916,warrior,arms,32,11,21
Rocketbom,tichondrius,911,warrior,arms,23,10,13
Beanstrom,tichondrius,911,warrior,arms,23,10,13
Skarkla,thrall,911,warrior,arms,29,10,19
Lobo,sargeras,911,warrior,arms,58,17,41
Beyblade,jubeithos,910,warrior,arms,17,10,7
Loudpee,tichondrius,910,warrior,arms,20,11,9
Nexie,moon-guard,910,warrior,arms,21,10,11
Kzw,illidan,910,warrior,arms,23,10,13
Deathhit,barthilas,907,warrior,arms,18,10,8
Lishajr,malganis,907,warrior,arms,32,16,16
Llewellenar,stormrage,907,warrior,arms,23,10,13
Warbreaker,stormrage,905,warrior,arms,17,10,7
Spitts,frostmourne,904,warrior,arms,21,10,11
Placerqt,ragnaros,903,warrior,arms,26,11,15
Atrocithy,ragnaros,896,warrior,arms,16,10,6
Doglegz,saurfang,896,warrior,arms,18,10,8
Girioo,thrall,895,warrior,arms,14,10,4
Ohjim,stormrage,892,warrior,arms,26,10,16
Pumpuup,bleeding-hollow,890,warrior,arms,48,19,29
Smokezee,barthilas,890,warrior,arms,26,10,16
Machatlan,stormrage,889,warrior,arms,38,18,20
Wallzar,sargeras,887,warrior,arms,20,10,10
Hruum,moknathal,886,warrior,arms,18,10,8
Tankadin,dragonmaw,885,warrior,arms,24,10,14
Mortalchop,tichondrius,880,warrior,arms,19,10,9
Poornub,emerald-dream,875,warrior,arms,19,11,8
Moosebeef,garrosh,873,warrior,arms,67,32,35
Sígmar,dreadmaul,869,warrior,arms,18,10,8
Wreckerr,area-52,869,warrior,arms,26,12,14
Moonyxx,frostmourne,864,warrior,arms,12,9,3
Skynitez,area-52,864,warrior,arms,12,9,3
Tobella,illidan,864,warrior,arms,12,9,3
Iracor,stormrage,864,warrior,arms,12,9,3
Dripgodx,malganis,864,warrior,arms,12,9,3
Youngmoneyd,illidan,864,warrior,arms,12,9,3
Joker,andorhal,864,warrior,arms,12,9,3
Microraccoon,tichondrius,864,warrior,arms,12,9,3
Dedgamesucks,darkspear,864,warrior,arms,12,9,3
Anklebiter,aerie-peak,864,warrior,arms,18,9,9
Solocon,tichondrius,864,warrior,arms,18,9,9
Vanlur,khaz-modan,864,warrior,arms,18,9,9
Grimfate,boulderfist,864,warrior,arms,18,9,9
Mlau,tichondrius,864,warrior,arms,18,9,9
Rageroidz,sargeras,864,warrior,arms,18,9,9
Miniraccoon,tichondrius,864,warrior,arms,18,9,9
Gläedr,dalaran,864,warrior,arms,18,9,9
Gathzyx,tichondrius,864,warrior,arms,18,9,9
Alchera,fizzcrank,864,warrior,arms,18,9,9
Undeadbones,firetree,864,warrior,arms,18,9,9
Dreamonn,illidan,864,warrior,arms,18,9,9
Oafnir,moon-guard,864,warrior,arms,18,9,9
Stÿgian,blood-furnace,864,warrior,arms,18,9,9
Intricacy,tichondrius,864,warrior,arms,18,9,9
Böô,tichondrius,864,warrior,arms,18,9,9
Warwagon,the-underbog,864,warrior,arms,18,9,9
Bbg,bleeding-hollow,864,warrior,arms,18,9,9
Dreadtøøth,tichondrius,864,warrior,arms,24,9,15
Dankdad,garrosh,864,warrior,arms,24,9,15
Eensy,sargeras,864,warrior,arms,24,9,15
Boxxyy,tichondrius,864,warrior,arms,24,9,15
Dustywx,area-52,864,warrior,arms,24,9,15
Sejac,moon-guard,864,warrior,arms,24,9,15
Pretending,dalaran,864,warrior,arms,24,9,15
Boardslide,proudmoore,864,warrior,arms,30,9,21
Durist,tichondrius,864,warrior,arms,36,9,27
Grehk,sargeras,863,warrior,arms,12,9,3
Tinymooie,frostmourne,863,warrior,arms,12,9,3
Roadglide,korgath,863,warrior,arms,12,9,3
Eggheadorc,area-52,863,warrior,arms,12,9,3
Stickystorm,proudmoore,863,warrior,arms,16,10,6
Skorgebt,thrall,863,warrior,arms,18,9,9
Chrom,illidan,863,warrior,arms,18,9,9
Trén,hydraxis,863,warrior,arms,18,9,9
Däwggy,tichondrius,863,warrior,arms,18,9,9
Erdnase,ragnaros,863,warrior,arms,18,9,9
Wxwxwxwxwxw,illidan,863,warrior,arms,18,9,9
Tâte,sargeras,863,warrior,arms,18,9,9
Nosoraki,thrall,863,warrior,arms,18,9,9
Spxnk,illidan,863,warrior,arms,18,9,9
Terneitor,ragnaros,863,warrior,arms,18,9,9
Reckfül,proudmoore,863,warrior,arms,18,9,9
Balthamel,dunemaul,863,warrior,arms,18,9,9
Palauu,tichondrius,863,warrior,arms,18,9,9
Greven,malganis,863,warrior,arms,18,9,9
Sambojüjü,stormrage,863,warrior,arms,18,9,9
Zaynafein,emerald-dream,863,warrior,arms,18,9,9
Hasbullaa,proudmoore,863,warrior,arms,18,9,9
Mechagodzila,kiljaeden,863,warrior,arms,18,9,9
Kid,daggerspine,863,warrior,arms,18,9,9
Averagewar,frostwolf,863,warrior,arms,18,9,9
Coveiro,nemesis,863,warrior,arms,19,9,10
Spincycle,khadgar,863,warrior,arms,21,9,12
Laochra,aggramar,863,warrior,arms,24,9,15
Skunkz,kelthuzad,863,warrior,arms,24,9,15
Touhen,illidan,863,warrior,arms,24,9,15
Notoxzy,tichondrius,863,warrior,arms,24,9,15
Actio,stormrage,863,warrior,arms,24,9,15
Wrecktang,tichondrius,863,warrior,arms,24,9,15
Vrinith,ragnaros,863,warrior,arms,25,9,16
Hammertoez,thunderhorn,863,warrior,arms,26,9,17
Xumæ,akama,863,warrior,arms,30,9,21
Madeus,quelthalas,863,warrior,arms,30,9,21
Warwslayer,tichondrius,863,warrior,arms,30,9,21
Qnl,sargeras,862,warrior,arms,16,10,6
Xargosh,magtheridon,862,warrior,arms,18,9,9
Izârâk,frostmourne,862,warrior,arms,18,9,9
Um,moon-guard,862,warrior,arms,18,9,9
Cogsbixby,aerie-peak,862,warrior,arms,18,9,9
Wargorin,bleeding-hollow,862,warrior,arms,18,9,9
Humansmash,thrall,862,warrior,arms,18,9,9
Fatalsfury,tichondrius,862,warrior,arms,18,9,9
Iskandr,amanthul,862,warrior,arms,21,10,11
Xurc,gnomeregan,862,warrior,arms,24,9,15
Wárriór,tichondrius,862,warrior,arms,24,9,15
Ichigami,kelthuzad,862,warrior,arms,24,9,15
Tbagg,area-52,862,warrior,arms,24,9,15
Shniewind,ragnaros,862,warrior,arms,30,9,21
Jodoro,malfurion,861,warrior,arms,18,9,9
Bruxigar,ragnaros,861,warrior,arms,18,9,9
Swolthelas,tichondrius,861,warrior,arms,18,9,9
Avalisk,balnazzar,861,warrior,arms,21,10,11
Vãryan,frostmourne,861,warrior,arms,24,9,15
Gobx,tichondrius,861,warrior,arms,24,9,15
Shínkicker,area-52,861,warrior,arms,24,9,15
Durtmcsmash,stormrage,860,warrior,arms,18,9,9
Ogundados,kelthuzad,860,warrior,arms,18,9,9
Kurgos,quelthalas,860,warrior,arms,18,9,9
Stormit,illidan,860,warrior,arms,19,9,10
Jindyn,boulderfist,860,warrior,arms,64,29,35
Marnan,quelthalas,860,warrior,arms,24,9,15
Layllassa,moon-guard,860,warrior,arms,24,9,15
Ultradma,area-52,860,warrior,arms,24,9,15
Umogarmac,draktharon,860,warrior,arms,24,9,15
Kiyokó,sargeras,859,warrior,arms,18,9,9
Zhyper,frostmourne,859,warrior,arms,18,9,9
Thörir,proudmoore,859,warrior,arms,18,9,9
Vio,mannoroth,859,warrior,arms,18,9,9
Nishtana,quelthalas,859,warrior,arms,18,9,9
Tôpanga,lightninghoof,859,warrior,arms,24,9,15
Féril,ragnaros,858,warrior,arms,18,9,9
Åres,wyrmrest-accord,858,warrior,arms,18,9,9
Corthíus,stormrage,858,warrior,arms,22,10,12
Bachyr,stormrage,858,warrior,arms,24,9,15
Deathstrøke,illidan,858,warrior,arms,30,9,21
Boltmor,stormrage,857,warrior,arms,12,9,3
Tinyguysmall,eredar,857,warrior,arms,22,11,11
Gahii,barthilas,857,warrior,arms,18,9,9
Kaimana,zuljin,857,warrior,arms,18,9,9
Joshums,warsong,857,warrior,arms,26,10,16
Karusuke,stormrage,857,warrior,arms,24,9,15
Fugufish,nemesis,857,warrior,arms,24,9,15
Sparkye,gallywix,856,warrior,arms,18,9,9
Éllenor,azralon,856,warrior,arms,18,9,9
Tomcruizes,tichondrius,856,warrior,arms,18,9,9
Tsurik,malfurion,856,warrior,arms,30,9,21
Eorik,stormrage,856,warrior,arms,36,9,27
Daytime,scilla,855,warrior,arms,18,9,9
Coldsnaps,azjolnerub,855,warrior,arms,18,9,9
Preschool,sargeras,854,warrior,arms,12,9,3
Kenroc,illidan,854,warrior,arms,18,9,9
Wândêrer,wyrmrest-accord,854,warrior,arms,18,9,9
Xarlon,stormrage,854,warrior,arms,21,10,11
Garusok,thrall,853,warrior,arms,12,9,3
Kkaell,azralon,852,warrior,arms,18,9,9
Asiyurekhans,borean-tundra,851,warrior,arms,12,9,3
Trigon,chromaggus,851,warrior,arms,18,9,9
Jaimey,malganis,845,warrior,arms,23,9,14
Whiteclouds,blood-furnace,844,warrior,arms,42,17,25
Karadell,emerald-dream,843,warrior,arms,22,10,12
Blockcheese,illidan,840,warrior,arms,30,9,21
Lamaril,silvermoon,837,warrior,arms,12,9,3
Molloywr,kelthuzad,831,warrior,arms,23,9,14
Karrison,azshara,829,warrior,arms,85,41,44
Eskama,hyjal,823,warrior,arms,29,9,20
Hjoz,illidan,822,warrior,arms,16,9,7
Beepboop,malganis,817,warrior,arms,18,9,9
Rexxous,hyjal,815,warrior,arms,27,9,18
Dupaminichav,stormrage,814,warrior,arms,15,9,6
Bargorengar,skullcrusher,814,warrior,arms,78,34,44
Vikkz,frostmourne,811,warrior,arms,23,9,14
Scran,sargeras,809,warrior,arms,21,10,11
Paí,nemesis,808,warrior,arms,17,9,8
Gigazug,stormrage,799,warrior,arms,20,9,11
Rahj,saurfang,799,warrior,arms,20,9,11
Fatmân,tichondrius,798,warrior,arms,22,9,13
Warrihoe,stormrage,798,warrior,arms,23,9,14
Psychosicko,tichondrius,796,warrior,arms,17,9,8
Alzuga,quelthalas,796,warrior,arms,26,9,17
Dierdris,gnomeregan,795,warrior,arms,19,9,10
Zemdur,azralon,795,warrior,arms,20,9,11
Xcal,malganis,795,warrior,arms,20,9,11
Murrdock,nesingwary,794,warrior,arms,14,9,5
Thagunshow,tichondrius,794,warrior,arms,20,9,11
Ripstorm,emerald-dream,794,warrior,arms,20,9,11
Ruick,wyrmrest-accord,793,warrior,arms,18,9,9
Vandalizer,sargeras,788,warrior,arms,20,10,10
Joecules,kelthuzad,783,warrior,arms,17,9,8
Morbaras,tichondrius,781,warrior,arms,25,9,16
Koraciá,illidan,780,warrior,arms,19,9,10
Traglos,ragnaros,768,warrior,arms,12,8,4
Dadslapper,illidan,768,warrior,arms,12,8,4
Gorva,emerald-dream,768,warrior,arms,12,8,4
Willieruth,stormrage,768,warrior,arms,12,8,4
Optym,onyxia,768,warrior,arms,12,8,4
Cazora,ragnaros,768,warrior,arms,12,8,4
Wreckfúll,sargeras,768,warrior,arms,12,8,4
Clown,andorhal,768,warrior,arms,12,8,4
Thornhardt,frostmourne,768,warrior,arms,12,8,4
Huangatang,wyrmrest-accord,768,warrior,arms,12,8,4
Patékphilípe,area-52,768,warrior,arms,12,8,4
Smallbrainx,tichondrius,768,warrior,arms,12,8,4
Sweeped,darkspear,768,warrior,arms,12,8,4
Xaenne,zuljin,768,warrior,arms,12,8,4
Zdokk,sargeras,768,warrior,arms,12,8,4
Fløkî,azralon,768,warrior,arms,12,8,4
Cjay,bleeding-hollow,768,warrior,arms,12,8,4
Iced,tichondrius,768,warrior,arms,12,8,4
Gabv,shadowmoon,768,warrior,arms,12,8,4
Sleifx,quelthalas,768,warrior,arms,12,8,4
Laggytwodope,kelthuzad,768,warrior,arms,12,8,4
Zleam,area-52,768,warrior,arms,12,8,4
Imakeupuddin,turalyon,768,warrior,arms,12,8,4
Grüumsh,drenden,768,warrior,arms,12,8,4
Msallsunday,nerzhul,768,warrior,arms,12,8,4
Hoodslam,moon-guard,768,warrior,arms,12,8,4
Saucebussin,emerald-dream,768,warrior,arms,12,8,4
Staffed,area-52,768,warrior,arms,12,8,4
Halibut,kelthuzad,768,warrior,arms,12,8,4
Slaughterx,malganis,768,warrior,arms,12,8,4
Armsupx,tichondrius,768,warrior,arms,12,8,4
Dazuu,illidan,768,warrior,arms,18,8,10
Tamajkaz,the-forgotten-coast,768,warrior,arms,18,8,10
Supermieo,illidan,768,warrior,arms,18,8,10
Gízzmo,tichondrius,768,warrior,arms,18,8,10
Chronek,sargeras,768,warrior,arms,18,8,10
Baaltica,ragnaros,768,warrior,arms,18,8,10
Martrios,alexstrasza,768,warrior,arms,18,8,10
Elitistx,bleeding-hollow,768,warrior,arms,18,8,10
Stoneball,kiljaeden,768,warrior,arms,18,8,10
Leunitas,shadow-council,768,warrior,arms,18,8,10
Cuddlechamp,barthilas,768,warrior,arms,18,8,10
Easylel,stormrage,768,warrior,arms,18,8,10
Monkeystrike,barthilas,768,warrior,arms,18,8,10
Tádakatsu,sargeras,768,warrior,arms,18,8,10
Elkz,tichondrius,768,warrior,arms,18,8,10
Elky,area-52,768,warrior,arms,18,8,10
Ogre,magtheridon,768,warrior,arms,18,8,10
Sabers,mannoroth,768,warrior,arms,18,8,10
Linjunfeng,tichondrius,768,warrior,arms,18,8,10
Ricksanches,shadowmoon,768,warrior,arms,18,8,10
Majaya,area-52,768,warrior,arms,24,8,16
Dirkdallas,tichondrius,768,warrior,arms,24,8,16
Bornne,doomhammer,768,warrior,arms,30,8,22
Executefreak,illidan,767,warrior,arms,12,8,4
Husc,kiljaeden,767,warrior,arms,12,8,4
Domminux,darkspear,767,warrior,arms,12,8,4
Rúz,illidan,767,warrior,arms,12,8,4
Mikeyforever,quelthalas,767,warrior,arms,12,8,4
Rushee,argent-dawn,767,warrior,arms,12,8,4
Pigblind,azralon,767,warrior,arms,12,8,4
Tharez,stormrage,767,warrior,arms,12,8,4
Ferdaliance,tichondrius,767,warrior,arms,12,8,4
Alucardio,turalyon,767,warrior,arms,12,8,4
Dukar,crushridge,767,warrior,arms,12,8,4
Letsgosmokes,stormrage,767,warrior,arms,12,8,4
Azziiqt,stormrage,767,warrior,arms,12,8,4
Kixxel,sargeras,767,warrior,arms,12,8,4
Mongosyco,proudmoore,767,warrior,arms,12,8,4
Warwagon,malganis,767,warrior,arms,12,8,4
Wantor,lightnings-blade,767,warrior,arms,12,8,4
Silac,drenden,767,warrior,arms,12,8,4
Gränd,frostmourne,767,warrior,arms,12,8,4
Blazingguard,stormrage,767,warrior,arms,12,8,4
Bloodface,azralon,767,warrior,arms,13,8,5
Zédelívery,azralon,767,warrior,arms,16,9,7
Azkaosa,tichondrius,767,warrior,arms,18,8,10
Nogèt,frostmourne,767,warrior,arms,18,8,10
Laylowk,tichondrius,767,warrior,arms,18,8,10
Moarbrainz,mannoroth,767,warrior,arms,18,8,10
Wakaflaka,kiljaeden,767,warrior,arms,18,8,10
Houdinix,stormrage,767,warrior,arms,18,8,10
Ihazlolstorm,area-52,767,warrior,arms,18,8,10
Dalinare,area-52,767,warrior,arms,18,8,10
Æwarrìor,tichondrius,767,warrior,arms,18,8,10
Broxar,area-52,767,warrior,arms,18,8,10
Speedyfarm,sargeras,767,warrior,arms,18,8,10
Fraxxure,proudmoore,767,warrior,arms,18,8,10
Nanor,zuljin,767,warrior,arms,18,8,10
Jorked,drakkari,767,warrior,arms,18,8,10
Slashup,sargeras,767,warrior,arms,18,8,10
Drusillaa,deathwing,767,warrior,arms,18,8,10
Pípe,nemesis,767,warrior,arms,18,8,10
Jódiarias,bleeding-hollow,767,warrior,arms,18,8,10
Elegorn,nemesis,767,warrior,arms,18,8,10
Execute,kirin-tor,767,warrior,arms,18,8,10
Geubsalx,tichondrius,767,warrior,arms,18,8,10
Empyrius,exodar,767,warrior,arms,18,8,10
Orgreshin,area-52,767,warrior,arms,21,9,12
Sabini,nemesis,767,warrior,arms,24,8,16
Cajual,area-52,767,warrior,arms,24,8,16
Cevadix,azralon,767,warrior,arms,24,8,16
Rraw,demon-soul,767,warrior,arms,24,8,16
Brawnforce,shadowsong,767,warrior,arms,24,8,16
Essofeit,frostmourne,767,warrior,arms,24,8,16
Techanina,aerie-peak,767,warrior,arms,24,8,16
Mondëgo,stormrage,767,warrior,arms,24,8,16
Headsour,thunderhorn,767,warrior,arms,30,8,22
Khrull,khazgoroth,766,warrior,arms,12,8,4
Ragarok,jubeithos,766,warrior,arms,12,8,4
Houk,frostmourne,766,warrior,arms,12,8,4
Zhasi,bonechewer,766,warrior,arms,12,8,4
Warriorc,laughing-skull,766,warrior,arms,12,8,4
Horvv,frostmourne,766,warrior,arms,12,8,4
Thesmackboi,sargeras,766,warrior,arms,12,8,4
Jackhanma,kelthuzad,766,warrior,arms,12,8,4
Brodin,maelstrom,766,warrior,arms,12,8,4
Sálieri,ragnaros,766,warrior,arms,18,8,10
Chj,kelthuzad,766,warrior,arms,18,8,10
Truecarnage,emerald-dream,766,warrior,arms,18,8,10
Camphump,moon-guard,766,warrior,arms,18,8,10
Edalthor,quelthalas,766,warrior,arms,18,8,10
Donnacha,garona,766,warrior,arms,18,8,10
Hemmyroidz,tichondrius,766,warrior,arms,18,8,10
Javabaenss,tichondrius,766,warrior,arms,18,8,10
Bigsquiggle,blackrock,766,warrior,arms,18,8,10
Orthopedic,tichondrius,766,warrior,arms,18,8,10
Zrads,zuljin,766,warrior,arms,19,8,11
Violençe,malganis,766,warrior,arms,24,8,16
Xforcewar,zuljin,766,warrior,arms,24,8,16
Damadar,malganis,766,warrior,arms,24,8,16
Modzilla,aerie-peak,766,warrior,arms,30,8,22
Léva,ragnaros,765,warrior,arms,12,8,4
Kurgrok,kiljaeden,765,warrior,arms,12,8,4
Belladeom,azralon,765,warrior,arms,18,8,10
Xeto,ragnaros,765,warrior,arms,18,8,10
Ulfioff,whisperwind,765,warrior,arms,18,8,10
Vassild,firetree,765,warrior,arms,18,8,10
Uragiri,shadowsong,765,warrior,arms,18,8,10
Percthirty,blackrock,765,warrior,arms,18,8,10
Franklenn,mannoroth,765,warrior,arms,24,8,16
Lui,the-forgotten-coast,765,warrior,arms,24,8,16
Maxprotein,area-52,764,warrior,arms,14,8,6
Harattawi,thrall,764,warrior,arms,18,8,10
Alexarchos,chogall,764,warrior,arms,18,8,10
Nosferagc,frostmourne,764,warrior,arms,21,9,12
Exist,kaelthas,764,warrior,arms,24,8,16
Daniín,azralon,764,warrior,arms,25,8,17
Friends,azjolnerub,763,warrior,arms,18,8,10
Croton,moon-guard,763,warrior,arms,18,8,10
Luneblade,tichondrius,763,warrior,arms,18,8,10
Chamfer,illidan,763,warrior,arms,18,8,10
Sygw,area-52,763,warrior,arms,24,8,16
Hellus,tichondrius,763,warrior,arms,24,8,16
Shìromìzù,eredar,762,warrior,arms,12,8,4
Tarmer,moon-guard,762,warrior,arms,18,8,10
Sweetdeé,zuljin,762,warrior,arms,18,8,10
Arktoast,tichondrius,762,warrior,arms,24,8,16
Revenn,greymane,761,warrior,arms,12,8,4
Jårko,dathremar,761,warrior,arms,18,8,10
Lumilis,draenor,760,warrior,arms,18,8,10
Vynfull,area-52,760,warrior,arms,18,8,10
Rafaelwar,drakkari,758,warrior,arms,18,8,10
Badazzdad,thunderhorn,757,warrior,arms,18,8,10
Trapwar,malganis,755,warrior,arms,12,8,4
Bilmuuri,illidan,754,warrior,arms,27,9,18
Fleshtuxedo,stormrage,752,warrior,arms,12,8,4
Bratomil,amanthul,751,warrior,arms,18,8,10
Xomis,thrall,750,warrior,arms,17,8,9
Tgnomeless,gilneas,750,warrior,arms,25,8,17
Gladiattor,tol-barad,749,warrior,arms,18,8,10
Dadookibooty,area-52,740,warrior,arms,24,11,13
Ironwarr,hyjal,740,warrior,arms,23,8,15
Vetinari,nazjatar,735,warrior,arms,11,8,3
Outo,stormrage,735,warrior,arms,17,8,9
Casmier,tichondrius,734,warrior,arms,17,8,9
Tánktop,sargeras,733,warrior,arms,14,9,5
Gorakis,barthilas,733,warrior,arms,20,9,11
Saigø,stormrage,723,warrior,arms,18,8,10
Señor,barthilas,719,warrior,arms,15,8,7
Mêlo,area-52,719,warrior,arms,17,8,9
Randywar,tichondrius,719,warrior,arms,21,8,13
Wreckthis,area-52,718,warrior,arms,17,8,9
Ârmstrong,quelthalas,714,warrior,arms,23,10,13
Alemão,bleeding-hollow,713,warrior,arms,23,9,14
Hrothtyr,kelthuzad,702,warrior,arms,20,8,12
Tabadigbick,bleeding-hollow,698,warrior,arms,17,8,9
Hordrek,moon-guard,688,warrior,arms,13,8,5
Psyrush,area-52,687,warrior,arms,19,8,11
Valuxia,sargeras,687,warrior,arms,19,8,11
Earfquake,boulderfist,686,warrior,arms,13,8,5
Greenbrain,dunemaul,685,warrior,arms,19,8,11
Grounyl,azralon,672,warrior,arms,12,7,5
Drashka,ragnaros,672,warrior,arms,12,7,5
Dehumanized,greymane,672,warrior,arms,12,7,5
Nekopara,caelestrasz,672,warrior,arms,12,7,5
Jypster,stormrage,672,warrior,arms,12,7,5
Gbrz,stormrage,672,warrior,arms,12,7,5
Kevy,arygos,672,warrior,arms,12,7,5
Madamemarie,stormrage,672,warrior,arms,12,7,5
Espadotas,ragnaros,672,warrior,arms,12,7,5
Cuzmyslam,sargeras,672,warrior,arms,12,7,5
Spaceslam,tichondrius,672,warrior,arms,12,7,5
Deseroth,sargeras,672,warrior,arms,12,7,5
Tunnelvision,garrosh,672,warrior,arms,12,7,5
Spartagux,dalaran,672,warrior,arms,12,7,5
Arsis,whisperwind,672,warrior,arms,12,7,5
Studdythejet,zuljin,672,warrior,arms,12,7,5
Korbles,moon-guard,672,warrior,arms,12,7,5
Madmartiggan,tichondrius,672,warrior,arms,12,7,5
Kufflinks,kelthuzad,672,warrior,arms,12,7,5
Slaughtér,tichondrius,672,warrior,arms,12,7,5
Petuniä,zuljin,672,warrior,arms,12,7,5
Deathammer,stormrage,672,warrior,arms,12,7,5
Toungy,kelthuzad,672,warrior,arms,12,7,5
Qutuz,illidan,672,warrior,arms,12,7,5
Papazugs,kelthuzad,672,warrior,arms,12,7,5
Warzôg,emerald-dream,672,warrior,arms,12,7,5
Raeging,area-52,672,warrior,arms,12,7,5
Baye,kargath,672,warrior,arms,12,7,5
Furìous,stormrage,672,warrior,arms,12,7,5
Niulaoye,tichondrius,672,warrior,arms,12,7,5
Nayuta,area-52,672,warrior,arms,12,7,5
Executor,mugthol,672,warrior,arms,12,7,5
Mouncha,tichondrius,672,warrior,arms,12,7,5
Bullwar,barthilas,672,warrior,arms,12,7,5
Jahrakál,thunderlord,672,warrior,arms,12,7,5
Cugij,frostmourne,672,warrior,arms,12,7,5
Bloodshêdz,stormrage,672,warrior,arms,12,7,5
Ousetadoidao,nemesis,672,warrior,arms,12,7,5
Ischyrós,stormrage,672,warrior,arms,12,7,5
Mõgorrin,area-52,672,warrior,arms,12,7,5
Püsspeepers,kelthuzad,672,warrior,arms,12,7,5
Jaysmom,tichondrius,672,warrior,arms,12,7,5
Turtleofhope,barthilas,672,warrior,arms,12,7,5
Roiboy,stormrage,672,warrior,arms,12,7,5
Hinsionzillu,proudmoore,672,warrior,arms,12,7,5
Yrz,malganis,672,warrior,arms,12,7,5
Fernzie,malganis,672,warrior,arms,12,7,5
Vids,aegwynn,672,warrior,arms,12,7,5
Kahn,andorhal,672,warrior,arms,12,7,5
Okayge,proudmoore,672,warrior,arms,12,7,5
Giv,frostmourne,672,warrior,arms,12,7,5
Magnusz,zuljin,672,warrior,arms,12,7,5
Yqoos,tichondrius,672,warrior,arms,12,7,5
Havocsmash,tichondrius,672,warrior,arms,12,7,5
Benbtw,malganis,672,warrior,arms,12,7,5
Jesbar,ragnaros,672,warrior,arms,12,7,5
Bean,ragnaros,672,warrior,arms,12,7,5
Xdoombringer,area-52,672,warrior,arms,12,7,5
Hopefulki,duskwood,672,warrior,arms,12,7,5
Ryalaeth,moon-guard,672,warrior,arms,12,7,5
Vxjohnson,proudmoore,672,warrior,arms,15,8,7
Kappiz,wyrmrest-accord,672,warrior,arms,14,7,7
Infâmous,proudmoore,672,warrior,arms,18,7,11
Zuans,azralon,672,warrior,arms,18,7,11
Ignorebrain,tichondrius,672,warrior,arms,18,7,11
Sayjaki,stormrage,672,warrior,arms,18,7,11
Beatstickz,malganis,672,warrior,arms,18,7,11
Pangus,uldum,672,warrior,arms,18,7,11
Kerrena,kelthuzad,672,warrior,arms,18,7,11
Uglyfuq,bleeding-hollow,672,warrior,arms,18,7,11
Jackmonkey,the-forgotten-coast,672,warrior,arms,18,7,11
Ivory,emerald-dream,672,warrior,arms,18,7,11
Käggai,khadgar,672,warrior,arms,18,7,11
Orczug,tichondrius,672,warrior,arms,18,7,11
Hellizzy,sargeras,672,warrior,arms,18,7,11
Hazelbean,tichondrius,672,warrior,arms,18,7,11
Eronara,emerald-dream,672,warrior,arms,18,7,11
Kraft,azralon,672,warrior,arms,18,7,11
Buddypalmer,bleeding-hollow,672,warrior,arms,18,7,11
Ulamøg,proudmoore,672,warrior,arms,18,7,11
Yamzprime,stormrage,672,warrior,arms,18,7,11
Ryänlord,mugthol,672,warrior,arms,18,7,11
July,arthas,672,warrior,arms,18,7,11
Udmwarrior,zuljin,672,warrior,arms,18,7,11
Lorewow,quelthalas,672,warrior,arms,18,7,11
Arquiem,ragnaros,672,warrior,arms,18,7,11
Dypnos,ragnaros,672,warrior,arms,18,7,11
Goyqqw,illidan,672,warrior,arms,18,7,11
Kforti,kiljaeden,672,warrior,arms,18,7,11
Hårrison,tichondrius,672,warrior,arms,18,7,11
Rudakoff,ragnaros,672,warrior,arms,18,7,11
Beifong,barthilas,672,warrior,arms,24,7,17
Paralyzed,malganis,672,warrior,arms,24,7,17
Omlas,azralon,672,warrior,arms,24,7,17
Festerclaws,wyrmrest-accord,672,warrior,arms,24,7,17
Corevp,barthilas,672,warrior,arms,24,7,17
Natalieftm,tichondrius,672,warrior,arms,24,7,17
Pokeyobutt,hydraxis,672,warrior,arms,24,7,17
Zugmeov,barthilas,672,warrior,arms,24,7,17
Joaododrøp,azralon,671,warrior,arms,12,7,5
Vijit,stormrage,671,warrior,arms,12,7,5
Gunnëy,malganis,671,warrior,arms,12,7,5
Sriara,ragnaros,671,warrior,arms,12,7,5
Furiousangel,area-52,671,warrior,arms,12,7,5
Riffralph,quelthalas,671,warrior,arms,12,7,5
Girthstick,eredar,671,warrior,arms,12,7,5
Rhuktar,azralon,671,warrior,arms,12,7,5
Capo,windrunner,671,warrior,arms,12,7,5
Iradri,wyrmrest-accord,671,warrior,arms,12,7,5
Coffeephd,moon-guard,671,warrior,arms,12,7,5
Hungdiesel,area-52,671,warrior,arms,12,7,5
Jeason,ragnaros,671,warrior,arms,12,7,5
Dêsêcratê,frostmourne,671,warrior,arms,12,7,5
Nyokenshi,quelthalas,671,warrior,arms,12,7,5
Balela,sargeras,671,warrior,arms,12,7,5
Dunkindots,tichondrius,671,warrior,arms,12,7,5
Pipeman,blackhand,671,warrior,arms,12,7,5
Exceldoc,frostwolf,671,warrior,arms,12,7,5
Blazie,barthilas,671,warrior,arms,12,7,5
Maddzspin,tichondrius,671,warrior,arms,12,7,5
Schwicker,stormrage,671,warrior,arms,12,7,5
Glizzarms,dalaran,671,warrior,arms,12,7,5
Kevinlanders,sargeras,671,warrior,arms,12,7,5
Jedeva,stormrage,671,warrior,arms,12,7,5
Ramborco,kelthuzad,671,warrior,arms,12,7,5
Kryssanta,kilrogg,671,warrior,arms,13,7,6
Metaphoric,stormrage,671,warrior,arms,15,8,7
Ironhide,malorne,671,warrior,arms,18,7,11
Stepzugger,illidan,671,warrior,arms,18,7,11
Chieef,illidan,671,warrior,arms,18,7,11
Bröstörm,bonechewer,671,warrior,arms,18,7,11
Mustachelove,bleeding-hollow,671,warrior,arms,18,7,11
Rembrand,blackhand,671,warrior,arms,18,7,11
Analítico,ragnaros,671,warrior,arms,18,7,11
Layøut,azralon,671,warrior,arms,18,7,11
Mirandakerrx,frostmourne,671,warrior,arms,18,7,11
Nehpets,akama,671,warrior,arms,18,7,11
Pharan,malganis,671,warrior,arms,18,7,11
Earnhardt,tichondrius,671,warrior,arms,18,7,11
Kasheeka,spirestone,671,warrior,arms,18,7,11
Cj,proudmoore,671,warrior,arms,18,7,11
Paratech,thrall,671,warrior,arms,18,7,11
Smash,frostmane,671,warrior,arms,18,7,11
Strongtongue,malganis,671,warrior,arms,18,7,11
Mentalape,bleeding-hollow,671,warrior,arms,18,7,11
Conviction,draka,671,warrior,arms,18,7,11
Brøxigár,quelthalas,671,warrior,arms,18,7,11
Chumbinhu,stormrage,671,warrior,arms,18,7,11
Flabergaster,skullcrusher,671,warrior,arms,18,7,11
Moffett,illidan,671,warrior,arms,18,7,11
Grazellor,khaz-modan,671,warrior,arms,18,7,11
Slöppyjoe,blackrock,671,warrior,arms,18,7,11
Andrexion,moon-guard,671,warrior,arms,18,7,11
Xeniwar,tichondrius,671,warrior,arms,20,7,13
Powerjaw,stormrage,671,warrior,arms,24,7,17
Zerevik,stormrage,671,warrior,arms,24,7,17
Tryndåmere,firetree,671,warrior,arms,24,7,17
Winso,blood-furnace,671,warrior,arms,24,7,17
Vandammage,cenarion-circle,671,warrior,arms,24,7,17
Czartacus,dalaran,670,warrior,arms,14,9,5
Svantevit,tichondrius,670,warrior,arms,12,7,5
Hoboken,quelthalas,670,warrior,arms,12,7,5
Nraged,illidan,670,warrior,arms,12,7,5
Oglethorrpe,dragonmaw,670,warrior,arms,12,7,5
Deathlokz,proudmoore,670,warrior,arms,12,7,5
Murrderrface,azgalor,670,warrior,arms,12,7,5
Darquan,trollbane,670,warrior,arms,12,7,5
Eirikdahulk,area-52,670,warrior,arms,12,7,5
Draggo,tortheldrin,670,warrior,arms,12,7,5
Promewar,ragnaros,670,warrior,arms,12,7,5
Babyreap,frostmourne,670,warrior,arms,12,7,5
Bailo,dathremar,670,warrior,arms,12,7,5
Gìraffe,illidan,670,warrior,arms,18,7,11
Dizzygal,hyjal,670,warrior,arms,18,7,11
Daleo,ragnaros,670,warrior,arms,18,7,11
Kaimera,echo-isles,670,warrior,arms,18,7,11
Aquaknight,tortheldrin,670,warrior,arms,18,7,11
Reidahn,zuljin,670,warrior,arms,24,7,17
Tarviss,exodar,670,warrior,arms,26,7,19
Torage,wyrmrest-accord,669,warrior,arms,12,7,5
Astrokreep,emerald-dream,669,warrior,arms,12,7,5
Guille,skullcrusher,669,warrior,arms,12,7,5
Getoffmee,queldorei,669,warrior,arms,18,7,11
Kâyous,tichondrius,669,warrior,arms,18,7,11
Harnor,garrosh,669,warrior,arms,18,7,11
Teyliemond,amanthul,668,warrior,arms,12,7,5
Grokash,azralon,668,warrior,arms,18,7,11
Nepheliloux,amanthul,668,warrior,arms,18,7,11
Pandamoanman,moon-guard,668,warrior,arms,18,7,11
Azaeil,tanaris,668,warrior,arms,18,7,11
Yanïka,barthilas,667,warrior,arms,13,7,6
Moøster,aggramar,667,warrior,arms,18,7,11
Sienge,tortheldrin,667,warrior,arms,18,7,11
Rogkhan,tichondrius,667,warrior,arms,18,7,11
Kevasaurr,sargeras,667,warrior,arms,24,7,17
Zammuro,sargeras,666,warrior,arms,12,7,5
Mattrick,hyjal,665,warrior,arms,12,7,5
Terribletom,stormrage,665,warrior,arms,18,7,11
Wnunes,nemesis,665,warrior,arms,18,7,11
Nepharia,kirin-tor,664,warrior,arms,18,7,11
Jötunn,dalaran,663,warrior,arms,12,7,5
Kriegert,illidan,663,warrior,arms,12,7,5
Othon,nemesis,663,warrior,arms,12,7,5
Lilwarrior,blackrock,661,warrior,arms,12,7,5
Konstanttine,darkspear,660,warrior,arms,13,7,6
Dragothian,laughing-skull,655,warrior,arms,17,7,10
Blok,malorne,655,warrior,arms,17,7,10
Garrygarry,zuljin,639,warrior,arms,14,8,6
Agnesis,quelthalas,639,warrior,arms,16,7,9
Parmizan,hydraxis,639,warrior,arms,16,7,9
Moostorm,darkspear,639,warrior,arms,17,7,10
Fewfingers,sargeras,638,warrior,arms,16,7,9
Jamska,quelthalas,638,warrior,arms,17,7,10
Twinxin,thrall,637,warrior,arms,17,7,10
Rametep,illidan,624,warrior,arms,15,7,8
Oohyu,tichondrius,623,warrior,arms,11,7,4
Tildzy,sargeras,623,warrior,arms,11,7,4
Allenwalker,dreadmaul,623,warrior,arms,13,7,6
Haveya,ghostlands,623,warrior,arms,15,7,8
Bigboycandy,malganis,621,warrior,arms,11,7,4
Bullkathoss,bleeding-hollow,620,warrior,arms,23,8,15
Xunaco,quelthalas,620,warrior,arms,26,7,19
Shabus,moon-guard,617,warrior,arms,21,8,13
Ålbedo,malganis,616,warrior,arms,23,8,15
Kimuraa,hyjal,615,warrior,arms,23,9,14
Spartanor,darkspear,607,warrior,arms,20,7,13
Pkrage,hellscream,606,warrior,arms,11,7,4
Reliquia,quelthalas,606,warrior,arms,20,7,13
Suhwoosh,bleeding-hollow,584,warrior,arms,28,10,18
Nada,eredar,576,warrior,arms,6,6,0
Elpresador,dragonmaw,576,warrior,arms,6,6,0
Dóminus,malfurion,576,warrior,arms,6,6,0
Baltusrol,hydraxis,576,warrior,arms,6,6,0
Khalwar,ragnaros,576,warrior,arms,6,6,0
Darkoil,illidan,576,warrior,arms,6,6,0
Roflcombo,illidan,576,warrior,arms,12,6,6
Sorr,bonechewer,576,warrior,arms,12,6,6
Arên,ragnaros,576,warrior,arms,12,6,6
Swiftystorm,thrall,576,warrior,arms,12,6,6
Tmgagexx,tichondrius,576,warrior,arms,12,6,6
Stÿgían,kelthuzad,576,warrior,arms,12,6,6
Catêyês,kelthuzad,576,warrior,arms,12,6,6
Lathian,sargeras,576,warrior,arms,12,6,6
Illmindofboo,tichondrius,576,warrior,arms,12,6,6
Gladdz,moon-guard,576,warrior,arms,12,6,6
Gílly,borean-tundra,576,warrior,arms,12,6,6
Mebraindead,tichondrius,576,warrior,arms,12,6,6
Ctc,gilneas,576,warrior,arms,12,6,6
Rattw,area-52,576,warrior,arms,12,6,6
Screwz,blackrock,576,warrior,arms,12,6,6
Kronathas,stormrage,576,warrior,arms,12,6,6
Jakslasfa,aegwynn,576,warrior,arms,12,6,6
Flanrych,illidan,576,warrior,arms,12,6,6
Larrythelob,kelthuzad,576,warrior,arms,12,6,6
Feedmetren,tichondrius,576,warrior,arms,12,6,6
Rendron,frostmourne,576,warrior,arms,12,6,6
Inkurushio,suramar,576,warrior,arms,12,6,6
Latorre,kelthuzad,576,warrior,arms,12,6,6
Brrazze,moon-guard,576,warrior,arms,12,6,6
Hülkamanïa,sargeras,576,warrior,arms,12,6,6
Mufasaprime,ursin,576,warrior,arms,12,6,6
Bagginses,quelthalas,576,warrior,arms,12,6,6
Jerebeloz,proudmoore,576,warrior,arms,12,6,6
Kovarro,stormrage,576,warrior,arms,12,6,6
Sodarzok,thaurissan,576,warrior,arms,12,6,6
Azrailz,stormrage,576,warrior,arms,12,6,6
Targramu,emerald-dream,576,warrior,arms,12,6,6
Prìscìlla,stormrage,576,warrior,arms,12,6,6
Trexxen,stormrage,576,warrior,arms,12,6,6
Hitwkey,tichondrius,576,warrior,arms,12,6,6
Aùstin,moon-guard,576,warrior,arms,12,6,6
Dgumby,illidan,576,warrior,arms,12,6,6
Xilents,frostmourne,576,warrior,arms,12,6,6
Warnazx,azralon,576,warrior,arms,12,6,6
Yenør,stormrage,576,warrior,arms,12,6,6
Zingywar,tichondrius,576,warrior,arms,12,6,6
Raahj,sargeras,576,warrior,arms,12,6,6
Rexquando,barthilas,576,warrior,arms,12,6,6
Rokknark,stormrage,576,warrior,arms,12,6,6
Nooniezpw,tichondrius,576,warrior,arms,12,6,6
Bedman,tichondrius,576,warrior,arms,12,6,6
Iromrogar,area-52,576,warrior,arms,12,6,6
Chura,kiljaeden,576,warrior,arms,12,6,6
Spikedudley,wildhammer,576,warrior,arms,12,6,6
Bailu,ragnaros,576,warrior,arms,12,6,6
Griftustle,moon-guard,576,warrior,arms,12,6,6
Sadomize,kiljaeden,576,warrior,arms,12,6,6
Hololeave,tichondrius,576,warrior,arms,12,6,6
Jabakas,tichondrius,576,warrior,arms,12,6,6
Bamlin,sargeras,576,warrior,arms,12,6,6
Cleaveson,malganis,576,warrior,arms,12,6,6
Luminiere,sargeras,576,warrior,arms,12,6,6
Madrak,greymane,576,warrior,arms,12,6,6
Róngor,ragnaros,576,warrior,arms,12,6,6
Señortryhard,area-52,576,warrior,arms,12,6,6
Kuraiaki,crushridge,576,warrior,arms,12,6,6
Breaker,undermine,576,warrior,arms,12,6,6
Brookiecooki,frostmourne,576,warrior,arms,12,6,6
Deicide,quelthalas,576,warrior,arms,12,6,6
Dustiezi,stormrage,576,warrior,arms,12,6,6
Ayaseharuqt,quelthalas,576,warrior,arms,12,6,6
Flidumpling,tichondrius,576,warrior,arms,12,6,6
Biorhn,area-52,576,warrior,arms,12,6,6
Gnomërcy,tichondrius,576,warrior,arms,12,6,6
Êraser,tichondrius,576,warrior,arms,12,6,6
Amortens,area-52,576,warrior,arms,12,6,6
Sigrik,moon-guard,576,warrior,arms,12,6,6
Chrig,tichondrius,576,warrior,arms,12,6,6
Murdokkwml,ragnaros,576,warrior,arms,12,6,6
Linios,tichondrius,576,warrior,arms,12,6,6
Dreamwarr,tichondrius,576,warrior,arms,12,6,6
Clutchclutz,spirestone,576,warrior,arms,12,6,6
Loxcrow,sargeras,576,warrior,arms,12,6,6
Grughak,kiljaeden,576,warrior,arms,12,6,6
Zugsok,thrall,576,warrior,arms,12,6,6
Prontera,illidan,576,warrior,arms,12,6,6
Blazight,dunemaul,576,warrior,arms,12,6,6
Calledon,emerald-dream,576,warrior,arms,12,6,6
Psychescape,cenarius,576,warrior,arms,12,6,6
Glourfindel,quelthalas,576,warrior,arms,12,6,6
Toegap,illidan,576,warrior,arms,12,6,6
Luckychaos,bleeding-hollow,576,warrior,arms,12,6,6
Hipower,lethon,576,warrior,arms,12,6,6
Warsongworg,tichondrius,576,warrior,arms,12,6,6
Littlemieoo,sargeras,576,warrior,arms,12,6,6
Oxxelfer,tichondrius,576,warrior,arms,12,6,6
Assamith,nemesis,576,warrior,arms,12,6,6
Cannibalizm,hyjal,576,warrior,arms,12,6,6
Ratherfull,ragnaros,576,warrior,arms,12,6,6
Cassetto,icecrown,576,warrior,arms,12,6,6
Sunderstruck,boulderfist,576,warrior,arms,12,6,6
Areiana,stormrage,576,warrior,arms,12,6,6
Dollfacelol,bleeding-hollow,576,warrior,arms,12,6,6
Kazabare,tichondrius,576,warrior,arms,12,6,6
Ibyessa,emerald-dream,576,warrior,arms,12,6,6
Reflective,zuljin,576,warrior,arms,12,6,6
Roccoz,quelthalas,576,warrior,arms,12,6,6
Dysazter,ravencrest,576,warrior,arms,12,6,6
Tàlent,thrall,576,warrior,arms,12,6,6
Devastata,jaedenar,576,warrior,arms,12,6,6
Caperage,tichondrius,576,warrior,arms,12,6,6
Gonthoriàn,stormrage,576,warrior,arms,12,6,6
Alphablade,frostmourne,576,warrior,arms,12,6,6
Fatpoos,barthilas,576,warrior,arms,12,6,6
Zzode,tichondrius,576,warrior,arms,12,6,6
Marîn,stormrage,576,warrior,arms,12,6,6
Szar,stormrage,576,warrior,arms,12,6,6
Arozay,illidan,576,warrior,arms,12,6,6
Bonclay,nerzhul,576,warrior,arms,12,6,6
Pyrælara,shattered-halls,576,warrior,arms,12,6,6
Rikthor,sargeras,576,warrior,arms,12,6,6
Armsofury,kelthuzad,576,warrior,arms,12,6,6
Aladarith,moon-guard,576,warrior,arms,12,6,6
Martiallawl,skullcrusher,576,warrior,arms,12,6,6
Orkussw,illidan,576,warrior,arms,12,6,6
Exeqt,terokkar,576,warrior,arms,12,6,6
Guerramacina,tichondrius,576,warrior,arms,13,6,7
Ganzism,tichondrius,576,warrior,arms,13,6,7
Olala,kiljaeden,576,warrior,arms,13,6,7
Phojjangz,tichondrius,576,warrior,arms,16,7,9
Ronak,vashj,576,warrior,arms,18,6,12
Eabywarrs,tichondrius,576,warrior,arms,18,6,12
Lundyswung,silver-hand,576,warrior,arms,18,6,12
Ðred,blackhand,576,warrior,arms,18,6,12
Stormwald,sargeras,576,warrior,arms,18,6,12
Pushh,thrall,576,warrior,arms,18,6,12
Ezgamelol,azralon,576,warrior,arms,18,6,12
Drakunai,shattered-halls,576,warrior,arms,18,6,12
Májorrobot,area-52,576,warrior,arms,18,6,12
Xgraves,sargeras,576,warrior,arms,18,6,12
Syrupsippin,zuljin,576,warrior,arms,18,6,12
Silywarr,frostmourne,576,warrior,arms,18,6,12
Boozy,barthilas,576,warrior,arms,18,6,12
Ahkimih,ragnaros,576,warrior,arms,18,6,12
Kaggorax,tichondrius,576,warrior,arms,18,6,12
Abrakàrn,zuluhed,576,warrior,arms,18,6,12
Dondà,illidan,576,warrior,arms,18,6,12
Robar,trollbane,576,warrior,arms,18,6,12
Mahoneslice,thrall,576,warrior,arms,18,6,12
Egoist,malganis,576,warrior,arms,18,6,12
Longcutie,tichondrius,576,warrior,arms,18,6,12
Kennäy,azralon,576,warrior,arms,18,6,12
Cleavxy,sargeras,576,warrior,arms,18,6,12
Rhinð,sargeras,576,warrior,arms,18,6,12
Fayttful,area-52,576,warrior,arms,18,6,12
Aldhard,moon-guard,576,warrior,arms,18,6,12
Augutra,moon-guard,576,warrior,arms,18,6,12
Psilly,sargeras,576,warrior,arms,18,6,12
Geubsal,tichondrius,576,warrior,arms,18,6,12
Cowboybeast,tanaris,576,warrior,arms,18,6,12
Irondefense,thrall,576,warrior,arms,18,6,12
Nillor,emerald-dream,576,warrior,arms,18,6,12
Sõnics,tichondrius,576,warrior,arms,18,6,12
Lieofa,tichondrius,576,warrior,arms,19,6,13
Contentious,moon-guard,576,warrior,arms,24,6,18
Shîzu,moon-guard,576,warrior,arms,24,6,18
Trohgdor,sargeras,575,warrior,arms,12,6,6
Ragefested,tichondrius,575,warrior,arms,12,6,6
Theodere,moon-guard,575,warrior,arms,12,6,6
Cryptikk,tichondrius,575,warrior,arms,12,6,6
Stonnies,bleeding-hollow,575,warrior,arms,12,6,6
Aguìi,quelthalas,575,warrior,arms,12,6,6
Córnpop,tichondrius,575,warrior,arms,12,6,6
Penryn,illidan,575,warrior,arms,12,6,6
Vioar,hyjal,575,warrior,arms,12,6,6
Pandatrue,azralon,575,warrior,arms,12,6,6
Desul,tichondrius,575,warrior,arms,12,6,6
Amérus,moon-guard,575,warrior,arms,12,6,6
Redneckk,emerald-dream,575,warrior,arms,12,6,6
Thornakh,stormrage,575,warrior,arms,12,6,6
Nospace,tichondrius,575,warrior,arms,12,6,6
Atømic,illidan,575,warrior,arms,12,6,6
Gilisraw,tichondrius,575,warrior,arms,12,6,6
Bolx,archimonde,575,warrior,arms,12,6,6
Edgeegee,sargeras,575,warrior,arms,12,6,6
Obstruktíon,tichondrius,575,warrior,arms,12,6,6
Ajulacho,ragnaros,575,warrior,arms,12,6,6
Abuse,nordrassil,575,warrior,arms,12,6,6
Huggesmash,thaurissan,575,warrior,arms,12,6,6
Gimmiefood,emerald-dream,575,warrior,arms,12,6,6
Tyrall,stormrage,575,warrior,arms,12,6,6
Orryn,proudmoore,575,warrior,arms,12,6,6
Trenbalogna,area-52,575,warrior,arms,12,6,6
Teyrn,stormrage,575,warrior,arms,12,6,6
Balthazãr,quelthalas,575,warrior,arms,12,6,6
Bkdorbandit,illidan,575,warrior,arms,12,6,6
Volnas,earthen-ring,575,warrior,arms,12,6,6
Jujuassgeter,darkspear,575,warrior,arms,12,6,6
Pummels,area-52,575,warrior,arms,12,6,6
Hildibrawn,stormrage,575,warrior,arms,12,6,6
Onisusu,frostmourne,575,warrior,arms,12,6,6
Mekkanic,moon-guard,575,warrior,arms,12,6,6
Weewarrior,wyrmrest-accord,575,warrior,arms,12,6,6
Aybssin,skullcrusher,575,warrior,arms,12,6,6
Burntwaffle,ysera,575,warrior,arms,12,6,6
Maltrate,hyjal,575,warrior,arms,15,7,8
Èxecutè,area-52,575,warrior,arms,15,7,8
Bärdock,ragnaros,575,warrior,arms,16,7,9
Diesel,duskwood,575,warrior,arms,14,6,8
Agoro,tichondrius,575,warrior,arms,14,6,8
Opalert,tichondrius,575,warrior,arms,18,6,12
Renziass,tichondrius,575,warrior,arms,18,6,12
Orckims,tichondrius,575,warrior,arms,18,6,12
Dede,darkspear,575,warrior,arms,18,6,12
Neegrompp,moonrunner,575,warrior,arms,18,6,12
Chadler,dragonmaw,575,warrior,arms,18,6,12
Slamchowdy,tichondrius,575,warrior,arms,18,6,12
Darkshrek,quelthalas,574,warrior,arms,12,6,6
Wako,hyjal,574,warrior,arms,12,6,6
Mubun,tichondrius,574,warrior,arms,12,6,6
Kracha,thrall,574,warrior,arms,12,6,6
Porkasolta,goldrinn,574,warrior,arms,12,6,6
Zolpidem,nemesis,574,warrior,arms,18,6,12
Masami,moon-guard,574,warrior,arms,18,6,12
Grândmâ,zuljin,574,warrior,arms,18,6,12
Tekkamanaxe,tichondrius,574,warrior,arms,24,6,18
Antonios,drakthul,574,warrior,arms,30,6,24
Môgwai,kelthuzad,573,warrior,arms,12,6,6
Chrysion,moon-guard,573,warrior,arms,12,6,6
Logohn,wyrmrest-accord,573,warrior,arms,12,6,6
Dúmp,stormrage,573,warrior,arms,12,6,6
Irgon,quelthalas,573,warrior,arms,12,6,6
Gfree,kiljaeden,573,warrior,arms,21,7,14
Brosèph,sargeras,573,warrior,arms,18,6,12
Liiberator,thrall,573,warrior,arms,18,6,12
Girei,ghostlands,573,warrior,arms,18,6,12
Faóra,moon-guard,572,warrior,arms,12,6,6
Johnsnake,sargeras,572,warrior,arms,12,6,6
Azyxia,emerald-dream,572,warrior,arms,15,7,8
Bitiatus,scilla,572,warrior,arms,18,6,12
Reginato,ravenholdt,572,warrior,arms,18,6,12
Tatsher,turalyon,571,warrior,arms,12,6,6
Rudiblade,dalaran,571,warrior,arms,12,6,6
Slaughterist,illidan,567,warrior,arms,18,6,12
Ciran,azralon,564,warrior,arms,18,6,12
Stormfuhrer,stormrage,559,warrior,arms,15,7,8
Conchalover,illidan,559,warrior,arms,17,6,11
Lïnkzq,frostmourne,558,warrior,arms,10,7,3
Ecopolis,azshara,544,warrior,arms,16,6,10
Ballzindeep,tichondrius,543,warrior,arms,8,7,1
Tastyskeet,illidan,543,warrior,arms,11,6,5
Tâlos,ysondre,543,warrior,arms,11,6,5
Trevvel,proudmoore,543,warrior,arms,11,6,5
Tecnowar,quelthalas,543,warrior,arms,17,6,11
Ragerok,bleeding-hollow,542,warrior,arms,22,7,15
Jÿp,tichondrius,527,warrior,arms,11,6,5
Warwik,stormscale,527,warrior,arms,17,6,11
Ledezma,proudmoore,527,warrior,arms,17,6,11
Lazric,area-52,524,warrior,arms,15,6,9
Meadsweats,tichondrius,522,warrior,arms,17,10,7
Bersérk,area-52,522,warrior,arms,14,8,6
Tomcruz,bloodscalp,522,warrior,arms,16,7,9
Hrókr,kiljaeden,522,warrior,arms,19,8,11
Shaydeen,black-dragonflight,521,warrior,arms,15,7,8
Swafty,daggerspine,519,warrior,arms,17,9,8
Rhok,elune,515,warrior,arms,16,9,7
Protologist,chogall,512,warrior,arms,16,6,10
Illicitiri,sargeras,511,warrior,arms,10,6,4
Samoksk,ragnaros,511,warrior,arms,11,6,5
Kvobash,area-52,511,warrior,arms,11,6,5
Jackjaeger,area-52,511,warrior,arms,16,6,10
Berzerc,stormrage,511,warrior,arms,18,6,12
Ruiend,bonechewer,510,warrior,arms,14,6,8
Tyraelius,kiljaeden,510,warrior,arms,17,6,11
Magarrior,shadowsong,495,warrior,arms,13,7,6
Zachw,stormrage,495,warrior,arms,13,6,7
Warlapse,emerald-dream,494,warrior,arms,13,6,7
Flexecute,area-52,480,warrior,arms,6,5,1
Ryü,khaz-modan,480,warrior,arms,6,5,1
Noor,tichondrius,480,warrior,arms,6,5,1
Xruntz,kelthuzad,480,warrior,arms,6,5,1
Byvo,stormrage,480,warrior,arms,6,5,1
Billythunda,tichondrius,480,warrior,arms,6,5,1
Tehnklo,malorne,480,warrior,arms,6,5,1
Healthpoints,area-52,480,warrior,arms,6,5,1
Warmgun,quelthalas,480,warrior,arms,6,5,1
Tâlos,magtheridon,480,warrior,arms,6,5,1
Ghostemane,whisperwind,480,warrior,arms,6,5,1
Jackox,sargeras,480,warrior,arms,6,5,1
Pavv,malganis,480,warrior,arms,6,5,1
Trojanx,malganis,480,warrior,arms,6,5,1
Kushian,tichondrius,480,warrior,arms,6,5,1
Isoln,tichondrius,480,warrior,arms,6,5,1
Noreaga,tichondrius,480,warrior,arms,6,5,1
Biggesttoees,tichondrius,480,warrior,arms,6,5,1
Zerøhøùr,kul-tiras,480,warrior,arms,6,5,1
Tinymo,archimonde,480,warrior,arms,6,5,1
Jarlaix,dragonmaw,480,warrior,arms,6,5,1
Rickywarx,illidan,480,warrior,arms,6,5,1
Olbus,tichondrius,480,warrior,arms,6,5,1
Ckranzz,azralon,480,warrior,arms,6,5,1
Saladin,gnomeregan,480,warrior,arms,6,5,1
Damore,sargeras,480,warrior,arms,6,5,1
Bootypound,sargeras,480,warrior,arms,6,5,1
Crookedface,area-52,480,warrior,arms,6,5,1
Geàrbreaker,tichondrius,480,warrior,arms,6,5,1
Meatsweatx,stormrage,480,warrior,arms,6,5,1
Moè,frostmourne,480,warrior,arms,10,6,4
Skaaxx,barthilas,480,warrior,arms,10,6,4
Warpenguin,kelthuzad,480,warrior,arms,10,6,4
Whittyxc,tichondrius,480,warrior,arms,9,5,4
Sercastic,illidan,480,warrior,arms,11,6,5
Iamfine,area-52,480,warrior,arms,12,5,7
Phyriix,stormrage,480,warrior,arms,12,5,7
Shadowsea,dragonblight,480,warrior,arms,12,5,7
Ffrog,tichondrius,480,warrior,arms,12,5,7
Glenn,tichondrius,480,warrior,arms,12,5,7
Flexxinpapi,exodar,480,warrior,arms,12,5,7
Sylvanos,arthas,480,warrior,arms,12,5,7
Ericthegreat,azuremyst,480,warrior,arms,12,5,7
Takenotez,sargeras,480,warrior,arms,12,5,7
Paulhëyman,sargeras,480,warrior,arms,12,5,7
Miniwarkingx,tichondrius,480,warrior,arms,12,5,7
Greyknights,kiljaeden,480,warrior,arms,12,5,7
Dillý,area-52,480,warrior,arms,12,5,7
Drudw,moon-guard,480,warrior,arms,12,5,7
Mayshowgunmo,tichondrius,480,warrior,arms,12,5,7
Beerstorm,stormrage,480,warrior,arms,12,5,7
Mimiu,ragnaros,480,warrior,arms,12,5,7
Viizer,tichondrius,480,warrior,arms,12,5,7
Qwort,moon-guard,480,warrior,arms,12,5,7
Secondbro,tichondrius,480,warrior,arms,12,5,7
Vmill,tichondrius,480,warrior,arms,12,5,7
Clamjammed,thrall,480,warrior,arms,12,5,7
Nazgrull,wildhammer,480,warrior,arms,12,5,7
Sigismundd,bonechewer,480,warrior,arms,12,5,7
Kvoth,bleeding-hollow,480,warrior,arms,12,5,7
Kluster,kelthuzad,480,warrior,arms,12,5,7
Silvers,blades-edge,480,warrior,arms,12,5,7
Agoge,stormrage,480,warrior,arms,12,5,7
Claponomics,area-52,480,warrior,arms,12,5,7
Bariotyr,the-underbog,480,warrior,arms,12,5,7
Peters,malfurion,480,warrior,arms,12,5,7
Lanco,kiljaeden,480,warrior,arms,12,5,7
Vurk,area-52,480,warrior,arms,12,5,7
Téry,dalaran,480,warrior,arms,12,5,7
Matumbo,skullcrusher,480,warrior,arms,12,5,7
Kethsel,ragnaros,480,warrior,arms,12,5,7
Wonbin,moon-guard,480,warrior,arms,12,5,7
Thaedes,kelthuzad,480,warrior,arms,12,5,7
Pandaxes,proudmoore,480,warrior,arms,12,5,7
Karik,proudmoore,480,warrior,arms,12,5,7
Astrálís,nemesis,480,warrior,arms,12,5,7
Gonzwold,drenden,480,warrior,arms,12,5,7
Buffwar,tichondrius,480,warrior,arms,12,5,7
Arcâdio,cairne,480,warrior,arms,12,5,7
Krongarr,area-52,480,warrior,arms,12,5,7
Bootysmelly,mannoroth,480,warrior,arms,12,5,7
Excalibruh,frostmourne,480,warrior,arms,12,5,7
Beleña,dalaran,480,warrior,arms,12,5,7
Huleo,tichondrius,480,warrior,arms,12,5,7
Lru,whisperwind,480,warrior,arms,12,5,7
Robertolini,moon-guard,480,warrior,arms,12,5,7
Loveføx,stormrage,480,warrior,arms,12,5,7
Martydom,proudmoore,480,warrior,arms,12,5,7
Loudnoise,frostwolf,480,warrior,arms,12,5,7
Warriorkofwa,tichondrius,480,warrior,arms,12,5,7
Maniel,greymane,480,warrior,arms,12,5,7
Ponygon,quelthalas,480,warrior,arms,12,5,7
Batchat,frostmourne,480,warrior,arms,12,5,7
Thehóund,area-52,480,warrior,arms,12,5,7
Thiccowman,area-52,480,warrior,arms,12,5,7
Crushingnews,sargeras,480,warrior,arms,12,5,7
Shrëkslovaki,tichondrius,480,warrior,arms,12,5,7
Bigcracka,illidan,480,warrior,arms,12,5,7
Fracked,sargeras,480,warrior,arms,12,5,7
Felorelea,moon-guard,480,warrior,arms,12,5,7
Zuiken,kiljaeden,480,warrior,arms,12,5,7
Hemkcus,zuluhed,480,warrior,arms,12,5,7
Gävilar,sargeras,480,warrior,arms,12,5,7
Igoon,dentarg,480,warrior,arms,12,5,7
Schoolbuhs,tichondrius,480,warrior,arms,12,5,7
Tiitlefight,bleeding-hollow,480,warrior,arms,12,5,7
Crammed,tichondrius,480,warrior,arms,12,5,7
Wcb,sargeras,480,warrior,arms,12,5,7
Vãnth,kelthuzad,480,warrior,arms,12,5,7
Shwip,tichondrius,480,warrior,arms,12,5,7
Shadalloo,azralon,480,warrior,arms,12,5,7
Bulldozar,zuljin,480,warrior,arms,12,5,7
Jkasdfglkg,tichondrius,480,warrior,arms,12,5,7
Trevmo,bloodscalp,480,warrior,arms,12,5,7
Zuggernaut,shadowsong,480,warrior,arms,12,5,7
Philipjoo,illidan,480,warrior,arms,12,5,7
Pregnannie,barthilas,480,warrior,arms,12,5,7
Consolidate,hyjal,480,warrior,arms,12,5,7
Juggernäut,malganis,480,warrior,arms,12,5,7
Toddlovesu,kelthuzad,480,warrior,arms,12,5,7
Biggrizz,area-52,480,warrior,arms,12,5,7
Thedeejoner,caelestrasz,480,warrior,arms,12,5,7
Elkinss,tichondrius,480,warrior,arms,12,5,7
Madhouse,tanaris,480,warrior,arms,12,5,7
Kð,zuljin,480,warrior,arms,12,5,7
Metalhog,sargeras,480,warrior,arms,12,5,7
Kamboocha,tichondrius,480,warrior,arms,12,5,7
Cpudemon,undermine,480,warrior,arms,12,5,7
Shapur,tichondrius,480,warrior,arms,12,5,7
Kaikah,aegwynn,480,warrior,arms,12,5,7
Biggiesmash,bleeding-hollow,480,warrior,arms,12,5,7
Sideon,frostmourne,480,warrior,arms,12,5,7
Wën,stormrage,480,warrior,arms,12,5,7
Hìtchslap,tichondrius,480,warrior,arms,12,5,7
Flëët,tichondrius,480,warrior,arms,12,5,7
Spirìt,illidan,480,warrior,arms,12,5,7
Huricas,arthas,480,warrior,arms,12,5,7
Orcbum,kiljaeden,480,warrior,arms,12,5,7
Lokgur,gallywix,480,warrior,arms,12,5,7
Bloodxfrenzy,silvermoon,480,warrior,arms,12,5,7
Meatspinner,sargeras,480,warrior,arms,12,5,7
Womanbeaterx,stormrage,480,warrior,arms,12,5,7
Jäëgër,moon-guard,480,warrior,arms,12,5,7
Scozziee,barthilas,480,warrior,arms,12,5,7
Slamoholic,turalyon,480,warrior,arms,12,5,7
Quinntis,anvilmar,480,warrior,arms,12,5,7
Cuantascopas,ragnaros,480,warrior,arms,12,5,7
Crogosh,quelthalas,480,warrior,arms,12,5,7
Manbok,tichondrius,480,warrior,arms,12,5,7
Brickhouse,tichondrius,480,warrior,arms,12,5,7
Tyragyz,azralon,480,warrior,arms,12,5,7
Whytea,cairne,480,warrior,arms,12,5,7
Dynamiite,bleeding-hollow,480,warrior,arms,12,5,7
Cabi,frostmourne,480,warrior,arms,12,5,7
Justicwar,area-52,480,warrior,arms,12,5,7
Milbën,tichondrius,480,warrior,arms,12,5,7
Andrismash,barthilas,480,warrior,arms,12,5,7
Grandtank,veknilash,480,warrior,arms,15,6,9
Battosaì,bonechewer,480,warrior,arms,15,6,9
Mág,burning-legion,480,warrior,arms,13,5,8
Oledcktwist,garrosh,480,warrior,arms,13,5,8
Zibby,malganis,480,warrior,arms,14,5,9
Darkdargon,tichondrius,480,warrior,arms,18,6,12
Tigershárk,tichondrius,480,warrior,arms,16,5,11
Imprw,stormrage,480,warrior,arms,18,5,13
Kamigoroshi,crushridge,480,warrior,arms,18,5,13
Goaco,drakkari,480,warrior,arms,18,5,13
Reifrayton,ragnaros,480,warrior,arms,18,5,13
Ravager,ragnaros,480,warrior,arms,18,5,13
Skyanidas,korgath,480,warrior,arms,18,5,13
Eightydeuce,bonechewer,480,warrior,arms,18,5,13
Osannd,tichondrius,480,warrior,arms,18,5,13
Shaynaynay,tichondrius,480,warrior,arms,18,5,13
Oofta,kelthuzad,480,warrior,arms,18,5,13
Øvrpwrd,frostmourne,480,warrior,arms,18,5,13
Seppukush,quelthalas,480,warrior,arms,18,5,13
Smackify,stormrage,480,warrior,arms,18,5,13
Kkuzo,bleeding-hollow,480,warrior,arms,18,5,13
Tsathoggua,kiljaeden,480,warrior,arms,18,5,13
Cyllyzie,emerald-dream,480,warrior,arms,18,5,13
Aldathion,argent-dawn,480,warrior,arms,18,5,13
Bigwarrior,stonemaul,480,warrior,arms,19,5,14
Bornclueless,illidan,480,warrior,arms,21,5,16
Creannew,drakkari,480,warrior,arms,24,5,19
Lorinzer,zuljin,480,warrior,arms,24,5,19
Tanger,korgath,479,warrior,arms,6,5,1
Dinocrusher,illidan,479,warrior,arms,6,5,1
Sarkhan,zuluhed,479,warrior,arms,6,5,1
Asidieslowly,tichondrius,479,warrior,arms,6,5,1
Faiken,quelthalas,479,warrior,arms,6,5,1
Rinngo,proudmoore,479,warrior,arms,6,5,1
Trufsoturi,bleeding-hollow,479,warrior,arms,12,5,7
Dirtyrandy,zuluhed,479,warrior,arms,12,5,7
Rücküs,tichondrius,479,warrior,arms,12,5,7
Maudlewis,bladefist,479,warrior,arms,12,5,7
Kurixu,ragnaros,479,warrior,arms,12,5,7
Cueromodel,ragnaros,479,warrior,arms,12,5,7
Crushaholic,azgalor,479,warrior,arms,12,5,7
Stretchytime,emerald-dream,479,warrior,arms,12,5,7
Synestira,frostmourne,479,warrior,arms,12,5,7
Skragg,chogall,479,warrior,arms,12,5,7
Bovisrex,shadow-council,479,warrior,arms,12,5,7
Luckstang,zuljin,479,warrior,arms,12,5,7
Spliff,ghostlands,479,warrior,arms,12,5,7
Unphased,area-52,479,warrior,arms,12,5,7
Warstik,malganis,479,warrior,arms,12,5,7
Têzeret,shadowmoon,479,warrior,arms,12,5,7
Spàcetìme,stormrage,479,warrior,arms,12,5,7
Fwengli,illidan,479,warrior,arms,12,5,7
Reishera,stormrage,479,warrior,arms,12,5,7
Qqmachine,tichondrius,479,warrior,arms,12,5,7
Helscreem,hyjal,479,warrior,arms,18,5,13
Irøns,arthas,479,warrior,arms,18,5,13
Onso,ragnaros,479,warrior,arms,18,5,13
ßlindãø,azralon,479,warrior,arms,18,5,13
Flexecute,senjin,479,warrior,arms,18,5,13
Tentacruels,area-52,479,warrior,arms,18,5,13
Kanicky,draka,479,warrior,arms,18,5,13
Fruth,nagrand,479,warrior,arms,24,5,19
Gorrthrax,area-52,479,warrior,arms,24,5,19
Arooy,azralon,478,warrior,arms,6,5,1
Otyek,proudmoore,478,warrior,arms,12,5,7
Bennybrock,crushridge,478,warrior,arms,12,5,7
Condog,stormrage,478,warrior,arms,12,5,7
Dirtywarrior,lightnings-blade,478,warrior,arms,12,5,7
Tmible,ragnaros,477,warrior,arms,6,5,1
Larale,emerald-dream,477,warrior,arms,12,5,7
Therom,ragnaros,477,warrior,arms,21,6,15
Acanof,azjolnerub,474,warrior,arms,9,6,3
Raktrazbirt,dalaran,472,warrior,arms,12,5,7
Bøøtymuncher,illidan,462,warrior,arms,11,7,4
Naindejardin,sargeras,462,warrior,arms,11,5,6
Danalle,area-52,448,warrior,arms,10,6,4
Mverstappen,azralon,448,warrior,arms,10,5,5
Turboboy,tichondrius,448,warrior,arms,10,5,5
Notcoverage,tichondrius,447,warrior,arms,11,5,6
Tenderturtle,tichondrius,447,warrior,arms,11,5,6
Enelsita,sargeras,447,warrior,arms,14,6,8
Dontkiteme,frostmourne,447,warrior,arms,17,5,12
Boorabill,stormrage,446,warrior,arms,14,6,8
Hvwk,sargeras,445,warrior,arms,11,5,6
Dpsdone,blackrock,432,warrior,arms,9,6,3
Gurgak,illidan,431,warrior,arms,11,5,6
Esko,tichondrius,431,warrior,arms,11,5,6
Jackedaniels,stormrage,431,warrior,arms,12,5,7
Bloodbottle,darkspear,426,warrior,arms,14,7,7
Reignwolf,azralon,426,warrior,arms,13,6,7
Boombasta,shuhalo,426,warrior,arms,15,6,9
Machutron,quelthalas,415,warrior,arms,8,5,3
Yarocktoo,kelthuzad,415,warrior,arms,8,5,3
Crackersmack,stormrage,415,warrior,arms,11,6,5
Nrico,frostmourne,415,warrior,arms,10,5,5
Thano,kiljaeden,415,warrior,arms,10,5,5
Superbest,tichondrius,415,warrior,arms,14,5,9
Smashsmash,barthilas,400,warrior,arms,7,5,2
Calcùlus,kelthuzad,400,warrior,arms,13,5,8
Gushyguts,tichondrius,399,warrior,arms,19,5,14
Wardread,frostmourne,384,warrior,arms,6,4,2
Terminatorr,quelthalas,384,warrior,arms,6,4,2
Wariorwang,tichondrius,384,warrior,arms,6,4,2
Daddydomtop,moon-guard,384,warrior,arms,6,4,2
Gnasty,hyjal,384,warrior,arms,6,4,2
Sayuri,frostmourne,384,warrior,arms,6,4,2
Chapux,ragnaros,384,warrior,arms,6,4,2
Takitó,ragnaros,384,warrior,arms,6,4,2
Picpay,area-52,384,warrior,arms,6,4,2
Claymorer,tichondrius,384,warrior,arms,6,4,2
Deosgladius,ragnaros,384,warrior,arms,6,4,2
Mfgodofwar,kelthuzad,384,warrior,arms,6,4,2
Gozugurself,barthilas,384,warrior,arms,6,4,2
Swaystko,sargeras,384,warrior,arms,6,4,2
Sakuraya,tichondrius,384,warrior,arms,6,4,2
Ragingboner,aggramar,384,warrior,arms,6,4,2
Chulain,tichondrius,384,warrior,arms,6,4,2
Mortalhandx,tichondrius,384,warrior,arms,6,4,2
Swingyslammy,area-52,384,warrior,arms,6,4,2
Ziggeraut,cenarion-circle,384,warrior,arms,6,4,2
Lxstcxntury,sargeras,384,warrior,arms,6,4,2
Sphatic,tichondrius,384,warrior,arms,6,4,2
Farlywarrior,tichondrius,384,warrior,arms,6,4,2
Rõcky,frostmourne,384,warrior,arms,6,4,2
Tickej,dragonmaw,384,warrior,arms,6,4,2
Ckoaw,dalaran,384,warrior,arms,6,4,2
Afelhia,moon-guard,384,warrior,arms,6,4,2
Shartstaín,tichondrius,384,warrior,arms,6,4,2
Swillzz,illidan,384,warrior,arms,6,4,2
Warcheif,dentarg,384,warrior,arms,6,4,2
Mòrgo,agamaggan,384,warrior,arms,6,4,2
Jersucristö,quelthalas,384,warrior,arms,6,4,2
Swordfighter,moon-guard,384,warrior,arms,6,4,2
Yêawen,tichondrius,384,warrior,arms,6,4,2
Fròthy,emerald-dream,384,warrior,arms,6,4,2
Còlòssal,moknathal,384,warrior,arms,6,4,2
Kimbö,quelthalas,384,warrior,arms,6,4,2
Blitzø,malganis,384,warrior,arms,6,4,2
Littlegengar,tichondrius,384,warrior,arms,6,4,2
Blucollardad,bleeding-hollow,384,warrior,arms,6,4,2
Hamur,azralon,384,warrior,arms,6,4,2
Titanmax,kelthuzad,384,warrior,arms,6,4,2
Braxxìnn,tichondrius,384,warrior,arms,6,4,2
Lüxord,quelthalas,384,warrior,arms,6,4,2
Borahgis,area-52,384,warrior,arms,6,4,2
Caberg,ragnaros,384,warrior,arms,6,4,2
Alèx,tichondrius,384,warrior,arms,6,4,2
Bajheeraz,sargeras,384,warrior,arms,6,4,2
Softtofu,illidan,384,warrior,arms,6,4,2
Cheshe,area-52,384,warrior,arms,6,4,2
Pineapplezz,kelthuzad,384,warrior,arms,6,4,2
Zoldyak,ragnaros,384,warrior,arms,6,4,2
Fancysin,malganis,384,warrior,arms,6,4,2
Rungoar,frostmourne,384,warrior,arms,6,4,2
Rinima,tichondrius,384,warrior,arms,6,4,2
Zarttorius,quelthalas,384,warrior,arms,6,4,2
Bütch,stormrage,384,warrior,arms,6,4,2
Ráwrxd,bleeding-hollow,384,warrior,arms,6,4,2
Kraggo,zuljin,384,warrior,arms,6,4,2
Helder,destromath,384,warrior,arms,6,4,2
Frakt,illidan,384,warrior,arms,6,4,2
Restoy,tichondrius,384,warrior,arms,6,4,2
Oddyseey,moon-guard,384,warrior,arms,6,4,2
Nextquestion,sargeras,384,warrior,arms,6,4,2
Iroh,thunderhorn,384,warrior,arms,6,4,2
Fingaz,azralon,384,warrior,arms,6,4,2
Míaguiulfo,ragnaros,384,warrior,arms,6,4,2
Mommystrasza,kelthuzad,384,warrior,arms,6,4,2
Halfman,turalyon,384,warrior,arms,6,4,2
Evergardens,saurfang,384,warrior,arms,6,4,2
Conormacleod,stormrage,384,warrior,arms,6,4,2
Sinergui,nemesis,384,warrior,arms,6,4,2
Kaghogar,area-52,384,warrior,arms,6,4,2
Sanqq,tichondrius,384,warrior,arms,6,4,2
Ediann,elune,384,warrior,arms,6,4,2
Bigmens,illidan,384,warrior,arms,6,4,2
Cläpped,thrall,384,warrior,arms,6,4,2
Kruçify,dark-iron,384,warrior,arms,6,4,2
Krokü,area-52,384,warrior,arms,6,4,2
Thiccyb,area-52,384,warrior,arms,6,4,2
Ssamba,shattered-hand,384,warrior,arms,6,4,2
Sonoflaw,skullcrusher,384,warrior,arms,6,4,2
Prodigi,ragnaros,384,warrior,arms,6,4,2
Malgoth,illidan,384,warrior,arms,6,4,2
Thottprot,blackhand,384,warrior,arms,6,4,2
Sygurd,drakkari,384,warrior,arms,6,4,2
Slapywar,illidan,384,warrior,arms,6,4,2
Bajheeraz,tichondrius,384,warrior,arms,6,4,2
Calembo,illidan,384,warrior,arms,6,4,2
Burzerk,malganis,384,warrior,arms,6,4,2
Ummso,nerzhul,384,warrior,arms,6,4,2
Mystïctank,sargeras,384,warrior,arms,6,4,2
Gangdan,sargeras,384,warrior,arms,6,4,2
Aægekaz,proudmoore,384,warrior,arms,6,4,2
Stromdart,quelthalas,384,warrior,arms,6,4,2
Dazfury,barthilas,384,warrior,arms,6,4,2
Pilgrimslays,tichondrius,384,warrior,arms,6,4,2
Bjërgsen,azralon,384,warrior,arms,6,4,2
Evencane,stormrage,384,warrior,arms,6,4,2
Farmtruckqt,proudmoore,384,warrior,arms,6,4,2
Boomtacular,moon-guard,384,warrior,arms,6,4,2
Appolyonn,hyjal,384,warrior,arms,6,4,2
Tsutsana,lightninghoof,384,warrior,arms,6,4,2
Neon,wildhammer,384,warrior,arms,6,4,2
Gamörä,illidan,384,warrior,arms,6,4,2
Diâbetes,area-52,384,warrior,arms,6,4,2
Gurneyhalec,proudmoore,384,warrior,arms,6,4,2
Koalabear,shadow-council,384,warrior,arms,6,4,2
Tankdawg,draktharon,384,warrior,arms,6,4,2
Hamburgezo,quelthalas,384,warrior,arms,6,4,2
Datogkush,frostmourne,384,warrior,arms,6,4,2
Mikrotik,alleria,384,warrior,arms,6,4,2
Yivicus,sargeras,384,warrior,arms,6,4,2
Ygìr,mannoroth,384,warrior,arms,6,4,2
Orangew,dalaran,384,warrior,arms,6,4,2
Veedrin,ysera,384,warrior,arms,6,4,2
Odalp,tichondrius,384,warrior,arms,6,4,2
Majinnox,wyrmrest-accord,384,warrior,arms,6,4,2
Stormleap,tichondrius,384,warrior,arms,6,4,2
Bruisebanner,area-52,384,warrior,arms,6,4,2
Styiex,ragnaros,384,warrior,arms,6,4,2
Yagarel,dalaran,384,warrior,arms,6,4,2
Mcwanga,barthilas,384,warrior,arms,6,4,2
Demolishier,quelthalas,384,warrior,arms,6,4,2
Copinhodagua,azralon,384,warrior,arms,6,4,2
Dragonupup,tichondrius,384,warrior,arms,6,4,2
Misticstorm,barthilas,384,warrior,arms,6,4,2
Slipter,ragnaros,384,warrior,arms,6,4,2
Crunchytacos,zuljin,384,warrior,arms,6,4,2
Hoboeddtwo,area-52,384,warrior,arms,6,4,2
Galaxius,frostmane,384,warrior,arms,7,4,3
Hitmypronoun,illidan,384,warrior,arms,9,5,4
Greenishfox,illidan,384,warrior,arms,9,5,4
Finndal,bleeding-hollow,384,warrior,arms,9,5,4
Ragnarlbrok,goldrinn,384,warrior,arms,10,5,5
Kalisandra,undermine,384,warrior,arms,10,5,5
Ailes,hakkar,384,warrior,arms,11,4,7
Jaredfrmsbwy,kelthuzad,384,warrior,arms,12,4,8
Redbeanw,tichondrius,384,warrior,arms,12,4,8
Draiken,dalaran,384,warrior,arms,12,4,8
Handikap,stormrage,384,warrior,arms,12,4,8
Chongos,malganis,384,warrior,arms,12,4,8
Thelsarian,nerzhul,384,warrior,arms,12,4,8
Brendan,llane,384,warrior,arms,12,4,8
Malahorda,illidan,384,warrior,arms,12,4,8
Nginx,queldorei,384,warrior,arms,12,4,8
Demonsterz,ravenholdt,384,warrior,arms,12,4,8
Chàrr,crushridge,384,warrior,arms,12,4,8
Metalhit,tichondrius,384,warrior,arms,12,4,8
Barrocops,kiljaeden,384,warrior,arms,12,4,8
Joekenshield,stonemaul,384,warrior,arms,12,4,8
Crimsóñ,kelthuzad,384,warrior,arms,12,4,8
Bewbeebangz,kelthuzad,384,warrior,arms,12,4,8
Totenhammer,nathrezim,384,warrior,arms,12,4,8
Varrian,rivendare,384,warrior,arms,12,4,8
Licona,wyrmrest-accord,384,warrior,arms,12,4,8
Jasonsdady,illidan,384,warrior,arms,12,4,8
Fetalalcohol,illidan,384,warrior,arms,12,4,8
Ferilya,thunderhorn,384,warrior,arms,12,4,8
Runningatyou,area-52,384,warrior,arms,12,4,8
Claphub,malganis,384,warrior,arms,12,4,8
Koei,illidan,384,warrior,arms,12,4,8
Tanksbad,lightnings-blade,384,warrior,arms,12,4,8
Estrasystole,sargeras,384,warrior,arms,12,4,8
Sandrine,fizzcrank,384,warrior,arms,12,4,8
Ästen,kargath,384,warrior,arms,12,4,8
Galaxywar,stormrage,384,warrior,arms,12,4,8
Jathellum,stormrage,384,warrior,arms,12,4,8
Khaellanax,azralon,384,warrior,arms,12,4,8
Bib,malganis,384,warrior,arms,12,4,8
Renclave,wyrmrest-accord,384,warrior,arms,12,4,8
Pop,stormrage,384,warrior,arms,12,4,8
Laokan,illidan,384,warrior,arms,12,4,8
Palumorw,deathwing,384,warrior,arms,12,4,8
Doully,proudmoore,384,warrior,arms,12,4,8
Porchorc,hyjal,384,warrior,arms,12,4,8
Sorty,emerald-dream,384,warrior,arms,12,4,8
Xårren,stormrage,384,warrior,arms,12,4,8
Regax,thrall,384,warrior,arms,12,4,8
Wendër,area-52,384,warrior,arms,12,4,8
Lebs,frostmourne,384,warrior,arms,12,4,8
Smokr,azralon,384,warrior,arms,12,4,8
Bigboy,icecrown,384,warrior,arms,12,4,8
Bigshett,sargeras,384,warrior,arms,12,4,8
Angrybrog,malfurion,384,warrior,arms,12,4,8
Pilsenerog,ragnaros,384,warrior,arms,12,4,8
Còsmico,trollbane,384,warrior,arms,12,4,8
Gurtheng,sargeras,384,warrior,arms,12,4,8
Rexmar,tichondrius,384,warrior,arms,12,4,8
Gangaa,barthilas,384,warrior,arms,12,4,8
Meanface,malganis,384,warrior,arms,12,4,8
Wingnut,zuluhed,384,warrior,arms,12,4,8
Emmartillos,ragnaros,384,warrior,arms,12,4,8
Majitz,azralon,384,warrior,arms,12,4,8
Ladderx,area-52,384,warrior,arms,12,4,8
Warmachined,grizzly-hills,384,warrior,arms,12,4,8
Narduk,emerald-dream,384,warrior,arms,12,4,8
Facekilla,nordrassil,384,warrior,arms,12,4,8
Filth,tichondrius,384,warrior,arms,12,4,8
Bersk,sargeras,384,warrior,arms,12,4,8
Notfaytful,thrall,384,warrior,arms,12,4,8
Vurks,frostmourne,384,warrior,arms,12,4,8
Redrumman,demon-soul,384,warrior,arms,12,4,8
Izhansheni,illidan,384,warrior,arms,12,4,8
Grullhamer,ragnaros,384,warrior,arms,12,4,8
Warspartan,stormrage,384,warrior,arms,12,4,8
Brazenox,illidan,384,warrior,arms,12,4,8
Dessindir,quelthalas,384,warrior,arms,12,4,8
Drewpqawk,tichondrius,384,warrior,arms,12,4,8
Kenedy,moon-guard,384,warrior,arms,12,4,8
Zamera,tichondrius,384,warrior,arms,12,4,8
Dosey,kelthuzad,384,warrior,arms,12,4,8
Furyofrage,dalaran,384,warrior,arms,12,4,8
Freedum,shandris,384,warrior,arms,12,4,8
Nerolanast,wyrmrest-accord,384,warrior,arms,12,4,8
Velanos,bleeding-hollow,384,warrior,arms,12,4,8
Guyllol,barthilas,384,warrior,arms,12,4,8
Akoro,bleeding-hollow,384,warrior,arms,12,4,8
Gazah,skullcrusher,384,warrior,arms,12,4,8
Zulataza,zuljin,384,warrior,arms,12,4,8
Durango,duskwood,384,warrior,arms,12,4,8
Flexyx,arthas,384,warrior,arms,12,4,8
Gorethak,kiljaeden,384,warrior,arms,12,4,8
Moseshrute,zuljin,384,warrior,arms,12,4,8
Gaouis,stormreaver,384,warrior,arms,12,4,8
Tappyc,tichondrius,384,warrior,arms,12,4,8
Fatherkelso,tichondrius,384,warrior,arms,12,4,8
Frntdblbicep,tichondrius,384,warrior,arms,12,4,8
Lørdvingådør,azralon,384,warrior,arms,12,4,8
Indfo,altar-of-storms,384,warrior,arms,12,4,8
Hameey,sargeras,384,warrior,arms,12,4,8
Mefus,wyrmrest-accord,384,warrior,arms,12,4,8
Hambster,frostmane,384,warrior,arms,12,4,8
Obama,chogall,384,warrior,arms,12,4,8
Zebel,tichondrius,384,warrior,arms,12,4,8
Hârambe,kiljaeden,384,warrior,arms,12,4,8
Aldaøm,ragnaros,384,warrior,arms,12,4,8
Nxmabala,proudmoore,384,warrior,arms,12,4,8
Cupper,tichondrius,384,warrior,arms,12,4,8
Snack,stormreaver,384,warrior,arms,12,4,8
Daduké,stormrage,384,warrior,arms,12,4,8
Murotamaka,malganis,384,warrior,arms,12,4,8
Ballsy,fenris,384,warrior,arms,12,4,8
Drakgøre,ragnaros,384,warrior,arms,12,4,8
Goodrik,quelthalas,384,warrior,arms,12,4,8
Zebron,sargeras,384,warrior,arms,12,4,8
Mindgoblin,bleeding-hollow,384,warrior,arms,12,4,8
Iargestpp,bleeding-hollow,384,warrior,arms,12,4,8
Hamslamm,area-52,384,warrior,arms,12,4,8
Mikejustice,kelthuzad,384,warrior,arms,12,4,8
Verrynasty,area-52,384,warrior,arms,12,4,8
Swingú,illidan,384,warrior,arms,12,4,8
Naelynh,quelthalas,384,warrior,arms,12,4,8
Heliza,ragnaros,384,warrior,arms,12,4,8
Spacegoatze,thunderlord,384,warrior,arms,12,4,8
Wyborn,emerald-dream,384,warrior,arms,12,4,8
Dámöuse,stormrage,384,warrior,arms,12,4,8
Allonsas,moon-guard,384,warrior,arms,12,4,8
Sinkale,moon-guard,384,warrior,arms,12,4,8
Iden,vashj,384,warrior,arms,12,4,8
Zantetsukenn,sargeras,384,warrior,arms,12,4,8
Jaclksparrow,azralon,384,warrior,arms,12,4,8
Warriormikey,tichondrius,384,warrior,arms,12,4,8
Twoshoutz,stormrage,384,warrior,arms,12,4,8
Bondadoso,stormrage,384,warrior,arms,13,4,9
Varkery,sargeras,384,warrior,arms,13,4,9
Lunusx,stormrage,384,warrior,arms,13,4,9
Kyres,moon-guard,384,warrior,arms,16,4,12
Biggieth,sargeras,384,warrior,arms,21,5,16
Jazzkiler,azralon,384,warrior,arms,17,4,13
Gladicus,zuljin,384,warrior,arms,18,4,14
Raggnar,zuluhed,384,warrior,arms,18,4,14
Cowsgomerr,tichondrius,384,warrior,arms,18,4,14
Retiarius,tichondrius,384,warrior,arms,18,4,14
Asphyxiating,illidan,384,warrior,arms,18,4,14
Draxxarlol,zuljin,384,warrior,arms,18,4,14
Zugyu,tichondrius,384,warrior,arms,18,4,14
Powerlift,area-52,384,warrior,arms,18,4,14
Orcrist,stormreaver,383,warrior,arms,6,4,2
Unbeaten,malganis,383,warrior,arms,6,4,2
Ezaxe,tichondrius,383,warrior,arms,6,4,2
Thedozer,kargath,383,warrior,arms,6,4,2
Sethh,ragnaros,383,warrior,arms,6,4,2
Randumxx,nerzhul,383,warrior,arms,6,4,2
Rathlann,crushridge,383,warrior,arms,6,4,2
Yeit,tichondrius,383,warrior,arms,6,4,2
Tookbeki,tichondrius,383,warrior,arms,6,4,2
Antêro,sargeras,383,warrior,arms,12,4,8
Ralf,emerald-dream,383,warrior,arms,12,4,8
Drovik,malygos,383,warrior,arms,12,4,8
Orangerzze,hyjal,383,warrior,arms,12,4,8
Duvir,frostwolf,383,warrior,arms,12,4,8
Dayafter,queldorei,383,warrior,arms,12,4,8
Aazokk,emerald-dream,383,warrior,arms,12,4,8
Ajamu,aegwynn,383,warrior,arms,12,4,8
Spitbeard,kargath,383,warrior,arms,12,4,8
Bläckraven,quelthalas,383,warrior,arms,12,4,8
Christellà,dalaran,383,warrior,arms,18,4,14
Bigbouba,jubeithos,383,warrior,arms,24,4,20
Bahlsac,cenarion-circle,382,warrior,arms,12,4,8
Lightstrikes,sargeras,379,warrior,arms,12,4,8
Dingoe,wyrmrest-accord,379,warrior,arms,12,4,8
Handdok,runetotem,379,warrior,arms,12,4,8
Såmmÿ,moon-guard,379,warrior,arms,12,4,8
Twohandkilla,scilla,367,warrior,arms,11,4,7
Loomine,illidan,367,warrior,arms,11,4,7
Shagalaca,tichondrius,367,warrior,arms,11,4,7
Drakôn,quelthalas,367,warrior,arms,11,4,7
Xaxxar,bleeding-hollow,367,warrior,arms,11,4,7
Warsins,bonechewer,367,warrior,arms,17,4,13
Gâbríel,maiev,351,warrior,arms,11,4,7
Förkz,ragnaros,351,warrior,arms,11,4,7
Vaetren,area-52,351,warrior,arms,11,4,7
Thøros,moon-guard,351,warrior,arms,11,4,7
Twinktop,tichondrius,351,warrior,arms,11,4,7
Cönan,thunderhorn,351,warrior,arms,16,4,12
Boyarde,tichondrius,336,warrior,arms,9,4,5
Matasimio,drakkari,336,warrior,arms,9,4,5
Justentacle,zuljin,336,warrior,arms,15,4,11
Sinweaver,bleeding-hollow,335,warrior,arms,9,5,4
Caynos,stormrage,335,warrior,arms,11,4,7
Toir,bladefist,335,warrior,arms,11,4,7
Jimpepega,quelthalas,335,warrior,arms,11,4,7
Rubbers,thrall,330,warrior,arms,17,6,11
Macray,zuljin,330,warrior,arms,18,5,13
Lildumptruck,emerald-dream,320,warrior,arms,10,4,6
Painstake,illidan,320,warrior,arms,19,5,14
Toetoeto,darrowmere,319,warrior,arms,5,4,1
Skollton,tichondrius,319,warrior,arms,5,4,1
Vaider,bleeding-hollow,319,warrior,arms,5,4,1
Rauwers,azralon,319,warrior,arms,8,4,4
Kricken,frostmourne,319,warrior,arms,8,4,4
Cptdrako,alterac-mountains,319,warrior,arms,8,4,4
Aerriz,area-52,319,warrior,arms,11,4,7
Edmaghar,ragnaros,319,warrior,arms,14,4,10
Atruis,area-52,304,warrior,arms,7,4,3
Syradar,ragnaros,304,warrior,arms,13,4,9
Rezhan,area-52,304,warrior,arms,13,4,9
Nicolasrage,trollbane,303,warrior,arms,11,5,6
Hotboxer,kelthuzad,295,warrior,arms,12,5,7
Rockhardt,tichondrius,288,warrior,arms,6,3,3
Faywarsong,area-52,288,warrior,arms,6,3,3
Runtasticx,tichondrius,288,warrior,arms,6,3,3
Agamere,stormrage,288,warrior,arms,6,3,3
Jutank,sargeras,288,warrior,arms,6,3,3
Gpro,tichondrius,288,warrior,arms,6,3,3
Davien,tichondrius,288,warrior,arms,6,3,3
Yasser,ragnaros,288,warrior,arms,6,3,3
Drugdilla,zuljin,288,warrior,arms,6,3,3
Hesch,thunderlord,288,warrior,arms,6,3,3
Schlosh,laughing-skull,288,warrior,arms,6,3,3
Dronarmus,ragnaros,288,warrior,arms,6,3,3
Robio,tichondrius,288,warrior,arms,6,3,3
Mcrîb,stormscale,288,warrior,arms,6,3,3
Kénblock,tichondrius,288,warrior,arms,6,3,3
Småckêd,sargeras,288,warrior,arms,6,3,3
Scottpilgrim,illidan,288,warrior,arms,6,3,3
Bigpharma,elune,288,warrior,arms,6,3,3
Caalypso,stormrage,288,warrior,arms,6,3,3
Badvelic,tichondrius,288,warrior,arms,6,3,3
Nedstarc,laughing-skull,288,warrior,arms,6,3,3
Wrèckingball,tichondrius,288,warrior,arms,6,3,3
Hanginaround,zuluhed,288,warrior,arms,6,3,3
Spartanfury,tichondrius,288,warrior,arms,6,3,3
Mekaknight,destromath,288,warrior,arms,6,3,3
Swifty,tichondrius,288,warrior,arms,6,3,3
Hotaha,tichondrius,288,warrior,arms,6,3,3
Robostergler,tichondrius,288,warrior,arms,6,3,3
Dematic,skullcrusher,288,warrior,arms,6,3,3
Az,malorne,288,warrior,arms,6,3,3
Críxus,sargeras,288,warrior,arms,6,3,3
Tulnaak,durotan,288,warrior,arms,6,3,3
Valför,ysera,288,warrior,arms,6,3,3
Salveknight,ragnaros,288,warrior,arms,6,3,3
Vólkar,quelthalas,288,warrior,arms,6,3,3
Roidråge,area-52,288,warrior,arms,6,3,3
Ayenel,stormrage,288,warrior,arms,6,3,3
Poppacd,stormrage,288,warrior,arms,6,3,3
Swizzly,tichondrius,288,warrior,arms,6,3,3
Hytonmi,moon-guard,288,warrior,arms,6,3,3
Daedrion,dalaran,288,warrior,arms,6,3,3
Allmurr,ragnaros,288,warrior,arms,6,3,3
Decimus,medivh,288,warrior,arms,6,3,3
Larosfan,tichondrius,288,warrior,arms,6,3,3
Brayven,area-52,288,warrior,arms,6,3,3
Grapegush,bleeding-hollow,288,warrior,arms,6,3,3
Ambevsgunnar,tichondrius,288,warrior,arms,6,3,3
Nazakeen,tichondrius,288,warrior,arms,6,3,3
Rezorc,stormrage,288,warrior,arms,6,3,3
Smashndspin,sargeras,288,warrior,arms,6,3,3
Necrøbutchër,ragnaros,288,warrior,arms,6,3,3
Allmotor,zuljin,288,warrior,arms,6,3,3
Fjswpp,tichondrius,288,warrior,arms,6,3,3
Springbreak,bleeding-hollow,288,warrior,arms,6,3,3
Exdilla,zuljin,288,warrior,arms,6,3,3
Riidim,area-52,288,warrior,arms,6,3,3
Fakktwo,blackhand,288,warrior,arms,6,3,3
Mandofl,ragnaros,288,warrior,arms,6,3,3
Jerveen,quelthalas,288,warrior,arms,6,3,3
Cheekclapps,tichondrius,288,warrior,arms,6,3,3
Dedbeet,barthilas,288,warrior,arms,6,3,3
Kuntahkintah,tichondrius,288,warrior,arms,6,3,3
Blazingfury,area-52,288,warrior,arms,6,3,3
Jackanape,sargeras,288,warrior,arms,6,3,3
Magthor,warsong,288,warrior,arms,6,3,3
Zemms,mannoroth,288,warrior,arms,6,3,3
Kokurawr,burning-legion,288,warrior,arms,6,3,3
Aalrua,moon-guard,288,warrior,arms,6,3,3
Serindel,quelthalas,288,warrior,arms,6,3,3
Mcbanner,ragnaros,288,warrior,arms,6,3,3
Notawar,stormrage,288,warrior,arms,6,3,3
Wrekzor,zuljin,288,warrior,arms,6,3,3
Mortaryon,malganis,288,warrior,arms,6,3,3
Hellscrom,galakrond,288,warrior,arms,6,3,3
Trashman,frostwolf,288,warrior,arms,6,3,3
Reapr,moonrunner,288,warrior,arms,6,3,3
Exequet,tichondrius,288,warrior,arms,6,3,3
Zenmore,illidan,288,warrior,arms,6,3,3
Zåzriel,tichondrius,288,warrior,arms,6,3,3
Aiöria,ragnaros,288,warrior,arms,6,3,3
Fivewarrior,tichondrius,288,warrior,arms,6,3,3
Tsmtsmtsm,tichondrius,288,warrior,arms,6,3,3
Cwar,tichondrius,288,warrior,arms,6,3,3
Dropthemic,tichondrius,288,warrior,arms,6,3,3
Zemi,sargeras,288,warrior,arms,6,3,3
Darkirondolo,tichondrius,288,warrior,arms,6,3,3
Humanlog,illidan,288,warrior,arms,6,3,3
Glowstick,tichondrius,288,warrior,arms,6,3,3
Miarisa,moon-guard,288,warrior,arms,6,3,3
Idarkshakra,illidan,288,warrior,arms,6,3,3
Perfz,bleeding-hollow,288,warrior,arms,6,3,3
Srkong,stormrage,288,warrior,arms,6,3,3
Cabelas,tichondrius,288,warrior,arms,6,3,3
Akhinoz,area-52,288,warrior,arms,6,3,3
Óðinnodin,tichondrius,288,warrior,arms,6,3,3
Leonidas,barthilas,288,warrior,arms,6,3,3
Tnytank,burning-legion,288,warrior,arms,6,3,3
Wulfgarn,frostwolf,288,warrior,arms,6,3,3
Sweetmojito,vashj,288,warrior,arms,6,3,3
Chronicdank,tichondrius,288,warrior,arms,6,3,3
Clerond,tichondrius,288,warrior,arms,6,3,3
Cokedope,tichondrius,288,warrior,arms,6,3,3
Noteko,tichondrius,288,warrior,arms,6,3,3
Desertor,illidan,288,warrior,arms,6,3,3
Chøde,barthilas,288,warrior,arms,6,3,3
Letyoupain,illidan,288,warrior,arms,6,3,3
Altron,icecrown,288,warrior,arms,6,3,3
Ssamok,ragnaros,288,warrior,arms,6,3,3
Shloope,barthilas,288,warrior,arms,6,3,3
Drakr,ragnaros,288,warrior,arms,6,3,3
Vibrates,stormreaver,288,warrior,arms,6,3,3
Fregory,moon-guard,288,warrior,arms,6,3,3
Exiledwarz,area-52,288,warrior,arms,6,3,3
Temperament,area-52,288,warrior,arms,6,3,3
Meatpouch,kelthuzad,288,warrior,arms,6,3,3
Axeslaps,illidan,288,warrior,arms,6,3,3
Hotwings,kelthuzad,288,warrior,arms,6,3,3
Warriortimes,ragnaros,288,warrior,arms,6,3,3
Warnuk,lightnings-blade,288,warrior,arms,6,3,3
Retrô,uldum,288,warrior,arms,6,3,3
Tread,mugthol,288,warrior,arms,6,3,3
Akilosh,illidan,288,warrior,arms,6,3,3
Richenbach,kelthuzad,288,warrior,arms,6,3,3
Corrum,shuhalo,288,warrior,arms,6,3,3
Dunsker,stormrage,288,warrior,arms,6,3,3
Pussman,malganis,288,warrior,arms,6,3,3
Topee,area-52,288,warrior,arms,6,3,3
Hukzula,illidan,288,warrior,arms,6,3,3
Shiromiya,tichondrius,288,warrior,arms,6,3,3
Percanator,aggramar,288,warrior,arms,6,3,3
Renning,malganis,288,warrior,arms,6,3,3
Smashbashdie,stormrage,288,warrior,arms,6,3,3
Ellx,sargeras,288,warrior,arms,6,3,3
Jeyvil,stormrage,288,warrior,arms,6,3,3
Thunderess,illidan,288,warrior,arms,6,3,3
Garroshrimp,tichondrius,288,warrior,arms,6,3,3
Tothepain,thrall,288,warrior,arms,6,3,3
Evôlutiôn,kelthuzad,288,warrior,arms,6,3,3
Gypsypsycho,stormrage,288,warrior,arms,6,3,3
Huffzo,tichondrius,288,warrior,arms,6,3,3
Solembuumm,illidan,288,warrior,arms,6,3,3
Cryptex,illidan,288,warrior,arms,6,3,3
Fyle,stormrage,288,warrior,arms,6,3,3
Readytoflee,moon-guard,288,warrior,arms,6,3,3
Assmut,stormrage,288,warrior,arms,6,3,3
Senzhi,sargeras,288,warrior,arms,6,3,3
Dolph,sargeras,288,warrior,arms,6,3,3
Ragemelon,icecrown,288,warrior,arms,6,3,3
Stárscreám,malganis,288,warrior,arms,6,3,3
Haginn,malorne,288,warrior,arms,6,3,3
Éten,drakkari,288,warrior,arms,6,3,3
Girthquake,stormreaver,288,warrior,arms,6,3,3
Ghomory,quelthalas,288,warrior,arms,6,3,3
Imperiial,stormrage,288,warrior,arms,6,3,3
Flarkin,area-52,288,warrior,arms,6,3,3
Largegayman,sargeras,288,warrior,arms,6,3,3
Miltlan,drakkari,288,warrior,arms,6,3,3
Duglug,malganis,288,warrior,arms,6,3,3
Warreeper,area-52,288,warrior,arms,6,3,3
Mittyroar,khazgoroth,288,warrior,arms,6,3,3
Jug,khazgoroth,288,warrior,arms,6,3,3
Messe,khazgoroth,288,warrior,arms,6,3,3
Seymourbot,illidan,288,warrior,arms,6,3,3
Kajind,boulderfist,288,warrior,arms,6,3,3
Rockybâlboa,illidan,288,warrior,arms,6,3,3
Finnagnome,sargeras,288,warrior,arms,6,3,3
Siouxfall,area-52,288,warrior,arms,6,3,3
Tragictonka,stormrage,288,warrior,arms,6,3,3
Vistacleave,maiev,288,warrior,arms,6,3,3
Skullsplittr,illidan,288,warrior,arms,6,3,3
Krïtzkreig,the-forgotten-coast,288,warrior,arms,6,3,3
Gulharot,stormrage,288,warrior,arms,6,3,3
Forthejeers,sargeras,288,warrior,arms,6,3,3
Dublinn,llane,288,warrior,arms,6,3,3
Elegance,llane,288,warrior,arms,6,3,3
Bëowulf,malganis,288,warrior,arms,6,3,3
Sauceslinga,frostmourne,288,warrior,arms,6,3,3
Antiab,ragnaros,288,warrior,arms,6,3,3
Uzy,proudmoore,288,warrior,arms,6,3,3
Vnw,illidan,288,warrior,arms,6,3,3
Unhealbedam,area-52,288,warrior,arms,6,3,3
Camaeel,stormrage,288,warrior,arms,6,3,3
Orkwar,tichondrius,288,warrior,arms,6,3,3
Nukehazard,bleeding-hollow,288,warrior,arms,6,3,3
Liltotey,frostmourne,288,warrior,arms,6,3,3
Benieswar,frostmourne,288,warrior,arms,6,3,3
Brôm,emerald-dream,288,warrior,arms,6,3,3
Sunhands,emerald-dream,288,warrior,arms,6,3,3
Leeth,azralon,288,warrior,arms,6,3,3
Telynne,frostmourne,288,warrior,arms,6,3,3
Warbringerr,hydraxis,288,warrior,arms,6,3,3
Ei,darrowmere,288,warrior,arms,6,3,3
Geyaráh,azralon,288,warrior,arms,6,3,3
Ragëqt,windrunner,288,warrior,arms,6,3,3
Sinjino,proudmoore,288,warrior,arms,6,3,3
Gorkrog,frostmourne,288,warrior,arms,6,3,3
Boitoróh,azralon,288,warrior,arms,6,3,3
Gungo,kiljaeden,288,warrior,arms,6,3,3
Renseven,frostmourne,288,warrior,arms,6,3,3
Kryptïç,moon-guard,288,warrior,arms,6,3,3
Carborr,frostmourne,288,warrior,arms,6,3,3
Osselan,moon-guard,288,warrior,arms,6,3,3
Bghero,wyrmrest-accord,288,warrior,arms,6,3,3
Faelzerá,azralon,288,warrior,arms,6,3,3
Trackhawk,moon-guard,288,warrior,arms,6,3,3
Preceptron,azralon,288,warrior,arms,6,3,3
Bullblader,azralon,288,warrior,arms,6,3,3
Billpoonover,blackwing-lair,288,warrior,arms,6,3,3
Awöl,jubeithos,288,warrior,arms,6,3,3
Edokthong,frostmourne,288,warrior,arms,6,3,3
Scanlan,dalvengyr,288,warrior,arms,6,3,3
Flavorw,cairne,288,warrior,arms,6,3,3
Ymìr,moon-guard,288,warrior,arms,6,3,3
Vinetic,kiljaeden,288,warrior,arms,6,3,3
Phaknah,emerald-dream,288,warrior,arms,6,3,3
Poonoxo,gundrak,288,warrior,arms,6,3,3
Tenfury,proudmoore,288,warrior,arms,6,3,3
Tinylimbs,frostmourne,288,warrior,arms,6,3,3
Valperion,frostmourne,288,warrior,arms,6,3,3
Rhonusturune,blackrock,288,warrior,arms,6,3,3
Ðuffman,jubeithos,288,warrior,arms,6,3,3
Maldre,stormrage,288,warrior,arms,9,4,5
Rageslayer,area-52,288,warrior,arms,9,4,5
Grognäk,malganis,288,warrior,arms,7,3,4
Terukan,drakkari,288,warrior,arms,7,3,4
Ohdang,dark-iron,288,warrior,arms,8,3,5
Ennia,azralon,288,warrior,arms,9,3,6
Akil,ragnaros,288,warrior,arms,15,4,11
Neltar,nagrand,288,warrior,arms,12,3,9
Extremist,nagrand,288,warrior,arms,12,3,9
Eightballerz,barthilas,288,warrior,arms,12,3,9
Scrubzwarr,barthilas,288,warrior,arms,12,3,9
Porori,proudmoore,288,warrior,arms,12,3,9
Ntwandamaela,moon-guard,288,warrior,arms,12,3,9
Smallraccoon,tichondrius,288,warrior,arms,12,3,9
Grimthad,emerald-dream,288,warrior,arms,12,3,9
Erzawälkër,quelthalas,288,warrior,arms,12,3,9
Darthfaith,azgalor,288,warrior,arms,12,3,9
Beenbag,aerie-peak,288,warrior,arms,12,3,9
Orcboic,area-52,288,warrior,arms,12,3,9
Minnysota,area-52,288,warrior,arms,12,3,9
Äisemberg,quelthalas,288,warrior,arms,12,3,9
Aræn,sargeras,288,warrior,arms,12,3,9
Gnomas,destromath,288,warrior,arms,12,3,9
Ichil,azshara,288,warrior,arms,12,3,9
Smashyu,fenris,288,warrior,arms,12,3,9
Bekilled,frostmourne,288,warrior,arms,12,3,9
Relay,mugthol,288,warrior,arms,12,3,9
Battleboxes,area-52,288,warrior,arms,12,3,9
Basingsei,area-52,288,warrior,arms,12,3,9
Kirikash,illidan,288,warrior,arms,12,3,9
Ggodmyles,lightbringer,288,warrior,arms,12,3,9
Morgithia,suramar,288,warrior,arms,12,3,9
Mesw,illidan,288,warrior,arms,12,3,9
Fupatwo,moon-guard,288,warrior,arms,12,3,9
Zaeyr,tichondrius,288,warrior,arms,12,3,9
Forarrior,malganis,288,warrior,arms,12,3,9
Alliancerulz,darrowmere,288,warrior,arms,12,3,9
Kero,malganis,288,warrior,arms,12,3,9
Valestrike,moon-guard,288,warrior,arms,12,3,9
Aralla,area-52,288,warrior,arms,12,3,9
Kigo,azralon,288,warrior,arms,12,3,9
Guerreraa,ragnaros,288,warrior,arms,12,3,9
Krunchal,terenas,288,warrior,arms,12,3,9
Wxxz,tichondrius,288,warrior,arms,12,3,9
Luchonamøm,ragnaros,288,warrior,arms,12,3,9
Xdragonfirex,terenas,288,warrior,arms,12,3,9
Djshinobi,whisperwind,288,warrior,arms,12,3,9
Swiftless,gnomeregan,288,warrior,arms,12,3,9
Brujas,blackrock,288,warrior,arms,12,3,9
Sescor,moon-guard,288,warrior,arms,12,3,9
Hozer,tichondrius,288,warrior,arms,12,3,9
Naughtynilla,sargeras,288,warrior,arms,12,3,9
Brütalize,wyrmrest-accord,288,warrior,arms,12,3,9
Maldrik,exodar,288,warrior,arms,12,3,9
Mothor,thrall,288,warrior,arms,12,3,9
Ggéz,stormrage,288,warrior,arms,12,3,9
Âlecos,ragnaros,288,warrior,arms,12,3,9
Hrl,tichondrius,288,warrior,arms,12,3,9
Melancalli,thorium-brotherhood,288,warrior,arms,12,3,9
Enzothebaker,thrall,288,warrior,arms,12,3,9
Kregnar,gundrak,288,warrior,arms,12,3,9
Nektar,aerie-peak,288,warrior,arms,12,3,9
Roadpig,zuljin,288,warrior,arms,12,3,9
Héro,stormrage,288,warrior,arms,12,3,9
Geontage,drakkari,288,warrior,arms,12,3,9
Nightwing,bleeding-hollow,288,warrior,arms,12,3,9
Émerald,kilrogg,288,warrior,arms,12,3,9
Paxyisbad,tichondrius,288,warrior,arms,12,3,9
Doomr,tichondrius,288,warrior,arms,12,3,9
Staticego,dalaran,288,warrior,arms,12,3,9
Mavromantus,lightninghoof,288,warrior,arms,12,3,9
Kintownhero,aegwynn,288,warrior,arms,12,3,9
Dablao,tichondrius,288,warrior,arms,12,3,9
Enulimen,daggerspine,288,warrior,arms,12,3,9
Zsl,tichondrius,288,warrior,arms,12,3,9
Snippy,garona,288,warrior,arms,12,3,9
Mansin,tichondrius,288,warrior,arms,12,3,9
Dainbramage,dalaran,288,warrior,arms,12,3,9
Awezc,chogall,288,warrior,arms,12,3,9
Kierto,undermine,288,warrior,arms,12,3,9
Phargo,korgath,288,warrior,arms,12,3,9
Glamen,moon-guard,288,warrior,arms,12,3,9
Kiillwar,smolderthorn,288,warrior,arms,12,3,9
Lowdopamine,tichondrius,288,warrior,arms,12,3,9
Soughloe,illidan,288,warrior,arms,12,3,9
Slamspam,the-underbog,288,warrior,arms,13,3,10
Khallell,illidan,288,warrior,arms,18,3,15
Dorathorn,azralon,288,warrior,arms,18,3,15
Integrâl,tichondrius,288,warrior,arms,18,3,15
Mathilan,moon-guard,288,warrior,arms,18,3,15
Giant,lothar,288,warrior,arms,18,3,15
Madgrim,tichondrius,288,warrior,arms,18,3,15
Macbride,blackrock,288,warrior,arms,24,3,21
Yomaaln,blackrock,287,warrior,arms,6,3,3
Silverludê,sargeras,287,warrior,arms,6,3,3
Magtharas,dunemaul,287,warrior,arms,6,3,3
Elliyuh,darkspear,287,warrior,arms,6,3,3
Saintgeorge,thorium-brotherhood,287,warrior,arms,6,3,3
Breinan,ragnaros,287,warrior,arms,6,3,3
Smashthings,area-52,287,warrior,arms,6,3,3
Noktarr,tichondrius,287,warrior,arms,9,4,5
Brutekush,barthilas,287,warrior,arms,12,3,9
Leosax,drakthul,287,warrior,arms,12,3,9
Clayske,gurubashi,287,warrior,arms,12,3,9
Dekromm,tol-barad,287,warrior,arms,12,3,9
Rhawl,ragnaros,287,warrior,arms,22,5,17
Borgosa,wyrmrest-accord,287,warrior,arms,18,3,15
Tyronê,moon-guard,287,warrior,arms,18,3,15
Morphexo,quelthalas,276,warrior,arms,20,6,14
Vith,bleeding-hollow,271,warrior,arms,11,3,8
Dazanor,moon-guard,271,warrior,arms,11,3,8
Zugbrained,zuljin,271,warrior,arms,11,3,8
Nooy,blackrock,271,warrior,arms,17,3,14
Thorsën,sargeras,256,warrior,arms,8,4,4
Zuckexe,illidan,256,warrior,arms,10,3,7
Pippysmallz,tichondrius,256,warrior,arms,10,3,7
Nècroxious,hellscream,255,warrior,arms,11,3,8
Spicywagyu,tichondrius,255,warrior,arms,11,3,8
Blksquadron,sargeras,253,warrior,arms,12,3,9
Faduuba,quelthalas,240,warrior,arms,9,3,6
Builtdif,zuljin,239,warrior,arms,5,3,2
Busyguyw,kiljaeden,239,warrior,arms,5,3,2
ßlitzxkreig,tichondrius,239,warrior,arms,5,3,2
Omicripto,tichondrius,239,warrior,arms,5,3,2
Hakén,tichondrius,239,warrior,arms,5,3,2
Kholusia,kul-tiras,239,warrior,arms,5,3,2
Kalphok,tichondrius,239,warrior,arms,5,3,2
Likearock,thrall,239,warrior,arms,5,3,2
Benchpress,bleeding-hollow,223,warrior,arms,8,3,5
Nayaqt,tichondrius,223,warrior,arms,8,3,5
Snikkles,frostmourne,223,warrior,arms,8,3,5
Metal,ragnaros,223,warrior,arms,8,3,5
Nicked,azralon,223,warrior,arms,14,3,11
Condemnd,area-52,207,warrior,arms,8,3,5
Elyn,tichondrius,192,warrior,arms,4,3,1
Wonderjack,akama,192,warrior,arms,4,3,1
Porotitto,drakkari,192,warrior,arms,11,4,7
Arianarkw,sargeras,192,warrior,arms,9,3,6
Berru,bleeding-hollow,192,warrior,arms,9,3,6
Cugino,tichondrius,192,warrior,arms,9,3,6
Shiestyzug,tichondrius,192,warrior,arms,6,2,4
Xurug,zuljin,192,warrior,arms,6,2,4
Spaceshuttle,bleeding-hollow,192,warrior,arms,6,2,4
Tonytonychop,chogall,192,warrior,arms,6,2,4
Trenbopanda,tichondrius,192,warrior,arms,6,2,4
Hookiee,zuljin,192,warrior,arms,6,2,4
Pookythebear,tichondrius,192,warrior,arms,6,2,4
Armsracê,zuljin,192,warrior,arms,6,2,4
Harlo,nerzhul,192,warrior,arms,6,2,4
Bloodscream,magtheridon,192,warrior,arms,6,2,4
Freezyraw,zuljin,192,warrior,arms,6,2,4
Suavay,executus,192,warrior,arms,6,2,4
Vamsx,barthilas,192,warrior,arms,6,2,4
Verwischen,zuljin,192,warrior,arms,6,2,4
Danksoms,arthas,192,warrior,arms,6,2,4
Ronipastrami,kelthuzad,192,warrior,arms,6,2,4
Tnknspnk,magtheridon,192,warrior,arms,6,2,4
Chopmeat,ysera,192,warrior,arms,6,2,4
Chapa,tichondrius,192,warrior,arms,6,2,4
Kostikk,tichondrius,192,warrior,arms,6,2,4
Bearlornan,frostmourne,192,warrior,arms,6,2,4
Tatro,tichondrius,192,warrior,arms,6,2,4
Passionjar,bleeding-hollow,192,warrior,arms,6,2,4
Bs,kiljaeden,192,warrior,arms,6,2,4
Burstful,bleeding-hollow,192,warrior,arms,6,2,4
Oow,barthilas,192,warrior,arms,6,2,4
Drtbag,tichondrius,192,warrior,arms,6,2,4
Avansys,tichondrius,192,warrior,arms,6,2,4
Bronzeblood,arthas,192,warrior,arms,6,2,4
Kvnñ,frostmourne,192,warrior,arms,6,2,4
Bigbungus,frostmourne,192,warrior,arms,6,2,4
Papichoppyme,bleeding-hollow,192,warrior,arms,6,2,4
Emraldfury,darkspear,192,warrior,arms,6,2,4
Kinaed,durotan,192,warrior,arms,6,2,4
Clayguns,argent-dawn,192,warrior,arms,6,2,4
Hurricán,tichondrius,192,warrior,arms,6,2,4
Gtrain,barthilas,192,warrior,arms,6,2,4
Ningz,tichondrius,192,warrior,arms,6,2,4
Risr,illidan,192,warrior,arms,6,2,4
Dracufeuer,bleeding-hollow,192,warrior,arms,6,2,4
Annubiis,tichondrius,192,warrior,arms,6,2,4
Zingerboss,barthilas,192,warrior,arms,6,2,4
Depressedman,tichondrius,192,warrior,arms,6,2,4
Stormbadge,tichondrius,192,warrior,arms,6,2,4
Hellabandz,bleeding-hollow,192,warrior,arms,6,2,4
Blackzone,lethon,192,warrior,arms,6,2,4
Sylvannlee,tichondrius,192,warrior,arms,6,2,4
Shrexecute,tichondrius,192,warrior,arms,6,2,4
Deloum,tichondrius,192,warrior,arms,6,2,4
Marszx,frostmourne,192,warrior,arms,6,2,4
Icebringer,frostmourne,192,warrior,arms,6,2,4
Rendus,hyjal,192,warrior,arms,6,2,4
Uldrath,hyjal,192,warrior,arms,6,2,4
Controlololx,hyjal,192,warrior,arms,6,2,4
Kratøz,tichondrius,192,warrior,arms,6,2,4
Sweatyvols,illidan,192,warrior,arms,6,2,4
Thiccthôt,frostmourne,192,warrior,arms,6,2,4
Tokushima,illidan,192,warrior,arms,6,2,4
Roidragez,illidan,192,warrior,arms,6,2,4
Flyaf,illidan,192,warrior,arms,6,2,4
Fäey,dalaran,192,warrior,arms,6,2,4
Kuthero,bonechewer,192,warrior,arms,6,2,4
Endlesskilla,destromath,192,warrior,arms,6,2,4
Braxxinn,tichondrius,192,warrior,arms,6,2,4
Squonks,kelthuzad,192,warrior,arms,6,2,4
Ychazz,stormrage,192,warrior,arms,6,2,4
Dreadworld,bleeding-hollow,192,warrior,arms,6,2,4
Focalabbys,illidan,192,warrior,arms,6,2,4
Soldiër,proudmoore,192,warrior,arms,6,2,4
Tinykong,zuljin,192,warrior,arms,6,2,4
Gigglamesh,muradin,192,warrior,arms,6,2,4
Rambð,illidan,192,warrior,arms,6,2,4
Wakkawar,stormrage,192,warrior,arms,6,2,4
Orphenkaos,bleeding-hollow,192,warrior,arms,6,2,4
Baynn,frostmourne,192,warrior,arms,6,2,4
Guroku,tichondrius,192,warrior,arms,6,2,4
Berario,garrosh,192,warrior,arms,6,2,4
Åmowarr,illidan,192,warrior,arms,6,2,4
Dalmor,stormrage,192,warrior,arms,6,2,4
Beirdo,aegwynn,192,warrior,arms,6,2,4
Bjorgsen,frostmourne,192,warrior,arms,6,2,4
Berserkur,daggerspine,192,warrior,arms,6,2,4
Wildawar,tichondrius,192,warrior,arms,6,2,4
Befòx,tichondrius,192,warrior,arms,6,2,4
Josmawar,drakkari,192,warrior,arms,6,2,4
Kreits,drakkari,192,warrior,arms,6,2,4
Nabangle,barthilas,192,warrior,arms,6,2,4
Eleenoor,drakkari,192,warrior,arms,6,2,4
Clumhaku,dalaran,192,warrior,arms,6,2,4
Darkstrikee,tichondrius,192,warrior,arms,6,2,4
Ulkharek,wyrmrest-accord,192,warrior,arms,6,2,4
Deepsplitter,illidan,192,warrior,arms,6,2,4
Soulmerc,turalyon,192,warrior,arms,6,2,4
Orcly,kilrogg,192,warrior,arms,6,2,4
Variants,azralon,192,warrior,arms,6,2,4
Danskmand,tichondrius,192,warrior,arms,6,2,4
Kénny,stormrage,192,warrior,arms,6,2,4
Stellabear,aggramar,192,warrior,arms,6,2,4
Brenrainn,thrall,192,warrior,arms,6,2,4
Warcryof,illidan,192,warrior,arms,6,2,4
Stavsie,tichondrius,192,warrior,arms,6,2,4
Borealiss,ragnaros,192,warrior,arms,6,2,4
Tyir,ragnaros,192,warrior,arms,6,2,4
Ereshom,wyrmrest-accord,192,warrior,arms,6,2,4
Saabre,tichondrius,192,warrior,arms,6,2,4
Jessicajinn,illidan,192,warrior,arms,6,2,4
Ruinhorn,thrall,192,warrior,arms,6,2,4
Vampiranha,azralon,192,warrior,arms,6,2,4
Jéshka,wyrmrest-accord,192,warrior,arms,6,2,4
Rekshor,wyrmrest-accord,192,warrior,arms,6,2,4
Trouz,ragnaros,192,warrior,arms,6,2,4
Raldoron,thrall,192,warrior,arms,6,2,4
Joelyyonerr,barthilas,192,warrior,arms,6,2,4
Sosaalmigh,tichondrius,192,warrior,arms,6,2,4
Bubjones,anvilmar,192,warrior,arms,6,2,4
Suzushi,tichondrius,192,warrior,arms,6,2,4
Overlordz,azralon,192,warrior,arms,6,2,4
Dunklad,thrall,192,warrior,arms,6,2,4
Hoovie,thrall,192,warrior,arms,6,2,4
Bbyzugga,kelthuzad,192,warrior,arms,6,2,4
Karlsabad,medivh,192,warrior,arms,6,2,4
Draimän,ragnaros,192,warrior,arms,6,2,4
Frankal,aegwynn,192,warrior,arms,6,2,4
Dagorine,eredar,192,warrior,arms,6,2,4
Bloodthristy,dunemaul,192,warrior,arms,6,2,4
Hbbaboy,nagrand,192,warrior,arms,6,2,4
Æxe,tichondrius,192,warrior,arms,6,2,4
ßabybeef,azralon,192,warrior,arms,6,2,4
Warkaiser,ragnaros,192,warrior,arms,6,2,4
Surge,eredar,192,warrior,arms,6,2,4
Chuck,zangarmarsh,192,warrior,arms,6,2,4
Troyana,azralon,192,warrior,arms,6,2,4
Bestexecutes,stormrage,192,warrior,arms,6,2,4
Wl,ragnaros,192,warrior,arms,6,2,4
Maleficous,tol-barad,192,warrior,arms,6,2,4
Jírky,ragnaros,192,warrior,arms,6,2,4
Corazondleón,ragnaros,192,warrior,arms,6,2,4
Anabolicjim,frostmourne,192,warrior,arms,6,2,4
Negrolas,nemesis,192,warrior,arms,6,2,4
Denival,proudmoore,192,warrior,arms,6,2,4
Disheartened,wyrmrest-accord,192,warrior,arms,6,2,4
Nezy,frostmourne,192,warrior,arms,6,2,4
Gátzú,ragnaros,192,warrior,arms,6,2,4
Yeèzy,stormrage,192,warrior,arms,6,2,4
Arbitraiter,whisperwind,192,warrior,arms,6,2,4
Yeicomoon,ragnaros,192,warrior,arms,6,2,4
Tankum,dunemaul,192,warrior,arms,6,2,4
Dodiru,azralon,192,warrior,arms,6,2,4
Düde,whisperwind,192,warrior,arms,6,2,4
Crno,stormrage,192,warrior,arms,6,2,4
Bonetotem,azralon,192,warrior,arms,6,2,4
Mansaniwis,tichondrius,192,warrior,arms,6,2,4
Xaviorn,illidan,192,warrior,arms,6,2,4
Helminth,kirin-tor,192,warrior,arms,6,2,4
Tarkvs,ragnaros,192,warrior,arms,6,2,4
Flakesskillz,darkspear,192,warrior,arms,6,2,4
Padregordo,stormrage,192,warrior,arms,6,2,4
Slamzftw,stormreaver,192,warrior,arms,6,2,4
Annihilataur,blackhand,192,warrior,arms,6,2,4
Rizmal,area-52,192,warrior,arms,6,2,4
Failnat,area-52,192,warrior,arms,6,2,4
Lgnasty,area-52,192,warrior,arms,6,2,4
Bogii,area-52,192,warrior,arms,6,2,4
Primørdíal,tichondrius,192,warrior,arms,6,2,4
Lhariza,stormrage,192,warrior,arms,6,2,4
Wooglinx,stormrage,192,warrior,arms,6,2,4
Dahakawar,malganis,192,warrior,arms,6,2,4
Sypii,malganis,192,warrior,arms,6,2,4
Saltos,frostmourne,192,warrior,arms,6,2,4
Pép,malganis,192,warrior,arms,6,2,4
Tnknspnk,stormrage,192,warrior,arms,6,2,4
Chrizo,area-52,192,warrior,arms,6,2,4
Saltycrakerz,area-52,192,warrior,arms,6,2,4
Nordrages,stormrage,192,warrior,arms,6,2,4
Ggcthulu,area-52,192,warrior,arms,6,2,4
Nerffrogues,stormrage,192,warrior,arms,6,2,4
Immadropyou,malganis,192,warrior,arms,6,2,4
Akaínu,area-52,192,warrior,arms,6,2,4
Àyo,frostmourne,192,warrior,arms,6,2,4
Titanwarr,malganis,192,warrior,arms,6,2,4
Riggs,stonemaul,192,warrior,arms,6,2,4
Hitokïri,stormrage,192,warrior,arms,6,2,4
Playbox,area-52,192,warrior,arms,6,2,4
Çampbêll,area-52,192,warrior,arms,6,2,4
Treeinchkokk,area-52,192,warrior,arms,6,2,4
Comic,malganis,192,warrior,arms,6,2,4
Digitalfear,malganis,192,warrior,arms,6,2,4
Pendrake,proudmoore,192,warrior,arms,6,2,4
Kalabawph,area-52,192,warrior,arms,6,2,4
Derr,tichondrius,192,warrior,arms,6,2,4
Zulex,dathremar,192,warrior,arms,6,2,4
Eurthx,lightbringer,192,warrior,arms,6,2,4
Smokingops,frostmourne,192,warrior,arms,6,2,4
Warhova,area-52,192,warrior,arms,6,2,4
Pisagnòmos,quelthalas,192,warrior,arms,6,2,4
Alitalia,thunderlord,192,warrior,arms,6,2,4
Dëckhand,proudmoore,192,warrior,arms,6,2,4
Kraff,tichondrius,192,warrior,arms,6,2,4
Tüssèll,khazgoroth,192,warrior,arms,6,2,4
Jakelope,proudmoore,192,warrior,arms,6,2,4
Eravor,quelthalas,192,warrior,arms,6,2,4
Airolol,tichondrius,192,warrior,arms,6,2,4
Mututu,frostmourne,192,warrior,arms,6,2,4
Lazarenthus,stormrage,192,warrior,arms,6,2,4
Marconisabio,azralon,192,warrior,arms,6,2,4
Beilian,quelthalas,192,warrior,arms,6,2,4
Hagger,quelthalas,192,warrior,arms,6,2,4
Stebe,thunderlord,192,warrior,arms,6,2,4
Tearadis,thunderlord,192,warrior,arms,6,2,4
Guanabacoa,area-52,192,warrior,arms,6,2,4
Toscö,quelthalas,192,warrior,arms,6,2,4
Deldramor,proudmoore,192,warrior,arms,6,2,4
Hookahmasta,area-52,192,warrior,arms,6,2,4
Exec,mannoroth,192,warrior,arms,6,2,4
Mongofiera,quelthalas,192,warrior,arms,6,2,4
Pornawar,area-52,192,warrior,arms,6,2,4
Fùzzy,zuluhed,192,warrior,arms,6,2,4
Smokinaces,emerald-dream,192,warrior,arms,6,2,4
Iapologiz,illidan,192,warrior,arms,6,2,4
Uprisèn,illidan,192,warrior,arms,6,2,4
Stinkdog,khazgoroth,192,warrior,arms,6,2,4
Bradic,bladefist,192,warrior,arms,6,2,4
Scrubwarrior,black-dragonflight,192,warrior,arms,6,2,4
Hawaiianko,guldan,192,warrior,arms,6,2,4
Disturbed,velen,192,warrior,arms,6,2,4
Vegr,queldorei,192,warrior,arms,6,2,4
Xtrego,quelthalas,192,warrior,arms,6,2,4
Kiladrew,korgath,192,warrior,arms,6,2,4
Zabutay,quelthalas,192,warrior,arms,6,2,4
Noblêsix,dalaran,192,warrior,arms,6,2,4
Adonis,burning-blade,192,warrior,arms,6,2,4
Donni,kelthuzad,192,warrior,arms,6,2,4
Liabilities,icecrown,192,warrior,arms,6,2,4
Minionz,tichondrius,192,warrior,arms,6,2,4
Smeshyou,kelthuzad,192,warrior,arms,6,2,4
Orson,lothar,192,warrior,arms,6,2,4
Yeetzbytre,sargeras,192,warrior,arms,6,2,4
Mahknut,moon-guard,192,warrior,arms,6,2,4
Lopotron,sargeras,192,warrior,arms,6,2,4
Thresdan,emerald-dream,192,warrior,arms,6,2,4
Tormite,spirestone,192,warrior,arms,6,2,4
Oneeyewille,sargeras,192,warrior,arms,6,2,4
Berserkchow,sargeras,192,warrior,arms,6,2,4
Pollere,firetree,192,warrior,arms,6,2,4
Steelbane,moon-guard,192,warrior,arms,6,2,4
Skalvi,moon-guard,192,warrior,arms,6,2,4
Donpepe,sargeras,192,warrior,arms,6,2,4
Negrus,sargeras,192,warrior,arms,6,2,4
Beârz,the-underbog,192,warrior,arms,6,2,4
Alppha,emerald-dream,192,warrior,arms,6,2,4
Lvcifer,akama,192,warrior,arms,6,2,4
Mochigome,moon-guard,192,warrior,arms,6,2,4
Rí,moon-guard,192,warrior,arms,6,2,4
Pandemonio,burning-legion,192,warrior,arms,6,2,4
Lavablood,moon-guard,192,warrior,arms,6,2,4
Zerríck,moon-guard,192,warrior,arms,6,2,4
Plata,akama,192,warrior,arms,6,2,4
Zekken,blades-edge,192,warrior,arms,6,2,4
Fealix,moon-guard,192,warrior,arms,6,2,4
Creedmor,moon-guard,192,warrior,arms,6,2,4
Oðín,emerald-dream,192,warrior,arms,6,2,4
Linkedd,sargeras,192,warrior,arms,6,2,4
Valky,sargeras,192,warrior,arms,6,2,4
Revinth,sargeras,192,warrior,arms,6,2,4
Daechoochoo,frostwolf,192,warrior,arms,6,2,4
Moosoka,malorne,192,warrior,arms,6,2,4
Rassius,sargeras,192,warrior,arms,6,2,4
Amicus,frostmourne,192,warrior,arms,7,2,5
Sinenrs,tichondrius,192,warrior,arms,8,2,6
Xavíerus,tichondrius,192,warrior,arms,9,2,7
Rexsi,korgath,192,warrior,arms,9,2,7
Redrunebar,illidan,192,warrior,arms,10,2,8
Hiddensquids,laughing-skull,192,warrior,arms,11,2,9
Ragekilla,silvermoon,192,warrior,arms,12,2,10
Alvitr,kelthuzad,192,warrior,arms,12,2,10
Twoironfist,azralon,192,warrior,arms,12,2,10
Cleaver,draka,192,warrior,arms,12,2,10
Lawyer,quelthalas,192,warrior,arms,12,2,10
Zulm,emerald-dream,192,warrior,arms,12,2,10
Jiva,emerald-dream,192,warrior,arms,12,2,10
Item,nerzhul,192,warrior,arms,12,2,10
Grègore,stormrage,192,warrior,arms,12,2,10
Killtrain,illidan,192,warrior,arms,12,2,10
Yoknitron,bonechewer,192,warrior,arms,12,2,10
Bearyfresh,area-52,192,warrior,arms,12,2,10
Loveliuna,illidan,192,warrior,arms,12,2,10
Warmachîne,area-52,192,warrior,arms,12,2,10
Loktaromoose,frostmourne,192,warrior,arms,12,2,10
Goretooth,moon-guard,192,warrior,arms,12,2,10
Bronkyaf,hyjal,192,warrior,arms,12,2,10
Trollchopo,kiljaeden,192,warrior,arms,12,2,10
Axemurdera,frostmourne,192,warrior,arms,12,2,10
Erwin,kiljaeden,192,warrior,arms,12,2,10
Stipdip,tichondrius,192,warrior,arms,12,2,10
Aymadommy,illidan,192,warrior,arms,12,2,10
Gouzizhang,proudmoore,192,warrior,arms,12,2,10
Léonwow,tichondrius,192,warrior,arms,12,2,10
Árades,tichondrius,192,warrior,arms,12,2,10
Råging,area-52,192,warrior,arms,12,2,10
Gornal,sargeras,192,warrior,arms,12,2,10
Spårtacus,illidan,192,warrior,arms,12,2,10
Shaffer,bleeding-hollow,192,warrior,arms,12,2,10
Jsl,tichondrius,192,warrior,arms,12,2,10
Strongboii,tichondrius,192,warrior,arms,12,2,10
Ohhgeekush,proudmoore,192,warrior,arms,12,2,10
Braygar,barthilas,192,warrior,arms,12,2,10
Jhalakni,quelthalas,192,warrior,arms,12,2,10
Annyan,ragnaros,192,warrior,arms,12,2,10
Avondwella,undermine,192,warrior,arms,12,2,10
Warhoofz,malganis,192,warrior,arms,12,2,10
Connero,stormrage,192,warrior,arms,12,2,10
Escuamata,quelthalas,192,warrior,arms,12,2,10
Gambii,moon-guard,192,warrior,arms,12,2,10
Hellswine,barthilas,192,warrior,arms,12,2,10
Kurzix,crushridge,192,warrior,arms,12,2,10
Lawlstørm,stormrage,192,warrior,arms,12,2,10
Zaxxry,malganis,192,warrior,arms,12,2,10
Mokthar,barthilas,192,warrior,arms,12,2,10
Hugezs,tichondrius,192,warrior,arms,12,2,10
Falcmore,stormrage,192,warrior,arms,12,2,10
Haruq,tichondrius,192,warrior,arms,12,2,10
Artá,uldum,192,warrior,arms,12,2,10
Brutaltruth,dragonmaw,192,warrior,arms,12,2,10
Arthurston,tichondrius,192,warrior,arms,12,2,10
Pennyonebutt,barthilas,192,warrior,arms,12,2,10
Schecterguy,stormrage,192,warrior,arms,14,2,12
Fallensoul,nazjatar,192,warrior,arms,14,2,12
Edrelang,bronzebeard,191,warrior,arms,6,2,4
Blackkcow,zuljin,191,warrior,arms,6,2,4
Hazell,gundrak,191,warrior,arms,6,2,4
Krátös,farstriders,191,warrior,arms,6,2,4
Chóps,quelthalas,191,warrior,arms,6,2,4
Bunedau,azgalor,191,warrior,arms,12,2,10
Berserko,gurubashi,175,warrior,arms,9,4,5
Hornsolo,archimonde,175,warrior,arms,11,2,9
Hemmy,kilrogg,175,warrior,arms,11,2,9
Tour,proudmoore,160,warrior,arms,10,2,8
Ybsorc,kelthuzad,160,warrior,arms,10,2,8
Kellsbro,hyjal,159,warrior,arms,5,2,3
Zîppyx,tichondrius,159,warrior,arms,5,2,3
Wyerlyn,illidan,159,warrior,arms,5,2,3
Vapyr,moon-guard,159,warrior,arms,5,2,3
Rutroo,kelthuzad,159,warrior,arms,5,2,3
Gontore,thrall,159,warrior,arms,5,2,3
Notoriousmmà,illidan,159,warrior,arms,5,2,3
Swordblood,ragnaros,159,warrior,arms,5,2,3
Leshak,tichondrius,159,warrior,arms,5,2,3
Sheerwill,wyrmrest-accord,159,warrior,arms,8,3,5
Eatscrayons,barthilas,159,warrior,arms,11,2,9
Liftedgainz,stormreaver,144,warrior,arms,3,3,0
Chawboks,sargeras,144,warrior,arms,9,2,7
Dösiërx,area-52,138,warrior,arms,9,3,6
Fatbarstard,jubeithos,138,warrior,arms,16,3,13
Scottie,cairne,136,warrior,arms,7,3,4
Nosors,kelthuzad,128,warrior,arms,4,2,2
Clarityw,illidan,128,warrior,arms,4,2,2
Rageface,illidan,128,warrior,arms,4,2,2
Stunahh,bleeding-hollow,128,warrior,arms,4,2,2
Captnplague,mugthol,128,warrior,arms,5,2,3
Eatmyblade,wyrmrest-accord,128,warrior,arms,10,2,8
Jowesley,azralon,105,warrior,arms,14,4,10
Ranikmurr,moon-guard,96,warrior,arms,3,2,1
Kevs,sargeras,96,warrior,arms,3,2,1
Shoresy,korgath,96,warrior,arms,3,2,1
Ryuulion,proudmoore,96,warrior,arms,3,2,1
Darthkrull,ragnaros,96,warrior,arms,3,2,1
Wolurog,emerald-dream,96,warrior,arms,6,1,5
Wäkko,stormrage,96,warrior,arms,6,1,5
Targha,tichondrius,96,warrior,arms,6,1,5
Jennatolls,boulderfist,96,warrior,arms,6,1,5
Warriorlover,stormrage,96,warrior,arms,6,1,5
Fexis,queldorei,96,warrior,arms,6,1,5
Shibanda,tichondrius,96,warrior,arms,6,1,5
Hellamoist,tichondrius,96,warrior,arms,6,1,5
Sosaw,moon-guard,96,warrior,arms,6,1,5
Tfd,tichondrius,96,warrior,arms,6,1,5
Brigandier,shattered-hand,96,warrior,arms,6,1,5
Einoch,stormrage,96,warrior,arms,6,1,5
Rambovix,tichondrius,96,warrior,arms,6,1,5
Berawar,tichondrius,96,warrior,arms,6,1,5
Betsisword,stormrage,96,warrior,arms,6,1,5
Faintswar,stormrage,96,warrior,arms,6,1,5
Kåyotix,proudmoore,96,warrior,arms,6,1,5
Radenos,proudmoore,96,warrior,arms,6,1,5
Talunus,tichondrius,96,warrior,arms,6,1,5
Uju,lothar,96,warrior,arms,6,1,5
Blazeblade,cenarius,96,warrior,arms,6,1,5
Dikesrus,tichondrius,96,warrior,arms,6,1,5
Iscylicene,tichondrius,96,warrior,arms,6,1,5
Cahdrophenia,moon-guard,96,warrior,arms,6,1,5
Pyraei,nordrassil,96,warrior,arms,6,1,5
Cursedogre,tichondrius,96,warrior,arms,6,1,5
Myc,zuljin,96,warrior,arms,6,1,5
Glonzito,tichondrius,96,warrior,arms,6,1,5
Kevinersaa,frostmourne,96,warrior,arms,6,1,5
Chubw,tichondrius,96,warrior,arms,6,1,5
Smoogzz,tichondrius,96,warrior,arms,6,1,5
Zépileque,azralon,96,warrior,arms,6,1,5
Dogmar,moon-guard,96,warrior,arms,6,1,5
Mortalbtw,tichondrius,96,warrior,arms,6,1,5
Olavson,proudmoore,96,warrior,arms,6,1,5
Larrybiscuit,moon-guard,96,warrior,arms,6,1,5
Bestgrunt,tichondrius,96,warrior,arms,6,1,5
Warmaghar,azralon,96,warrior,arms,6,1,5
Didgeridoo,stormrage,96,warrior,arms,6,1,5
Melithiae,barthilas,96,warrior,arms,6,1,5
Codey,stormrage,96,warrior,arms,6,1,5
Wrex,bleeding-hollow,96,warrior,arms,6,1,5
Warsung,azgalor,96,warrior,arms,6,1,5
Jpiece,tichondrius,96,warrior,arms,6,1,5
Shimizuken,tichondrius,96,warrior,arms,6,1,5
Bhuppzz,barthilas,96,warrior,arms,6,1,5
Ivadell,stormrage,96,warrior,arms,6,1,5
Zørg,bleeding-hollow,96,warrior,arms,6,1,5
Atomicboxer,tichondrius,96,warrior,arms,6,1,5
Shagstrike,azralon,96,warrior,arms,6,1,5
Weechubber,bleeding-hollow,96,warrior,arms,6,1,5
Rogswar,sargeras,96,warrior,arms,6,1,5
Paveyourcave,sargeras,96,warrior,arms,6,1,5
Skrtcobain,moon-guard,96,warrior,arms,6,1,5
Xalë,tichondrius,96,warrior,arms,6,1,5
Joetempest,azralon,96,warrior,arms,6,1,5
Solsirrior,tichondrius,96,warrior,arms,6,1,5
Yongvi,tichondrius,96,warrior,arms,6,1,5
Dokoba,bleeding-hollow,96,warrior,arms,6,1,5
Nelfmoehawk,barthilas,96,warrior,arms,6,1,5
Wienertoes,tichondrius,96,warrior,arms,6,1,5
Abaton,wyrmrest-accord,96,warrior,arms,6,1,5
Rarityw,tichondrius,96,warrior,arms,6,1,5
Igoboom,bleeding-hollow,96,warrior,arms,6,1,5
Elodié,stormrage,96,warrior,arms,6,1,5
Fidelwar,bleeding-hollow,96,warrior,arms,6,1,5
Erhue,sargeras,96,warrior,arms,6,1,5
Tangö,barthilas,96,warrior,arms,6,1,5
Meleth,darkspear,96,warrior,arms,6,1,5
Icé,bleeding-hollow,96,warrior,arms,6,1,5
Thiq,proudmoore,96,warrior,arms,6,1,5
Tagaash,azralon,96,warrior,arms,6,1,5
Selockclap,bleeding-hollow,96,warrior,arms,6,1,5
Gromhell,azralon,96,warrior,arms,6,1,5
Bobisyourmom,tichondrius,96,warrior,arms,6,1,5
Warstun,tichondrius,96,warrior,arms,6,1,5
Cloudsmash,arthas,96,warrior,arms,6,1,5
Adav,arthas,96,warrior,arms,6,1,5
Felwariorkig,tichondrius,96,warrior,arms,6,1,5
Maxtavius,baelgun,96,warrior,arms,6,1,5
Shadowswar,tichondrius,96,warrior,arms,6,1,5
Angryorc,norgannon,96,warrior,arms,6,1,5
Nukefrmorbit,dalaran,96,warrior,arms,6,1,5
Droggo,cenarius,96,warrior,arms,6,1,5
Aotha,moon-guard,96,warrior,arms,6,1,5
Edariana,dalaran,96,warrior,arms,6,1,5
Funsize,dalaran,96,warrior,arms,6,1,5
Sver,dalaran,96,warrior,arms,6,1,5
Dezeran,tichondrius,96,warrior,arms,6,1,5
Vethronis,dalaran,96,warrior,arms,6,1,5
Meytuglin,stormrage,96,warrior,arms,6,1,5
Genesisblade,illidan,96,warrior,arms,6,1,5
Vitalocity,frostmourne,96,warrior,arms,6,1,5
Jazz,frostwolf,96,warrior,arms,6,1,5
Thiccsmith,blackrock,96,warrior,arms,6,1,5
Warrmachine,scarlet-crusade,96,warrior,arms,6,1,5
Wàrrðèémzý,frostmourne,96,warrior,arms,6,1,5
Skärz,azshara,96,warrior,arms,6,1,5
Klobnslob,mannoroth,96,warrior,arms,6,1,5
Hypëriøn,bleeding-hollow,96,warrior,arms,6,1,5
Soymong,frostmourne,96,warrior,arms,6,1,5
Stinkktoe,tichondrius,96,warrior,arms,6,1,5
Cindabotica,sargeras,96,warrior,arms,6,1,5
Nukee,tichondrius,96,warrior,arms,6,1,5
Beastro,rexxar,96,warrior,arms,6,1,5
Dáin,azralon,96,warrior,arms,6,1,5
Razgorkul,illidan,96,warrior,arms,6,1,5
Släughter,zuljin,96,warrior,arms,6,1,5
Blacken,tichondrius,96,warrior,arms,6,1,5
Pressd,frostmourne,96,warrior,arms,6,1,5
Rage,tanaris,96,warrior,arms,6,1,5
Kboyrage,sargeras,96,warrior,arms,6,1,5
Nicrose,hyjal,96,warrior,arms,6,1,5
Vhagaar,emerald-dream,96,warrior,arms,6,1,5
Deathislovê,moonrunner,96,warrior,arms,6,1,5
Hergo,spirestone,96,warrior,arms,6,1,5
Striphex,trollbane,96,warrior,arms,6,1,5
Mezw,tichondrius,96,warrior,arms,6,1,5
Serakur,emerald-dream,96,warrior,arms,6,1,5
Glurg,illidan,96,warrior,arms,6,1,5
Rucktuck,tichondrius,96,warrior,arms,6,1,5
Noctrelor,sargeras,96,warrior,arms,6,1,5
Keynlor,antonidas,96,warrior,arms,6,1,5
Sweetlove,akama,96,warrior,arms,6,1,5
Jimhoffa,bonechewer,96,warrior,arms,6,1,5
Goywarr,illidan,96,warrior,arms,6,1,5
Odiiragda,sargeras,96,warrior,arms,6,1,5
Dragginball,garrosh,96,warrior,arms,6,1,5
Morotak,area-52,96,warrior,arms,6,1,5
Forsake,daggerspine,96,warrior,arms,6,1,5
Ghostierip,illidan,96,warrior,arms,6,1,5
Blitzkrieegz,drakkari,96,warrior,arms,6,1,5
Arkenon,drakkari,96,warrior,arms,6,1,5
Hadrum,turalyon,96,warrior,arms,6,1,5
Grosjambes,turalyon,96,warrior,arms,6,1,5
Kargan,thrall,96,warrior,arms,6,1,5
Däger,ragnaros,96,warrior,arms,6,1,5
Slayabunny,icecrown,96,warrior,arms,6,1,5
Kado,zuluhed,96,warrior,arms,6,1,5
Shuffle,velen,96,warrior,arms,6,1,5
Warbomb,thrall,96,warrior,arms,6,1,5
Gordurin,akama,96,warrior,arms,6,1,5
Okgotchax,kelthuzad,96,warrior,arms,6,1,5
Elryth,ragnaros,96,warrior,arms,6,1,5
Airwick,kelthuzad,96,warrior,arms,6,1,5
Tømy,quelthalas,96,warrior,arms,6,1,5
Notacop,malygos,96,warrior,arms,6,1,5
Kaysin,sargeras,96,warrior,arms,6,1,5
Shyliar,thrall,96,warrior,arms,6,1,5
Morlu,alleria,96,warrior,arms,6,1,5
Xeno,steamwheedle-cartel,96,warrior,arms,6,1,5
Áres,spinebreaker,96,warrior,arms,6,1,5
Nyaner,quelthalas,96,warrior,arms,6,1,5
Lifaen,zangarmarsh,96,warrior,arms,6,1,5
Garagedays,area-52,96,warrior,arms,6,1,5
Silverdeadl,ragnaros,96,warrior,arms,6,1,5
Draann,kirin-tor,96,warrior,arms,6,1,5
Fréäkk,ragnaros,96,warrior,arms,6,1,5
Gärroshh,ragnaros,96,warrior,arms,6,1,5
Horahloux,ragnaros,96,warrior,arms,6,1,5
Roxesc,area-52,96,warrior,arms,6,1,5
Racsorr,ragnaros,96,warrior,arms,6,1,5
Ghaladir,area-52,96,warrior,arms,6,1,5
Heyzulnut,whisperwind,96,warrior,arms,6,1,5
Aidenwr,area-52,96,warrior,arms,6,1,5
Mikachero,ragnaros,96,warrior,arms,6,1,5
Nibones,malganis,96,warrior,arms,6,1,5
Doriax,sentinels,96,warrior,arms,6,1,5
Durseyturm,area-52,96,warrior,arms,6,1,5
Uub,malganis,96,warrior,arms,6,1,5
Darkromel,quelthalas,96,warrior,arms,6,1,5
Immortal,icecrown,96,warrior,arms,6,1,5
Äléx,frostmourne,96,warrior,arms,7,1,6
Maat,blood-furnace,96,warrior,arms,8,1,7
Sangettsu,stormrage,96,warrior,arms,8,1,7
Ruinsteel,area-52,96,warrior,arms,8,1,7
Ogrimir,moon-guard,96,warrior,arms,9,1,8
Sickwar,emerald-dream,96,warrior,arms,12,1,11
Meelehard,zuljin,96,warrior,arms,12,1,11
Berzerk,dentarg,96,warrior,arms,12,1,11
Bushwook,emerald-dream,96,warrior,arms,12,1,11
Odyssey,vashj,96,warrior,arms,12,1,11
Honoriowar,nemesis,96,warrior,arms,12,1,11
Morkep,stormrage,96,warrior,arms,12,1,11
Cartou,stormscale,96,warrior,arms,12,1,11
Drarn,norgannon,96,warrior,arms,12,1,11
Baozz,frostmourne,96,warrior,arms,12,1,11
Njalulfhild,korgath,96,warrior,arms,12,1,11
Falkur,amanthul,96,warrior,arms,12,1,11
Babyfelix,tichondrius,96,warrior,arms,12,1,11
Wmuuzh,quelthalas,96,warrior,arms,12,1,11
Hazzak,quelthalas,96,warrior,arms,12,1,11
Psykd,arathor,79,warrior,arms,5,1,4
Stackws,tichondrius,79,warrior,arms,5,1,4
Keringan,stormrage,79,warrior,arms,5,1,4
Savagetko,illidan,79,warrior,arms,5,1,4
Rokmok,frostmane,79,warrior,arms,5,1,4
Roxon,hellscream,79,warrior,arms,5,1,4
Hexenwolf,moon-guard,79,warrior,arms,5,1,4
Smashpatatas,proudmoore,64,warrior,arms,4,1,3
Sniperbeer,sargeras,64,warrior,arms,4,1,3
Garrossh,thunderhorn,64,warrior,arms,4,1,3
Kothal,thrall,63,warrior,arms,2,2,0
Anvil,bronzebeard,63,warrior,arms,2,2,0
Thewarrior,tichondrius,48,warrior,arms,3,1,2
Critnectar,aggramar,48,warrior,arms,3,1,2
Warriorba,tichondrius,48,warrior,arms,3,1,2
Foldrak,quelthalas,48,warrior,arms,3,1,2
Åcé,ragnaros,48,warrior,arms,3,1,2
Mauboro,azralon,48,warrior,arms,3,1,2
Rumka,draktharon,42,warrior,arms,6,2,4
Ghostkin,ragnaros,42,warrior,arms,7,2,5
Trôca,ragnaros,42,warrior,arms,8,2,6
Hexmaul,zuljin,31,warrior,arms,2,1,1
Raselix,quelthalas,31,warrior,arms,2,1,1
Flus,zuljin,31,warrior,arms,2,1,1
Mantiflash,stormrage,31,warrior,arms,2,1,1
Flandiz,sargeras,31,warrior,arms,2,1,1
Shwutty,stormrage,16,warrior,arms,1,1,0
Goodidea,mannoroth,16,warrior,arms,1,1,0
Clêaved,darkspear,16,warrior,arms,1,1,0
Americanbull,moon-guard,1399,warrior,protection,80,41,39
Graventhal,tichondrius,1192,warrior,protection,53,25,28
Percaderp,barthilas,1158,warrior,protection,63,30,33
Thororan,whisperwind,845,warrior,protection,27,10,17
Appolyonn,hyjal,836,warrior,protection,43,17,26
Logan,twisting-nether,705,warrior,protection,44,12,32
Smelldrglove,frostmourne,692,warrior,protection,32,12,20
Nansitao,kelthuzad,668,warrior,protection,24,7,17
Lagurtz,ragnaros,576,warrior,protection,18,6,12
Ghostoffury,thrall,574,warrior,protection,12,6,6
Meadier,windrunner,566,warrior,protection,12,6,6
Stophitingme,bloodscalp,525,warrior,protection,40,10,30
Archaòn,frostmourne,473,warrior,protection,12,5,7
Ksubîî,frostmourne,448,warrior,protection,16,5,11
Dabdaddyy,dawnbringer,384,warrior,protection,6,4,2
Kidkolby,moon-guard,384,warrior,protection,12,4,8
Rhuk,drakkari,383,warrior,protection,24,4,20
Metalhog,sargeras,288,warrior,protection,6,3,3
Manthraxx,sargeras,288,warrior,protection,6,3,3
Chàrr,crushridge,288,warrior,protection,15,4,11
Zatu,moknathal,285,warrior,protection,12,3,9
Toothnnailz,destromath,284,warrior,protection,12,3,9
Tåra,area-52,256,warrior,protection,22,3,19
Executespam,madoran,192,warrior,protection,6,2,4
Bulldozer,terokkar,192,warrior,protection,12,2,10
Strongtongue,malganis,192,warrior,protection,12,2,10
Loonycity,arygos,192,warrior,protection,12,2,10
Fearless,moon-guard,96,warrior,protection,6,1,5
Lunusx,stormrage,96,warrior,protection,6,1,5
Varith,sargeras,96,warrior,protection,12,1,11
Mannorth,aerie-peak,95,warrior,protection,6,1,5
Piojowar,quelthalas,95,warrior,protection,6,1,5
Jindyn,boulderfist,95,warrior,protection,6,1,5
Stowdace,bladefist,89,warrior,protection,10,5,5
Axiyum,tichondrius,79,warrior,protection,5,1,4
Juicey,burning-blade,31,warrior,protection,2,1,1
