name,realm,rating,cls,spec,play,win,lose
Эваер,blackscar,1549,deathknight,blood,48,25,23
Rahbekius,kazzak,1055,deathknight,blood,36,11,25
Schiva,eredar,252,deathknight,blood,11,3,8
Bóby,ravencrest,2023,deathknight,unholy,108,51,57
Worlviuz,argent-dawn,2021,deathknight,unholy,99,53,46
Enzy,drakthul,1948,deathknight,unholy,42,26,16
Shadowdeathj,kazzak,1913,deathknight,unholy,54,27,27
Conqueròr,tarren-mill,1903,deathknight,unholy,54,24,30
Bedstemoor,ravencrest,1899,deathknight,unholy,60,30,30
Валькейн,blackscar,1883,deathknight,unholy,60,32,28
Akaliz,die-aldor,1876,deathknight,unholy,66,35,31
Хайвейтухэлл,soulflayer,1874,deathknight,unholy,66,32,34
Vakü,burning-legion,1866,deathknight,unholy,108,49,59
Narali,argent-dawn,1859,deathknight,unholy,72,34,38
Murky,kazzak,1852,deathknight,unholy,60,29,31
Дайтоолгоун,gordunni,1851,deathknight,unholy,65,31,34
Vallenhal,twisting-nether,1850,deathknight,unholy,48,23,25
Leomordf,doomhammer,1847,deathknight,unholy,57,40,17
Mockingbirdo,sanguino,1836,deathknight,unholy,36,24,12
Amnésyx,ysondre,1835,deathknight,unholy,58,30,28
Lilshiet,stormreaver,1831,deathknight,unholy,66,30,36
Namzera,draenor,1827,deathknight,unholy,114,70,44
Oscman,silvermoon,1827,deathknight,unholy,54,32,22
Cealdris,blackmoore,1819,deathknight,unholy,30,20,10
Обледенение,gordunni,1819,deathknight,unholy,36,19,17
Argonat,silvermoon,1812,deathknight,unholy,64,40,24
Кромгона,soulflayer,1809,deathknight,unholy,36,28,8
Аоепупс,gordunni,1809,deathknight,unholy,57,28,29
Ezlyy,ravencrest,1807,deathknight,unholy,78,41,37
Лордэскорт,gordunni,1805,deathknight,unholy,78,37,41
Inflex,silvermoon,1789,deathknight,unholy,72,36,36
Leónid,kazzak,1780,deathknight,unholy,54,27,27
Lovroo,silvermoon,1769,deathknight,unholy,36,19,17
Kwc,ravencrest,1749,deathknight,unholy,45,24,21
Køley,draenor,1732,deathknight,unholy,41,23,18
Crenshawx,twisting-nether,1717,deathknight,unholy,65,30,35
Mávé,tarren-mill,1715,deathknight,unholy,47,24,23
Koranderx,argent-dawn,1713,deathknight,unholy,30,18,12
Shanariel,khaz-modan,1712,deathknight,unholy,54,33,21
Sangíus,blackmoore,1712,deathknight,unholy,148,70,78
Leanâdle,hyjal,1698,deathknight,unholy,74,38,36
Эриданс,gordunni,1689,deathknight,unholy,78,46,32
Кулькулегал,ashenvale,1685,deathknight,unholy,54,27,27
ßankoedno,stormscale,1676,deathknight,unholy,102,53,49
Blazeberg,blackrock,1662,deathknight,unholy,58,33,25
Zokko,blackrock,1659,deathknight,unholy,42,22,20
Jesûsx,ravencrest,1656,deathknight,unholy,30,18,12
Grepetta,argent-dawn,1656,deathknight,unholy,139,64,75
Unhóly,tarren-mill,1655,deathknight,unholy,48,28,20
Kickbot,outland,1652,deathknight,unholy,71,35,36
Reann,argent-dawn,1649,deathknight,unholy,55,31,24
Garrinchá,stormscale,1636,deathknight,unholy,48,21,27
Hellguy,draenor,1625,deathknight,unholy,96,42,54
Аркёт,howling-fjord,1618,deathknight,unholy,42,19,23
Verminosis,stormscale,1614,deathknight,unholy,48,17,31
Lockhead,stormscale,1611,deathknight,unholy,72,41,31
Змейняша,soulflayer,1590,deathknight,unholy,42,20,22
Lichbørn,ragnaros,1585,deathknight,unholy,48,22,26
Megdeath,silvermoon,1583,deathknight,unholy,55,28,27
Yandeäth,chants-éternels,1574,deathknight,unholy,30,18,12
Ктунец,blackscar,1570,deathknight,unholy,36,19,17
Söttguetsi,blackrock,1566,deathknight,unholy,35,20,15
Devilknight,dentarg,1557,deathknight,unholy,112,58,54
Darkertimes,ragnaros,1554,deathknight,unholy,54,21,33
Anaralien,ravencrest,1551,deathknight,unholy,83,40,43
Десхоб,soulflayer,1547,deathknight,unholy,66,22,44
Нарилуне,blackscar,1542,deathknight,unholy,86,45,41
Woddey,blackrock,1535,deathknight,unholy,48,28,20
Andreàs,silvermoon,1533,deathknight,unholy,30,16,14
Вурдулакх,gordunni,1532,deathknight,unholy,78,38,40
Çruél,silvermoon,1530,deathknight,unholy,36,16,20
Greymarker,kirin-tor,1526,deathknight,unholy,30,19,11
Dörfl,antonidas,1524,deathknight,unholy,75,36,39
Yusehz,kazzak,1523,deathknight,unholy,41,17,24
Deusmort,ravencrest,1507,deathknight,unholy,54,22,32
Notsyndra,nemesis,1504,deathknight,unholy,30,16,14
Sîck,bladefist,1503,deathknight,unholy,60,22,38
Numnuts,alakir,1502,deathknight,unholy,36,21,15
Pavkata,outland,1501,deathknight,unholy,88,45,43
Vainajala,die-aldor,1493,deathknight,unholy,39,20,19
Сванхильда,grom,1490,deathknight,unholy,30,16,14
Sorostew,twisting-nether,1467,deathknight,unholy,36,20,16
Jäätynyt,zenedar,1467,deathknight,unholy,48,17,31
Qtxi,nozdormu,1456,deathknight,unholy,42,21,21
Roaredrick,draenor,1453,deathknight,unholy,69,34,35
Bokrak,norgannon,1450,deathknight,unholy,35,23,12
Sictir,stormscale,1448,deathknight,unholy,53,28,25
Unholy,ragnaros,1444,deathknight,unholy,38,20,18
Fxckingmad,ravencrest,1437,deathknight,unholy,24,15,9
Pellizquitas,sanguino,1435,deathknight,unholy,24,15,9
Wôrgenator,kazzak,1435,deathknight,unholy,42,15,27
Gødofredo,dun-modr,1428,deathknight,unholy,54,29,25
Кокосоус,gordunni,1425,deathknight,unholy,30,15,15
Анихиме,howling-fjord,1424,deathknight,unholy,57,28,29
Nèrfx,ragnaros,1422,deathknight,unholy,36,15,21
Xado,frostwolf,1421,deathknight,unholy,66,37,29
Mìa,kragjin,1421,deathknight,unholy,49,22,27
Элекна,deepholm,1412,deathknight,unholy,36,16,20
Terren,ravencrest,1409,deathknight,unholy,52,29,23
Xirra,tarren-mill,1409,deathknight,unholy,63,31,32
Aeneriah,tarren-mill,1396,deathknight,unholy,32,16,16
Сантамо,soulflayer,1386,deathknight,unholy,32,16,16
Necrotic,blackrock,1383,deathknight,unholy,23,15,8
Metalmanethé,tarren-mill,1372,deathknight,unholy,79,33,46
Blorin,sylvanas,1372,deathknight,unholy,58,24,34
Спавни,blackscar,1369,deathknight,unholy,105,45,60
Azüla,ysondre,1343,deathknight,unholy,30,14,16
Necrølyte,sylvanas,1342,deathknight,unholy,18,14,4
Бургер,soulflayer,1340,deathknight,unholy,36,14,22
Darkknights,archimonde,1335,deathknight,unholy,24,15,9
Nazgül,drakthul,1335,deathknight,unholy,24,14,10
Derfitt,sanguino,1328,deathknight,unholy,30,14,16
Aleejha,draenor,1316,deathknight,unholy,28,15,13
Bloodbane,burning-blade,1316,deathknight,unholy,30,14,16
Detrah,argent-dawn,1315,deathknight,unholy,52,27,25
Dêku,aegwynn,1312,deathknight,unholy,75,44,31
Mojodango,outland,1299,deathknight,unholy,26,15,11
Necrozy,aggra-português,1298,deathknight,unholy,66,35,31
Nommad,archimonde,1296,deathknight,unholy,35,14,21
Kaletorn,ragnaros,1291,deathknight,unholy,42,21,21
Skøurge,silvermoon,1287,deathknight,unholy,54,23,31
Гронташ,howling-fjord,1286,deathknight,unholy,29,14,15
Teljujad,sanguino,1285,deathknight,unholy,38,16,22
Смердонос,grom,1282,deathknight,unholy,24,14,10
Lorvetis,malorne,1278,deathknight,unholy,36,14,22
Хассандра,galakrond,1271,deathknight,unholy,26,14,12
Fentanil,elune,1270,deathknight,unholy,40,19,21
Drenodur,amanthul,1261,deathknight,unholy,24,14,10
Superere,hyjal,1261,deathknight,unholy,36,17,19
Сенкрул,gordunni,1259,deathknight,unholy,24,18,6
Неондк,eversong,1245,deathknight,unholy,30,13,17
Arizon,drakthul,1245,deathknight,unholy,36,13,23
Fennro,ysondre,1244,deathknight,unholy,42,13,29
Vatø,tarren-mill,1243,deathknight,unholy,30,13,17
Вирко,eversong,1242,deathknight,unholy,24,13,11
Джайвана,soulflayer,1242,deathknight,unholy,42,21,21
Hawkthuglife,dun-modr,1239,deathknight,unholy,30,13,17
Shabiri,twisting-nether,1238,deathknight,unholy,29,14,15
Кристер,lich-king,1234,deathknight,unholy,30,13,17
Крикед,soulflayer,1230,deathknight,unholy,60,32,28
Jalapeñofan,tarren-mill,1229,deathknight,unholy,24,13,11
Necrocancerr,twisting-nether,1229,deathknight,unholy,84,38,46
Gûuts,archimonde,1199,deathknight,unholy,84,40,44
Wombo,dentarg,1195,deathknight,unholy,27,13,14
Jihm,silvermoon,1192,deathknight,unholy,37,16,21
Abnormus,tarren-mill,1175,deathknight,unholy,45,19,26
Tyranus,quelthalas,1174,deathknight,unholy,67,24,43
Gladiadk,ysondre,1151,deathknight,unholy,30,12,18
Happsor,eredar,1150,deathknight,unholy,30,12,18
Dklol,dun-morogh,1150,deathknight,unholy,36,14,22
Numnutz,alakir,1149,deathknight,unholy,25,13,12
Icegrin,silvermoon,1149,deathknight,unholy,24,12,12
Frege,tarren-mill,1149,deathknight,unholy,30,12,18
Necrofear,grim-batol,1149,deathknight,unholy,36,12,24
Nødder,ragnaros,1145,deathknight,unholy,18,12,6
Diatriss,argent-dawn,1134,deathknight,unholy,27,15,12
Qmy,outland,1131,deathknight,unholy,24,12,12
Pamplemouse,burning-blade,1111,deathknight,unholy,36,18,18
Butthurtx,stormscale,1087,deathknight,unholy,22,12,10
Ashlëy,kaelthas,1081,deathknight,unholy,58,29,29
Дайтоолгоун,deathguard,1055,deathknight,unholy,18,11,7
Doozz,draenor,1055,deathknight,unholy,30,11,19
Gargalon,drakthul,1054,deathknight,unholy,18,11,7
Baltersa,blackhand,1054,deathknight,unholy,30,11,19
Trialist,dun-modr,1052,deathknight,unholy,18,11,7
Ardros,eredar,1051,deathknight,unholy,24,11,13
Бреч,gordunni,1050,deathknight,unholy,30,11,19
Züg,draenor,1046,deathknight,unholy,24,11,13
Мокраявода,soulflayer,1035,deathknight,unholy,70,37,33
Asakurai,grim-batol,1026,deathknight,unholy,18,11,7
Darkhallow,thrall,1013,deathknight,unholy,27,12,15
Hordak,stormscale,1007,deathknight,unholy,21,11,10
Tyrannus,earthen-ring,1000,deathknight,unholy,23,13,10
Gowther,blackmoore,999,deathknight,unholy,30,16,14
Facèpalm,ravencrest,985,deathknight,unholy,21,12,9
Gathalion,the-maelstrom,980,deathknight,unholy,48,28,20
Fpsrvg,minahonda,974,deathknight,unholy,35,16,19
Сгеатог,gordunni,960,deathknight,unholy,18,10,8
Kaliro,sylvanas,960,deathknight,unholy,18,10,8
Jiodythyy,archimonde,959,deathknight,unholy,24,10,14
Ronsôn,terrordar,959,deathknight,unholy,24,10,14
Yagoora,silvermoon,959,deathknight,unholy,27,11,16
Exanex,ragnaros,957,deathknight,unholy,18,10,8
Zoree,draenor,957,deathknight,unholy,18,10,8
Evelys,kazzak,954,deathknight,unholy,18,10,8
Лекъса,gordunni,909,deathknight,unholy,23,10,13
Blízna,kazzak,894,deathknight,unholy,20,10,10
Олинф,deathguard,894,deathknight,unholy,32,10,22
Khalifamia,alonsus,864,deathknight,unholy,18,9,9
Usbdock,stormscale,864,deathknight,unholy,18,9,9
Rankor,grim-batol,864,deathknight,unholy,18,9,9
Panorboy,tarren-mill,864,deathknight,unholy,18,9,9
Gripbroblem,nemesis,864,deathknight,unholy,24,9,15
Sanlex,twisting-nether,864,deathknight,unholy,30,9,21
Castlevanía,ravencrest,863,deathknight,unholy,18,9,9
Feministi,stormreaver,863,deathknight,unholy,24,9,15
Sevatar,zuljin,862,deathknight,unholy,12,9,3
Unholycard,argent-dawn,860,deathknight,unholy,18,9,9
Ridire,saurfang,859,deathknight,unholy,22,10,12
Tarfu,kazzak,856,deathknight,unholy,18,9,9
Marcianorock,dalaran,850,deathknight,unholy,18,9,9
Deathcleave,burning-legion,845,deathknight,unholy,23,9,14
Dkbladet,ravencrest,794,deathknight,unholy,26,9,17
Wórzzag,arygos,768,deathknight,unholy,12,8,4
Deathvid,ravencrest,768,deathknight,unholy,12,8,4
Femilista,dun-modr,768,deathknight,unholy,12,8,4
Фростинг,gordunni,768,deathknight,unholy,12,8,4
Вовчан,howling-fjord,768,deathknight,unholy,18,8,10
Скизм,howling-fjord,768,deathknight,unholy,18,8,10
Silvergreed,kazzak,768,deathknight,unholy,18,8,10
Борнтудай,borean-tundra,768,deathknight,unholy,18,8,10
Zatrina,blackrock,768,deathknight,unholy,24,8,16
Zeghor,ragnaros,767,deathknight,unholy,24,8,16
Krinoe,dalaran,766,deathknight,unholy,18,8,10
Tanenoss,kazzak,766,deathknight,unholy,18,8,10
Zombienatíon,silvermoon,766,deathknight,unholy,24,8,16
Lobotomia,burning-blade,764,deathknight,unholy,18,8,10
Roykoopa,hyjal,762,deathknight,unholy,18,8,10
Karalun,nagrand,726,deathknight,unholy,18,8,10
Synthwave,tarren-mill,719,deathknight,unholy,17,8,9
Sveinnhran,kazzak,702,deathknight,unholy,28,8,20
Dklékata,archimonde,672,deathknight,unholy,12,7,5
Ipanic,argent-dawn,672,deathknight,unholy,12,7,5
Moonpoxdk,nerathor,672,deathknight,unholy,12,7,5
Шифычдк,howling-fjord,672,deathknight,unholy,12,7,5
Слендер,howling-fjord,672,deathknight,unholy,12,7,5
Ðiesel,stormscale,672,deathknight,unholy,18,7,11
Алсидис,gordunni,672,deathknight,unholy,18,7,11
Sélyne,dalaran,672,deathknight,unholy,18,7,11
Gadres,aegwynn,672,deathknight,unholy,18,7,11
Никнейм,gordunni,672,deathknight,unholy,18,7,11
Soulchaos,ravencrest,672,deathknight,unholy,18,7,11
Ghaloob,draenor,672,deathknight,unholy,18,7,11
Geraltbg,twisting-nether,672,deathknight,unholy,18,7,11
Fearléss,outland,672,deathknight,unholy,18,7,11
Bephomet,onyxia,672,deathknight,unholy,18,7,11
Negzul,blackmoore,671,deathknight,unholy,12,7,5
Дэдушка,gordunni,671,deathknight,unholy,12,7,5
Prænklý,blackrock,671,deathknight,unholy,12,7,5
Segrim,drakthul,671,deathknight,unholy,12,7,5
Mcrune,ravencrest,671,deathknight,unholy,18,7,11
Bärdk,forscherliga,671,deathknight,unholy,18,7,11
Ithis,zuljin,671,deathknight,unholy,18,7,11
Ráisy,outland,671,deathknight,unholy,24,7,17
Unzul,twisting-nether,660,deathknight,unholy,12,7,5
Aldramil,gorgonnash,645,deathknight,unholy,18,7,11
Itreachesout,ravencrest,639,deathknight,unholy,17,7,10
Nephalêm,thrall,576,deathknight,unholy,12,6,6
Nasxsy,blackmoore,576,deathknight,unholy,12,6,6
Swordkill,drakthul,576,deathknight,unholy,12,6,6
Hêalz,ungoro,576,deathknight,unholy,12,6,6
Sanuky,blackrock,576,deathknight,unholy,12,6,6
Кромгондк,soulflayer,576,deathknight,unholy,12,6,6
Sølîta,archimonde,576,deathknight,unholy,18,6,12
Bloodkatana,drakthul,576,deathknight,unholy,18,6,12
Mosscraciun,kazzak,575,deathknight,unholy,12,6,6
Fineral,argent-dawn,575,deathknight,unholy,12,6,6
Feugen,hyjal,575,deathknight,unholy,12,6,6
Jöndas,drakthul,575,deathknight,unholy,12,6,6
Havi,thunderhorn,575,deathknight,unholy,12,6,6
Zelbørk,medivh,575,deathknight,unholy,12,6,6
Ezreo,neptulon,575,deathknight,unholy,12,6,6
Ennigmá,stormscale,572,deathknight,unholy,12,6,6
Nickolass,skullcrusher,570,deathknight,unholy,12,6,6
Draforce,quelthalas,527,deathknight,unholy,11,6,5
Deadpòól,twisting-nether,521,deathknight,unholy,33,7,26
Theamine,silvermoon,480,deathknight,unholy,6,5,1
Izanagii,exodar,480,deathknight,unholy,6,5,1
Барагган,thermaplugg,480,deathknight,unholy,6,5,1
Critycal,draenor,480,deathknight,unholy,6,5,1
Preddktwo,twisting-nether,480,deathknight,unholy,6,5,1
Cbalife,ragnaros,480,deathknight,unholy,12,5,7
Hotcherryx,dun-modr,480,deathknight,unholy,12,5,7
Дядьдим,soulflayer,480,deathknight,unholy,12,5,7
Dräpârn,sylvanas,480,deathknight,unholy,12,5,7
Dêeath,madmortem,480,deathknight,unholy,12,5,7
Branchë,stormscale,480,deathknight,unholy,12,5,7
Deathmonsta,auchindoun,480,deathknight,unholy,12,5,7
Аронас,blackscar,480,deathknight,unholy,12,5,7
Pandahapci,ragnaros,480,deathknight,unholy,12,5,7
Zhugzug,ragnaros,480,deathknight,unholy,12,5,7
Manovar,archimonde,480,deathknight,unholy,12,5,7
Eltorro,ravencrest,480,deathknight,unholy,12,5,7
Apacstanya,ragnaros,480,deathknight,unholy,12,5,7
Fraeya,sunstrider,480,deathknight,unholy,12,5,7
Ahilus,bladefist,480,deathknight,unholy,12,5,7
Xad,blackrock,480,deathknight,unholy,18,5,13
Orcborg,zuljin,479,deathknight,unholy,12,5,7
Mailasse,dalaran,476,deathknight,unholy,10,6,4
Ezlar,silvermoon,400,deathknight,unholy,7,5,2
Sang,deathwing,384,deathknight,unholy,6,4,2
Lichkunt,stormscale,384,deathknight,unholy,6,4,2
Krisigaped,blackhand,384,deathknight,unholy,6,4,2
Annabolik,ravencrest,384,deathknight,unholy,6,4,2
Quantumshift,ravencrest,384,deathknight,unholy,6,4,2
Redduck,silvermoon,384,deathknight,unholy,6,4,2
Copium,hyjal,384,deathknight,unholy,6,4,2
Cheethdoom,ragnaros,384,deathknight,unholy,6,4,2
Kailara,draenor,384,deathknight,unholy,6,4,2
Èvíl,stormscale,384,deathknight,unholy,6,4,2
Рыжаяпедаль,soulflayer,384,deathknight,unholy,6,4,2
Ахелекус,blackscar,384,deathknight,unholy,6,4,2
Øtherànóther,stormscale,384,deathknight,unholy,6,4,2
Helmich,frostmane,384,deathknight,unholy,6,4,2
Morgianà,argent-dawn,384,deathknight,unholy,6,4,2
Миракл,howling-fjord,384,deathknight,unholy,6,4,2
Akelæ,draenor,384,deathknight,unholy,6,4,2
Raust,xavius,384,deathknight,unholy,8,4,4
Tyvra,blackhand,384,deathknight,unholy,15,5,10
Протосеня,soulflayer,384,deathknight,unholy,12,4,8
Анзорини,gordunni,384,deathknight,unholy,12,4,8
Мёрдерфэйсх,soulflayer,384,deathknight,unholy,12,4,8
Epoch,azjolnerub,384,deathknight,unholy,12,4,8
Szayestra,draenor,384,deathknight,unholy,12,4,8
Sekkah,tarren-mill,384,deathknight,unholy,12,4,8
Nómòre,ravencrest,384,deathknight,unholy,12,4,8
Razdig,dun-modr,384,deathknight,unholy,12,4,8
Moko,defias-brotherhood,384,deathknight,unholy,12,4,8
Maxïmus,argent-dawn,384,deathknight,unholy,18,4,14
Jowân,blackmoore,383,deathknight,unholy,6,4,2
Takåtry,archimonde,383,deathknight,unholy,6,4,2
Dunkàn,silvermoon,383,deathknight,unholy,6,4,2
Flippmo,argent-dawn,383,deathknight,unholy,9,5,4
Хворной,howling-fjord,383,deathknight,unholy,12,4,8
Oldu,haomarush,379,deathknight,unholy,12,4,8
Варрлнишнс,soulflayer,367,deathknight,unholy,11,4,7
Ogomegee,ravencrest,352,deathknight,unholy,10,4,6
Millknight,norgannon,341,deathknight,unholy,15,6,9
Randomdkxd,ravencrest,304,deathknight,unholy,13,4,9
Ullefuz,silvermoon,288,deathknight,unholy,6,3,3
Rottenpete,grim-batol,288,deathknight,unholy,6,3,3
Zêlëph,archimonde,288,deathknight,unholy,6,3,3
Yousaindk,blackrock,288,deathknight,unholy,6,3,3
Arxelas,sylvanas,288,deathknight,unholy,6,3,3
Krookidk,archimonde,288,deathknight,unholy,6,3,3
Mocca,aegwynn,288,deathknight,unholy,6,3,3
Crudelias,aegwynn,288,deathknight,unholy,6,3,3
Cyphîllyth,auchindoun,288,deathknight,unholy,6,3,3
Galgalí,blackmoore,288,deathknight,unholy,6,3,3
Sathmayla,silvermoon,288,deathknight,unholy,6,3,3
Âlîce,culte-de-la-rive-noire,288,deathknight,unholy,6,3,3
Альдафьод,howling-fjord,288,deathknight,unholy,6,3,3
Râke,teldrassil,288,deathknight,unholy,6,3,3
Synchronic,stormscale,288,deathknight,unholy,6,3,3
Тзинч,soulflayer,288,deathknight,unholy,6,3,3
Clérora,argent-dawn,288,deathknight,unholy,6,3,3
Quetza,twisting-nether,288,deathknight,unholy,6,3,3
Mamanica,sanguino,288,deathknight,unholy,6,3,3
Storhøf,sanguino,288,deathknight,unholy,6,3,3
Erodevil,kazzak,288,deathknight,unholy,6,3,3
Løz,kazzak,288,deathknight,unholy,6,3,3
Еххел,soulflayer,288,deathknight,unholy,6,3,3
Vip,argent-dawn,288,deathknight,unholy,6,3,3
Myeltior,kazzak,288,deathknight,unholy,6,3,3
Jénga,ghostlands,288,deathknight,unholy,6,3,3
Calina,frostwolf,288,deathknight,unholy,6,3,3
Azrìal,agamaggan,288,deathknight,unholy,6,3,3
Maxto,outland,288,deathknight,unholy,6,3,3
Cleverb,silvermoon,288,deathknight,unholy,12,3,9
Valanaari,argent-dawn,288,deathknight,unholy,12,3,9
Nuadar,outland,288,deathknight,unholy,12,3,9
Zegaan,kazzak,288,deathknight,unholy,12,3,9
Lair,shendralar,288,deathknight,unholy,12,3,9
Ràiven,blackmoore,288,deathknight,unholy,12,3,9
Dimania,the-maelstrom,288,deathknight,unholy,12,3,9
Tyranuse,kazzak,288,deathknight,unholy,12,3,9
Lurkkiss,ravencrest,288,deathknight,unholy,12,3,9
Garasu,eredar,288,deathknight,unholy,18,3,15
Kaldhan,nemesis,287,deathknight,unholy,6,3,3
Arthursq,stormscale,285,deathknight,unholy,12,3,9
Dekayo,blackrock,256,deathknight,unholy,10,3,7
Évìl,stormscale,239,deathknight,unholy,5,3,2
Xawias,ulduar,234,deathknight,unholy,8,4,4
Pawcio,argent-dawn,192,deathknight,unholy,6,2,4
Plaguebones,ravencrest,192,deathknight,unholy,6,2,4
Thryndiel,ravencrest,192,deathknight,unholy,6,2,4
Norux,alonsus,192,deathknight,unholy,6,2,4
Kacpèr,burning-legion,192,deathknight,unholy,6,2,4
Gothenburger,darksorrow,192,deathknight,unholy,6,2,4
Duriel,stormscale,192,deathknight,unholy,6,2,4
Postura,kazzak,192,deathknight,unholy,6,2,4
Shewoman,stormreaver,192,deathknight,unholy,6,2,4
Engelinä,ysondre,192,deathknight,unholy,6,2,4
Dizin,ravencrest,192,deathknight,unholy,6,2,4
Zugzugdecay,kazzak,192,deathknight,unholy,6,2,4
Exult,twisting-nether,192,deathknight,unholy,6,2,4
Eigrin,argent-dawn,192,deathknight,unholy,6,2,4
Mustapha,kazzak,192,deathknight,unholy,6,2,4
Njor,twisting-nether,192,deathknight,unholy,6,2,4
Хорссэ,soulflayer,192,deathknight,unholy,6,2,4
Frostich,ragnaros,192,deathknight,unholy,6,2,4
Аэрит,howling-fjord,192,deathknight,unholy,6,2,4
Nestia,emerald-dream,192,deathknight,unholy,6,2,4
Шинратенсеи,howling-fjord,192,deathknight,unholy,6,2,4
Unholyysteel,silvermoon,192,deathknight,unholy,6,2,4
Ilovegouàng,khaz-modan,192,deathknight,unholy,6,2,4
Unholykebab,defias-brotherhood,192,deathknight,unholy,6,2,4
Dk,earthen-ring,192,deathknight,unholy,6,2,4
Urukaye,silvermoon,192,deathknight,unholy,6,2,4
Kromas,silvermoon,192,deathknight,unholy,6,2,4
Thoir,ahnqiraj,192,deathknight,unholy,6,2,4
Homelándér,blackmoore,192,deathknight,unholy,6,2,4
Vrez,argent-dawn,192,deathknight,unholy,6,2,4
Nihilistyx,blackrock,192,deathknight,unholy,6,2,4
Sugarcakedk,blackrock,192,deathknight,unholy,6,2,4
Morinosei,twisting-nether,192,deathknight,unholy,6,2,4
Bigblackgrip,hyjal,192,deathknight,unholy,6,2,4
Elendren,blackrock,192,deathknight,unholy,6,2,4
Körthazz,hyjal,192,deathknight,unholy,6,2,4
Ketnissq,blackrock,192,deathknight,unholy,6,2,4
Lithics,blades-edge,192,deathknight,unholy,6,2,4
Морталес,azuregos,192,deathknight,unholy,6,2,4
Fdkgotbuffed,tarren-mill,192,deathknight,unholy,6,2,4
Буризан,blackscar,192,deathknight,unholy,6,2,4
Гадиния,soulflayer,191,deathknight,unholy,4,3,1
Àragørn,blackrock,191,deathknight,unholy,6,2,4
Джагат,gordunni,191,deathknight,unholy,12,2,10
Dødsmanna,twisting-nether,144,deathknight,unholy,9,2,7
Cayliadk,tarren-mill,138,deathknight,unholy,14,4,10
Jarhèad,grim-batol,96,deathknight,unholy,10,3,7
Seal,lightnings-blade,96,deathknight,unholy,15,4,11
Deathcam,emerald-dream,96,deathknight,unholy,6,1,5
Fixmybones,frostmane,96,deathknight,unholy,6,1,5
Gravetitan,shattrath,96,deathknight,unholy,6,1,5
Dextèr,stormreaver,96,deathknight,unholy,6,1,5
Eívór,garrosh,96,deathknight,unholy,6,1,5
Vîrus,kazzak,96,deathknight,unholy,6,1,5
Cameltôe,frostwolf,96,deathknight,unholy,6,1,5
Kixx,bloodfeather,96,deathknight,unholy,6,1,5
Peiie,ravencrest,96,deathknight,unholy,6,1,5
Торедх,howling-fjord,96,deathknight,unholy,6,1,5
Инфлюминс,soulflayer,96,deathknight,unholy,6,1,5
Orrengo,blackrock,96,deathknight,unholy,6,1,5
Quizon,tarren-mill,96,deathknight,unholy,6,1,5
Skrati,das-syndikat,96,deathknight,unholy,6,1,5
Madsgrip,tarren-mill,96,deathknight,unholy,6,1,5
Smallbaboon,stormreaver,96,deathknight,unholy,6,1,5
Форнителли,howling-fjord,96,deathknight,unholy,12,1,11
Brasith,outland,96,deathknight,unholy,12,1,11
Ârtjom,aegwynn,64,deathknight,unholy,4,1,3
Táli,tarren-mill,48,deathknight,unholy,3,1,2
Garrinchá,stormscale,1999,deathknight,frost,54,33,21
Anotherdkx,ravencrest,1997,deathknight,frost,60,36,24
Имерсий,gordunni,1929,deathknight,frost,42,26,16
Fdkgotbuffed,tarren-mill,1865,deathknight,frost,48,25,23
Murbastic,draenor,1851,deathknight,frost,96,45,51
Frostlux,archimonde,1733,deathknight,frost,144,68,76
Никнейм,gordunni,1647,deathknight,frost,42,21,21
Vidofnir,argent-dawn,1611,deathknight,frost,50,28,22
Xolaani,outland,1596,deathknight,frost,36,20,16
Dripgrip,ravencrest,1585,deathknight,frost,71,35,36
Arxelas,sylvanas,1584,deathknight,frost,88,47,41
Raylenx,uldaman,1574,deathknight,frost,57,29,28
Kailara,draenor,1556,deathknight,frost,42,23,19
Dktroll,blackmoore,1546,deathknight,frost,109,50,59
Regniér,frostwolf,1540,deathknight,frost,51,23,28
Deucalyqt,nemesis,1501,deathknight,frost,42,18,24
Фростмаран,soulflayer,1494,deathknight,frost,66,34,32
Jeanice,blackhand,1434,deathknight,frost,30,15,15
Cayliadk,tarren-mill,1427,deathknight,frost,33,17,16
Кулькулегал,ashenvale,1424,deathknight,frost,24,15,9
Дарргг,ashenvale,1422,deathknight,frost,36,15,21
Маклайкнайт,gordunni,1417,deathknight,frost,78,36,42
Ðeucaly,nemesis,1357,deathknight,frost,66,30,36
Mocca,aegwynn,1357,deathknight,frost,52,21,31
Devilknight,dentarg,1256,deathknight,frost,54,27,27
Gorobijec,drakthul,1245,deathknight,frost,24,13,11
Düks,dun-modr,1238,deathknight,frost,87,39,48
Comehere,norgannon,1214,deathknight,frost,18,13,5
Arthasuk,dun-modr,1163,deathknight,frost,38,20,18
Darkchas,silvermoon,1144,deathknight,frost,24,12,12
Krasny,hyjal,1126,deathknight,frost,36,19,17
Nôsferatú,amanthul,1125,deathknight,frost,30,15,15
Dkruffos,draenor,1114,deathknight,frost,48,18,30
Zerodude,silvermoon,1112,deathknight,frost,54,26,28
Кроуфрост,gordunni,1076,deathknight,frost,30,12,18
Woddey,blackrock,1073,deathknight,frost,48,22,26
Вафельнаяфея,blackscar,1073,deathknight,frost,43,17,26
Leónid,kazzak,1056,deathknight,frost,18,11,7
Stevensdk,darkspear,1051,deathknight,frost,18,11,7
Superere,hyjal,1026,deathknight,frost,24,11,13
Dursall,thrall,965,deathknight,frost,43,20,23
Mikagoddess,argent-dawn,959,deathknight,frost,18,10,8
Ubiystvo,kazzak,955,deathknight,frost,18,10,8
Døuffy,hyjal,954,deathknight,frost,18,10,8
Mattesøs,drakthul,951,deathknight,frost,24,10,14
Fareast,nerathor,924,deathknight,frost,42,21,21
Twardobaba,burning-legion,884,deathknight,frost,20,10,10
Wrathlich,tyrande,863,deathknight,frost,18,9,9
Rêxaks,dun-modr,863,deathknight,frost,24,9,15
Frostmommy,argent-dawn,862,deathknight,frost,18,9,9
Fallenjaina,kazzak,862,deathknight,frost,24,9,15
Neorteriona,argent-dawn,860,deathknight,frost,18,9,9
Vîrus,kazzak,859,deathknight,frost,18,9,9
Peachvajz,turalyon,855,deathknight,frost,24,11,13
Afadk,kazzak,839,deathknight,frost,30,13,17
Guillemet,turalyon,830,deathknight,frost,16,10,6
Craftmaker,eonar,816,deathknight,frost,44,19,25
Ivik,the-maelstrom,771,deathknight,frost,20,10,10
Espatula,ravencrest,768,deathknight,frost,12,8,4
Igetmount,draenor,768,deathknight,frost,18,8,10
Fullbusterr,hyjal,761,deathknight,frost,12,8,4
Kixx,bloodfeather,711,deathknight,frost,29,8,21
Gorefiend,kazzak,672,deathknight,frost,12,7,5
Tenzøftw,archimonde,672,deathknight,frost,12,7,5
Asphyxias,alleria,672,deathknight,frost,12,7,5
Chakko,ravencrest,672,deathknight,frost,18,7,11
Flúrrý,kazzak,672,deathknight,frost,18,7,11
Diogenisis,arthas,672,deathknight,frost,18,7,11
Abnormus,tarren-mill,670,deathknight,frost,12,7,5
Меланндрис,gordunni,669,deathknight,frost,15,8,7
Alastoras,nemesis,665,deathknight,frost,18,7,11
Elbaqwan,the-shatar,646,deathknight,frost,18,7,11
Нифер,deathguard,576,deathknight,frost,12,6,6
Винкис,gordunni,576,deathknight,frost,12,6,6
Планус,booty-bay,576,deathknight,frost,12,6,6
Narali,argent-dawn,576,deathknight,frost,12,6,6
Izanagii,exodar,572,deathknight,frost,12,6,6
Elendren,blackrock,480,deathknight,frost,6,5,1
Feelmyfuri,mazrigos,480,deathknight,frost,12,5,7
Viuff,kazzak,480,deathknight,frost,12,5,7
Moosbirne,blackhand,479,deathknight,frost,12,5,7
Xtream,blackmoore,479,deathknight,frost,12,5,7
Khelthalas,teldrassil,477,deathknight,frost,6,5,1
Copium,hyjal,477,deathknight,frost,12,5,7
Predatormkdd,ravencrest,429,deathknight,frost,11,5,6
Reann,argent-dawn,384,deathknight,frost,6,4,2
Namzera,draenor,384,deathknight,frost,6,4,2
Gageth,shadowsong,384,deathknight,frost,15,5,10
Belía,blackmoore,384,deathknight,frost,12,4,8
Æew,kazzak,384,deathknight,frost,12,4,8
Кокосоус,gordunni,384,deathknight,frost,17,4,13
Beherith,sunstrider,383,deathknight,frost,6,4,2
Gravehammer,sylvanas,383,deathknight,frost,6,4,2
Гадиния,soulflayer,383,deathknight,frost,12,4,8
Breeze,xavius,383,deathknight,frost,12,4,8
Бранс,gordunni,383,deathknight,frost,12,4,8
Kivo,marécage-de-zangar,383,deathknight,frost,12,4,8
Ogomegee,ravencrest,288,deathknight,frost,6,3,3
Селес,ashenvale,288,deathknight,frost,6,3,3
Rubbann,ravencrest,288,deathknight,frost,6,3,3
Skorice,dalaran,288,deathknight,frost,6,3,3
Vaanor,draenor,288,deathknight,frost,6,3,3
Apraxia,ravencrest,288,deathknight,frost,6,3,3
Keridíin,twisting-nether,288,deathknight,frost,6,3,3
Whippy,ravencrest,288,deathknight,frost,6,3,3
Ûñhølýðéåthj,tarren-mill,288,deathknight,frost,6,3,3
Eynoway,blackmoore,288,deathknight,frost,6,3,3
Геннош,howling-fjord,288,deathknight,frost,6,3,3
Cyphîllyth,auchindoun,288,deathknight,frost,6,3,3
Veneera,emeriss,288,deathknight,frost,6,3,3
Modelo,twisting-nether,288,deathknight,frost,6,3,3
Ниффер,deathguard,288,deathknight,frost,6,3,3
Руин,blackscar,288,deathknight,frost,6,3,3
Eckodk,aggra-português,288,deathknight,frost,6,3,3
Raihor,outland,288,deathknight,frost,8,3,5
Tyranuse,kazzak,288,deathknight,frost,12,3,9
Thilior,silvermoon,288,deathknight,frost,12,3,9
Tzunâ,blackmoore,288,deathknight,frost,18,3,15
Lichfils,chogall,285,deathknight,frost,21,3,18
Venthyrgwa,kazzak,284,deathknight,frost,7,5,2
Neitoperho,frostmane,192,deathknight,frost,6,2,4
Sindó,blackrock,192,deathknight,frost,6,2,4
Leonis,arthas,192,deathknight,frost,6,2,4
Deathcardos,die-aldor,192,deathknight,frost,6,2,4
Mennal,the-maelstrom,192,deathknight,frost,6,2,4
Deathknight,spinebreaker,192,deathknight,frost,6,2,4
Pandahapci,ragnaros,192,deathknight,frost,6,2,4
Vaffe,tarren-mill,192,deathknight,frost,6,2,4
Doozz,draenor,192,deathknight,frost,6,2,4
Køley,draenor,192,deathknight,frost,6,2,4
Hordak,stormscale,192,deathknight,frost,6,2,4
Ilaenu,ravencrest,192,deathknight,frost,6,2,4
Tyró,ravencrest,192,deathknight,frost,6,2,4
Deadpòól,twisting-nether,192,deathknight,frost,12,2,10
Nîghtmáre,ravencrest,159,deathknight,frost,5,2,3
Aczheron,argent-dawn,96,deathknight,frost,6,1,5
Буризан,blackscar,96,deathknight,frost,6,1,5
Ezlar,silvermoon,96,deathknight,frost,6,1,5
Hydross,archimonde,96,deathknight,frost,6,1,5
Cleverb,silvermoon,96,deathknight,frost,6,1,5
Dïkcite,archimonde,96,deathknight,frost,6,1,5
Thryndiel,ravencrest,96,deathknight,frost,6,1,5
Бахлыщ,soulflayer,96,deathknight,frost,6,1,5
Thínkk,ysondre,96,deathknight,frost,6,1,5
Urukaye,silvermoon,96,deathknight,frost,6,1,5
Slimez,magtheridon,96,deathknight,frost,6,1,5
Assølid,arathor,42,deathknight,frost,11,2,9
Zslebaans,dun-modr,2204,demonhunter,havoc,104,55,49
Norgàn,die-aldor,2178,demonhunter,havoc,81,44,37
Melan,sanguino,2116,demonhunter,havoc,108,54,54
Itsdampbaby,kazzak,2064,demonhunter,havoc,67,36,31
Battlebruh,ghostlands,2032,demonhunter,havoc,83,39,44
Læsy,antonidas,2025,demonhunter,havoc,101,53,48
Enysia,twisting-nether,2001,demonhunter,havoc,92,42,50
Damatche,outland,1991,demonhunter,havoc,108,57,51
Veon,ravencrest,1989,demonhunter,havoc,221,106,115
Ohseri,defias-brotherhood,1978,demonhunter,havoc,72,38,34
Anabbele,kazzak,1968,demonhunter,havoc,90,49,41
Ðesz,sanguino,1960,demonhunter,havoc,78,37,41
Badtimes,malganis,1941,demonhunter,havoc,114,60,54
Ïîï,archimonde,1934,demonhunter,havoc,79,37,42
Scubaman,tarren-mill,1932,demonhunter,havoc,54,31,23
Zuklio,ysondre,1928,demonhunter,havoc,54,28,26
Pipeandy,kazzak,1918,demonhunter,havoc,83,45,38
Fiveyearques,sylvanas,1911,demonhunter,havoc,78,39,39
Razzagall,elune,1910,demonhunter,havoc,42,20,22
Walkmyshoes,twisting-nether,1907,demonhunter,havoc,90,46,44
Boxssabanned,archimonde,1903,demonhunter,havoc,77,38,39
Belvé,draenor,1897,demonhunter,havoc,78,40,38
Battlebruuh,ghostlands,1885,demonhunter,havoc,54,23,31
Donkeydh,tarren-mill,1868,demonhunter,havoc,54,36,18
Perna,ghostlands,1867,demonhunter,havoc,60,29,31
Illislan,darksorrow,1866,demonhunter,havoc,114,58,56
Brolafsen,ravencrest,1859,demonhunter,havoc,66,32,34
Airelidari,tyrande,1856,demonhunter,havoc,84,45,39
Mädchen,blackhand,1854,demonhunter,havoc,48,23,25
Gíftig,ravencrest,1843,demonhunter,havoc,47,24,23
Клопобойка,gordunni,1842,demonhunter,havoc,69,37,32
Bloodwatcher,twisting-nether,1842,demonhunter,havoc,54,27,27
Лфгхиро,soulflayer,1839,demonhunter,havoc,41,23,18
Fotmdehatwo,blackrock,1837,demonhunter,havoc,61,32,29
Kindablind,aggramar,1835,demonhunter,havoc,65,33,32
Màuul,ravencrest,1831,demonhunter,havoc,80,39,41
Сасун,galakrond,1831,demonhunter,havoc,69,32,37
Supay,rexxar,1830,demonhunter,havoc,58,31,27
Betterevoker,outland,1828,demonhunter,havoc,54,32,22
Yamehd,stormreaver,1827,demonhunter,havoc,42,26,16
Boostbydh,archimonde,1826,demonhunter,havoc,62,31,31
Heatx,ysondre,1825,demonhunter,havoc,60,31,29
Сибу,soulflayer,1825,demonhunter,havoc,48,21,27
Iryut,onyxia,1820,demonhunter,havoc,60,32,28
Dreamslash,tarren-mill,1817,demonhunter,havoc,52,29,23
Unseenshadow,ragnaros,1813,demonhunter,havoc,60,25,35
Zerinitý,outland,1809,demonhunter,havoc,48,29,19
Glìmpsêgøðx,twisting-nether,1809,demonhunter,havoc,42,22,20
Хменчик,soulflayer,1809,demonhunter,havoc,97,47,50
Yúki,blackrock,1809,demonhunter,havoc,48,23,25
Ææçëñ,ravencrest,1808,demonhunter,havoc,36,23,13
Demonalpha,stormscale,1808,demonhunter,havoc,33,19,14
Xarôth,eredar,1805,demonhunter,havoc,48,22,26
Cláw,ravencrest,1804,demonhunter,havoc,66,33,33
Cydh,auchindoun,1804,demonhunter,havoc,54,27,27
Oldforwow,outland,1803,demonhunter,havoc,84,44,40
Batik,blackmoore,1802,demonhunter,havoc,78,40,38
Gilletteabdi,argent-dawn,1802,demonhunter,havoc,66,31,35
Миелион,gordunni,1800,demonhunter,havoc,65,29,36
Chxpo,twisting-nether,1796,demonhunter,havoc,83,43,40
Funkiller,stormscale,1788,demonhunter,havoc,46,24,22
Mazöku,ravencrest,1787,demonhunter,havoc,72,41,31
Apfelbaum,die-aldor,1785,demonhunter,havoc,48,31,17
Геммула,howling-fjord,1779,demonhunter,havoc,90,50,40
Mongoose,drakthul,1768,demonhunter,havoc,48,26,22
Netherim,twisting-nether,1768,demonhunter,havoc,60,27,33
Brawndow,draenor,1764,demonhunter,havoc,66,29,37
Évø,silvermoon,1763,demonhunter,havoc,54,26,28
Stazó,drakthul,1756,demonhunter,havoc,85,46,39
Wojtall,silvermoon,1750,demonhunter,havoc,83,49,34
Nuxzhell,tarren-mill,1749,demonhunter,havoc,96,49,47
Primolover,outland,1747,demonhunter,havoc,54,27,27
Onof,hyjal,1742,demonhunter,havoc,54,26,28
Belákor,twisting-nether,1741,demonhunter,havoc,115,60,55
Weez,kilrogg,1719,demonhunter,havoc,54,26,28
Pulsefuzzy,burning-legion,1715,demonhunter,havoc,42,25,17
Maevê,frostmourne,1712,demonhunter,havoc,37,19,18
Uldren,defias-brotherhood,1711,demonhunter,havoc,56,26,30
Рейз,howling-fjord,1710,demonhunter,havoc,42,19,23
Depure,blackrock,1707,demonhunter,havoc,48,24,24
Ðoksy,archimonde,1707,demonhunter,havoc,36,18,18
Hunee,kazzak,1706,demonhunter,havoc,54,32,22
Киттигоплей,soulflayer,1705,demonhunter,havoc,24,18,6
Íllìðåñgøðx,twisting-nether,1705,demonhunter,havoc,46,22,24
Zeroques,frostmane,1705,demonhunter,havoc,54,25,29
Mentalìst,blackmoore,1703,demonhunter,havoc,57,35,22
Felen,zuljin,1703,demonhunter,havoc,47,21,26
Gøat,nemesis,1700,demonhunter,havoc,24,18,6
Indral,argent-dawn,1699,demonhunter,havoc,42,25,17
Malignantx,ragnaros,1699,demonhunter,havoc,42,22,20
Donipwnz,blackrock,1698,demonhunter,havoc,42,21,21
Tanjero,stormscale,1696,demonhunter,havoc,53,36,17
Balberith,twisting-nether,1692,demonhunter,havoc,48,27,21
Bxdh,outland,1688,demonhunter,havoc,45,21,24
Истребитель,blackscar,1687,demonhunter,havoc,54,33,21
Мортрэд,gordunni,1675,demonhunter,havoc,36,23,13
Шахдан,howling-fjord,1673,demonhunter,havoc,76,43,33
Spheria,outland,1671,demonhunter,havoc,83,40,43
Автокикер,soulflayer,1655,demonhunter,havoc,30,18,12
Cuddlypeanut,argent-dawn,1655,demonhunter,havoc,58,23,35
Thorair,ravenholdt,1653,demonhunter,havoc,60,31,29
Khétí,tarren-mill,1652,demonhunter,havoc,48,23,25
Demonmancer,ravencrest,1651,demonhunter,havoc,78,44,34
Velysaría,guldan,1650,demonhunter,havoc,46,25,21
Finwe,outland,1646,demonhunter,havoc,39,23,16
Ïfï,archimonde,1646,demonhunter,havoc,62,31,31
Èstefany,stormscale,1638,demonhunter,havoc,36,25,11
Aofaye,aegwynn,1638,demonhunter,havoc,53,21,32
Riptos,blackhand,1635,demonhunter,havoc,46,22,24
Razex,kazzak,1635,demonhunter,havoc,51,23,28
Akkita,ravencrest,1631,demonhunter,havoc,56,32,24
Temac,magtheridon,1630,demonhunter,havoc,42,22,20
Reckqt,eredar,1628,demonhunter,havoc,30,17,13
Юзлескласс,gordunni,1627,demonhunter,havoc,36,20,16
Omegapump,ravencrest,1626,demonhunter,havoc,36,19,17
Drmanaburn,ravencrest,1624,demonhunter,havoc,30,17,13
Jolyh,nemesis,1622,demonhunter,havoc,36,24,12
Крикадский,howling-fjord,1617,demonhunter,havoc,54,35,19
Nøbodyx,tarren-mill,1617,demonhunter,havoc,36,20,16
Demonichanta,azjolnerub,1617,demonhunter,havoc,84,43,41
Imslapping,draenor,1610,demonhunter,havoc,54,29,25
Kikitank,hyjal,1609,demonhunter,havoc,101,54,47
Picpouc,archimonde,1608,demonhunter,havoc,48,22,26
Aiean,ravencrest,1608,demonhunter,havoc,48,20,28
Nillrogthedh,stormscale,1598,demonhunter,havoc,78,52,26
Çôæ,twisting-nether,1598,demonhunter,havoc,36,20,16
Zayláh,ravencrest,1597,demonhunter,havoc,72,35,37
Майотх,gordunni,1593,demonhunter,havoc,72,28,44
Lindzor,frostmane,1584,demonhunter,havoc,35,25,10
Incanator,tarren-mill,1584,demonhunter,havoc,54,28,26
Däshgødx,stormscale,1582,demonhunter,havoc,42,26,16
Трукейт,gordunni,1582,demonhunter,havoc,56,33,23
Великаямыша,blackscar,1572,demonhunter,havoc,38,23,15
Possomhd,kazzak,1572,demonhunter,havoc,36,21,15
Felski,outland,1572,demonhunter,havoc,40,18,22
Авилолз,gordunni,1568,demonhunter,havoc,36,18,18
Azaleia,archimonde,1566,demonhunter,havoc,89,45,44
Xalgalor,silvermoon,1565,demonhunter,havoc,36,20,16
Lghdtv,ravencrest,1560,demonhunter,havoc,66,33,33
Telarris,twisting-nether,1557,demonhunter,havoc,117,71,46
Yousaindh,blackrock,1553,demonhunter,havoc,48,18,30
Nolitara,exodar,1552,demonhunter,havoc,42,20,22
Shylea,ravencrest,1551,demonhunter,havoc,54,30,24
Dinastye,archimonde,1546,demonhunter,havoc,30,17,13
Frevee,outland,1543,demonhunter,havoc,71,45,26
Malakbel,nemesis,1541,demonhunter,havoc,63,34,29
Lanadelbae,teldrassil,1538,demonhunter,havoc,67,31,36
Boozlike,tarren-mill,1537,demonhunter,havoc,54,28,26
Nixzon,thrall,1537,demonhunter,havoc,54,18,36
Ambudh,kazzak,1533,demonhunter,havoc,30,16,14
Tyssra,argent-dawn,1531,demonhunter,havoc,36,16,20
Мужичок,soulflayer,1529,demonhunter,havoc,30,18,12
Albunico,draenor,1527,demonhunter,havoc,105,59,46
Tenawees,blackmoore,1525,demonhunter,havoc,30,20,10
Vênedri,eredar,1522,demonhunter,havoc,36,22,14
Сосочков,soulflayer,1522,demonhunter,havoc,35,17,18
Ilovelilith,zuljin,1521,demonhunter,havoc,30,16,14
Amnésysx,ysondre,1521,demonhunter,havoc,36,16,20
Guccibaby,silvermoon,1518,demonhunter,havoc,42,21,21
Akaria,blackrock,1517,demonhunter,havoc,46,33,13
Speedførce,antonidas,1513,demonhunter,havoc,36,16,20
Shadoss,ravencrest,1513,demonhunter,havoc,42,18,24
Âspen,archimonde,1512,demonhunter,havoc,30,23,7
Myztiko,hellscream,1511,demonhunter,havoc,87,47,40
Havocer,burning-legion,1511,demonhunter,havoc,36,18,18
Slaanaesh,kazzak,1511,demonhunter,havoc,45,17,28
Quazr,outland,1509,demonhunter,havoc,69,44,25
Garoteromani,draenor,1509,demonhunter,havoc,30,19,11
Oonn,outland,1509,demonhunter,havoc,33,18,15
Цэрри,soulflayer,1509,demonhunter,havoc,48,24,24
Tamtheone,silvermoon,1503,demonhunter,havoc,54,26,28
Nisirae,argent-dawn,1501,demonhunter,havoc,39,24,15
Rvnx,archimonde,1497,demonhunter,havoc,54,27,27
Hauntedseoul,grim-batol,1496,demonhunter,havoc,90,54,36
Xetalar,burning-legion,1494,demonhunter,havoc,66,40,26
Métakagoule,ysondre,1488,demonhunter,havoc,45,22,23
Snitchezz,blackmoore,1486,demonhunter,havoc,66,36,30
Susanoø,eredar,1481,demonhunter,havoc,81,40,41
Oggidanbuu,tarren-mill,1479,demonhunter,havoc,36,17,19
Échô,tarren-mill,1479,demonhunter,havoc,36,17,19
Winxclub,ravencrest,1478,demonhunter,havoc,41,24,17
Kayzel,argent-dawn,1477,demonhunter,havoc,66,30,36
Vorbis,twisting-nether,1472,demonhunter,havoc,42,17,25
Цезарий,gordunni,1462,demonhunter,havoc,60,28,32
Arnokia,kazzak,1462,demonhunter,havoc,42,18,24
Dyamo,sylvanas,1453,demonhunter,havoc,123,57,66
Ülquiorrä,kazzak,1450,demonhunter,havoc,53,34,19
Mavorz,blackhand,1437,demonhunter,havoc,24,15,9
Shadyblady,nemesis,1433,demonhunter,havoc,24,15,9
Satånist,outland,1433,demonhunter,havoc,24,15,9
Nuitrayer,hyjal,1432,demonhunter,havoc,35,23,12
Împd,ravencrest,1432,demonhunter,havoc,78,36,42
Soizis,drakthul,1431,demonhunter,havoc,24,15,9
Dadøw,dun-modr,1431,demonhunter,havoc,36,15,21
Râindra,twisting-nether,1428,demonhunter,havoc,72,32,40
Felom,garona,1427,demonhunter,havoc,24,15,9
Duffin,doomhammer,1427,demonhunter,havoc,60,26,34
Crappyftw,ravencrest,1425,demonhunter,havoc,66,34,32
Фэсс,soulflayer,1423,demonhunter,havoc,36,16,20
Дартарин,gordunni,1422,demonhunter,havoc,44,26,18
Imlegalblind,ragnaros,1422,demonhunter,havoc,38,17,21
Ilidrax,hyjal,1421,demonhunter,havoc,30,15,15
Phudi,tarren-mill,1419,demonhunter,havoc,71,32,39
Molntuss,ravencrest,1418,demonhunter,havoc,38,15,23
Camtoe,ravencrest,1416,demonhunter,havoc,25,16,9
Аянамирейко,blackscar,1407,demonhunter,havoc,42,26,16
Súrinox,blackrock,1405,demonhunter,havoc,47,31,16
Luckertwo,tarren-mill,1403,demonhunter,havoc,54,30,24
Alithy,kazzak,1400,demonhunter,havoc,53,32,21
Dominik,the-maelstrom,1396,demonhunter,havoc,36,20,16
Razziyel,ragnaros,1396,demonhunter,havoc,41,21,20
Valarauk,ravencrest,1395,demonhunter,havoc,63,38,25
Darrkdemon,kazzak,1395,demonhunter,havoc,65,28,37
Чанпэн,soulflayer,1392,demonhunter,havoc,86,42,44
Фумиан,soulflayer,1387,demonhunter,havoc,36,15,21
Ranked,drakthul,1386,demonhunter,havoc,39,16,23
Thugrøse,blackrock,1385,demonhunter,havoc,36,18,18
Cptxo,tarren-mill,1382,demonhunter,havoc,35,16,19
Keanujeeves,dentarg,1376,demonhunter,havoc,60,33,27
ßerdína,tarren-mill,1373,demonhunter,havoc,33,15,18
Anstict,kazzak,1371,demonhunter,havoc,42,19,23
Seyran,silvermoon,1367,demonhunter,havoc,30,15,15
Iaml,ravencrest,1366,demonhunter,havoc,49,24,25
Ziltush,archimonde,1366,demonhunter,havoc,45,22,23
Imsickleavme,draenor,1363,demonhunter,havoc,64,32,32
Ларэгар,azuregos,1361,demonhunter,havoc,60,24,36
Øbsessiøn,kazzak,1360,demonhunter,havoc,36,16,20
Despèradø,archimonde,1356,demonhunter,havoc,36,15,21
Flaybalbooll,ragnaros,1355,demonhunter,havoc,48,23,25
Агрочика,borean-tundra,1343,demonhunter,havoc,35,15,20
Slutkitten,ravencrest,1342,demonhunter,havoc,24,14,10
Illídana,azjolnerub,1340,demonhunter,havoc,62,32,30
Ted,frostwolf,1339,demonhunter,havoc,30,14,16
Elsynn,dalaran,1338,demonhunter,havoc,30,14,16
Nepthýs,blackhand,1338,demonhunter,havoc,33,15,18
Demonmatheo,stormscale,1337,demonhunter,havoc,24,14,10
Itheos,kazzak,1336,demonhunter,havoc,36,17,19
Faytundh,kult-der-verdammten,1336,demonhunter,havoc,30,14,16
Shaihulud,sanguino,1336,demonhunter,havoc,48,22,26
Adalya,stormrage,1336,demonhunter,havoc,35,15,20
Kïng,frostmane,1330,demonhunter,havoc,18,14,4
Khalestya,shendralar,1330,demonhunter,havoc,36,15,21
Кельдарк,soulflayer,1324,demonhunter,havoc,70,27,43
Ragnirok,deathwing,1317,demonhunter,havoc,42,18,24
Ðraudræm,ravencrest,1314,demonhunter,havoc,50,21,29
Írony,draenor,1310,demonhunter,havoc,26,15,11
Slowcuzclick,stormscale,1307,demonhunter,havoc,85,44,41
Breezzdh,twisting-nether,1305,demonhunter,havoc,29,14,15
Enthia,antonidas,1303,demonhunter,havoc,35,15,20
Каралас,soulflayer,1301,demonhunter,havoc,36,21,15
Skywålker,stormscale,1292,demonhunter,havoc,33,14,19
Haldin,kazzak,1287,demonhunter,havoc,29,14,15
Billidan,eredar,1282,demonhunter,havoc,54,25,29
Przemson,mazrigos,1281,demonhunter,havoc,29,14,15
Thegamesucks,ravencrest,1279,demonhunter,havoc,139,69,70
Wrakdh,archimonde,1275,demonhunter,havoc,36,21,15
Jayhan,chamber-of-aspects,1264,demonhunter,havoc,47,25,22
Norac,silvermoon,1248,demonhunter,havoc,41,16,25
Sofun,stormscale,1247,demonhunter,havoc,24,13,11
Дэн,blackscar,1246,demonhunter,havoc,24,13,11
Cuirnoir,ravencrest,1244,demonhunter,havoc,24,13,11
Anubias,ravencrest,1243,demonhunter,havoc,36,13,23
Ryänåir,ravencrest,1241,demonhunter,havoc,18,13,5
Illiada,spinebreaker,1240,demonhunter,havoc,24,13,11
Турбосвинья,gordunni,1239,demonhunter,havoc,24,13,11
Demonligos,draenor,1239,demonhunter,havoc,66,35,31
Edh,dalaran,1239,demonhunter,havoc,30,13,17
Brisingamen,outland,1234,demonhunter,havoc,24,13,11
Culywurly,silvermoon,1234,demonhunter,havoc,24,13,11
Bøøgý,silvermoon,1234,demonhunter,havoc,42,19,23
Tkr,zuljin,1231,demonhunter,havoc,18,13,5
Claere,blackhand,1231,demonhunter,havoc,60,33,27
Hirbs,silvermoon,1222,demonhunter,havoc,61,25,36
Coltender,drakthul,1222,demonhunter,havoc,46,18,28
Ashrena,ysondre,1218,demonhunter,havoc,18,13,5
Bestdemon,tarren-mill,1218,demonhunter,havoc,24,13,11
Notcrashy,eredar,1215,demonhunter,havoc,18,13,5
Betråyêr,draenor,1213,demonhunter,havoc,38,15,23
Thingawoop,tarren-mill,1211,demonhunter,havoc,26,14,12
Philona,die-aldor,1209,demonhunter,havoc,63,28,35
Hawoc,chamber-of-aspects,1194,demonhunter,havoc,24,14,10
Аркантт,soulflayer,1193,demonhunter,havoc,30,14,16
Nanocsika,twisting-nether,1187,demonhunter,havoc,51,24,27
Сумърак,grom,1180,demonhunter,havoc,23,13,10
Luzifer,ambossar,1171,demonhunter,havoc,64,31,33
Kiriall,blackmoore,1169,demonhunter,havoc,42,18,24
Lagordin,aggramar,1161,demonhunter,havoc,18,14,4
Neverdance,ravencrest,1152,demonhunter,havoc,24,12,12
Brainlessdmg,ragnaros,1151,demonhunter,havoc,18,12,6
Barbarinjo,silvermoon,1151,demonhunter,havoc,18,12,6
Lassudan,stormreaver,1151,demonhunter,havoc,24,12,12
Felwinter,ravencrest,1151,demonhunter,havoc,24,12,12
Элизар,howling-fjord,1151,demonhunter,havoc,24,12,12
Bojestvena,twisting-nether,1151,demonhunter,havoc,24,12,12
Kebabidin,kazzak,1151,demonhunter,havoc,24,12,12
Hagana,tirion,1151,demonhunter,havoc,24,12,12
Enfy,twisting-nether,1150,demonhunter,havoc,24,12,12
Doomcake,emeriss,1149,demonhunter,havoc,18,12,6
Seleverkauft,antonidas,1149,demonhunter,havoc,18,12,6
Bigboychaos,twisting-nether,1149,demonhunter,havoc,36,19,17
Kezumå,tarren-mill,1149,demonhunter,havoc,24,12,12
Azraethx,ravencrest,1148,demonhunter,havoc,18,12,6
Åelita,burning-legion,1147,demonhunter,havoc,18,12,6
Jumboo,tarren-mill,1146,demonhunter,havoc,24,12,12
Dhzor,twisting-nether,1146,demonhunter,havoc,24,12,12
Razrsolo,tarren-mill,1145,demonhunter,havoc,24,12,12
Fullsënd,ragnaros,1145,demonhunter,havoc,36,12,24
Stellarvore,nemesis,1144,demonhunter,havoc,24,12,12
Ämi,blackmoore,1143,demonhunter,havoc,24,12,12
Sweetpety,tarren-mill,1143,demonhunter,havoc,24,12,12
Vozol,stormscale,1141,demonhunter,havoc,18,14,4
Tayo,dun-modr,1140,demonhunter,havoc,24,12,12
Poutanaola,twisting-nether,1140,demonhunter,havoc,24,12,12
Hornyhexy,stormscale,1139,demonhunter,havoc,30,12,18
Gullveîg,archimonde,1136,demonhunter,havoc,24,12,12
Toddsnuggles,thrall,1135,demonhunter,havoc,18,12,6
Даблкорк,soulflayer,1133,demonhunter,havoc,29,16,13
Checakore,argent-dawn,1130,demonhunter,havoc,24,12,12
Бичерезх,soulflayer,1127,demonhunter,havoc,24,12,12
Даргсайд,gordunni,1121,demonhunter,havoc,30,12,18
Chapzi,ragnaros,1117,demonhunter,havoc,24,12,12
Bläckdëvïl,uldum,1115,demonhunter,havoc,18,12,6
Scarebearz,outland,1113,demonhunter,havoc,42,23,19
Zengor,twilights-hammer,1109,demonhunter,havoc,28,14,14
Сильверган,soulflayer,1102,demonhunter,havoc,42,17,25
Kebiz,ragnaros,1090,demonhunter,havoc,23,12,11
Oxydh,ravencrest,1086,demonhunter,havoc,23,12,11
Tórstenstøck,ravencrest,1085,demonhunter,havoc,17,12,5
Venøøm,eldrethalas,1084,demonhunter,havoc,84,37,47
Byah,kazzak,1076,demonhunter,havoc,49,20,29
Kladius,skullcrusher,1067,demonhunter,havoc,21,12,9
Guanzho,silvermoon,1066,demonhunter,havoc,33,13,20
Munja,hyjal,1064,demonhunter,havoc,36,16,20
Itsukix,stormscale,1063,demonhunter,havoc,24,13,11
Gabquist,argent-dawn,1056,demonhunter,havoc,23,15,8
Kostiq,kazzak,1056,demonhunter,havoc,18,11,7
Dantert,zuljin,1056,demonhunter,havoc,18,11,7
Demoncyka,twisting-nether,1056,demonhunter,havoc,30,11,19
Sepdy,draenor,1055,demonhunter,havoc,18,11,7
Trashcarlitô,eredar,1055,demonhunter,havoc,18,11,7
Burchulica,sylvanas,1055,demonhunter,havoc,18,11,7
Dasein,tarren-mill,1055,demonhunter,havoc,24,11,13
Treehunter,ravencrest,1054,demonhunter,havoc,18,11,7
Hialdoo,sylvanas,1054,demonhunter,havoc,30,11,19
Evil,uldum,1051,demonhunter,havoc,24,11,13
Aphulucky,kazzak,1050,demonhunter,havoc,30,11,19
Delfee,twisting-nether,1041,demonhunter,havoc,24,13,11
Milkeyes,ravencrest,1041,demonhunter,havoc,42,21,21
Demonhyan,chants-éternels,1035,demonhunter,havoc,49,25,24
Джигурдинец,gordunni,1035,demonhunter,havoc,24,12,12
Aamonath,tarren-mill,1030,demonhunter,havoc,30,16,14
Увиден,eversong,1021,demonhunter,havoc,47,22,25
Metadel,outland,1016,demonhunter,havoc,54,29,25
Шмальнуть,gordunni,997,demonhunter,havoc,32,12,20
Viridisignis,silvermoon,993,demonhunter,havoc,36,16,20
Нохелет,deepholm,984,demonhunter,havoc,45,21,24
Sintoraz,amanthul,975,demonhunter,havoc,36,21,15
Deadskill,alexstrasza,975,demonhunter,havoc,42,19,23
Demontripo,silvermoon,973,demonhunter,havoc,69,36,33
Флеркенкот,galakrond,972,demonhunter,havoc,55,28,27
Hunterston,twisting-nether,963,demonhunter,havoc,62,34,28
Нэйтиси,soulflayer,960,demonhunter,havoc,18,10,8
Illidrax,outland,960,demonhunter,havoc,18,10,8
Уполномочен,howling-fjord,960,demonhunter,havoc,18,10,8
Rehagen,ysondre,960,demonhunter,havoc,24,10,14
Yerla,burning-legion,960,demonhunter,havoc,24,10,14
Eyasluna,twisting-nether,960,demonhunter,havoc,24,10,14
Testôdh,blackrock,960,demonhunter,havoc,24,10,14
Përry,archimonde,959,demonhunter,havoc,18,10,8
Катякрылышки,gordunni,959,demonhunter,havoc,18,10,8
Theaisbae,twisting-nether,959,demonhunter,havoc,18,10,8
Kinstak,sanguino,959,demonhunter,havoc,18,10,8
Kéftëmé,ravencrest,959,demonhunter,havoc,18,10,8
Аитерия,gordunni,958,demonhunter,havoc,12,10,2
Хингарский,deathguard,958,demonhunter,havoc,18,10,8
Iphanaa,frostmane,958,demonhunter,havoc,22,10,12
Gïzmó,tarren-mill,958,demonhunter,havoc,24,10,14
Blizdliksk,outland,957,demonhunter,havoc,18,10,8
Pówèr,ravencrest,953,demonhunter,havoc,18,10,8
Thëos,argent-dawn,953,demonhunter,havoc,18,10,8
Shadowkick,archimonde,953,demonhunter,havoc,96,43,53
Momochi,silvermoon,952,demonhunter,havoc,18,10,8
Symbul,blackrock,951,demonhunter,havoc,24,10,14
Sinthetyx,quelthalas,940,demonhunter,havoc,24,14,10
Shishiro,alakir,937,demonhunter,havoc,24,10,14
Finstergraf,blackmoore,909,demonhunter,havoc,18,10,8
Varedisa,kazzak,906,demonhunter,havoc,23,10,13
Skylinex,dentarg,901,demonhunter,havoc,48,24,24
Øctågøñ,blackrock,894,demonhunter,havoc,22,10,12
Bicskas,ragnaros,891,demonhunter,havoc,20,11,9
Obey,exodar,890,demonhunter,havoc,20,10,10
Folygale,outland,864,demonhunter,havoc,12,9,3
Mønkeyx,kazzak,864,demonhunter,havoc,12,9,3
Wibergdh,kazzak,864,demonhunter,havoc,12,9,3
Bignugs,ravencrest,864,demonhunter,havoc,18,9,9
Toschadh,blackmoore,864,demonhunter,havoc,18,9,9
Çøððøøððøøðð,blackmoore,864,demonhunter,havoc,18,9,9
Saene,ravencrest,864,demonhunter,havoc,18,9,9
Faufilé,garona,864,demonhunter,havoc,18,9,9
Raïley,archimonde,864,demonhunter,havoc,18,9,9
Смутсайбот,howling-fjord,864,demonhunter,havoc,18,9,9
Oniramqt,aegwynn,864,demonhunter,havoc,18,9,9
Eréthrus,ravencrest,864,demonhunter,havoc,18,9,9
Ferihokurva,outland,864,demonhunter,havoc,18,9,9
Sghemon,pozzo-delleternità,864,demonhunter,havoc,18,9,9
Demobob,tarren-mill,864,demonhunter,havoc,18,9,9
Майкелелекек,gordunni,864,demonhunter,havoc,24,9,15
Chïbrøne,archimonde,864,demonhunter,havoc,24,9,15
Cheetòs,blackmoore,863,demonhunter,havoc,12,9,3
Ììîîííììîîíí,tarren-mill,863,demonhunter,havoc,18,9,9
Unkqt,dalaran,863,demonhunter,havoc,18,9,9
Nvampire,draenor,862,demonhunter,havoc,12,9,3
Sebyk,doomhammer,862,demonhunter,havoc,18,9,9
Jesana,argent-dawn,862,demonhunter,havoc,18,9,9
Zappikdh,silvermoon,862,demonhunter,havoc,18,9,9
Pichkachu,sylvanas,859,demonhunter,havoc,18,9,9
Kaizzy,twisting-nether,856,demonhunter,havoc,18,9,9
Hawek,madmortem,855,demonhunter,havoc,12,9,3
Azazelkw,ragnaros,855,demonhunter,havoc,18,9,9
Dreggath,doomhammer,845,demonhunter,havoc,24,9,15
Гарнаш,howling-fjord,842,demonhunter,havoc,18,9,9
Zulthealbino,tarren-mill,830,demonhunter,havoc,14,10,4
Попкасиська,eversong,819,demonhunter,havoc,41,19,22
Taliaa,drakthul,816,demonhunter,havoc,15,9,6
Тарапынька,gordunni,816,demonhunter,havoc,23,9,14
Kroepoeks,mazrigos,789,demonhunter,havoc,18,9,9
Kundans,aegwynn,787,demonhunter,havoc,17,9,8
Enjøybrah,nemesis,768,demonhunter,havoc,12,8,4
Azzïnoth,sargeras,768,demonhunter,havoc,12,8,4
Dedemøn,ysondre,768,demonhunter,havoc,12,8,4
Wibez,twisting-nether,768,demonhunter,havoc,12,8,4
Eyecandy,scarshield-legion,768,demonhunter,havoc,12,8,4
Stinkymonkey,pozzo-delleternità,768,demonhunter,havoc,18,8,10
Shõ,twisting-nether,768,demonhunter,havoc,24,8,16
Камуи,gordunni,768,demonhunter,havoc,30,8,22
Morphiyy,tarren-mill,767,demonhunter,havoc,12,8,4
Lozakum,draenor,767,demonhunter,havoc,12,8,4
Misli,stormscale,767,demonhunter,havoc,12,8,4
Мицлейн,gordunni,767,demonhunter,havoc,18,8,10
Zitx,ravencrest,766,demonhunter,havoc,18,8,10
Demonjay,stormscale,766,demonhunter,havoc,22,9,13
Natazia,eredar,765,demonhunter,havoc,18,8,10
Lùcîfer,hellfire,763,demonhunter,havoc,18,8,10
Covidian,kilrogg,762,demonhunter,havoc,12,8,4
Bessus,aggra-português,762,demonhunter,havoc,18,8,10
Maltok,ysondre,762,demonhunter,havoc,18,8,10
Lögan,uldum,759,demonhunter,havoc,18,8,10
Nuriia,arthas,749,demonhunter,havoc,12,8,4
Merelini,twisting-nether,736,demonhunter,havoc,16,8,8
Krm,dun-modr,735,demonhunter,havoc,14,9,5
Baddxd,ragnaros,719,demonhunter,havoc,11,8,3
Gushìñgwøuñð,blackmoore,719,demonhunter,havoc,11,8,3
Silan,kiljaeden,711,demonhunter,havoc,17,8,9
Jco,kazzak,703,demonhunter,havoc,20,8,12
Стрепа,grom,693,demonhunter,havoc,17,8,9
Alied,burning-blade,672,demonhunter,havoc,12,7,5
Bizl,arygos,672,demonhunter,havoc,12,7,5
Yorxdh,eredar,672,demonhunter,havoc,12,7,5
Enhtailo,draenor,672,demonhunter,havoc,12,7,5
Hextechz,stormscale,672,demonhunter,havoc,12,7,5
Геннитиро,deathguard,672,demonhunter,havoc,12,7,5
Ozu,blackrock,672,demonhunter,havoc,12,7,5
Skarvy,bronze-dragonflight,672,demonhunter,havoc,12,7,5
Dibo,blackmoore,672,demonhunter,havoc,12,7,5
Шалдарон,howling-fjord,672,demonhunter,havoc,12,7,5
Yeedhlol,blackmoore,672,demonhunter,havoc,12,7,5
Pepenger,kazzak,672,demonhunter,havoc,12,7,5
Wintalker,nemesis,672,demonhunter,havoc,12,7,5
Simshady,stormscale,672,demonhunter,havoc,12,7,5
Demondulle,kazzak,672,demonhunter,havoc,18,7,11
Satti,sargeras,672,demonhunter,havoc,18,7,11
Onizukadh,archimonde,672,demonhunter,havoc,18,7,11
Anerana,malganis,672,demonhunter,havoc,18,7,11
Gnarpump,emeriss,672,demonhunter,havoc,18,7,11
Коньх,goldrinn,672,demonhunter,havoc,18,7,11
Rõb,magtheridon,672,demonhunter,havoc,18,7,11
Exceltor,sanguino,672,demonhunter,havoc,24,7,17
Nerfy,silvermoon,671,demonhunter,havoc,12,7,5
Ddvh,drakthul,671,demonhunter,havoc,12,7,5
Meji,ravencrest,671,demonhunter,havoc,12,7,5
Balsza,burning-legion,671,demonhunter,havoc,12,7,5
Pleskdh,malganis,671,demonhunter,havoc,18,7,11
Méruème,hyjal,671,demonhunter,havoc,18,7,11
Zintu,draenor,671,demonhunter,havoc,24,7,17
Милинайт,eversong,670,demonhunter,havoc,12,7,5
Тушино,lich-king,670,demonhunter,havoc,12,7,5
Necrotyle,twisting-nether,669,demonhunter,havoc,21,8,13
Fikyx,draenor,667,demonhunter,havoc,18,7,11
Malabala,grim-batol,639,demonhunter,havoc,11,7,4
Davidastt,drakthul,639,demonhunter,havoc,23,7,16
Legionek,burning-blade,629,demonhunter,havoc,14,8,6
Лизарин,gordunni,623,demonhunter,havoc,17,7,10
Makhabunda,terokkar,618,demonhunter,havoc,28,8,20
Mèlfurion,hyjal,607,demonhunter,havoc,13,8,5
Deadhuntor,daggerspine,606,demonhunter,havoc,11,7,4
Squan,blackmoore,602,demonhunter,havoc,14,7,7
Prouser,turalyon,588,demonhunter,havoc,21,8,13
Alasune,twisting-nether,576,demonhunter,havoc,6,6,0
Djaris,ghostlands,576,demonhunter,havoc,6,6,0
Stonedaf,ravencrest,576,demonhunter,havoc,6,6,0
Kiirtach,dun-modr,576,demonhunter,havoc,9,7,2
Dhlee,ravencrest,576,demonhunter,havoc,12,6,6
Hcsgötze,dalaran,576,demonhunter,havoc,12,6,6
Lòsêr,ravencrest,576,demonhunter,havoc,12,6,6
Shivarræ,stormreaver,576,demonhunter,havoc,12,6,6
Пибзянка,howling-fjord,576,demonhunter,havoc,12,6,6
Elswavé,kazzak,576,demonhunter,havoc,12,6,6
Lezzo,tarren-mill,576,demonhunter,havoc,12,6,6
Noovedh,ravencrest,576,demonhunter,havoc,12,6,6
Aeshalla,blackmoore,576,demonhunter,havoc,12,6,6
Soulmortal,draenor,576,demonhunter,havoc,12,6,6
Хорбелий,deathguard,576,demonhunter,havoc,12,6,6
Sadzari,burning-legion,576,demonhunter,havoc,12,6,6
Врежимеэтти,soulflayer,576,demonhunter,havoc,12,6,6
Thedudex,dunemaul,576,demonhunter,havoc,12,6,6
Viced,kazzak,576,demonhunter,havoc,12,6,6
Reckqqt,eredar,576,demonhunter,havoc,12,6,6
Mittÿ,tarren-mill,576,demonhunter,havoc,12,6,6
Kyuzo,sanguino,576,demonhunter,havoc,12,6,6
Zmasteez,ahnqiraj,576,demonhunter,havoc,12,6,6
Bamßi,ragnaros,576,demonhunter,havoc,12,6,6
Kaitlyyn,norgannon,576,demonhunter,havoc,12,6,6
Lurtéx,kazzak,576,demonhunter,havoc,12,6,6
Rhinozerg,kazzak,576,demonhunter,havoc,12,6,6
Elipireli,doomhammer,576,demonhunter,havoc,12,6,6
Pinx,archimonde,576,demonhunter,havoc,18,6,12
Dhqoo,blackrock,576,demonhunter,havoc,18,6,12
Nøøßønline,hyjal,576,demonhunter,havoc,18,6,12
Véin,stormscale,576,demonhunter,havoc,18,6,12
Calcïum,archimonde,576,demonhunter,havoc,18,6,12
Illidián,chamber-of-aspects,576,demonhunter,havoc,18,6,12
Zaÿn,antonidas,576,demonhunter,havoc,18,6,12
Sailen,blackmoore,576,demonhunter,havoc,18,6,12
Míàkhãlîfâýð,stormscale,576,demonhunter,havoc,18,6,12
Shizuuli,outland,576,demonhunter,havoc,30,6,24
Nezruslfive,dun-modr,575,demonhunter,havoc,12,6,6
Древиал,gordunni,575,demonhunter,havoc,12,6,6
Daweeo,the-maelstrom,575,demonhunter,havoc,12,6,6
Jahannam,ysondre,575,demonhunter,havoc,12,6,6
Icelucard,argent-dawn,575,demonhunter,havoc,12,6,6
Draxie,turalyon,575,demonhunter,havoc,16,7,9
Candylicks,kazzak,575,demonhunter,havoc,18,6,12
Tokoloshë,ragnaros,574,demonhunter,havoc,12,6,6
Schonevrouw,aszune,574,demonhunter,havoc,12,6,6
Ibeem,dentarg,574,demonhunter,havoc,12,6,6
Sangita,tarren-mill,574,demonhunter,havoc,12,6,6
Аллилания,fordragon,572,demonhunter,havoc,6,6,0
Bahmut,argent-dawn,569,demonhunter,havoc,12,6,6
Twistyy,drakthul,569,demonhunter,havoc,18,6,12
Дантавул,gordunni,568,demonhunter,havoc,18,6,12
Sarissa,dun-modr,542,demonhunter,havoc,14,7,7
Подкрадунзай,soulflayer,527,demonhunter,havoc,9,7,2
Makiu,archimonde,527,demonhunter,havoc,15,6,9
Иланари,gordunni,526,demonhunter,havoc,11,6,5
Máédhros,ravencrest,512,demonhunter,havoc,10,6,4
Kanéki,sylvanas,480,demonhunter,havoc,6,5,1
Ninetzqp,tarren-mill,480,demonhunter,havoc,6,5,1
Jugøbænned,blackrock,480,demonhunter,havoc,6,5,1
Nxmpys,sanguino,480,demonhunter,havoc,6,5,1
Giboo,emerald-dream,480,demonhunter,havoc,6,5,1
Muyoni,eredar,480,demonhunter,havoc,6,5,1
Muharaar,ravencrest,480,demonhunter,havoc,6,5,1
Neralith,ravencrest,480,demonhunter,havoc,6,5,1
Demonk,nemesis,480,demonhunter,havoc,6,5,1
Tylleröwittu,grim-batol,480,demonhunter,havoc,6,5,1
Draqula,ravencrest,480,demonhunter,havoc,12,5,7
Jórúnn,twisting-nether,480,demonhunter,havoc,12,5,7
Ozeey,draenor,480,demonhunter,havoc,12,5,7
Jotaros,ravencrest,480,demonhunter,havoc,12,5,7
Onlyfangodx,antonidas,480,demonhunter,havoc,12,5,7
Brodor,alakir,480,demonhunter,havoc,12,5,7
Veryfunhaha,ravencrest,480,demonhunter,havoc,12,5,7
Nèvér,silvermoon,480,demonhunter,havoc,12,5,7
Wrathia,rexxar,480,demonhunter,havoc,12,5,7
Нереалочка,blackscar,480,demonhunter,havoc,12,5,7
Superchocowo,sanguino,480,demonhunter,havoc,12,5,7
Ayyo,agamaggan,480,demonhunter,havoc,12,5,7
Ðémón,outland,480,demonhunter,havoc,12,5,7
Irenzy,twisting-nether,480,demonhunter,havoc,12,5,7
Tomkis,ravencrest,480,demonhunter,havoc,12,5,7
Chosabreka,zuljin,480,demonhunter,havoc,12,5,7
Nøvillain,blackrock,480,demonhunter,havoc,12,5,7
Ignasei,archimonde,480,demonhunter,havoc,12,5,7
Gündüzgezen,silvermoon,480,demonhunter,havoc,12,5,7
Nstea,cthun,480,demonhunter,havoc,12,5,7
Paschli,tarren-mill,480,demonhunter,havoc,12,5,7
Kanabiz,outland,480,demonhunter,havoc,12,5,7
Topg,bladefist,480,demonhunter,havoc,12,5,7
Spitface,aegwynn,480,demonhunter,havoc,12,5,7
Íamprepared,tarren-mill,480,demonhunter,havoc,12,5,7
Varthag,antonidas,480,demonhunter,havoc,12,5,7
Alandiel,twisting-nether,480,demonhunter,havoc,12,5,7
Tastyblades,blackmoore,480,demonhunter,havoc,12,5,7
Roaf,twisting-nether,480,demonhunter,havoc,15,6,9
Aelina,area-52,480,demonhunter,havoc,18,5,13
Кайренсс,howling-fjord,480,demonhunter,havoc,18,5,13
Slizer,draenor,480,demonhunter,havoc,18,5,13
Darnke,silvermoon,480,demonhunter,havoc,18,5,13
Sephiris,argent-dawn,479,demonhunter,havoc,6,5,1
Merilidan,blackrock,479,demonhunter,havoc,12,5,7
Demontevz,outland,479,demonhunter,havoc,12,5,7
Скудайвер,gordunni,478,demonhunter,havoc,12,5,7
Maryjane,nordrassil,478,demonhunter,havoc,12,5,7
Kairidemon,eredar,477,demonhunter,havoc,12,5,7
Winnztlol,chamber-of-aspects,477,demonhunter,havoc,15,5,10
Vincbengt,tarren-mill,476,demonhunter,havoc,12,5,7
Illikan,stormscale,474,demonhunter,havoc,12,5,7
Etraidor,turalyon,473,demonhunter,havoc,12,5,7
Anishara,die-nachtwache,463,demonhunter,havoc,13,6,7
Shaundead,drakthul,447,demonhunter,havoc,11,5,6
Akäly,hyjal,447,demonhunter,havoc,11,5,6
Дисофи,soulflayer,431,demonhunter,havoc,11,5,6
Níghtwing,wildhammer,415,demonhunter,havoc,11,5,6
Lirigizel,hellscream,384,demonhunter,havoc,6,4,2
Mýg,ravencrest,384,demonhunter,havoc,6,4,2
Caronte,los-errantes,384,demonhunter,havoc,6,4,2
Adraelia,archimonde,384,demonhunter,havoc,6,4,2
Twopumpchump,twisting-nether,384,demonhunter,havoc,6,4,2
Люцифэйль,gordunni,384,demonhunter,havoc,6,4,2
Varonx,drakthul,384,demonhunter,havoc,6,4,2
Äzräël,dun-modr,384,demonhunter,havoc,6,4,2
Lemondehunta,twisting-nether,384,demonhunter,havoc,6,4,2
Calendith,arathor,384,demonhunter,havoc,6,4,2
Styxdh,blackhand,384,demonhunter,havoc,6,4,2
Shtahuntna,tarren-mill,384,demonhunter,havoc,6,4,2
Véspé,naxxramas,384,demonhunter,havoc,6,4,2
Titanslayyer,azjolnerub,384,demonhunter,havoc,6,4,2
Cielis,outland,384,demonhunter,havoc,6,4,2
Найтбладия,gordunni,384,demonhunter,havoc,6,4,2
Doobregeesy,burning-legion,384,demonhunter,havoc,6,4,2
Fckmlf,outland,384,demonhunter,havoc,6,4,2
Dxæn,archimonde,384,demonhunter,havoc,6,4,2
Atrikagodx,kazzak,384,demonhunter,havoc,6,4,2
Мужна,grom,384,demonhunter,havoc,6,4,2
Sua,outland,384,demonhunter,havoc,6,4,2
Ikari,neptulon,384,demonhunter,havoc,6,4,2
Никкэс,gordunni,384,demonhunter,havoc,6,4,2
Кайриель,gordunni,384,demonhunter,havoc,6,4,2
Талисзора,gordunni,384,demonhunter,havoc,6,4,2
Drilloz,ravencrest,384,demonhunter,havoc,6,4,2
Sidekiq,silvermoon,384,demonhunter,havoc,6,4,2
Onecho,ragnaros,384,demonhunter,havoc,6,4,2
Freakerzoid,kazzak,384,demonhunter,havoc,11,4,7
Frostidh,ysondre,384,demonhunter,havoc,12,4,8
Mempaan,magtheridon,384,demonhunter,havoc,12,4,8
Ilyerias,twisting-nether,384,demonhunter,havoc,12,4,8
Rebelion,dun-modr,384,demonhunter,havoc,12,4,8
Itadora,antonidas,384,demonhunter,havoc,12,4,8
Shanaplow,hyjal,384,demonhunter,havoc,12,4,8
Shyoxdh,twisting-nether,384,demonhunter,havoc,12,4,8
Lelaniae,blackhand,384,demonhunter,havoc,12,4,8
Innocuouss,twisting-nether,384,demonhunter,havoc,12,4,8
Lòsâng,sanguino,384,demonhunter,havoc,12,4,8
Leylas,nagrand,384,demonhunter,havoc,12,4,8
Хокану,gordunni,384,demonhunter,havoc,12,4,8
Floridaboy,ravencrest,384,demonhunter,havoc,12,4,8
Moonbeàm,kazzak,384,demonhunter,havoc,12,4,8
Rylqt,blackmoore,384,demonhunter,havoc,12,4,8
Одзангейра,blackscar,384,demonhunter,havoc,12,4,8
Лупидолх,soulflayer,384,demonhunter,havoc,12,4,8
Luunz,argent-dawn,384,demonhunter,havoc,18,4,14
Maytherel,blackhand,384,demonhunter,havoc,18,4,14
Nelairia,tarren-mill,383,demonhunter,havoc,6,4,2
Yuka,earthen-ring,383,demonhunter,havoc,12,4,8
Elenastar,kazzak,383,demonhunter,havoc,12,4,8
Vengatoria,cthun,383,demonhunter,havoc,12,4,8
Thorskinius,ravencrest,383,demonhunter,havoc,12,4,8
Jamule,dun-morogh,381,demonhunter,havoc,12,4,8
Lexxdh,blackmoore,351,demonhunter,havoc,8,5,3
Блэйденрифтс,soulflayer,351,demonhunter,havoc,11,4,7
Hyperflex,blackrock,320,demonhunter,havoc,10,4,6
Maddificator,silvermoon,316,demonhunter,havoc,8,4,4
Fruttidimare,frostwolf,288,demonhunter,havoc,6,3,3
Âstræa,antonidas,288,demonhunter,havoc,6,3,3
Ittas,archimonde,288,demonhunter,havoc,6,3,3
Mortyb,kazzak,288,demonhunter,havoc,6,3,3
Fantabolous,ragnaros,288,demonhunter,havoc,6,3,3
Myuøu,hyjal,288,demonhunter,havoc,6,3,3
Анавеллка,howling-fjord,288,demonhunter,havoc,6,3,3
Дэйнни,blackscar,288,demonhunter,havoc,6,3,3
Tharysan,sanguino,288,demonhunter,havoc,6,3,3
Íllìðåñgøðx,antonidas,288,demonhunter,havoc,6,3,3
Blisdon,argent-dawn,288,demonhunter,havoc,6,3,3
Albdh,kazzak,288,demonhunter,havoc,6,3,3
Danedemlia,magtheridon,288,demonhunter,havoc,6,3,3
Dadagodx,kazzak,288,demonhunter,havoc,6,3,3
Chotzbrocke,blackhand,288,demonhunter,havoc,6,3,3
Annaboliik,ravencrest,288,demonhunter,havoc,6,3,3
Imvnrcvr,dalaran,288,demonhunter,havoc,6,3,3
Alleyezønme,outland,288,demonhunter,havoc,6,3,3
Völkswagen,dun-modr,288,demonhunter,havoc,6,3,3
Mollamaija,defias-brotherhood,288,demonhunter,havoc,6,3,3
Giftìg,ravencrest,288,demonhunter,havoc,6,3,3
Андрюхадх,soulflayer,288,demonhunter,havoc,6,3,3
Lonedh,sylvanas,288,demonhunter,havoc,6,3,3
Länika,drakthul,288,demonhunter,havoc,6,3,3
Неффкодх,howling-fjord,288,demonhunter,havoc,6,3,3
Shaadraz,stormscale,288,demonhunter,havoc,6,3,3
Эридари,blackscar,288,demonhunter,havoc,6,3,3
Mürh,nordrassil,288,demonhunter,havoc,6,3,3
Резако,soulflayer,288,demonhunter,havoc,6,3,3
Sayee,drakthul,288,demonhunter,havoc,6,3,3
Natzú,ravencrest,288,demonhunter,havoc,6,3,3
Nthday,draenor,288,demonhunter,havoc,6,3,3
Backflipgødx,uldaman,288,demonhunter,havoc,6,3,3
Ðêmønìnsìðê,blackmoore,288,demonhunter,havoc,6,3,3
Hellboi,dun-modr,288,demonhunter,havoc,6,3,3
Xénôns,archimonde,288,demonhunter,havoc,6,3,3
Wrathill,draenor,288,demonhunter,havoc,6,3,3
Dzikalocha,burning-legion,288,demonhunter,havoc,6,3,3
Saleny,blackrock,288,demonhunter,havoc,6,3,3
Сангвиннус,howling-fjord,288,demonhunter,havoc,6,3,3
Deschacke,eredar,288,demonhunter,havoc,6,3,3
Даудаев,gordunni,288,demonhunter,havoc,6,3,3
Exodlia,silvermoon,288,demonhunter,havoc,6,3,3
Sandem,blackrock,288,demonhunter,havoc,6,3,3
Notapistol,outland,288,demonhunter,havoc,6,3,3
Abigorien,blackmoore,288,demonhunter,havoc,6,3,3
Valø,malganis,288,demonhunter,havoc,6,3,3
Кейсимег,soulflayer,288,demonhunter,havoc,6,3,3
Shinnu,antonidas,288,demonhunter,havoc,6,3,3
Schwitte,tichondrius,288,demonhunter,havoc,6,3,3
Ботология,gordunni,288,demonhunter,havoc,6,3,3
Õmen,ravencrest,288,demonhunter,havoc,6,3,3
Cindras,turalyon,288,demonhunter,havoc,6,3,3
Муими,soulflayer,288,demonhunter,havoc,6,3,3
Neony,blackmoore,288,demonhunter,havoc,6,3,3
Кирсена,gordunni,288,demonhunter,havoc,6,3,3
Aedilles,ravencrest,288,demonhunter,havoc,6,3,3
Зедю,howling-fjord,288,demonhunter,havoc,6,3,3
Èfiie,culte-de-la-rive-noire,288,demonhunter,havoc,6,3,3
Hyonzyyesh,silvermoon,288,demonhunter,havoc,6,3,3
Nightwalk,blackmoore,288,demonhunter,havoc,6,3,3
Ifeeldirty,draenor,288,demonhunter,havoc,6,3,3
Dhaosh,nemesis,288,demonhunter,havoc,6,3,3
Demonsushi,tarren-mill,288,demonhunter,havoc,6,3,3
Batx,ravencrest,288,demonhunter,havoc,6,3,3
Extitan,twisting-nether,288,demonhunter,havoc,6,3,3
Иллидал,greymane,288,demonhunter,havoc,6,3,3
Koomaliha,outland,288,demonhunter,havoc,7,3,4
Wauway,ragnaros,288,demonhunter,havoc,8,3,5
Lovesong,the-shatar,288,demonhunter,havoc,12,3,9
Rurt,sanguino,288,demonhunter,havoc,12,3,9
Kruthor,taerar,288,demonhunter,havoc,12,3,9
Rúpél,thrall,288,demonhunter,havoc,12,3,9
Darktérror,silvermoon,288,demonhunter,havoc,12,3,9
Bichmicher,earthen-ring,288,demonhunter,havoc,12,3,9
Asporos,pozzo-delleternità,288,demonhunter,havoc,12,3,9
Metaman,archimonde,288,demonhunter,havoc,12,3,9
Obitum,burning-legion,288,demonhunter,havoc,12,3,9
Firebringer,silvermoon,288,demonhunter,havoc,12,3,9
Tenaebris,silvermoon,288,demonhunter,havoc,12,3,9
Nyxxeria,drakthul,288,demonhunter,havoc,12,3,9
Vandazza,argent-dawn,288,demonhunter,havoc,12,3,9
Skajlan,burning-legion,288,demonhunter,havoc,12,3,9
Cptgmiasbria,eredar,288,demonhunter,havoc,12,3,9
Tuffêli,turalyon,288,demonhunter,havoc,12,3,9
Lamello,nemesis,288,demonhunter,havoc,12,3,9
Devildust,ravencrest,288,demonhunter,havoc,18,3,15
Jimdh,quelthalas,288,demonhunter,havoc,18,3,15
Lasthija,dun-modr,288,demonhunter,havoc,18,3,15
Saturnein,stormscale,287,demonhunter,havoc,6,3,3
Menutzdh,tarren-mill,287,demonhunter,havoc,6,3,3
Anandria,blutkessel,287,demonhunter,havoc,6,3,3
Hannipham,silvermoon,287,demonhunter,havoc,9,4,5
Judderzz,bronze-dragonflight,286,demonhunter,havoc,6,3,3
Dàrkinette,archimonde,286,demonhunter,havoc,6,3,3
Subelsiu,alakir,286,demonhunter,havoc,12,3,9
Xaro,quelthalas,239,demonhunter,havoc,5,3,2
Itskarmax,outland,239,demonhunter,havoc,5,3,2
Amionisiken,amanthul,208,demonhunter,havoc,7,3,4
Erenyeagerr,kazzak,192,demonhunter,havoc,4,3,1
Critlerman,blackmoore,192,demonhunter,havoc,4,3,1
Actuallytrol,argent-dawn,192,demonhunter,havoc,6,2,4
Williamgrant,alonsus,192,demonhunter,havoc,6,2,4
Datejust,archimonde,192,demonhunter,havoc,6,2,4
Linkôs,aegwynn,192,demonhunter,havoc,6,2,4
Tacodhx,ravencrest,192,demonhunter,havoc,6,2,4
Bämbøué,hyjal,192,demonhunter,havoc,6,2,4
Alcadejas,pozzo-delleternità,192,demonhunter,havoc,6,2,4
Palaurx,kazzak,192,demonhunter,havoc,6,2,4
Крикетх,soulflayer,192,demonhunter,havoc,6,2,4
Xekaul,tarren-mill,192,demonhunter,havoc,6,2,4
Martøsdh,uldum,192,demonhunter,havoc,6,2,4
Gandzsä,ragnaros,192,demonhunter,havoc,6,2,4
Vulcaan,ravencrest,192,demonhunter,havoc,6,2,4
Hupon,drakthul,192,demonhunter,havoc,6,2,4
Juicyglaives,ragnaros,192,demonhunter,havoc,6,2,4
Karpandero,stormreaver,192,demonhunter,havoc,6,2,4
Malzehar,tarren-mill,192,demonhunter,havoc,6,2,4
Demontoolz,outland,192,demonhunter,havoc,6,2,4
Monkeypox,twisting-nether,192,demonhunter,havoc,6,2,4
Cøldlean,ravencrest,192,demonhunter,havoc,6,2,4
Stormshred,stormscale,192,demonhunter,havoc,6,2,4
Usaïnbolts,archimonde,192,demonhunter,havoc,6,2,4
Беатриз,soulflayer,192,demonhunter,havoc,6,2,4
Cutforshred,zenedar,192,demonhunter,havoc,6,2,4
Malkyor,ysondre,192,demonhunter,havoc,6,2,4
Disconecting,outland,192,demonhunter,havoc,6,2,4
Dèsdemøna,nemesis,192,demonhunter,havoc,6,2,4
Sweåfy,outland,192,demonhunter,havoc,6,2,4
Wolfex,hellfire,192,demonhunter,havoc,6,2,4
Zlett,draenor,192,demonhunter,havoc,6,2,4
Antidevil,kazzak,192,demonhunter,havoc,6,2,4
Mêgumi,kirin-tor,192,demonhunter,havoc,6,2,4
Jawohunt,rexxar,192,demonhunter,havoc,6,2,4
Zxcjklcasdlk,sylvanas,192,demonhunter,havoc,6,2,4
Nairra,blackmoore,192,demonhunter,havoc,6,2,4
Soca,ysondre,192,demonhunter,havoc,6,2,4
Тэнсу,borean-tundra,192,demonhunter,havoc,6,2,4
Шоеррей,gordunni,192,demonhunter,havoc,6,2,4
Téthis,uldaman,192,demonhunter,havoc,6,2,4
Saphira,laughing-skull,192,demonhunter,havoc,6,2,4
Деорру,gordunni,192,demonhunter,havoc,6,2,4
Vayshi,turalyon,192,demonhunter,havoc,6,2,4
Broglaive,sylvanas,192,demonhunter,havoc,6,2,4
Аллидариан,howling-fjord,192,demonhunter,havoc,6,2,4
Nanana,doomhammer,192,demonhunter,havoc,6,2,4
Riveén,blackhand,192,demonhunter,havoc,6,2,4
Папичгодх,borean-tundra,192,demonhunter,havoc,6,2,4
Мэлифсб,blackscar,192,demonhunter,havoc,6,2,4
Stickidan,malganis,192,demonhunter,havoc,6,2,4
Spideymon,ragnaros,192,demonhunter,havoc,12,2,10
Gagfordaddy,ravencrest,192,demonhunter,havoc,12,2,10
Zynês,draenor,192,demonhunter,havoc,12,2,10
Gouteça,la-croisade-écarlate,192,demonhunter,havoc,12,2,10
Mettdaemon,ravencrest,192,demonhunter,havoc,12,2,10
Drâparn,sylvanas,192,demonhunter,havoc,12,2,10
Zaydra,the-maelstrom,192,demonhunter,havoc,12,2,10
Redgi,tarren-mill,192,demonhunter,havoc,12,2,10
Enygamy,frostmane,192,demonhunter,havoc,12,2,10
Orochimaruu,kargath,192,demonhunter,havoc,12,2,10
Deathniresa,argent-dawn,191,demonhunter,havoc,6,2,4
Hellforce,nemesis,191,demonhunter,havoc,6,2,4
Butcherr,ulduar,191,demonhunter,havoc,12,2,10
Noorrd,hyjal,191,demonhunter,havoc,12,2,10
Zakaji,blackmoore,127,demonhunter,havoc,8,2,6
Felsbane,argent-dawn,96,demonhunter,havoc,3,2,1
Shyynedh,grim-batol,96,demonhunter,havoc,6,1,5
Rxor,eredar,96,demonhunter,havoc,6,1,5
Mlecznygolem,silvermoon,96,demonhunter,havoc,6,1,5
Burritodh,tarren-mill,96,demonhunter,havoc,6,1,5
Ripgodx,bronzebeard,96,demonhunter,havoc,6,1,5
Artwar,stormscale,96,demonhunter,havoc,6,1,5
Giace,drakthul,96,demonhunter,havoc,6,1,5
Ryuhayabusa,stormscale,96,demonhunter,havoc,6,1,5
Amaterasù,alleria,96,demonhunter,havoc,6,1,5
Klave,argent-dawn,96,demonhunter,havoc,6,1,5
Зарах,gordunni,96,demonhunter,havoc,6,1,5
Lilfly,twisting-nether,96,demonhunter,havoc,6,1,5
Kiô,drakthul,96,demonhunter,havoc,6,1,5
Stàmàzza,nemesis,96,demonhunter,havoc,6,1,5
Pkdaemon,draenor,96,demonhunter,havoc,6,1,5
Bitex,archimonde,96,demonhunter,havoc,6,1,5
Lorcanmar,draenor,96,demonhunter,havoc,6,1,5
Ghetzlel,draenor,96,demonhunter,havoc,6,1,5
Mareen,pozzo-delleternità,96,demonhunter,havoc,6,1,5
Парагони,gordunni,96,demonhunter,havoc,6,1,5
Andij,frostwolf,96,demonhunter,havoc,6,1,5
Daekon,ahnqiraj,96,demonhunter,havoc,6,1,5
Максимлолпро,howling-fjord,96,demonhunter,havoc,6,1,5
Аззазэль,howling-fjord,96,demonhunter,havoc,6,1,5
Annee,eredar,96,demonhunter,havoc,6,1,5
Snelle,outland,96,demonhunter,havoc,6,1,5
Jiínx,kazzak,96,demonhunter,havoc,6,1,5
Найлинель,fordragon,96,demonhunter,havoc,6,1,5
Zarafel,hyjal,96,demonhunter,havoc,6,1,5
Babyyéah,sunstrider,96,demonhunter,havoc,12,1,11
Ecthelionn,outland,96,demonhunter,havoc,12,1,11
Elldarion,blackhand,79,demonhunter,havoc,5,1,4
Deamo,stormscale,79,demonhunter,havoc,5,1,4
Caluxe,blackmoore,79,demonhunter,havoc,5,1,4
Гадх,gordunni,42,demonhunter,havoc,8,2,6
Greyfel,blackhand,31,demonhunter,havoc,2,1,1
Sinjinzoo,blackrock,31,demonhunter,havoc,2,1,1
Felwaifu,tarren-mill,31,demonhunter,havoc,2,1,1
Ìllídán,ravencrest,31,demonhunter,havoc,2,1,1
Brawngodx,draenor,16,demonhunter,havoc,1,1,0
Herzbann,madmortem,16,demonhunter,havoc,1,1,0
Vengeancezin,frostwhisper,1736,demonhunter,vengeance,48,23,25
Zarín,outland,765,demonhunter,vengeance,18,8,10
Jedidiah,aggra-português,336,demonhunter,vengeance,9,4,5
Сумърак,grom,192,demonhunter,vengeance,12,2,10
Zarafel,hyjal,95,demonhunter,vengeance,6,1,5
Hibibi,kazzak,2200,druid,restoration,81,47,34
Iloveher,ravencrest,2162,druid,restoration,130,71,59
Årt,ravencrest,2153,druid,restoration,120,65,55
Trèes,outland,2107,druid,restoration,95,59,36
Pegasu,kelthuzad,2105,druid,restoration,78,45,33
Nesedondon,stormscale,2101,druid,restoration,60,44,16
Kev,elune,2017,druid,restoration,131,65,66
Lunamimi,argent-dawn,1990,druid,restoration,212,114,98
Thotz,kazzak,1960,druid,restoration,60,31,29
Rives,sylvanas,1947,druid,restoration,60,36,24
Sheippi,stormreaver,1945,druid,restoration,54,31,23
Nastycat,magtheridon,1932,druid,restoration,90,47,43
Hånukkah,outland,1911,druid,restoration,58,29,29
Afky,stormreaver,1886,druid,restoration,60,34,26
Maxpojke,ravencrest,1876,druid,restoration,142,88,54
Ralaa,guldan,1865,druid,restoration,54,29,25
Promethezine,tarren-mill,1862,druid,restoration,93,54,39
Druidrak,eredar,1855,druid,restoration,66,32,34
Yoogy,ravencrest,1852,druid,restoration,48,30,18
Thysabtw,archimonde,1850,druid,restoration,47,30,17
Angrykejton,silvermoon,1844,druid,restoration,97,46,51
Thebiggest,ravencrest,1836,druid,restoration,42,25,17
Jmdr,silvermoon,1830,druid,restoration,71,31,40
Spamclone,draenor,1828,druid,restoration,57,30,27
Køngx,blackhand,1827,druid,restoration,65,33,32
Dendariottvx,sunstrider,1825,druid,restoration,43,25,18
Gummysnake,aszune,1823,druid,restoration,42,25,17
Doodlez,blackrock,1820,druid,restoration,60,27,33
Wraithshape,stormscale,1800,druid,restoration,60,32,28
Lalalime,arthas,1799,druid,restoration,59,26,33
Hizzy,burning-legion,1794,druid,restoration,125,63,62
Дикаякиара,blackscar,1775,druid,restoration,83,38,45
Threesixnìne,dun-morogh,1774,druid,restoration,42,23,19
Heçtôr,silvermoon,1767,druid,restoration,60,27,33
Arthéas,archimonde,1763,druid,restoration,102,49,53
Theatrex,ravencrest,1755,druid,restoration,93,54,39
Clone,aegwynn,1752,druid,restoration,36,21,15
Matteps,outland,1742,druid,restoration,41,19,22
Luhmanish,thunderhorn,1740,druid,restoration,66,36,30
Улдрэйн,deathguard,1739,druid,restoration,66,38,28
Lifelover,outland,1734,druid,restoration,48,23,25
Tedel,kazzak,1728,druid,restoration,47,28,19
Moondra,outland,1716,druid,restoration,65,26,39
Wéédmâñ,ravencrest,1715,druid,restoration,31,21,10
Bambambimbim,draenor,1715,druid,restoration,36,18,18
Alolexx,archimonde,1711,druid,restoration,30,18,12
Skrrlock,ravencrest,1706,druid,restoration,42,18,24
Moonbee,burning-blade,1704,druid,restoration,42,28,14
Asaj,argent-dawn,1696,druid,restoration,42,29,13
Eviscreator,stormscale,1683,druid,restoration,42,27,15
Филавтия,gordunni,1674,druid,restoration,36,18,18
Khunahype,thrall,1673,druid,restoration,47,26,21
Gøðførm,silvermoon,1673,druid,restoration,102,51,51
Jìnró,ravencrest,1667,druid,restoration,117,56,61
Builtdiffy,kazzak,1657,druid,restoration,48,29,19
Jcpenney,xavius,1657,druid,restoration,45,26,19
Metagrass,stormscale,1650,druid,restoration,60,23,37
Chacopic,archimonde,1646,druid,restoration,48,20,28
Olaphy,elune,1645,druid,restoration,72,36,36
Чухх,howling-fjord,1636,druid,restoration,52,29,23
Diolives,stormscale,1630,druid,restoration,60,34,26
Friedbrocolí,tarren-mill,1629,druid,restoration,30,17,13
Asga,stormscale,1628,druid,restoration,30,17,13
Frances,auchindoun,1622,druid,restoration,51,30,21
Миледистайпи,gordunni,1619,druid,restoration,32,18,14
Goldrax,outland,1615,druid,restoration,24,17,7
Slaugh,zuljin,1608,druid,restoration,48,20,28
Опапенелопа,blackscar,1607,druid,restoration,39,27,12
Ðarckness,kazzak,1600,druid,restoration,24,17,7
Swifte,argent-dawn,1600,druid,restoration,48,27,21
Mortalnight,sinstralis,1600,druid,restoration,152,77,75
Akmón,tarren-mill,1600,druid,restoration,58,20,38
Buffbloom,auchindoun,1589,druid,restoration,96,49,47
Feelstreeman,twisting-nether,1569,druid,restoration,60,36,24
Xoriauz,archimonde,1562,druid,restoration,66,29,37
Crïn,ravencrest,1553,druid,restoration,36,17,19
Kundz,dalaran,1550,druid,restoration,107,60,47
Bearform,blackhand,1548,druid,restoration,48,23,25
Ittei,korgall,1547,druid,restoration,30,18,12
Warami,eredar,1539,druid,restoration,36,19,17
Galadronìa,aegwynn,1532,druid,restoration,24,16,8
Tjxaxa,ravencrest,1532,druid,restoration,30,16,14
Naffelle,ysondre,1530,druid,restoration,30,16,14
Dwaokut,ravencrest,1514,druid,restoration,47,24,23
Arogane,outland,1512,druid,restoration,51,26,25
Брэвно,gordunni,1506,druid,restoration,78,47,31
Kicki,outland,1494,druid,restoration,66,34,32
Atôtheex,kazzak,1488,druid,restoration,43,21,22
Shufflê,blackmoore,1482,druid,restoration,42,20,22
Ына,gordunni,1481,druid,restoration,75,37,38
Lukass,drakthul,1478,druid,restoration,24,16,8
Zaerox,ambossar,1474,druid,restoration,48,23,25
Plàntz,tarren-mill,1464,druid,restoration,42,23,19
Drbse,silvermoon,1461,druid,restoration,56,28,28
Spliçe,draenor,1458,druid,restoration,42,21,21
Scorlok,eredar,1455,druid,restoration,44,25,19
Flum,darksorrow,1443,druid,restoration,84,45,39
Xyruden,kazzak,1441,druid,restoration,171,69,102
Блумха,howling-fjord,1435,druid,restoration,66,34,32
Cörelly,ravencrest,1423,druid,restoration,133,84,49
Setztes,tarren-mill,1399,druid,restoration,28,16,12
Kooglaash,kazzak,1395,druid,restoration,54,25,29
Ивантяй,gordunni,1369,druid,restoration,65,32,33
Balanc,ragnaros,1366,druid,restoration,30,16,14
Zwierzyniec,jaedenar,1357,druid,restoration,60,27,33
Delmond,sylvanas,1356,druid,restoration,93,49,44
Sandirion,silvermoon,1353,druid,restoration,271,130,141
Ghaara,outland,1348,druid,restoration,34,19,15
Vanostboom,kazzak,1343,druid,restoration,24,14,10
Shifthappénz,draenor,1334,druid,restoration,60,28,32
Друлёнышь,eversong,1331,druid,restoration,66,33,33
Làhen,ravencrest,1330,druid,restoration,36,15,21
Mchots,ragnaros,1326,druid,restoration,71,33,38
Scaleo,stormreaver,1324,druid,restoration,30,20,10
Knzm,dun-modr,1323,druid,restoration,120,62,58
Yenwe,kazzak,1322,druid,restoration,36,20,16
Koemarkt,sunstrider,1319,druid,restoration,42,27,15
Крайсонг,soulflayer,1316,druid,restoration,36,18,18
Mangy,xavius,1309,druid,restoration,60,30,30
Bägira,sylvanas,1305,druid,restoration,47,24,23
Bigßoi,stormscale,1300,druid,restoration,54,26,28
Shelby,tirion,1298,druid,restoration,42,22,20
Callìa,sylvanas,1294,druid,restoration,36,18,18
Kittý,terokkar,1294,druid,restoration,87,36,51
Pardus,ambossar,1293,druid,restoration,32,15,17
Ekologiskxx,outland,1292,druid,restoration,73,34,39
Cuxorb,rexxar,1291,druid,restoration,36,17,19
Leliaen,sylvanas,1290,druid,restoration,24,14,10
Feinberg,stormscale,1286,druid,restoration,42,14,28
Seikoo,defias-brotherhood,1284,druid,restoration,91,41,50
Tôrmêñtêd,outland,1277,druid,restoration,24,14,10
Zaratras,arathor,1276,druid,restoration,44,22,22
Pureballs,twisting-nether,1275,druid,restoration,69,36,33
Киберужас,gordunni,1267,druid,restoration,81,38,43
Nalreaa,kazzak,1265,druid,restoration,48,27,21
Рефикс,gordunni,1252,druid,restoration,73,47,26
Weregoon,blackmoore,1251,druid,restoration,84,39,45
Chas,ravencrest,1247,druid,restoration,24,13,11
Deltsur,stormscale,1247,druid,restoration,35,17,18
Sorryblya,ravencrest,1246,druid,restoration,30,13,17
Andr,voljin,1245,druid,restoration,36,13,23
Zydrux,outland,1242,druid,restoration,18,13,5
Ilyethea,earthen-ring,1242,druid,restoration,131,71,60
ßløøm,outland,1236,druid,restoration,24,16,8
Chinoiserie,aszune,1231,druid,restoration,72,39,33
Idect,silvermoon,1230,druid,restoration,48,24,24
Sgtdrood,archimonde,1223,druid,restoration,30,13,17
Dreaddot,archimonde,1210,druid,restoration,24,13,11
Delarion,nemesis,1209,druid,restoration,30,16,14
Autoritär,gilneas,1209,druid,restoration,49,26,23
Räysa,archimonde,1204,druid,restoration,103,56,47
Namenloser,azshara,1200,druid,restoration,72,39,33
Bynxx,antonidas,1200,druid,restoration,35,17,18
Dokixo,kazzak,1199,druid,restoration,23,13,10
Обейрин,gordunni,1188,druid,restoration,54,25,29
Сваткумбрат,eversong,1182,druid,restoration,72,26,46
Dadud,twisting-nether,1181,druid,restoration,24,17,7
Halleyz,hyjal,1177,druid,restoration,72,39,33
Mochiløxz,tarren-mill,1155,druid,restoration,24,13,11
Mitnik,stormscale,1151,druid,restoration,47,29,18
Mentallyill,ravencrest,1151,druid,restoration,24,12,12
Dreathqt,twisting-nether,1150,druid,restoration,24,12,12
Olympïee,archimonde,1147,druid,restoration,24,12,12
Elmáestró,aegwynn,1146,druid,restoration,24,12,12
Hílarío,sanguino,1146,druid,restoration,36,12,24
Floka,archimonde,1145,druid,restoration,18,12,6
Dobbmaster,aegwynn,1143,druid,restoration,179,87,92
Fettpumpad,karazhan,1141,druid,restoration,79,43,36
Walenok,thrall,1141,druid,restoration,66,34,32
Катяблум,gordunni,1139,druid,restoration,30,12,18
Кнесис,howling-fjord,1138,druid,restoration,19,13,6
Arfedan,kazzak,1136,druid,restoration,42,24,18
Inkeyes,outland,1134,druid,restoration,53,19,34
Walexx,kazzak,1130,druid,restoration,26,14,12
Cäsïo,khaz-modan,1114,druid,restoration,30,18,12
Midnightstry,alakir,1109,druid,restoration,30,16,14
Zirkuszwei,aegwynn,1102,druid,restoration,29,14,15
Snowrk,hyjal,1101,druid,restoration,30,19,11
Hólo,blackrock,1097,druid,restoration,29,14,15
Elanrya,argent-dawn,1093,druid,restoration,48,14,34
Омгдру,gordunni,1089,druid,restoration,75,35,40
Demerit,aegwynn,1087,druid,restoration,20,12,8
Relache,twisting-nether,1086,druid,restoration,42,23,19
Ndnd,drakthul,1085,druid,restoration,56,29,27
Mendozä,stormscale,1082,druid,restoration,36,18,18
Qjkuug,twisting-nether,1081,druid,restoration,17,12,5
Cazzette,grim-batol,1073,druid,restoration,24,13,11
Hypnosoad,outland,1062,druid,restoration,76,31,45
Sprøut,drakthul,1056,druid,restoration,24,11,13
Trèes,draenor,1056,druid,restoration,24,11,13
Хлайси,gordunni,1056,druid,restoration,24,11,13
Weisslogia,aegwynn,1055,druid,restoration,18,11,7
Evílz,kazzak,1055,druid,restoration,18,11,7
Nasgra,malganis,1055,druid,restoration,24,11,13
Deluron,malganis,1053,druid,restoration,18,11,7
Analmonstret,shattered-hand,1053,druid,restoration,18,11,7
Вексиус,gordunni,1053,druid,restoration,18,11,7
Рамзес,gordunni,1052,druid,restoration,18,11,7
Luarbak,kazzak,1041,druid,restoration,18,11,7
Vícvega,ravencrest,1038,druid,restoration,18,11,7
Maryjuanita,silvermoon,1024,druid,restoration,50,13,37
Shanikya,argent-dawn,1021,druid,restoration,44,20,24
Niknoom,azjolnerub,1020,druid,restoration,30,18,12
Tângo,eredar,1019,druid,restoration,25,12,13
Thélon,antonidas,1015,druid,restoration,33,21,12
Sertris,kazzak,1015,druid,restoration,31,11,20
Raysa,archimonde,1011,druid,restoration,36,13,23
Saimdude,blackrock,1001,druid,restoration,24,11,13
Johndru,kazzak,991,druid,restoration,47,16,31
Spidete,sanguino,986,druid,restoration,30,15,15
Robutt,runetotem,976,druid,restoration,22,12,10
Nimèl,argent-dawn,966,druid,restoration,36,16,20
Wegian,sylvanas,962,druid,restoration,63,36,27
Bëstwôrld,archimonde,960,druid,restoration,18,10,8
Джелони,soulflayer,960,druid,restoration,18,10,8
Amaré,burning-legion,960,druid,restoration,24,10,14
Rozi,draenor,959,druid,restoration,12,10,2
Sélia,sylvanas,959,druid,restoration,24,10,14
Bellhooks,blackrock,958,druid,restoration,18,10,8
Styleexd,ragnaros,955,druid,restoration,18,10,8
Inspiredrood,archimonde,954,druid,restoration,30,18,12
Feanthur,drakthul,954,druid,restoration,82,44,38
Ubbeleg,kazzak,950,druid,restoration,18,10,8
Дилайт,blackscar,950,druid,restoration,24,10,14
Zarlaac,ravencrest,947,druid,restoration,18,10,8
Cigamt,kazzak,943,druid,restoration,12,10,2
Spoco,defias-brotherhood,938,druid,restoration,42,22,20
Eko,auchindoun,930,druid,restoration,30,10,20
Maldrýn,stormscale,927,druid,restoration,17,10,7
Macanbre,tarren-mill,925,druid,restoration,24,13,11
Missfar,doomhammer,923,druid,restoration,36,13,23
Shokazu,blackmoore,917,druid,restoration,46,20,26
Chainbrake,sylvanas,911,druid,restoration,17,10,7
Akifumi,archimonde,903,druid,restoration,35,11,24
Jambonmaster,archimonde,899,druid,restoration,24,12,12
Алунар,lich-king,878,druid,restoration,24,10,14
Simouch,archimonde,870,druid,restoration,42,18,24
Shinöbü,sanguino,864,druid,restoration,12,9,3
Uñsullied,kazzak,864,druid,restoration,12,9,3
Kyomã,burning-legion,864,druid,restoration,18,9,9
Praetorian,sylvanas,864,druid,restoration,24,9,15
Haszard,outland,863,druid,restoration,18,9,9
Jikuni,ravencrest,862,druid,restoration,18,9,9
Nyxxz,shattered-hand,862,druid,restoration,18,9,9
Moonfetamine,silvermoon,861,druid,restoration,24,9,15
Thardruid,stormscale,860,druid,restoration,18,9,9
Kárél,drakthul,859,druid,restoration,18,10,8
Krollix,dun-morogh,859,druid,restoration,35,17,18
Amakary,blackrock,855,druid,restoration,24,9,15
Relxc,outland,854,druid,restoration,12,9,3
Chujogrzmot,kazzak,843,druid,restoration,23,9,14
Diastra,silvermoon,837,druid,restoration,19,10,9
Triplej,twisting-nether,836,druid,restoration,18,9,9
Фэйблуд,blackscar,830,druid,restoration,24,10,14
Найтед,gordunni,828,druid,restoration,16,10,6
Metaboss,ravencrest,817,druid,restoration,71,24,47
Ninadobrev,ragnaros,816,druid,restoration,15,10,5
Lyndruid,sylvanas,804,druid,restoration,42,16,26
Бехеровка,grom,784,druid,restoration,28,11,17
Sintiq,silvermoon,783,druid,restoration,11,9,2
Gaeldeth,silvermoon,768,druid,restoration,12,8,4
Rînaa,ravencrest,768,druid,restoration,12,8,4
Dablol,draenor,768,druid,restoration,12,8,4
Hotlotta,aegwynn,768,druid,restoration,12,8,4
Wømbat,ravencrest,768,druid,restoration,12,8,4
Kajiun,silvermoon,767,druid,restoration,12,8,4
Noxlunaire,ravencrest,766,druid,restoration,18,8,10
Thieane,blackhand,765,druid,restoration,12,8,4
Khalec,silvermoon,765,druid,restoration,12,8,4
Jehtrotull,nemesis,765,druid,restoration,14,8,6
Crydotcom,aegwynn,765,druid,restoration,18,8,10
Memento,kazzak,765,druid,restoration,18,8,10
Crep,krasus,762,druid,restoration,12,8,4
Liquis,outland,761,druid,restoration,18,8,10
Hootymactoot,magtheridon,752,druid,restoration,12,8,4
Hopê,burning-legion,751,druid,restoration,12,8,4
Frostfox,ghostlands,741,druid,restoration,22,9,13
Bidodici,nemesis,729,druid,restoration,123,51,72
Лордсенка,eversong,721,druid,restoration,18,8,10
Paawz,stormscale,702,druid,restoration,16,8,8
Урька,blackscar,700,druid,restoration,29,9,20
Ruap,blackmoore,690,druid,restoration,14,8,6
Buufu,kazzak,686,druid,restoration,13,8,5
Магараганага,azuregos,675,druid,restoration,25,8,17
Plsbuffdruid,ravencrest,672,druid,restoration,12,7,5
Mafiasnipe,ravencrest,672,druid,restoration,12,7,5
Dortalon,outland,672,druid,restoration,12,7,5
Hasselhoof,eredar,672,druid,restoration,12,7,5
Хуссипусси,galakrond,672,druid,restoration,18,7,11
Kanyevotèrx,ravencrest,672,druid,restoration,18,7,11
Miouzy,archimonde,672,druid,restoration,18,7,11
Стомпбр,gordunni,672,druid,restoration,24,7,17
Wenciorek,kazzak,671,druid,restoration,12,7,5
Dablolo,ravencrest,671,druid,restoration,12,7,5
Darktigrou,archimonde,671,druid,restoration,12,7,5
Zkasnoname,archimonde,671,druid,restoration,18,7,11
Dafapa,twilights-hammer,671,druid,restoration,18,7,11
Шеданна,gordunni,671,druid,restoration,24,7,17
Soný,aegwynn,670,druid,restoration,18,7,11
Тчаёк,gordunni,668,druid,restoration,16,8,8
Thaeldres,argent-dawn,667,druid,restoration,18,7,11
Nøkki,draenor,667,druid,restoration,18,7,11
Shenandoah,hyjal,666,druid,restoration,12,7,5
Gribix,kazzak,666,druid,restoration,12,7,5
Bazilika,argent-dawn,661,druid,restoration,12,7,5
Nasduck,ravencrest,640,druid,restoration,10,8,2
Foaqi,aegwynn,639,druid,restoration,16,7,9
Asanaria,ravencrest,639,druid,restoration,20,8,12
Kùrámágødx,ravencrest,624,druid,restoration,17,7,10
Zerschmatzen,aegwynn,610,druid,restoration,28,9,19
Атмос,deathguard,607,druid,restoration,8,7,1
Heavysmoker,emeriss,607,druid,restoration,11,7,4
Medreas,argent-dawn,594,druid,restoration,16,7,9
Justforgames,ravencrest,576,druid,restoration,6,6,0
Bakicadr,sylvanas,576,druid,restoration,6,6,0
Draxedin,kazzak,576,druid,restoration,6,6,0
Oschlandor,blackmoore,576,druid,restoration,6,6,0
Lorucka,die-nachtwache,576,druid,restoration,12,6,6
Doodougie,silvermoon,576,druid,restoration,12,6,6
Jhiun,ragnaros,576,druid,restoration,12,6,6
Сладуляя,gordunni,576,druid,restoration,12,6,6
Foxyfeet,outland,576,druid,restoration,12,6,6
Sálty,aegwynn,576,druid,restoration,12,6,6
Cyriaan,eredar,576,druid,restoration,12,6,6
Skadooshee,kazzak,576,druid,restoration,12,6,6
Rhonir,twisting-nether,576,druid,restoration,12,6,6
Acxaryl,ravencrest,576,druid,restoration,12,6,6
Shredzz,ravencrest,576,druid,restoration,12,6,6
Pölkky,argent-dawn,576,druid,restoration,18,6,12
Neverpanic,stormscale,576,druid,restoration,18,6,12
Tjillevippen,tarren-mill,576,druid,restoration,18,6,12
Велаине,soulflayer,575,druid,restoration,12,6,6
Ekaterina,dun-morogh,575,druid,restoration,12,6,6
Scarrymonsta,outland,575,druid,restoration,12,6,6
Shylanna,ragnaros,575,druid,restoration,12,6,6
Avilary,tarren-mill,575,druid,restoration,18,6,12
Pouletqt,archimonde,575,druid,restoration,18,6,12
Storfjåset,stormscale,575,druid,restoration,18,6,12
Mascraxx,earthen-ring,575,druid,restoration,18,6,12
Spritzer,tarren-mill,574,druid,restoration,12,6,6
Mcneil,wrathbringer,574,druid,restoration,12,6,6
Doovex,ragnaros,574,druid,restoration,18,6,12
Зервес,gordunni,574,druid,restoration,24,6,18
Лаегмерил,gordunni,573,druid,restoration,10,7,3
Dfjguidfg,baelgun,573,druid,restoration,18,6,12
Ragdru,twisting-nether,573,druid,restoration,24,6,18
Druiddamage,the-maelstrom,571,druid,restoration,12,6,6
Malandrin,khazgoroth,568,druid,restoration,18,6,12
Vlookup,tarren-mill,543,druid,restoration,17,6,11
Уэсериктх,blackscar,528,druid,restoration,9,6,3
Feedbark,stormscale,522,druid,restoration,17,8,9
Funnyjoker,outland,480,druid,restoration,6,5,1
Niksidruid,grim-batol,480,druid,restoration,6,5,1
Мегабамбук,soulflayer,480,druid,restoration,6,5,1
Místergreen,ravencrest,480,druid,restoration,12,5,7
Halyconwings,outland,480,druid,restoration,12,5,7
Shiftway,stormscale,480,druid,restoration,12,5,7
Asude,outland,480,druid,restoration,12,5,7
Мафио,blackscar,480,druid,restoration,12,5,7
Druidicchi,stormscale,480,druid,restoration,12,5,7
Kvalitet,outland,480,druid,restoration,12,5,7
Epicskin,kazzak,480,druid,restoration,12,5,7
Greengolly,argent-dawn,480,druid,restoration,12,5,7
Watchmebear,stormscale,480,druid,restoration,12,5,7
Loleh,ragnaros,480,druid,restoration,12,5,7
Nightmoon,hellscream,480,druid,restoration,12,5,7
Yseraheal,drakthul,480,druid,restoration,18,5,13
Skillfall,ravencrest,480,druid,restoration,18,5,13
Dirtyhacks,blackmoore,479,druid,restoration,6,5,1
Jagu,blackrock,479,druid,restoration,6,5,1
Weiden,twisting-nether,479,druid,restoration,6,5,1
Bhorumir,colinas-pardas,479,druid,restoration,12,5,7
Nissemand,ravencrest,479,druid,restoration,12,5,7
Ballosh,hyjal,479,druid,restoration,12,5,7
Quiksx,blackrock,479,druid,restoration,13,5,8
Whiskers,emerald-dream,479,druid,restoration,16,6,10
Hubek,silvermoon,478,druid,restoration,6,5,1
Jimmorris,eredar,477,druid,restoration,12,5,7
Mandy,spinebreaker,477,druid,restoration,12,5,7
Bearinator,aggramar,477,druid,restoration,12,5,7
Raysien,doomhammer,476,druid,restoration,12,5,7
Sýrês,malganis,475,druid,restoration,12,5,7
Hashtagone,ysondre,463,druid,restoration,17,5,12
Lutzmiller,eredar,453,druid,restoration,31,10,21
Druidicmorr,sylvanas,447,druid,restoration,10,5,5
Joksica,draenor,447,druid,restoration,11,5,6
Skilloxus,gilneas,426,druid,restoration,21,6,15
Guccicken,garona,425,druid,restoration,16,7,9
Ráw,dun-modr,400,druid,restoration,13,5,8
Bartoluca,twisting-nether,393,druid,restoration,28,6,22
Lfsecondreju,ravencrest,384,druid,restoration,6,4,2
Stinka,ravencrest,384,druid,restoration,6,4,2
Bloomies,tarren-mill,384,druid,restoration,6,4,2
Chable,hyjal,384,druid,restoration,6,4,2
Нагетсмяу,howling-fjord,384,druid,restoration,6,4,2
Maiverdr,ravencrest,384,druid,restoration,6,4,2
Zagrem,antonidas,384,druid,restoration,6,4,2
Naruhot,archimonde,384,druid,restoration,6,4,2
Leyô,archimonde,384,druid,restoration,6,4,2
Sinthorasia,blackrock,384,druid,restoration,6,4,2
Yandris,argent-dawn,384,druid,restoration,6,4,2
Greenberry,eonar,384,druid,restoration,6,4,2
Bâneth,destromath,384,druid,restoration,6,4,2
Kyssope,chants-éternels,384,druid,restoration,6,4,2
Monatamis,kazzak,384,druid,restoration,6,4,2
Naphé,ysondre,384,druid,restoration,6,4,2
Zonsy,twisting-nether,384,druid,restoration,6,4,2
Alexialol,silvermoon,384,druid,restoration,6,4,2
Zeroclones,the-maelstrom,384,druid,restoration,6,4,2
Eyvimel,ravencrest,384,druid,restoration,6,4,2
Kaamirach,blackmoore,384,druid,restoration,6,4,2
Jellyxdd,silvermoon,384,druid,restoration,6,4,2
Xandersito,sanguino,384,druid,restoration,6,4,2
Lucael,blackmoore,384,druid,restoration,12,4,8
Celtimi,antonidas,384,druid,restoration,12,4,8
Crìmz,aszune,384,druid,restoration,12,4,8
Ravenfel,argent-dawn,384,druid,restoration,12,4,8
Neverfall,aegwynn,384,druid,restoration,12,4,8
Eaglefox,aszune,384,druid,restoration,12,4,8
Deretus,blackmoore,384,druid,restoration,12,4,8
Nozome,draenor,384,druid,restoration,12,4,8
Muraebbasta,pozzo-delleternità,384,druid,restoration,12,4,8
Lyvuni,blackmoore,384,druid,restoration,12,4,8
Biglet,tarren-mill,384,druid,restoration,12,4,8
Hrz,kazzak,384,druid,restoration,18,4,14
Jabbah,defias-brotherhood,383,druid,restoration,6,4,2
Irondruid,silvermoon,383,druid,restoration,6,4,2
Nargaí,kargath,383,druid,restoration,6,4,2
Прожималодру,deathguard,383,druid,restoration,12,4,8
Mimisiek,burning-legion,383,druid,restoration,12,4,8
Шикалат,howling-fjord,383,druid,restoration,24,4,20
Pega,nazjatar,382,druid,restoration,12,4,8
Roséa,ravencrest,382,druid,restoration,12,4,8
Борзойрог,soulflayer,382,druid,restoration,12,4,8
Amalou,ravencrest,381,druid,restoration,12,4,8
Tranquillo,outland,379,druid,restoration,12,4,8
Pudseytree,doomhammer,379,druid,restoration,12,4,8
Blolzz,silvermoon,377,druid,restoration,18,4,14
Nøbødy,silvermoon,351,druid,restoration,11,4,7
Biegel,ysera,351,druid,restoration,11,4,7
Vaacku,stormreaver,288,druid,restoration,6,3,3
Jebaitor,tarren-mill,288,druid,restoration,6,3,3
Zhosy,shattrath,288,druid,restoration,6,3,3
Murlwywy,blackmoore,288,druid,restoration,6,3,3
Brosephiné,stormscale,288,druid,restoration,6,3,3
Davorian,frostmane,288,druid,restoration,6,3,3
Nohos,blackrock,288,druid,restoration,6,3,3
Bloomitize,ravencrest,288,druid,restoration,6,3,3
Lucidor,frostmane,288,druid,restoration,6,3,3
Rabacki,blackmoore,288,druid,restoration,6,3,3
Vashiko,tarren-mill,288,druid,restoration,6,3,3
Druni,blackrock,288,druid,restoration,6,3,3
Clownrad,tarren-mill,288,druid,restoration,6,3,3
Magiskeforme,draenor,288,druid,restoration,6,3,3
Derie,nazjatar,288,druid,restoration,6,3,3
Stevedru,ravencrest,288,druid,restoration,6,3,3
Wurzeldor,ravencrest,288,druid,restoration,6,3,3
Kokanine,ravencrest,288,druid,restoration,6,3,3
Ipsdray,ysondre,288,druid,restoration,6,3,3
Milknosugar,tarren-mill,288,druid,restoration,6,3,3
Танганэку,howling-fjord,288,druid,restoration,6,3,3
Semiflora,silvermoon,288,druid,restoration,6,3,3
Tamburoo,tarren-mill,288,druid,restoration,6,3,3
Martinesämst,outland,288,druid,restoration,6,3,3
Moonbloom,defias-brotherhood,288,druid,restoration,6,3,3
Tarshish,outland,288,druid,restoration,6,3,3
Norkenis,neptulon,288,druid,restoration,6,3,3
Felisin,ravencrest,288,druid,restoration,6,3,3
Shyni,outland,288,druid,restoration,6,3,3
Mindru,sylvanas,288,druid,restoration,6,3,3
Ceapamatii,sylvanas,288,druid,restoration,6,3,3
Surfingbirdx,ragnaros,288,druid,restoration,6,3,3
Aesha,los-errantes,288,druid,restoration,6,3,3
Корнерит,gordunni,288,druid,restoration,6,3,3
Тое,soulflayer,288,druid,restoration,6,3,3
Фонш,soulflayer,288,druid,restoration,6,3,3
Mnine,twisting-nether,288,druid,restoration,6,3,3
Rumbus,sanguino,288,druid,restoration,7,3,4
Piñaclonada,archimonde,288,druid,restoration,9,3,6
Draawun,burning-legion,288,druid,restoration,11,3,8
Rawillinen,kazzak,288,druid,restoration,12,3,9
Ванечка,razuvious,288,druid,restoration,12,3,9
Teah,darkmoon-faire,288,druid,restoration,12,3,9
Restodruidx,ravencrest,288,druid,restoration,12,3,9
Shiotake,hyjal,288,druid,restoration,12,3,9
Храмульчик,blackscar,288,druid,restoration,12,3,9
Telaroxx,die-nachtwache,288,druid,restoration,12,3,9
Cárnagè,stormscale,288,druid,restoration,12,3,9
Areidhel,pozzo-delleternità,288,druid,restoration,12,3,9
Yøungreidzz,blackrock,288,druid,restoration,18,3,15
Djclonex,archimonde,287,druid,restoration,6,3,3
Krizak,eredar,287,druid,restoration,6,3,3
Fubarmeep,outland,287,druid,restoration,6,3,3
Taskingoman,twisting-nether,287,druid,restoration,6,3,3
Paniel,amanthul,286,druid,restoration,6,3,3
Robeala,twisting-nether,286,druid,restoration,6,3,3
Elônea,antonidas,285,druid,restoration,12,3,9
Siahra,khaz-modan,283,druid,restoration,36,3,33
Lexopewpew,ravencrest,256,druid,restoration,16,3,13
Duduque,twisting-nether,255,druid,restoration,11,3,8
Quorn,pozzo-delleternità,240,druid,restoration,7,4,3
Amélor,ragnaros,239,druid,restoration,5,3,2
Thornat,chamber-of-aspects,239,druid,restoration,5,3,2
Mayte,ragnaros,239,druid,restoration,5,3,2
Jnzymiau,blackrock,192,druid,restoration,4,3,1
Corias,blackmoore,192,druid,restoration,6,2,4
Noxann,archimonde,192,druid,restoration,6,2,4
Moodee,kazzak,192,druid,restoration,6,2,4
Príimé,kazzak,192,druid,restoration,6,2,4
Holybarkz,aegwynn,192,druid,restoration,6,2,4
Benjiee,kazzak,192,druid,restoration,6,2,4
Chrisdruid,argent-dawn,192,druid,restoration,6,2,4
Vinniehacker,archimonde,192,druid,restoration,6,2,4
Xidenn,quelthalas,192,druid,restoration,6,2,4
Josedudu,twisting-nether,192,druid,restoration,6,2,4
Mchøt,ravencrest,192,druid,restoration,6,2,4
Plantpuzzl,silvermoon,192,druid,restoration,6,2,4
Pinkpanda,arthas,192,druid,restoration,6,2,4
Nooz,thrall,192,druid,restoration,6,2,4
Шокоокулист,gordunni,192,druid,restoration,6,2,4
Fanso,burning-legion,192,druid,restoration,6,2,4
Huebbi,blackmoore,192,druid,restoration,6,2,4
Kkona,silvermoon,192,druid,restoration,6,2,4
Yesco,malganis,192,druid,restoration,6,2,4
Bigbones,frostwolf,192,druid,restoration,6,2,4
Vertabrain,twilights-hammer,192,druid,restoration,12,2,10
Xenva,blackmoore,192,druid,restoration,12,2,10
Салона,deathguard,192,druid,restoration,12,2,10
Prowlinger,silvermoon,191,druid,restoration,6,2,4
Дела,eversong,191,druid,restoration,6,2,4
Allod,stormscale,168,druid,restoration,11,4,7
Didi,frostwhisper,138,druid,restoration,6,3,3
Xneji,sylvanas,111,druid,restoration,13,2,11
Haginator,twisting-nether,96,druid,restoration,6,1,5
Uuni,sylvanas,96,druid,restoration,6,1,5
Вакидзами,gordunni,96,druid,restoration,6,1,5
Lisovamavka,draenor,96,druid,restoration,6,1,5
Gintoni,dun-modr,96,druid,restoration,6,1,5
Secô,sylvanas,96,druid,restoration,6,1,5
Kerydwen,silvermoon,96,druid,restoration,6,1,5
Sozu,magtheridon,96,druid,restoration,6,1,5
Nuggetspøwa,dalaran,96,druid,restoration,6,1,5
Druvian,argent-dawn,96,druid,restoration,6,1,5
Asklepion,twisting-nether,96,druid,restoration,6,1,5
Qdrood,quelthalas,96,druid,restoration,6,1,5
Druidguden,tarren-mill,96,druid,restoration,6,1,5
Мунпраид,gordunni,96,druid,restoration,6,1,5
Fotmrerollér,darksorrow,96,druid,restoration,6,1,5
Effi,aggramar,96,druid,restoration,6,1,5
Thaïs,blackmoore,96,druid,restoration,6,1,5
Happyhoter,blackrock,96,druid,restoration,6,1,5
Seekíng,blackmoore,96,druid,restoration,6,1,5
Nediena,twisting-nether,96,druid,restoration,6,1,5
Teengirl,blackmoore,96,druid,restoration,6,1,5
Muju,stormscale,96,druid,restoration,6,1,5
Tranduiil,drakthul,96,druid,restoration,6,1,5
Linkin,azshara,96,druid,restoration,6,1,5
Houwalia,archimonde,96,druid,restoration,12,1,11
Dreäms,ravencrest,95,druid,restoration,6,1,5
Pobrica,stormscale,79,druid,restoration,5,1,4
Сугрик,deathweaver,64,druid,restoration,10,1,9
Oyoyo,kaelthas,63,druid,restoration,2,2,0
Nancey,auchindoun,48,druid,restoration,3,1,2
Quizdarude,draenor,42,druid,restoration,10,3,7
Eceria,the-maelstrom,42,druid,restoration,9,2,7
Uniquz,sylvanas,42,druid,restoration,11,2,9
Djemdruid,argent-dawn,1585,druid,guardian,42,18,24
Windythemilf,stormscale,1215,druid,guardian,80,40,40
Rbgbear,blackhand,857,druid,guardian,18,9,9
Bulleyo,ysondre,719,druid,guardian,11,8,3
Микайо,goldrinn,573,druid,guardian,12,6,6
Critter,kargath,572,druid,guardian,12,6,6
Rapatera,argent-dawn,479,druid,guardian,12,5,7
Bigdomas,sylvanas,474,druid,guardian,12,5,7
Crazydudu,tarren-mill,393,druid,guardian,17,6,11
Tigerbear,argent-dawn,384,druid,guardian,12,4,8
Zinister,hyjal,192,druid,guardian,6,2,4
Twinklex,ravencrest,2224,druid,feral,86,45,41
Xercas,outland,2094,druid,feral,59,35,24
Desenlace,ravencrest,2063,druid,feral,101,56,45
Iminz,ravencrest,2053,druid,feral,78,37,41
Jakamx,ravencrest,2039,druid,feral,120,62,58
Lxve,tarren-mill,1999,druid,feral,60,31,29
Ktx,aegwynn,1963,druid,feral,60,35,25
Nøfåmïly,silvermoon,1954,druid,feral,66,41,25
Rapatera,argent-dawn,1952,druid,feral,42,24,18
Zøte,ravencrest,1952,druid,feral,60,33,27
Cløwnferalx,argent-dawn,1896,druid,feral,36,20,16
Норланда,gordunni,1884,druid,feral,60,32,28
Purgatxry,ravencrest,1860,druid,feral,123,59,64
Nîîght,ravencrest,1852,druid,feral,48,23,25
Tilikum,stormscale,1851,druid,feral,144,74,70
Djmeowxd,blackrock,1849,druid,feral,54,27,27
Minaervea,antonidas,1846,druid,feral,72,33,39
Houmrx,ravencrest,1830,druid,feral,36,23,13
Фейкхехе,gordunni,1822,druid,feral,48,27,21
Kroñm,dun-modr,1818,druid,feral,60,25,35
Nfxdruid,argent-dawn,1810,druid,feral,90,54,36
Dashfull,ravencrest,1807,druid,feral,55,31,24
Jarethy,dun-modr,1807,druid,feral,54,25,29
Jhiun,ragnaros,1806,druid,feral,72,40,32
Bigangrycatx,ravencrest,1803,druid,feral,62,26,36
Tomyn,burning-legion,1785,druid,feral,48,28,20
Dzandel,silvermoon,1773,druid,feral,144,72,72
Февти,gordunni,1762,druid,feral,53,29,24
Mykk,ravencrest,1755,druid,feral,39,27,12
Pilaf,emerald-dream,1743,druid,feral,69,32,37
Moldrokk,ravencrest,1739,druid,feral,52,31,21
Apuasaatana,stormreaver,1731,druid,feral,36,20,16
Trøüpäx,outland,1721,druid,feral,48,25,23
Ромкабикстар,gordunni,1721,druid,feral,36,18,18
Mutaattori,sylvanas,1720,druid,feral,37,18,19
Yesbody,tarren-mill,1718,druid,feral,36,18,18
Jabbari,outland,1711,druid,feral,48,27,21
Skytek,silvermoon,1706,druid,feral,48,21,27
Freyanah,argent-dawn,1701,druid,feral,66,27,39
Taladruide,archimonde,1696,druid,feral,36,20,16
Annksunamún,ysondre,1694,druid,feral,108,62,46
Goodtrip,archimonde,1686,druid,feral,50,26,24
Adabsurdum,kazzak,1683,druid,feral,65,26,39
Mabkferal,ravencrest,1681,druid,feral,38,22,16
Mortality,proudmoore,1679,druid,feral,53,23,30
Трэвисдог,gordunni,1673,druid,feral,35,18,17
Ðrüid,ravencrest,1668,druid,feral,66,31,35
Skypinho,blackhand,1656,druid,feral,42,21,21
Uebiwe,silvermoon,1654,druid,feral,42,22,20
Yongala,archimonde,1650,druid,feral,48,29,19
Bloodyredlyx,ysera,1647,druid,feral,36,21,15
Shiftydruid,thunderhorn,1647,druid,feral,83,34,49
Jgltrainer,archimonde,1635,druid,feral,41,24,17
Jukeboks,silvermoon,1633,druid,feral,43,20,23
Ñøpe,ravencrest,1630,druid,feral,30,17,13
Fyrkax,aegwynn,1626,druid,feral,30,17,13
Риама,blackscar,1615,druid,feral,60,31,29
Khunahype,thrall,1610,druid,feral,24,17,7
Bulan,ghostlands,1609,druid,feral,54,34,20
Banzeye,nordrassil,1607,druid,feral,68,35,33
Nouin,twisting-nether,1603,druid,feral,36,17,19
Unoseeme,outland,1603,druid,feral,36,17,19
Asçdruid,kazzak,1602,druid,feral,50,22,28
Evilshade,ravencrest,1599,druid,feral,77,28,49
Lukeyferalxo,argent-dawn,1567,druid,feral,60,33,27
Phenova,sargeras,1567,druid,feral,41,17,24
Màz,blackmoore,1545,druid,feral,62,27,35
Råñkønêbëår,ravencrest,1535,druid,feral,24,16,8
Муумуумуу,howling-fjord,1535,druid,feral,66,29,37
Drylle,argent-dawn,1534,druid,feral,57,31,26
Sÿlph,sylvanas,1505,druid,feral,48,29,19
Jerrybeans,ravencrest,1495,druid,feral,60,27,33
Зонкс,gordunni,1493,druid,feral,64,33,31
Oleander,zuljin,1479,druid,feral,113,56,57
Margueriti,the-maelstrom,1452,druid,feral,43,17,26
Arilíaxo,amanthul,1426,druid,feral,18,15,3
Phesxd,sylvanas,1425,druid,feral,42,21,21
Clipsy,twilights-hammer,1421,druid,feral,78,34,44
Vancis,ravencrest,1407,druid,feral,45,25,20
Cörelly,ravencrest,1405,druid,feral,30,17,13
Pipima,kazzak,1405,druid,feral,42,18,24
Eranor,archimonde,1399,druid,feral,72,33,39
Мелталиора,soulflayer,1396,druid,feral,35,15,20
Arlina,magtheridon,1379,druid,feral,51,20,31
Bernfried,silvermoon,1368,druid,feral,34,15,19
Ripgødx,outland,1367,druid,feral,65,35,30
Shaggery,stormscale,1337,druid,feral,51,22,29
Degentiuso,alakir,1336,druid,feral,53,29,24
Мунпраид,gordunni,1317,druid,feral,40,15,25
Балаклаваа,soulflayer,1316,druid,feral,29,18,11
Boomzter,frostmane,1308,druid,feral,31,14,17
Majokz,ravencrest,1307,druid,feral,44,23,21
Catkovic,kult-der-verdammten,1307,druid,feral,29,14,15
Regelè,sylvanas,1305,druid,feral,86,45,41
Оудин,blackscar,1255,druid,feral,23,14,9
Yaddas,draenor,1248,druid,feral,18,13,5
Twyty,khaz-modan,1248,druid,feral,46,21,25
Nalaa,festung-der-stürme,1243,druid,feral,60,23,37
Kyoshî,blackmoore,1241,druid,feral,50,30,20
Cleandc,blackhand,1234,druid,feral,34,20,14
Deviantdruid,tarren-mill,1231,druid,feral,39,20,19
Bâbusch,blackmoore,1230,druid,feral,24,13,11
Shymä,hyjal,1206,druid,feral,73,30,43
Stelthee,silvermoon,1198,druid,feral,45,17,28
Tussenfryd,draenor,1186,druid,feral,52,19,33
Shinshìva,twisting-nether,1162,druid,feral,76,41,35
Feraligator,sanguino,1157,druid,feral,56,25,31
Bigpapad,ravencrest,1152,druid,feral,24,12,12
Cocaqt,nemesis,1151,druid,feral,18,12,6
Zelaron,twisting-nether,1151,druid,feral,18,12,6
Kàraba,archimonde,1151,druid,feral,22,13,9
Zbear,kazzak,1151,druid,feral,36,16,20
Shyngodx,archimonde,1150,druid,feral,18,12,6
Hottad,tarren-mill,1150,druid,feral,36,18,18
Opresse,archimonde,1150,druid,feral,30,12,18
Webla,blackmoore,1149,druid,feral,23,13,10
Whísperclaw,ravencrest,1145,druid,feral,23,13,10
Mônchô,sanguino,1142,druid,feral,39,21,18
Texoria,twisting-nether,1141,druid,feral,30,12,18
Manoestouro,draenor,1128,druid,feral,36,12,24
Dirtyfantasy,alakir,1115,druid,feral,36,18,18
Bigdaddytate,kazzak,1100,druid,feral,23,12,11
Millenia,darkmoon-faire,1097,druid,feral,30,13,17
Skatch,sylvanas,1056,druid,feral,18,11,7
Yone,blackmoore,1056,druid,feral,24,11,13
Boostedbear,ragnaros,1056,druid,feral,24,11,13
Cåssidy,archimonde,1056,druid,feral,24,11,13
Elfsu,ravencrest,1055,druid,feral,18,11,7
Symbiosa,silvermoon,1055,druid,feral,18,11,7
Silksharp,ravencrest,1055,druid,feral,18,11,7
Liya,ravencrest,1054,druid,feral,30,11,19
Rami,sylvanas,1053,druid,feral,30,11,19
Tsajj,stormreaver,1052,druid,feral,27,16,11
Одряя,soulflayer,1050,druid,feral,18,11,7
Chirnaruk,ravencrest,1049,druid,feral,24,11,13
Panthéra,ravencrest,1047,druid,feral,30,11,19
Blazor,eredar,1038,druid,feral,16,12,4
Amoonaa,kazzak,1028,druid,feral,18,12,6
Swagmode,draenor,1016,druid,feral,31,17,14
Брэмблс,soulflayer,1008,druid,feral,35,15,20
Арбузег,gordunni,1004,druid,feral,23,11,12
Tsopúnisher,twisting-nether,990,druid,feral,28,13,15
Descendance,ysondre,972,druid,feral,18,11,7
Yøløswag,naxxramas,962,druid,feral,35,16,19
Degmond,silvermoon,960,druid,feral,18,10,8
Mcvøvà,kazzak,959,druid,feral,18,10,8
Rbgbot,ragnaros,959,druid,feral,18,10,8
Beerista,tarren-mill,959,druid,feral,24,11,13
Cyph,shadowsong,958,druid,feral,18,10,8
Nîchtsnutz,blackmoore,958,druid,feral,18,10,8
Donoz,ravencrest,956,druid,feral,12,10,2
Corrupthz,outland,955,druid,feral,24,10,14
ßußßo,ravencrest,947,druid,feral,12,10,2
Реептилоид,soulflayer,942,druid,feral,24,10,14
Janjalism,silvermoon,939,druid,feral,51,27,24
Druidicmorr,sylvanas,937,druid,feral,26,10,16
Kermit,die-aldor,937,druid,feral,39,10,29
Quikahn,outland,864,druid,feral,12,9,3
Sixmonthbann,ravencrest,864,druid,feral,18,9,9
Cocomojo,outland,864,druid,feral,18,9,9
Furrykruger,the-maelstrom,864,druid,feral,18,9,9
Котосапенс,howling-fjord,863,druid,feral,18,9,9
Narunis,tarren-mill,863,druid,feral,18,9,9
Triluxa,blackmoore,863,druid,feral,18,9,9
Avanah,silvermoon,863,druid,feral,24,9,15
Пиггипоп,soulflayer,863,druid,feral,24,9,15
Legitx,dentarg,863,druid,feral,27,10,17
Олежасутра,howling-fjord,863,druid,feral,30,9,21
Мунфайр,galakrond,862,druid,feral,18,9,9
Larryburns,nathrezim,862,druid,feral,18,9,9
Nalreaa,kazzak,859,druid,feral,18,9,9
Реалаг,howling-fjord,847,druid,feral,23,9,14
Snupy,outland,815,druid,feral,17,9,8
Reward,ragnaros,800,druid,feral,16,9,7
Йванныч,gordunni,793,druid,feral,26,9,17
Moonkniight,ravencrest,768,druid,feral,12,8,4
Stopwatching,outland,768,druid,feral,18,8,10
Zaibastus,doomhammer,768,druid,feral,18,8,10
Апвель,gordunni,768,druid,feral,18,8,10
Mimir,la-croisade-écarlate,767,druid,feral,12,8,4
Elitarian,argent-dawn,767,druid,feral,18,8,10
Seysso,silvermoon,767,druid,feral,18,8,10
Laek,chogall,767,druid,feral,24,8,16
Weedum,kazzak,766,druid,feral,18,8,10
Thielyy,blackmoore,766,druid,feral,18,8,10
Crow,saurfang,766,druid,feral,20,8,12
Liionheart,khaz-modan,762,druid,feral,18,8,10
Плагиат,grom,749,druid,feral,30,8,22
Kynji,twisting-nether,730,druid,feral,22,8,14
Cubswansón,outland,719,druid,feral,14,9,5
Cyriaan,eredar,719,druid,feral,17,8,9
Cheddar,tyrande,718,druid,feral,17,8,9
Kouda,draenor,704,druid,feral,16,8,8
Катяблум,gordunni,672,druid,feral,12,7,5
Nøkki,draenor,672,druid,feral,12,7,5
Zechey,stormreaver,672,druid,feral,12,7,5
Fíja,blackmoore,672,druid,feral,12,7,5
Crøwnd,twisting-nether,672,druid,feral,12,7,5
Фекаллис,soulflayer,672,druid,feral,12,7,5
Диздру,howling-fjord,672,druid,feral,12,7,5
Oni,kelthuzad,672,druid,feral,18,7,11
Mysticalmoon,ravencrest,672,druid,feral,18,7,11
Криашин,goldrinn,671,druid,feral,12,7,5
Sôalôgel,blackrock,671,druid,feral,12,7,5
Snapeshifter,blackhand,671,druid,feral,12,7,5
Тётявискас,howling-fjord,671,druid,feral,12,7,5
Kimpine,kirin-tor,671,druid,feral,15,8,7
Bærbell,blackrock,671,druid,feral,18,7,11
Carakal,outland,671,druid,feral,18,7,11
Lazerbinks,blackmoore,671,druid,feral,24,7,17
Biorythm,draenor,670,druid,feral,12,7,5
Noobbiiee,silvermoon,670,druid,feral,12,7,5
Teddîursa,kazzak,670,druid,feral,24,7,17
Toredorxy,blackrock,669,druid,feral,12,7,5
Radime,khaz-modan,669,druid,feral,12,7,5
Salviaf,silvermoon,669,druid,feral,12,7,5
Lorcàn,argent-dawn,669,druid,feral,24,7,17
Nicos,elune,668,druid,feral,18,7,11
Owling,antonidas,661,druid,feral,18,7,11
Mordpaw,stormscale,639,druid,feral,14,8,6
Блюгилли,ashenvale,639,druid,feral,32,8,24
Fückøff,ravencrest,576,druid,feral,6,6,0
Ferøsse,hyjal,576,druid,feral,6,6,0
Tonycatmeow,ravencrest,576,druid,feral,12,6,6
Mooncarnatio,burning-legion,576,druid,feral,12,6,6
Drbeef,sanguino,576,druid,feral,12,6,6
Amandial,silvermoon,576,druid,feral,12,6,6
Baccthana,auchindoun,576,druid,feral,12,6,6
Nédith,archimonde,576,druid,feral,12,6,6
Arlandia,drakthul,576,druid,feral,12,6,6
Rbg,dun-modr,576,druid,feral,12,6,6
Vlcák,drakthul,576,druid,feral,12,6,6
Vulko,lightbringer,576,druid,feral,12,6,6
Chiwsy,outland,576,druid,feral,12,6,6
Hugepepega,ravencrest,576,druid,feral,12,6,6
Кеорл,gordunni,576,druid,feral,18,6,12
Devonshira,ravencrest,575,druid,feral,12,6,6
Drudonja,silvermoon,575,druid,feral,12,6,6
Xurta,kazzak,575,druid,feral,12,6,6
Chunkeykill,alonsus,575,druid,feral,12,6,6
Hadespool,sanguino,575,druid,feral,12,6,6
Mudpie,stormscale,575,druid,feral,12,6,6
Скайтибрайдх,gordunni,575,druid,feral,18,6,12
Zeyne,ravencrest,574,druid,feral,12,6,6
Phanterus,chamber-of-aspects,574,druid,feral,12,6,6
Hadesx,blackhand,570,druid,feral,12,6,6
Друлевой,greymane,570,druid,feral,12,6,6
Spangle,stormscale,554,druid,feral,21,7,14
Блиденг,gordunni,522,druid,feral,21,8,13
Théó,grim-batol,520,druid,feral,11,6,5
Ytzù,archimonde,480,druid,feral,6,5,1
Urfi,tyrande,480,druid,feral,6,5,1
Retzerbil,ravencrest,480,druid,feral,10,6,4
Plankface,ravencrest,480,druid,feral,12,5,7
Nainket,ravencrest,480,druid,feral,12,5,7
Zurllyn,ravencrest,480,druid,feral,12,5,7
Kardashìan,ravencrest,480,druid,feral,12,5,7
Шэйпшифт,fordragon,480,druid,feral,12,5,7
Sketz,stormscale,480,druid,feral,12,5,7
Eltroncazo,sanguino,480,druid,feral,12,5,7
Rímeru,blackmoore,480,druid,feral,12,5,7
Erenalby,draenor,480,druid,feral,12,5,7
Sìa,frostmane,480,druid,feral,18,5,13
Outtanowhere,drakthul,480,druid,feral,18,5,13
Mérias,archimonde,480,druid,feral,18,5,13
Yiradur,stormscale,480,druid,feral,18,5,13
Cdsxr,outland,480,druid,feral,24,5,19
Kodobursto,stormscale,479,druid,feral,12,5,7
Poskehh,outland,479,druid,feral,12,5,7
Holditorsken,grim-batol,479,druid,feral,12,5,7
Менстряк,howling-fjord,479,druid,feral,18,5,13
Tibozx,stormscale,478,druid,feral,12,5,7
Progodd,kazzak,477,druid,feral,12,5,7
Skylarr,alexstrasza,475,druid,feral,12,5,7
Беконайзер,howling-fjord,463,druid,feral,11,5,6
Zynmeow,lordaeron,416,druid,feral,19,6,13
Nipply,ravencrest,415,druid,feral,15,6,9
Psixx,blackhand,384,druid,feral,6,4,2
Hushorde,twisting-nether,384,druid,feral,6,4,2
Takamizy,ysondre,384,druid,feral,6,4,2
Minaye,hyjal,384,druid,feral,6,4,2
Salseo,uldum,384,druid,feral,6,4,2
Faveyo,die-nachtwache,384,druid,feral,6,4,2
Ryáanz,ravencrest,384,druid,feral,6,4,2
Seekx,silvermoon,384,druid,feral,6,4,2
Ábomínatíon,draenor,384,druid,feral,6,4,2
Aleatório,grim-batol,384,druid,feral,6,4,2
Wex,darksorrow,384,druid,feral,6,4,2
Dystaleon,blackrock,384,druid,feral,6,4,2
Lolhaha,ravencrest,384,druid,feral,6,4,2
Dureka,tarren-mill,384,druid,feral,6,4,2
Fzx,aegwynn,384,druid,feral,6,4,2
Epicplays,sylvanas,384,druid,feral,6,4,2
Сиэн,ashenvale,384,druid,feral,6,4,2
Noxxzar,stormscale,384,druid,feral,6,4,2
Терамин,howling-fjord,384,druid,feral,6,4,2
Diktus,outland,384,druid,feral,6,4,2
Tangela,stormreaver,384,druid,feral,6,4,2
Doopdroo,tarren-mill,384,druid,feral,12,4,8
Tyldormeow,tarren-mill,384,druid,feral,12,4,8
Стэлларпауэр,gordunni,384,druid,feral,12,4,8
Extracssion,ysondre,384,druid,feral,12,4,8
Goatmeal,draenor,384,druid,feral,12,4,8
Jxst,tarren-mill,384,druid,feral,12,4,8
Trauller,outland,384,druid,feral,12,4,8
Luveena,kazzak,384,druid,feral,12,4,8
Shiotake,hyjal,384,druid,feral,12,4,8
Koffee,archimonde,384,druid,feral,12,4,8
Thaelyy,drakthul,384,druid,feral,18,4,14
Gediminas,argent-dawn,384,druid,feral,18,4,14
Derzis,eonar,383,druid,feral,6,4,2
Laststand,aggra-português,383,druid,feral,6,4,2
Lutis,magtheridon,383,druid,feral,12,4,8
Altramuz,uldum,382,druid,feral,6,4,2
Kageioshi,kazzak,382,druid,feral,12,4,8
Viølin,silvermoon,381,druid,feral,12,4,8
Verbat,cthun,379,druid,feral,12,4,8
Rakuy,thrall,352,druid,feral,10,4,6
Erelae,twisting-nether,352,druid,feral,10,4,6
Âltashamane,elune,351,druid,feral,11,4,7
Feytique,aegwynn,288,druid,feral,6,3,3
Jinxaran,culte-de-la-rive-noire,288,druid,feral,6,3,3
Sartipus,draenor,288,druid,feral,6,3,3
Druidicchi,stormscale,288,druid,feral,6,3,3
Vãrima,ravencrest,288,druid,feral,6,3,3
Kovlian,argent-dawn,288,druid,feral,6,3,3
Sylvy,dun-modr,288,druid,feral,6,3,3
Yepnesse,khaz-modan,288,druid,feral,6,3,3
Hipølita,zuljin,288,druid,feral,6,3,3
Runeclaws,twisting-nether,288,druid,feral,6,3,3
Loafy,the-maelstrom,288,druid,feral,6,3,3
Radauronny,malganis,288,druid,feral,6,3,3
Veryfast,blackhand,288,druid,feral,6,3,3
Fuzzylol,haomarush,288,druid,feral,6,3,3
Lenyl,dun-modr,288,druid,feral,6,3,3
Apetino,dun-modr,288,druid,feral,6,3,3
Kärmä,eldrethalas,288,druid,feral,6,3,3
Shingeki,alonsus,288,druid,feral,6,3,3
Wildthing,blackmoore,288,druid,feral,6,3,3
Druiidou,dalaran,288,druid,feral,6,3,3
Nå,outland,288,druid,feral,6,3,3
Moonpuff,kazzak,288,druid,feral,6,3,3
Snkyexpress,aegwynn,288,druid,feral,6,3,3
Déme,twisting-nether,288,druid,feral,6,3,3
Blvckðvitchz,ravencrest,288,druid,feral,6,3,3
Zantill,chamber-of-aspects,288,druid,feral,7,3,4
Kittyclâw,perenolde,288,druid,feral,12,3,9
Tazdino,destromath,288,druid,feral,12,3,9
Лорья,azuregos,288,druid,feral,12,3,9
Ðevilwhite,nemesis,288,druid,feral,12,3,9
Trikill,hyjal,288,druid,feral,13,3,10
Tallbutshort,stormscale,288,druid,feral,18,3,15
Frincessa,burning-legion,288,druid,feral,18,3,15
Jupter,burning-blade,287,druid,feral,6,3,3
Kyth,forscherliga,287,druid,feral,12,3,9
Mistic,twisting-nether,287,druid,feral,12,3,9
Zottelmahne,blackrock,286,druid,feral,6,3,3
Bakar,ghostlands,286,druid,feral,6,3,3
Wurnas,silvermoon,271,druid,feral,11,3,8
Диджейкошка,howling-fjord,239,druid,feral,5,3,2
Bagheera,archimonde,239,druid,feral,5,3,2
Astlanes,ysondre,192,druid,feral,6,2,4
Aryitu,blackrock,192,druid,feral,6,2,4
Treepoloski,stormscale,192,druid,feral,6,2,4
Jimmyxdd,kazzak,192,druid,feral,6,2,4
Bartax,culte-de-la-rive-noire,192,druid,feral,6,2,4
Melcow,eredar,192,druid,feral,6,2,4
Nidra,silvermoon,192,druid,feral,6,2,4
Docdruid,outland,192,druid,feral,6,2,4
Goodtrip,hyjal,192,druid,feral,6,2,4
Медверх,gordunni,192,druid,feral,6,2,4
Wuzzington,outland,192,druid,feral,6,2,4
Вохако,howling-fjord,192,druid,feral,6,2,4
Citrus,sargeras,192,druid,feral,6,2,4
Rabacki,blackmoore,192,druid,feral,6,2,4
Mervend,tarren-mill,192,druid,feral,6,2,4
Pneuma,xavius,192,druid,feral,6,2,4
Glyn,earthen-ring,192,druid,feral,6,2,4
Shylovez,aegwynn,192,druid,feral,6,2,4
Mcservietsky,chogall,192,druid,feral,6,2,4
Savagehèals,ravencrest,192,druid,feral,6,2,4
Kisskossa,stormscale,192,druid,feral,6,2,4
Rabatout,eitrigg,192,druid,feral,6,2,4
Coineagan,frostmourne,192,druid,feral,6,2,4
Rollozuu,blackrock,192,druid,feral,6,2,4
Feralsaber,ghostlands,192,druid,feral,6,2,4
Котфилин,gordunni,192,druid,feral,6,2,4
Лякокля,soulflayer,192,druid,feral,6,2,4
Chikiz,ghostlands,192,druid,feral,6,2,4
Pitchou,karazhan,192,druid,feral,6,2,4
Amoveo,argent-dawn,192,druid,feral,12,2,10
Xarxius,sanguino,192,druid,feral,12,2,10
Фаллендэл,gordunni,191,druid,feral,6,2,4
Anyône,dun-morogh,191,druid,feral,6,2,4
Jompemanfish,stormscale,191,druid,feral,6,2,4
Ôpium,eldrethalas,191,druid,feral,6,2,4
Kittasek,drakthul,191,druid,feral,6,2,4
Эвгедент,deathguard,191,druid,feral,18,2,16
Loriann,twisting-nether,191,druid,feral,18,2,16
Shadøwdruid,silvermoon,190,druid,feral,12,2,10
Korkskruven,draenor,159,druid,feral,5,2,3
Muryo,der-rat-von-dalaran,159,druid,feral,5,2,3
Azaría,aegwynn,128,druid,feral,4,2,2
Lionquokk,azjolnerub,128,druid,feral,4,2,2
Moderntalkin,aegwynn,96,druid,feral,17,4,13
Majesty,nagrand,96,druid,feral,6,1,5
Dash,the-maelstrom,96,druid,feral,6,1,5
Plàntz,tarren-mill,96,druid,feral,6,1,5
Heav,kiljaeden,96,druid,feral,6,1,5
Teám,tarren-mill,96,druid,feral,6,1,5
Älênkâ,drakthul,96,druid,feral,6,1,5
Cøcøpøpsmøke,archimonde,96,druid,feral,6,1,5
Thaneo,blackmoore,96,druid,feral,6,1,5
Blintschiki,echsenkessel,96,druid,feral,6,1,5
Ãnimal,argent-dawn,96,druid,feral,6,1,5
Awán,aegwynn,96,druid,feral,6,1,5
Catgirlx,ravencrest,96,druid,feral,6,1,5
Zinister,hyjal,96,druid,feral,6,1,5
Théodên,dalaran,96,druid,feral,6,1,5
Kuw,archimonde,96,druid,feral,6,1,5
Zulazain,bladefist,96,druid,feral,6,1,5
Fabulous,genjuros,96,druid,feral,6,1,5
Gurudru,tarren-mill,96,druid,feral,6,1,5
Klaerke,tarren-mill,96,druid,feral,6,1,5
Zaltaruk,sanguino,96,druid,feral,6,1,5
Nidrien,doomhammer,96,druid,feral,6,1,5
Бабакошка,gordunni,96,druid,feral,6,1,5
Хэрес,gordunni,96,druid,feral,6,1,5
Biffsteak,blackhand,96,druid,feral,12,1,11
Veyronn,burning-legion,96,druid,feral,12,1,11
Taco,eredar,96,druid,feral,12,1,11
Bidodici,nemesis,95,druid,feral,6,1,5
Azraël,les-clairvoyants,79,druid,feral,5,1,4
Krekigaadzre,draenor,48,druid,feral,3,1,2
Aendy,tarren-mill,48,druid,feral,3,1,2
Wolfly,ravencrest,42,druid,feral,11,3,8
Bd,stormscale,2225,druid,balance,83,49,34
Immuz,kazzak,2215,druid,balance,101,55,46
Sleepyhallow,blackmoore,2142,druid,balance,100,58,42
Merceý,ravencrest,2134,druid,balance,63,44,19
Eviscreator,stormscale,2120,druid,balance,90,63,27
Batboomie,zuljin,2109,druid,balance,114,71,43
Tmeister,kazzak,2101,druid,balance,72,42,30
Skivesnulle,kazzak,2088,druid,balance,78,40,38
Handsoff,stormscale,2078,druid,balance,84,47,37
Fuséton,tarren-mill,2075,druid,balance,78,47,31
Thelire,silvermoon,2065,druid,balance,78,45,33
Antahka,archimonde,2057,druid,balance,60,34,26
Mephîs,ravencrest,2046,druid,balance,58,39,19
Владисзади,gordunni,2036,druid,balance,59,35,24
Klimakleber,ravencrest,2024,druid,balance,93,47,46
Howgh,destromath,1969,druid,balance,89,53,36
Dincks,draenor,1964,druid,balance,42,29,13
Ôwlnur,kult-der-verdammten,1963,druid,balance,49,28,21
Broccoliboy,sylvanas,1949,druid,balance,42,26,16
Muufasa,blackmoore,1926,druid,balance,86,47,39
Flæppy,blackmoore,1923,druid,balance,61,32,29
Laserchicken,malganis,1912,druid,balance,95,47,48
Shåmss,kazzak,1910,druid,balance,36,23,13
Рейзакх,howling-fjord,1905,druid,balance,78,40,38
Secrägodx,ragnaros,1902,druid,balance,48,29,19
Ackiz,ravencrest,1898,druid,balance,48,27,21
Vabore,twisting-nether,1892,druid,balance,54,32,22
Sunshinex,silvermoon,1892,druid,balance,48,26,22
Votionex,tarren-mill,1891,druid,balance,64,38,26
Aggroasian,tarren-mill,1890,druid,balance,93,57,36
Isatá,ravencrest,1887,druid,balance,42,29,13
Fiskmåsn,twisting-nether,1887,druid,balance,84,54,30
Shayia,aegwynn,1884,druid,balance,60,33,27
Kankstery,stormscale,1882,druid,balance,65,44,21
Malex,auchindoun,1870,druid,balance,48,29,19
Shivany,twisting-nether,1870,druid,balance,64,33,31
Karvajyrä,stormreaver,1865,druid,balance,90,56,34
Trntydr,senjin,1856,druid,balance,24,20,4
Starbro,grim-batol,1856,druid,balance,48,27,21
Даирлин,gordunni,1853,druid,balance,76,35,41
Neirdá,hyjal,1846,druid,balance,84,52,32
Арадия,gordunni,1843,druid,balance,66,35,31
Fredhqt,tarren-mill,1841,druid,balance,53,31,22
Hrz,kazzak,1839,druid,balance,79,50,29
Punxybear,ravencrest,1838,druid,balance,60,32,28
Babynaty,ravencrest,1838,druid,balance,140,71,69
Méáckós,aegwynn,1832,druid,balance,53,26,27
Nuvemone,stormscale,1831,druid,balance,84,48,36
Hppsr,eredar,1830,druid,balance,54,27,27
Bearpawzz,kazzak,1823,druid,balance,48,29,19
Transmangodx,tarren-mill,1822,druid,balance,42,27,15
Mirynn,elune,1822,druid,balance,81,43,38
Catchmê,archimonde,1820,druid,balance,44,25,19
Néllÿ,elune,1818,druid,balance,42,20,22
Captaïn,twisting-nether,1816,druid,balance,36,27,9
Lunahu,argent-dawn,1816,druid,balance,72,42,30
Kruwkamilka,burning-legion,1815,druid,balance,36,24,12
Astrobazooka,stormreaver,1815,druid,balance,77,48,29
Wrathgodx,aegwynn,1814,druid,balance,36,24,12
Newaccount,kazzak,1813,druid,balance,36,25,11
Bákhar,ravencrest,1813,druid,balance,42,23,19
Травкер,howling-fjord,1813,druid,balance,89,43,46
Win,hellscream,1809,druid,balance,48,25,23
Небесныйхант,soulflayer,1808,druid,balance,59,30,29
Deép,nazjatar,1807,druid,balance,48,28,20
Zendda,hyjal,1806,druid,balance,48,23,25
Cøntrol,argent-dawn,1803,druid,balance,54,31,23
Rexonadudu,kazzak,1789,druid,balance,32,21,11
Wriong,ravencrest,1773,druid,balance,42,28,14
Hyac,the-maelstrom,1770,druid,balance,30,23,7
Kirexz,blackrock,1767,druid,balance,36,27,9
Mooskie,draenor,1767,druid,balance,42,28,14
Сосисосочка,gordunni,1763,druid,balance,42,20,22
Elissian,silvermoon,1758,druid,balance,78,47,31
Meowcry,outland,1755,druid,balance,36,24,12
ßa,blackmoore,1754,druid,balance,41,25,16
Xyzy,burning-legion,1753,druid,balance,48,28,20
Thardruid,stormscale,1738,druid,balance,66,40,26
Grisdrood,draenor,1737,druid,balance,89,49,40
Dudukid,nemesis,1737,druid,balance,48,26,22
Positivîty,stormscale,1729,druid,balance,30,19,11
Sentería,sylvanas,1729,druid,balance,48,22,26
Maroxd,stormscale,1723,druid,balance,24,18,6
Pouletqt,archimonde,1723,druid,balance,42,21,21
Ånaðeårmas,outland,1720,druid,balance,51,30,21
Kalgarm,burning-legion,1719,druid,balance,66,29,37
Darktigrou,archimonde,1717,druid,balance,24,18,6
Gurru,xavius,1715,druid,balance,48,26,22
Nyndrà,archimonde,1714,druid,balance,72,31,41
Владибой,gordunni,1712,druid,balance,36,18,18
Starfallkey,dun-modr,1707,druid,balance,81,47,34
Shapeshift,sanguino,1705,druid,balance,32,21,11
Credenz,frostmane,1705,druid,balance,48,28,20
Merawr,ravencrest,1704,druid,balance,69,41,28
Ganqb,ravencrest,1699,druid,balance,108,67,41
Nutsnack,tarren-mill,1699,druid,balance,36,20,16
Trekkertt,zuljin,1693,druid,balance,47,23,24
Slaugh,zuljin,1690,druid,balance,42,24,18
Kenzia,stormrage,1687,druid,balance,30,18,12
Disvikz,outland,1683,druid,balance,36,23,13
Zkrd,kazzak,1678,druid,balance,48,25,23
Emmdru,silvermoon,1671,druid,balance,30,22,8
Øffroadz,blackmoore,1670,druid,balance,24,18,6
Peaches,aerie-peak,1668,druid,balance,30,22,8
Мэдикейт,soulflayer,1668,druid,balance,54,33,21
Ruetinjeri,blackmoore,1668,druid,balance,37,20,17
Зетзул,grom,1667,druid,balance,47,27,20
Ôp,aegwynn,1656,druid,balance,32,19,13
Xä,bloodscalp,1652,druid,balance,82,49,33
Mochiløxz,tarren-mill,1644,druid,balance,38,26,12
Hyunâ,dalaran,1644,druid,balance,42,27,15
Limme,ravencrest,1636,druid,balance,28,20,8
Derfaï,kaelthas,1636,druid,balance,41,21,20
Трэйкотик,blackscar,1634,druid,balance,29,19,10
Naturalbeef,argent-dawn,1634,druid,balance,40,22,18
Qtkitty,outland,1632,druid,balance,48,28,20
Calê,blackrock,1631,druid,balance,39,26,13
Yarinai,blackmoore,1631,druid,balance,48,26,22
Masakrelol,sanguino,1631,druid,balance,36,18,18
Squirtdogx,drakthul,1630,druid,balance,30,17,13
Лсдспайсы,soulflayer,1623,druid,balance,36,21,15
Highonfire,grim-batol,1620,druid,balance,42,30,12
Moonzysunzy,sylvanas,1620,druid,balance,30,17,13
Landesverrat,kazzak,1619,druid,balance,24,21,3
Linkin,azshara,1618,druid,balance,54,26,28
Solariah,garona,1616,druid,balance,90,51,39
Dràkàn,dethecus,1613,druid,balance,30,17,13
Agagagagagag,ravencrest,1611,druid,balance,28,18,10
Онличикен,gordunni,1611,druid,balance,72,32,40
Trinket,frostmane,1610,druid,balance,30,23,7
Dizay,xavius,1610,druid,balance,30,19,11
Аласторвов,deathweaver,1610,druid,balance,60,28,32
Deadmeøw,outland,1609,druid,balance,34,21,13
Moonhusky,blackrock,1608,druid,balance,24,17,7
Algír,argent-dawn,1607,druid,balance,42,23,19
Ryng,nagrand,1606,druid,balance,60,41,19
Malvakten,kazzak,1606,druid,balance,80,38,42
Mopboomkin,twisting-nether,1605,druid,balance,24,19,5
Угощаюх,howling-fjord,1604,druid,balance,24,17,7
Pwnylol,teldrassil,1604,druid,balance,46,30,16
Сибирячечка,greymane,1603,druid,balance,24,17,7
Veyronn,burning-legion,1586,druid,balance,42,22,20
Drcaøs,sanguino,1580,druid,balance,66,35,31
Kokslina,sylvanas,1580,druid,balance,35,17,18
Bashmac,mugthol,1578,druid,balance,24,18,6
Rá,outland,1573,druid,balance,24,19,5
Pradasurge,ravencrest,1570,druid,balance,77,42,35
Stinkyicky,sylvanas,1569,druid,balance,36,25,11
Mäismz,hyjal,1567,druid,balance,36,24,12
Elodìa,antonidas,1561,druid,balance,30,21,9
Муниня,gordunni,1559,druid,balance,24,17,7
Pëchy,aggra-português,1555,druid,balance,36,22,14
Balanc,ragnaros,1554,druid,balance,47,25,22
Exca,stormscale,1552,druid,balance,48,26,22
Eärendir,ravencrest,1550,druid,balance,66,36,30
Матумбо,razuvious,1543,druid,balance,48,27,21
Gurudru,tarren-mill,1537,druid,balance,60,24,36
Izzi,arathor,1534,druid,balance,42,24,18
Druidflight,ravencrest,1534,druid,balance,48,24,24
Maijs,ravencrest,1533,druid,balance,36,16,20
Starcowx,ragnaros,1530,druid,balance,30,18,12
Shaakm,nerathor,1527,druid,balance,30,17,13
Lisbethqt,nemesis,1523,druid,balance,24,16,8
Bastodonte,skullcrusher,1523,druid,balance,30,16,14
Dematos,forscherliga,1520,druid,balance,42,29,13
Баттнэйкед,gordunni,1520,druid,balance,65,31,34
Chansnax,thrall,1519,druid,balance,46,26,20
Quorn,pozzo-delleternità,1515,druid,balance,52,25,27
Ahuevshiy,wildhammer,1512,druid,balance,24,16,8
Ventrìx,alleria,1512,druid,balance,36,16,20
Мунстрайк,borean-tundra,1505,druid,balance,23,16,7
Mogi,pozzo-delleternità,1479,druid,balance,36,18,18
Ðiàblos,nemesis,1470,druid,balance,36,27,9
Tawaraki,outland,1459,druid,balance,108,60,48
Møønhorn,nemesis,1459,druid,balance,38,19,19
Бамболони,gordunni,1458,druid,balance,39,26,13
Meatwallet,defias-brotherhood,1457,druid,balance,29,19,10
Каралесер,gordunni,1453,druid,balance,36,17,19
Moffwastaken,kazzak,1453,druid,balance,42,17,25
Aègon,ravencrest,1448,druid,balance,35,21,14
Viverion,ravencrest,1445,druid,balance,36,19,17
Æøøm,blackmoore,1444,druid,balance,29,16,13
Pø,blackrock,1443,druid,balance,53,26,27
Ðelix,ysera,1442,druid,balance,32,18,14
Jwrld,stormscale,1439,druid,balance,24,15,9
Гнетея,howling-fjord,1438,druid,balance,36,20,16
Gudñ,tarren-mill,1437,druid,balance,29,16,13
Uglyrasputin,blackmoore,1434,druid,balance,95,49,46
Cmfg,blackrock,1429,druid,balance,21,16,5
Anabola,frostwhisper,1423,druid,balance,24,15,9
Petiteorange,archimonde,1420,druid,balance,24,16,8
Kanataka,stormscale,1418,druid,balance,36,23,13
Däkk,draenor,1411,druid,balance,30,15,15
Boomalot,auchindoun,1399,druid,balance,48,25,23
Isylia,twisting-nether,1388,druid,balance,36,15,21
Goom,rexxar,1387,druid,balance,96,56,40
Arkatt,outland,1384,druid,balance,24,16,8
Darksbear,draenor,1368,druid,balance,24,16,8
Heanra,frostmane,1363,druid,balance,35,22,13
Strinx,ragnaros,1349,druid,balance,18,16,2
Bum,ravencrest,1344,druid,balance,18,14,4
Divref,tarren-mill,1343,druid,balance,18,14,4
Insølitø,sanguino,1343,druid,balance,30,15,15
Rosskemp,tarren-mill,1342,druid,balance,18,14,4
Mesmerizing,ravencrest,1339,druid,balance,24,14,10
Brainjuice,blackrock,1339,druid,balance,24,14,10
Dreathqt,twisting-nether,1335,druid,balance,36,14,22
Даена,razuvious,1334,druid,balance,18,14,4
Soward,la-croisade-écarlate,1331,druid,balance,38,17,21
Yuhor,outland,1330,druid,balance,24,14,10
Бонони,booty-bay,1328,druid,balance,30,14,16
Primdâhl,ravencrest,1318,druid,balance,24,14,10
Bløødax,hyjal,1314,druid,balance,88,40,48
Czarnykocur,burning-legion,1311,druid,balance,36,19,17
Solarian,ravencrest,1304,druid,balance,42,26,16
Horadruid,silvermoon,1296,druid,balance,84,44,40
Kolt,rajaxx,1295,druid,balance,33,16,17
Callmev,hyjal,1294,druid,balance,18,14,4
Hammd,kazzak,1275,druid,balance,20,14,6
Droodfarm,hyjal,1274,druid,balance,18,14,4
Мантоя,gordunni,1267,druid,balance,23,14,9
Ðoxi,draenor,1261,druid,balance,54,26,28
Morlas,kazzak,1261,druid,balance,50,22,28
Mayhh,ragnaros,1255,druid,balance,31,20,11
Rode,magtheridon,1246,druid,balance,30,14,16
Smittly,bloodhoof,1243,druid,balance,36,17,19
Rngmåchinéx,ravencrest,1240,druid,balance,23,14,9
Kubzii,archimonde,1239,druid,balance,24,13,11
Mahist,archimonde,1234,druid,balance,18,13,5
Trylune,blackmoore,1234,druid,balance,24,13,11
Ashär,kirin-tor,1231,druid,balance,45,21,24
Fantaclause,tarren-mill,1229,druid,balance,39,18,21
Oxox,defias-brotherhood,1227,druid,balance,24,14,10
Àlec,silvermoon,1225,druid,balance,78,43,35
Wildthing,blackmoore,1201,druid,balance,26,13,13
Quiksx,blackrock,1200,druid,balance,31,13,18
Pultsarí,tarren-mill,1199,druid,balance,21,13,8
Rek,sanguino,1199,druid,balance,27,13,14
Druiddamage,the-maelstrom,1189,druid,balance,78,38,40
Киллиманжаро,howling-fjord,1186,druid,balance,74,32,42
Chulainn,sylvanas,1181,druid,balance,24,18,6
Jeesman,sylvanas,1181,druid,balance,24,14,10
Tjoepert,azjolnerub,1164,druid,balance,42,15,27
Bearcosby,burning-legion,1160,druid,balance,23,13,10
Шадарлогот,gordunni,1160,druid,balance,60,33,27
Convokeboost,archimonde,1155,druid,balance,17,14,3
Gnotten,thunderhorn,1154,druid,balance,23,13,10
Ferraridudux,ravencrest,1152,druid,balance,12,12,0
Broxisqt,blackrock,1152,druid,balance,18,12,6
Minado,outland,1151,druid,balance,12,12,0
Nastyclones,kazzak,1151,druid,balance,18,12,6
Atrosity,ravencrest,1150,druid,balance,18,12,6
Saufeb,stormscale,1150,druid,balance,24,12,12
Owenwilson,twisting-nether,1149,druid,balance,18,12,6
Abyssaldepth,ravencrest,1147,druid,balance,12,12,0
Requinymph,ravencrest,1141,druid,balance,24,12,12
Shiotake,hyjal,1139,druid,balance,24,12,12
Kotomer,defias-brotherhood,1137,druid,balance,54,19,35
Fhi,antonidas,1132,druid,balance,18,12,6
Hotlife,ravencrest,1116,druid,balance,20,13,7
Haginator,twisting-nether,1112,druid,balance,30,12,18
Exilara,twisting-nether,1111,druid,balance,20,13,7
Braokhull,stormscale,1111,druid,balance,30,14,16
Loriann,twisting-nether,1111,druid,balance,69,31,38
Darisom,alexstrasza,1102,druid,balance,51,34,17
Settembre,ragnaros,1100,druid,balance,21,13,8
Séxycàt,ravencrest,1096,druid,balance,33,12,21
Inghlo,blackmoore,1095,druid,balance,18,13,5
Exiztenz,deathwing,1090,druid,balance,30,16,14
Qtrly,ravencrest,1086,druid,balance,26,12,14
Buckshee,doomhammer,1066,druid,balance,47,25,22
Cubir,turalyon,1065,druid,balance,23,12,11
Øncê,durotan,1056,druid,balance,18,11,7
Iamobito,blackmoore,1056,druid,balance,18,11,7
Turtleform,blackrock,1056,druid,balance,18,11,7
Cptnclone,blackmoore,1055,druid,balance,18,11,7
Tuttu,kazzak,1055,druid,balance,18,11,7
Shakso,stormscale,1055,druid,balance,18,11,7
Neverpanic,stormscale,1054,druid,balance,18,11,7
Ícekiss,hyjal,1053,druid,balance,12,11,1
Amoveo,argent-dawn,1053,druid,balance,18,11,7
Teaser,dun-modr,1053,druid,balance,24,11,13
Aimwaré,ravencrest,1050,druid,balance,24,11,13
Кекичшрекич,soulflayer,1045,druid,balance,24,11,13
Rorugo,sanguino,1044,druid,balance,18,11,7
Slurmms,sylvanas,1040,druid,balance,60,35,25
Hárty,tarren-mill,1035,druid,balance,24,11,13
Eliaster,ysondre,1034,druid,balance,18,11,7
Anerol,arthas,1031,druid,balance,36,19,17
Diepauline,aegwynn,1030,druid,balance,42,22,20
Rexiehunty,aszune,998,druid,balance,29,11,18
Skvll,silvermoon,987,druid,balance,26,11,15
Demonbalance,silvermoon,986,druid,balance,16,11,5
Wildanomaly,argent-dawn,986,druid,balance,22,11,11
Krtt,tarren-mill,986,druid,balance,28,11,17
Bulvai,medivh,979,druid,balance,14,11,3
Søfiaa,argent-dawn,961,druid,balance,30,16,14
Ccoco,aegwynn,960,druid,balance,12,10,2
Duridlol,nemesis,960,druid,balance,12,10,2
Kjøttberit,moonglade,960,druid,balance,12,10,2
Björnskift,tarren-mill,960,druid,balance,18,10,8
Wizzlafa,ravencrest,960,druid,balance,18,10,8
Andreud,dunemaul,960,druid,balance,24,10,14
Esrín,the-maelstrom,959,druid,balance,18,10,8
Tárzáñ,ravencrest,959,druid,balance,18,10,8
Narq,sylvanas,959,druid,balance,18,10,8
Hunkex,frostmane,959,druid,balance,21,10,11
Thepuma,dun-modr,958,druid,balance,12,10,2
Élán,sylvanas,958,druid,balance,18,10,8
Sefinana,malganis,958,druid,balance,24,10,14
Magiskeforme,draenor,957,druid,balance,12,10,2
Verenai,bloodfeather,957,druid,balance,12,10,2
Buhuu,blackmoore,957,druid,balance,18,10,8
Damigjat,sylvanas,956,druid,balance,12,10,2
Cantdonothig,ravencrest,956,druid,balance,22,11,11
Sajlol,doomhammer,955,druid,balance,18,10,8
Nøny,gorgonnash,955,druid,balance,18,10,8
Fruitdealer,antonidas,954,druid,balance,21,11,10
Ilovedruid,forscherliga,953,druid,balance,22,11,11
Hypnosoad,outland,951,druid,balance,24,10,14
Ххансолл,gordunni,947,druid,balance,18,10,8
Resthunor,draenor,935,druid,balance,18,10,8
Bullmarkets,kazzak,934,druid,balance,18,10,8
Naone,silvermoon,929,druid,balance,24,10,14
Ryuzu,aegwynn,910,druid,balance,17,10,7
Суггуторр,howling-fjord,909,druid,balance,75,36,39
Hisoca,tarren-mill,870,druid,balance,25,10,15
Izhusky,ravencrest,864,druid,balance,12,9,3
Juvencus,twisting-nether,864,druid,balance,12,9,3
Greenful,drakthul,864,druid,balance,12,9,3
Øhmygød,stormscale,864,druid,balance,18,9,9
Zødzin,kazzak,864,druid,balance,18,9,9
Gallokiriko,zuljin,864,druid,balance,18,9,9
Dyroxs,twisting-nether,864,druid,balance,18,9,9
Större,twisting-nether,863,druid,balance,12,9,3
Lillevän,tarren-mill,863,druid,balance,18,9,9
Scaleo,stormreaver,863,druid,balance,24,9,15
Bxxmkin,draenor,862,druid,balance,12,9,3
Mindruid,kazzak,862,druid,balance,18,9,9
Angharradh,arthas,862,druid,balance,18,9,9
Metaboss,ravencrest,862,druid,balance,18,9,9
Xora,kazzak,862,druid,balance,30,9,21
Амахасла,deathweaver,861,druid,balance,12,9,3
Druidere,outland,859,druid,balance,24,9,15
Lunably,silvermoon,855,druid,balance,18,9,9
Limmiited,ravencrest,855,druid,balance,18,9,9
Vrill,kazzak,850,druid,balance,21,10,11
Pretender,arathi,829,druid,balance,22,9,13
Cöyote,hyjal,796,druid,balance,24,10,14
Elgatos,kazzak,768,druid,balance,12,8,4
Kissaey,emeriss,768,druid,balance,12,8,4
Quadpulse,ravencrest,768,druid,balance,12,8,4
Ylmh,archimonde,768,druid,balance,12,8,4
Starsy,frostmane,768,druid,balance,12,8,4
Djfukface,ravencrest,768,druid,balance,12,8,4
Oommis,outland,768,druid,balance,12,8,4
Slahnesh,aegwynn,768,druid,balance,12,8,4
Клыкояр,goldrinn,768,druid,balance,12,8,4
Obsessíon,kazzak,768,druid,balance,12,8,4
Tiktokstar,blackrock,768,druid,balance,12,8,4
Øwlkin,ravencrest,768,druid,balance,12,8,4
Ferawri,draenor,768,druid,balance,12,8,4
Cowgurl,stormscale,768,druid,balance,12,8,4
Icek,outland,768,druid,balance,12,8,4
Shiftowl,tarren-mill,768,druid,balance,12,8,4
Rekked,alleria,768,druid,balance,12,8,4
Ghostpaws,ravencrest,768,druid,balance,18,8,10
Shroomdoom,ravencrest,768,druid,balance,18,8,10
Egirlqtxoxo,stormscale,767,druid,balance,12,8,4
Goüsta,archimonde,767,druid,balance,12,8,4
Drutiful,outland,767,druid,balance,18,8,10
Ilovehannah,laughing-skull,767,druid,balance,18,8,10
Døttore,garona,767,druid,balance,18,8,10
Zoxen,nefarian,767,druid,balance,18,8,10
Chrevarraige,saurfang,766,druid,balance,12,8,4
Кулунхе,soulflayer,763,druid,balance,12,8,4
Wazam,kazzak,763,druid,balance,12,8,4
Nømat,defias-brotherhood,763,druid,balance,12,8,4
Aggibääm,blackhand,724,druid,balance,18,8,10
Мунмунмун,gordunni,687,druid,balance,11,8,3
Nujus,kazzak,672,druid,balance,12,7,5
Hajlol,sylvanas,672,druid,balance,12,7,5
Лёхалепеха,gordunni,672,druid,balance,12,7,5
Stb,outland,672,druid,balance,12,7,5
Çhîñêséðrüîð,kazzak,672,druid,balance,12,7,5
Jazzme,aegwynn,672,druid,balance,12,7,5
Qyoon,argent-dawn,672,druid,balance,12,7,5
Glúingél,tarren-mill,672,druid,balance,12,7,5
Kabôôm,stormscale,672,druid,balance,12,7,5
Superchïcken,archimonde,672,druid,balance,12,7,5
Delarion,nemesis,672,druid,balance,12,7,5
Lilim,culte-de-la-rive-noire,672,druid,balance,12,7,5
Trønchetto,nemesis,672,druid,balance,12,7,5
Rbgkári,draenor,672,druid,balance,12,7,5
Mommymìlkers,archimonde,672,druid,balance,12,7,5
Svend,kazzak,672,druid,balance,12,7,5
Epicplays,sylvanas,672,druid,balance,12,7,5
Mazalot,kazzak,672,druid,balance,12,7,5
Mythiaran,argent-dawn,672,druid,balance,12,7,5
Daÿdream,ravencrest,672,druid,balance,12,7,5
Okøë,marécage-de-zangar,672,druid,balance,12,7,5
Núri,lordaeron,672,druid,balance,18,7,11
Tronchetto,nemesis,672,druid,balance,18,7,11
Âlhajillo,dun-modr,672,druid,balance,18,7,11
Thcpositiv,aegwynn,672,druid,balance,18,7,11
Blackfür,sylvanas,672,druid,balance,18,7,11
Hauntie,kazzak,671,druid,balance,12,7,5
Farodiin,blackmoore,671,druid,balance,12,7,5
Fruntimmern,sylvanas,671,druid,balance,12,7,5
Rikayn,tarren-mill,671,druid,balance,12,7,5
Mnqn,ravencrest,671,druid,balance,12,7,5
Cagaboliches,sanguino,671,druid,balance,12,7,5
Irishdemón,ravencrest,671,druid,balance,15,8,7
Muhz,nathrezim,671,druid,balance,18,7,11
Rédbull,outland,671,druid,balance,18,7,11
Fréki,ravenholdt,670,druid,balance,12,7,5
Mööñ,hyjal,670,druid,balance,12,7,5
Balzàc,ravencrest,670,druid,balance,12,7,5
Wolfhealer,blackmoore,669,druid,balance,12,7,5
Challi,nordrassil,669,druid,balance,18,7,11
Мяурицао,howling-fjord,668,druid,balance,12,7,5
Медведяра,howling-fjord,663,druid,balance,15,8,7
Mascraxx,earthen-ring,651,druid,balance,19,8,11
Nille,tarren-mill,617,druid,balance,14,8,6
Bubidiblumdr,twisting-nether,605,druid,balance,16,7,9
Xenuss,kazzak,576,druid,balance,6,6,0
Bakkú,ravencrest,576,druid,balance,6,6,0
Qpoof,sylvanas,576,druid,balance,6,6,0
Ухухуня,gordunni,576,druid,balance,6,6,0
Mønrøe,ravencrest,576,druid,balance,9,7,2
Bigtouch,draenor,576,druid,balance,12,6,6
Elunælle,les-sentinelles,576,druid,balance,12,6,6
Layle,argent-dawn,576,druid,balance,12,6,6
Nancey,auchindoun,576,druid,balance,12,6,6
Мунпраид,gordunni,576,druid,balance,12,6,6
Quoting,ravencrest,576,druid,balance,12,6,6
Vulkayn,ysondre,576,druid,balance,12,6,6
Saabeq,hyjal,576,druid,balance,12,6,6
Quinten,ulduar,576,druid,balance,12,6,6
Néxct,stormscale,576,druid,balance,12,6,6
Зулкхаку,soulflayer,576,druid,balance,12,6,6
Nuggetspøwa,dalaran,576,druid,balance,12,6,6
Thefudge,silvermoon,576,druid,balance,12,6,6
Kamenká,aegwynn,576,druid,balance,12,6,6
Feelstreeman,twisting-nether,576,druid,balance,12,6,6
Dyuuna,hyjal,576,druid,balance,12,6,6
Mentaldead,tarren-mill,576,druid,balance,12,6,6
Diolives,stormscale,576,druid,balance,12,6,6
Monkeynight,ambossar,576,druid,balance,14,6,8
Smedoge,outland,576,druid,balance,18,6,12
Meezy,ragnaros,575,druid,balance,12,6,6
Òniz,hyjal,575,druid,balance,12,6,6
Zaratras,arathor,575,druid,balance,12,6,6
Seudoz,silvermoon,575,druid,balance,12,6,6
Zeifana,khaz-modan,575,druid,balance,12,6,6
Ziele,the-maelstrom,575,druid,balance,12,6,6
Orazien,ravencrest,575,druid,balance,12,6,6
Sabresheep,twisting-nether,575,druid,balance,18,6,12
Джоннчек,gordunni,574,druid,balance,10,7,3
Momaa,neptulon,574,druid,balance,12,6,6
Sheâ,nemesis,574,druid,balance,18,6,12
Kittasek,drakthul,572,druid,balance,12,6,6
Tombenuit,tarren-mill,572,druid,balance,12,6,6
Tarantinonon,kazzak,572,druid,balance,18,6,12
Arecsne,turalyon,543,druid,balance,14,7,7
Xyiz,ravencrest,528,druid,balance,15,6,9
Кашаган,howling-fjord,527,druid,balance,15,6,9
Suranaelle,argent-dawn,519,druid,balance,17,7,10
Sylvy,dun-modr,480,druid,balance,6,5,1
Pezuñera,sanguino,480,druid,balance,6,5,1
Knùbz,ravencrest,480,druid,balance,6,5,1
Pinkpanda,arthas,480,druid,balance,6,5,1
Buckmysallz,archimonde,480,druid,balance,6,5,1
Lazerbinks,blackmoore,480,druid,balance,6,5,1
Itadorikun,silvermoon,480,druid,balance,6,5,1
Ibnform,archimonde,480,druid,balance,6,5,1
Gulmi,outland,480,druid,balance,6,5,1
Couleaf,stormscale,480,druid,balance,6,5,1
Troc,karazhan,480,druid,balance,6,5,1
Ezeke,eredar,480,druid,balance,6,5,1
Faxotium,argent-dawn,480,druid,balance,6,5,1
Rilak,nordrassil,480,druid,balance,6,5,1
Kénshin,blackhand,480,druid,balance,6,5,1
Воому,soulflayer,480,druid,balance,6,5,1
Doup,alakir,480,druid,balance,12,5,7
Slâkkxz,kazzak,480,druid,balance,12,5,7
Hirmo,ragnaros,480,druid,balance,12,5,7
Pèps,dalaran,480,druid,balance,12,5,7
Superpoulet,archimonde,480,druid,balance,12,5,7
Zomgcow,twisting-nether,480,druid,balance,12,5,7
Naturina,shattered-hand,480,druid,balance,12,5,7
Corias,blackmoore,480,druid,balance,12,5,7
Yadon,the-maelstrom,480,druid,balance,12,5,7
Pròtodrù,twisting-nether,480,druid,balance,12,5,7
Lifecycle,nemesis,480,druid,balance,12,5,7
Ploho,blackmoore,480,druid,balance,12,5,7
Gstahr,taerar,480,druid,balance,12,5,7
Escaa,stormscale,480,druid,balance,12,5,7
Qïx,outland,480,druid,balance,15,6,9
Kunya,tarren-mill,480,druid,balance,18,5,13
Druice,tyrande,479,druid,balance,6,5,1
Mariss,chogall,479,druid,balance,6,5,1
Kroaxs,draenor,479,druid,balance,12,5,7
Fakers,the-maelstrom,477,druid,balance,6,5,1
Zenkay,naxxramas,476,druid,balance,16,6,10
Iskaarjx,archimonde,463,druid,balance,11,5,6
Слоич,howling-fjord,457,druid,balance,15,7,8
Chouan,marécage-de-zangar,457,druid,balance,21,7,14
Eloahdruid,blackhand,432,druid,balance,9,5,4
Whythis,archimonde,432,druid,balance,15,5,10
Wildmistake,argent-dawn,415,druid,balance,11,5,6
Whiskers,emerald-dream,400,druid,balance,7,5,2
Leafsandstuf,ragnaros,384,druid,balance,6,4,2
Lakersinfive,argent-dawn,384,druid,balance,6,4,2
Teryx,blackmoore,384,druid,balance,6,4,2
Sunisan,stormscale,384,druid,balance,6,4,2
Loswochos,blackmoore,384,druid,balance,6,4,2
Jometatile,hyjal,384,druid,balance,6,4,2
Yinx,darksorrow,384,druid,balance,6,4,2
Daluria,malganis,384,druid,balance,6,4,2
Shiffe,argent-dawn,384,druid,balance,6,4,2
Croquetoro,sanguino,384,druid,balance,6,4,2
Citróne,blackrock,384,druid,balance,6,4,2
Brandyballix,twisting-nether,384,druid,balance,6,4,2
Xvmon,draenor,384,druid,balance,6,4,2
Fatfingerx,blackrock,384,druid,balance,6,4,2
Sagezza,draenor,384,druid,balance,6,4,2
Àsúnâ,eredar,384,druid,balance,6,4,2
Potatodru,ragnaros,384,druid,balance,6,4,2
Twitchmoney,archimonde,384,druid,balance,6,4,2
Betol,das-konsortium,384,druid,balance,6,4,2
Vertabrain,twilights-hammer,384,druid,balance,6,4,2
Cpt,xavius,384,druid,balance,6,4,2
Youngdinozzo,dalaran,384,druid,balance,6,4,2
Mendorin,stormrage,384,druid,balance,6,4,2
Kabuul,dun-modr,384,druid,balance,6,4,2
Hardí,tarren-mill,384,druid,balance,6,4,2
Benzinoid,silvermoon,384,druid,balance,6,4,2
Boomjutzu,kazzak,384,druid,balance,6,4,2
Fransman,sylvanas,384,druid,balance,6,4,2
Hotdóts,outland,384,druid,balance,6,4,2
Htxo,kazzak,384,druid,balance,6,4,2
Shapees,sylvanas,384,druid,balance,6,4,2
Ekologiskxx,outland,384,druid,balance,6,4,2
Angrykejton,silvermoon,384,druid,balance,6,4,2
Adizero,blackrock,384,druid,balance,11,4,7
Ibroninad,ragnaros,384,druid,balance,12,4,8
Redyogurt,outland,384,druid,balance,12,4,8
Màlàkaii,hyjal,384,druid,balance,12,4,8
Вбг,soulflayer,384,druid,balance,12,4,8
Ööh,outland,384,druid,balance,12,4,8
Commonsense,kazzak,384,druid,balance,12,4,8
Sixtyinches,burning-blade,384,druid,balance,12,4,8
Jamzydruid,kazzak,384,druid,balance,12,4,8
Stepgødx,twisting-nether,384,druid,balance,12,4,8
Tmhaikyu,blackhand,384,druid,balance,12,4,8
Tjillevippen,tarren-mill,384,druid,balance,12,4,8
Cptsponksa,tarren-mill,384,druid,balance,12,4,8
Achre,thunderhorn,384,druid,balance,12,4,8
Yee,twisting-nether,384,druid,balance,12,4,8
Madhatterr,kazzak,384,druid,balance,12,4,8
Sároman,ravencrest,384,druid,balance,12,4,8
Ljóskan,kazzak,384,druid,balance,12,4,8
Жекакотик,eversong,384,druid,balance,12,4,8
Rivella,blackrock,384,druid,balance,12,4,8
Губкобоб,galakrond,384,druid,balance,16,4,12
Храмульчик,blackscar,383,druid,balance,6,4,2
Mongwau,blackrock,383,druid,balance,6,4,2
Moonpouk,archimonde,383,druid,balance,6,4,2
Rullader,draenor,383,druid,balance,6,4,2
Wartôn,blackhand,383,druid,balance,12,4,8
Calistane,silvermoon,383,druid,balance,18,4,14
Katharo,kult-der-verdammten,383,druid,balance,24,4,20
Ráw,dun-modr,367,druid,balance,11,4,7
Tommyruin,the-venture-co,352,druid,balance,10,4,6
Ратататата,blackscar,351,druid,balance,8,5,3
Blakemonster,khaz-modan,351,druid,balance,8,5,3
Zybri,ragnaros,351,druid,balance,11,4,7
Nightshaðe,argent-dawn,351,druid,balance,11,4,7
Нэйроуз,howling-fjord,351,druid,balance,11,4,7
Durkdriven,kazzak,336,druid,balance,15,4,11
Sketit,grim-batol,335,druid,balance,11,4,7
Shåmssz,kazzak,330,druid,balance,8,6,2
Martinesämst,outland,320,druid,balance,10,4,6
Rønièl,tarren-mill,319,druid,balance,5,4,1
Eclipße,silvermoon,319,druid,balance,5,4,1
Emochicken,silvermoon,288,druid,balance,6,3,3
Flanagân,hyjal,288,druid,balance,6,3,3
Niul,aegwynn,288,druid,balance,6,3,3
Auches,argent-dawn,288,druid,balance,6,3,3
Tobid,blackrock,288,druid,balance,6,3,3
Vaacku,stormreaver,288,druid,balance,6,3,3
Zapx,hyjal,288,druid,balance,6,3,3
Illmíndofboo,twisting-nether,288,druid,balance,6,3,3
Rumjin,burning-blade,288,druid,balance,6,3,3
Derie,nazjatar,288,druid,balance,6,3,3
Fantomasik,drakthul,288,druid,balance,6,3,3
Quinteness,silvermoon,288,druid,balance,6,3,3
Hashishi,grim-batol,288,druid,balance,6,3,3
Biologie,onyxia,288,druid,balance,6,3,3
Detü,blackrock,288,druid,balance,6,3,3
Fesenjon,blackhand,288,druid,balance,6,3,3
Islandbôy,blackrock,288,druid,balance,6,3,3
Suevlaki,ragnaros,288,druid,balance,6,3,3
Блиденг,gordunni,288,druid,balance,6,3,3
Crackfat,stormscale,288,druid,balance,6,3,3
Alanpapi,sanguino,288,druid,balance,6,3,3
Coogee,malganis,288,druid,balance,6,3,3
Rektjin,stormscale,288,druid,balance,6,3,3
Astralbody,auchindoun,288,druid,balance,6,3,3
Meretrizx,kazzak,288,druid,balance,6,3,3
Laker,stormscale,288,druid,balance,6,3,3
Hordepwnr,sylvanas,288,druid,balance,6,3,3
Jabbah,defias-brotherhood,288,druid,balance,6,3,3
Покусаютебя,gordunni,288,druid,balance,6,3,3
Ullainho,stormscale,288,druid,balance,6,3,3
Pvekek,stormscale,288,druid,balance,6,3,3
Orangeterror,stormscale,288,druid,balance,6,3,3
Fishe,twisting-nether,288,druid,balance,6,3,3
Феразинария,gordunni,288,druid,balance,6,3,3
Ciwone,blackrock,288,druid,balance,6,3,3
Kamatea,eredar,288,druid,balance,6,3,3
Applestrudle,blackrock,288,druid,balance,6,3,3
Катяблум,gordunni,288,druid,balance,6,3,3
Зонкс,gordunni,288,druid,balance,6,3,3
Jirenthegrey,antonidas,288,druid,balance,6,3,3
Raxona,blackmoore,288,druid,balance,6,3,3
Siuo,ravencrest,288,druid,balance,6,3,3
Buboss,ravencrest,288,druid,balance,6,3,3
Mdrgtwo,ravencrest,288,druid,balance,6,3,3
Suitti,ravencrest,288,druid,balance,6,3,3
Lèafy,silvermoon,288,druid,balance,7,3,4
Likwidator,stormscale,288,druid,balance,12,3,9
Lúthiëñ,silvermoon,288,druid,balance,12,3,9
Барли,grom,288,druid,balance,12,3,9
Elatadru,silvermoon,288,druid,balance,12,3,9
Hengst,laughing-skull,288,druid,balance,12,3,9
Ronî,arthas,288,druid,balance,12,3,9
Crywingz,antonidas,288,druid,balance,12,3,9
ßalmain,nethersturm,287,druid,balance,12,3,9
Jhiun,ragnaros,256,druid,balance,4,4,0
Bóssít,doomhammer,255,druid,balance,11,3,8
Hotsincee,stormscale,255,druid,balance,11,3,8
Maw,hellfire,239,druid,balance,5,3,2
Dresten,burning-blade,192,druid,balance,6,2,4
Jimmyxdd,kazzak,192,druid,balance,6,2,4
Emidrem,ravencrest,192,druid,balance,6,2,4
Ancientix,burning-legion,192,druid,balance,6,2,4
Telbo,ravencrest,192,druid,balance,6,2,4
Blablábla,silvermoon,192,druid,balance,6,2,4
Gipi,ravencrest,192,druid,balance,6,2,4
Sorkoxd,silvermoon,192,druid,balance,6,2,4
Tallbutshort,stormscale,192,druid,balance,6,2,4
Saliencias,kazzak,192,druid,balance,6,2,4
Tønychopper,sanguino,192,druid,balance,6,2,4
Chäz,sanguino,192,druid,balance,6,2,4
When,kirin-tor,192,druid,balance,6,2,4
Winarchikxxl,tarren-mill,192,druid,balance,6,2,4
Forigiver,draenor,192,druid,balance,6,2,4
Drazefin,twisting-nether,192,druid,balance,6,2,4
Noou,aegwynn,192,druid,balance,6,2,4
Segundø,archimonde,192,druid,balance,6,2,4
Zolduran,archimonde,192,druid,balance,6,2,4
Taskingoman,twisting-nether,192,druid,balance,6,2,4
Juicypus,ragnaros,192,druid,balance,6,2,4
Rwq,outland,192,druid,balance,6,2,4
Laødinay,hyjal,192,druid,balance,6,2,4
Lóvebeam,ravencrest,192,druid,balance,6,2,4
Héryse,hyjal,192,druid,balance,6,2,4
Hâyâbusa,antonidas,192,druid,balance,6,2,4
Canezmvp,blackrock,192,druid,balance,6,2,4
Tamburoo,tarren-mill,192,druid,balance,6,2,4
Коктявзер,deathweaver,192,druid,balance,6,2,4
Снэйк,borean-tundra,192,druid,balance,6,2,4
Tadoson,blackmoore,192,druid,balance,6,2,4
Kaamirach,blackmoore,192,druid,balance,6,2,4
Маалир,gordunni,192,druid,balance,6,2,4
Arrock,malfurion,191,druid,balance,6,2,4
Silvacustos,teldrassil,191,druid,balance,12,2,10
Drix,frostwolf,175,druid,balance,11,2,9
Théodên,dalaran,127,druid,balance,13,2,11
Drooshy,ravencrest,96,druid,balance,3,2,1
Drmoe,blackmoore,96,druid,balance,3,2,1
Ishaqu,bladefist,96,druid,balance,6,1,5
Samuelito,ravencrest,96,druid,balance,6,1,5
Маминапуська,soulflayer,96,druid,balance,6,1,5
Ipsdray,ysondre,96,druid,balance,6,1,5
Fleq,antonidas,96,druid,balance,6,1,5
Tigerbalm,ravenholdt,96,druid,balance,6,1,5
Xwerzz,stormscale,96,druid,balance,6,1,5
Ddggss,ragnaros,96,druid,balance,6,1,5
Goated,stormscale,96,druid,balance,6,1,5
Exactt,blackrock,96,druid,balance,6,1,5
Nermax,kazzak,96,druid,balance,6,1,5
Elfsu,ravencrest,96,druid,balance,6,1,5
Ösdru,tarren-mill,96,druid,balance,6,1,5
Ghostdoggie,stormscale,96,druid,balance,6,1,5
Garudax,blackrock,96,druid,balance,6,1,5
Ãnimal,argent-dawn,96,druid,balance,6,1,5
Kidow,wrathbringer,96,druid,balance,6,1,5
Machie,argent-dawn,96,druid,balance,6,1,5
Yosimoo,draenor,96,druid,balance,6,1,5
Herekitykity,frostmane,96,druid,balance,6,1,5
Mondino,blackrock,96,druid,balance,12,1,11
Negríno,cthun,95,druid,balance,3,2,1
Kodobursto,stormscale,79,druid,balance,6,1,5
Foxîo,frostmane,31,druid,balance,2,1,1
Dotclass,outland,31,druid,balance,2,1,1
Nalreaa,kazzak,31,druid,balance,8,1,7
Báttlx,blackrock,16,druid,balance,7,1,6
Néthy,argent-dawn,2186,evoker,preservation,78,47,31
Bodytypezero,terenas,2169,evoker,preservation,110,62,48
Sukkmymadnes,draenor,2120,evoker,preservation,79,39,40
Гачитварь,galakrond,2091,evoker,preservation,191,95,96
Nesedon,stormscale,1972,evoker,preservation,66,33,33
Шафлэнжоер,fordragon,1958,evoker,preservation,30,22,8
Phnx,blackrock,1945,evoker,preservation,198,103,95
Puzikloh,ravencrest,1913,evoker,preservation,36,20,16
Dragonsweat,hyjal,1910,evoker,preservation,48,29,19
Drogon,shendralar,1909,evoker,preservation,54,29,25
Waifuwu,blackhand,1900,evoker,preservation,175,85,90
Vokedrak,eredar,1875,evoker,preservation,66,32,34
Amadeusx,ravencrest,1874,evoker,preservation,48,30,18
Xays,ravencrest,1864,evoker,preservation,70,34,36
Dn,shattered-hand,1863,evoker,preservation,54,23,31
Baiyuekui,blackmoore,1854,evoker,preservation,189,97,92
Myshagini,ravencrest,1846,evoker,preservation,45,27,18
Æzorahai,area-52,1845,evoker,preservation,72,33,39
Theories,blackhand,1832,evoker,preservation,56,27,29
Rvrsl,outland,1828,evoker,preservation,60,29,31
Zimbello,nemesis,1826,evoker,preservation,36,26,10
Ripgódx,bronzebeard,1826,evoker,preservation,42,28,14
Matrixslave,tarren-mill,1822,evoker,preservation,69,38,31
Onelastdance,ravencrest,1821,evoker,preservation,59,50,9
Jakelóng,ravencrest,1818,evoker,preservation,52,25,27
Zychodrac,draenor,1816,evoker,preservation,60,29,31
Ipho,twisting-nether,1815,evoker,preservation,72,32,40
Mixn,argent-dawn,1812,evoker,preservation,93,41,52
Ноубадиаттак,soulflayer,1811,evoker,preservation,72,30,42
Smellybreath,ravencrest,1810,evoker,preservation,36,19,17
Dragonmeta,kazzak,1808,evoker,preservation,36,19,17
Wakûwakû,kazzak,1805,evoker,preservation,135,72,63
Cptdrakon,twisting-nether,1802,evoker,preservation,77,43,34
Podonok,ravencrest,1797,evoker,preservation,36,19,17
Swainsupp,archimonde,1776,evoker,preservation,42,19,23
Seafolk,stormscale,1762,evoker,preservation,110,61,49
Infidus,ravencrest,1754,evoker,preservation,42,29,13
Dragondaddy,eredar,1748,evoker,preservation,42,19,23
Talim,terrordar,1742,evoker,preservation,48,21,27
Camdaddy,magtheridon,1715,evoker,preservation,117,60,57
Трейш,soulflayer,1714,evoker,preservation,72,29,43
Lazey,stormscale,1713,evoker,preservation,30,18,12
Bònéz,blackmoore,1675,evoker,preservation,95,47,48
Kankethyr,korgall,1660,evoker,preservation,29,18,11
Sedricae,twisting-nether,1654,evoker,preservation,91,51,40
Даэдра,gordunni,1652,evoker,preservation,42,22,20
Аскми,blackscar,1642,evoker,preservation,84,35,49
Âspên,archimonde,1639,evoker,preservation,51,24,27
Дарконикс,gordunni,1632,evoker,preservation,48,25,23
Rüllatorsven,stormscale,1631,evoker,preservation,36,21,15
Тирэсплюс,soulflayer,1630,evoker,preservation,30,17,13
Kackaloch,tarren-mill,1625,evoker,preservation,69,37,32
Akaos,silvermoon,1613,evoker,preservation,38,20,18
Lytër,sanguino,1606,evoker,preservation,51,33,18
Bugdul,twisting-nether,1603,evoker,preservation,44,26,18
Tenibris,die-nachtwache,1593,evoker,preservation,48,24,24
Fearawr,malganis,1552,evoker,preservation,63,22,41
Obbwoke,ravencrest,1550,evoker,preservation,60,25,35
Kalevra,eredar,1548,evoker,preservation,37,18,19
Ðåñîq,kazzak,1534,evoker,preservation,30,16,14
Malboroasted,archimonde,1524,evoker,preservation,36,18,18
Нежныйболт,howling-fjord,1510,evoker,preservation,122,61,61
Superflyy,kazzak,1503,evoker,preservation,54,24,30
Ацидракон,blackscar,1502,evoker,preservation,66,27,39
Odensbest,silvermoon,1496,evoker,preservation,55,32,23
Bigaluga,blackmoore,1492,evoker,preservation,42,18,24
Madelynxoxo,draenor,1450,evoker,preservation,30,25,5
Dragoncya,archimonde,1447,evoker,preservation,72,33,39
Wingzy,chogall,1443,evoker,preservation,83,44,39
Condrage,grim-batol,1432,evoker,preservation,30,17,13
Nanthira,darksorrow,1410,evoker,preservation,74,33,41
Evizard,nagrand,1407,evoker,preservation,53,30,23
Loveheart,die-aldor,1405,evoker,preservation,52,23,29
Spiragon,ysondre,1397,evoker,preservation,24,15,9
Draxaer,outland,1390,evoker,preservation,90,52,38
Ammendorn,blackrock,1384,evoker,preservation,46,27,19
Azorgaron,outland,1383,evoker,preservation,60,26,34
Dragnthsnuts,sylvanas,1380,evoker,preservation,32,16,16
Nexxà,archimonde,1373,evoker,preservation,39,28,11
Ятромантис,gordunni,1352,evoker,preservation,147,71,76
Breall,tarren-mill,1343,evoker,preservation,60,22,38
Maxthecar,draenor,1342,evoker,preservation,30,18,12
Adriia,draenor,1341,evoker,preservation,18,14,4
Drarent,hyjal,1340,evoker,preservation,54,24,30
Nakavoker,arygos,1340,evoker,preservation,34,14,20
Navilism,kazzak,1330,evoker,preservation,166,87,79
Cinquanteuro,hyjal,1313,evoker,preservation,96,41,55
Штеци,howling-fjord,1306,evoker,preservation,166,65,101
Mortlalune,conseil-des-ombres,1299,evoker,preservation,43,25,18
Sinistrea,conseil-des-ombres,1296,evoker,preservation,40,17,23
Scalo,kazzak,1292,evoker,preservation,90,41,49
Geckonen,stormreaver,1279,evoker,preservation,100,54,46
Malfø,exodar,1270,evoker,preservation,91,45,46
Drackheal,kaelthas,1269,evoker,preservation,35,21,14
Lynastrasza,silvermoon,1268,evoker,preservation,55,32,23
Ludracy,antonidas,1267,evoker,preservation,66,34,32
Cenca,blackmoore,1263,evoker,preservation,49,20,29
Didii,frostwhisper,1263,evoker,preservation,82,32,50
Asinitaris,ravencrest,1253,evoker,preservation,41,22,19
Rescuegirl,blackrock,1249,evoker,preservation,33,16,17
Froststraza,chamber-of-aspects,1247,evoker,preservation,30,13,17
Healevoker,aegwynn,1246,evoker,preservation,30,13,17
Methamfetami,kazzak,1239,evoker,preservation,24,13,11
Uroegevoker,twisting-nether,1227,evoker,preservation,39,18,21
Oldwhiteman,guldan,1199,evoker,preservation,28,13,15
Драконсила,gordunni,1198,evoker,preservation,23,13,10
Ohcaralho,outland,1198,evoker,preservation,33,14,19
Zethreus,silvermoon,1170,evoker,preservation,58,30,28
Dragawn,grim-batol,1159,evoker,preservation,42,27,15
Retyss,twisting-nether,1158,evoker,preservation,95,53,42
Eagleflow,aszune,1154,evoker,preservation,31,13,18
Dârys,kazzak,1152,evoker,preservation,24,12,12
Puffthemagic,archimonde,1151,evoker,preservation,24,12,12
Sinusiitiis,destromath,1142,evoker,preservation,18,12,6
Discodidling,silvermoon,1139,evoker,preservation,30,13,17
Tennin,thrall,1131,evoker,preservation,33,20,13
Adnoc,tarren-mill,1124,evoker,preservation,19,13,6
Howtodragon,twisting-nether,1118,evoker,preservation,30,13,17
Beenus,doomhammer,1117,evoker,preservation,24,14,10
Fredgobrr,tarren-mill,1106,evoker,preservation,30,17,13
Uztfuzt,blackmoore,1103,evoker,preservation,24,15,9
Zathîel,argent-dawn,1098,evoker,preservation,75,31,44
Алекстраса,blackscar,1097,evoker,preservation,30,16,14
Saphirá,hyjal,1094,evoker,preservation,28,13,15
Singe,nemesis,1081,evoker,preservation,48,12,36
Blackli,kazzak,1074,evoker,preservation,33,14,19
Dizablise,burning-legion,1056,evoker,preservation,18,11,7
Haxyia,outland,1056,evoker,preservation,18,11,7
Kronata,sanguino,1056,evoker,preservation,24,11,13
Phyrrax,silvermoon,1055,evoker,preservation,18,11,7
Themasktw,kazzak,1055,evoker,preservation,18,11,7
Tombeelee,kazzak,1055,evoker,preservation,18,11,7
Devidra,defias-brotherhood,1055,evoker,preservation,24,11,13
Valkroth,argent-dawn,1055,evoker,preservation,24,11,13
Dragonsimp,archimonde,1047,evoker,preservation,18,11,7
Sarapakara,burning-blade,1047,evoker,preservation,24,11,13
Predatax,drakthul,1040,evoker,preservation,42,21,21
Pigioto,silvermoon,1031,evoker,preservation,59,31,28
Dragonna,argent-dawn,1022,evoker,preservation,24,11,13
Lizardofoz,argent-dawn,1019,evoker,preservation,18,12,6
Palindre,argent-dawn,987,evoker,preservation,29,14,15
Morlie,argent-dawn,987,evoker,preservation,29,13,16
Varaug,veklor,973,evoker,preservation,23,14,9
Slashlowe,archimonde,972,evoker,preservation,36,17,19
Ecovoker,outland,960,evoker,preservation,18,10,8
Бедныйгрузин,howling-fjord,960,evoker,preservation,18,10,8
Nyghtx,sanguino,960,evoker,preservation,18,10,8
Salamanderx,stormscale,959,evoker,preservation,12,10,2
Kaipha,ravencrest,959,evoker,preservation,18,10,8
Béatér,aegwynn,959,evoker,preservation,18,10,8
Jimmytrivet,archimonde,950,evoker,preservation,21,10,11
Draklorn,moonglade,935,evoker,preservation,12,10,2
Vozzat,stormscale,934,evoker,preservation,24,11,13
Cárried,twilights-hammer,902,evoker,preservation,33,11,22
Canitabravar,cthun,898,evoker,preservation,60,30,30
Marasz,silvermoon,893,evoker,preservation,42,22,20
Eosin,blackrock,890,evoker,preservation,23,10,13
Moondraka,outland,864,evoker,preservation,18,9,9
Smâûg,silvermoon,864,evoker,preservation,18,9,9
Hool,silvermoon,864,evoker,preservation,48,21,27
Мишанячешуя,gordunni,863,evoker,preservation,12,9,3
Cupcâke,dalaran,863,evoker,preservation,18,9,9
Sissilisko,sylvanas,861,evoker,preservation,12,9,3
Blazeros,sylvanas,861,evoker,preservation,36,15,21
Mistvoke,kazzak,860,evoker,preservation,18,9,9
Lithnxv,bladefist,859,evoker,preservation,18,9,9
Erhvoker,veknilash,858,evoker,preservation,27,10,17
Amaterãsu,kazzak,855,evoker,preservation,18,9,9
Javåscript,outland,849,evoker,preservation,18,9,9
Evok,deathwing,835,evoker,preservation,18,9,9
Viseriðn,archimonde,827,evoker,preservation,24,9,15
Мэриджэин,soulflayer,809,evoker,preservation,21,9,12
Jhoanna,grim-batol,804,evoker,preservation,18,9,9
Верметор,soulflayer,790,evoker,preservation,60,15,45
Humòngóus,kazzak,768,evoker,preservation,12,8,4
Jmy,bloodhoof,768,evoker,preservation,12,8,4
Nst,zuljin,768,evoker,preservation,12,8,4
Zendaë,archimonde,768,evoker,preservation,12,8,4
Bümber,stormscale,768,evoker,preservation,18,8,10
Ringil,tarren-mill,768,evoker,preservation,18,8,10
Crottedezen,archimonde,768,evoker,preservation,18,8,10
Huxleysroar,draenor,768,evoker,preservation,18,8,10
Nekrosdrake,tarren-mill,767,evoker,preservation,18,8,10
Sorextrazy,twisting-nether,765,evoker,preservation,24,8,16
Уполнамоченн,soulflayer,764,evoker,preservation,12,8,4
Nagimurr,kazzak,763,evoker,preservation,12,8,4
Gilgakek,darksorrow,763,evoker,preservation,18,8,10
Vores,norgannon,753,evoker,preservation,18,8,10
Drachi,ambossar,751,evoker,preservation,18,8,10
Drakars,kazzak,749,evoker,preservation,18,8,10
Винтер,azuregos,680,evoker,preservation,13,8,5
Sunfyres,frostmane,679,evoker,preservation,28,8,20
Profdrake,zuluhed,672,evoker,preservation,12,7,5
Dwagonzuv,the-maelstrom,672,evoker,preservation,12,7,5
Berlyvoke,stormscale,672,evoker,preservation,12,7,5
Malowux,outland,672,evoker,preservation,12,7,5
Sulführer,sanguino,672,evoker,preservation,18,7,11
Saga,aegwynn,671,evoker,preservation,12,7,5
Draaxy,twisting-nether,671,evoker,preservation,15,8,7
Smokitor,kazzak,670,evoker,preservation,12,7,5
Scalie,ravencrest,670,evoker,preservation,12,7,5
Ramfurry,kazzak,607,evoker,preservation,17,7,10
Nazalath,eonar,576,evoker,preservation,6,6,0
Gardenewt,ravencrest,576,evoker,preservation,6,6,0
Потныйдракон,soulflayer,576,evoker,preservation,12,6,6
Talynn,sylvanas,576,evoker,preservation,12,6,6
Вексалис,gordunni,576,evoker,preservation,12,6,6
Jacko,nemesis,576,evoker,preservation,12,6,6
Dedx,sylvanas,576,evoker,preservation,12,6,6
Krayvoker,tarren-mill,576,evoker,preservation,12,6,6
Mistrßroducr,stormreaver,576,evoker,preservation,12,6,6
Sindragonk,ravencrest,576,evoker,preservation,12,6,6
Sính,ravencrest,576,evoker,preservation,12,6,6
Matysniak,burning-legion,576,evoker,preservation,12,6,6
Myntara,tarren-mill,576,evoker,preservation,18,6,12
Shroudflight,draenor,576,evoker,preservation,18,6,12
Zeigrem,antonidas,575,evoker,preservation,6,6,0
Jamiewing,ravencrest,575,evoker,preservation,12,6,6
Donns,frostmane,575,evoker,preservation,12,6,6
Tarystrasza,blackrock,574,evoker,preservation,12,6,6
Schenlong,kelthuzad,574,evoker,preservation,12,6,6
Dratheon,dun-modr,574,evoker,preservation,12,6,6
Drakpojke,stormscale,574,evoker,preservation,12,6,6
Groovyy,hyjal,574,evoker,preservation,12,6,6
Dreamiee,kazzak,574,evoker,preservation,18,6,12
Dracarysfire,kazzak,573,evoker,preservation,12,6,6
Viseron,zuljin,573,evoker,preservation,15,7,8
Steeken,haomarush,572,evoker,preservation,18,6,12
Jurrassic,defias-brotherhood,571,evoker,preservation,12,6,6
Rasalhague,uldum,522,evoker,preservation,15,6,9
Dracarysx,grim-batol,520,evoker,preservation,15,7,8
Choubalo,archimonde,520,evoker,preservation,22,9,13
Alamostrasza,doomhammer,480,evoker,preservation,6,5,1
Sürion,grim-batol,480,evoker,preservation,6,5,1
Branados,argent-dawn,480,evoker,preservation,6,5,1
Zemar,dalaran,480,evoker,preservation,6,5,1
Holyvoker,aegwynn,480,evoker,preservation,6,5,1
Chasxstrasza,ravencrest,480,evoker,preservation,12,5,7
Gardennewt,ravencrest,480,evoker,preservation,12,5,7
Óceiros,silvermoon,480,evoker,preservation,12,5,7
Evokoloko,outland,480,evoker,preservation,12,5,7
Nemrák,blackmoore,480,evoker,preservation,12,5,7
Lìssàndra,argent-dawn,480,evoker,preservation,18,5,13
Scaleflux,argent-dawn,479,evoker,preservation,12,5,7
Kärlethos,dun-modr,478,evoker,preservation,12,5,7
Widow,chromaggus,478,evoker,preservation,12,5,7
Anso,sanguino,478,evoker,preservation,12,5,7
Fodom,medivh,477,evoker,preservation,12,5,7
Эфирид,blackscar,443,evoker,preservation,11,5,6
Grajade,dun-modr,422,evoker,preservation,15,6,9
Bindrasz,ahnqiraj,384,evoker,preservation,6,4,2
Esalisko,kazzak,384,evoker,preservation,6,4,2
Crocodeal,ysondre,384,evoker,preservation,6,4,2
Kremost,sylvanas,384,evoker,preservation,6,4,2
Vizdraken,tarren-mill,384,evoker,preservation,6,4,2
Darigo,ravencrest,384,evoker,preservation,6,4,2
Dreamwalk,archimonde,384,evoker,preservation,6,4,2
Etier,aegwynn,384,evoker,preservation,6,4,2
Drakeish,kazzak,384,evoker,preservation,6,4,2
Nhoru,stormscale,384,evoker,preservation,6,4,2
Polzeig,dentarg,384,evoker,preservation,6,4,2
Toílet,blackmoore,384,evoker,preservation,12,4,8
Evokker,antonidas,384,evoker,preservation,12,4,8
Killafoolz,kazzak,384,evoker,preservation,12,4,8
Dracum,kazzak,384,evoker,preservation,12,4,8
Chronowalker,ragnaros,384,evoker,preservation,12,4,8
Karristrasza,silvermoon,384,evoker,preservation,12,4,8
Deadfyre,dun-modr,383,evoker,preservation,6,4,2
Кефтыме,soulflayer,383,evoker,preservation,6,4,2
Entombevoker,twisting-nether,383,evoker,preservation,6,4,2
Yaldthion,dun-modr,383,evoker,preservation,18,4,14
Steadyop,doomhammer,382,evoker,preservation,6,4,2
Yadormi,sylvanas,379,evoker,preservation,18,4,14
Valtion,stormscale,288,evoker,preservation,6,3,3
Escaaboy,stormscale,288,evoker,preservation,6,3,3
Reptak,stormscale,288,evoker,preservation,6,3,3
Raegos,ravencrest,288,evoker,preservation,6,3,3
Meezyevo,ragnaros,288,evoker,preservation,6,3,3
Primepewpew,ragnaros,288,evoker,preservation,6,3,3
Samidr,ravencrest,288,evoker,preservation,6,3,3
Jmý,tarren-mill,288,evoker,preservation,6,3,3
Bluesaphir,ravencrest,288,evoker,preservation,6,3,3
Alanikus,silvermoon,288,evoker,preservation,6,3,3
Apaçi,ravencrest,288,evoker,preservation,6,3,3
Keizal,twisting-nether,288,evoker,preservation,6,3,3
Renalia,blackrock,288,evoker,preservation,6,3,3
Colacorta,zuljin,288,evoker,preservation,6,3,3
Cragheart,ravencrest,288,evoker,preservation,6,3,3
Viseriøn,kazzak,288,evoker,preservation,6,3,3
Indragon,blackmoore,288,evoker,preservation,6,3,3
Distinkd,draenor,288,evoker,preservation,6,3,3
Raøug,blackmoore,288,evoker,preservation,6,3,3
Botomforgold,ravencrest,288,evoker,preservation,6,3,3
Deathwingx,sylvanas,288,evoker,preservation,6,3,3
Baszz,aegwynn,288,evoker,preservation,6,3,3
Kirivoker,dun-modr,288,evoker,preservation,6,3,3
Draelaynex,eredar,288,evoker,preservation,6,3,3
Nezruslfarm,cthun,288,evoker,preservation,6,3,3
Sondosa,twisting-nether,288,evoker,preservation,6,3,3
Jmyzard,tarren-mill,288,evoker,preservation,6,3,3
Pruttburk,draenor,288,evoker,preservation,6,3,3
Evokimag,grim-batol,288,evoker,preservation,6,3,3
Nahkiainen,darksorrow,288,evoker,preservation,6,3,3
Vyore,silvermoon,288,evoker,preservation,6,3,3
Fusanabide,kazzak,288,evoker,preservation,8,3,5
Dokkàmxk,archimonde,288,evoker,preservation,12,3,9
Bemil,twisting-nether,288,evoker,preservation,12,3,9
Monftroglou,archimonde,288,evoker,preservation,12,3,9
Reelona,silvermoon,288,evoker,preservation,12,3,9
Mfdragon,grim-batol,288,evoker,preservation,12,3,9
Horiz,kazzak,288,evoker,preservation,12,3,9
Smrdimipytel,drakthul,288,evoker,preservation,16,3,13
Anlong,alakir,287,evoker,preservation,11,3,8
Elexatra,hyjal,287,evoker,preservation,12,3,9
Тирдде,deathweaver,286,evoker,preservation,6,3,3
Agnî,sanguino,240,evoker,preservation,9,3,6
Smoochbumble,argent-dawn,240,evoker,preservation,9,3,6
Baranzion,twisting-nether,207,evoker,preservation,8,3,5
Eryot,aggra-português,192,evoker,preservation,6,2,4
Parodize,thrall,192,evoker,preservation,6,2,4
Flipflapflop,twisting-nether,192,evoker,preservation,6,2,4
Sheràqt,blackrock,192,evoker,preservation,6,2,4
Wernøker,archimonde,192,evoker,preservation,6,2,4
Høt,nemesis,192,evoker,preservation,6,2,4
Freesckretx,archimonde,192,evoker,preservation,6,2,4
Glurak,stormscale,192,evoker,preservation,6,2,4
Dragonzo,arathor,192,evoker,preservation,6,2,4
Arniye,ravencrest,192,evoker,preservation,6,2,4
Iwaavoker,archimonde,192,evoker,preservation,6,2,4
Nickydragonx,stormscale,192,evoker,preservation,6,2,4
Dno,archimonde,192,evoker,preservation,6,2,4
Dracanus,bronze-dragonflight,192,evoker,preservation,6,2,4
Mistime,twisting-nether,192,evoker,preservation,6,2,4
Spacebreath,ravencrest,192,evoker,preservation,6,2,4
Azurog,blackmoore,192,evoker,preservation,6,2,4
Puzzles,ravencrest,192,evoker,preservation,6,2,4
Pureshot,archimonde,192,evoker,preservation,6,2,4
Lînkôs,aegwynn,192,evoker,preservation,6,2,4
Crazylucifer,kazzak,192,evoker,preservation,6,2,4
Голденджо,gordunni,192,evoker,preservation,11,2,9
Xerragon,ravencrest,192,evoker,preservation,12,2,10
Pico,madmortem,192,evoker,preservation,12,2,10
Мизурион,gordunni,191,evoker,preservation,6,2,4
Гарил,grom,191,evoker,preservation,6,2,4
Touge,varimathras,191,evoker,preservation,6,2,4
Morsan,tichondrius,191,evoker,preservation,6,2,4
Eldrax,emerald-dream,159,evoker,preservation,5,2,3
Zerario,blackhand,159,evoker,preservation,5,2,3
Zzaazaa,argent-dawn,137,evoker,preservation,10,3,7
Odiin,dun-modr,96,evoker,preservation,3,2,1
Hakuzah,terokkar,96,evoker,preservation,6,1,5
Iblvicanfly,stormscale,96,evoker,preservation,6,1,5
Margouillax,archimonde,96,evoker,preservation,6,1,5
Mulqahdiiv,archimonde,96,evoker,preservation,6,1,5
Kitoed,aegwynn,96,evoker,preservation,6,1,5
Reska,archimonde,96,evoker,preservation,6,1,5
Dragorasi,frostwolf,96,evoker,preservation,6,1,5
Kuramir,twisting-nether,96,evoker,preservation,6,1,5
Ch,ghostlands,96,evoker,preservation,6,1,5
Смехокрыл,deathguard,96,evoker,preservation,6,1,5
Kurger,twisting-nether,96,evoker,preservation,6,1,5
Brystrasza,quelthalas,96,evoker,preservation,6,1,5
Галактиг,thermaplugg,96,evoker,preservation,6,1,5
Ezinice,hyjal,96,evoker,preservation,6,1,5
Cadwalader,blades-edge,96,evoker,preservation,6,1,5
Kaezmasterx,blackrock,96,evoker,preservation,6,1,5
Targzæ,hyjal,96,evoker,preservation,6,1,5
Stjáuni,ravencrest,96,evoker,preservation,16,2,14
Sopollina,draenor,96,evoker,preservation,12,1,11
Âbs,archimonde,96,evoker,preservation,12,1,11
Kamings,outland,95,evoker,preservation,7,1,6
Fluffykoi,silvermoon,95,evoker,preservation,12,1,11
ßëkûsåùrús,ragnaros,79,evoker,preservation,5,1,4
Drakenyasha,tarren-mill,2109,evoker,devastation,87,44,43
Kàido,ravencrest,2035,evoker,devastation,120,62,58
Babodrake,blackhand,2019,evoker,devastation,55,27,28
Wexvoker,darksorrow,1961,evoker,devastation,50,31,19
Eldunaries,argent-dawn,1896,evoker,devastation,78,43,35
Hollowbreath,sanguino,1845,evoker,devastation,90,47,43
Rexzstrasza,eredar,1841,evoker,devastation,54,31,23
Lizardbøi,blackhand,1827,evoker,devastation,66,33,33
Драгонтьма,gordunni,1823,evoker,devastation,65,33,32
Amadeusx,ravencrest,1810,evoker,devastation,55,30,25
Sârmikas,blackhand,1808,evoker,devastation,48,26,22
Brokz,twisting-nether,1806,evoker,devastation,30,19,11
Xzvoker,kazzak,1800,evoker,devastation,54,29,25
Avë,kazzak,1790,evoker,devastation,71,36,35
Mizamiza,blackrock,1786,evoker,devastation,65,35,30
Animenorgam,alakir,1779,evoker,devastation,36,30,6
Jamiewing,ravencrest,1767,evoker,devastation,47,28,19
Bigmacfrite,ysondre,1761,evoker,devastation,52,25,27
Ízma,ravencrest,1741,evoker,devastation,102,49,53
Korvi,ravencrest,1733,evoker,devastation,32,19,13
Хетсв,gordunni,1719,evoker,devastation,90,53,37
Kymaíra,hyjal,1716,evoker,devastation,48,22,26
Ironwing,sanguino,1702,evoker,devastation,171,97,74
Papayoyo,draenor,1693,evoker,devastation,120,59,61
Ruinastrasza,silvermoon,1680,evoker,devastation,107,54,53
Irvethius,argent-dawn,1675,evoker,devastation,66,30,36
Sürion,grim-batol,1641,evoker,devastation,54,30,24
Hanoostrasz,tarren-mill,1629,evoker,devastation,43,26,17
Dracoli,eredar,1625,evoker,devastation,42,23,19
Merkels,blackmoore,1617,evoker,devastation,39,23,16
Dracohfeu,archimonde,1617,evoker,devastation,30,17,13
Ghiscar,dentarg,1610,evoker,devastation,45,26,19
Draxxys,blackmoore,1607,evoker,devastation,48,23,25
Мнякуня,howling-fjord,1600,evoker,devastation,46,24,22
Denegos,sylvanas,1594,evoker,devastation,48,30,18
Cûddles,hyjal,1589,evoker,devastation,90,48,42
Ðø,antonidas,1589,evoker,devastation,35,18,17
Krothus,outland,1588,evoker,devastation,82,46,36
Спайрок,gordunni,1586,evoker,devastation,53,25,28
Lilpooper,bloodhoof,1583,evoker,devastation,33,20,13
Ludwoker,tarren-mill,1577,evoker,devastation,61,40,21
Famouszorc,sanguino,1574,evoker,devastation,71,43,28
Фиамниэль,gordunni,1574,evoker,devastation,36,18,18
Yuhabahha,kazzak,1569,evoker,devastation,76,39,37
Snoby,onyxia,1552,evoker,devastation,51,25,26
Ch,ghostlands,1551,evoker,devastation,41,20,21
Serulyon,draenor,1546,evoker,devastation,36,18,18
Tetsú,tarren-mill,1541,evoker,devastation,36,20,16
Kayly,twisting-nether,1538,evoker,devastation,36,26,10
Caliss,archimonde,1532,evoker,devastation,44,27,17
Edvoker,twisting-nether,1527,evoker,devastation,30,16,14
Sawk,archimonde,1522,evoker,devastation,30,19,11
Agnî,sanguino,1521,evoker,devastation,58,29,29
Oontäälihis,ravencrest,1509,evoker,devastation,36,16,20
Yála,anetheron,1506,evoker,devastation,120,63,57
Drazam,blackrock,1503,evoker,devastation,41,25,16
Tibimbo,blackrock,1503,evoker,devastation,50,29,21
Ocanada,draenor,1495,evoker,devastation,30,17,13
Dracyan,taerar,1479,evoker,devastation,42,24,18
Shimmerscale,blackhand,1462,evoker,devastation,65,34,31
Pêengei,blackrock,1456,evoker,devastation,30,16,14
Malfoyer,arathor,1451,evoker,devastation,48,27,21
Tezkaz,blackmoore,1440,evoker,devastation,53,22,31
Нерфсрочно,gordunni,1435,evoker,devastation,36,15,21
Саммеракс,gordunni,1422,evoker,devastation,36,15,21
Dowaa,tarren-mill,1414,evoker,devastation,30,15,15
Инсейнмэн,soulflayer,1400,evoker,devastation,36,16,20
Pippomale,nemesis,1388,evoker,devastation,30,16,14
Darktempest,onyxia,1387,evoker,devastation,36,20,16
Drunkino,aegwynn,1376,evoker,devastation,30,16,14
Ксдз,soulflayer,1368,evoker,devastation,42,20,22
Ken,la-croisade-écarlate,1358,evoker,devastation,42,19,23
Twodeep,blackrock,1342,evoker,devastation,24,14,10
Yoshinora,archimonde,1337,evoker,devastation,30,15,15
Valdrakon,doomhammer,1336,evoker,devastation,24,14,10
Rowzy,sylvanas,1332,evoker,devastation,47,21,26
Favill,blackhand,1318,evoker,devastation,45,18,27
Parisinka,silvermoon,1304,evoker,devastation,75,37,38
Llael,blackhand,1265,evoker,devastation,81,34,47
Xtdrakaris,uldum,1260,evoker,devastation,113,50,63
Дреадди,soulflayer,1246,evoker,devastation,21,14,7
Fyndassil,blackrock,1245,evoker,devastation,36,13,23
Drákon,dalaran,1238,evoker,devastation,24,13,11
Arbylegion,outland,1237,evoker,devastation,18,13,5
Tokzestra,hyjal,1235,evoker,devastation,57,26,31
Lagerstrasza,stormreaver,1234,evoker,devastation,30,13,17
Baroqs,antonidas,1226,evoker,devastation,18,13,5
Dragonaked,silvermoon,1220,evoker,devastation,42,18,24
Isizzu,draenor,1205,evoker,devastation,73,37,36
Iolite,dun-modr,1156,evoker,devastation,30,17,13
Dispelgodx,eredar,1149,evoker,devastation,24,12,12
Darkssoul,outland,1149,evoker,devastation,36,12,24
Nuvese,tarren-mill,1147,evoker,devastation,24,12,12
Углекислот,howling-fjord,1147,evoker,devastation,30,12,18
Zaralek,stormscale,1145,evoker,devastation,18,12,6
Dragoncloak,blackrock,1134,evoker,devastation,30,20,10
Nazalath,eonar,1134,evoker,devastation,31,13,18
Sleepnot,argent-dawn,1121,evoker,devastation,18,12,6
Gharløk,outland,1118,evoker,devastation,32,14,18
Ahiresegyfej,ragnaros,1091,evoker,devastation,24,14,10
Evojøa,tarren-mill,1056,evoker,devastation,18,11,7
Homeoffice,zenedar,1055,evoker,devastation,18,11,7
Jamzyevoker,emerald-dream,1055,evoker,devastation,21,12,9
Cinnannoe,tarren-mill,1047,evoker,devastation,24,11,13
Коляомон,gordunni,1036,evoker,devastation,18,11,7
Flaminghot,stormreaver,1034,evoker,devastation,97,51,46
Рептилойдина,howling-fjord,1030,evoker,devastation,24,11,13
Airbourne,sanguino,1022,evoker,devastation,26,15,11
Алыйкиви,howling-fjord,1016,evoker,devastation,21,12,9
Lesgrossman,ravencrest,960,evoker,devastation,18,10,8
Evokimag,grim-batol,958,evoker,devastation,24,10,14
Maccen,twisting-nether,955,evoker,devastation,18,10,8
Enzospatalo,nemesis,955,evoker,devastation,18,10,8
Cuufizix,silvermoon,952,evoker,devastation,18,10,8
Steeken,haomarush,952,evoker,devastation,24,10,14
Øseria,khaz-modan,950,evoker,devastation,18,10,8
Childofdawn,blackmoore,949,evoker,devastation,18,10,8
Душнот,fordragon,948,evoker,devastation,18,10,8
Leskano,aegwynn,948,evoker,devastation,24,12,12
Scalo,kazzak,935,evoker,devastation,17,10,7
Donairian,doomhammer,910,evoker,devastation,48,24,24
Sleipnyr,garrosh,882,evoker,devastation,30,12,18
Shaze,zuljin,879,evoker,devastation,17,10,7
Быковскии,howling-fjord,871,evoker,devastation,30,16,14
Гневиан,eversong,864,evoker,devastation,12,9,3
Yimvoker,blackrock,864,evoker,devastation,18,9,9
Kmzi,twisting-nether,864,evoker,devastation,18,9,9
Hëroinhenry,tarren-mill,863,evoker,devastation,12,9,3
Лабриса,galakrond,863,evoker,devastation,18,9,9
Рогатыйдебик,gordunni,863,evoker,devastation,18,9,9
Mommystrasza,dentarg,863,evoker,devastation,18,9,9
Аймбадикабтв,howling-fjord,863,evoker,devastation,18,9,9
Туймаада,soulflayer,862,evoker,devastation,12,9,3
Blasto,tarren-mill,858,evoker,devastation,24,9,15
Флардикас,gordunni,842,evoker,devastation,24,9,15
Dragonhero,arygos,830,evoker,devastation,36,16,20
Mazakqt,draenor,768,evoker,devastation,12,8,4
Meust,blackrock,768,evoker,devastation,12,8,4
Пивнаябошка,soulflayer,768,evoker,devastation,12,8,4
Ларенил,gordunni,768,evoker,devastation,18,8,10
Balthinar,argent-dawn,768,evoker,devastation,18,8,10
Ipanicsoar,tarren-mill,735,evoker,devastation,17,8,9
Claxy,ragnaros,672,evoker,devastation,12,7,5
Эбиб,gordunni,672,evoker,devastation,12,7,5
Zmej,twisting-nether,672,evoker,devastation,12,7,5
Кунидракон,gordunni,672,evoker,devastation,18,7,11
Dschíses,malganis,671,evoker,devastation,12,7,5
Tenshà,nemesis,671,evoker,devastation,12,7,5
Enemi,twisting-nether,669,evoker,devastation,14,9,5
Fruhans,tarren-mill,667,evoker,devastation,12,7,5
Akúda,blackhand,667,evoker,devastation,12,7,5
Scalash,drakthul,658,evoker,devastation,12,7,5
Zharas,nemesis,623,evoker,devastation,11,7,4
Sintharion,ravencrest,618,evoker,devastation,27,9,18
Dovakin,arathi,601,evoker,devastation,14,7,7
Zpartadraga,ragnaros,584,evoker,devastation,9,8,1
Scathethrel,draenor,576,evoker,devastation,12,6,6
Mattyastrasz,hyjal,576,evoker,devastation,12,6,6
Krazuntus,argent-dawn,576,evoker,devastation,12,6,6
Potéto,rashgarroth,576,evoker,devastation,12,6,6
Saragoza,kirin-tor,576,evoker,devastation,12,6,6
Terrorclaw,ragnaros,576,evoker,devastation,12,6,6
Khimari,xavius,576,evoker,devastation,12,6,6
Xfckd,ragnaros,575,evoker,devastation,12,6,6
Xatures,twisting-nether,572,evoker,devastation,6,6,0
Dragonlia,blackrock,480,evoker,devastation,6,5,1
Swapxyevo,ravencrest,480,evoker,devastation,6,5,1
Fayral,blackmoore,480,evoker,devastation,6,5,1
Bindrasz,ahnqiraj,480,evoker,devastation,12,5,7
Dracnass,silvermoon,480,evoker,devastation,12,5,7
Dragonide,draenor,480,evoker,devastation,12,5,7
Pavelito,ysondre,480,evoker,devastation,12,5,7
Hyperflexx,blackrock,480,evoker,devastation,12,5,7
Atoll,scarshield-legion,480,evoker,devastation,18,5,13
Sloeez,kazzak,480,evoker,devastation,18,5,13
Dakir,blackmoore,479,evoker,devastation,6,5,1
Canitabravar,cthun,479,evoker,devastation,6,5,1
Vermithors,ravencrest,479,evoker,devastation,12,5,7
Ekko,nethersturm,478,evoker,devastation,12,5,7
Lugarius,gilneas,477,evoker,devastation,16,6,10
Syraxis,shadowsong,415,evoker,devastation,10,5,5
Штеци,howling-fjord,384,evoker,devastation,6,4,2
Deathdream,stormscale,384,evoker,devastation,6,4,2
Wurm,shadowsong,384,evoker,devastation,6,4,2
Yol,bladefist,384,evoker,devastation,6,4,2
Iblvicanfly,stormscale,384,evoker,devastation,6,4,2
Nathraakhza,argent-dawn,384,evoker,devastation,6,4,2
Nochance,dentarg,384,evoker,devastation,6,4,2
Elitedraach,tarren-mill,384,evoker,devastation,6,4,2
Pinacóladaqt,stormscale,384,evoker,devastation,6,4,2
Melodio,outland,384,evoker,devastation,6,4,2
Advancedboy,archimonde,384,evoker,devastation,6,4,2
Glurakk,aegwynn,384,evoker,devastation,6,4,2
Draghad,blackmoore,384,evoker,devastation,6,4,2
Sharaxis,blackmoore,384,evoker,devastation,12,4,8
Duvahkahr,ragnaros,384,evoker,devastation,12,4,8
Croker,ravencrest,384,evoker,devastation,12,4,8
Jeannedebruj,ravencrest,384,evoker,devastation,18,4,14
Dragomakry,blackmoore,383,evoker,devastation,6,4,2
Hekatonshire,hyjal,383,evoker,devastation,6,4,2
Morsan,tichondrius,383,evoker,devastation,6,4,2
Thebigsmoke,lightbringer,383,evoker,devastation,12,4,8
Davioncz,thunderhorn,382,evoker,devastation,6,4,2
Rîncêwind,uldum,382,evoker,devastation,6,4,2
Sheego,anetheron,382,evoker,devastation,6,4,2
Kayizer,archimonde,382,evoker,devastation,6,4,2
Drakea,sanguino,367,evoker,devastation,17,4,13
Ryújín,blackhand,335,evoker,devastation,11,4,7
Somntersu,argent-dawn,319,evoker,devastation,5,4,1
Lago,gorgonnash,303,evoker,devastation,7,4,3
Drachenwut,aegwynn,288,evoker,devastation,6,3,3
Predictrash,archimonde,288,evoker,devastation,6,3,3
Pêrcevâl,archimonde,288,evoker,devastation,6,3,3
Geckonen,stormreaver,288,evoker,devastation,6,3,3
Azurog,blackmoore,288,evoker,devastation,6,3,3
Feldrac,ravencrest,288,evoker,devastation,6,3,3
Nerfmeplze,outland,288,evoker,devastation,6,3,3
Sakade,archimonde,288,evoker,devastation,6,3,3
Dracofeuxd,archimonde,288,evoker,devastation,6,3,3
Feinerkerl,blackmoore,288,evoker,devastation,6,3,3
Dracofion,ravencrest,288,evoker,devastation,6,3,3
Ughvoker,kazzak,288,evoker,devastation,6,3,3
Malowux,outland,288,evoker,devastation,6,3,3
Драккалис,eversong,288,evoker,devastation,6,3,3
Lektar,eredar,288,evoker,devastation,6,3,3
Dracsamdi,tarren-mill,288,evoker,devastation,6,3,3
Azustraza,ysondre,288,evoker,devastation,6,3,3
Draxone,malfurion,288,evoker,devastation,6,3,3
Ðragøn,argent-dawn,288,evoker,devastation,6,3,3
Zettaflare,nazjatar,288,evoker,devastation,6,3,3
Mollÿ,sanguino,288,evoker,devastation,6,3,3
Magmarôs,argent-dawn,288,evoker,devastation,6,3,3
Varagon,rexxar,288,evoker,devastation,6,3,3
Deathwingx,sylvanas,288,evoker,devastation,6,3,3
Hömeöffice,sylvanas,288,evoker,devastation,6,3,3
Ryuu,mazrigos,288,evoker,devastation,6,3,3
Шотнутый,soulflayer,288,evoker,devastation,9,4,5
Haltorr,ravencrest,288,evoker,devastation,12,3,9
Evosker,zuljin,288,evoker,devastation,12,3,9
Stefanosxios,bloodfeather,288,evoker,devastation,12,3,9
Valdrakken,anubarak,288,evoker,devastation,12,3,9
Hästdrake,the-maelstrom,288,evoker,devastation,12,3,9
Belianf,silvermoon,287,evoker,devastation,6,3,3
Stormydude,doomhammer,286,evoker,devastation,6,3,3
Филлид,gordunni,255,evoker,devastation,8,4,4
Azzul,teldrassil,233,evoker,devastation,6,4,2
Bæxo,blackrock,192,evoker,devastation,6,2,4
Ellphi,illidan,192,evoker,devastation,6,2,4
Ppiaxx,dalaran,192,evoker,devastation,6,2,4
Vynestria,argent-dawn,192,evoker,devastation,6,2,4
Burnrate,draenor,192,evoker,devastation,6,2,4
Kda,die-nachtwache,192,evoker,devastation,6,2,4
Twokgbananas,blackhand,192,evoker,devastation,6,2,4
Adamâs,archimonde,192,evoker,devastation,6,2,4
Draaxy,twisting-nether,192,evoker,devastation,6,2,4
Дракомант,eversong,192,evoker,devastation,12,2,10
Tenkenfutsu,elune,192,evoker,devastation,18,2,16
Kraakraa,turalyon,191,evoker,devastation,6,2,4
Piyuli,silvermoon,159,evoker,devastation,5,2,3
Gypsydrake,tarren-mill,159,evoker,devastation,8,3,5
Kirien,blackhand,96,evoker,devastation,6,1,5
Terrorwings,twisting-nether,96,evoker,devastation,6,1,5
Oeos,dragonblight,96,evoker,devastation,6,1,5
Кеннокс,soulflayer,96,evoker,devastation,6,1,5
Oldlizard,blackrock,96,evoker,devastation,6,1,5
Dracarysfire,kazzak,96,evoker,devastation,6,1,5
Släshés,ravencrest,96,evoker,devastation,6,1,5
Asharys,argent-dawn,96,evoker,devastation,6,1,5
Xidalulz,sylvanas,63,evoker,devastation,2,2,0
Bulydracguir,kazzak,42,evoker,devastation,7,2,5
Âspên,archimonde,31,evoker,devastation,2,1,1
Pjållistani,ravencrest,2143,hunter,marksmanship,72,49,23
Мартидэн,howling-fjord,1973,hunter,marksmanship,95,47,48
Stavfel,kazzak,1952,hunter,marksmanship,71,37,34
Nennimi,ravencrest,1941,hunter,marksmanship,63,35,28
Душнила,razuvious,1898,hunter,marksmanship,83,44,39
Huprah,ravencrest,1881,hunter,marksmanship,66,35,31
Matasso,burning-legion,1849,hunter,marksmanship,53,30,23
Yasuohasagi,archimonde,1828,hunter,marksmanship,42,23,19
Evacuatur,argent-dawn,1826,hunter,marksmanship,66,33,33
Bestregards,ravencrest,1819,hunter,marksmanship,48,22,26
Techpoint,silvermoon,1816,hunter,marksmanship,42,27,15
Crôwley,twisting-nether,1816,hunter,marksmanship,54,30,24
Xanter,blackrock,1806,hunter,marksmanship,36,20,16
Hallé,frostmane,1769,hunter,marksmanship,66,39,27
Ceitronox,argent-dawn,1765,hunter,marksmanship,42,23,19
Murtagh,khaz-modan,1739,hunter,marksmanship,54,28,26
Ancalarion,tarren-mill,1717,hunter,marksmanship,42,21,21
Mogwai,stormscale,1698,hunter,marksmanship,47,23,24
Bearmane,tarren-mill,1682,hunter,marksmanship,59,31,28
Ремонтлицаа,gordunni,1670,hunter,marksmanship,75,45,30
Jabela,eredar,1668,hunter,marksmanship,78,35,43
Wildheárt,aegwynn,1659,hunter,marksmanship,42,23,19
Alêx,outland,1649,hunter,marksmanship,48,22,26
Evengance,dragonblight,1638,hunter,marksmanship,42,32,10
Травок,gordunni,1634,hunter,marksmanship,34,24,10
Speedhack,argent-dawn,1626,hunter,marksmanship,57,31,26
Trashcarlito,eredar,1619,hunter,marksmanship,24,17,7
Minisay,magtheridon,1602,hunter,marksmanship,148,75,73
Scheixanter,drakthul,1597,hunter,marksmanship,59,25,34
Johnreapèr,sylvanas,1588,hunter,marksmanship,44,21,23
Recrent,kazzak,1578,hunter,marksmanship,48,28,20
Лисатия,gordunni,1562,hunter,marksmanship,48,22,26
Lebalaffré,arathi,1557,hunter,marksmanship,53,29,24
Мизэрица,soulflayer,1556,hunter,marksmanship,54,26,28
Mantinell,hellfire,1553,hunter,marksmanship,36,20,16
Килофвратх,gordunni,1545,hunter,marksmanship,36,18,18
Desudi,tarren-mill,1534,hunter,marksmanship,47,22,25
Chaussons,kazzak,1532,hunter,marksmanship,42,22,20
Адвентурер,howling-fjord,1531,hunter,marksmanship,42,22,20
Rattentäter,alexstrasza,1526,hunter,marksmanship,48,26,22
Vavabxl,ysondre,1524,hunter,marksmanship,42,22,20
Mînérvá,blackhand,1521,hunter,marksmanship,48,31,17
Elja,laughing-skull,1521,hunter,marksmanship,30,19,11
Vangeroth,kazzak,1510,hunter,marksmanship,69,37,32
Yarnvid,twisting-nether,1494,hunter,marksmanship,42,21,21
Szybky,defias-brotherhood,1488,hunter,marksmanship,48,24,24
Doncar,stormscale,1486,hunter,marksmanship,33,17,16
Summa,silvermoon,1482,hunter,marksmanship,54,26,28
Balamut,aegwynn,1471,hunter,marksmanship,65,37,28
Inayah,outland,1465,hunter,marksmanship,55,28,27
Kariss,khaz-modan,1464,hunter,marksmanship,54,24,30
Rex,chamber-of-aspects,1454,hunter,marksmanship,39,23,16
Autoturret,eredar,1454,hunter,marksmanship,48,24,24
Хальвеген,gordunni,1452,hunter,marksmanship,64,30,34
Meinkoenig,frostwolf,1448,hunter,marksmanship,48,30,18
Hunsed,sanguino,1445,hunter,marksmanship,36,23,13
Asthorio,stormscale,1442,hunter,marksmanship,83,36,47
Джоуе,ashenvale,1437,hunter,marksmanship,30,15,15
Luuszapfae,aegwynn,1436,hunter,marksmanship,29,16,13
Nagu,antonidas,1435,hunter,marksmanship,30,15,15
Iilac,argent-dawn,1422,hunter,marksmanship,126,77,49
Kalima,malfurion,1416,hunter,marksmanship,72,28,44
Velrox,blackmoore,1414,hunter,marksmanship,36,15,21
Pickaboo,defias-brotherhood,1386,hunter,marksmanship,48,20,28
Carpante,nemesis,1383,hunter,marksmanship,42,17,25
Дисконнэктор,soulflayer,1374,hunter,marksmanship,48,17,31
Dexter,ravencrest,1365,hunter,marksmanship,35,15,20
Elonyr,sanguino,1365,hunter,marksmanship,113,46,67
Slmao,tarren-mill,1357,hunter,marksmanship,42,18,24
Zirgoo,outland,1355,hunter,marksmanship,30,15,15
Gugenot,tarren-mill,1352,hunter,marksmanship,33,16,17
Amphi,stormscale,1350,hunter,marksmanship,24,16,8
Selaesa,chamber-of-aspects,1345,hunter,marksmanship,36,18,18
Будкусломаю,grom,1345,hunter,marksmanship,41,16,25
Cenaa,ragnaros,1343,hunter,marksmanship,19,14,5
Skillzone,silvermoon,1340,hunter,marksmanship,30,14,16
Lowcaskor,turalyon,1335,hunter,marksmanship,24,14,10
Naid,lordaeron,1333,hunter,marksmanship,24,14,10
Røxxilia,blackmoore,1333,hunter,marksmanship,48,20,28
Glad,argent-dawn,1333,hunter,marksmanship,55,21,34
Lincolne,ravencrest,1328,hunter,marksmanship,35,15,20
Deadfire,hyjal,1325,hunter,marksmanship,42,20,22
Mindgap,pozzo-delleternità,1325,hunter,marksmanship,30,14,16
Skohal,draenor,1312,hunter,marksmanship,43,23,20
Arrowdoxx,silvermoon,1310,hunter,marksmanship,117,51,66
Оленнька,howling-fjord,1306,hunter,marksmanship,24,14,10
Iòvól,azuremyst,1301,hunter,marksmanship,34,17,17
Samhunt,blackrock,1299,hunter,marksmanship,29,14,15
Yoúmad,draenor,1288,hunter,marksmanship,28,14,14
Booms,eonar,1287,hunter,marksmanship,36,17,19
Smitheye,argent-dawn,1287,hunter,marksmanship,48,22,26
Kyudo,ravencrest,1286,hunter,marksmanship,35,15,20
Narøs,blackhand,1281,hunter,marksmanship,42,17,25
Шимэйла,gordunni,1275,hunter,marksmanship,37,16,21
Одисенс,eversong,1267,hunter,marksmanship,39,21,18
Хантвкроксах,gordunni,1257,hunter,marksmanship,22,14,8
Bigfoot,argent-dawn,1256,hunter,marksmanship,30,14,16
Touscahunter,kazzak,1251,hunter,marksmanship,77,41,36
Narawinger,silvermoon,1239,hunter,marksmanship,30,16,14
Shedzargo,twisting-nether,1234,hunter,marksmanship,24,13,11
Fränko,ravencrest,1234,hunter,marksmanship,30,13,17
Babclaar,culte-de-la-rive-noire,1227,hunter,marksmanship,18,13,5
Arize,quelthalas,1204,hunter,marksmanship,67,32,35
Kendow,blackrock,1185,hunter,marksmanship,44,20,24
Elyxa,ysondre,1177,hunter,marksmanship,42,23,19
Sâetha,dun-modr,1157,hunter,marksmanship,36,14,22
Jodd,ragnaros,1152,hunter,marksmanship,24,12,12
Poatan,outland,1152,hunter,marksmanship,69,34,35
Redneckjoe,draenor,1152,hunter,marksmanship,30,13,17
Áñmy,ravencrest,1151,hunter,marksmanship,18,12,6
Myice,twisting-nether,1150,hunter,marksmanship,18,12,6
Huntrag,tarren-mill,1149,hunter,marksmanship,30,12,18
Миссклик,soulflayer,1143,hunter,marksmanship,18,12,6
Cooroona,stormrage,1119,hunter,marksmanship,24,12,12
Farmerjoee,alakir,1117,hunter,marksmanship,18,12,6
Tungusta,defias-brotherhood,1116,hunter,marksmanship,30,17,13
Сандабар,borean-tundra,1079,hunter,marksmanship,29,16,13
Opsi,area-52,1066,hunter,marksmanship,32,12,20
Swáy,twisting-nether,1064,hunter,marksmanship,184,84,100
Sisilianno,khaz-modan,1063,hunter,marksmanship,43,15,28
Анхантэй,lich-king,1059,hunter,marksmanship,94,46,48
Khregan,aerie-peak,1056,hunter,marksmanship,18,11,7
Àfpro,hyjal,1054,hunter,marksmanship,18,11,7
Eferos,quelthalas,1054,hunter,marksmanship,24,11,13
Darm,sunstrider,1054,hunter,marksmanship,24,11,13
Murkek,drakthul,1053,hunter,marksmanship,18,11,7
Thelasiel,aerie-peak,1052,hunter,marksmanship,55,26,29
Афигеннски,ashenvale,1051,hunter,marksmanship,24,11,13
Kbesagrillo,sanguino,1050,hunter,marksmanship,24,11,13
Tntabsotrap,silvermoon,1049,hunter,marksmanship,18,11,7
Винтаж,deepholm,1041,hunter,marksmanship,59,26,33
Maroxy,ragnaros,1039,hunter,marksmanship,29,11,18
Bollo,malganis,1034,hunter,marksmanship,23,11,12
Dentaar,draenor,1030,hunter,marksmanship,54,24,30
Onlystuns,sylvanas,1022,hunter,marksmanship,23,11,12
Jaýlah,draenor,1020,hunter,marksmanship,42,19,23
Slicer,arthas,1019,hunter,marksmanship,41,15,26
Rabiate,blackrock,1011,hunter,marksmanship,22,11,11
Lookmyezzy,ravencrest,990,hunter,marksmanship,20,11,9
Noobatala,tarren-mill,977,hunter,marksmanship,30,13,17
Skilachi,stormscale,960,hunter,marksmanship,24,10,14
Квит,blackscar,960,hunter,marksmanship,24,10,14
Rzeezznik,burning-legion,959,hunter,marksmanship,18,10,8
Smekminbåge,tarren-mill,959,hunter,marksmanship,18,10,8
Tiidus,burning-legion,955,hunter,marksmanship,18,10,8
Meskette,ravencrest,954,hunter,marksmanship,18,10,8
Prodanhunts,frostmane,953,hunter,marksmanship,24,10,14
Ensomnia,silvermoon,952,hunter,marksmanship,12,10,2
Azaella,tarren-mill,948,hunter,marksmanship,18,10,8
Madida,ravencrest,925,hunter,marksmanship,12,10,2
Grafhunter,antonidas,890,hunter,marksmanship,20,10,10
Laara,khaz-modan,889,hunter,marksmanship,41,16,25
Luckyshooter,nethersturm,877,hunter,marksmanship,71,32,39
Jayri,ravencrest,863,hunter,marksmanship,18,9,9
Амобарбиталх,gordunni,863,hunter,marksmanship,18,9,9
Hiðe,archimonde,862,hunter,marksmanship,12,9,3
Theuzikat,ragnaros,861,hunter,marksmanship,24,9,15
Triggaz,stormscale,846,hunter,marksmanship,29,9,20
Tomtus,aggramar,836,hunter,marksmanship,18,9,9
Куфа,blackscar,831,hunter,marksmanship,20,10,10
Greel,saurfang,791,hunter,marksmanship,24,10,14
Wìndrunner,malfurion,787,hunter,marksmanship,41,19,22
Eldrilaon,arthas,783,hunter,marksmanship,18,9,9
Azsräel,dalaran,780,hunter,marksmanship,19,9,10
Дарктеххно,howling-fjord,768,hunter,marksmanship,12,8,4
Nidaliyae,archimonde,768,hunter,marksmanship,18,8,10
Xqzmytrapz,blackrock,768,hunter,marksmanship,18,8,10
Dasimir,blackrock,767,hunter,marksmanship,18,8,10
Raegal,sanguino,767,hunter,marksmanship,18,8,10
Iniduhr,dalaran,767,hunter,marksmanship,18,8,10
Jup,elune,767,hunter,marksmanship,30,8,22
Høward,aegwynn,766,hunter,marksmanship,12,8,4
Shoót,blackmoore,766,hunter,marksmanship,18,8,10
Qmbonboni,ravencrest,765,hunter,marksmanship,18,8,10
Blackas,dun-modr,763,hunter,marksmanship,18,8,10
Sinsé,conseil-des-ombres,762,hunter,marksmanship,12,8,4
Shibai,outland,762,hunter,marksmanship,18,8,10
Wetto,ravencrest,759,hunter,marksmanship,18,8,10
Fèhn,krasus,757,hunter,marksmanship,12,8,4
Rollei,uldum,754,hunter,marksmanship,12,8,4
Ártemide,pozzo-delleternità,754,hunter,marksmanship,18,8,10
Erestor,hellfire,747,hunter,marksmanship,12,8,4
Deathøfrats,ravencrest,719,hunter,marksmanship,11,8,3
Talcaliste,archimonde,701,hunter,marksmanship,32,11,21
Dtq,silvermoon,672,hunter,marksmanship,12,7,5
Гусецап,gordunni,672,hunter,marksmanship,12,7,5
Хвоостт,gordunni,672,hunter,marksmanship,12,7,5
Агелетка,gordunni,672,hunter,marksmanship,12,7,5
Avaren,archimonde,672,hunter,marksmanship,12,7,5
Vanstro,ragnaros,672,hunter,marksmanship,12,7,5
Кисяныч,gordunni,672,hunter,marksmanship,12,7,5
Chindala,zuljin,672,hunter,marksmanship,12,7,5
Weilerz,drakthul,672,hunter,marksmanship,12,7,5
Diapositiv,draenor,672,hunter,marksmanship,12,7,5
Bigbowyahurd,draenor,672,hunter,marksmanship,12,7,5
Corrupth,outland,672,hunter,marksmanship,15,8,7
Длинноемоджо,soulflayer,672,hunter,marksmanship,18,7,11
Трольболь,eversong,672,hunter,marksmanship,18,7,11
Podroto,tyrande,672,hunter,marksmanship,18,7,11
Eldrekou,kazzak,672,hunter,marksmanship,18,7,11
Griffithstew,blackmoore,672,hunter,marksmanship,24,7,17
Онкьяр,gordunni,672,hunter,marksmanship,24,7,17
Maknamara,tarren-mill,671,hunter,marksmanship,12,7,5
Souljâh,eredar,671,hunter,marksmanship,12,7,5
Encore,sylvanas,671,hunter,marksmanship,12,7,5
Mainblu,nemesis,671,hunter,marksmanship,12,7,5
Ashrak,frostmourne,671,hunter,marksmanship,18,7,11
Gintønic,blackmoore,671,hunter,marksmanship,24,7,17
Ямакасси,thermaplugg,671,hunter,marksmanship,36,7,29
Mizumo,burning-legion,670,hunter,marksmanship,12,7,5
Deathtrapper,bronzebeard,670,hunter,marksmanship,12,7,5
Yip,twisting-nether,670,hunter,marksmanship,18,7,11
Хапмьюзик,howling-fjord,670,hunter,marksmanship,24,7,17
Lonewolfe,ravencrest,669,hunter,marksmanship,18,7,11
Fetts,silvermoon,667,hunter,marksmanship,18,7,11
Sogoru,dun-modr,637,hunter,marksmanship,15,8,7
Väärä,stormscale,636,hunter,marksmanship,11,7,4
Crétin,archimonde,617,hunter,marksmanship,20,8,12
Ofortuna,silvermoon,576,hunter,marksmanship,6,6,0
Merquryh,ravencrest,576,hunter,marksmanship,6,6,0
Nirn,ravencrest,576,hunter,marksmanship,12,6,6
Jeston,amanthul,576,hunter,marksmanship,12,6,6
Инкризшот,gordunni,576,hunter,marksmanship,12,6,6
Natchell,ysondre,576,hunter,marksmanship,12,6,6
Луврен,deepholm,576,hunter,marksmanship,12,6,6
Birgitta,jaedenar,576,hunter,marksmanship,12,6,6
Huntazt,draenor,576,hunter,marksmanship,12,6,6
Rizlay,the-maelstrom,576,hunter,marksmanship,12,6,6
Velites,aggra-português,576,hunter,marksmanship,12,6,6
Zaragattas,aggra-português,576,hunter,marksmanship,12,6,6
Shína,argent-dawn,576,hunter,marksmanship,12,6,6
Migro,sylvanas,576,hunter,marksmanship,12,6,6
Yezzu,sylvanas,576,hunter,marksmanship,15,7,8
Iceyx,stormscale,576,hunter,marksmanship,18,6,12
Setis,uldaman,576,hunter,marksmanship,24,6,18
Helioshin,pozzo-delleternità,575,hunter,marksmanship,12,6,6
Слезыотлука,howling-fjord,575,hunter,marksmanship,12,6,6
Vïcødïnë,sinstralis,575,hunter,marksmanship,12,6,6
Xesih,twisting-nether,575,hunter,marksmanship,12,6,6
Taveon,turalyon,575,hunter,marksmanship,12,6,6
Ксидре,eversong,575,hunter,marksmanship,12,6,6
Ina,tarren-mill,575,hunter,marksmanship,12,6,6
Kilölek,ragnaros,575,hunter,marksmanship,12,6,6
Tinlop,ragnaros,573,hunter,marksmanship,18,6,12
Adventures,darkmoon-faire,565,hunter,marksmanship,12,6,6
Kartouche,culte-de-la-rive-noire,565,hunter,marksmanship,12,6,6
Sauer,stormreaver,564,hunter,marksmanship,18,6,12
Calea,zirkel-des-cenarius,561,hunter,marksmanship,18,6,12
Nyjal,archimonde,480,hunter,marksmanship,6,5,1
Feelmyfurý,tarren-mill,480,hunter,marksmanship,6,5,1
Сальверди,gordunni,480,hunter,marksmanship,6,5,1
Тэуреэль,gordunni,480,hunter,marksmanship,12,5,7
Galou,ghostlands,480,hunter,marksmanship,12,5,7
Deathmarks,blackrock,480,hunter,marksmanship,12,5,7
Tavira,zuljin,480,hunter,marksmanship,12,5,7
Ðõt,ravencrest,480,hunter,marksmanship,12,5,7
Artémíss,kazzak,480,hunter,marksmanship,12,5,7
Кайсго,gordunni,480,hunter,marksmanship,12,5,7
Hï,eitrigg,480,hunter,marksmanship,12,5,7
Carrilynn,blackrock,480,hunter,marksmanship,12,5,7
Lightarròw,nordrassil,480,hunter,marksmanship,12,5,7
Carre,twilights-hammer,480,hunter,marksmanship,12,5,7
Крой,howling-fjord,480,hunter,marksmanship,12,5,7
Gromaya,elune,480,hunter,marksmanship,13,5,8
Dramin,defias-brotherhood,480,hunter,marksmanship,18,5,13
Xoarqt,aegwynn,480,hunter,marksmanship,18,5,13
Tetiscaza,sanguino,480,hunter,marksmanship,24,5,19
Bluetiger,azshara,479,hunter,marksmanship,6,5,1
Jozsiur,ragnaros,479,hunter,marksmanship,6,5,1
Nìsalle,argent-dawn,479,hunter,marksmanship,12,5,7
Whereismypet,azjolnerub,479,hunter,marksmanship,12,5,7
Vèreesa,azjolnerub,479,hunter,marksmanship,12,5,7
Thebalrog,korgall,478,hunter,marksmanship,12,5,7
Tiph,argent-dawn,478,hunter,marksmanship,12,5,7
Bendit,eredar,478,hunter,marksmanship,12,5,7
Robros,dentarg,475,hunter,marksmanship,12,5,7
Sixty,rajaxx,474,hunter,marksmanship,18,5,13
Tupalax,outland,447,hunter,marksmanship,16,6,10
Jocitwitch,ragnaros,432,hunter,marksmanship,9,6,3
Twinshot,anetheron,384,hunter,marksmanship,6,4,2
Baldazr,shadowsong,384,hunter,marksmanship,6,4,2
Doloresman,tarren-mill,384,hunter,marksmanship,6,4,2
Hntudwn,azshara,384,hunter,marksmanship,6,4,2
Slo,sylvanas,384,hunter,marksmanship,6,4,2
Denkstah,tarren-mill,384,hunter,marksmanship,6,4,2
Ixxmhunt,blackrock,384,hunter,marksmanship,6,4,2
Халикер,soulflayer,384,hunter,marksmanship,6,4,2
Nßatrapper,outland,384,hunter,marksmanship,6,4,2
Jägarenen,kazzak,384,hunter,marksmanship,6,4,2
Dariusmm,silvermoon,384,hunter,marksmanship,6,4,2
Kragán,silvermoon,384,hunter,marksmanship,6,4,2
Snipinx,draenor,384,hunter,marksmanship,6,4,2
Ëluna,burning-legion,384,hunter,marksmanship,6,4,2
Earlyspring,ragnaros,384,hunter,marksmanship,6,4,2
Сынсема,blackscar,384,hunter,marksmanship,6,4,2
Хантероо,gordunni,384,hunter,marksmanship,6,4,2
Джеймсфранко,blackscar,384,hunter,marksmanship,6,4,2
Ðøper,hyjal,384,hunter,marksmanship,6,4,2
Burninghunt,ravencrest,384,hunter,marksmanship,6,4,2
Sandchaton,ragnaros,384,hunter,marksmanship,6,4,2
Aidsmacka,shattered-hand,384,hunter,marksmanship,6,4,2
Bazrzokh,elune,384,hunter,marksmanship,6,4,2
Deeparrow,stormscale,384,hunter,marksmanship,12,4,8
Rupeebtw,stormscale,384,hunter,marksmanship,12,4,8
Peonfarmer,argent-dawn,384,hunter,marksmanship,12,4,8
Hashaya,hyjal,384,hunter,marksmanship,12,4,8
Zurzok,blackrock,384,hunter,marksmanship,12,4,8
Neosmoke,shadowsong,384,hunter,marksmanship,12,4,8
Tartaupommes,hyjal,384,hunter,marksmanship,12,4,8
Strikke,archimonde,384,hunter,marksmanship,12,4,8
Cais,drakthul,384,hunter,marksmanship,12,4,8
Kêêpsmile,blackmoore,384,hunter,marksmanship,18,4,14
Конар,soulflayer,383,hunter,marksmanship,6,4,2
Gorá,dethecus,383,hunter,marksmanship,6,4,2
Survivr,frostmane,383,hunter,marksmanship,6,4,2
Kyéra,kirin-tor,383,hunter,marksmanship,12,4,8
Hanzolo,uldum,383,hunter,marksmanship,12,4,8
Zirriath,mazrigos,383,hunter,marksmanship,12,4,8
Tenkai,cthun,382,hunter,marksmanship,6,4,2
Bélier,hyjal,382,hunter,marksmanship,12,4,8
Zicko,argent-dawn,382,hunter,marksmanship,12,4,8
Miezuu,ravencrest,335,hunter,marksmanship,9,4,5
Rapid,sylvanas,288,hunter,marksmanship,6,3,3
Djidawn,ysondre,288,hunter,marksmanship,6,3,3
Ekz,twisting-nether,288,hunter,marksmanship,6,3,3
Nothrokh,auchindoun,288,hunter,marksmanship,6,3,3
Nanns,silvermoon,288,hunter,marksmanship,6,3,3
Adariana,archimonde,288,hunter,marksmanship,6,3,3
Littlenugget,ravencrest,288,hunter,marksmanship,6,3,3
Blacksyo,elune,288,hunter,marksmanship,6,3,3
Люблюлюбовь,gordunni,288,hunter,marksmanship,6,3,3
Fugass,ragnaros,288,hunter,marksmanship,6,3,3
Muddí,ravencrest,288,hunter,marksmanship,6,3,3
Zøk,stormscale,288,hunter,marksmanship,6,3,3
Dreemshoot,stormscale,288,hunter,marksmanship,6,3,3
Makaxx,stormscale,288,hunter,marksmanship,6,3,3
Jomerin,thrall,288,hunter,marksmanship,6,3,3
Ruppig,nozdormu,288,hunter,marksmanship,6,3,3
Phinecone,stormscale,288,hunter,marksmanship,6,3,3
Samasukë,grim-batol,288,hunter,marksmanship,6,3,3
Lithell,kazzak,288,hunter,marksmanship,6,3,3
Эвилтар,soulflayer,288,hunter,marksmanship,6,3,3
Pläpp,stormscale,288,hunter,marksmanship,6,3,3
Agbaba,twisting-nether,288,hunter,marksmanship,6,3,3
Ронингуд,gordunni,288,hunter,marksmanship,6,3,3
Ричардн,howling-fjord,288,hunter,marksmanship,6,3,3
Atranex,ravencrest,288,hunter,marksmanship,6,3,3
Swïtchz,hyjal,288,hunter,marksmanship,6,3,3
Bocek,silvermoon,288,hunter,marksmanship,6,3,3
Nerdhark,hyjal,288,hunter,marksmanship,6,3,3
Комомура,soulflayer,288,hunter,marksmanship,6,3,3
Gwalëndil,hyjal,288,hunter,marksmanship,6,3,3
Gilgharsh,rajaxx,288,hunter,marksmanship,6,3,3
Neescafe,sylvanas,288,hunter,marksmanship,6,3,3
Deadluck,kazzak,288,hunter,marksmanship,6,3,3
Noxxen,burning-legion,288,hunter,marksmanship,6,3,3
Fize,blackmoore,288,hunter,marksmanship,6,3,3
Яроняютрапу,gordunni,288,hunter,marksmanship,6,3,3
Feyoonxx,blackrock,288,hunter,marksmanship,6,3,3
Zajaczek,burning-legion,288,hunter,marksmanship,6,3,3
Eliune,silvermoon,288,hunter,marksmanship,6,3,3
Egodennis,frostwolf,288,hunter,marksmanship,6,3,3
Spirys,drakthul,288,hunter,marksmanship,6,3,3
Olyleskotch,ravencrest,288,hunter,marksmanship,6,3,3
Nightarrowq,tarren-mill,288,hunter,marksmanship,9,4,5
Amdéa,boulderfist,288,hunter,marksmanship,10,4,6
Secrety,doomhammer,288,hunter,marksmanship,11,3,8
Chassuu,khaz-modan,288,hunter,marksmanship,12,3,9
Lùchiean,kazzak,288,hunter,marksmanship,12,3,9
Deify,grim-batol,288,hunter,marksmanship,12,3,9
Oduross,minahonda,288,hunter,marksmanship,12,3,9
Zubro,kazzak,288,hunter,marksmanship,12,3,9
Rediction,ravencrest,288,hunter,marksmanship,12,3,9
Naaztko,stormscale,288,hunter,marksmanship,12,3,9
Amistat,kazzak,288,hunter,marksmanship,12,3,9
Бубунн,howling-fjord,288,hunter,marksmanship,12,3,9
Jakis,silvermoon,288,hunter,marksmanship,12,3,9
Incompetence,argent-dawn,288,hunter,marksmanship,12,3,9
Deneja,kilrogg,288,hunter,marksmanship,12,3,9
Koreic,silvermoon,288,hunter,marksmanship,12,3,9
Оркос,deathweaver,287,hunter,marksmanship,6,3,3
Robìnhood,nemesis,287,hunter,marksmanship,6,3,3
Dwoas,darkspear,287,hunter,marksmanship,12,3,9
Arkman,malganis,287,hunter,marksmanship,18,3,15
Krippie,dun-modr,286,hunter,marksmanship,6,3,3
Лордввт,howling-fjord,286,hunter,marksmanship,6,3,3
Millhunter,norgannon,284,hunter,marksmanship,12,3,9
Rockymarciaa,dalaran,240,hunter,marksmanship,15,3,12
Garrash,teldrassil,192,hunter,marksmanship,6,2,4
Jamais02AEE6,stormscale,192,hunter,marksmanship,6,2,4
Sharpeyezz,ravencrest,192,hunter,marksmanship,6,2,4
Realme,blackrock,192,hunter,marksmanship,6,2,4
Vâleriaa,blackrock,192,hunter,marksmanship,6,2,4
Axran,ravencrest,192,hunter,marksmanship,6,2,4
Nelf,shattered-hand,192,hunter,marksmanship,6,2,4
Anoroxx,arthas,192,hunter,marksmanship,6,2,4
Феорика,grom,192,hunter,marksmanship,6,2,4
Lilsnipè,outland,192,hunter,marksmanship,6,2,4
Silenta,outland,192,hunter,marksmanship,6,2,4
Slayman,kazzak,192,hunter,marksmanship,6,2,4
Doknak,gilneas,192,hunter,marksmanship,6,2,4
Monnee,outland,192,hunter,marksmanship,6,2,4
Greenstar,twisting-nether,192,hunter,marksmanship,6,2,4
Bellecoq,arathi,192,hunter,marksmanship,6,2,4
Mönster,ravenholdt,192,hunter,marksmanship,6,2,4
Domsín,ravencrest,192,hunter,marksmanship,6,2,4
Охотуначал,soulflayer,192,hunter,marksmanship,6,2,4
Huntbeard,ragnaros,192,hunter,marksmanship,6,2,4
Bowner,frostmane,192,hunter,marksmanship,6,2,4
Darkshàdow,archimonde,192,hunter,marksmanship,6,2,4
Bobleearrow,darkspear,192,hunter,marksmanship,6,2,4
Sivoh,silvermoon,192,hunter,marksmanship,6,2,4
Notikâ,aegwynn,192,hunter,marksmanship,6,2,4
Rafaela,genjuros,192,hunter,marksmanship,6,2,4
Draknik,nemesis,192,hunter,marksmanship,6,2,4
Stingarrow,stormscale,192,hunter,marksmanship,6,2,4
Carioca,blackhand,192,hunter,marksmanship,6,2,4
Brizza,talnivarr,192,hunter,marksmanship,6,2,4
Zulldek,sanguino,192,hunter,marksmanship,6,2,4
Zendar,blackmoore,192,hunter,marksmanship,6,2,4
Deadyeyez,doomhammer,192,hunter,marksmanship,6,2,4
Mobshot,twisting-nether,192,hunter,marksmanship,6,2,4
Sayn,la-croisade-écarlate,192,hunter,marksmanship,6,2,4
Йинги,gordunni,192,hunter,marksmanship,6,2,4
Beletor,medivh,192,hunter,marksmanship,6,2,4
Свадебная,gordunni,192,hunter,marksmanship,6,2,4
Bláckheart,doomhammer,192,hunter,marksmanship,6,2,4
Øßlíck,ysondre,192,hunter,marksmanship,6,2,4
Лорбан,gordunni,192,hunter,marksmanship,6,2,4
Suchskill,stormreaver,192,hunter,marksmanship,6,2,4
Marcher,aggra-português,192,hunter,marksmanship,12,2,10
Weedonyhunt,hyjal,192,hunter,marksmanship,12,2,10
Friskì,draenor,192,hunter,marksmanship,12,2,10
Shademd,ahnqiraj,192,hunter,marksmanship,12,2,10
Muckel,area-52,192,hunter,marksmanship,12,2,10
Aimnfire,anachronos,192,hunter,marksmanship,12,2,10
Explicits,stormscale,192,hunter,marksmanship,12,2,10
Сашатетива,gordunni,192,hunter,marksmanship,12,2,10
Serihu,cthun,192,hunter,marksmanship,12,2,10
Stormhoofd,bloodhoof,191,hunter,marksmanship,6,2,4
Aadarshh,turalyon,191,hunter,marksmanship,6,2,4
Selini,bloodfeather,191,hunter,marksmanship,6,2,4
Jaguàr,kazzak,159,hunter,marksmanship,5,2,3
Buttsnipe,sylvanas,159,hunter,marksmanship,5,2,3
Cêdric,alleria,159,hunter,marksmanship,5,2,3
Haleth,uldum,159,hunter,marksmanship,5,2,3
Neremyn,sylvanas,138,hunter,marksmanship,9,3,6
Mmaaee,ravencrest,128,hunter,marksmanship,4,2,2
Akahr,thrall,96,hunter,marksmanship,3,2,1
Showdope,drakthul,96,hunter,marksmanship,6,1,5
Cítyzens,drakthul,96,hunter,marksmanship,6,1,5
Killzo,sylvanas,96,hunter,marksmanship,6,1,5
Shadoox,argent-dawn,96,hunter,marksmanship,6,1,5
Cxc,dun-modr,96,hunter,marksmanship,6,1,5
Metalbaci,sylvanas,96,hunter,marksmanship,6,1,5
Donáldtrúmp,tarren-mill,96,hunter,marksmanship,6,1,5
Blowplac,moonglade,96,hunter,marksmanship,6,1,5
Cléò,kazzak,96,hunter,marksmanship,6,1,5
Jimbow,blackrock,96,hunter,marksmanship,6,1,5
Faccacamoale,twisting-nether,96,hunter,marksmanship,6,1,5
Камсшотт,gordunni,96,hunter,marksmanship,6,1,5
Andtamed,thunderhorn,96,hunter,marksmanship,6,1,5
Statik,deathwing,96,hunter,marksmanship,6,1,5
Tillhunt,kargath,96,hunter,marksmanship,6,1,5
Deadlymayhem,dragonblight,96,hunter,marksmanship,6,1,5
Wèdra,hyjal,96,hunter,marksmanship,6,1,5
Huntsmart,kazzak,96,hunter,marksmanship,6,1,5
Desow,blackrock,96,hunter,marksmanship,6,1,5
Eowale,outland,96,hunter,marksmanship,6,1,5
Горгонт,blackscar,96,hunter,marksmanship,6,1,5
Огнеборик,howling-fjord,96,hunter,marksmanship,6,1,5
Аккулэйд,blackscar,96,hunter,marksmanship,6,1,5
Xaraimz,ravencrest,96,hunter,marksmanship,6,1,5
Chantalia,ravencrest,96,hunter,marksmanship,6,1,5
Наладдчик,howling-fjord,96,hunter,marksmanship,6,1,5
Oatmeal,dun-morogh,96,hunter,marksmanship,7,1,6
Denixxia,bronzebeard,95,hunter,marksmanship,3,2,1
Magahra,thrall,95,hunter,marksmanship,6,1,5
Rdevill,outland,64,hunter,marksmanship,4,1,3
Dréws,kazzak,64,hunter,marksmanship,4,1,3
Urith,les-clairvoyants,63,hunter,marksmanship,2,2,0
Imortaltroll,kazzak,16,hunter,marksmanship,1,1,0
Chrishyh,blackrock,16,hunter,marksmanship,1,1,0
Elgango,blackrock,16,hunter,marksmanship,1,1,0
Pridz,archimonde,2097,hunter,survival,96,51,45
Fíng,tarren-mill,2060,hunter,survival,54,30,24
Mestar,outland,2059,hunter,survival,157,81,76
Macrolaim,outland,2006,hunter,survival,96,45,51
Harrianlar,ravenholdt,1995,hunter,survival,71,34,37
Huntity,kazzak,1994,hunter,survival,95,51,44
Bonquiesha,tarren-mill,1971,hunter,survival,60,38,22
Pokefangirlx,grim-batol,1934,hunter,survival,57,40,17
Ryomen,garona,1930,hunter,survival,87,50,37
Sneakyshøt,nemesis,1923,hunter,survival,72,42,30
Razoorine,blackrock,1911,hunter,survival,90,51,39
Kagrot,silvermoon,1876,hunter,survival,66,32,34
Stormblãze,ravencrest,1867,hunter,survival,78,33,45
Lágåta,outland,1864,hunter,survival,53,27,26
Øvade,argent-dawn,1861,hunter,survival,67,41,26
Ravebae,silvermoon,1851,hunter,survival,90,46,44
Разплюханка,howling-fjord,1842,hunter,survival,78,46,32
Booxun,sylvanas,1840,hunter,survival,81,37,44
Квит,blackscar,1832,hunter,survival,30,20,10
Josethepimpo,stormscale,1832,hunter,survival,66,32,34
Polaqu,burning-legion,1809,hunter,survival,60,37,23
Горгонт,blackscar,1804,hunter,survival,54,29,25
Yemistar,archimonde,1802,hunter,survival,48,24,24
Zpf,silvermoon,1801,hunter,survival,56,30,26
Jackjager,ravencrest,1800,hunter,survival,33,21,12
Nikzeubii,archimonde,1798,hunter,survival,42,19,23
Fatbushpig,stormscale,1786,hunter,survival,30,19,11
Yosia,draenor,1756,hunter,survival,48,28,20
Avizi,anachronos,1752,hunter,survival,60,33,27
Yeezu,sylvanas,1750,hunter,survival,42,20,22
Earfalass,twisting-nether,1726,hunter,survival,32,23,9
Кулерквест,soulflayer,1720,hunter,survival,60,37,23
Pwon,ravencrest,1719,hunter,survival,100,54,46
Dreämhäck,ravencrest,1705,hunter,survival,24,19,5
Mewithoutyou,ragnaros,1699,hunter,survival,96,43,53
Frog,crushridge,1698,hunter,survival,54,30,24
Momohenní,archimonde,1698,hunter,survival,48,26,22
Zäroury,ravencrest,1682,hunter,survival,47,27,20
Yemmeth,argent-dawn,1662,hunter,survival,111,58,53
Lxoh,turalyon,1660,hunter,survival,119,60,59
Darllene,kazzak,1657,hunter,survival,71,33,38
Yazqua,deathwing,1638,hunter,survival,58,34,24
Closeenought,ravencrest,1628,hunter,survival,48,24,24
Xiumiune,antonidas,1626,hunter,survival,54,32,22
Riema,ragnaros,1626,hunter,survival,46,24,22
Летмимейт,howling-fjord,1622,hunter,survival,44,22,22
Kajtarn,outland,1621,hunter,survival,54,24,30
Танчибосс,soulflayer,1618,hunter,survival,60,32,28
Ruxhunter,sanguino,1607,hunter,survival,84,47,37
Tillhunt,kargath,1600,hunter,survival,57,36,21
Ódelagga,sylvanas,1598,hunter,survival,54,32,22
Dariusmm,silvermoon,1598,hunter,survival,58,32,26
Madzynette,archimonde,1594,hunter,survival,31,20,11
Losiané,thrall,1592,hunter,survival,58,29,29
Psychotik,stormreaver,1581,hunter,survival,76,43,33
Shoty,zuluhed,1575,hunter,survival,51,29,22
Свадебная,gordunni,1573,hunter,survival,88,48,40
Сабакаа,borean-tundra,1571,hunter,survival,54,31,23
Pizzafanatic,blackrock,1564,hunter,survival,37,20,17
Turdy,executus,1559,hunter,survival,40,23,17
Ðarrk,tarren-mill,1557,hunter,survival,54,29,25
Kalani,la-croisade-écarlate,1556,hunter,survival,54,28,26
Âmalphy,ravencrest,1549,hunter,survival,42,17,25
Ðoñko,hyjal,1541,hunter,survival,99,52,47
Rynex,festung-der-stürme,1534,hunter,survival,30,16,14
Monkeytrapz,norgannon,1526,hunter,survival,24,16,8
Жэш,howling-fjord,1514,hunter,survival,24,16,8
Lukez,ravencrest,1513,hunter,survival,24,16,8
Sznxøxo,ravencrest,1498,hunter,survival,24,16,8
Nienel,archimonde,1490,hunter,survival,41,16,25
Olk,stormscale,1439,hunter,survival,24,15,9
Albumx,hyjal,1439,hunter,survival,111,52,59
Лесбиянюсь,gordunni,1434,hunter,survival,24,15,9
Zulldek,sanguino,1406,hunter,survival,30,15,15
Zacxx,ravencrest,1398,hunter,survival,23,16,7
Andjelaa,kazzak,1398,hunter,survival,30,15,15
Crème,blackrock,1395,hunter,survival,59,23,36
Sorozo,aegwynn,1363,hunter,survival,29,15,14
Alexdi,kazzak,1341,hunter,survival,30,14,16
Icetrapped,eredar,1341,hunter,survival,30,14,16
Xaone,blackrock,1340,hunter,survival,18,14,4
Cjezka,blackmoore,1339,hunter,survival,30,14,16
Avaren,archimonde,1337,hunter,survival,30,14,16
Calyssae,shattered-halls,1325,hunter,survival,22,15,7
Jamalinho,silvermoon,1322,hunter,survival,60,38,22
Santiägø,archimonde,1322,hunter,survival,42,23,19
Zehned,ysondre,1316,hunter,survival,57,25,32
Malgorn,burning-legion,1314,hunter,survival,34,23,11
Slagatronic,ragnaros,1290,hunter,survival,24,15,9
Kazzaak,kazzak,1288,hunter,survival,42,15,27
Глаззалмаз,howling-fjord,1264,hunter,survival,22,14,8
Jumong,ragnaros,1246,hunter,survival,24,13,11
Clicker,runetotem,1234,hunter,survival,30,13,17
Sayn,la-croisade-écarlate,1227,hunter,survival,24,13,11
Suxino,doomhammer,1226,hunter,survival,30,13,17
Nvukaze,argent-dawn,1198,hunter,survival,21,15,6
Feignindeath,twisting-nether,1173,hunter,survival,26,14,12
Mmkekw,guldan,1151,hunter,survival,18,12,6
Zhulk,los-errantes,1151,hunter,survival,24,12,12
Dabeszt,draenor,1150,hunter,survival,18,12,6
Grulog,kazzak,1150,hunter,survival,30,12,18
Тэмплест,howling-fjord,1146,hunter,survival,18,12,6
Rettoo,aszune,1146,hunter,survival,19,12,7
Gilzog,exodar,1138,hunter,survival,30,12,18
Cabaim,eredar,1137,hunter,survival,18,12,6
Huntoruu,outland,1122,hunter,survival,67,30,37
Exquisitor,draenor,1117,hunter,survival,29,12,17
Raztreadör,dun-modr,1111,hunter,survival,22,12,10
Easyclass,hyjal,1096,hunter,survival,22,14,8
Sainttcc,thrall,1065,hunter,survival,36,13,23
Nwnw,tarren-mill,1056,hunter,survival,18,11,7
Lutza,sanguino,1056,hunter,survival,24,11,13
Akronis,outland,1056,hunter,survival,30,11,19
Clifton,archimonde,1055,hunter,survival,12,11,1
Субоота,gordunni,1055,hunter,survival,18,11,7
Sunyjuyono,ravencrest,1055,hunter,survival,24,11,13
Копия,azuregos,1055,hunter,survival,24,11,13
Микихаса,galakrond,1054,hunter,survival,24,11,13
Westcøãst,archimonde,1051,hunter,survival,18,11,7
Шадак,soulflayer,1038,hunter,survival,30,11,19
Giobi,draenor,996,hunter,survival,24,13,11
Kukenisluken,stormscale,960,hunter,survival,18,10,8
Obbnfriends,ravencrest,960,hunter,survival,18,10,8
Islide,ravencrest,960,hunter,survival,24,10,14
Ðrãke,blackmoore,958,hunter,survival,18,10,8
Менстряк,deathguard,958,hunter,survival,18,10,8
Wikariusz,kazzak,958,hunter,survival,30,10,20
Mcgloebels,archimonde,956,hunter,survival,21,11,10
Zwerghauer,arthas,953,hunter,survival,18,10,8
Сильвиина,eversong,953,hunter,survival,24,10,14
Zipzâp,blackrock,936,hunter,survival,18,10,8
Ashablack,argent-dawn,888,hunter,survival,17,10,7
Чууч,blackscar,864,hunter,survival,12,9,3
Åíøñs,kazzak,864,hunter,survival,12,9,3
Lìmpy,stormreaver,864,hunter,survival,12,9,3
Bicmex,ravencrest,864,hunter,survival,12,9,3
Mogumogu,blackhand,864,hunter,survival,12,9,3
Svinrbglol,arygos,864,hunter,survival,18,9,9
Sipsomewater,ravencrest,864,hunter,survival,18,9,9
Mileysaures,stormscale,863,hunter,survival,12,9,3
Zøk,stormscale,863,hunter,survival,12,9,3
Murkek,drakthul,863,hunter,survival,12,9,3
Rollin,khaz-modan,861,hunter,survival,12,9,3
Hoffen,dentarg,861,hunter,survival,12,9,3
Voltár,antonidas,854,hunter,survival,24,9,15
Kyosoku,silvermoon,816,hunter,survival,21,9,12
Melissax,silvermoon,810,hunter,survival,22,10,12
Næ,kazzak,798,hunter,survival,14,9,5
Норапина,eversong,797,hunter,survival,18,9,9
Drolig,blackmoore,793,hunter,survival,17,9,8
Zerberas,blackrock,768,hunter,survival,12,8,4
Ilovejwrld,dun-modr,768,hunter,survival,12,8,4
Vargar,arygos,768,hunter,survival,12,8,4
Götdelen,kult-der-verdammten,768,hunter,survival,12,8,4
Bicepspump,dun-morogh,768,hunter,survival,18,8,10
Майен,thermaplugg,768,hunter,survival,18,8,10
Dorota,auchindoun,767,hunter,survival,12,8,4
Cataleýà,outland,767,hunter,survival,12,8,4
Robzyhunter,kazzak,767,hunter,survival,12,8,4
Prodanhunts,frostmane,767,hunter,survival,18,8,10
Стивстифлер,razuvious,766,hunter,survival,12,8,4
Taurïel,stormscale,765,hunter,survival,18,8,10
Cämper,aegwynn,763,hunter,survival,18,8,10
Doru,silvermoon,762,hunter,survival,18,8,10
Хантероо,gordunni,756,hunter,survival,18,8,10
Gedept,blackrock,735,hunter,survival,20,9,11
Betarayjinx,kazzak,720,hunter,survival,15,8,7
Subha,quelthalas,672,hunter,survival,12,7,5
Lugnåls,hyjal,672,hunter,survival,12,7,5
Robinbuds,stormscale,672,hunter,survival,12,7,5
Neddly,draenor,672,hunter,survival,12,7,5
Иснсейшн,soulflayer,672,hunter,survival,12,7,5
Dyndns,blackmoore,672,hunter,survival,12,7,5
Гудхантер,blackscar,672,hunter,survival,12,7,5
Amilienne,nozdormu,672,hunter,survival,12,7,5
Terrorduni,tarren-mill,672,hunter,survival,18,7,11
Оскорбление,howling-fjord,672,hunter,survival,18,7,11
Cadier,argent-dawn,672,hunter,survival,18,7,11
Daweí,draenor,672,hunter,survival,18,7,11
Zeer,sylvanas,672,hunter,survival,18,7,11
Мандалорецц,soulflayer,671,hunter,survival,12,7,5
Fyoni,silvermoon,671,hunter,survival,12,7,5
Karabeg,twisting-nether,671,hunter,survival,12,7,5
Herubin,doomhammer,671,hunter,survival,12,7,5
Dragonflayer,sylvanas,666,hunter,survival,12,7,5
Spakker,the-shatar,666,hunter,survival,16,8,8
Jakis,silvermoon,623,hunter,survival,17,7,10
Akavirie,outland,622,hunter,survival,11,7,4
Animàl,argent-dawn,607,hunter,survival,16,7,9
Burbutsuluki,silvermoon,576,hunter,survival,6,6,0
Thugzilla,auchindoun,576,hunter,survival,6,6,0
Løvebombing,ravencrest,576,hunter,survival,6,6,0
Gitanìlla,dun-modr,576,hunter,survival,6,6,0
Ajko,blackmoore,576,hunter,survival,6,6,0
Миаур,gordunni,576,hunter,survival,12,6,6
Nunziatellà,nemesis,576,hunter,survival,12,6,6
Huntiika,twisting-nether,576,hunter,survival,12,6,6
Hunjo,quelthalas,576,hunter,survival,12,6,6
Morkahs,dalaran,576,hunter,survival,12,6,6
Nkl,archimonde,576,hunter,survival,12,6,6
Mouganstine,archimonde,576,hunter,survival,12,6,6
Memli,uldaman,575,hunter,survival,12,6,6
Grimazg,chogall,575,hunter,survival,12,6,6
Littlhuntard,tarren-mill,575,hunter,survival,12,6,6
Pãstèque,ravencrest,575,hunter,survival,12,6,6
Milandra,the-maelstrom,573,hunter,survival,12,6,6
Kurkelx,ravencrest,480,hunter,survival,6,5,1
Gíggí,malganis,480,hunter,survival,6,5,1
Ватмано,gordunni,480,hunter,survival,6,5,1
Vilopez,arthas,480,hunter,survival,6,5,1
Glama,archimonde,480,hunter,survival,6,5,1
Deek,ysera,480,hunter,survival,6,5,1
Sarrow,ravencrest,480,hunter,survival,6,5,1
Nooksem,blackrock,480,hunter,survival,6,5,1
Röwene,argent-dawn,480,hunter,survival,6,5,1
Зеленыйиисус,gordunni,480,hunter,survival,6,5,1
Moscowmule,tarren-mill,480,hunter,survival,12,5,7
Ballistix,elune,480,hunter,survival,12,5,7
Hunterado,burning-legion,480,hunter,survival,12,5,7
Abeba,grim-batol,480,hunter,survival,12,5,7
Agnêas,silvermoon,480,hunter,survival,12,5,7
Kirax,ravencrest,480,hunter,survival,12,5,7
Guanchin,silvermoon,480,hunter,survival,12,5,7
Aequitaz,blackhand,480,hunter,survival,18,5,13
Badboyxoxo,stormscale,479,hunter,survival,6,5,1
Bloodxx,ragnaros,479,hunter,survival,12,5,7
Pôîson,kazzak,478,hunter,survival,24,5,19
Skyythe,dun-morogh,474,hunter,survival,12,5,7
Jabela,eredar,447,hunter,survival,11,5,6
Китас,soulflayer,445,hunter,survival,14,6,8
Azuren,twisting-nether,430,hunter,survival,11,5,6
Floris,outland,384,hunter,survival,6,4,2
Reviam,ravencrest,384,hunter,survival,6,4,2
Burninghunt,ravencrest,384,hunter,survival,6,4,2
Capullospawn,dun-morogh,384,hunter,survival,6,4,2
Velen,pozzo-delleternità,384,hunter,survival,6,4,2
Djøgi,archimonde,384,hunter,survival,6,4,2
Virzion,silvermoon,384,hunter,survival,6,4,2
Raelaf,zuljin,384,hunter,survival,6,4,2
Maiver,ravencrest,384,hunter,survival,6,4,2
Nomorex,frostwhisper,384,hunter,survival,6,4,2
Fmatzen,the-maelstrom,384,hunter,survival,6,4,2
Snippy,sanguino,384,hunter,survival,6,4,2
Maiverx,ravencrest,384,hunter,survival,6,4,2
Luftikuss,arthas,384,hunter,survival,6,4,2
Scypher,ragnaros,384,hunter,survival,6,4,2
Аминотоксид,blackscar,384,hunter,survival,6,4,2
Куфа,blackscar,384,hunter,survival,6,4,2
Renegansnipe,silvermoon,384,hunter,survival,6,4,2
Foxyfoxo,guldan,384,hunter,survival,6,4,2
Paxiwtf,eredar,384,hunter,survival,6,4,2
Avashah,ravencrest,384,hunter,survival,10,4,6
Eâgleêyê,frostwolf,384,hunter,survival,12,4,8
Skumrask,outland,384,hunter,survival,12,4,8
Vunter,malganis,384,hunter,survival,12,4,8
Beaststeaks,thrall,384,hunter,survival,12,4,8
Ázurâ,blackhand,384,hunter,survival,12,4,8
Ниалла,thermaplugg,384,hunter,survival,12,4,8
Binhoker,argent-dawn,383,hunter,survival,6,4,2
Platza,ragnaros,383,hunter,survival,12,4,8
Ghob,kazzak,330,hunter,survival,8,5,3
Sùnzí,alakir,319,hunter,survival,6,4,2
Natchell,ysondre,288,hunter,survival,6,3,3
Assaultrifle,frostmane,288,hunter,survival,6,3,3
Voldagor,hyjal,288,hunter,survival,6,3,3
Rewgodxq,ravencrest,288,hunter,survival,6,3,3
Aidsmacka,shattered-hand,288,hunter,survival,6,3,3
Knokkelmann,outland,288,hunter,survival,6,3,3
Atalnta,ravencrest,288,hunter,survival,6,3,3
Ashendan,silvermoon,288,hunter,survival,6,3,3
Lightxyz,ravencrest,288,hunter,survival,6,3,3
Rákthar,blackmoore,288,hunter,survival,6,3,3
Pechvogel,blackmoore,288,hunter,survival,6,3,3
Helvetiya,sylvanas,288,hunter,survival,6,3,3
Himatoumi,elune,288,hunter,survival,6,3,3
Prinzz,blackmoore,288,hunter,survival,6,3,3
Simppeli,sylvanas,288,hunter,survival,6,3,3
Faccacamoale,twisting-nether,288,hunter,survival,6,3,3
Oneeyedjoe,the-maelstrom,288,hunter,survival,6,3,3
Ремонтлицаа,gordunni,288,hunter,survival,6,3,3
Стингергодх,gordunni,288,hunter,survival,6,3,3
Engetsu,drakthul,288,hunter,survival,6,3,3
Hühneknubbel,blackmoore,288,hunter,survival,6,3,3
Паркх,soulflayer,288,hunter,survival,6,3,3
Rizlay,the-maelstrom,288,hunter,survival,12,3,9
Aspergun,ragnaros,288,hunter,survival,12,3,9
Nestór,todeswache,288,hunter,survival,12,3,9
Jäinenool,outland,288,hunter,survival,12,3,9
Lezigoulleur,marécage-de-zangar,287,hunter,survival,6,3,3
Neilime,marécage-de-zangar,287,hunter,survival,12,3,9
Axiøs,thrall,239,hunter,survival,5,3,2
Doubleright,ravencrest,192,hunter,survival,6,2,4
Одисенс,eversong,192,hunter,survival,6,2,4
Tdapills,sanguino,192,hunter,survival,6,2,4
Lithell,kazzak,192,hunter,survival,6,2,4
Belaux,archimonde,192,hunter,survival,6,2,4
Ammò,kazzak,192,hunter,survival,6,2,4
Gynax,hyjal,192,hunter,survival,6,2,4
Adram,burning-legion,192,hunter,survival,6,2,4
Steffxd,twisting-nether,192,hunter,survival,6,2,4
Неужто,deathguard,192,hunter,survival,6,2,4
Saejku,archimonde,192,hunter,survival,6,2,4
Roscke,drakthul,192,hunter,survival,6,2,4
Marluxiâ,archimonde,192,hunter,survival,6,2,4
Наладдчик,howling-fjord,192,hunter,survival,6,2,4
Zøøkëëper,silvermoon,192,hunter,survival,6,2,4
Yakayoshi,kazzak,192,hunter,survival,6,2,4
Ilovemax,archimonde,192,hunter,survival,6,2,4
Eromoar,outland,192,hunter,survival,6,2,4
Vorsord,zuljin,192,hunter,survival,6,2,4
Regale,archimonde,192,hunter,survival,6,2,4
Flexifys,tarren-mill,192,hunter,survival,6,2,4
Гаррельд,blackscar,192,hunter,survival,6,2,4
Skewdar,hyjal,192,hunter,survival,12,2,10
Hanibale,burning-blade,192,hunter,survival,12,2,10
Yinn,kilrogg,192,hunter,survival,12,2,10
Ирртой,grom,191,hunter,survival,6,2,4
Комомура,soulflayer,169,hunter,survival,17,4,13
Оверман,azuregos,159,hunter,survival,8,3,5
Grollar,ragnaros,96,hunter,survival,6,1,5
Эвилтар,soulflayer,96,hunter,survival,6,1,5
Ryztik,garona,96,hunter,survival,6,1,5
Amadia,defias-brotherhood,96,hunter,survival,6,1,5
Katzchen,burning-legion,96,hunter,survival,6,1,5
Escaflôwn,aegwynn,96,hunter,survival,6,1,5
Supcuz,stormscale,96,hunter,survival,6,1,5
Yake,kazzak,84,hunter,survival,16,4,12
Рангмар,howling-fjord,79,hunter,survival,5,1,4
Mâjôô,blackhand,64,hunter,survival,4,1,3
Skyyw,tarren-mill,64,hunter,survival,5,1,4
Jacobszy,outland,63,hunter,survival,2,2,0
Reðrighthånð,throkferoth,48,hunter,survival,3,1,2
Velrhegal,tarren-mill,16,hunter,survival,7,1,6
Mariabanks,aegwynn,2286,hunter,beastmastery,180,96,84
Esperion,ragnaros,2042,hunter,beastmastery,90,43,47
Hypse,kazzak,2031,hunter,beastmastery,107,50,57
Zyphx,der-rat-von-dalaran,2024,hunter,beastmastery,90,43,47
Cbã,ravencrest,1995,hunter,beastmastery,42,21,21
Plugonbaby,hyjal,1994,hunter,beastmastery,59,28,31
Libanais,archimonde,1987,hunter,beastmastery,107,50,57
Gernoqz,frostwolf,1973,hunter,beastmastery,107,51,56
Куфа,blackscar,1909,hunter,beastmastery,36,20,16
Wîldhunt,burning-legion,1902,hunter,beastmastery,71,36,35
Manj,blackhand,1888,hunter,beastmastery,54,29,25
Wilfyre,twisting-nether,1885,hunter,beastmastery,63,32,31
Feevah,frostmane,1880,hunter,beastmastery,148,73,75
Blackszpak,jaedenar,1876,hunter,beastmastery,42,23,19
Дианнесса,howling-fjord,1876,hunter,beastmastery,71,35,36
Phesx,sylvanas,1865,hunter,beastmastery,54,27,27
Ígrågøßñø,silvermoon,1864,hunter,beastmastery,44,30,14
Izmad,archimonde,1864,hunter,beastmastery,167,101,66
Биско,gordunni,1862,hunter,beastmastery,68,34,34
Triggaz,stormscale,1860,hunter,beastmastery,117,66,51
Krampack,dun-modr,1858,hunter,beastmastery,54,31,23
Doghxnter,ravencrest,1853,hunter,beastmastery,42,21,21
Sipsomewater,ravencrest,1852,hunter,beastmastery,57,30,27
Берх,gordunni,1843,hunter,beastmastery,48,27,21
Nyzuri,die-aldor,1843,hunter,beastmastery,54,26,28
Miløø,silvermoon,1835,hunter,beastmastery,48,26,22
Breezme,twisting-nether,1833,hunter,beastmastery,66,31,35
Rákthar,blackmoore,1832,hunter,beastmastery,66,32,34
Gaeln,outland,1828,hunter,beastmastery,72,34,38
Odeôn,twisting-nether,1826,hunter,beastmastery,48,20,28
Burninghunt,ravencrest,1822,hunter,beastmastery,60,32,28
Brokeasalwys,ravencrest,1821,hunter,beastmastery,54,26,28
Baltímore,stormscale,1815,hunter,beastmastery,35,19,16
Горгонт,blackscar,1813,hunter,beastmastery,42,24,18
Марчик,blackscar,1810,hunter,beastmastery,42,19,23
Hiddenx,blackmoore,1808,hunter,beastmastery,42,21,21
Huntchonk,kazzak,1806,hunter,beastmastery,53,27,26
Truejkee,silvermoon,1805,hunter,beastmastery,54,29,25
Crippa,tarren-mill,1803,hunter,beastmastery,54,28,26
Nystaleoss,grim-batol,1778,hunter,beastmastery,54,25,29
Nottberozz,silvermoon,1773,hunter,beastmastery,54,32,22
Klausmanne,blackrock,1765,hunter,beastmastery,69,31,38
Séyena,outland,1764,hunter,beastmastery,42,19,23
Fullxtrap,hyjal,1763,hunter,beastmastery,41,19,22
Mtrider,twisting-nether,1754,hunter,beastmastery,48,23,25
Ilovemax,archimonde,1750,hunter,beastmastery,46,20,26
Easyclass,hyjal,1737,hunter,beastmastery,72,44,28
Aimshots,twisting-nether,1731,hunter,beastmastery,48,24,24
Вождь,howling-fjord,1730,hunter,beastmastery,42,21,21
Thogel,hyjal,1728,hunter,beastmastery,54,26,28
Irefutabilâ,outland,1726,hunter,beastmastery,72,32,40
Duppdupp,eredar,1726,hunter,beastmastery,66,29,37
Babýrage,twisting-nether,1716,hunter,beastmastery,30,18,12
Дашатрирубля,soulflayer,1715,hunter,beastmastery,42,21,21
Fize,blackmoore,1712,hunter,beastmastery,41,20,21
Nèxz,blackrock,1711,hunter,beastmastery,66,28,38
Alpharaven,ravencrest,1709,hunter,beastmastery,48,25,23
Рагнарианх,gordunni,1705,hunter,beastmastery,42,18,24
Wodhunterxdd,outland,1703,hunter,beastmastery,47,21,26
Eazzyy,auchindoun,1695,hunter,beastmastery,36,21,15
Пихпахах,gordunni,1691,hunter,beastmastery,82,43,39
Ooh,doomhammer,1691,hunter,beastmastery,66,26,40
Трапгодикс,eversong,1690,hunter,beastmastery,42,25,17
Cnby,stormscale,1672,hunter,beastmastery,25,18,7
Nestór,todeswache,1667,hunter,beastmastery,36,22,14
Kachaxa,kazzak,1667,hunter,beastmastery,52,23,29
Скадхи,blackscar,1662,hunter,beastmastery,40,22,18
Elamondria,outland,1657,hunter,beastmastery,53,31,22
Índigo,kazzak,1650,hunter,beastmastery,44,25,19
Mânhunt,blackhand,1648,hunter,beastmastery,100,46,54
Krix,ragnaros,1635,hunter,beastmastery,42,26,16
Экономист,fordragon,1633,hunter,beastmastery,36,21,15
Xiioo,ravencrest,1631,hunter,beastmastery,65,29,36
Imcuteandfun,ravencrest,1630,hunter,beastmastery,60,24,36
Nimhunt,dentarg,1628,hunter,beastmastery,48,21,27
Roarmantic,blackrock,1627,hunter,beastmastery,36,17,19
Hultasy,outland,1626,hunter,beastmastery,66,32,34
Порошокк,howling-fjord,1625,hunter,beastmastery,30,17,13
Дэнвин,deathweaver,1625,hunter,beastmastery,42,22,20
Gibiswag,outland,1625,hunter,beastmastery,36,17,19
Sïmc,archimonde,1624,hunter,beastmastery,60,32,28
Xxiioo,ravencrest,1623,hunter,beastmastery,46,30,16
Jägarnmt,twisting-nether,1623,hunter,beastmastery,42,20,22
Wingclip,ravencrest,1622,hunter,beastmastery,36,17,19
Merquryh,ravencrest,1619,hunter,beastmastery,36,20,16
Vezeka,ravencrest,1618,hunter,beastmastery,42,26,16
Impxgodx,outland,1617,hunter,beastmastery,39,18,21
Куоль,gordunni,1613,hunter,beastmastery,42,17,25
Ðéadsøulz,stormscale,1611,hunter,beastmastery,48,26,22
Jeeso,baelgun,1610,hunter,beastmastery,48,22,26
Taoshii,die-aldor,1609,hunter,beastmastery,54,30,24
Janko,ravencrest,1609,hunter,beastmastery,48,26,22
Chasseurcool,argent-dawn,1604,hunter,beastmastery,32,19,13
Céah,blackrock,1604,hunter,beastmastery,54,28,26
Brisbya,khaz-modan,1600,hunter,beastmastery,29,21,8
Priceqtxd,ravencrest,1596,hunter,beastmastery,31,22,9
Búddhá,stormscale,1591,hunter,beastmastery,108,50,58
Зоотян,gordunni,1586,hunter,beastmastery,52,25,27
Rndhunt,shattrath,1575,hunter,beastmastery,36,18,18
Draugrinnh,tarren-mill,1574,hunter,beastmastery,54,25,29
Grusijohn,executus,1573,hunter,beastmastery,66,33,33
Eldrekou,kazzak,1572,hunter,beastmastery,36,18,18
Комомура,soulflayer,1568,hunter,beastmastery,53,24,29
Paimen,darksorrow,1566,hunter,beastmastery,48,26,22
Антисерт,ashenvale,1566,hunter,beastmastery,52,25,27
Sagethunt,blackrock,1565,hunter,beastmastery,41,17,24
Missmytraps,ravencrest,1561,hunter,beastmastery,27,17,10
Coldmonster,tarren-mill,1560,hunter,beastmastery,78,49,29
Gunde,kazzak,1551,hunter,beastmastery,102,52,50
Stickey,antonidas,1541,hunter,beastmastery,48,23,25
Аллони,booty-bay,1541,hunter,beastmastery,66,31,35
Parhainkoira,argent-dawn,1537,hunter,beastmastery,30,17,13
Тиблэк,soulflayer,1532,hunter,beastmastery,77,38,39
Aroeris,ravencrest,1526,hunter,beastmastery,36,19,17
Каоссхант,howling-fjord,1523,hunter,beastmastery,24,16,8
Sarrow,ravencrest,1523,hunter,beastmastery,77,41,36
Akaris,archimonde,1522,hunter,beastmastery,33,17,16
Пулявзубах,gordunni,1518,hunter,beastmastery,50,27,23
Tayaa,draenor,1518,hunter,beastmastery,55,28,27
Отерон,gordunni,1515,hunter,beastmastery,36,22,14
Icetrapped,eredar,1502,hunter,beastmastery,41,25,16
Lowfet,neptulon,1502,hunter,beastmastery,34,20,14
Bastianapa,twisting-nether,1501,hunter,beastmastery,60,29,31
Чапуршилов,lich-king,1489,hunter,beastmastery,64,34,30
Âmalphy,ravencrest,1485,hunter,beastmastery,29,16,13
Пивопьюня,ashenvale,1484,hunter,beastmastery,29,16,13
Забзаб,soulflayer,1484,hunter,beastmastery,29,16,13
Orcoro,ysondre,1479,hunter,beastmastery,78,35,43
Mytown,hyjal,1473,hunter,beastmastery,24,16,8
Boulaax,ysondre,1457,hunter,beastmastery,94,57,37
Ázurâ,blackhand,1451,hunter,beastmastery,27,17,10
Anca,aegwynn,1445,hunter,beastmastery,36,17,19
Palaur,kazzak,1440,hunter,beastmastery,53,26,27
Uglybaboon,draenor,1439,hunter,beastmastery,36,15,21
Dogetrainer,silvermoon,1436,hunter,beastmastery,24,15,9
Draxil,archimonde,1436,hunter,beastmastery,30,15,15
Честнный,howling-fjord,1435,hunter,beastmastery,89,41,48
Qtìp,aegwynn,1434,hunter,beastmastery,30,15,15
Pérnix,tarren-mill,1429,hunter,beastmastery,24,15,9
Anjeschka,nemesis,1427,hunter,beastmastery,40,24,16
Meskette,ravencrest,1423,hunter,beastmastery,48,22,26
Rhee,the-maelstrom,1421,hunter,beastmastery,90,39,51
Ericspet,stormscale,1416,hunter,beastmastery,24,15,9
Waalth,ragnaros,1414,hunter,beastmastery,66,30,36
Яроняютрапу,gordunni,1413,hunter,beastmastery,24,17,7
Velocity,nagrand,1411,hunter,beastmastery,41,19,22
Mariehunt,blackmoore,1411,hunter,beastmastery,66,30,36
Metalmaison,archimonde,1409,hunter,beastmastery,30,15,15
Neíth,the-maelstrom,1405,hunter,beastmastery,42,17,25
Nallepuuoh,outland,1403,hunter,beastmastery,30,15,15
Váal,dun-modr,1401,hunter,beastmastery,63,36,27
Leriath,shadowsong,1400,hunter,beastmastery,29,19,10
Phinecone,stormscale,1399,hunter,beastmastery,42,18,24
Jägarntwo,stormscale,1389,hunter,beastmastery,39,15,24
Bambamgalke,antonidas,1378,hunter,beastmastery,72,34,38
Sonìc,kazzak,1373,hunter,beastmastery,32,16,16
Pammycakes,bronze-dragonflight,1363,hunter,beastmastery,30,16,14
Drestan,drakthul,1363,hunter,beastmastery,36,16,20
Киборка,howling-fjord,1352,hunter,beastmastery,30,15,15
Laoriane,hyjal,1351,hunter,beastmastery,30,15,15
Rdom,stormreaver,1348,hunter,beastmastery,28,15,13
Carioca,blackhand,1339,hunter,beastmastery,30,14,16
Saromán,ravencrest,1327,hunter,beastmastery,30,16,14
Acmé,kazzak,1326,hunter,beastmastery,30,14,16
Mágaz,draenor,1319,hunter,beastmastery,36,16,20
Muspigen,tarren-mill,1313,hunter,beastmastery,81,37,44
Ayyubi,blackrock,1306,hunter,beastmastery,30,14,16
Notikâ,aegwynn,1304,hunter,beastmastery,36,15,21
Люблюлюбовь,gordunni,1300,hunter,beastmastery,24,18,6
Афонадзе,gordunni,1298,hunter,beastmastery,48,24,24
Straybullet,kazzak,1296,hunter,beastmastery,30,14,16
Чизано,deathguard,1295,hunter,beastmastery,30,14,16
Loógosh,blackmoore,1280,hunter,beastmastery,36,15,21
Kiingsane,archimonde,1268,hunter,beastmastery,33,15,18
Шионо,howling-fjord,1250,hunter,beastmastery,26,14,12
Ðowz,ysondre,1248,hunter,beastmastery,24,13,11
Гринмех,gordunni,1247,hunter,beastmastery,24,13,11
Pagman,thrall,1247,hunter,beastmastery,30,13,17
Thing,kazzak,1246,hunter,beastmastery,24,13,11
Símpíng,tarren-mill,1245,hunter,beastmastery,18,13,5
Eddy,the-maelstrom,1244,hunter,beastmastery,30,19,11
Жмыххунтер,howling-fjord,1244,hunter,beastmastery,24,13,11
Horhyndan,ragnaros,1243,hunter,beastmastery,24,13,11
Nîøssx,blackrock,1242,hunter,beastmastery,24,13,11
Nkdchef,outland,1240,hunter,beastmastery,24,13,11
Salvia,chromaggus,1239,hunter,beastmastery,54,28,26
Neescafe,sylvanas,1236,hunter,beastmastery,27,14,13
Elsasehunter,zuljin,1232,hunter,beastmastery,30,13,17
Davíncí,tarren-mill,1226,hunter,beastmastery,65,35,30
Туруханец,gordunni,1225,hunter,beastmastery,42,21,21
Desow,blackrock,1222,hunter,beastmastery,18,13,5
Stogie,auchindoun,1217,hunter,beastmastery,24,13,11
Meredo,burning-legion,1209,hunter,beastmastery,42,18,24
Heylie,senjin,1206,hunter,beastmastery,47,16,31
Балласкиндер,gordunni,1162,hunter,beastmastery,54,28,26
Oròme,pozzo-delleternità,1154,hunter,beastmastery,24,13,11
Bíllybobbs,argent-dawn,1152,hunter,beastmastery,24,12,12
Sentriks,tarren-mill,1151,hunter,beastmastery,24,12,12
Brawnshunt,stormscale,1151,hunter,beastmastery,24,12,12
Digimørtal,kazzak,1150,hunter,beastmastery,18,12,6
Galileo,sanguino,1150,hunter,beastmastery,26,12,14
Eaglexx,twisting-nether,1149,hunter,beastmastery,24,12,12
Treaz,sanguino,1149,hunter,beastmastery,30,12,18
Poupoune,uldum,1147,hunter,beastmastery,30,12,18
Zubro,kazzak,1146,hunter,beastmastery,30,12,18
Artemisas,draenor,1144,hunter,beastmastery,30,12,18
Fiftyóne,festung-der-stürme,1144,hunter,beastmastery,30,12,18
Chagaure,hyjal,1141,hunter,beastmastery,24,12,12
Xystîco,thrall,1139,hunter,beastmastery,24,12,12
Dramin,defias-brotherhood,1128,hunter,beastmastery,59,27,32
Nidromel,stormscale,1112,hunter,beastmastery,36,15,21
Juha,the-maelstrom,1111,hunter,beastmastery,26,13,13
Savori,kazzak,1096,hunter,beastmastery,31,18,13
Cruelsummer,kul-tiras,1091,hunter,beastmastery,30,12,18
Brometheus,sylvanas,1083,hunter,beastmastery,41,15,26
Schnezzler,nerathor,1059,hunter,beastmastery,24,12,12
Tsoutsoukoss,silvermoon,1057,hunter,beastmastery,37,16,21
Ynv,argent-dawn,1056,hunter,beastmastery,18,11,7
Eggcowmeow,azjolnerub,1055,hunter,beastmastery,18,11,7
Хастла,greymane,1055,hunter,beastmastery,18,11,7
Jaky,illidan,1055,hunter,beastmastery,41,24,17
Safnirx,tarren-mill,1055,hunter,beastmastery,36,11,25
Fåded,ravencrest,1054,hunter,beastmastery,25,12,13
Daveq,drakthul,1054,hunter,beastmastery,24,11,13
Sparcùs,stormreaver,1052,hunter,beastmastery,24,11,13
Pilogbueferd,silvermoon,1050,hunter,beastmastery,18,11,7
Коблазнх,howling-fjord,1048,hunter,beastmastery,24,11,13
Flunkytim,blackmoore,1046,hunter,beastmastery,18,11,7
Venkox,archimonde,1039,hunter,beastmastery,37,19,18
Pumukle,madmortem,1035,hunter,beastmastery,34,15,19
Linchpin,dentarg,1034,hunter,beastmastery,30,11,19
Ветиринарша,gordunni,1020,hunter,beastmastery,30,11,19
Olamay,blackmoore,1019,hunter,beastmastery,24,11,13
Shpider,burning-blade,1019,hunter,beastmastery,39,16,23
Grollar,ragnaros,1014,hunter,beastmastery,80,42,38
Karstarkk,sanguino,1014,hunter,beastmastery,30,11,19
Nerfjuice,silvermoon,1006,hunter,beastmastery,27,13,14
Винченцо,blackscar,1003,hunter,beastmastery,21,11,10
Joshalama,quelthalas,1003,hunter,beastmastery,23,11,12
Кразайс,ashenvale,975,hunter,beastmastery,26,12,14
Feigur,sanguino,969,hunter,beastmastery,24,12,12
Dioxis,silvermoon,962,hunter,beastmastery,36,13,23
Missmytrap,archimonde,960,hunter,beastmastery,12,10,2
Lajnus,frostmane,960,hunter,beastmastery,18,10,8
Bilbohunter,draenor,960,hunter,beastmastery,18,10,8
Dìgítal,twisting-nether,960,hunter,beastmastery,18,10,8
Jägarn,stormscale,960,hunter,beastmastery,24,10,14
Tagz,ravencrest,960,hunter,beastmastery,24,10,14
Fãdê,ravencrest,959,hunter,beastmastery,12,10,2
Ixix,blackhand,959,hunter,beastmastery,18,10,8
Drøøðqt,blackrock,959,hunter,beastmastery,18,10,8
Thinkerer,silvermoon,959,hunter,beastmastery,18,10,8
Djøgi,archimonde,959,hunter,beastmastery,24,10,14
Søuïlløn,archimonde,958,hunter,beastmastery,12,10,2
Tháyn,tarren-mill,958,hunter,beastmastery,18,10,8
Hogar,frostwolf,957,hunter,beastmastery,18,10,8
Magarosh,eredar,953,hunter,beastmastery,24,10,14
Baileé,onyxia,952,hunter,beastmastery,21,11,10
Skullstah,ravencrest,951,hunter,beastmastery,18,10,8
Lioness,ahnqiraj,951,hunter,beastmastery,24,10,14
Lemeric,blackmoore,942,hunter,beastmastery,19,10,9
Deadlysnîpe,antonidas,941,hunter,beastmastery,16,11,5
Ertestuing,tarren-mill,931,hunter,beastmastery,24,10,14
Enanorabioso,minahonda,927,hunter,beastmastery,24,10,14
Paînfull,kazzak,926,hunter,beastmastery,23,10,13
Goliathoz,blackmoore,917,hunter,beastmastery,35,19,16
Stjordal,chamber-of-aspects,917,hunter,beastmastery,63,30,33
Kronzucker,eredar,914,hunter,beastmastery,36,16,20
Kënshiro,kazzak,893,hunter,beastmastery,20,10,10
Sukzess,antonidas,864,hunter,beastmastery,12,9,3
Eenel,twisting-nether,864,hunter,beastmastery,12,9,3
Kapowz,kazzak,864,hunter,beastmastery,12,9,3
Lilpancake,kazzak,864,hunter,beastmastery,12,9,3
Haltrâdar,archimonde,864,hunter,beastmastery,16,10,6
Scrubbi,destromath,864,hunter,beastmastery,18,9,9
Shoranon,stormscale,864,hunter,beastmastery,18,9,9
Idtrapthat,nagrand,864,hunter,beastmastery,18,9,9
Gondoo,tarren-mill,864,hunter,beastmastery,18,9,9
Painaldeepz,stormscale,864,hunter,beastmastery,18,9,9
Nordafrøst,antonidas,864,hunter,beastmastery,18,9,9
Denkstah,tarren-mill,864,hunter,beastmastery,24,9,15
Feralhound,exodar,863,hunter,beastmastery,18,9,9
Fluphy,thrall,863,hunter,beastmastery,18,9,9
Мунлэс,lich-king,863,hunter,beastmastery,19,9,10
Greathorn,arthas,862,hunter,beastmastery,12,9,3
Tåxi,silvermoon,861,hunter,beastmastery,18,9,9
Джантига,howling-fjord,859,hunter,beastmastery,18,9,9
Asousa,stormscale,859,hunter,beastmastery,18,9,9
Бруксиан,fordragon,857,hunter,beastmastery,19,9,10
Arakton,drakthul,849,hunter,beastmastery,23,10,13
Luckyhunty,dalaran,847,hunter,beastmastery,24,9,15
Greenstar,twisting-nether,846,hunter,beastmastery,27,10,17
Пушкабомби,soulflayer,841,hunter,beastmastery,28,11,17
Enty,blackrock,830,hunter,beastmastery,14,10,4
Deathmarks,blackrock,830,hunter,beastmastery,29,9,20
Lissudarlin,stormreaver,829,hunter,beastmastery,48,22,26
Võnbødefeld,frostmourne,827,hunter,beastmastery,17,9,8
Slojork,thrall,826,hunter,beastmastery,32,10,22
Happyrme,thrall,825,hunter,beastmastery,18,9,9
Mykris,aegwynn,825,hunter,beastmastery,23,9,14
Kure,blackrock,824,hunter,beastmastery,28,10,18
Grokis,blackhand,822,hunter,beastmastery,24,11,13
Anoroxx,arthas,815,hunter,beastmastery,17,9,8
Шаурмэ,gordunni,815,hunter,beastmastery,21,9,12
Hammertime,sanguino,798,hunter,beastmastery,17,9,8
Weoneshot,ravencrest,768,hunter,beastmastery,12,8,4
Eagletalon,twisting-nether,768,hunter,beastmastery,12,8,4
Saggymilkies,outland,768,hunter,beastmastery,12,8,4
Trapgoddxx,archimonde,768,hunter,beastmastery,12,8,4
Ahlgood,stormscale,768,hunter,beastmastery,12,8,4
Mufdii,sylvanas,768,hunter,beastmastery,18,8,10
Dispairge,antonidas,768,hunter,beastmastery,18,8,10
Hîldegard,todeswache,768,hunter,beastmastery,18,8,10
Pewpewstuff,draenor,768,hunter,beastmastery,18,8,10
Grynu,kazzak,768,hunter,beastmastery,24,8,16
Hacz,bronzebeard,768,hunter,beastmastery,24,8,16
Ловихимеру,soulflayer,767,hunter,beastmastery,12,8,4
Drigs,blackrock,767,hunter,beastmastery,18,8,10
Earnzie,outland,767,hunter,beastmastery,18,8,10
Лсныйпамп,howling-fjord,767,hunter,beastmastery,18,8,10
Шурикцаревич,galakrond,767,hunter,beastmastery,24,8,16
Prodanhunts,frostmane,767,hunter,beastmastery,24,8,16
Røzy,twisting-nether,766,hunter,beastmastery,12,8,4
Pekaxôxô,sanguino,766,hunter,beastmastery,12,8,4
Feignindeath,twisting-nether,766,hunter,beastmastery,12,8,4
Unrealy,grim-batol,766,hunter,beastmastery,12,8,4
Abovival,ragnaros,766,hunter,beastmastery,18,8,10
Plong,argent-dawn,761,hunter,beastmastery,12,8,4
Luzivarus,malganis,751,hunter,beastmastery,23,8,15
Altimor,blackmoore,719,hunter,beastmastery,17,8,9
Catmother,grim-batol,717,hunter,beastmastery,14,9,5
Быщь,gordunni,717,hunter,beastmastery,17,8,9
Tyranski,ravencrest,704,hunter,beastmastery,22,8,14
Sélenaé,hyjal,703,hunter,beastmastery,16,8,8
Feyoonx,blackrock,703,hunter,beastmastery,23,9,14
Huntbeard,aegwynn,695,hunter,beastmastery,22,8,14
Vaelyste,doomhammer,672,hunter,beastmastery,12,7,5
Tukene,kazzak,672,hunter,beastmastery,12,7,5
Knokkelmann,outland,672,hunter,beastmastery,12,7,5
Fôx,frostmane,672,hunter,beastmastery,12,7,5
Bigramy,sanguino,672,hunter,beastmastery,12,7,5
Letsrock,outland,672,hunter,beastmastery,12,7,5
Мэлвиса,borean-tundra,672,hunter,beastmastery,12,7,5
Diapositiv,draenor,672,hunter,beastmastery,12,7,5
Jêsslíne,ravencrest,672,hunter,beastmastery,12,7,5
Gorgorm,ravencrest,672,hunter,beastmastery,12,7,5
Riflur,stormscale,672,hunter,beastmastery,12,7,5
Sylariel,die-aldor,672,hunter,beastmastery,12,7,5
Zuxz,blackmoore,672,hunter,beastmastery,12,7,5
Twineyes,ravencrest,672,hunter,beastmastery,12,7,5
Ufecläimbe,eredar,672,hunter,beastmastery,12,7,5
Moistmán,kazzak,672,hunter,beastmastery,12,7,5
Фираналь,blackscar,672,hunter,beastmastery,15,8,7
Misstrap,nemesis,672,hunter,beastmastery,18,7,11
Pryse,hyjal,672,hunter,beastmastery,18,7,11
Gitanìlla,dun-modr,672,hunter,beastmastery,18,7,11
Летмимейт,howling-fjord,672,hunter,beastmastery,26,7,19
Darkdexou,defias-brotherhood,671,hunter,beastmastery,12,7,5
Strade,argent-dawn,671,hunter,beastmastery,12,7,5
Askaway,sylvanas,671,hunter,beastmastery,12,7,5
Ecalter,dun-modr,671,hunter,beastmastery,12,7,5
Waidø,blackhand,671,hunter,beastmastery,12,7,5
Vexhh,outland,671,hunter,beastmastery,12,7,5
Neeske,sylvanas,671,hunter,beastmastery,18,7,11
Snipingdog,stormscale,670,hunter,beastmastery,12,7,5
Poatan,outland,667,hunter,beastmastery,18,7,11
Rollei,uldum,666,hunter,beastmastery,12,7,5
Llamp,draenor,657,hunter,beastmastery,18,7,11
Notchan,stormscale,639,hunter,beastmastery,11,7,4
Каосси,gordunni,639,hunter,beastmastery,15,8,7
Adram,burning-legion,623,hunter,beastmastery,11,7,4
Yukina,frostmourne,602,hunter,beastmastery,16,7,9
Snipertjuh,silvermoon,591,hunter,beastmastery,19,7,12
Pawzz,kazzak,576,hunter,beastmastery,6,6,0
Mâjôô,blackhand,576,hunter,beastmastery,10,7,3
Синглшот,blackscar,576,hunter,beastmastery,12,6,6
Trapgodxx,archimonde,576,hunter,beastmastery,12,6,6
Зеленыйиисус,gordunni,576,hunter,beastmastery,12,6,6
Paraskámu,twisting-nether,576,hunter,beastmastery,12,6,6
Showdope,drakthul,576,hunter,beastmastery,12,6,6
Шмыгахант,gordunni,576,hunter,beastmastery,12,6,6
Logales,dragonblight,576,hunter,beastmastery,12,6,6
Cítyzens,drakthul,576,hunter,beastmastery,12,6,6
Raegal,sanguino,576,hunter,beastmastery,12,6,6
Sznxøxo,ravencrest,576,hunter,beastmastery,12,6,6
Arcø,dun-modr,576,hunter,beastmastery,12,6,6
Futureman,blackrock,576,hunter,beastmastery,12,6,6
Sallya,kazzak,576,hunter,beastmastery,12,6,6
Magicnanø,nemesis,576,hunter,beastmastery,12,6,6
Razoorine,blackrock,576,hunter,beastmastery,12,6,6
Jackjager,ravencrest,576,hunter,beastmastery,12,6,6
Зуланария,howling-fjord,576,hunter,beastmastery,12,6,6
Spidak,stormscale,576,hunter,beastmastery,12,6,6
Deblaze,aegwynn,576,hunter,beastmastery,12,6,6
Nagu,antonidas,576,hunter,beastmastery,12,6,6
Svolatch,blackrock,576,hunter,beastmastery,12,6,6
Chïefhunt,twisting-nether,576,hunter,beastmastery,12,6,6
Saymqt,blackrock,576,hunter,beastmastery,15,7,8
Nexztwo,blackrock,576,hunter,beastmastery,15,7,8
Gedzer,silvermoon,576,hunter,beastmastery,16,7,9
Realme,blackrock,576,hunter,beastmastery,18,6,12
Noversia,aegwynn,576,hunter,beastmastery,18,6,12
Свадебная,gordunni,576,hunter,beastmastery,18,6,12
Mehtäsika,xavius,575,hunter,beastmastery,12,6,6
Стреладемона,gordunni,575,hunter,beastmastery,12,6,6
Бирмингем,ashenvale,575,hunter,beastmastery,12,6,6
Толяарканшот,razuvious,575,hunter,beastmastery,12,6,6
Truedetectiv,aggramar,575,hunter,beastmastery,12,6,6
Puska,gilneas,575,hunter,beastmastery,12,6,6
Nerdhark,hyjal,575,hunter,beastmastery,18,6,12
Дипшот,deathguard,575,hunter,beastmastery,18,6,12
Zäyk,zuljin,575,hunter,beastmastery,18,6,12
Айлиси,soulflayer,575,hunter,beastmastery,31,6,25
Tempestes,tarren-mill,573,hunter,beastmastery,12,6,6
Teacee,twisting-nether,570,hunter,beastmastery,12,6,6
Åsynåmvp,twisting-nether,543,hunter,beastmastery,11,6,5
Dreemshoot,stormscale,542,hunter,beastmastery,11,6,5
Шэйдуокер,gordunni,528,hunter,beastmastery,15,6,9
Braatski,stormscale,526,hunter,beastmastery,18,7,11
Mirmona,stormscale,512,hunter,beastmastery,16,6,10
Shaznak,argent-dawn,480,hunter,beastmastery,6,5,1
Amitar,tarren-mill,480,hunter,beastmastery,6,5,1
Stamzer,drakthul,480,hunter,beastmastery,6,5,1
Мунмейстер,blackscar,480,hunter,beastmastery,6,5,1
Burbutsuluki,silvermoon,480,hunter,beastmastery,6,5,1
Solò,eredar,480,hunter,beastmastery,6,5,1
Wellocérapt,confrérie-du-thorium,480,hunter,beastmastery,6,5,1
Funkalation,ravencrest,480,hunter,beastmastery,6,5,1
Hidethegun,draenor,480,hunter,beastmastery,6,5,1
Huntma,kazzak,480,hunter,beastmastery,6,5,1
Freebïrd,shattered-hand,480,hunter,beastmastery,6,5,1
Mordhunterx,draenor,480,hunter,beastmastery,6,5,1
Jinxbomber,draenor,480,hunter,beastmastery,6,5,1
Survabuse,silvermoon,480,hunter,beastmastery,9,6,3
Ataxyz,draenor,480,hunter,beastmastery,12,5,7
Düivell,grim-batol,480,hunter,beastmastery,12,5,7
Grabbin,silvermoon,480,hunter,beastmastery,12,5,7
Tiendat,kazzak,480,hunter,beastmastery,12,5,7
Jawox,antonidas,480,hunter,beastmastery,12,5,7
Ingvi,antonidas,480,hunter,beastmastery,12,5,7
Grrizzly,kazzak,480,hunter,beastmastery,12,5,7
Vargar,arygos,480,hunter,beastmastery,12,5,7
Chúx,twisting-nether,480,hunter,beastmastery,12,5,7
Bubbahubba,ragnaros,480,hunter,beastmastery,12,5,7
Рафлекс,eversong,480,hunter,beastmastery,12,5,7
Квит,blackscar,480,hunter,beastmastery,12,5,7
Lis,gorgonnash,480,hunter,beastmastery,12,5,7
Джеймсфранко,blackscar,480,hunter,beastmastery,12,5,7
Vassiliadis,bronze-dragonflight,480,hunter,beastmastery,12,5,7
Китас,soulflayer,480,hunter,beastmastery,12,5,7
Elvenian,twisting-nether,480,hunter,beastmastery,12,5,7
Rxr,kazzak,480,hunter,beastmastery,12,5,7
Tizzlbang,ragnaros,480,hunter,beastmastery,12,5,7
Келкузд,howling-fjord,480,hunter,beastmastery,12,5,7
Chrishyh,blackrock,480,hunter,beastmastery,18,5,13
Setyouintrap,ravencrest,480,hunter,beastmastery,18,5,13
Erethrus,ravencrest,480,hunter,beastmastery,18,5,13
Тружка,soulflayer,480,hunter,beastmastery,24,5,19
Oife,auchindoun,479,hunter,beastmastery,12,5,7
Laerya,les-clairvoyants,479,hunter,beastmastery,12,5,7
Droubidi,garona,479,hunter,beastmastery,12,5,7
Killzo,sylvanas,479,hunter,beastmastery,12,5,7
Nieki,eitrigg,479,hunter,beastmastery,24,5,19
Бодрыйсэм,soulflayer,477,hunter,beastmastery,12,5,7
Momohenní,archimonde,448,hunter,beastmastery,10,5,5
Bellecoq,arathi,447,hunter,beastmastery,11,5,6
Кайсго,gordunni,384,hunter,beastmastery,6,4,2
Wêskêr,tarren-mill,384,hunter,beastmastery,6,4,2
Нью,soulflayer,384,hunter,beastmastery,6,4,2
Robbingyou,tarren-mill,384,hunter,beastmastery,6,4,2
Трапча,soulflayer,384,hunter,beastmastery,6,4,2
Bøøya,aegwynn,384,hunter,beastmastery,6,4,2
Remiss,sanguino,384,hunter,beastmastery,6,4,2
Pufyrella,kilrogg,384,hunter,beastmastery,6,4,2
Xndr,sanguino,384,hunter,beastmastery,6,4,2
Леао,howling-fjord,384,hunter,beastmastery,6,4,2
Illaice,antonidas,384,hunter,beastmastery,6,4,2
Kethos,draenor,384,hunter,beastmastery,6,4,2
Bravestarr,blades-edge,384,hunter,beastmastery,6,4,2
Снюсинка,gordunni,384,hunter,beastmastery,6,4,2
Xiviora,archimonde,384,hunter,beastmastery,6,4,2
Zpy,blackmoore,384,hunter,beastmastery,6,4,2
Dragosvis,arathor,384,hunter,beastmastery,6,4,2
Astari,outland,384,hunter,beastmastery,6,4,2
Khregan,aerie-peak,384,hunter,beastmastery,6,4,2
Nocturr,ragnaros,384,hunter,beastmastery,6,4,2
Nßatrapper,outland,384,hunter,beastmastery,6,4,2
Azzazeal,drakthul,384,hunter,beastmastery,6,4,2
Pfizershotx,khaz-modan,384,hunter,beastmastery,6,4,2
Thursty,twisting-nether,384,hunter,beastmastery,6,4,2
Hask,pozzo-delleternità,384,hunter,beastmastery,6,4,2
Flytomars,ravencrest,384,hunter,beastmastery,6,4,2
Dregor,nemesis,384,hunter,beastmastery,6,4,2
Nith,ungoro,384,hunter,beastmastery,6,4,2
Патапум,deathguard,384,hunter,beastmastery,6,4,2
Lultrap,nemesis,384,hunter,beastmastery,6,4,2
Basìcs,nemesis,384,hunter,beastmastery,6,4,2
Кежма,howling-fjord,384,hunter,beastmastery,6,4,2
Wetto,ravencrest,384,hunter,beastmastery,6,4,2
Strélka,blackrock,384,hunter,beastmastery,6,4,2
Sixty,rajaxx,384,hunter,beastmastery,6,4,2
Orcji,blackhand,384,hunter,beastmastery,6,4,2
Kruk,blackhand,384,hunter,beastmastery,6,4,2
Кулинарк,howling-fjord,384,hunter,beastmastery,6,4,2
Liquidhunter,quelthalas,384,hunter,beastmastery,6,4,2
Zanéy,ravencrest,384,hunter,beastmastery,6,4,2
Jaxxoo,outland,384,hunter,beastmastery,6,4,2
Alexdi,kazzak,384,hunter,beastmastery,6,4,2
Drukan,hyjal,384,hunter,beastmastery,6,4,2
Aléxy,sanguino,384,hunter,beastmastery,12,4,8
Neocb,ravencrest,384,hunter,beastmastery,12,4,8
Вейзу,ashenvale,384,hunter,beastmastery,12,4,8
Samanou,kazzak,384,hunter,beastmastery,12,4,8
Колякилшот,gordunni,384,hunter,beastmastery,12,4,8
Ryuwen,dun-modr,384,hunter,beastmastery,12,4,8
Valomeere,tarren-mill,384,hunter,beastmastery,12,4,8
Felorya,kazzak,384,hunter,beastmastery,12,4,8
Thérón,ravencrest,384,hunter,beastmastery,12,4,8
Матанал,gordunni,384,hunter,beastmastery,12,4,8
Øï,outland,384,hunter,beastmastery,12,4,8
Sharpeneye,ragnaros,384,hunter,beastmastery,12,4,8
Pergola,spinebreaker,384,hunter,beastmastery,12,4,8
Kannon,twisting-nether,384,hunter,beastmastery,12,4,8
Tervueren,burning-blade,384,hunter,beastmastery,18,4,14
Bemtistaru,draenor,384,hunter,beastmastery,18,4,14
Trend,silvermoon,384,hunter,beastmastery,18,4,14
Xscaper,twilights-hammer,383,hunter,beastmastery,6,4,2
Delazi,proudmoore,383,hunter,beastmastery,12,4,8
Bornum,khaz-modan,383,hunter,beastmastery,17,4,13
Beerox,ysondre,382,hunter,beastmastery,12,4,8
Румлис,gordunni,382,hunter,beastmastery,12,4,8
Dréws,kazzak,367,hunter,beastmastery,11,4,7
Appollo,magtheridon,288,hunter,beastmastery,6,3,3
Chasseeur,archimonde,288,hunter,beastmastery,6,3,3
Arnatti,tyrande,288,hunter,beastmastery,6,3,3
Kreiden,twisting-nether,288,hunter,beastmastery,6,3,3
Artze,outland,288,hunter,beastmastery,6,3,3
Bufosh,twisting-nether,288,hunter,beastmastery,6,3,3
Vhalín,magtheridon,288,hunter,beastmastery,6,3,3
Dorkos,sanguino,288,hunter,beastmastery,6,3,3
Blazeblue,hyjal,288,hunter,beastmastery,6,3,3
Akavirie,outland,288,hunter,beastmastery,6,3,3
Kyliun,frostmane,288,hunter,beastmastery,6,3,3
Krasavcik,shattrath,288,hunter,beastmastery,6,3,3
Iliíilíiílíl,outland,288,hunter,beastmastery,6,3,3
Irükandji,chants-éternels,288,hunter,beastmastery,6,3,3
Yssup,frostmane,288,hunter,beastmastery,6,3,3
Zoophobiaqt,silvermoon,288,hunter,beastmastery,6,3,3
Amigoss,argent-dawn,288,hunter,beastmastery,6,3,3
Pluttbug,xavius,288,hunter,beastmastery,6,3,3
Hunterlolz,tarren-mill,288,hunter,beastmastery,6,3,3
Kalt,twisting-nether,288,hunter,beastmastery,6,3,3
Beletor,medivh,288,hunter,beastmastery,6,3,3
Kragán,silvermoon,288,hunter,beastmastery,6,3,3
Cryptomars,twisting-nether,288,hunter,beastmastery,6,3,3
Sàclak,ysondre,288,hunter,beastmastery,6,3,3
Valhnir,sanguino,288,hunter,beastmastery,6,3,3
Kronkh,nemesis,288,hunter,beastmastery,6,3,3
Appirc,tarren-mill,288,hunter,beastmastery,6,3,3
Dtq,silvermoon,288,hunter,beastmastery,6,3,3
Iuyiuy,dalaran,288,hunter,beastmastery,6,3,3
Omegakek,madmortem,288,hunter,beastmastery,6,3,3
Halessia,ravencrest,288,hunter,beastmastery,6,3,3
Katzchen,burning-legion,288,hunter,beastmastery,6,3,3
Nîco,nathrezim,288,hunter,beastmastery,6,3,3
Tedohunter,ragnaros,288,hunter,beastmastery,6,3,3
Blmlooter,stormreaver,288,hunter,beastmastery,6,3,3
Ebobuss,tarren-mill,288,hunter,beastmastery,6,3,3
Axran,ravencrest,288,hunter,beastmastery,6,3,3
Kásúxøxø,ravencrest,288,hunter,beastmastery,6,3,3
Taurïel,stormscale,288,hunter,beastmastery,6,3,3
Nosfuratu,stormscale,288,hunter,beastmastery,6,3,3
Utoast,ravencrest,288,hunter,beastmastery,6,3,3
Rickh,ravencrest,288,hunter,beastmastery,6,3,3
Midist,stormscale,288,hunter,beastmastery,6,3,3
Jamesyy,ravencrest,288,hunter,beastmastery,6,3,3
Géeked,ravencrest,288,hunter,beastmastery,6,3,3
Benbutton,antonidas,288,hunter,beastmastery,6,3,3
Shedzargo,twisting-nether,288,hunter,beastmastery,6,3,3
Flugsmälla,kazzak,288,hunter,beastmastery,6,3,3
Маунтдроп,gordunni,288,hunter,beastmastery,6,3,3
Djtrapyasis,blackmoore,288,hunter,beastmastery,6,3,3
Скукота,grom,288,hunter,beastmastery,6,3,3
Lobo,kazzak,288,hunter,beastmastery,6,3,3
Будкусломаю,grom,288,hunter,beastmastery,6,3,3
Оркос,deathweaver,288,hunter,beastmastery,6,3,3
Колтрэйнборз,blackscar,288,hunter,beastmastery,6,3,3
Дзэнмашина,booty-bay,288,hunter,beastmastery,6,3,3
Fedya,kazzak,288,hunter,beastmastery,6,3,3
Джэромо,gordunni,288,hunter,beastmastery,6,3,3
Enthur,sylvanas,288,hunter,beastmastery,6,3,3
Оксанчек,howling-fjord,288,hunter,beastmastery,6,3,3
Razuye,nerathor,288,hunter,beastmastery,6,3,3
Metalbaci,sylvanas,288,hunter,beastmastery,6,3,3
Рофшор,gordunni,288,hunter,beastmastery,6,3,3
Lofiel,blackrock,288,hunter,beastmastery,6,3,3
Oldrocker,sylvanas,288,hunter,beastmastery,6,3,3
Kxx,kazzak,288,hunter,beastmastery,6,3,3
Ozunâ,blackmoore,288,hunter,beastmastery,6,3,3
Lioneli,sylvanas,288,hunter,beastmastery,6,3,3
Avatarofwoe,blackmoore,288,hunter,beastmastery,6,3,3
Безос,soulflayer,288,hunter,beastmastery,6,3,3
Anhur,blackmoore,288,hunter,beastmastery,6,3,3
Spiritshot,baelgun,288,hunter,beastmastery,8,3,5
Хантероо,gordunni,288,hunter,beastmastery,8,3,5
Riik,ragnaros,288,hunter,beastmastery,12,3,9
Headhunterzz,dun-modr,288,hunter,beastmastery,12,3,9
Orgasmatronn,stormscale,288,hunter,beastmastery,12,3,9
Mogumogu,blackhand,288,hunter,beastmastery,12,3,9
Nerøz,ravencrest,288,hunter,beastmastery,12,3,9
Jamesbownd,ravencrest,288,hunter,beastmastery,12,3,9
Drakess,daggerspine,288,hunter,beastmastery,12,3,9
Bubby,burning-legion,288,hunter,beastmastery,12,3,9
Craná,blackrock,288,hunter,beastmastery,12,3,9
Xoarqt,aegwynn,288,hunter,beastmastery,12,3,9
Atraxi,aegwynn,288,hunter,beastmastery,12,3,9
Neuwi,stormreaver,287,hunter,beastmastery,6,3,3
Asca,eldrethalas,287,hunter,beastmastery,12,3,9
Nixxay,antonidas,286,hunter,beastmastery,6,3,3
Esgar,blackrock,239,hunter,beastmastery,5,3,2
Bigbababotan,blackrock,234,hunter,beastmastery,9,4,5
Bortian,argent-dawn,208,hunter,beastmastery,7,3,4
Zeanort,nordrassil,192,hunter,beastmastery,6,2,4
Дэлмор,greymane,192,hunter,beastmastery,6,2,4
Tøixøna,tyrande,192,hunter,beastmastery,6,2,4
Lusifa,antonidas,192,hunter,beastmastery,6,2,4
Naid,lordaeron,192,hunter,beastmastery,6,2,4
Dragoki,blackmoore,192,hunter,beastmastery,6,2,4
Droz,blackmoore,192,hunter,beastmastery,6,2,4
Demónhunter,frostmane,192,hunter,beastmastery,6,2,4
Akhtabot,twisting-nether,192,hunter,beastmastery,6,2,4
As,kazzak,192,hunter,beastmastery,6,2,4
Siegbald,ragnaros,192,hunter,beastmastery,6,2,4
Shieryu,archimonde,192,hunter,beastmastery,6,2,4
Akù,magtheridon,192,hunter,beastmastery,6,2,4
Инкризшот,gordunni,192,hunter,beastmastery,6,2,4
Nikzeubii,archimonde,192,hunter,beastmastery,6,2,4
Ridbàck,archimonde,192,hunter,beastmastery,6,2,4
Nómarak,drakthul,192,hunter,beastmastery,6,2,4
Кулерквест,soulflayer,192,hunter,beastmastery,6,2,4
Doraxa,sanguino,192,hunter,beastmastery,6,2,4
Zulldek,sanguino,192,hunter,beastmastery,6,2,4
Ренектон,soulflayer,192,hunter,beastmastery,6,2,4
Phyllobates,blackrock,192,hunter,beastmastery,6,2,4
Ðoxz,blackrock,192,hunter,beastmastery,6,2,4
Silencxz,aegwynn,192,hunter,beastmastery,6,2,4
Legolex,burning-blade,192,hunter,beastmastery,6,2,4
Therakal,culte-de-la-rive-noire,192,hunter,beastmastery,6,2,4
Tillhunt,kargath,192,hunter,beastmastery,6,2,4
Афигеннски,ashenvale,192,hunter,beastmastery,6,2,4
Jayyke,frostmane,192,hunter,beastmastery,6,2,4
Luuszapfae,aegwynn,192,hunter,beastmastery,6,2,4
Arykes,drakthul,192,hunter,beastmastery,6,2,4
Акройя,gordunni,192,hunter,beastmastery,6,2,4
Coltan,nemesis,192,hunter,beastmastery,6,2,4
Father,auchindoun,192,hunter,beastmastery,6,2,4
Dohter,kazzak,192,hunter,beastmastery,6,2,4
Dzikapumpa,burning-legion,192,hunter,beastmastery,6,2,4
Mdmalol,malganis,192,hunter,beastmastery,6,2,4
Zappikhunter,silvermoon,192,hunter,beastmastery,6,2,4
Dentaar,draenor,192,hunter,beastmastery,6,2,4
Liscie,silvermoon,192,hunter,beastmastery,6,2,4
Lascazador,dun-modr,192,hunter,beastmastery,6,2,4
Karuso,ravencrest,192,hunter,beastmastery,6,2,4
Wildwingsebb,nazjatar,192,hunter,beastmastery,6,2,4
Azahunt,kazzak,192,hunter,beastmastery,6,2,4
Marryme,blackhand,192,hunter,beastmastery,6,2,4
Stuckstepbro,silvermoon,192,hunter,beastmastery,6,2,4
Lísy,hyjal,192,hunter,beastmastery,6,2,4
Онкьяр,gordunni,192,hunter,beastmastery,6,2,4
Sourxete,silvermoon,192,hunter,beastmastery,6,2,4
Lurigalinda,twisting-nether,192,hunter,beastmastery,6,2,4
Aughtism,turalyon,192,hunter,beastmastery,6,2,4
Sarbacanes,hyjal,192,hunter,beastmastery,6,2,4
Thecorruptor,skullcrusher,192,hunter,beastmastery,6,2,4
Ефрейя,gordunni,192,hunter,beastmastery,6,2,4
Gunmeister,bronzebeard,192,hunter,beastmastery,6,2,4
Hitray,stormscale,192,hunter,beastmastery,6,2,4
Травок,gordunni,192,hunter,beastmastery,6,2,4
Tràpz,archimonde,192,hunter,beastmastery,8,2,6
Blastarrow,the-maelstrom,192,hunter,beastmastery,12,2,10
Elja,laughing-skull,192,hunter,beastmastery,12,2,10
Rheyl,dun-morogh,192,hunter,beastmastery,12,2,10
Bláckheart,doomhammer,192,hunter,beastmastery,12,2,10
Порошокк,gordunni,192,hunter,beastmastery,12,2,10
Slayman,kazzak,192,hunter,beastmastery,18,2,16
Traknard,confrérie-du-thorium,191,hunter,beastmastery,6,2,4
Charlet,archimonde,191,hunter,beastmastery,6,2,4
Åånei,twisting-nether,144,hunter,beastmastery,9,2,7
Elnazar,archimonde,128,hunter,beastmastery,4,2,2
Deathøfrats,ravencrest,128,hunter,beastmastery,4,2,2
Slmao,tarren-mill,96,hunter,beastmastery,6,1,5
Táráh,proudmoore,96,hunter,beastmastery,6,1,5
Hollyz,auchindoun,96,hunter,beastmastery,6,1,5
Trollohunt,twisting-nether,96,hunter,beastmastery,6,1,5
Nomorex,frostwhisper,96,hunter,beastmastery,6,1,5
Chambiann,tarren-mill,96,hunter,beastmastery,6,1,5
Boybiron,silvermoon,96,hunter,beastmastery,6,1,5
Gbureczka,burning-legion,96,hunter,beastmastery,6,1,5
Hashaya,hyjal,96,hunter,beastmastery,6,1,5
Pjållistani,ravencrest,96,hunter,beastmastery,6,1,5
Jägerjokke,blackrock,96,hunter,beastmastery,6,1,5
Буреклык,gordunni,96,hunter,beastmastery,6,1,5
Кертион,howling-fjord,96,hunter,beastmastery,6,1,5
Дочьпескова,gordunni,96,hunter,beastmastery,6,1,5
Weafster,outland,96,hunter,beastmastery,6,1,5
Traplørdx,sylvanas,96,hunter,beastmastery,6,1,5
Zurzok,blackrock,96,hunter,beastmastery,6,1,5
Imahuntard,frostmane,96,hunter,beastmastery,6,1,5
Råhl,zuljin,96,hunter,beastmastery,6,1,5
Yoggys,outland,96,hunter,beastmastery,6,1,5
Colth,hyjal,96,hunter,beastmastery,6,1,5
Евилик,gordunni,96,hunter,beastmastery,6,1,5
Wórldz,dun-modr,96,hunter,beastmastery,6,1,5
Betarayjinx,kazzak,96,hunter,beastmastery,6,1,5
Raggeh,frostwhisper,96,hunter,beastmastery,6,1,5
Darkray,dalaran,96,hunter,beastmastery,6,1,5
Gramzy,blackmoore,96,hunter,beastmastery,6,1,5
Jozsiur,ragnaros,96,hunter,beastmastery,6,1,5
Hntudwn,azshara,96,hunter,beastmastery,6,1,5
Sayn,la-croisade-écarlate,96,hunter,beastmastery,6,1,5
ßèástymãç,ravencrest,96,hunter,beastmastery,6,1,5
Darllene,kazzak,96,hunter,beastmastery,6,1,5
Cliff,kiljaeden,96,hunter,beastmastery,6,1,5
Thóorin,ravencrest,96,hunter,beastmastery,12,1,11
Críted,blackmoore,96,hunter,beastmastery,12,1,11
Tsyapka,tarren-mill,96,hunter,beastmastery,12,1,11
Shoothim,destromath,95,hunter,beastmastery,3,2,1
Youngjinh,ravencrest,64,hunter,beastmastery,4,1,3
Yahamenistos,ysondre,64,hunter,beastmastery,4,1,3
Bynen,tarren-mill,42,hunter,beastmastery,10,2,8
Бей,gordunni,31,hunter,beastmastery,2,1,1
Tunhaa,arthas,16,hunter,beastmastery,1,1,0
Gwaan,outland,9,hunter,beastmastery,6,2,4
Choll,stormscale,1866,mage,arcane,30,20,10
Bebenm,archimonde,1825,mage,arcane,60,29,31
Aleç,ravencrest,1811,mage,arcane,48,25,23
Obbjob,ravencrest,1748,mage,arcane,60,30,30
Raíku,ravencrest,1723,mage,arcane,30,18,12
Непутевыймаг,gordunni,1715,mage,arcane,24,23,1
Castorcato,kazzak,1691,mage,arcane,36,24,12
Dardíe,ravencrest,1645,mage,arcane,30,19,11
Sérc,ravencrest,1626,mage,arcane,30,17,13
Wracrz,argent-dawn,1620,mage,arcane,36,23,13
Alustrasz,skullcrusher,1578,mage,arcane,42,24,18
Нефростмаг,gordunni,1564,mage,arcane,36,18,18
Манкай,fordragon,1554,mage,arcane,66,40,26
Шттрвблнкт,soulflayer,1546,mage,arcane,35,17,18
Ðøæø,twisting-nether,1528,mage,arcane,89,46,43
Wàneís,ravencrest,1514,mage,arcane,42,16,26
Ekron,sanguino,1481,mage,arcane,56,28,28
Tnhigh,blackrock,1407,mage,arcane,39,24,15
Nefrendel,kazzak,1395,mage,arcane,33,19,14
Фоулли,howling-fjord,1390,mage,arcane,23,15,8
Nakamura,outland,1386,mage,arcane,112,49,63
Barspin,lightnings-blade,1380,mage,arcane,30,18,12
Lemaroxd,draenor,1370,mage,arcane,23,15,8
Lusionator,defias-brotherhood,1370,mage,arcane,30,18,12
Манаманна,gordunni,1362,mage,arcane,105,54,51
Jhawkwizard,draenor,1285,mage,arcane,42,20,22
Ozdewish,hyjal,1262,mage,arcane,67,33,34
Валбериса,deepholm,1241,mage,arcane,48,31,17
Absie,tarren-mill,1234,mage,arcane,18,13,5
Pradapimp,ravencrest,1218,mage,arcane,26,14,12
Rezre,stormscale,1212,mage,arcane,54,28,26
Hardways,archimonde,1184,mage,arcane,78,32,46
Cubis,archimonde,1152,mage,arcane,24,12,12
Meolchum,outland,1148,mage,arcane,35,15,20
Demizboub,archimonde,1143,mage,arcane,60,31,29
Shirrunn,the-maelstrom,1119,mage,arcane,20,13,7
Sszz,ravencrest,1057,mage,arcane,30,15,15
Mercem,stormscale,1056,mage,arcane,12,11,1
Ogarcanefist,outland,1049,mage,arcane,24,11,13
Léa,rashgarroth,1042,mage,arcane,24,11,13
Aleteia,stormscale,960,mage,arcane,18,10,8
Проблембойх,gordunni,960,mage,arcane,18,10,8
Xiaomofashi,quelthalas,956,mage,arcane,12,10,2
Раканчик,gordunni,909,mage,arcane,17,10,7
Вадимодесса,soulflayer,904,mage,arcane,37,17,20
Scaless,stormscale,891,mage,arcane,22,10,12
Fuhry,tarren-mill,864,mage,arcane,12,9,3
Puni,emerald-dream,864,mage,arcane,12,9,3
Dárdie,ravencrest,864,mage,arcane,18,9,9
Waterhagx,tarren-mill,799,mage,arcane,11,9,2
Bullegong,archimonde,768,mage,arcane,12,8,4
Zimbabweborc,burning-legion,768,mage,arcane,12,8,4
Tiqma,sylvanas,768,mage,arcane,18,8,10
Orkamor,sylvanas,768,mage,arcane,18,8,10
Zehnvonzehn,antonidas,767,mage,arcane,18,8,10
Дырявка,galakrond,766,mage,arcane,18,8,10
Aeghis,darkspear,765,mage,arcane,18,8,10
Kobrass,spinebreaker,764,mage,arcane,24,8,16
Doryy,silvermoon,672,mage,arcane,12,7,5
Яшабурстх,blackscar,672,mage,arcane,12,7,5
Akâri,silvermoon,670,mage,arcane,12,7,5
Magikere,tarren-mill,668,mage,arcane,12,7,5
Mageé,argent-dawn,621,mage,arcane,17,7,10
Pyllymake,kazzak,576,mage,arcane,12,6,6
Radagulf,outland,576,mage,arcane,18,6,12
Spicymash,chogall,575,mage,arcane,12,6,6
Макотшельник,gordunni,480,mage,arcane,6,5,1
Ecovation,tarren-mill,480,mage,arcane,12,5,7
Sallesauruus,outland,480,mage,arcane,12,5,7
Diper,burning-legion,480,mage,arcane,12,5,7
Elor,eredar,480,mage,arcane,15,6,9
Mðj,kazzak,480,mage,arcane,18,5,13
Ледянойкекс,gordunni,480,mage,arcane,18,5,13
Ewina,twisting-nether,479,mage,arcane,6,5,1
Mortlol,chamber-of-aspects,479,mage,arcane,12,5,7
Gorn,ravencrest,478,mage,arcane,12,5,7
Portal,scarshield-legion,384,mage,arcane,6,4,2
Jengele,argent-dawn,384,mage,arcane,6,4,2
Freshforces,ragnaros,384,mage,arcane,6,4,2
Yunox,stormscale,384,mage,arcane,6,4,2
Hexmath,tarren-mill,384,mage,arcane,6,4,2
Rizzlybear,outland,384,mage,arcane,6,4,2
Nötmârtònxø,ragnaros,384,mage,arcane,6,4,2
Uní,emerald-dream,384,mage,arcane,12,4,8
Fôôxy,aegwynn,383,mage,arcane,6,4,2
Frostdeath,medivh,383,mage,arcane,12,4,8
Дантрий,gordunni,382,mage,arcane,6,4,2
Димаскунфу,howling-fjord,352,mage,arcane,16,4,12
Даанрен,galakrond,288,mage,arcane,6,3,3
Ovrpwrdxd,kazzak,288,mage,arcane,6,3,3
Aristarco,outland,288,mage,arcane,6,3,3
Persi,dentarg,288,mage,arcane,6,3,3
Auchenax,argent-dawn,288,mage,arcane,6,3,3
Сизаам,howling-fjord,288,mage,arcane,6,3,3
Magijoana,silvermoon,288,mage,arcane,6,3,3
Barryscótt,stormscale,288,mage,arcane,6,3,3
Serctheone,ravencrest,288,mage,arcane,9,4,5
Kudakto,ravencrest,288,mage,arcane,12,3,9
Arcadua,sanguino,287,mage,arcane,6,3,3
Иссэя,borean-tundra,286,mage,arcane,6,3,3
Kasus,sporeggar,286,mage,arcane,6,3,3
Tokyodes,twisting-nether,255,mage,arcane,11,3,8
Naween,hyjal,239,mage,arcane,5,3,2
Ímnotback,outland,239,mage,arcane,5,3,2
Линклер,fordragon,192,mage,arcane,6,2,4
Baravar,blackrock,192,mage,arcane,6,2,4
Teeclis,twisting-nether,192,mage,arcane,6,2,4
Хблэйз,howling-fjord,192,mage,arcane,6,2,4
Ryûblast,archimonde,192,mage,arcane,6,2,4
Superduck,ragnaros,192,mage,arcane,6,2,4
Kbd,outland,192,mage,arcane,6,2,4
Ãshs,archimonde,192,mage,arcane,6,2,4
Shiranize,aegwynn,192,mage,arcane,6,2,4
Thorstäin,ragnaros,192,mage,arcane,6,2,4
Arimila,sylvanas,192,mage,arcane,6,2,4
Zoot,ravencrest,192,mage,arcane,6,2,4
Noxkin,stormscale,192,mage,arcane,6,2,4
Versachi,neptulon,192,mage,arcane,6,2,4
Hruon,ravenholdt,192,mage,arcane,6,2,4
Schøkø,eredar,192,mage,arcane,6,2,4
Канеллис,howling-fjord,192,mage,arcane,7,2,5
Старкскрим,gordunni,96,mage,arcane,6,1,5
Thelastmage,outland,96,mage,arcane,6,1,5
Nohbrain,blackmoore,96,mage,arcane,6,1,5
Moosemæn,stormscale,96,mage,arcane,6,1,5
Angélique,ragnaros,96,mage,arcane,6,1,5
Hólmess,silvermoon,96,mage,arcane,6,1,5
Манднесс,azuregos,79,mage,arcane,11,1,10
Яшабурстх,blackscar,1943,mage,fire,66,35,31
Rizzlybear,outland,1918,mage,fire,75,35,40
Lêgendary,kazzak,1917,mage,fire,27,21,6
Slôw,kazzak,1893,mage,fire,30,20,10
Hatsu,kazzak,1884,mage,fire,60,32,28
Шипми,gordunni,1862,mage,fire,78,39,39
Uniquenoodle,alakir,1857,mage,fire,72,34,38
Dardie,ravencrest,1849,mage,fire,48,30,18
Hazewrld,ravencrest,1848,mage,fire,132,62,70
Wàneís,ravencrest,1831,mage,fire,40,25,15
Evohz,stormscale,1822,mage,fire,66,33,33
Elmaestró,aegwynn,1815,mage,fire,48,30,18
Bigkent,stormscale,1814,mage,fire,62,27,35
Isenhour,frostmane,1810,mage,fire,66,34,32
Jirt,stormscale,1782,mage,fire,47,28,19
Cörnflekz,stormscale,1755,mage,fire,32,21,11
Ygø,hyjal,1740,mage,fire,65,29,36
Hardtimes,blackhand,1738,mage,fire,70,38,32
Ókamí,ravencrest,1724,mage,fire,73,36,37
Mágetráiner,ravencrest,1721,mage,fire,36,18,18
Nihilvm,dalaran,1720,mage,fire,36,19,17
Twizzkek,silvermoon,1719,mage,fire,39,19,20
Håtsu,ravencrest,1714,mage,fire,42,21,21
Gelußaßa,ravencrest,1696,mage,fire,35,22,13
Авгурей,howling-fjord,1685,mage,fire,36,18,18
Spelltastìc,blackmoore,1675,mage,fire,36,18,18
Asterixus,sylvanas,1668,mage,fire,54,33,21
Milkenjoyer,ravencrest,1656,mage,fire,23,18,5
Reyown,archimonde,1649,mage,fire,30,23,7
Magenerfed,archimonde,1637,mage,fire,42,21,21
Obbjob,ravencrest,1631,mage,fire,72,36,36
Stoychav,outland,1630,mage,fire,42,24,18
Tommy,laughing-skull,1628,mage,fire,42,20,22
Håtemebaby,kazzak,1627,mage,fire,36,17,19
Sheepmeepbip,ravencrest,1619,mage,fire,47,20,27
Cienaños,outland,1606,mage,fire,66,34,32
Айслэнц,howling-fjord,1602,mage,fire,42,21,21
Whats,korgall,1585,mage,fire,70,39,31
Czd,outland,1574,mage,fire,53,21,32
Прауз,soulflayer,1573,mage,fire,33,17,16
Disnay,draenor,1531,mage,fire,36,21,15
Skrex,blackrock,1525,mage,fire,42,25,17
Htwhy,kazzak,1448,mage,fire,36,16,20
Secretagent,aegwynn,1439,mage,fire,66,37,29
Shahnoza,thrall,1428,mage,fire,24,15,9
Vzrmage,antonidas,1422,mage,fire,72,28,44
Razrkh,ragnaros,1409,mage,fire,36,19,17
Kappotjeplif,ravencrest,1403,mage,fire,42,24,18
Plætinum,ravencrest,1393,mage,fire,56,27,29
Aikamie,draenor,1391,mage,fire,36,18,18
Реордиан,gordunni,1389,mage,fire,41,15,26
Blitzo,madmortem,1361,mage,fire,42,25,17
Ryzea,ravencrest,1348,mage,fire,29,17,12
Magmarro,burning-legion,1342,mage,fire,36,19,17
Consquens,aszune,1337,mage,fire,18,14,4
Zestrax,kazzak,1334,mage,fire,36,26,10
Dxdxdxdxdx,drakthul,1330,mage,fire,30,14,16
Dantiqa,ravencrest,1328,mage,fire,38,16,22
Darríck,argent-dawn,1323,mage,fire,41,16,25
Stylaaz,twisting-nether,1317,mage,fire,35,18,17
Insanewizard,kazzak,1308,mage,fire,30,14,16
Liendri,aegwynn,1305,mage,fire,30,14,16
Fingolfin,amanthul,1286,mage,fire,156,72,84
Varenca,blackrock,1283,mage,fire,69,33,36
Magicalmig,draenor,1278,mage,fire,84,52,32
Dóncójones,blackrock,1273,mage,fire,35,16,19
Fiveboyjr,tarren-mill,1271,mage,fire,48,25,23
Диссоциация,greymane,1247,mage,fire,18,13,5
Prácticemàge,archimonde,1246,mage,fire,18,13,5
Frozentwink,kul-tiras,1246,mage,fire,24,13,11
Zensheep,silvermoon,1235,mage,fire,24,13,11
Elcølgaø,sanguino,1233,mage,fire,30,13,17
Faunas,kazzak,1230,mage,fire,46,27,19
Быкуня,gordunni,1196,mage,fire,24,13,11
Mëgu,silvermoon,1179,mage,fire,62,28,34
Dobbite,archimonde,1178,mage,fire,30,21,9
Rewq,twisting-nether,1147,mage,fire,18,12,6
Råståfåri,uldum,1145,mage,fire,24,12,12
Demensida,ravencrest,1145,mage,fire,28,13,15
Noviina,argent-dawn,1135,mage,fire,18,12,6
Аваон,deathguard,1128,mage,fire,24,12,12
Eutkir,silvermoon,1121,mage,fire,27,13,14
Fritmckhaine,archimonde,1116,mage,fire,36,21,15
Gorleg,draenor,1072,mage,fire,47,17,30
Uknowhowwedu,aegwynn,1056,mage,fire,18,11,7
Твейдей,blackscar,1056,mage,fire,24,11,13
Gnomag,argent-dawn,1051,mage,fire,18,11,7
Rayniß,blackmoore,1051,mage,fire,24,11,13
Carinuz,blackmoore,1051,mage,fire,25,11,14
Camiina,shattered-hand,1050,mage,fire,18,11,7
Pablø,blackrock,1014,mage,fire,31,15,16
Cyrîll,malygos,979,mage,fire,67,33,34
Вселениум,razuvious,975,mage,fire,22,11,11
Smlx,outland,960,mage,fire,18,10,8
Akâri,silvermoon,958,mage,fire,18,10,8
Naps,argent-dawn,957,mage,fire,18,10,8
Atixx,aegwynn,952,mage,fire,27,11,16
Kuríbo,gorgonnash,944,mage,fire,21,11,10
Sèrum,drakthul,927,mage,fire,23,10,13
Icx,tarren-mill,905,mage,fire,21,12,9
Magicspark,madmortem,898,mage,fire,54,26,28
Nåzmyz,outland,891,mage,fire,17,10,7
Macheat,kazzak,864,mage,fire,12,9,3
Magerocks,ragnaros,864,mage,fire,12,9,3
Turbomedusa,draenor,864,mage,fire,12,9,3
Âcryz,blackrock,864,mage,fire,18,9,9
Thegoodoctor,kazzak,864,mage,fire,18,9,9
Экзорсус,goldrinn,863,mage,fire,18,9,9
Gagaj,ravencrest,862,mage,fire,24,9,15
Skarxaa,sanguino,861,mage,fire,18,9,9
Sagregas,silvermoon,861,mage,fire,60,26,34
Firewitch,blackhand,860,mage,fire,18,9,9
Чоуза,gordunni,858,mage,fire,24,9,15
Ênizt,archimonde,846,mage,fire,17,9,8
Дрраго,greymane,830,mage,fire,23,9,14
Töframaður,draenor,827,mage,fire,16,9,7
Zéngã,kazzak,798,mage,fire,16,9,7
Azulêera,archimonde,768,mage,fire,12,8,4
Roxxis,kazzak,768,mage,fire,12,8,4
Yésdávé,stormscale,768,mage,fire,12,8,4
Imtrynasheep,kazzak,767,mage,fire,12,8,4
Bclaudiu,terokkar,767,mage,fire,16,9,7
Алаурс,howling-fjord,767,mage,fire,18,8,10
Büyübaba,twisting-nether,767,mage,fire,24,8,16
Iamslow,sylvanas,762,mage,fire,12,8,4
Arcadua,sanguino,758,mage,fire,12,8,4
Doonii,ragnaros,751,mage,fire,17,8,9
Kalyypso,arygos,735,mage,fire,16,9,7
Spacehoe,stormscale,672,mage,fire,12,7,5
Sleepingfate,stormscale,672,mage,fire,12,7,5
Ширм,blackscar,672,mage,fire,12,7,5
Двинск,soulflayer,672,mage,fire,12,7,5
Вовзон,howling-fjord,672,mage,fire,12,7,5
Equálity,blackrock,672,mage,fire,12,7,5
Elldiamage,draenor,672,mage,fire,12,7,5
Underscore,outland,672,mage,fire,12,7,5
Dazz,ravencrest,672,mage,fire,12,7,5
Calientay,ragnaros,672,mage,fire,18,7,11
Pisini,tarren-mill,672,mage,fire,18,7,11
Texmexguden,tarren-mill,672,mage,fire,18,7,11
Mangiafuoco,nemesis,672,mage,fire,18,7,11
Spellfaker,drakthul,671,mage,fire,12,7,5
Shealá,blackhand,671,mage,fire,12,7,5
Колдрагос,gordunni,671,mage,fire,18,7,11
Mauvé,blades-edge,670,mage,fire,12,7,5
Ustafrr,argent-dawn,670,mage,fire,13,7,6
Magikere,tarren-mill,639,mage,fire,17,7,10
Skylezy,blackrock,623,mage,fire,11,7,4
Hexmath,tarren-mill,617,mage,fire,17,10,7
Chrismage,argent-dawn,606,mage,fire,20,7,13
Whócárés,dragonmaw,576,mage,fire,6,6,0
Arcticfury,ravencrest,576,mage,fire,6,6,0
Matsuratkø,nemesis,576,mage,fire,6,6,0
Yanir,die-arguswacht,576,mage,fire,12,6,6
Serctheone,ravencrest,576,mage,fire,12,6,6
Çana,thrall,576,mage,fire,12,6,6
Pluggis,the-maelstrom,576,mage,fire,12,6,6
Feath,ravencrest,576,mage,fire,12,6,6
Mowns,ravencrest,576,mage,fire,12,6,6
Zimbabweborc,burning-legion,576,mage,fire,12,6,6
Rhodghar,ravencrest,576,mage,fire,12,6,6
Steveishigh,tarren-mill,576,mage,fire,13,6,7
Рифтиг,howling-fjord,576,mage,fire,18,6,12
Charizard,emerald-dream,575,mage,fire,9,7,2
Durdi,silvermoon,574,mage,fire,12,6,6
Explosìve,arthas,574,mage,fire,12,6,6
Santoz,blackrock,504,mage,fire,14,6,8
Utarii,deathwing,480,mage,fire,6,5,1
Pandathis,frostwolf,480,mage,fire,6,5,1
Jél,stormscale,480,mage,fire,6,5,1
Excuséme,ravencrest,480,mage,fire,6,5,1
Weedup,zuljin,480,mage,fire,6,5,1
Bzzr,tarren-mill,480,mage,fire,6,5,1
Cleancc,blackhand,480,mage,fire,6,5,1
Yoku,nethersturm,480,mage,fire,6,5,1
Saturator,burning-legion,480,mage,fire,12,5,7
Warwizz,sanguino,480,mage,fire,12,5,7
Teeclis,twisting-nether,480,mage,fire,12,5,7
Magechonk,kazzak,480,mage,fire,12,5,7
Lotharie,aegwynn,480,mage,fire,12,5,7
Røysi,ravencrest,480,mage,fire,12,5,7
Backped,kazzak,480,mage,fire,18,5,13
Spispi,burning-legion,479,mage,fire,15,6,9
Iceorb,azshara,479,mage,fire,24,5,19
Spader,argent-dawn,478,mage,fire,12,5,7
Exorifrigo,dun-modr,477,mage,fire,16,5,11
Buuszek,outland,430,mage,fire,11,5,6
Zaci,argent-dawn,384,mage,fire,6,4,2
Larah,les-clairvoyants,384,mage,fire,6,4,2
Cardioexpert,ravencrest,384,mage,fire,6,4,2
Itrius,tarren-mill,384,mage,fire,6,4,2
Mnday,ravencrest,384,mage,fire,6,4,2
Blinker,frostwhisper,384,mage,fire,6,4,2
Lokilus,dalaran,384,mage,fire,6,4,2
Mitchmage,ravencrest,384,mage,fire,6,4,2
Gidsor,silvermoon,384,mage,fire,6,4,2
Ovrpwrdxd,kazzak,384,mage,fire,6,4,2
Gennésïs,darksorrow,384,mage,fire,6,4,2
Нефростмаг,gordunni,384,mage,fire,6,4,2
Cesi,silvermoon,384,mage,fire,6,4,2
Doryy,silvermoon,384,mage,fire,6,4,2
Saryotheone,silvermoon,384,mage,fire,6,4,2
Rooven,aegwynn,384,mage,fire,12,4,8
Викликс,borean-tundra,384,mage,fire,12,4,8
Ледянойкекс,gordunni,384,mage,fire,12,4,8
Camelshaver,tarren-mill,384,mage,fire,12,4,8
Aarcheon,kazzak,384,mage,fire,12,4,8
Aimaniac,stormscale,384,mage,fire,12,4,8
Lusionator,defias-brotherhood,384,mage,fire,18,4,14
Leontus,outland,383,mage,fire,6,4,2
Rapidfrost,drakthul,383,mage,fire,6,4,2
Netherstorm,chogall,380,mage,fire,12,4,8
Vulcanx,stormscale,351,mage,fire,11,4,7
Lusifera,outland,336,mage,fire,9,4,5
Løxyy,ysondre,336,mage,fire,9,4,5
Мэдраша,gordunni,335,mage,fire,17,4,13
Schøkø,eredar,288,mage,fire,6,3,3
Zøe,aggra-português,288,mage,fire,6,3,3
Radiantfury,outland,288,mage,fire,6,3,3
Росвенд,gordunni,288,mage,fire,6,3,3
Alterwhite,archimonde,288,mage,fire,6,3,3
Anaxtra,guldan,288,mage,fire,6,3,3
Lëyra,ysondre,288,mage,fire,6,3,3
Гекомория,fordragon,288,mage,fire,6,3,3
Manvo,bloodscalp,288,mage,fire,6,3,3
Dynamica,ravencrest,288,mage,fire,6,3,3
Triplesevenx,silvermoon,288,mage,fire,6,3,3
Coachrmp,ravencrest,288,mage,fire,6,3,3
Salvadordalí,ravencrest,288,mage,fire,6,3,3
Aulny,kaelthas,288,mage,fire,6,3,3
Shermî,blackrock,288,mage,fire,6,3,3
Namemage,stormscale,288,mage,fire,6,3,3
Hey,khazgoroth,288,mage,fire,6,3,3
Funkyfriday,twisting-nether,288,mage,fire,6,3,3
Колтрэйн,blackscar,288,mage,fire,9,3,6
Trenpapi,twisting-nether,288,mage,fire,12,3,9
Oblív,ravencrest,288,mage,fire,12,3,9
Aylan,kazzak,288,mage,fire,12,3,9
Frökenfrost,stormscale,288,mage,fire,12,3,9
Rasaku,argent-dawn,288,mage,fire,12,3,9
Ceanna,argent-dawn,287,mage,fire,12,3,9
Regenn,kazzak,286,mage,fire,6,3,3
Critr,sylvanas,239,mage,fire,5,3,2
Shâdozy,blackmoore,239,mage,fire,5,3,2
Gerdâ,confrérie-du-thorium,239,mage,fire,9,4,5
Sokardes,the-maelstrom,192,mage,fire,4,3,1
Mðj,kazzak,192,mage,fire,6,2,4
Szarbán,ragnaros,192,mage,fire,6,2,4
Atzin,sanguino,192,mage,fire,6,2,4
Dnt,twilights-hammer,192,mage,fire,6,2,4
Watchmeclic,archimonde,192,mage,fire,6,2,4
Letitsnow,ravencrest,192,mage,fire,6,2,4
Zeklo,frostmane,192,mage,fire,6,2,4
Димаскунфу,howling-fjord,192,mage,fire,6,2,4
Sheepwithmeh,blackrock,192,mage,fire,6,2,4
Anisovsky,archimonde,192,mage,fire,6,2,4
Genviedgiclé,arathi,192,mage,fire,6,2,4
Malshash,outland,192,mage,fire,6,2,4
Деозар,eversong,192,mage,fire,6,2,4
Kilféfroid,ysondre,192,mage,fire,6,2,4
Skitsó,shadowsong,192,mage,fire,6,2,4
Anthrex,drakthul,192,mage,fire,6,2,4
Elynaé,draenor,192,mage,fire,6,2,4
Alarak,drakthul,192,mage,fire,6,2,4
Magenox,blackrock,192,mage,fire,6,2,4
Neird,sinstralis,192,mage,fire,12,2,10
Mesvef,archimonde,192,mage,fire,12,2,10
Magijoana,silvermoon,192,mage,fire,12,2,10
Nötmârtònxø,ragnaros,192,mage,fire,12,2,10
Firelight,argent-dawn,192,mage,fire,12,2,10
Hólmess,silvermoon,192,mage,fire,12,2,10
Çatàclysmík,kazzak,192,mage,fire,12,2,10
Kyani,mannoroth,192,mage,fire,12,2,10
Veveroiu,defias-brotherhood,191,mage,fire,6,2,4
Bobbasor,defias-brotherhood,138,mage,fire,11,4,7
Wizmec,silvermoon,96,mage,fire,6,1,5
Пламяорды,soulflayer,96,mage,fire,6,1,5
Овеча,gordunni,96,mage,fire,6,1,5
Миднаит,gordunni,96,mage,fire,6,1,5
Nilitar,kazzak,96,mage,fire,6,1,5
Nodnarb,dragonblight,96,mage,fire,6,1,5
Símple,sylvanas,96,mage,fire,6,1,5
Waan,sylvanas,96,mage,fire,6,1,5
Варриморыч,soulflayer,96,mage,fire,6,1,5
Røvso,ragnaros,96,mage,fire,6,1,5
Zoot,ravencrest,96,mage,fire,6,1,5
Проблембойх,gordunni,96,mage,fire,6,1,5
Tsungy,twisting-nether,96,mage,fire,6,1,5
Дизордерх,gordunni,96,mage,fire,6,1,5
Phenoxi,sylvanas,96,mage,fire,6,1,5
Wizarð,archimonde,96,mage,fire,6,1,5
Satheril,argent-dawn,96,mage,fire,6,1,5
Mexxî,thrall,96,mage,fire,6,1,5
Nuvx,ravencrest,96,mage,fire,6,1,5
Megancox,blackmoore,96,mage,fire,6,1,5
Nabucor,culte-de-la-rive-noire,95,mage,fire,6,1,5
Freezeballs,blackmoore,16,mage,fire,7,1,6
Serctheone,ravencrest,2031,mage,frost,90,44,46
Partypower,twisting-nether,2006,mage,frost,75,37,38
Oseri,defias-brotherhood,1989,mage,frost,77,37,40
Auchenax,argent-dawn,1960,mage,frost,83,46,37
Avizura,kazzak,1951,mage,frost,42,25,17
Gossipgirlz,outland,1923,mage,frost,100,55,45
Søz,agamaggan,1899,mage,frost,65,31,34
Rekzaop,ravencrest,1886,mage,frost,72,34,38
Jaimey,blackhand,1857,mage,frost,96,49,47
Dastion,ravencrest,1847,mage,frost,56,27,29
Exone,sylvanas,1828,mage,frost,66,32,34
Мэдвэйз,gordunni,1819,mage,frost,48,31,17
Nilitar,kazzak,1815,mage,frost,36,19,17
Bombswag,bloodhoof,1807,mage,frost,59,31,28
Xmoo,blackrock,1805,mage,frost,48,24,24
Novaco,ravencrest,1805,mage,frost,59,29,30
Tellysia,blackmoore,1802,mage,frost,47,26,21
Shíróyama,ravencrest,1789,mage,frost,84,51,33
Sukmikok,twisting-nether,1789,mage,frost,54,29,25
Sóz,ravencrest,1763,mage,frost,49,27,22
Efes,dun-modr,1763,mage,frost,42,23,19
Henqo,burning-legion,1762,mage,frost,58,25,33
Mexxî,thrall,1761,mage,frost,36,21,15
Tfmchamp,ravencrest,1755,mage,frost,27,21,6
Aìnz,hyjal,1751,mage,frost,48,21,27
Praison,defias-brotherhood,1748,mage,frost,42,26,16
Колинас,soulflayer,1748,mage,frost,101,50,51
Sondremage,outland,1746,mage,frost,116,55,61
Nightfee,eredar,1745,mage,frost,42,21,21
Fakér,ravencrest,1743,mage,frost,48,25,23
Blackfirez,ravencrest,1725,mage,frost,30,18,12
Äntigood,outland,1724,mage,frost,29,19,10
Tánu,quelthalas,1717,mage,frost,66,32,34
Lorothar,blackhand,1712,mage,frost,60,24,36
Drfeeldgoodd,mazrigos,1699,mage,frost,42,18,24
Comodus,ragnaros,1694,mage,frost,42,26,16
Ãshs,archimonde,1690,mage,frost,48,20,28
Алаурс,howling-fjord,1686,mage,frost,42,22,20
Jenggot,ravencrest,1681,mage,frost,35,18,17
Girldalf,silvermoon,1680,mage,frost,96,51,45
Emoden,silvermoon,1678,mage,frost,63,31,32
Raíner,eredar,1675,mage,frost,66,37,29
Vilenciaga,kazzak,1660,mage,frost,42,23,19
Ёкай,soulflayer,1659,mage,frost,54,40,14
Гекомория,fordragon,1654,mage,frost,74,39,35
Lo,kilrogg,1648,mage,frost,51,22,29
Crylz,kazzak,1644,mage,frost,41,20,21
Rambau,archimonde,1631,mage,frost,48,22,26
Thesiôu,ravencrest,1629,mage,frost,36,20,16
Chikounet,archimonde,1627,mage,frost,39,21,18
Thinamerican,defias-brotherhood,1620,mage,frost,24,18,6
Rosady,ragnaros,1615,mage,frost,30,17,13
Chareyla,argent-dawn,1615,mage,frost,71,38,33
Swizzy,arathor,1614,mage,frost,36,20,16
Magethings,kazzak,1611,mage,frost,36,21,15
Xæll,silvermoon,1611,mage,frost,114,61,53
Fireblood,runetotem,1610,mage,frost,48,21,27
Jirø,cthun,1602,mage,frost,34,18,16
Bzzr,tarren-mill,1601,mage,frost,54,35,19
Soloqtarget,archimonde,1598,mage,frost,36,17,19
Arimila,sylvanas,1596,mage,frost,48,23,25
Nickg,ravencrest,1595,mage,frost,36,19,17
Zimbabweborc,burning-legion,1591,mage,frost,24,17,7
Plætinum,ravencrest,1585,mage,frost,70,40,30
Sunehx,blackrock,1578,mage,frost,36,19,17
Ceillech,blackrock,1574,mage,frost,47,24,23
Joulz,ravencrest,1561,mage,frost,80,34,46
Sykz,hyjal,1559,mage,frost,47,24,23
Gaduz,kazzak,1556,mage,frost,66,28,38
Pryt,ragnaros,1555,mage,frost,60,30,30
Frostgodxqt,ravencrest,1545,mage,frost,37,19,18
Glowie,stormreaver,1532,mage,frost,30,16,14
Mlodysimba,burning-legion,1526,mage,frost,30,16,14
Èverix,ravencrest,1526,mage,frost,42,16,26
Buddi,burning-blade,1521,mage,frost,96,48,48
Zøe,aggra-português,1520,mage,frost,24,16,8
Сосулькина,gordunni,1520,mage,frost,71,39,32
Itzlucky,twisting-nether,1513,mage,frost,69,32,37
Iroya,festung-der-stürme,1506,mage,frost,48,20,28
Widmage,silvermoon,1505,mage,frost,42,16,26
Gêrky,drakthul,1503,mage,frost,63,33,30
Fullpolly,twisting-nether,1493,mage,frost,30,19,11
Únna,sanguino,1493,mage,frost,51,29,22
Cheerió,aggramar,1478,mage,frost,54,23,31
Магсимум,ashenvale,1476,mage,frost,30,18,12
Octtmiss,twisting-nether,1476,mage,frost,33,17,16
Homellander,silvermoon,1469,mage,frost,54,30,24
Nimdáá,stormscale,1467,mage,frost,47,32,15
Fïttan,stormscale,1464,mage,frost,44,20,24
Райоми,fordragon,1461,mage,frost,37,17,20
Smöked,tarren-mill,1458,mage,frost,169,90,79
Lesoleil,archimonde,1453,mage,frost,30,19,11
Khivax,twisting-nether,1448,mage,frost,66,27,39
Woorm,sylvanas,1446,mage,frost,76,44,32
Asiman,eredar,1436,mage,frost,30,15,15
Icefix,dun-modr,1434,mage,frost,53,28,25
Absoluteswag,tarren-mill,1416,mage,frost,33,16,17
Shainax,dun-modr,1410,mage,frost,71,35,36
Shüri,kazzak,1404,mage,frost,60,35,25
Phélenia,sargeras,1402,mage,frost,36,16,20
Alicánte,silvermoon,1380,mage,frost,36,16,20
Søphiâ,thrall,1374,mage,frost,39,23,16
Цепнойпёс,goldrinn,1371,mage,frost,34,17,17
Katarapower,silvermoon,1359,mage,frost,91,41,50
Jíncks,anachronos,1344,mage,frost,24,14,10
Ovrpwrdxd,kazzak,1337,mage,frost,18,14,4
Rihnou,blackmoore,1332,mage,frost,30,14,16
Sused,outland,1321,mage,frost,30,16,14
Вендайса,soulflayer,1319,mage,frost,60,41,19
Beaun,tarren-mill,1319,mage,frost,24,14,10
Демолюшн,soulflayer,1318,mage,frost,29,14,15
Dzikk,silvermoon,1318,mage,frost,30,14,16
Mxrrz,kazzak,1299,mage,frost,73,33,40
Psychosiss,kazzak,1298,mage,frost,49,27,22
Xânârchy,minahonda,1290,mage,frost,60,28,32
Seelengott,onyxia,1288,mage,frost,37,20,17
Iggilaus,blackhand,1275,mage,frost,48,22,26
Suidas,auchindoun,1273,mage,frost,42,18,24
Jedite,die-todeskrallen,1269,mage,frost,40,19,21
Гатмир,gordunni,1269,mage,frost,41,16,25
Apócalyptic,tarren-mill,1263,mage,frost,40,22,18
Pwntt,terenas,1248,mage,frost,39,15,24
Xenant,ravencrest,1246,mage,frost,30,13,17
Símple,sylvanas,1246,mage,frost,36,13,23
Ингилейф,howling-fjord,1245,mage,frost,36,13,23
Oiklo,eitrigg,1243,mage,frost,49,19,30
Rexør,frostwolf,1232,mage,frost,30,14,16
Maquiwizz,aggra-português,1230,mage,frost,24,13,11
Sekulicgoga,draenor,1228,mage,frost,81,44,37
Nups,ravencrest,1225,mage,frost,30,13,17
Alktraz,outland,1223,mage,frost,30,13,17
Fleurdelacur,ravencrest,1218,mage,frost,36,20,16
Laenadria,argent-dawn,1218,mage,frost,36,13,23
Iulie,kazzak,1212,mage,frost,30,13,17
Scaless,stormscale,1209,mage,frost,58,28,30
Хируэль,gordunni,1208,mage,frost,30,14,16
Лутиум,howling-fjord,1205,mage,frost,83,49,34
Abolf,twisting-nether,1189,mage,frost,24,13,11
Дарнивил,gordunni,1185,mage,frost,36,14,22
Qtiepatootie,silvermoon,1176,mage,frost,72,41,31
Teuboku,ysondre,1162,mage,frost,20,14,6
Oathkeepper,silvermoon,1158,mage,frost,58,28,30
Setyouoncs,ravencrest,1152,mage,frost,18,12,6
Барсуктри,deathguard,1152,mage,frost,18,12,6
Левелнес,howling-fjord,1148,mage,frost,30,12,18
Blasty,guldan,1148,mage,frost,33,13,20
Ghalanz,ravencrest,1138,mage,frost,36,12,24
Morphees,twisting-nether,1132,mage,frost,18,12,6
Animaze,argent-dawn,1131,mage,frost,60,33,27
Iamslow,sylvanas,1130,mage,frost,18,12,6
Tôke,kaelthas,1128,mage,frost,24,12,12
Tacto,ravencrest,1127,mage,frost,27,14,13
Amicuta,ravencrest,1125,mage,frost,36,17,19
Медивера,gordunni,1119,mage,frost,26,13,13
Айсвеном,gordunni,1111,mage,frost,24,12,12
Jackin,burning-legion,1109,mage,frost,30,12,18
Snowrain,chogall,1099,mage,frost,29,16,13
Sâkuya,blackrock,1086,mage,frost,26,12,14
Goeb,kazzak,1083,mage,frost,35,14,21
Mdog,stormreaver,1078,mage,frost,30,12,18
Demensida,ravencrest,1074,mage,frost,32,12,20
Ymirë,khaz-modan,1068,mage,frost,19,12,7
Дедамаг,eversong,1064,mage,frost,36,18,18
Лемозяра,gordunni,1056,mage,frost,12,11,1
Onnÿy,dun-modr,1056,mage,frost,18,11,7
Rere,zenedar,1054,mage,frost,26,13,13
Саваннхмаег,blackscar,1052,mage,frost,18,11,7
Юлианх,gordunni,1051,mage,frost,142,67,75
Pipihu,silvermoon,1050,mage,frost,18,11,7
Férécide,ysondre,1045,mage,frost,30,11,19
Синийлед,galakrond,1044,mage,frost,30,11,19
Вельдрик,soulflayer,1037,mage,frost,36,14,22
Lifemagic,chamber-of-aspects,1030,mage,frost,48,23,25
Schtenen,silvermoon,1024,mage,frost,56,22,34
Arkhaen,archimonde,1022,mage,frost,23,11,12
Erzà,todeswache,992,mage,frost,23,13,10
Fashes,sunstrider,991,mage,frost,30,14,16
Slobbery,aggramar,990,mage,frost,20,11,9
Инкрионити,gordunni,989,mage,frost,17,11,6
Kumakara,archimonde,981,mage,frost,24,12,12
Dnt,twilights-hammer,974,mage,frost,24,11,13
Niivel,ysondre,972,mage,frost,66,37,29
Clonefcf,sylvanas,971,mage,frost,31,16,15
Missl,draenor,960,mage,frost,18,10,8
Гамаюнх,deathguard,959,mage,frost,18,10,8
Alkhazzar,defias-brotherhood,958,mage,frost,24,10,14
Мибринк,soulflayer,958,mage,frost,30,10,20
Discomorph,the-maelstrom,957,mage,frost,18,10,8
Орижн,howling-fjord,952,mage,frost,18,10,8
Nightplays,sylvanas,951,mage,frost,18,10,8
Этридемус,howling-fjord,947,mage,frost,30,10,20
Килавый,eversong,938,mage,frost,12,10,2
Tommy,laughing-skull,927,mage,frost,23,10,13
Êmmá,blackmoore,926,mage,frost,48,20,28
Блья,howling-fjord,918,mage,frost,18,11,7
Ghostgivree,archimonde,917,mage,frost,30,16,14
Farrä,dun-modr,914,mage,frost,47,25,22
Stickiburn,malganis,912,mage,frost,21,10,11
Døliprane,garona,900,mage,frost,36,19,17
Amazona,veklor,891,mage,frost,14,11,3
Викликс,borean-tundra,874,mage,frost,16,11,5
Gliffy,terokkar,869,mage,frost,22,10,12
Fakeklepter,sylvanas,864,mage,frost,12,9,3
Ney,drakthul,864,mage,frost,12,9,3
Medara,darkspear,864,mage,frost,18,9,9
Surlancealot,outland,863,mage,frost,18,9,9
Kippercarry,outland,863,mage,frost,18,9,9
Stryee,ragnaros,862,mage,frost,12,9,3
Strychne,ragnaros,860,mage,frost,12,9,3
Evuryl,nemesis,858,mage,frost,12,9,3
Misscandy,doomhammer,858,mage,frost,18,9,9
Naote,blackhand,858,mage,frost,18,9,9
Suikune,twisting-nether,857,mage,frost,12,9,3
Voralastor,doomhammer,855,mage,frost,12,9,3
Zedsdeadbaby,argent-dawn,852,mage,frost,12,9,3
Tàylerdarden,nemesis,845,mage,frost,23,9,14
Baravar,blackrock,811,mage,frost,23,9,14
Bengé,ragnaros,796,mage,frost,16,9,7
Akâri,silvermoon,784,mage,frost,25,9,16
Séxmachiné,draenor,768,mage,frost,12,8,4
Afterimage,zuljin,768,mage,frost,12,8,4
Margistikus,die-aldor,768,mage,frost,54,28,26
Zelimeth,outland,768,mage,frost,18,8,10
Ввнд,galakrond,768,mage,frost,18,8,10
Väänik,draenor,768,mage,frost,18,8,10
Wmp,ravencrest,768,mage,frost,18,8,10
Нереварин,soulflayer,768,mage,frost,24,8,16
Tajos,drakthul,767,mage,frost,12,8,4
Gagaj,ravencrest,767,mage,frost,12,8,4
Quilava,ghostlands,766,mage,frost,12,8,4
Сибиди,gordunni,766,mage,frost,12,8,4
Iceterror,ravencrest,766,mage,frost,12,8,4
Tradez,norgannon,765,mage,frost,24,8,16
Lêgólás,blackmoore,762,mage,frost,18,8,10
Laurents,silvermoon,748,mage,frost,13,9,4
Xæl,ravencrest,733,mage,frost,18,8,10
Amalou,stormscale,729,mage,frost,26,9,17
Neymar,aszune,719,mage,frost,11,8,3
Rektd,blackhand,719,mage,frost,15,8,7
Shakéx,outland,672,mage,frost,12,7,5
Axhole,darksorrow,672,mage,frost,12,7,5
Вольняша,azuregos,672,mage,frost,12,7,5
Melleny,nemesis,672,mage,frost,12,7,5
Ôbsury,hyjal,672,mage,frost,12,7,5
Gavno,ravencrest,672,mage,frost,18,7,11
Миднаит,gordunni,672,mage,frost,18,7,11
Mageyreid,quelthalas,672,mage,frost,18,7,11
Preí,archimonde,672,mage,frost,18,7,11
Чистокрут,gordunni,672,mage,frost,18,7,11
Badphaz,frostmane,671,mage,frost,12,7,5
Ærrflôw,frostwolf,671,mage,frost,12,7,5
Frisstana,outland,671,mage,frost,12,7,5
Frostvirgin,twisting-nether,671,mage,frost,18,7,11
Ice,sargeras,671,mage,frost,18,7,11
Elcølgaø,sanguino,671,mage,frost,30,7,23
Aileean,burning-legion,669,mage,frost,18,7,11
Firehasse,draenor,668,mage,frost,18,7,11
Latiny,destromath,668,mage,frost,18,7,11
Iceicebáby,draenor,667,mage,frost,18,7,11
Toxttr,drakthul,657,mage,frost,12,7,5
Roughfked,silvermoon,657,mage,frost,18,7,11
Helloimgone,blackmoore,655,mage,frost,17,7,10
Speedshatter,aegwynn,640,mage,frost,16,7,9
Melíssa,silvermoon,576,mage,frost,6,6,0
Afklow,pozzo-delleternità,576,mage,frost,12,6,6
Zoot,ravencrest,576,mage,frost,12,6,6
Tiqma,sylvanas,576,mage,frost,12,6,6
Koreanbbq,outland,576,mage,frost,12,6,6
Obbjob,ravencrest,576,mage,frost,12,6,6
Watchmeclick,archimonde,576,mage,frost,12,6,6
Sainth,sanguino,576,mage,frost,12,6,6
Бингчилинг,howling-fjord,576,mage,frost,12,6,6
Джинетикс,deathguard,576,mage,frost,12,6,6
Nécrømage,confrérie-du-thorium,576,mage,frost,12,6,6
Insømnium,stormscale,576,mage,frost,12,6,6
Oscarwizyo,ravencrest,576,mage,frost,18,6,12
Layzzy,kazzak,576,mage,frost,18,6,12
Ury,hyjal,576,mage,frost,18,6,12
Bolesnimage,draenor,575,mage,frost,12,6,6
Stillfrostin,blackrock,575,mage,frost,12,6,6
Xakiha,kazzak,575,mage,frost,12,6,6
Corpusqq,eredar,575,mage,frost,18,6,12
Flakeh,outland,575,mage,frost,18,6,12
Saturator,burning-legion,575,mage,frost,18,6,12
Haljina,kazzak,574,mage,frost,18,6,12
Pinkis,darkmoon-faire,572,mage,frost,12,6,6
Piego,turalyon,565,mage,frost,12,6,6
Vilain,tarren-mill,559,mage,frost,11,6,5
Magerocks,ragnaros,480,mage,frost,6,5,1
Hérä,archimonde,480,mage,frost,6,5,1
Wortyvery,outland,480,mage,frost,6,5,1
Insanewizard,kazzak,480,mage,frost,6,5,1
Kaì,twisting-nether,480,mage,frost,6,5,1
Zehnvonzehn,antonidas,480,mage,frost,6,5,1
Фоулли,howling-fjord,480,mage,frost,10,6,4
Snowsánji,blackmoore,480,mage,frost,12,5,7
Zionw,frostwolf,480,mage,frost,12,5,7
Манднесс,azuregos,480,mage,frost,12,5,7
Moffmage,sylvanas,480,mage,frost,12,5,7
Thelastmage,outland,480,mage,frost,12,5,7
Bamz,malganis,480,mage,frost,12,5,7
Vathalis,zuluhed,480,mage,frost,12,5,7
Zhodusqt,ragnaros,480,mage,frost,12,5,7
Gàtsby,outland,480,mage,frost,12,5,7
Milkenjoyer,ravencrest,480,mage,frost,12,5,7
Stîckî,malganis,480,mage,frost,18,5,13
Zenó,blackrock,480,mage,frost,18,5,13
Muchmage,silvermoon,480,mage,frost,18,5,13
Pinguíni,aegwynn,479,mage,frost,6,5,1
Fôôxy,aegwynn,479,mage,frost,12,5,7
Winterblues,frostmourne,479,mage,frost,12,5,7
Rifinouu,archimonde,476,mage,frost,12,5,7
Lexalia,blackmoore,473,mage,frost,12,5,7
Blinkinggoat,ragnaros,448,mage,frost,16,5,11
Zaruna,arathor,432,mage,frost,9,6,3
Aerius,lightnings-blade,432,mage,frost,9,5,4
Swemagus,outland,432,mage,frost,9,5,4
Kelthuzed,twisting-nether,432,mage,frost,15,5,10
Naynn,archimonde,431,mage,frost,11,5,6
Leylus,blackmoore,399,mage,frost,5,5,0
Nightcàller,pozzo-delleternità,384,mage,frost,6,4,2
Zerobelow,silvermoon,384,mage,frost,6,4,2
Sìsia,ragnaros,384,mage,frost,6,4,2
Пламяорды,soulflayer,384,mage,frost,6,4,2
Primodious,kazzak,384,mage,frost,6,4,2
Evilmagíc,tarren-mill,384,mage,frost,6,4,2
Nötmârtònxø,ragnaros,384,mage,frost,6,4,2
Ðazzftw,archimonde,384,mage,frost,6,4,2
Crzyubrdrver,blackrock,384,mage,frost,6,4,2
Skdroople,ravencrest,384,mage,frost,6,4,2
Doryy,silvermoon,384,mage,frost,6,4,2
Pezi,outland,384,mage,frost,6,4,2
Phenoxi,sylvanas,384,mage,frost,6,4,2
Kleini,die-aldor,384,mage,frost,6,4,2
Botanicula,the-maelstrom,384,mage,frost,6,4,2
Хблэйз,howling-fjord,384,mage,frost,6,4,2
Leontus,outland,384,mage,frost,6,4,2
Celdra,blackrock,384,mage,frost,6,4,2
Santriss,defias-brotherhood,384,mage,frost,6,4,2
Tills,kargath,384,mage,frost,6,4,2
Proudmøøre,argent-dawn,384,mage,frost,6,4,2
Zionara,stormscale,384,mage,frost,6,4,2
Løwskìll,outland,384,mage,frost,6,4,2
Arcitech,tarren-mill,384,mage,frost,6,4,2
Lyndsey,dalaran,384,mage,frost,6,4,2
Razzìatore,pozzo-delleternità,384,mage,frost,7,4,3
Bebarz,darksorrow,384,mage,frost,12,4,8
Iceorb,azshara,384,mage,frost,12,4,8
Bestial,alexstrasza,384,mage,frost,12,4,8
Frigus,khaz-modan,384,mage,frost,12,4,8
Mgtowforlife,ravencrest,384,mage,frost,12,4,8
Gacosane,chamber-of-aspects,384,mage,frost,12,4,8
Tærrëñshíll,tarren-mill,384,mage,frost,12,4,8
Ahdetärjag,silvermoon,384,mage,frost,12,4,8
Muntiks,ravencrest,384,mage,frost,12,4,8
Unreadyx,archimonde,384,mage,frost,12,4,8
Ioriyagami,dragonmaw,384,mage,frost,12,4,8
Faunas,kazzak,384,mage,frost,12,4,8
Yshax,malganis,384,mage,frost,18,4,14
Ezzekkiel,elune,383,mage,frost,6,4,2
Heavyfire,kazzak,383,mage,frost,6,4,2
Wuffwuffspik,grim-batol,383,mage,frost,6,4,2
Lenycz,burning-blade,383,mage,frost,12,4,8
Brandonjames,ragnaros,383,mage,frost,12,4,8
Лордбелиал,soulflayer,382,mage,frost,12,4,8
Escobar,frostmane,335,mage,frost,8,5,3
Avb,twisting-nether,335,mage,frost,11,4,7
Sleîhg,sanguino,320,mage,frost,10,4,6
Regenn,kazzak,318,mage,frost,5,4,1
Bebenm,archimonde,288,mage,frost,6,3,3
Frostjävel,grim-batol,288,mage,frost,6,3,3
Zyllu,argent-dawn,288,mage,frost,6,3,3
Óuíja,outland,288,mage,frost,6,3,3
Овеча,gordunni,288,mage,frost,6,3,3
Narcîsa,sanguino,288,mage,frost,6,3,3
Magekaoz,sylvanas,288,mage,frost,6,3,3
Fboltprocd,ragnaros,288,mage,frost,6,3,3
Luckydo,turalyon,288,mage,frost,6,3,3
Walian,burning-blade,288,mage,frost,6,3,3
Samath,conseil-des-ombres,288,mage,frost,6,3,3
Bóósh,alakir,288,mage,frost,6,3,3
Snowberry,blackrock,288,mage,frost,6,3,3
Dumbledores,aegwynn,288,mage,frost,6,3,3
Kurtkiels,draenor,288,mage,frost,6,3,3
Onegaisenpai,ragnaros,288,mage,frost,6,3,3
Учительйода,ashenvale,288,mage,frost,6,3,3
Lyramage,draenor,288,mage,frost,6,3,3
Newtwo,ravencrest,288,mage,frost,6,3,3
Leafløver,ravencrest,288,mage,frost,6,3,3
Betomage,blackmoore,288,mage,frost,6,3,3
Siérra,outland,288,mage,frost,6,3,3
Øscarwizyo,ravencrest,288,mage,frost,6,3,3
Kurtcobain,draenor,288,mage,frost,6,3,3
Tommyboy,dragonblight,288,mage,frost,6,3,3
Dragotus,dragonblight,288,mage,frost,6,3,3
Морозящий,howling-fjord,288,mage,frost,6,3,3
Miihawkk,khaz-modan,288,mage,frost,6,3,3
Track,blackhand,288,mage,frost,6,3,3
Justvik,eredar,288,mage,frost,6,3,3
Frökenfrost,stormscale,288,mage,frost,6,3,3
Microsmag,thrall,288,mage,frost,6,3,3
Håtemebaby,kazzak,288,mage,frost,6,3,3
Broccosoup,kazzak,288,mage,frost,6,3,3
Haginatorr,twisting-nether,288,mage,frost,6,3,3
Ørixx,blackhand,288,mage,frost,6,3,3
Blinkmehome,silvermoon,288,mage,frost,12,3,9
Distrophy,vashj,288,mage,frost,12,3,9
Эммилиарда,gordunni,288,mage,frost,12,3,9
Deletron,ragnaros,288,mage,frost,12,3,9
Sérc,ravencrest,288,mage,frost,12,3,9
Naween,hyjal,288,mage,frost,12,3,9
Fernandéz,ravencrest,288,mage,frost,12,3,9
Wambamm,ravencrest,288,mage,frost,12,3,9
Voraxma,draenor,288,mage,frost,12,3,9
Gogara,kazzak,288,mage,frost,12,3,9
Деметрадон,gordunni,288,mage,frost,12,3,9
Magó,eredar,287,mage,frost,6,3,3
Ramcoz,twisting-nether,287,mage,frost,6,3,3
Rintoh,pozzo-delleternità,287,mage,frost,12,3,9
Momotemp,emerald-dream,287,mage,frost,12,3,9
Kasus,sporeggar,287,mage,frost,12,3,9
Гунмаказ,soulflayer,256,mage,frost,4,4,0
Lemonshelo,archimonde,240,mage,frost,9,3,6
Kaeki,khaz-modan,233,mage,frost,8,5,3
Rayniß,blackmoore,223,mage,frost,8,3,5
Ingibjorg,auchindoun,192,mage,frost,6,2,4
Gameart,alexstrasza,192,mage,frost,6,2,4
Aern,sinstralis,192,mage,frost,6,2,4
Mðj,kazzak,192,mage,frost,6,2,4
Sebers,kazzak,192,mage,frost,6,2,4
Rizzlybear,outland,192,mage,frost,6,2,4
Krookéd,tarren-mill,192,mage,frost,6,2,4
Магниффика,blackscar,192,mage,frost,6,2,4
Noxkin,stormscale,192,mage,frost,6,2,4
Smokedaddy,stormscale,192,mage,frost,6,2,4
Labius,dun-modr,192,mage,frost,6,2,4
Chíefsheep,thrall,192,mage,frost,6,2,4
Elor,eredar,192,mage,frost,6,2,4
Bloodymage,zenedar,192,mage,frost,6,2,4
Aelire,die-aldor,192,mage,frost,6,2,4
Welt,drakthul,192,mage,frost,6,2,4
Etherìon,los-errantes,192,mage,frost,6,2,4
Nøxas,archimonde,192,mage,frost,6,2,4
Magenox,blackrock,192,mage,frost,6,2,4
Meteofrost,draenor,192,mage,frost,6,2,4
Мэтаскрим,soulflayer,192,mage,frost,6,2,4
Незерёб,soulflayer,192,mage,frost,6,2,4
Løxyy,ysondre,192,mage,frost,6,2,4
Lillelord,defias-brotherhood,192,mage,frost,6,2,4
Frostbringer,archimonde,192,mage,frost,6,2,4
Tygaone,tirion,192,mage,frost,6,2,4
Юджегс,soulflayer,192,mage,frost,6,2,4
Frazztato,tarren-mill,192,mage,frost,6,2,4
Maveya,blackmoore,192,mage,frost,6,2,4
Dxdxdxdxdx,drakthul,192,mage,frost,6,2,4
Forestie,silvermoon,192,mage,frost,6,2,4
Broduy,draenor,192,mage,frost,6,2,4
Xenodike,blackrock,192,mage,frost,6,2,4
Knometsj,ravencrest,192,mage,frost,6,2,4
Silvariy,stormscale,192,mage,frost,12,2,10
Cavadrex,arathor,192,mage,frost,12,2,10
Mariujana,ravencrest,192,mage,frost,12,2,10
Eldariel,ravencrest,192,mage,frost,12,2,10
Rapidfrost,drakthul,192,mage,frost,12,2,10
Intêrnet,archimonde,192,mage,frost,12,2,10
Esscheppert,blackrock,192,mage,frost,12,2,10
Phibonaci,sylvanas,191,mage,frost,6,2,4
Mátraxx,silvermoon,191,mage,frost,12,2,10
Kyan,burning-legion,159,mage,frost,5,2,3
Dødo,archimonde,159,mage,frost,5,2,3
Iceym,ravencrest,159,mage,frost,5,2,3
Nebby,argent-dawn,159,mage,frost,5,2,3
Mínêrvâ,blackrock,144,mage,frost,3,3,0
Ehren,ravencrest,138,mage,frost,10,3,7
Skitsó,shadowsong,127,mage,frost,4,2,2
Markasaura,kazzak,127,mage,frost,8,2,6
Mutly,kazzak,96,mage,frost,3,2,1
Ntintsec,tarren-mill,96,mage,frost,3,2,1
Alphaburstqx,ragnaros,96,mage,frost,6,1,5
Teeclis,twisting-nether,96,mage,frost,6,1,5
Niladyel,hyjal,96,mage,frost,6,1,5
Aarcheon,kazzak,96,mage,frost,6,1,5
Shinzel,hyjal,96,mage,frost,6,1,5
Apeex,chamber-of-aspects,96,mage,frost,6,1,5
Testoletku,twisting-nether,96,mage,frost,6,1,5
Elynaé,draenor,96,mage,frost,6,1,5
Fîrestorm,doomhammer,96,mage,frost,6,1,5
Squìshy,magtheridon,96,mage,frost,6,1,5
Nullso,zuljin,96,mage,frost,6,1,5
Däpper,ragnaros,96,mage,frost,6,1,5
Charliezard,argent-dawn,96,mage,frost,6,1,5
Kaiyn,argent-dawn,96,mage,frost,6,1,5
Devòna,silvermoon,96,mage,frost,6,1,5
Sheeptonreup,archimonde,96,mage,frost,6,1,5
Réd,earthen-ring,96,mage,frost,6,1,5
Loskapaska,stormreaver,96,mage,frost,6,1,5
Boned,ravencrest,96,mage,frost,6,1,5
Xoouuboo,eredar,96,mage,frost,6,1,5
Колтрэйн,blackscar,96,mage,frost,6,1,5
Rezre,stormscale,96,mage,frost,6,1,5
Gocu,tarren-mill,63,mage,frost,2,2,0
Yoxt,blackhand,31,mage,frost,2,1,1
Fractox,ysondre,16,mage,frost,1,1,0
Xaramael,colinas-pardas,8,mage,frost,9,3,6
Nnsstt,zuljin,2277,monk,mistweaver,104,64,40
Brickedup,twisting-nether,2205,monk,mistweaver,85,51,34
Cocojones,tarren-mill,2194,monk,mistweaver,60,42,18
Tímmz,blackrock,2166,monk,mistweaver,84,53,31
Pennyflame,stormscale,2151,monk,mistweaver,101,60,41
Bankmw,tarren-mill,2131,monk,mistweaver,59,42,17
Umadbrohuh,outland,2126,monk,mistweaver,66,39,27
Beetlejuicé,stormscale,2118,monk,mistweaver,42,28,14
Sinted,blackmoore,2103,monk,mistweaver,83,52,31
Lifelessons,blackrock,2103,monk,mistweaver,57,34,23
Akanetsu,kazzak,2102,monk,mistweaver,78,48,30
Mibe,alonsus,2096,monk,mistweaver,102,50,52
Monkeyi,silvermoon,2076,monk,mistweaver,102,55,47
Ballademager,magtheridon,2036,monk,mistweaver,54,34,20
Seeyoulater,nemesis,2029,monk,mistweaver,84,45,39
Inlakech,auchindoun,2027,monk,mistweaver,123,71,52
Brxndimonk,antonidas,1985,monk,mistweaver,57,32,25
Loiyh,dun-modr,1969,monk,mistweaver,72,35,37
Øllen,stormscale,1961,monk,mistweaver,59,35,24
Lylleri,darksorrow,1960,monk,mistweaver,44,27,17
Stringg,zuljin,1953,monk,mistweaver,120,73,47
Kêkburagol,kazzak,1938,monk,mistweaver,66,45,21
Môûsè,ravencrest,1937,monk,mistweaver,24,21,3
Couchfrmikea,twisting-nether,1937,monk,mistweaver,72,38,34
Pwner,daggerspine,1933,monk,mistweaver,84,50,34
Karsat,hyjal,1932,monk,mistweaver,108,63,45
Tryhârdx,stormscale,1927,monk,mistweaver,60,31,29
Jades,emeriss,1925,monk,mistweaver,91,49,42
Manjini,blackhand,1908,monk,mistweaver,47,27,20
Muchobijca,defias-brotherhood,1891,monk,mistweaver,72,41,31
Effeots,blackrock,1888,monk,mistweaver,114,63,51
Vivie,destromath,1885,monk,mistweaver,36,20,16
Alprox,moonglade,1885,monk,mistweaver,104,57,47
Arenatwo,outland,1879,monk,mistweaver,51,33,18
Voltzeig,dentarg,1870,monk,mistweaver,114,60,54
Bigbummer,blackmoore,1863,monk,mistweaver,66,36,30
Hiryu,argent-dawn,1862,monk,mistweaver,53,31,22
Youkâi,blackrock,1859,monk,mistweaver,48,31,17
Glooni,blackrock,1858,monk,mistweaver,57,33,24
Monkeystar,archimonde,1856,monk,mistweaver,48,29,19
Фейкнаут,soulflayer,1855,monk,mistweaver,60,35,25
Коконгкд,blackscar,1852,monk,mistweaver,66,37,29
Bobthewild,draenor,1850,monk,mistweaver,131,57,74
Барлиос,soulflayer,1846,monk,mistweaver,90,57,33
Moariann,drakthul,1845,monk,mistweaver,96,49,47
Mistyhoe,twisting-nether,1843,monk,mistweaver,47,26,21
Siignmonk,ravencrest,1840,monk,mistweaver,54,31,23
Yungsooth,stormscale,1838,monk,mistweaver,53,37,16
Kratzl,blackrock,1838,monk,mistweaver,42,27,15
Zaerin,eredar,1833,monk,mistweaver,31,20,11
Motang,blackmoore,1833,monk,mistweaver,56,32,24
Døk,twisting-nether,1832,monk,mistweaver,30,22,8
Flandersmonk,archimonde,1829,monk,mistweaver,42,27,15
Deepl,dun-modr,1829,monk,mistweaver,48,24,24
Ðalvan,blackrock,1828,monk,mistweaver,54,27,27
Mistyfox,aszune,1828,monk,mistweaver,95,45,50
Halùnkè,eredar,1825,monk,mistweaver,36,26,10
Cranex,terenas,1823,monk,mistweaver,47,26,21
Tigermw,twisting-nether,1821,monk,mistweaver,49,31,18
Анстапоблх,grom,1820,monk,mistweaver,54,24,30
Teampro,ragnaros,1815,monk,mistweaver,119,62,57
Savagex,sanguino,1814,monk,mistweaver,60,32,28
Basilbrushxd,stormscale,1813,monk,mistweaver,48,27,21
Digzzy,draenor,1812,monk,mistweaver,57,32,25
Onlyfist,stormscale,1811,monk,mistweaver,42,28,14
Фунтос,soulflayer,1811,monk,mistweaver,30,19,11
Montex,stormscale,1811,monk,mistweaver,42,19,23
Суммрачная,gordunni,1810,monk,mistweaver,66,42,24
Bigbøøty,silvermoon,1810,monk,mistweaver,60,29,31
Karmasnitch,antonidas,1808,monk,mistweaver,66,38,28
Mobrac,twisting-nether,1807,monk,mistweaver,39,21,18
Veganweaver,ravencrest,1804,monk,mistweaver,36,28,8
Онимэшнеца,gordunni,1804,monk,mistweaver,48,28,20
Uwû,ravencrest,1801,monk,mistweaver,53,41,12
Limbaskalol,dun-modr,1800,monk,mistweaver,75,38,37
Howtoown,burning-legion,1792,monk,mistweaver,36,22,14
Kêkbûrâgól,kazzak,1787,monk,mistweaver,44,25,19
Supercoach,blackrock,1786,monk,mistweaver,75,44,31
Donitrivegas,blackrock,1783,monk,mistweaver,30,24,6
Musclemage,turalyon,1781,monk,mistweaver,48,24,24
Playbîrd,archimonde,1779,monk,mistweaver,89,47,42
Subàru,draenor,1772,monk,mistweaver,42,29,13
Stifmeister,tarren-mill,1772,monk,mistweaver,60,34,26
Шортмневноги,howling-fjord,1772,monk,mistweaver,41,20,21
Fatskeleton,stormreaver,1771,monk,mistweaver,326,160,166
Lünara,ambossar,1766,monk,mistweaver,42,27,15
Commadore,draenor,1766,monk,mistweaver,42,20,22
Элонхаск,gordunni,1764,monk,mistweaver,48,25,23
Вульфхильда,soulflayer,1761,monk,mistweaver,78,44,34
Hardi,chamber-of-aspects,1760,monk,mistweaver,61,36,25
Рендикаое,soulflayer,1758,monk,mistweaver,85,48,37
Youssee,silvermoon,1756,monk,mistweaver,104,66,38
Sniffn,ravencrest,1754,monk,mistweaver,54,35,19
Merína,ragnaros,1753,monk,mistweaver,72,44,28
Mcscrub,ragnaros,1742,monk,mistweaver,35,24,11
Ønlyfäns,kazzak,1740,monk,mistweaver,88,51,37
Zeoverx,ragnaros,1737,monk,mistweaver,48,22,26
Pyrìt,blackhand,1726,monk,mistweaver,24,22,2
Turricane,blackmoore,1722,monk,mistweaver,36,18,18
Séi,kazzak,1721,monk,mistweaver,36,18,18
Аскмилол,deathweaver,1717,monk,mistweaver,60,35,25
Neisha,drakthul,1711,monk,mistweaver,42,26,16
Pudgefeed,silvermoon,1701,monk,mistweaver,30,19,11
Mwrbg,shadowsong,1697,monk,mistweaver,77,44,33
Вакидзави,gordunni,1694,monk,mistweaver,48,31,17
Sugermum,outland,1692,monk,mistweaver,42,22,20
Táuriéll,eredar,1692,monk,mistweaver,36,18,18
Neszesmonk,ragnaros,1692,monk,mistweaver,54,25,29
Zorkev,dun-modr,1689,monk,mistweaver,41,27,14
Ранки,lich-king,1688,monk,mistweaver,36,20,16
Stramonk,nemesis,1684,monk,mistweaver,126,62,64
Shirkán,ragnaros,1680,monk,mistweaver,48,25,23
Chanzey,silvermoon,1678,monk,mistweaver,72,42,30
Papours,ysondre,1676,monk,mistweaver,30,22,8
Errowin,blackmoore,1676,monk,mistweaver,60,38,22
Trollroll,defias-brotherhood,1673,monk,mistweaver,60,33,27
Meemyo,blackmoore,1671,monk,mistweaver,47,21,26
Лиянь,soulflayer,1659,monk,mistweaver,42,23,19
Jabington,aegwynn,1657,monk,mistweaver,70,40,30
Репаблликуес,gordunni,1656,monk,mistweaver,34,20,14
Sîono,antonidas,1655,monk,mistweaver,24,18,6
Эддрос,gordunni,1655,monk,mistweaver,66,35,31
Gronkr,draenor,1654,monk,mistweaver,35,18,17
Brewnox,ragnaros,1651,monk,mistweaver,41,20,21
Haìryplotter,kazzak,1650,monk,mistweaver,42,23,19
Skailzkrt,hyjal,1649,monk,mistweaver,43,19,24
Fatdad,magtheridon,1647,monk,mistweaver,59,26,33
Mangi,rexxar,1645,monk,mistweaver,60,31,29
Imeon,dun-modr,1644,monk,mistweaver,30,18,12
Hamsster,ravencrest,1644,monk,mistweaver,48,25,23
Cåpybårå,outland,1643,monk,mistweaver,48,25,23
Hajlong,outland,1641,monk,mistweaver,42,21,21
Fistify,destromath,1639,monk,mistweaver,24,20,4
Suliya,zuluhed,1639,monk,mistweaver,36,21,15
Timboqt,blackmoore,1638,monk,mistweaver,70,43,27
Donkeymønk,hyjal,1636,monk,mistweaver,40,26,14
Loofey,ragnaros,1635,monk,mistweaver,36,19,17
Xoconut,kazzak,1634,monk,mistweaver,66,40,26
Swagmonk,silvermoon,1632,monk,mistweaver,38,20,18
Loobee,ravencrest,1630,monk,mistweaver,30,17,13
Orcimon,draenor,1630,monk,mistweaver,30,17,13
Seandyche,ravencrest,1628,monk,mistweaver,28,18,10
Lyashi,dalaran,1628,monk,mistweaver,36,20,16
Brewstea,kazzak,1627,monk,mistweaver,48,22,26
Бадика,howling-fjord,1625,monk,mistweaver,42,27,15
Йорита,soulflayer,1625,monk,mistweaver,30,17,13
Kîrânâ,eredar,1624,monk,mistweaver,24,17,7
Sâu,twisting-nether,1623,monk,mistweaver,30,17,13
Rullefald,stormscale,1623,monk,mistweaver,54,28,26
Meltfistqt,ravencrest,1621,monk,mistweaver,88,39,49
Shyheim,outland,1620,monk,mistweaver,24,20,4
Zonsym,twisting-nether,1620,monk,mistweaver,36,20,16
Кулакх,blackscar,1619,monk,mistweaver,36,20,16
Jetleê,eredar,1617,monk,mistweaver,138,71,67
Кулаквнос,gordunni,1616,monk,mistweaver,54,30,24
Kilograme,tarren-mill,1611,monk,mistweaver,42,21,21
Sinanger,dun-modr,1604,monk,mistweaver,72,37,35
Alë,argent-dawn,1603,monk,mistweaver,66,41,25
Encanthar,blackhand,1603,monk,mistweaver,88,48,40
Olympiiee,archimonde,1601,monk,mistweaver,158,84,74
Yörg,eredar,1600,monk,mistweaver,51,30,21
Soulring,kazzak,1595,monk,mistweaver,45,21,24
Brüderlichke,elune,1590,monk,mistweaver,42,19,23
Слишкомхорош,thermaplugg,1580,monk,mistweaver,23,17,6
Misthera,burning-legion,1580,monk,mistweaver,48,22,26
Zenfir,sylvanas,1577,monk,mistweaver,42,30,12
Wrv,kazzak,1573,monk,mistweaver,60,25,35
Warsox,aegwynn,1570,monk,mistweaver,48,26,22
Bullergøjen,ravencrest,1568,monk,mistweaver,36,27,9
Snookzlol,aegwynn,1568,monk,mistweaver,41,25,16
Ultdave,eredar,1568,monk,mistweaver,57,32,25
Pitrols,twisting-nether,1566,monk,mistweaver,36,21,15
Gronoz,drakthul,1562,monk,mistweaver,66,43,23
Неэверида,deepholm,1561,monk,mistweaver,48,33,15
Òó,vashj,1558,monk,mistweaver,42,20,22
Soulxq,blackrock,1557,monk,mistweaver,72,40,32
Unsanegodx,ravencrest,1553,monk,mistweaver,30,22,8
Мефодийкун,howling-fjord,1550,monk,mistweaver,36,18,18
Binkote,zuljin,1546,monk,mistweaver,41,25,16
Macpunchy,defias-brotherhood,1545,monk,mistweaver,30,18,12
Sneezaø,ravencrest,1541,monk,mistweaver,114,66,48
Pamtu,dun-modr,1539,monk,mistweaver,36,21,15
Quendiz,frostwolf,1535,monk,mistweaver,24,16,8
Pembi,blades-edge,1534,monk,mistweaver,80,39,41
Véxyra,draenor,1529,monk,mistweaver,24,16,8
Hôn,sanguino,1528,monk,mistweaver,23,17,6
Miînd,tarren-mill,1527,monk,mistweaver,42,27,15
Kåýðø,archimonde,1526,monk,mistweaver,48,26,22
Jingfeng,arthas,1526,monk,mistweaver,30,16,14
Shadezz,blackmoore,1522,monk,mistweaver,24,16,8
Áyell,archimonde,1519,monk,mistweaver,42,27,15
Jacksa,bronze-dragonflight,1515,monk,mistweaver,30,16,14
Dicedkiwi,quelthalas,1513,monk,mistweaver,54,35,19
Urbàs,blackmoore,1507,monk,mistweaver,36,25,11
Smâsh,blackhand,1506,monk,mistweaver,34,25,9
Ceeja,blackmoore,1503,monk,mistweaver,35,22,13
Gravityfist,aegwynn,1503,monk,mistweaver,36,18,18
Caniluvz,eredar,1501,monk,mistweaver,24,16,8
Monkim,chogall,1499,monk,mistweaver,24,16,8
Onlyfunn,sanguino,1499,monk,mistweaver,30,16,14
Cykatea,dun-modr,1495,monk,mistweaver,157,85,72
Monkzdino,destromath,1494,monk,mistweaver,47,24,23
Rzi,amanthul,1493,monk,mistweaver,71,41,30
Zýru,ragnaros,1490,monk,mistweaver,29,18,11
Pøwcow,blackrock,1486,monk,mistweaver,101,56,45
Moveietss,stormscale,1485,monk,mistweaver,18,16,2
Kroyus,antonidas,1483,monk,mistweaver,48,28,20
Idrdob,kazzak,1479,monk,mistweaver,63,36,27
Notachi,doomhammer,1471,monk,mistweaver,77,38,39
Loddarita,ravencrest,1466,monk,mistweaver,30,23,7
Noni,gorgonnash,1459,monk,mistweaver,65,31,34
Аци,blackscar,1456,monk,mistweaver,30,16,14
Watchmedamp,draenor,1450,monk,mistweaver,75,46,29
Çoomðragon,stormscale,1439,monk,mistweaver,18,15,3
Монккд,gordunni,1439,monk,mistweaver,69,43,26
Prettysus,silvermoon,1439,monk,mistweaver,30,18,12
Seventhirty,ravencrest,1439,monk,mistweaver,30,15,15
Swaghäuser,blackmoore,1439,monk,mistweaver,54,22,32
Sadmw,archimonde,1438,monk,mistweaver,24,15,9
Monkrah,blackmoore,1436,monk,mistweaver,30,15,15
Orgasmix,tarren-mill,1436,monk,mistweaver,36,16,20
Zoida,azuremyst,1433,monk,mistweaver,30,15,15
Dudulinda,silvermoon,1432,monk,mistweaver,42,23,19
Yarie,blackmoore,1432,monk,mistweaver,66,33,33
Jerymonk,tarren-mill,1421,monk,mistweaver,30,16,14
Woushou,outland,1420,monk,mistweaver,48,31,17
Setup,thrall,1420,monk,mistweaver,55,32,23
Njursten,twilights-hammer,1420,monk,mistweaver,111,50,61
Biftas,nagrand,1415,monk,mistweaver,27,16,11
Fistingfury,burning-blade,1415,monk,mistweaver,48,24,24
Nêøø,blackrock,1414,monk,mistweaver,67,45,22
Mistsen,kazzak,1414,monk,mistweaver,75,44,31
Notfist,kazzak,1411,monk,mistweaver,30,19,11
Chiuna,sylvanas,1411,monk,mistweaver,30,15,15
Самадайка,howling-fjord,1411,monk,mistweaver,50,24,26
Salsina,nemesis,1409,monk,mistweaver,62,37,25
Haxxo,die-nachtwache,1387,monk,mistweaver,32,22,10
Räyh,outland,1387,monk,mistweaver,33,16,17
Endorrphine,ravencrest,1387,monk,mistweaver,70,28,42
Rullsimpa,ravencrest,1387,monk,mistweaver,41,15,26
Monkgd,sylvanas,1384,monk,mistweaver,96,54,42
Medovic,blackmoore,1380,monk,mistweaver,81,46,35
Kruemelkeks,frostwolf,1378,monk,mistweaver,52,31,21
Beaglemo,blackrock,1366,monk,mistweaver,35,15,20
Romk,darkspear,1352,monk,mistweaver,36,25,11
Патаомальчик,blackscar,1352,monk,mistweaver,35,15,20
Ричфлекс,howling-fjord,1344,monk,mistweaver,66,41,25
Skailzkrtwo,hyjal,1341,monk,mistweaver,24,14,10
Adis,nerathor,1337,monk,mistweaver,24,14,10
Aseidith,tarren-mill,1337,monk,mistweaver,24,14,10
Neash,silvermoon,1337,monk,mistweaver,24,14,10
Rocknreroll,executus,1336,monk,mistweaver,24,14,10
Slugerpigen,stormscale,1333,monk,mistweaver,36,24,12
Baddany,sanguino,1332,monk,mistweaver,24,16,8
Loreo,burning-legion,1332,monk,mistweaver,75,47,28
Incapme,outland,1330,monk,mistweaver,42,23,19
Vetocorleone,kazzak,1325,monk,mistweaver,35,21,14
Pandimaci,ragnaros,1317,monk,mistweaver,35,22,13
Mistbringer,kazzak,1315,monk,mistweaver,78,37,41
Bluum,ravencrest,1315,monk,mistweaver,36,16,20
Civix,sanguino,1305,monk,mistweaver,24,15,9
Orkiya,archimonde,1305,monk,mistweaver,72,35,37
Nesthorian,draenor,1297,monk,mistweaver,76,40,36
Камикадзэн,gordunni,1296,monk,mistweaver,24,15,9
Zenmist,kazzak,1294,monk,mistweaver,23,14,9
Gigilonis,korgall,1292,monk,mistweaver,48,23,25
Assfist,drakthul,1288,monk,mistweaver,57,37,20
Boredom,wildhammer,1286,monk,mistweaver,30,21,9
Trivi,blackrock,1284,monk,mistweaver,39,21,18
Nìkâ,blackmoore,1278,monk,mistweaver,39,22,17
Ðëvx,argent-dawn,1275,monk,mistweaver,51,28,23
Ugras,auchindoun,1273,monk,mistweaver,36,14,22
Wwception,blackrock,1272,monk,mistweaver,26,14,12
Rymz,sanguino,1270,monk,mistweaver,28,17,11
Larå,ravencrest,1269,monk,mistweaver,65,31,34
Mishax,draenor,1268,monk,mistweaver,72,35,37
Kungfupandy,blackmoore,1264,monk,mistweaver,61,36,25
Szilvia,sylvanas,1263,monk,mistweaver,48,25,23
Macgyverr,outland,1258,monk,mistweaver,24,14,10
Трикленд,azuregos,1254,monk,mistweaver,30,15,15
Angeryw,kazzak,1248,monk,mistweaver,18,13,5
Vanost,kazzak,1248,monk,mistweaver,24,13,11
Chígoku,grim-batol,1248,monk,mistweaver,46,20,26
Zulein,defias-brotherhood,1247,monk,mistweaver,18,13,5
Jiafei,tarren-mill,1247,monk,mistweaver,24,13,11
Zevenblad,stormscale,1247,monk,mistweaver,24,13,11
Yto,gorgonnash,1247,monk,mistweaver,24,13,11
Meldi,ravencrest,1247,monk,mistweaver,24,13,11
Egg,frostmane,1246,monk,mistweaver,24,13,11
Bigmckoy,kazzak,1242,monk,mistweaver,21,14,7
Mmrkick,kazzak,1241,monk,mistweaver,24,13,11
Tjann,stormscale,1240,monk,mistweaver,18,13,5
Dearmw,silvermoon,1240,monk,mistweaver,24,13,11
Kayen,frostwhisper,1238,monk,mistweaver,46,23,23
Fungku,azjolnerub,1238,monk,mistweaver,26,13,13
Monkehst,dun-modr,1227,monk,mistweaver,48,20,28
Zinnout,twisting-nether,1226,monk,mistweaver,18,13,5
Xplosiv,twisting-nether,1220,monk,mistweaver,18,13,5
Wteg,emerald-dream,1220,monk,mistweaver,30,14,16
Fistus,dentarg,1214,monk,mistweaver,29,13,16
Bhasundara,turalyon,1212,monk,mistweaver,88,51,37
Mareki,nethersturm,1209,monk,mistweaver,24,13,11
Freemann,archimonde,1204,monk,mistweaver,70,33,37
Farmander,silvermoon,1197,monk,mistweaver,42,21,21
Yuukiiqt,kult-der-verdammten,1197,monk,mistweaver,29,13,16
Mîstxd,kazzak,1181,monk,mistweaver,17,13,4
Krylin,antonidas,1176,monk,mistweaver,27,13,14
Chainster,defias-brotherhood,1167,monk,mistweaver,40,19,21
Webhottie,twisting-nether,1151,monk,mistweaver,18,12,6
Waramow,eredar,1151,monk,mistweaver,18,12,6
Phyxone,twisting-nether,1151,monk,mistweaver,24,12,12
Zesha,zuljin,1151,monk,mistweaver,30,12,18
Xado,aegwynn,1150,monk,mistweaver,18,12,6
Нунтяк,gordunni,1150,monk,mistweaver,24,12,12
Vooxis,drakthul,1147,monk,mistweaver,18,12,6
Shiftchenko,stormscale,1142,monk,mistweaver,42,24,18
Xiaokingqvq,silvermoon,1142,monk,mistweaver,24,12,12
Guthäxlul,khazgoroth,1138,monk,mistweaver,69,37,32
Cicera,kazzak,1138,monk,mistweaver,30,12,18
Mondrim,burning-legion,1138,monk,mistweaver,34,13,21
Riendy,silvermoon,1137,monk,mistweaver,18,12,6
Lubeï,kirin-tor,1131,monk,mistweaver,34,21,13
Graffy,eonar,1128,monk,mistweaver,18,13,5
Pundok,blackrock,1124,monk,mistweaver,24,12,12
Тамаз,gordunni,1119,monk,mistweaver,29,12,17
Tintatama,aszune,1113,monk,mistweaver,76,32,44
Grauwe,stormscale,1102,monk,mistweaver,21,13,8
Alphafist,argent-dawn,1093,monk,mistweaver,24,12,12
Mofisto,bladefist,1093,monk,mistweaver,36,13,23
Quendi,arthas,1090,monk,mistweaver,23,12,11
Tripitakâ,dun-modr,1085,monk,mistweaver,29,12,17
Løsang,blackrock,1083,monk,mistweaver,30,18,12
Adgoh,tarren-mill,1070,monk,mistweaver,17,14,3
Hurricaine,hyjal,1056,monk,mistweaver,18,11,7
Izuwumi,ragnaros,1056,monk,mistweaver,18,11,7
Öhlinmonk,outland,1056,monk,mistweaver,18,11,7
Marqinio,archimonde,1056,monk,mistweaver,18,11,7
Precocconx,stormreaver,1056,monk,mistweaver,18,11,7
Фуфинус,gordunni,1056,monk,mistweaver,24,11,13
Koguosa,outland,1055,monk,mistweaver,12,11,1
Behrens,defias-brotherhood,1055,monk,mistweaver,18,11,7
Kakor,gorgonnash,1055,monk,mistweaver,18,11,7
Birgitbuddha,gorgonnash,1055,monk,mistweaver,18,11,7
Darlaa,ravencrest,1055,monk,mistweaver,18,11,7
Chibuku,burning-legion,1055,monk,mistweaver,18,11,7
Manatoiled,draenor,1055,monk,mistweaver,18,11,7
Cochonhalall,archimonde,1055,monk,mistweaver,24,11,13
Rolxx,twisting-nether,1055,monk,mistweaver,30,11,19
Jakethestake,twilights-hammer,1054,monk,mistweaver,12,11,1
Hærleyquin,ravencrest,1054,monk,mistweaver,18,11,7
Tráïner,madmortem,1054,monk,mistweaver,30,11,19
Pepesmacks,kazzak,1052,monk,mistweaver,18,11,7
Mankee,kazzak,1052,monk,mistweaver,26,11,15
Brünó,kazzak,1046,monk,mistweaver,33,22,11
Mjaweaver,stormscale,1046,monk,mistweaver,56,20,36
Vanquishlølz,archimonde,1033,monk,mistweaver,27,11,16
Yahní,eredar,1032,monk,mistweaver,24,11,13
Dèathpunch,doomhammer,1025,monk,mistweaver,54,26,28
Mwmkgodxz,archimonde,1007,monk,mistweaver,15,12,3
Heäléna,ragnaros,979,monk,mistweaver,21,15,6
Birdymonk,boulderfist,964,monk,mistweaver,30,17,13
Glaphan,the-maelstrom,960,monk,mistweaver,12,10,2
Pizzabud,ravencrest,960,monk,mistweaver,12,10,2
Ashenore,outland,960,monk,mistweaver,18,10,8
Joke,ragnaros,960,monk,mistweaver,18,10,8
Homes,blackmoore,960,monk,mistweaver,18,10,8
Ræïzò,dun-morogh,960,monk,mistweaver,18,10,8
Kurbanov,stormscale,960,monk,mistweaver,18,10,8
Ffxivrefugee,argent-dawn,960,monk,mistweaver,18,10,8
Xoleck,aegwynn,960,monk,mistweaver,24,10,14
Citamonk,blackmoore,959,monk,mistweaver,12,10,2
Uckkm,ragnaros,959,monk,mistweaver,12,10,2
Malkaviano,kazzak,958,monk,mistweaver,16,11,5
Búns,draenor,958,monk,mistweaver,18,10,8
Sajin,la-croisade-écarlate,958,monk,mistweaver,18,10,8
Bigballs,ysera,958,monk,mistweaver,24,10,14
Karoou,kelthuzad,957,monk,mistweaver,24,10,14
Rheinair,antonidas,956,monk,mistweaver,24,10,14
Gråce,nemesis,954,monk,mistweaver,12,10,2
Extaszeh,turalyon,952,monk,mistweaver,12,10,2
Monkyd,stormscale,950,monk,mistweaver,18,10,8
Xwtdreamz,hyjal,946,monk,mistweaver,24,10,14
Changzu,sanguino,938,monk,mistweaver,18,12,6
Ariä,marécage-de-zangar,930,monk,mistweaver,24,13,11
Dícxi,ravencrest,910,monk,mistweaver,17,10,7
Tierrax,cthun,906,monk,mistweaver,22,12,10
Mer,outland,905,monk,mistweaver,20,11,9
Eclipsè,dragonmaw,889,monk,mistweaver,17,10,7
Fulgrem,stormscale,879,monk,mistweaver,13,10,3
Kaezm,blackrock,864,monk,mistweaver,12,9,3
Timmzý,blackmoore,864,monk,mistweaver,12,9,3
Problematic,blackmoore,864,monk,mistweaver,12,9,3
Ultrasense,outland,864,monk,mistweaver,18,9,9
Pogimonkey,ragnaros,864,monk,mistweaver,18,9,9
Fansolini,burning-legion,864,monk,mistweaver,18,9,9
Shixen,ragnaros,864,monk,mistweaver,18,9,9
Pafia,ysondre,864,monk,mistweaver,18,9,9
Polch,archimonde,864,monk,mistweaver,18,9,9
Bossmanfred,outland,863,monk,mistweaver,12,9,3
Simonex,ravencrest,863,monk,mistweaver,12,9,3
Shokko,uldaman,863,monk,mistweaver,18,9,9
Chàrràth,blackmoore,863,monk,mistweaver,18,9,9
Plaguer,nordrassil,863,monk,mistweaver,18,9,9
Eckø,rashgarroth,862,monk,mistweaver,12,9,3
Cbmonk,sylvanas,861,monk,mistweaver,12,9,3
Carnat,blackrock,861,monk,mistweaver,12,9,3
Lucebree,nozdormu,855,monk,mistweaver,18,9,9
Blackmonk,chromaggus,852,monk,mistweaver,18,9,9
Santoron,baelgun,816,monk,mistweaver,27,9,18
Drugashe,archimonde,815,monk,mistweaver,23,9,14
Tèam,defias-brotherhood,810,monk,mistweaver,15,9,6
Zeldrís,ragnaros,798,monk,mistweaver,26,9,17
Lanory,blackmoore,768,monk,mistweaver,12,8,4
Ðurîmar,ravencrest,768,monk,mistweaver,12,8,4
Mástermônkèy,tarren-mill,768,monk,mistweaver,12,8,4
Miamalkøva,nemesis,768,monk,mistweaver,12,8,4
Xadoqt,aegwynn,768,monk,mistweaver,12,8,4
Kirkeý,ravencrest,768,monk,mistweaver,12,8,4
Trashcarlita,eredar,768,monk,mistweaver,12,8,4
Тащунаскилле,thermaplugg,768,monk,mistweaver,12,8,4
Ikuyaa,ravencrest,768,monk,mistweaver,12,8,4
Jiuhjitsu,blackmoore,768,monk,mistweaver,12,8,4
Sonydl,archimonde,768,monk,mistweaver,16,9,7
Tøxicweaver,kazzak,768,monk,mistweaver,18,8,10
Эрмонд,soulflayer,768,monk,mistweaver,18,8,10
Ronkingkong,ravencrest,768,monk,mistweaver,18,8,10
Ryx,twisting-nether,768,monk,mistweaver,18,8,10
Adamlól,tarren-mill,768,monk,mistweaver,18,8,10
Nsq,ravencrest,768,monk,mistweaver,18,8,10
Mösêê,eredar,768,monk,mistweaver,28,9,19
Tokz,ravencrest,767,monk,mistweaver,12,8,4
Kapitan,sanguino,767,monk,mistweaver,12,8,4
Мистхоррор,gordunni,767,monk,mistweaver,12,8,4
Shiguru,dun-morogh,767,monk,mistweaver,12,8,4
Leblatt,blackhand,767,monk,mistweaver,12,8,4
Scare,stormreaver,767,monk,mistweaver,12,8,4
Freyas,outland,767,monk,mistweaver,18,8,10
Syyrø,silvermoon,767,monk,mistweaver,18,8,10
Тевикс,gordunni,767,monk,mistweaver,24,8,16
Индоран,howling-fjord,766,monk,mistweaver,12,8,4
Hersmonk,drakthul,765,monk,mistweaver,12,8,4
Wangho,magtheridon,760,monk,mistweaver,24,8,16
Hollymêdx,blackmoore,734,monk,mistweaver,19,9,10
Diffenbachia,outland,719,monk,mistweaver,9,9,0
Тиктокмонк,gordunni,719,monk,mistweaver,15,9,6
Hidekami,archimonde,702,monk,mistweaver,22,8,14
Vivir,stormreaver,687,monk,mistweaver,13,8,5
Keeba,kirin-tor,679,monk,mistweaver,99,42,57
Frajer,auchindoun,672,monk,mistweaver,12,7,5
Linshai,eredar,672,monk,mistweaver,12,7,5
Hessuzen,stormreaver,672,monk,mistweaver,12,7,5
Eynodiggity,blackmoore,672,monk,mistweaver,12,7,5
Kyleestrutt,stormscale,672,monk,mistweaver,12,7,5
Monkler,blackhand,672,monk,mistweaver,12,7,5
Kushvendorx,silvermoon,672,monk,mistweaver,12,7,5
Cubw,archimonde,672,monk,mistweaver,12,7,5
Kattlåda,darkspear,672,monk,mistweaver,12,7,5
Crñ,blackmoore,672,monk,mistweaver,12,7,5
Flowy,uldum,672,monk,mistweaver,12,7,5
Numpys,sanguino,672,monk,mistweaver,12,7,5
Fugmonk,ravencrest,672,monk,mistweaver,12,7,5
Shkorwi,drakthul,672,monk,mistweaver,12,7,5
Prototyp,burning-legion,672,monk,mistweaver,12,7,5
Kitingbuddha,aegwynn,672,monk,mistweaver,12,7,5
Çz,tarren-mill,672,monk,mistweaver,12,7,5
Taìka,archimonde,672,monk,mistweaver,12,7,5
Sart,aerie-peak,672,monk,mistweaver,12,7,5
Bighealz,aggra-português,672,monk,mistweaver,12,7,5
Flexify,outland,672,monk,mistweaver,12,7,5
Dollyqt,ravencrest,672,monk,mistweaver,12,7,5
Xdhehehexd,twisting-nether,672,monk,mistweaver,12,7,5
Thayne,blades-edge,672,monk,mistweaver,12,7,5
Yuuhai,ravencrest,672,monk,mistweaver,12,7,5
Dodomino,archimonde,672,monk,mistweaver,12,7,5
Dmonk,alakir,672,monk,mistweaver,18,7,11
Yukimøn,hyjal,671,monk,mistweaver,12,7,5
Chigee,kazzak,671,monk,mistweaver,12,7,5
Кисеч,soulflayer,671,monk,mistweaver,12,7,5
Dumplings,earthen-ring,671,monk,mistweaver,12,7,5
Monkield,kazzak,671,monk,mistweaver,15,8,7
Uncleheal,tarren-mill,671,monk,mistweaver,18,7,11
Mistïnguette,dalaran,670,monk,mistweaver,12,7,5
Worf,haomarush,670,monk,mistweaver,12,7,5
Zendyy,argent-dawn,670,monk,mistweaver,12,7,5
Carcasce,la-croisade-écarlate,665,monk,mistweaver,18,7,11
Celestine,mugthol,659,monk,mistweaver,18,7,11
Fistarfrans,sylvanas,639,monk,mistweaver,8,8,0
Chucknorrís,kilrogg,624,monk,mistweaver,15,7,8
Allosthenos,ravencrest,623,monk,mistweaver,15,7,8
ßæutiful,silvermoon,616,monk,mistweaver,24,10,14
Cybert,blackmoore,607,monk,mistweaver,11,7,4
Ofwgkta,moonglade,576,monk,mistweaver,6,6,0
Lilithrevan,frostmourne,576,monk,mistweaver,6,6,0
Balia,blackrock,576,monk,mistweaver,12,6,6
Aritisi,tarren-mill,576,monk,mistweaver,12,6,6
Annoyingtwo,archimonde,576,monk,mistweaver,12,6,6
Meliowo,ravencrest,576,monk,mistweaver,12,6,6
Maybeexm,ravencrest,576,monk,mistweaver,12,6,6
Féfè,archimonde,576,monk,mistweaver,12,6,6
Xarêlla,aegwynn,576,monk,mistweaver,12,6,6
Gízmö,tarren-mill,576,monk,mistweaver,12,6,6
Yumhai,dun-modr,576,monk,mistweaver,12,6,6
Гроксси,howling-fjord,576,monk,mistweaver,12,6,6
Srdarr,kazzak,576,monk,mistweaver,12,6,6
Poohya,silvermoon,576,monk,mistweaver,12,6,6
Bitbird,zirkel-des-cenarius,576,monk,mistweaver,12,6,6
Vedak,stormreaver,576,monk,mistweaver,12,6,6
Mørbradgryde,silvermoon,576,monk,mistweaver,12,6,6
Твикса,soulflayer,576,monk,mistweaver,12,6,6
Visk,blackmoore,576,monk,mistweaver,12,6,6
Telder,sylvanas,576,monk,mistweaver,12,6,6
Коумана,gordunni,576,monk,mistweaver,15,7,8
Saitamä,archimonde,576,monk,mistweaver,18,6,12
Германика,soulflayer,576,monk,mistweaver,18,6,12
Heyami,ravencrest,576,monk,mistweaver,24,6,18
Tojokirumi,dalaran,575,monk,mistweaver,6,6,0
Vexzen,tarren-mill,575,monk,mistweaver,12,6,6
Tily,stormreaver,575,monk,mistweaver,12,6,6
Rakowo,arthas,575,monk,mistweaver,12,6,6
Kungfubatti,stormscale,575,monk,mistweaver,12,6,6
Samie,ravencrest,575,monk,mistweaver,12,6,6
ßojo,kazzak,575,monk,mistweaver,12,6,6
Drlyn,blackmoore,575,monk,mistweaver,12,6,6
Zøubida,draenor,575,monk,mistweaver,12,6,6
Painswîft,blackhand,575,monk,mistweaver,18,6,12
Джоский,borean-tundra,575,monk,mistweaver,24,6,18
Othalain,silvermoon,574,monk,mistweaver,12,6,6
Sydras,silvermoon,574,monk,mistweaver,12,6,6
Carloz,drakthul,574,monk,mistweaver,12,6,6
Zedruu,tarren-mill,571,monk,mistweaver,12,6,6
Luru,outland,527,monk,mistweaver,11,6,5
Dipdop,blackhand,517,monk,mistweaver,27,7,20
Maikez,stormreaver,512,monk,mistweaver,16,6,10
Tarzaki,hyjal,494,monk,mistweaver,13,6,7
Lovange,silvermoon,480,monk,mistweaver,6,5,1
Dihsa,ragnaros,480,monk,mistweaver,6,5,1
Dukhi,kazzak,480,monk,mistweaver,6,5,1
Такиера,gordunni,480,monk,mistweaver,6,5,1
Blinkër,sanguino,480,monk,mistweaver,6,5,1
Applestrûdel,blackrock,480,monk,mistweaver,6,5,1
Kebabrolle,blackrock,480,monk,mistweaver,6,5,1
Roadrunnér,ravencrest,480,monk,mistweaver,6,5,1
Uao,tarren-mill,480,monk,mistweaver,6,5,1
Sio,dentarg,480,monk,mistweaver,6,5,1
Holyrop,aegwynn,480,monk,mistweaver,6,5,1
Павнмонкх,gordunni,480,monk,mistweaver,6,5,1
Residùe,kazzak,480,monk,mistweaver,6,5,1
Pafia,sargeras,480,monk,mistweaver,6,5,1
Ohmegah,frostmane,480,monk,mistweaver,6,5,1
Stromon,silvermoon,480,monk,mistweaver,6,5,1
Керизз,gordunni,480,monk,mistweaver,6,5,1
Habmit,ravencrest,480,monk,mistweaver,6,5,1
Nyrkkiseski,outland,480,monk,mistweaver,6,5,1
Pandacus,silvermoon,480,monk,mistweaver,12,5,7
Kandislee,ravencrest,480,monk,mistweaver,12,5,7
Scz,draenor,480,monk,mistweaver,12,5,7
Qî,ravencrest,480,monk,mistweaver,12,5,7
Siezlebabo,blackrock,480,monk,mistweaver,12,5,7
Holyropx,aegwynn,480,monk,mistweaver,12,5,7
Gemil,argent-dawn,480,monk,mistweaver,12,5,7
Shreckmonk,burning-blade,480,monk,mistweaver,12,5,7
Musashiden,twisting-nether,480,monk,mistweaver,12,5,7
Zóma,ragnaros,480,monk,mistweaver,12,5,7
Puddinpop,auchindoun,480,monk,mistweaver,12,5,7
Madraven,ravencrest,480,monk,mistweaver,18,5,13
Patiencebro,archimonde,480,monk,mistweaver,18,5,13
Ivi,neptulon,479,monk,mistweaver,12,5,7
Jumper,xavius,479,monk,mistweaver,12,5,7
Toaborsten,tarren-mill,478,monk,mistweaver,6,5,1
Апесиинка,gordunni,477,monk,mistweaver,12,5,7
Filomenata,rexxar,469,monk,mistweaver,19,5,14
Pìmpìnelle,garona,432,monk,mistweaver,9,6,3
Dræk,twisting-nether,426,monk,mistweaver,19,6,13
Годъяр,gordunni,415,monk,mistweaver,8,5,3
Якунка,soulflayer,384,monk,mistweaver,6,4,2
Latify,todeswache,384,monk,mistweaver,6,4,2
Greentape,kiljaeden,384,monk,mistweaver,6,4,2
Elmonkodonko,draenor,384,monk,mistweaver,6,4,2
Peaceweaver,ravencrest,384,monk,mistweaver,6,4,2
Coularx,stormscale,384,monk,mistweaver,6,4,2
Trancendent,silvermoon,384,monk,mistweaver,6,4,2
Lmnsx,ravencrest,384,monk,mistweaver,6,4,2
Леобтв,soulflayer,384,monk,mistweaver,6,4,2
Sotqyy,stormscale,384,monk,mistweaver,6,4,2
Oiorie,twisting-nether,384,monk,mistweaver,6,4,2
Missislee,aegwynn,384,monk,mistweaver,6,4,2
Ennamoly,blackmoore,384,monk,mistweaver,6,4,2
Bhrag,die-aldor,384,monk,mistweaver,6,4,2
Mushush,draenor,384,monk,mistweaver,6,4,2
Глитч,deepholm,384,monk,mistweaver,6,4,2
Эрумонк,gordunni,384,monk,mistweaver,6,4,2
Ryac,defias-brotherhood,384,monk,mistweaver,6,4,2
Inthepoopa,outland,384,monk,mistweaver,6,4,2
Bamiegoreng,aegwynn,384,monk,mistweaver,6,4,2
Barracüs,dun-modr,384,monk,mistweaver,6,4,2
Bekachu,ragnaros,384,monk,mistweaver,6,4,2
Panson,twisting-nether,384,monk,mistweaver,6,4,2
Apolskis,ravencrest,384,monk,mistweaver,6,4,2
Vienuolè,silvermoon,384,monk,mistweaver,6,4,2
Xurf,draenor,384,monk,mistweaver,6,4,2
Mjoo,blackrock,384,monk,mistweaver,6,4,2
Naìsh,arygos,384,monk,mistweaver,6,4,2
Alomonk,archimonde,384,monk,mistweaver,6,4,2
Camlen,draenor,384,monk,mistweaver,6,4,2
Jackål,silvermoon,384,monk,mistweaver,6,4,2
Sugra,frostwolf,384,monk,mistweaver,6,4,2
Nillebpgodx,kazzak,384,monk,mistweaver,6,4,2
Xianxiaa,ravencrest,384,monk,mistweaver,6,4,2
Kickin,burning-legion,384,monk,mistweaver,6,4,2
Nulojeu,archimonde,384,monk,mistweaver,6,4,2
Nimander,burning-legion,384,monk,mistweaver,6,4,2
Bigflex,conseil-des-ombres,384,monk,mistweaver,6,4,2
Ouhmaikgød,dun-modr,384,monk,mistweaver,6,4,2
Brewswíllis,tarren-mill,384,monk,mistweaver,6,4,2
Mâjô,blackhand,384,monk,mistweaver,6,4,2
Bratana,dun-morogh,384,monk,mistweaver,6,4,2
Audaz,dun-modr,384,monk,mistweaver,12,4,8
Gakunie,blackhand,384,monk,mistweaver,12,4,8
Монкиннияя,gordunni,384,monk,mistweaver,12,4,8
Jyll,malganis,384,monk,mistweaver,12,4,8
Dromarch,dun-modr,384,monk,mistweaver,12,4,8
Ляосинь,deepholm,383,monk,mistweaver,6,4,2
Сукавкимоно,soulflayer,383,monk,mistweaver,6,4,2
Drpajhiwo,burning-legion,383,monk,mistweaver,6,4,2
Psychö,zuljin,383,monk,mistweaver,12,4,8
Xentimus,kazzak,383,monk,mistweaver,12,4,8
Fkflying,defias-brotherhood,381,monk,mistweaver,12,4,8
Chiá,tarren-mill,351,monk,mistweaver,11,4,7
Andrah,blackmoore,335,monk,mistweaver,11,4,7
Kégman,silvermoon,330,monk,mistweaver,10,8,2
Ilikeducks,ravencrest,319,monk,mistweaver,5,4,1
Strillen,twisting-nether,304,monk,mistweaver,7,4,3
Benzzy,ragnaros,304,monk,mistweaver,7,4,3
Uggs,hyjal,288,monk,mistweaver,6,3,3
Lanuia,aegwynn,288,monk,mistweaver,6,3,3
Musaya,chamber-of-aspects,288,monk,mistweaver,6,3,3
Leikô,grim-batol,288,monk,mistweaver,6,3,3
Atommyran,frostmane,288,monk,mistweaver,6,3,3
Crommul,burning-legion,288,monk,mistweaver,6,3,3
Родо,blackscar,288,monk,mistweaver,6,3,3
Lassador,onyxia,288,monk,mistweaver,6,3,3
Lp,mugthol,288,monk,mistweaver,6,3,3
Vingurd,terokkar,288,monk,mistweaver,6,3,3
Coalsack,outland,288,monk,mistweaver,6,3,3
Moinalisaa,outland,288,monk,mistweaver,6,3,3
Calmpalms,tarren-mill,288,monk,mistweaver,6,3,3
Mickeyworms,archimonde,288,monk,mistweaver,6,3,3
Baisi,blackhand,288,monk,mistweaver,6,3,3
Fistwave,malganis,288,monk,mistweaver,6,3,3
Zyrosmonk,blackmoore,288,monk,mistweaver,6,3,3
Kaizenthor,runetotem,288,monk,mistweaver,6,3,3
Shiftkin,stormscale,288,monk,mistweaver,6,3,3
Rhatid,twisting-nether,288,monk,mistweaver,6,3,3
Mecin,ragnaros,288,monk,mistweaver,6,3,3
Koba,frostwolf,288,monk,mistweaver,6,3,3
Rípple,alakir,288,monk,mistweaver,6,3,3
Perikencito,dun-modr,288,monk,mistweaver,6,3,3
Kbwser,silvermoon,288,monk,mistweaver,6,3,3
Píco,gorgonnash,288,monk,mistweaver,6,3,3
Loempia,outland,288,monk,mistweaver,6,3,3
Mistless,ragnaros,288,monk,mistweaver,6,3,3
Totemlygodx,alakir,288,monk,mistweaver,6,3,3
Mommymonk,outland,288,monk,mistweaver,6,3,3
Stolas,spinebreaker,288,monk,mistweaver,6,3,3
Räpeltäjä,stormreaver,288,monk,mistweaver,6,3,3
Йуппи,galakrond,288,monk,mistweaver,6,3,3
Kätelyys,dun-modr,288,monk,mistweaver,6,3,3
Fistweavr,antonidas,288,monk,mistweaver,6,3,3
Kukn,twisting-nether,288,monk,mistweaver,12,3,9
Brewdooms,laughing-skull,288,monk,mistweaver,12,3,9
Nela,sanguino,288,monk,mistweaver,12,3,9
Vladikus,tarren-mill,288,monk,mistweaver,18,3,15
Jetchi,twisting-nether,287,monk,mistweaver,6,3,3
Brizs,outland,287,monk,mistweaver,6,3,3
Ryanshazier,eredar,287,monk,mistweaver,6,3,3
Demakis,stormscale,239,monk,mistweaver,5,3,2
Pikajeww,kazzak,239,monk,mistweaver,5,3,2
Xalyà,archimonde,239,monk,mistweaver,9,4,5
Colita,kazzak,233,monk,mistweaver,16,5,11
Bakersdozen,tarren-mill,192,monk,mistweaver,6,2,4
Kûngfu,tarren-mill,192,monk,mistweaver,6,2,4
Stdzym,tarren-mill,192,monk,mistweaver,6,2,4
Siouxxsie,thunderhorn,192,monk,mistweaver,6,2,4
Люсилью,howling-fjord,192,monk,mistweaver,6,2,4
Syy,medivh,192,monk,mistweaver,6,2,4
Erapanzon,nemesis,192,monk,mistweaver,6,2,4
Sînge,archimonde,192,monk,mistweaver,6,2,4
Zywoo,emerald-dream,192,monk,mistweaver,6,2,4
Jadefain,argent-dawn,192,monk,mistweaver,6,2,4
Pizelx,alakir,192,monk,mistweaver,6,2,4
Discoelysia,outland,192,monk,mistweaver,6,2,4
Ashm,shattered-halls,192,monk,mistweaver,6,2,4
Saintmoon,drakthul,192,monk,mistweaver,6,2,4
Hanumahn,kilrogg,192,monk,mistweaver,6,2,4
Тэсси,blackscar,192,monk,mistweaver,6,2,4
Зараз,gordunni,192,monk,mistweaver,6,2,4
Exbuddhist,outland,192,monk,mistweaver,6,2,4
Espectrå,dun-modr,192,monk,mistweaver,6,2,4
Acbcz,draenor,192,monk,mistweaver,6,2,4
Mouhous,hellscream,192,monk,mistweaver,6,2,4
Kmorhin,antonidas,192,monk,mistweaver,6,2,4
Kapud,twisting-nether,192,monk,mistweaver,6,2,4
Auaaua,ravencrest,192,monk,mistweaver,6,2,4
Jetsweep,kazzak,192,monk,mistweaver,6,2,4
Rgkekw,dun-modr,192,monk,mistweaver,6,2,4
Yinsho,stormscale,192,monk,mistweaver,6,2,4
Domingovivas,dun-modr,192,monk,mistweaver,6,2,4
Jackamonk,kazzak,192,monk,mistweaver,6,2,4
Badcøwboy,archimonde,192,monk,mistweaver,20,5,15
Konnîchîwa,kazzak,192,monk,mistweaver,12,2,10
Ascrem,ragnaros,192,monk,mistweaver,12,2,10
Mugenzen,sanguino,192,monk,mistweaver,12,2,10
Sargnorak,dalaran,191,monk,mistweaver,6,2,4
Pandasia,kargath,186,monk,mistweaver,16,4,12
Swiftmonky,azuremyst,159,monk,mistweaver,5,2,3
Quotes,darksorrow,138,monk,mistweaver,10,4,6
Monkeymain,tarren-mill,138,monk,mistweaver,11,4,7
Wraq,tarren-mill,128,monk,mistweaver,4,2,2
Mynaira,tarren-mill,112,monk,mistweaver,13,2,11
Антошамв,gordunni,96,monk,mistweaver,6,1,5
Renegatt,twisting-nether,96,monk,mistweaver,6,1,5
Mongretod,ravencrest,96,monk,mistweaver,6,1,5
Ðéliora,la-croisade-écarlate,96,monk,mistweaver,6,1,5
Pitit,outland,96,monk,mistweaver,6,1,5
Daitaro,ravencrest,96,monk,mistweaver,6,1,5
Brewbunnyqt,thrall,96,monk,mistweaver,6,1,5
Botsmw,kazzak,96,monk,mistweaver,6,1,5
Kegrøll,doomhammer,96,monk,mistweaver,6,1,5
Psychocop,drakthul,96,monk,mistweaver,6,1,5
Legpunch,the-maelstrom,96,monk,mistweaver,6,1,5
Moorf,ravencrest,96,monk,mistweaver,6,1,5
Rostick,drakthul,96,monk,mistweaver,6,1,5
Brixelol,kazzak,96,monk,mistweaver,6,1,5
Brandy,kazzak,96,monk,mistweaver,6,1,5
Glivilalis,drekthar,96,monk,mistweaver,6,1,5
Monkolben,blackmoore,96,monk,mistweaver,6,1,5
Boîndíl,malfurion,96,monk,mistweaver,6,1,5
Jessiemonk,blackhand,96,monk,mistweaver,6,1,5
Chîca,ysondre,96,monk,mistweaver,6,1,5
Shîïna,ysondre,96,monk,mistweaver,6,1,5
Kano,burning-legion,96,monk,mistweaver,6,1,5
Ytjin,draenor,96,monk,mistweaver,6,1,5
Tossen,ragnaros,96,monk,mistweaver,6,1,5
Capos,wrathbringer,96,monk,mistweaver,11,1,10
Bobbyknuckls,ravencrest,96,monk,mistweaver,12,1,11
Griffens,argent-dawn,79,monk,mistweaver,5,1,4
Moreløs,stormscale,42,monk,mistweaver,12,3,9
Monkeykung,defias-brotherhood,40,monk,mistweaver,16,3,13
Padawang,twisting-nether,767,monk,brewmaster,24,8,16
Lubeï,kirin-tor,96,monk,brewmaster,6,1,5
Sîxmonths,stormscale,2263,monk,windwalker,72,48,24
Fistyw,stormscale,2141,monk,windwalker,80,46,34
Tabetai,tarren-mill,2125,monk,windwalker,90,46,44
Lilcatlife,tyrande,2123,monk,windwalker,66,36,30
Ewynamonk,silvermoon,2121,monk,windwalker,102,51,51
Snusochnocco,the-maelstrom,2120,monk,windwalker,78,39,39
Plaww,dalaran,2051,monk,windwalker,84,53,31
Rivazsunkick,archimonde,2035,monk,windwalker,124,59,65
Мистмастер,soulflayer,1984,monk,windwalker,48,30,18
Jájsemshadow,drakthul,1971,monk,windwalker,66,36,30
Hurricrane,kazzak,1962,monk,windwalker,70,37,33
Domww,outland,1961,monk,windwalker,78,47,31
Ilovehim,antonidas,1950,monk,windwalker,54,34,20
Pandamoniun,aggra-português,1936,monk,windwalker,48,27,21
Riskcapcap,dentarg,1935,monk,windwalker,66,35,31
Melyda,ravencrest,1921,monk,windwalker,84,47,37
Bulluh,blackmoore,1919,monk,windwalker,47,27,20
Ellipirelli,doomhammer,1911,monk,windwalker,46,21,25
Muix,draenor,1906,monk,windwalker,30,20,10
Hastewalker,dun-morogh,1898,monk,windwalker,42,23,19
Ztl,twisting-nether,1887,monk,windwalker,77,48,29
Rmtexter,ravencrest,1865,monk,windwalker,41,22,19
Яагрессивный,howling-fjord,1850,monk,windwalker,74,36,38
Theoww,dragonblight,1847,monk,windwalker,54,26,28
Flunkefar,defias-brotherhood,1845,monk,windwalker,90,42,48
Щищ,gordunni,1840,monk,windwalker,36,21,15
Santanax,ravencrest,1834,monk,windwalker,42,27,15
Shpunk,ravencrest,1821,monk,windwalker,54,27,27
Monkees,twisting-nether,1815,monk,windwalker,65,33,32
Soulja,bloodfeather,1810,monk,windwalker,46,29,17
Lullerull,silvermoon,1810,monk,windwalker,51,31,20
Troopmonk,ravencrest,1809,monk,windwalker,48,26,22
Фодз,soulflayer,1809,monk,windwalker,58,26,32
Pàrádìsé,ravencrest,1807,monk,windwalker,72,38,34
Åbyssgòd,kazzak,1805,monk,windwalker,60,24,36
Аррани,thermaplugg,1803,monk,windwalker,52,29,23
Fistinguhuhu,outland,1803,monk,windwalker,60,30,30
Monkmeta,frostwolf,1800,monk,windwalker,30,19,11
Teressah,argent-dawn,1800,monk,windwalker,42,22,20
Mionoor,aegwynn,1792,monk,windwalker,84,43,41
Twinny,drakthul,1789,monk,windwalker,54,34,20
Нелегитимный,howling-fjord,1788,monk,windwalker,95,44,51
Ароба,blackscar,1781,monk,windwalker,54,25,29
Skailzkrt,hyjal,1779,monk,windwalker,42,22,20
Такюн,howling-fjord,1765,monk,windwalker,72,39,33
Váinz,ravencrest,1761,monk,windwalker,42,23,19
Меняубило,howling-fjord,1757,monk,windwalker,60,32,28
Mikedcrybaby,tarren-mill,1740,monk,windwalker,72,38,34
Xiâomèi,dun-modr,1740,monk,windwalker,42,21,21
Daosh,nemesis,1738,monk,windwalker,49,25,24
Инрэйджинкап,soulflayer,1735,monk,windwalker,54,24,30
Лазанья,grom,1731,monk,windwalker,60,27,33
Eth,nagrand,1725,monk,windwalker,42,22,20
Yassøux,archimonde,1719,monk,windwalker,66,29,37
Муррчалкин,howling-fjord,1710,monk,windwalker,30,18,12
Калестонз,howling-fjord,1692,monk,windwalker,42,22,20
Notmelo,dun-modr,1692,monk,windwalker,36,18,18
Sørann,drekthar,1685,monk,windwalker,34,22,12
Klumpenx,draenor,1683,monk,windwalker,56,26,30
Unangebracht,silvermoon,1678,monk,windwalker,101,53,48
Fistofrage,ravencrest,1677,monk,windwalker,36,22,14
Enerchi,ravencrest,1671,monk,windwalker,42,23,19
Гладастар,soulflayer,1665,monk,windwalker,66,33,33
Gonkun,outland,1662,monk,windwalker,49,26,23
Tommypistol,runetotem,1659,monk,windwalker,48,20,28
Тихийпук,deathguard,1656,monk,windwalker,48,28,20
Bîmbâmboom,blackmoore,1650,monk,windwalker,42,22,20
Sylicia,alleria,1648,monk,windwalker,97,47,50
Ashânti,eredar,1646,monk,windwalker,50,24,26
Гуппер,howling-fjord,1646,monk,windwalker,54,23,31
Reõ,argent-dawn,1645,monk,windwalker,42,25,17
Yiannischan,draenor,1638,monk,windwalker,36,20,16
Rêshi,draenor,1629,monk,windwalker,36,25,11
Fotmwalker,ragnaros,1626,monk,windwalker,48,19,29
Gyto,archimonde,1623,monk,windwalker,36,20,16
Pwaff,kazzak,1623,monk,windwalker,42,22,20
Beernie,tarren-mill,1608,monk,windwalker,24,17,7
Mebrin,ragnaros,1600,monk,windwalker,36,17,19
Idiot,outland,1588,monk,windwalker,36,18,18
Маруты,soulflayer,1571,monk,windwalker,41,18,23
Bastos,blackrock,1569,monk,windwalker,156,81,75
Erenaar,nemesis,1563,monk,windwalker,36,29,7
Jolbucheron,hyjal,1559,monk,windwalker,48,27,21
Тэсти,blackscar,1557,monk,windwalker,29,17,12
Ютуми,soulflayer,1557,monk,windwalker,36,17,19
Xullon,dragonblight,1542,monk,windwalker,60,27,33
Doktormonk,blackrock,1537,monk,windwalker,38,20,18
Shaolinthug,stormscale,1531,monk,windwalker,36,16,20
Jeydi,ravencrest,1528,monk,windwalker,41,29,12
Sushiroll,stormrage,1528,monk,windwalker,30,16,14
Thérez,les-sentinelles,1527,monk,windwalker,30,16,14
Vayarah,antonidas,1519,monk,windwalker,24,16,8
Анпапаяя,galakrond,1507,monk,windwalker,47,26,21
Виноипиво,soulflayer,1507,monk,windwalker,36,16,20
Дивипи,blackscar,1506,monk,windwalker,54,24,30
Zandoy,draenor,1500,monk,windwalker,34,17,17
Акумах,blackscar,1499,monk,windwalker,48,19,29
Spinntowin,blackmoore,1456,monk,windwalker,57,29,28
Xuuan,argent-dawn,1448,monk,windwalker,54,33,21
Tisaki,blackhand,1447,monk,windwalker,23,16,7
Balia,blackrock,1439,monk,windwalker,24,15,9
Unpruneable,stormscale,1439,monk,windwalker,30,15,15
Oberháupt,blackrock,1432,monk,windwalker,30,15,15
Sagewhisper,ravencrest,1429,monk,windwalker,45,20,25
Notsmol,quelthalas,1422,monk,windwalker,30,15,15
Bobbyknuckls,ravencrest,1405,monk,windwalker,54,24,30
Vushao,blackmoore,1389,monk,windwalker,89,44,45
Kyraxs,silvermoon,1379,monk,windwalker,36,17,19
Кюзичка,gordunni,1379,monk,windwalker,83,38,45
Icecoldish,tarren-mill,1378,monk,windwalker,60,33,27
Kungfumite,twisting-nether,1376,monk,windwalker,53,31,22
Bakash,ysondre,1353,monk,windwalker,128,57,71
Коркирас,howling-fjord,1343,monk,windwalker,72,42,30
Saltotriks,tarren-mill,1341,monk,windwalker,30,14,16
Domiqx,blackhand,1339,monk,windwalker,30,14,16
Undefinedid,ravencrest,1335,monk,windwalker,92,48,44
Doobly,kazzak,1329,monk,windwalker,77,37,40
Kixxus,blackmoore,1328,monk,windwalker,24,14,10
Тринх,ashenvale,1327,monk,windwalker,24,14,10
Nigu,dun-modr,1317,monk,windwalker,30,14,16
Монголгодх,howling-fjord,1296,monk,windwalker,30,17,13
Sororicide,stormscale,1292,monk,windwalker,29,14,15
Mycki,dalaran,1289,monk,windwalker,29,15,14
Queteapie,stormscale,1248,monk,windwalker,24,13,11
Brñ,twisting-nether,1248,monk,windwalker,24,13,11
Zukatan,tarren-mill,1247,monk,windwalker,24,13,11
Санварион,eversong,1247,monk,windwalker,24,13,11
Dadqt,eredar,1247,monk,windwalker,24,13,11
Heyami,ravencrest,1246,monk,windwalker,30,13,17
Mønkeydluffy,blackmoore,1241,monk,windwalker,54,26,28
Eonyzi,kazzak,1238,monk,windwalker,24,13,11
Kouradoskylo,twisting-nether,1234,monk,windwalker,29,16,13
Kegrøll,doomhammer,1231,monk,windwalker,42,21,21
Kanõ,outland,1222,monk,windwalker,24,13,11
Mirôku,onyxia,1216,monk,windwalker,24,13,11
Imvengeance,stormscale,1204,monk,windwalker,28,14,14
Boutarzi,hyjal,1203,monk,windwalker,30,13,17
Uffsmaul,blackhand,1180,monk,windwalker,34,17,17
Yøøps,dalaran,1171,monk,windwalker,35,16,19
Sponkas,tarren-mill,1152,monk,windwalker,24,12,12
Милыйколян,soulflayer,1152,monk,windwalker,24,12,12
Дезмимонк,ashenvale,1152,monk,windwalker,28,13,15
Arsonists,argent-dawn,1151,monk,windwalker,18,12,6
Çhina,twisting-nether,1151,monk,windwalker,24,12,12
Vexíllum,sylvanas,1151,monk,windwalker,24,12,12
Димакарма,howling-fjord,1151,monk,windwalker,30,12,18
Jinpachi,ravencrest,1151,monk,windwalker,30,12,18
Хекмуги,borean-tundra,1146,monk,windwalker,24,12,12
Янасру,gordunni,1145,monk,windwalker,153,73,80
Azato,hyjal,1137,monk,windwalker,24,12,12
Nodzomi,shadowsong,1132,monk,windwalker,24,12,12
Pandermann,antonidas,1100,monk,windwalker,24,12,12
Vercya,dun-morogh,1090,monk,windwalker,31,14,17
Hilzaxsub,archimonde,1083,monk,windwalker,23,12,11
Daybaobao,the-maelstrom,1062,monk,windwalker,22,12,10
Артемиоксх,blackscar,1056,monk,windwalker,25,11,14
Osalot,ravencrest,1055,monk,windwalker,18,11,7
Stillwater,thrall,1055,monk,windwalker,24,11,13
Dwdw,aerie-peak,1055,monk,windwalker,24,11,13
Djshady,sylvanas,1054,monk,windwalker,18,11,7
Miløøx,silvermoon,1054,monk,windwalker,18,11,7
Tiaqa,aegwynn,1053,monk,windwalker,12,11,1
Cheethfu,ragnaros,1052,monk,windwalker,18,11,7
Nikchi,destromath,1049,monk,windwalker,30,11,19
Yesman,quelthalas,1049,monk,windwalker,40,13,27
Kîngjungeîle,dalaran,1047,monk,windwalker,18,11,7
Ехерех,blackscar,1043,monk,windwalker,24,14,10
Dionee,twisting-nether,1027,monk,windwalker,18,11,7
Яшкациган,howling-fjord,1011,monk,windwalker,28,11,17
Одиниз,gordunni,998,monk,windwalker,30,20,10
Malarie,magtheridon,998,monk,windwalker,36,18,18
Hefners,grim-batol,991,monk,windwalker,23,11,12
Marcianorock,archimonde,987,monk,windwalker,30,13,17
Bruzuh,outland,980,monk,windwalker,25,12,13
Вагонюлеера,howling-fjord,974,monk,windwalker,22,11,11
Kitcheneer,twisting-nether,960,monk,windwalker,12,10,2
Yungdrippy,eredar,960,monk,windwalker,18,10,8
Stepsyzz,stormscale,960,monk,windwalker,18,10,8
Ladderfiend,stormscale,960,monk,windwalker,18,10,8
Ðävàizskó,ysondre,960,monk,windwalker,18,10,8
Gararasu,eredar,960,monk,windwalker,24,10,14
Rorkito,sanguino,959,monk,windwalker,30,10,20
Bandiya,archimonde,874,monk,windwalker,31,10,21
Redundänt,kazzak,864,monk,windwalker,12,9,3
Thänkky,kazzak,864,monk,windwalker,12,9,3
Mcscrub,ragnaros,864,monk,windwalker,12,9,3
Projectasura,draenor,864,monk,windwalker,18,9,9
Рэйвх,howling-fjord,864,monk,windwalker,18,9,9
Джэкичача,soulflayer,864,monk,windwalker,18,9,9
Pazü,ysondre,864,monk,windwalker,18,9,9
Lrizz,argent-dawn,864,monk,windwalker,18,9,9
Weaverman,ragnaros,864,monk,windwalker,18,9,9
Healbotzweik,frostwolf,864,monk,windwalker,18,9,9
Heran,ravencrest,864,monk,windwalker,24,9,15
Bèrïth,kazzak,863,monk,windwalker,18,9,9
Realiaze,tichondrius,863,monk,windwalker,18,9,9
Fungamelol,blackhand,862,monk,windwalker,12,9,3
Wakmo,bladefist,860,monk,windwalker,16,10,6
Добраядушка,gordunni,860,monk,windwalker,18,9,9
Elfisto,baelgun,860,monk,windwalker,18,9,9
Exikûsh,frostwolf,860,monk,windwalker,18,9,9
Moonkeeye,stormscale,853,monk,windwalker,18,9,9
Karatiy,doomhammer,844,monk,windwalker,81,27,54
Yobo,archimonde,815,monk,windwalker,17,9,8
Wladqz,stormscale,768,monk,windwalker,12,8,4
Carbozø,archimonde,768,monk,windwalker,12,8,4
Ocëane,sanguino,768,monk,windwalker,12,8,4
Steros,die-aldor,768,monk,windwalker,12,8,4
Slayh,archimonde,768,monk,windwalker,12,8,4
Hitsuwalker,archimonde,768,monk,windwalker,12,8,4
Runefists,twisting-nether,768,monk,windwalker,12,8,4
Eggroll,archimonde,768,monk,windwalker,12,8,4
Дуэльныйчел,howling-fjord,768,monk,windwalker,18,8,10
Gdkz,tarren-mill,768,monk,windwalker,18,8,10
Rismonk,twisting-nether,768,monk,windwalker,18,8,10
Yacum,blackrock,768,monk,windwalker,18,8,10
Kåtsumi,sanguino,768,monk,windwalker,18,8,10
Дыня,gordunni,767,monk,windwalker,12,8,4
Сандерстрайк,howling-fjord,767,monk,windwalker,18,8,10
Pocaa,arakarahm,766,monk,windwalker,18,8,10
Nggz,archimonde,764,monk,windwalker,12,8,4
Кирокко,gordunni,761,monk,windwalker,12,8,4
Томтью,gordunni,735,monk,windwalker,17,8,9
Euronymesis,silvermoon,687,monk,windwalker,11,8,3
Dopi,frostmane,672,monk,windwalker,12,7,5
Arthanaar,drakthul,672,monk,windwalker,12,7,5
Yukfou,tarren-mill,672,monk,windwalker,12,7,5
Potsymist,twisting-nether,672,monk,windwalker,12,7,5
Имортарион,howling-fjord,672,monk,windwalker,12,7,5
Saodiseng,outland,672,monk,windwalker,12,7,5
Lesauceboss,kazzak,672,monk,windwalker,12,7,5
Ðâvàizskÿ,ysondre,672,monk,windwalker,12,7,5
Gankplank,nemesis,672,monk,windwalker,12,7,5
Moistpocket,stormscale,672,monk,windwalker,18,7,11
Senretsu,shattered-halls,672,monk,windwalker,18,7,11
Anhox,ragnaros,672,monk,windwalker,18,7,11
Elinalia,burning-legion,672,monk,windwalker,18,7,11
Kåýðø,archimonde,672,monk,windwalker,18,7,11
Flowér,auchindoun,672,monk,windwalker,18,7,11
Iceym,stormscale,672,monk,windwalker,21,8,13
Bierdame,blackhand,671,monk,windwalker,12,7,5
Вамптолкер,howling-fjord,671,monk,windwalker,12,7,5
Ролитта,gordunni,671,monk,windwalker,12,7,5
Recklusa,stormscale,671,monk,windwalker,12,7,5
Malutkie,defias-brotherhood,671,monk,windwalker,12,7,5
Hosh,ysondre,671,monk,windwalker,24,7,17
Kirara,talnivarr,668,monk,windwalker,12,7,5
Hampocket,ravencrest,639,monk,windwalker,20,8,12
Fusetonww,tarren-mill,623,monk,windwalker,11,7,4
Wolmachégodx,archimonde,576,monk,windwalker,6,6,0
Samantonah,nemesis,576,monk,windwalker,6,6,0
Rezuz,draenor,576,monk,windwalker,6,6,0
Bellarika,nemesis,576,monk,windwalker,6,6,0
Ferree,tarren-mill,576,monk,windwalker,12,6,6
Apprentice,ravencrest,576,monk,windwalker,12,6,6
Weezé,outland,576,monk,windwalker,12,6,6
Balance,laughing-skull,576,monk,windwalker,12,6,6
Snookzlol,aegwynn,576,monk,windwalker,12,6,6
Йетисан,gordunni,576,monk,windwalker,12,6,6
Galaxyfists,blackhand,576,monk,windwalker,12,6,6
Мэрджик,soulflayer,576,monk,windwalker,12,6,6
Xàrslòulolz,kazzak,576,monk,windwalker,12,6,6
Miridius,silvermoon,576,monk,windwalker,12,6,6
Fiststowin,blackrock,576,monk,windwalker,18,6,12
Norgamx,alakir,576,monk,windwalker,18,6,12
Möîne,arathi,576,monk,windwalker,18,6,12
Pitball,ravencrest,576,monk,windwalker,18,6,12
Ívó,ragnaros,576,monk,windwalker,18,6,12
Dummars,ragnaros,575,monk,windwalker,12,6,6
Chiroidz,kazzak,575,monk,windwalker,12,6,6
Mönchdog,blackmoore,573,monk,windwalker,12,6,6
Mullan,eonar,573,monk,windwalker,24,6,18
Cptfist,argent-dawn,543,monk,windwalker,17,6,11
Merjis,stormscale,527,monk,windwalker,11,6,5
Emptyeyés,kazzak,480,monk,windwalker,6,5,1
Kungfuhkyou,tarren-mill,480,monk,windwalker,6,5,1
Anteric,sylvanas,480,monk,windwalker,6,5,1
Karmaisabich,ragnaros,480,monk,windwalker,6,5,1
Peaceweaver,ravencrest,480,monk,windwalker,6,5,1
Merilwyn,argent-dawn,480,monk,windwalker,6,5,1
Fistedx,twisting-nether,480,monk,windwalker,6,5,1
Hàtéppl,ravencrest,480,monk,windwalker,6,5,1
Madelnheaven,burning-legion,480,monk,windwalker,6,5,1
Larsowns,ragnaros,480,monk,windwalker,6,5,1
Onlypressw,tarren-mill,480,monk,windwalker,12,5,7
Brandy,kazzak,480,monk,windwalker,12,5,7
Mink,uldum,480,monk,windwalker,12,5,7
Vivvy,argent-dawn,480,monk,windwalker,12,5,7
Diagmonk,kazzak,480,monk,windwalker,12,5,7
Blyatfast,draenor,480,monk,windwalker,12,5,7
Discosean,frostmane,480,monk,windwalker,12,5,7
Kaelwind,burning-legion,480,monk,windwalker,12,5,7
Nerd,argent-dawn,480,monk,windwalker,12,5,7
Archnun,stormscale,480,monk,windwalker,12,5,7
Lucaspires,sylvanas,480,monk,windwalker,12,5,7
Chaospilot,sylvanas,480,monk,windwalker,12,5,7
Кунфумастер,gordunni,480,monk,windwalker,12,5,7
Mayliene,stormscale,480,monk,windwalker,12,5,7
Fistus,dentarg,480,monk,windwalker,12,5,7
Djpunchable,blackrock,480,monk,windwalker,12,5,7
Атакцуки,gordunni,480,monk,windwalker,12,5,7
Greenshortea,aegwynn,480,monk,windwalker,12,5,7
Nicesky,ravencrest,480,monk,windwalker,18,5,13
Fatlazypanda,argent-dawn,479,monk,windwalker,6,5,1
Gidmonk,darkspear,477,monk,windwalker,6,5,1
Камагами,howling-fjord,400,monk,windwalker,7,5,2
Shagzy,ravencrest,399,monk,windwalker,5,5,0
Dadrael,argent-dawn,384,monk,windwalker,6,4,2
Pili,aegwynn,384,monk,windwalker,6,4,2
Orenichi,antonidas,384,monk,windwalker,6,4,2
Fln,blackrock,384,monk,windwalker,6,4,2
Hertel,boulderfist,384,monk,windwalker,6,4,2
Tàlo,anachronos,384,monk,windwalker,6,4,2
Njursten,twilights-hammer,384,monk,windwalker,6,4,2
Faxax,draenor,384,monk,windwalker,6,4,2
Monkflexi,draenor,384,monk,windwalker,6,4,2
Uwuhehe,ravencrest,384,monk,windwalker,6,4,2
Dræk,twisting-nether,384,monk,windwalker,6,4,2
Âdonis,twisting-nether,384,monk,windwalker,6,4,2
Scribzw,twisting-nether,384,monk,windwalker,6,4,2
Hôllowx,archimonde,384,monk,windwalker,6,4,2
Pelou,culte-de-la-rive-noire,384,monk,windwalker,6,4,2
Tysonwonka,thrall,384,monk,windwalker,6,4,2
Palarîns,dalaran,384,monk,windwalker,6,4,2
Soulspar,ragnaros,384,monk,windwalker,6,4,2
Bossdog,mugthol,384,monk,windwalker,6,4,2
Rugys,ravenholdt,384,monk,windwalker,6,4,2
Windstormcro,ragnaros,384,monk,windwalker,6,4,2
Tubørg,ravencrest,384,monk,windwalker,6,4,2
Baisi,blackhand,384,monk,windwalker,6,4,2
Onn,outland,384,monk,windwalker,6,4,2
Naschitüte,blackrock,384,monk,windwalker,6,4,2
Agitoyamissj,burning-legion,384,monk,windwalker,9,5,4
Ackken,twisting-nether,384,monk,windwalker,9,5,4
Andrah,blackmoore,384,monk,windwalker,12,4,8
Duches,tarren-mill,384,monk,windwalker,12,4,8
Monkgol,stormscale,384,monk,windwalker,12,4,8
Räyh,outland,384,monk,windwalker,12,4,8
Rollah,ravencrest,384,monk,windwalker,12,4,8
Sesi,drakthul,384,monk,windwalker,24,4,20
Bbinzu,lothar,383,monk,windwalker,6,4,2
Agress,sanguino,383,monk,windwalker,12,4,8
Диванн,howling-fjord,335,monk,windwalker,11,4,7
Alë,argent-dawn,319,monk,windwalker,8,4,4
Крэйзимедвед,howling-fjord,288,monk,windwalker,6,3,3
Zenified,ragnaros,288,monk,windwalker,6,3,3
Monkacek,drakthul,288,monk,windwalker,6,3,3
Aaronm,tarren-mill,288,monk,windwalker,6,3,3
Sàlêxz,ysondre,288,monk,windwalker,6,3,3
Ratfacè,outland,288,monk,windwalker,6,3,3
Räpeltäjä,stormreaver,288,monk,windwalker,6,3,3
Zelraqt,burning-steppes,288,monk,windwalker,6,3,3
Czvibuh,drakthul,288,monk,windwalker,6,3,3
Zunixxww,terrordar,288,monk,windwalker,6,3,3
Bal,tyrande,288,monk,windwalker,6,3,3
Расселкроу,galakrond,288,monk,windwalker,6,3,3
Sebbii,twisting-nether,288,monk,windwalker,6,3,3
Alkanphel,kazzak,288,monk,windwalker,6,3,3
Verfa,twisting-nether,288,monk,windwalker,6,3,3
Deretrox,twisting-nether,288,monk,windwalker,6,3,3
Tempestu,twisting-nether,288,monk,windwalker,6,3,3
Fistyfast,hyjal,288,monk,windwalker,6,3,3
Chæli,tarren-mill,288,monk,windwalker,6,3,3
Omnibar,kazzak,288,monk,windwalker,6,3,3
Realfighter,arathor,288,monk,windwalker,6,3,3
Ðoom,sylvanas,288,monk,windwalker,6,3,3
Iluvfistinjk,sylvanas,288,monk,windwalker,6,3,3
Barylen,outland,288,monk,windwalker,12,3,9
Inkegomonk,draenor,288,monk,windwalker,12,3,9
Mönchfatih,blackhand,288,monk,windwalker,12,3,9
Keskonriz,ysondre,288,monk,windwalker,12,3,9
Халиосфа,gordunni,288,monk,windwalker,12,3,9
Clamps,darkspear,288,monk,windwalker,12,3,9
Roxmonk,ravencrest,288,monk,windwalker,12,3,9
Darré,sylvanas,288,monk,windwalker,18,3,15
Lewimoäne,khaz-modan,287,monk,windwalker,6,3,3
Iamzra,kazzak,239,monk,windwalker,5,3,2
Ninadobrév,stormscale,234,monk,windwalker,11,5,6
Bignessb,draenor,192,monk,windwalker,4,3,1
ßibip,hyjal,192,monk,windwalker,4,3,1
Wazari,nemesis,192,monk,windwalker,6,2,4
Däemon,twisting-nether,192,monk,windwalker,6,2,4
Loriodas,tarren-mill,192,monk,windwalker,6,2,4
Iluvatareru,twisting-nether,192,monk,windwalker,6,2,4
Cac,argent-dawn,192,monk,windwalker,6,2,4
Walterwayne,blackrock,192,monk,windwalker,6,2,4
Ryle,forscherliga,192,monk,windwalker,6,2,4
Monk,dun-modr,192,monk,windwalker,6,2,4
Savecdfornxt,blackmoore,192,monk,windwalker,6,2,4
Otp,hyjal,192,monk,windwalker,6,2,4
Dodoglad,hyjal,192,monk,windwalker,6,2,4
Цеска,howling-fjord,192,monk,windwalker,6,2,4
Mtmonk,tarren-mill,192,monk,windwalker,6,2,4
Mwoinesamdi,hyjal,192,monk,windwalker,6,2,4
Zýru,ragnaros,192,monk,windwalker,6,2,4
Fistingfury,burning-blade,192,monk,windwalker,6,2,4
Mîsts,aszune,192,monk,windwalker,6,2,4
Kenjibsen,blackhand,192,monk,windwalker,6,2,4
Miamausebär,blackmoore,192,monk,windwalker,6,2,4
Eynodiggity,blackmoore,192,monk,windwalker,6,2,4
Khirazim,ysondre,192,monk,windwalker,6,2,4
Mcflaïe,ysondre,192,monk,windwalker,6,2,4
Bobthewild,draenor,192,monk,windwalker,6,2,4
Frajer,auchindoun,192,monk,windwalker,6,2,4
Wwisalright,burning-legion,192,monk,windwalker,6,2,4
Musclorww,ysondre,192,monk,windwalker,6,2,4
Kneecapper,ravencrest,192,monk,windwalker,6,2,4
Belobe,stormscale,192,monk,windwalker,6,2,4
Meltfistqt,ravencrest,192,monk,windwalker,6,2,4
Bloodychi,ravencrest,192,monk,windwalker,6,2,4
Dianly,ravencrest,192,monk,windwalker,6,2,4
Niamix,archimonde,192,monk,windwalker,11,2,9
Tongat,ravencrest,192,monk,windwalker,12,2,10
Непорядочная,gordunni,192,monk,windwalker,12,2,10
Yianjih,blackmoore,191,monk,windwalker,6,2,4
Жекадобряк,howling-fjord,191,monk,windwalker,10,3,7
Pipatvs,drakthul,144,monk,windwalker,3,3,0
Ravelbaby,blackrock,128,monk,windwalker,4,2,2
Trolleurz,archimonde,128,monk,windwalker,10,2,8
Kano,burning-legion,96,monk,windwalker,3,2,1
Mjaweaver,stormscale,96,monk,windwalker,6,1,5
Néroburnsred,eredar,96,monk,windwalker,6,1,5
Синнэрли,soulflayer,96,monk,windwalker,6,1,5
Kaizenthor,runetotem,96,monk,windwalker,6,1,5
Smâsh,blackhand,96,monk,windwalker,6,1,5
Zugzuwg,ahnqiraj,96,monk,windwalker,6,1,5
Embodimonk,twisting-nether,96,monk,windwalker,6,1,5
Dadeldo,blackrock,96,monk,windwalker,6,1,5
Umbrâsyl,ravencrest,96,monk,windwalker,6,1,5
Blutáar,khazgoroth,96,monk,windwalker,6,1,5
Mìcrøb,blackmoore,96,monk,windwalker,6,1,5
Olympeá,silvermoon,96,monk,windwalker,6,1,5
Чвка,booty-bay,96,monk,windwalker,6,1,5
Saduh,thrall,96,monk,windwalker,6,1,5
Risingspud,frostmane,96,monk,windwalker,6,1,5
Kinføu,hyjal,96,monk,windwalker,6,1,5
Xtcc,kazzak,79,monk,windwalker,5,1,4
Xámell,ravencrest,48,monk,windwalker,3,1,2
Åbx,argent-dawn,2191,paladin,holy,113,59,54
Crewxdlolz,frostmane,2123,paladin,holy,211,118,93
Lickssi,outland,2001,paladin,holy,94,56,38
Jìmjim,ysondre,1915,paladin,holy,102,47,55
Kyoma,burning-legion,1876,paladin,holy,63,28,35
Tipmax,ravencrest,1856,paladin,holy,61,37,24
Wiriday,draenor,1853,paladin,holy,54,25,29
Niwariel,silvermoon,1852,paladin,holy,60,37,23
Типмакс,howling-fjord,1851,paladin,holy,42,25,17
Jeø,stormscale,1823,paladin,holy,54,28,26
Neverlostx,ravencrest,1816,paladin,holy,48,31,17
Ránchìek,ravencrest,1812,paladin,holy,54,26,28
Aww,anachronos,1809,paladin,holy,48,22,26
Jûliâ,archimonde,1807,paladin,holy,70,41,29
Måvé,tarren-mill,1804,paladin,holy,42,25,17
Vindîcator,defias-brotherhood,1773,paladin,holy,83,37,46
Popecrusade,archimonde,1771,paladin,holy,48,35,13
Аришалисичка,blackscar,1727,paladin,holy,70,36,34
Holylightxz,runetotem,1717,paladin,holy,75,36,39
Runtheshôw,tarren-mill,1710,paladin,holy,60,25,35
Andûrîl,tarren-mill,1704,paladin,holy,47,29,18
Thaderyl,auchindoun,1696,paladin,holy,42,20,22
Rettyfield,blackrock,1689,paladin,holy,30,18,12
Акунделар,gordunni,1685,paladin,holy,102,50,52
Voklane,tarren-mill,1676,paladin,holy,48,23,25
Emloses,outland,1661,paladin,holy,60,32,28
Rekieuna,archimonde,1647,paladin,holy,108,56,52
Arysur,defias-brotherhood,1647,paladin,holy,54,25,29
Deodas,kazzak,1638,paladin,holy,48,26,22
Vaîjin,aegwynn,1636,paladin,holy,41,20,21
Faíren,mugthol,1635,paladin,holy,48,25,23
Smightypal,silvermoon,1629,paladin,holy,66,35,31
Valia,argent-dawn,1610,paladin,holy,30,17,13
Goodpeace,kazzak,1607,paladin,holy,43,20,23
Острит,gordunni,1605,paladin,holy,78,45,33
Judgejuryexe,kazzak,1600,paladin,holy,92,44,48
Baazil,ragnaros,1595,paladin,holy,42,21,21
Тошанич,soulflayer,1587,paladin,holy,48,23,25
Realpalla,ravenholdt,1571,paladin,holy,42,25,17
Isøri,antonidas,1562,paladin,holy,96,45,51
Itsjulie,sylvanas,1557,paladin,holy,34,18,16
Флэшкапро,soulflayer,1557,paladin,holy,57,30,27
Holychît,sanguino,1553,paladin,holy,69,29,40
Skurly,ragnaros,1551,paladin,holy,42,19,23
Strûgglebûs,outland,1543,paladin,holy,47,25,22
Срувтапкизз,blackscar,1543,paladin,holy,83,29,54
Потокденег,howling-fjord,1534,paladin,holy,86,36,50
Gasilol,frostwolf,1533,paladin,holy,69,35,34
Dàrckness,ravencrest,1525,paladin,holy,111,59,52
Powertilt,ravencrest,1521,paladin,holy,45,16,29
Aíe,draenor,1513,paladin,holy,34,22,12
Jajmentx,kazzak,1509,paladin,holy,48,28,20
Narkal,archimonde,1504,paladin,holy,30,16,14
Lóde,silvermoon,1501,paladin,holy,72,38,34
Rùfus,tarren-mill,1491,paladin,holy,30,17,13
Drdeus,kazzak,1486,paladin,holy,30,16,14
Бадбх,howling-fjord,1486,paladin,holy,60,22,38
Arenalena,sylvanas,1483,paladin,holy,83,39,44
Pooncy,ragnaros,1482,paladin,holy,54,22,32
Xenyaa,arygos,1474,paladin,holy,36,17,19
Noliferx,ravencrest,1467,paladin,holy,68,39,29
Уретроград,soulflayer,1466,paladin,holy,48,25,23
Shabbyy,bronzebeard,1466,paladin,holy,36,17,19
Hotub,twisting-nether,1463,paladin,holy,57,32,25
Zycqo,silvermoon,1454,paladin,holy,132,67,65
Marygueguete,archimonde,1448,paladin,holy,48,21,27
Likkik,ravencrest,1439,paladin,holy,33,16,17
Kantfyrste,ravencrest,1438,paladin,holy,91,38,53
Taiso,alonsus,1422,paladin,holy,132,64,68
Enemylosers,stormscale,1421,paladin,holy,42,20,22
Heilgaharald,blackrock,1419,paladin,holy,36,18,18
Хегия,gordunni,1414,paladin,holy,30,15,15
Ðenlox,destromath,1408,paladin,holy,104,53,51
Эсерпи,gordunni,1400,paladin,holy,52,28,24
Fourshaw,ravencrest,1399,paladin,holy,71,31,40
Arlette,moonglade,1393,paladin,holy,42,19,23
Xenaké,kazzak,1391,paladin,holy,62,20,42
Bécasszelium,varimathras,1389,paladin,holy,60,29,31
Зондарк,booty-bay,1388,paladin,holy,47,20,27
Sacbøt,stormscale,1387,paladin,holy,87,45,42
Аяпал,blackscar,1383,paladin,holy,66,35,31
Сашафистинг,gordunni,1380,paladin,holy,90,41,49
Keele,stormscale,1369,paladin,holy,58,28,30
Satipal,sargeras,1368,paladin,holy,69,28,41
Mecah,hyjal,1365,paladin,holy,42,21,21
Mitsaklas,grim-batol,1352,paladin,holy,39,15,24
Леонящер,gordunni,1351,paladin,holy,108,58,50
Freaak,dethecus,1351,paladin,holy,36,15,21
Снупарь,blackscar,1351,paladin,holy,45,18,27
Dathróhán,silvermoon,1350,paladin,holy,142,65,77
Lastaid,azshara,1349,paladin,holy,48,22,26
Steggeh,argent-dawn,1340,paladin,holy,78,28,50
Wollymolly,ravencrest,1338,paladin,holy,24,14,10
Грор,galakrond,1334,paladin,holy,18,14,4
Polydeukis,stormscale,1333,paladin,holy,48,16,32
Hîfi,blackmoore,1328,paladin,holy,55,36,19
Lightbrîng,hyjal,1327,paladin,holy,53,26,27
Nudzolini,tarren-mill,1321,paladin,holy,24,15,9
Wrathlol,ravencrest,1317,paladin,holy,65,31,34
Blazeberg,tirion,1299,paladin,holy,30,15,15
Kerven,doomhammer,1293,paladin,holy,42,16,26
Amolan,drakthul,1290,paladin,holy,27,19,8
Maitrelampe,argent-dawn,1281,paladin,holy,36,14,22
Alard,sanguino,1277,paladin,holy,60,22,38
Сэлфхил,gordunni,1276,paladin,holy,29,14,15
Реколори,gordunni,1268,paladin,holy,39,20,19
Делатор,gordunni,1267,paladin,holy,48,22,26
Necrozi,stormscale,1263,paladin,holy,36,21,15
Tíep,blackmoore,1262,paladin,holy,71,36,35
Kaitlyne,tarren-mill,1252,paladin,holy,91,46,45
Kambood,twisting-nether,1245,paladin,holy,84,39,45
Leon,veknilash,1213,paladin,holy,48,19,29
Farata,ravencrest,1192,paladin,holy,94,44,50
Bigfailure,blackmoore,1188,paladin,holy,47,13,34
Skyf,outland,1180,paladin,holy,35,13,22
Shiidori,aegwynn,1175,paladin,holy,57,23,34
Keryann,argent-dawn,1168,paladin,holy,54,24,30
Zebramann,silvermoon,1167,paladin,holy,42,19,23
Pokébowl,outland,1166,paladin,holy,30,14,16
Eldorín,blackmoore,1152,paladin,holy,30,12,18
Kaki,gorgonnash,1151,paladin,holy,18,12,6
Lrnz,tarren-mill,1151,paladin,holy,30,12,18
Lexó,ravencrest,1151,paladin,holy,30,12,18
Kakii,gorgonnash,1150,paladin,holy,30,12,18
Алексендлерх,soulflayer,1149,paladin,holy,18,12,6
Chryme,thrall,1149,paladin,holy,18,12,6
Demecir,twisting-nether,1148,paladin,holy,65,26,39
Elsewhere,archimonde,1146,paladin,holy,30,12,18
Archaegis,silvermoon,1141,paladin,holy,30,12,18
Talimañ,kazzak,1140,paladin,holy,18,12,6
Uzuriel,chogall,1130,paladin,holy,133,49,84
Weserwehr,laughing-skull,1124,paladin,holy,36,15,21
Serim,dun-modr,1119,paladin,holy,54,23,31
Cmen,silvermoon,1111,paladin,holy,97,50,47
Tscheba,kazzak,1109,paladin,holy,82,42,40
Dabstar,antonidas,1086,paladin,holy,88,41,47
Jaezlin,tarren-mill,1084,paladin,holy,46,21,25
Trístesse,tarren-mill,1081,paladin,holy,53,24,29
Catali,sanguino,1079,paladin,holy,41,19,22
Wedervärdig,twilights-hammer,1079,paladin,holy,30,12,18
Trisunonvaki,khazgoroth,1075,paladin,holy,53,22,31
Høpé,malganis,1061,paladin,holy,44,22,22
Sonil,les-sentinelles,1054,paladin,holy,27,12,15
Pullheavy,silvermoon,1052,paladin,holy,24,11,13
Cykadin,dun-modr,1050,paladin,holy,30,11,19
Bovinequeef,twisting-nether,1048,paladin,holy,18,11,7
Dawnforged,stormscale,1044,paladin,holy,36,12,24
Салфеточник,thermaplugg,1044,paladin,holy,36,11,25
Babybeater,outland,1043,paladin,holy,37,14,23
Grimbold,hellfire,1042,paladin,holy,18,11,7
Strykar,aggra-português,1028,paladin,holy,18,11,7
Ромерл,gordunni,1028,paladin,holy,93,41,52
Kuhs,eredar,1022,paladin,holy,47,16,31
Skolisse,kazzak,1015,paladin,holy,24,11,13
Golldy,burning-legion,1008,paladin,holy,21,12,9
Paliester,stormscale,1007,paladin,holy,18,12,6
Zerfleddern,aegwynn,1000,paladin,holy,41,15,26
Satip,archimonde,993,paladin,holy,30,19,11
Clerik,eredar,987,paladin,holy,52,27,25
Poundcake,stormscale,978,paladin,holy,38,15,23
Byoß,ravencrest,960,paladin,holy,18,10,8
Optîmuslîme,veklor,959,paladin,holy,18,10,8
Whórainzóne,eredar,958,paladin,holy,36,10,26
Johnaggro,outland,953,paladin,holy,25,11,14
Valkhana,draenor,949,paladin,holy,18,10,8
Бэнкли,soulflayer,948,paladin,holy,18,10,8
Cmelacek,wildhammer,948,paladin,holy,18,10,8
Lightmachine,kirin-tor,945,paladin,holy,12,10,2
Kaktuszfüge,ragnaros,939,paladin,holy,36,20,16
Messîah,outland,939,paladin,holy,43,19,24
Quezkal,dun-modr,938,paladin,holy,21,11,10
Karnwield,kirin-tor,938,paladin,holy,28,13,15
Paladons,darksorrow,922,paladin,holy,30,16,14
Legenda,grim-batol,908,paladin,holy,24,11,13
Яполковник,gordunni,887,paladin,holy,53,30,23
Theisixtus,drakthul,883,paladin,holy,23,12,11
Holysacx,aegwynn,864,paladin,holy,12,9,3
Goyimslayer,ravencrest,864,paladin,holy,12,9,3
Áfx,blackmoore,864,paladin,holy,37,14,23
Wokyo,tarren-mill,863,paladin,holy,12,9,3
Коварное,borean-tundra,863,paladin,holy,18,9,9
Easypala,blackrock,863,paladin,holy,36,9,27
Injection,khaz-modan,862,paladin,holy,26,9,17
Рэймета,soulflayer,861,paladin,holy,18,9,9
Roshï,tarren-mill,861,paladin,holy,24,9,15
Dömötörp,ragnaros,861,paladin,holy,24,9,15
Kayndornek,ravencrest,859,paladin,holy,18,9,9
Smirk,aggra-português,857,paladin,holy,12,9,3
Elganwar,hyjal,856,paladin,holy,18,9,9
Kocovic,tarren-mill,855,paladin,holy,24,9,15
Palir,ysondre,853,paladin,holy,18,9,9
Faildin,arathor,853,paladin,holy,30,9,21
Burkaal,antonidas,852,paladin,holy,24,9,15
Fract,aggramar,838,paladin,holy,18,9,9
Kárlsberg,aegwynn,833,paladin,holy,30,12,18
Алукартик,deathguard,831,paladin,holy,17,9,8
Pupsihasi,kelthuzad,825,paladin,holy,17,9,8
Ridethelight,nemesis,823,paladin,holy,18,9,9
Curufin,grim-batol,767,paladin,holy,12,8,4
Ashbrìnger,aegwynn,767,paladin,holy,12,8,4
Ostardo,blackhand,767,paladin,holy,12,8,4
Анбели,gordunni,767,paladin,holy,12,8,4
Alldo,drakthul,767,paladin,holy,18,8,10
Mikemyers,blackhand,767,paladin,holy,18,8,10
Locofatguy,drakthul,767,paladin,holy,18,8,10
Qpax,twisting-nether,767,paladin,holy,18,8,10
Micrøsi,thrall,767,paladin,holy,18,8,10
Konane,drekthar,767,paladin,holy,19,8,11
Tyktyk,draenor,766,paladin,holy,12,8,4
Bezvakost,thunderhorn,766,paladin,holy,18,8,10
Demonskiller,alakir,766,paladin,holy,18,8,10
Bighammerx,ravencrest,765,paladin,holy,18,8,10
Rébél,argent-dawn,763,paladin,holy,24,8,16
Ikbenmani,tarren-mill,760,paladin,holy,18,8,10
Buddy,conseil-des-ombres,757,paladin,holy,12,8,4
Паландис,howling-fjord,757,paladin,holy,18,8,10
Nosn,ravencrest,755,paladin,holy,18,8,10
Vintar,quelthalas,743,paladin,holy,24,8,16
Gegge,kazzak,701,paladin,holy,26,8,18
Haros,xavius,686,paladin,holy,13,8,5
Blazerlolz,kazzak,672,paladin,holy,12,7,5
Umirinbruv,zenedar,672,paladin,holy,20,7,13
Daddysiliam,ravencrest,671,paladin,holy,12,7,5
Tiffanyqt,frostwolf,671,paladin,holy,12,7,5
Skatiaringos,silvermoon,671,paladin,holy,18,7,11
Mohamedx,tarren-mill,671,paladin,holy,18,7,11
Vivalabeef,stormscale,671,paladin,holy,18,7,11
Sangriul,outland,671,paladin,holy,24,7,17
Skarn,pozzo-delleternità,670,paladin,holy,18,7,11
Seinz,talnivarr,668,paladin,holy,18,7,11
Anemonaa,argent-dawn,658,paladin,holy,12,7,5
Langibo,malfurion,658,paladin,holy,12,7,5
Jüther,pozzo-delleternità,623,paladin,holy,17,7,10
Торсгард,howling-fjord,622,paladin,holy,15,8,7
Istani,twisting-nether,576,paladin,holy,12,6,6
Ben,ghostlands,576,paladin,holy,12,6,6
Skwáru,burning-legion,576,paladin,holy,12,6,6
Dogmatic,blackmoore,576,paladin,holy,12,6,6
Макстипчик,howling-fjord,576,paladin,holy,12,6,6
Aese,dun-modr,576,paladin,holy,12,6,6
Drohim,aegwynn,576,paladin,holy,12,6,6
Kiingen,ragnaros,576,paladin,holy,12,6,6
Jinyssa,silvermoon,576,paladin,holy,12,6,6
Думгохан,howling-fjord,576,paladin,holy,18,6,12
Лимфома,goldrinn,576,paladin,holy,18,6,12
Язвавгорле,soulflayer,576,paladin,holy,18,6,12
Fannypoo,sylvanas,576,paladin,holy,18,6,12
Джонниджага,blackscar,576,paladin,holy,22,7,15
Seabrook,stormscale,576,paladin,holy,24,6,18
Expot,blackmoore,575,paladin,holy,12,6,6
Goodbit,dentarg,575,paladin,holy,12,6,6
Ritiv,stormreaver,575,paladin,holy,12,6,6
Manole,ravencrest,575,paladin,holy,17,8,9
Cadila,silvermoon,574,paladin,holy,12,6,6
Pussdocta,ravencrest,574,paladin,holy,18,6,12
Holymax,gorgonnash,573,paladin,holy,12,6,6
Ggiwastheret,kazzak,480,paladin,holy,6,5,1
Welivewewin,defias-brotherhood,480,paladin,holy,6,5,1
Derpe,hellscream,480,paladin,holy,6,5,1
Teksor,frostmourne,480,paladin,holy,6,5,1
Gayestpala,ravencrest,480,paladin,holy,12,5,7
Bossedin,aszune,480,paladin,holy,12,5,7
Elfaza,uldum,480,paladin,holy,12,5,7
Percocetx,tarren-mill,480,paladin,holy,12,5,7
Elians,outland,480,paladin,holy,12,5,7
Zilu,kazzak,480,paladin,holy,12,5,7
Stepsislana,tarren-mill,480,paladin,holy,12,5,7
Emistesía,stormscale,480,paladin,holy,12,5,7
Лайхтни,gordunni,480,paladin,holy,12,5,7
Asenae,draenor,480,paladin,holy,18,5,13
Zymotíx,stormscale,480,paladin,holy,18,5,13
Elohim,echsenkessel,480,paladin,holy,18,5,13
Гола,gordunni,480,paladin,holy,18,5,13
Mestgone,dalaran,480,paladin,holy,18,5,13
Nezâ,thrall,480,paladin,holy,18,5,13
Brøadway,eredar,479,paladin,holy,12,5,7
Puiçanpal,archimonde,479,paladin,holy,12,5,7
Bubblegum,dentarg,478,paladin,holy,18,5,13
Menagron,tarren-mill,476,paladin,holy,13,5,8
Styflor,dalaran,476,paladin,holy,18,5,13
Jargot,antonidas,472,paladin,holy,12,5,7
Тейдехан,gordunni,426,paladin,holy,21,6,15
Eastranspal,ravencrest,426,paladin,holy,24,6,18
Nemesisbot,dun-modr,384,paladin,holy,6,4,2
Bapêe,thrall,384,paladin,holy,6,4,2
Devinèqt,tarren-mill,384,paladin,holy,6,4,2
Bloednicht,dentarg,384,paladin,holy,6,4,2
Первыйпал,blackscar,384,paladin,holy,6,4,2
Rookbeef,eredar,384,paladin,holy,6,4,2
Wiffy,ravencrest,384,paladin,holy,6,4,2
Dunutunicorn,argent-dawn,384,paladin,holy,6,4,2
Norandel,turalyon,384,paladin,holy,12,4,8
Erathoor,grim-batol,384,paladin,holy,12,4,8
Eline,zenedar,384,paladin,holy,12,4,8
Wingcomandêr,aegwynn,384,paladin,holy,12,4,8
Pussas,burning-legion,384,paladin,holy,12,4,8
Crucifiction,balnazzar,384,paladin,holy,12,4,8
Cerseï,frostmane,384,paladin,holy,12,4,8
Visersion,tarren-mill,384,paladin,holy,12,4,8
Stratarxis,kazzak,384,paladin,holy,12,4,8
Emistesia,stormscale,384,paladin,holy,12,4,8
Tyrø,ravencrest,384,paladin,holy,12,4,8
Sebatrøz,ravencrest,384,paladin,holy,12,4,8
Psikatchuu,hyjal,384,paladin,holy,12,4,8
Erao,the-maelstrom,384,paladin,holy,12,4,8
Imitrex,hyjal,384,paladin,holy,12,4,8
Талрэн,howling-fjord,384,paladin,holy,18,4,14
Daizen,blackrock,383,paladin,holy,6,4,2
Boric,bloodhoof,383,paladin,holy,12,4,8
Galadørn,elune,383,paladin,holy,12,4,8
Caumon,los-errantes,383,paladin,holy,12,4,8
Gromezrael,elune,383,paladin,holy,12,4,8
Superpaladin,draenor,383,paladin,holy,18,4,14
Santtox,dun-modr,383,paladin,holy,18,4,14
Scissors,dun-morogh,383,paladin,holy,18,4,14
Tömmÿ,draenor,382,paladin,holy,12,4,8
Ysnee,sanguino,320,paladin,holy,16,4,12
Ubiquitous,kazzak,319,paladin,holy,11,4,7
Holysac,aegwynn,288,paladin,holy,6,3,3
Reeley,drakthul,288,paladin,holy,6,3,3
Holypapa,argent-dawn,288,paladin,holy,6,3,3
Dewastør,blackmoore,288,paladin,holy,6,3,3
Astollfo,hyjal,288,paladin,holy,6,3,3
Вивай,howling-fjord,288,paladin,holy,6,3,3
Veléxis,outland,288,paladin,holy,6,3,3
Tacodin,blackrock,288,paladin,holy,6,3,3
Blessedpapi,draenor,288,paladin,holy,6,3,3
Solumon,gorgonnash,288,paladin,holy,6,3,3
Matagladis,dun-modr,288,paladin,holy,6,3,3
Heldarim,ysondre,288,paladin,holy,6,3,3
Scrimple,stormscale,288,paladin,holy,6,3,3
Rohanan,blackrock,288,paladin,holy,6,3,3
Бладиполи,soulflayer,288,paladin,holy,6,3,3
Кольт,borean-tundra,288,paladin,holy,6,3,3
Рустиктоп,gordunni,288,paladin,holy,6,3,3
Breez,die-aldor,288,paladin,holy,6,3,3
Кейлол,soulflayer,288,paladin,holy,9,3,6
Brölin,sanguino,288,paladin,holy,12,3,9
Tyraïa,archimonde,288,paladin,holy,12,3,9
Linxo,argent-dawn,288,paladin,holy,12,3,9
Bcrp,ragnaros,288,paladin,holy,12,3,9
Rezvaya,tarren-mill,288,paladin,holy,12,3,9
Telarii,die-nachtwache,288,paladin,holy,12,3,9
Kapsloch,twisting-nether,288,paladin,holy,12,3,9
Ramos,aggra-português,288,paladin,holy,12,3,9
Arbuzno,draenor,288,paladin,holy,12,3,9
Паладинас,lich-king,288,paladin,holy,18,3,15
Макспал,lich-king,287,paladin,holy,6,3,3
Averyholycow,the-maelstrom,287,paladin,holy,6,3,3
Crusadelight,alakir,287,paladin,holy,6,3,3
Toxií,argent-dawn,287,paladin,holy,12,3,9
Purificatoru,draenor,287,paladin,holy,12,3,9
Kcore,blackrock,287,paladin,holy,12,3,9
Ударник,soulflayer,286,paladin,holy,6,3,3
Justyowx,archimonde,256,paladin,holy,4,4,0
Psycholas,ysondre,239,paladin,holy,5,3,2
Regis,dragonblight,234,paladin,holy,7,4,3
Xila,blackrock,234,paladin,holy,9,4,5
Reeceboss,ravencrest,234,paladin,holy,17,5,12
Mustardio,tarren-mill,234,paladin,holy,14,4,10
Mozzie,archimonde,234,paladin,holy,20,4,16
Zeiserig,antonidas,192,paladin,holy,6,2,4
Nirvanä,drakthul,192,paladin,holy,6,2,4
Memewings,tarren-mill,192,paladin,holy,6,2,4
Benedikt,stormscale,192,paladin,holy,6,2,4
Envli,ragnaros,192,paladin,holy,6,2,4
Lompe,karazhan,192,paladin,holy,6,2,4
Teflonmagìc,ravencrest,192,paladin,holy,6,2,4
Дюве,blackscar,192,paladin,holy,6,2,4
Léinãd,kazzak,192,paladin,holy,6,2,4
Ришардебюр,soulflayer,192,paladin,holy,6,2,4
Itsgossiplol,twisting-nether,192,paladin,holy,6,2,4
Pátish,terenas,192,paladin,holy,6,2,4
Alisonquínn,defias-brotherhood,192,paladin,holy,6,2,4
Realdeal,argent-dawn,192,paladin,holy,6,2,4
Bígmachine,draenor,192,paladin,holy,6,2,4
Zerohour,kilrogg,192,paladin,holy,6,2,4
Krayzier,nordrassil,192,paladin,holy,6,2,4
Edgï,confrérie-du-thorium,192,paladin,holy,6,2,4
Vadomar,emerald-dream,192,paladin,holy,6,2,4
Прожектор,gordunni,192,paladin,holy,6,2,4
Lafrogge,culte-de-la-rive-noire,192,paladin,holy,6,2,4
Durnell,sylvanas,192,paladin,holy,6,2,4
Essina,argent-dawn,192,paladin,holy,12,2,10
Westranspal,ravencrest,192,paladin,holy,12,2,10
Холидугги,howling-fjord,192,paladin,holy,12,2,10
Wíw,kazzak,192,paladin,holy,12,2,10
Phalphlingo,stormscale,192,paladin,holy,12,2,10
Zuplex,deathwing,191,paladin,holy,6,2,4
Àkí,blackmoore,191,paladin,holy,6,2,4
Pïñkñætðøðÿ,tarren-mill,138,paladin,holy,14,3,11
Демига,ashenvale,96,paladin,holy,6,1,5
Zerafic,sylvanas,96,paladin,holy,6,1,5
Iamyellow,silvermoon,96,paladin,holy,6,1,5
Holyfalls,blackmoore,96,paladin,holy,6,1,5
Minirempart,khaz-modan,96,paladin,holy,6,1,5
Mybadvibes,tarren-mill,96,paladin,holy,6,1,5
Aienest,ragnaros,96,paladin,holy,6,1,5
Fükdîscláss,ravencrest,96,paladin,holy,6,1,5
Bittersweex,stormscale,96,paladin,holy,6,1,5
Bubbleheart,ahnqiraj,96,paladin,holy,6,1,5
Aggressìon,twisting-nether,96,paladin,holy,6,1,5
Wingcomander,aegwynn,96,paladin,holy,6,1,5
Andrøiz,dun-modr,96,paladin,holy,6,1,5
Switchflip,frostmane,96,paladin,holy,6,1,5
Maxôr,norgannon,96,paladin,holy,6,1,5
Playprist,aegwynn,96,paladin,holy,6,1,5
Agorasieya,frostwolf,96,paladin,holy,6,1,5
Insanevegan,ravencrest,96,paladin,holy,6,1,5
Lunaary,antonidas,96,paladin,holy,12,1,11
Kaelorian,silvermoon,96,paladin,holy,12,1,11
Callon,das-syndikat,95,paladin,holy,6,1,5
Yijania,argent-dawn,42,paladin,holy,9,2,7
Cosmicstâr,kazzak,2189,paladin,retribution,83,46,37
Retwar,ravencrest,2108,paladin,retribution,48,34,14
Mýstíc,ravencrest,2106,paladin,retribution,100,49,51
Peiker,blackrock,2066,paladin,retribution,64,35,29
Ufø,magtheridon,2022,paladin,retribution,66,35,31
Steelsuit,argent-dawn,1986,paladin,retribution,122,66,56
Sonne,tarren-mill,1985,paladin,retribution,72,36,36
Нейтхигерс,howling-fjord,1945,paladin,retribution,77,39,38
Bernhoftxd,ravencrest,1917,paladin,retribution,92,39,53
Bigspin,ravencrest,1906,paladin,retribution,54,29,25
Декионзхц,howling-fjord,1886,paladin,retribution,66,27,39
Толвард,gordunni,1881,paladin,retribution,25,21,4
Аполодориан,gordunni,1876,paladin,retribution,60,30,30
Pancakee,the-maelstrom,1872,paladin,retribution,60,31,29
Дэнискарз,gordunni,1866,paladin,retribution,48,26,22
Durenai,aegwynn,1859,paladin,retribution,72,32,40
Аеррис,gordunni,1853,paladin,retribution,77,34,43
Dasar,twisting-nether,1851,paladin,retribution,72,31,41
Nein,blackhand,1848,paladin,retribution,102,47,55
Risingfi,kult-der-verdammten,1844,paladin,retribution,78,47,31
Стьюпидбой,howling-fjord,1843,paladin,retribution,66,34,32
Astilia,sylvanas,1843,paladin,retribution,84,43,41
Hornyret,kazzak,1839,paladin,retribution,96,46,50
Yungboihoj,twisting-nether,1831,paladin,retribution,125,61,64
Phix,outland,1829,paladin,retribution,66,31,35
Jowanno,stormscale,1826,paladin,retribution,66,32,34
Eimaqt,stormscale,1825,paladin,retribution,70,33,37
Cqt,ravencrest,1823,paladin,retribution,66,30,36
Angryturk,ravencrest,1816,paladin,retribution,36,19,17
Kriszi,burning-legion,1814,paladin,retribution,60,23,37
Ktk,ravencrest,1813,paladin,retribution,121,67,54
Drkp,blackrock,1811,paladin,retribution,31,20,11
Коварное,borean-tundra,1810,paladin,retribution,66,36,30
Elypsia,tarren-mill,1810,paladin,retribution,66,29,37
Miilicium,archimonde,1808,paladin,retribution,53,23,30
Ðaegos,blackmoore,1807,paladin,retribution,89,39,50
Antou,twisting-nether,1806,paladin,retribution,99,46,53
Brassaren,stormscale,1805,paladin,retribution,61,30,31
Karadøc,archimonde,1802,paladin,retribution,90,41,49
Miriokekw,archimonde,1802,paladin,retribution,60,26,34
Bakawolf,burning-legion,1800,paladin,retribution,60,28,32
Icekissz,hyjal,1795,paladin,retribution,24,19,5
Dibzi,argent-dawn,1782,paladin,retribution,48,24,24
Vankwok,stormscale,1771,paladin,retribution,33,20,13
Синодх,eversong,1771,paladin,retribution,59,27,32
Xillindion,blackhand,1767,paladin,retribution,60,28,32
Nanisunda,thrall,1761,paladin,retribution,54,29,25
Sofhiya,silvermoon,1759,paladin,retribution,42,24,18
Блэканус,blackscar,1759,paladin,retribution,54,25,29
Опгоп,gordunni,1758,paladin,retribution,83,41,42
Игры,gordunni,1755,paladin,retribution,59,28,31
Simjon,defias-brotherhood,1745,paladin,retribution,102,61,41
Matriarchxd,kazzak,1745,paladin,retribution,36,20,16
Delgato,kazzak,1742,paladin,retribution,134,69,65
Bjornulfr,ravencrest,1733,paladin,retribution,53,22,31
Qarak,argent-dawn,1732,paladin,retribution,65,30,35
Freshreroll,tarren-mill,1723,paladin,retribution,36,24,12
Bersercute,sylvanas,1723,paladin,retribution,48,25,23
Vhardan,archimonde,1720,paladin,retribution,113,53,60
Granfort,argent-dawn,1718,paladin,retribution,78,33,45
Kazuroo,blackmoore,1713,paladin,retribution,30,18,12
Tsorig,tarren-mill,1704,paladin,retribution,60,36,24
Pestomp,tarren-mill,1704,paladin,retribution,53,24,29
Lesterqt,thrall,1704,paladin,retribution,60,24,36
Мегопалл,blackscar,1704,paladin,retribution,72,28,44
Nutqtgodx,archimonde,1702,paladin,retribution,36,21,15
Ilòvekris,draenor,1701,paladin,retribution,102,48,54
Пинкпуссибой,howling-fjord,1700,paladin,retribution,44,27,17
Gùtz,xavius,1698,paladin,retribution,45,22,23
Rli,twisting-nether,1696,paladin,retribution,53,28,25
Yuber,ravencrest,1695,paladin,retribution,60,25,35
Djstompyamom,stormscale,1694,paladin,retribution,51,23,28
Beautýbeast,ravencrest,1693,paladin,retribution,47,24,23
Kêkbûrâgol,kazzak,1688,paladin,retribution,30,20,10
Rekktadin,grim-batol,1688,paladin,retribution,53,23,30
Swahadon,stormscale,1688,paladin,retribution,48,20,28
Зондарк,booty-bay,1687,paladin,retribution,59,24,35
Losër,ravencrest,1687,paladin,retribution,54,20,34
Tremelay,silvermoon,1685,paladin,retribution,84,39,45
Dréamypie,silvermoon,1681,paladin,retribution,47,18,29
Breakdøwñ,blackrock,1681,paladin,retribution,84,32,52
Охоху,gordunni,1678,paladin,retribution,36,21,15
Аскеттх,gordunni,1678,paladin,retribution,48,27,21
Кавайнекс,azuregos,1677,paladin,retribution,50,26,24
Ярослэйв,howling-fjord,1676,paladin,retribution,42,21,21
Pruntadin,silvermoon,1672,paladin,retribution,48,21,27
Morri,ravencrest,1670,paladin,retribution,85,34,51
Малиновыйбох,gordunni,1666,paladin,retribution,49,28,21
Denastys,nemesis,1662,paladin,retribution,42,19,23
Milkyavenger,sylvanas,1659,paladin,retribution,53,35,18
Русэльф,howling-fjord,1657,paladin,retribution,38,21,17
Сёмаигрок,soulflayer,1654,paladin,retribution,54,26,28
Misako,sanguino,1651,paladin,retribution,60,29,31
Wakke,outland,1646,paladin,retribution,32,23,9
Ønlyfâns,dragonblight,1633,paladin,retribution,54,23,31
Sübôvîñ,ravencrest,1629,paladin,retribution,44,26,18
Фэйсрол,gordunni,1628,paladin,retribution,59,21,38
Отловщик,gordunni,1627,paladin,retribution,36,17,19
Lisma,bloodfeather,1623,paladin,retribution,47,26,21
Wingsmode,kazzak,1623,paladin,retribution,48,17,31
Дюрьвючыф,razuvious,1622,paladin,retribution,80,36,44
Sonarix,blackrock,1621,paladin,retribution,36,19,17
Lonesolo,sylvanas,1618,paladin,retribution,36,20,16
Ças,quelthalas,1618,paladin,retribution,42,17,25
Smirk,aggra-português,1617,paladin,retribution,42,20,22
Утипутя,goldrinn,1616,paladin,retribution,30,17,13
Holyblast,archimonde,1615,paladin,retribution,42,22,20
Skyrose,ravencrest,1614,paladin,retribution,42,23,19
Snødunkern,outland,1613,paladin,retribution,66,26,40
Taurski,sylvanas,1611,paladin,retribution,30,19,11
Discølove,blackmoore,1610,paladin,retribution,43,21,22
Ruath,xavius,1610,paladin,retribution,42,18,24
Lightsaint,kazzak,1601,paladin,retribution,24,20,4
Saabnaab,outland,1600,paladin,retribution,96,59,37
Spegepølse,silvermoon,1590,paladin,retribution,50,28,22
Altundrdel,ravencrest,1587,paladin,retribution,48,25,23
Batteldin,blackmoore,1573,paladin,retribution,72,46,26
Ришардебюр,soulflayer,1573,paladin,retribution,41,21,20
Mezor,dun-modr,1572,paladin,retribution,42,18,24
Tazken,tarren-mill,1567,paladin,retribution,42,18,24
Djcrusade,twisting-nether,1565,paladin,retribution,61,36,25
Sántouryu,ravencrest,1564,paladin,retribution,68,28,40
Kathí,kazzak,1563,paladin,retribution,24,18,6
Valhella,stormscale,1549,paladin,retribution,105,52,53
Vanthael,chamber-of-aspects,1548,paladin,retribution,78,42,36
Ниашес,howling-fjord,1547,paladin,retribution,41,18,23
Honorkill,silvermoon,1546,paladin,retribution,24,17,7
Данхайк,gordunni,1537,paladin,retribution,60,34,26
Unschúld,blackrock,1534,paladin,retribution,49,29,20
Réaxon,archimonde,1533,paladin,retribution,33,17,16
Bigbuffdaddy,draenor,1531,paladin,retribution,118,53,65
Nikkibenzqt,blackmoore,1530,paladin,retribution,42,16,26
Pætter,aggra-português,1529,paladin,retribution,24,16,8
Elrandil,kazzak,1528,paladin,retribution,66,30,36
Jorhall,antonidas,1521,paladin,retribution,76,40,36
Paakz,stormscale,1520,paladin,retribution,37,19,18
Thedarksteel,ravencrest,1520,paladin,retribution,42,16,26
Jac,nemesis,1518,paladin,retribution,48,24,24
Таптыгин,gordunni,1518,paladin,retribution,36,16,20
Salti,magtheridon,1517,paladin,retribution,61,31,30
Rapwnzel,sylvanas,1515,paladin,retribution,60,30,30
Mélli,eredar,1512,paladin,retribution,45,25,20
Draizor,twisting-nether,1512,paladin,retribution,71,29,42
Wyllian,grim-batol,1511,paladin,retribution,30,16,14
Саймум,blackscar,1509,paladin,retribution,45,19,26
Násty,twisting-nether,1508,paladin,retribution,42,20,22
Kènpachî,blackrock,1506,paladin,retribution,30,16,14
Powerpuffret,antonidas,1500,paladin,retribution,42,20,22
Ralphias,twisting-nether,1498,paladin,retribution,72,32,40
Aethelwold,ragnaros,1494,paladin,retribution,84,29,55
Ben,ghostlands,1492,paladin,retribution,24,16,8
Holzer,azshara,1491,paladin,retribution,29,16,13
Tyrael,darksorrow,1490,paladin,retribution,104,46,58
Менетиил,galakrond,1488,paladin,retribution,52,17,35
Rugila,ragnaros,1485,paladin,retribution,39,24,15
Shröömïë,silvermoon,1485,paladin,retribution,48,25,23
Ðivine,stormscale,1483,paladin,retribution,42,25,17
Тюрр,lich-king,1480,paladin,retribution,43,21,22
Термотравка,grom,1478,paladin,retribution,72,30,42
Cauze,ravencrest,1472,paladin,retribution,24,16,8
Catar,arathor,1467,paladin,retribution,140,78,62
Ceccil,dun-modr,1462,paladin,retribution,30,19,11
Кронкс,howling-fjord,1457,paladin,retribution,81,38,43
Offa,draenor,1456,paladin,retribution,30,17,13
Lightbrîng,hyjal,1455,paladin,retribution,42,17,25
Синфуледи,gordunni,1454,paladin,retribution,48,17,31
Bregowine,doomhammer,1452,paladin,retribution,60,33,27
Arfeniel,stormscale,1448,paladin,retribution,54,20,34
Jathx,silvermoon,1444,paladin,retribution,50,28,22
Teho,dragonblight,1443,paladin,retribution,30,19,11
Ibnkrook,archimonde,1439,paladin,retribution,30,15,15
Дезоиль,gordunni,1436,paladin,retribution,24,15,9
Nîhil,silvermoon,1436,paladin,retribution,36,15,21
Nedith,pozzo-delleternità,1435,paladin,retribution,30,15,15
Pâsla,hyjal,1433,paladin,retribution,42,15,27
Ironquist,doomhammer,1432,paladin,retribution,30,15,15
Hódle,silvermoon,1431,paladin,retribution,24,15,9
Gulinborsti,aegwynn,1427,paladin,retribution,24,17,7
Mattiesko,kazzak,1427,paladin,retribution,78,39,39
Goldhand,vashj,1425,paladin,retribution,54,27,27
Flaweldin,ravencrest,1420,paladin,retribution,18,15,3
Maybach,onyxia,1419,paladin,retribution,42,16,26
Hagën,minahonda,1407,paladin,retribution,35,20,15
Xawier,ghostlands,1407,paladin,retribution,30,15,15
Илюшагодх,gordunni,1405,paladin,retribution,36,22,14
Sickbolt,eredar,1404,paladin,retribution,48,27,21
Crazzylight,kazzak,1403,paladin,retribution,74,35,39
Волатбай,gordunni,1396,paladin,retribution,33,18,15
Thazyru,frostmane,1395,paladin,retribution,24,16,8
Dantrag,eredar,1391,paladin,retribution,42,15,27
Proletardk,draenor,1375,paladin,retribution,48,25,23
Джекадамс,gordunni,1375,paladin,retribution,66,16,50
Morniarn,argent-dawn,1374,paladin,retribution,54,29,25
Günselsen,antonidas,1373,paladin,retribution,30,16,14
Izolated,aegwynn,1372,paladin,retribution,42,16,26
Telredor,rexxar,1372,paladin,retribution,42,15,27
Svetijuju,kazzak,1367,paladin,retribution,60,29,31
Беймикс,gordunni,1364,paladin,retribution,54,29,25
Батллграунт,soulflayer,1362,paladin,retribution,50,29,21
Эзарх,gordunni,1359,paladin,retribution,58,29,29
Ретриванлав,gordunni,1358,paladin,retribution,60,20,40
Гучив,howling-fjord,1354,paladin,retribution,48,27,21
Apolomaeuz,blackhand,1354,paladin,retribution,36,20,16
Ashent,stormscale,1353,paladin,retribution,42,19,23
Борссалино,gordunni,1352,paladin,retribution,77,35,42
Sparrda,dun-modr,1350,paladin,retribution,36,20,16
Baldivar,silvermoon,1343,paladin,retribution,36,18,18
Retdead,nordrassil,1342,paladin,retribution,24,14,10
Ослепителен,eversong,1342,paladin,retribution,30,14,16
Zerørespect,ravencrest,1342,paladin,retribution,36,14,22
Aasimar,twilights-hammer,1341,paladin,retribution,58,30,28
Geneundreitt,dethecus,1341,paladin,retribution,30,14,16
Wingsteak,draenor,1339,paladin,retribution,33,14,19
Витурус,howling-fjord,1339,paladin,retribution,42,14,28
Кузькинамать,greymane,1338,paladin,retribution,30,14,16
Dainan,blackmoore,1338,paladin,retribution,30,14,16
Мэибибэиби,howling-fjord,1335,paladin,retribution,36,14,22
Biggboii,twisting-nether,1335,paladin,retribution,36,14,22
Aikm,tarren-mill,1332,paladin,retribution,50,26,24
Хилерскийхил,soulflayer,1332,paladin,retribution,32,14,18
Knigh,draenor,1331,paladin,retribution,24,14,10
Staticdeath,ravencrest,1326,paladin,retribution,30,14,16
Impaross,shattrath,1320,paladin,retribution,96,49,47
Taiso,alonsus,1316,paladin,retribution,30,14,16
Бэйгреон,gordunni,1309,paladin,retribution,26,15,11
Testør,ragnaros,1308,paladin,retribution,35,14,21
Røck,aggra-português,1306,paladin,retribution,23,14,9
Aisnil,twilights-hammer,1303,paladin,retribution,35,15,20
Booyaahh,ravencrest,1301,paladin,retribution,36,17,19
Hàsbulla,khaz-modan,1300,paladin,retribution,30,15,15
Foxare,burning-legion,1299,paladin,retribution,41,23,18
Rudî,sanguino,1295,paladin,retribution,22,16,6
Aegend,antonidas,1291,paladin,retribution,96,43,53
Unohana,shattered-halls,1290,paladin,retribution,48,14,34
Модрит,soulflayer,1287,paladin,retribution,23,14,9
Æe,blackmoore,1285,paladin,retribution,31,21,10
Angrykorean,blackmoore,1284,paladin,retribution,59,28,31
Faithsmemory,silvermoon,1284,paladin,retribution,41,15,26
Darhuun,antonidas,1281,paladin,retribution,93,43,50
Dieversity,stormscale,1280,paladin,retribution,41,16,25
Nardindindou,ysondre,1278,paladin,retribution,68,34,34
Elení,thrall,1269,paladin,retribution,31,14,17
Эльбабло,lich-king,1268,paladin,retribution,45,21,24
Перизкопец,gordunni,1267,paladin,retribution,30,16,14
Viiri,burning-legion,1257,paladin,retribution,35,20,15
Tønyx,les-clairvoyants,1253,paladin,retribution,32,14,18
Lightppl,outland,1249,paladin,retribution,36,19,17
Lübu,archimonde,1248,paladin,retribution,30,13,17
Zion,runetotem,1247,paladin,retribution,24,13,11
Msharix,kazzak,1247,paladin,retribution,24,13,11
Krîstal,aegwynn,1247,paladin,retribution,24,13,11
Anatorka,drakthul,1247,paladin,retribution,30,16,14
Paladiodinos,hyjal,1247,paladin,retribution,42,16,26
Royki,the-maelstrom,1247,paladin,retribution,36,13,23
Spacknas,blackmoore,1246,paladin,retribution,18,13,5
Réfractio,die-aldor,1245,paladin,retribution,30,13,17
Ðenlox,destromath,1244,paladin,retribution,36,13,23
Tyri,silvermoon,1242,paladin,retribution,24,13,11
Raoun,archimonde,1242,paladin,retribution,30,13,17
Mhehø,hyjal,1241,paladin,retribution,42,13,29
Ämÿcüs,zuljin,1238,paladin,retribution,24,13,11
Fisslol,kazzak,1235,paladin,retribution,36,13,23
Aurroraa,doomhammer,1233,paladin,retribution,27,14,13
Mystixd,talnivarr,1227,paladin,retribution,18,13,5
Баблспула,soulflayer,1227,paladin,retribution,30,13,17
Вандиир,soulflayer,1226,paladin,retribution,24,13,11
Velkar,frostmane,1221,paladin,retribution,50,26,24
Юлец,galakrond,1220,paladin,retribution,30,13,17
Nomurabeta,naxxramas,1219,paladin,retribution,30,13,17
Ragnarük,khaz-modan,1217,paladin,retribution,42,20,22
Angelcore,tarren-mill,1215,paladin,retribution,30,13,17
Owiganowi,ulduar,1209,paladin,retribution,24,15,9
Afhvahj,tichondrius,1209,paladin,retribution,22,13,9
Duckiboy,ragnaros,1209,paladin,retribution,40,19,21
Rothmans,aggra-português,1208,paladin,retribution,24,13,11
Светлыйкит,blackscar,1204,paladin,retribution,48,25,23
Цвандр,gordunni,1201,paladin,retribution,46,20,26
Glàdiator,outland,1198,paladin,retribution,23,13,10
Frankostyle,sanguino,1193,paladin,retribution,29,13,16
Whiffy,silvermoon,1193,paladin,retribution,36,13,23
Helmed,tarren-mill,1189,paladin,retribution,27,16,11
Skippadin,ravencrest,1185,paladin,retribution,35,13,22
Palagray,blackmoore,1166,paladin,retribution,36,16,20
Holybubo,tarren-mill,1153,paladin,retribution,48,26,22
Bigdblaster,twisting-nether,1152,paladin,retribution,18,12,6
Eysn,blackrock,1152,paladin,retribution,24,12,12
Franclovis,hyjal,1152,paladin,retribution,29,12,17
Vadya,ravencrest,1151,paladin,retribution,18,12,6
Zubxp,ravencrest,1151,paladin,retribution,24,12,12
Fordragon,twisting-nether,1151,paladin,retribution,30,12,18
Ruotollo,ravencrest,1150,paladin,retribution,24,12,12
Hirako,nemesis,1150,paladin,retribution,24,12,12
Cowwithspell,stormscale,1150,paladin,retribution,24,12,12
Dominikcro,sylvanas,1149,paladin,retribution,24,12,12
Kaitlyne,tarren-mill,1149,paladin,retribution,24,12,12
Ïdø,hyjal,1149,paladin,retribution,30,12,18
Akoumb,twisting-nether,1148,paladin,retribution,24,12,12
Opsyoudie,kazzak,1147,paladin,retribution,33,13,20
Shtaladin,sylvanas,1146,paladin,retribution,24,12,12
Хельдотер,howling-fjord,1146,paladin,retribution,25,12,13
Gymly,kazzak,1145,paladin,retribution,30,14,16
Xyzl,argent-dawn,1144,paladin,retribution,18,12,6
Dijkie,boulderfist,1139,paladin,retribution,30,12,18
Endar,drakthul,1139,paladin,retribution,30,12,18
Диваин,gordunni,1133,paladin,retribution,24,12,12
Theodór,antonidas,1132,paladin,retribution,29,12,17
Questos,burning-legion,1130,paladin,retribution,45,25,20
Deathzinger,aszune,1126,paladin,retribution,24,12,12
Vrgingamer,kazzak,1125,paladin,retribution,42,13,29
Hïto,dun-modr,1121,paladin,retribution,18,12,6
Troj,ahnqiraj,1112,paladin,retribution,30,14,16
Ylvannka,blackmoore,1109,paladin,retribution,25,12,13
Shädyss,hyjal,1105,paladin,retribution,76,34,42
Ðâny,elune,1104,paladin,retribution,27,12,15
Obé,argent-dawn,1080,paladin,retribution,72,37,35
Миоцуки,gordunni,1077,paladin,retribution,28,12,16
Рэгнволд,deathguard,1062,paladin,retribution,23,12,11
Lytza,frostwolf,1059,paladin,retribution,30,15,15
Quasimotto,turalyon,1058,paladin,retribution,30,13,17
Inkzen,silvermoon,1056,paladin,retribution,18,11,7
Jedzy,ragnaros,1056,paladin,retribution,18,11,7
Carlá,silvermoon,1056,paladin,retribution,25,13,12
Swàyz,archimonde,1055,paladin,retribution,24,11,13
Stukker,silvermoon,1055,paladin,retribution,24,11,13
Ilikejudge,blackmoore,1055,paladin,retribution,30,11,19
Martoretard,archimonde,1055,paladin,retribution,30,11,19
Аилерия,howling-fjord,1054,paladin,retribution,12,11,1
Addwyr,blackrock,1054,paladin,retribution,18,11,7
Codindio,silvermoon,1054,paladin,retribution,18,11,7
Jout,tarren-mill,1054,paladin,retribution,24,11,13
Lyraestra,hyjal,1054,paladin,retribution,30,11,19
Valarians,nemesis,1053,paladin,retribution,18,11,7
Carlash,draenor,1053,paladin,retribution,18,11,7
Deceneü,kazzak,1053,paladin,retribution,24,11,13
Блейзерфайт,eversong,1052,paladin,retribution,18,11,7
Paellysuir,blackmoore,1052,paladin,retribution,24,11,13
Hammarfall,ravencrest,1052,paladin,retribution,27,12,15
Хеллкик,howling-fjord,1052,paladin,retribution,30,11,19
Ayàhuazka,ysondre,1051,paladin,retribution,24,11,13
Fëanôr,tarren-mill,1046,paladin,retribution,128,64,64
Traqnbilkarq,stormscale,1044,paladin,retribution,24,12,12
Immortalkrux,archimonde,1044,paladin,retribution,36,13,23
Vendikor,nemesis,1044,paladin,retribution,42,11,31
Кветирон,soulflayer,1043,paladin,retribution,36,11,25
Naneno,silvermoon,1038,paladin,retribution,28,12,16
Tóxicpaladín,kazzak,1037,paladin,retribution,23,11,12
Saró,ravencrest,1035,paladin,retribution,22,12,10
Kýrp,stormreaver,1035,paladin,retribution,30,11,19
Truezero,draenor,1034,paladin,retribution,24,11,13
Beastyblodne,sylvanas,1031,paladin,retribution,18,11,7
Böb,garona,1029,paladin,retribution,24,11,13
Sunsaiy,doomhammer,1027,paladin,retribution,24,12,12
Мистерху,gordunni,1026,paladin,retribution,55,22,33
Monkeytm,archimonde,1024,paladin,retribution,22,11,11
Hateless,tarren-mill,1024,paladin,retribution,28,11,17
Sinthoràs,shattered-hand,1018,paladin,retribution,24,13,11
Krïstâlùlz,archimonde,1014,paladin,retribution,34,15,19
Crynó,blackmoore,1010,paladin,retribution,30,13,17
Renaseh,twisting-nether,1007,paladin,retribution,23,11,12
Snaty,khaz-modan,1004,paladin,retribution,33,18,15
Pytha,nozdormu,1004,paladin,retribution,25,13,12
Paladie,dalaran,997,paladin,retribution,84,43,41
Âchîle,garona,991,paladin,retribution,43,23,20
Elinmogz,kazzak,989,paladin,retribution,20,11,9
Bloodaxjr,archimonde,984,paladin,retribution,26,11,15
Dvouklik,burning-blade,982,paladin,retribution,23,11,12
Raerk,dalaran,962,paladin,retribution,19,11,8
ßlacklight,archimonde,960,paladin,retribution,18,10,8
Dudjaw,stormscale,960,paladin,retribution,18,10,8
Дракула,howling-fjord,959,paladin,retribution,18,10,8
Makakí,twisting-nether,959,paladin,retribution,18,10,8
Ararion,tarren-mill,959,paladin,retribution,18,10,8
Deadholland,ravencrest,959,paladin,retribution,18,10,8
Gangb,ravencrest,959,paladin,retribution,18,10,8
Гневнебес,howling-fjord,959,paladin,retribution,24,10,14
Mayhemx,ravencrest,959,paladin,retribution,36,10,26
Splasher,grim-batol,958,paladin,retribution,18,10,8
Uliko,twisting-nether,958,paladin,retribution,18,10,8
Palwig,tarren-mill,958,paladin,retribution,18,10,8
Arcardi,dun-morogh,958,paladin,retribution,18,10,8
Io,frostwolf,958,paladin,retribution,30,10,20
Aégon,archimonde,957,paladin,retribution,30,11,19
Elganwar,hyjal,956,paladin,retribution,18,10,8
Syracx,blackhand,956,paladin,retribution,24,10,14
Sylazz,blackrock,955,paladin,retribution,49,19,30
Zeyz,defias-brotherhood,954,paladin,retribution,18,10,8
Vlodthar,uldum,952,paladin,retribution,18,10,8
Mustach,aggra-português,952,paladin,retribution,23,10,13
Джагадаптер,gordunni,951,paladin,retribution,18,10,8
Wumbo,sinstralis,950,paladin,retribution,18,10,8
Мизиола,galakrond,948,paladin,retribution,24,10,14
Xemoth,kazzak,947,paladin,retribution,18,10,8
Ziggyz,kul-tiras,945,paladin,retribution,19,10,9
Dildotbagins,argent-dawn,941,paladin,retribution,36,20,16
Plato,arthas,933,paladin,retribution,18,10,8
Justrhino,kazzak,927,paladin,retribution,23,10,13
Caladys,silvermoon,926,paladin,retribution,23,10,13
Crazypits,silvermoon,913,paladin,retribution,30,10,20
Ulrhik,nemesis,911,paladin,retribution,27,11,16
Tánk,twilights-hammer,909,paladin,retribution,24,12,12
Vorthir,khaz-modan,880,paladin,retribution,20,10,10
Gilet,argent-dawn,864,paladin,retribution,12,9,3
Zaaen,burning-legion,864,paladin,retribution,12,9,3
Holysnickers,tarren-mill,864,paladin,retribution,12,9,3
Halevia,kazzak,864,paladin,retribution,18,9,9
Сотранокинг,soulflayer,864,paladin,retribution,18,9,9
Рикшак,howling-fjord,864,paladin,retribution,18,9,9
Kilô,sylvanas,864,paladin,retribution,18,9,9
Lecutus,sunstrider,864,paladin,retribution,22,10,12
Лакостик,howling-fjord,864,paladin,retribution,24,9,15
Sitekx,burning-legion,864,paladin,retribution,24,9,15
Сводимиаое,soulflayer,864,paladin,retribution,24,9,15
Angelisho,zuljin,864,paladin,retribution,24,9,15
Umirinbruv,zenedar,864,paladin,retribution,30,9,21
Búbbles,nerathor,863,paladin,retribution,12,9,3
Karyouka,archimonde,863,paladin,retribution,12,9,3
Nillenkäse,antonidas,863,paladin,retribution,12,9,3
Malthred,ravenholdt,863,paladin,retribution,18,9,9
Sildrit,draenor,863,paladin,retribution,18,9,9
Runhexi,silvermoon,863,paladin,retribution,18,9,9
Сазар,gordunni,863,paladin,retribution,18,9,9
Fujszi,arathor,863,paladin,retribution,18,9,9
Baé,drakthul,863,paladin,retribution,24,9,15
Vylnoa,twisting-nether,863,paladin,retribution,30,9,21
Димасгачи,gordunni,862,paladin,retribution,12,9,3
Primle,thrall,862,paladin,retribution,12,9,3
Yaoiri,argent-dawn,862,paladin,retribution,12,9,3
Роллита,gordunni,862,paladin,retribution,24,9,15
Маркант,gordunni,861,paladin,retribution,18,9,9
Kaizêr,silvermoon,860,paladin,retribution,18,9,9
Leyawin,sanguino,858,paladin,retribution,18,9,9
Steakenstein,nathrezim,858,paladin,retribution,18,9,9
Valpen,veknilash,857,paladin,retribution,18,9,9
Palitard,turalyon,851,paladin,retribution,18,9,9
Kollak,dun-modr,850,paladin,retribution,24,9,15
Patzi,die-todeskrallen,847,paladin,retribution,30,11,19
Painshield,outland,847,paladin,retribution,29,9,20
Pàlàthor,khaz-modan,826,paladin,retribution,18,9,9
Helvirya,defias-brotherhood,794,paladin,retribution,48,19,29
Hýox,malganis,784,paladin,retribution,19,9,10
Zeggayodax,nemesis,768,paladin,retribution,12,8,4
Djandja,blackrock,768,paladin,retribution,12,8,4
Vickdicator,stormscale,768,paladin,retribution,12,8,4
Ðeathron,blackmoore,768,paladin,retribution,16,9,7
Baxuz,draenor,768,paladin,retribution,18,8,10
Legodudex,ravencrest,768,paladin,retribution,18,8,10
Daveboss,dragonblight,768,paladin,retribution,18,8,10
Tyristrum,kilrogg,768,paladin,retribution,18,8,10
Чемеряк,gordunni,768,paladin,retribution,18,8,10
Prex,dun-modr,768,paladin,retribution,18,8,10
Bobiwan,ravencrest,768,paladin,retribution,18,8,10
Isora,twisting-nether,768,paladin,retribution,18,8,10
Thaddios,burning-blade,768,paladin,retribution,18,8,10
Нижмубабл,soulflayer,768,paladin,retribution,18,8,10
Kayøz,aegwynn,768,paladin,retribution,18,8,10
Merkury,sanguino,768,paladin,retribution,18,8,10
Iiwar,silvermoon,768,paladin,retribution,18,8,10
Âlßêdø,ravencrest,768,paladin,retribution,24,8,16
Мистеравадон,gordunni,768,paladin,retribution,24,8,16
Nabbi,ravencrest,768,paladin,retribution,24,8,16
Tadashì,aegwynn,768,paladin,retribution,24,8,16
Toxií,argent-dawn,768,paladin,retribution,30,8,22
ßancu,ragnaros,768,paladin,retribution,30,8,22
Hutimeni,turalyon,767,paladin,retribution,12,8,4
Vvaarok,blackmoore,767,paladin,retribution,12,8,4
Dawnnslayer,kazzak,767,paladin,retribution,12,8,4
Blówout,tarren-mill,767,paladin,retribution,12,8,4
Nfxx,argent-dawn,767,paladin,retribution,12,8,4
Lawlight,frostmane,767,paladin,retribution,18,8,10
Ruftadin,ragnaros,767,paladin,retribution,18,8,10
Eywinn,silvermoon,767,paladin,retribution,18,8,10
Hôrrible,ravencrest,767,paladin,retribution,18,8,10
Xersys,draenor,767,paladin,retribution,18,8,10
Кливерти,gordunni,767,paladin,retribution,24,8,16
Fremuduin,argent-dawn,766,paladin,retribution,12,8,4
Yrgin,ravencrest,766,paladin,retribution,12,8,4
Threathor,outland,766,paladin,retribution,21,9,12
Enveador,garrosh,766,paladin,retribution,19,8,11
Террорх,blackscar,766,paladin,retribution,30,8,22
Zanreti,outland,765,paladin,retribution,24,8,16
Killa,stormrage,764,paladin,retribution,18,8,10
Zemoss,kazzak,763,paladin,retribution,12,8,4
Kealen,nemesis,763,paladin,retribution,18,8,10
Holylimx,draenor,762,paladin,retribution,24,8,16
Mosih,bloodfeather,759,paladin,retribution,12,8,4
Goungokuhrbo,doomhammer,755,paladin,retribution,12,8,4
Lliissaa,kazzak,742,paladin,retribution,18,8,10
Grayparser,silvermoon,735,paladin,retribution,14,9,5
Lynaé,blackhand,735,paladin,retribution,13,8,5
Craaw,archimonde,735,paladin,retribution,23,8,15
Kipperb,kazzak,720,paladin,retribution,17,8,9
Kaljir,archimonde,719,paladin,retribution,15,9,6
Orseis,anubarak,718,paladin,retribution,17,8,9
Lumino,twilights-hammer,717,paladin,retribution,17,8,9
Calaestra,twisting-nether,714,paladin,retribution,12,9,3
Ajkulaa,kazzak,703,paladin,retribution,20,8,12
Tavyy,sylvanas,701,paladin,retribution,11,8,3
Elitest,hyjal,688,paladin,retribution,25,8,17
Gradepal,drakthul,687,paladin,retribution,19,8,11
Weekly,outland,672,paladin,retribution,12,7,5
Shjami,rexxar,672,paladin,retribution,12,7,5
Gimly,anachronos,672,paladin,retribution,12,7,5
Korendil,frostmane,672,paladin,retribution,12,7,5
Ilpreside,nemesis,672,paladin,retribution,12,7,5
Starworkal,ragnaros,672,paladin,retribution,12,7,5
Anatollia,silvermoon,672,paladin,retribution,12,7,5
Vhalkur,dun-modr,672,paladin,retribution,12,7,5
Мериатас,soulflayer,672,paladin,retribution,12,7,5
Лиривель,howling-fjord,672,paladin,retribution,12,7,5
Rb,twisting-nether,672,paladin,retribution,12,7,5
Miriem,twisting-nether,672,paladin,retribution,12,7,5
Bigducc,draenor,672,paladin,retribution,12,7,5
Делимнаноль,blackscar,672,paladin,retribution,12,7,5
Sunwalker,bronzebeard,672,paladin,retribution,12,7,5
Иродиада,gordunni,672,paladin,retribution,12,7,5
Grimstark,argent-dawn,672,paladin,retribution,12,7,5
Шоринг,gordunni,672,paladin,retribution,12,7,5
Биоразлагаем,gordunni,672,paladin,retribution,12,7,5
Hammertime,guldan,672,paladin,retribution,12,7,5
Syruplol,blackrock,672,paladin,retribution,12,7,5
Mordar,ravencrest,672,paladin,retribution,13,7,6
Колсет,soulflayer,672,paladin,retribution,18,7,11
Gaalarr,burning-legion,672,paladin,retribution,18,7,11
Arbuzno,draenor,672,paladin,retribution,18,7,11
Kæycc,blackmoore,672,paladin,retribution,18,7,11
Plarbo,blackmoore,672,paladin,retribution,18,7,11
Lílou,blackmoore,672,paladin,retribution,18,7,11
Zachäus,kirin-tor,672,paladin,retribution,18,7,11
Nyxbane,kazzak,672,paladin,retribution,18,7,11
Ritaora,aggramar,672,paladin,retribution,18,7,11
Lysander,antonidas,672,paladin,retribution,18,7,11
Vodax,argent-dawn,672,paladin,retribution,18,7,11
Chocbear,tarren-mill,672,paladin,retribution,18,7,11
Auryel,nemesis,672,paladin,retribution,18,7,11
Bíceron,sanguino,672,paladin,retribution,18,7,11
Wingsuit,eredar,672,paladin,retribution,20,7,13
Коссандра,greymane,672,paladin,retribution,23,7,16
Llaynn,argent-dawn,672,paladin,retribution,24,7,17
Emostylex,draenor,672,paladin,retribution,24,7,17
Ящеры,gordunni,672,paladin,retribution,24,7,17
Imreallybadx,blackrock,671,paladin,retribution,12,7,5
Samueel,blackmoore,671,paladin,retribution,12,7,5
Zélix,bronzebeard,671,paladin,retribution,12,7,5
Kyríé,tarren-mill,671,paladin,retribution,12,7,5
Наваляка,deathguard,671,paladin,retribution,12,7,5
Рипкарт,gordunni,671,paladin,retribution,12,7,5
Jackub,draenor,671,paladin,retribution,12,7,5
Uraraka,burning-blade,671,paladin,retribution,12,7,5
Unkillablee,stormscale,671,paladin,retribution,12,7,5
Laenira,nemesis,671,paladin,retribution,18,7,11
Zandorath,argent-dawn,671,paladin,retribution,18,7,11
Johnßlake,dun-modr,671,paladin,retribution,18,7,11
Alvíss,sanguino,671,paladin,retribution,18,7,11
Eken,hyjal,671,paladin,retribution,18,7,11
Thebestpala,tarren-mill,671,paladin,retribution,18,7,11
Shockashy,stormscale,671,paladin,retribution,21,8,13
Keol,sanguino,670,paladin,retribution,12,7,5
Fredas,hyjal,670,paladin,retribution,18,7,11
Tripani,twisting-nether,669,paladin,retribution,12,7,5
Starstríder,aszune,669,paladin,retribution,12,7,5
Shorella,malganis,669,paladin,retribution,12,7,5
Самерваль,borean-tundra,669,paladin,retribution,12,7,5
Ghallandre,khaz-modan,669,paladin,retribution,12,7,5
Rangorian,defias-brotherhood,669,paladin,retribution,24,7,17
Gxdéon,hyjal,667,paladin,retribution,12,7,5
Messîah,outland,666,paladin,retribution,12,7,5
Quoque,turalyon,664,paladin,retribution,15,8,7
Halimox,terokkar,664,paladin,retribution,18,7,11
Wolya,blackrock,663,paladin,retribution,15,8,7
Vexxus,blackrock,661,paladin,retribution,12,7,5
Belzed,draenor,660,paladin,retribution,15,8,7
Luxor,sporeggar,658,paladin,retribution,12,7,5
Boabux,draenor,638,paladin,retribution,17,7,10
Diamir,rajaxx,624,paladin,retribution,15,7,8
Denounce,defias-brotherhood,624,paladin,retribution,21,7,14
Darkironpala,argent-dawn,623,paladin,retribution,15,7,8
Jaro,alleria,623,paladin,retribution,21,7,14
Goofyaf,ravencrest,618,paladin,retribution,16,9,7
Ressler,tichondrius,616,paladin,retribution,15,7,8
Nollieflip,tarren-mill,607,paladin,retribution,11,7,4
Crohnox,nemesis,607,paladin,retribution,14,7,7
Reito,eredar,576,paladin,retribution,6,6,0
Hølypwnjk,forscherliga,576,paladin,retribution,6,6,0
Lóyal,kazzak,576,paladin,retribution,6,6,0
Scairtin,ravencrest,576,paladin,retribution,12,6,6
Walladin,stormscale,576,paladin,retribution,12,6,6
Кошкотяночка,ashenvale,576,paladin,retribution,12,6,6
Shownómercy,stormscale,576,paladin,retribution,12,6,6
Søulréaper,stormscale,576,paladin,retribution,12,6,6
Ruggero,stormscale,576,paladin,retribution,12,6,6
Retgodx,eredar,576,paladin,retribution,12,6,6
Диджейнобабл,howling-fjord,576,paladin,retribution,12,6,6
Elendíl,azjolnerub,576,paladin,retribution,12,6,6
Vysavo,draenor,576,paladin,retribution,12,6,6
Exolis,archimonde,576,paladin,retribution,12,6,6
Arayël,archimonde,576,paladin,retribution,12,6,6
Романтик,deathweaver,576,paladin,retribution,12,6,6
Mekluba,twisting-nether,576,paladin,retribution,12,6,6
Mawrâ,twisting-nether,576,paladin,retribution,12,6,6
Ridethelight,nemesis,576,paladin,retribution,12,6,6
Olivaresx,ravencrest,576,paladin,retribution,12,6,6
Günykoloke,blackrock,576,paladin,retribution,12,6,6
Ryaz,blackrock,576,paladin,retribution,12,6,6
Варблэйз,gordunni,576,paladin,retribution,12,6,6
Яправ,borean-tundra,576,paladin,retribution,12,6,6
Melverti,kazzak,576,paladin,retribution,12,6,6
Tauskiz,sylvanas,576,paladin,retribution,12,6,6
Béhèlit,sargeras,576,paladin,retribution,12,6,6
Eldrial,argent-dawn,576,paladin,retribution,12,6,6
Shaylaru,tarren-mill,576,paladin,retribution,12,6,6
Exolia,archimonde,576,paladin,retribution,12,6,6
Gabrîel,sanguino,576,paladin,retribution,12,6,6
Puré,festung-der-stürme,576,paladin,retribution,12,6,6
Malemanlad,silvermoon,576,paladin,retribution,12,6,6
Darkenorr,silvermoon,576,paladin,retribution,12,6,6
Тардариус,gordunni,576,paladin,retribution,12,6,6
Azûl,archimonde,576,paladin,retribution,12,6,6
Mouncake,archimonde,576,paladin,retribution,12,6,6
Bulkpwders,burning-legion,576,paladin,retribution,12,6,6
Obsidyen,outland,576,paladin,retribution,14,6,8
Pârabellum,the-maelstrom,576,paladin,retribution,18,6,12
Zeldalòl,outland,576,paladin,retribution,18,6,12
Магрейм,gordunni,576,paladin,retribution,18,6,12
Holymerda,grim-batol,576,paladin,retribution,18,6,12
Xila,blackrock,576,paladin,retribution,18,6,12
Thoriz,elune,576,paladin,retribution,18,6,12
Curtwizz,silvermoon,576,paladin,retribution,18,6,12
Ædrenn,archimonde,576,paladin,retribution,18,6,12
Mariaremarc,silvermoon,576,paladin,retribution,18,6,12
Асканиэль,howling-fjord,576,paladin,retribution,18,6,12
Sacredwrath,burning-legion,576,paladin,retribution,18,6,12
Hermmes,alakir,576,paladin,retribution,18,6,12
Ганка,blackscar,576,paladin,retribution,18,6,12
Modeladin,ragnaros,576,paladin,retribution,18,6,12
Tharizod,nagrand,576,paladin,retribution,18,6,12
Ctierpala,ravencrest,576,paladin,retribution,18,6,12
Кхабелех,howling-fjord,576,paladin,retribution,18,6,12
Xourens,twisting-nether,576,paladin,retribution,18,6,12
Nergigante,drekthar,576,paladin,retribution,18,6,12
Aqualisse,hyjal,576,paladin,retribution,24,6,18
Holyblast,shattered-hand,575,paladin,retribution,6,6,0
Cigyal,hyjal,575,paladin,retribution,6,6,0
Kyrokonserve,blackmoore,575,paladin,retribution,14,7,7
Mikipaki,tarren-mill,575,paladin,retribution,12,6,6
Phillipe,illidan,575,paladin,retribution,12,6,6
Irinor,rashgarroth,575,paladin,retribution,12,6,6
Pewpews,twisting-nether,575,paladin,retribution,12,6,6
Antón,dun-modr,575,paladin,retribution,12,6,6
Эксвайп,howling-fjord,575,paladin,retribution,12,6,6
Hornox,ragnaros,575,paladin,retribution,12,6,6
Rilledread,stormscale,575,paladin,retribution,12,6,6
Nothonnest,archimonde,575,paladin,retribution,12,6,6
Faventu,ragnaros,575,paladin,retribution,12,6,6
Khrotos,draenor,575,paladin,retribution,12,6,6
Trøllørd,shattrath,575,paladin,retribution,12,6,6
Keith,dragonmaw,575,paladin,retribution,12,6,6
Vaako,blackrock,575,paladin,retribution,12,6,6
Hydarr,twisting-nether,575,paladin,retribution,12,6,6
Блэквилл,howling-fjord,575,paladin,retribution,18,6,12
Dafe,zuluhed,574,paladin,retribution,13,8,5
Vondarkmoor,magtheridon,574,paladin,retribution,12,6,6
Humaladi,draenor,574,paladin,retribution,18,6,12
Cpsuper,azuremyst,573,paladin,retribution,12,6,6
Thorold,earthen-ring,572,paladin,retribution,16,8,8
Nhum,destromath,572,paladin,retribution,12,6,6
Boaka,outland,571,paladin,retribution,18,6,12
Exiztant,ravencrest,571,paladin,retribution,18,6,12
Ràwx,twisting-nether,559,paladin,retribution,23,6,17
Knygnesys,silvermoon,558,paladin,retribution,9,8,1
Лусейд,howling-fjord,558,paladin,retribution,11,7,4
Dôrä,ysondre,543,paladin,retribution,17,6,11
Dinøx,archimonde,542,paladin,retribution,23,6,17
Babypic,ambossar,511,paladin,retribution,14,6,8
Yunax,silvermoon,480,paladin,retribution,6,5,1
Kendomendo,ravencrest,480,paladin,retribution,6,5,1
Smirky,silvermoon,480,paladin,retribution,6,5,1
Fatherabdul,ravencrest,480,paladin,retribution,6,5,1
Sabríel,ragnaros,480,paladin,retribution,6,5,1
Yull,twisting-nether,480,paladin,retribution,6,5,1
Rankoneretri,arathor,480,paladin,retribution,6,5,1
Derian,antonidas,480,paladin,retribution,6,5,1
Wuzzle,azshara,480,paladin,retribution,6,5,1
Havefunzqt,archimonde,480,paladin,retribution,6,5,1
Yezitzme,blackrock,480,paladin,retribution,6,5,1
Fullsendbro,ravencrest,480,paladin,retribution,6,5,1
Retaxx,outland,480,paladin,retribution,6,5,1
Gigasack,ravencrest,480,paladin,retribution,6,5,1
Aisolôn,thrall,480,paladin,retribution,6,5,1
Galevar,argent-dawn,480,paladin,retribution,6,5,1
Xoriun,norgannon,480,paladin,retribution,6,5,1
Ryven,stormscale,480,paladin,retribution,6,5,1
Sigmud,turalyon,480,paladin,retribution,6,5,1
Mufuqa,ragnaros,480,paladin,retribution,12,5,7
Sytrexxer,frostwolf,480,paladin,retribution,12,5,7
Lighttitan,ravencrest,480,paladin,retribution,12,5,7
Ретроградий,howling-fjord,480,paladin,retribution,12,5,7
Héphäistos,silvermoon,480,paladin,retribution,12,5,7
Kinvqt,tarren-mill,480,paladin,retribution,12,5,7
Retenki,silvermoon,480,paladin,retribution,12,5,7
Боремир,borean-tundra,480,paladin,retribution,12,5,7
Serjudge,kazzak,480,paladin,retribution,12,5,7
Harridin,ravencrest,480,paladin,retribution,12,5,7
Nordkreuz,aegwynn,480,paladin,retribution,12,5,7
Rullatôrsven,stormscale,480,paladin,retribution,12,5,7
Razrpal,tarren-mill,480,paladin,retribution,12,5,7
Galadrion,dun-modr,480,paladin,retribution,12,5,7
Dêstî,silvermoon,480,paladin,retribution,12,5,7
Dannyvye,outland,480,paladin,retribution,12,5,7
Freedomwinds,kazzak,480,paladin,retribution,12,5,7
Lightlogic,ravencrest,480,paladin,retribution,12,5,7
Zaopink,blackhand,480,paladin,retribution,12,5,7
Endavour,ravencrest,480,paladin,retribution,12,5,7
Retlikeme,ravencrest,480,paladin,retribution,12,5,7
Milenia,nemesis,480,paladin,retribution,12,5,7
Bascelik,outland,480,paladin,retribution,12,5,7
Drylands,ravencrest,480,paladin,retribution,12,5,7
Nizzlee,eredar,480,paladin,retribution,12,5,7
Equityy,burning-legion,480,paladin,retribution,12,5,7
Гниленький,razuvious,480,paladin,retribution,12,5,7
Babaluga,blackrock,480,paladin,retribution,12,5,7
Ivarladin,draenor,480,paladin,retribution,12,5,7
Qpala,quelthalas,480,paladin,retribution,12,5,7
Корсаро,deepholm,480,paladin,retribution,12,5,7
Cêa,blackrock,480,paladin,retribution,12,5,7
Bancu,outland,480,paladin,retribution,12,5,7
Ênma,archimonde,480,paladin,retribution,12,5,7
Daoht,ysondre,480,paladin,retribution,12,5,7
Alard,sanguino,480,paladin,retribution,12,5,7
Rînedaman,ysondre,480,paladin,retribution,12,5,7
Wingzy,hyjal,480,paladin,retribution,12,5,7
Kylaz,die-ewige-wacht,480,paladin,retribution,12,5,7
Mozaiczny,burning-legion,480,paladin,retribution,12,5,7
Sîlversun,grim-batol,480,paladin,retribution,12,5,7
Proxidus,blackmoore,480,paladin,retribution,12,5,7
Bobilous,twisting-nether,480,paladin,retribution,12,5,7
Angelynor,ysondre,480,paladin,retribution,12,5,7
Mecah,hyjal,480,paladin,retribution,12,5,7
Ysell,sargeras,480,paladin,retribution,12,5,7
Naexea,archimonde,480,paladin,retribution,12,5,7
Истенен,blackscar,480,paladin,retribution,18,5,13
Thoreas,perenolde,480,paladin,retribution,18,5,13
Juicycheeks,frostwolf,480,paladin,retribution,18,5,13
Chyve,tarren-mill,480,paladin,retribution,18,5,13
Xciepo,rexxar,480,paladin,retribution,18,5,13
Uwelist,arathor,480,paladin,retribution,18,5,13
Valkûn,rexxar,480,paladin,retribution,18,5,13
Zialo,ravencrest,480,paladin,retribution,24,5,19
Exobyte,stormscale,480,paladin,retribution,24,5,19
Buckfizz,ysondre,479,paladin,retribution,6,5,1
Teogrim,blackmoore,479,paladin,retribution,6,5,1
Edwards,sanguino,479,paladin,retribution,12,5,7
Baymanda,tarren-mill,479,paladin,retribution,12,5,7
Пропала,greymane,479,paladin,retribution,12,5,7
Молотоборец,gordunni,479,paladin,retribution,12,5,7
Taffz,burning-legion,479,paladin,retribution,12,5,7
Эллессар,howling-fjord,479,paladin,retribution,12,5,7
Solyra,blackhand,479,paladin,retribution,12,5,7
Bloodsworn,stormrage,479,paladin,retribution,12,5,7
Rettarded,draenor,479,paladin,retribution,12,5,7
Ilacktoes,twisting-nether,478,paladin,retribution,12,5,7
Mirelaw,drakthul,478,paladin,retribution,12,5,7
Rayshield,tarren-mill,478,paladin,retribution,17,6,11
Четкийчервь,soulflayer,478,paladin,retribution,18,5,13
Pyrogon,malorne,477,paladin,retribution,18,5,13
Zantria,alleria,476,paladin,retribution,12,5,7
Morhgain,kazzak,476,paladin,retribution,18,5,13
Баблыч,borean-tundra,472,paladin,retribution,12,5,7
Блатш,greymane,448,paladin,retribution,16,5,11
Trisunonvaki,khazgoroth,447,paladin,retribution,11,5,6
Гкм,howling-fjord,447,paladin,retribution,11,5,6
Kevlar,frostmane,446,paladin,retribution,12,6,6
Æïs,blackrock,432,paladin,retribution,9,5,4
Sunnyboy,tarren-mill,431,paladin,retribution,11,5,6
Lagaminë,dalaran,429,paladin,retribution,27,5,22
Qshadow,frostwhisper,416,paladin,retribution,16,5,11
Aleixodolphi,argent-dawn,416,paladin,retribution,16,5,11
Анастэриан,thermaplugg,415,paladin,retribution,8,5,3
Gluttön,tarren-mill,400,paladin,retribution,7,5,2
Chikaz,archimonde,388,paladin,retribution,14,7,7
Skrýmir,marécage-de-zangar,384,paladin,retribution,6,4,2
Dornu,tarren-mill,384,paladin,retribution,6,4,2
Лиадринель,howling-fjord,384,paladin,retribution,6,4,2
Tdchopa,ravencrest,384,paladin,retribution,6,4,2
Guccishock,twisting-nether,384,paladin,retribution,6,4,2
Деленка,gordunni,384,paladin,retribution,6,4,2
Rölfchen,frostwolf,384,paladin,retribution,6,4,2
Bâbass,sargeras,384,paladin,retribution,6,4,2
Atrexie,lightbringer,384,paladin,retribution,6,4,2
Палочка,howling-fjord,384,paladin,retribution,6,4,2
Durnell,sylvanas,384,paladin,retribution,6,4,2
Dragongîrl,lothar,384,paladin,retribution,6,4,2
Vatix,trollbane,384,paladin,retribution,6,4,2
Nicolae,colinas-pardas,384,paladin,retribution,6,4,2
Дохлаяженах,gordunni,384,paladin,retribution,6,4,2
Dobbygotsock,kazzak,384,paladin,retribution,6,4,2
Tÿy,sylvanas,384,paladin,retribution,6,4,2
Luckyman,aszune,384,paladin,retribution,6,4,2
Vaníos,nazjatar,384,paladin,retribution,6,4,2
Атикинс,gordunni,384,paladin,retribution,6,4,2
Radamanthes,ysondre,384,paladin,retribution,6,4,2
Franc,aggra-português,384,paladin,retribution,6,4,2
Соулерт,ashenvale,384,paladin,retribution,6,4,2
Missmyhoj,archimonde,384,paladin,retribution,6,4,2
Bcrp,ragnaros,384,paladin,retribution,6,4,2
Siuras,blackmoore,384,paladin,retribution,6,4,2
Skittlespala,twisting-nether,384,paladin,retribution,6,4,2
Myridan,bloodhoof,384,paladin,retribution,6,4,2
Kaelron,sanguino,384,paladin,retribution,6,4,2
Argonak,sanguino,384,paladin,retribution,6,4,2
Aelthir,kazzak,384,paladin,retribution,6,4,2
Kaileena,archimonde,384,paladin,retribution,6,4,2
Demsi,ravencrest,384,paladin,retribution,6,4,2
Леаркус,blackscar,384,paladin,retribution,6,4,2
Bornir,khaz-modan,384,paladin,retribution,6,4,2
Tigurius,zuljin,384,paladin,retribution,6,4,2
Pesterci,draenor,384,paladin,retribution,6,4,2
Wiither,argent-dawn,384,paladin,retribution,6,4,2
Sabriaña,silvermoon,384,paladin,retribution,6,4,2
Drownlord,eredar,384,paladin,retribution,6,4,2
Aylion,blackrock,384,paladin,retribution,6,4,2
Tazkaz,archimonde,384,paladin,retribution,6,4,2
Akaasix,stormscale,384,paladin,retribution,6,4,2
Valin,frostmane,384,paladin,retribution,6,4,2
Meìster,blackmoore,384,paladin,retribution,6,4,2
Arcillus,stormscale,384,paladin,retribution,6,4,2
Zeportpala,archimonde,384,paladin,retribution,6,4,2
Мэднессх,howling-fjord,384,paladin,retribution,6,4,2
Shevøçk,ravencrest,384,paladin,retribution,6,4,2
Volkai,zuljin,384,paladin,retribution,6,4,2
Baxxster,blackhand,384,paladin,retribution,6,4,2
Panicmaker,ravencrest,384,paladin,retribution,6,4,2
Mooses,stormscale,384,paladin,retribution,6,4,2
Clamjam,sylvanas,384,paladin,retribution,6,4,2
Arrious,frostmane,384,paladin,retribution,6,4,2
Zhàø,ysondre,384,paladin,retribution,6,4,2
Veldora,zuljin,384,paladin,retribution,6,4,2
Swânn,sanguino,384,paladin,retribution,6,4,2
Dankin,pozzo-delleternità,384,paladin,retribution,6,4,2
Cùpìdstunt,draenor,384,paladin,retribution,6,4,2
Atanasum,dun-modr,384,paladin,retribution,6,4,2
Spizz,dun-modr,384,paladin,retribution,6,4,2
Pâlâpâm,blackmoore,384,paladin,retribution,6,4,2
Ârev,antonidas,384,paladin,retribution,6,4,2
Velikor,dun-modr,384,paladin,retribution,6,4,2
Screws,dun-modr,384,paladin,retribution,6,4,2
Crussaden,stormscale,384,paladin,retribution,7,4,3
Olaghkan,dun-modr,384,paladin,retribution,8,4,4
Хилвкд,blackscar,384,paladin,retribution,11,4,7
Athênâ,azjolnerub,384,paladin,retribution,15,5,10
Kjobergen,tarren-mill,384,paladin,retribution,12,4,8
Andrøiz,dun-modr,384,paladin,retribution,12,4,8
Kaleyra,argent-dawn,384,paladin,retribution,12,4,8
Eîon,argent-dawn,384,paladin,retribution,12,4,8
Зираэлис,gordunni,384,paladin,retribution,12,4,8
Inkuboss,nemesis,384,paladin,retribution,12,4,8
Батллграунд,soulflayer,384,paladin,retribution,12,4,8
Pålegg,emerald-dream,384,paladin,retribution,12,4,8
Vitacé,burning-legion,384,paladin,retribution,12,4,8
Розовыйбабл,gordunni,384,paladin,retribution,12,4,8
Xòtrios,argent-dawn,384,paladin,retribution,12,4,8
Netharia,antonidas,384,paladin,retribution,12,4,8
Данбро,borean-tundra,384,paladin,retribution,12,4,8
Hasart,tarren-mill,384,paladin,retribution,12,4,8
Lusugo,alakir,384,paladin,retribution,12,4,8
Artoriaz,ravencrest,384,paladin,retribution,12,4,8
Yasfy,stormscale,384,paladin,retribution,12,4,8
Nìcky,stormscale,384,paladin,retribution,12,4,8
Сандалар,gordunni,384,paladin,retribution,12,4,8
Шэйкер,blackscar,384,paladin,retribution,12,4,8
Créo,draenor,384,paladin,retribution,12,4,8
Minfa,argent-dawn,384,paladin,retribution,12,4,8
Kiriel,dun-modr,384,paladin,retribution,12,4,8
Donttaskwhy,sylvanas,384,paladin,retribution,12,4,8
Benzimus,ragnaros,384,paladin,retribution,12,4,8
Bundagains,silvermoon,384,paladin,retribution,12,4,8
Relius,outland,384,paladin,retribution,12,4,8
Arkkipiispa,outland,384,paladin,retribution,12,4,8
Генатрамбон,howling-fjord,384,paladin,retribution,12,4,8
Lucretius,kilrogg,384,paladin,retribution,12,4,8
Serim,dun-modr,384,paladin,retribution,12,4,8
Apocalypsé,twisting-nether,384,paladin,retribution,12,4,8
Sacredlol,blackmoore,384,paladin,retribution,12,4,8
Oldsqlmofu,blackrock,384,paladin,retribution,12,4,8
Decain,twisting-nether,384,paladin,retribution,12,4,8
Dennyboy,sylvanas,384,paladin,retribution,12,4,8
Thiccdeeps,aegwynn,384,paladin,retribution,12,4,8
Cyban,twisting-nether,384,paladin,retribution,12,4,8
Celerius,trollbane,384,paladin,retribution,12,4,8
Âtlas,ragnaros,384,paladin,retribution,12,4,8
Okcså,ragnaros,384,paladin,retribution,16,5,11
Crysania,twisting-nether,384,paladin,retribution,18,4,14
Maitrelampe,argent-dawn,384,paladin,retribution,18,4,14
Skénder,kazzak,384,paladin,retribution,18,4,14
Cadearas,antonidas,384,paladin,retribution,18,4,14
Orbia,draenor,384,paladin,retribution,18,4,14
Møøgødx,bronzebeard,384,paladin,retribution,18,4,14
Rafflesia,sanguino,384,paladin,retribution,18,4,14
Itsgossiplol,twisting-nether,384,paladin,retribution,18,4,14
Campo,tarren-mill,384,paladin,retribution,18,4,14
Руказакона,deathguard,384,paladin,retribution,18,4,14
Buddabob,antonidas,384,paladin,retribution,24,4,20
Fløki,blackrock,383,paladin,retribution,6,4,2
Рукаф,soulflayer,383,paladin,retribution,6,4,2
Ahritea,blackrock,383,paladin,retribution,6,4,2
Bubblemama,aegwynn,383,paladin,retribution,6,4,2
Krögerelf,garrosh,383,paladin,retribution,6,4,2
Torczy,frostwhisper,383,paladin,retribution,6,4,2
Edyk,silvermoon,383,paladin,retribution,6,4,2
Käylä,silvermoon,383,paladin,retribution,12,4,8
Ságé,thrall,383,paladin,retribution,16,4,12
Vibeer,ravencrest,382,paladin,retribution,6,4,2
Mechoka,auchindoun,382,paladin,retribution,7,4,3
Mystíque,die-todeskrallen,382,paladin,retribution,12,4,8
Raptasenda,archimonde,376,paladin,retribution,20,7,13
Joeintkaa,ragnaros,351,paladin,retribution,11,4,7
Kantfyrste,ravencrest,351,paladin,retribution,11,4,7
Madzy,archimonde,351,paladin,retribution,11,4,7
Freemain,doomhammer,336,paladin,retribution,9,4,5
Sunsera,blackrock,330,paladin,retribution,8,5,3
Alanore,tarren-mill,330,paladin,retribution,13,6,7
Тошши,soulflayer,330,paladin,retribution,16,6,10
Îiî,archimonde,330,paladin,retribution,15,5,10
Reiwyn,archimonde,320,paladin,retribution,10,4,6
Vell,bronze-dragonflight,319,paladin,retribution,5,4,1
Kyazar,sylvanas,319,paladin,retribution,5,4,1
Teliriyon,blackrock,319,paladin,retribution,8,4,4
Fleshoflight,arathor,304,paladin,retribution,10,5,5
Бигтедо,gordunni,288,paladin,retribution,6,3,3
Askmy,stormscale,288,paladin,retribution,6,3,3
Partysyster,defias-brotherhood,288,paladin,retribution,6,3,3
Exceed,blackmoore,288,paladin,retribution,6,3,3
Aklime,blackmoore,288,paladin,retribution,6,3,3
Holypurger,shattered-hand,288,paladin,retribution,6,3,3
Moolurk,stormscale,288,paladin,retribution,6,3,3
Prâtox,blackmoore,288,paladin,retribution,6,3,3
Diaéna,kirin-tor,288,paladin,retribution,6,3,3
Reptoglad,archimonde,288,paladin,retribution,6,3,3
Прожектор,gordunni,288,paladin,retribution,6,3,3
Kelsumi,draenor,288,paladin,retribution,6,3,3
Darnero,blackrock,288,paladin,retribution,6,3,3
Eléndrên,blackrock,288,paladin,retribution,6,3,3
Lazaraat,antonidas,288,paladin,retribution,6,3,3
Jeriiret,khaz-modan,288,paladin,retribution,6,3,3
Golgel,turalyon,288,paladin,retribution,6,3,3
Jagen,tyrande,288,paladin,retribution,6,3,3
Âlßêdø,silvermoon,288,paladin,retribution,6,3,3
Vanyon,malganis,288,paladin,retribution,6,3,3
Ophillan,draenor,288,paladin,retribution,6,3,3
Palapouffe,khaz-modan,288,paladin,retribution,6,3,3
Exolix,archimonde,288,paladin,retribution,6,3,3
Minirempart,khaz-modan,288,paladin,retribution,6,3,3
Kielonpala,kazzak,288,paladin,retribution,6,3,3
Divineovic,ravencrest,288,paladin,retribution,6,3,3
Рукибудды,soulflayer,288,paladin,retribution,6,3,3
Лефша,soulflayer,288,paladin,retribution,6,3,3
Uxxer,sanguino,288,paladin,retribution,6,3,3
Llighthand,ravencrest,288,paladin,retribution,6,3,3
Timal,eitrigg,288,paladin,retribution,6,3,3
Khadet,draenor,288,paladin,retribution,6,3,3
Sakulchan,antonidas,288,paladin,retribution,6,3,3
Zeltose,uldaman,288,paladin,retribution,6,3,3
Fogell,ravencrest,288,paladin,retribution,6,3,3
Kalimgor,theradras,288,paladin,retribution,6,3,3
Фемдом,blackscar,288,paladin,retribution,6,3,3
Muieiulica,twisting-nether,288,paladin,retribution,6,3,3
Exolie,archimonde,288,paladin,retribution,6,3,3
Azlaya,sargeras,288,paladin,retribution,6,3,3
Lyrïcs,ysondre,288,paladin,retribution,6,3,3
Froxies,drakthul,288,paladin,retribution,6,3,3
Ïrönhämmër,argent-dawn,288,paladin,retribution,6,3,3
Думклиф,gordunni,288,paladin,retribution,6,3,3
Lazone,ysondre,288,paladin,retribution,6,3,3
Ericafontës,kazzak,288,paladin,retribution,6,3,3
Рамстафарай,gordunni,288,paladin,retribution,6,3,3
Astralenigma,hyjal,288,paladin,retribution,6,3,3
Paidi,die-todeskrallen,288,paladin,retribution,6,3,3
Singlemomdtf,argent-dawn,288,paladin,retribution,6,3,3
Kýríl,antonidas,288,paladin,retribution,6,3,3
Sarunan,ravencrest,288,paladin,retribution,6,3,3
Lerrap,argent-dawn,288,paladin,retribution,6,3,3
Lixîa,hyjal,288,paladin,retribution,6,3,3
Cloudlight,argent-dawn,288,paladin,retribution,6,3,3
Løøktår,ysondre,288,paladin,retribution,6,3,3
Shaká,ravencrest,288,paladin,retribution,6,3,3
Ragen,kazzak,288,paladin,retribution,6,3,3
Illmindofyou,twisting-nether,288,paladin,retribution,6,3,3
Nympa,sylvanas,288,paladin,retribution,6,3,3
Zuveron,the-maelstrom,288,paladin,retribution,6,3,3
Névér,steamwheedle-cartel,288,paladin,retribution,6,3,3
Мортлайт,soulflayer,288,paladin,retribution,6,3,3
Ertheus,argent-dawn,288,paladin,retribution,6,3,3
Auditõr,argent-dawn,288,paladin,retribution,6,3,3
Holyshêêt,draenor,288,paladin,retribution,6,3,3
Yaldly,dun-modr,288,paladin,retribution,6,3,3
Asgardietis,kazzak,288,paladin,retribution,6,3,3
Cursedd,sanguino,288,paladin,retribution,6,3,3
Hydrolic,blackrock,288,paladin,retribution,6,3,3
Bubblefett,ysera,288,paladin,retribution,6,3,3
Лайсен,gordunni,288,paladin,retribution,6,3,3
Tyranius,bronzebeard,288,paladin,retribution,6,3,3
Yungboii,kazzak,288,paladin,retribution,6,3,3
Йосяфлексер,howling-fjord,288,paladin,retribution,6,3,3
Nalaea,arathor,288,paladin,retribution,6,3,3
Palapaye,archimonde,288,paladin,retribution,6,3,3
Lotheirid,antonidas,288,paladin,retribution,6,3,3
Маразоточка,howling-fjord,288,paladin,retribution,6,3,3
Зеппели,gordunni,288,paladin,retribution,6,3,3
Киэрсис,howling-fjord,288,paladin,retribution,6,3,3
Aoldur,ragnaros,288,paladin,retribution,6,3,3
Qpalax,outland,288,paladin,retribution,6,3,3
Steínsgate,ravencrest,288,paladin,retribution,6,3,3
Rhyvar,outland,288,paladin,retribution,6,3,3
Loscar,silvermoon,288,paladin,retribution,6,3,3
Lonesoul,tarren-mill,288,paladin,retribution,6,3,3
Véngeance,twilights-hammer,288,paladin,retribution,6,3,3
Feelmylight,tarren-mill,288,paladin,retribution,6,3,3
Bunurata,silvermoon,288,paladin,retribution,6,3,3
Lóde,silvermoon,288,paladin,retribution,6,3,3
Æthëlflæd,ravencrest,288,paladin,retribution,6,3,3
Partur,stormreaver,288,paladin,retribution,6,3,3
Akcope,thunderhorn,288,paladin,retribution,6,3,3
Strangerx,blackrock,288,paladin,retribution,6,3,3
Seekêr,tarren-mill,288,paladin,retribution,6,3,3
Nînaninja,silvermoon,288,paladin,retribution,6,3,3
Eyebluee,tarren-mill,288,paladin,retribution,6,3,3
Animegifx,ragnaros,288,paladin,retribution,6,3,3
Retroxy,stormreaver,288,paladin,retribution,6,3,3
Palior,sylvanas,288,paladin,retribution,6,3,3
Elesmerias,dalaran,288,paladin,retribution,6,3,3
Fabsy,frostwolf,288,paladin,retribution,6,3,3
Tyn,dragonmaw,288,paladin,retribution,6,3,3
Parlma,naxxramas,288,paladin,retribution,13,4,9
Wolluna,frostwolf,288,paladin,retribution,12,3,9
Холихит,gordunni,288,paladin,retribution,12,3,9
Dmascus,blackrock,288,paladin,retribution,12,3,9
Pascual,magtheridon,288,paladin,retribution,12,3,9
Масачусетсс,gordunni,288,paladin,retribution,12,3,9
Xiuya,dun-modr,288,paladin,retribution,12,3,9
Àræs,archimonde,288,paladin,retribution,12,3,9
Luridity,argent-dawn,288,paladin,retribution,12,3,9
Blecheîmer,aegwynn,288,paladin,retribution,12,3,9
Найдэкер,gordunni,288,paladin,retribution,12,3,9
Lylennâ,argent-dawn,288,paladin,retribution,12,3,9
Whórainzóne,eredar,288,paladin,retribution,12,3,9
Бунча,gordunni,288,paladin,retribution,12,3,9
Dathea,aegwynn,288,paladin,retribution,12,3,9
Эеомли,blackscar,288,paladin,retribution,12,3,9
Zerohour,kilrogg,288,paladin,retribution,12,3,9
Snibsxpala,silvermoon,288,paladin,retribution,12,3,9
Mâêdhrøsx,ravencrest,288,paladin,retribution,12,3,9
Anesthesiax,ravencrest,288,paladin,retribution,12,3,9
Daddysiliam,ravencrest,288,paladin,retribution,12,3,9
Bezúziusz,ragnaros,288,paladin,retribution,12,3,9
Mandingbull,stormscale,288,paladin,retribution,12,3,9
Trollpaladin,blackmoore,288,paladin,retribution,12,3,9
Simsaii,stormscale,288,paladin,retribution,12,3,9
Moriex,drakthul,288,paladin,retribution,12,3,9
Diccari,stormreaver,288,paladin,retribution,12,3,9
Kreselia,ravencrest,288,paladin,retribution,12,3,9
Dalaly,kazzak,288,paladin,retribution,12,3,9
Ашилолпро,soulflayer,288,paladin,retribution,12,3,9
Strätholme,drakthul,288,paladin,retribution,12,3,9
Arthàs,blackmoore,288,paladin,retribution,12,3,9
Ramhal,stormscale,288,paladin,retribution,12,3,9
Мува,soulflayer,288,paladin,retribution,14,3,11
Bafbaf,arathi,288,paladin,retribution,15,3,12
Cilise,bronzebeard,288,paladin,retribution,18,3,15
Johannx,tarren-mill,288,paladin,retribution,18,3,15
Ллосла,howling-fjord,288,paladin,retribution,18,3,15
Ulderoth,dun-modr,288,paladin,retribution,18,3,15
Lééroÿ,sylvanas,287,paladin,retribution,8,4,4
Choyoki,blackmoore,287,paladin,retribution,7,3,4
Juliea,aegwynn,287,paladin,retribution,18,5,13
Trevorion,argent-dawn,287,paladin,retribution,12,3,9
Bore,culte-de-la-rive-noire,287,paladin,retribution,12,3,9
Rsanchez,frostwolf,286,paladin,retribution,6,3,3
Рбгхил,howling-fjord,271,paladin,retribution,11,3,8
Tofrus,kazzak,271,paladin,retribution,11,3,8
Pooncy,ragnaros,239,paladin,retribution,5,3,2
Loire,blackmoore,239,paladin,retribution,5,3,2
Erannor,kirin-tor,239,paladin,retribution,5,3,2
Pak,amanthul,239,paladin,retribution,9,4,5
Dørvâp,culte-de-la-rive-noire,234,paladin,retribution,11,4,7
Lawtõn,argent-dawn,223,paladin,retribution,6,4,2
Альмор,blackscar,223,paladin,retribution,8,3,5
Aimee,draenor,192,paladin,retribution,4,3,1
Mysticlight,sylvanas,192,paladin,retribution,12,5,7
Kökslaktarn,sylvanas,192,paladin,retribution,9,3,6
Холигор,deathguard,192,paladin,retribution,6,2,4
Antimov,twisting-nether,192,paladin,retribution,6,2,4
Valzyffs,twisting-nether,192,paladin,retribution,6,2,4
Sletlana,burning-blade,192,paladin,retribution,6,2,4
Yømø,antonidas,192,paladin,retribution,6,2,4
Turbopal,burning-blade,192,paladin,retribution,6,2,4
Бордюрчег,howling-fjord,192,paladin,retribution,6,2,4
Shufflee,drakthul,192,paladin,retribution,6,2,4
Caribbean,outland,192,paladin,retribution,6,2,4
Пепескарлет,howling-fjord,192,paladin,retribution,6,2,4
Némesis,frostmane,192,paladin,retribution,6,2,4
Lindrone,aggra-português,192,paladin,retribution,6,2,4
Holyape,argent-dawn,192,paladin,retribution,6,2,4
Huevo,frostmane,192,paladin,retribution,6,2,4
Dalemiar,ravencrest,192,paladin,retribution,6,2,4
Rettalius,ravencrest,192,paladin,retribution,6,2,4
Dàk,grim-batol,192,paladin,retribution,6,2,4
Aguerx,alleria,192,paladin,retribution,6,2,4
Galenhad,kazzak,192,paladin,retribution,6,2,4
Dollicia,outland,192,paladin,retribution,6,2,4
Jimrogier,argent-dawn,192,paladin,retribution,6,2,4
Lorex,grim-batol,192,paladin,retribution,6,2,4
Donfilippo,burning-legion,192,paladin,retribution,6,2,4
Valanyr,kazzak,192,paladin,retribution,6,2,4
Ultrabenzo,ravencrest,192,paladin,retribution,6,2,4
Refléx,zirkel-des-cenarius,192,paladin,retribution,6,2,4
Mírato,blackhand,192,paladin,retribution,6,2,4
Powerphally,outland,192,paladin,retribution,6,2,4
Drident,die-nachtwache,192,paladin,retribution,6,2,4
Alto,nordrassil,192,paladin,retribution,6,2,4
Bálerion,bronze-dragonflight,192,paladin,retribution,6,2,4
Hargreeve,ravencrest,192,paladin,retribution,6,2,4
Víii,outland,192,paladin,retribution,6,2,4
Hännó,malganis,192,paladin,retribution,6,2,4
Zbykmasta,burning-legion,192,paladin,retribution,6,2,4
Maxunius,antonidas,192,paladin,retribution,6,2,4
Aistor,burning-legion,192,paladin,retribution,6,2,4
Strøb,antonidas,192,paladin,retribution,6,2,4
Paxillustral,twisting-nether,192,paladin,retribution,6,2,4
Freyjä,turalyon,192,paladin,retribution,6,2,4
Vircy,outland,192,paladin,retribution,6,2,4
Pyronort,eredar,192,paladin,retribution,6,2,4
Starr,confrérie-du-thorium,192,paladin,retribution,6,2,4
Juozas,argent-dawn,192,paladin,retribution,6,2,4
Боевикс,ashenvale,192,paladin,retribution,6,2,4
Zuldekk,sanguino,192,paladin,retribution,6,2,4
Daviaa,silvermoon,192,paladin,retribution,6,2,4
Ashariah,die-aldor,192,paladin,retribution,6,2,4
Ainnamash,twisting-nether,192,paladin,retribution,6,2,4
Galaerøn,elune,192,paladin,retribution,6,2,4
Rdypaladin,ravencrest,192,paladin,retribution,6,2,4
Instaquez,stormscale,192,paladin,retribution,6,2,4
Denlow,silvermoon,192,paladin,retribution,6,2,4
Slymm,archimonde,192,paladin,retribution,6,2,4
Jâybee,ravencrest,192,paladin,retribution,6,2,4
Антитеррор,greymane,192,paladin,retribution,6,2,4
Brictom,tarren-mill,192,paladin,retribution,6,2,4
Riares,darkspear,192,paladin,retribution,6,2,4
Raceper,the-maelstrom,192,paladin,retribution,6,2,4
Flashhèart,draenor,192,paladin,retribution,6,2,4
Ijego,silvermoon,192,paladin,retribution,6,2,4
Jkøø,sanguino,192,paladin,retribution,6,2,4
Fortination,dalaran,192,paladin,retribution,6,2,4
Freeloliipop,darksorrow,192,paladin,retribution,6,2,4
Tosá,antonidas,192,paladin,retribution,6,2,4
Samious,draenor,192,paladin,retribution,6,2,4
Stinkytoes,draenor,192,paladin,retribution,6,2,4
Humphry,vashj,192,paladin,retribution,6,2,4
Mathrixo,silvermoon,192,paladin,retribution,6,2,4
Рамзеса,soulflayer,192,paladin,retribution,6,2,4
Støøk,shendralar,192,paladin,retribution,6,2,4
Trainwréck,ravencrest,192,paladin,retribution,6,2,4
Vaalé,aegwynn,192,paladin,retribution,6,2,4
Lättäkamerus,ravencrest,192,paladin,retribution,6,2,4
Yumhi,dun-modr,192,paladin,retribution,6,2,4
Takezop,dun-modr,192,paladin,retribution,6,2,4
Скруддж,howling-fjord,192,paladin,retribution,6,2,4
Drasir,nemesis,192,paladin,retribution,6,2,4
Олегсудья,howling-fjord,192,paladin,retribution,6,2,4
Panomecon,magtheridon,192,paladin,retribution,6,2,4
Fannypoo,sylvanas,192,paladin,retribution,6,2,4
Tinyandy,blackrock,192,paladin,retribution,6,2,4
Ghéttørèt,das-konsortium,192,paladin,retribution,6,2,4
Aelaris,dunemaul,192,paladin,retribution,6,2,4
Noxy,thrall,192,paladin,retribution,6,2,4
Deresos,anetheron,192,paladin,retribution,6,2,4
Bozznamaan,thrall,192,paladin,retribution,6,2,4
Meruem,blackrock,192,paladin,retribution,6,2,4
Alus,blackmoore,192,paladin,retribution,6,2,4
Blazeê,blackrock,192,paladin,retribution,6,2,4
Blurengo,blackrock,192,paladin,retribution,6,2,4
Oldsurehand,blackmoore,192,paladin,retribution,6,2,4
Razarus,sylvanas,192,paladin,retribution,6,2,4
Smilé,sylvanas,192,paladin,retribution,6,2,4
Хексали,soulflayer,192,paladin,retribution,6,2,4
Сасмен,blackscar,192,paladin,retribution,6,2,4
Djstompyasis,blackmoore,192,paladin,retribution,6,2,4
Leroya,blackrock,192,paladin,retribution,6,2,4
Apolytos,laughing-skull,192,paladin,retribution,6,2,4
Лимфома,goldrinn,192,paladin,retribution,12,2,10
Mariuhûna,blackmoore,192,paladin,retribution,12,2,10
Babarush,nozdormu,192,paladin,retribution,12,2,10
Cunix,draenor,192,paladin,retribution,12,2,10
Rhyua,eredar,192,paladin,retribution,12,2,10
Holysiah,kazzak,192,paladin,retribution,12,2,10
Tjabo,burning-blade,192,paladin,retribution,12,2,10
Мунрейм,gordunni,192,paladin,retribution,12,2,10
Rîex,alleria,192,paladin,retribution,12,2,10
Skemfar,sanguino,192,paladin,retribution,12,2,10
Galaadh,archimonde,192,paladin,retribution,12,2,10
Nevermoore,doomhammer,192,paladin,retribution,12,2,10
Pârâsite,hyjal,192,paladin,retribution,12,2,10
Remedios,archimonde,192,paladin,retribution,12,2,10
Imaturtle,darksorrow,192,paladin,retribution,12,2,10
Eniste,silvermoon,192,paladin,retribution,12,2,10
Leriell,ravencrest,192,paladin,retribution,12,2,10
Verix,thrall,192,paladin,retribution,12,2,10
Белкоксю,booty-bay,192,paladin,retribution,12,2,10
Cyxanacma,silvermoon,192,paladin,retribution,18,2,16
Yeohinyiu,khaz-modan,191,paladin,retribution,6,2,4
Duckula,ravenholdt,191,paladin,retribution,6,2,4
Ârthâstrâs,terrordar,191,paladin,retribution,6,2,4
Guckzu,malganis,191,paladin,retribution,6,2,4
Broziopath,blackrock,191,paladin,retribution,6,2,4
Derbrècher,azshara,191,paladin,retribution,6,2,4
Bellight,sinstralis,191,paladin,retribution,13,2,11
Thelronis,kelthuzad,175,paladin,retribution,11,2,9
Geronimooh,vashj,159,paladin,retribution,5,2,3
Trístesse,tarren-mill,159,paladin,retribution,5,2,3
Heiemdall,azuremyst,159,paladin,retribution,5,2,3
Джибути,soulflayer,159,paladin,retribution,14,3,11
Монбиин,soulflayer,138,paladin,retribution,6,3,3
Braiinafk,thrall,138,paladin,retribution,6,3,3
Скелфер,soulflayer,138,paladin,retribution,8,3,5
Jesamine,blackmoore,138,paladin,retribution,9,3,6
Danneris,sanguino,137,paladin,retribution,7,3,4
Paillasson,nerzhul,128,paladin,retribution,4,2,2
Qpax,twisting-nether,128,paladin,retribution,4,2,2
Melvòó,blackrock,96,paladin,retribution,3,2,1
Aalyaah,zirkel-des-cenarius,96,paladin,retribution,3,2,1
Kelianna,drakthul,96,paladin,retribution,3,2,1
Маефис,gordunni,96,paladin,retribution,3,2,1
Zvirblis,chamber-of-aspects,96,paladin,retribution,3,2,1
Zlätän,outland,96,paladin,retribution,6,1,5
Ragie,twisting-nether,96,paladin,retribution,6,1,5
Thaderyl,auchindoun,96,paladin,retribution,6,1,5
Bigdamjudgee,outland,96,paladin,retribution,6,1,5
Hølyshøckz,blackmoore,96,paladin,retribution,6,1,5
Tozzey,defias-brotherhood,96,paladin,retribution,6,1,5
Ahreesh,blackrock,96,paladin,retribution,6,1,5
Aggressìon,twisting-nether,96,paladin,retribution,6,1,5
Atacan,twisting-nether,96,paladin,retribution,6,1,5
Dänie,silvermoon,96,paladin,retribution,6,1,5
Reinwaltz,the-maelstrom,96,paladin,retribution,6,1,5
Pianiste,sinstralis,96,paladin,retribution,6,1,5
Akrobatka,sanguino,96,paladin,retribution,6,1,5
Vokesh,silvermoon,96,paladin,retribution,6,1,5
Tj,sanguino,96,paladin,retribution,6,1,5
Highlòrd,silvermoon,96,paladin,retribution,6,1,5
Veshnu,blackrock,96,paladin,retribution,6,1,5
Friemelaar,silvermoon,96,paladin,retribution,6,1,5
Аладушок,gordunni,96,paladin,retribution,6,1,5
Holyhannes,blackmoore,96,paladin,retribution,6,1,5
Shuukz,blackmoore,96,paladin,retribution,6,1,5
Hyggë,sanguino,96,paladin,retribution,6,1,5
Jûliâ,archimonde,96,paladin,retribution,6,1,5
Kaelorian,silvermoon,96,paladin,retribution,6,1,5
Flashyo,archimonde,96,paladin,retribution,6,1,5
Phalex,outland,96,paladin,retribution,6,1,5
Hammexõr,sylvanas,96,paladin,retribution,6,1,5
Zarrex,blackrock,96,paladin,retribution,6,1,5
Stabilisator,blackrock,96,paladin,retribution,6,1,5
Zandathor,chamber-of-aspects,96,paladin,retribution,6,1,5
Steelrose,auchindoun,96,paladin,retribution,6,1,5
Retrystyle,ragnaros,96,paladin,retribution,6,1,5
Aion,chamber-of-aspects,96,paladin,retribution,6,1,5
Saedrick,nemesis,96,paladin,retribution,6,1,5
Baxteria,dun-modr,96,paladin,retribution,6,1,5
Тамплиир,gordunni,96,paladin,retribution,6,1,5
Crawini,ragnaros,96,paladin,retribution,6,1,5
Fatalism,draenor,96,paladin,retribution,6,1,5
Светиздырки,howling-fjord,96,paladin,retribution,6,1,5
Dananas,draenor,96,paladin,retribution,6,1,5
Diggs,draenor,96,paladin,retribution,6,1,5
Lolladin,blackmoore,96,paladin,retribution,6,1,5
Мэркес,fordragon,96,paladin,retribution,6,1,5
Ironstealman,shattered-hand,96,paladin,retribution,6,1,5
Эльтарус,soulflayer,96,paladin,retribution,6,1,5
Pikoman,hellfire,96,paladin,retribution,6,1,5
Винзерг,ashenvale,96,paladin,retribution,6,1,5
Dufftroll,kazzak,96,paladin,retribution,6,1,5
Blazix,kazzak,96,paladin,retribution,6,1,5
Pliscken,kazzak,96,paladin,retribution,6,1,5
Nijówka,burning-legion,96,paladin,retribution,6,1,5
Miawyn,blackmoore,96,paladin,retribution,6,1,5
Holyloa,laughing-skull,96,paladin,retribution,6,1,5
Skarium,hyjal,96,paladin,retribution,6,1,5
Моррзито,soulflayer,96,paladin,retribution,6,1,5
Жмышенко,gordunni,96,paladin,retribution,6,1,5
Rataxes,stormreaver,96,paladin,retribution,6,1,5
Vorsip,tarren-mill,96,paladin,retribution,6,1,5
Monmo,emerald-dream,96,paladin,retribution,6,1,5
Serberen,ravencrest,96,paladin,retribution,6,1,5
Анофарин,gordunni,96,paladin,retribution,6,1,5
Lagrops,chants-éternels,96,paladin,retribution,6,1,5
Graphpora,argent-dawn,96,paladin,retribution,6,1,5
Taraniah,argent-dawn,96,paladin,retribution,6,1,5
Traxxces,ravencrest,96,paladin,retribution,6,1,5
Пилоттыч,gordunni,96,paladin,retribution,6,1,5
Akagami,ysondre,96,paladin,retribution,6,1,5
Shanilia,argent-dawn,96,paladin,retribution,6,1,5
Lowfi,argent-dawn,96,paladin,retribution,6,1,5
Kírin,drakthul,96,paladin,retribution,6,1,5
Destya,eredar,96,paladin,retribution,6,1,5
Bázer,antonidas,96,paladin,retribution,6,1,5
Valiscar,antonidas,96,paladin,retribution,6,1,5
Gwynel,argent-dawn,96,paladin,retribution,6,1,5
Хилтонепта,gordunni,96,paladin,retribution,6,1,5
Palamaister,stormscale,96,paladin,retribution,6,1,5
Bürd,rajaxx,96,paladin,retribution,6,1,5
Sâfcon,eredar,96,paladin,retribution,6,1,5
Bigfatpig,ravencrest,96,paladin,retribution,6,1,5
Nîcolascage,stormscale,96,paladin,retribution,6,1,5
Fleckige,nethersturm,96,paladin,retribution,6,1,5
Quaterbâck,antonidas,96,paladin,retribution,6,1,5
Quarrel,kul-tiras,96,paladin,retribution,6,1,5
Zethhx,stormscale,96,paladin,retribution,6,1,5
Évo,drakthul,96,paladin,retribution,6,1,5
Kefalas,ravencrest,96,paladin,retribution,6,1,5
Línke,sanguino,96,paladin,retribution,7,1,6
Ратомир,howling-fjord,96,paladin,retribution,8,1,7
Cianna,shattered-hand,96,paladin,retribution,10,1,9
Gazïel,kaelthas,96,paladin,retribution,12,1,11
Vengryn,turalyon,96,paladin,retribution,12,1,11
Fenik,dun-modr,96,paladin,retribution,12,1,11
Nauy,korgall,96,paladin,retribution,12,1,11
Snakedubaby,blackrock,96,paladin,retribution,12,1,11
Combinecka,chamber-of-aspects,96,paladin,retribution,12,1,11
Медверус,gordunni,96,paladin,retribution,12,1,11
Dragonous,darkmoon-faire,96,paladin,retribution,20,1,19
Charlybrown,archimonde,95,paladin,retribution,6,1,5
Rhauk,dun-modr,79,paladin,retribution,5,1,4
Vabz,blackrock,79,paladin,retribution,5,1,4
Pastaflwras,twisting-nether,64,paladin,retribution,4,1,3
Perfectum,burning-legion,64,paladin,retribution,4,1,3
Emakk,darksorrow,63,paladin,retribution,2,2,0
Lafrogge,culte-de-la-rive-noire,48,paladin,retribution,3,1,2
Rulîx,blackmoore,42,paladin,retribution,15,2,13
Кранштейн,gordunni,31,paladin,retribution,2,1,1
Runkpaladin,kazzak,31,paladin,retribution,2,1,1
Irondawg,rajaxx,31,paladin,retribution,8,1,7
Davidas,drakthul,16,paladin,retribution,1,1,0
Qïkarï,antonidas,16,paladin,retribution,1,1,0
Arbuzno,draenor,1936,paladin,protection,54,38,16
Leotheron,boulderfist,1763,paladin,protection,156,104,52
Collinnawin,aegwynn,1741,paladin,protection,72,36,36
Maximumtaste,ravencrest,1662,paladin,protection,30,22,8
Sterben,aegwynn,1625,paladin,protection,48,20,28
Elitest,hyjal,1481,paladin,protection,124,31,93
Trufetteuh,hyjal,1449,paladin,protection,60,42,18
Haringoth,argent-dawn,1448,paladin,protection,42,21,21
Ichbin,sanguino,1298,paladin,protection,53,22,31
Velkar,frostmane,1284,paladin,protection,46,23,23
Lóu,hyjal,1224,paladin,protection,29,14,15
Sonnywalkman,twisting-nether,1055,paladin,protection,12,11,1
Justífiéd,kazzak,1055,paladin,protection,24,11,13
Fumbz,alakir,767,paladin,protection,12,8,4
Проц,soulflayer,766,paladin,protection,12,8,4
Kraljevic,silvermoon,672,paladin,protection,12,7,5
Ванябублгам,soulflayer,672,paladin,protection,18,7,11
Lägolas,thrall,511,paladin,protection,11,6,5
Supremerage,silvermoon,480,paladin,protection,12,5,7
Tíríón,nethersturm,479,paladin,protection,12,5,7
Galevar,argent-dawn,384,paladin,protection,6,4,2
Marihuána,ragnaros,384,paladin,protection,12,4,8
Xrules,blackhand,382,paladin,protection,12,4,8
Elkka,azjolnerub,319,paladin,protection,5,4,1
Figustyle,archimonde,318,paladin,protection,10,4,6
Statscowski,thrall,288,paladin,protection,6,3,3
Swäagg,hyjal,288,paladin,protection,6,3,3
Æero,blackhand,288,paladin,protection,6,3,3
Снайпик,azuregos,288,paladin,protection,6,3,3
Zuplex,deathwing,288,paladin,protection,6,3,3
Ðizzmo,bloodfeather,288,paladin,protection,12,3,9
Yourmomz,kazzak,239,paladin,protection,5,3,2
Derina,silvermoon,192,paladin,protection,6,2,4
Lotheriem,argent-dawn,192,paladin,protection,6,2,4
Helladin,haomarush,192,paladin,protection,6,2,4
Синерина,blackscar,192,paladin,protection,6,2,4
Quantox,frostwolf,192,paladin,protection,12,2,10
Exion,ravenholdt,159,paladin,protection,5,2,3
Flakkson,stormscale,96,paladin,protection,12,1,11
Bobilous,twisting-nether,79,paladin,protection,5,1,4
Tippressure,ravencrest,64,paladin,protection,4,1,3
Candrä,archimonde,2115,priest,holy,84,43,41
Yötönyö,ravencrest,2043,priest,holy,60,32,28
Lenyp,sanguino,1900,priest,holy,78,41,37
Ladá,stormscale,1873,priest,holy,108,55,53
Výra,der-rat-von-dalaran,1864,priest,holy,47,30,17
Кальвейт,deathweaver,1863,priest,holy,45,24,21
Лоаресс,gordunni,1850,priest,holy,48,25,23
Weezing,ysondre,1849,priest,holy,72,36,36
Dmnz,blackrock,1840,priest,holy,75,34,41
Yateh,blackmoore,1824,priest,holy,62,32,30
Катккат,soulflayer,1823,priest,holy,48,27,21
Sayne,arathor,1815,priest,holy,168,91,77
Maruh,malganis,1812,priest,holy,113,60,53
Eriónd,ravencrest,1811,priest,holy,66,34,32
Muchos,blackrock,1807,priest,holy,66,31,35
Køzukï,ravencrest,1805,priest,holy,66,28,38
Гоплзнекст,gordunni,1749,priest,holy,138,75,63
Psi,hakkar,1725,priest,holy,127,76,51
Kunen,sanguino,1701,priest,holy,42,27,15
Wåtrux,alakir,1701,priest,holy,106,59,47
Smïlë,ravencrest,1688,priest,holy,143,73,70
Gladíator,blackhand,1677,priest,holy,102,58,44
Phobò,blackrock,1676,priest,holy,66,30,36
Kÿokó,ravencrest,1670,priest,holy,72,40,32
Shanya,thrall,1660,priest,holy,177,92,85
Tangent,ravencrest,1637,priest,holy,36,18,18
Jim,saurfang,1635,priest,holy,192,92,100
Друмги,gordunni,1635,priest,holy,54,19,35
Møhammed,wrathbringer,1633,priest,holy,96,48,48
Stinkydog,kazzak,1633,priest,holy,65,30,35
Calithria,kazzak,1631,priest,holy,95,53,42
Dény,ravencrest,1621,priest,holy,60,36,24
Alchemïst,ravencrest,1617,priest,holy,46,21,25
Affro,drakthul,1613,priest,holy,54,27,27
Нубстрим,gordunni,1611,priest,holy,60,28,32
Kaalu,frostmane,1611,priest,holy,116,53,63
Sïxsïxsïx,ravencrest,1608,priest,holy,37,18,19
Ilenna,dun-morogh,1607,priest,holy,42,25,17
Zxø,ravencrest,1601,priest,holy,160,88,72
Alpháømegá,outland,1591,priest,holy,56,26,30
Sehlia,kazzak,1563,priest,holy,38,21,17
Dolens,argent-dawn,1563,priest,holy,36,18,18
Wilby,archimonde,1547,priest,holy,36,18,18
Gnomemonk,stormscale,1533,priest,holy,120,55,65
Шотыказау,blackscar,1530,priest,holy,24,16,8
Beatrixz,twisting-nether,1523,priest,holy,43,19,24
Заволончик,blackscar,1518,priest,holy,90,43,47
Divinetouch,ravencrest,1516,priest,holy,78,35,43
Dokkaebì,kazzak,1514,priest,holy,135,67,68
Joeasaurs,ragnaros,1510,priest,holy,60,24,36
Løøney,kazzak,1504,priest,holy,24,16,8
Rines,thrall,1493,priest,holy,89,43,46
Bifs,blackmoore,1482,priest,holy,30,19,11
Suxino,stormscale,1468,priest,holy,54,30,24
Markianos,silvermoon,1464,priest,holy,102,54,48
Symbolofhope,ravencrest,1460,priest,holy,117,62,55
Atiyesh,arthas,1448,priest,holy,111,61,50
Maah,defias-brotherhood,1444,priest,holy,74,42,32
Siign,ravencrest,1433,priest,holy,30,15,15
Fizzlesp,tarren-mill,1425,priest,holy,30,15,15
Phénylanine,khaz-modan,1420,priest,holy,51,27,24
Инзора,gordunni,1400,priest,holy,30,15,15
Orcid,chogall,1399,priest,holy,36,22,14
Lasuora,nemesis,1380,priest,holy,42,20,22
Madcole,blackhand,1371,priest,holy,85,43,42
Kbakå,kazzak,1353,priest,holy,54,24,30
Alros,elune,1346,priest,holy,54,26,28
Carlitastock,eredar,1343,priest,holy,24,14,10
Мамкалол,soulflayer,1341,priest,holy,24,14,10
Cosines,ravencrest,1341,priest,holy,30,14,16
Seladine,ravencrest,1314,priest,holy,74,37,37
Certe,twisting-nether,1302,priest,holy,60,26,34
Catstretch,ravencrest,1300,priest,holy,89,38,51
Zakhun,stormrage,1290,priest,holy,70,37,33
Asare,outland,1286,priest,holy,60,35,25
Tëmärï,ravencrest,1280,priest,holy,36,25,11
Gloxina,argent-dawn,1271,priest,holy,60,30,30
Virginmaris,sanguino,1270,priest,holy,36,19,17
Ethery,argent-dawn,1266,priest,holy,65,33,32
Hydraximus,garrosh,1263,priest,holy,244,114,130
Åluneth,kazzak,1258,priest,holy,51,23,28
Delphina,archimonde,1254,priest,holy,41,20,21
Zên,argent-dawn,1248,priest,holy,21,14,7
Eox,kazzak,1239,priest,holy,24,13,11
Kbakå,stormscale,1237,priest,holy,53,23,30
Nykah,antonidas,1224,priest,holy,55,19,36
Morrydin,stormreaver,1217,priest,holy,48,18,30
Neenä,ravencrest,1214,priest,holy,50,25,25
Dathlight,argent-dawn,1201,priest,holy,53,31,22
Скартэикс,howling-fjord,1200,priest,holy,42,20,22
Torcena,garrosh,1175,priest,holy,71,36,35
Xzklolz,twisting-nether,1161,priest,holy,23,13,10
Kaiikoo,ravencrest,1152,priest,holy,18,12,6
Evabae,the-maelstrom,1149,priest,holy,18,12,6
Meanbabe,argent-dawn,1149,priest,holy,24,12,12
Преттисмайл,gordunni,1149,priest,holy,30,12,18
Dúréx,sanguino,1147,priest,holy,24,18,6
Alizeé,nazjatar,1131,priest,holy,24,12,12
Alloktonos,ravencrest,1092,priest,holy,73,26,47
Kæos,blackrock,1091,priest,holy,64,28,36
Anàriel,elune,1070,priest,holy,36,13,23
Grafius,stormscale,1056,priest,holy,18,11,7
Covidios,twisting-nether,1056,priest,holy,42,21,21
Zen,talnivarr,1056,priest,holy,24,11,13
Рейеан,soulflayer,1054,priest,holy,24,11,13
Uro,tirion,1053,priest,holy,30,11,19
Pigdestroyin,frostmane,1052,priest,holy,24,11,13
Koíré,defias-brotherhood,1048,priest,holy,24,11,13
Тевтонка,goldrinn,1041,priest,holy,42,18,24
Türapea,draenor,1033,priest,holy,18,12,6
Laewen,die-aldor,1032,priest,holy,27,13,14
Ankhepope,outland,1013,priest,holy,56,33,23
Orcü,tarren-mill,1011,priest,holy,36,15,21
Deeforce,argent-dawn,996,priest,holy,73,39,34
Copperplume,ravenholdt,986,priest,holy,36,11,25
Rägà,archimonde,980,priest,holy,20,11,9
Valtessian,medivh,961,priest,holy,57,27,30
Leadeur,kazzak,960,priest,holy,12,10,2
Dranbor,argent-dawn,959,priest,holy,18,10,8
Soapie,defias-brotherhood,951,priest,holy,18,10,8
Archangel,terokkar,942,priest,holy,42,22,20
Kanki,haomarush,925,priest,holy,42,19,23
Eurydike,blackrock,887,priest,holy,16,10,6
Melancholly,thunderhorn,886,priest,holy,17,10,7
Rhæveth,ravencrest,864,priest,holy,18,9,9
Âlolexx,archimonde,863,priest,holy,12,9,3
Ankî,aegwynn,863,priest,holy,18,9,9
Hoeneygodx,antonidas,863,priest,holy,18,9,9
Highn,anetheron,863,priest,holy,18,9,9
Andreel,ravencrest,860,priest,holy,18,9,9
Ломаюключики,gordunni,849,priest,holy,18,9,9
Libetha,ysondre,797,priest,holy,11,9,2
Rahela,dun-modr,793,priest,holy,17,9,8
Evílz,tarren-mill,768,priest,holy,12,8,4
Ÿolo,nemesis,768,priest,holy,18,8,10
Fjonnski,blackmoore,767,priest,holy,12,8,4
Sak,uldaman,767,priest,holy,18,8,10
Mylini,silvermoon,765,priest,holy,12,8,4
Mcmuffin,runetotem,761,priest,holy,12,8,4
Sickheals,doomhammer,755,priest,holy,12,8,4
Moirgana,minahonda,718,priest,holy,17,8,9
Dazé,ravencrest,713,priest,holy,17,9,8
Mélínâ,blackmoore,691,priest,holy,28,9,19
Iliridan,pozzo-delleternità,673,priest,holy,30,8,22
Boomixed,twisting-nether,672,priest,holy,12,7,5
Hiimgreen,blackhand,672,priest,holy,12,7,5
Гшд,gordunni,672,priest,holy,12,7,5
Darkoul,conseil-des-ombres,672,priest,holy,12,7,5
Malkàv,hyjal,672,priest,holy,12,7,5
Willzah,outland,672,priest,holy,12,7,5
Alphacub,ragnaros,672,priest,holy,18,7,11
Penvon,ravencrest,672,priest,holy,24,7,17
Gintøníc,blackmoore,671,priest,holy,12,7,5
Yuhé,elune,671,priest,holy,12,7,5
Penitence,drekthar,671,priest,holy,18,7,11
Omnissiiah,silvermoon,670,priest,holy,18,7,11
Sücre,dalaran,668,priest,holy,12,7,5
Zinary,silvermoon,667,priest,holy,18,7,11
Sâtânica,kelthuzad,610,priest,holy,27,8,19
Blâdes,gorgonnash,589,priest,holy,17,7,10
Zoophobîa,stormscale,576,priest,holy,12,6,6
Boonlai,ravencrest,576,priest,holy,12,6,6
Englishheart,auchindoun,576,priest,holy,12,6,6
Testdeath,ravencrest,576,priest,holy,12,6,6
Câlyr,ragnaros,576,priest,holy,12,6,6
Найтингеилл,gordunni,576,priest,holy,12,6,6
Yamai,thrall,576,priest,holy,12,6,6
Darkoul,ravencrest,576,priest,holy,12,6,6
Migam,kazzak,576,priest,holy,12,6,6
Nancey,draenor,576,priest,holy,12,6,6
Nou,aegwynn,576,priest,holy,12,6,6
Hara,elune,576,priest,holy,18,6,12
Мотд,gordunni,576,priest,holy,18,6,12
Rennic,stormscale,575,priest,holy,12,6,6
Brigied,turalyon,575,priest,holy,12,6,6
Sodatsu,cthun,575,priest,holy,12,6,6
Tyrhaa,blackmoore,575,priest,holy,18,6,12
Morphuz,tarren-mill,573,priest,holy,18,6,12
Leyea,kazzak,571,priest,holy,18,6,12
Spàgno,nemesis,571,priest,holy,18,6,12
Priestxx,twilights-hammer,543,priest,holy,11,6,5
Scartay,outland,543,priest,holy,11,6,5
Ezechiel,twisting-nether,542,priest,holy,11,6,5
Secundis,silvermoon,480,priest,holy,6,5,1
Jaisuu,ravencrest,480,priest,holy,6,5,1
Mcdeady,tarren-mill,480,priest,holy,12,5,7
Mazeari,sylvanas,480,priest,holy,12,5,7
Sisko,stormscale,480,priest,holy,12,5,7
Quiwzx,blackrock,480,priest,holy,12,5,7
Servêy,twisting-nether,480,priest,holy,12,5,7
Jaz,ysondre,480,priest,holy,12,5,7
Misscure,draenor,480,priest,holy,18,5,13
Árcadoom,quelthalas,479,priest,holy,12,5,7
Kímbérléy,argent-dawn,476,priest,holy,12,5,7
Hipnotika,nemesis,447,priest,holy,11,5,6
Byzzi,draenor,384,priest,holy,6,4,2
Tyene,voljin,384,priest,holy,6,4,2
Nálá,nethersturm,384,priest,holy,6,4,2
Veurjin,uldaman,384,priest,holy,6,4,2
Arithon,blackrock,384,priest,holy,6,4,2
Skíps,sylvanas,384,priest,holy,6,4,2
Gertie,blackhand,384,priest,holy,12,4,8
Flurri,tarren-mill,384,priest,holy,12,4,8
Sayash,chamber-of-aspects,384,priest,holy,12,4,8
Zarez,stormscale,384,priest,holy,12,4,8
Disillusíon,tarren-mill,384,priest,holy,12,4,8
Ksn,argent-dawn,384,priest,holy,12,4,8
Badguymike,ragnaros,384,priest,holy,12,4,8
Skytheory,eredar,384,priest,holy,13,4,9
Ðlcz,blackrock,384,priest,holy,18,4,14
Ømegagødx,outland,384,priest,holy,18,4,14
Sîanah,archimonde,383,priest,holy,12,4,8
Valentinus,dragonmaw,352,priest,holy,16,4,12
Shyvi,ravencrest,319,priest,holy,5,4,1
Holydolly,doomhammer,288,priest,holy,6,3,3
Holyheartx,argent-dawn,288,priest,holy,6,3,3
Hilerki,draenor,288,priest,holy,6,3,3
Arabpriest,draenor,288,priest,holy,6,3,3
Ariyia,argent-dawn,288,priest,holy,6,3,3
ßestworld,draenor,288,priest,holy,6,3,3
Missdemerè,nemesis,288,priest,holy,6,3,3
Sohryø,drekthar,288,priest,holy,6,3,3
Ahilarry,tarren-mill,288,priest,holy,6,3,3
Nerfnerf,kazzak,288,priest,holy,6,3,3
Shmoly,stormscale,288,priest,holy,6,3,3
Blackwidow,chromaggus,288,priest,holy,6,3,3
Миррен,gordunni,288,priest,holy,6,3,3
Drminduskâ,ysondre,288,priest,holy,6,3,3
Bobitä,ravencrest,288,priest,holy,6,3,3
Jeboc,ravencrest,288,priest,holy,6,3,3
Bambus,shattered-hand,288,priest,holy,6,3,3
Avelynn,ravencrest,288,priest,holy,6,3,3
Lurri,tarren-mill,288,priest,holy,12,3,9
Quami,dun-modr,288,priest,holy,12,3,9
Farae,arathor,288,priest,holy,18,3,15
Ripjuice,sylvanas,287,priest,holy,12,3,9
Burnex,thrall,192,priest,holy,6,2,4
Eyllise,ragnaros,192,priest,holy,6,2,4
Vitae,gorgonnash,192,priest,holy,6,2,4
Nathamo,archimonde,192,priest,holy,6,2,4
Dami,defias-brotherhood,192,priest,holy,6,2,4
Korzec,dun-modr,192,priest,holy,6,2,4
Возхд,soulflayer,192,priest,holy,6,2,4
Dangerfred,stormscale,192,priest,holy,6,2,4
Yukirito,drakthul,192,priest,holy,6,2,4
Discobrill,silvermoon,192,priest,holy,6,2,4
Haxxøn,die-nachtwache,192,priest,holy,6,2,4
Nýkah,antonidas,192,priest,holy,6,2,4
Krematorio,twisting-nether,192,priest,holy,6,2,4
Elmaestrø,aegwynn,192,priest,holy,6,2,4
Bamboleon,blackrock,192,priest,holy,6,2,4
Prästpojken,frostwhisper,192,priest,holy,6,2,4
Бранлор,howling-fjord,192,priest,holy,8,2,6
Bøij,pozzo-delleternità,192,priest,holy,8,2,6
Gød,magtheridon,192,priest,holy,18,2,16
Benificent,argent-dawn,159,priest,holy,5,2,3
Bubbleup,defias-brotherhood,96,priest,holy,6,1,5
Remkoja,blackrock,96,priest,holy,6,1,5
Systerstål,twisting-nether,96,priest,holy,6,1,5
Laadyybirkee,blackhand,96,priest,holy,6,1,5
Herwin,twisting-nether,96,priest,holy,6,1,5
Tÿona,hyjal,96,priest,holy,6,1,5
Salvatíon,sanguino,96,priest,holy,6,1,5
Сакредлайв,gordunni,96,priest,holy,6,1,5
Pattie,ragnaros,96,priest,holy,6,1,5
Felvytwo,stormscale,96,priest,holy,12,1,11
Kæzm,blackrock,96,priest,holy,12,1,11
Syntara,twisting-nether,96,priest,holy,12,1,11
Mswagner,outland,79,priest,holy,5,1,4
Darkyos,azshara,42,priest,holy,6,2,4
Èfflux,ravencrest,2172,priest,discipline,86,54,32
Bedfirez,ravencrest,2161,priest,discipline,211,122,89
Dripcheck,draenor,2159,priest,discipline,79,46,33
Holypoppa,ravencrest,2145,priest,discipline,115,64,51
Saentainen,kazzak,2133,priest,discipline,95,68,27
Cylizx,stormscale,2133,priest,discipline,114,62,52
Moonriver,archimonde,2132,priest,discipline,66,39,27
Artle,sanguino,2131,priest,discipline,83,44,39
Vanostsp,kazzak,2131,priest,discipline,90,45,45
Jayti,ravencrest,2106,priest,discipline,67,35,32
Rñd,ravencrest,2049,priest,discipline,60,29,31
Mentalboom,emerald-dream,2045,priest,discipline,77,40,37
Shmoly,stormscale,2022,priest,discipline,85,45,40
Гопикзашквар,blackscar,2017,priest,discipline,104,47,57
Salvinia,kelthuzad,1999,priest,discipline,90,48,42
Jidammy,ravencrest,1989,priest,discipline,66,32,34
Dpriesta,aegwynn,1979,priest,discipline,88,52,36
Acondisc,kazzak,1977,priest,discipline,76,43,33
Aeogon,kazzak,1972,priest,discipline,107,50,57
Ilumiinatrix,dun-modr,1971,priest,discipline,120,63,57
Lyrvanax,ravencrest,1971,priest,discipline,74,36,38
Djsüssi,frostwolf,1969,priest,discipline,84,37,47
Charlotten,shattered-hand,1963,priest,discipline,84,42,42
Хомяктьмы,gordunni,1955,priest,discipline,66,35,31
Sinetrax,tarren-mill,1953,priest,discipline,86,50,36
Trialight,ravencrest,1951,priest,discipline,59,39,20
Primayodbain,archimonde,1947,priest,discipline,58,33,25
Ekman,twisting-nether,1940,priest,discipline,72,38,34
Kekkons,sylvanas,1938,priest,discipline,65,34,31
Senga,kazzak,1937,priest,discipline,78,38,40
Vengefulmaze,ravencrest,1935,priest,discipline,54,28,26
Фанпау,soulflayer,1919,priest,discipline,72,34,38
Алинкалол,howling-fjord,1917,priest,discipline,117,73,44
Summerfinn,ravencrest,1911,priest,discipline,63,32,31
Neverdome,ravencrest,1903,priest,discipline,107,62,45
Azrpr,ravencrest,1902,priest,discipline,58,30,28
Kangaroogodx,ravencrest,1901,priest,discipline,78,35,43
Psyheea,stormscale,1898,priest,discipline,127,54,73
Разорлайтх,gordunni,1890,priest,discipline,29,21,8
Discishârd,ravencrest,1890,priest,discipline,87,45,42
Ronnyvandamm,destromath,1887,priest,discipline,88,58,30
Clapped,ravencrest,1887,priest,discipline,72,32,40
Klonyaryk,ravencrest,1885,priest,discipline,42,24,18
Porkhunt,stormscale,1883,priest,discipline,66,37,29
Mavisqt,draenor,1880,priest,discipline,42,24,18
Merylle,ragnaros,1880,priest,discipline,60,29,31
ßrb,sylvanas,1873,priest,discipline,90,55,35
Мамкалол,soulflayer,1873,priest,discipline,144,75,69
Saniqt,kazzak,1865,priest,discipline,57,35,22
Painchampion,draenor,1864,priest,discipline,54,23,31
Asyncx,ravencrest,1862,priest,discipline,68,35,33
Georgeshxx,ravencrest,1861,priest,discipline,66,34,32
Flao,ravencrest,1860,priest,discipline,52,28,24
Sublab,kazzak,1859,priest,discipline,60,33,27
Citadelle,blackmoore,1858,priest,discipline,59,36,23
Мефодийприст,howling-fjord,1858,priest,discipline,102,62,40
Wernou,archimonde,1858,priest,discipline,48,29,19
Norganp,die-aldor,1855,priest,discipline,30,20,10
Unfaithful,twisting-nether,1854,priest,discipline,70,43,27
Pheen,kazzak,1854,priest,discipline,66,34,32
Dieterdose,tarren-mill,1852,priest,discipline,44,29,15
Lloreen,ravencrest,1852,priest,discipline,42,25,17
Comedii,blackmoore,1850,priest,discipline,166,86,80
Underdogx,eredar,1849,priest,discipline,60,33,27
Rynnegan,zuljin,1849,priest,discipline,72,31,41
Çhåosgòddess,kazzak,1848,priest,discipline,42,25,17
Vajadisc,twisting-nether,1848,priest,discipline,72,28,44
Sláin,outland,1847,priest,discipline,48,27,21
Andrë,ragnaros,1845,priest,discipline,46,29,17
Jagardoden,stormscale,1845,priest,discipline,59,33,26
Хомячпочка,gordunni,1845,priest,discipline,48,25,23
Leahbtw,ravencrest,1844,priest,discipline,54,30,24
Asanti,die-aldor,1843,priest,discipline,48,30,18
Soyloverjuan,auchindoun,1843,priest,discipline,52,27,25
Bæsts,ravencrest,1842,priest,discipline,47,35,12
Minilove,ravencrest,1842,priest,discipline,36,22,14
Maxfly,archimonde,1841,priest,discipline,42,22,20
Chaxxpriest,blackrock,1841,priest,discipline,89,41,48
Mend,tarren-mill,1841,priest,discipline,77,34,43
Kàrèm,blutkessel,1839,priest,discipline,48,28,20
Thelïght,ravencrest,1839,priest,discipline,54,27,27
Sheelah,ravencrest,1838,priest,discipline,66,32,34
Nasdaq,ravencrest,1837,priest,discipline,60,30,30
Nevercared,aegwynn,1835,priest,discipline,30,25,5
Видзар,blackscar,1834,priest,discipline,42,27,15
Azaciúx,sylvanas,1832,priest,discipline,48,29,19
Dreifearfünf,arygos,1830,priest,discipline,62,39,23
Potatojuicer,argent-dawn,1829,priest,discipline,63,31,32
Mainputa,pozzo-delleternità,1829,priest,discipline,58,28,30
Akeno,sylvanas,1829,priest,discipline,70,31,39
Pradrak,eredar,1828,priest,discipline,54,31,23
Chivalryy,argent-dawn,1828,priest,discipline,119,64,55
Ltmp,ravencrest,1827,priest,discipline,48,24,24
Eliriya,thrall,1826,priest,discipline,96,48,48
Eau,quelthalas,1826,priest,discipline,64,30,34
Sathie,ravencrest,1825,priest,discipline,60,29,31
Collinna,aegwynn,1824,priest,discipline,105,57,48
Lanata,blackrock,1823,priest,discipline,60,34,26
Мухаглот,soulflayer,1823,priest,discipline,71,37,34
Mamaa,stormscale,1822,priest,discipline,72,40,32
Sèco,sylvanas,1822,priest,discipline,42,23,19
Rickerstrike,stormscale,1822,priest,discipline,90,47,43
Tecc,draenor,1822,priest,discipline,130,65,65
Mèlindra,silvermoon,1821,priest,discipline,35,28,7
Jackiqt,nemesis,1821,priest,discipline,30,21,9
Билет,borean-tundra,1821,priest,discipline,42,26,16
Aâraks,khaz-modan,1821,priest,discipline,134,82,52
Mommymilkrx,argent-dawn,1821,priest,discipline,239,124,115
Kripteksx,ravencrest,1819,priest,discipline,47,27,20
Дорогасмеха,howling-fjord,1819,priest,discipline,66,36,30
Vibéz,outland,1819,priest,discipline,54,27,27
Egi,lothar,1818,priest,discipline,51,27,24
Monsterzx,outland,1818,priest,discipline,90,44,46
Свэпи,blackscar,1817,priest,discipline,47,27,20
Lakeworth,argent-dawn,1817,priest,discipline,104,48,56
Mystz,dun-modr,1816,priest,discipline,57,34,23
Hanniri,archimonde,1816,priest,discipline,48,28,20
Виллавелл,blackscar,1815,priest,discipline,48,24,24
Zyzx,blackrock,1815,priest,discipline,66,29,37
Bigextendo,blackmoore,1814,priest,discipline,60,32,28
Discusting,anachronos,1814,priest,discipline,66,34,32
Разрухаз,gordunni,1814,priest,discipline,59,30,29
Elataqt,silvermoon,1812,priest,discipline,79,45,34
Eedazap,argent-dawn,1812,priest,discipline,58,32,26
ßlinkytwinky,outland,1812,priest,discipline,36,19,17
Discoqt,aegwynn,1812,priest,discipline,60,30,30
Cæsifer,blackrock,1811,priest,discipline,100,55,45
Arthezz,ravencrest,1811,priest,discipline,80,40,40
Øxxgodx,blackrock,1810,priest,discipline,81,43,38
Xrq,stormscale,1809,priest,discipline,36,27,9
Shøy,nemesis,1809,priest,discipline,48,26,22
Devoura,sylvanas,1808,priest,discipline,42,23,19
Фастэксп,razuvious,1808,priest,discipline,60,31,29
Yeepah,hyjal,1808,priest,discipline,112,57,55
Aprilfalls,blackmoore,1808,priest,discipline,54,25,29
Seasonf,tarren-mill,1807,priest,discipline,60,28,32
Roxeal,archimonde,1806,priest,discipline,102,65,37
Izzý,antonidas,1806,priest,discipline,30,19,11
Zarahard,draenor,1806,priest,discipline,120,65,55
Светжрец,blackscar,1805,priest,discipline,36,26,10
Tattum,ragnaros,1805,priest,discipline,84,57,27
Pricemg,thrall,1805,priest,discipline,42,26,16
Andaar,ravencrest,1805,priest,discipline,60,32,28
Шкурюклады,gordunni,1805,priest,discipline,60,27,33
Floyyd,kazzak,1804,priest,discipline,42,24,18
Spinebuster,frostwolf,1804,priest,discipline,54,26,28
Gehrke,silvermoon,1803,priest,discipline,105,51,54
Галюхах,soulflayer,1802,priest,discipline,36,19,17
Artístx,twisting-nether,1801,priest,discipline,53,29,24
Rngånxiety,ravencrest,1801,priest,discipline,60,28,32
Salvatíon,sanguino,1801,priest,discipline,179,82,97
Felwy,stormscale,1800,priest,discipline,48,31,17
Mautiya,blackrock,1800,priest,discipline,96,52,44
Neffty,aegwynn,1800,priest,discipline,54,27,27
Lazyx,tarren-mill,1800,priest,discipline,59,29,30
Mysterymucus,draenor,1798,priest,discipline,72,40,32
Втильте,blackscar,1797,priest,discipline,120,67,53
Gaussqt,ravencrest,1797,priest,discipline,78,39,39
Legiondisc,blackmoore,1794,priest,discipline,151,69,82
Некронево,howling-fjord,1793,priest,discipline,45,27,18
Bassepriest,tarren-mill,1791,priest,discipline,59,31,28
Hopesallgone,stormscale,1787,priest,discipline,84,52,32
Voxtwo,blackrock,1786,priest,discipline,30,21,9
Sekker,silvermoon,1782,priest,discipline,220,119,101
Wardshield,ravencrest,1781,priest,discipline,23,19,4
Remkoja,blackrock,1770,priest,discipline,72,36,36
Src,ravencrest,1768,priest,discipline,48,29,19
Magetrainer,tarren-mill,1765,priest,discipline,60,42,18
Utrd,kazzak,1764,priest,discipline,66,31,35
Deepsea,kazzak,1762,priest,discipline,119,60,59
Ziknait,sargeras,1758,priest,discipline,36,23,13
Ironqt,malfurion,1758,priest,discipline,112,48,64
Aòo,twisting-nether,1756,priest,discipline,60,29,31
Hellhammer,stormreaver,1751,priest,discipline,60,32,28
Aruna,ravencrest,1746,priest,discipline,48,26,22
Grouptherpst,draenor,1746,priest,discipline,76,35,41
Evpisces,archimonde,1744,priest,discipline,147,65,82
Stola,archimonde,1744,priest,discipline,83,30,53
Gòldfinger,norgannon,1743,priest,discipline,138,66,72
Артжрец,soulflayer,1742,priest,discipline,64,38,26
Mïserygødx,nemesis,1739,priest,discipline,66,45,21
Xeldrania,azshara,1739,priest,discipline,41,22,19
Justyø,archimonde,1738,priest,discipline,148,88,60
Xzep,archimonde,1738,priest,discipline,72,38,34
Kianprie,silvermoon,1737,priest,discipline,83,33,50
Akzar,blackrock,1734,priest,discipline,183,101,82
Shonsized,argent-dawn,1729,priest,discipline,108,60,48
Prips,bladefist,1725,priest,discipline,213,108,105
Tacochrist,kazzak,1724,priest,discipline,47,27,20
Scarified,aggramar,1724,priest,discipline,36,20,16
Goldensp,sanguino,1723,priest,discipline,57,29,28
Justdänce,hyjal,1723,priest,discipline,46,23,23
Hamsicam,frostwolf,1723,priest,discipline,88,37,51
Virulence,twisting-nether,1722,priest,discipline,108,61,47
Файкахохо,soulflayer,1722,priest,discipline,53,23,30
Clownspec,twisting-nether,1721,priest,discipline,42,22,20
Samaya,blackrock,1721,priest,discipline,80,36,44
Nzothapostle,baelgun,1720,priest,discipline,60,30,30
Kedrack,draenor,1719,priest,discipline,42,27,15
Alexpriest,twisting-nether,1719,priest,discipline,77,47,30
Leffie,outland,1719,priest,discipline,51,26,25
Kaksel,blackrock,1718,priest,discipline,60,35,25
Mercilégion,sargeras,1716,priest,discipline,42,21,21
Spaanseslof,silvermoon,1715,priest,discipline,48,25,23
Berseenreikä,the-venture-co,1715,priest,discipline,48,24,24
Racecar,executus,1715,priest,discipline,96,44,52
Xutira,silvermoon,1713,priest,discipline,159,86,73
Ostrogami,silvermoon,1711,priest,discipline,160,70,90
Cdplz,archimonde,1711,priest,discipline,54,23,31
Wérrýxs,kazzak,1710,priest,discipline,94,56,38
Seranà,hyjal,1708,priest,discipline,42,26,16
Kijhun,uldaman,1707,priest,discipline,66,37,29
Shínx,illidan,1705,priest,discipline,48,27,21
Ðês,ravencrest,1703,priest,discipline,30,18,12
Blazingad,kazzak,1702,priest,discipline,77,37,40
Scarletstory,ravencrest,1702,priest,discipline,90,41,49
Elsieexø,ravencrest,1700,priest,discipline,48,21,27
Holymoly,talnivarr,1700,priest,discipline,78,33,45
Nooxid,eredar,1699,priest,discipline,65,36,29
Kaleycuoco,blackrock,1699,priest,discipline,48,24,24
Rlyeh,argent-dawn,1697,priest,discipline,42,23,19
Rippertmepls,ravencrest,1697,priest,discipline,54,27,27
Raesd,argent-dawn,1695,priest,discipline,54,30,24
Swdommeil,aegwynn,1695,priest,discipline,48,24,24
Alicewhydel,blackhand,1694,priest,discipline,36,18,18
Unréål,ravencrest,1694,priest,discipline,42,20,22
Wóllo,stormscale,1693,priest,discipline,30,18,12
Nalakis,archimonde,1693,priest,discipline,50,29,21
Aenon,argent-dawn,1693,priest,discipline,87,45,42
Healseri,defias-brotherhood,1693,priest,discipline,36,18,18
Verweven,twisting-nether,1692,priest,discipline,47,26,21
Maxmoto,blackrock,1690,priest,discipline,50,29,21
Уровеньб,soulflayer,1690,priest,discipline,36,18,18
Rhauru,tyrande,1690,priest,discipline,48,20,28
Swdjack,blackrock,1689,priest,discipline,90,44,46
Yënâs,hyjal,1687,priest,discipline,79,52,27
Hrtbrxkn,ravencrest,1687,priest,discipline,64,39,25
Abudhabi,blackhand,1686,priest,discipline,138,71,67
Ingelosi,eredar,1685,priest,discipline,100,52,48
Roshmanoff,stormscale,1683,priest,discipline,36,18,18
Hwren,auchindoun,1682,priest,discipline,90,41,49
Lizka,kazzak,1681,priest,discipline,54,26,28
Lorimac,dun-modr,1679,priest,discipline,66,31,35
Yukasa,silvermoon,1679,priest,discipline,54,21,33
Шайтсунг,soulflayer,1677,priest,discipline,56,30,26
Фокусшвд,soulflayer,1676,priest,discipline,120,59,61
Faderfarbror,tarren-mill,1675,priest,discipline,55,33,22
Spiritina,darkmoon-faire,1671,priest,discipline,54,34,20
Byef,kazzak,1671,priest,discipline,56,31,25
Voideffsucks,stormscale,1670,priest,discipline,42,22,20
Ävbmârsík,kazzak,1670,priest,discipline,36,18,18
Walkmydome,twisting-nether,1669,priest,discipline,108,56,52
Sills,twisting-nether,1668,priest,discipline,47,21,26
Gravebrain,draenor,1667,priest,discipline,46,26,20
Enteja,outland,1667,priest,discipline,125,59,66
Twinkerz,ravencrest,1664,priest,discipline,36,23,13
Worldgamer,blackrock,1664,priest,discipline,84,43,41
Lindvorm,tarren-mill,1664,priest,discipline,66,33,33
Schlämpie,blackmoore,1664,priest,discipline,43,21,22
Gepeitschter,frostwolf,1662,priest,discipline,102,56,46
Sikaanyo,blackhand,1662,priest,discipline,66,35,31
Афганский,gordunni,1661,priest,discipline,34,20,14
Slimcharles,ravencrest,1661,priest,discipline,89,52,37
Sutenör,kazzak,1660,priest,discipline,96,36,60
Önnÿ,dun-modr,1659,priest,discipline,42,19,23
Lobbygriefer,ravencrest,1658,priest,discipline,89,49,40
Troedelsuppe,destromath,1656,priest,discipline,110,46,64
Èightsix,draenor,1653,priest,discipline,101,59,42
Amtoxic,stormscale,1653,priest,discipline,246,123,123
Discxqt,ysondre,1652,priest,discipline,77,49,28
Нед,greymane,1651,priest,discipline,90,56,34
Misántropo,dun-modr,1650,priest,discipline,53,36,17
Arlekin,ravencrest,1649,priest,discipline,72,47,25
Zoophobîa,stormscale,1649,priest,discipline,42,22,20
Debeo,ragnaros,1644,priest,discipline,39,24,15
Naphell,outland,1644,priest,discipline,66,31,35
Mitha,tarren-mill,1643,priest,discipline,50,26,24
Ðæððÿsgïrl,ravencrest,1641,priest,discipline,72,38,34
Поршкаенн,gordunni,1641,priest,discipline,42,22,20
Shîn,zirkel-des-cenarius,1640,priest,discipline,42,21,21
Вашачесть,gordunni,1639,priest,discipline,48,24,24
Mindfiend,stormscale,1639,priest,discipline,42,20,22
Шаастраха,gordunni,1639,priest,discipline,50,22,28
Киллус,ashenvale,1639,priest,discipline,54,23,31
Effectx,stormscale,1638,priest,discipline,54,29,25
Felaenna,argent-dawn,1638,priest,discipline,58,28,30
Vorynax,silvermoon,1637,priest,discipline,56,31,25
Miikkap,blackhand,1637,priest,discipline,48,26,22
Znàdix,silvermoon,1637,priest,discipline,110,54,56
Tricavla,frostmane,1635,priest,discipline,48,25,23
Apuessii,dun-modr,1635,priest,discipline,47,21,26
Фенджидисплх,blackscar,1633,priest,discipline,42,21,21
Denunciation,argent-dawn,1632,priest,discipline,36,20,16
Ankus,tarren-mill,1631,priest,discipline,48,23,25
Kollis,twilights-hammer,1630,priest,discipline,75,36,39
Inoru,stormreaver,1629,priest,discipline,78,41,37
Zeruhphin,eredar,1628,priest,discipline,36,20,16
Leviakerman,blackrock,1628,priest,discipline,42,18,24
Scurrp,aegwynn,1627,priest,discipline,48,23,25
Aleluia,alonsus,1627,priest,discipline,99,43,56
Eestpr,tarren-mill,1626,priest,discipline,45,20,25
Pestmorran,sylvanas,1626,priest,discipline,150,66,84
Bijaqt,blackmoore,1625,priest,discipline,42,17,25
Demora,ysondre,1624,priest,discipline,24,17,7
Violentha,kazzak,1624,priest,discipline,90,46,44
Echonic,aegwynn,1624,priest,discipline,105,48,57
Rezzurrectum,doomhammer,1623,priest,discipline,36,20,16
Мплехибои,gordunni,1622,priest,discipline,54,30,24
Mønsterx,kazzak,1621,priest,discipline,40,25,15
Zinzor,archimonde,1621,priest,discipline,61,37,24
Outtloor,twisting-nether,1619,priest,discipline,39,25,14
Uivi,azjolnerub,1617,priest,discipline,30,17,13
Trashedd,outland,1617,priest,discipline,42,20,22
Некрогуро,gordunni,1617,priest,discipline,36,17,19
Isweariheal,twisting-nether,1616,priest,discipline,58,37,21
Gehrketwo,silvermoon,1615,priest,discipline,36,21,15
Priewyn,ragnaros,1615,priest,discipline,96,51,45
Wonderdispel,ragnaros,1614,priest,discipline,48,21,27
Rmt,darksorrow,1613,priest,discipline,36,21,15
Babybelle,arakarahm,1612,priest,discipline,49,27,22
Mnu,blackrock,1611,priest,discipline,36,21,15
Rezzdar,lightnings-blade,1611,priest,discipline,36,17,19
Lolylights,tarren-mill,1611,priest,discipline,48,20,28
Feeqamikka,ragnaros,1610,priest,discipline,32,20,12
Nyxoqtxd,ravencrest,1610,priest,discipline,64,35,29
Toba,hellscream,1608,priest,discipline,101,60,41
Bizqit,tarren-mill,1608,priest,discipline,59,30,29
Fakecats,sargeras,1608,priest,discipline,51,22,29
Awcute,kazzak,1607,priest,discipline,84,37,47
Alwaysøøm,kazzak,1605,priest,discipline,24,20,4
Rabbai,twisting-nether,1604,priest,discipline,42,21,21
Veltrag,sanguino,1603,priest,discipline,30,21,9
Хилботгодикс,borean-tundra,1602,priest,discipline,42,32,10
Isalvation,stormscale,1602,priest,discipline,42,17,25
Yunusgødx,kazzak,1601,priest,discipline,30,20,10
Мастди,ashenvale,1601,priest,discipline,41,20,21
Deathgodx,archimonde,1601,priest,discipline,64,31,33
Dêrbómbêr,guldan,1600,priest,discipline,54,30,24
Sdn,twisting-nether,1600,priest,discipline,36,17,19
Interrupted,kazzak,1600,priest,discipline,66,30,36
Brigittë,ravencrest,1600,priest,discipline,42,19,23
Ðarkan,kaelthas,1599,priest,discipline,78,43,35
Hâlez,antonidas,1599,priest,discipline,144,77,67
Ahpøual,archimonde,1599,priest,discipline,72,32,40
Nyarlatothep,boulderfist,1598,priest,discipline,118,63,55
Fazzy,nagrand,1596,priest,discipline,40,23,17
Aédeira,blackhand,1596,priest,discipline,47,20,27
Alèxy,tarren-mill,1596,priest,discipline,48,19,29
Xangha,burning-legion,1592,priest,discipline,198,99,99
Hamati,blackhand,1591,priest,discipline,54,34,20
Санггвиний,soulflayer,1589,priest,discipline,60,36,24
Skynoxx,ragnaros,1589,priest,discipline,102,50,52
Shanny,kazzak,1587,priest,discipline,59,34,25
Pokahonta,silvermoon,1585,priest,discipline,76,40,36
Healêl,sanguino,1581,priest,discipline,36,17,19
Athelsta,alleria,1580,priest,discipline,42,22,20
Exoduz,stormscale,1578,priest,discipline,56,29,27
Соулвардинг,soulflayer,1577,priest,discipline,42,18,24
Ödriaell,the-venture-co,1577,priest,discipline,42,17,25
Tuitio,blackmoore,1576,priest,discipline,65,34,31
Oioiio,kazzak,1574,priest,discipline,42,18,24
Thalanas,ravencrest,1573,priest,discipline,105,51,54
Анстахоуп,grom,1570,priest,discipline,48,38,10
Yugemilkers,kazzak,1570,priest,discipline,44,20,24
Lyrina,twisting-nether,1569,priest,discipline,173,95,78
Hèmera,tichondrius,1568,priest,discipline,55,41,14
Аая,blackscar,1566,priest,discipline,66,31,35
Denyz,blackrock,1566,priest,discipline,54,21,33
Diszi,norgannon,1565,priest,discipline,46,23,23
Виспх,eversong,1565,priest,discipline,239,107,132
Efeslol,dun-modr,1564,priest,discipline,54,24,30
Yøløswagg,silvermoon,1564,priest,discipline,48,21,27
Menda,eredar,1563,priest,discipline,100,60,40
Swoptoplong,blackhand,1563,priest,discipline,152,78,74
Qhub,sylvanas,1563,priest,discipline,42,19,23
Unfaker,drakthul,1562,priest,discipline,36,23,13
Cinri,argent-dawn,1562,priest,discipline,136,65,71
Tansk,stormscale,1561,priest,discipline,84,51,33
Lishado,twisting-nether,1561,priest,discipline,78,40,38
Alz,rashgarroth,1561,priest,discipline,68,33,35
Chamelthoe,the-maelstrom,1561,priest,discipline,72,34,38
Barackomana,blackrock,1561,priest,discipline,48,19,29
Рвотка,gordunni,1559,priest,discipline,124,68,56
Флафика,deathguard,1558,priest,discipline,48,29,19
Gbpjr,xavius,1557,priest,discipline,40,23,17
Juggster,bloodhoof,1557,priest,discipline,120,64,56
Scaryolol,blackmoore,1557,priest,discipline,35,18,17
Raawri,blackmoore,1557,priest,discipline,54,24,30
Cätälin,twisting-nether,1557,priest,discipline,117,51,66
Touchmypink,ragnaros,1557,priest,discipline,48,18,30
Wencis,kazzak,1555,priest,discipline,54,25,29
Kàalyx,archimonde,1555,priest,discipline,42,18,24
Баблби,soulflayer,1555,priest,discipline,85,29,56
Frednshield,tarren-mill,1554,priest,discipline,69,34,35
Pepeflex,draenor,1552,priest,discipline,43,21,22
Abømination,hyjal,1551,priest,discipline,27,18,9
Sazuki,sylvanas,1551,priest,discipline,77,38,39
Korzec,dun-modr,1550,priest,discipline,102,54,48
Arkkinunna,outland,1549,priest,discipline,124,59,65
Burningheatx,kazzak,1548,priest,discipline,41,29,12
Twosugars,sylvanas,1548,priest,discipline,60,29,31
Sonics,antonidas,1548,priest,discipline,66,31,35
Elämäntypy,stormscale,1547,priest,discipline,54,28,26
Badorange,kazzak,1547,priest,discipline,36,18,18
Systerstål,twisting-nether,1546,priest,discipline,78,45,33
Foobi,the-maelstrom,1546,priest,discipline,183,102,81
Олегстразза,howling-fjord,1546,priest,discipline,75,38,37
Lethalhealz,outland,1544,priest,discipline,36,20,16
Nomakprst,sanguino,1544,priest,discipline,102,51,51
Rasha,kazzak,1543,priest,discipline,51,31,20
Kèvin,das-syndikat,1542,priest,discipline,36,18,18
Shadowboness,twisting-nether,1542,priest,discipline,52,25,27
Майндоф,howling-fjord,1541,priest,discipline,48,28,20
Whiskie,twisting-nether,1540,priest,discipline,60,30,30
Wasnezov,blackhand,1540,priest,discipline,36,17,19
Panoio,aggra-português,1540,priest,discipline,53,25,28
Voidsnitch,antonidas,1540,priest,discipline,66,30,36
Laxímink,sylvanas,1540,priest,discipline,59,24,35
Grautesk,chogall,1539,priest,discipline,48,23,25
Acrio,die-ewige-wacht,1536,priest,discipline,30,17,13
Sebikpri,ravencrest,1536,priest,discipline,48,25,23
Ёджих,blackscar,1535,priest,discipline,61,32,29
Goblex,hyjal,1535,priest,discipline,63,28,35
Разрухаовнз,gordunni,1534,priest,discipline,24,16,8
Ladderpolice,blackmoore,1534,priest,discipline,30,16,14
Loví,twisting-nether,1533,priest,discipline,36,16,20
Ptsd,argent-dawn,1533,priest,discipline,60,26,34
Laonar,silvermoon,1532,priest,discipline,91,56,35
Khâléd,kazzak,1531,priest,discipline,30,16,14
Фыбра,soulflayer,1531,priest,discipline,30,16,14
Preachyjeg,ravencrest,1531,priest,discipline,48,19,29
Амбракадабра,blackscar,1530,priest,discipline,36,26,10
Ziv,grim-batol,1530,priest,discipline,68,45,23
Vigodis,alleria,1530,priest,discipline,45,27,18
Avengëd,nagrand,1530,priest,discipline,34,18,16
Alphabreyf,tarren-mill,1529,priest,discipline,41,21,20
Mêmphìs,twisting-nether,1529,priest,discipline,65,29,36
Джелесана,gordunni,1528,priest,discipline,69,31,38
Valnor,pozzo-delleternità,1527,priest,discipline,54,25,29
Cnqz,archimonde,1526,priest,discipline,36,16,20
Alusiepriest,ravencrest,1525,priest,discipline,72,44,28
Dejica,kult-der-verdammten,1525,priest,discipline,60,30,30
Bandulskii,twisting-nether,1525,priest,discipline,157,71,86
Senpumara,malganis,1523,priest,discipline,147,74,73
Invexx,tarren-mill,1523,priest,discipline,54,23,31
Southyz,stormscale,1521,priest,discipline,36,21,15
Mentaldeadp,draenor,1521,priest,discipline,42,24,18
Tritíana,blackrock,1520,priest,discipline,87,55,32
Kæyc,blackmoore,1520,priest,discipline,42,24,18
Holycrit,aszune,1520,priest,discipline,30,17,13
Yûnalescá,blackmoore,1520,priest,discipline,54,26,28
Cbsad,madmortem,1518,priest,discipline,78,45,33
Krasawìtch,onyxia,1518,priest,discipline,54,24,30
Nocdsusage,draenor,1517,priest,discipline,30,16,14
Lythi,eredar,1517,priest,discipline,100,43,57
Xtracheesy,ragnaros,1516,priest,discipline,48,27,21
Mortarz,ragnaros,1515,priest,discipline,36,17,19
Aestina,silvermoon,1514,priest,discipline,102,49,53
Devot,outland,1513,priest,discipline,38,25,13
Evõmax,sylvanas,1512,priest,discipline,54,33,21
Virdeo,aegwynn,1511,priest,discipline,30,16,14
Lurri,tarren-mill,1510,priest,discipline,84,43,41
Ohbenji,ravencrest,1510,priest,discipline,68,32,36
Glyss,draenor,1509,priest,discipline,24,16,8
Holycrapx,chromaggus,1509,priest,discipline,44,22,22
Klituriis,twisting-nether,1508,priest,discipline,71,39,32
Scade,kazzak,1508,priest,discipline,68,34,34
Cresellia,twisting-nether,1506,priest,discipline,128,58,70
Dench,azjolnerub,1505,priest,discipline,60,25,35
Pshan,blackmoore,1504,priest,discipline,104,49,55
Cryksî,eredar,1501,priest,discipline,51,27,24
Dreythan,stormrage,1501,priest,discipline,50,19,31
Japral,blackhand,1500,priest,discipline,24,16,8
Мьюсх,deathguard,1500,priest,discipline,77,42,35
Ilovedisc,kazzak,1499,priest,discipline,33,19,14
Blackbox,burning-legion,1497,priest,discipline,89,39,50
Vhim,hyjal,1497,priest,discipline,44,19,25
Mopriest,eredar,1496,priest,discipline,24,16,8
Poonies,silvermoon,1495,priest,discipline,52,22,30
Olio,outland,1494,priest,discipline,76,35,41
Huffinctus,tarren-mill,1493,priest,discipline,70,36,34
Tinpr,sanguino,1493,priest,discipline,84,37,47
Tøxicboy,ravencrest,1492,priest,discipline,36,17,19
Dotdotggwp,stormscale,1487,priest,discipline,78,37,41
Phasmöphobia,zuljin,1487,priest,discipline,72,30,42
Aurosa,argent-dawn,1486,priest,discipline,61,28,33
Emryth,blackhand,1486,priest,discipline,48,17,31
Шатолюгран,soulflayer,1485,priest,discipline,46,32,14
Drxz,twilights-hammer,1485,priest,discipline,36,18,18
Ssol,tarren-mill,1481,priest,discipline,43,24,19
Jumperlawl,khaz-modan,1481,priest,discipline,48,26,22
Jhaazx,nemesis,1481,priest,discipline,119,60,59
Шарадин,gordunni,1477,priest,discipline,104,57,47
Kdot,drakthul,1477,priest,discipline,48,23,25
Кошечка,deathguard,1477,priest,discipline,35,16,19
Spirítbox,argent-dawn,1475,priest,discipline,60,30,30
Neoni,blackmoore,1475,priest,discipline,88,42,46
Kanî,eredar,1475,priest,discipline,48,21,27
Alesthion,silvermoon,1475,priest,discipline,44,19,25
Sheshan,destromath,1473,priest,discipline,35,20,15
Licktheheal,outland,1473,priest,discipline,30,17,13
Надийя,gordunni,1470,priest,discipline,66,38,28
Krystynal,archimonde,1470,priest,discipline,29,16,13
Кэндимен,gordunni,1469,priest,discipline,38,25,13
Battra,argent-dawn,1468,priest,discipline,78,41,37
Трэй,deathguard,1467,priest,discipline,72,41,31
Saintpri,twisting-nether,1467,priest,discipline,54,29,25
Kyseki,ravencrest,1467,priest,discipline,174,90,84
Yákizå,darksorrow,1466,priest,discipline,72,30,42
Prästpojken,frostwhisper,1465,priest,discipline,42,16,26
Alliora,dalaran,1462,priest,discipline,51,20,31
Krayziest,tarren-mill,1461,priest,discipline,42,26,16
Medipack,khaz-modan,1459,priest,discipline,30,20,10
Xoxogg,burning-blade,1458,priest,discipline,60,38,22
Zedrus,azshara,1458,priest,discipline,81,39,42
Avaichquirit,tarren-mill,1457,priest,discipline,36,17,19
Pàndoràh,nemesis,1453,priest,discipline,36,20,16
Kâltak,aegwynn,1446,priest,discipline,48,24,24
Kåstå,archimonde,1445,priest,discipline,38,24,14
Простосори,gordunni,1445,priest,discipline,107,45,62
Troublemaker,durotan,1443,priest,discipline,42,24,18
Sombralúz,sanguino,1442,priest,discipline,36,20,16
Alakkiria,ravencrest,1442,priest,discipline,59,30,29
Laurent,sanguino,1441,priest,discipline,36,16,20
Хомие,soulflayer,1441,priest,discipline,54,22,32
Sprutch,kazzak,1439,priest,discipline,50,28,22
Bedkara,ravencrest,1439,priest,discipline,30,15,15
Kaémon,twisting-nether,1439,priest,discipline,58,23,35
Sleepypriest,frostmane,1438,priest,discipline,24,15,9
Snutz,draenor,1437,priest,discipline,24,15,9
Ðiscobiscuit,argent-dawn,1437,priest,discipline,49,27,22
Mjamc,stormscale,1437,priest,discipline,72,30,42
Dzoo,kazzak,1436,priest,discipline,58,27,31
Babywayn,onyxia,1434,priest,discipline,51,24,27
Nurbanu,ravencrest,1433,priest,discipline,24,19,5
Selëne,blackrock,1433,priest,discipline,42,22,20
Mswagner,outland,1433,priest,discipline,30,15,15
Nêxt,ravencrest,1431,priest,discipline,18,15,3
Prezica,stormscale,1431,priest,discipline,77,40,37
Smilézz,eredar,1430,priest,discipline,30,15,15
Angelofdeàth,kazzak,1429,priest,discipline,24,18,6
Вилайф,galakrond,1429,priest,discipline,47,19,28
Ivysaurus,ravencrest,1428,priest,discipline,54,31,23
Ssjfoxyo,sylvanas,1428,priest,discipline,36,15,21
Pregrip,twisting-nether,1425,priest,discipline,113,60,53
Урголиафа,howling-fjord,1425,priest,discipline,54,25,29
Двелегитоп,howling-fjord,1421,priest,discipline,24,15,9
Targoviste,archimonde,1421,priest,discipline,135,73,62
Adev,drakthul,1420,priest,discipline,36,20,16
Gïanna,archimonde,1420,priest,discipline,42,23,19
Нэстикус,gordunni,1418,priest,discipline,30,16,14
Zoe,aegwynn,1417,priest,discipline,88,45,43
Greedyaf,stormscale,1416,priest,discipline,89,45,44
Sáshagrey,arathor,1416,priest,discipline,37,18,19
Flyingdutch,tarren-mill,1415,priest,discipline,78,40,38
Øbz,sylvanas,1415,priest,discipline,42,15,27
Jandice,blackrock,1414,priest,discipline,30,15,15
Kaeldara,ysondre,1413,priest,discipline,24,15,9
Мэдсанван,howling-fjord,1410,priest,discipline,24,15,9
Eagrh,ravencrest,1409,priest,discipline,30,20,10
Dunderprälle,outland,1409,priest,discipline,30,15,15
Lévention,stormscale,1408,priest,discipline,36,20,16
Rizzlerx,blackmoore,1408,priest,discipline,30,16,14
Holysheett,magtheridon,1408,priest,discipline,36,18,18
Massbimba,tarren-mill,1407,priest,discipline,90,49,41
Gothixs,draenor,1406,priest,discipline,44,26,18
Менестрели,gordunni,1405,priest,discipline,34,25,9
Yzïam,ravencrest,1405,priest,discipline,23,15,8
Marllen,twisting-nether,1405,priest,discipline,53,22,31
Naïlu,hyjal,1403,priest,discipline,54,33,21
Flurri,tarren-mill,1403,priest,discipline,84,44,40
Dímension,ragnaros,1401,priest,discipline,62,37,25
Silvdarr,hyjal,1401,priest,discipline,66,34,32
Holineß,burning-blade,1400,priest,discipline,24,15,9
Mewpew,azjolnerub,1400,priest,discipline,36,15,21
Bolflo,khaz-modan,1399,priest,discipline,72,39,33
Chankilolx,dun-modr,1399,priest,discipline,119,51,68
Laadyybirkee,blackhand,1398,priest,discipline,140,70,70
Kbakå,stormscale,1398,priest,discipline,48,18,30
Soulreapper,blackhand,1397,priest,discipline,105,57,48
Ræpriestx,ragnaros,1393,priest,discipline,57,28,29
Oxborn,thrall,1393,priest,discipline,62,29,33
Dragovic,chogall,1392,priest,discipline,69,31,38
Мдзшка,gordunni,1392,priest,discipline,114,51,63
Blackheal,sanguino,1387,priest,discipline,48,20,28
Nakali,the-maelstrom,1386,priest,discipline,30,16,14
Дядяврач,howling-fjord,1386,priest,discipline,60,28,32
Pyropenance,twisting-nether,1386,priest,discipline,83,35,48
Valaç,turalyon,1383,priest,discipline,77,42,35
Tintapri,aszune,1381,priest,discipline,75,38,37
Onelovexx,thrall,1380,priest,discipline,36,15,21
Jupiter,silvermoon,1378,priest,discipline,24,15,9
Streety,nethersturm,1378,priest,discipline,90,43,47
Chowhone,archimonde,1377,priest,discipline,88,48,40
Gangreana,kazzak,1377,priest,discipline,78,42,36
Dolifrius,dalaran,1375,priest,discipline,50,30,20
Syntara,twisting-nether,1374,priest,discipline,60,26,34
Nirvánabang,sylvanas,1372,priest,discipline,36,20,16
Rabbît,stormscale,1372,priest,discipline,82,42,40
Блексебет,soulflayer,1372,priest,discipline,72,35,37
Geesuz,outland,1372,priest,discipline,39,16,23
Discobrill,silvermoon,1372,priest,discipline,42,16,26
Kutjeskopper,silvermoon,1371,priest,discipline,36,19,17
Скизма,gordunni,1370,priest,discipline,42,25,17
Snuifje,azjolnerub,1370,priest,discipline,70,29,41
Overhealzz,blackmoore,1369,priest,discipline,30,16,14
Шпангл,gordunni,1369,priest,discipline,36,15,21
Могулас,soulflayer,1368,priest,discipline,100,44,56
Zealtron,darksorrow,1368,priest,discipline,35,15,20
Сашадвасм,gordunni,1364,priest,discipline,24,15,9
Luuña,ravencrest,1364,priest,discipline,82,39,43
Thrakoun,twilights-hammer,1364,priest,discipline,39,17,22
Unholyfield,draenor,1363,priest,discipline,66,28,38
Aisha,rajaxx,1361,priest,discipline,69,32,37
Joniop,stormreaver,1361,priest,discipline,48,20,28
Batsu,hyjal,1358,priest,discipline,54,24,30
Animepfp,stormreaver,1358,priest,discipline,48,20,28
Priesless,sylvanas,1357,priest,discipline,34,20,14
Hardcode,twisting-nether,1356,priest,discipline,32,16,16
Enoriya,blackrock,1354,priest,discipline,68,37,31
Kratzîgel,blackmoore,1354,priest,discipline,90,47,43
Tarellia,argent-dawn,1353,priest,discipline,54,36,18
Íhðly,silvermoon,1353,priest,discipline,30,15,15
Solarïah,garona,1352,priest,discipline,32,19,13
Littlehelper,shendralar,1352,priest,discipline,39,16,23
Buszeekk,outland,1351,priest,discipline,28,18,10
Isore,culte-de-la-rive-noire,1351,priest,discipline,34,20,14
Feelmypainn,kazzak,1350,priest,discipline,42,23,19
Инстенли,howling-fjord,1348,priest,discipline,36,17,19
Maidie,stormscale,1347,priest,discipline,43,26,17
Тварьгосподя,gordunni,1347,priest,discipline,102,51,51
Maylà,aegwynn,1347,priest,discipline,48,18,30
Pwjetlifelol,grim-batol,1345,priest,discipline,97,52,45
Sâtânica,kelthuzad,1345,priest,discipline,72,33,39
Garfriest,aggra-português,1344,priest,discipline,36,22,14
Antainis,silvermoon,1344,priest,discipline,37,19,18
Noxr,ravencrest,1344,priest,discipline,50,18,32
Bubidiblumpr,twisting-nether,1343,priest,discipline,30,18,12
Ецци,howling-fjord,1343,priest,discipline,38,18,20
Kevokko,silvermoon,1342,priest,discipline,24,14,10
Rpriest,outland,1342,priest,discipline,24,14,10
Putinkuilo,outland,1342,priest,discipline,30,15,15
Поднялбабки,deathguard,1342,priest,discipline,36,14,22
Mobcal,twisting-nether,1342,priest,discipline,36,14,22
Asdfghqwezxc,twisting-nether,1341,priest,discipline,24,14,10
Alfaböna,outland,1341,priest,discipline,107,60,47
Bubbelchên,blackhand,1339,priest,discipline,24,14,10
Convulsiveq,silvermoon,1339,priest,discipline,172,85,87
Elethia,blackmoore,1339,priest,discipline,30,14,16
Kirtarah,aegwynn,1338,priest,discipline,30,14,16
Dispelgodxx,eredar,1338,priest,discipline,30,14,16
Amanojakü,ravencrest,1337,priest,discipline,36,24,12
Chealsey,thrall,1335,priest,discipline,45,30,15
Соникида,gordunni,1334,priest,discipline,36,14,22
Enduring,darksorrow,1332,priest,discipline,54,23,31
Aroghul,eredar,1331,priest,discipline,54,23,31
Waafa,kazzak,1331,priest,discipline,42,14,28
Averagenoob,ragnaros,1330,priest,discipline,30,14,16
Кролс,gordunni,1330,priest,discipline,30,14,16
Holyshiz,stormrage,1328,priest,discipline,24,14,10
Rose,darksorrow,1328,priest,discipline,37,21,16
Alaeddin,kazzak,1328,priest,discipline,48,19,29
Pètunia,ravencrest,1327,priest,discipline,45,28,17
Maccz,hyjal,1327,priest,discipline,30,14,16
Nou,aegwynn,1327,priest,discipline,36,14,22
Dirtydoc,area-52,1326,priest,discipline,33,18,15
Phreyst,draenor,1324,priest,discipline,18,14,4
Jodge,ravencrest,1324,priest,discipline,48,26,22
Nerfnerf,kazzak,1324,priest,discipline,130,62,68
Burnex,thrall,1324,priest,discipline,30,14,16
Lïnkz,kazzak,1322,priest,discipline,24,14,10
Докторпэйн,howling-fjord,1322,priest,discipline,34,16,18
Kotipope,silvermoon,1321,priest,discipline,65,38,27
Alexnator,malganis,1320,priest,discipline,36,16,20
Fatherliam,emerald-dream,1319,priest,discipline,42,19,23
Асади,gordunni,1318,priest,discipline,36,22,14
Eileengu,silvermoon,1318,priest,discipline,46,27,19
Mediumheals,tarren-mill,1316,priest,discipline,30,16,14
Nuklash,burning-legion,1313,priest,discipline,24,14,10
Ggsus,outland,1313,priest,discipline,48,20,28
Форсибучи,soulflayer,1312,priest,discipline,66,30,36
Ahmnesia,archimonde,1306,priest,discipline,48,19,29
Пристижнаяя,gordunni,1298,priest,discipline,32,15,17
Бомжскадилом,gordunni,1297,priest,discipline,129,67,62
Asuriyan,grim-batol,1296,priest,discipline,39,20,19
Noobpriest,blackrock,1296,priest,discipline,36,14,22
Dabalthazar,ravencrest,1295,priest,discipline,21,14,7
Mishas,draenor,1294,priest,discipline,30,19,11
Brach,nazjatar,1293,priest,discipline,24,15,9
Pl,sunstrider,1293,priest,discipline,42,22,20
Vès,stormscale,1292,priest,discipline,54,30,24
Mustatomi,stormreaver,1291,priest,discipline,27,14,13
Brainwash,darksorrow,1289,priest,discipline,53,18,35
Winnever,dun-modr,1288,priest,discipline,81,42,39
Шадоухоррор,gordunni,1285,priest,discipline,45,18,27
Sílvana,nordrassil,1284,priest,discipline,76,39,37
Elderiel,turalyon,1284,priest,discipline,48,23,25
Fullymetalz,defias-brotherhood,1282,priest,discipline,46,26,20
Mynameisebe,twisting-nether,1282,priest,discipline,42,18,24
Salzgehalt,antonidas,1277,priest,discipline,42,27,15
Psyfir,outland,1277,priest,discipline,77,39,38
Verrottênd,frostwolf,1274,priest,discipline,30,15,15
Fitu,drakthul,1274,priest,discipline,29,14,15
Frekio,eitrigg,1273,priest,discipline,59,24,35
Overshadowed,kazzak,1272,priest,discipline,169,77,92
Даркфолс,soulflayer,1270,priest,discipline,53,28,25
Zùt,ysondre,1269,priest,discipline,48,28,20
Micobra,dalaran,1267,priest,discipline,24,14,10
Bandgap,antonidas,1267,priest,discipline,62,24,38
Chrispriest,argent-dawn,1264,priest,discipline,32,14,18
Sacerfull,sanguino,1263,priest,discipline,48,23,25
Suzziee,silvermoon,1263,priest,discipline,42,20,22
Акктуальная,deepholm,1262,priest,discipline,36,19,17
Acidpills,hyjal,1260,priest,discipline,28,14,14
Мненосина,goldrinn,1257,priest,discipline,34,14,20
Seinaruki,emerald-dream,1254,priest,discipline,24,14,10
Топчикс,gordunni,1251,priest,discipline,48,24,24
Buan,outland,1248,priest,discipline,18,13,5
Suprenext,draenor,1248,priest,discipline,24,13,11
Chasx,ravencrest,1248,priest,discipline,30,13,17
Dêmôn,stormscale,1247,priest,discipline,18,13,5
Boulotpas,hyjal,1247,priest,discipline,49,35,14
Zychopriest,antonidas,1247,priest,discipline,24,13,11
Swdömmel,aegwynn,1247,priest,discipline,24,13,11
Feedergodx,dun-modr,1247,priest,discipline,24,13,11
Drillin,ravencrest,1247,priest,discipline,30,13,17
Eukmassus,archimonde,1247,priest,discipline,30,13,17
Doublefreak,draenor,1244,priest,discipline,18,13,5
Hotdog,kult-der-verdammten,1244,priest,discipline,30,17,13
Эвэргарден,eversong,1243,priest,discipline,42,13,29
Tylér,stormscale,1241,priest,discipline,18,13,5
Folelli,ysondre,1241,priest,discipline,30,13,17
Cutename,burning-blade,1240,priest,discipline,30,14,16
Алуан,blackscar,1240,priest,discipline,42,13,29
Holyswift,dun-morogh,1239,priest,discipline,85,45,40
Капляболи,gordunni,1237,priest,discipline,33,20,13
Dreamhatcher,deathwing,1236,priest,discipline,30,13,17
Disturbdtwo,archimonde,1235,priest,discipline,24,13,11
Mcdced,archimonde,1235,priest,discipline,30,13,17
Divaz,eredar,1234,priest,discipline,48,18,30
Kätsulol,ysondre,1233,priest,discipline,24,13,11
Héternel,ysondre,1232,priest,discipline,44,21,23
Janinw,sylvanas,1232,priest,discipline,30,13,17
Samtig,malganis,1232,priest,discipline,57,23,34
Pawriest,draenor,1231,priest,discipline,24,14,10
Lighter,dragonblight,1230,priest,discipline,46,31,15
Lucianßk,sanguino,1230,priest,discipline,48,27,21
Фейкай,blackscar,1229,priest,discipline,24,13,11
Baglet,ravencrest,1224,priest,discipline,24,13,11
Cntrl,frostmane,1223,priest,discipline,48,24,24
Anzil,dun-modr,1223,priest,discipline,30,13,17
Psychoboris,outland,1222,priest,discipline,54,29,25
Nukksch,antonidas,1222,priest,discipline,45,18,27
Xieen,outland,1220,priest,discipline,54,22,32
Лолиэль,soulflayer,1218,priest,discipline,57,31,26
Talonjean,conseil-des-ombres,1218,priest,discipline,24,13,11
Perdítá,thrall,1217,priest,discipline,71,33,38
Simbaba,archimonde,1214,priest,discipline,30,17,13
Vannax,arygos,1214,priest,discipline,30,13,17
Nymrasus,ravencrest,1213,priest,discipline,24,13,11
Beabanane,aegwynn,1210,priest,discipline,26,14,12
Хаварь,gordunni,1210,priest,discipline,69,32,37
Cøøbrà,hyjal,1209,priest,discipline,52,30,22
Freezydot,silvermoon,1207,priest,discipline,63,37,26
Palitox,kazzak,1207,priest,discipline,24,13,11
Selenar,neptulon,1205,priest,discipline,36,19,17
Свежага,howling-fjord,1203,priest,discipline,76,33,43
Mamaoh,ravencrest,1203,priest,discipline,30,13,17
Beaglep,blackrock,1203,priest,discipline,53,13,40
Lekadolplusc,doomhammer,1200,priest,discipline,37,21,16
Ahree,sargeras,1193,priest,discipline,28,13,15
Skrnz,turalyon,1192,priest,discipline,35,13,22
Дайбчик,gordunni,1191,priest,discipline,28,15,13
Stazqt,conseil-des-ombres,1191,priest,discipline,40,15,25
Uro,tirion,1190,priest,discipline,41,14,27
Triksas,sylvanas,1187,priest,discipline,24,19,5
Drsmort,blackrock,1185,priest,discipline,48,23,25
Myrmeen,silvermoon,1184,priest,discipline,42,20,22
Vedina,bronze-dragonflight,1184,priest,discipline,42,17,25
Pandalulz,turalyon,1181,priest,discipline,20,14,6
Pocketissue,ravencrest,1178,priest,discipline,22,14,8
Yojoyo,draenor,1177,priest,discipline,73,33,40
Парикнахер,soulflayer,1171,priest,discipline,36,23,13
Velles,nazjatar,1171,priest,discipline,126,58,68
Captn,draenor,1171,priest,discipline,54,22,32
Styrbjörn,shattered-hand,1165,priest,discipline,32,14,18
Aléhyl,la-croisade-écarlate,1164,priest,discipline,30,14,16
Valnaya,draenor,1163,priest,discipline,25,15,10
Olîra,hyjal,1163,priest,discipline,30,14,16
Seras,bloodfeather,1163,priest,discipline,48,21,27
Klaura,blackmoore,1161,priest,discipline,30,15,15
Miralou,ravencrest,1154,priest,discipline,54,34,20
Coldyxz,blackrock,1152,priest,discipline,18,12,6
Azoran,dentarg,1152,priest,discipline,24,12,12
Djrussia,tarren-mill,1152,priest,discipline,30,12,18
Swera,twisting-nether,1151,priest,discipline,18,12,6
Yesdaddypls,draenor,1151,priest,discipline,25,13,12
Listrix,frostmane,1151,priest,discipline,30,12,18
Deadandugly,eredar,1151,priest,discipline,30,12,18
Verjin,kazzak,1150,priest,discipline,36,12,24
Minipõppy,ravencrest,1149,priest,discipline,24,12,12
Ticklebell,ravencrest,1148,priest,discipline,30,21,9
Discmoo,kazzak,1148,priest,discipline,20,12,8
Èzì,burning-legion,1148,priest,discipline,24,12,12
Destinychild,norgannon,1148,priest,discipline,29,12,17
Tarîs,archimonde,1147,priest,discipline,24,12,12
Indicta,darksorrow,1147,priest,discipline,27,13,14
Sandaal,drakthul,1146,priest,discipline,47,21,26
Hiereia,khadgar,1143,priest,discipline,30,12,18
Árî,dun-modr,1141,priest,discipline,18,12,6
Dotterin,draenor,1140,priest,discipline,24,12,12
Añgêl,ravencrest,1140,priest,discipline,81,37,44
Healy,blackrock,1140,priest,discipline,36,13,23
Mädmän,draenor,1139,priest,discipline,72,38,34
Dotsin,kazzak,1139,priest,discipline,72,32,40
Chibrausorus,archimonde,1139,priest,discipline,30,12,18
Drissz,archimonde,1135,priest,discipline,24,12,12
Seneth,twisting-nether,1135,priest,discipline,24,12,12
Brunestùd,pozzo-delleternità,1133,priest,discipline,50,23,27
Blàckângel,blackrock,1130,priest,discipline,225,113,112
Kyrédan,dalaran,1129,priest,discipline,47,25,22
Vaewyn,ravencrest,1126,priest,discipline,24,12,12
Zenoo,argent-dawn,1122,priest,discipline,18,12,6
Therezzer,burning-legion,1122,priest,discipline,24,12,12
Karzin,aggra-português,1120,priest,discipline,60,28,32
Youngfade,twisting-nether,1120,priest,discipline,28,13,15
Iømÿnudir,archimonde,1119,priest,discipline,30,13,17
Discoprillan,twisting-nether,1117,priest,discipline,29,14,15
Ew,shattered-halls,1117,priest,discipline,28,13,15
Yoii,nemesis,1116,priest,discipline,16,13,3
Trimégiste,hyjal,1112,priest,discipline,48,25,23
Залупский,gordunni,1111,priest,discipline,24,12,12
Arkkupiispa,stormreaver,1111,priest,discipline,28,13,15
Didinini,outland,1109,priest,discipline,18,12,6
Ruderali,blackmoore,1106,priest,discipline,24,12,12
Bigballer,stormscale,1103,priest,discipline,27,13,14
Crinji,blackmoore,1103,priest,discipline,25,12,13
Nellytaa,dalaran,1102,priest,discipline,27,15,12
Möd,ragnaros,1100,priest,discipline,30,13,17
Dezriah,tarren-mill,1097,priest,discipline,22,13,9
Шестьнадцать,gordunni,1097,priest,discipline,23,12,11
Prïstië,drakthul,1094,priest,discipline,42,22,20
Шкуропльот,gordunni,1093,priest,discipline,28,13,15
Mjölkpelle,twisting-nether,1092,priest,discipline,18,14,4
Mønti,onyxia,1092,priest,discipline,33,17,16
Арабет,galakrond,1091,priest,discipline,44,24,20
Saénna,burning-legion,1083,priest,discipline,26,12,14
Shilôz,hyjal,1082,priest,discipline,27,13,14
Гомотряс,howling-fjord,1079,priest,discipline,102,54,48
Carpathîan,blackhand,1079,priest,discipline,66,23,43
Hetha,tarren-mill,1076,priest,discipline,24,16,8
Waxosc,silvermoon,1076,priest,discipline,62,25,37
Deckardkain,pozzo-delleternità,1075,priest,discipline,36,20,16
Ghostroller,ravencrest,1075,priest,discipline,23,12,11
Lunairess,silvermoon,1069,priest,discipline,60,16,44
Mournus,defias-brotherhood,1065,priest,discipline,17,12,5
Pleistras,magtheridon,1057,priest,discipline,34,21,13
Yânùx,aegwynn,1056,priest,discipline,12,11,1
Elsuzette,hyjal,1056,priest,discipline,16,12,4
Asgà,stormscale,1056,priest,discipline,18,11,7
Watchmedark,ravencrest,1056,priest,discipline,24,11,13
Stormmyy,kazzak,1056,priest,discipline,24,11,13
Snuskong,kazzak,1056,priest,discipline,30,11,19
Akaria,kelthuzad,1056,priest,discipline,30,11,19
Ashenflexj,draenor,1055,priest,discipline,18,11,7
Psjk,blackrock,1055,priest,discipline,23,13,10
Pureàngel,ravencrest,1055,priest,discipline,24,11,13
Yungblessing,stormscale,1055,priest,discipline,24,11,13
Cptisus,draenor,1055,priest,discipline,30,11,19
Sosabgd,azjolnerub,1054,priest,discipline,18,11,7
Horrðr,kazzak,1054,priest,discipline,18,11,7
Gajos,frostwolf,1054,priest,discipline,18,11,7
Strawhât,eredar,1054,priest,discipline,18,11,7
Deicidex,blackrock,1054,priest,discipline,30,11,19
Flaskandeux,tarren-mill,1054,priest,discipline,38,11,27
Tÿona,hyjal,1053,priest,discipline,18,11,7
Sølvfox,stormscale,1053,priest,discipline,18,11,7
Liviúss,draenor,1053,priest,discipline,24,11,13
Softie,zuljin,1052,priest,discipline,18,11,7
Trénboloné,tarren-mill,1052,priest,discipline,24,11,13
Devotedape,draenor,1052,priest,discipline,24,11,13
Mautijr,blackrock,1050,priest,discipline,23,14,9
Junglepriest,ravencrest,1050,priest,discipline,24,11,13
Angelic,ragnaros,1050,priest,discipline,30,11,19
Hashoko,draenor,1048,priest,discipline,12,11,1
Sanril,ragnaros,1048,priest,discipline,24,11,13
Neseig,blutkessel,1047,priest,discipline,18,11,7
Prellish,draenor,1047,priest,discipline,24,11,13
Ichpvpeuch,eredar,1046,priest,discipline,24,11,13
Jeanpipe,khaz-modan,1044,priest,discipline,12,11,1
Needmana,hyjal,1044,priest,discipline,36,15,21
Kaos,anetheron,1043,priest,discipline,15,13,2
Hardloker,ravencrest,1043,priest,discipline,24,11,13
Подчинись,ashenvale,1042,priest,discipline,24,11,13
Liliashet,sanguino,1038,priest,discipline,18,11,7
Chillx,blackmoore,1037,priest,discipline,81,44,37
Khai,tarren-mill,1037,priest,discipline,49,26,23
Loetharion,archimonde,1032,priest,discipline,18,11,7
Limpopon,doomhammer,1031,priest,discipline,30,11,19
Jconnelly,antonidas,1023,priest,discipline,20,12,8
Borgír,burning-legion,1021,priest,discipline,23,11,12
Sòsò,archimonde,1018,priest,discipline,60,25,35
Therealopa,blackmoore,1016,priest,discipline,67,30,37
Фрустрациия,soulflayer,1013,priest,discipline,20,12,8
Фурлена,blackscar,1011,priest,discipline,23,11,12
Gaalonikus,blackmoore,1008,priest,discipline,21,12,9
Zurlyne,ravencrest,1007,priest,discipline,21,12,9
Discoruzki,ravencrest,1007,priest,discipline,23,11,12
Assiduous,stormreaver,1002,priest,discipline,20,12,8
Mijuuk,zuljin,1000,priest,discipline,36,23,13
Îndura,drakthul,993,priest,discipline,61,30,31
Negativeapm,archimonde,991,priest,discipline,17,11,6
Boomhilde,aegwynn,987,priest,discipline,113,54,59
Huzlin,kazzak,983,priest,discipline,28,11,17
Ciri,die-aldor,975,priest,discipline,19,11,8
Borrex,sanguino,971,priest,discipline,13,11,2
Stargal,blackmoore,960,priest,discipline,12,10,2
Flensu,stormscale,960,priest,discipline,12,10,2
Krematorio,twisting-nether,960,priest,discipline,18,10,8
Bekznfiend,ragnaros,960,priest,discipline,18,10,8
Ринкуку,howling-fjord,960,priest,discipline,18,10,8
Ohlinsqt,outland,960,priest,discipline,18,10,8
Gerryqt,draenor,960,priest,discipline,24,10,14
Rngamer,silvermoon,959,priest,discipline,12,10,2
Cx,mazrigos,959,priest,discipline,12,10,2
Casic,blackhand,959,priest,discipline,12,10,2
Ðaala,blackrock,959,priest,discipline,18,10,8
Hïstërïä,silvermoon,959,priest,discipline,18,10,8
Waffur,twisting-nether,959,priest,discipline,18,10,8
Moglimeister,blackrock,959,priest,discipline,18,10,8
Yaoz,sanguino,959,priest,discipline,18,10,8
Рыжаякискис,soulflayer,959,priest,discipline,18,10,8
Андерприст,soulflayer,959,priest,discipline,24,10,14
Aurorä,burning-legion,959,priest,discipline,24,10,14
Loliheal,blackmoore,959,priest,discipline,28,11,17
Fatalx,grim-batol,958,priest,discipline,16,11,5
Joeelz,blackmoore,958,priest,discipline,18,10,8
Vynivan,korgall,958,priest,discipline,18,10,8
Kolinamenus,dun-morogh,958,priest,discipline,24,10,14
Èlysium,grim-batol,958,priest,discipline,24,10,14
Discipleotl,stormscale,957,priest,discipline,12,10,2
Hellsaya,ysondre,957,priest,discipline,12,10,2
Mamis,anetheron,957,priest,discipline,24,10,14
Yøzø,blackhand,957,priest,discipline,57,22,35
Вейтарен,gordunni,957,priest,discipline,30,10,20
Cidrea,saurfang,956,priest,discipline,18,10,8
Quinax,shattered-hand,956,priest,discipline,18,10,8
Dalylla,aggra-português,956,priest,discipline,18,10,8
Chimara,eredar,955,priest,discipline,18,10,8
Dstars,archimonde,955,priest,discipline,24,10,14
Zyrexan,defias-brotherhood,955,priest,discipline,30,10,20
Chilltcaster,blackrock,954,priest,discipline,26,10,16
Tristar,nethersturm,953,priest,discipline,18,10,8
Calsote,sanguino,952,priest,discipline,30,10,20
Salskagripme,ragnaros,950,priest,discipline,12,10,2
Mirelaw,stormscale,949,priest,discipline,18,10,8
Desperion,ragnaros,949,priest,discipline,24,10,14
Seum,ravencrest,945,priest,discipline,24,10,14
Заплетальщик,howling-fjord,942,priest,discipline,40,20,20
Perlo,sanguino,940,priest,discipline,71,37,34
Pavyone,twisting-nether,926,priest,discipline,23,10,13
Amysantiàgo,sylvanas,924,priest,discipline,17,10,7
Meodor,antonidas,923,priest,discipline,24,14,10
Voidvania,drakthul,922,priest,discipline,17,10,7
Kallsen,ravencrest,920,priest,discipline,27,15,12
Аргла,soulflayer,915,priest,discipline,30,10,20
Notnøw,silvermoon,911,priest,discipline,17,10,7
Titibolls,sanguino,908,priest,discipline,23,10,13
Nunnis,kazzak,906,priest,discipline,60,30,30
Mocnymaco,burning-blade,905,priest,discipline,37,14,23
Socratés,antonidas,886,priest,discipline,42,17,25
Unleet,sylvanas,885,priest,discipline,28,11,17
Praystatîon,dragonblight,882,priest,discipline,31,17,14
Shnookfour,agamaggan,882,priest,discipline,22,12,10
Shyria,argent-dawn,878,priest,discipline,17,10,7
Mungam,draenor,878,priest,discipline,23,10,13
Moinmeister,frostmourne,876,priest,discipline,17,10,7
Toks,stormscale,871,priest,discipline,45,10,35
Elfiontko,burning-legion,870,priest,discipline,24,11,13
Aladorius,la-croisade-écarlate,867,priest,discipline,22,10,12
Lexojam,ravencrest,864,priest,discipline,12,9,3
Pohja,veknilash,864,priest,discipline,12,9,3
Priéstitude,kazzak,864,priest,discipline,12,9,3
Билетлолпро,borean-tundra,864,priest,discipline,12,9,3
Qpapi,quelthalas,864,priest,discipline,12,9,3
Concetto,nazjatar,864,priest,discipline,12,9,3
Антошашвп,azuregos,864,priest,discipline,18,9,9
Viu,eredar,864,priest,discipline,18,9,9
Secø,sylvanas,864,priest,discipline,18,9,9
Sørcedote,dun-modr,864,priest,discipline,18,9,9
Donpedrila,kazzak,864,priest,discipline,18,9,9
Жентельмен,deathguard,864,priest,discipline,18,9,9
Djros,magtheridon,864,priest,discipline,18,9,9
Леддигага,gordunni,864,priest,discipline,18,9,9
Whýççpèrx,ravencrest,864,priest,discipline,18,9,9
Itsdiscobaby,auchindoun,864,priest,discipline,24,9,15
Chocomiette,archimonde,864,priest,discipline,25,9,16
Otheym,the-maelstrom,863,priest,discipline,12,9,3
Duqes,stormreaver,863,priest,discipline,12,9,3
Dankopriest,drakthul,863,priest,discipline,12,9,3
Shadowmend,aegwynn,863,priest,discipline,12,9,3
Ihaveibs,doomhammer,863,priest,discipline,18,9,9
Gulch,blackmoore,863,priest,discipline,18,9,9
Darkprofit,aegwynn,863,priest,discipline,18,9,9
Markianos,silvermoon,863,priest,discipline,18,9,9
Эйвиг,blackscar,863,priest,discipline,18,9,9
Grêy,dun-modr,863,priest,discipline,18,9,9
Pedopräst,stormscale,863,priest,discipline,18,9,9
Nooway,kazzak,863,priest,discipline,24,9,15
Xyliqa,aegwynn,863,priest,discipline,24,9,15
Artì,kazzak,863,priest,discipline,24,9,15
Fulgus,sanguino,863,priest,discipline,30,9,21
Joeshmoex,blackrock,862,priest,discipline,12,9,3
Mtbalt,tarren-mill,862,priest,discipline,12,9,3
Ceraghk,tichondrius,862,priest,discipline,12,9,3
Søkariss,elune,862,priest,discipline,12,9,3
Gnomeeater,silvermoon,862,priest,discipline,12,9,3
Olereo,blackhand,862,priest,discipline,18,9,9
Skyalpha,silvermoon,862,priest,discipline,18,9,9
Littleheal,ghostlands,861,priest,discipline,18,9,9
Benificent,argent-dawn,861,priest,discipline,22,9,13
Drüdkh,tarren-mill,861,priest,discipline,30,9,21
Littleabs,the-maelstrom,858,priest,discipline,12,9,3
Маимморта,howling-fjord,858,priest,discipline,18,9,9
Priestige,spinebreaker,858,priest,discipline,18,9,9
Щявыхилим,howling-fjord,857,priest,discipline,13,9,4
Daddyfinger,argent-dawn,857,priest,discipline,18,9,9
Fingerblast,sanguino,853,priest,discipline,18,9,9
Bálíé,blackmoore,846,priest,discipline,18,9,9
Evastemplar,turalyon,836,priest,discipline,24,9,15
Steadyog,doomhammer,835,priest,discipline,12,9,3
Amaretta,perenolde,833,priest,discipline,20,11,9
Spooka,ravencrest,831,priest,discipline,17,9,8
Illuminarexo,sylvanas,831,priest,discipline,17,9,8
Kaldhor,ysondre,831,priest,discipline,23,9,14
Noviriel,argent-dawn,831,priest,discipline,23,9,14
Mílérí,ravencrest,830,priest,discipline,23,9,14
Ladá,stormscale,815,priest,discipline,19,9,10
Xghazo,sylvanas,809,priest,discipline,15,9,6
Eßola,silvermoon,809,priest,discipline,20,10,10
Paine,pozzo-delleternità,809,priest,discipline,19,9,10
Давалкасвета,gordunni,807,priest,discipline,27,10,17
Maerlene,nemesis,800,priest,discipline,22,9,13
Dhassy,sanguino,799,priest,discipline,11,9,2
Pillian,nordrassil,799,priest,discipline,16,9,7
Tremrfinger,dun-modr,798,priest,discipline,14,9,5
Протомуу,gordunni,783,priest,discipline,11,9,2
Gobblestick,draenor,768,priest,discipline,12,8,4
Gothicpriest,blackrock,768,priest,discipline,12,8,4
Nolnilian,archimonde,768,priest,discipline,12,8,4
Bambus,shattered-hand,768,priest,discipline,12,8,4
Cathocrasty,draenor,768,priest,discipline,12,8,4
Imsaltyxd,tarren-mill,768,priest,discipline,12,8,4
Shdwxy,blackrock,768,priest,discipline,12,8,4
Orkanwal,ravencrest,768,priest,discipline,12,8,4
Raeratwo,archimonde,768,priest,discipline,12,8,4
Oldnbad,archimonde,768,priest,discipline,12,8,4
Tryhàrdx,stormscale,768,priest,discipline,12,8,4
Anabølix,ravencrest,768,priest,discipline,12,8,4
Cizer,kazzak,768,priest,discipline,12,8,4
Joeblowx,blackrock,768,priest,discipline,12,8,4
Xandrial,blackmoore,768,priest,discipline,12,8,4
Pikaboom,the-maelstrom,768,priest,discipline,18,8,10
Yuukii,kult-der-verdammten,768,priest,discipline,18,8,10
Aelíth,archimonde,768,priest,discipline,18,8,10
Frígídhealz,outland,768,priest,discipline,18,8,10
Reflector,sunstrider,768,priest,discipline,18,8,10
Plsdontcry,blackrock,768,priest,discipline,18,8,10
Flào,draenor,768,priest,discipline,18,8,10
Kêkwshádêzz,blackmoore,768,priest,discipline,18,8,10
Dendegodx,kazzak,768,priest,discipline,18,8,10
Theblank,pozzo-delleternità,768,priest,discipline,18,8,10
Jumby,outland,768,priest,discipline,18,8,10
Nstp,zuljin,768,priest,discipline,18,8,10
Infamoussftw,drakthul,768,priest,discipline,18,8,10
Phyxiusx,stormscale,768,priest,discipline,18,8,10
Keryin,draenor,768,priest,discipline,24,8,16
Ðelftware,tarren-mill,767,priest,discipline,12,8,4
Xaerah,blackmoore,767,priest,discipline,12,8,4
Rher,blackmoore,767,priest,discipline,12,8,4
Freaki,blackrock,767,priest,discipline,12,8,4
Gobie,sunstrider,767,priest,discipline,12,8,4
Kletroll,archimonde,767,priest,discipline,12,8,4
Aurunea,blackrock,767,priest,discipline,12,8,4
Jakeow,auchindoun,767,priest,discipline,12,8,4
Brênos,blackmoore,767,priest,discipline,12,8,4
Вурти,howling-fjord,767,priest,discipline,18,8,10
Eördög,ragnaros,767,priest,discipline,18,8,10
Eluveitieq,kazzak,767,priest,discipline,18,8,10
Kitanai,silvermoon,767,priest,discipline,18,8,10
Smokäy,blackhand,767,priest,discipline,18,8,10
Arwén,zuljin,767,priest,discipline,18,8,10
Icyc,outland,767,priest,discipline,36,8,28
Worstdisceu,draenor,766,priest,discipline,12,8,4
Ráka,earthen-ring,766,priest,discipline,12,8,4
Nostramo,kirin-tor,766,priest,discipline,18,8,10
Мегаствол,howling-fjord,766,priest,discipline,18,8,10
Zâdra,malganis,766,priest,discipline,18,8,10
Deadpxlz,ravencrest,766,priest,discipline,18,8,10
Baybe,ravencrest,765,priest,discipline,12,8,4
Getötet,blackrock,765,priest,discipline,18,8,10
Pocketsimp,stormscale,765,priest,discipline,18,8,10
Wandéline,arathi,765,priest,discipline,24,8,16
Buttafly,archimonde,764,priest,discipline,18,8,10
Mefeon,draenor,763,priest,discipline,18,8,10
Togx,silvermoon,763,priest,discipline,18,8,10
Joebando,ravencrest,763,priest,discipline,18,8,10
Nightshådøw,silvermoon,762,priest,discipline,22,10,12
Boyraz,argent-dawn,760,priest,discipline,18,8,10
Deathspawn,hellscream,757,priest,discipline,12,8,4
Jeuwls,argent-dawn,756,priest,discipline,18,8,10
Sîanah,archimonde,754,priest,discipline,12,8,4
Йуп,ashenvale,735,priest,discipline,16,9,7
Ислейн,howling-fjord,735,priest,discipline,29,8,21
Blorpan,tarren-mill,734,priest,discipline,26,9,17
Prazefin,twisting-nether,733,priest,discipline,10,9,1
Aeo,twisting-nether,731,priest,discipline,17,8,9
Cthultist,dun-modr,728,priest,discipline,26,9,17
Syreet,silvermoon,714,priest,discipline,34,9,25
Greenlizard,stormreaver,704,priest,discipline,22,8,14
Sacerdotini,outland,702,priest,discipline,19,9,10
Sissi,blackmoore,701,priest,discipline,16,8,8
Nésha,dun-modr,686,priest,discipline,11,8,3
Trixix,ragnaros,684,priest,discipline,14,8,6
Obbdasknob,ravencrest,672,priest,discipline,12,7,5
Lahammy,kazzak,672,priest,discipline,12,7,5
Vo,dentarg,672,priest,discipline,12,7,5
Ezcobar,twilights-hammer,672,priest,discipline,12,7,5
Furtnajebany,tarren-mill,672,priest,discipline,12,7,5
Репабликуес,gordunni,672,priest,discipline,12,7,5
Binkx,tarren-mill,672,priest,discipline,12,7,5
Sydnex,blackmoore,672,priest,discipline,12,7,5
Dombili,frostmane,672,priest,discipline,12,7,5
Bunnygxrl,ravencrest,672,priest,discipline,12,7,5
Xraid,blackmoore,672,priest,discipline,12,7,5
Longheals,stormscale,672,priest,discipline,12,7,5
Garsdal,tarren-mill,672,priest,discipline,12,7,5
Kuqezi,archimonde,672,priest,discipline,12,7,5
Wurstpriest,silvermoon,672,priest,discipline,12,7,5
Bebydaniwey,eredar,672,priest,discipline,12,7,5
Mdmaster,stormreaver,672,priest,discipline,12,7,5
Убивал,soulflayer,672,priest,discipline,12,7,5
Лайбаси,howling-fjord,672,priest,discipline,12,7,5
Durness,argent-dawn,672,priest,discipline,12,7,5
Smiteweaver,drakthul,672,priest,discipline,12,7,5
Plåster,dunemaul,672,priest,discipline,12,7,5
Goodra,sylvanas,672,priest,discipline,12,7,5
Найтингеилл,gordunni,672,priest,discipline,12,7,5
Chuckline,eredar,672,priest,discipline,12,7,5
Anyndra,twisting-nether,672,priest,discipline,12,7,5
Healicious,teldrassil,672,priest,discipline,12,7,5
Nihpolz,ragnaros,672,priest,discipline,12,7,5
Kleot,ragnaros,672,priest,discipline,12,7,5
Spìrít,ghostlands,672,priest,discipline,12,7,5
Wyrofear,ragnaros,672,priest,discipline,12,7,5
Infandus,pozzo-delleternità,672,priest,discipline,12,7,5
Sehek,sanguino,672,priest,discipline,12,7,5
Pattie,ragnaros,672,priest,discipline,12,7,5
Carnegi,burning-legion,672,priest,discipline,12,7,5
Arize,dun-modr,672,priest,discipline,12,7,5
Giily,archimonde,672,priest,discipline,12,7,5
Gudjon,dragonblight,672,priest,discipline,12,7,5
Ominoushell,twisting-nether,672,priest,discipline,15,7,8
Halysis,chamber-of-aspects,672,priest,discipline,16,7,9
Undeadpriest,aegwynn,672,priest,discipline,18,7,11
Бенджаминлол,blackscar,672,priest,discipline,18,7,11
Свдпро,soulflayer,672,priest,discipline,18,7,11
Miklós,die-aldor,672,priest,discipline,18,7,11
Themistia,kazzak,672,priest,discipline,18,7,11
Gød,magtheridon,672,priest,discipline,18,7,11
Cház,dun-modr,672,priest,discipline,18,7,11
Wifta,ravencrest,672,priest,discipline,18,7,11
Enzysama,sanguino,672,priest,discipline,18,7,11
Ðanilosp,dun-modr,672,priest,discipline,18,7,11
Nancey,draenor,672,priest,discipline,18,7,11
Xîz,silvermoon,672,priest,discipline,18,7,11
Gurgaue,argent-dawn,672,priest,discipline,18,7,11
Cáss,archimonde,672,priest,discipline,18,7,11
Mysticforces,silvermoon,672,priest,discipline,18,7,11
Dotreveal,ravencrest,672,priest,discipline,21,8,13
Drwho,zuljin,672,priest,discipline,21,8,13
Péntagón,festung-der-stürme,672,priest,discipline,24,7,17
Mixoo,throkferoth,672,priest,discipline,24,7,17
Exaneo,ragnaros,672,priest,discipline,24,7,17
Mafakor,ravencrest,672,priest,discipline,24,7,17
Aeritha,blackmoore,671,priest,discipline,12,7,5
Ylivoima,stormscale,671,priest,discipline,12,7,5
Sabaxdxd,dun-modr,671,priest,discipline,12,7,5
Fargall,eonar,671,priest,discipline,12,7,5
Prost,aerie-peak,671,priest,discipline,12,7,5
Ebolaidman,ravencrest,671,priest,discipline,12,7,5
Aiewn,elune,671,priest,discipline,12,7,5
Chokmâh,sanguino,671,priest,discipline,12,7,5
Carnacia,tarren-mill,671,priest,discipline,12,7,5
Xharyo,ravencrest,671,priest,discipline,16,7,9
Vregoa,twisting-nether,671,priest,discipline,18,7,11
Lezz,ragnaros,671,priest,discipline,18,7,11
Kbakå,kazzak,671,priest,discipline,20,7,13
Zatón,dun-modr,671,priest,discipline,24,7,17
Holyfussell,antonidas,671,priest,discipline,24,7,17
Clua,draenor,670,priest,discipline,12,7,5
Arenarooky,eredar,670,priest,discipline,12,7,5
Nobbisnice,drakthul,670,priest,discipline,12,7,5
Ràthaløs,sanguino,670,priest,discipline,12,7,5
Orqz,anetheron,670,priest,discipline,12,7,5
Asolan,drakthul,670,priest,discipline,18,7,11
Makkalisser,kazzak,670,priest,discipline,24,7,17
Prognosis,frostwhisper,669,priest,discipline,12,7,5
Johnnypleb,blackrock,669,priest,discipline,12,7,5
Bomzhik,silvermoon,669,priest,discipline,12,7,5
Enlîl,zuljin,669,priest,discipline,12,7,5
Reighl,drakthul,669,priest,discipline,12,7,5
Mescaminator,blackmoore,668,priest,discipline,18,7,11
Míjagí,blackhand,668,priest,discipline,22,8,14
Angusbeêf,blackrock,667,priest,discipline,12,7,5
Avor,hellfire,665,priest,discipline,12,7,5
Inaeries,argent-dawn,664,priest,discipline,12,7,5
Buzzard,frostmourne,662,priest,discipline,12,7,5
Redøm,stormreaver,655,priest,discipline,18,8,10
Nilsatis,grim-batol,644,priest,discipline,53,19,34
Tori,marécage-de-zangar,639,priest,discipline,14,8,6
Sigor,hellfire,634,priest,discipline,11,7,4
Zthul,draenor,624,priest,discipline,15,8,7
Darktattoo,twisting-nether,621,priest,discipline,21,8,13
Türapea,draenor,620,priest,discipline,11,7,4
Solaní,antonidas,617,priest,discipline,20,9,11
Aliciakeys,twilights-hammer,607,priest,discipline,16,7,9
Diccen,twilights-hammer,592,priest,discipline,13,7,6
Смотривнебоь,soulflayer,592,priest,discipline,13,7,6
Pouffi,garona,576,priest,discipline,6,6,0
Táliss,arthas,576,priest,discipline,6,6,0
Vædan,drakthul,576,priest,discipline,6,6,0
Vèrcs,silvermoon,576,priest,discipline,6,6,0
Juhduss,tarren-mill,576,priest,discipline,6,6,0
Menarille,kazzak,576,priest,discipline,6,6,0
Holytopp,aegwynn,576,priest,discipline,6,6,0
Leahuwu,ravencrest,576,priest,discipline,12,6,6
Swkunz,dun-modr,576,priest,discipline,12,6,6
Kankstery,kazzak,576,priest,discipline,12,6,6
Sensimiya,dalaran,576,priest,discipline,12,6,6
Dunkelseele,ahnqiraj,576,priest,discipline,12,6,6
Prsx,ravencrest,576,priest,discipline,12,6,6
Animalrescue,draenor,576,priest,discipline,12,6,6
Ÿolo,nemesis,576,priest,discipline,12,6,6
Yugata,archimonde,576,priest,discipline,12,6,6
Jämar,archimonde,576,priest,discipline,12,6,6
Akemmì,sylvanas,576,priest,discipline,12,6,6
Ðèvì,ravencrest,576,priest,discipline,12,6,6
Towelie,stormscale,576,priest,discipline,12,6,6
Scortie,blackrock,576,priest,discipline,12,6,6
Yroe,gorgonnash,576,priest,discipline,12,6,6
Jmp,tarren-mill,576,priest,discipline,12,6,6
Angrypiex,stormscale,576,priest,discipline,12,6,6
Teradros,blackhand,576,priest,discipline,12,6,6
Mindx,sylvanas,576,priest,discipline,12,6,6
Muant,twisting-nether,576,priest,discipline,12,6,6
Lowery,argent-dawn,576,priest,discipline,12,6,6
Dotmaker,sanguino,576,priest,discipline,12,6,6
Bindw,tarren-mill,576,priest,discipline,12,6,6
Boysa,earthen-ring,576,priest,discipline,12,6,6
Омилая,gordunni,576,priest,discipline,12,6,6
Størmblaze,stormreaver,576,priest,discipline,12,6,6
Ènma,archimonde,576,priest,discipline,12,6,6
Legitha,blackmoore,576,priest,discipline,12,6,6
Ballarr,burning-legion,576,priest,discipline,12,6,6
Kolinamenuss,dun-morogh,576,priest,discipline,12,6,6
Mïxa,eitrigg,576,priest,discipline,12,6,6
Родохрозит,blackscar,576,priest,discipline,12,6,6
Skevitche,hyjal,576,priest,discipline,12,6,6
Stee,sylvanas,576,priest,discipline,12,6,6
Popor,archimonde,576,priest,discipline,12,6,6
Rune,ravencrest,576,priest,discipline,12,6,6
Krokkete,hyjal,576,priest,discipline,12,6,6
Yro,gorgonnash,576,priest,discipline,12,6,6
Ømñyx,outland,576,priest,discipline,12,6,6
Supernal,twisting-nether,576,priest,discipline,12,6,6
Aia,tyrande,576,priest,discipline,12,6,6
Dõrà,ravencrest,576,priest,discipline,12,6,6
Piperxp,ravencrest,576,priest,discipline,12,6,6
Disillusíon,tarren-mill,576,priest,discipline,18,6,12
Nêlumar,aegwynn,576,priest,discipline,18,6,12
Kîlo,sylvanas,576,priest,discipline,18,6,12
Cylantharia,eredar,576,priest,discipline,18,6,12
Verti,outland,576,priest,discipline,18,6,12
Alros,elune,576,priest,discipline,18,6,12
Dyliz,stormscale,576,priest,discipline,18,6,12
Próxs,ravencrest,576,priest,discipline,18,6,12
Алуриэлия,gordunni,576,priest,discipline,18,6,12
Cinjá,thrall,576,priest,discipline,19,6,13
Gertie,blackhand,575,priest,discipline,6,6,0
Zembowae,drakthul,575,priest,discipline,12,6,6
Lillthya,kazzak,575,priest,discipline,12,6,6
Pulttipiispa,ravencrest,575,priest,discipline,12,6,6
Kipnuggetz,burning-legion,575,priest,discipline,12,6,6
Yvaini,xavius,575,priest,discipline,12,6,6
Tira,darksorrow,575,priest,discipline,12,6,6
Vempress,neptulon,575,priest,discipline,12,6,6
Byxoph,sanguino,575,priest,discipline,12,6,6
Ðotgød,nemesis,575,priest,discipline,12,6,6
Valeriana,stormreaver,575,priest,discipline,12,6,6
Hidr,nemesis,575,priest,discipline,12,6,6
Empí,sanguino,575,priest,discipline,12,6,6
Flackiepi,tarren-mill,575,priest,discipline,12,6,6
Hensynsløs,draenor,575,priest,discipline,12,6,6
Фионыч,blackscar,575,priest,discipline,12,6,6
Handmännchen,kelthuzad,575,priest,discipline,12,6,6
Priestvnr,hyjal,575,priest,discipline,12,6,6
Hâmmel,blackrock,575,priest,discipline,12,6,6
Yante,ragnaros,575,priest,discipline,12,6,6
Hypnòz,archimonde,575,priest,discipline,12,6,6
Noskan,silvermoon,575,priest,discipline,15,7,8
Juco,draenor,575,priest,discipline,18,6,12
Тэвиель,gordunni,575,priest,discipline,24,6,18
Вэстервилли,howling-fjord,575,priest,discipline,24,6,18
Duaijhutari,outland,574,priest,discipline,12,6,6
Draenera,silvermoon,574,priest,discipline,12,6,6
Tindoriel,bronzebeard,574,priest,discipline,12,6,6
Prigart,sylvanas,574,priest,discipline,18,6,12
Nerul,twisting-nether,574,priest,discipline,19,6,13
Kreem,frostmane,573,priest,discipline,12,6,6
Milessa,steamwheedle-cartel,573,priest,discipline,24,6,18
Drioz,ysondre,572,priest,discipline,12,6,6
Timmemeep,outland,572,priest,discipline,12,6,6
Äwësömë,aggra-português,571,priest,discipline,12,6,6
Glutenhode,stormscale,571,priest,discipline,12,6,6
Vepa,blackrock,566,priest,discipline,16,6,10
Shalacho,blackrock,566,priest,discipline,24,6,18
Grimdream,ragnaros,544,priest,discipline,16,6,10
Derylium,kazzak,542,priest,discipline,11,6,5
Sensor,kazzak,528,priest,discipline,9,6,3
Rahan,stormscale,527,priest,discipline,12,7,5
Fricia,zuljin,527,priest,discipline,11,6,5
Lydîâ,blackhand,527,priest,discipline,11,6,5
Lauriinda,culte-de-la-rive-noire,522,priest,discipline,13,7,6
Triuna,sylvanas,522,priest,discipline,17,8,9
Demmi,dun-modr,522,priest,discipline,22,7,15
Полуниця,galakrond,522,priest,discipline,23,7,16
Cummask,silvermoon,512,priest,discipline,16,6,10
Tepevelf,dun-modr,512,priest,discipline,22,6,16
Никорете,soulflayer,511,priest,discipline,11,6,5
Nnaoy,ysondre,511,priest,discipline,14,6,8
Disconsick,vashj,511,priest,discipline,26,6,20
Ноубадди,howling-fjord,509,priest,discipline,15,6,9
Teyranamin,defias-brotherhood,496,priest,discipline,7,6,1
Blååb,draenor,496,priest,discipline,13,6,7
Nazo,sylvanas,493,priest,discipline,13,6,7
Sorchad,hyjal,480,priest,discipline,6,5,1
Xghj,sylvanas,480,priest,discipline,6,5,1
Loldisc,arthas,480,priest,discipline,6,5,1
Paìnz,blackhand,480,priest,discipline,6,5,1
Chôrdi,aegwynn,480,priest,discipline,6,5,1
Eladri,silvermoon,480,priest,discipline,6,5,1
Darkshdwbrst,malorne,480,priest,discipline,6,5,1
Fantästic,kazzak,480,priest,discipline,6,5,1
Centaurio,nemesis,480,priest,discipline,6,5,1
Violentha,silvermoon,480,priest,discipline,6,5,1
Vandansk,kazzak,480,priest,discipline,6,5,1
Thedisco,kazzak,480,priest,discipline,6,5,1
Golletz,twisting-nether,480,priest,discipline,6,5,1
Swep,ragnaros,480,priest,discipline,6,5,1
Yungmazikeen,archimonde,480,priest,discipline,6,5,1
Lamp,terokkar,480,priest,discipline,6,5,1
Undeathy,ravencrest,480,priest,discipline,6,5,1
Ronnmoss,defias-brotherhood,480,priest,discipline,6,5,1
Bindww,tarren-mill,480,priest,discipline,6,5,1
Ayõu,ravencrest,480,priest,discipline,6,5,1
Kâiøxx,outland,480,priest,discipline,6,5,1
Nayballistic,tarren-mill,480,priest,discipline,6,5,1
Trippinorbs,stormscale,480,priest,discipline,6,5,1
Rîeka,antonidas,480,priest,discipline,6,5,1
Trntypr,senjin,480,priest,discipline,6,5,1
Lmnsqzy,ravencrest,480,priest,discipline,6,5,1
Нэриэлл,gordunni,480,priest,discipline,6,5,1
Rixfoulah,ysondre,480,priest,discipline,6,5,1
Nimuëh,ragnaros,480,priest,discipline,10,6,4
Aêalama,argent-dawn,480,priest,discipline,12,5,7
Epa,zuljin,480,priest,discipline,12,5,7
Mayday,silvermoon,480,priest,discipline,12,5,7
Holyasprin,sylvanas,480,priest,discipline,12,5,7
Chaosxo,draenor,480,priest,discipline,12,5,7
Suaakypriest,tyrande,480,priest,discipline,12,5,7
Bimbax,dun-modr,480,priest,discipline,12,5,7
Nastynina,frostwhisper,480,priest,discipline,12,5,7
Косн,razuvious,480,priest,discipline,12,5,7
Дъикиймвп,deepholm,480,priest,discipline,12,5,7
Magthalor,twisting-nether,480,priest,discipline,12,5,7
Navihato,silvermoon,480,priest,discipline,12,5,7
Уер,galakrond,480,priest,discipline,12,5,7
Karoopi,ysondre,480,priest,discipline,12,5,7
Yânux,aegwynn,480,priest,discipline,12,5,7
Roylian,ravencrest,480,priest,discipline,12,5,7
Swiftdemise,sylvanas,480,priest,discipline,12,5,7
Healenax,ravencrest,480,priest,discipline,12,5,7
Jeboc,ravencrest,480,priest,discipline,12,5,7
Wet,twisting-nether,480,priest,discipline,12,5,7
Nirsis,dun-modr,480,priest,discipline,12,5,7
Arythc,ahnqiraj,480,priest,discipline,12,5,7
Massdispell,silvermoon,480,priest,discipline,12,5,7
Абсорбиболь,howling-fjord,480,priest,discipline,12,5,7
Prästbaazil,ragnaros,480,priest,discipline,12,5,7
Omnissiiah,silvermoon,480,priest,discipline,12,5,7
Litera,silvermoon,480,priest,discipline,12,5,7
Вайтбласт,howling-fjord,480,priest,discipline,12,5,7
Саксесфул,howling-fjord,480,priest,discipline,12,5,7
Råcòøñ,ravencrest,480,priest,discipline,12,5,7
Baloopriest,grim-batol,480,priest,discipline,12,5,7
Meheal,lothar,480,priest,discipline,12,5,7
Nyù,kazzak,480,priest,discipline,12,5,7
Azrella,ravencrest,480,priest,discipline,12,5,7
Seankingkong,ravencrest,480,priest,discipline,12,5,7
Karanas,archimonde,480,priest,discipline,12,5,7
Borgamor,frostmane,480,priest,discipline,12,5,7
Seskipr,stormreaver,480,priest,discipline,12,5,7
Ananous,hyjal,480,priest,discipline,12,5,7
Deadsloth,hyjal,480,priest,discipline,12,5,7
Tabaç,stormscale,480,priest,discipline,12,5,7
Nhajÿ,hyjal,480,priest,discipline,12,5,7
Døtzillah,kazzak,480,priest,discipline,12,5,7
Yukîna,blackrock,480,priest,discipline,12,5,7
Medivs,blackmoore,480,priest,discipline,12,5,7
Grozozo,tarren-mill,480,priest,discipline,12,5,7
Bibleenjoyer,blackmoore,480,priest,discipline,12,5,7
Shadew,stormscale,480,priest,discipline,12,5,7
Rébörn,tarren-mill,480,priest,discipline,12,5,7
Nayballsp,tarren-mill,480,priest,discipline,12,5,7
Hollylicious,kazzak,480,priest,discipline,12,5,7
Donbas,tarren-mill,480,priest,discipline,12,5,7
Gumer,antonidas,480,priest,discipline,12,5,7
Ameja,sylvanas,480,priest,discipline,13,5,8
Ilostmybible,runetotem,480,priest,discipline,16,6,10
Biscuits,ravencrest,480,priest,discipline,18,5,13
Карбонит,fordragon,480,priest,discipline,18,5,13
Faouzia,argent-dawn,480,priest,discipline,18,5,13
Szycho,burning-legion,480,priest,discipline,18,5,13
Chekkó,blackrock,480,priest,discipline,18,5,13
Felvytwo,stormscale,480,priest,discipline,18,5,13
Taiyöshin,silvermoon,480,priest,discipline,18,5,13
Ча,thermaplugg,480,priest,discipline,18,5,13
Reìdood,stormscale,479,priest,discipline,6,5,1
Perxonx,twisting-nether,479,priest,discipline,6,5,1
Rhésùs,archimonde,479,priest,discipline,6,5,1
Deneye,thunderhorn,479,priest,discipline,9,6,3
Velenthan,stormrage,479,priest,discipline,12,5,7
Дэйвора,ashenvale,479,priest,discipline,12,5,7
Janclod,pozzo-delleternità,479,priest,discipline,12,5,7
Velenthøs,argent-dawn,479,priest,discipline,12,5,7
Sewerperson,doomhammer,479,priest,discipline,12,5,7
Veecna,the-maelstrom,479,priest,discipline,12,5,7
Zofa,sunstrider,479,priest,discipline,12,5,7
Stigmata,auchindoun,479,priest,discipline,12,5,7
Cobrix,nemesis,479,priest,discipline,12,5,7
Quepimquepam,tarren-mill,479,priest,discipline,18,5,13
Sleeyz,blackmoore,479,priest,discipline,24,5,19
Hotwheal,ysondre,478,priest,discipline,12,5,7
Healheal,outland,477,priest,discipline,12,5,7
Phosphorus,blackhand,476,priest,discipline,12,5,7
Sednâ,conseil-des-ombres,463,priest,discipline,11,5,6
Synxii,ravencrest,448,priest,discipline,10,5,5
Rulz,zuluhed,446,priest,discipline,11,5,6
Rodshun,dun-modr,431,priest,discipline,17,5,12
Лимоняшечка,soulflayer,426,priest,discipline,14,6,8
Sixeus,outland,426,priest,discipline,14,6,8
Kårejonny,tarren-mill,425,priest,discipline,8,6,2
Шруня,howling-fjord,400,priest,discipline,24,5,19
Mazikeen,stormscale,384,priest,discipline,6,4,2
Sinîra,frostwolf,384,priest,discipline,6,4,2
Büssi,blackrock,384,priest,discipline,6,4,2
Buerak,tarren-mill,384,priest,discipline,6,4,2
Gorti,ravencrest,384,priest,discipline,6,4,2
Chilie,ravencrest,384,priest,discipline,6,4,2
Ssjx,ravencrest,384,priest,discipline,6,4,2
Gingerflexay,archimonde,384,priest,discipline,6,4,2
Limerençe,ravencrest,384,priest,discipline,6,4,2
Zyrean,bronzebeard,384,priest,discipline,6,4,2
Tâmshi,dun-modr,384,priest,discipline,6,4,2
Zumbae,tarren-mill,384,priest,discipline,6,4,2
Daniweyy,eredar,384,priest,discipline,6,4,2
Priestutute,tarren-mill,384,priest,discipline,6,4,2
Botstyleswdx,ravencrest,384,priest,discipline,6,4,2
Lemontea,frostwolf,384,priest,discipline,6,4,2
Iirina,draenor,384,priest,discipline,6,4,2
Stuhlgänger,blackhand,384,priest,discipline,6,4,2
Mohammedx,tarren-mill,384,priest,discipline,6,4,2
Nàlak,archimonde,384,priest,discipline,6,4,2
Quecum,draenor,384,priest,discipline,6,4,2
Pínx,nerathor,384,priest,discipline,6,4,2
Praywingsebb,nazjatar,384,priest,discipline,6,4,2
Gimcho,magtheridon,384,priest,discipline,6,4,2
Nevermyndz,blackmoore,384,priest,discipline,6,4,2
Reól,blackmoore,384,priest,discipline,6,4,2
Zeatt,ysera,384,priest,discipline,6,4,2
Relaxmom,bloodhoof,384,priest,discipline,6,4,2
Chuntriest,shadowsong,384,priest,discipline,6,4,2
Yukirito,drakthul,384,priest,discipline,6,4,2
Nesar,stormscale,384,priest,discipline,6,4,2
Dzyxx,ravencrest,384,priest,discipline,6,4,2
Hadk,blackrock,384,priest,discipline,6,4,2
Awön,stormscale,384,priest,discipline,6,4,2
Above,hyjal,384,priest,discipline,6,4,2
Pipperxp,ravencrest,384,priest,discipline,6,4,2
Кхарли,howling-fjord,384,priest,discipline,6,4,2
Healmebaby,kiljaeden,384,priest,discipline,6,4,2
Baptized,baelgun,384,priest,discipline,6,4,2
Neeti,kazzak,384,priest,discipline,6,4,2
Sinnestrike,tarren-mill,384,priest,discipline,6,4,2
Papynou,garona,384,priest,discipline,6,4,2
Pasalacabra,zuljin,384,priest,discipline,6,4,2
Helikipope,kazzak,384,priest,discipline,6,4,2
Pankp,kazzak,384,priest,discipline,6,4,2
Monstretpr,dragonblight,384,priest,discipline,6,4,2
Papêrcut,kazzak,384,priest,discipline,6,4,2
Серью,booty-bay,384,priest,discipline,6,4,2
Experimentix,silvermoon,384,priest,discipline,6,4,2
Zargoss,sylvanas,384,priest,discipline,6,4,2
Mndvx,sylvanas,384,priest,discipline,6,4,2
Petshopboi,sylvanas,384,priest,discipline,6,4,2
Duem,kazzak,384,priest,discipline,6,4,2
Spoggle,kazzak,384,priest,discipline,6,4,2
Fsnx,sylvanas,384,priest,discipline,6,4,2
Drdré,blackrock,384,priest,discipline,12,4,8
Эрьеро,gordunni,384,priest,discipline,12,4,8
Manäka,hyjal,384,priest,discipline,12,4,8
Geierlol,blackrock,384,priest,discipline,12,4,8
ßlowska,hyjal,384,priest,discipline,12,4,8
Ministry,tirion,384,priest,discipline,12,4,8
Заак,howling-fjord,384,priest,discipline,12,4,8
Сайлентхилл,howling-fjord,384,priest,discipline,12,4,8
Yonkerz,frostmane,384,priest,discipline,12,4,8
Jael,frostmane,384,priest,discipline,12,4,8
Shadowbread,tarren-mill,384,priest,discipline,12,4,8
Abrakahudder,tarren-mill,384,priest,discipline,12,4,8
Fiilaaja,stormreaver,384,priest,discipline,12,4,8
Сегуната,howling-fjord,384,priest,discipline,12,4,8
Anzee,tarren-mill,384,priest,discipline,12,4,8
Kalestharia,blackmoore,384,priest,discipline,12,4,8
Lillaego,ragnaros,384,priest,discipline,12,4,8
Yoloswaglørd,blackmoore,384,priest,discipline,12,4,8
Lysium,sylvanas,384,priest,discipline,12,4,8
Alicanx,twisting-nether,384,priest,discipline,12,4,8
Hoses,twisting-nether,384,priest,discipline,12,4,8
Jaywie,twisting-nether,384,priest,discipline,12,4,8
Absolution,stormscale,384,priest,discipline,12,4,8
Пэйтен,deathguard,384,priest,discipline,12,4,8
Sabakk,archimonde,384,priest,discipline,12,4,8
Goatrocker,kazzak,384,priest,discipline,12,4,8
Pnsl,dun-morogh,384,priest,discipline,12,4,8
Dhed,turalyon,384,priest,discipline,12,4,8
Tsunadesaama,silvermoon,384,priest,discipline,12,4,8
Predpriest,twisting-nether,384,priest,discipline,12,4,8
Artymox,sylvanas,384,priest,discipline,12,4,8
Ankî,aegwynn,384,priest,discipline,12,4,8
Filtro,eredar,384,priest,discipline,12,4,8
Valirda,twisting-nether,384,priest,discipline,12,4,8
Skyløl,dun-modr,384,priest,discipline,12,4,8
Dexlolo,stormscale,384,priest,discipline,12,4,8
Xypri,nordrassil,384,priest,discipline,12,4,8
Melord,thunderhorn,384,priest,discipline,12,4,8
Spezzato,nemesis,384,priest,discipline,12,4,8
Rmp,stormscale,384,priest,discipline,12,4,8
Druzhok,sylvanas,384,priest,discipline,12,4,8
Deathtrapx,draenor,384,priest,discipline,12,4,8
Nøwénna,ravencrest,384,priest,discipline,12,4,8
Djokui,uldum,384,priest,discipline,12,4,8
Vicetøne,stormscale,384,priest,discipline,12,4,8
Radiancekey,sanguino,384,priest,discipline,12,4,8
Necromania,cthun,384,priest,discipline,12,4,8
Zeröone,silvermoon,384,priest,discipline,17,4,13
Blackwidow,chromaggus,384,priest,discipline,18,4,14
Hðly,doomhammer,383,priest,discipline,6,4,2
Пахад,blackscar,383,priest,discipline,6,4,2
Enchanttress,burning-legion,383,priest,discipline,6,4,2
Elba,defias-brotherhood,383,priest,discipline,12,4,8
Miriàl,outland,383,priest,discipline,12,4,8
Хилогайка,howling-fjord,383,priest,discipline,12,4,8
Seiigops,ysondre,382,priest,discipline,6,4,2
Havanna,dethecus,382,priest,discipline,6,4,2
Camellight,stormscale,382,priest,discipline,12,4,8
Тэтсу,greymane,382,priest,discipline,12,4,8
Grommyr,eredar,381,priest,discipline,12,4,8
Tephutes,ravencrest,367,priest,discipline,11,4,7
Thanil,bloodfeather,367,priest,discipline,11,4,7
Pjuww,outland,351,priest,discipline,11,4,7
Doxxi,argent-dawn,336,priest,discipline,9,5,4
Salvatör,quelthalas,336,priest,discipline,15,5,10
Sneed,moonglade,335,priest,discipline,12,5,7
Kenderke,ragnaros,335,priest,discipline,11,4,7
Vicønia,tarren-mill,335,priest,discipline,11,4,7
Ebashuvkashu,stormscale,335,priest,discipline,11,4,7
Thaeres,stormscale,330,priest,discipline,17,7,10
Runay,draenor,330,priest,discipline,13,5,8
Theunknown,stormscale,330,priest,discipline,17,5,12
Кирюшасэмпай,gordunni,320,priest,discipline,10,4,6
Hidary,ysondre,319,priest,discipline,8,4,4
Enaches,twisting-nether,304,priest,discipline,7,4,3
Discobeb,les-clairvoyants,288,priest,discipline,6,3,3
Swd,dun-morogh,288,priest,discipline,6,3,3
ßestworld,draenor,288,priest,discipline,6,3,3
Flet,emerald-dream,288,priest,discipline,6,3,3
Parzivál,argent-dawn,288,priest,discipline,6,3,3
Randmbare,nemesis,288,priest,discipline,6,3,3
Deathchicka,draenor,288,priest,discipline,6,3,3
Virulent,nemesis,288,priest,discipline,6,3,3
Holytop,aegwynn,288,priest,discipline,6,3,3
Mythrixia,draenor,288,priest,discipline,6,3,3
Irenedwen,silvermoon,288,priest,discipline,6,3,3
Byshadow,silvermoon,288,priest,discipline,6,3,3
Sapue,aegwynn,288,priest,discipline,6,3,3
Saltfeskball,tarren-mill,288,priest,discipline,6,3,3
Bridélight,archimonde,288,priest,discipline,6,3,3
Ònasou,silvermoon,288,priest,discipline,6,3,3
Laërhia,archimonde,288,priest,discipline,6,3,3
Apeist,outland,288,priest,discipline,6,3,3
Tyarande,tarren-mill,288,priest,discipline,6,3,3
Moistmidget,frostmane,288,priest,discipline,6,3,3
Zikár,kazzak,288,priest,discipline,6,3,3
Darknun,aggra-português,288,priest,discipline,6,3,3
ßrûm,archimonde,288,priest,discipline,6,3,3
Uglypriest,grim-batol,288,priest,discipline,6,3,3
Miraña,kazzak,288,priest,discipline,6,3,3
Justjuice,hyjal,288,priest,discipline,6,3,3
Imprøved,outland,288,priest,discipline,6,3,3
Applepiez,ravencrest,288,priest,discipline,6,3,3
Santainphy,cthun,288,priest,discipline,6,3,3
Spaghettoni,tarren-mill,288,priest,discipline,6,3,3
Purpl,tarren-mill,288,priest,discipline,6,3,3
ßøunty,dun-modr,288,priest,discipline,6,3,3
Starships,kazzak,288,priest,discipline,6,3,3
Lèss,ysondre,288,priest,discipline,6,3,3
Killafoolx,silvermoon,288,priest,discipline,6,3,3
Moth,kazzak,288,priest,discipline,6,3,3
Goldgot,tarren-mill,288,priest,discipline,6,3,3
Noonex,hakkar,288,priest,discipline,6,3,3
Velanrous,kazzak,288,priest,discipline,6,3,3
Eros,illidan,288,priest,discipline,6,3,3
Åtømîç,kazzak,288,priest,discipline,6,3,3
Carlye,stormreaver,288,priest,discipline,6,3,3
Сайларс,howling-fjord,288,priest,discipline,6,3,3
Шорон,howling-fjord,288,priest,discipline,6,3,3
Саммерфинн,gordunni,288,priest,discipline,6,3,3
Windieqt,drakthul,288,priest,discipline,6,3,3
Xotz,thrall,288,priest,discipline,6,3,3
Xyfas,azshara,288,priest,discipline,6,3,3
Микаса,howling-fjord,288,priest,discipline,6,3,3
Нагп,gordunni,288,priest,discipline,6,3,3
Dumix,shadowsong,288,priest,discipline,6,3,3
Mindflayér,stormscale,288,priest,discipline,6,3,3
Гшд,gordunni,288,priest,discipline,6,3,3
Annisa,kazzak,288,priest,discipline,6,3,3
Камшотхил,gordunni,288,priest,discipline,6,3,3
Àlucárd,blackhand,288,priest,discipline,6,3,3
Matiagmenh,stormscale,288,priest,discipline,6,3,3
Húlda,auchindoun,288,priest,discipline,6,3,3
Døgfîsh,stormscale,288,priest,discipline,6,3,3
Mariahscarey,blackhand,288,priest,discipline,6,3,3
Шлёндрик,gordunni,288,priest,discipline,6,3,3
Tiktokdancér,kazzak,288,priest,discipline,6,3,3
Nelyø,destromath,288,priest,discipline,6,3,3
Krolox,blackhand,288,priest,discipline,6,3,3
Shadoxx,malganis,288,priest,discipline,6,3,3
Paphahaha,ragnaros,288,priest,discipline,6,3,3
Watchmepray,stormscale,288,priest,discipline,6,3,3
Zák,sylvanas,288,priest,discipline,6,3,3
Pluf,nefarian,288,priest,discipline,6,3,3
Mitasdi,stormscale,288,priest,discipline,6,3,3
Jp,gorgonnash,288,priest,discipline,6,3,3
Биркох,blackscar,288,priest,discipline,6,3,3
Vaurork,stormscale,288,priest,discipline,6,3,3
Hanagaki,ragnaros,288,priest,discipline,6,3,3
Edoran,ragnaros,288,priest,discipline,6,3,3
Elfdarkholme,stormscale,288,priest,discipline,6,3,3
Palrins,dalaran,288,priest,discipline,6,3,3
Qpops,twisting-nether,288,priest,discipline,6,3,3
Deppara,twisting-nether,288,priest,discipline,6,3,3
Moppriest,twisting-nether,288,priest,discipline,6,3,3
Pietyberi,tichondrius,288,priest,discipline,6,3,3
Immutable,twisting-nether,288,priest,discipline,6,3,3
Decimerad,kazzak,288,priest,discipline,6,3,3
Effot,twisting-nether,288,priest,discipline,6,3,3
Squidlicker,twisting-nether,288,priest,discipline,6,3,3
Indrades,blackmoore,288,priest,discipline,6,3,3
Ансор,lich-king,288,priest,discipline,6,3,3
Sbj,bronze-dragonflight,288,priest,discipline,6,3,3
Giatros,kazzak,288,priest,discipline,6,3,3
Hmanco,burning-legion,288,priest,discipline,6,3,3
Allaría,bronze-dragonflight,288,priest,discipline,6,3,3
Sctheal,outland,288,priest,discipline,6,3,3
Fønss,sanguino,288,priest,discipline,6,3,3
Hukkuvahirvi,ravencrest,288,priest,discipline,6,3,3
Arjak,stormscale,288,priest,discipline,6,3,3
Grzmocillaa,burning-legion,288,priest,discipline,6,3,3
Spoc,blackrock,288,priest,discipline,6,3,3
Chigreru,uldum,288,priest,discipline,6,3,3
Majestíc,blackmoore,288,priest,discipline,6,3,3
Diarolz,sanguino,288,priest,discipline,6,3,3
Tsuser,blackrock,288,priest,discipline,6,3,3
Hængøver,blackmoore,288,priest,discipline,6,3,3
Gagai,ravencrest,288,priest,discipline,6,3,3
Makemyday,dun-modr,288,priest,discipline,6,3,3
Acik,bladefist,288,priest,discipline,6,3,3
Чилюнахиле,gordunni,288,priest,discipline,6,3,3
Axewound,neptulon,288,priest,discipline,6,3,3
Holycowheals,the-maelstrom,288,priest,discipline,6,3,3
Milderyp,kazzak,288,priest,discipline,6,3,3
Nefufangirl,ravencrest,288,priest,discipline,6,3,3
Drynte,blackmoore,288,priest,discipline,6,3,3
Challengepro,burning-legion,288,priest,discipline,6,3,3
Jaylove,frostwolf,288,priest,discipline,6,3,3
Eldrathir,burning-legion,288,priest,discipline,6,3,3
Чилюотферала,eversong,288,priest,discipline,6,3,3
Viì,ravencrest,288,priest,discipline,6,3,3
Dealtime,ysondre,288,priest,discipline,6,3,3
Sardine,ravencrest,288,priest,discipline,6,3,3
Depleeky,blackmoore,288,priest,discipline,6,3,3
Фотосз,soulflayer,288,priest,discipline,6,3,3
Shyvi,ravencrest,288,priest,discipline,6,3,3
Чикхоп,blackscar,288,priest,discipline,6,3,3
Aasgard,frostwolf,288,priest,discipline,6,3,3
Iløvelena,ravencrest,288,priest,discipline,6,3,3
Iloveilka,madmortem,288,priest,discipline,6,3,3
Rhàenyra,ravencrest,288,priest,discipline,6,3,3
Аридел,ashenvale,288,priest,discipline,6,3,3
Nexìan,ravencrest,288,priest,discipline,6,3,3
Eyllise,ragnaros,288,priest,discipline,10,4,6
Voilencia,kazzak,288,priest,discipline,12,3,9
Ælæx,alleria,288,priest,discipline,12,3,9
Telpriest,blackrock,288,priest,discipline,12,3,9
Raî,durotan,288,priest,discipline,12,3,9
Výra,der-rat-von-dalaran,288,priest,discipline,12,3,9
Венэма,azuregos,288,priest,discipline,12,3,9
Nyxém,blackmoore,288,priest,discipline,12,3,9
Yaaoz,dun-modr,288,priest,discipline,12,3,9
Падлез,howling-fjord,288,priest,discipline,12,3,9
Марджелла,howling-fjord,288,priest,discipline,12,3,9
Shockpriest,grim-batol,288,priest,discipline,12,3,9
Âlígés,outland,288,priest,discipline,12,3,9
Kalamh,marécage-de-zangar,288,priest,discipline,12,3,9
Sins,defias-brotherhood,288,priest,discipline,12,3,9
Djezà,archimonde,288,priest,discipline,12,3,9
Crazyhealsqt,hellfire,288,priest,discipline,12,3,9
Mackópriest,ragnaros,288,priest,discipline,12,3,9
Momomomomomo,aegwynn,288,priest,discipline,12,3,9
Kitazu,draenor,288,priest,discipline,12,3,9
Biierlip,twisting-nether,288,priest,discipline,12,3,9
Nuriva,frostmane,288,priest,discipline,12,3,9
Malaboost,archimonde,288,priest,discipline,12,3,9
Летиин,gordunni,288,priest,discipline,12,3,9
Dizzaer,terokkar,288,priest,discipline,12,3,9
Honompa,darkmoon-faire,288,priest,discipline,12,3,9
Sarinà,archimonde,288,priest,discipline,18,3,15
Rushax,ravencrest,287,priest,discipline,6,3,3
Rhanira,aegwynn,287,priest,discipline,6,3,3
Feloriya,antonidas,287,priest,discipline,6,3,3
Xkv,blackmoore,287,priest,discipline,6,3,3
Loriny,ragnaros,287,priest,discipline,8,3,5
Tíffanny,ragnaros,287,priest,discipline,12,3,9
Kashmirweed,ravencrest,287,priest,discipline,12,3,9
Elraine,ravencrest,287,priest,discipline,12,3,9
Lamark,korgall,287,priest,discipline,12,3,9
Eritreea,stormscale,287,priest,discipline,12,3,9
Waikiki,ambossar,256,priest,discipline,4,4,0
Czee,draenor,255,priest,discipline,11,3,8
Alphakillerz,sanguino,255,priest,discipline,11,3,8
Zlothax,blackrock,255,priest,discipline,11,3,8
Luxumbra,quelthalas,240,priest,discipline,9,4,5
Duelistfied,blackrock,240,priest,discipline,9,4,5
Sánta,blackmoore,240,priest,discipline,9,3,6
Enimao,tarren-mill,239,priest,discipline,5,3,2
Tyeldine,ragnaros,239,priest,discipline,9,4,5
Паратузов,gordunni,239,priest,discipline,29,3,26
Sologrifer,sylvanas,234,priest,discipline,9,4,5
Paandosa,outland,234,priest,discipline,9,4,5
Katwizro,hyjal,234,priest,discipline,16,6,10
Mineshadow,argent-dawn,234,priest,discipline,11,4,7
Krakjak,twisting-nether,234,priest,discipline,15,4,11
Holybøi,ragnaros,234,priest,discipline,23,5,18
Lacrum,ragnaros,233,priest,discipline,8,4,4
Shadowpeste,aggra-português,233,priest,discipline,11,4,7
Cestrial,sylvanas,223,priest,discipline,8,3,5
Mzpriest,dalaran,192,priest,discipline,4,3,1
Кфень,soulflayer,192,priest,discipline,4,3,1
Mamabeer,draenor,192,priest,discipline,6,2,4
Hormgal,blackmoore,192,priest,discipline,6,2,4
Soupana,darksorrow,192,priest,discipline,6,2,4
Meanazer,antonidas,192,priest,discipline,6,2,4
Idén,quelthalas,192,priest,discipline,6,2,4
Shyvannas,antonidas,192,priest,discipline,6,2,4
Zxø,ravencrest,192,priest,discipline,6,2,4
Bigpinkballs,tarren-mill,192,priest,discipline,6,2,4
Jerzay,hyjal,192,priest,discipline,6,2,4
Manau,culte-de-la-rive-noire,192,priest,discipline,6,2,4
Methslinger,draenor,192,priest,discipline,6,2,4
Seehz,ysondre,192,priest,discipline,6,2,4
Efflúx,ravencrest,192,priest,discipline,6,2,4
Vanillå,silvermoon,192,priest,discipline,6,2,4
Ruebi,blackmoore,192,priest,discipline,6,2,4
Yuuvi,ravencrest,192,priest,discipline,6,2,4
Dîablø,eredar,192,priest,discipline,6,2,4
Pøh,kilrogg,192,priest,discipline,6,2,4
Tubercurass,hyjal,192,priest,discipline,6,2,4
Phantombride,silvermoon,192,priest,discipline,6,2,4
Mcx,stormscale,192,priest,discipline,6,2,4
Chankro,sanguino,192,priest,discipline,6,2,4
Dinma,argent-dawn,192,priest,discipline,6,2,4
Homxcxde,ravencrest,192,priest,discipline,6,2,4
Várósh,blackmoore,192,priest,discipline,6,2,4
Ethylene,ysondre,192,priest,discipline,6,2,4
Rallzken,stormscale,192,priest,discipline,6,2,4
Senza,ysondre,192,priest,discipline,6,2,4
Anvena,elune,192,priest,discipline,6,2,4
Chabih,ravencrest,192,priest,discipline,6,2,4
Derathon,eredar,192,priest,discipline,6,2,4
Колдунская,soulflayer,192,priest,discipline,6,2,4
Toxicx,aegwynn,192,priest,discipline,6,2,4
Shalvy,aegwynn,192,priest,discipline,6,2,4
Sipriest,silvermoon,192,priest,discipline,6,2,4
Attenna,ravencrest,192,priest,discipline,6,2,4
Fandac,sylvanas,192,priest,discipline,6,2,4
Soreboners,stormscale,192,priest,discipline,6,2,4
Mêduse,ravencrest,192,priest,discipline,6,2,4
Prodan,frostmane,192,priest,discipline,6,2,4
Luziaa,outland,192,priest,discipline,6,2,4
Shalabox,twisting-nether,192,priest,discipline,6,2,4
Nálá,nethersturm,192,priest,discipline,6,2,4
Aidkit,burning-legion,192,priest,discipline,6,2,4
Xayona,argent-dawn,192,priest,discipline,6,2,4
Ølle,ravencrest,192,priest,discipline,6,2,4
Lirrydoz,ravencrest,192,priest,discipline,6,2,4
Vadhänder,the-maelstrom,192,priest,discipline,6,2,4
Grduebel,tirion,192,priest,discipline,6,2,4
Ponting,kazzak,192,priest,discipline,6,2,4
Kimjongpanda,ravencrest,192,priest,discipline,6,2,4
Шпалкоклоб,soulflayer,192,priest,discipline,6,2,4
Ünholy,burning-legion,192,priest,discipline,6,2,4
Malapriest,dalaran,192,priest,discipline,6,2,4
Nevor,nemesis,192,priest,discipline,6,2,4
Tinúvielle,dalaran,192,priest,discipline,6,2,4
Skytheory,eredar,192,priest,discipline,6,2,4
Prîëstìtütê,doomhammer,192,priest,discipline,6,2,4
Chópsuey,stormscale,192,priest,discipline,6,2,4
Andhoras,dalaran,192,priest,discipline,6,2,4
Nekros,agamaggan,192,priest,discipline,6,2,4
Qku,ravencrest,192,priest,discipline,6,2,4
Missright,ragnaros,192,priest,discipline,6,2,4
Viagrà,outland,192,priest,discipline,6,2,4
Spectriums,twisting-nether,192,priest,discipline,6,2,4
Ratingfeeder,tarren-mill,192,priest,discipline,6,2,4
Xýz,tarren-mill,192,priest,discipline,6,2,4
Eclaír,blackhand,192,priest,discipline,6,2,4
Рэпру,galakrond,192,priest,discipline,6,2,4
Zéró,gorgonnash,192,priest,discipline,6,2,4
Døtgdx,archimonde,192,priest,discipline,6,2,4
Jeez,twilights-hammer,192,priest,discipline,6,2,4
Targolina,argent-dawn,192,priest,discipline,6,2,4
Ballsbrawlz,sylvanas,192,priest,discipline,6,2,4
Wumtris,ragnaros,192,priest,discipline,6,2,4
Монесса,howling-fjord,192,priest,discipline,6,2,4
Dqt,ragnaros,192,priest,discipline,6,2,4
Striderz,outland,192,priest,discipline,6,2,4
Gladíator,blackhand,192,priest,discipline,6,2,4
Taschigi,rexxar,192,priest,discipline,6,2,4
Fadehojwnabe,the-shatar,192,priest,discipline,6,2,4
Äkvä,ragnaros,192,priest,discipline,6,2,4
Тейдехан,howling-fjord,192,priest,discipline,6,2,4
Titiqr,naxxramas,192,priest,discipline,6,2,4
Chrònos,das-konsortium,192,priest,discipline,6,2,4
Daesa,defias-brotherhood,192,priest,discipline,6,2,4
Йефа,gordunni,192,priest,discipline,6,2,4
Забейка,howling-fjord,192,priest,discipline,6,2,4
Ичисанчик,howling-fjord,192,priest,discipline,6,2,4
Rickermortis,defias-brotherhood,192,priest,discipline,6,2,4
Flayin,kazzak,192,priest,discipline,7,2,5
Zarez,stormscale,192,priest,discipline,20,4,16
Petjouli,darksorrow,192,priest,discipline,12,2,10
Flygar,outland,192,priest,discipline,12,2,10
Miind,tarren-mill,192,priest,discipline,12,2,10
Pierrebourne,blackmoore,192,priest,discipline,12,2,10
Chenandler,aggra-português,192,priest,discipline,12,2,10
Aist,ragnaros,192,priest,discipline,12,2,10
Trickfulzqt,stormscale,192,priest,discipline,12,2,10
Aldebrand,dun-modr,192,priest,discipline,12,2,10
Marôs,antonidas,192,priest,discipline,12,2,10
Neliica,silvermoon,192,priest,discipline,12,2,10
Norah,kirin-tor,192,priest,discipline,12,2,10
Yhraeliaegh,defias-brotherhood,192,priest,discipline,18,2,16
Zinary,silvermoon,192,priest,discipline,18,2,16
Adolosh,thrall,191,priest,discipline,6,2,4
Sotanax,khazgoroth,144,priest,discipline,9,2,7
Xire,outland,138,priest,discipline,8,3,5
Ohhowpretty,ravencrest,138,priest,discipline,11,4,7
Zhenkasp,kazzak,138,priest,discipline,16,3,13
Xakala,cthun,137,priest,discipline,13,3,10
Thimble,blackhand,127,priest,discipline,8,2,6
Holyheartx,argent-dawn,121,priest,discipline,16,3,13
Lucerna,defias-brotherhood,112,priest,discipline,7,2,5
Midy,drakthul,96,priest,discipline,3,2,1
Xaeroow,archimonde,96,priest,discipline,6,1,5
Скартэикс,howling-fjord,96,priest,discipline,6,1,5
Huhu,defias-brotherhood,96,priest,discipline,6,1,5
Vampirito,ragnaros,96,priest,discipline,6,1,5
Йоййо,gordunni,96,priest,discipline,6,1,5
Twinkboyx,ragnaros,96,priest,discipline,6,1,5
Немонте,gordunni,96,priest,discipline,6,1,5
Dami,defias-brotherhood,96,priest,discipline,6,1,5
Discovery,aggra-português,96,priest,discipline,6,1,5
Broncos,twisting-nether,96,priest,discipline,6,1,5
Shinesomnya,aegwynn,96,priest,discipline,6,1,5
Mariio,blackmoore,96,priest,discipline,6,1,5
Jerolol,sanguino,96,priest,discipline,6,1,5
Mambanero,nemesis,96,priest,discipline,6,1,5
Wynkx,zuljin,96,priest,discipline,6,1,5
Joncartagena,sanguino,96,priest,discipline,6,1,5
Sayala,dalaran,96,priest,discipline,6,1,5
Yixi,blackmoore,96,priest,discipline,6,1,5
Dionegativ,draenor,96,priest,discipline,6,1,5
Жрецдуши,gordunni,96,priest,discipline,6,1,5
Namï,darksorrow,96,priest,discipline,6,1,5
Оумега,gordunni,96,priest,discipline,6,1,5
Synoé,la-croisade-écarlate,96,priest,discipline,6,1,5
Pristürk,burning-legion,96,priest,discipline,6,1,5
Могвайи,soulflayer,96,priest,discipline,6,1,5
Миррен,gordunni,96,priest,discipline,6,1,5
Xälis,ysondre,96,priest,discipline,6,1,5
Doncamïllo,blackrock,96,priest,discipline,6,1,5
Марриаза,blackscar,96,priest,discipline,6,1,5
Iololololxd,eredar,96,priest,discipline,6,1,5
Ulfsarkaom,turalyon,96,priest,discipline,6,1,5
Fuzzymerge,ravencrest,96,priest,discipline,6,1,5
Fluxyqt,ravencrest,96,priest,discipline,6,1,5
Leykop,ravencrest,96,priest,discipline,6,1,5
Coqa,blackrock,96,priest,discipline,6,1,5
Redblue,onyxia,96,priest,discipline,6,1,5
Героиннарбг,soulflayer,96,priest,discipline,6,1,5
Pellé,stormscale,96,priest,discipline,6,1,5
Miraçlê,kazzak,96,priest,discipline,6,1,5
Acidrops,hyjal,96,priest,discipline,6,1,5
Jbte,silvermoon,96,priest,discipline,6,1,5
Rennic,stormscale,96,priest,discipline,6,1,5
Orioz,tarren-mill,96,priest,discipline,6,1,5
Ixdeadxl,stormscale,96,priest,discipline,6,1,5
Kuxk,stormscale,96,priest,discipline,6,1,5
Sende,tarren-mill,96,priest,discipline,6,1,5
Menjo,silvermoon,96,priest,discipline,6,1,5
Madcole,blackhand,96,priest,discipline,6,1,5
Erkay,kazzak,96,priest,discipline,6,1,5
Ascendare,tarren-mill,96,priest,discipline,6,1,5
Porklifer,tarren-mill,96,priest,discipline,6,1,5
Promiqt,drakthul,96,priest,discipline,6,1,5
Olqp,tarren-mill,96,priest,discipline,6,1,5
Epokalarm,ragnaros,96,priest,discipline,12,1,11
Nomorelight,stormscale,96,priest,discipline,12,1,11
Sorprendente,cthun,96,priest,discipline,12,1,11
Abstauberin,blackrock,64,priest,discipline,4,1,3
Piacolada,aegwynn,48,priest,discipline,3,1,2
Discopriestt,outland,48,priest,discipline,3,1,2
Chnechnechne,outland,42,priest,discipline,11,3,8
Flexelzz,argent-dawn,42,priest,discipline,8,2,6
Xxddxd,draenor,42,priest,discipline,17,3,14
Kak,gorgonnash,42,priest,discipline,13,2,11
Yggdra,ragnaros,2229,priest,shadow,66,44,22
Permafeetup,aegwynn,2151,priest,shadow,78,45,33
Syedi,drakthul,2150,priest,shadow,105,52,53
Хедмэнмвп,gordunni,2143,priest,shadow,138,69,69
Rzkp,eredar,2110,priest,shadow,93,50,43
Blacktrain,burning-blade,2080,priest,shadow,94,46,48
Даняпампгодх,soulflayer,2060,priest,shadow,116,58,58
Миладиель,gordunni,2059,priest,shadow,65,35,30
Standtall,blackrock,2056,priest,shadow,72,41,31
Finn,kult-der-verdammten,2056,priest,shadow,102,56,46
Crainoo,ravencrest,2045,priest,shadow,113,54,59
Pu,outland,2039,priest,shadow,90,43,47
Сделайсам,gordunni,2033,priest,shadow,65,37,28
Dollyboo,tarren-mill,2030,priest,shadow,59,40,19
Purpl,tarren-mill,2022,priest,shadow,96,52,44
Bönfire,silvermoon,2009,priest,shadow,72,37,35
Stjärtsten,tarren-mill,2003,priest,shadow,93,60,33
Notsoholy,blackmoore,1993,priest,shadow,54,33,21
Sethÿr,sanguino,1982,priest,shadow,126,66,60
Zhadum,stormscale,1964,priest,shadow,84,45,39
Vaccineboost,silvermoon,1960,priest,shadow,42,23,19
Moretti,ravencrest,1953,priest,shadow,54,32,22
Maryhugette,archimonde,1951,priest,shadow,66,36,30
Heal,hyjal,1950,priest,shadow,141,85,56
Dhurza,shendralar,1938,priest,shadow,66,39,27
Thanatae,kazzak,1906,priest,shadow,54,27,27
Justtpro,twisting-nether,1905,priest,shadow,81,54,27
Gorholm,argent-dawn,1900,priest,shadow,42,29,13
Hansmaul,thrall,1897,priest,shadow,36,20,16
Ilovemycat,silvermoon,1895,priest,shadow,42,27,15
Shádówý,kazzak,1889,priest,shadow,36,20,16
Rrj,ravencrest,1886,priest,shadow,46,29,17
Qoryn,ravencrest,1882,priest,shadow,42,25,17
Heffer,outland,1880,priest,shadow,93,58,35
Destinyhero,aegwynn,1876,priest,shadow,52,27,25
Pepeshadow,twisting-nether,1875,priest,shadow,36,22,14
Бхонсамди,blackscar,1870,priest,shadow,59,37,22
Tremrfinger,dun-modr,1866,priest,shadow,38,29,9
Yuzuflex,hyjal,1863,priest,shadow,57,29,28
Prøphetx,thrall,1861,priest,shadow,93,46,47
Léandrä,magtheridon,1860,priest,shadow,60,28,32
Estragon,quelthalas,1859,priest,shadow,58,32,26
Ансор,lich-king,1856,priest,shadow,89,50,39
Iodjsaiojoij,kazzak,1856,priest,shadow,54,30,24
Perché,silvermoon,1855,priest,shadow,42,33,9
Melábufeis,dun-modr,1854,priest,shadow,54,32,22
Термидор,booty-bay,1853,priest,shadow,59,40,19
Nousey,twisting-nether,1847,priest,shadow,42,25,17
Èxtêrmìnätör,kazzak,1845,priest,shadow,48,30,18
Akolyte,blackmoore,1843,priest,shadow,36,22,14
Trisks,ravencrest,1843,priest,shadow,34,20,14
Sadix,ravencrest,1835,priest,shadow,66,38,28
Безрассудица,howling-fjord,1834,priest,shadow,55,29,26
Dippy,blackrock,1830,priest,shadow,36,23,13
Schmetter,tarren-mill,1829,priest,shadow,65,29,36
Milkysmite,twisting-nether,1828,priest,shadow,46,30,16
Selëne,blackrock,1827,priest,shadow,72,43,29
Anateoris,turalyon,1825,priest,shadow,76,43,33
Ûñträînablê,outland,1822,priest,shadow,48,34,14
Zodzín,ragnaros,1815,priest,shadow,36,19,17
Theunknown,thrall,1814,priest,shadow,42,30,12
Luvlyrah,draenor,1812,priest,shadow,81,52,29
Бвонсаамди,soulflayer,1811,priest,shadow,53,27,26
Skillmåsterx,ravencrest,1810,priest,shadow,54,29,25
Gymbró,kazzak,1809,priest,shadow,54,31,23
Salkerer,stormscale,1807,priest,shadow,30,19,11
Snarks,sylvanas,1806,priest,shadow,36,20,16
Galatea,les-sentinelles,1805,priest,shadow,78,44,34
Vajainap,outland,1804,priest,shadow,30,19,11
Mataî,kazzak,1803,priest,shadow,84,49,35
Margots,kazzak,1802,priest,shadow,42,22,20
Buøbuarns,sanguino,1797,priest,shadow,39,19,20
Walterwhite,stormscale,1791,priest,shadow,36,21,15
Namsolo,kazzak,1783,priest,shadow,72,38,34
Староезло,gordunni,1777,priest,shadow,62,30,32
Ымц,gordunni,1775,priest,shadow,48,23,25
Cheesecake,defias-brotherhood,1774,priest,shadow,48,27,21
Zoodiacp,blackrock,1774,priest,shadow,50,24,26
Dingopriest,blackrock,1768,priest,shadow,30,22,8
Rockness,blackmoore,1767,priest,shadow,107,73,34
Darthmantle,silvermoon,1758,priest,shadow,53,26,27
Rãpidi,hyjal,1740,priest,shadow,59,34,25
Всезнайка,soulflayer,1735,priest,shadow,60,35,25
Ankî,aegwynn,1731,priest,shadow,78,42,36
Akibom,drakthul,1730,priest,shadow,35,22,13
Mojibien,burning-legion,1727,priest,shadow,63,41,22
Goodsuck,tarren-mill,1723,priest,shadow,36,22,14
Перекованный,soulflayer,1722,priest,shadow,81,45,36
Infuséd,aegwynn,1721,priest,shadow,30,18,12
Игорянатакуе,eversong,1712,priest,shadow,100,55,45
Becknarbritt,stormscale,1706,priest,shadow,89,58,31
Djops,outland,1706,priest,shadow,54,27,27
Zuhä,twisting-nether,1703,priest,shadow,42,22,20
Atahalni,argent-dawn,1700,priest,shadow,36,18,18
Zeythz,ravencrest,1695,priest,shadow,52,34,18
Genjutzux,kazzak,1694,priest,shadow,36,23,13
Хьёх,blackscar,1688,priest,shadow,36,23,13
Кломми,gordunni,1688,priest,shadow,66,35,31
Víppe,stormreaver,1682,priest,shadow,53,32,21
Dezerta,nozdormu,1680,priest,shadow,56,32,24
Klosso,anachronos,1676,priest,shadow,77,34,43
Zhyn,turalyon,1669,priest,shadow,76,46,30
Marbellexd,pozzo-delleternità,1668,priest,shadow,76,45,31
Tosem,antonidas,1661,priest,shadow,30,19,11
Финдовский,gordunni,1649,priest,shadow,102,54,48
Helín,hellfire,1647,priest,shadow,78,43,35
Mehtz,ravencrest,1641,priest,shadow,96,46,50
Milo,argent-dawn,1640,priest,shadow,102,61,41
Lâughing,ravencrest,1638,priest,shadow,31,19,12
Undefined,chamber-of-aspects,1634,priest,shadow,40,28,12
Hanic,kazzak,1631,priest,shadow,24,17,7
Dbeezy,tarren-mill,1630,priest,shadow,30,17,13
Ageyr,ragnaros,1628,priest,shadow,29,21,8
Devoura,sylvanas,1628,priest,shadow,24,17,7
Buffholy,dun-modr,1626,priest,shadow,42,26,16
Liptonolda,blackhand,1624,priest,shadow,30,17,13
Psycos,kazzak,1613,priest,shadow,42,25,17
Rnkz,sanguino,1612,priest,shadow,36,20,16
Everdark,twisting-nether,1611,priest,shadow,84,49,35
Nabøøbies,blackmoore,1607,priest,shadow,32,18,14
Faminé,outland,1606,priest,shadow,47,22,25
Yêl,thrall,1604,priest,shadow,97,54,43
Kujiua,ravencrest,1603,priest,shadow,55,28,27
Sudeki,blackmoore,1601,priest,shadow,42,20,22
Spklooril,hyjal,1600,priest,shadow,92,48,44
Трубишоп,howling-fjord,1599,priest,shadow,52,25,27
Киндзер,blackscar,1593,priest,shadow,30,20,10
Pombär,ragnaros,1587,priest,shadow,54,36,18
Ревентонх,howling-fjord,1585,priest,shadow,106,59,47
Sheto,burning-legion,1585,priest,shadow,54,25,29
Ruhe,silvermoon,1583,priest,shadow,42,22,20
Priestazie,madmortem,1577,priest,shadow,78,46,32
Sepharis,runetotem,1576,priest,shadow,95,56,39
Milamati,kazzak,1576,priest,shadow,60,28,32
Sphero,earthen-ring,1572,priest,shadow,36,18,18
Llothx,ravencrest,1571,priest,shadow,50,27,23
Ксерф,soulflayer,1568,priest,shadow,54,23,31
Asterixsu,sylvanas,1556,priest,shadow,30,20,10
Babarøqa,blackmoore,1555,priest,shadow,54,29,25
Амгар,galakrond,1552,priest,shadow,78,46,32
Sháady,ravencrest,1549,priest,shadow,42,23,19
Coupdekaraté,sylvanas,1543,priest,shadow,36,18,18
Ankhh,bloodscalp,1539,priest,shadow,42,19,23
Саксесфул,howling-fjord,1535,priest,shadow,97,53,44
Xsß,dun-modr,1534,priest,shadow,24,16,8
Deathlý,blackrock,1534,priest,shadow,30,16,14
Zekonja,doomhammer,1532,priest,shadow,82,42,40
Umbralx,ragnaros,1513,priest,shadow,71,42,29
Ammp,outland,1511,priest,shadow,66,41,25
Imøteph,ragnaros,1497,priest,shadow,30,18,12
Zászàsmaster,kazzak,1496,priest,shadow,36,24,12
Bercxu,ragnaros,1487,priest,shadow,60,34,26
Даняпампх,soulflayer,1485,priest,shadow,60,36,24
Nygel,kazzak,1483,priest,shadow,35,21,14
Vatikanet,ravencrest,1475,priest,shadow,63,36,27
Mightyfool,aegwynn,1475,priest,shadow,36,18,18
Massbimba,tarren-mill,1475,priest,shadow,41,19,22
Kajifoxi,frostmane,1473,priest,shadow,39,27,12
Cykdwojeczka,burning-legion,1469,priest,shadow,48,21,27
Кхэрри,goldrinn,1464,priest,shadow,24,16,8
Weebi,silvermoon,1455,priest,shadow,29,17,12
Dotsin,kazzak,1453,priest,shadow,77,40,37
Kightz,twisting-nether,1452,priest,shadow,36,17,19
Cinaedus,stormreaver,1449,priest,shadow,51,27,24
Sanebassoff,kazzak,1447,priest,shadow,94,55,39
Raikup,ravencrest,1439,priest,shadow,30,15,15
Ondskabsfuld,kazzak,1439,priest,shadow,30,15,15
Айсиоу,howling-fjord,1438,priest,shadow,24,15,9
Деплитфофан,gordunni,1437,priest,shadow,41,26,15
Kendea,silvermoon,1435,priest,shadow,81,46,35
Simôc,eredar,1433,priest,shadow,30,15,15
Yaoshih,draenor,1430,priest,shadow,47,25,22
Blasphemiia,outland,1426,priest,shadow,30,21,9
Jaimee,zirkel-des-cenarius,1425,priest,shadow,24,15,9
Vhayna,kazzak,1417,priest,shadow,53,32,21
Sebbepriest,twisting-nether,1416,priest,shadow,30,18,12
Зонкк,thermaplugg,1416,priest,shadow,42,24,18
Saintethérez,archimonde,1410,priest,shadow,45,30,15
Hâicu,antonidas,1406,priest,shadow,39,22,17
Melanore,sylvanas,1406,priest,shadow,60,28,32
Maxhima,defias-brotherhood,1404,priest,shadow,66,34,32
Absolution,stormscale,1398,priest,shadow,42,22,20
Дэспира,howling-fjord,1391,priest,shadow,28,16,12
Kertith,argent-dawn,1386,priest,shadow,73,36,37
Hek,sylvanas,1384,priest,shadow,72,36,36
Palitox,kazzak,1383,priest,shadow,58,30,28
Синатро,deathguard,1382,priest,shadow,42,29,13
Damyo,eredar,1381,priest,shadow,54,29,25
Йоййо,gordunni,1377,priest,shadow,34,16,18
Hemaplex,dun-modr,1371,priest,shadow,29,16,13
Vedina,bronze-dragonflight,1371,priest,shadow,69,28,41
Miruh,malganis,1369,priest,shadow,24,21,3
Astangia,nemesis,1368,priest,shadow,75,43,32
Hëllokitty,sanguino,1366,priest,shadow,54,30,24
Shizo,blutkessel,1364,priest,shadow,29,20,9
Erkay,kazzak,1362,priest,shadow,36,17,19
Багбери,eversong,1359,priest,shadow,48,28,20
Broncos,twisting-nether,1358,priest,shadow,52,31,21
Either,kazzak,1353,priest,shadow,29,15,14
Seni,gilneas,1346,priest,shadow,43,21,22
Angsty,blackrock,1342,priest,shadow,24,14,10
Офелла,howling-fjord,1340,priest,shadow,35,19,16
Velenthøs,argent-dawn,1338,priest,shadow,41,23,18
Settemsen,tarren-mill,1334,priest,shadow,18,14,4
Daltheria,daggerspine,1333,priest,shadow,36,23,13
Kellen,burning-blade,1332,priest,shadow,58,32,26
Unerfedsp,archimonde,1332,priest,shadow,30,14,16
Казуямисима,gordunni,1328,priest,shadow,24,14,10
Seneth,twisting-nether,1327,priest,shadow,24,14,10
Dyshexia,bronze-dragonflight,1318,priest,shadow,30,14,16
Cnsnn,ysondre,1313,priest,shadow,19,14,5
Sodomix,tarren-mill,1305,priest,shadow,42,26,16
Hecaté,blackhand,1305,priest,shadow,49,27,22
Сариандра,gordunni,1295,priest,shadow,24,15,9
Ваккарий,gordunni,1284,priest,shadow,25,15,10
Fiftyfives,hyjal,1271,priest,shadow,33,14,19
Littlebugger,argent-dawn,1254,priest,shadow,39,15,24
Voidlink,kazzak,1247,priest,shadow,18,13,5
Cutepangolin,khaz-modan,1247,priest,shadow,18,13,5
Selaria,magtheridon,1245,priest,shadow,18,13,5
Mizulol,ravencrest,1245,priest,shadow,24,13,11
Spamplague,stormscale,1243,priest,shadow,24,13,11
Geløpr,eredar,1242,priest,shadow,18,13,5
Greyford,blackhand,1240,priest,shadow,18,13,5
Priestfive,stormscale,1239,priest,shadow,24,13,11
Míjagí,blackhand,1239,priest,shadow,30,14,16
Adägïo,dun-modr,1238,priest,shadow,24,13,11
Morsy,alleria,1235,priest,shadow,27,14,13
Morteous,twisting-nether,1234,priest,shadow,171,86,85
Prøfesor,nemesis,1224,priest,shadow,24,13,11
Ggdoll,twisting-nether,1222,priest,shadow,56,27,29
Nagatary,blackmoore,1220,priest,shadow,42,21,21
Даркфолс,soulflayer,1219,priest,shadow,30,15,15
Tesz,perenolde,1217,priest,shadow,36,16,20
Lowisa,sylvanas,1212,priest,shadow,23,13,10
Baptizer,nemesis,1193,priest,shadow,36,23,13
Valirda,twisting-nether,1187,priest,shadow,27,13,14
Thergozar,stormscale,1178,priest,shadow,36,26,10
Флэшх,soulflayer,1177,priest,shadow,22,13,9
Farseerx,ravencrest,1166,priest,shadow,36,23,13
Scaryman,ravencrest,1157,priest,shadow,23,14,9
Knútx,stormscale,1152,priest,shadow,18,12,6
Shåmssv,kazzak,1152,priest,shadow,24,12,12
Синфал,blackscar,1152,priest,shadow,24,12,12
Quezaris,stormscale,1152,priest,shadow,24,12,12
Медовыедотки,soulflayer,1152,priest,shadow,24,12,12
Julîane,aegwynn,1151,priest,shadow,18,12,6
Animesenpai,kazzak,1151,priest,shadow,18,12,6
Arendt,blackhand,1151,priest,shadow,18,12,6
Facemeltina,kiljaeden,1151,priest,shadow,24,12,12
Rakamain,ravencrest,1150,priest,shadow,18,12,6
Affex,tarren-mill,1150,priest,shadow,18,12,6
Theoniss,draenor,1149,priest,shadow,18,12,6
Basicpr,ravencrest,1147,priest,shadow,18,12,6
Cylantharia,eredar,1147,priest,shadow,24,12,12
Ølle,ravencrest,1147,priest,shadow,24,12,12
Hârlequin,draenor,1140,priest,shadow,48,25,23
Cthulou,tarren-mill,1137,priest,shadow,60,31,29
Shinígamí,frostmane,1135,priest,shadow,24,12,12
Cerbero,doomhammer,1128,priest,shadow,18,12,6
Hotdog,kult-der-verdammten,1128,priest,shadow,36,16,20
Shiannâ,malganis,1118,priest,shadow,26,13,13
Voidlord,hyjal,1116,priest,shadow,28,13,15
Nellytaa,dalaran,1103,priest,shadow,31,16,15
Yuhé,elune,1100,priest,shadow,24,16,8
Cabalist,silvermoon,1091,priest,shadow,36,18,18
Nightshådøw,silvermoon,1089,priest,shadow,21,12,9
Санятруу,blackscar,1087,priest,shadow,48,28,20
Ounxx,blackrock,1085,priest,shadow,17,12,5
Terrored,ravencrest,1055,priest,shadow,18,11,7
Hellscon,kazzak,1055,priest,shadow,18,11,7
Apuessii,dun-modr,1054,priest,shadow,23,12,11
Kylähullu,ravencrest,1054,priest,shadow,24,11,13
Abjure,silvermoon,1053,priest,shadow,18,11,7
Блюмсик,blackscar,1052,priest,shadow,30,18,12
Tbs,sylvanas,1052,priest,shadow,21,12,9
Êttân,ravencrest,1049,priest,shadow,24,11,13
Pregrip,twisting-nether,1048,priest,shadow,24,11,13
Holypowér,twisting-nether,1041,priest,shadow,24,11,13
Flayin,kazzak,1035,priest,shadow,24,11,13
Дикаях,gordunni,1035,priest,shadow,35,11,24
Тэтсу,greymane,1018,priest,shadow,18,12,6
Vavulya,blackhand,988,priest,shadow,16,11,5
Angleka,argent-dawn,973,priest,shadow,23,12,11
Tentoumushi,ravencrest,960,priest,shadow,12,10,2
Maedhrós,ravencrest,960,priest,shadow,12,10,2
Blindöts,tarren-mill,960,priest,shadow,18,10,8
Billybay,argent-dawn,959,priest,shadow,12,10,2
Iessei,outland,959,priest,shadow,18,10,8
Supriest,alakir,959,priest,shadow,24,10,14
Goodison,outland,959,priest,shadow,24,10,14
Onlyfansp,ravencrest,959,priest,shadow,24,10,14
Miruvai,tarren-mill,958,priest,shadow,18,10,8
Momomomomomo,aegwynn,958,priest,shadow,18,10,8
Raspberrypíe,silvermoon,956,priest,shadow,18,10,8
Shadowsister,burning-blade,955,priest,shadow,18,10,8
Odium,alakir,950,priest,shadow,18,10,8
Saviour,spinebreaker,949,priest,shadow,18,10,8
Evilspel,ravencrest,948,priest,shadow,18,10,8
Иннй,howling-fjord,947,priest,shadow,24,11,13
Силабездны,deathguard,946,priest,shadow,38,20,18
Ninjajane,sylvanas,927,priest,shadow,16,10,6
Priestoll,draenor,911,priest,shadow,21,10,11
Weekfortyone,blackhand,911,priest,shadow,23,10,13
Physxd,blackrock,864,priest,shadow,12,9,3
Mydianá,aegwynn,864,priest,shadow,12,9,3
Insanious,skullcrusher,864,priest,shadow,18,9,9
Vibéz,outland,864,priest,shadow,18,9,9
Festiz,tichondrius,863,priest,shadow,12,9,3
Jadæ,ragnaros,863,priest,shadow,18,9,9
Mackings,the-maelstrom,863,priest,shadow,18,9,9
Garycash,outland,863,priest,shadow,21,10,11
Voodkaa,drakthul,862,priest,shadow,16,10,6
Xangha,burning-legion,862,priest,shadow,18,9,9
Hörror,twisting-nether,862,priest,shadow,18,9,9
Ilostmybible,runetotem,862,priest,shadow,24,9,15
Dívíne,ravenholdt,861,priest,shadow,12,9,3
Cringelørd,alakir,861,priest,shadow,12,9,3
Anathemas,draenor,861,priest,shadow,12,9,3
Dopey,kazzak,861,priest,shadow,12,9,3
Dutchstuff,karazhan,861,priest,shadow,18,9,9
Adssdfhjgh,outland,860,priest,shadow,12,9,3
Meshen,ysondre,858,priest,shadow,16,10,6
Дроус,borean-tundra,858,priest,shadow,30,12,18
Ниомана,gordunni,848,priest,shadow,12,9,3
Akroama,archimonde,847,priest,shadow,17,9,8
Уртримас,gordunni,847,priest,shadow,24,9,15
Pipen,stormscale,820,priest,shadow,23,9,14
Csksablanca,sargeras,815,priest,shadow,11,9,2
Bréézee,ravencrest,799,priest,shadow,23,9,14
Sypnos,zuljin,797,priest,shadow,16,9,7
Ecquidozx,ravencrest,768,priest,shadow,12,8,4
Adub,tarren-mill,768,priest,shadow,12,8,4
Прыст,howling-fjord,768,priest,shadow,12,8,4
Abrakahudder,tarren-mill,768,priest,shadow,12,8,4
Shyvi,ravencrest,768,priest,shadow,12,8,4
Versio,dalvengyr,768,priest,shadow,12,8,4
Sÿrax,ysondre,768,priest,shadow,12,8,4
Qiandra,argent-dawn,768,priest,shadow,18,8,10
Putríd,sylvanas,767,priest,shadow,12,8,4
Jegred,draenor,767,priest,shadow,12,8,4
Xxede,dun-modr,767,priest,shadow,18,8,10
Unreal,nagrand,767,priest,shadow,18,8,10
Flexzpriest,destromath,767,priest,shadow,18,8,10
Äiri,blackmoore,767,priest,shadow,18,8,10
Priestlolx,aegwynn,767,priest,shadow,24,8,16
Søcrax,blackrock,766,priest,shadow,12,8,4
Ехереу,blackscar,766,priest,shadow,12,8,4
Tiinia,hyjal,766,priest,shadow,18,8,10
Powna,blackrock,765,priest,shadow,12,8,4
Géèk,alakir,765,priest,shadow,19,8,11
Sammel,moonglade,763,priest,shadow,18,8,10
Asdaprice,hellfire,758,priest,shadow,12,8,4
Shíàpríést,kazzak,734,priest,shadow,29,8,21
Onskansmoder,shattered-hand,733,priest,shadow,22,8,14
Raetwo,stormscale,703,priest,shadow,14,8,6
Bidraget,ravencrest,672,priest,shadow,12,7,5
Nomorelight,stormscale,672,priest,shadow,12,7,5
Sadgepriest,draenor,672,priest,shadow,12,7,5
Nyotux,blackrock,672,priest,shadow,12,7,5
Swdjkbad,kazzak,672,priest,shadow,12,7,5
Bizzlebabe,lightbringer,672,priest,shadow,12,7,5
Yoe,twisting-nether,672,priest,shadow,12,7,5
Фиброз,blackscar,672,priest,shadow,12,7,5
Марриаза,blackscar,672,priest,shadow,12,7,5
Schmatzy,blackmoore,672,priest,shadow,12,7,5
Donkyrobert,tarren-mill,672,priest,shadow,12,7,5
Laradiel,dun-modr,672,priest,shadow,12,7,5
Миррен,gordunni,672,priest,shadow,12,7,5
Gød,magtheridon,672,priest,shadow,12,7,5
Leggat,draenor,672,priest,shadow,15,8,7
Irlfatguy,ravencrest,672,priest,shadow,20,7,13
Badomens,draenor,671,priest,shadow,12,7,5
Elarya,zenedar,671,priest,shadow,12,7,5
Cryptoniite,kazzak,671,priest,shadow,12,7,5
Энвиньяттар,howling-fjord,671,priest,shadow,12,7,5
Beonin,tarren-mill,671,priest,shadow,13,7,6
Holyshadów,azjolnerub,671,priest,shadow,18,7,11
Jerolol,sanguino,671,priest,shadow,18,7,11
Neggan,chamber-of-aspects,671,priest,shadow,18,7,11
Gooflord,ravencrest,671,priest,shadow,18,7,11
Morgoh,die-arguswacht,670,priest,shadow,12,7,5
Hiela,outland,670,priest,shadow,12,7,5
Kitasia,tarren-mill,670,priest,shadow,12,7,5
Sáro,ravencrest,669,priest,shadow,12,7,5
Bonbonici,sylvanas,666,priest,shadow,12,7,5
Ruhoniy,ysondre,658,priest,shadow,12,7,5
Eryxial,antonidas,655,priest,shadow,17,7,10
Ladouce,archimonde,624,priest,shadow,15,8,7
Brainwash,darksorrow,608,priest,shadow,16,7,9
Bøts,ravencrest,607,priest,shadow,14,7,7
Fåith,twilights-hammer,576,priest,shadow,6,6,0
Lr,aszune,576,priest,shadow,6,6,0
Uselessxasel,sanguino,576,priest,shadow,6,6,0
Stèálth,sylvanas,576,priest,shadow,6,6,0
Toesxcker,stormscale,576,priest,shadow,6,6,0
Kirrako,tarren-mill,576,priest,shadow,6,6,0
Ekkfwiedrice,ragnaros,576,priest,shadow,6,6,0
Voidgodx,blackrock,576,priest,shadow,12,6,6
Varjomies,ragnaros,576,priest,shadow,12,6,6
Cultist,defias-brotherhood,576,priest,shadow,12,6,6
Smiles,burning-steppes,576,priest,shadow,12,6,6
Skyfour,blackmoore,576,priest,shadow,12,6,6
Carmechanic,defias-brotherhood,576,priest,shadow,12,6,6
Genthus,kazzak,576,priest,shadow,12,6,6
Saliâ,blackmoore,576,priest,shadow,12,6,6
Babydark,ravencrest,576,priest,shadow,12,6,6
Бранлор,howling-fjord,576,priest,shadow,12,6,6
Miraçlê,kazzak,576,priest,shadow,12,6,6
Raisedbyrap,blackrock,576,priest,shadow,12,6,6
Jaimë,ravencrest,576,priest,shadow,12,6,6
Pandacore,frostmane,576,priest,shadow,12,6,6
Fluffieh,ravencrest,576,priest,shadow,12,6,6
Syam,dun-morogh,576,priest,shadow,18,6,12
Healiea,outland,576,priest,shadow,18,6,12
Нитровина,howling-fjord,575,priest,shadow,12,6,6
Princéssà,aegwynn,575,priest,shadow,12,6,6
Inei,doomhammer,575,priest,shadow,12,6,6
ßeastx,nethersturm,575,priest,shadow,12,6,6
Lathas,bloodfeather,574,priest,shadow,12,6,6
Reptika,tichondrius,573,priest,shadow,12,6,6
Dayowe,antonidas,571,priest,shadow,12,6,6
Rzktwo,eredar,543,priest,shadow,11,6,5
Minabonxx,silvermoon,543,priest,shadow,22,6,16
Ðizzi,dun-modr,522,priest,shadow,15,8,7
Õðæßìùa,kazzak,511,priest,shadow,11,6,5
Sayash,chamber-of-aspects,495,priest,shadow,14,6,8
Drarianna,nemesis,480,priest,shadow,6,5,1
Øhlø,ysondre,480,priest,shadow,6,5,1
Huffle,argent-dawn,480,priest,shadow,6,5,1
Zevulós,ravencrest,480,priest,shadow,6,5,1
Rinkahands,silvermoon,480,priest,shadow,6,5,1
Darkqt,ravencrest,480,priest,shadow,6,5,1
Potati,defias-brotherhood,480,priest,shadow,6,5,1
Енотхд,soulflayer,480,priest,shadow,6,5,1
Скизма,gordunni,480,priest,shadow,6,5,1
Jingling,kazzak,480,priest,shadow,6,5,1
Attilerg,stormscale,480,priest,shadow,6,5,1
Døtgdx,archimonde,480,priest,shadow,6,5,1
Raeratwo,archimonde,480,priest,shadow,6,5,1
Dümbledore,aggra-português,480,priest,shadow,6,5,1
Shadowful,drakthul,480,priest,shadow,12,5,7
Manyus,archimonde,480,priest,shadow,12,5,7
Svenskabarn,twisting-nether,480,priest,shadow,12,5,7
Kwolinger,norgannon,480,priest,shadow,12,5,7
Imaut,emerald-dream,480,priest,shadow,12,5,7
Rovensin,ravencrest,480,priest,shadow,12,5,7
Rokil,ravencrest,480,priest,shadow,12,5,7
Cmonbro,hyjal,480,priest,shadow,12,5,7
Darrianna,outland,480,priest,shadow,12,5,7
Homxcxde,ravencrest,480,priest,shadow,12,5,7
Lildiggy,outland,480,priest,shadow,12,5,7
Môrtïciâ,tarren-mill,480,priest,shadow,12,5,7
Majinbuù,sargeras,480,priest,shadow,12,5,7
Rakkha,ravencrest,480,priest,shadow,12,5,7
Felaenna,argent-dawn,480,priest,shadow,12,5,7
Shucks,stormscale,480,priest,shadow,12,5,7
Seenoend,neptulon,480,priest,shadow,12,5,7
Jonig,blackmoore,480,priest,shadow,18,5,13
Lasdrael,dun-modr,479,priest,shadow,6,5,1
Inzàné,kazzak,479,priest,shadow,6,5,1
Rogmisa,cthun,479,priest,shadow,12,5,7
Sucukpriest,blackrock,479,priest,shadow,12,5,7
Heinricht,ragnaros,479,priest,shadow,12,5,7
Tyene,voljin,448,priest,shadow,10,5,5
Bimboxo,argent-dawn,413,priest,shadow,16,5,11
Levitation,alakir,384,priest,shadow,6,4,2
Lumex,aegwynn,384,priest,shadow,6,4,2
Hòllymèdx,blackmoore,384,priest,shadow,6,4,2
Говорун,grom,384,priest,shadow,6,4,2
Deeforce,argent-dawn,384,priest,shadow,6,4,2
Jpxoxo,blackhand,384,priest,shadow,6,4,2
Mafiasnipers,ravencrest,384,priest,shadow,6,4,2
Alinfinito,ravencrest,384,priest,shadow,6,4,2
Sandcastles,ravencrest,384,priest,shadow,6,4,2
Lysium,sylvanas,384,priest,shadow,6,4,2
Roastie,frostmane,384,priest,shadow,6,4,2
Majestíc,blackmoore,384,priest,shadow,6,4,2
Valaç,turalyon,384,priest,shadow,6,4,2
Вэстервилли,howling-fjord,384,priest,shadow,6,4,2
Yoggies,tarren-mill,384,priest,shadow,6,4,2
Torino,kazzak,384,priest,shadow,6,4,2
Слышуфонк,howling-fjord,384,priest,shadow,6,4,2
Ðanilox,dun-modr,384,priest,shadow,6,4,2
Dumámày,silvermoon,384,priest,shadow,6,4,2
Ottii,thrall,384,priest,shadow,6,4,2
Zindrix,silvermoon,384,priest,shadow,6,4,2
Gbc,emerald-dream,384,priest,shadow,6,4,2
Kobiden,stormreaver,384,priest,shadow,6,4,2
Velence,ravencrest,384,priest,shadow,6,4,2
Bubbleup,defias-brotherhood,384,priest,shadow,6,4,2
Êlectron,ravencrest,384,priest,shadow,6,4,2
Diha,argent-dawn,384,priest,shadow,6,4,2
Mérce,kazzak,384,priest,shadow,6,4,2
Draryanna,nemesis,384,priest,shadow,6,4,2
Shadowboness,twisting-nether,384,priest,shadow,6,4,2
Controlled,tarren-mill,384,priest,shadow,6,4,2
Spherics,ravencrest,384,priest,shadow,6,4,2
Spae,twisting-nether,384,priest,shadow,6,4,2
Alicanx,twisting-nether,384,priest,shadow,6,4,2
Alusiepriest,ravencrest,384,priest,shadow,6,4,2
Looó,los-errantes,384,priest,shadow,6,4,2
Шучунекошмар,soulflayer,384,priest,shadow,6,4,2
Nìak,ysondre,384,priest,shadow,15,5,10
Bacovia,tarren-mill,384,priest,shadow,12,4,8
Трейдарк,blackscar,384,priest,shadow,12,4,8
Dpriesta,aegwynn,384,priest,shadow,12,4,8
Ларчшп,gordunni,384,priest,shadow,12,4,8
Psystorm,frostmane,384,priest,shadow,12,4,8
Shadøwz,grim-batol,384,priest,shadow,12,4,8
Swoptoplong,blackhand,384,priest,shadow,12,4,8
Отчепадре,gordunni,384,priest,shadow,12,4,8
Secundis,silvermoon,384,priest,shadow,12,4,8
Umbrazoid,sanguino,384,priest,shadow,12,4,8
Gerase,blackrock,384,priest,shadow,12,4,8
Zultor,ragnaros,384,priest,shadow,13,4,9
Chlorohhkine,chogall,384,priest,shadow,13,4,9
Redfield,frostmane,383,priest,shadow,12,4,8
Stoffig,aggramar,382,priest,shadow,6,4,2
Perchédue,silvermoon,367,priest,shadow,11,4,7
Tsunadesaama,silvermoon,367,priest,shadow,11,4,7
Aeo,twisting-nether,351,priest,shadow,11,4,7
Alfredosauce,stormscale,351,priest,shadow,11,4,7
Solaní,antonidas,335,priest,shadow,11,4,7
Rasha,kazzak,288,priest,shadow,6,3,3
Lethaa,twisting-nether,288,priest,shadow,6,3,3
Jacep,kazzak,288,priest,shadow,6,3,3
Uria,moonglade,288,priest,shadow,6,3,3
Liliashet,sanguino,288,priest,shadow,6,3,3
Maela,uldum,288,priest,shadow,6,3,3
Imadîa,dalaran,288,priest,shadow,6,3,3
Ggsus,outland,288,priest,shadow,6,3,3
Xpy,kazzak,288,priest,shadow,6,3,3
Qwertyuioasd,ravencrest,288,priest,shadow,6,3,3
Stinkycreep,executus,288,priest,shadow,6,3,3
Dboi,tarren-mill,288,priest,shadow,6,3,3
Laffy,saurfang,288,priest,shadow,6,3,3
Linara,frostmane,288,priest,shadow,6,3,3
Skymning,tarren-mill,288,priest,shadow,6,3,3
Abyssonmind,dun-modr,288,priest,shadow,6,3,3
Zøid,ysondre,288,priest,shadow,6,3,3
Holybestie,eredar,288,priest,shadow,6,3,3
Wkid,draenor,288,priest,shadow,6,3,3
Roxfer,ysondre,288,priest,shadow,6,3,3
Ragwitch,draenor,288,priest,shadow,6,3,3
Poposy,hyjal,288,priest,shadow,6,3,3
Papynou,garona,288,priest,shadow,6,3,3
Nhajÿ,hyjal,288,priest,shadow,6,3,3
Arratør,ysondre,288,priest,shadow,6,3,3
Prästjäväln,stormscale,288,priest,shadow,6,3,3
Hilerki,draenor,288,priest,shadow,6,3,3
Sweedensp,hyjal,288,priest,shadow,6,3,3
Vilayetko,ravencrest,288,priest,shadow,6,3,3
Nukyo,blackmoore,288,priest,shadow,6,3,3
Даняпимпгадх,soulflayer,288,priest,shadow,6,3,3
Pbwser,silvermoon,288,priest,shadow,6,3,3
Korzec,dun-modr,288,priest,shadow,6,3,3
Bubidiblumpr,twisting-nether,288,priest,shadow,6,3,3
Мариаглорум,gordunni,288,priest,shadow,6,3,3
Freezydot,silvermoon,288,priest,shadow,6,3,3
Stepsisstuck,ragnaros,288,priest,shadow,6,3,3
Maskinjundre,bronzebeard,288,priest,shadow,6,3,3
Heygoogle,ravencrest,288,priest,shadow,6,3,3
Ктулсотум,soulflayer,288,priest,shadow,6,3,3
Montane,wrathbringer,288,priest,shadow,6,3,3
Omnissiiah,silvermoon,288,priest,shadow,6,3,3
Solítude,darkmoon-faire,288,priest,shadow,6,3,3
Allanna,talnivarr,288,priest,shadow,6,3,3
Dolens,argent-dawn,288,priest,shadow,6,3,3
Strunkiin,defias-brotherhood,288,priest,shadow,6,3,3
Presbyter,mazrigos,288,priest,shadow,6,3,3
Xayona,argent-dawn,288,priest,shadow,6,3,3
Лиройгеморой,gordunni,288,priest,shadow,6,3,3
Kallsen,ravencrest,288,priest,shadow,6,3,3
Kopfsache,blackmoore,288,priest,shadow,7,3,4
Wintercurse,twisting-nether,288,priest,shadow,12,3,9
Damnedangel,drakthul,288,priest,shadow,12,3,9
Cthultist,dun-modr,288,priest,shadow,12,3,9
Nesar,stormscale,288,priest,shadow,12,3,9
Lynseanna,ravencrest,288,priest,shadow,12,3,9
Elumi,the-maelstrom,288,priest,shadow,12,3,9
Charmebolzen,blackrock,288,priest,shadow,12,3,9
Kaenlin,the-maelstrom,288,priest,shadow,18,3,15
Васпохилить,howling-fjord,288,priest,shadow,18,3,15
Jês,thrall,287,priest,shadow,6,3,3
Phasmofobia,ragnaros,287,priest,shadow,6,3,3
Намдандар,howling-fjord,287,priest,shadow,6,3,3
Мргорсан,eversong,287,priest,shadow,6,3,3
Syfl,defias-brotherhood,287,priest,shadow,12,3,9
Irrtum,nozdormu,286,priest,shadow,6,3,3
Endchor,eredar,286,priest,shadow,6,3,3
Czikibriki,ravenholdt,256,priest,shadow,4,4,0
Tweediertie,argent-dawn,239,priest,shadow,5,3,2
Guccimaane,twisting-nether,239,priest,shadow,5,3,2
Alpharîus,argent-dawn,192,priest,shadow,6,2,4
Sigor,hellfire,192,priest,shadow,6,2,4
Spyrono,kazzak,192,priest,shadow,6,2,4
Zikár,kazzak,192,priest,shadow,6,2,4
Shopify,nagrand,192,priest,shadow,6,2,4
Whocare,tarren-mill,192,priest,shadow,6,2,4
Bodeeney,hellfire,192,priest,shadow,6,2,4
Vregoa,twisting-nether,192,priest,shadow,6,2,4
Notdespo,kazzak,192,priest,shadow,6,2,4
Шадоупуз,soulflayer,192,priest,shadow,6,2,4
Bandgap,antonidas,192,priest,shadow,6,2,4
Ràthaløs,sanguino,192,priest,shadow,6,2,4
Triinkett,doomhammer,192,priest,shadow,6,2,4
Arunp,magtheridon,192,priest,shadow,6,2,4
Vengigodxx,ravencrest,192,priest,shadow,6,2,4
Низара,deathguard,192,priest,shadow,6,2,4
Kidkuddo,blackmoore,192,priest,shadow,6,2,4
Crzzy,dun-modr,192,priest,shadow,6,2,4
Sotriggered,sylvanas,192,priest,shadow,6,2,4
Wiglere,argent-dawn,192,priest,shadow,6,2,4
Aruna,ravencrest,192,priest,shadow,6,2,4
Cdplz,archimonde,192,priest,shadow,6,2,4
Calïxløve,der-rat-von-dalaran,192,priest,shadow,6,2,4
Xaeroow,archimonde,192,priest,shadow,6,2,4
Phobò,blackrock,192,priest,shadow,6,2,4
Xiä,archimonde,192,priest,shadow,6,2,4
Atelstan,drakthul,192,priest,shadow,6,2,4
Trencharse,draenor,192,priest,shadow,6,2,4
Rallzken,stormscale,192,priest,shadow,6,2,4
Hadsup,stormscale,192,priest,shadow,6,2,4
Cto,gorgonnash,192,priest,shadow,6,2,4
Omejan,frostmane,192,priest,shadow,6,2,4
Мсикатана,gordunni,192,priest,shadow,6,2,4
Шарадин,gordunni,192,priest,shadow,6,2,4
Babarøga,blackrock,192,priest,shadow,6,2,4
Shinesomnya,aegwynn,192,priest,shadow,6,2,4
Nomarak,drakthul,192,priest,shadow,6,2,4
Önnÿ,dun-modr,192,priest,shadow,12,2,10
Семмэр,gordunni,192,priest,shadow,12,2,10
Karmapollys,silvermoon,191,priest,shadow,6,2,4
Caballococo,dun-modr,175,priest,shadow,11,2,9
Edoran,ragnaros,159,priest,shadow,5,2,3
Qku,ravencrest,144,priest,shadow,9,3,6
Пампгодх,howling-fjord,138,priest,shadow,10,4,6
Alswynn,draenor,138,priest,shadow,13,3,10
Reeflix,blackmoore,96,priest,shadow,3,2,1
Abudhabi,blackhand,96,priest,shadow,6,1,5
Tryagain,ravencrest,96,priest,shadow,6,1,5
Tùcøcø,archimonde,96,priest,shadow,6,1,5
Абсорбиболь,howling-fjord,96,priest,shadow,6,1,5
Kristiflicka,kazzak,96,priest,shadow,6,1,5
Stola,archimonde,96,priest,shadow,6,1,5
Sacher,shendralar,96,priest,shadow,6,1,5
Vès,stormscale,96,priest,shadow,6,1,5
Khäñ,ravencrest,96,priest,shadow,6,1,5
Мегаствол,howling-fjord,96,priest,shadow,6,1,5
Gobie,sunstrider,96,priest,shadow,6,1,5
Jakepriest,twisting-nether,96,priest,shadow,6,1,5
Baltrom,ravencrest,96,priest,shadow,6,1,5
Jarkk,ysondre,96,priest,shadow,6,1,5
Koíré,defias-brotherhood,96,priest,shadow,6,1,5
Maddøc,die-aldor,96,priest,shadow,6,1,5
Kianprie,silvermoon,96,priest,shadow,6,1,5
Yonaka,amanthul,96,priest,shadow,12,1,11
Gandals,shadowsong,64,priest,shadow,4,1,3
Xharyo,ravencrest,64,priest,shadow,4,1,3
Achesita,sylvanas,48,priest,shadow,3,1,2
Rãz,stormscale,2130,rogue,outlaw,66,36,30
Kekuriix,vashj,1819,rogue,outlaw,76,40,36
Lidiaubaro,ravencrest,1570,rogue,outlaw,83,39,44
Deevoll,tarren-mill,1563,rogue,outlaw,90,42,48
Зувер,blackscar,1442,rogue,outlaw,48,26,22
Bonelesschic,silvermoon,1429,rogue,outlaw,41,24,17
Syrn,ravencrest,1421,rogue,outlaw,30,15,15
Nèwt,aggramar,1419,rogue,outlaw,84,40,44
Sigleif,argent-dawn,1407,rogue,outlaw,54,25,29
Cryneth,ravencrest,1373,rogue,outlaw,51,25,26
Jasolo,silvermoon,1343,rogue,outlaw,78,48,30
Tidløs,dun-morogh,1270,rogue,outlaw,41,15,26
Djeud,archimonde,1230,rogue,outlaw,34,17,17
Carvyn,defias-brotherhood,1221,rogue,outlaw,27,14,13
Scotlander,argent-dawn,1143,rogue,outlaw,24,12,12
Spiochrr,burning-legion,1064,rogue,outlaw,44,17,27
Svddendeath,ragnaros,1034,rogue,outlaw,24,11,13
Murkyy,gilneas,924,rogue,outlaw,20,11,9
Melahl,kazzak,909,rogue,outlaw,18,11,7
Bxtchslayer,blackmoore,876,rogue,outlaw,18,10,8
Шторкаа,gordunni,868,rogue,outlaw,19,10,9
Radiogodx,stormscale,863,rogue,outlaw,24,9,15
Kreay,tarren-mill,862,rogue,outlaw,12,9,3
Ранконх,lich-king,768,rogue,outlaw,24,8,16
Джулт,soulflayer,767,rogue,outlaw,24,8,16
Blàckbèàrd,silvermoon,743,rogue,outlaw,24,9,15
Kreayx,ysondre,672,rogue,outlaw,12,7,5
Loubina,silvermoon,672,rogue,outlaw,12,7,5
Kreay,ysondre,672,rogue,outlaw,12,7,5
Kidneyou,ragnaros,672,rogue,outlaw,18,7,11
Rogiko,twisting-nether,672,rogue,outlaw,18,7,11
Shichi,archimonde,655,rogue,outlaw,17,7,10
Jalsket,tarren-mill,576,rogue,outlaw,12,6,6
Badabôôm,wrathbringer,575,rogue,outlaw,12,6,6
Noodlegoose,tarren-mill,575,rogue,outlaw,12,6,6
Pidroseus,argent-dawn,575,rogue,outlaw,12,6,6
Lättja,hyjal,574,rogue,outlaw,12,6,6
Тимареканец,eversong,572,rogue,outlaw,18,6,12
Zômbiê,blackrock,491,rogue,outlaw,13,6,7
Lïke,frostwolf,480,rogue,outlaw,6,5,1
Eukaryot,aggra-português,480,rogue,outlaw,6,5,1
Featfawkes,ragnaros,480,rogue,outlaw,12,5,7
Koopa,argent-dawn,480,rogue,outlaw,12,5,7
Fivepoint,blackmoore,480,rogue,outlaw,12,5,7
Дизелюжн,howling-fjord,480,rogue,outlaw,12,5,7
Chillo,ravencrest,384,rogue,outlaw,6,4,2
Synexo,sylvanas,384,rogue,outlaw,12,4,8
Bannedfrigid,outland,384,rogue,outlaw,12,4,8
Кингксу,gordunni,384,rogue,outlaw,18,4,14
Trímønâ,gorgonnash,351,rogue,outlaw,11,4,7
Cigarette,emeriss,288,rogue,outlaw,6,3,3
Onlyluvhurt,dun-modr,288,rogue,outlaw,6,3,3
Vokhun,outland,288,rogue,outlaw,6,3,3
Heulleise,die-ewige-wacht,288,rogue,outlaw,12,3,9
Finisher,sanguino,288,rogue,outlaw,12,3,9
Krixor,ravencrest,288,rogue,outlaw,12,3,9
Mcgora,doomhammer,286,rogue,outlaw,6,3,3
Omuspan,magtheridon,285,rogue,outlaw,12,3,9
Soothinqq,emerald-dream,238,rogue,outlaw,5,3,2
Оргельна,gordunni,192,rogue,outlaw,6,2,4
Nyxal,argent-dawn,192,rogue,outlaw,6,2,4
Zind,dalaran,192,rogue,outlaw,6,2,4
Макевин,gordunni,192,rogue,outlaw,12,2,10
Hânnäh,hyjal,191,rogue,outlaw,6,2,4
Matchfixer,moonglade,138,rogue,outlaw,10,3,7
Alvoriace,hyjal,96,rogue,outlaw,6,1,5
Mallaurya,dalaran,96,rogue,outlaw,6,1,5
Ciaordel,sylvanas,96,rogue,outlaw,6,1,5
Dredge,kaelthas,96,rogue,outlaw,6,1,5
Yüm,burning-blade,96,rogue,outlaw,6,1,5
Фофламидзе,gordunni,47,rogue,outlaw,3,1,2
Denjinx,culte-de-la-rive-noire,2107,rogue,subtlety,78,43,35
Смертьвсмоке,gordunni,1917,rogue,subtlety,74,35,39
Pridå,thrall,1912,rogue,subtlety,60,30,30
Asterisyup,silvermoon,1879,rogue,subtlety,83,51,32
Пожилойпупь,gordunni,1869,rogue,subtlety,36,20,16
Sapécomejaja,archimonde,1866,rogue,subtlety,38,24,14
Brensø,nemesis,1857,rogue,subtlety,99,60,39
Âkame,argent-dawn,1853,rogue,subtlety,59,32,27
Nàsklolz,hyjal,1842,rogue,subtlety,48,24,24
Radiogodx,stormscale,1832,rogue,subtlety,42,23,19
Флексити,soulflayer,1832,rogue,subtlety,60,30,30
Лолелт,borean-tundra,1830,rogue,subtlety,62,31,31
Chatdisabled,drakthul,1830,rogue,subtlety,84,41,43
Iqws,ravencrest,1811,rogue,subtlety,54,29,25
Chatbann,blackrock,1809,rogue,subtlety,82,48,34
Troxerboxer,tarren-mill,1806,rogue,subtlety,42,22,20
Xtoyo,zuljin,1804,rogue,subtlety,54,29,25
Malasap,archimonde,1776,rogue,subtlety,104,59,45
Vulkos,lightbringer,1758,rogue,subtlety,42,20,22
Sábros,ravencrest,1743,rogue,subtlety,90,42,48
Trîçk,aegwynn,1719,rogue,subtlety,36,23,13
Yumiee,arygos,1697,rogue,subtlety,80,44,36
Lówskill,outland,1692,rogue,subtlety,48,23,25
Rhayesh,silvermoon,1678,rogue,subtlety,88,41,47
Роземсти,gordunni,1676,rogue,subtlety,74,38,36
Renhri,burning-legion,1667,rogue,subtlety,155,79,76
Ccedolol,stormscale,1662,rogue,subtlety,59,32,27
Røgger,ragnaros,1655,rogue,subtlety,35,18,17
Lilaven,turalyon,1650,rogue,subtlety,39,21,18
Getschwîfty,ravencrest,1639,rogue,subtlety,27,18,9
Shadezlöl,ravencrest,1639,rogue,subtlety,48,22,26
Dancex,kazzak,1634,rogue,subtlety,42,28,14
Ipresskidney,tarren-mill,1630,rogue,subtlety,75,47,28
Tinylol,dun-morogh,1620,rogue,subtlety,48,29,19
Эмилилавс,galakrond,1616,rogue,subtlety,30,18,12
Insomnla,silvermoon,1615,rogue,subtlety,43,22,21
Ratirl,kult-der-verdammten,1603,rogue,subtlety,30,19,11
Tanssy,ragnaros,1603,rogue,subtlety,44,25,19
Naïmitsu,hyjal,1597,rogue,subtlety,36,21,15
Txm,argent-dawn,1590,rogue,subtlety,36,18,18
Морзо,howling-fjord,1582,rogue,subtlety,66,39,27
Oxyrog,ravencrest,1580,rogue,subtlety,42,22,20
Ishízu,exodar,1572,rogue,subtlety,48,20,28
Sinist,twisting-nether,1531,rogue,subtlety,50,23,27
Zilemjr,stormscale,1522,rogue,subtlety,30,19,11
Бладстейн,blackscar,1512,rogue,subtlety,34,21,13
Johnnyprep,ravencrest,1511,rogue,subtlety,36,22,14
Шпилля,gordunni,1505,rogue,subtlety,48,24,24
Ramses,onyxia,1505,rogue,subtlety,42,18,24
Handuil,blackmoore,1488,rogue,subtlety,36,17,19
Meccura,silvermoon,1484,rogue,subtlety,39,22,17
Inyria,outland,1477,rogue,subtlety,76,41,35
Ibizå,ravencrest,1477,rogue,subtlety,36,18,18
Абисиан,soulflayer,1456,rogue,subtlety,54,28,26
Onlyluvhurt,dun-modr,1451,rogue,subtlety,58,32,26
Ванэйти,gordunni,1446,rogue,subtlety,96,52,44
Dêlaral,blackhand,1437,rogue,subtlety,30,15,15
Deathcvlt,hyjal,1428,rogue,subtlety,60,29,31
Svddendeath,ragnaros,1427,rogue,subtlety,30,17,13
Дернирог,howling-fjord,1418,rogue,subtlety,30,17,13
Sniiky,kazzak,1415,rogue,subtlety,24,16,8
Эренх,gordunni,1385,rogue,subtlety,42,19,23
Voki,dalaran,1376,rogue,subtlety,24,15,9
Sumsarx,ravencrest,1374,rogue,subtlety,65,31,34
Зорго,deathguard,1366,rogue,subtlety,30,15,15
Achterom,tarren-mill,1366,rogue,subtlety,62,24,38
Spr,malfurion,1354,rogue,subtlety,62,33,29
Huej,tarren-mill,1353,rogue,subtlety,48,32,16
Эдкенуэй,gordunni,1351,rogue,subtlety,47,25,22
Morgan,argent-dawn,1349,rogue,subtlety,36,20,16
Dàwn,boulderfist,1349,rogue,subtlety,46,25,21
Cheapshôt,archimonde,1347,rogue,subtlety,40,19,21
Asm,the-maelstrom,1344,rogue,subtlety,18,14,4
Illmatíc,ravencrest,1344,rogue,subtlety,24,14,10
Smøkyyx,eredar,1342,rogue,subtlety,30,14,16
Dölf,archimonde,1333,rogue,subtlety,29,17,12
Luckeri,antonidas,1328,rogue,subtlety,54,27,27
Lilrookie,argent-dawn,1327,rogue,subtlety,50,30,20
Nexieane,ravencrest,1324,rogue,subtlety,72,39,33
Солевыегубки,gordunni,1322,rogue,subtlety,24,14,10
Jáyjay,antonidas,1322,rogue,subtlety,30,14,16
Grzech,burning-legion,1308,rogue,subtlety,30,14,16
Azovrouge,terokkar,1304,rogue,subtlety,18,14,4
Ксионас,gordunni,1296,rogue,subtlety,70,33,37
Mxx,stormscale,1278,rogue,subtlety,42,25,17
Wraithh,minahonda,1275,rogue,subtlety,24,14,10
Старллесс,gordunni,1261,rogue,subtlety,60,29,31
Usainßreak,chogall,1258,rogue,subtlety,24,14,10
Billybang,outland,1257,rogue,subtlety,23,14,9
Subzy,burning-legion,1257,rogue,subtlety,30,18,12
Zuqzwang,outland,1247,rogue,subtlety,24,13,11
Sunå,archimonde,1247,rogue,subtlety,24,13,11
Sashikorosu,archimonde,1245,rogue,subtlety,22,14,8
Clawdíte,blackrock,1245,rogue,subtlety,36,13,23
Тучёна,soulflayer,1243,rogue,subtlety,42,25,17
Pfourtwenty,eredar,1243,rogue,subtlety,24,13,11
Китей,howling-fjord,1242,rogue,subtlety,30,13,17
Adwl,archimonde,1226,rogue,subtlety,45,20,25
Althieves,ravencrest,1216,rogue,subtlety,18,13,5
Architeggt,eredar,1209,rogue,subtlety,38,14,24
Levíeus,blackrock,1206,rogue,subtlety,18,14,4
Рестинписер,soulflayer,1204,rogue,subtlety,24,13,11
Keophz,tarren-mill,1203,rogue,subtlety,24,13,11
Avøry,antonidas,1201,rogue,subtlety,30,13,17
Ézzah,blackhand,1192,rogue,subtlety,33,14,19
ßøß,ysondre,1188,rogue,subtlety,26,15,11
Darkan,kaelthas,1159,rogue,subtlety,48,29,19
Howton,archimonde,1152,rogue,subtlety,18,12,6
Sénsorium,draenor,1148,rogue,subtlety,37,15,22
Appatras,tarren-mill,1147,rogue,subtlety,18,12,6
Teba,cthun,1143,rogue,subtlety,22,13,9
Sâybyëbæ,dun-modr,1142,rogue,subtlety,30,12,18
Zx,frostmane,1140,rogue,subtlety,24,12,12
Monoxid,eredar,1128,rogue,subtlety,24,12,12
Xblackhole,tarren-mill,1128,rogue,subtlety,30,12,18
Nightq,tarren-mill,1126,rogue,subtlety,24,12,12
Зенофар,soulflayer,1124,rogue,subtlety,29,12,17
Попочке,soulflayer,1116,rogue,subtlety,18,13,5
Calpic,sanguino,1115,rogue,subtlety,30,12,18
Mâêl,blackmoore,1113,rogue,subtlety,29,12,17
Xeggy,turalyon,1112,rogue,subtlety,18,12,6
Ryzem,archimonde,1091,rogue,subtlety,54,28,26
Unreallx,silvermoon,1077,rogue,subtlety,68,29,39
Löka,amanthul,1071,rogue,subtlety,117,59,58
Tripx,ravencrest,1062,rogue,subtlety,19,12,7
Shoxy,ravencrest,1056,rogue,subtlety,21,12,9
Ccedox,stormscale,1055,rogue,subtlety,18,11,7
Инфера,lich-king,1055,rogue,subtlety,24,11,13
Флеймсфорт,gordunni,1055,rogue,subtlety,35,16,19
Kleptomancy,sylvanas,1054,rogue,subtlety,18,11,7
Îlîlîlîlîlî,azuremyst,1053,rogue,subtlety,33,15,18
Cøntrøl,stormreaver,1050,rogue,subtlety,18,11,7
Maam,ravencrest,1046,rogue,subtlety,18,11,7
Leepz,outland,1043,rogue,subtlety,18,11,7
Коффемолка,ashenvale,1037,rogue,subtlety,24,11,13
Ithru,twisting-nether,1035,rogue,subtlety,102,51,51
Binbág,draenor,1030,rogue,subtlety,18,11,7
Ултра,gordunni,1025,rogue,subtlety,27,11,16
Thehand,eonar,1016,rogue,subtlety,18,11,7
Swâggerino,kazzak,1004,rogue,subtlety,26,12,14
Stuxothug,silvermoon,981,rogue,subtlety,17,11,6
Cazzette,ravencrest,976,rogue,subtlety,13,11,2
Cuckboy,chogall,973,rogue,subtlety,27,16,11
Pochîta,blackrock,964,rogue,subtlety,35,13,22
Lfgenjoyer,tarren-mill,960,rogue,subtlety,12,10,2
Noboorstsub,ravencrest,959,rogue,subtlety,12,10,2
Кишмякх,howling-fjord,959,rogue,subtlety,36,10,26
Ÿøßø,archimonde,958,rogue,subtlety,18,10,8
Хавиа,gordunni,958,rogue,subtlety,18,10,8
Skýfire,ravencrest,957,rogue,subtlety,24,10,14
Rogueas,stormscale,956,rogue,subtlety,18,10,8
Mishøna,kazzak,951,rogue,subtlety,12,10,2
Qiiss,stormscale,949,rogue,subtlety,18,10,8
Callboy,turalyon,949,rogue,subtlety,24,10,14
Skillissuex,tarren-mill,939,rogue,subtlety,18,10,8
Сладкийперец,borean-tundra,939,rogue,subtlety,22,11,11
Сабанутый,howling-fjord,938,rogue,subtlety,42,21,21
Lovetospoon,ravencrest,937,rogue,subtlety,25,11,14
Kezaay,silvermoon,923,rogue,subtlety,24,13,11
Whaiipy,ravencrest,908,rogue,subtlety,44,23,21
Sentaria,argent-dawn,903,rogue,subtlety,36,18,18
Knoffchad,blackhand,894,rogue,subtlety,20,10,10
Oazo,ysondre,892,rogue,subtlety,29,11,18
Katarïnä,khaz-modan,887,rogue,subtlety,24,11,13
Hemorhoid,outland,884,rogue,subtlety,42,21,21
Bleeds,thrall,875,rogue,subtlety,17,10,7
Псиихооз,eversong,867,rogue,subtlety,19,10,9
Фрозенденс,gordunni,864,rogue,subtlety,12,9,3
Stonyhavana,ravencrest,864,rogue,subtlety,12,9,3
Calestrian,tarren-mill,864,rogue,subtlety,18,9,9
Baldoh,kazzak,863,rogue,subtlety,12,9,3
Namelless,twisting-nether,863,rogue,subtlety,18,9,9
Cørek,blackhand,863,rogue,subtlety,18,9,9
Márto,archimonde,863,rogue,subtlety,24,9,15
Lânnïster,kazzak,863,rogue,subtlety,24,9,15
Сабик,howling-fjord,862,rogue,subtlety,12,9,3
Crixor,blackrock,861,rogue,subtlety,12,9,3
Cesârion,antonidas,860,rogue,subtlety,24,9,15
Eightball,frostmane,859,rogue,subtlety,18,9,9
Sequoja,blackrock,858,rogue,subtlety,24,9,15
Arrzhan,silvermoon,852,rogue,subtlety,12,9,3
Jugalos,ravencrest,847,rogue,subtlety,17,9,8
Sunø,archimonde,847,rogue,subtlety,29,9,20
Горланг,ashenvale,841,rogue,subtlety,18,9,9
Memphismp,drakthul,831,rogue,subtlety,17,9,8
Ganker,antonidas,830,rogue,subtlety,20,10,10
Liquidgaba,ravencrest,787,rogue,subtlety,36,13,23
Фрозенблейдс,gordunni,768,rogue,subtlety,12,8,4
Djdillá,kazzak,768,rogue,subtlety,12,8,4
Хасилей,booty-bay,768,rogue,subtlety,12,8,4
Whoton,archimonde,768,rogue,subtlety,16,9,7
Тохуо,lich-king,768,rogue,subtlety,18,8,10
Ач,gordunni,768,rogue,subtlety,18,8,10
Zygzäg,hyjal,768,rogue,subtlety,18,8,10
Zëkke,sanguino,767,rogue,subtlety,12,8,4
Bamsejuicee,kazzak,767,rogue,subtlety,12,8,4
Trimøná,gorgonnash,767,rogue,subtlety,12,8,4
Mdadx,stormreaver,767,rogue,subtlety,18,8,10
Vanéry,ravencrest,766,rogue,subtlety,12,8,4
Byonics,durotan,763,rogue,subtlety,12,8,4
Deprress,silvermoon,762,rogue,subtlety,12,8,4
Yamoshí,sanguino,756,rogue,subtlety,18,8,10
Drakhez,sanguino,752,rogue,subtlety,12,8,4
Mannheim,kazzak,749,rogue,subtlety,12,8,4
Stâr,archimonde,730,rogue,subtlety,16,8,8
Trapstar,stormscale,672,rogue,subtlety,12,7,5
Сильфитт,gordunni,672,rogue,subtlety,12,7,5
Änanké,outland,672,rogue,subtlety,12,7,5
Лэйкиро,gordunni,672,rogue,subtlety,12,7,5
Gankbang,frostmane,672,rogue,subtlety,12,7,5
Starfighter,pozzo-delleternità,672,rogue,subtlety,12,7,5
Kidknee,outland,672,rogue,subtlety,12,7,5
Социалистсс,gordunni,672,rogue,subtlety,18,7,11
Exanimu,ravencrest,672,rogue,subtlety,18,7,11
Kenjí,silvermoon,672,rogue,subtlety,18,7,11
Jkrx,draenor,671,rogue,subtlety,12,7,5
Nairobii,tarren-mill,671,rogue,subtlety,12,7,5
Hyake,zuljin,671,rogue,subtlety,12,7,5
Káríc,draenor,671,rogue,subtlety,12,7,5
Teralala,kazzak,671,rogue,subtlety,18,7,11
Maroshko,argent-dawn,671,rogue,subtlety,18,7,11
Daekrun,argent-dawn,670,rogue,subtlety,18,7,11
Sicariø,argent-dawn,669,rogue,subtlety,18,7,11
Coronababy,argent-dawn,668,rogue,subtlety,12,7,5
Ракфорн,howling-fjord,668,rogue,subtlety,24,7,17
Pepperbox,twisting-nether,667,rogue,subtlety,12,7,5
Thicck,twisting-nether,667,rogue,subtlety,30,8,22
Cacucoxpahu,kazzak,666,rogue,subtlety,12,7,5
Strangeboy,ravencrest,576,rogue,subtlety,6,6,0
Погибайдуде,gordunni,576,rogue,subtlety,6,6,0
Naiikaii,antonidas,576,rogue,subtlety,6,6,0
Шадовкилер,blackscar,576,rogue,subtlety,12,6,6
Vensq,drakthul,576,rogue,subtlety,12,6,6
Feradelia,thrall,576,rogue,subtlety,12,6,6
Bleakhøuse,ravencrest,576,rogue,subtlety,12,6,6
Àlleyezonme,ravencrest,576,rogue,subtlety,12,6,6
Bizzarerogue,tarren-mill,576,rogue,subtlety,12,6,6
Sly,emerald-dream,576,rogue,subtlety,12,6,6
Ibizà,ravencrest,576,rogue,subtlety,12,6,6
Blihhubba,silvermoon,576,rogue,subtlety,18,6,12
Tracersxrude,ravencrest,576,rogue,subtlety,18,6,12
Stabymoose,draenor,575,rogue,subtlety,12,6,6
Пусякиллерх,gordunni,575,rogue,subtlety,12,6,6
Grifika,outland,575,rogue,subtlety,12,6,6
Wøølfgang,archimonde,575,rogue,subtlety,18,6,12
Gansull,nemesis,575,rogue,subtlety,18,6,12
Jisz,doomhammer,574,rogue,subtlety,12,6,6
Hersuub,blackmoore,574,rogue,subtlety,12,6,6
Blantek,defias-brotherhood,573,rogue,subtlety,12,6,6
Freddybst,twisting-nether,571,rogue,subtlety,12,6,6
Lêvî,sanguino,569,rogue,subtlety,12,6,6
Grikra,argent-dawn,566,rogue,subtlety,12,6,6
Abomïñatïøñ,ravencrest,565,rogue,subtlety,12,6,6
Faable,silvermoon,544,rogue,subtlety,17,6,11
Niinim,draenor,539,rogue,subtlety,21,7,14
Malignance,drakthul,511,rogue,subtlety,14,7,7
Draytonlove,nemesis,480,rogue,subtlety,6,5,1
Дакоока,soulflayer,480,rogue,subtlety,6,5,1
Veryscaryguý,twisting-nether,480,rogue,subtlety,6,5,1
Loznah,outland,480,rogue,subtlety,12,5,7
Akyô,archimonde,480,rogue,subtlety,12,5,7
Mzaa,ravencrest,480,rogue,subtlety,12,5,7
Darkveil,xavius,480,rogue,subtlety,12,5,7
Amuini,magtheridon,480,rogue,subtlety,12,5,7
Críppléz,ravencrest,480,rogue,subtlety,12,5,7
Фрозеншедов,gordunni,480,rogue,subtlety,12,5,7
Киднитучер,fordragon,480,rogue,subtlety,12,5,7
Decoyed,sylvanas,480,rogue,subtlety,12,5,7
Kickcake,ravencrest,480,rogue,subtlety,12,5,7
Elfreyja,archimonde,480,rogue,subtlety,16,5,11
Zodracir,scarshield-legion,480,rogue,subtlety,18,5,13
Drydamage,kazzak,480,rogue,subtlety,18,5,13
Zobrak,twisting-nether,479,rogue,subtlety,12,5,7
Моямайя,eversong,479,rogue,subtlety,12,5,7
Ryxon,arathor,479,rogue,subtlety,12,5,7
Zanaken,stormscale,479,rogue,subtlety,12,5,7
Распяздяй,gordunni,479,rogue,subtlety,12,5,7
Hashlund,stormscale,479,rogue,subtlety,12,5,7
Прошмандэ,gordunni,479,rogue,subtlety,12,5,7
Zourkan,archimonde,479,rogue,subtlety,12,5,7
Yüm,burning-blade,478,rogue,subtlety,18,5,13
Mozenn,draenor,478,rogue,subtlety,19,5,14
Mallaurya,dalaran,474,rogue,subtlety,12,5,7
Nineball,frostmane,447,rogue,subtlety,11,5,6
Кумаме,howling-fjord,447,rogue,subtlety,11,5,6
Ålleyézonme,ravencrest,415,rogue,subtlety,11,5,6
Qylu,argent-dawn,384,rogue,subtlety,6,4,2
Grekén,bronze-dragonflight,384,rogue,subtlety,6,4,2
Джеанит,gordunni,384,rogue,subtlety,6,4,2
Djswaghetti,stormscale,384,rogue,subtlety,6,4,2
Naláa,ravencrest,384,rogue,subtlety,6,4,2
Ñavy,archimonde,384,rogue,subtlety,6,4,2
Mega,nordrassil,384,rogue,subtlety,6,4,2
Ocklol,archimonde,384,rogue,subtlety,6,4,2
Ciosy,blackrock,384,rogue,subtlety,6,4,2
Darksilencee,blackmoore,384,rogue,subtlety,6,4,2
Ninjaassasin,aegwynn,384,rogue,subtlety,6,4,2
Seeralex,anetheron,384,rogue,subtlety,6,4,2
Нунас,soulflayer,384,rogue,subtlety,6,4,2
Nxnja,silvermoon,384,rogue,subtlety,6,4,2
Sxpped,stormscale,384,rogue,subtlety,12,4,8
Zergroidz,kazzak,384,rogue,subtlety,12,4,8
Ambushmike,gorgonnash,384,rogue,subtlety,12,4,8
Máuul,ravencrest,384,rogue,subtlety,12,4,8
Slayered,burning-legion,384,rogue,subtlety,12,4,8
Zømbië,kazzak,384,rogue,subtlety,18,4,14
Fizgaroth,argent-dawn,382,rogue,subtlety,6,4,2
Mercìles,kazzak,322,rogue,subtlety,13,6,7
Cozu,stormrage,317,rogue,subtlety,10,4,6
Жабоклик,gordunni,304,rogue,subtlety,14,4,10
Opiïum,ysondre,303,rogue,subtlety,7,4,3
Waakie,frostmane,288,rogue,subtlety,6,3,3
Izzyb,auchindoun,288,rogue,subtlety,6,3,3
Botnet,blackmoore,288,rogue,subtlety,6,3,3
Smorcoolio,stormscale,288,rogue,subtlety,6,3,3
Nakli,antonidas,288,rogue,subtlety,6,3,3
Roguanal,hyjal,288,rogue,subtlety,6,3,3
Нойсеен,gordunni,288,rogue,subtlety,6,3,3
Røguøross,archimonde,288,rogue,subtlety,6,3,3
Alexandra,kazzak,288,rogue,subtlety,6,3,3
Бэрнии,howling-fjord,288,rogue,subtlety,6,3,3
Ncrø,aszune,288,rogue,subtlety,6,3,3
Jawen,silvermoon,288,rogue,subtlety,6,3,3
Vanisshh,hyjal,288,rogue,subtlety,6,3,3
Sneakysáp,ravencrest,288,rogue,subtlety,6,3,3
Baradiir,defias-brotherhood,288,rogue,subtlety,6,3,3
Zayøn,outland,288,rogue,subtlety,6,3,3
Sadgexd,draenor,288,rogue,subtlety,6,3,3
Poughkeepsie,outland,288,rogue,subtlety,6,3,3
Mekóz,draenor,288,rogue,subtlety,6,3,3
Uareincombat,drakthul,288,rogue,subtlety,6,3,3
Lepreuchan,archimonde,288,rogue,subtlety,6,3,3
Swiftyfan,silvermoon,288,rogue,subtlety,6,3,3
Protolink,zuljin,288,rogue,subtlety,6,3,3
Валанбалас,soulflayer,288,rogue,subtlety,6,3,3
Sicu,malganis,288,rogue,subtlety,6,3,3
Xhemil,tarren-mill,288,rogue,subtlety,6,3,3
Faptastíc,blackmoore,288,rogue,subtlety,6,3,3
Kolto,argent-dawn,288,rogue,subtlety,6,3,3
Fugly,ragnaros,288,rogue,subtlety,8,3,5
Mns,drakthul,288,rogue,subtlety,12,3,9
Helcof,emerald-dream,288,rogue,subtlety,12,3,9
Воробнальщик,soulflayer,288,rogue,subtlety,12,3,9
Zoldyck,bloodhoof,288,rogue,subtlety,12,3,9
Ристоврация,gordunni,288,rogue,subtlety,12,3,9
Xyúmopjoßblú,ravencrest,288,rogue,subtlety,12,3,9
Ñú,ravencrest,288,rogue,subtlety,12,3,9
Skíll,sanguino,288,rogue,subtlety,12,3,9
Pestctrl,argent-dawn,288,rogue,subtlety,12,3,9
Taniwa,archimonde,288,rogue,subtlety,12,3,9
Daggoth,kiljaeden,288,rogue,subtlety,12,3,9
Gingahboy,doomhammer,287,rogue,subtlety,6,3,3
Styggvanas,tarren-mill,287,rogue,subtlety,15,4,11
Боузи,howling-fjord,287,rogue,subtlety,12,3,9
Cesar,blackhand,286,rogue,subtlety,6,3,3
Ratolí,dun-modr,286,rogue,subtlety,6,3,3
Воруюнарынке,gordunni,286,rogue,subtlety,6,3,3
Skene,sanguino,284,rogue,subtlety,12,3,9
Frequenzalfa,silvermoon,256,rogue,subtlety,4,4,0
Juuzou,outland,239,rogue,subtlety,5,3,2
Subsònik,tarren-mill,239,rogue,subtlety,5,3,2
Actualcarry,dentarg,234,rogue,subtlety,6,4,2
Смекрус,soulflayer,208,rogue,subtlety,7,3,4
Cbrook,sylvanas,192,rogue,subtlety,6,2,4
Шмарамышь,soulflayer,192,rogue,subtlety,6,2,4
Ilyrya,azuremyst,192,rogue,subtlety,6,2,4
Голадриель,gordunni,192,rogue,subtlety,6,2,4
Maxtnulaujeu,archimonde,192,rogue,subtlety,6,2,4
Stigh,twisting-nether,192,rogue,subtlety,6,2,4
Smoothiè,twisting-nether,192,rogue,subtlety,6,2,4
Khepaso,sanguino,192,rogue,subtlety,6,2,4
Fatnutsac,eredar,192,rogue,subtlety,6,2,4
Sigleif,argent-dawn,192,rogue,subtlety,6,2,4
Selecta,bloodhoof,192,rogue,subtlety,6,2,4
Зебол,howling-fjord,192,rogue,subtlety,6,2,4
Kïbs,dalaran,192,rogue,subtlety,6,2,4
Wrathed,stormreaver,192,rogue,subtlety,6,2,4
Giftknirps,silvermoon,192,rogue,subtlety,6,2,4
Bananashow,aegwynn,192,rogue,subtlety,6,2,4
Haikyu,blackhand,192,rogue,subtlety,6,2,4
Режупополам,howling-fjord,192,rogue,subtlety,6,2,4
Igel,antonidas,192,rogue,subtlety,6,2,4
Skaterboy,stormscale,192,rogue,subtlety,6,2,4
Aikaza,blackmoore,192,rogue,subtlety,6,2,4
Greiskull,cthun,192,rogue,subtlety,15,3,12
Refundlands,kazzak,192,rogue,subtlety,12,2,10
Delenor,stormscale,192,rogue,subtlety,12,2,10
Azziinoth,ragnaros,192,rogue,subtlety,12,2,10
Acheravar,antonidas,192,rogue,subtlety,12,2,10
Destrektor,kazzak,192,rogue,subtlety,12,2,10
Aeønaxx,hyjal,191,rogue,subtlety,6,2,4
Энвитио,gordunni,191,rogue,subtlety,6,2,4
Cabalion,draenor,191,rogue,subtlety,6,2,4
Thiranor,cthun,191,rogue,subtlety,6,2,4
Algopyrin,ragnaros,191,rogue,subtlety,6,2,4
Singularität,silvermoon,191,rogue,subtlety,6,2,4
Feinted,kazzak,159,rogue,subtlety,5,2,3
Bandèra,ragnaros,138,rogue,subtlety,15,3,12
Idrîl,rashgarroth,137,rogue,subtlety,9,3,6
Songoro,tirion,96,rogue,subtlety,3,2,1
Takenòtes,nemesis,96,rogue,subtlety,6,1,5
Stealthi,stormscale,96,rogue,subtlety,6,1,5
Fintex,ravencrest,96,rogue,subtlety,6,1,5
Edaniel,draenor,96,rogue,subtlety,6,1,5
Whiteløtûs,dun-modr,96,rogue,subtlety,6,1,5
Jaydeeñ,ravencrest,96,rogue,subtlety,6,1,5
Letheus,stormscale,96,rogue,subtlety,6,1,5
Verk,twilights-hammer,96,rogue,subtlety,6,1,5
Tripleníne,silvermoon,96,rogue,subtlety,6,1,5
Nerkmind,ragnaros,96,rogue,subtlety,6,1,5
Kongnognog,ragnaros,96,rogue,subtlety,6,1,5
Kidneyou,ragnaros,96,rogue,subtlety,6,1,5
Rímen,archimonde,96,rogue,subtlety,6,1,5
Twinkyzzö,archimonde,96,rogue,subtlety,6,1,5
Элонли,gordunni,96,rogue,subtlety,6,1,5
Rufinol,twisting-nether,96,rogue,subtlety,6,1,5
Tàazz,archimonde,96,rogue,subtlety,6,1,5
Hyrule,onyxia,96,rogue,subtlety,6,1,5
Shyy,dun-modr,96,rogue,subtlety,6,1,5
Àrléngødx,kazzak,96,rogue,subtlety,6,1,5
Grindz,ravencrest,96,rogue,subtlety,6,1,5
Lëmönhäzë,dun-modr,96,rogue,subtlety,6,1,5
Nohks,blackmoore,96,rogue,subtlety,6,1,5
Рэйбэк,howling-fjord,96,rogue,subtlety,6,1,5
Madisonivyqt,blackmoore,96,rogue,subtlety,6,1,5
Çåñçér,sylvanas,96,rogue,subtlety,12,1,11
Альдинг,howling-fjord,96,rogue,subtlety,12,1,11
Jomoama,norgannon,96,rogue,subtlety,12,1,11
Digmorre,drakthul,79,rogue,subtlety,5,1,4
Nesth,silvermoon,79,rogue,subtlety,5,1,4
Mâtâtâ,die-ewige-wacht,63,rogue,subtlety,2,2,0
Domiqs,blackhand,63,rogue,subtlety,2,2,0
Dendriodidit,kazzak,31,rogue,subtlety,2,1,1
Fánsly,silvermoon,2101,rogue,assassination,72,37,35
Shadenox,ravencrest,1986,rogue,assassination,119,55,64
Chínerox,thunderhorn,1973,rogue,assassination,87,46,41
Vayyel,silvermoon,1943,rogue,assassination,130,63,67
Vulrin,argent-dawn,1899,rogue,assassination,77,44,33
Buffassa,ravencrest,1858,rogue,assassination,65,41,24
Aæ,stormscale,1852,rogue,assassination,53,28,25
Mentol,stormscale,1842,rogue,assassination,47,35,12
Asàd,draenor,1841,rogue,assassination,47,30,17
Prei,hyjal,1812,rogue,assassination,60,30,30
Shadeco,ravencrest,1811,rogue,assassination,60,29,31
Пожилойпуп,gordunni,1811,rogue,assassination,54,26,28
Lookåtme,ravencrest,1808,rogue,assassination,48,20,28
Ридлли,soulflayer,1775,rogue,assassination,47,23,24
Awaaylol,stormscale,1758,rogue,assassination,81,38,43
Warbell,ravencrest,1757,rogue,assassination,66,27,39
Eiscreme,blackmoore,1741,rogue,assassination,74,37,37
Rinj,antonidas,1721,rogue,assassination,83,35,48
Youcrymydear,outland,1711,rogue,assassination,66,31,35
Варэль,borean-tundra,1704,rogue,assassination,78,41,37
Drenched,turalyon,1703,rogue,assassination,66,30,36
Blindlol,emerald-dream,1700,rogue,assassination,48,24,24
Войенх,gordunni,1692,rogue,assassination,114,55,59
Акиоми,gordunni,1691,rogue,assassination,102,57,45
Sotro,dun-modr,1690,rogue,assassination,66,26,40
Dáydreamín,draenor,1689,rogue,assassination,54,23,31
Çhïñêsérøqüè,tarren-mill,1686,rogue,assassination,65,27,38
Visuáls,antonidas,1643,rogue,assassination,51,22,29
Synergize,stormreaver,1626,rogue,assassination,97,49,48
Мистеркрэпс,howling-fjord,1624,rogue,assassination,47,19,28
Shookyz,zuljin,1615,rogue,assassination,54,27,27
Nîllá,blackmoore,1600,rogue,assassination,42,18,24
Precious,sylvanas,1551,rogue,assassination,48,19,29
Ockzy,archimonde,1534,rogue,assassination,45,22,23
Шмарамышь,soulflayer,1524,rogue,assassination,54,27,27
Keeke,outland,1518,rogue,assassination,36,17,19
Howfastiam,ravencrest,1515,rogue,assassination,24,16,8
Søsaboy,nemesis,1510,rogue,assassination,36,18,18
Shikamouflé,archimonde,1507,rogue,assassination,94,43,51
Knutten,wildhammer,1500,rogue,assassination,96,43,53
Nùgz,area-52,1498,rogue,assassination,119,65,54
Ванэйти,gordunni,1489,rogue,assassination,30,18,12
Vennomous,darkspear,1488,rogue,assassination,30,17,13
Grzech,burning-legion,1473,rogue,assassination,46,27,19
Kãlí,blackmoore,1460,rogue,assassination,48,20,28
Diazz,aegwynn,1459,rogue,assassination,60,26,34
Волнорес,eversong,1453,rogue,assassination,64,32,32
Freemmr,draenor,1417,rogue,assassination,40,22,18
Silesi,kazzak,1415,rogue,assassination,40,19,21
Arkblenderx,silvermoon,1409,rogue,assassination,64,32,32
Koreanrogue,archimonde,1406,rogue,assassination,24,15,9
Eizan,outland,1395,rogue,assassination,30,16,14
Teseiga,aegwynn,1394,rogue,assassination,84,32,52
Naiikaii,antonidas,1343,rogue,assassination,30,14,16
Heavý,argent-dawn,1343,rogue,assassination,30,14,16
Ciaordel,sylvanas,1330,rogue,assassination,66,30,36
Belsazar,azshara,1320,rogue,assassination,74,32,42
Axoic,ravencrest,1312,rogue,assassination,36,15,21
Sigleif,argent-dawn,1309,rogue,assassination,61,28,33
ßênz,archimonde,1308,rogue,assassination,36,14,22
Сайгакк,galakrond,1247,rogue,assassination,52,27,25
Zerocell,kazzak,1240,rogue,assassination,48,23,25
Shaokiz,sylvanas,1239,rogue,assassination,24,13,11
Pitøu,outland,1219,rogue,assassination,24,14,10
Luftpumpe,blackrock,1214,rogue,assassination,24,13,11
Mazeken,kazzak,1212,rogue,assassination,35,13,22
Kariinthuul,aegwynn,1205,rogue,assassination,48,20,28
Bennyweth,argent-dawn,1205,rogue,assassination,42,16,26
Piñotxo,sanguino,1200,rogue,assassination,29,13,16
Sùbzerø,archimonde,1186,rogue,assassination,23,13,10
Dime,silvermoon,1167,rogue,assassination,60,31,29
Veronkierto,stormreaver,1166,rogue,assassination,48,24,24
Pasarelo,dun-modr,1158,rogue,assassination,71,32,39
Nevelon,chogall,1138,rogue,assassination,30,14,16
Matchfixer,moonglade,1105,rogue,assassination,47,20,27
Yvÿ,archimonde,1101,rogue,assassination,24,12,12
Elûnè,silvermoon,1097,rogue,assassination,30,14,16
Lelíth,ravencrest,1091,rogue,assassination,23,12,11
Gravestam,sunstrider,1085,rogue,assassination,36,17,19
Trollohlol,malganis,1072,rogue,assassination,30,13,17
Пусякиллерх,gordunni,1064,rogue,assassination,37,14,23
Boskönigt,ragnaros,1056,rogue,assassination,36,17,19
Goshîmoshî,stormscale,1056,rogue,assassination,30,11,19
Fatnutsac,eredar,1055,rogue,assassination,24,11,13
Zaintsas,tarren-mill,1049,rogue,assassination,27,12,15
Zizmo,deathwing,1049,rogue,assassination,30,11,19
Синигурай,soulflayer,1045,rogue,assassination,24,11,13
Zélla,twisting-nether,1044,rogue,assassination,24,11,13
Sladen,ghostlands,1032,rogue,assassination,24,11,13
Lesale,turalyon,1011,rogue,assassination,36,16,20
Alltaïr,ravencrest,1006,rogue,assassination,56,29,27
Swarge,silvermoon,994,rogue,assassination,79,29,50
Зоти,lich-king,959,rogue,assassination,18,10,8
Лёнтролль,blackscar,958,rogue,assassination,18,10,8
Unshaken,dun-modr,958,rogue,assassination,24,10,14
Редфилд,blackscar,956,rogue,assassination,18,10,8
Патайчик,soulflayer,954,rogue,assassination,18,10,8
Gârrík,blackhand,954,rogue,assassination,18,10,8
Purplereign,frostmane,939,rogue,assassination,36,18,18
Nighteshift,silvermoon,936,rogue,assassination,24,10,14
Batsu,alleria,922,rogue,assassination,23,10,13
Макггара,soulflayer,914,rogue,assassination,95,42,53
Sadgexd,draenor,906,rogue,assassination,28,11,17
Ороти,greymane,891,rogue,assassination,20,12,8
Skýhigh,ravencrest,864,rogue,assassination,12,9,3
Watchmeyoe,ravencrest,864,rogue,assassination,18,9,9
Ohdaesu,aegwynn,864,rogue,assassination,30,9,21
Koopa,argent-dawn,864,rogue,assassination,36,9,27
Erion,silvermoon,863,rogue,assassination,24,9,15
Haikyu,blackhand,862,rogue,assassination,24,9,15
Alnaddafrog,outland,861,rogue,assassination,12,9,3
Norlix,ravencrest,856,rogue,assassination,18,9,9
Oshä,dalaran,854,rogue,assassination,24,9,15
Îlihad,zuljin,824,rogue,assassination,42,16,26
Ewyna,silvermoon,816,rogue,assassination,21,10,11
Gillette,guldan,813,rogue,assassination,36,14,22
Løuvees,archimonde,810,rogue,assassination,40,15,25
Yuffi,ysondre,803,rogue,assassination,23,11,12
Onlyluvhurt,dun-modr,768,rogue,assassination,24,8,16
Finanzamtlg,blackrock,767,rogue,assassination,16,9,7
Krimos,archimonde,759,rogue,assassination,12,8,4
Sáinz,malganis,713,rogue,assassination,23,9,14
Candycc,burning-legion,687,rogue,assassination,13,8,5
Moneylake,stormscale,672,rogue,assassination,12,7,5
Stabbinu,burning-legion,672,rogue,assassination,12,7,5
Zilemjr,stormscale,672,rogue,assassination,18,7,11
Npkx,outland,672,rogue,assassination,18,7,11
Köna,archimonde,672,rogue,assassination,18,7,11
Eeros,kazzak,672,rogue,assassination,18,7,11
Monski,ravencrest,672,rogue,assassination,24,7,17
Luketherogue,twisting-nether,672,rogue,assassination,24,7,17
Eightball,frostmane,671,rogue,assassination,12,7,5
Givewallet,ravencrest,671,rogue,assassination,12,7,5
Weakrat,kult-der-verdammten,671,rogue,assassination,12,7,5
Yassu,archimonde,671,rogue,assassination,18,7,11
Babysteps,the-maelstrom,670,rogue,assassination,12,7,5
Кэйлфрут,gordunni,670,rogue,assassination,12,7,5
Поздоровайся,howling-fjord,670,rogue,assassination,12,7,5
Effectz,ragnaros,669,rogue,assassination,18,7,11
Ashami,genjuros,666,rogue,assassination,18,7,11
Sospiro,nemesis,601,rogue,assassination,16,7,9
Diagnoze,silvermoon,576,rogue,assassination,12,6,6
Mâêl,blackmoore,576,rogue,assassination,12,6,6
Mollyperph,ravencrest,576,rogue,assassination,12,6,6
Voetdown,blackmoore,576,rogue,assassination,12,6,6
Ритор,deathguard,576,rogue,assassination,12,6,6
Lôre,blackrock,576,rogue,assassination,12,6,6
Blooddance,ragnaros,576,rogue,assassination,18,6,12
Røler,ravencrest,576,rogue,assassination,18,6,12
Mystykal,twisting-nether,575,rogue,assassination,12,6,6
Niapro,dun-morogh,575,rogue,assassination,12,6,6
Ppollito,hyjal,575,rogue,assassination,18,6,12
Röllz,ysondre,575,rogue,assassination,18,6,12
Jupitor,argent-dawn,574,rogue,assassination,12,6,6
Kuttunga,ravencrest,574,rogue,assassination,12,6,6
Outofstuns,earthen-ring,574,rogue,assassination,18,7,11
Reginlief,argent-dawn,572,rogue,assassination,6,6,0
Snakeshiv,ravenholdt,569,rogue,assassination,12,6,6
Jústina,die-aldor,569,rogue,assassination,18,6,12
Симус,lich-king,568,rogue,assassination,12,6,6
Lastsight,burning-legion,528,rogue,assassination,9,7,2
Ûltraaxx,ysondre,528,rogue,assassination,15,6,9
Stonyhavana,ravencrest,527,rogue,assassination,11,6,5
Unterweger,die-aldor,526,rogue,assassination,11,6,5
Babouill,ysondre,480,rogue,assassination,6,5,1
Botsrogue,kazzak,480,rogue,assassination,12,5,7
Stealthi,stormscale,480,rogue,assassination,12,5,7
Liraia,eredar,480,rogue,assassination,12,5,7
Patryk,silvermoon,480,rogue,assassination,12,5,7
Morgan,argent-dawn,480,rogue,assassination,12,5,7
Кэпс,blackscar,480,rogue,assassination,12,5,7
Иллвилл,soulflayer,480,rogue,assassination,12,5,7
Kuzmin,die-aldor,480,rogue,assassination,12,5,7
Aikaza,blackmoore,480,rogue,assassination,12,5,7
Malatang,thrall,480,rogue,assassination,12,5,7
Ambushgirl,ravencrest,480,rogue,assassination,18,5,13
Republicano,cthun,480,rogue,assassination,18,5,13
Wrathed,stormreaver,480,rogue,assassination,18,5,13
Oggish,tarren-mill,480,rogue,assassination,24,5,19
Хэресс,soulflayer,479,rogue,assassination,6,5,1
Letheus,stormscale,479,rogue,assassination,12,5,7
Bonejaw,tarren-mill,479,rogue,assassination,12,5,7
Blackone,nemesis,473,rogue,assassination,18,5,13
Lorena,ravencrest,446,rogue,assassination,11,5,6
Raiyqyu,archimonde,425,rogue,assassination,21,6,15
Bluehell,sanguino,415,rogue,assassination,10,5,5
Dredge,kaelthas,391,rogue,assassination,25,8,17
Jaxck,sylvanas,384,rogue,assassination,6,4,2
Дикийминус,howling-fjord,384,rogue,assassination,6,4,2
Obsçuritý,ragnaros,384,rogue,assassination,6,4,2
Кайдарра,eversong,384,rogue,assassination,6,4,2
Kidneyou,ragnaros,384,rogue,assassination,6,4,2
Çhïñêsémøñkè,drakthul,384,rogue,assassination,6,4,2
Whosmanz,ragnaros,384,rogue,assassination,6,4,2
Биокарлик,soulflayer,384,rogue,assassination,6,4,2
Sadìra,echsenkessel,384,rogue,assassination,6,4,2
Myk,ravencrest,384,rogue,assassination,6,4,2
Awakeaf,outland,384,rogue,assassination,6,4,2
Brñ,ravencrest,384,rogue,assassination,6,4,2
Poughkeepsie,outland,384,rogue,assassination,6,4,2
Tebzr,ravencrest,384,rogue,assassination,6,4,2
Аязлаая,blackscar,384,rogue,assassination,6,4,2
Brunhityx,ravencrest,384,rogue,assassination,6,4,2
Sîccarîus,ravencrest,384,rogue,assassination,6,4,2
Mouchess,hyjal,384,rogue,assassination,6,4,2
Röguetönerö,dun-modr,384,rogue,assassination,12,4,8
Paidaki,kazzak,384,rogue,assassination,12,4,8
Crimatoria,rajaxx,384,rogue,assassination,12,4,8
Angeldarky,silvermoon,384,rogue,assassination,12,4,8
Stepbrogue,tarren-mill,384,rogue,assassination,12,4,8
Ámbush,sylvanas,384,rogue,assassination,12,4,8
Meimei,sanguino,384,rogue,assassination,12,4,8
Фуллблайнд,gordunni,384,rogue,assassination,12,4,8
Feucht,argent-dawn,384,rogue,assassination,12,4,8
Гранетанцор,blackscar,384,rogue,assassination,12,4,8
Petsakos,ravencrest,384,rogue,assassination,12,4,8
Achterom,tarren-mill,384,rogue,assassination,12,4,8
Ibizà,ravencrest,384,rogue,assassination,18,4,14
Vexedancer,stormscale,383,rogue,assassination,6,4,2
Opiïum,ysondre,383,rogue,assassination,6,4,2
Килларан,howling-fjord,383,rogue,assassination,6,4,2
Цилана,gordunni,383,rogue,assassination,6,4,2
Whiz,alexstrasza,383,rogue,assassination,15,5,10
Obbexd,outland,383,rogue,assassination,12,4,8
Satiiva,terokkar,383,rogue,assassination,18,4,14
Deragur,antonidas,382,rogue,assassination,6,4,2
Twinkyzzö,archimonde,382,rogue,assassination,12,4,8
Møkkagnom,darkspear,381,rogue,assassination,12,4,8
Lilbubblegum,emerald-dream,351,rogue,assassination,11,4,7
Eljana,amanthul,335,rogue,assassination,11,4,7
Peeon,drakthul,330,rogue,assassination,29,6,23
Рэкрейвон,gordunni,288,rogue,assassination,6,3,3
Stælf,argent-dawn,288,rogue,assassination,6,3,3
Myxx,ravencrest,288,rogue,assassination,6,3,3
Роземсти,gordunni,288,rogue,assassination,6,3,3
Subyo,eredar,288,rogue,assassination,6,3,3
Brazi,dalaran,288,rogue,assassination,6,3,3
Stroògz,ysondre,288,rogue,assassination,6,3,3
Psg,argent-dawn,288,rogue,assassination,6,3,3
Uzrigu,tarren-mill,288,rogue,assassination,6,3,3
Izzyb,auchindoun,288,rogue,assassination,6,3,3
Luciferx,stormscale,288,rogue,assassination,6,3,3
Котянкахд,howling-fjord,288,rogue,assassination,6,3,3
Mordred,stormscale,288,rogue,assassination,6,3,3
Redcutter,silvermoon,288,rogue,assassination,6,3,3
Ракфорн,howling-fjord,288,rogue,assassination,6,3,3
Cander,kazzak,288,rogue,assassination,6,3,3
Richï,outland,288,rogue,assassination,12,3,9
Rîg,draenor,288,rogue,assassination,12,3,9
Hersuub,blackmoore,288,rogue,assassination,12,3,9
Ryurfy,archimonde,288,rogue,assassination,12,3,9
Cbrook,sylvanas,288,rogue,assassination,12,3,9
Лайнэл,deathweaver,288,rogue,assassination,12,3,9
Jáyjay,antonidas,288,rogue,assassination,18,3,15
Willin,kazzak,287,rogue,assassination,6,3,3
Гламурятина,gordunni,287,rogue,assassination,6,3,3
Kuxion,zuljin,286,rogue,assassination,12,3,9
Knockyz,khaz-modan,285,rogue,assassination,12,3,9
Verbb,turalyon,284,rogue,assassination,12,3,9
Fizzkhalifa,zuljin,284,rogue,assassination,12,3,9
Dmfd,darksorrow,284,rogue,assassination,18,3,15
Bauwten,ravencrest,255,rogue,assassination,8,4,4
Blckrogue,bloodfeather,240,rogue,assassination,9,3,6
Starkad,archimonde,239,rogue,assassination,5,3,2
Alpinestars,dun-modr,239,rogue,assassination,5,3,2
Rhâpsødýx,twisting-nether,234,rogue,assassination,8,4,4
Gadûz,kazzak,234,rogue,assassination,23,4,19
Kyropth,eredar,192,rogue,assassination,6,2,4
Xanyy,bloodfeather,192,rogue,assassination,6,2,4
Halucinogeno,silvermoon,192,rogue,assassination,6,2,4
Kenjí,silvermoon,192,rogue,assassination,6,2,4
Fushimi,ravencrest,192,rogue,assassination,6,2,4
Nastyrogue,burning-legion,192,rogue,assassination,6,2,4
Rearmer,burning-legion,192,rogue,assassination,6,2,4
Vanisha,outland,192,rogue,assassination,6,2,4
Tinta,aszune,192,rogue,assassination,6,2,4
Нойсеен,gordunni,192,rogue,assassination,6,2,4
Yanlu,ysondre,192,rogue,assassination,6,2,4
Sokillu,silvermoon,192,rogue,assassination,6,2,4
Tofix,tarren-mill,192,rogue,assassination,6,2,4
Díddz,tarren-mill,192,rogue,assassination,6,2,4
Maxrizzx,ravencrest,192,rogue,assassination,6,2,4
Bangerstab,draenor,192,rogue,assassination,6,2,4
Fälke,dun-modr,192,rogue,assassination,6,2,4
Gane,sanguino,192,rogue,assassination,6,2,4
Grøax,ragnaros,192,rogue,assassination,6,2,4
Xeggy,turalyon,192,rogue,assassination,6,2,4
Nudelholz,blackrock,192,rogue,assassination,6,2,4
Eazmode,outland,192,rogue,assassination,6,2,4
Azovrouge,terokkar,192,rogue,assassination,6,2,4
Китей,howling-fjord,192,rogue,assassination,6,2,4
Ghðst,stormscale,192,rogue,assassination,6,2,4
Jonewrld,ravencrest,192,rogue,assassination,6,2,4
Shúrae,blackmoore,192,rogue,assassination,6,2,4
Bronxbomber,tarren-mill,192,rogue,assassination,6,2,4
Gankbang,frostmane,192,rogue,assassination,6,2,4
Mallaurya,dalaran,192,rogue,assassination,6,2,4
Missesinvis,blackmoore,192,rogue,assassination,6,2,4
Ichiegoichie,draenor,192,rogue,assassination,6,2,4
Mexxn,antonidas,192,rogue,assassination,7,2,5
Sheyrrà,aegwynn,192,rogue,assassination,12,2,10
Траста,fordragon,192,rogue,assassination,12,2,10
Stonecold,twilights-hammer,192,rogue,assassination,12,2,10
Vezinia,ravencrest,192,rogue,assassination,12,2,10
Бонасера,blackscar,192,rogue,assassination,12,2,10
Cacucoxpahu,kazzak,192,rogue,assassination,12,2,10
Sumiftw,drakthul,192,rogue,assassination,12,2,10
Mingzhu,ravencrest,192,rogue,assassination,12,2,10
Gøldzahn,antonidas,192,rogue,assassination,12,2,10
Romiel,ravencrest,192,rogue,assassination,12,2,10
Лэйкиро,gordunni,192,rogue,assassination,12,2,10
Rêdbello,dun-morogh,191,rogue,assassination,6,2,4
Nhot,kazzak,191,rogue,assassination,6,2,4
Drexxo,drakthul,191,rogue,assassination,6,2,4
Rogunelf,stormreaver,191,rogue,assassination,6,2,4
Flawlesser,kazzak,96,rogue,assassination,3,2,1
Ристоврация,gordunni,96,rogue,assassination,6,1,5
Кейнилин,gordunni,96,rogue,assassination,6,1,5
Msrogue,eredar,96,rogue,assassination,6,1,5
Трисися,gordunni,96,rogue,assassination,6,1,5
Метаболикх,gordunni,96,rogue,assassination,6,1,5
Mindset,eredar,96,rogue,assassination,6,1,5
Ohmydotz,archimonde,96,rogue,assassination,6,1,5
Penetrantos,eredar,96,rogue,assassination,6,1,5
Sly,emerald-dream,96,rogue,assassination,6,1,5
Ogc,draenor,96,rogue,assassination,6,1,5
Yörgs,eredar,96,rogue,assassination,6,1,5
Fíìp,drakthul,96,rogue,assassination,6,1,5
Yamoshí,sanguino,96,rogue,assassination,6,1,5
Chalkbag,blackrock,96,rogue,assassination,6,1,5
Nezuko,gilneas,96,rogue,assassination,6,1,5
Icyicé,kazzak,96,rogue,assassination,6,1,5
Fkuwu,dalaran,96,rogue,assassination,6,1,5
Dezxxyox,dun-modr,96,rogue,assassination,6,1,5
Frequenzalfa,silvermoon,96,rogue,assassination,6,1,5
Giftknirps,silvermoon,96,rogue,assassination,6,1,5
Layson,les-clairvoyants,79,rogue,assassination,5,1,4
Ressputini,emeriss,79,rogue,assassination,5,1,4
Poupiouchou,hyjal,79,rogue,assassination,11,1,10
Драгенхз,gordunni,2133,shaman,restoration,215,117,98
Shadrak,eredar,2123,shaman,restoration,84,46,38
Trashgame,kazzak,2050,shaman,restoration,66,36,30
Джексобед,soulflayer,2024,shaman,restoration,78,42,36
Sentûn,blackrock,1960,shaman,restoration,103,56,47
Epsylone,kazzak,1945,shaman,restoration,89,45,44
Bmbx,archimonde,1941,shaman,restoration,167,89,78
Ultrahound,twisting-nether,1923,shaman,restoration,36,28,8
Yararsiz,twisting-nether,1913,shaman,restoration,102,55,47
Skreewu,outland,1908,shaman,restoration,78,37,41
Carlpeant,drakthul,1896,shaman,restoration,72,36,36
Swkx,dun-modr,1895,shaman,restoration,52,33,19
Sinzzu,ragnaros,1880,shaman,restoration,108,57,51
Owrly,stormscale,1878,shaman,restoration,100,48,52
Crnine,pozzo-delleternità,1863,shaman,restoration,33,25,8
Louler,ragnaros,1860,shaman,restoration,124,69,55
Tallyx,ravencrest,1855,shaman,restoration,72,34,38
Yachiru,sylvanas,1854,shaman,restoration,73,59,14
Centralc,twisting-nether,1833,shaman,restoration,41,26,15
Shamuunn,ravencrest,1830,shaman,restoration,54,28,26
Дольчих,deathguard,1830,shaman,restoration,68,30,38
Sethrøllins,hyjal,1829,shaman,restoration,102,47,55
Adroda,kazzak,1827,shaman,restoration,39,22,17
Kraksham,ravencrest,1825,shaman,restoration,70,42,28
Lunarsloths,hyjal,1823,shaman,restoration,48,28,20
Teldathree,archimonde,1818,shaman,restoration,77,40,37
Shamrockx,outland,1816,shaman,restoration,83,42,41
Трс,razuvious,1815,shaman,restoration,65,38,27
Lahey,draenor,1811,shaman,restoration,80,47,33
Zhull,ravencrest,1810,shaman,restoration,48,23,25
Kïllard,archimonde,1809,shaman,restoration,48,24,24
Helloiamdoni,ravencrest,1807,shaman,restoration,95,59,36
Nokster,twisting-nether,1806,shaman,restoration,84,60,24
Greggyb,twisting-nether,1805,shaman,restoration,36,22,14
Valko,hellfire,1804,shaman,restoration,30,19,11
Deepwithyou,blackhand,1803,shaman,restoration,45,28,17
Neou,archimonde,1803,shaman,restoration,54,27,27
Stensham,stormreaver,1801,shaman,restoration,48,28,20
Kiansham,silvermoon,1801,shaman,restoration,47,26,21
Jawje,tarren-mill,1796,shaman,restoration,84,38,46
Josë,twisting-nether,1791,shaman,restoration,47,25,22
Wíllz,ravencrest,1787,shaman,restoration,48,25,23
Mininini,ravencrest,1783,shaman,restoration,48,24,24
Hexe,kazzak,1783,shaman,restoration,75,32,43
Онеоне,deathweaver,1778,shaman,restoration,47,29,18
Lavalavalava,blackrock,1778,shaman,restoration,162,91,71
Цукерок,soulflayer,1775,shaman,restoration,24,19,5
Fuzzynuts,ravencrest,1772,shaman,restoration,90,51,39
Shiranoye,blackrock,1755,shaman,restoration,72,37,35
Эоя,howling-fjord,1748,shaman,restoration,66,33,33
Harmony,outland,1746,shaman,restoration,24,19,5
Palfe,khaz-modan,1746,shaman,restoration,93,46,47
Purgeluxe,aegwynn,1740,shaman,restoration,59,32,27
Мефодийшаман,howling-fjord,1734,shaman,restoration,36,27,9
Агентхолинки,gordunni,1726,shaman,restoration,24,18,6
Waramors,eredar,1722,shaman,restoration,53,28,25
Coldlean,haomarush,1714,shaman,restoration,36,23,13
Shamandoino,wildhammer,1711,shaman,restoration,72,30,42
Ihealbro,blackrock,1707,shaman,restoration,30,22,8
Connecting,hyjal,1704,shaman,restoration,39,21,18
Мвнз,soulflayer,1700,shaman,restoration,54,22,32
Thunderrock,stormreaver,1699,shaman,restoration,42,18,24
Wacomtablet,kazzak,1690,shaman,restoration,24,18,6
Kreamcake,bladefist,1689,shaman,restoration,66,25,41
Вишняблэйз,soulflayer,1684,shaman,restoration,41,24,17
Милфшама,blackscar,1682,shaman,restoration,177,87,90
Чинанрук,howling-fjord,1680,shaman,restoration,77,38,39
Awcchampion,stormscale,1677,shaman,restoration,85,54,31
Mbembe,blackhand,1674,shaman,restoration,48,26,22
Windfúhrèr,tarren-mill,1669,shaman,restoration,42,20,22
Ixxmre,blackrock,1666,shaman,restoration,60,33,27
Reäz,archimonde,1665,shaman,restoration,42,21,21
Atwâ,ravencrest,1663,shaman,restoration,51,31,20
Héxdóctór,ravencrest,1663,shaman,restoration,74,42,32
Machmacan,argent-dawn,1662,shaman,restoration,62,32,30
Shamolili,stormscale,1659,shaman,restoration,42,20,22
Мвнзх,gordunni,1656,shaman,restoration,54,24,30
Hypéra,kazzak,1654,shaman,restoration,150,81,69
Ларкуш,howling-fjord,1648,shaman,restoration,48,25,23
Donv,blackmoore,1638,shaman,restoration,36,21,15
Шсаваннх,blackscar,1636,shaman,restoration,136,71,65
Rxs,thunderhorn,1635,shaman,restoration,54,28,26
Pøwertoto,dalaran,1632,shaman,restoration,54,24,30
Turboeddy,blackmoore,1631,shaman,restoration,43,27,16
Johncoltrane,archimonde,1628,shaman,restoration,60,39,21
Кичисанчик,howling-fjord,1628,shaman,restoration,114,54,60
Urshak,alleria,1624,shaman,restoration,30,20,10
Askagain,sylvanas,1624,shaman,restoration,28,18,10
Xhanon,kazzak,1624,shaman,restoration,36,20,16
Инкуль,howling-fjord,1621,shaman,restoration,42,20,22
Sûckmytotem,ragnaros,1619,shaman,restoration,30,17,13
Lechii,stormscale,1619,shaman,restoration,71,40,31
Zwergmann,blackrock,1618,shaman,restoration,42,30,12
Seasick,frostmane,1618,shaman,restoration,66,34,32
Тафельшпиц,soulflayer,1617,shaman,restoration,40,18,22
Bladeyx,ragnaros,1612,shaman,restoration,105,56,49
Arslos,twisting-nether,1611,shaman,restoration,18,17,1
Makkalisse,kazzak,1609,shaman,restoration,24,17,7
Rexatar,blackrock,1606,shaman,restoration,36,21,15
Sixtyone,stormscale,1601,shaman,restoration,48,30,18
Whiskiy,kazzak,1598,shaman,restoration,26,18,8
Tupato,kazzak,1597,shaman,restoration,56,29,27
Bullezno,kazzak,1595,shaman,restoration,63,37,26
Zinjk,nemesis,1591,shaman,restoration,72,39,33
Hjod,outland,1591,shaman,restoration,61,32,29
Shockair,frostwolf,1591,shaman,restoration,69,32,37
Vioception,blackrock,1584,shaman,restoration,48,19,29
Sanamaxx,colinas-pardas,1583,shaman,restoration,38,21,17
Сорит,blackscar,1577,shaman,restoration,30,20,10
Blowxd,aegwynn,1573,shaman,restoration,104,59,45
Beastmodex,eredar,1567,shaman,restoration,132,68,64
Uzze,drakthul,1564,shaman,restoration,60,26,34
Zorcs,silvermoon,1561,shaman,restoration,85,41,44
Exolnard,twisting-nether,1557,shaman,restoration,60,28,32
Zanezu,stormscale,1553,shaman,restoration,42,18,24
Earthhulk,thrall,1547,shaman,restoration,71,40,31
Linkedink,tarren-mill,1545,shaman,restoration,23,17,6
Bezixx,ravencrest,1544,shaman,restoration,60,31,29
Sadfemecraft,aggramar,1540,shaman,restoration,60,26,34
Anöuchkâ,ysondre,1535,shaman,restoration,42,19,23
Mcktavish,silvermoon,1534,shaman,restoration,36,22,14
Yomuchacha,dun-modr,1533,shaman,restoration,46,20,26
Mypakypa,outland,1532,shaman,restoration,48,20,28
Damex,thunderhorn,1531,shaman,restoration,54,18,36
Phaynozx,cthun,1530,shaman,restoration,30,16,14
Reezex,silvermoon,1526,shaman,restoration,65,34,31
Reilah,drakthul,1525,shaman,restoration,54,26,28
Ilovejamie,sylvanas,1522,shaman,restoration,54,30,24
Кислаябуба,howling-fjord,1520,shaman,restoration,61,28,33
Akrobata,silvermoon,1519,shaman,restoration,150,75,75
Schain,eredar,1518,shaman,restoration,36,24,12
Хэйзл,ashenvale,1512,shaman,restoration,44,19,25
Aceofraphy,thrall,1511,shaman,restoration,102,45,57
Mamacitá,eredar,1508,shaman,restoration,108,36,72
Mydpsrbad,stormscale,1507,shaman,restoration,42,23,19
Bumblebeec,tarren-mill,1505,shaman,restoration,48,25,23
Krovogor,silvermoon,1501,shaman,restoration,54,31,23
Remkoo,blackrock,1498,shaman,restoration,24,17,7
Отчима,howling-fjord,1496,shaman,restoration,41,21,20
Darnast,draenor,1495,shaman,restoration,34,16,18
Gspót,twisting-nether,1493,shaman,restoration,92,46,46
Diix,archimonde,1489,shaman,restoration,66,27,39
Kalaris,stormscale,1488,shaman,restoration,36,20,16
Pacio,alakir,1481,shaman,restoration,78,40,38
Thyroideus,argent-dawn,1478,shaman,restoration,36,20,16
Cuzzer,drakthul,1475,shaman,restoration,59,31,28
Gützli,blackmoore,1474,shaman,restoration,93,35,58
Upisi,burning-legion,1471,shaman,restoration,48,18,30
Tèysh,ysondre,1470,shaman,restoration,48,28,20
Zlingx,auchindoun,1468,shaman,restoration,42,21,21
Jazzrod,stormscale,1458,shaman,restoration,96,49,47
Stòrmbreakèr,nemesis,1458,shaman,restoration,37,18,19
Djxyoloswag,silvermoon,1452,shaman,restoration,63,27,36
Ezilol,blackhand,1448,shaman,restoration,30,17,13
Velkin,thrall,1448,shaman,restoration,91,44,47
Emochka,ravencrest,1445,shaman,restoration,115,53,62
Bonraptor,kirin-tor,1443,shaman,restoration,41,20,21
Ebøbøla,terokkar,1435,shaman,restoration,92,34,58
Diya,karazhan,1434,shaman,restoration,66,31,35
Kataretic,kazzak,1433,shaman,restoration,24,17,7
Shemanrolf,outland,1425,shaman,restoration,57,26,31
Vaizii,silvermoon,1423,shaman,restoration,41,17,24
Fitnessdavid,ravencrest,1417,shaman,restoration,29,15,14
Monstermunch,ravencrest,1416,shaman,restoration,78,33,45
Mìcrøs,thrall,1413,shaman,restoration,24,15,9
Wôdân,blackrock,1412,shaman,restoration,54,21,33
Hexoffender,alakir,1401,shaman,restoration,48,20,28
Yois,nemesis,1392,shaman,restoration,60,34,26
Okdar,stormscale,1391,shaman,restoration,30,19,11
Johnblånn,stormscale,1389,shaman,restoration,51,30,21
Cobbel,argent-dawn,1387,shaman,restoration,36,18,18
Shago,archimonde,1369,shaman,restoration,47,19,28
Vioceptîon,blackrock,1368,shaman,restoration,18,15,3
Vuls,blackmoore,1367,shaman,restoration,24,18,6
Братишкапинг,soulflayer,1358,shaman,restoration,95,50,45
Antey,ravencrest,1354,shaman,restoration,52,27,25
Yezx,hyjal,1351,shaman,restoration,52,32,20
Ketzersend,alleria,1351,shaman,restoration,30,18,12
Roineé,draenor,1343,shaman,restoration,24,14,10
Sugarfreé,ragnaros,1341,shaman,restoration,30,14,16
Rhakhatheckh,nemesis,1340,shaman,restoration,30,16,14
Nestre,kazzak,1339,shaman,restoration,30,14,16
Nassîî,antonidas,1338,shaman,restoration,30,14,16
Shapperdin,darksorrow,1336,shaman,restoration,24,14,10
Lustmasterx,grim-batol,1333,shaman,restoration,36,16,20
Ксмо,gordunni,1331,shaman,restoration,24,14,10
Jarvís,gilneas,1327,shaman,restoration,50,19,31
Asumix,illidan,1320,shaman,restoration,53,28,25
Mâde,ravencrest,1317,shaman,restoration,44,24,20
Navezi,twisting-nether,1310,shaman,restoration,48,29,19
Sugardad,khaz-modan,1309,shaman,restoration,40,19,21
Murmelï,stormreaver,1307,shaman,restoration,33,18,15
Littledorf,ravencrest,1301,shaman,restoration,24,16,8
Showman,archimonde,1298,shaman,restoration,62,28,34
Крэгнор,gordunni,1295,shaman,restoration,81,43,38
Thundersioux,ravencrest,1287,shaman,restoration,27,18,9
Сёмабро,ashenvale,1284,shaman,restoration,94,51,43
Samantouz,archimonde,1282,shaman,restoration,63,27,36
Ishkadar,twisting-nether,1270,shaman,restoration,33,15,18
Жижелье,howling-fjord,1263,shaman,restoration,52,28,24
Малекулакота,soulflayer,1261,shaman,restoration,35,14,21
Teccatwo,outland,1252,shaman,restoration,45,23,22
Fulminare,ravencrest,1250,shaman,restoration,36,20,16
Светшам,howling-fjord,1248,shaman,restoration,24,13,11
Karlurban,outland,1247,shaman,restoration,30,13,17
Rottulos,stormrage,1246,shaman,restoration,18,13,5
Anlaki,silvermoon,1241,shaman,restoration,18,13,5
Ironkraw,stormscale,1240,shaman,restoration,30,13,17
Kuhnedy,blackrock,1228,shaman,restoration,30,13,17
Oldrym,blackrock,1227,shaman,restoration,58,24,34
Alexmiamosch,thrall,1226,shaman,restoration,78,48,30
Gaelic,frostmourne,1226,shaman,restoration,24,13,11
Lolafløres,dun-modr,1216,shaman,restoration,41,32,9
Sickbrain,silvermoon,1216,shaman,restoration,45,19,26
Перегной,ashenvale,1212,shaman,restoration,93,39,54
Morttes,burning-legion,1205,shaman,restoration,27,14,13
Moonbotico,blackrock,1202,shaman,restoration,30,15,15
Blöödfist,drakthul,1200,shaman,restoration,35,14,21
Kickvando,blackmoore,1184,shaman,restoration,38,18,20
Biztor,jaedenar,1178,shaman,restoration,48,26,22
Arabesk,arygos,1169,shaman,restoration,96,46,50
Lechirurgien,elune,1169,shaman,restoration,42,20,22
Qjie,argent-dawn,1168,shaman,restoration,29,18,11
Thenasil,stormscale,1165,shaman,restoration,42,19,23
Drman,shattered-hand,1162,shaman,restoration,42,25,17
Ðøminantx,stormscale,1155,shaman,restoration,30,14,16
Quòr,antonidas,1154,shaman,restoration,30,23,7
Bombasthicc,ravencrest,1151,shaman,restoration,18,12,6
Phoenííx,twisting-nether,1151,shaman,restoration,24,12,12
Teldarian,archimonde,1151,shaman,restoration,24,12,12
Lolalovexo,kazzak,1150,shaman,restoration,30,14,16
Martuscielöl,drakthul,1149,shaman,restoration,38,12,26
Putzè,blackrock,1148,shaman,restoration,18,12,6
Djosershamy,draenor,1148,shaman,restoration,24,12,12
Kaherad,antonidas,1148,shaman,restoration,72,33,39
Leunam,draenor,1147,shaman,restoration,40,17,23
Kärríegold,blackrock,1146,shaman,restoration,18,12,6
Nogag,kazzak,1145,shaman,restoration,24,12,12
Laïnàà,archimonde,1136,shaman,restoration,53,21,32
Дагод,booty-bay,1131,shaman,restoration,18,12,6
Warianis,ravencrest,1128,shaman,restoration,24,12,12
Holshammy,nemesis,1127,shaman,restoration,90,39,51
Lemontea,burning-blade,1112,shaman,restoration,30,12,18
Woade,silvermoon,1108,shaman,restoration,30,12,18
Sáltý,ravencrest,1103,shaman,restoration,21,12,9
Thuknala,tarren-mill,1094,shaman,restoration,23,13,10
Darnok,quelthalas,1079,shaman,restoration,42,16,26
Fußpilzmann,blackmoore,1076,shaman,restoration,48,21,27
Baelee,sylvanas,1071,shaman,restoration,24,12,12
Smyke,magtheridon,1069,shaman,restoration,60,31,29
Руикси,howling-fjord,1056,shaman,restoration,24,11,13
Wess,archimonde,1056,shaman,restoration,24,11,13
Invadé,stormscale,1056,shaman,restoration,24,11,13
Fotmherøqtx,ravencrest,1055,shaman,restoration,18,11,7
Goeller,stormscale,1055,shaman,restoration,18,11,7
Incredibade,stormscale,1055,shaman,restoration,18,11,7
Garuga,dun-morogh,1055,shaman,restoration,24,11,13
Lexos,ravencrest,1054,shaman,restoration,18,11,7
Elshamino,ravencrest,1054,shaman,restoration,24,11,13
Tiddles,arathor,1053,shaman,restoration,18,11,7
Hexmeqt,frostwolf,1053,shaman,restoration,18,11,7
Gronash,sunstrider,1051,shaman,restoration,18,11,7
Kíkjo,aegwynn,1050,shaman,restoration,18,11,7
Enzopotenzo,blackrock,1050,shaman,restoration,24,11,13
Waterboi,blackmoore,1050,shaman,restoration,30,11,19
Redoms,stormreaver,1048,shaman,restoration,24,11,13
Flikus,aggra-português,1048,shaman,restoration,30,11,19
Murmaiderz,draenor,1047,shaman,restoration,24,11,13
Chokeonme,blackrock,1046,shaman,restoration,63,37,26
Mandoloriana,sylvanas,1041,shaman,restoration,24,11,13
Elijaá,nordrassil,1033,shaman,restoration,18,11,7
Dasce,sylvanas,1022,shaman,restoration,24,12,12
Mantoon,doomhammer,1013,shaman,restoration,30,12,18
Blainehammer,arathor,1006,shaman,restoration,30,12,18
Noulol,aegwynn,1005,shaman,restoration,23,12,11
Венжии,soulflayer,1002,shaman,restoration,30,12,18
Haginathor,twisting-nether,981,shaman,restoration,54,28,26
Variablelol,outland,974,shaman,restoration,11,11,0
Mearu,bronze-dragonflight,961,shaman,restoration,30,18,12
Милжон,soulflayer,961,shaman,restoration,31,17,14
Chäväman,archimonde,960,shaman,restoration,24,10,14
Tidepog,ravencrest,960,shaman,restoration,24,10,14
Horokeu,blackrock,959,shaman,restoration,18,10,8
Crysisx,sanguino,959,shaman,restoration,18,10,8
Loay,blackrock,959,shaman,restoration,24,10,14
Schnessert,silvermoon,956,shaman,restoration,24,10,14
Nwäar,archimonde,951,shaman,restoration,18,10,8
Alakan,saurfang,943,shaman,restoration,30,10,20
Bloodvaron,zuljin,942,shaman,restoration,29,10,19
Nexolok,alleria,933,shaman,restoration,54,30,24
Bîlunder,arygos,927,shaman,restoration,23,10,13
Panicsc,twisting-nether,920,shaman,restoration,23,10,13
Garifus,dun-modr,909,shaman,restoration,72,33,39
Märthalouise,twisting-nether,879,shaman,restoration,25,10,15
Mysterqt,nemesis,864,shaman,restoration,12,9,3
Batmanmain,twisting-nether,864,shaman,restoration,16,10,6
Nothexy,stormscale,864,shaman,restoration,18,9,9
Фатнир,soulflayer,864,shaman,restoration,18,9,9
Котенокмур,soulflayer,864,shaman,restoration,24,9,15
Carlitosham,eredar,864,shaman,restoration,24,9,15
Discoranger,ravencrest,863,shaman,restoration,18,9,9
Shamanopaf,tarren-mill,861,shaman,restoration,18,9,9
Ephase,burning-blade,861,shaman,restoration,24,9,15
Amu,ravencrest,860,shaman,restoration,18,9,9
Джонпсинаа,gordunni,860,shaman,restoration,18,9,9
Шайнинлайт,soulflayer,860,shaman,restoration,30,9,21
Orchal,defias-brotherhood,859,shaman,restoration,18,9,9
Sunsham,illidan,858,shaman,restoration,18,9,9
Valdraxx,ravencrest,852,shaman,restoration,46,19,27
Ambrosioss,kazzak,841,shaman,restoration,12,9,3
Numdog,stormreaver,831,shaman,restoration,17,9,8
Mcbloob,kazzak,829,shaman,restoration,22,10,12
Hacyria,archimonde,815,shaman,restoration,18,9,9
Дрфэка,soulflayer,815,shaman,restoration,36,9,27
Eduorde,silvermoon,796,shaman,restoration,14,9,5
Ivnashaman,drakthul,768,shaman,restoration,12,8,4
Рамаксбосс,gordunni,768,shaman,restoration,12,8,4
Lilcake,ravencrest,768,shaman,restoration,12,8,4
Disharmony,outland,768,shaman,restoration,12,8,4
Squixi,ravencrest,768,shaman,restoration,12,8,4
Socialfailur,archimonde,768,shaman,restoration,12,8,4
Rostislav,ravencrest,768,shaman,restoration,12,8,4
Enchancement,ragnaros,768,shaman,restoration,12,8,4
Lorko,twisting-nether,768,shaman,restoration,18,8,10
Igly,antonidas,768,shaman,restoration,18,8,10
Sprühkot,aegwynn,768,shaman,restoration,18,8,10
Swineflowing,ysondre,768,shaman,restoration,18,8,10
Ripstorm,sylvanas,768,shaman,restoration,18,8,10
Iloveléa,ravencrest,768,shaman,restoration,18,8,10
Eisei,stormscale,767,shaman,restoration,12,8,4
Berasham,dalaran,767,shaman,restoration,12,8,4
Jänis,ragnaros,767,shaman,restoration,12,8,4
Lauree,terokkar,767,shaman,restoration,12,8,4
Juyina,ravencrest,767,shaman,restoration,18,8,10
Ugard,burning-legion,767,shaman,restoration,18,8,10
Iwaa,dalaran,767,shaman,restoration,18,8,10
Nexian,kazzak,767,shaman,restoration,24,8,16
Aldron,tirion,766,shaman,restoration,12,8,4
Джоукх,howling-fjord,766,shaman,restoration,12,8,4
Xamic,twisting-nether,765,shaman,restoration,18,8,10
Gundersen,stormscale,763,shaman,restoration,18,8,10
Bennycooch,silvermoon,763,shaman,restoration,24,8,16
Bullvai,dun-morogh,761,shaman,restoration,12,8,4
Rórekk,aegwynn,761,shaman,restoration,18,8,10
Linknvm,thrall,760,shaman,restoration,12,8,4
Swedishmeat,kazzak,757,shaman,restoration,20,11,9
Selrin,blackrock,718,shaman,restoration,23,8,15
Midgetfizzle,kazzak,714,shaman,restoration,22,10,12
Carpetmaster,ragnaros,714,shaman,restoration,21,9,12
Mltx,twilights-hammer,703,shaman,restoration,14,8,6
Thangog,ragnaros,703,shaman,restoration,16,8,8
Spiirit,tarren-mill,672,shaman,restoration,12,7,5
Pvegame,tarren-mill,672,shaman,restoration,12,7,5
Timide,ravencrest,672,shaman,restoration,12,7,5
Drohx,ysondre,672,shaman,restoration,12,7,5
Bullfox,aszune,672,shaman,restoration,12,7,5
Awumbahway,outland,672,shaman,restoration,12,7,5
Raintlordx,twisting-nether,672,shaman,restoration,12,7,5
Rôwdy,kazzak,672,shaman,restoration,12,7,5
Elmezz,aggra-português,672,shaman,restoration,12,7,5
Тубалкайн,soulflayer,672,shaman,restoration,12,7,5
Voodoonerd,twisting-nether,672,shaman,restoration,12,7,5
Alëxx,hyjal,672,shaman,restoration,12,7,5
Pädagogeig,antonidas,672,shaman,restoration,12,7,5
Arathoir,ravencrest,672,shaman,restoration,12,7,5
Aioñ,kazzak,672,shaman,restoration,15,7,8
Viinny,dun-modr,672,shaman,restoration,18,7,11
Jenkem,hyjal,672,shaman,restoration,18,7,11
Крэйвхх,howling-fjord,672,shaman,restoration,18,7,11
Cylantarus,blackrock,672,shaman,restoration,18,7,11
Çøynx,aegwynn,672,shaman,restoration,20,7,13
Oscar,khaz-modan,671,shaman,restoration,12,7,5
Schamazon,tarren-mill,671,shaman,restoration,12,7,5
Suntpraf,kazzak,671,shaman,restoration,12,7,5
Shâdôwlîght,antonidas,671,shaman,restoration,18,7,11
Zaiyoxgodx,thrall,671,shaman,restoration,18,7,11
Daboó,vashj,670,shaman,restoration,12,7,5
Shámpain,antonidas,670,shaman,restoration,12,7,5
Gnackbretzn,eredar,670,shaman,restoration,24,7,17
Bogmagnus,the-maelstrom,659,shaman,restoration,39,13,26
Nojiko,blackrock,638,shaman,restoration,17,7,10
Hazufel,kaelthas,634,shaman,restoration,20,8,12
Иоч,soulflayer,623,shaman,restoration,11,7,4
Енотикусь,soulflayer,618,shaman,restoration,12,8,4
Мке,howling-fjord,615,shaman,restoration,29,11,18
Shamiinn,ravencrest,576,shaman,restoration,6,6,0
Goodevening,tarren-mill,576,shaman,restoration,12,6,6
Blipster,tarren-mill,576,shaman,restoration,12,6,6
Komodski,kazzak,576,shaman,restoration,12,6,6
Raketenrieke,blackrock,576,shaman,restoration,12,6,6
Quizx,blackrock,576,shaman,restoration,12,6,6
Wintradezki,tarren-mill,576,shaman,restoration,12,6,6
Monamour,twisting-nether,576,shaman,restoration,12,6,6
Katwio,hyjal,576,shaman,restoration,12,6,6
Mêrowinger,blackhand,576,shaman,restoration,12,6,6
Назульчике,razuvious,576,shaman,restoration,12,6,6
Dimront,gorgonnash,576,shaman,restoration,12,6,6
Apaorkaxyz,ragnaros,576,shaman,restoration,12,6,6
Bigdaddyxo,tarren-mill,576,shaman,restoration,12,6,6
Horcsog,ravencrest,576,shaman,restoration,12,6,6
Wibra,nagrand,576,shaman,restoration,12,6,6
Rckfeller,burning-legion,576,shaman,restoration,12,6,6
Enoughh,the-maelstrom,576,shaman,restoration,12,6,6
Runbrorun,hyjal,576,shaman,restoration,12,6,6
Gromaburst,stormscale,576,shaman,restoration,12,6,6
Канамаш,borean-tundra,576,shaman,restoration,12,6,6
Redomsh,stormreaver,576,shaman,restoration,12,6,6
Ambuu,kazzak,576,shaman,restoration,12,6,6
Zoolza,kirin-tor,576,shaman,restoration,18,6,12
Jackypink,ragnaros,576,shaman,restoration,18,6,12
Bresidendo,frostwhisper,576,shaman,restoration,18,6,12
Nakenfeigy,stormreaver,575,shaman,restoration,6,6,0
Beyp,sylvanas,575,shaman,restoration,12,6,6
Shamnox,blackrock,575,shaman,restoration,12,6,6
Stortvloed,twisting-nether,575,shaman,restoration,12,6,6
Whatsup,aggramar,575,shaman,restoration,12,6,6
Icytide,kazzak,528,shaman,restoration,15,6,9
Télapou,ragnaros,527,shaman,restoration,11,6,5
Манрото,soulflayer,526,shaman,restoration,9,6,3
Crixuss,argent-dawn,526,shaman,restoration,11,6,5
Arigolds,twilights-hammer,511,shaman,restoration,11,6,5
Jakesmistake,stormscale,494,shaman,restoration,11,7,4
Эйвуа,gordunni,486,shaman,restoration,22,8,14
Ub,garona,480,shaman,restoration,6,5,1
Antikahraman,blackrock,480,shaman,restoration,6,5,1
Schamfxx,blackrock,480,shaman,restoration,6,5,1
Shamsteaks,thrall,480,shaman,restoration,6,5,1
Терату,howling-fjord,480,shaman,restoration,6,5,1
Lexxthree,blackrock,480,shaman,restoration,6,5,1
Fernashaman,aggra-português,480,shaman,restoration,6,5,1
Geneazytwo,silvermoon,480,shaman,restoration,6,5,1
Qobq,ravencrest,480,shaman,restoration,6,5,1
Lmnn,ravencrest,480,shaman,restoration,6,5,1
Vodoochild,hyjal,480,shaman,restoration,6,5,1
Djschamihaar,blackrock,480,shaman,restoration,6,5,1
Kelvok,silvermoon,480,shaman,restoration,6,5,1
Holytidezx,aegwynn,480,shaman,restoration,10,6,4
Hakunax,twisting-nether,480,shaman,restoration,12,5,7
Syreer,silvermoon,480,shaman,restoration,12,5,7
Cheerz,ravencrest,480,shaman,restoration,12,5,7
Szellento,darksorrow,480,shaman,restoration,12,5,7
Inspektør,kazzak,480,shaman,restoration,12,5,7
Bandyy,magtheridon,480,shaman,restoration,12,5,7
Yuliy,arathor,480,shaman,restoration,12,5,7
Papskalla,ravencrest,480,shaman,restoration,12,5,7
Evííl,tarren-mill,480,shaman,restoration,12,5,7
Markboymint,earthen-ring,480,shaman,restoration,12,5,7
Évileye,silvermoon,480,shaman,restoration,12,5,7
Uanl,stormscale,480,shaman,restoration,12,5,7
Volwerin,blackhand,480,shaman,restoration,12,5,7
Kacamaz,twisting-nether,480,shaman,restoration,12,5,7
Blowlips,argent-dawn,480,shaman,restoration,12,5,7
Lontarsdaddy,twisting-nether,480,shaman,restoration,12,5,7
Maestralink,aegwynn,480,shaman,restoration,12,5,7
Azifox,hyjal,480,shaman,restoration,12,5,7
Sørum,grim-batol,480,shaman,restoration,12,5,7
Libano,archimonde,480,shaman,restoration,12,5,7
Reticlol,kazzak,480,shaman,restoration,12,5,7
Bosskwtt,kazzak,480,shaman,restoration,12,5,7
Alisàn,teldrassil,480,shaman,restoration,13,5,8
Savan,darkspear,480,shaman,restoration,24,5,19
Banilikum,tarren-mill,480,shaman,restoration,24,5,19
Jävlajävel,draenor,479,shaman,restoration,6,5,1
Bénathon,ravencrest,479,shaman,restoration,10,6,4
Сорнинай,soulflayer,479,shaman,restoration,12,5,7
Spartecøbra,dalaran,479,shaman,restoration,12,5,7
Thunderberg,antonidas,475,shaman,restoration,12,5,7
Sèfìx,tarren-mill,447,shaman,restoration,14,6,8
Cømedian,ragnaros,431,shaman,restoration,9,6,3
Shamakerr,tarren-mill,426,shaman,restoration,17,7,10
Äppelpaj,earthen-ring,426,shaman,restoration,15,6,9
Tegellera,ravencrest,424,shaman,restoration,17,6,11
Blixtlasse,magtheridon,400,shaman,restoration,13,5,8
Kyogre,auchindoun,384,shaman,restoration,6,4,2
Greatørc,tarren-mill,384,shaman,restoration,6,4,2
Ærthgød,stormscale,384,shaman,restoration,6,4,2
Jimkopf,eredar,384,shaman,restoration,6,4,2
Soffsittaren,kazzak,384,shaman,restoration,6,4,2
Ruvxy,twisting-nether,384,shaman,restoration,6,4,2
Holytidez,aegwynn,384,shaman,restoration,6,4,2
Tigo,tarren-mill,384,shaman,restoration,6,4,2
Monstacookie,stormreaver,384,shaman,restoration,6,4,2
Ларисашерсть,blackscar,384,shaman,restoration,6,4,2
Виелетта,gordunni,384,shaman,restoration,6,4,2
Dmgaddict,kazzak,384,shaman,restoration,6,4,2
Neovim,trollbane,384,shaman,restoration,6,4,2
Bandulski,twisting-nether,384,shaman,restoration,6,4,2
Viallinen,stormreaver,384,shaman,restoration,6,4,2
Tonifo,nemesis,384,shaman,restoration,6,4,2
Pogchampz,nemesis,384,shaman,restoration,6,4,2
Hamuksha,nerathor,384,shaman,restoration,6,4,2
Хотдевил,gordunni,384,shaman,restoration,6,4,2
Lingz,auchindoun,384,shaman,restoration,6,4,2
Aliatës,sanguino,384,shaman,restoration,6,4,2
Purgérkíng,silvermoon,384,shaman,restoration,6,4,2
Qoekke,uldum,384,shaman,restoration,6,4,2
Keenxd,burning-legion,384,shaman,restoration,6,4,2
Stolen,skullcrusher,384,shaman,restoration,6,4,2
Pank,kazzak,384,shaman,restoration,6,4,2
Grimn,burning-legion,384,shaman,restoration,6,4,2
Pilinham,aggra-português,384,shaman,restoration,6,4,2
Kekke,uldum,384,shaman,restoration,6,4,2
Санрэйн,soulflayer,384,shaman,restoration,6,4,2
Naphe,ysondre,384,shaman,restoration,12,4,8
Fersok,zuljin,384,shaman,restoration,12,4,8
Squixi,tarren-mill,384,shaman,restoration,12,4,8
Lavababe,blackmoore,384,shaman,restoration,12,4,8
Muril,argent-dawn,384,shaman,restoration,12,4,8
Archsha,burning-legion,384,shaman,restoration,12,4,8
Kaffekask,stormscale,384,shaman,restoration,12,4,8
Roverlos,blackrock,384,shaman,restoration,12,4,8
Kerfo,ragnaros,384,shaman,restoration,12,4,8
Shammzy,malganis,384,shaman,restoration,12,4,8
Vey,hyjal,384,shaman,restoration,12,4,8
Hyflex,alakir,384,shaman,restoration,12,4,8
Omgodofwar,burning-blade,384,shaman,restoration,12,4,8
Saviothewise,aggra-português,383,shaman,restoration,6,4,2
Fivezax,tarren-mill,383,shaman,restoration,6,4,2
Khattla,outland,383,shaman,restoration,6,4,2
Knasta,malygos,383,shaman,restoration,12,4,8
Rêêza,blackhand,383,shaman,restoration,12,4,8
Sleyvarian,chamber-of-aspects,383,shaman,restoration,12,4,8
Killhorn,malganis,382,shaman,restoration,6,4,2
Slippyjim,azshara,382,shaman,restoration,12,4,8
Xpone,blackrock,380,shaman,restoration,12,4,8
Zboubii,archimonde,351,shaman,restoration,11,4,7
Xoxoxoxoa,twisting-nether,328,shaman,restoration,29,6,23
Zhangliyi,ravencrest,319,shaman,restoration,5,4,1
Reparagos,sanguino,304,shaman,restoration,7,4,3
Cukkerberg,ragnaros,288,shaman,restoration,6,3,3
Shamamamin,argent-dawn,288,shaman,restoration,6,3,3
Shamoobob,archimonde,288,shaman,restoration,6,3,3
Totemboyuk,tarren-mill,288,shaman,restoration,6,3,3
Tarzh,dalaran,288,shaman,restoration,6,3,3
Onlytides,doomhammer,288,shaman,restoration,6,3,3
Tenror,ragnaros,288,shaman,restoration,6,3,3
Skrewu,stormscale,288,shaman,restoration,6,3,3
Kilazz,twisting-nether,288,shaman,restoration,6,3,3
Ханикс,blackscar,288,shaman,restoration,6,3,3
Вэллкомм,gordunni,288,shaman,restoration,6,3,3
Kataclysm,nemesis,288,shaman,restoration,6,3,3
Mestgonee,draenor,288,shaman,restoration,6,3,3
Arshak,stormscale,288,shaman,restoration,6,3,3
Splashgodx,frostwolf,288,shaman,restoration,6,3,3
Soulsh,die-ewige-wacht,288,shaman,restoration,6,3,3
Yarali,argent-dawn,288,shaman,restoration,6,3,3
Ярусскийй,howling-fjord,288,shaman,restoration,6,3,3
Karakoram,ysondre,288,shaman,restoration,6,3,3
Shamansh,draenor,288,shaman,restoration,6,3,3
Oldmanrena,stormscale,288,shaman,restoration,6,3,3
Draredemolen,archimonde,288,shaman,restoration,6,3,3
Tartorno,antonidas,288,shaman,restoration,6,3,3
Zyphiz,twisting-nether,288,shaman,restoration,6,3,3
Lanzatotems,dun-modr,288,shaman,restoration,6,3,3
Indeed,frostmourne,288,shaman,restoration,6,3,3
Rndshaman,thrall,288,shaman,restoration,6,3,3
Nêmônin,perenolde,288,shaman,restoration,6,3,3
Stibs,silvermoon,288,shaman,restoration,6,3,3
Pépón,dun-modr,288,shaman,restoration,6,3,3
Turbokrapka,tarren-mill,288,shaman,restoration,6,3,3
Shèshe,uldaman,288,shaman,restoration,6,3,3
Aeknor,ravencrest,288,shaman,restoration,6,3,3
Vaweñ,ravencrest,288,shaman,restoration,6,3,3
Madytz,eredar,288,shaman,restoration,6,3,3
Meöw,nemesis,288,shaman,restoration,6,3,3
Abalenn,kazzak,288,shaman,restoration,6,3,3
Richtigfies,kazzak,288,shaman,restoration,6,3,3
Гарантийный,lich-king,288,shaman,restoration,6,3,3
Prepegahex,blackmoore,288,shaman,restoration,6,3,3
Wtbtoes,ravencrest,288,shaman,restoration,12,3,9
Charquanda,argent-dawn,288,shaman,restoration,12,3,9
Volstorm,ysondre,288,shaman,restoration,12,3,9
Floki,emerald-dream,288,shaman,restoration,12,3,9
Madrävëngodx,ragnaros,288,shaman,restoration,12,3,9
Barbebiendur,archimonde,288,shaman,restoration,12,3,9
Nyzo,tarren-mill,288,shaman,restoration,12,3,9
Feizhousa,outland,288,shaman,restoration,12,3,9
Aboveaverage,stormscale,288,shaman,restoration,12,3,9
Neejtjak,ravencrest,288,shaman,restoration,12,3,9
Totembaws,blackmoore,288,shaman,restoration,12,3,9
Nêgan,ravencrest,288,shaman,restoration,16,3,13
Sakoon,twisting-nether,287,shaman,restoration,6,3,3
Yàra,throkferoth,287,shaman,restoration,6,3,3
Alïsyo,nemesis,287,shaman,restoration,12,3,9
Corbo,ysondre,285,shaman,restoration,9,4,5
Mimsy,hyjal,285,shaman,restoration,12,3,9
Грейсаша,howling-fjord,270,shaman,restoration,11,3,8
Crazypurgeqt,arathor,255,shaman,restoration,11,3,8
Elliesham,kazzak,239,shaman,restoration,5,3,2
Brigantino,burning-legion,239,shaman,restoration,5,3,2
Tickly,blackhand,239,shaman,restoration,5,3,2
Suculenta,zuljin,238,shaman,restoration,5,3,2
Vukroth,argent-dawn,222,shaman,restoration,8,3,5
Maybeyes,twisting-nether,192,shaman,restoration,6,2,4
Fufupartyxx,blackrock,192,shaman,restoration,6,2,4
Coöld,archimonde,192,shaman,restoration,6,2,4
Umbraverfaa,twisting-nether,192,shaman,restoration,6,2,4
Thanasiss,kazzak,192,shaman,restoration,6,2,4
Liferqt,nemesis,192,shaman,restoration,6,2,4
Raincaller,archimonde,192,shaman,restoration,6,2,4
Vickeshaman,stormreaver,192,shaman,restoration,6,2,4
Srøgg,archimonde,192,shaman,restoration,6,2,4
Элементаликс,ashenvale,192,shaman,restoration,6,2,4
Cragouz,archimonde,192,shaman,restoration,6,2,4
Tether,twisting-nether,192,shaman,restoration,6,2,4
Dmgccbot,outland,192,shaman,restoration,6,2,4
Kàji,ravencrest,192,shaman,restoration,6,2,4
Wåe,outland,192,shaman,restoration,6,2,4
Sniipy,blackmoore,192,shaman,restoration,6,2,4
Урахарочка,soulflayer,192,shaman,restoration,6,2,4
Pumanii,silvermoon,192,shaman,restoration,6,2,4
Checkpoint,defias-brotherhood,192,shaman,restoration,6,2,4
Berascendz,argent-dawn,192,shaman,restoration,6,2,4
Wahya,stormscale,192,shaman,restoration,6,2,4
Lexus,nordrassil,192,shaman,restoration,6,2,4
Sablolix,ravencrest,192,shaman,restoration,6,2,4
Lêss,ysondre,192,shaman,restoration,6,2,4
Ðiezz,ysondre,192,shaman,restoration,6,2,4
Pûrge,tarren-mill,192,shaman,restoration,6,2,4
Nixxy,magtheridon,192,shaman,restoration,6,2,4
Vulkan,kirin-tor,192,shaman,restoration,6,2,4
Vyrá,onyxia,192,shaman,restoration,6,2,4
Hímars,ragnaros,192,shaman,restoration,6,2,4
Боргирх,soulflayer,192,shaman,restoration,6,2,4
Kevox,malganis,192,shaman,restoration,6,2,4
Natasz,burning-legion,192,shaman,restoration,6,2,4
Xentic,kazzak,192,shaman,restoration,6,2,4
Semrix,blackhand,192,shaman,restoration,6,2,4
Mcgrêgor,aegwynn,192,shaman,restoration,6,2,4
Shàwyn,sylvanas,192,shaman,restoration,6,2,4
Nøný,gorgonnash,192,shaman,restoration,6,2,4
Soger,mannoroth,192,shaman,restoration,6,2,4
Snobas,kazzak,192,shaman,restoration,6,2,4
Schmamane,blutkessel,192,shaman,restoration,6,2,4
Grende,sylvanas,192,shaman,restoration,6,2,4
Шиока,borean-tundra,192,shaman,restoration,6,2,4
Baboss,blutkessel,192,shaman,restoration,6,2,4
Strikerz,aggra-português,192,shaman,restoration,7,2,5
Gards,sylvanas,192,shaman,restoration,12,2,10
Ekxr,kazzak,192,shaman,restoration,12,2,10
Muntark,thrall,192,shaman,restoration,12,2,10
Cptnkirby,malganis,192,shaman,restoration,12,2,10
Jelincic,ravencrest,192,shaman,restoration,12,2,10
Shamhingo,stormscale,192,shaman,restoration,18,2,16
Zenzua,twisting-nether,159,shaman,restoration,5,2,3
Belldandý,archimonde,128,shaman,restoration,4,2,2
Shamaray,stormscale,127,shaman,restoration,8,2,6
Kelshaj,thrall,96,shaman,restoration,3,2,1
Shamgott,silvermoon,96,shaman,restoration,6,1,5
Reflux,outland,96,shaman,restoration,6,1,5
Чаиро,howling-fjord,96,shaman,restoration,6,1,5
Zimzalabling,kazzak,96,shaman,restoration,6,1,5
Таззикшок,soulflayer,96,shaman,restoration,6,1,5
Ikó,kazzak,96,shaman,restoration,6,1,5
Garulf,twisting-nether,96,shaman,restoration,6,1,5
Greenbo,burning-blade,96,shaman,restoration,6,1,5
Rëazx,archimonde,96,shaman,restoration,6,1,5
Ripperdoc,stormreaver,96,shaman,restoration,6,1,5
Dvrg,antonidas,96,shaman,restoration,6,1,5
Zethh,antonidas,96,shaman,restoration,6,1,5
Nêôô,blackrock,96,shaman,restoration,6,1,5
Thísisrestø,sanguino,96,shaman,restoration,6,1,5
Kimpa,minahonda,96,shaman,restoration,6,1,5
Ronell,argent-dawn,96,shaman,restoration,6,1,5
Dälon,thrall,96,shaman,restoration,6,1,5
Rawtex,draenor,96,shaman,restoration,6,1,5
Chunkss,argent-dawn,96,shaman,restoration,12,1,11
Tiamât,culte-de-la-rive-noire,96,shaman,restoration,12,1,11
Freeleys,silvermoon,96,shaman,restoration,12,1,11
Porre,zuljin,96,shaman,restoration,12,1,11
Penumbrah,kazzak,96,shaman,restoration,20,1,19
Hairball,turalyon,95,shaman,restoration,6,2,4
Twotwozero,defias-brotherhood,95,shaman,restoration,6,1,5
Taiki,sylvanas,90,shaman,restoration,13,4,9
Realiz,ysondre,79,shaman,restoration,5,1,4
Icozy,stormscale,48,shaman,restoration,3,1,2
Icanbreathe,ravencrest,42,shaman,restoration,9,2,7
Gerlo,thrall,41,shaman,restoration,7,2,5
Rungõo,blackrock,2267,shaman,elemental,84,48,36
Silden,thrall,2157,shaman,elemental,97,55,42
Shamanazor,twisting-nether,2153,shaman,elemental,66,41,25
Trickful,kazzak,2136,shaman,elemental,60,42,18
Lexila,doomhammer,2119,shaman,elemental,71,46,25
Lavayoshi,kazzak,2086,shaman,elemental,66,47,19
Space,stormscale,1983,shaman,elemental,66,33,33
Satisfya,ambossar,1937,shaman,elemental,53,31,22
Rngo,blackrock,1906,shaman,elemental,36,23,13
Eyi,ambossar,1883,shaman,elemental,80,40,40
Kärríegold,blackrock,1878,shaman,elemental,87,48,39
Punished,blackrock,1869,shaman,elemental,42,25,17
Lavaole,blackrock,1861,shaman,elemental,42,24,18
Маигваза,soulflayer,1843,shaman,elemental,36,24,12
Crazyshaman,ravencrest,1829,shaman,elemental,53,26,27
Healyoa,blackmoore,1817,shaman,elemental,105,51,54
Theglue,kilrogg,1816,shaman,elemental,30,19,11
Штормкрашер,howling-fjord,1810,shaman,elemental,48,30,18
Djlavaburst,malganis,1810,shaman,elemental,110,56,54
Kailash,defias-brotherhood,1808,shaman,elemental,54,26,28
Naskezz,kazzak,1804,shaman,elemental,83,40,43
Burstraze,tarren-mill,1801,shaman,elemental,58,32,26
Suldaro,aegwynn,1800,shaman,elemental,55,30,25
Anqe,twisting-nether,1800,shaman,elemental,66,34,32
Shiggenbasta,kazzak,1766,shaman,elemental,42,26,16
Onceinalife,ambossar,1741,shaman,elemental,35,21,14
Pitsamestari,frostmane,1732,shaman,elemental,63,37,26
Xtremeshaman,blackmoore,1709,shaman,elemental,24,18,6
Spajry,drakthul,1695,shaman,elemental,24,18,6
Braíntas,norgannon,1682,shaman,elemental,36,20,16
Sáàd,ravencrest,1681,shaman,elemental,42,20,22
Ânuk,blackrock,1677,shaman,elemental,96,47,49
Smorchamp,sanguino,1676,shaman,elemental,36,22,14
Proccit,blackrock,1673,shaman,elemental,42,22,20
Esal,blackrock,1665,shaman,elemental,31,21,10
Zaarok,voljin,1655,shaman,elemental,81,37,44
Haasshaman,ravencrest,1650,shaman,elemental,43,21,22
Batan,kazzak,1643,shaman,elemental,53,26,27
Volcanò,outland,1643,shaman,elemental,52,24,28
Карбонатрикс,soulflayer,1641,shaman,elemental,30,19,11
Axahavregryn,kazzak,1640,shaman,elemental,66,40,26
Urshak,alleria,1639,shaman,elemental,36,24,12
Dakyele,ravencrest,1636,shaman,elemental,35,20,15
Eupra,archimonde,1630,shaman,elemental,30,17,13
Malybou,ysondre,1628,shaman,elemental,30,17,13
Rrtyui,twisting-nether,1628,shaman,elemental,30,17,13
Mcmxcvi,ravencrest,1625,shaman,elemental,24,17,7
Ungabungha,stormscale,1625,shaman,elemental,72,42,30
Blízzilassø,malygos,1621,shaman,elemental,137,74,63
Sniffix,ysondre,1594,shaman,elemental,61,33,28
Гудлаик,soulflayer,1584,shaman,elemental,58,32,26
Twiva,silvermoon,1572,shaman,elemental,76,45,31
Anøüchkä,ysondre,1572,shaman,elemental,42,21,21
Neotrax,outland,1571,shaman,elemental,60,31,29
Томёрк,gordunni,1569,shaman,elemental,79,40,39
Harod,suramar,1558,shaman,elemental,66,34,32
Deeck,ravencrest,1557,shaman,elemental,60,38,22
Hapkin,defias-brotherhood,1557,shaman,elemental,48,24,24
Nykhara,sanguino,1554,shaman,elemental,30,17,13
Lavatherapy,grim-batol,1550,shaman,elemental,30,17,13
Ryysham,ravencrest,1526,shaman,elemental,30,16,14
Essneces,burning-legion,1523,shaman,elemental,36,18,18
Valunii,lordaeron,1518,shaman,elemental,52,22,30
Mariomental,draenor,1517,shaman,elemental,36,16,20
Athul,theradras,1513,shaman,elemental,37,22,15
Máui,korgall,1506,shaman,elemental,42,21,21
Милфшама,blackscar,1505,shaman,elemental,35,17,18
Borbor,argent-dawn,1496,shaman,elemental,34,16,18
Connecting,hyjal,1439,shaman,elemental,24,15,9
Gungo,deathwing,1435,shaman,elemental,30,15,15
Totemlié,ravencrest,1434,shaman,elemental,24,15,9
Naorgot,uldaman,1432,shaman,elemental,30,15,15
Skrbkic,tarren-mill,1429,shaman,elemental,91,48,43
Kirak,anetheron,1428,shaman,elemental,60,33,27
Kæzx,blackrock,1421,shaman,elemental,30,15,15
Alèks,forscherliga,1415,shaman,elemental,56,36,20
Lafia,blackrock,1415,shaman,elemental,36,15,21
Olawizard,draenor,1401,shaman,elemental,43,22,21
Løun,archimonde,1400,shaman,elemental,30,15,15
Дестройбэйби,gordunni,1385,shaman,elemental,36,20,16
Rohknar,ragnaros,1374,shaman,elemental,30,17,13
Kimpa,minahonda,1373,shaman,elemental,60,34,26
Тыщатристах,howling-fjord,1366,shaman,elemental,30,20,10
Jímmy,frostwhisper,1353,shaman,elemental,24,15,9
Murdá,ravencrest,1343,shaman,elemental,24,14,10
Tâsty,blackmoore,1343,shaman,elemental,24,14,10
Nalaadu,stormscale,1338,shaman,elemental,24,14,10
Xesti,twisting-nether,1337,shaman,elemental,54,26,28
Totemlyhot,blackrock,1333,shaman,elemental,24,14,10
Гексанол,soulflayer,1332,shaman,elemental,34,16,18
Microb,blackmoore,1326,shaman,elemental,30,14,16
Doneteasy,blackrock,1315,shaman,elemental,24,14,10
Amanishama,twisting-nether,1313,shaman,elemental,42,21,21
Lavamann,blackmoore,1313,shaman,elemental,36,18,18
Флоррэт,gordunni,1287,shaman,elemental,42,15,27
Bigboisham,outland,1261,shaman,elemental,29,15,14
Mezzoblu,sanguino,1253,shaman,elemental,31,14,17
Blackyx,dun-modr,1247,shaman,elemental,18,13,5
Dretch,dun-morogh,1247,shaman,elemental,24,13,11
Mjorè,twisting-nether,1247,shaman,elemental,24,13,11
Chênoya,blackrock,1246,shaman,elemental,30,13,17
Shibol,ravencrest,1246,shaman,elemental,34,14,20
Quizx,blackrock,1245,shaman,elemental,60,25,35
Gagné,hyjal,1239,shaman,elemental,24,13,11
Makgoa,ysondre,1237,shaman,elemental,18,13,5
Alwaysangry,silvermoon,1236,shaman,elemental,24,13,11
Vulcainn,marécage-de-zangar,1232,shaman,elemental,47,31,16
Zna,archimonde,1224,shaman,elemental,34,14,20
Waterboi,blackmoore,1219,shaman,elemental,24,13,11
Сосмыслом,howling-fjord,1217,shaman,elemental,30,13,17
Xfiles,garona,1210,shaman,elemental,36,16,20
Lechirurgien,elune,1206,shaman,elemental,24,13,11
Märthalouise,twisting-nether,1191,shaman,elemental,29,15,14
Aviciix,sanguino,1180,shaman,elemental,32,13,19
Boxo,frostwolf,1169,shaman,elemental,46,27,19
Фистинктотем,soulflayer,1162,shaman,elemental,35,16,19
Agrero,auchindoun,1152,shaman,elemental,18,12,6
Blyatifulday,malganis,1152,shaman,elemental,24,12,12
Eppîx,lightnings-blade,1152,shaman,elemental,24,12,12
Barbarra,stormscale,1152,shaman,elemental,24,12,12
Matmonai,hyjal,1152,shaman,elemental,30,12,18
Zest,hyjal,1151,shaman,elemental,18,12,6
Pxsquals,ravencrest,1151,shaman,elemental,18,12,6
Tasoro,sanguino,1151,shaman,elemental,24,12,12
Obryss,tarren-mill,1151,shaman,elemental,24,12,12
Fabslx,archimonde,1151,shaman,elemental,24,12,12
Feetenjoyerx,kazzak,1151,shaman,elemental,24,12,12
Xorron,archimonde,1149,shaman,elemental,30,12,18
Goromar,kirin-tor,1144,shaman,elemental,54,22,32
Waaghbozz,eredar,1138,shaman,elemental,24,12,12
Pawsh,dun-modr,1138,shaman,elemental,27,13,14
Onlyfansmod,uldum,1137,shaman,elemental,24,12,12
Tempest,kul-tiras,1136,shaman,elemental,18,12,6
Djent,outland,1133,shaman,elemental,24,12,12
Superkee,kazzak,1126,shaman,elemental,24,14,10
Elshifotrem,throkferoth,1125,shaman,elemental,24,12,12
Велгур,soulflayer,1120,shaman,elemental,26,13,13
Farùk,ravencrest,1102,shaman,elemental,21,13,8
Earthtjockis,ragnaros,1087,shaman,elemental,17,12,5
Båkka,ysondre,1056,shaman,elemental,12,11,1
Bärtigeberta,aegwynn,1056,shaman,elemental,18,11,7
Tommybanger,kazzak,1056,shaman,elemental,18,11,7
Drshock,blackmoore,1056,shaman,elemental,24,11,13
Matmons,hyjal,1056,shaman,elemental,24,11,13
Dzielnysham,silvermoon,1054,shaman,elemental,18,11,7
Èrò,blackhand,1053,shaman,elemental,24,11,13
Dropdattotem,stormscale,1049,shaman,elemental,24,11,13
Louler,ragnaros,1049,shaman,elemental,24,11,13
Kylas,die-ewige-wacht,1047,shaman,elemental,18,11,7
Flochy,argent-dawn,1008,shaman,elemental,42,25,17
Justweirdaf,blackmoore,980,shaman,elemental,27,12,15
Proccq,twisting-nether,960,shaman,elemental,18,10,8
Paulbaniel,alonsus,960,shaman,elemental,24,10,14
Thorleíf,silvermoon,959,shaman,elemental,18,10,8
Sunsong,twisting-nether,958,shaman,elemental,24,10,14
Transcendent,malorne,956,shaman,elemental,12,10,2
Pórçé,shattered-hand,954,shaman,elemental,18,10,8
Fúth,ysondre,954,shaman,elemental,22,11,11
Rekhtar,burning-legion,944,shaman,elemental,18,10,8
Obesisham,outland,943,shaman,elemental,30,11,19
Smorcxx,kazzak,934,shaman,elemental,30,10,20
Orishimaru,blackrock,932,shaman,elemental,23,10,13
Scurvy,malganis,907,shaman,elemental,24,10,14
Соленый,booty-bay,876,shaman,elemental,39,17,22
ßaraky,kazzak,864,shaman,elemental,12,9,3
Bambustic,kazzak,864,shaman,elemental,12,9,3
Raintlordx,twisting-nether,864,shaman,elemental,12,9,3
Jøhnwick,ysondre,864,shaman,elemental,18,9,9
Johncoltrane,archimonde,863,shaman,elemental,12,9,3
Гивми,blackscar,863,shaman,elemental,16,10,6
Думсия,gordunni,863,shaman,elemental,18,9,9
Smort,frostwolf,863,shaman,elemental,18,9,9
Drainergødx,ragnaros,863,shaman,elemental,18,9,9
Bigheal,quelthalas,862,shaman,elemental,18,9,9
Bowtenstorm,ravencrest,849,shaman,elemental,12,9,3
Holdafstand,tarren-mill,798,shaman,elemental,14,9,5
Stickix,malganis,768,shaman,elemental,12,8,4
Aspên,archimonde,768,shaman,elemental,12,8,4
Dumpaman,frostmane,768,shaman,elemental,12,8,4
Elektron,malganis,768,shaman,elemental,12,8,4
Visboer,stormscale,768,shaman,elemental,12,8,4
Adamyo,stormscale,768,shaman,elemental,18,8,10
Naphe,ysondre,768,shaman,elemental,18,8,10
Thorunir,sylvanas,768,shaman,elemental,24,8,16
Robofat,ravencrest,767,shaman,elemental,12,8,4
Yang,der-rat-von-dalaran,767,shaman,elemental,12,8,4
Atuaßëlha,grim-batol,767,shaman,elemental,18,8,10
Magath,nethersturm,766,shaman,elemental,12,8,4
Электро,thermaplugg,719,shaman,elemental,11,8,3
Dòrfy,silvermoon,672,shaman,elemental,12,7,5
Replicusele,doomhammer,672,shaman,elemental,12,7,5
Pipousham,blackhand,672,shaman,elemental,12,7,5
Jehae,archimonde,672,shaman,elemental,12,7,5
Ðãvê,veknilash,672,shaman,elemental,12,7,5
Pheazka,outland,672,shaman,elemental,12,7,5
Чойсе,deathguard,672,shaman,elemental,12,7,5
Shamandoino,wildhammer,672,shaman,elemental,12,7,5
Horizons,the-maelstrom,672,shaman,elemental,12,7,5
Diaba,sylvanas,672,shaman,elemental,12,7,5
Bosslikex,ravencrest,672,shaman,elemental,12,7,5
Kæde,dun-morogh,672,shaman,elemental,12,7,5
Starelement,draenor,672,shaman,elemental,18,7,11
Шумноватт,howling-fjord,672,shaman,elemental,18,7,11
Canjo,aegwynn,671,shaman,elemental,18,7,11
Cracklord,outland,671,shaman,elemental,18,7,11
Tiamât,culte-de-la-rive-noire,667,shaman,elemental,18,7,11
Ximid,doomhammer,659,shaman,elemental,18,7,11
Федосик,galakrond,658,shaman,elemental,18,7,11
Mcbloob,kazzak,639,shaman,elemental,11,7,4
Screwz,archimonde,638,shaman,elemental,14,8,6
Zanyun,burning-legion,607,shaman,elemental,14,7,7
Jåime,ravencrest,576,shaman,elemental,6,6,0
Baarona,neptulon,576,shaman,elemental,6,6,0
Forrak,argent-dawn,576,shaman,elemental,12,6,6
Kemurus,kazzak,576,shaman,elemental,12,6,6
Cïgänää,archimonde,576,shaman,elemental,12,6,6
Monstermunch,ravencrest,576,shaman,elemental,12,6,6
Lavalava,blackmoore,576,shaman,elemental,12,6,6
Woof,culte-de-la-rive-noire,576,shaman,elemental,12,6,6
Nëllaqt,archimonde,576,shaman,elemental,12,6,6
Дзод,deathweaver,576,shaman,elemental,12,6,6
Dsgrc,tarren-mill,576,shaman,elemental,18,6,12
Regnever,draenor,576,shaman,elemental,18,6,12
Syndia,das-konsortium,575,shaman,elemental,12,6,6
Chøurøx,hyjal,575,shaman,elemental,13,6,7
Carusø,thrall,574,shaman,elemental,12,6,6
Isheartears,outland,543,shaman,elemental,11,6,5
Hanatopikeur,grim-batol,527,shaman,elemental,17,6,11
Turbokrapka,tarren-mill,522,shaman,elemental,17,8,9
Rungozvs,blackrock,480,shaman,elemental,6,5,1
Couldar,stormscale,480,shaman,elemental,6,5,1
Bunnz,kazzak,480,shaman,elemental,6,5,1
Autopanne,malganis,480,shaman,elemental,6,5,1
Смоуктли,howling-fjord,480,shaman,elemental,6,5,1
Élé,twisting-nether,480,shaman,elemental,6,5,1
Minimalist,stormscale,480,shaman,elemental,6,5,1
Baldcreep,blackrock,480,shaman,elemental,6,5,1
Lêmberger,eredar,480,shaman,elemental,6,5,1
Elegodx,ravencrest,480,shaman,elemental,6,5,1
Muscade,silvermoon,480,shaman,elemental,6,5,1
Lovelyshaman,silvermoon,480,shaman,elemental,7,5,2
Nekhros,sargeras,480,shaman,elemental,12,5,7
Хеллбат,howling-fjord,480,shaman,elemental,12,5,7
Crespó,alakir,480,shaman,elemental,12,5,7
Swapxy,outland,480,shaman,elemental,12,5,7
Loshohealva,stormscale,480,shaman,elemental,12,5,7
Matmodir,hyjal,480,shaman,elemental,12,5,7
Skullføck,argent-dawn,480,shaman,elemental,12,5,7
Noyá,argent-dawn,479,shaman,elemental,12,5,7
Aldonatello,blackrock,479,shaman,elemental,12,5,7
Эфирад,blackscar,479,shaman,elemental,12,5,7
Sinwithin,ravencrest,478,shaman,elemental,12,5,7
Novka,eredar,447,shaman,elemental,11,5,6
Disharmony,outland,426,shaman,elemental,13,6,7
Blùé,tarren-mill,399,shaman,elemental,5,5,0
Alëxx,hyjal,384,shaman,elemental,6,4,2
Klicken,tarren-mill,384,shaman,elemental,6,4,2
Ralokar,blackrock,384,shaman,elemental,6,4,2
Ruvxy,twisting-nether,384,shaman,elemental,6,4,2
Trustlemac,onyxia,384,shaman,elemental,6,4,2
Totempoo,the-maelstrom,384,shaman,elemental,6,4,2
Hobblefoot,stormscale,384,shaman,elemental,6,4,2
Bkdgoodz,aegwynn,384,shaman,elemental,6,4,2
Kévinn,draenor,384,shaman,elemental,6,4,2
Selonthyx,ravencrest,384,shaman,elemental,6,4,2
Parthon,ravencrest,384,shaman,elemental,6,4,2
Kraksham,ravencrest,384,shaman,elemental,6,4,2
Teslashock,outland,384,shaman,elemental,6,4,2
Mèåtbåll,ravencrest,384,shaman,elemental,6,4,2
Дашажмихекс,howling-fjord,384,shaman,elemental,6,4,2
Shamurky,kazzak,384,shaman,elemental,6,4,2
Kohnân,hyjal,384,shaman,elemental,6,4,2
Shaakez,kazzak,384,shaman,elemental,6,4,2
Thëtis,chogall,384,shaman,elemental,6,4,2
Sebubu,twisting-nether,384,shaman,elemental,6,4,2
Whizjy,sanguino,384,shaman,elemental,6,4,2
Føxï,pozzo-delleternità,384,shaman,elemental,6,4,2
Goitbate,azuremyst,384,shaman,elemental,12,4,8
Ххенеси,soulflayer,384,shaman,elemental,12,4,8
Zengã,kazzak,384,shaman,elemental,12,4,8
Eskìmo,malganis,384,shaman,elemental,12,4,8
Hí,bronzebeard,384,shaman,elemental,12,4,8
Вензеро,howling-fjord,384,shaman,elemental,12,4,8
Hotis,onyxia,384,shaman,elemental,12,4,8
Zokah,emeriss,383,shaman,elemental,6,4,2
Незнаком,booty-bay,379,shaman,elemental,12,4,8
Кирагаз,gordunni,319,shaman,elemental,5,4,1
Wacomtablet,kazzak,319,shaman,elemental,5,4,1
Vukroth,argent-dawn,288,shaman,elemental,6,3,3
Localicious,ragnaros,288,shaman,elemental,6,3,3
Spruehkot,aegwynn,288,shaman,elemental,6,3,3
Qenninka,drakthul,288,shaman,elemental,6,3,3
Torouk,rashgarroth,288,shaman,elemental,6,3,3
Gissary,drakthul,288,shaman,elemental,6,3,3
Joeyexe,outland,288,shaman,elemental,6,3,3
Volvíc,tichondrius,288,shaman,elemental,6,3,3
Dagra,twisting-nether,288,shaman,elemental,6,3,3
Symy,draenor,288,shaman,elemental,6,3,3
Kapïtão,aggra-português,288,shaman,elemental,6,3,3
Shamanmans,grim-batol,288,shaman,elemental,6,3,3
Solosüper,ravencrest,288,shaman,elemental,6,3,3
Amu,ravencrest,288,shaman,elemental,6,3,3
Ironbuttrfly,magtheridon,288,shaman,elemental,6,3,3
Hothand,thrall,288,shaman,elemental,6,3,3
Velkin,thrall,288,shaman,elemental,6,3,3
Houmpf,hyjal,288,shaman,elemental,6,3,3
Novoz,ysondre,288,shaman,elemental,6,3,3
Bhargonen,silvermoon,288,shaman,elemental,6,3,3
Lunarsloth,hyjal,288,shaman,elemental,6,3,3
Rottulos,stormrage,288,shaman,elemental,6,3,3
Simppe,stormreaver,288,shaman,elemental,6,3,3
Kelvok,silvermoon,288,shaman,elemental,6,3,3
Reignisover,silvermoon,288,shaman,elemental,6,3,3
Réläx,kazzak,288,shaman,elemental,6,3,3
Hethne,kazzak,288,shaman,elemental,6,3,3
Касикандрэра,soulflayer,288,shaman,elemental,6,3,3
Херургх,soulflayer,288,shaman,elemental,6,3,3
Davinshhe,kazzak,288,shaman,elemental,6,3,3
Херург,soulflayer,288,shaman,elemental,6,3,3
Firella,the-maelstrom,288,shaman,elemental,6,3,3
Родохрозид,blackscar,288,shaman,elemental,6,3,3
Реалайзер,blackscar,288,shaman,elemental,6,3,3
Дваллинн,gordunni,288,shaman,elemental,6,3,3
Kónjo,kazzak,288,shaman,elemental,6,3,3
Рокутаро,gordunni,288,shaman,elemental,6,3,3
Мистеркутёж,gordunni,288,shaman,elemental,6,3,3
Наладчик,gordunni,288,shaman,elemental,6,3,3
Сепич,gordunni,288,shaman,elemental,6,3,3
Ласара,eversong,288,shaman,elemental,6,3,3
Elvalya,archimonde,288,shaman,elemental,12,3,9
Gammeldunder,shattered-hand,288,shaman,elemental,12,3,9
Elevlach,drakthul,288,shaman,elemental,12,3,9
Itsnasty,blackmoore,287,shaman,elemental,6,3,3
Вещун,deathguard,284,shaman,elemental,12,3,9
Naturexz,silvermoon,234,shaman,elemental,8,4,4
Xereús,kazzak,192,shaman,elemental,4,3,1
Stíckíx,malganis,192,shaman,elemental,4,3,1
Fuzzbolt,silvermoon,192,shaman,elemental,6,2,4
Windfúhrèr,tarren-mill,192,shaman,elemental,6,2,4
Zackyboi,tarren-mill,192,shaman,elemental,6,2,4
Ratatakéas,archimonde,192,shaman,elemental,6,2,4
Nuvet,argent-dawn,192,shaman,elemental,6,2,4
Ahrim,argent-dawn,192,shaman,elemental,6,2,4
Smashz,stormscale,192,shaman,elemental,6,2,4
Thornyberrý,outland,192,shaman,elemental,6,2,4
Blancc,kazzak,192,shaman,elemental,6,2,4
Sgf,stormscale,192,shaman,elemental,6,2,4
Attm,twisting-nether,192,shaman,elemental,6,2,4
Веег,deathweaver,192,shaman,elemental,6,2,4
Huyø,stormscale,192,shaman,elemental,6,2,4
Präsi,die-aldor,192,shaman,elemental,6,2,4
Дагод,booty-bay,192,shaman,elemental,6,2,4
Максобман,howling-fjord,192,shaman,elemental,6,2,4
Nnekalol,twisting-nether,192,shaman,elemental,6,2,4
Zbysiu,ravencrest,192,shaman,elemental,6,2,4
Ishkadar,twisting-nether,192,shaman,elemental,6,2,4
Fâro,dun-modr,192,shaman,elemental,6,2,4
Шлолка,gordunni,192,shaman,elemental,6,2,4
Squixi,ravencrest,192,shaman,elemental,6,2,4
Dormido,sanguino,192,shaman,elemental,6,2,4
Nuekx,sanguino,192,shaman,elemental,6,2,4
Dräpàrn,sylvanas,192,shaman,elemental,6,2,4
Rakermän,dun-modr,192,shaman,elemental,6,2,4
Shockbestie,eredar,192,shaman,elemental,7,2,5
Alfang,turalyon,192,shaman,elemental,12,2,10
Thriveqt,nemesis,192,shaman,elemental,12,2,10
Sweetcåndy,stormscale,192,shaman,elemental,12,2,10
Виспепешам,gordunni,192,shaman,elemental,12,2,10
Ærö,outland,192,shaman,elemental,12,2,10
Lavaburstx,antonidas,138,shaman,elemental,10,3,7
Champïx,archimonde,96,shaman,elemental,3,2,1
Nopivøt,hyjal,96,shaman,elemental,7,2,5
Sayokô,grim-batol,96,shaman,elemental,6,1,5
Fatflop,sylvanas,96,shaman,elemental,6,1,5
Heheheyup,ravencrest,96,shaman,elemental,6,1,5
Shaminista,ravencrest,96,shaman,elemental,6,1,5
Сентес,soulflayer,96,shaman,elemental,6,1,5
Magicmekoz,draenor,96,shaman,elemental,6,1,5
Takkenuma,hyjal,96,shaman,elemental,6,1,5
Пэппивкашке,howling-fjord,96,shaman,elemental,6,1,5
Setac,stormscale,96,shaman,elemental,6,1,5
Альтегро,blackscar,96,shaman,elemental,6,1,5
Shamsteaks,ysera,96,shaman,elemental,6,1,5
Bonestompamc,blackmoore,96,shaman,elemental,6,1,5
Rawside,thrall,96,shaman,elemental,6,1,5
Ulfax,argent-dawn,96,shaman,elemental,12,1,11
Snusyy,ravencrest,31,shaman,elemental,2,1,1
Memourian,drakthul,16,shaman,elemental,7,1,6
Mûnch,kazzak,2369,shaman,enhancement,98,66,32
Avines,twisting-nether,2176,shaman,enhancement,102,52,50
Крааули,soulflayer,2151,shaman,enhancement,120,61,59
Shïnnkøk,stormscale,2130,shaman,enhancement,72,43,29
Shadi,stormscale,2119,shaman,enhancement,84,44,40
Strippzz,stormscale,2116,shaman,enhancement,78,46,32
Дудивтф,soulflayer,2104,shaman,enhancement,81,46,35
Sparkyxd,twisting-nether,2102,shaman,enhancement,78,40,38
Sillaas,ysondre,2067,shaman,enhancement,96,45,51
Yüri,stormscale,2048,shaman,enhancement,89,46,43
Читорра,gordunni,2042,shaman,enhancement,54,33,21
Ruffepuffe,twisting-nether,2029,shaman,enhancement,90,53,37
Myguns,silvermoon,2018,shaman,enhancement,48,33,15
Gottiy,blackhand,2010,shaman,enhancement,90,48,42
Smorcshamyy,kazzak,2000,shaman,enhancement,42,26,16
Panzarkamp,stormscale,1981,shaman,enhancement,83,55,28
Fckumen,blackmoore,1970,shaman,enhancement,64,39,25
Maelstrom,eredar,1968,shaman,enhancement,90,57,33
Shïnnøk,stormscale,1961,shaman,enhancement,114,59,55
Bredare,ravencrest,1919,shaman,enhancement,42,37,5
Вацунвец,goldrinn,1913,shaman,enhancement,80,46,34
Viablous,ravencrest,1888,shaman,enhancement,84,61,23
Xa,blackrock,1882,shaman,enhancement,30,20,10
Karpsham,stormscale,1868,shaman,enhancement,55,26,29
Mustakrakish,terokkar,1855,shaman,enhancement,36,24,12
Turbostruck,ravencrest,1854,shaman,enhancement,60,25,35
Hexmex,stormreaver,1853,shaman,enhancement,42,21,21
Enhshamanop,draenor,1851,shaman,enhancement,90,44,46
Сахарокь,soulflayer,1840,shaman,enhancement,42,27,15
Друггрумилей,soulflayer,1828,shaman,enhancement,42,24,18
Uhøfligeulf,draenor,1824,shaman,enhancement,42,23,19
Chakafuyo,dun-modr,1822,shaman,enhancement,42,25,17
Пэппивкашке,howling-fjord,1818,shaman,enhancement,38,23,15
Argotan,drakthul,1817,shaman,enhancement,71,43,28
Mckoy,kazzak,1816,shaman,enhancement,40,27,13
Naochí,silvermoon,1813,shaman,enhancement,29,20,9
Bikdig,dun-modr,1812,shaman,enhancement,78,47,31
Hermerejildo,stormscale,1809,shaman,enhancement,48,25,23
Xôàrqt,eredar,1806,shaman,enhancement,132,74,58
Реактиватор,soulflayer,1803,shaman,enhancement,47,27,20
Nopre,blackrock,1802,shaman,enhancement,45,25,20
Actionhank,area-52,1802,shaman,enhancement,45,25,20
Talrall,twisting-nether,1789,shaman,enhancement,60,31,29
Totemofgreed,rexxar,1786,shaman,enhancement,72,32,40
Alterem,kazzak,1778,shaman,enhancement,66,34,32
Pýthøn,silvermoon,1772,shaman,enhancement,54,27,27
Ázøk,stormscale,1746,shaman,enhancement,82,41,41
Vayshibro,turalyon,1740,shaman,enhancement,48,26,22
Zetorgg,burning-legion,1738,shaman,enhancement,53,25,28
Wacomtablet,kazzak,1736,shaman,enhancement,36,19,17
Radåhn,outland,1729,shaman,enhancement,48,28,20
Халльбьерн,howling-fjord,1726,shaman,enhancement,60,36,24
Axdn,ravencrest,1722,shaman,enhancement,36,18,18
Snëakyboom,stormscale,1717,shaman,enhancement,96,46,50
Тралси,howling-fjord,1715,shaman,enhancement,24,18,6
Mèátßãllgøðx,kazzak,1714,shaman,enhancement,48,21,27
Nînadobrevx,stormscale,1709,shaman,enhancement,93,59,34
Plsdontpress,stormscale,1703,shaman,enhancement,36,22,14
Wóllff,archimonde,1703,shaman,enhancement,36,18,18
Bluetide,ravencrest,1699,shaman,enhancement,45,32,13
Тандерстарк,howling-fjord,1699,shaman,enhancement,30,21,9
Morguk,zuljin,1691,shaman,enhancement,45,24,21
Basz,aegwynn,1690,shaman,enhancement,31,18,13
Frankone,outland,1683,shaman,enhancement,30,22,8
Horelio,sanguino,1683,shaman,enhancement,45,26,19
Sangoma,frostmane,1683,shaman,enhancement,83,35,48
Gelthan,zuljin,1680,shaman,enhancement,36,22,14
Wheygodx,ravencrest,1679,shaman,enhancement,63,34,29
Moini,eredar,1674,shaman,enhancement,42,21,21
Greythunda,archimonde,1672,shaman,enhancement,36,23,13
Veloudinos,twisting-nether,1662,shaman,enhancement,72,49,23
Casualhex,argent-dawn,1656,shaman,enhancement,60,35,25
Царьбер,soulflayer,1652,shaman,enhancement,69,38,31
Lurkmon,twisting-nether,1650,shaman,enhancement,35,24,11
Láynert,dun-modr,1648,shaman,enhancement,107,52,55
Энха,howling-fjord,1641,shaman,enhancement,36,21,15
Joanna,frostwolf,1632,shaman,enhancement,42,19,23
Naïda,conseil-des-ombres,1631,shaman,enhancement,29,18,11
Ниу,thermaplugg,1629,shaman,enhancement,30,17,13
Dennismanone,tarren-mill,1628,shaman,enhancement,42,20,22
Kammek,tarren-mill,1624,shaman,enhancement,63,41,22
Chamkalix,sanguino,1623,shaman,enhancement,72,37,35
Úpli,blackmoore,1621,shaman,enhancement,30,18,12
Echoingshock,argent-dawn,1619,shaman,enhancement,36,22,14
Madmadbro,tarren-mill,1616,shaman,enhancement,36,24,12
Stormbreáker,twisting-nether,1615,shaman,enhancement,81,54,27
Bumbummann,blackmoore,1608,shaman,enhancement,66,34,32
Obrijames,tarren-mill,1606,shaman,enhancement,36,22,14
Grrud,draenor,1604,shaman,enhancement,42,23,19
Enigmar,stormscale,1604,shaman,enhancement,73,38,35
Shambamm,stormscale,1603,shaman,enhancement,42,24,18
Etox,darksorrow,1602,shaman,enhancement,36,19,17
Moaxtyr,blackmoore,1601,shaman,enhancement,42,29,13
Reparagos,sanguino,1599,shaman,enhancement,36,21,15
Sndheal,kazzak,1596,shaman,enhancement,24,19,5
Jabaraklol,stormscale,1595,shaman,enhancement,64,42,22
Spetsnazz,archimonde,1591,shaman,enhancement,48,20,28
Ореганно,howling-fjord,1589,shaman,enhancement,36,21,15
Lersham,the-maelstrom,1588,shaman,enhancement,30,18,12
Typhoön,sanguino,1581,shaman,enhancement,97,49,48
Цс,azuregos,1578,shaman,enhancement,92,51,41
Raveell,defias-brotherhood,1575,shaman,enhancement,40,19,21
Chendra,scarshield-legion,1570,shaman,enhancement,77,37,40
Чухансмент,gordunni,1565,shaman,enhancement,30,19,11
Xestil,blackmoore,1564,shaman,enhancement,29,17,12
Tartakos,ravencrest,1564,shaman,enhancement,37,21,16
Автозакзак,soulflayer,1563,shaman,enhancement,35,17,18
Tobanga,malganis,1559,shaman,enhancement,30,18,12
Kosface,tarren-mill,1557,shaman,enhancement,71,38,33
Toteemikylpy,argent-dawn,1540,shaman,enhancement,24,17,7
Ozilie,khaz-modan,1534,shaman,enhancement,30,18,12
Milheroj,tarren-mill,1533,shaman,enhancement,27,17,10
Deaslow,hyjal,1531,shaman,enhancement,35,17,18
Shamanyxx,tarren-mill,1530,shaman,enhancement,30,16,14
Defiaz,stormscale,1527,shaman,enhancement,34,25,9
Heeze,doomhammer,1525,shaman,enhancement,48,29,19
Ryhèn,stormscale,1523,shaman,enhancement,57,32,25
Imadaonly,drakthul,1517,shaman,enhancement,54,24,30
Дрегтан,howling-fjord,1513,shaman,enhancement,42,20,22
Voodooms,laughing-skull,1507,shaman,enhancement,29,20,9
Oronakgladx,ravencrest,1507,shaman,enhancement,54,28,26
Кинговели,soulflayer,1505,shaman,enhancement,36,17,19
Барракудах,gordunni,1503,shaman,enhancement,36,16,20
Rabalalaha,twisting-nether,1494,shaman,enhancement,62,30,32
Gerethor,burning-legion,1493,shaman,enhancement,39,18,21
Smozze,grim-batol,1486,shaman,enhancement,48,22,26
Xxloon,blackrock,1477,shaman,enhancement,54,33,21
Mcbloob,kazzak,1469,shaman,enhancement,81,39,42
Mírídíuss,silvermoon,1464,shaman,enhancement,23,16,7
Shockxy,norgannon,1464,shaman,enhancement,34,16,18
Vascodagama,twisting-nether,1460,shaman,enhancement,36,21,15
Ludwigson,tarren-mill,1442,shaman,enhancement,30,17,13
Дефибо,howling-fjord,1439,shaman,enhancement,54,26,28
Dshaman,aegwynn,1438,shaman,enhancement,18,15,3
Shocktopussi,stormscale,1435,shaman,enhancement,33,18,15
Shamãn,draenor,1433,shaman,enhancement,36,16,20
Arhitopg,silvermoon,1430,shaman,enhancement,36,15,21
Шокмужик,gordunni,1428,shaman,enhancement,30,15,15
Порнёреф,howling-fjord,1424,shaman,enhancement,48,31,17
Painshock,outland,1422,shaman,enhancement,24,15,9
Chimp,lightnings-blade,1415,shaman,enhancement,30,17,13
Эбгерсон,soulflayer,1415,shaman,enhancement,60,29,31
Элетеми,soulflayer,1410,shaman,enhancement,24,15,9
Ubies,silvermoon,1410,shaman,enhancement,24,15,9
Arkaos,exodar,1403,shaman,enhancement,31,17,14
Cahuna,stormscale,1402,shaman,enhancement,57,22,35
Yurkën,uldum,1397,shaman,enhancement,54,25,29
Dcanne,outland,1393,shaman,enhancement,39,21,18
Hayvaan,blackrock,1387,shaman,enhancement,58,34,24
Juliaroberts,ragnaros,1386,shaman,enhancement,42,24,18
Patsham,wildhammer,1372,shaman,enhancement,30,16,14
Notoxus,antonidas,1364,shaman,enhancement,78,39,39
Chämalö,archimonde,1351,shaman,enhancement,84,45,39
Ørgus,aegwynn,1345,shaman,enhancement,137,79,58
Faydé,stormscale,1343,shaman,enhancement,30,14,16
Jäy,twisting-nether,1342,shaman,enhancement,24,14,10
Lassolasse,sylvanas,1341,shaman,enhancement,18,14,4
Шторсонг,gordunni,1337,shaman,enhancement,45,30,15
Kanaky,hyjal,1333,shaman,enhancement,24,14,10
Zuvx,ravencrest,1332,shaman,enhancement,42,23,19
Jondil,das-syndikat,1324,shaman,enhancement,30,14,16
Ошиндра,gordunni,1320,shaman,enhancement,28,15,13
Kenseienh,kazzak,1317,shaman,enhancement,83,39,44
Shambolicc,ravencrest,1310,shaman,enhancement,29,14,15
Wedís,outland,1299,shaman,enhancement,42,22,20
Katastrofuss,stormscale,1283,shaman,enhancement,29,19,10
Виндфуриа,gordunni,1280,shaman,enhancement,36,20,16
Лэнгипас,gordunni,1279,shaman,enhancement,47,26,21
Manrod,tarren-mill,1271,shaman,enhancement,48,25,23
Shaayys,archimonde,1270,shaman,enhancement,42,14,28
Sunetee,kazzak,1264,shaman,enhancement,30,14,16
Fatpig,stormscale,1248,shaman,enhancement,24,13,11
Fözk,outland,1247,shaman,enhancement,18,13,5
Taktouka,archimonde,1247,shaman,enhancement,24,13,11
Ripstorm,sylvanas,1242,shaman,enhancement,30,13,17
Kijin,kirin-tor,1235,shaman,enhancement,24,13,11
Pvegame,tarren-mill,1233,shaman,enhancement,30,13,17
Convîcted,grim-batol,1230,shaman,enhancement,22,14,8
Zandali,tarren-mill,1229,shaman,enhancement,36,21,15
Lokresh,azjolnerub,1220,shaman,enhancement,24,13,11
Trîkill,hyjal,1217,shaman,enhancement,30,13,17
Dendyre,outland,1214,shaman,enhancement,29,13,16
Shamaray,stormscale,1208,shaman,enhancement,30,16,14
Шалман,thermaplugg,1178,shaman,enhancement,65,29,36
Khelyyn,tarren-mill,1176,shaman,enhancement,28,13,15
Тленозавр,gordunni,1173,shaman,enhancement,33,13,20
Плюжка,greymane,1159,shaman,enhancement,30,18,12
Enhahaha,tarren-mill,1152,shaman,enhancement,18,12,6
Взалходил,soulflayer,1151,shaman,enhancement,18,12,6
Boombastíc,ravencrest,1151,shaman,enhancement,24,12,12
Kulefesk,grim-batol,1151,shaman,enhancement,24,12,12
Daybidaybi,stormscale,1151,shaman,enhancement,28,13,15
Møldør,tarren-mill,1150,shaman,enhancement,18,12,6
Бренненд,howling-fjord,1150,shaman,enhancement,18,12,6
Dmgaddict,kazzak,1149,shaman,enhancement,24,12,12
Zulmalis,twisting-nether,1149,shaman,enhancement,24,12,12
Isucklasso,aegwynn,1148,shaman,enhancement,18,12,6
Barbebiendur,archimonde,1148,shaman,enhancement,24,12,12
Porphy,kazzak,1147,shaman,enhancement,18,12,6
Gøretterøg,ysondre,1147,shaman,enhancement,19,12,7
Krovn,aszune,1147,shaman,enhancement,24,12,12
Kargos,stormscale,1146,shaman,enhancement,24,12,12
Äijä,chromaggus,1144,shaman,enhancement,24,12,12
Экспатриот,greymane,1143,shaman,enhancement,18,12,6
Îzanami,ravencrest,1138,shaman,enhancement,24,12,12
Filigran,ragnaros,1132,shaman,enhancement,24,12,12
Arcura,twisting-nether,1127,shaman,enhancement,24,13,11
Precíous,sporeggar,1115,shaman,enhancement,34,19,15
Быковат,booty-bay,1101,shaman,enhancement,30,12,18
Китраст,soulflayer,1088,shaman,enhancement,22,12,10
Lumii,azshara,1088,shaman,enhancement,30,13,17
Kringspierce,twisting-nether,1086,shaman,enhancement,55,34,21
Proccq,twisting-nether,1056,shaman,enhancement,18,11,7
Бафамет,blackscar,1056,shaman,enhancement,18,11,7
Gúîtårgøð,sanguino,1056,shaman,enhancement,24,11,13
Pusspatrol,kazzak,1056,shaman,enhancement,24,11,13
Sozetwo,tarren-mill,1055,shaman,enhancement,12,11,1
Kutipaperi,stormscale,1053,shaman,enhancement,18,11,7
Paintball,kazzak,1053,shaman,enhancement,18,11,7
Elémenta,turalyon,1053,shaman,enhancement,18,11,7
Nexdown,archimonde,1053,shaman,enhancement,18,11,7
Hitmeagain,blackhand,1053,shaman,enhancement,24,11,13
Sangvinus,outland,1051,shaman,enhancement,18,11,7
Voodoohexman,kazzak,1050,shaman,enhancement,18,11,7
Biglynx,sanguino,1049,shaman,enhancement,66,36,30
Perunya,tarren-mill,1049,shaman,enhancement,24,11,13
Щцц,soulflayer,1047,shaman,enhancement,18,11,7
Shamrøck,archimonde,1042,shaman,enhancement,30,15,15
Sg,la-croisade-écarlate,1014,shaman,enhancement,24,11,13
Aquæ,suramar,997,shaman,enhancement,26,13,13
Beletili,chogall,997,shaman,enhancement,25,12,13
Thorâ,frostmane,987,shaman,enhancement,14,11,3
Worstshamy,sanguino,960,shaman,enhancement,12,10,2
Dumhuvud,stormscale,960,shaman,enhancement,12,10,2
Dumbasha,ravencrest,960,shaman,enhancement,18,10,8
Belroc,ravencrest,960,shaman,enhancement,18,10,8
Azifox,hyjal,960,shaman,enhancement,18,10,8
Mëditåtïøñ,blackrock,960,shaman,enhancement,24,10,14
Cripxo,sanguino,959,shaman,enhancement,12,10,2
Skyróxx,blackrock,959,shaman,enhancement,18,10,8
Thrâwl,kazzak,958,shaman,enhancement,12,10,2
Zarkab,ysondre,958,shaman,enhancement,16,11,5
Myngo,thrall,958,shaman,enhancement,18,10,8
Buuddha,drakthul,958,shaman,enhancement,18,10,8
Apexpredlol,blackmoore,958,shaman,enhancement,24,10,14
Плаглорд,howling-fjord,956,shaman,enhancement,18,10,8
Атл,deathguard,952,shaman,enhancement,12,10,2
Grimtøtem,defias-brotherhood,951,shaman,enhancement,18,10,8
Rushfabi,aegwynn,948,shaman,enhancement,24,10,14
Shamanigans,terrordar,945,shaman,enhancement,12,10,2
Mimsy,hyjal,941,shaman,enhancement,41,17,24
Чухмандос,gordunni,932,shaman,enhancement,23,11,12
Kushme,silvermoon,904,shaman,enhancement,30,10,20
Trobø,ravencrest,900,shaman,enhancement,21,10,11
Joeyexe,outland,896,shaman,enhancement,22,10,12
Nethershock,blackmoore,867,shaman,enhancement,36,18,18
Kilomanjaro,bloodfeather,864,shaman,enhancement,12,9,3
Blackyx,dun-modr,864,shaman,enhancement,12,9,3
Grende,sylvanas,864,shaman,enhancement,18,9,9
Маелштромс,soulflayer,864,shaman,enhancement,18,9,9
Politemanner,stormscale,864,shaman,enhancement,18,9,9
Пеклоь,soulflayer,864,shaman,enhancement,24,9,15
Tornis,terokkar,863,shaman,enhancement,12,9,3
Maddogxz,frostwolf,863,shaman,enhancement,12,9,3
Johncoltrane,archimonde,863,shaman,enhancement,12,9,3
Qauter,hellfire,863,shaman,enhancement,18,9,9
Turbopuddi,kazzak,863,shaman,enhancement,18,9,9
Shyne,vashj,863,shaman,enhancement,18,9,9
Enhx,ravencrest,863,shaman,enhancement,18,9,9
Thalir,aegwynn,863,shaman,enhancement,21,10,11
Legitbro,ravencrest,863,shaman,enhancement,24,9,15
Venomos,kazzak,863,shaman,enhancement,27,10,17
Моктрогтар,ashenvale,862,shaman,enhancement,12,9,3
Moodoo,antonidas,862,shaman,enhancement,24,9,15
Totemlover,draenor,859,shaman,enhancement,16,10,6
Бойкийкот,gordunni,852,shaman,enhancement,18,9,9
Stormrex,magtheridon,846,shaman,enhancement,18,9,9
Ryujìñjakka,culte-de-la-rive-noire,812,shaman,enhancement,18,9,9
Nubokesel,ragnaros,796,shaman,enhancement,20,9,11
Yunero,argent-dawn,784,shaman,enhancement,13,9,4
Tdogfx,blackhand,768,shaman,enhancement,12,8,4
Dhedge,draenor,768,shaman,enhancement,12,8,4
Altotem,blackmoore,768,shaman,enhancement,12,8,4
Lytningx,ravencrest,768,shaman,enhancement,12,8,4
Buffdraventy,archimonde,768,shaman,enhancement,12,8,4
Qätär,ravencrest,768,shaman,enhancement,12,8,4
Thunderdøme,stormscale,768,shaman,enhancement,12,8,4
Aswøg,kazzak,768,shaman,enhancement,12,8,4
Teknorave,dun-modr,768,shaman,enhancement,12,8,4
Trulylove,tarren-mill,768,shaman,enhancement,18,8,10
Paschol,aegwynn,768,shaman,enhancement,18,8,10
Слакербэдбой,gordunni,768,shaman,enhancement,18,8,10
Oldstorm,ravencrest,768,shaman,enhancement,18,8,10
Gnomecake,vashj,768,shaman,enhancement,18,8,10
Elèon,blackrock,768,shaman,enhancement,18,8,10
Shámi,gilneas,768,shaman,enhancement,18,8,10
Канамаш,borean-tundra,767,shaman,enhancement,12,8,4
Darhgan,argent-dawn,767,shaman,enhancement,12,8,4
Pontifhkas,ragnaros,767,shaman,enhancement,16,9,7
Ïï,archimonde,767,shaman,enhancement,18,8,10
Tschacô,malganis,767,shaman,enhancement,18,8,10
Toxicnux,nemesis,767,shaman,enhancement,18,8,10
Bolgrath,blackmoore,767,shaman,enhancement,18,8,10
Mcslammer,kazzak,767,shaman,enhancement,24,8,16
Carusø,thrall,764,shaman,enhancement,18,8,10
Hectoraïus,ysondre,763,shaman,enhancement,18,8,10
Prømetheüs,sanguino,759,shaman,enhancement,16,9,7
Fotmslave,laughing-skull,749,shaman,enhancement,15,10,5
Mendoz,nazjatar,748,shaman,enhancement,18,8,10
Arslos,twisting-nether,735,shaman,enhancement,14,9,5
Тотемныйчад,gordunni,731,shaman,enhancement,16,8,8
Trenhard,drakthul,731,shaman,enhancement,17,8,9
Kunancementa,ravencrest,718,shaman,enhancement,17,8,9
Khrin,blackmoore,672,shaman,enhancement,12,7,5
Enoughh,the-maelstrom,672,shaman,enhancement,12,7,5
Sígrun,aegwynn,672,shaman,enhancement,12,7,5
Ekinoz,outland,672,shaman,enhancement,12,7,5
Yacu,blackrock,672,shaman,enhancement,12,7,5
Laix,khaz-modan,672,shaman,enhancement,12,7,5
Metalbeef,xavius,672,shaman,enhancement,12,7,5
Koiru,argent-dawn,672,shaman,enhancement,12,7,5
Ùseless,archimonde,672,shaman,enhancement,12,7,5
Fotmburstwin,blackmoore,672,shaman,enhancement,12,7,5
Azzizael,argent-dawn,672,shaman,enhancement,12,7,5
Salvadr,zuljin,672,shaman,enhancement,14,7,7
Pumanii,silvermoon,672,shaman,enhancement,18,7,11
Zró,blackrock,672,shaman,enhancement,18,7,11
Matchstíck,draenor,672,shaman,enhancement,18,7,11
Иллюминэйшн,soulflayer,672,shaman,enhancement,18,7,11
Palmalecki,ravencrest,672,shaman,enhancement,18,7,11
Yombaï,archimonde,672,shaman,enhancement,18,7,11
Рэггдолл,soulflayer,672,shaman,enhancement,24,7,17
Shyrion,onyxia,672,shaman,enhancement,24,7,17
Asaakira,blackmoore,672,shaman,enhancement,24,7,17
Janserey,burning-legion,671,shaman,enhancement,12,7,5
Gurtok,drakthul,670,shaman,enhancement,12,7,5
Чёкнутое,soulflayer,668,shaman,enhancement,12,7,5
Viandehachee,dalaran,667,shaman,enhancement,12,7,5
Verlas,kazzak,607,shaman,enhancement,16,7,9
Noboorst,stormscale,576,shaman,enhancement,6,6,0
Phobiatics,thrall,576,shaman,enhancement,6,6,0
Axilary,tarren-mill,576,shaman,enhancement,6,6,0
Tzaish,blackmoore,576,shaman,enhancement,12,6,6
Taraesh,blackhand,576,shaman,enhancement,12,6,6
Crysis,sanguino,576,shaman,enhancement,12,6,6
Madboys,kazzak,576,shaman,enhancement,12,6,6
Tarantan,eredar,576,shaman,enhancement,12,6,6
Dami,die-aldor,576,shaman,enhancement,12,6,6
Elemefayoh,tarren-mill,576,shaman,enhancement,12,6,6
Ayame,burning-steppes,576,shaman,enhancement,12,6,6
Dwarfstil,blackmoore,576,shaman,enhancement,12,6,6
Shawck,ravencrest,576,shaman,enhancement,12,6,6
Neurax,sanguino,576,shaman,enhancement,12,6,6
Treyway,dun-modr,576,shaman,enhancement,12,6,6
Шампуньхан,blackscar,576,shaman,enhancement,12,6,6
Nìno,azshara,576,shaman,enhancement,12,6,6
Tharma,blackmoore,576,shaman,enhancement,12,6,6
Recaim,outland,576,shaman,enhancement,12,6,6
Chêlëx,silvermoon,576,shaman,enhancement,12,6,6
Finni,hyjal,575,shaman,enhancement,12,6,6
Furioous,ravencrest,575,shaman,enhancement,12,6,6
Мамонтшам,howling-fjord,575,shaman,enhancement,12,6,6
Другалёк,howling-fjord,573,shaman,enhancement,18,6,12
Дядяшаман,gordunni,573,shaman,enhancement,18,6,12
Krakennm,dalaran,571,shaman,enhancement,12,6,6
Хмелецкий,soulflayer,570,shaman,enhancement,12,6,6
Juniyaa,blackrock,543,shaman,enhancement,14,7,7
Izaarleus,argent-dawn,542,shaman,enhancement,11,6,5
Капарис,deathweaver,527,shaman,enhancement,15,6,9
Шаманутый,soulflayer,522,shaman,enhancement,14,7,7
Tescriamelio,ysondre,480,shaman,enhancement,6,5,1
Synergizer,kazzak,480,shaman,enhancement,6,5,1
Medoje,argent-dawn,480,shaman,enhancement,6,5,1
Ðevi,ravencrest,480,shaman,enhancement,6,5,1
Falseshepard,kazzak,480,shaman,enhancement,6,5,1
Ðexx,stormscale,480,shaman,enhancement,6,5,1
Senroxx,blackrock,480,shaman,enhancement,6,5,1
Earthquaker,the-maelstrom,480,shaman,enhancement,6,5,1
Ятебясмету,gordunni,480,shaman,enhancement,6,5,1
Øutfox,silvermoon,480,shaman,enhancement,6,5,1
Windsòng,stormscale,480,shaman,enhancement,6,5,1
Complete,hyjal,480,shaman,enhancement,6,5,1
Shamarach,sylvanas,480,shaman,enhancement,6,5,1
Martini,tichondrius,480,shaman,enhancement,9,6,3
Itswoland,tarren-mill,480,shaman,enhancement,10,6,4
Whizjy,sanguino,480,shaman,enhancement,12,5,7
Pank,kazzak,480,shaman,enhancement,12,5,7
Tyrox,kirin-tor,480,shaman,enhancement,12,5,7
Tonifo,nemesis,480,shaman,enhancement,12,5,7
Grosgourdin,la-croisade-écarlate,480,shaman,enhancement,12,5,7
Ogmehu,stormreaver,480,shaman,enhancement,12,5,7
Shamira,nethersturm,480,shaman,enhancement,12,5,7
Hexwife,archimonde,480,shaman,enhancement,12,5,7
Faltygo,drakthul,480,shaman,enhancement,12,5,7
Жуксик,greymane,480,shaman,enhancement,12,5,7
Kabard,silvermoon,480,shaman,enhancement,12,5,7
Bowtenstorm,ravencrest,480,shaman,enhancement,12,5,7
Volcanò,outland,480,shaman,enhancement,12,5,7
Schoølbøyq,blackrock,480,shaman,enhancement,12,5,7
Чаапалах,blackscar,480,shaman,enhancement,12,5,7
Халльбиорн,gordunni,480,shaman,enhancement,18,5,13
Bumm,twisting-nether,478,shaman,enhancement,18,5,13
Asstroy,sanguino,477,shaman,enhancement,6,5,1
Mõrax,ysondre,464,shaman,enhancement,13,6,7
Ananasanax,twisting-nether,435,shaman,enhancement,20,9,11
Даблпамп,howling-fjord,431,shaman,enhancement,17,5,12
Spicemélange,archimonde,384,shaman,enhancement,6,4,2
Dwarfofwar,ravencrest,384,shaman,enhancement,6,4,2
Zayliha,ravencrest,384,shaman,enhancement,6,4,2
Sinwithin,ravencrest,384,shaman,enhancement,6,4,2
Stromkek,eredar,384,shaman,enhancement,6,4,2
Shamrún,sylvanas,384,shaman,enhancement,6,4,2
Tijae,ravencrest,384,shaman,enhancement,6,4,2
Lovèless,stormscale,384,shaman,enhancement,6,4,2
Wertih,burning-legion,384,shaman,enhancement,6,4,2
Runè,azjolnerub,384,shaman,enhancement,6,4,2
Sêarix,aegwynn,384,shaman,enhancement,6,4,2
Шамунчез,gordunni,384,shaman,enhancement,6,4,2
Ipbar,blackrock,384,shaman,enhancement,6,4,2
Testosterone,dun-modr,384,shaman,enhancement,6,4,2
Shds,blackmoore,384,shaman,enhancement,6,4,2
Kolbászlelkü,ragnaros,384,shaman,enhancement,6,4,2
Isogrind,archimonde,384,shaman,enhancement,6,4,2
Gandy,the-maelstrom,384,shaman,enhancement,6,4,2
Richtigfies,kazzak,384,shaman,enhancement,6,4,2
Simularcum,kazzak,384,shaman,enhancement,6,4,2
Proper,tichondrius,384,shaman,enhancement,6,4,2
Ilkim,hyjal,384,shaman,enhancement,6,4,2
Rodneymullen,tarren-mill,384,shaman,enhancement,6,4,2
Xalta,eldrethalas,384,shaman,enhancement,6,4,2
Argarok,argent-dawn,384,shaman,enhancement,6,4,2
Россаврн,galakrond,384,shaman,enhancement,6,4,2
Jaykezap,kazzak,384,shaman,enhancement,6,4,2
Rakermän,dun-modr,384,shaman,enhancement,6,4,2
Олешао,howling-fjord,384,shaman,enhancement,6,4,2
Vulkân,silvermoon,384,shaman,enhancement,6,4,2
Atée,silvermoon,384,shaman,enhancement,6,4,2
Максобман,howling-fjord,384,shaman,enhancement,6,4,2
Xhahal,hyjal,384,shaman,enhancement,10,4,6
Javaburst,ragnaros,384,shaman,enhancement,12,4,8
Johnisplay,tarren-mill,384,shaman,enhancement,12,4,8
Бигмамуля,booty-bay,384,shaman,enhancement,12,4,8
Видсон,soulflayer,384,shaman,enhancement,12,4,8
Waterboi,blackmoore,384,shaman,enhancement,12,4,8
Рокмару,soulflayer,384,shaman,enhancement,12,4,8
Wishstêên,stormscale,384,shaman,enhancement,16,4,12
Domiro,ravencrest,384,shaman,enhancement,18,4,14
Derryo,silvermoon,384,shaman,enhancement,18,4,14
Vaesk,auchindoun,383,shaman,enhancement,6,4,2
Màverìck,nemesis,383,shaman,enhancement,6,4,2
Wolkano,zuljin,383,shaman,enhancement,10,5,5
Аеесо,gordunni,383,shaman,enhancement,12,4,8
Windfury,sylvanas,383,shaman,enhancement,12,4,8
Øzy,sanguino,382,shaman,enhancement,6,4,2
Asogg,archimonde,379,shaman,enhancement,12,4,8
Disciplé,blackmoore,367,shaman,enhancement,11,4,7
Kireekoura,tarren-mill,336,shaman,enhancement,9,4,5
Mazokuu,ragnaros,329,shaman,enhancement,16,6,10
Hurtigtotem,ravencrest,320,shaman,enhancement,10,4,6
Jeki,ysondre,320,shaman,enhancement,22,4,18
Nargrul,tarren-mill,319,shaman,enhancement,5,4,1
Мэлик,howling-fjord,288,shaman,enhancement,6,3,3
Bobonbu,forscherliga,288,shaman,enhancement,6,3,3
Eomsham,magtheridon,288,shaman,enhancement,6,3,3
Chrisbrownx,outland,288,shaman,enhancement,6,3,3
Xfiles,garona,288,shaman,enhancement,6,3,3
Джоннси,howling-fjord,288,shaman,enhancement,6,3,3
Киллдрак,howling-fjord,288,shaman,enhancement,6,3,3
Pelicius,sanguino,288,shaman,enhancement,6,3,3
Stormasaurus,anachronos,288,shaman,enhancement,6,3,3
Lilkazamm,blackrock,288,shaman,enhancement,6,3,3
Tâktoukâ,archimonde,288,shaman,enhancement,6,3,3
Likê,aegwynn,288,shaman,enhancement,6,3,3
Fanatroka,ravencrest,288,shaman,enhancement,6,3,3
Nëÿrën,drakthul,288,shaman,enhancement,6,3,3
Kemurus,kazzak,288,shaman,enhancement,6,3,3
Рыганский,blackscar,288,shaman,enhancement,6,3,3
Chehkhan,archimonde,288,shaman,enhancement,6,3,3
Funkins,hyjal,288,shaman,enhancement,6,3,3
Rejrax,ravencrest,288,shaman,enhancement,6,3,3
Волкк,soulflayer,288,shaman,enhancement,6,3,3
Hansdieter,antonidas,288,shaman,enhancement,6,3,3
Dénekha,zuljin,288,shaman,enhancement,6,3,3
Kezron,aegwynn,288,shaman,enhancement,6,3,3
Lavashnikov,burning-legion,288,shaman,enhancement,6,3,3
Xesti,twisting-nether,288,shaman,enhancement,6,3,3
Loshohealva,stormscale,288,shaman,enhancement,6,3,3
Айбьорн,gordunni,288,shaman,enhancement,6,3,3
Tahsus,blackmoore,288,shaman,enhancement,6,3,3
Wakoteh,quelthalas,288,shaman,enhancement,6,3,3
Stensham,stormreaver,288,shaman,enhancement,6,3,3
Zokah,emeriss,288,shaman,enhancement,6,3,3
Uomae,dun-modr,288,shaman,enhancement,6,3,3
Ccedtodeath,sylvanas,288,shaman,enhancement,6,3,3
Rhakhatheckh,nemesis,288,shaman,enhancement,12,3,9
Æskalatiøn,aegwynn,288,shaman,enhancement,12,3,9
Maybeyes,twisting-nether,288,shaman,enhancement,12,3,9
Dastarus,archimonde,288,shaman,enhancement,12,3,9
Hurbi,twisting-nether,288,shaman,enhancement,12,3,9
Lorthargol,chamber-of-aspects,288,shaman,enhancement,12,3,9
Krishun,blackmoore,288,shaman,enhancement,12,3,9
Trotzig,aegwynn,287,shaman,enhancement,6,3,3
Chronochrome,chamber-of-aspects,287,shaman,enhancement,6,3,3
Korzo,amanthul,287,shaman,enhancement,6,3,3
Murog,dalaran,287,shaman,enhancement,6,3,3
Biphrost,nemesis,287,shaman,enhancement,6,3,3
Nothìnto,pozzo-delleternità,287,shaman,enhancement,6,3,3
Sardemar,defias-brotherhood,286,shaman,enhancement,6,3,3
Laghärta,dun-modr,286,shaman,enhancement,6,3,3
Jehae,archimonde,239,shaman,enhancement,5,3,2
Mooshock,balnazzar,223,shaman,enhancement,8,3,5
Nefasti,stormscale,223,shaman,enhancement,8,3,5
Urshak,alleria,192,shaman,enhancement,6,2,4
Shock,magtheridon,192,shaman,enhancement,6,2,4
Kelvok,silvermoon,192,shaman,enhancement,6,2,4
Sgf,stormscale,192,shaman,enhancement,6,2,4
Bonethugdex,bladefist,192,shaman,enhancement,6,2,4
Acces,stormscale,192,shaman,enhancement,6,2,4
Родохрозид,blackscar,192,shaman,enhancement,6,2,4
Реалайзер,blackscar,192,shaman,enhancement,6,2,4
Monamour,twisting-nether,192,shaman,enhancement,6,2,4
Blixtnedslag,shattered-hand,192,shaman,enhancement,6,2,4
Volvíc,tichondrius,192,shaman,enhancement,6,2,4
Zmech,chamber-of-aspects,192,shaman,enhancement,6,2,4
Turbinká,burning-legion,192,shaman,enhancement,6,2,4
Shambamty,thrall,192,shaman,enhancement,6,2,4
Savan,darkspear,192,shaman,enhancement,6,2,4
Destroilleur,archimonde,192,shaman,enhancement,6,2,4
Snapbábe,blackmoore,192,shaman,enhancement,6,2,4
Carlos,magtheridon,192,shaman,enhancement,6,2,4
Haasshaman,ravencrest,192,shaman,enhancement,6,2,4
Shrektar,outland,192,shaman,enhancement,6,2,4
Bladeyx,ragnaros,192,shaman,enhancement,6,2,4
Pulvêrizêr,agamaggan,192,shaman,enhancement,6,2,4
Elementhor,archimonde,192,shaman,enhancement,6,2,4
Тенав,blackscar,192,shaman,enhancement,6,2,4
Xharnel,defias-brotherhood,192,shaman,enhancement,6,2,4
Bábbajaggí,blackrock,192,shaman,enhancement,6,2,4
Dalgorr,magtheridon,192,shaman,enhancement,6,2,4
Duhdelido,ravencrest,192,shaman,enhancement,6,2,4
Lovros,kazzak,192,shaman,enhancement,6,2,4
Aubesombre,dalaran,192,shaman,enhancement,6,2,4
Blutschrei,tarren-mill,192,shaman,enhancement,12,2,10
Shaminista,ravencrest,191,shaman,enhancement,6,2,4
Rorenth,blackhand,159,shaman,enhancement,5,2,3
Blautorkel,amanthul,159,shaman,enhancement,5,2,3
Yaar,alleria,159,shaman,enhancement,5,2,3
Tookaageeroo,burning-legion,159,shaman,enhancement,8,3,5
Tianoele,drakthul,144,shaman,enhancement,3,3,0
Дромгрон,howling-fjord,96,shaman,enhancement,6,1,5
Satanloveme,stormscale,96,shaman,enhancement,6,1,5
Maskinett,stormscale,96,shaman,enhancement,6,1,5
Grabmytotemz,tarren-mill,96,shaman,enhancement,6,1,5
Saduria,antonidas,96,shaman,enhancement,6,1,5
Nuluadroguri,twisting-nether,96,shaman,enhancement,6,1,5
Vladraxes,draenor,96,shaman,enhancement,6,1,5
Avattar,twisting-nether,96,shaman,enhancement,6,1,5
Kynaz,sanguino,96,shaman,enhancement,6,1,5
Kappatotem,silvermoon,96,shaman,enhancement,6,1,5
Bambustic,kazzak,96,shaman,enhancement,6,1,5
Eneel,blackmoore,96,shaman,enhancement,6,1,5
Corvux,tarren-mill,96,shaman,enhancement,6,1,5
Тыпроиграл,gordunni,96,shaman,enhancement,6,1,5
Fòóxi,ravencrest,96,shaman,enhancement,6,1,5
Relampago,eredar,96,shaman,enhancement,6,1,5
Weaslêy,frostwolf,96,shaman,enhancement,6,1,5
Ghaargrim,tarren-mill,96,shaman,enhancement,6,1,5
Lavalew,lightbringer,96,shaman,enhancement,6,1,5
Sïlvek,sanguino,96,shaman,enhancement,6,1,5
Лорикок,grom,96,shaman,enhancement,12,1,11
Gälädhan,ysondre,95,shaman,enhancement,6,1,5
Madbud,stormscale,79,shaman,enhancement,5,1,4
Blitzviech,aegwynn,79,shaman,enhancement,5,1,4
Wenesday,ysondre,48,shaman,enhancement,3,1,2
Rký,outland,48,shaman,enhancement,3,1,2
Hanumanas,kazzak,31,shaman,enhancement,2,1,1
Dotjürgen,blackrock,2205,warlock,demonology,84,48,36
Rikkërt,draenor,2186,warlock,demonology,83,45,38
Tuskawl,stormreaver,2154,warlock,demonology,91,51,40
Firochektro,ravencrest,2141,warlock,demonology,69,42,27
Supergeîl,blackrock,2112,warlock,demonology,71,38,33
Амеаль,eversong,2086,warlock,demonology,96,53,43
Anthh,doomhammer,2076,warlock,demonology,66,36,30
Whøknøws,twisting-nether,2070,warlock,demonology,72,37,35
Shablagoo,twisting-nether,2008,warlock,demonology,72,41,31
Britneý,stormscale,2007,warlock,demonology,76,37,39
Конидэмико,blackscar,1954,warlock,demonology,83,38,45
Badapow,stormscale,1943,warlock,demonology,48,27,21
Kamorilock,blackhand,1912,warlock,demonology,36,20,16
Maintarget,blackrock,1905,warlock,demonology,64,32,32
Anúki,kazzak,1900,warlock,demonology,25,21,4
Juicybolt,chogall,1893,warlock,demonology,52,31,21
Stafar,kazzak,1875,warlock,demonology,60,33,27
Bluh,twisting-nether,1860,warlock,demonology,36,22,14
Dhärc,sanguino,1854,warlock,demonology,54,31,23
Höfmänn,grim-batol,1847,warlock,demonology,48,31,17
Динодотз,howling-fjord,1847,warlock,demonology,54,27,27
Syntaxzwo,blackmoore,1844,warlock,demonology,36,24,12
Nayolana,argent-dawn,1839,warlock,demonology,36,27,9
Ravendoor,grim-batol,1839,warlock,demonology,58,28,30
Höfmänn,kazzak,1829,warlock,demonology,33,22,11
Млечный,blackscar,1822,warlock,demonology,54,30,24
Cellfear,kazzak,1818,warlock,demonology,42,24,18
Stankaemayne,blackhand,1817,warlock,demonology,49,29,20
Bualock,tarren-mill,1815,warlock,demonology,36,22,14
Devilfluffy,blackhand,1815,warlock,demonology,59,35,24
Blackdog,argent-dawn,1814,warlock,demonology,48,23,25
Kimkold,twisting-nether,1811,warlock,demonology,48,29,19
Sad,lightnings-blade,1810,warlock,demonology,48,26,22
Lúcìfér,stormscale,1806,warlock,demonology,66,34,32
Nyotu,antonidas,1802,warlock,demonology,48,25,23
Онлидемон,gordunni,1788,warlock,demonology,40,23,17
Rumour,sunstrider,1786,warlock,demonology,42,21,21
Тьмазвёздная,gordunni,1783,warlock,demonology,39,23,16
Nemwl,draenor,1760,warlock,demonology,42,25,17
Catchlock,tarren-mill,1752,warlock,demonology,36,20,16
Нгага,howling-fjord,1740,warlock,demonology,161,88,73
Lïñglïñg,twisting-nether,1730,warlock,demonology,30,22,8
Годнодх,gordunni,1716,warlock,demonology,30,18,12
Onlylock,outland,1712,warlock,demonology,30,21,9
Кварий,howling-fjord,1711,warlock,demonology,75,33,42
Malificus,silvermoon,1708,warlock,demonology,96,54,42
Stalowwy,silvermoon,1708,warlock,demonology,42,23,19
Attritiona,stormscale,1703,warlock,demonology,42,22,20
Glavy,burning-legion,1699,warlock,demonology,66,36,30
Totephia,kazzak,1696,warlock,demonology,72,33,39
Tyrantlol,sylvanas,1686,warlock,demonology,36,23,13
Jinusek,burning-legion,1682,warlock,demonology,43,23,20
Адво,howling-fjord,1682,warlock,demonology,35,18,17
Dæhli,argent-dawn,1676,warlock,demonology,30,19,11
Djshyasiañ,perenolde,1668,warlock,demonology,124,65,59
Ambitions,hyjal,1661,warlock,demonology,34,21,13
Kemel,thrall,1655,warlock,demonology,30,21,9
Htaedfo,tarren-mill,1649,warlock,demonology,44,21,23
Utsus,tarren-mill,1645,warlock,demonology,36,23,13
Shugglock,draenor,1630,warlock,demonology,36,20,16
Indrâxx,hyjal,1626,warlock,demonology,18,17,1
Malowix,outland,1625,warlock,demonology,36,17,19
Dualla,aegwynn,1623,warlock,demonology,36,17,19
Дёмын,howling-fjord,1620,warlock,demonology,36,17,19
Itspoint,draenor,1618,warlock,demonology,53,29,24
Malzeva,ravencrest,1617,warlock,demonology,36,17,19
Neuth,draenor,1611,warlock,demonology,44,19,25
Tjockoloco,tarren-mill,1608,warlock,demonology,36,22,14
Havexis,tichondrius,1602,warlock,demonology,42,32,10
Despépêche,garona,1601,warlock,demonology,30,19,11
Vultzbolt,draenor,1601,warlock,demonology,30,19,11
Gemors,ravenholdt,1599,warlock,demonology,60,32,28
Alphalock,mannoroth,1595,warlock,demonology,33,18,15
Impaler,tarren-mill,1593,warlock,demonology,122,54,68
Импака,howling-fjord,1577,warlock,demonology,150,79,71
Darcîa,destromath,1574,warlock,demonology,48,27,21
Егосяхаос,soulflayer,1567,warlock,demonology,54,26,28
Roedin,tarren-mill,1566,warlock,demonology,84,32,52
Snackstickz,twisting-nether,1565,warlock,demonology,30,17,13
Eleriya,argent-dawn,1564,warlock,demonology,36,19,17
Rune,aegwynn,1558,warlock,demonology,40,22,18
Tudii,frostwolf,1553,warlock,demonology,53,32,21
Ayóó,doomhammer,1539,warlock,demonology,94,51,43
Potatowl,ravencrest,1535,warlock,demonology,30,16,14
Benne,stormscale,1534,warlock,demonology,24,16,8
Fsandtwo,ravencrest,1534,warlock,demonology,30,16,14
Sedryn,turalyon,1526,warlock,demonology,150,78,72
Fiveyearque,sylvanas,1523,warlock,demonology,24,16,8
Dotsyoudown,kelthuzad,1521,warlock,demonology,30,16,14
Silenozz,ragnaros,1520,warlock,demonology,46,25,21
Shakuroz,frostwolf,1517,warlock,demonology,27,17,10
Dasda,defias-brotherhood,1507,warlock,demonology,42,21,21
Grêenbull,eredar,1498,warlock,demonology,30,16,14
Demonjoker,blackhand,1494,warlock,demonology,27,17,10
Sineko,twisting-nether,1477,warlock,demonology,45,22,23
Lankycheese,kazzak,1439,warlock,demonology,24,15,9
Хаосболик,gordunni,1438,warlock,demonology,24,15,9
Smaúg,archimonde,1438,warlock,demonology,30,15,15
Crathar,kazzak,1436,warlock,demonology,24,15,9
Nerigo,senjin,1435,warlock,demonology,30,15,15
Épidémie,outland,1427,warlock,demonology,36,15,21
Corbiejr,tarren-mill,1425,warlock,demonology,58,23,35
Sevastus,argent-dawn,1391,warlock,demonology,48,25,23
Locktrainer,tarren-mill,1374,warlock,demonology,38,15,23
Proßlock,kazzak,1357,warlock,demonology,27,16,11
Wåfa,kazzak,1345,warlock,demonology,24,15,9
Hâres,anetheron,1331,warlock,demonology,28,15,13
Бельведерчи,blackscar,1327,warlock,demonology,18,14,4
Absúrd,turalyon,1326,warlock,demonology,97,55,42
Ädarä,cthun,1311,warlock,demonology,24,14,10
Rpez,archimonde,1285,warlock,demonology,73,34,39
Гулдарий,howling-fjord,1283,warlock,demonology,45,23,22
Jondi,blackmoore,1257,warlock,demonology,23,14,9
Инсип,blackscar,1256,warlock,demonology,42,18,24
Eroszakolock,ragnaros,1245,warlock,demonology,18,13,5
Zelieknight,ysondre,1245,warlock,demonology,24,13,11
Нэкрил,howling-fjord,1241,warlock,demonology,21,13,8
Olsel,draenor,1241,warlock,demonology,24,13,11
Tekron,blackhand,1237,warlock,demonology,18,13,5
Sïlïthuss,ravencrest,1237,warlock,demonology,24,13,11
Чутьчутьзлая,gordunni,1237,warlock,demonology,24,13,11
Dominvs,silvermoon,1234,warlock,demonology,25,14,11
Wítchær,blackhand,1221,warlock,demonology,18,13,5
Vorgoth,argent-dawn,1179,warlock,demonology,28,13,15
Zehirisalari,twisting-nether,1152,warlock,demonology,18,12,6
Scallington,shattered-hand,1152,warlock,demonology,18,12,6
Weso,grim-batol,1152,warlock,demonology,18,12,6
Bloodlock,onyxia,1152,warlock,demonology,24,12,12
Инфес,deathweaver,1151,warlock,demonology,18,12,6
Тёмабиль,gordunni,1150,warlock,demonology,18,12,6
Moffguldan,sanguino,1150,warlock,demonology,18,12,6
Стокыч,soulflayer,1149,warlock,demonology,30,12,18
Tonin,antonidas,1142,warlock,demonology,18,12,6
Bakýra,dun-modr,1132,warlock,demonology,18,12,6
Арон,soulflayer,1119,warlock,demonology,23,12,11
Razzguul,blackmoore,1112,warlock,demonology,22,12,10
Adafbhf,tichondrius,1101,warlock,demonology,23,12,11
Altffeer,blackmoore,1100,warlock,demonology,17,12,5
Glooness,burning-legion,1056,warlock,demonology,18,11,7
Tamatóax,tarren-mill,1055,warlock,demonology,12,11,1
Khavar,antonidas,1055,warlock,demonology,18,11,7
Algolagniac,stormscale,1054,warlock,demonology,18,11,7
Dàrksoul,thrall,1054,warlock,demonology,18,11,7
Gwl,archimonde,1054,warlock,demonology,18,11,7
Forthewin,stormreaver,1042,warlock,demonology,24,11,13
Outofcurses,earthen-ring,1038,warlock,demonology,23,11,12
Panic,stormrage,1016,warlock,demonology,17,11,6
Splicer,eredar,975,warlock,demonology,19,11,8
Krøl,nemesis,960,warlock,demonology,12,10,2
Jopasiski,draenor,960,warlock,demonology,24,10,14
Seriasa,blackmoore,959,warlock,demonology,24,10,14
Паникс,gordunni,958,warlock,demonology,18,10,8
Nerzhull,stormscale,958,warlock,demonology,18,10,8
Храбзар,gordunni,943,warlock,demonology,23,10,13
Ablas,bladefist,940,warlock,demonology,35,10,25
Fearmydear,alleria,926,warlock,demonology,17,10,7
Rngmåchinêx,ravencrest,896,warlock,demonology,16,10,6
Öbsury,hyjal,864,warlock,demonology,12,9,3
Yazurí,ravencrest,864,warlock,demonology,12,9,3
Osbaa,bladefist,864,warlock,demonology,12,9,3
Ooroothothz,frostwolf,864,warlock,demonology,12,9,3
Hellguards,silvermoon,864,warlock,demonology,12,9,3
Dabezdwl,outland,864,warlock,demonology,18,9,9
Dispeluapls,blackmoore,864,warlock,demonology,18,9,9
Fandirxd,draenor,864,warlock,demonology,18,9,9
Hellbboy,azjolnerub,863,warlock,demonology,12,9,3
Felburrn,twisting-nether,863,warlock,demonology,18,9,9
Stormytrumpy,twisting-nether,863,warlock,demonology,18,9,9
Nosoulnoprob,sylvanas,863,warlock,demonology,24,9,15
Ilarizium,ysondre,861,warlock,demonology,18,9,9
Lifesteal,auchindoun,858,warlock,demonology,18,9,9
Анрали,soulflayer,831,warlock,demonology,17,9,8
Бирел,soulflayer,799,warlock,demonology,16,9,7
Инфезиус,deathweaver,768,warlock,demonology,12,8,4
Фортэр,ashenvale,768,warlock,demonology,12,8,4
Staenkymayne,blackhand,768,warlock,demonology,12,8,4
Topmodelx,eredar,768,warlock,demonology,12,8,4
Ájszmen,ravencrest,768,warlock,demonology,12,8,4
Lonelock,blackrock,768,warlock,demonology,12,8,4
Jimboneutron,stormscale,768,warlock,demonology,12,8,4
Kolskegg,doomhammer,768,warlock,demonology,18,8,10
Koldarr,blackmoore,768,warlock,demonology,18,8,10
Djezzick,stormscale,768,warlock,demonology,18,8,10
Idkdot,ravencrest,768,warlock,demonology,18,8,10
Merzavka,kazzak,765,warlock,demonology,12,8,4
Njutbar,ragnaros,765,warlock,demonology,18,8,10
Ясяшотлав,soulflayer,761,warlock,demonology,22,11,11
Wanderingowl,blackmoore,760,warlock,demonology,12,8,4
Простоседой,gordunni,703,warlock,demonology,17,8,9
Louên,dun-modr,672,warlock,demonology,12,7,5
Ballerlock,ravencrest,672,warlock,demonology,12,7,5
Гвоздяшка,blackscar,672,warlock,demonology,12,7,5
Fedpikkefar,kazzak,672,warlock,demonology,12,7,5
Dalamon,draenor,672,warlock,demonology,12,7,5
Greeylock,blackhand,672,warlock,demonology,12,7,5
Dirtytyrant,sanguino,672,warlock,demonology,12,7,5
Zouglougou,archimonde,672,warlock,demonology,12,7,5
Bigbagelbob,archimonde,672,warlock,demonology,12,7,5
Ravenglass,argent-dawn,672,warlock,demonology,12,7,5
Fearfearfear,archimonde,672,warlock,demonology,12,7,5
Dâedra,argent-dawn,672,warlock,demonology,18,7,11
Bewbys,draenor,671,warlock,demonology,24,7,17
Расмурът,soulflayer,670,warlock,demonology,18,7,11
Esgül,draenor,655,warlock,demonology,17,7,10
Nimh,azjolnerub,623,warlock,demonology,15,7,8
Котрх,gordunni,576,warlock,demonology,6,6,0
Kennÿfõx,ysondre,576,warlock,demonology,6,6,0
Smâûhg,blackrock,576,warlock,demonology,6,6,0
Rikkért,draenor,576,warlock,demonology,6,6,0
Pogbõss,kazzak,576,warlock,demonology,10,7,3
Biest,drakthul,576,warlock,demonology,12,6,6
Cringetamer,silvermoon,576,warlock,demonology,12,6,6
Vîmø,antonidas,576,warlock,demonology,12,6,6
Xenastro,silvermoon,576,warlock,demonology,12,6,6
Аоепампгодх,howling-fjord,576,warlock,demonology,12,6,6
Шэдоубёрн,soulflayer,576,warlock,demonology,12,6,6
Джердхаус,fordragon,576,warlock,demonology,12,6,6
Rikmeyzter,burning-blade,576,warlock,demonology,12,6,6
Wacamolymojo,tarren-mill,576,warlock,demonology,12,6,6
Nephystø,archimonde,576,warlock,demonology,12,6,6
Сладкийпир,soulflayer,576,warlock,demonology,12,6,6
Synthiax,silvermoon,576,warlock,demonology,12,6,6
Bibiflexberg,eredar,576,warlock,demonology,12,6,6
Емс,gordunni,576,warlock,demonology,12,6,6
Cørpse,burning-legion,576,warlock,demonology,12,6,6
Демоник,deathguard,576,warlock,demonology,12,6,6
Hamnam,blackrock,576,warlock,demonology,12,6,6
Dabulock,blackmoore,576,warlock,demonology,12,6,6
Oldasianman,blackrock,576,warlock,demonology,18,6,12
Morgan,jaedenar,576,warlock,demonology,18,6,12
Deadleth,blackrock,575,warlock,demonology,10,7,3
Profylaxis,arathor,575,warlock,demonology,12,6,6
Xerxia,blackrock,575,warlock,demonology,18,6,12
Mesîkatayut,outland,573,warlock,demonology,15,6,9
Absurdd,turalyon,568,warlock,demonology,14,9,5
Ghoulishdani,stormscale,559,warlock,demonology,17,6,11
Bibilockbert,aegwynn,480,warlock,demonology,6,5,1
Ahollic,frostwolf,480,warlock,demonology,6,5,1
Sanguinis,theradras,480,warlock,demonology,6,5,1
Rektube,sanguino,480,warlock,demonology,6,5,1
Syntax,blackmoore,480,warlock,demonology,6,5,1
Gulldan,bloodfeather,480,warlock,demonology,6,5,1
Фирвебало,soulflayer,480,warlock,demonology,6,5,1
Zeddy,draenor,480,warlock,demonology,6,5,1
Dontargetme,draenor,480,warlock,demonology,6,5,1
Døwz,ysondre,480,warlock,demonology,12,5,7
Alotami,frostwolf,480,warlock,demonology,12,5,7
Khâmélÿa,culte-de-la-rive-noire,480,warlock,demonology,12,5,7
Törtidotcom,blackrock,480,warlock,demonology,12,5,7
Kukcaryfuk,drakthul,480,warlock,demonology,12,5,7
Cigänä,archimonde,480,warlock,demonology,12,5,7
Erøne,archimonde,480,warlock,demonology,12,5,7
Søcraqt,blackrock,480,warlock,demonology,13,5,8
Brodoh,dun-modr,480,warlock,demonology,18,5,13
Ezekîél,blackhand,479,warlock,demonology,6,5,1
Jag,neptulon,479,warlock,demonology,6,5,1
Cmzdalock,ravencrest,479,warlock,demonology,6,5,1
Stormblast,azshara,479,warlock,demonology,14,7,7
Shuggul,draenor,400,warlock,demonology,7,5,2
Dedalus,zuluhed,399,warlock,demonology,7,5,2
Devildodo,elune,384,warlock,demonology,6,4,2
Demosteaks,thrall,384,warlock,demonology,6,4,2
Azraëlle,drekthar,384,warlock,demonology,6,4,2
Adellara,draenor,384,warlock,demonology,6,4,2
Æternallock,nemesis,384,warlock,demonology,6,4,2
Benvyx,twisting-nether,384,warlock,demonology,6,4,2
Zzooxx,silvermoon,384,warlock,demonology,6,4,2
Plâytïmè,stormscale,384,warlock,demonology,6,4,2
Otemlock,sanguino,384,warlock,demonology,6,4,2
Enviroq,burning-legion,384,warlock,demonology,6,4,2
Zoreck,uldum,384,warlock,demonology,6,4,2
Erkai,kazzak,384,warlock,demonology,6,4,2
Dotwhat,ravencrest,384,warlock,demonology,6,4,2
Endherkonk,sanguino,384,warlock,demonology,6,4,2
Nattû,outland,384,warlock,demonology,6,4,2
Kfo,ragnaros,384,warlock,demonology,6,4,2
Lamboo,tarren-mill,384,warlock,demonology,6,4,2
Shazem,tarren-mill,384,warlock,demonology,6,4,2
Devour,magtheridon,384,warlock,demonology,6,4,2
Ahollic,antonidas,384,warlock,demonology,6,4,2
Chedipes,stormscale,384,warlock,demonology,6,4,2
Nekhar,twisting-nether,384,warlock,demonology,6,4,2
Marador,drakthul,384,warlock,demonology,6,4,2
Куськысь,gordunni,384,warlock,demonology,9,5,4
Xtyran,blackmoore,384,warlock,demonology,12,4,8
Darksoll,hyjal,384,warlock,demonology,12,4,8
Slockoló,ragnaros,384,warlock,demonology,12,4,8
Graveshaker,quelthalas,384,warlock,demonology,12,4,8
Musallat,argent-dawn,384,warlock,demonology,12,4,8
Zartax,kazzak,384,warlock,demonology,12,4,8
Ишла,gordunni,384,warlock,demonology,12,4,8
Migyardondup,exodar,382,warlock,demonology,6,4,2
Monroé,hellfire,367,warlock,demonology,11,4,7
Nili,dethecus,351,warlock,demonology,11,4,7
Floriae,argent-dawn,329,warlock,demonology,13,5,8
Darcol,archimonde,288,warlock,demonology,6,3,3
Infernion,stormscale,288,warlock,demonology,6,3,3
Mingingclass,stormscale,288,warlock,demonology,6,3,3
Xjms,darksorrow,288,warlock,demonology,6,3,3
Klaab,hyjal,288,warlock,demonology,6,3,3
Myliege,kilrogg,288,warlock,demonology,6,3,3
Wendetta,stormreaver,288,warlock,demonology,6,3,3
Lokmonji,perenolde,288,warlock,demonology,6,3,3
Afflimoomoo,tarren-mill,288,warlock,demonology,6,3,3
Zerx,malganis,288,warlock,demonology,6,3,3
Waîdo,blackhand,288,warlock,demonology,6,3,3
Horststenzl,blackrock,288,warlock,demonology,6,3,3
Локистраик,borean-tundra,288,warlock,demonology,6,3,3
Xiraq,nathrezim,288,warlock,demonology,6,3,3
Väladar,sanguino,288,warlock,demonology,6,3,3
Elmîr,blackmoore,288,warlock,demonology,6,3,3
Fearu,kazzak,288,warlock,demonology,6,3,3
Alcringe,kazzak,288,warlock,demonology,6,3,3
Bionic,eredar,288,warlock,demonology,6,3,3
Wombsa,blackmoore,288,warlock,demonology,6,3,3
Buserella,eredar,288,warlock,demonology,6,3,3
Suucc,draenor,288,warlock,demonology,6,3,3
Дотботх,howling-fjord,288,warlock,demonology,6,3,3
Purepkbob,quelthalas,288,warlock,demonology,6,3,3
Jetset,moonglade,288,warlock,demonology,6,3,3
Mombo,the-maelstrom,288,warlock,demonology,6,3,3
Bono,frostwhisper,288,warlock,demonology,6,3,3
Netcownt,silvermoon,288,warlock,demonology,9,4,5
Rushkush,ravencrest,288,warlock,demonology,7,3,4
Tunrîda,illidan,288,warlock,demonology,10,3,7
Dardec,hyjal,288,warlock,demonology,12,3,9
Themengh,stormscale,288,warlock,demonology,12,3,9
Ftpete,argent-dawn,288,warlock,demonology,12,3,9
Ydidntuwait,ragnaros,288,warlock,demonology,12,3,9
Kamí,sanguino,288,warlock,demonology,12,3,9
Hartee,argent-dawn,288,warlock,demonology,18,3,15
Ambralia,blackmoore,287,warlock,demonology,6,3,3
Calypso,korgall,239,warlock,demonology,5,3,2
Vreyax,aegwynn,239,warlock,demonology,5,3,2
Médeâ,ravencrest,192,warlock,demonology,6,2,4
Zyréx,eredar,192,warlock,demonology,6,2,4
Déadwish,ravencrest,192,warlock,demonology,6,2,4
Эссминет,soulflayer,192,warlock,demonology,6,2,4
Bowti,ravencrest,192,warlock,demonology,6,2,4
Baradür,sanguino,192,warlock,demonology,6,2,4
Epoku,stormscale,192,warlock,demonology,6,2,4
Repah,doomhammer,192,warlock,demonology,6,2,4
Bu,zirkel-des-cenarius,192,warlock,demonology,6,2,4
Nazw,ravencrest,192,warlock,demonology,6,2,4
Stromzii,silvermoon,192,warlock,demonology,6,2,4
Azurma,tarren-mill,192,warlock,demonology,6,2,4
Indifférence,archimonde,192,warlock,demonology,6,2,4
Nastychâtøn,ysondre,192,warlock,demonology,6,2,4
Sneptics,draenor,192,warlock,demonology,6,2,4
Xoky,argent-dawn,192,warlock,demonology,6,2,4
Chram,uldum,192,warlock,demonology,7,2,5
Letzterlude,thrall,159,warlock,demonology,5,2,3
Tid,burning-legion,96,warlock,demonology,6,1,5
Acererak,thunderhorn,96,warlock,demonology,6,1,5
Tuz,blackrock,96,warlock,demonology,6,1,5
Methmuncher,twisting-nether,96,warlock,demonology,6,1,5
Millhaus,gorgonnash,96,warlock,demonology,6,1,5
Bolt,stormscale,96,warlock,demonology,6,1,5
Dimmybyrger,stormreaver,96,warlock,demonology,6,1,5
Divvaa,tarren-mill,96,warlock,demonology,6,1,5
Árkan,thrall,96,warlock,demonology,6,1,5
Môrgán,draenor,96,warlock,demonology,6,1,5
Кайзершлафен,fordragon,31,warlock,demonology,2,1,1
Lokko,nemesis,31,warlock,demonology,2,1,1
Mundunugu,sanguino,16,warlock,demonology,1,1,0
Inferniøn,ravencrest,2339,warlock,destruction,69,52,17
Lopari,aegwynn,2276,warlock,destruction,83,53,30
Canabolic,stormscale,2269,warlock,destruction,90,55,35
Acentro,stormscale,2231,warlock,destruction,71,46,25
Боуман,howling-fjord,2206,warlock,destruction,90,52,38
Tópdogg,twisting-nether,2140,warlock,destruction,54,43,11
Фаерморн,blackscar,2135,warlock,destruction,36,30,6
Jâzggz,twisting-nether,2130,warlock,destruction,54,37,17
Císuh,stormreaver,2123,warlock,destruction,66,45,21
Héffer,outland,2119,warlock,destruction,92,68,24
Cryzzbad,stormscale,2109,warlock,destruction,36,29,7
Velv,nagrand,2109,warlock,destruction,72,38,34
Rootzlx,ravencrest,2103,warlock,destruction,85,49,36
Arfdispo,hyjal,2103,warlock,destruction,77,43,34
Erutaerc,drakthul,2096,warlock,destruction,42,29,13
Dabzw,twisting-nether,2075,warlock,destruction,67,43,24
Handicapped,burning-legion,2061,warlock,destruction,72,41,31
Drainsouls,stormscale,2047,warlock,destruction,141,78,63
Absurdity,twisting-nether,2046,warlock,destruction,54,31,23
Артик,gordunni,2032,warlock,destruction,36,30,6
Aestheatic,draenor,2026,warlock,destruction,113,65,48
Vitus,malganis,2022,warlock,destruction,72,46,26
Фримех,soulflayer,2021,warlock,destruction,47,37,10
Geluwu,tarren-mill,2015,warlock,destruction,60,35,25
Ánderxyo,dun-modr,2010,warlock,destruction,36,29,7
Кишмякхб,howling-fjord,2008,warlock,destruction,60,32,28
Snapperz,stormscale,2007,warlock,destruction,72,38,34
Asáel,blackrock,1993,warlock,destruction,48,31,17
Wldot,ravencrest,1986,warlock,destruction,48,31,17
Lywov,stormscale,1979,warlock,destruction,48,27,21
Кенгарь,howling-fjord,1976,warlock,destruction,66,39,27
Кириланскил,gordunni,1974,warlock,destruction,48,30,18
Shangalar,burning-legion,1972,warlock,destruction,54,35,19
Ffpiiras,dunemaul,1972,warlock,destruction,63,37,26
Necromanya,ravencrest,1970,warlock,destruction,60,39,21
Koisk,tarren-mill,1966,warlock,destruction,60,34,26
Телола,gordunni,1960,warlock,destruction,42,27,15
Рауваскх,howling-fjord,1955,warlock,destruction,41,21,20
Сумракк,gordunni,1954,warlock,destruction,66,35,31
Stefcheto,twilights-hammer,1950,warlock,destruction,60,34,26
Bäle,stormreaver,1948,warlock,destruction,48,28,20
Онлидемон,gordunni,1942,warlock,destruction,73,38,35
Ryûsuke,dun-modr,1941,warlock,destruction,36,24,12
Паилка,galakrond,1934,warlock,destruction,57,34,23
Chaosbuster,magtheridon,1932,warlock,destruction,60,40,20
Steckenpferd,blackmoore,1930,warlock,destruction,36,24,12
Anihli,kazzak,1924,warlock,destruction,54,33,21
Zélroth,argent-dawn,1921,warlock,destruction,54,35,19
Upsahl,twisting-nether,1916,warlock,destruction,81,48,33
Legionlockxd,twisting-nether,1910,warlock,destruction,64,33,31
Bóbtown,stormscale,1908,warlock,destruction,42,30,12
Zoodíac,blackrock,1904,warlock,destruction,48,32,16
Mxxmmllm,kargath,1896,warlock,destruction,95,59,36
Felcamino,outland,1889,warlock,destruction,54,29,25
Kwoleriker,norgannon,1885,warlock,destruction,58,33,25
Ønlyfans,blackhand,1881,warlock,destruction,42,29,13
Malgarøth,tarren-mill,1880,warlock,destruction,54,23,31
Henmur,stormscale,1879,warlock,destruction,64,37,27
Azurma,tarren-mill,1878,warlock,destruction,36,22,14
Hladankurac,twisting-nether,1877,warlock,destruction,36,22,14
Инферналках,gordunni,1873,warlock,destruction,47,32,15
Dæhli,argent-dawn,1871,warlock,destruction,54,31,23
Ðènnis,tarren-mill,1870,warlock,destruction,42,28,14
Isuckwarlock,aegwynn,1870,warlock,destruction,48,26,22
Xeremas,blackrock,1869,warlock,destruction,36,28,8
Gogmorok,dunemaul,1867,warlock,destruction,106,53,53
Аоепампгодх,howling-fjord,1866,warlock,destruction,68,51,17
Rohyna,archimonde,1865,warlock,destruction,36,27,9
Spookytouch,draenor,1865,warlock,destruction,58,34,24
Rúbs,sylvanas,1865,warlock,destruction,60,33,27
Fearo,kazzak,1864,warlock,destruction,54,32,22
Nëismz,hyjal,1863,warlock,destruction,36,24,12
Sheitana,ysondre,1863,warlock,destruction,60,39,21
Rokkarn,kazzak,1863,warlock,destruction,48,29,19
Homerbamboom,hyjal,1857,warlock,destruction,41,32,9
Vvj,ravencrest,1857,warlock,destruction,54,28,26
Sïeur,archimonde,1856,warlock,destruction,101,65,36
Demoner,tarren-mill,1854,warlock,destruction,132,81,51
Darksoll,hyjal,1853,warlock,destruction,41,31,10
Wankdiesel,der-rat-von-dalaran,1853,warlock,destruction,96,48,48
Шархихохо,gordunni,1852,warlock,destruction,54,30,24
Jawoxoxo,rexxar,1852,warlock,destruction,48,20,28
Zèlêph,archimonde,1851,warlock,destruction,78,52,26
Johnylock,draenor,1850,warlock,destruction,116,71,45
Рашчер,gordunni,1850,warlock,destruction,36,21,15
Кобре,howling-fjord,1847,warlock,destruction,42,26,16
Magonyth,ravencrest,1847,warlock,destruction,54,33,21
Ayperos,tyrande,1847,warlock,destruction,72,38,34
Шрэкс,blackscar,1846,warlock,destruction,42,22,20
Schrimz,blackrock,1844,warlock,destruction,48,24,24
Attilergg,stormscale,1839,warlock,destruction,32,23,9
Ñila,ravencrest,1839,warlock,destruction,36,23,13
Nayolana,argent-dawn,1839,warlock,destruction,75,35,40
Kimkold,twisting-nether,1836,warlock,destruction,66,30,36
Блакхен,blackscar,1835,warlock,destruction,42,23,19
Zàkx,silvermoon,1831,warlock,destruction,124,71,53
Vregor,twisting-nether,1830,warlock,destruction,30,23,7
Extingul,tarren-mill,1828,warlock,destruction,30,23,7
Smaúg,archimonde,1827,warlock,destruction,48,23,25
Djhanzó,outland,1823,warlock,destruction,33,21,12
Worse,kazzak,1823,warlock,destruction,48,29,19
Médeâ,ravencrest,1822,warlock,destruction,54,31,23
Ethiq,blackrock,1818,warlock,destruction,30,19,11
Srkzlol,durotan,1817,warlock,destruction,66,35,31
Eboyclass,twisting-nether,1816,warlock,destruction,24,19,5
Louloudots,ragnaros,1815,warlock,destruction,36,22,14
Voldby,kazzak,1815,warlock,destruction,36,19,17
Nemwl,draenor,1814,warlock,destruction,66,31,35
Kamoriwl,blackhand,1813,warlock,destruction,30,19,11
Yùna,frostwolf,1811,warlock,destruction,36,23,13
Gregwyn,hellscream,1809,warlock,destruction,24,19,5
Kumamoto,tarren-mill,1809,warlock,destruction,36,23,13
Rûttna,kazzak,1806,warlock,destruction,53,27,26
Yøshinø,wildhammer,1805,warlock,destruction,48,36,12
Amdead,sylvanas,1804,warlock,destruction,23,20,3
Laolife,twisting-nether,1803,warlock,destruction,60,30,30
Richerdgir,ravencrest,1802,warlock,destruction,39,25,14
Glooness,burning-legion,1802,warlock,destruction,42,22,20
Ulora,zirkel-des-cenarius,1801,warlock,destruction,47,28,19
Мспечень,howling-fjord,1800,warlock,destruction,36,28,8
Skrana,kazzak,1800,warlock,destruction,65,39,26
Lockchonk,kazzak,1792,warlock,destruction,36,28,8
Sargus,drakthul,1788,warlock,destruction,46,26,20
Кейкегенкай,gordunni,1787,warlock,destruction,57,33,24
Nekrosd,tarren-mill,1787,warlock,destruction,90,48,42
Якурюимнепох,gordunni,1786,warlock,destruction,35,24,11
Ërîkå,ravencrest,1785,warlock,destruction,99,59,40
Knoxwhite,stormscale,1781,warlock,destruction,36,25,11
Nògg,frostwhisper,1780,warlock,destruction,30,21,9
Kikeri,blackhand,1775,warlock,destruction,42,26,16
Ftpete,argent-dawn,1773,warlock,destruction,74,44,30
Maderto,burning-legion,1766,warlock,destruction,167,90,77
Dooms,antonidas,1761,warlock,destruction,36,26,10
Vmorghuliss,sanguino,1757,warlock,destruction,84,38,46
Chaoscrit,eredar,1756,warlock,destruction,44,26,18
Dogoon,sylvanas,1756,warlock,destruction,83,48,35
Mønarch,argent-dawn,1755,warlock,destruction,67,40,27
Wällaar,ragnaros,1750,warlock,destruction,42,25,17
Хирацука,howling-fjord,1749,warlock,destruction,45,31,14
Plaguee,outland,1745,warlock,destruction,44,28,16
Bianchii,stormscale,1743,warlock,destruction,27,20,7
Tàkaz,drekthar,1743,warlock,destruction,36,21,15
Brainac,blackrock,1736,warlock,destruction,30,19,11
Взорг,soulflayer,1736,warlock,destruction,60,30,30
Sneptics,draenor,1734,warlock,destruction,115,73,42
Десло,thermaplugg,1731,warlock,destruction,42,25,17
Тьмазвёздная,gordunni,1729,warlock,destruction,30,22,8
Slytherim,stormscale,1727,warlock,destruction,45,33,12
Doodle,the-maelstrom,1726,warlock,destruction,48,26,22
Motcha,kazzak,1724,warlock,destruction,30,18,12
Someonepro,tarren-mill,1722,warlock,destruction,41,19,22
Killerbolt,blackmoore,1720,warlock,destruction,42,28,14
Jegfaller,wildhammer,1718,warlock,destruction,114,58,56
Öbsury,hyjal,1715,warlock,destruction,43,23,20
Ràzek,kazzak,1712,warlock,destruction,77,38,39
Djfearbot,kazzak,1708,warlock,destruction,48,29,19
Boumbye,ysondre,1707,warlock,destruction,38,23,15
Junakot,silvermoon,1706,warlock,destruction,30,18,12
Røiheenøk,archimonde,1706,warlock,destruction,72,34,38
Wintheirl,argent-dawn,1705,warlock,destruction,84,46,38
Демоник,deathguard,1704,warlock,destruction,36,21,15
Alcringe,kazzak,1703,warlock,destruction,116,65,51
Èlton,tarren-mill,1700,warlock,destruction,48,28,20
Silmerion,twilights-hammer,1696,warlock,destruction,36,22,14
Portlock,kazzak,1696,warlock,destruction,42,24,18
Hairyporta,blackmoore,1694,warlock,destruction,50,29,21
Acidmvp,ravencrest,1692,warlock,destruction,60,33,27
Mangolicious,twisting-nether,1688,warlock,destruction,42,21,21
Raepist,terokkar,1679,warlock,destruction,42,25,17
Hellguards,silvermoon,1677,warlock,destruction,42,23,19
Whøîäm,kazzak,1676,warlock,destruction,30,22,8
Feardotbye,stormscale,1675,warlock,destruction,27,18,9
Wåfa,kazzak,1673,warlock,destruction,24,18,6
Kiwibob,defias-brotherhood,1671,warlock,destruction,35,22,13
Killning,medivh,1669,warlock,destruction,48,27,21
Nybbx,frostmane,1668,warlock,destruction,66,31,35
Fizzydark,malganis,1662,warlock,destruction,42,22,20
Fearlessgødx,ravencrest,1655,warlock,destruction,48,26,22
Robertóó,burning-legion,1653,warlock,destruction,40,24,16
Тагочи,gordunni,1652,warlock,destruction,38,21,17
Noomaca,drakthul,1651,warlock,destruction,42,23,19
Kìmar,amanthul,1648,warlock,destruction,72,40,32
Laedreth,argent-dawn,1646,warlock,destruction,29,18,11
Kenachaos,twisting-nether,1645,warlock,destruction,29,19,10
Twisted,malganis,1645,warlock,destruction,43,24,19
Sleethy,destromath,1642,warlock,destruction,36,20,16
Tuplajekku,sylvanas,1641,warlock,destruction,41,19,22
Dualla,aegwynn,1639,warlock,destruction,30,19,11
Opiumers,kazzak,1638,warlock,destruction,41,23,18
Azthral,nemesis,1638,warlock,destruction,58,32,26
Shádóws,nagrand,1637,warlock,destruction,50,29,21
Ecoxx,aegwynn,1636,warlock,destruction,30,22,8
Ketamol,ravencrest,1636,warlock,destruction,30,19,11
Logicdotexé,tarren-mill,1635,warlock,destruction,30,21,9
Порртвейн,howling-fjord,1628,warlock,destruction,29,18,11
Koldarr,blackmoore,1627,warlock,destruction,46,26,20
Rakshazza,eredar,1626,warlock,destruction,36,22,14
Delumia,tarren-mill,1624,warlock,destruction,66,34,32
Pørtal,aggra-português,1622,warlock,destruction,30,17,13
Rêctûmsêêkêr,ravencrest,1622,warlock,destruction,30,17,13
Ánárchy,stormscale,1620,warlock,destruction,36,17,19
Reeween,argent-dawn,1619,warlock,destruction,30,18,12
Evylock,draenor,1619,warlock,destruction,30,17,13
Belial,minahonda,1615,warlock,destruction,27,18,9
Shadock,scarshield-legion,1614,warlock,destruction,24,17,7
Väladar,sanguino,1614,warlock,destruction,35,18,17
Meatbot,tarren-mill,1609,warlock,destruction,46,31,15
Lockyswag,draenor,1609,warlock,destruction,66,37,29
Badguldan,blackmoore,1609,warlock,destruction,39,20,19
Esmuel,argent-dawn,1608,warlock,destruction,71,43,28
Ðîâblô,silvermoon,1606,warlock,destruction,41,22,19
Juppi,blackrock,1605,warlock,destruction,24,19,5
Aloof,outland,1600,warlock,destruction,79,44,35
Garlan,dun-modr,1599,warlock,destruction,70,32,38
Keybump,outland,1598,warlock,destruction,36,21,15
Edrahil,lordaeron,1595,warlock,destruction,30,19,11
Magonyth,tarren-mill,1592,warlock,destruction,25,18,7
Spoíl,tarren-mill,1589,warlock,destruction,24,17,7
Ðemonsoul,stormscale,1588,warlock,destruction,36,17,19
Réxz,ravencrest,1586,warlock,destruction,72,36,36
Fearfearfear,archimonde,1583,warlock,destruction,42,19,23
Ludé,eredar,1577,warlock,destruction,66,32,34
Madridistaß,outland,1570,warlock,destruction,42,18,24
Gimlidota,tarren-mill,1565,warlock,destruction,59,35,24
Kerthan,malorne,1563,warlock,destruction,42,29,13
Lysanruth,la-croisade-écarlate,1562,warlock,destruction,54,26,28
Áutísm,silvermoon,1561,warlock,destruction,60,32,28
Davyjonessx,twisting-nether,1559,warlock,destruction,41,17,24
Yukokotier,archimonde,1557,warlock,destruction,42,22,20
Nijva,silvermoon,1550,warlock,destruction,36,17,19
Vultzbolt,draenor,1544,warlock,destruction,30,19,11
Beåtrìce,archimonde,1541,warlock,destruction,36,18,18
Noahh,kazzak,1538,warlock,destruction,56,37,19
Xtleonidas,uldum,1538,warlock,destruction,54,27,27
Ignittes,ragnaros,1537,warlock,destruction,24,17,7
Veracruza,draenor,1537,warlock,destruction,85,44,41
Героуд,howling-fjord,1536,warlock,destruction,58,35,23
Faermorn,kazzak,1535,warlock,destruction,24,16,8
Depressedkid,ravencrest,1535,warlock,destruction,24,16,8
Hebbxw,kazzak,1535,warlock,destruction,30,17,13
Kuckacocucka,outland,1532,warlock,destruction,24,16,8
Tehkorrum,archimonde,1531,warlock,destruction,30,16,14
Napoloen,kazzak,1530,warlock,destruction,30,16,14
Aoea,draenor,1529,warlock,destruction,24,16,8
Danidelarge,aegwynn,1529,warlock,destruction,40,18,22
Boltzer,archimonde,1528,warlock,destruction,24,16,8
Ltheory,aegwynn,1528,warlock,destruction,36,19,17
Atraped,zuljin,1527,warlock,destruction,42,25,17
Nospamcliqu,ysondre,1527,warlock,destruction,30,16,14
Hongkonger,kazzak,1522,warlock,destruction,90,47,43
Славеномен,howling-fjord,1521,warlock,destruction,56,29,27
Quickccast,draenor,1519,warlock,destruction,52,31,21
Ablas,bladefist,1519,warlock,destruction,63,29,34
Kognah,defias-brotherhood,1518,warlock,destruction,24,16,8
Rotinhell,kazzak,1518,warlock,destruction,34,17,17
Kaedinx,twisting-nether,1515,warlock,destruction,109,59,50
Skrikipanik,kazzak,1513,warlock,destruction,30,16,14
Psýcholoc,kazzak,1510,warlock,destruction,24,16,8
Deathscréam,burning-legion,1508,warlock,destruction,48,23,25
Banishedone,stormreaver,1507,warlock,destruction,30,18,12
Nøl,sargeras,1507,warlock,destruction,205,101,104
Sickening,twilights-hammer,1502,warlock,destruction,31,23,8
Kïng,elune,1498,warlock,destruction,48,25,23
Dzey,drakthul,1498,warlock,destruction,51,26,25
Malame,hyjal,1498,warlock,destruction,36,17,19
Interceptêr,blackrock,1496,warlock,destruction,36,18,18
Warlocat,the-maelstrom,1493,warlock,destruction,72,34,38
Elyö,dalaran,1486,warlock,destruction,41,16,25
Demonkïng,archimonde,1463,warlock,destruction,42,24,18
Chaosprophet,argent-dawn,1459,warlock,destruction,32,18,14
Czx,twisting-nether,1447,warlock,destruction,30,18,12
Variu,blackhand,1446,warlock,destruction,31,19,12
Dreadnogg,the-maelstrom,1446,warlock,destruction,40,21,19
Ignorantduck,sunstrider,1445,warlock,destruction,36,18,18
Nellyvato,eredar,1439,warlock,destruction,18,15,3
Gulwer,blackmoore,1438,warlock,destruction,24,15,9
Lockisbadx,draenor,1438,warlock,destruction,30,15,15
Matsuei,tarren-mill,1437,warlock,destruction,30,15,15
Whakkx,blackrock,1436,warlock,destruction,24,15,9
Tajit,eredar,1432,warlock,destruction,30,15,15
Deathfløw,draenor,1430,warlock,destruction,18,15,3
Holaw,tarren-mill,1430,warlock,destruction,42,19,23
Nitmoredots,dun-modr,1427,warlock,destruction,24,15,9
Nerzhull,stormscale,1427,warlock,destruction,115,55,60
Veoxohr,argent-dawn,1426,warlock,destruction,39,30,9
Shufflous,ghostlands,1424,warlock,destruction,28,16,12
Thugsupreme,ravencrest,1422,warlock,destruction,36,19,17
Kerway,outland,1420,warlock,destruction,30,15,15
Litox,twisting-nether,1412,warlock,destruction,33,16,17
Грань,ashenvale,1410,warlock,destruction,66,35,31
Kumas,hyjal,1406,warlock,destruction,30,16,14
Lockybàlboa,tarren-mill,1404,warlock,destruction,24,16,8
Stürmer,thrall,1403,warlock,destruction,36,19,17
Kenthal,nemesis,1398,warlock,destruction,33,16,17
Untactful,tarren-mill,1384,warlock,destruction,42,26,16
Ryurans,cthun,1379,warlock,destruction,59,31,28
Samyoung,kazzak,1378,warlock,destruction,42,23,19
Tuz,blackrock,1377,warlock,destruction,84,39,45
Voidislife,alakir,1373,warlock,destruction,69,33,36
Qaripidia,ravencrest,1368,warlock,destruction,28,15,13
Faro,trollbane,1364,warlock,destruction,60,22,38
Diablotiin,hyjal,1363,warlock,destruction,42,19,23
Strikeførce,ravencrest,1361,warlock,destruction,23,15,8
Bisacodyl,outland,1361,warlock,destruction,60,27,33
Dsï,outland,1344,warlock,destruction,24,14,10
Drututt,the-maelstrom,1344,warlock,destruction,24,14,10
Corbbolt,drakthul,1343,warlock,destruction,18,14,4
Drdoit,blackrock,1343,warlock,destruction,24,14,10
Anthraxus,argent-dawn,1343,warlock,destruction,24,14,10
Сильвиос,howling-fjord,1343,warlock,destruction,28,14,14
Rockbèll,blackmoore,1342,warlock,destruction,18,14,4
Mocha,ravencrest,1341,warlock,destruction,18,14,4
Terris,khaz-modan,1341,warlock,destruction,27,16,11
Alphå,blackmoore,1340,warlock,destruction,18,14,4
Khoug,blackmoore,1340,warlock,destruction,24,14,10
Dìablò,sylvanas,1339,warlock,destruction,36,24,12
Djdampening,bloodhoof,1338,warlock,destruction,22,15,7
Asbest,blackrock,1338,warlock,destruction,24,14,10
Büm,kazzak,1338,warlock,destruction,30,14,16
Zetsubo,drakthul,1337,warlock,destruction,28,15,13
Кварий,howling-fjord,1337,warlock,destruction,36,14,22
Anomen,sanguino,1334,warlock,destruction,30,14,16
Isata,ravencrest,1330,warlock,destruction,18,14,4
Ínsidióus,tarren-mill,1329,warlock,destruction,24,14,10
Wilog,silvermoon,1327,warlock,destruction,24,14,10
Chickoz,eredar,1321,warlock,destruction,49,31,18
Soulgünter,blackmoore,1317,warlock,destruction,34,23,11
Jinxme,tarren-mill,1317,warlock,destruction,24,14,10
Zivalelia,silvermoon,1316,warlock,destruction,48,19,29
Zloezlo,ravencrest,1314,warlock,destruction,30,14,16
Ghostfiend,tarren-mill,1313,warlock,destruction,21,15,6
Маларгас,soulflayer,1313,warlock,destruction,24,14,10
Pensiblesie,runetotem,1307,warlock,destruction,108,52,56
Blackjackk,tarren-mill,1305,warlock,destruction,36,14,22
Äsmødée,dalaran,1302,warlock,destruction,30,18,12
Lodem,darksorrow,1298,warlock,destruction,36,15,21
Demoz,sanguino,1289,warlock,destruction,28,17,11
Valcan,ragnaros,1288,warlock,destruction,43,21,22
Unkash,zuljin,1275,warlock,destruction,35,19,16
Ocaya,kazzak,1275,warlock,destruction,30,16,14
Ispankmysuc,korgall,1272,warlock,destruction,22,14,8
Pookabee,ravencrest,1263,warlock,destruction,30,14,16
Wicherson,burning-legion,1251,warlock,destruction,25,14,11
Creatúre,drakthul,1248,warlock,destruction,18,13,5
Mércé,stormscale,1248,warlock,destruction,18,13,5
Twork,tarren-mill,1248,warlock,destruction,24,13,11
Xfz,stormscale,1248,warlock,destruction,24,13,11
Dreamnyâsha,tarren-mill,1248,warlock,destruction,24,13,11
Bónz,outland,1248,warlock,destruction,24,13,11
Dótstuff,draenor,1247,warlock,destruction,24,13,11
Rhüd,twisting-nether,1247,warlock,destruction,24,13,11
Nyiks,blackhand,1247,warlock,destruction,24,13,11
Slavecry,silvermoon,1246,warlock,destruction,18,13,5
Dimmybyrger,stormreaver,1246,warlock,destruction,24,13,11
Kwoh,saurfang,1246,warlock,destruction,24,13,11
Vegetita,stormscale,1246,warlock,destruction,35,18,17
Todesgurke,alleria,1245,warlock,destruction,24,13,11
Jisera,kiljaeden,1245,warlock,destruction,30,13,17
Stromzii,silvermoon,1243,warlock,destruction,24,13,11
Htaedfo,tarren-mill,1243,warlock,destruction,30,13,17
Zeinth,sanguino,1241,warlock,destruction,18,13,5
Skruios,anetheron,1239,warlock,destruction,28,14,14
Noxsix,gorgonnash,1238,warlock,destruction,18,13,5
Кулутха,soulflayer,1237,warlock,destruction,18,13,5
Sirmic,hyjal,1235,warlock,destruction,30,13,17
Инсип,blackscar,1230,warlock,destruction,24,14,10
Unrealia,hyjal,1230,warlock,destruction,24,13,11
Asmonmald,stormscale,1228,warlock,destruction,24,13,11
Çhãøsførÿã,blackmoore,1219,warlock,destruction,30,13,17
Bigbolt,arathor,1215,warlock,destruction,20,14,6
Guntok,tarren-mill,1211,warlock,destruction,37,22,15
Maxxilla,twisting-nether,1205,warlock,destruction,83,39,44
Makîø,hyjal,1198,warlock,destruction,23,13,10
Ceu,tarren-mill,1197,warlock,destruction,21,14,7
Emoriy,blackmoore,1192,warlock,destruction,28,16,12
Ayóó,doomhammer,1187,warlock,destruction,59,33,26
Borrìs,blackhand,1183,warlock,destruction,24,15,9
Gricorby,drakthul,1167,warlock,destruction,17,13,4
Nibblez,shadowsong,1162,warlock,destruction,23,13,10
Dogdrakex,tarren-mill,1152,warlock,destruction,16,13,3
Простишутках,gordunni,1152,warlock,destruction,18,12,6
Deezbolts,kazzak,1152,warlock,destruction,18,12,6
Соргосор,gordunni,1152,warlock,destruction,18,12,6
Ниезвестнно,soulflayer,1152,warlock,destruction,24,12,12
Ekàti,ravencrest,1152,warlock,destruction,24,12,12
Консидёро,gordunni,1152,warlock,destruction,30,12,18
Pumpelumpe,twisting-nether,1152,warlock,destruction,33,13,20
Manhart,burning-legion,1151,warlock,destruction,18,12,6
Felcollíns,ravencrest,1151,warlock,destruction,18,12,6
Elldialock,draenor,1151,warlock,destruction,24,12,12
Varaxxis,twisting-nether,1151,warlock,destruction,24,12,12
Kikaikek,stormscale,1150,warlock,destruction,18,12,6
Ilovebronko,blackrock,1150,warlock,destruction,18,12,6
Beebs,aegwynn,1150,warlock,destruction,18,12,6
Scadar,kazzak,1149,warlock,destruction,18,12,6
Kritcheq,alakir,1149,warlock,destruction,60,29,31
Maikus,stormscale,1148,warlock,destruction,18,12,6
Nebulus,lightnings-blade,1146,warlock,destruction,18,12,6
Kivilock,dun-modr,1146,warlock,destruction,24,12,12
Моргоника,howling-fjord,1144,warlock,destruction,36,12,24
Jinxzed,frostwhisper,1143,warlock,destruction,18,12,6
Drillingsdad,dun-morogh,1126,warlock,destruction,24,12,12
Гулдас,thermaplugg,1126,warlock,destruction,30,13,17
Jobbymancer,twisting-nether,1122,warlock,destruction,18,12,6
Atruruz,antonidas,1109,warlock,destruction,47,24,23
Artyrus,burning-legion,1109,warlock,destruction,30,14,16
Riitaall,khaz-modan,1103,warlock,destruction,41,15,26
Ìpen,bloodfeather,1087,warlock,destruction,17,12,5
Tikondrus,ravencrest,1056,warlock,destruction,12,11,1
Tuskawl,stormreaver,1056,warlock,destruction,12,11,1
Dersdog,twisting-nether,1056,warlock,destruction,16,12,4
Lhestér,outland,1056,warlock,destruction,16,12,4
Fjutta,outland,1056,warlock,destruction,18,11,7
Кремация,blackscar,1056,warlock,destruction,18,11,7
Wester,blackmoore,1056,warlock,destruction,18,11,7
Avenueat,kazzak,1056,warlock,destruction,18,11,7
Setyouinfear,ravencrest,1056,warlock,destruction,24,11,13
Raknoxyeyeye,blackrock,1055,warlock,destruction,18,11,7
Fløkee,blackmoore,1055,warlock,destruction,18,11,7
Usianbølts,blackmoore,1055,warlock,destruction,18,11,7
Xiraq,nathrezim,1055,warlock,destruction,24,11,13
Lokajci,outland,1054,warlock,destruction,19,12,7
Mallevs,outland,1054,warlock,destruction,18,11,7
Tóuché,aegwynn,1054,warlock,destruction,18,11,7
Themut,draenor,1054,warlock,destruction,18,11,7
Niszoght,dun-modr,1052,warlock,destruction,29,18,11
Forcas,archimonde,1051,warlock,destruction,18,11,7
Белвет,blackscar,1051,warlock,destruction,24,11,13
Саденсират,gordunni,1047,warlock,destruction,15,12,3
Äbsalom,hyjal,1045,warlock,destruction,48,29,19
Orisess,bronze-dragonflight,1044,warlock,destruction,36,20,16
Бигтедок,gordunni,1036,warlock,destruction,48,23,25
Diseased,darksorrow,1005,warlock,destruction,26,14,12
Iltharian,die-todeskrallen,1000,warlock,destruction,17,11,6
Bolt,stormscale,985,warlock,destruction,17,11,6
Fromfuneral,anetheron,985,warlock,destruction,42,24,18
Insanely,kazzak,981,warlock,destruction,27,13,14
Eisenkiefer,thrall,961,warlock,destruction,65,22,43
Graystache,blackhand,960,warlock,destruction,12,10,2
Fyxs,talnivarr,960,warlock,destruction,12,10,2
Harefrøken,ravencrest,960,warlock,destruction,12,10,2
Plâytïmè,stormscale,960,warlock,destruction,12,10,2
Umbraz,blackmoore,960,warlock,destruction,12,10,2
Senkai,kelthuzad,960,warlock,destruction,12,10,2
Ñia,ravencrest,960,warlock,destruction,12,10,2
Slomg,sylvanas,960,warlock,destruction,12,10,2
Calli,blackrock,960,warlock,destruction,12,10,2
Skillførçé,kazzak,960,warlock,destruction,12,10,2
Djmcwarlock,kazzak,960,warlock,destruction,12,10,2
Ashlÿn,draenor,960,warlock,destruction,18,10,8
Gödisdëäd,sanguino,960,warlock,destruction,18,10,8
Adoxilock,twisting-nether,960,warlock,destruction,18,10,8
Schøkøbasher,blackrock,960,warlock,destruction,18,10,8
Блейдап,razuvious,960,warlock,destruction,18,10,8
Anniefuchsia,ravencrest,960,warlock,destruction,18,10,8
Lìmè,silvermoon,960,warlock,destruction,18,10,8
Healylockx,stormscale,960,warlock,destruction,18,10,8
Armellixd,dun-modr,960,warlock,destruction,24,10,14
Murdee,kazzak,960,warlock,destruction,24,10,14
Gorillabolts,tarren-mill,960,warlock,destruction,24,10,14
Xunzu,drakthul,960,warlock,destruction,24,10,14
Zízýéró,sylvanas,959,warlock,destruction,12,10,2
Olympïe,archimonde,959,warlock,destruction,16,11,5
Kekbólt,twisting-nether,959,warlock,destruction,18,10,8
Limoges,archimonde,959,warlock,destruction,18,10,8
Slâyâ,blackrock,958,warlock,destruction,12,10,2
Vîmø,antonidas,958,warlock,destruction,18,10,8
Annihilatîon,aegwynn,958,warlock,destruction,18,10,8
Ragequit,xavius,958,warlock,destruction,18,10,8
Адво,howling-fjord,958,warlock,destruction,18,10,8
Absurdd,turalyon,955,warlock,destruction,16,11,5
Spõk,ysondre,955,warlock,destruction,18,10,8
Thranerm,ravencrest,955,warlock,destruction,24,10,14
Babayagâ,sanguino,954,warlock,destruction,12,10,2
Realshady,kazzak,954,warlock,destruction,18,10,8
Pprwl,tarren-mill,954,warlock,destruction,24,10,14
Арцах,soulflayer,954,warlock,destruction,24,10,14
Gerart,tarren-mill,953,warlock,destruction,18,10,8
Aftxrlife,arathor,951,warlock,destruction,16,11,5
Gehirnwäsche,frostwolf,951,warlock,destruction,16,11,5
Sylrathas,burning-legion,941,warlock,destruction,18,10,8
Neetlock,suramar,940,warlock,destruction,24,10,14
Essealaes,stormscale,911,warlock,destruction,17,10,7
Rackare,darksorrow,910,warlock,destruction,15,10,5
Demowlition,archimonde,908,warlock,destruction,24,10,14
Tschapatalpi,blackhand,896,warlock,destruction,16,10,6
Bèkshà,blackrock,894,warlock,destruction,20,10,10
Soulboltx,ragnaros,864,warlock,destruction,12,9,3
Kasualdot,stormscale,864,warlock,destruction,12,9,3
Brødo,dun-modr,864,warlock,destruction,12,9,3
Ghachi,draenor,864,warlock,destruction,12,9,3
Boltmaster,burning-legion,864,warlock,destruction,12,9,3
Chàsx,archimonde,864,warlock,destruction,12,9,3
Mýlìfêbélike,kazzak,864,warlock,destruction,12,9,3
Çamille,ulduar,864,warlock,destruction,12,9,3
Бжк,gordunni,864,warlock,destruction,12,9,3
Märkähuikka,stormreaver,864,warlock,destruction,12,9,3
Vamanos,stormscale,864,warlock,destruction,12,9,3
Zikozor,ravencrest,864,warlock,destruction,16,10,6
Чернокок,blackscar,864,warlock,destruction,18,9,9
Фейкгодх,soulflayer,864,warlock,destruction,18,9,9
Gis,laughing-skull,864,warlock,destruction,18,9,9
Силорий,howling-fjord,864,warlock,destruction,18,9,9
Mxdojsrvqxzq,ravencrest,864,warlock,destruction,24,9,15
Helldoom,drakthul,864,warlock,destruction,24,9,15
Elerodril,ysondre,863,warlock,destruction,12,9,3
Narzok,kazzak,863,warlock,destruction,12,9,3
Гвоздяшка,blackscar,863,warlock,destruction,18,9,9
Sesoumaru,azshara,863,warlock,destruction,18,9,9
Andrealphus,outland,863,warlock,destruction,18,9,9
Vimb,archimonde,863,warlock,destruction,18,9,9
Bíggun,outland,862,warlock,destruction,12,9,3
Osyx,ravencrest,862,warlock,destruction,16,11,5
Мицуру,howling-fjord,861,warlock,destruction,18,9,9
Xhartus,argent-dawn,860,warlock,destruction,18,9,9
Shaxlock,draenor,860,warlock,destruction,18,9,9
Alphazero,zuluhed,815,warlock,destruction,17,9,8
Krestox,blackmoore,814,warlock,destruction,23,9,14
Merloc,magtheridon,801,warlock,destruction,20,10,10
Sovrìn,blackrock,797,warlock,destruction,14,9,5
Nimbin,taerar,796,warlock,destruction,20,9,11
Achluophobiå,ravencrest,784,warlock,destruction,13,9,4
Kitchiarû,uldaman,768,warlock,destruction,12,8,4
Rustos,ravencrest,768,warlock,destruction,12,8,4
Chaozvx,kazzak,768,warlock,destruction,12,8,4
Спаводах,soulflayer,768,warlock,destruction,12,8,4
Хастла,ashenvale,768,warlock,destruction,12,8,4
Maxlox,tarren-mill,768,warlock,destruction,12,8,4
Fulcanelli,sargeras,768,warlock,destruction,12,8,4
Overbuffed,wildhammer,768,warlock,destruction,12,8,4
Zilalol,sylvanas,768,warlock,destruction,12,8,4
Whisperer,defias-brotherhood,768,warlock,destruction,12,8,4
Belastiz,blackmoore,768,warlock,destruction,12,8,4
Teiser,nemesis,768,warlock,destruction,12,8,4
Dmonlock,hyjal,768,warlock,destruction,12,8,4
Estefanía,tarren-mill,768,warlock,destruction,12,8,4
Kaeb,archimonde,768,warlock,destruction,12,8,4
Jørdanna,blackrock,768,warlock,destruction,12,8,4
Kaktakto,ravencrest,768,warlock,destruction,18,8,10
Véstheim,saurfang,768,warlock,destruction,18,8,10
Laciewaifu,silvermoon,768,warlock,destruction,18,8,10
Adipure,blackrock,768,warlock,destruction,18,8,10
Flatulenzus,blackrock,768,warlock,destruction,18,8,10
Horststenzl,blackrock,768,warlock,destruction,18,8,10
Cørleen,eredar,768,warlock,destruction,24,8,16
Peterpaîn,blackmoore,767,warlock,destruction,16,11,5
Darcîa,destromath,767,warlock,destruction,12,8,4
Скул,soulflayer,767,warlock,destruction,12,8,4
Коилсестры,blackscar,767,warlock,destruction,15,9,6
Алхун,razuvious,767,warlock,destruction,18,8,10
Гупперлок,howling-fjord,767,warlock,destruction,18,8,10
Felbunni,silvermoon,766,warlock,destruction,18,8,10
Lewdrumpslap,kazzak,765,warlock,destruction,12,8,4
Lovrog,twisting-nether,765,warlock,destruction,12,8,4
Toffifae,argent-dawn,765,warlock,destruction,12,8,4
Бомбшелл,soulflayer,751,warlock,destruction,14,9,5
Ванадий,soulflayer,751,warlock,destruction,23,8,15
Salastro,ragnaros,735,warlock,destruction,11,8,3
Shaodul,stormscale,735,warlock,destruction,17,8,9
Rizzbolt,ravencrest,727,warlock,destruction,29,8,21
Warlocklordx,ravencrest,713,warlock,destruction,22,9,13
Kycknosa,archimonde,703,warlock,destruction,20,8,12
Påsqúåls,ravencrest,672,warlock,destruction,12,7,5
Ôlo,rajaxx,672,warlock,destruction,12,7,5
Limity,nozdormu,672,warlock,destruction,12,7,5
Visceris,ravencrest,672,warlock,destruction,12,7,5
Envizer,ravencrest,672,warlock,destruction,12,7,5
Матрикспз,soulflayer,672,warlock,destruction,12,7,5
Mowxll,blackrock,672,warlock,destruction,12,7,5
Yudy,burning-legion,672,warlock,destruction,12,7,5
Hell,twisting-nether,672,warlock,destruction,12,7,5
Filippö,eredar,672,warlock,destruction,12,7,5
Necrobtch,quelthalas,672,warlock,destruction,12,7,5
Amited,drakthul,672,warlock,destruction,12,7,5
Denasty,nemesis,672,warlock,destruction,12,7,5
Lúcìfér,stormscale,672,warlock,destruction,12,7,5
Märtas,burning-blade,672,warlock,destruction,12,7,5
Gjallarbrù,archimonde,672,warlock,destruction,12,7,5
Lottopallo,arathor,672,warlock,destruction,12,7,5
Ripnsew,ravencrest,672,warlock,destruction,12,7,5
Marador,drakthul,672,warlock,destruction,12,7,5
Panda,aegwynn,672,warlock,destruction,12,7,5
Snackstickz,twisting-nether,672,warlock,destruction,12,7,5
Veríty,kazzak,672,warlock,destruction,12,7,5
Britnèyfears,twisting-nether,672,warlock,destruction,18,7,11
Haedache,tarren-mill,672,warlock,destruction,18,7,11
Hædês,antonidas,672,warlock,destruction,18,7,11
Belakh,draenor,672,warlock,destruction,18,7,11
Topmodelx,eredar,672,warlock,destruction,18,7,11
Marripa,sanguino,672,warlock,destruction,24,7,17
Trickyy,azjolnerub,671,warlock,destruction,12,7,5
Saadq,draenor,671,warlock,destruction,12,7,5
Postymalony,kazzak,671,warlock,destruction,12,7,5
Waandi,ravencrest,671,warlock,destruction,12,7,5
Fauxshow,ravencrest,671,warlock,destruction,12,7,5
Paranoid,sylvanas,671,warlock,destruction,12,7,5
Cømps,blackrock,671,warlock,destruction,12,7,5
Baladas,nemesis,671,warlock,destruction,12,7,5
Panicbolt,ravencrest,671,warlock,destruction,12,7,5
Vengidotcom,outland,671,warlock,destruction,18,7,11
Sorxez,thrall,671,warlock,destruction,18,7,11
Qloss,burning-legion,670,warlock,destruction,12,7,5
Galath,wrathbringer,670,warlock,destruction,16,8,8
Mortori,tarren-mill,668,warlock,destruction,12,7,5
Fredé,kazzak,639,warlock,destruction,17,7,10
Zarastro,sunstrider,624,warlock,destruction,15,7,8
Vakgu,blackmoore,622,warlock,destruction,11,7,4
Гангстахохо,soulflayer,622,warlock,destruction,16,7,9
Zxò,twisting-nether,608,warlock,destruction,10,7,3
Érunali,archimonde,607,warlock,destruction,11,7,4
Willthehoe,alonsus,607,warlock,destruction,11,7,4
Datendariza,kazzak,607,warlock,destruction,14,7,7
Divvaa,tarren-mill,599,warlock,destruction,19,8,11
Инсинирейтх,gordunni,576,warlock,destruction,6,6,0
Popecandy,archimonde,576,warlock,destruction,6,6,0
Cafardcancer,archimonde,576,warlock,destruction,6,6,0
Skuvee,archimonde,576,warlock,destruction,6,6,0
Voukserys,tarren-mill,576,warlock,destruction,6,6,0
Boltilicious,kazzak,576,warlock,destruction,6,6,0
Klaier,dun-modr,576,warlock,destruction,9,7,2
Wlistoohard,stormscale,576,warlock,destruction,12,6,6
Eviil,tarren-mill,576,warlock,destruction,12,6,6
Keibo,drakthul,576,warlock,destruction,12,6,6
Dotalike,kazzak,576,warlock,destruction,12,6,6
Chafir,kazzak,576,warlock,destruction,12,6,6
Tbs,blackhand,576,warlock,destruction,12,6,6
Kalagorn,azshara,576,warlock,destruction,12,6,6
Britneyfears,burning-legion,576,warlock,destruction,12,6,6
Bazoo,nathrezim,576,warlock,destruction,12,6,6
Vulluin,blackrock,576,warlock,destruction,12,6,6
Drainforlife,blackrock,576,warlock,destruction,12,6,6
Staudi,eredar,576,warlock,destruction,12,6,6
Berkobaggins,ravencrest,576,warlock,destruction,12,6,6
Dèv,draenor,576,warlock,destruction,12,6,6
Xuthil,korgall,576,warlock,destruction,12,6,6
Zarisya,blackmoore,576,warlock,destruction,12,6,6
Mosslock,silvermoon,576,warlock,destruction,12,6,6
Nherthul,sanguino,576,warlock,destruction,12,6,6
Antoniolm,cthun,576,warlock,destruction,12,6,6
Ðôtgøðx,ravencrest,576,warlock,destruction,12,6,6
Benzakenta,sylvanas,576,warlock,destruction,12,6,6
Súícìdèbøy,colinas-pardas,576,warlock,destruction,12,6,6
ßenäfflock,ragnaros,576,warlock,destruction,12,6,6
Klasikas,kazzak,576,warlock,destruction,16,7,9
Naitix,argent-dawn,576,warlock,destruction,18,6,12
Hexdoctor,ravencrest,576,warlock,destruction,18,6,12
Solomohn,steamwheedle-cartel,575,warlock,destruction,6,6,0
Brarvile,zuljin,575,warlock,destruction,12,6,6
Dexterr,sylvanas,575,warlock,destruction,12,6,6
Gengada,blackhand,575,warlock,destruction,12,6,6
Nemssy,dun-modr,575,warlock,destruction,18,6,12
Nerokin,blackrock,574,warlock,destruction,6,6,0
Bono,frostwhisper,527,warlock,destruction,11,6,5
Plamena,neptulon,526,warlock,destruction,13,7,6
Wolferand,argent-dawn,521,warlock,destruction,24,7,17
Wewondak,drakthul,511,warlock,destruction,8,6,2
Scrim,laughing-skull,510,warlock,destruction,8,6,2
Kaspersdame,ravencrest,495,warlock,destruction,11,6,5
Крутизол,fordragon,493,warlock,destruction,13,6,7
Dejin,tarren-mill,480,warlock,destruction,6,5,1
Demonmilf,ysondre,480,warlock,destruction,6,5,1
Андаинг,soulflayer,480,warlock,destruction,6,5,1
Exiled,dragonblight,480,warlock,destruction,6,5,1
Бирел,soulflayer,480,warlock,destruction,6,5,1
Fearbeachx,ravencrest,480,warlock,destruction,6,5,1
Noobtamer,kazzak,480,warlock,destruction,6,5,1
Djløckgødx,ravencrest,480,warlock,destruction,6,5,1
Rensayy,ysondre,480,warlock,destruction,6,5,1
Гивмисоул,soulflayer,480,warlock,destruction,6,5,1
Verminosiss,stormscale,480,warlock,destruction,6,5,1
Файрусх,soulflayer,480,warlock,destruction,6,5,1
Coilxo,ravencrest,480,warlock,destruction,6,5,1
Levinbrz,ravencrest,480,warlock,destruction,6,5,1
Drainurlife,zenedar,480,warlock,destruction,6,5,1
Withered,nagrand,480,warlock,destruction,6,5,1
Nili,dethecus,480,warlock,destruction,6,5,1
Sadixxqt,ravencrest,480,warlock,destruction,6,5,1
Höglund,twisting-nether,480,warlock,destruction,6,5,1
Biest,drakthul,480,warlock,destruction,6,5,1
Квейдсан,howling-fjord,480,warlock,destruction,6,5,1
Sâlty,stormscale,480,warlock,destruction,6,5,1
Boglock,argent-dawn,480,warlock,destruction,6,5,1
Naemys,archimonde,480,warlock,destruction,6,5,1
Chaøs,thrall,480,warlock,destruction,6,5,1
Stazox,drakthul,480,warlock,destruction,6,5,1
Barbyqueue,kazzak,480,warlock,destruction,6,5,1
Веберх,howling-fjord,480,warlock,destruction,6,5,1
Ампе,blackscar,480,warlock,destruction,6,5,1
Warlockyo,blackrock,480,warlock,destruction,6,5,1
Whitebøy,hyjal,480,warlock,destruction,6,5,1
Mïllâïneeqtx,archimonde,480,warlock,destruction,6,5,1
Nëismz,azuremyst,480,warlock,destruction,6,5,1
Náwwk,blackmoore,480,warlock,destruction,6,5,1
Sluba,stormscale,480,warlock,destruction,6,5,1
Deruud,defias-brotherhood,480,warlock,destruction,6,5,1
Debz,twisting-nether,480,warlock,destruction,6,5,1
ßualock,sylvanas,480,warlock,destruction,6,5,1
Sotapen,ragnaros,480,warlock,destruction,6,5,1
Анкхзул,howling-fjord,480,warlock,destruction,6,5,1
Kieman,tarren-mill,480,warlock,destruction,12,5,7
Domdon,stormscale,480,warlock,destruction,12,5,7
Bajsibyx,tarren-mill,480,warlock,destruction,12,5,7
Динодотз,howling-fjord,480,warlock,destruction,12,5,7
Orgebixx,blackmoore,480,warlock,destruction,12,5,7
Hexdoc,alakir,480,warlock,destruction,12,5,7
Asper,ragnaros,480,warlock,destruction,12,5,7
Salouppio,archimonde,480,warlock,destruction,12,5,7
Kerídiin,twisting-nether,480,warlock,destruction,12,5,7
Köftemec,blackrock,480,warlock,destruction,12,5,7
Yeluna,alleria,480,warlock,destruction,12,5,7
Gillgarres,twisting-nether,480,warlock,destruction,12,5,7
Bricktot,ragnaros,480,warlock,destruction,12,5,7
Tzeeñtch,tarren-mill,480,warlock,destruction,12,5,7
Drfóx,draenor,480,warlock,destruction,12,5,7
Babayagaa,drakthul,480,warlock,destruction,12,5,7
Gåylørd,ravencrest,480,warlock,destruction,12,5,7
Infectius,kazzak,480,warlock,destruction,18,5,13
Profesorr,defias-brotherhood,480,warlock,destruction,18,5,13
Whine,uldum,479,warlock,destruction,12,5,7
Сенсация,ashenvale,479,warlock,destruction,12,5,7
Archélion,silvermoon,479,warlock,destruction,12,5,7
Soulsdeads,sylvanas,478,warlock,destruction,12,5,7
Börsenborisq,aegwynn,399,warlock,destruction,5,5,0
Mizxxta,zuljin,399,warlock,destruction,5,5,0
Arthesia,archimonde,384,warlock,destruction,6,4,2
Holiax,archimonde,384,warlock,destruction,6,4,2
Lobotomic,argent-dawn,384,warlock,destruction,6,4,2
Yhwäch,archimonde,384,warlock,destruction,6,4,2
Limecqt,dun-morogh,384,warlock,destruction,6,4,2
Gwl,archimonde,384,warlock,destruction,6,4,2
Incesticide,ragnaros,384,warlock,destruction,6,4,2
Reizouka,twisting-nether,384,warlock,destruction,6,4,2
Siyaa,eredar,384,warlock,destruction,6,4,2
Fandirxd,draenor,384,warlock,destruction,6,4,2
Balding,blackhand,384,warlock,destruction,6,4,2
Purplemonkey,burning-blade,384,warlock,destruction,6,4,2
Uqrlock,twisting-nether,384,warlock,destruction,6,4,2
Bewegen,frostwolf,384,warlock,destruction,6,4,2
Hannahowo,garona,384,warlock,destruction,6,4,2
Raddikal,archimonde,384,warlock,destruction,6,4,2
Nilsa,eredar,384,warlock,destruction,6,4,2
Cigänä,archimonde,384,warlock,destruction,6,4,2
Dotritos,tarren-mill,384,warlock,destruction,6,4,2
Diabolics,twisting-nether,384,warlock,destruction,6,4,2
Sïlïthuss,ravencrest,384,warlock,destruction,6,4,2
Nerfmeplz,archimonde,384,warlock,destruction,6,4,2
Rénna,twisting-nether,384,warlock,destruction,6,4,2
Sneltjej,draenor,384,warlock,destruction,6,4,2
Diemilch,blackmoore,384,warlock,destruction,6,4,2
Precogbtw,ravencrest,384,warlock,destruction,6,4,2
Janemba,ysondre,384,warlock,destruction,6,4,2
Lockteb,tarren-mill,384,warlock,destruction,6,4,2
Äri,blackmoore,384,warlock,destruction,6,4,2
Kar,haomarush,384,warlock,destruction,6,4,2
Wedlock,stormscale,384,warlock,destruction,6,4,2
Krachol,emeriss,384,warlock,destruction,6,4,2
Imissbfa,stormscale,384,warlock,destruction,6,4,2
Smithlock,blackrock,384,warlock,destruction,6,4,2
Abdulrahim,archimonde,384,warlock,destruction,6,4,2
Zekarat,blackrock,384,warlock,destruction,6,4,2
Yifu,ravencrest,384,warlock,destruction,6,4,2
Беллулар,howling-fjord,384,warlock,destruction,6,4,2
Daeyon,ravencrest,384,warlock,destruction,6,4,2
Boltyboi,chamber-of-aspects,384,warlock,destruction,6,4,2
Xshay,dun-modr,384,warlock,destruction,6,4,2
Akumako,stormscale,384,warlock,destruction,6,4,2
Hydrôlîc,blackrock,384,warlock,destruction,6,4,2
Íntikam,blackrock,384,warlock,destruction,6,4,2
Warlockery,argent-dawn,384,warlock,destruction,6,4,2
Ädarä,cthun,384,warlock,destruction,6,4,2
Вроман,fordragon,384,warlock,destruction,6,4,2
Ðuß,nemesis,384,warlock,destruction,6,4,2
Likeqtz,thrall,384,warlock,destruction,6,4,2
Unstablemind,nemesis,384,warlock,destruction,6,4,2
Freshademic,tarren-mill,384,warlock,destruction,6,4,2
Zéik,archimonde,384,warlock,destruction,6,4,2
Predlocktwo,twisting-nether,384,warlock,destruction,6,4,2
Yoplen,drakthul,384,warlock,destruction,6,4,2
Анрали,soulflayer,384,warlock,destruction,6,4,2
Póssiblyreef,silvermoon,384,warlock,destruction,6,4,2
Shadowburst,outland,384,warlock,destruction,6,4,2
Cloud,kazzak,384,warlock,destruction,6,4,2
Acilock,outland,384,warlock,destruction,6,4,2
Korupcijax,kazzak,384,warlock,destruction,6,4,2
Dobonard,sylvanas,384,warlock,destruction,6,4,2
Zilthon,dragonblight,384,warlock,destruction,6,4,2
Hotdoghomie,tarren-mill,384,warlock,destruction,6,4,2
Sterlock,sylvanas,384,warlock,destruction,6,4,2
Kääk,sylvanas,384,warlock,destruction,6,4,2
Cencible,twisting-nether,384,warlock,destruction,6,4,2
Gorthunz,kazzak,384,warlock,destruction,6,4,2
Чиназис,gordunni,384,warlock,destruction,6,4,2
Marenov,kazzak,384,warlock,destruction,6,4,2
Iulu,sylvanas,384,warlock,destruction,6,4,2
Джастсак,gordunni,384,warlock,destruction,6,4,2
Gambos,kazzak,384,warlock,destruction,6,4,2
Nògg,kazzak,384,warlock,destruction,6,4,2
Вешка,azuregos,384,warlock,destruction,6,4,2
Рыжевласочка,eversong,384,warlock,destruction,9,5,4
Happysrme,thrall,384,warlock,destruction,12,4,8
Saloninus,argent-dawn,384,warlock,destruction,12,4,8
Impvader,argent-dawn,384,warlock,destruction,12,4,8
Mustalol,outland,384,warlock,destruction,12,4,8
Mavelya,blackmoore,384,warlock,destruction,12,4,8
Лоллиторпеда,gordunni,384,warlock,destruction,12,4,8
Nerfwarriors,stormscale,384,warlock,destruction,12,4,8
Xârtôr,blackrock,384,warlock,destruction,12,4,8
Sædotern,stormscale,384,warlock,destruction,12,4,8
Tekron,blackhand,384,warlock,destruction,12,4,8
Margincalled,kazzak,384,warlock,destruction,12,4,8
Natsume,ragnaros,384,warlock,destruction,12,4,8
Letswreck,outland,384,warlock,destruction,12,4,8
Уфц,grom,384,warlock,destruction,12,4,8
Zoh,archimonde,384,warlock,destruction,12,4,8
Blackiouz,stormscale,384,warlock,destruction,12,4,8
Darkmaw,drakthul,384,warlock,destruction,12,4,8
Angrynoob,silvermoon,383,warlock,destruction,6,4,2
Pipêz,blackmoore,351,warlock,destruction,11,4,7
Зеленаямразь,soulflayer,336,warlock,destruction,9,4,5
Khano,twisting-nether,336,warlock,destruction,15,4,11
Рейнджр,eversong,330,warlock,destruction,15,6,9
Sapheâ,burning-legion,319,warlock,destruction,5,4,1
Chev,nemesis,319,warlock,destruction,5,4,1
Таксидермия,gordunni,319,warlock,destruction,5,4,1
Líok,eredar,319,warlock,destruction,11,4,7
Sicktir,aerie-peak,288,warlock,destruction,6,3,3
Cigarrette,draenor,288,warlock,destruction,6,3,3
Bte,draenor,288,warlock,destruction,6,3,3
Шеизла,borean-tundra,288,warlock,destruction,6,3,3
Lockki,blades-edge,288,warlock,destruction,6,3,3
Telodotto,nemesis,288,warlock,destruction,6,3,3
Herador,draenor,288,warlock,destruction,6,3,3
Gulleigh,draenor,288,warlock,destruction,6,3,3
Belnea,draenor,288,warlock,destruction,6,3,3
Fornaio,nemesis,288,warlock,destruction,6,3,3
Sateerik,draenor,288,warlock,destruction,6,3,3
Wdauwg,nazjatar,288,warlock,destruction,6,3,3
Nanotrik,draenor,288,warlock,destruction,6,3,3
Evaksiá,draenor,288,warlock,destruction,6,3,3
Osîrîs,aegwynn,288,warlock,destruction,6,3,3
Loveløck,blackrock,288,warlock,destruction,6,3,3
Firecast,kazzak,288,warlock,destruction,6,3,3
Imbalockzwei,aegwynn,288,warlock,destruction,6,3,3
Odenbest,silvermoon,288,warlock,destruction,6,3,3
Влицотьмой,gordunni,288,warlock,destruction,6,3,3
Глотающий,gordunni,288,warlock,destruction,6,3,3
Onetwobolt,archimonde,288,warlock,destruction,6,3,3
Issyl,kazzak,288,warlock,destruction,6,3,3
Zabani,das-syndikat,288,warlock,destruction,6,3,3
Hiroyukí,frostmane,288,warlock,destruction,6,3,3
Hairylock,outland,288,warlock,destruction,6,3,3
Galardodric,outland,288,warlock,destruction,6,3,3
Frankieboi,drakthul,288,warlock,destruction,6,3,3
Bluh,twisting-nether,288,warlock,destruction,6,3,3
Avogeiñ,tarren-mill,288,warlock,destruction,6,3,3
Lamboo,tarren-mill,288,warlock,destruction,6,3,3
Maevex,stormscale,288,warlock,destruction,6,3,3
Lockskalle,tarren-mill,288,warlock,destruction,6,3,3
Otemlock,sanguino,288,warlock,destruction,6,3,3
Voltadol,dun-modr,288,warlock,destruction,6,3,3
Vâgg,blackmoore,288,warlock,destruction,6,3,3
Fluugew,tarren-mill,288,warlock,destruction,6,3,3
Cpump,twisting-nether,288,warlock,destruction,6,3,3
Hepheisto,blackmoore,288,warlock,destruction,6,3,3
Fandusttwo,drakthul,288,warlock,destruction,6,3,3
Brodoh,dun-modr,288,warlock,destruction,6,3,3
Demónfire,sylvanas,288,warlock,destruction,6,3,3
Rb,anachronos,288,warlock,destruction,6,3,3
Waryald,dun-modr,288,warlock,destruction,6,3,3
Chapo,alleria,288,warlock,destruction,6,3,3
Helvetica,darksorrow,288,warlock,destruction,6,3,3
Dragmetohêll,blackhand,288,warlock,destruction,6,3,3
Çüñ,shattered-hand,288,warlock,destruction,6,3,3
Funcky,terokkar,288,warlock,destruction,6,3,3
Fsandtwo,ravencrest,288,warlock,destruction,6,3,3
Huaraches,stormscale,288,warlock,destruction,6,3,3
Thorenss,medivh,288,warlock,destruction,6,3,3
Azmondan,ahnqiraj,288,warlock,destruction,6,3,3
Bh,ragnaros,288,warlock,destruction,6,3,3
Læssêkøñgð,twisting-nether,288,warlock,destruction,6,3,3
Бешентумай,goldrinn,288,warlock,destruction,6,3,3
Epoku,stormscale,288,warlock,destruction,6,3,3
Exitumos,eredar,288,warlock,destruction,6,3,3
Talt,dalaran,288,warlock,destruction,6,3,3
Rhaznor,frostwolf,288,warlock,destruction,6,3,3
Wauwish,stormscale,288,warlock,destruction,6,3,3
Palmtri,stormscale,288,warlock,destruction,6,3,3
Deamheòlas,ravencrest,288,warlock,destruction,6,3,3
Wajiggity,ravencrest,288,warlock,destruction,6,3,3
Кайдзуки,howling-fjord,288,warlock,destruction,6,3,3
Icq,ravencrest,288,warlock,destruction,6,3,3
Nosoulnoprob,sylvanas,288,warlock,destruction,6,3,3
Doublebolt,the-maelstrom,288,warlock,destruction,6,3,3
Shena,chogall,288,warlock,destruction,6,3,3
Mewarlock,bronze-dragonflight,288,warlock,destruction,6,3,3
Ghosthound,stormscale,288,warlock,destruction,6,3,3
Jumbodot,tarren-mill,288,warlock,destruction,12,3,9
Milfhaunter,aegwynn,288,warlock,destruction,12,3,9
Tiffyilock,blackrock,288,warlock,destruction,12,3,9
Gnargamehl,nemesis,288,warlock,destruction,12,3,9
Svartalfen,outland,288,warlock,destruction,12,3,9
Shakuroz,frostwolf,288,warlock,destruction,12,3,9
Èrmes,eldrethalas,288,warlock,destruction,12,3,9
Ðæthpäct,dalaran,288,warlock,destruction,12,3,9
Azrail,anubarak,288,warlock,destruction,12,3,9
Грашек,soulflayer,287,warlock,destruction,6,3,3
Shutdown,sylvanas,287,warlock,destruction,6,3,3
Naniika,blackmoore,286,warlock,destruction,6,3,3
Destri,blackmoore,286,warlock,destruction,6,3,3
Insertchaos,draenor,239,warlock,destruction,5,3,2
Dotsyoudown,kelthuzad,208,warlock,destruction,7,3,4
Vortëxx,tarren-mill,192,warlock,destruction,9,3,6
Satanizm,silvermoon,192,warlock,destruction,6,2,4
Peardrax,draenor,192,warlock,destruction,6,2,4
Kleing,dragonblight,192,warlock,destruction,6,2,4
Bailerlock,antonidas,192,warlock,destruction,6,2,4
Aurelíá,ravencrest,192,warlock,destruction,6,2,4
Ðåñtåy,ravencrest,192,warlock,destruction,6,2,4
Уставок,soulflayer,192,warlock,destruction,6,2,4
Saffíe,ravencrest,192,warlock,destruction,6,2,4
Phéar,deathwing,192,warlock,destruction,6,2,4
Pelkopeelo,tarren-mill,192,warlock,destruction,6,2,4
Splojf,the-maelstrom,192,warlock,destruction,6,2,4
Werkx,archimonde,192,warlock,destruction,6,2,4
Palihatschi,eredar,192,warlock,destruction,6,2,4
Fiddyp,kazzak,192,warlock,destruction,6,2,4
Sad,lightnings-blade,192,warlock,destruction,6,2,4
Houndread,kazzak,192,warlock,destruction,6,2,4
Шэдоубёрн,soulflayer,192,warlock,destruction,6,2,4
Zêngâ,kazzak,192,warlock,destruction,6,2,4
Bulgyeøng,archimonde,192,warlock,destruction,6,2,4
Ooze,kazzak,192,warlock,destruction,6,2,4
Daeneerys,skullcrusher,192,warlock,destruction,6,2,4
Parley,frostmane,192,warlock,destruction,6,2,4
Zillinzy,frostmane,192,warlock,destruction,6,2,4
Jaliyah,outland,192,warlock,destruction,6,2,4
Gulzot,turalyon,192,warlock,destruction,6,2,4
Locknroll,terokkar,192,warlock,destruction,6,2,4
Diddia,malganis,192,warlock,destruction,6,2,4
Zagana,neptulon,192,warlock,destruction,6,2,4
Absúrd,turalyon,192,warlock,destruction,6,2,4
Levitibus,argent-dawn,192,warlock,destruction,6,2,4
Voodooskull,kazzak,192,warlock,destruction,6,2,4
Чернокнжник,soulflayer,192,warlock,destruction,6,2,4
Anthor,tarren-mill,192,warlock,destruction,6,2,4
Ilovemimi,hyjal,192,warlock,destruction,6,2,4
Brokengodx,dun-modr,192,warlock,destruction,6,2,4
Necrofearz,sylvanas,192,warlock,destruction,6,2,4
Merengue,uldum,192,warlock,destruction,6,2,4
Astralvoid,outland,192,warlock,destruction,6,2,4
Cindela,eredar,192,warlock,destruction,6,2,4
Kontanthjælp,tarren-mill,192,warlock,destruction,6,2,4
Ívânguldán,twisting-nether,192,warlock,destruction,6,2,4
Nerfbolts,archimonde,192,warlock,destruction,6,2,4
Lolock,archimonde,192,warlock,destruction,6,2,4
Ðaddyy,stormscale,192,warlock,destruction,6,2,4
Мерседэсс,gordunni,192,warlock,destruction,6,2,4
Архидрако,gordunni,192,warlock,destruction,6,2,4
Брузир,gordunni,192,warlock,destruction,6,2,4
Joemontana,blackrock,192,warlock,destruction,6,2,4
Карьерщица,booty-bay,192,warlock,destruction,6,2,4
Dotg,blackrock,192,warlock,destruction,6,2,4
Хашонмвп,gordunni,192,warlock,destruction,6,2,4
Obichamcici,tarren-mill,192,warlock,destruction,6,2,4
Hheavens,ragnaros,192,warlock,destruction,6,2,4
Емс,gordunni,192,warlock,destruction,6,2,4
Bloodysûgar,blackmoore,192,warlock,destruction,6,2,4
Línkéd,blackmoore,192,warlock,destruction,6,2,4
Colevid,blackmoore,192,warlock,destruction,6,2,4
Костикк,howling-fjord,192,warlock,destruction,6,2,4
Kokainas,dun-modr,192,warlock,destruction,12,2,10
Àbraxàs,nemesis,192,warlock,destruction,12,2,10
Nimwyn,argent-dawn,192,warlock,destruction,12,2,10
Watchlock,burning-legion,191,warlock,destruction,6,2,4
Arlu,blackrock,191,warlock,destruction,6,2,4
Геролин,goldrinn,169,warlock,destruction,18,6,12
Grimlòck,antonidas,159,warlock,destruction,5,2,3
Tid,burning-legion,159,warlock,destruction,5,2,3
Dony,dun-morogh,159,warlock,destruction,5,2,3
Hp,ysondre,159,warlock,destruction,5,2,3
Epzi,outland,159,warlock,destruction,5,2,3
Starlok,nemesis,159,warlock,destruction,5,2,3
Fêars,blackrock,128,warlock,destruction,4,2,2
Перегном,blackscar,127,warlock,destruction,8,2,6
Сайзэр,soulflayer,96,warlock,destruction,3,2,1
Mergon,ravencrest,96,warlock,destruction,3,2,1
Nekros,archimonde,96,warlock,destruction,3,2,1
Егосяхаос,soulflayer,96,warlock,destruction,6,1,5
Chaostheory,stormscale,96,warlock,destruction,6,1,5
Wt,twisting-nether,96,warlock,destruction,6,1,5
Icritmore,stormscale,96,warlock,destruction,6,1,5
Tropìcal,grim-batol,96,warlock,destruction,6,1,5
Brútality,nethersturm,96,warlock,destruction,6,1,5
Juhpz,blackrock,96,warlock,destruction,6,1,5
Mariahscary,auchindoun,96,warlock,destruction,6,1,5
Нафлэпил,gordunni,96,warlock,destruction,6,1,5
Dabezdwl,outland,96,warlock,destruction,6,1,5
Musallat,argent-dawn,96,warlock,destruction,6,1,5
Kneereap,antonidas,96,warlock,destruction,6,1,5
Jaines,forscherliga,96,warlock,destruction,6,1,5
Sindown,the-maelstrom,96,warlock,destruction,6,1,5
Sinsemilla,turalyon,96,warlock,destruction,6,1,5
Killerbeez,burning-blade,96,warlock,destruction,6,1,5
Werlock,sanguino,96,warlock,destruction,6,1,5
Wuahlock,doomhammer,96,warlock,destruction,6,1,5
Satânius,les-sentinelles,96,warlock,destruction,6,1,5
Lomendro,blackmoore,96,warlock,destruction,6,1,5
Neuth,draenor,96,warlock,destruction,6,1,5
Lilskunk,draenor,96,warlock,destruction,6,1,5
Rigour,silvermoon,96,warlock,destruction,6,1,5
Pilock,stormscale,96,warlock,destruction,6,1,5
Kopfkissen,azshara,96,warlock,destruction,6,1,5
Gâlvâtorix,frostmourne,96,warlock,destruction,6,1,5
Dalfgan,wildhammer,96,warlock,destruction,6,1,5
Grêenbull,eredar,96,warlock,destruction,9,1,8
Alithia,sylvanas,96,warlock,destruction,12,1,11
Racursed,outland,64,warlock,destruction,4,1,3
Nopower,dun-morogh,48,warlock,destruction,3,1,2
Daubi,ravencrest,31,warlock,destruction,2,1,1
Crse,antonidas,16,warlock,destruction,1,1,0
Khrym,stormscale,16,warlock,destruction,1,1,0
Beepbepp,grim-batol,16,warlock,destruction,1,1,0
Quanny,die-aldor,2078,warrior,fury,108,63,45
Schultze,kazzak,2036,warrior,fury,84,40,44
Gottdustin,lothar,2025,warrior,fury,95,51,44
Thorana,twisting-nether,2000,warrior,fury,138,66,72
Corvínus,blackrock,1978,warrior,fury,66,37,29
Gregorez,silvermoon,1966,warrior,fury,54,34,20
Wruxar,bronzebeard,1856,warrior,fury,54,29,25
Kwesta,kazzak,1850,warrior,fury,60,34,26
Castlevania,ravencrest,1840,warrior,fury,66,36,30
Sublex,aegwynn,1838,warrior,fury,54,33,21
Brythwyn,antonidas,1838,warrior,fury,42,24,18
Дахирарг,fordragon,1830,warrior,fury,48,25,23
Sporctaco,nemesis,1828,warrior,fury,58,30,28
Kenryu,argent-dawn,1825,warrior,fury,60,32,28
Sonnyzz,sanguino,1824,warrior,fury,36,21,15
Timewarrior,ravencrest,1824,warrior,fury,54,30,24
Трэйдар,blackscar,1823,warrior,fury,48,27,21
Letiis,blackrock,1816,warrior,fury,105,57,48
Adian,ravencrest,1813,warrior,fury,42,26,16
Schlauberg,azshara,1811,warrior,fury,48,29,19
Мигнт,howling-fjord,1810,warrior,fury,42,23,19
Nóvamh,draenor,1802,warrior,fury,42,24,18
Níghtfúry,ravencrest,1777,warrior,fury,48,24,24
Robycoleman,nemesis,1774,warrior,fury,36,22,14
Эйримор,gordunni,1763,warrior,fury,83,47,36
Unstopablle,twisting-nether,1755,warrior,fury,78,47,31
Tóffèl,thrall,1749,warrior,fury,36,27,9
Ranmaru,kazzak,1747,warrior,fury,55,28,27
Gladius,blutkessel,1733,warrior,fury,48,23,25
Ryonâgai,aegwynn,1726,warrior,fury,48,27,21
Очепенец,soulflayer,1724,warrior,fury,102,55,47
Кавайтити,blackscar,1718,warrior,fury,39,19,20
Варынеопэ,gordunni,1717,warrior,fury,59,32,27
Méido,argent-dawn,1712,warrior,fury,132,72,60
Thezug,blackmoore,1709,warrior,fury,42,24,18
Stansmash,kazzak,1704,warrior,fury,30,18,12
Badon,burning-legion,1697,warrior,fury,42,27,15
Протектор,soulflayer,1694,warrior,fury,58,30,28
Yodabär,blackmoore,1690,warrior,fury,120,62,58
Methodxd,outland,1683,warrior,fury,36,21,15
Imolderthenu,blackrock,1682,warrior,fury,30,19,11
Råzor,blackhand,1671,warrior,fury,84,51,33
Шлифую,howling-fjord,1667,warrior,fury,48,25,23
Deatheart,ysondre,1667,warrior,fury,40,20,20
Juna,hellscream,1663,warrior,fury,39,20,19
Даймонддогс,gordunni,1662,warrior,fury,46,25,21
Capitalista,das-konsortium,1661,warrior,fury,42,23,19
Megalann,silvermoon,1654,warrior,fury,48,24,24
Noproblem,ragnaros,1650,warrior,fury,65,34,31
Vÿnk,ysondre,1637,warrior,fury,56,32,24
Discoklaus,blackmoore,1636,warrior,fury,90,45,45
Peli,burning-blade,1634,warrior,fury,102,50,52
Бубаигавар,gordunni,1620,warrior,fury,36,18,18
Dronikos,ravencrest,1612,warrior,fury,36,22,14
Walexmaryk,ragnaros,1610,warrior,fury,107,58,49
Celn,silvermoon,1606,warrior,fury,121,68,53
Abnôrmus,tarren-mill,1604,warrior,fury,90,41,49
Averenx,frostwolf,1601,warrior,fury,68,34,34
Сариату,soulflayer,1580,warrior,fury,66,32,34
Koljach,sylvanas,1577,warrior,fury,96,49,47
Zupkaztrópka,burning-legion,1576,warrior,fury,54,28,26
Saadx,ravencrest,1567,warrior,fury,42,23,19
Вадло,soulflayer,1566,warrior,fury,30,17,13
ßbç,ysondre,1565,warrior,fury,72,36,36
Stahlhund,silvermoon,1564,warrior,fury,87,47,40
Zednos,twilights-hammer,1555,warrior,fury,72,38,34
Втораянатура,howling-fjord,1508,warrior,fury,36,22,14
Clellin,silvermoon,1505,warrior,fury,38,19,19
Garlogar,twisting-nether,1504,warrior,fury,30,18,12
Hrodulf,moonglade,1503,warrior,fury,60,28,32
Kwedrowar,burning-legion,1495,warrior,fury,30,16,14
Craghak,twisting-nether,1490,warrior,fury,70,36,34
Добиватель,howling-fjord,1488,warrior,fury,24,16,8
Grubshak,burning-legion,1480,warrior,fury,42,20,22
Wøokz,argent-dawn,1465,warrior,fury,72,33,39
Krauus,silvermoon,1455,warrior,fury,59,35,24
Dragão,kazzak,1443,warrior,fury,42,20,22
Арестант,soulflayer,1434,warrior,fury,37,24,13
Mustar,alexstrasza,1434,warrior,fury,59,35,24
Tweegles,argent-dawn,1433,warrior,fury,65,31,34
Boos,burning-legion,1432,warrior,fury,24,15,9
Truckfury,ravencrest,1429,warrior,fury,34,18,16
Halfbroken,moonglade,1420,warrior,fury,30,15,15
Terisá,blackmoore,1405,warrior,fury,34,18,16
Zíreael,ravencrest,1401,warrior,fury,30,17,13
Akînos,kazzak,1400,warrior,fury,57,27,30
Hidaykus,bronzebeard,1399,warrior,fury,70,35,35
Машамеч,blackscar,1396,warrior,fury,36,22,14
Gruttak,aegwynn,1361,warrior,fury,24,16,8
Zeliøn,elune,1353,warrior,fury,30,19,11
Sublex,blackrock,1343,warrior,fury,18,14,4
Mitu,sanguino,1338,warrior,fury,24,14,10
Старопрамен,thermaplugg,1338,warrior,fury,37,21,16
Madaxe,kazzak,1336,warrior,fury,18,14,4
Kragar,anetheron,1329,warrior,fury,45,25,20
Evrybodydown,draenor,1316,warrior,fury,24,14,10
Torok,antonidas,1314,warrior,fury,24,16,8
Ninja,bronze-dragonflight,1314,warrior,fury,54,25,29
Вархаус,blackscar,1313,warrior,fury,39,21,18
Touguro,aggra-português,1312,warrior,fury,33,15,18
Барабумм,soulflayer,1310,warrior,fury,77,41,36
Ælvstan,argent-dawn,1310,warrior,fury,59,30,29
Ryù,dun-modr,1310,warrior,fury,30,14,16
Toundrâa,archimonde,1306,warrior,fury,69,31,38
Bigrooster,argent-dawn,1303,warrior,fury,60,31,29
Tragix,hyjal,1301,warrior,fury,36,16,20
Дарккардинал,deathguard,1290,warrior,fury,23,14,9
Watntietnn,burning-blade,1268,warrior,fury,49,24,25
Варрвик,howling-fjord,1264,warrior,fury,33,14,19
Аштау,howling-fjord,1262,warrior,fury,49,20,29
Бормормуш,gordunni,1261,warrior,fury,73,30,43
Dizzyndumb,draenor,1260,warrior,fury,54,26,28
Azazelslayer,dethecus,1250,warrior,fury,19,14,5
Рагнарульв,gordunni,1248,warrior,fury,36,15,21
Elsensor,sylvanas,1247,warrior,fury,30,13,17
Zyalen,stormscale,1246,warrior,fury,24,13,11
Buzzingorc,tarren-mill,1232,warrior,fury,36,18,18
Èscøbar,dalaran,1226,warrior,fury,33,14,19
Quigatron,frostmane,1225,warrior,fury,42,25,17
Kundrak,blackhand,1205,warrior,fury,25,13,12
Borntothis,zuljin,1201,warrior,fury,24,13,11
Delinde,cthun,1175,warrior,fury,87,42,45
Sabrewølf,blackmoore,1169,warrior,fury,36,21,15
Номер,eversong,1169,warrior,fury,57,21,36
Coyle,eredar,1163,warrior,fury,23,13,10
Vesnãpusic,draenor,1146,warrior,fury,18,12,6
Baoni,hyjal,1144,warrior,fury,30,12,18
Späns,ragnaros,1135,warrior,fury,23,12,11
Exhumator,blackhand,1135,warrior,fury,36,12,24
Nykyro,draenor,1119,warrior,fury,54,23,31
Lillebibbi,tarren-mill,1116,warrior,fury,23,12,11
Seka,nozdormu,1098,warrior,fury,48,27,21
Floppikatten,kazzak,1091,warrior,fury,18,13,5
Kizzyo,draenor,1055,warrior,fury,18,11,7
Криккс,greymane,1055,warrior,fury,18,11,7
Wabisabì,silvermoon,1054,warrior,fury,18,11,7
Amagaddon,draenor,1050,warrior,fury,28,12,16
Murgrimm,die-silberne-hand,1048,warrior,fury,39,23,16
Grâkul,twisting-nether,1046,warrior,fury,30,11,19
Lâmy,khaz-modan,1035,warrior,fury,30,11,19
Рсдрпб,eversong,1034,warrior,fury,24,11,13
Reckless,tarren-mill,1033,warrior,fury,24,11,13
Tdanielt,burning-legion,1032,warrior,fury,18,11,7
Säl,ragnaros,1030,warrior,fury,25,12,13
Oughn,silvermoon,1028,warrior,fury,21,12,9
Falaliss,elune,1015,warrior,fury,18,11,7
Achonar,draenor,1012,warrior,fury,23,11,12
Помойник,gordunni,995,warrior,fury,41,25,16
Krlebajker,tarren-mill,977,warrior,fury,27,14,13
Эребб,howling-fjord,966,warrior,fury,60,29,31
Хенгард,gordunni,959,warrior,fury,18,10,8
Highoverlord,aggra-português,959,warrior,fury,18,10,8
Груббоб,booty-bay,958,warrior,fury,18,10,8
Budwise,stormscale,957,warrior,fury,18,10,8
Гронвер,soulflayer,957,warrior,fury,18,10,8
Skullfondler,argent-dawn,955,warrior,fury,18,10,8
Buzzingwarr,tarren-mill,950,warrior,fury,24,10,14
Deusi,garrosh,949,warrior,fury,18,10,8
Agitoyami,defias-brotherhood,935,warrior,fury,21,11,10
Bëlzé,les-clairvoyants,927,warrior,fury,30,12,18
Иктиннос,gordunni,911,warrior,fury,23,10,13
Sperta,frostmourne,903,warrior,fury,24,11,13
Суферна,howling-fjord,894,warrior,fury,27,13,14
Stretch,thrall,879,warrior,fury,19,10,9
Enzja,nazjatar,878,warrior,fury,19,10,9
Sparkzu,twisting-nether,864,warrior,fury,12,9,3
Kihili,twisting-nether,864,warrior,fury,12,9,3
Рыгатрон,galakrond,864,warrior,fury,18,9,9
Рэйвисмашина,gordunni,864,warrior,fury,24,9,15
Broksigarr,ragnaros,863,warrior,fury,12,9,3
Вменяемый,gordunni,863,warrior,fury,18,9,9
Wornag,argent-dawn,863,warrior,fury,18,9,9
Picciocino,nemesis,863,warrior,fury,24,9,15
Bobitybob,ravencrest,862,warrior,fury,12,9,3
Grimleaper,twisting-nether,862,warrior,fury,18,9,9
Itchiiz,alonsus,862,warrior,fury,18,9,9
Jâbs,hyjal,860,warrior,fury,30,10,20
Ranndall,blackrock,851,warrior,fury,18,9,9
Taurras,nathrezim,850,warrior,fury,35,17,18
Zaximos,twisting-nether,847,warrior,fury,15,10,5
Ânaxi,silvermoon,831,warrior,fury,14,10,4
Sairos,kirin-tor,824,warrior,fury,18,9,9
Spokowar,hyjal,768,warrior,fury,12,8,4
Грамол,soulflayer,768,warrior,fury,12,8,4
Zern,draenor,768,warrior,fury,12,8,4
Killhound,argent-dawn,768,warrior,fury,12,8,4
Skylexs,burning-legion,768,warrior,fury,18,8,10
Settin,silvermoon,767,warrior,fury,12,8,4
Skeptikal,argent-dawn,767,warrior,fury,12,8,4
Анакронокс,howling-fjord,767,warrior,fury,18,8,10
Лимор,howling-fjord,767,warrior,fury,24,8,16
Васильна,soulflayer,766,warrior,fury,12,8,4
Ампутиль,gordunni,766,warrior,fury,12,8,4
Thebiggreen,twisting-nether,766,warrior,fury,12,8,4
Неуно,howling-fjord,766,warrior,fury,18,8,10
Alevucerdaa,draenor,766,warrior,fury,18,8,10
Skefe,archimonde,765,warrior,fury,12,8,4
Ipes,blackmoore,763,warrior,fury,15,9,6
Cazzpowa,frostmane,762,warrior,fury,12,8,4
Khaalo,blackhand,760,warrior,fury,12,8,4
Kungeen,silvermoon,758,warrior,fury,24,8,16
Insanedmg,dun-modr,704,warrior,fury,16,8,8
Mamox,archimonde,687,warrior,fury,13,8,5
Yserá,auchindoun,672,warrior,fury,12,7,5
Где,blackscar,672,warrior,fury,12,7,5
Geez,burning-blade,672,warrior,fury,12,7,5
Kocmochka,tarren-mill,672,warrior,fury,12,7,5
Inconcussae,drakthul,672,warrior,fury,12,7,5
Sebastian,ravencrest,672,warrior,fury,12,7,5
Biturboo,blackrock,672,warrior,fury,16,8,8
Cocojumbo,azuremyst,671,warrior,fury,12,7,5
Теокрафт,howling-fjord,671,warrior,fury,12,7,5
Broknagar,draenor,671,warrior,fury,12,7,5
Нириэла,howling-fjord,671,warrior,fury,12,7,5
Sniperwølf,tyrande,671,warrior,fury,12,7,5
Buffury,twisting-nether,671,warrior,fury,12,7,5
Rìsàs,draenor,671,warrior,fury,18,7,11
Hagoxfit,los-errantes,671,warrior,fury,18,7,11
Garosh,drakthul,666,warrior,fury,12,7,5
Jetman,ravencrest,640,warrior,fury,16,8,8
Слайдус,gordunni,638,warrior,fury,11,7,4
Antismoke,silvermoon,624,warrior,fury,15,8,7
Fatspacka,argent-dawn,607,warrior,fury,14,7,7
Sockerbagarn,zenedar,592,warrior,fury,13,7,6
Licious,outland,576,warrior,fury,6,6,0
Артэкриогг,soulflayer,576,warrior,fury,6,6,0
Исскатель,gordunni,576,warrior,fury,6,6,0
Wgdx,ravencrest,576,warrior,fury,12,6,6
Monbun,silvermoon,576,warrior,fury,12,6,6
Redwraith,stormscale,576,warrior,fury,12,6,6
Shurubel,outland,576,warrior,fury,12,6,6
Yugoslav,argent-dawn,576,warrior,fury,12,6,6
Рэйлет,gordunni,576,warrior,fury,12,6,6
Нейв,blackscar,576,warrior,fury,12,6,6
Circumcist,dragonblight,576,warrior,fury,12,6,6
Honzakesl,drakthul,576,warrior,fury,12,6,6
Dhloos,kazzak,576,warrior,fury,12,6,6
Crandalius,kazzak,576,warrior,fury,12,6,6
Shintuargar,blackrock,576,warrior,fury,12,6,6
Stanfury,sylvanas,576,warrior,fury,12,6,6
Pokopo,blackrock,576,warrior,fury,12,6,6
Dírectdash,draenor,576,warrior,fury,12,6,6
Сталиран,gordunni,576,warrior,fury,18,6,12
Тьмасвятая,gordunni,576,warrior,fury,18,6,12
Svênsk,argent-dawn,575,warrior,fury,12,6,6
Oravedenes,draenor,575,warrior,fury,12,6,6
Sammäel,eldrethalas,575,warrior,fury,12,6,6
Ikkr,kazzak,575,warrior,fury,18,6,12
Valkirya,arthas,575,warrior,fury,18,6,12
Discølove,frostwolf,543,warrior,fury,11,6,5
Blutwar,kazzak,536,warrior,fury,14,7,7
Blaying,ravencrest,527,warrior,fury,11,6,5
Skeptikal,tarren-mill,527,warrior,fury,11,6,5
Dûrøtan,marécage-de-zangar,527,warrior,fury,15,6,9
Balsor,frostmane,526,warrior,fury,11,6,5
Mortalclaw,kazzak,521,warrior,fury,21,7,14
Broley,blackhand,496,warrior,fury,13,6,7
Лазба,gordunni,480,warrior,fury,6,5,1
Tweran,drakthul,480,warrior,fury,6,5,1
Дайбек,howling-fjord,480,warrior,fury,6,5,1
Веоленс,gordunni,480,warrior,fury,6,5,1
Easypoîntsx,tarren-mill,480,warrior,fury,6,5,1
Zerm,draenor,480,warrior,fury,6,5,1
Релайк,gordunni,480,warrior,fury,6,5,1
Ptp,argent-dawn,480,warrior,fury,6,5,1
Timmyda,dalaran,480,warrior,fury,6,5,1
Astreimehns,sanguino,480,warrior,fury,6,5,1
Corrin,frostmourne,480,warrior,fury,6,5,1
Спайкуссь,goldrinn,480,warrior,fury,6,5,1
Jugg,emerald-dream,480,warrior,fury,12,5,7
Stkacha,sanguino,480,warrior,fury,12,5,7
Альмас,galakrond,480,warrior,fury,12,5,7
Dallion,azjolnerub,480,warrior,fury,12,5,7
Kondomi,stormreaver,480,warrior,fury,12,5,7
Arthayl,eredar,480,warrior,fury,12,5,7
Darthmalgus,stormscale,480,warrior,fury,12,5,7
Beznacaj,outland,480,warrior,fury,12,5,7
Hítmachine,outland,480,warrior,fury,12,5,7
Soakmybeet,archimonde,480,warrior,fury,12,5,7
Гатал,howling-fjord,480,warrior,fury,12,5,7
Ødên,frostmane,480,warrior,fury,12,5,7
Напутанность,soulflayer,480,warrior,fury,12,5,7
Hangovar,thrall,479,warrior,fury,9,6,3
Kirkwood,terokkar,479,warrior,fury,10,6,4
Luciferkhan,twisting-nether,479,warrior,fury,12,5,7
Ragecap,rexxar,479,warrior,fury,12,5,7
Элейд,thermaplugg,479,warrior,fury,12,5,7
Offpants,drakthul,479,warrior,fury,18,5,13
Gabbz,aggra-português,478,warrior,fury,10,6,4
Azzog,archimonde,477,warrior,fury,18,5,13
Roostai,shattered-hand,476,warrior,fury,12,5,7
Fenr,sanguino,444,warrior,fury,11,7,4
Piinte,naxxramas,444,warrior,fury,11,5,6
Осгаард,gordunni,425,warrior,fury,15,7,8
Djranji,kazzak,416,warrior,fury,10,5,5
Aleextrasza,silvermoon,415,warrior,fury,8,5,3
Roxxyy,stormreaver,384,warrior,fury,6,4,2
Стано,booty-bay,384,warrior,fury,6,4,2
Immørtálx,tarren-mill,384,warrior,fury,6,4,2
Борзило,howling-fjord,384,warrior,fury,6,4,2
Впижаме,gordunni,384,warrior,fury,6,4,2
Нордгаар,howling-fjord,384,warrior,fury,6,4,2
Xqt,laughing-skull,384,warrior,fury,6,4,2
Well,kult-der-verdammten,384,warrior,fury,6,4,2
Bözzy,stormreaver,384,warrior,fury,6,4,2
Злопиканка,gordunni,384,warrior,fury,6,4,2
Trollboii,ravencrest,384,warrior,fury,6,4,2
Madvlad,twisting-nether,384,warrior,fury,6,4,2
Báshx,outland,384,warrior,fury,6,4,2
Blaktarr,dunemaul,384,warrior,fury,6,4,2
Profär,archimonde,384,warrior,fury,6,4,2
Вульрайс,deepholm,384,warrior,fury,6,4,2
Глинм,gordunni,384,warrior,fury,6,4,2
Orkboii,ravencrest,384,warrior,fury,6,4,2
Vullgrîm,blackmoore,384,warrior,fury,6,4,2
Gandosh,blackmoore,384,warrior,fury,6,4,2
Warinator,ravencrest,384,warrior,fury,6,4,2
Кайзерчиф,soulflayer,384,warrior,fury,6,4,2
Razzani,nathrezim,384,warrior,fury,6,4,2
Daldiee,ravencrest,384,warrior,fury,6,4,2
Bersurker,draenor,384,warrior,fury,6,4,2
Roidspam,outland,384,warrior,fury,12,4,8
Изберг,soulflayer,384,warrior,fury,12,4,8
Kurenn,tarren-mill,384,warrior,fury,12,4,8
Andjuu,doomhammer,384,warrior,fury,12,4,8
Drswing,kazzak,384,warrior,fury,12,4,8
Nekerka,burning-legion,384,warrior,fury,12,4,8
Fortressa,ravencrest,384,warrior,fury,12,4,8
Zyzie,argent-dawn,384,warrior,fury,12,4,8
Âshnâzgðûr,burning-blade,384,warrior,fury,18,4,14
Варриорнир,howling-fjord,382,warrior,fury,6,4,2
Beogor,grim-batol,367,warrior,fury,11,4,7
Greensmash,hyjal,351,warrior,fury,14,5,9
Shieldlord,kazzak,351,warrior,fury,17,4,13
Bossít,doomhammer,336,warrior,fury,9,4,5
Skillissues,argent-dawn,330,warrior,fury,11,7,4
Tato,frostmourne,319,warrior,fury,5,4,1
Manelar,draenor,319,warrior,fury,8,4,4
Limejuicer,argent-dawn,319,warrior,fury,8,4,4
Bstgame,frostmane,288,warrior,fury,6,3,3
Whàtsup,stormscale,288,warrior,fury,6,3,3
Frankytank,antonidas,288,warrior,fury,6,3,3
Ulthrak,archimonde,288,warrior,fury,6,3,3
Obox,ravencrest,288,warrior,fury,6,3,3
Punahabe,draenor,288,warrior,fury,6,3,3
Didgedelik,archimonde,288,warrior,fury,6,3,3
Whimbux,stormscale,288,warrior,fury,6,3,3
Yawalad,stormscale,288,warrior,fury,6,3,3
Cryze,ravencrest,288,warrior,fury,6,3,3
Jengaa,draenor,288,warrior,fury,6,3,3
Mfdoöm,draenor,288,warrior,fury,6,3,3
Skullsmasher,stormscale,288,warrior,fury,6,3,3
Dgyfh,dun-morogh,288,warrior,fury,6,3,3
Léonie,arakarahm,288,warrior,fury,6,3,3
Immera,silvermoon,288,warrior,fury,6,3,3
Андервульф,booty-bay,288,warrior,fury,6,3,3
Hazarku,colinas-pardas,288,warrior,fury,6,3,3
Xerone,doomhammer,288,warrior,fury,6,3,3
Kurko,blackmoore,288,warrior,fury,6,3,3
Malasortë,sylvanas,288,warrior,fury,6,3,3
Honör,sylvanas,288,warrior,fury,6,3,3
Valhrann,dalaran,288,warrior,fury,6,3,3
Ruixxted,stormreaver,288,warrior,fury,6,3,3
Тегриско,goldrinn,288,warrior,fury,6,3,3
Eekz,haomarush,288,warrior,fury,6,3,3
Darriuso,kazzak,288,warrior,fury,6,3,3
Reidunøks,kazzak,288,warrior,fury,6,3,3
Friendlytwo,quelthalas,288,warrior,fury,6,3,3
Taeshalach,der-abyssische-rat,288,warrior,fury,6,3,3
Лаинвуд,soulflayer,288,warrior,fury,6,3,3
Aìrwave,blackmoore,288,warrior,fury,6,3,3
Drfeelgud,twisting-nether,288,warrior,fury,6,3,3
Thagzar,burning-legion,288,warrior,fury,6,3,3
Afk,emeriss,288,warrior,fury,6,3,3
Lífelover,tarren-mill,288,warrior,fury,6,3,3
Wunderwaffle,xavius,288,warrior,fury,6,3,3
Izrael,alakir,288,warrior,fury,6,3,3
Гацс,soulflayer,288,warrior,fury,6,3,3
Kapuchino,twisting-nether,288,warrior,fury,6,3,3
Eleborn,tarren-mill,288,warrior,fury,6,3,3
Тактоядобрый,ashenvale,288,warrior,fury,6,3,3
Ärmodäuss,norgannon,288,warrior,fury,12,3,9
Confliction,outland,288,warrior,fury,12,3,9
Grommer,dentarg,288,warrior,fury,12,3,9
Urabrask,stormscale,288,warrior,fury,12,3,9
Aphae,defias-brotherhood,288,warrior,fury,12,3,9
Nightvision,skullcrusher,288,warrior,fury,12,3,9
Bäiley,drakthul,288,warrior,fury,12,3,9
Xonnico,ravencrest,287,warrior,fury,6,3,3
Arnnau,dun-modr,287,warrior,fury,6,3,3
Rédsonja,chamber-of-aspects,287,warrior,fury,6,3,3
Nogo,nagrand,286,warrior,fury,6,3,3
Miina,blutkessel,286,warrior,fury,6,3,3
Tiapollo,dun-modr,271,warrior,fury,11,3,8
Tàuruss,blackhand,256,warrior,fury,10,3,7
Hazl,balnazzar,238,warrior,fury,5,3,2
Флокт,howling-fjord,208,warrior,fury,7,3,4
Имбанутыйвар,soulflayer,192,warrior,fury,4,3,1
Piixxz,hyjal,192,warrior,fury,6,2,4
Durrüti,sanguino,192,warrior,fury,6,2,4
Pouckette,hyjal,192,warrior,fury,6,2,4
Чпонькмашина,soulflayer,192,warrior,fury,6,2,4
Блиблоб,eversong,192,warrior,fury,6,2,4
Саркон,ashenvale,192,warrior,fury,6,2,4
Янесними,soulflayer,192,warrior,fury,6,2,4
Souler,burning-legion,192,warrior,fury,6,2,4
Zalazain,burning-legion,192,warrior,fury,6,2,4
Unn,ragnaros,192,warrior,fury,6,2,4
Shownomercy,blackrock,192,warrior,fury,6,2,4
Maniaco,kazzak,192,warrior,fury,6,2,4
Wärfäcë,blades-edge,192,warrior,fury,6,2,4
Kaerz,ysondre,192,warrior,fury,6,2,4
Hördê,zuljin,192,warrior,fury,6,2,4
Amédé,ysondre,192,warrior,fury,6,2,4
Pflanzling,nozdormu,192,warrior,fury,6,2,4
Løktær,blackmoore,192,warrior,fury,6,2,4
Nokturnâl,silvermoon,192,warrior,fury,6,2,4
Nemecic,arathor,192,warrior,fury,6,2,4
Gregórry,eredar,192,warrior,fury,6,2,4
Solidier,archimonde,192,warrior,fury,6,2,4
Artheim,silvermoon,192,warrior,fury,6,2,4
Schmetterina,proudmoore,192,warrior,fury,6,2,4
Evilweraz,turalyon,192,warrior,fury,6,2,4
Lianore,sanguino,192,warrior,fury,6,2,4
Аркашевич,gordunni,192,warrior,fury,6,2,4
Suichôken,archimonde,192,warrior,fury,6,2,4
Rayyes,stormscale,192,warrior,fury,6,2,4
Wembley,proudmoore,192,warrior,fury,6,2,4
Avgorcgodx,stormscale,192,warrior,fury,6,2,4
Nabucadnozor,illidan,192,warrior,fury,6,2,4
Mîcî,tarren-mill,192,warrior,fury,6,2,4
Zirvey,tarren-mill,192,warrior,fury,6,2,4
Picklejuicer,argent-dawn,192,warrior,fury,6,2,4
Jriddyzug,ravencrest,192,warrior,fury,6,2,4
Velgur,ravencrest,192,warrior,fury,6,2,4
Buntstift,thrall,192,warrior,fury,6,2,4
Футжисубо,razuvious,192,warrior,fury,6,2,4
Garradoom,stormscale,192,warrior,fury,11,3,8
Arzes,draenor,192,warrior,fury,12,2,10
Pakusrage,defias-brotherhood,192,warrior,fury,12,2,10
Jaowa,blackmoore,192,warrior,fury,12,2,10
Dorinaz,die-aldor,191,warrior,fury,6,2,4
Tömahawk,defias-brotherhood,191,warrior,fury,6,2,4
Guinnasse,khaz-modan,191,warrior,fury,6,2,4
Omosha,burning-legion,191,warrior,fury,6,2,4
Кереешка,howling-fjord,175,warrior,fury,11,2,9
Ðønøvan,sanguino,159,warrior,fury,5,2,3
Brülldozer,kargath,159,warrior,fury,5,2,3
Spacemachine,kazzak,96,warrior,fury,6,1,5
Wanzzeur,hyjal,96,warrior,fury,6,1,5
Zyn,outland,96,warrior,fury,6,1,5
Raixxon,ragnaros,96,warrior,fury,6,1,5
Coldstory,draenor,96,warrior,fury,6,1,5
Фиббоначи,deathguard,96,warrior,fury,6,1,5
Акози,fordragon,96,warrior,fury,6,1,5
Usz,thunderhorn,96,warrior,fury,6,1,5
Temprament,ravencrest,96,warrior,fury,6,1,5
Moggorr,nemesis,79,warrior,fury,5,1,4
Pitii,burning-legion,63,warrior,fury,2,2,0
Thors,deathwing,42,warrior,fury,15,2,13
Gamepresa,silvermoon,16,warrior,fury,1,1,0
Réckx,twisting-nether,2136,warrior,arms,69,39,30
Marcus,ravencrest,2111,warrior,arms,78,39,39
Оркабал,howling-fjord,2100,warrior,arms,83,50,33
Midgetdamis,blackhand,2093,warrior,arms,78,56,22
Regnarok,sylvanas,2088,warrior,arms,142,83,59
Wràthfúl,kazzak,2020,warrior,arms,101,54,47
Trâshwarriør,blackhand,2014,warrior,arms,56,26,30
Кокдиллак,soulflayer,2012,warrior,arms,86,42,44
Manaskhan,tarren-mill,2011,warrior,arms,66,39,27
Mitu,sanguino,1987,warrior,arms,119,61,58
Zak,stormscale,1955,warrior,arms,78,37,41
Disarmed,auchindoun,1945,warrior,arms,54,31,23
Myonmyonmyon,blackmoore,1937,warrior,arms,68,41,27
Elwarroo,dun-modr,1936,warrior,arms,54,31,23
Ulrid,draenor,1923,warrior,arms,36,21,15
Kapuchino,twisting-nether,1921,warrior,arms,48,27,21
Shilix,twisting-nether,1917,warrior,arms,76,32,44
Комочекгнева,howling-fjord,1914,warrior,arms,31,21,10
Cerry,ravencrest,1906,warrior,arms,51,25,26
Naronnas,drakthul,1903,warrior,arms,66,39,27
Вандэрбой,howling-fjord,1897,warrior,arms,54,27,27
Palianytsia,ravencrest,1892,warrior,arms,47,25,22
Courageous,ravencrest,1889,warrior,arms,54,33,21
Хэйре,howling-fjord,1886,warrior,arms,60,35,25
Куесэс,howling-fjord,1880,warrior,arms,36,20,16
Cathériné,drakthul,1875,warrior,arms,48,27,21
Doomqt,terokkar,1873,warrior,arms,47,27,20
Emix,arygos,1871,warrior,arms,54,31,23
Вокилог,soulflayer,1860,warrior,arms,96,51,45
Gewyon,ragnaros,1859,warrior,arms,42,22,20
Длоордпро,soulflayer,1859,warrior,arms,41,20,21
Merked,kazzak,1857,warrior,arms,54,28,26
Alegral,ravencrest,1856,warrior,arms,71,32,39
Xvlanter,silvermoon,1854,warrior,arms,48,27,21
Брокскрим,soulflayer,1854,warrior,arms,54,28,26
Savesta,dalaran,1852,warrior,arms,66,32,34
Krônm,dun-modr,1847,warrior,arms,78,33,45
Хиро,deathweaver,1839,warrior,arms,54,27,27
Kamked,burning-legion,1838,warrior,arms,48,25,23
Timpey,kazzak,1838,warrior,arms,48,25,23
Ланро,gordunni,1831,warrior,arms,53,31,22
Blazefüry,ravencrest,1827,warrior,arms,61,33,28
Варбоссец,soulflayer,1825,warrior,arms,66,35,31
Lanstus,silvermoon,1823,warrior,arms,72,42,30
Julololo,archimonde,1821,warrior,arms,66,34,32
Uzamaki,bronzebeard,1820,warrior,arms,48,32,16
Knutrex,tarren-mill,1820,warrior,arms,61,35,26
Лилиофаныч,soulflayer,1820,warrior,arms,35,20,15
Лимпс,gordunni,1819,warrior,arms,30,19,11
Ðênnis,ravencrest,1818,warrior,arms,30,19,11
Pürporcc,archimonde,1818,warrior,arms,97,48,49
Экзекьютлол,soulflayer,1816,warrior,arms,47,25,22
Joéfernandés,sylvanas,1816,warrior,arms,36,19,17
Hellguard,archimonde,1815,warrior,arms,54,33,21
Juank,minahonda,1814,warrior,arms,48,21,27
Vic,tarren-mill,1813,warrior,arms,47,20,27
Axinit,blackrock,1811,warrior,arms,42,23,19
Idiotplay,drekthar,1811,warrior,arms,42,19,23
Hulkensmash,kazzak,1810,warrior,arms,115,60,55
Drclapit,blackrock,1808,warrior,arms,36,19,17
Варзила,blackscar,1807,warrior,arms,53,22,31
Gabrijel,draenor,1805,warrior,arms,54,25,29
Zombossio,tarren-mill,1804,warrior,arms,56,31,25
Çatàclysmíc,kazzak,1804,warrior,arms,60,30,30
Hanìbal,ravencrest,1803,warrior,arms,60,32,28
Ghakra,kazzak,1802,warrior,arms,36,25,11
Sagethi,blackrock,1802,warrior,arms,47,23,24
Aerês,tarren-mill,1801,warrior,arms,66,32,34
Ezøn,aegwynn,1787,warrior,arms,30,19,11
Voxz,stormscale,1780,warrior,arms,60,32,28
Bloodhorn,blackhand,1779,warrior,arms,95,47,48
Robou,hyjal,1771,warrior,arms,62,27,35
Enøt,kazzak,1767,warrior,arms,41,20,21
Nozuki,archimonde,1758,warrior,arms,101,51,50
Cesr,bloodhoof,1757,warrior,arms,83,36,47
Ástriax,ravencrest,1754,warrior,arms,87,39,48
Sneakydrm,kazzak,1753,warrior,arms,28,19,9
Pj,sanguino,1750,warrior,arms,68,30,38
Маклецкий,gordunni,1745,warrior,arms,138,63,75
Ítikovan,aegwynn,1744,warrior,arms,99,48,51
Cerßere,archimonde,1739,warrior,arms,48,23,25
Mojotsche,taerar,1738,warrior,arms,64,36,28
Shortcvnt,ravencrest,1736,warrior,arms,42,25,17
Reider,twisting-nether,1736,warrior,arms,72,30,42
Galeron,kazzak,1734,warrior,arms,48,22,26
Kiyomaro,stormscale,1732,warrior,arms,36,19,17
Magnî,auchindoun,1731,warrior,arms,54,29,25
Sahl,sylvanas,1727,warrior,arms,81,46,35
Nitheriá,draenor,1727,warrior,arms,95,48,47
Dõxqt,kazzak,1726,warrior,arms,44,24,20
Maldark,scarshield-legion,1726,warrior,arms,82,39,43
Gigadot,arathor,1725,warrior,arms,96,49,47
Khalimov,tarren-mill,1724,warrior,arms,60,29,31
Mômsboy,tarren-mill,1722,warrior,arms,52,26,26
Dannyp,twisting-nether,1722,warrior,arms,36,18,18
Wayneson,tarren-mill,1718,warrior,arms,96,49,47
Dairøx,blackrock,1715,warrior,arms,54,26,28
Stupidz,hyjal,1714,warrior,arms,42,18,24
Дроктул,howling-fjord,1713,warrior,arms,90,44,46
Chucho,argent-dawn,1710,warrior,arms,42,23,19
Daredevìl,eredar,1707,warrior,arms,47,21,26
Grántor,eredar,1691,warrior,arms,42,29,13
Leethal,outland,1690,warrior,arms,36,20,16
Sharpen,chamber-of-aspects,1688,warrior,arms,56,24,32
Gatts,krasus,1687,warrior,arms,107,47,60
Mystylez,silvermoon,1684,warrior,arms,42,20,22
Nargez,outland,1682,warrior,arms,36,22,14
Дайбайхенд,howling-fjord,1681,warrior,arms,42,21,21
Поршекаен,howling-fjord,1680,warrior,arms,53,24,29
Аоетакси,soulflayer,1678,warrior,arms,66,34,32
Cazaril,kazzak,1678,warrior,arms,78,38,40
Ässholedamis,blackhand,1677,warrior,arms,36,25,11
Komissarecks,aegwynn,1676,warrior,arms,39,21,18
Noragrets,stormscale,1676,warrior,arms,36,19,17
Thyréc,blackmoore,1676,warrior,arms,48,24,24
Омепразол,gordunni,1672,warrior,arms,50,28,22
Гатсберсерк,gordunni,1672,warrior,arms,71,39,32
Scardrex,defias-brotherhood,1672,warrior,arms,42,19,23
Xendyo,frostmourne,1669,warrior,arms,84,38,46
Фенилэфрин,gordunni,1665,warrior,arms,60,32,28
Balltas,drakthul,1664,warrior,arms,50,26,24
Jakim,tarren-mill,1660,warrior,arms,48,26,22
Theryk,sanguino,1658,warrior,arms,53,21,32
Crandalius,kazzak,1657,warrior,arms,69,42,27
Oluwafunmila,tarren-mill,1657,warrior,arms,44,24,20
Maarshl,ysondre,1657,warrior,arms,49,26,23
Книфэк,howling-fjord,1656,warrior,arms,46,23,23
Киссмиплис,gordunni,1655,warrior,arms,57,29,28
Asquare,stormscale,1655,warrior,arms,40,18,22
Ragnou,tarren-mill,1653,warrior,arms,30,18,12
Yellowjuice,stormscale,1650,warrior,arms,72,45,27
Wardruine,dun-modr,1649,warrior,arms,47,22,25
Nikkí,naxxramas,1648,warrior,arms,42,21,21
Reccey,blackrock,1647,warrior,arms,69,31,38
Grkpwh,silvermoon,1646,warrior,arms,36,21,15
Lyes,uldaman,1640,warrior,arms,84,43,41
Ebonheart,argent-dawn,1640,warrior,arms,94,45,49
Blåvingad,kazzak,1639,warrior,arms,26,18,8
Atlizz,twisting-nether,1635,warrior,arms,78,41,37
Eselhirte,blackmoore,1632,warrior,arms,73,41,32
Flaãy,ravencrest,1631,warrior,arms,45,26,19
Vallahan,argent-dawn,1631,warrior,arms,84,42,42
Боссберс,soulflayer,1631,warrior,arms,48,22,26
Aeyon,burning-blade,1628,warrior,arms,27,18,9
Чпокерз,gordunni,1627,warrior,arms,30,20,10
Facestomper,onyxia,1627,warrior,arms,60,34,26
Poolboyx,tarren-mill,1625,warrior,arms,48,26,22
Watashilfy,ravencrest,1624,warrior,arms,48,24,24
Wlãð,archimonde,1624,warrior,arms,48,23,25
Gigasmash,pozzo-delleternità,1624,warrior,arms,42,20,22
Phalek,argent-dawn,1623,warrior,arms,36,20,16
Bigboomer,frostmane,1619,warrior,arms,42,17,25
Скварх,howling-fjord,1618,warrior,arms,24,17,7
Aeldran,argent-dawn,1617,warrior,arms,42,23,19
Karny,ravencrest,1616,warrior,arms,30,17,13
Gladius,ysera,1615,warrior,arms,86,43,43
Zexa,tarren-mill,1615,warrior,arms,36,17,19
Boldinq,ravencrest,1613,warrior,arms,48,20,28
Мелькорт,gordunni,1612,warrior,arms,24,17,7
Blackwólf,bloodhoof,1612,warrior,arms,76,37,39
Strife,ravencrest,1609,warrior,arms,81,51,30
Wismerx,kazzak,1609,warrior,arms,42,20,22
Javakt,stormscale,1609,warrior,arms,48,20,28
Whoosah,ragnaros,1608,warrior,arms,105,54,51
Jriddyzug,ravencrest,1608,warrior,arms,36,17,19
Kaieh,argent-dawn,1607,warrior,arms,30,17,13
Jambaz,ravencrest,1607,warrior,arms,47,23,24
Gucciwarrior,blackhand,1607,warrior,arms,42,17,25
Darksídex,silvermoon,1604,warrior,arms,74,41,33
Vratranzhul,kirin-tor,1602,warrior,arms,38,20,18
Naait,draenor,1600,warrior,arms,45,24,21
Хэлслэйтэр,gordunni,1600,warrior,arms,94,49,45
Asenine,sylvanas,1598,warrior,arms,58,24,34
Giganza,outland,1595,warrior,arms,60,27,33
Riptack,anetheron,1591,warrior,arms,74,43,31
Xgs,archimonde,1586,warrior,arms,59,28,31
Quotx,stormscale,1585,warrior,arms,46,18,28
Skrawarr,das-syndikat,1584,warrior,arms,78,41,37
Кладбошаа,gordunni,1582,warrior,arms,42,21,21
Khanox,twisting-nether,1580,warrior,arms,30,17,13
Киллдекс,gordunni,1578,warrior,arms,42,20,22
Мастерион,soulflayer,1577,warrior,arms,42,21,21
Гримг,lich-king,1575,warrior,arms,39,18,21
Оргнар,ashenvale,1573,warrior,arms,48,27,21
Varyian,sporeggar,1573,warrior,arms,60,27,33
Бодибилдерыч,gordunni,1572,warrior,arms,35,18,17
Monbun,silvermoon,1570,warrior,arms,95,48,47
Pajalousta,elune,1562,warrior,arms,74,36,38
Xiiver,burning-legion,1561,warrior,arms,32,21,11
Imfiñe,outland,1557,warrior,arms,65,30,35
Svënja,ysondre,1555,warrior,arms,54,24,30
Çon,ravencrest,1554,warrior,arms,54,26,28
Manoito,argent-dawn,1552,warrior,arms,36,18,18
Warmâchine,burning-legion,1551,warrior,arms,54,19,35
Pumpadzhîja,outland,1547,warrior,arms,48,25,23
Андреевич,blackscar,1547,warrior,arms,74,37,37
Шагах,soulflayer,1547,warrior,arms,65,28,37
Мэйрил,lich-king,1546,warrior,arms,184,97,87
Bastrick,argent-dawn,1544,warrior,arms,49,24,25
Untiltèd,ravencrest,1543,warrior,arms,47,37,10
Craghak,twisting-nether,1535,warrior,arms,42,23,19
Anakhas,archimonde,1535,warrior,arms,30,16,14
Dríx,hyjal,1534,warrior,arms,36,17,19
Seifcham,ragnaros,1533,warrior,arms,36,16,20
Hindbærsaft,stormscale,1532,warrior,arms,32,22,10
Lazytowl,outland,1532,warrior,arms,63,29,34
Áäáäáäáä,aegwynn,1529,warrior,arms,30,16,14
Оргрриммар,soulflayer,1528,warrior,arms,90,41,49
Btr,archimonde,1527,warrior,arms,36,16,20
Aestheticon,burning-blade,1526,warrior,arms,24,16,8
Endan,kelthuzad,1525,warrior,arms,57,36,21
Miko,ysondre,1524,warrior,arms,42,20,22
Picciocino,nemesis,1524,warrior,arms,36,16,20
Hasbullá,kazzak,1523,warrior,arms,32,17,15
Spijkerbroek,alakir,1522,warrior,arms,35,19,16
Zeddone,drakthul,1522,warrior,arms,30,16,14
Darshan,grim-batol,1522,warrior,arms,36,16,20
Norwegian,silvermoon,1521,warrior,arms,74,34,40
Aurélus,rexxar,1520,warrior,arms,30,20,10
Shownomercy,blackrock,1519,warrior,arms,48,23,25
Arcreign,kazzak,1519,warrior,arms,48,22,26
Штурмгешутц,deathweaver,1518,warrior,arms,66,33,33
Solezte,tarren-mill,1517,warrior,arms,42,23,19
Genjutsubeat,blackmoore,1516,warrior,arms,42,24,18
Spärtan,dun-modr,1515,warrior,arms,66,34,32
Wrynir,archimonde,1515,warrior,arms,36,17,19
Everdipper,outland,1515,warrior,arms,42,16,26
Nighat,sanguino,1511,warrior,arms,66,34,32
Krigipigi,antonidas,1511,warrior,arms,42,16,26
Wildblue,sylvanas,1510,warrior,arms,54,30,24
Напутанность,soulflayer,1509,warrior,arms,111,59,52
Anthalar,argent-dawn,1506,warrior,arms,36,16,20
Rîdler,ravencrest,1504,warrior,arms,97,47,50
Bruxus,blackhand,1504,warrior,arms,60,27,33
Slidmacka,twisting-nether,1504,warrior,arms,81,34,47
Divyx,tarren-mill,1503,warrior,arms,30,17,13
Ðezia,tarren-mill,1503,warrior,arms,42,20,22
Гуорг,howling-fjord,1498,warrior,arms,63,25,38
Friskos,dalaran,1492,warrior,arms,46,20,26
Shrekwarr,kazzak,1491,warrior,arms,47,21,26
Hôrn,stormscale,1489,warrior,arms,54,32,22
Hefthyn,sanguino,1488,warrior,arms,36,20,16
Asuramaru,aegwynn,1485,warrior,arms,35,20,15
Едигейй,gordunni,1485,warrior,arms,34,19,15
Icekissx,hyjal,1476,warrior,arms,64,31,33
Togas,silvermoon,1471,warrior,arms,42,22,20
Tmp,blackrock,1470,warrior,arms,42,22,20
Clellin,silvermoon,1469,warrior,arms,75,37,38
Арткес,gordunni,1468,warrior,arms,39,20,19
Reapo,blackhand,1467,warrior,arms,78,32,46
Tealbell,chamber-of-aspects,1462,warrior,arms,48,27,21
Notinfa,draenor,1460,warrior,arms,48,27,21
Qiz,silvermoon,1460,warrior,arms,92,51,41
Swefy,sanguino,1460,warrior,arms,49,22,27
Crriminal,ravencrest,1454,warrior,arms,42,17,25
Атаир,deathweaver,1452,warrior,arms,26,16,10
Dzvenyhora,darkspear,1449,warrior,arms,78,36,42
Taylorswifty,twisting-nether,1447,warrior,arms,42,27,15
Ajax,defias-brotherhood,1447,warrior,arms,36,16,20
Trenbullone,kazzak,1446,warrior,arms,45,28,17
Tyëlin,elune,1446,warrior,arms,54,27,27
Karimlebrave,hyjal,1440,warrior,arms,68,33,35
Gnømércy,stormscale,1439,warrior,arms,30,15,15
Klonyarik,ravencrest,1439,warrior,arms,30,15,15
Makerrw,ravencrest,1438,warrior,arms,50,26,24
Ardmoo,burning-legion,1437,warrior,arms,39,20,19
Gorocpt,doomhammer,1437,warrior,arms,38,18,20
Gravityfalls,blackmoore,1437,warrior,arms,42,18,24
Mazzkze,silvermoon,1436,warrior,arms,114,58,56
Alyx,mugthol,1436,warrior,arms,66,33,33
Pentagramlol,twisting-nether,1434,warrior,arms,36,15,21
Marcnky,stormscale,1433,warrior,arms,33,18,15
Оксенфурт,soulflayer,1433,warrior,arms,30,15,15
Gozga,twisting-nether,1433,warrior,arms,33,16,17
Chaddimus,draenor,1431,warrior,arms,24,15,9
Frozenliøn,twisting-nether,1431,warrior,arms,30,15,15
Alinash,aegwynn,1427,warrior,arms,51,24,27
Вуриор,howling-fjord,1426,warrior,arms,30,15,15
Bôlufonâ,dun-modr,1424,warrior,arms,30,15,15
Lachandrius,blackhand,1422,warrior,arms,48,20,28
Dárkhammer,tarren-mill,1421,warrior,arms,36,16,20
Zellxd,stormscale,1418,warrior,arms,36,20,16
Дообрыйшмель,soulflayer,1414,warrior,arms,45,28,17
Oruka,mannoroth,1412,warrior,arms,42,24,18
Vølverinwar,thrall,1412,warrior,arms,48,22,26
Erotixboi,blackrock,1411,warrior,arms,24,15,9
Espröc,kazzak,1407,warrior,arms,71,39,32
Флагмэн,gordunni,1406,warrior,arms,35,15,20
Вэшикх,soulflayer,1403,warrior,arms,29,17,12
Bjösk,stormscale,1403,warrior,arms,45,23,22
Северот,deepholm,1401,warrior,arms,35,16,19
Diz,terokkar,1400,warrior,arms,67,38,29
Gargaflike,aggra-português,1400,warrior,arms,48,15,33
Абабоба,gordunni,1398,warrior,arms,30,16,14
Джасткипинг,gordunni,1396,warrior,arms,42,24,18
Nekerka,burning-legion,1394,warrior,arms,65,33,32
Chakrator,la-croisade-écarlate,1393,warrior,arms,36,17,19
Hatefury,twisting-nether,1393,warrior,arms,42,19,23
Громпузан,galakrond,1393,warrior,arms,36,15,21
Dranush,onyxia,1391,warrior,arms,68,35,33
Pokopo,blackrock,1390,warrior,arms,149,72,77
Думхаммер,howling-fjord,1389,warrior,arms,24,15,9
Луновоин,gordunni,1387,warrior,arms,24,15,9
Carras,confrérie-du-thorium,1383,warrior,arms,53,22,31
Xaheld,blackrock,1376,warrior,arms,30,16,14
Ràgnarok,chogall,1373,warrior,arms,42,26,16
Bleckwarrior,ravencrest,1371,warrior,arms,78,39,39
Qvate,twisting-nether,1367,warrior,arms,41,20,21
Андэрс,gordunni,1363,warrior,arms,91,41,50
Temprament,ravencrest,1361,warrior,arms,30,18,12
Arreat,chogall,1361,warrior,arms,60,24,36
Arithael,dun-modr,1360,warrior,arms,42,21,21
Malalulu,burning-legion,1360,warrior,arms,44,19,25
Diástasi,twisting-nether,1353,warrior,arms,54,29,25
Nelthôr,alleria,1350,warrior,arms,59,29,30
Оморальный,soulflayer,1349,warrior,arms,71,32,39
Gorchak,blackmoore,1346,warrior,arms,77,35,42
Blîxtgordon,tarren-mill,1343,warrior,arms,24,14,10
Варгана,soulflayer,1343,warrior,arms,29,15,14
Belattor,silvermoon,1343,warrior,arms,30,14,16
Rbbx,tarren-mill,1342,warrior,arms,24,14,10
Bumoletroll,draenor,1342,warrior,arms,27,15,12
Ущипнузатитю,deathguard,1341,warrior,arms,30,14,16
Mortalfist,stormscale,1339,warrior,arms,24,14,10
Lollydhur,nemesis,1336,warrior,arms,18,14,4
Pivcuga,kazzak,1335,warrior,arms,36,14,22
Jigsar,argent-dawn,1333,warrior,arms,30,19,11
Morthôr,grim-batol,1330,warrior,arms,24,14,10
Behemothwr,kazzak,1327,warrior,arms,75,37,38
Мускулатор,soulflayer,1327,warrior,arms,36,15,21
Chádtóurps,drakthul,1326,warrior,arms,29,14,15
Highz,grim-batol,1324,warrior,arms,30,16,14
Phenowarri,blackhand,1324,warrior,arms,30,15,15
Ähäkutti,frostmane,1323,warrior,arms,36,20,16
Кэфтэмэ,soulflayer,1323,warrior,arms,51,24,27
Bigboyx,kazzak,1320,warrior,arms,32,17,15
Неосим,gordunni,1319,warrior,arms,24,15,9
Nucleargrab,twilights-hammer,1317,warrior,arms,52,22,30
Палачубийца,deathguard,1315,warrior,arms,24,15,9
Kmica,khadgar,1314,warrior,arms,61,27,34
Бурчун,deathguard,1311,warrior,arms,24,14,10
Neverkind,twisting-nether,1307,warrior,arms,66,37,29
Ðræms,eldrethalas,1303,warrior,arms,36,17,19
Bossít,doomhammer,1301,warrior,arms,80,44,36
Jisoowar,blackhand,1301,warrior,arms,36,17,19
Агамемнан,soulflayer,1300,warrior,arms,53,24,29
Hobo,ravencrest,1298,warrior,arms,29,14,15
Bonesz,jaedenar,1298,warrior,arms,34,16,18
Weareinspace,stormscale,1296,warrior,arms,34,18,16
Seliasbro,kazzak,1295,warrior,arms,30,15,15
Shooky,blackrock,1294,warrior,arms,23,14,9
Endeawour,ravencrest,1290,warrior,arms,30,18,12
Tiwâz,eredar,1283,warrior,arms,27,15,12
Гогрикк,ashenvale,1279,warrior,arms,72,35,37
Hellzint,sanguino,1263,warrior,arms,70,24,46
Unarde,silvermoon,1256,warrior,arms,82,40,42
Soulcleaver,stormreaver,1255,warrior,arms,44,23,21
Фелпир,soulflayer,1255,warrior,arms,42,15,27
Zaatar,draenor,1254,warrior,arms,36,17,19
Кентаныч,howling-fjord,1254,warrior,arms,48,22,26
Leroxius,ragnaros,1254,warrior,arms,54,22,32
Semmino,nemesis,1248,warrior,arms,24,13,11
Azudaddy,blackmoore,1245,warrior,arms,24,13,11
Einherjer,burning-legion,1244,warrior,arms,22,14,8
Morrzerk,sylvanas,1243,warrior,arms,23,14,9
Furukawa,ravencrest,1242,warrior,arms,24,13,11
Trashman,bronzebeard,1242,warrior,arms,24,13,11
Kelhim,blackrock,1242,warrior,arms,24,13,11
Caméltoe,frostwolf,1242,warrior,arms,30,13,17
Gonutz,sylvanas,1241,warrior,arms,24,13,11
Mfdoöm,draenor,1239,warrior,arms,30,13,17
Omgihithard,draenor,1238,warrior,arms,24,13,11
Colosius,stormscale,1236,warrior,arms,30,19,11
Funknîco,wrathbringer,1233,warrior,arms,37,19,18
Silabozija,ravencrest,1227,warrior,arms,48,22,26
Кизуми,gordunni,1227,warrior,arms,33,14,19
Элейд,thermaplugg,1225,warrior,arms,47,23,24
Solaría,garona,1222,warrior,arms,30,15,15
Kloppnîx,blackmoore,1221,warrior,arms,38,23,15
Ghostwarx,blackmoore,1215,warrior,arms,38,19,19
Kobeni,ysondre,1213,warrior,arms,23,13,10
Troma,archimonde,1213,warrior,arms,35,13,22
Ironsteve,blackmoore,1209,warrior,arms,60,20,40
Azëlls,archimonde,1207,warrior,arms,42,21,21
Malevolént,silvermoon,1207,warrior,arms,30,13,17
Beans,argent-dawn,1207,warrior,arms,36,13,23
Endermite,magtheridon,1205,warrior,arms,18,13,5
Aiarm,twisting-nether,1200,warrior,arms,48,31,17
Sekwar,twisting-nether,1200,warrior,arms,30,14,16
Mozterwar,ravencrest,1197,warrior,arms,60,25,35
Kugghalfswor,doomhammer,1196,warrior,arms,57,23,34
Xunaakt,nemesis,1193,warrior,arms,21,14,7
Rèâpèr,kazzak,1192,warrior,arms,36,24,12
Ordínaryname,blackrock,1186,warrior,arms,134,72,62
Pyret,outland,1185,warrior,arms,40,14,26
Excutíé,twisting-nether,1184,warrior,arms,24,15,9
Zhoti,outland,1181,warrior,arms,28,13,15
Nyxz,blackhand,1177,warrior,arms,26,13,13
Виднокрай,gordunni,1177,warrior,arms,36,13,23
Pacosky,burning-legion,1175,warrior,arms,23,13,10
Tarkosha,terokkar,1169,warrior,arms,69,24,45
Sistabossen,magtheridon,1165,warrior,arms,24,13,11
Regna,eredar,1156,warrior,arms,72,33,39
Belfodiris,stormscale,1152,warrior,arms,18,12,6
Istyos,hyjal,1152,warrior,arms,18,12,6
Therealman,kazzak,1152,warrior,arms,18,12,6
Connorzw,blackmoore,1152,warrior,arms,18,12,6
Azotz,archimonde,1152,warrior,arms,24,12,12
Dõxlol,kazzak,1152,warrior,arms,24,12,12
Cisataker,hyjal,1151,warrior,arms,12,12,0
Shookyx,ravencrest,1151,warrior,arms,18,12,6
Xurainzone,eredar,1151,warrior,arms,18,12,6
Otp,ravencrest,1151,warrior,arms,24,12,12
Saidi,outland,1151,warrior,arms,31,12,19
Chargeurface,ragnaros,1150,warrior,arms,18,12,6
Crazykind,kazzak,1150,warrior,arms,24,12,12
Downpipe,twisting-nether,1150,warrior,arms,24,12,12
Cassândrä,dalaran,1150,warrior,arms,30,12,18
Damagz,tarren-mill,1150,warrior,arms,30,12,18
Crushonyou,aegwynn,1149,warrior,arms,24,12,12
Nardoch,archimonde,1149,warrior,arms,30,12,18
Alexandrrior,rexxar,1149,warrior,arms,30,12,18
Arandyr,archimonde,1149,warrior,arms,30,12,18
ßigarms,ravencrest,1148,warrior,arms,18,12,6
Krew,drakthul,1148,warrior,arms,24,12,12
Tercio,exodar,1148,warrior,arms,30,14,16
Fizzywarrior,blackmoore,1147,warrior,arms,18,12,6
Trenôdeca,stormscale,1147,warrior,arms,24,12,12
Malebolia,mugthol,1147,warrior,arms,24,12,12
Белхэнд,soulflayer,1147,warrior,arms,36,12,24
Remen,archimonde,1147,warrior,arms,36,12,24
Neoh,onyxia,1146,warrior,arms,51,29,22
Ганблейд,eversong,1146,warrior,arms,24,12,12
Sloppychoppy,silvermoon,1142,warrior,arms,29,13,16
Brahlus,frostwolf,1142,warrior,arms,30,13,17
Скрежет,gordunni,1142,warrior,arms,30,12,18
Raznon,magtheridon,1140,warrior,arms,30,12,18
Mortalik,silvermoon,1138,warrior,arms,52,17,35
Eekz,haomarush,1132,warrior,arms,24,12,12
Газрош,howling-fjord,1130,warrior,arms,28,14,14
Thisguyfax,the-venture-co,1129,warrior,arms,24,12,12
Draleckx,sanguino,1128,warrior,arms,36,13,23
Tajiri,alakir,1126,warrior,arms,64,32,32
Фикпопадешь,lich-king,1124,warrior,arms,39,13,26
Yüle,uldaman,1121,warrior,arms,30,15,15
Zool,madmortem,1120,warrior,arms,30,12,18
Ferpylél,ragnaros,1119,warrior,arms,25,13,12
Lûxn,silvermoon,1117,warrior,arms,78,34,44
Миранир,soulflayer,1116,warrior,arms,28,15,13
Wyshh,silvermoon,1113,warrior,arms,41,16,25
Kerisandra,silvermoon,1112,warrior,arms,25,14,11
Dreamkil,archimonde,1111,warrior,arms,38,16,22
Рестат,soulflayer,1106,warrior,arms,35,12,23
ßladex,azshara,1105,warrior,arms,17,12,5
Doveloo,kazzak,1102,warrior,arms,30,15,15
Argadea,archimonde,1102,warrior,arms,36,15,21
Sûgma,blackhand,1099,warrior,arms,32,17,15
Mélindà,silvermoon,1098,warrior,arms,15,12,3
Хазгора,howling-fjord,1096,warrior,arms,30,13,17
Дрейтон,eversong,1095,warrior,arms,30,13,17
Perykø,sanguino,1094,warrior,arms,34,12,22
Копенгаген,ashenvale,1091,warrior,arms,27,13,14
Krigsdunken,draenor,1080,warrior,arms,42,13,29
Jonalina,gilneas,1076,warrior,arms,78,36,42
Шорпит,howling-fjord,1065,warrior,arms,30,12,18
Áosr,ravencrest,1057,warrior,arms,47,24,23
Klnrk,ravencrest,1056,warrior,arms,18,11,7
Greenblób,kazzak,1056,warrior,arms,18,11,7
Rexonawarr,kazzak,1056,warrior,arms,18,11,7
Êphêý,kazzak,1056,warrior,arms,24,11,13
Анархорок,howling-fjord,1055,warrior,arms,18,11,7
Westwyde,hyjal,1055,warrior,arms,18,11,7
Gguts,archimonde,1055,warrior,arms,18,11,7
Sanerion,antonidas,1055,warrior,arms,18,11,7
Шурпач,deathguard,1055,warrior,arms,24,11,13
Scormash,burning-legion,1055,warrior,arms,24,11,13
Erikeverhard,nathrezim,1055,warrior,arms,24,11,13
Markorok,kazzak,1054,warrior,arms,18,11,7
Aemox,silvermoon,1054,warrior,arms,18,11,7
Râmi,perenolde,1054,warrior,arms,24,11,13
Jasperr,nemesis,1054,warrior,arms,31,13,18
Apollos,der-mithrilorden,1054,warrior,arms,30,11,19
Aizy,blackhand,1053,warrior,arms,18,11,7
Cyruk,blackmoore,1053,warrior,arms,30,11,19
Scusi,burning-blade,1053,warrior,arms,30,11,19
Orgi,drakthul,1053,warrior,arms,30,11,19
Mckinseybcg,outland,1052,warrior,arms,18,11,7
Ormert,sylvanas,1052,warrior,arms,22,12,10
Deviousjr,ragnaros,1051,warrior,arms,18,11,7
Informatica,doomhammer,1051,warrior,arms,18,11,7
Jumbodolmen,tarren-mill,1051,warrior,arms,18,11,7
Nameless,ysondre,1051,warrior,arms,24,11,13
Leomance,hyjal,1050,warrior,arms,18,11,7
Røiivar,hyjal,1050,warrior,arms,66,22,44
Mograinê,blackmoore,1049,warrior,arms,18,11,7
Zosska,burning-legion,1049,warrior,arms,24,11,13
Staribrko,outland,1049,warrior,arms,30,11,19
Дикийппц,gordunni,1046,warrior,arms,18,11,7
Batalius,dalaran,1046,warrior,arms,24,11,13
Perkoulator,archimonde,1041,warrior,arms,30,11,19
Nokturnâl,silvermoon,1037,warrior,arms,18,11,7
Степанычь,gordunni,1034,warrior,arms,24,11,13
Katzz,dun-morogh,1031,warrior,arms,24,11,13
Mañtís,argent-dawn,1025,warrior,arms,30,12,18
Cherserker,ragnaros,1022,warrior,arms,16,12,4
Draktul,aegwynn,1020,warrior,arms,18,11,7
Blayr,tarren-mill,1019,warrior,arms,35,11,24
Инелутабл,eversong,1017,warrior,arms,17,11,6
Odonko,blackmoore,1012,warrior,arms,18,11,7
Роккар,gordunni,1012,warrior,arms,24,11,13
Thenx,tarren-mill,1008,warrior,arms,27,12,15
Merdé,blackhand,1007,warrior,arms,90,43,47
Rumer,tarren-mill,1006,warrior,arms,23,11,12
Batïk,blackmoore,1000,warrior,arms,25,12,13
Sertigan,dun-modr,996,warrior,arms,33,13,20
Ovcharq,steamwheedle-cartel,994,warrior,arms,23,11,12
Zeroskllz,outland,994,warrior,arms,23,11,12
Obscurìa,argent-dawn,987,warrior,arms,36,11,25
Chilp,archimonde,981,warrior,arms,25,12,13
Зед,blackscar,977,warrior,arms,25,13,12
Ordwinz,silvermoon,970,warrior,arms,19,11,8
Bigschnäbi,blackhand,960,warrior,arms,12,10,2
Абырабыр,howling-fjord,960,warrior,arms,12,10,2
Wintertimex,stormscale,960,warrior,arms,12,10,2
Kurbá,stormscale,960,warrior,arms,12,10,2
Олдборовс,soulflayer,960,warrior,arms,18,10,8
Joeférnandes,ragnaros,960,warrior,arms,18,10,8
Broarextiger,ragnaros,960,warrior,arms,18,10,8
Proeliator,argent-dawn,960,warrior,arms,18,10,8
Элетий,soulflayer,960,warrior,arms,24,10,14
Immørtálx,tarren-mill,960,warrior,arms,24,10,14
Trapoulas,kazzak,960,warrior,arms,30,10,20
Воинлета,howling-fjord,959,warrior,arms,12,10,2
Ckz,ysondre,959,warrior,arms,12,10,2
Zdi,blackrock,959,warrior,arms,18,10,8
Toroespaña,draenor,959,warrior,arms,18,10,8
Fearmedear,sylvanas,959,warrior,arms,18,10,8
Rookian,blackrock,959,warrior,arms,18,10,8
Badwarr,blackhand,959,warrior,arms,18,10,8
Enzja,nazjatar,959,warrior,arms,24,10,14
Дугмар,gordunni,959,warrior,arms,24,10,14
Ðiscordia,blackhand,959,warrior,arms,30,10,20
Tahzwolf,stormscale,958,warrior,arms,12,10,2
Haanok,ravencrest,958,warrior,arms,18,10,8
Nøcturnaqq,silvermoon,958,warrior,arms,18,10,8
Vymd,archimonde,958,warrior,arms,28,11,17
Kilsorrow,silvermoon,957,warrior,arms,24,10,14
Tazkax,archimonde,956,warrior,arms,18,10,8
Hellrokk,drakthul,954,warrior,arms,18,10,8
Ayelsyssup,silvermoon,954,warrior,arms,24,10,14
Guruntar,kirin-tor,953,warrior,arms,24,10,14
Скользкийбро,gordunni,953,warrior,arms,24,10,14
Geicoo,dalaran,952,warrior,arms,30,15,15
Warriornrv,ysondre,950,warrior,arms,18,10,8
Plt,talnivarr,948,warrior,arms,16,11,5
Bòónki,ravencrest,948,warrior,arms,40,17,23
Axedingus,tarren-mill,947,warrior,arms,18,10,8
Adrï,draenor,947,warrior,arms,40,21,19
Balyndâ,aegwynn,945,warrior,arms,20,10,10
Mågne,tarren-mill,939,warrior,arms,30,10,20
Aggamemnus,ravencrest,929,warrior,arms,19,11,8
Philatou,antonidas,926,warrior,arms,17,10,7
Shavoi,die-aldor,926,warrior,arms,29,10,19
Dearmooses,stormscale,919,warrior,arms,30,15,15
Matti,magtheridon,911,warrior,arms,17,10,7
Apacolata,outland,895,warrior,arms,23,10,13
Ispor,shattered-halls,887,warrior,arms,47,24,23
Рагнарульв,gordunni,885,warrior,arms,14,10,4
Дотрен,galakrond,883,warrior,arms,42,20,22
Antraex,zuljin,876,warrior,arms,19,10,9
Oralinde,silvermoon,865,warrior,arms,30,14,16
Oldchap,nordrassil,864,warrior,arms,12,9,3
Schwän,twisting-nether,864,warrior,arms,12,9,3
Мираккл,borean-tundra,864,warrior,arms,12,9,3
Samîr,arthas,864,warrior,arms,12,9,3
Skädy,dun-modr,864,warrior,arms,12,9,3
Preliator,outland,864,warrior,arms,12,9,3
Antìcìdè,ravencrest,864,warrior,arms,12,9,3
Selenez,outland,864,warrior,arms,18,9,9
Flinta,blackmoore,864,warrior,arms,18,9,9
Mirageous,tarren-mill,864,warrior,arms,18,9,9
Brutilda,antonidas,864,warrior,arms,18,9,9
Quadfather,kazzak,864,warrior,arms,18,9,9
Qtcockxx,stormscale,864,warrior,arms,18,9,9
Nassir,stormscale,864,warrior,arms,18,9,9
Cleaver,tarren-mill,864,warrior,arms,18,9,9
Renwíck,burning-legion,864,warrior,arms,18,9,9
Puremëtal,silvermoon,864,warrior,arms,18,9,9
Meistersykes,silvermoon,864,warrior,arms,18,9,9
Oplarxigos,kazzak,864,warrior,arms,24,9,15
Vôx,sylvanas,864,warrior,arms,24,9,15
Xåb,dun-morogh,864,warrior,arms,24,9,15
Konebankærn,ravencrest,864,warrior,arms,24,9,15
Hortswarr,drakthul,863,warrior,arms,12,9,3
Lpa,stormscale,863,warrior,arms,12,9,3
Garwarr,twisting-nether,863,warrior,arms,12,9,3
Kantarion,stormscale,863,warrior,arms,18,9,9
Сэлфиш,lich-king,863,warrior,arms,18,9,9
Velinde,outland,863,warrior,arms,18,9,9
Saofang,twisting-nether,863,warrior,arms,18,9,9
Mllmmxxm,kargath,863,warrior,arms,18,9,9
Seraphys,ravencrest,863,warrior,arms,18,9,9
Дейниксис,howling-fjord,863,warrior,arms,18,9,9
Serastul,rajaxx,863,warrior,arms,18,9,9
Swayzze,frostwolf,863,warrior,arms,24,9,15
Лисерк,howling-fjord,863,warrior,arms,24,9,15
Rakuna,tarren-mill,863,warrior,arms,24,9,15
Grumpy,lightbringer,863,warrior,arms,24,9,15
Hradball,twilights-hammer,862,warrior,arms,18,9,9
Gacel,dun-modr,862,warrior,arms,18,9,9
Scrèàm,tarren-mill,862,warrior,arms,18,9,9
Rodenet,dun-modr,862,warrior,arms,18,9,9
Démigodx,stormscale,862,warrior,arms,24,9,15
Баварриор,greymane,862,warrior,arms,24,9,15
Jáson,kazzak,861,warrior,arms,24,9,15
Woopzi,twisting-nether,860,warrior,arms,36,9,27
Synrosh,hyjal,859,warrior,arms,18,9,9
Kval,kazzak,858,warrior,arms,18,9,9
Karden,doomhammer,858,warrior,arms,24,9,15
Garosh,drakthul,857,warrior,arms,18,9,9
Варбыкмашина,howling-fjord,857,warrior,arms,18,9,9
Безбожник,eversong,857,warrior,arms,18,9,9
Pawn,twisting-nether,857,warrior,arms,24,9,15
Dirtyjoe,khaz-modan,855,warrior,arms,25,9,16
Nøiir,malfurion,854,warrior,arms,18,9,9
Ruga,echsenkessel,846,warrior,arms,21,11,10
Luunk,ravencrest,846,warrior,arms,24,9,15
Inelegant,tarren-mill,840,warrior,arms,18,10,8
Sanhaevel,ravencrest,838,warrior,arms,21,10,11
Punishers,ysondre,825,warrior,arms,90,35,55
Actuallyorc,twisting-nether,799,warrior,arms,14,9,5
Vyctimz,ravencrest,799,warrior,arms,16,9,7
Sýkz,exodar,799,warrior,arms,17,9,8
Paranoiás,ragnaros,799,warrior,arms,20,9,11
Finalsmasher,thrall,798,warrior,arms,36,14,22
Bumbx,kazzak,796,warrior,arms,14,9,5
Astven,blackmoore,784,warrior,arms,19,9,10
Crîxús,silvermoon,768,warrior,arms,12,8,4
Wasro,norgannon,768,warrior,arms,12,8,4
Ballin,dragonblight,768,warrior,arms,12,8,4
Littlebugger,ravencrest,768,warrior,arms,12,8,4
Psinovich,sylvanas,768,warrior,arms,12,8,4
Bulfwart,zuljin,768,warrior,arms,12,8,4
Muyubu,eredar,768,warrior,arms,12,8,4
Dataçasé,silvermoon,768,warrior,arms,12,8,4
Иктиннос,gordunni,768,warrior,arms,12,8,4
Colard,ravencrest,768,warrior,arms,18,8,10
Grimlok,sylvanas,768,warrior,arms,18,8,10
Visari,kiljaeden,768,warrior,arms,18,8,10
Aauv,twisting-nether,768,warrior,arms,18,8,10
Avelyr,pozzo-delleternità,768,warrior,arms,18,8,10
Vlorgboi,drakthul,768,warrior,arms,18,8,10
Kupr,outland,768,warrior,arms,18,8,10
Сладкаяхурма,howling-fjord,768,warrior,arms,18,8,10
Jínro,draenor,768,warrior,arms,18,8,10
Xanatos,khazgoroth,768,warrior,arms,18,8,10
Micromachine,argent-dawn,768,warrior,arms,24,8,16
Уэсгар,blackscar,768,warrior,arms,24,8,16
Sindrener,ysondre,768,warrior,arms,24,8,16
Daýz,draenor,768,warrior,arms,24,8,16
Yoilenno,argent-dawn,767,warrior,arms,12,8,4
Bládez,ravencrest,767,warrior,arms,12,8,4
Mkazy,kirin-tor,767,warrior,arms,12,8,4
Chrekk,khaz-modan,767,warrior,arms,18,8,10
Akim,ysondre,767,warrior,arms,18,8,10
Øfè,ysondre,767,warrior,arms,18,8,10
Адво,gordunni,767,warrior,arms,18,8,10
Utero,drakthul,767,warrior,arms,18,8,10
Lrb,tarren-mill,767,warrior,arms,18,8,10
Dragão,kazzak,767,warrior,arms,18,8,10
Ronoh,kazzak,767,warrior,arms,18,8,10
Каутто,howling-fjord,767,warrior,arms,18,8,10
Horseye,eredar,767,warrior,arms,18,8,10
Ôwndbylx,aegwynn,767,warrior,arms,21,9,12
Spargebuci,draenor,767,warrior,arms,24,8,16
Cléàvage,silvermoon,767,warrior,arms,24,8,16
Ryle,anubarak,767,warrior,arms,30,8,22
Bxnx,aegwynn,766,warrior,arms,12,8,4
Ènteqt,antonidas,766,warrior,arms,12,8,4
Zandawar,drakthul,766,warrior,arms,12,8,4
Savh,silvermoon,766,warrior,arms,18,8,10
Taurosk,burning-legion,766,warrior,arms,18,8,10
Arkcules,ghostlands,766,warrior,arms,18,8,10
Dokô,twisting-nether,766,warrior,arms,24,8,16
Opseagull,defias-brotherhood,765,warrior,arms,12,8,4
Галактозар,soulflayer,763,warrior,arms,24,8,16
Whàtsup,stormscale,762,warrior,arms,18,8,10
Korvjnus,burning-blade,762,warrior,arms,18,8,10
Chipstjuven,tarren-mill,761,warrior,arms,13,8,5
Joka,dun-modr,761,warrior,arms,19,10,9
Øruch,draenor,761,warrior,arms,18,8,10
Warsky,archimonde,751,warrior,arms,12,8,4
Kixx,twisting-nether,748,warrior,arms,12,8,4
Кофесмолоком,ashenvale,735,warrior,arms,29,8,21
Pangowar,elune,720,warrior,arms,15,8,7
Durmithor,silvermoon,719,warrior,arms,29,8,21
Quarantino,ysondre,714,warrior,arms,17,8,9
Tazdingowar,antonidas,703,warrior,arms,16,8,8
Soundso,blackmoore,701,warrior,arms,14,8,6
Xiennas,stormscale,679,warrior,arms,19,9,10
Сика,blackscar,672,warrior,arms,12,7,5
Urasli,doomhammer,672,warrior,arms,12,7,5
Devìlscandy,stormscale,672,warrior,arms,12,7,5
Trilon,blackrock,672,warrior,arms,12,7,5
Biscuitoliva,hyjal,672,warrior,arms,12,7,5
Azarek,blackmoore,672,warrior,arms,12,7,5
Jenkinzz,stormscale,672,warrior,arms,12,7,5
Klearr,silvermoon,672,warrior,arms,12,7,5
Ozrenac,kazzak,672,warrior,arms,12,7,5
Tenvee,outland,672,warrior,arms,12,7,5
Boonur,arthas,672,warrior,arms,12,7,5
Dréngr,blackrock,672,warrior,arms,12,7,5
Brogre,stormrage,672,warrior,arms,12,7,5
Èzekiel,dalaran,672,warrior,arms,12,7,5
Antïsøcial,thrall,672,warrior,arms,12,7,5
Æriø,dalaran,672,warrior,arms,12,7,5
Malgár,argent-dawn,672,warrior,arms,12,7,5
Fiverare,stormscale,672,warrior,arms,12,7,5
Трэйдар,blackscar,672,warrior,arms,12,7,5
Bloodbrother,blackmoore,672,warrior,arms,12,7,5
Ødên,frostmane,672,warrior,arms,12,7,5
Midnightrain,archimonde,672,warrior,arms,12,7,5
Shaw,twisting-nether,672,warrior,arms,12,7,5
Ràkar,stormscale,672,warrior,arms,12,7,5
Huscar,thrall,672,warrior,arms,12,7,5
Хашонвар,gordunni,672,warrior,arms,12,7,5
Crøwñd,twisting-nether,672,warrior,arms,12,7,5
Марльин,howling-fjord,672,warrior,arms,12,7,5
Yelanx,twisting-nether,672,warrior,arms,12,7,5
Sickjackenx,executus,672,warrior,arms,12,7,5
Kamilfury,burning-legion,672,warrior,arms,16,8,8
Warrieron,stormscale,672,warrior,arms,18,7,11
Lusan,sylvanas,672,warrior,arms,18,7,11
Mezugzugyou,draenor,672,warrior,arms,18,7,11
Yeahq,kazzak,672,warrior,arms,18,7,11
Klonyarika,ravencrest,672,warrior,arms,18,7,11
Jeonsoyeon,argent-dawn,672,warrior,arms,18,7,11
Tinkaton,sylvanas,672,warrior,arms,18,7,11
Messermozart,blackmoore,672,warrior,arms,18,7,11
Europ,silvermoon,672,warrior,arms,18,7,11
Twoonewin,ragnaros,672,warrior,arms,18,7,11
Thundersword,sylvanas,672,warrior,arms,24,7,17
Elyalol,ragnaros,671,warrior,arms,12,7,5
Когарт,gordunni,671,warrior,arms,12,7,5
Rawne,kirin-tor,671,warrior,arms,12,7,5
Fluxerella,azjolnerub,671,warrior,arms,12,7,5
Гардринг,howling-fjord,671,warrior,arms,12,7,5
Wolfgladius,cthun,671,warrior,arms,12,7,5
Téldrus,blackrock,671,warrior,arms,12,7,5
Dukhe,sanguino,671,warrior,arms,12,7,5
Lågærtha,blackmoore,671,warrior,arms,12,7,5
Schneklinge,blutkessel,671,warrior,arms,12,7,5
Pakusrage,defias-brotherhood,671,warrior,arms,18,7,11
Tempii,ragnaros,671,warrior,arms,18,7,11
Kishkamen,ravencrest,671,warrior,arms,18,7,11
Tontonsmoky,hyjal,671,warrior,arms,18,7,11
Бубаигавар,gordunni,671,warrior,arms,24,7,17
Bigbaduglyy,twisting-nether,671,warrior,arms,24,7,17
Kilsera,blackmoore,670,warrior,arms,12,7,5
Grunwi,burning-legion,670,warrior,arms,12,7,5
Jackycoke,blackhand,670,warrior,arms,18,7,11
Фастод,greymane,669,warrior,arms,12,7,5
Infusione,nemesis,669,warrior,arms,12,7,5
Lø,chogall,669,warrior,arms,20,7,13
Inticam,durotan,667,warrior,arms,12,7,5
Papati,twisting-nether,667,warrior,arms,18,7,11
Bubciu,burning-legion,667,warrior,arms,24,7,17
Teraa,the-maelstrom,666,warrior,arms,12,7,5
Дедсдрыном,howling-fjord,654,warrior,arms,17,7,10
Furanos,blackrock,639,warrior,arms,11,7,4
Ajgreedy,grim-batol,639,warrior,arms,17,7,10
Broarexlion,ragnaros,639,warrior,arms,17,7,10
Набосуюногу,gordunni,623,warrior,arms,17,7,10
Facepálm,kazzak,607,warrior,arms,14,7,7
Szelenamoon,outland,607,warrior,arms,14,7,7
Matatorero,uldum,607,warrior,arms,16,7,9
Piccante,nemesis,576,warrior,arms,6,6,0
Искристый,howling-fjord,576,warrior,arms,6,6,0
Нерморрог,howling-fjord,576,warrior,arms,6,6,0
Irén,hellfire,576,warrior,arms,12,6,6
Eyeslicer,quelthalas,576,warrior,arms,12,6,6
Reacôn,twisting-nether,576,warrior,arms,12,6,6
Hycate,blackrock,576,warrior,arms,12,6,6
Jøtawarrior,sanguino,576,warrior,arms,12,6,6
Toqk,draenor,576,warrior,arms,12,6,6
Ïnahö,hyjal,576,warrior,arms,12,6,6
Skaylulz,ragnaros,576,warrior,arms,12,6,6
Laavapoeg,outland,576,warrior,arms,12,6,6
Borndet,eredar,576,warrior,arms,12,6,6
Civok,kult-der-verdammten,576,warrior,arms,12,6,6
Pitii,burning-legion,576,warrior,arms,12,6,6
Sydre,nerathor,576,warrior,arms,12,6,6
Majestatix,doomhammer,576,warrior,arms,12,6,6
Долирия,gordunni,576,warrior,arms,12,6,6
Данзетар,howling-fjord,576,warrior,arms,12,6,6
Bekkey,lightbringer,576,warrior,arms,12,6,6
Малаятварь,gordunni,576,warrior,arms,12,6,6
Goringbame,draenor,576,warrior,arms,12,6,6
Fookyoup,stormscale,576,warrior,arms,12,6,6
Mljecho,kazzak,576,warrior,arms,12,6,6
Àlexander,ravencrest,576,warrior,arms,12,6,6
Beamis,ragnaros,576,warrior,arms,12,6,6
Брок,soulflayer,576,warrior,arms,12,6,6
Арбузикхаха,soulflayer,576,warrior,arms,12,6,6
Folsack,sanguino,576,warrior,arms,12,6,6
Nexpwns,blackhand,576,warrior,arms,12,6,6
Grezlyk,drakthul,576,warrior,arms,12,6,6
Darkseid,burning-legion,576,warrior,arms,12,6,6
Кхаррнн,gordunni,576,warrior,arms,12,6,6
Donquiexote,ravencrest,576,warrior,arms,12,6,6
Jengaa,draenor,576,warrior,arms,12,6,6
Rakhaldin,blackhand,576,warrior,arms,12,6,6
Fluffycute,blackhand,576,warrior,arms,12,6,6
Bigdamtosco,ravencrest,576,warrior,arms,12,6,6
Dafok,rashgarroth,576,warrior,arms,12,6,6
Nedåh,blackrock,576,warrior,arms,12,6,6
Teronth,burning-legion,576,warrior,arms,12,6,6
Josem,sanguino,576,warrior,arms,12,6,6
Slám,burning-legion,576,warrior,arms,12,6,6
Bigboibeeper,draenor,576,warrior,arms,12,6,6
Nørst,draenor,576,warrior,arms,12,6,6
Jaythegodx,blackrock,576,warrior,arms,12,6,6
Knî,archimonde,576,warrior,arms,12,6,6
Tddyy,silvermoon,576,warrior,arms,12,6,6
Gíu,blackhand,576,warrior,arms,12,6,6
Bordi,nemesis,576,warrior,arms,12,6,6
Дейдулус,soulflayer,576,warrior,arms,18,6,12
Autumnfálls,kazzak,576,warrior,arms,18,6,12
Kímó,silvermoon,576,warrior,arms,18,6,12
Jokkul,tarren-mill,576,warrior,arms,18,6,12
Buntstift,thrall,576,warrior,arms,18,6,12
Hazzaogx,draenor,576,warrior,arms,18,6,12
Jeriko,archimonde,576,warrior,arms,18,6,12
Hellespont,hellscream,576,warrior,arms,18,6,12
Zirêael,kazzak,576,warrior,arms,24,6,18
Gôrilla,kazzak,576,warrior,arms,24,6,18
Chillycheesy,blackmoore,576,warrior,arms,24,6,18
Thiccrich,argent-dawn,575,warrior,arms,6,6,0
Pesroc,blackmoore,575,warrior,arms,9,7,2
Акози,fordragon,575,warrior,arms,12,6,6
Nixtor,defias-brotherhood,575,warrior,arms,12,6,6
Kirowarrior,silvermoon,575,warrior,arms,12,6,6
Critycall,drakthul,575,warrior,arms,12,6,6
Ràgnàmetàl,tarren-mill,575,warrior,arms,12,6,6
Wärfäcë,blades-edge,575,warrior,arms,12,6,6
Lebronjones,sylvanas,575,warrior,arms,12,6,6
Giggadaddy,tarren-mill,575,warrior,arms,12,6,6
Zutto,conseil-des-ombres,575,warrior,arms,12,6,6
Shuraj,hyjal,575,warrior,arms,16,6,10
Nicperh,dun-modr,575,warrior,arms,18,6,12
Reider,kazzak,575,warrior,arms,18,6,12
Átlás,blackmoore,575,warrior,arms,18,6,12
Gervvand,burning-legion,575,warrior,arms,18,6,12
Aliasus,outland,575,warrior,arms,18,6,12
Slaughteredd,kazzak,575,warrior,arms,18,6,12
Kosttya,argent-dawn,575,warrior,arms,18,6,12
Goldins,drakthul,575,warrior,arms,18,6,12
Zzeed,auchindoun,575,warrior,arms,24,6,18
Gnuhl,eredar,574,warrior,arms,15,7,8
Pips,minahonda,574,warrior,arms,24,6,18
Maggisauce,aegwynn,572,warrior,arms,12,6,6
Raldjorn,hyjal,571,warrior,arms,12,6,6
Dariusvolt,argent-dawn,571,warrior,arms,12,6,6
Unkmòr,pozzo-delleternità,568,warrior,arms,12,6,6
Ахиллслэм,howling-fjord,559,warrior,arms,17,6,11
Cutting,burning-legion,543,warrior,arms,11,6,5
Ganik,malganis,543,warrior,arms,11,6,5
Kåñéthy,outland,528,warrior,arms,15,7,8
Reapersrage,twisting-nether,528,warrior,arms,15,6,9
Imabeatyoass,kazzak,527,warrior,arms,11,6,5
Ragnacore,ravencrest,526,warrior,arms,11,6,5
Брамон,gordunni,512,warrior,arms,10,6,4
Megtorló,ragnaros,512,warrior,arms,16,6,10
Murp,lightnings-blade,480,warrior,arms,6,5,1
Арсон,soulflayer,480,warrior,arms,6,5,1
Zaedt,tarren-mill,480,warrior,arms,6,5,1
Орданис,deathguard,480,warrior,arms,6,5,1
Remylacroix,blackrock,480,warrior,arms,6,5,1
Smoothbrian,ravencrest,480,warrior,arms,6,5,1
Chadsmorc,twisting-nether,480,warrior,arms,6,5,1
Skorm,mugthol,480,warrior,arms,6,5,1
Mertik,twisting-nether,480,warrior,arms,6,5,1
Himarsenko,silvermoon,480,warrior,arms,6,5,1
Ønogal,archimonde,480,warrior,arms,6,5,1
Johnmeadows,ravencrest,480,warrior,arms,6,5,1
Liked,tarren-mill,480,warrior,arms,6,5,1
Maniackz,tarren-mill,480,warrior,arms,6,5,1
Zelwar,drakthul,480,warrior,arms,6,5,1
Lurion,malganis,480,warrior,arms,6,5,1
Kanté,burning-blade,480,warrior,arms,6,5,1
Warbringer,burning-blade,480,warrior,arms,6,5,1
Radîtz,blackmoore,480,warrior,arms,6,5,1
Tørrminator,stormscale,480,warrior,arms,6,5,1
Eidzø,tarren-mill,480,warrior,arms,6,5,1
Rockygifll,sinstralis,480,warrior,arms,6,5,1
Woobaby,outland,480,warrior,arms,6,5,1
Bashuk,grim-batol,480,warrior,arms,6,5,1
Tekmali,archimonde,480,warrior,arms,6,5,1
Гневныйвиги,howling-fjord,480,warrior,arms,6,5,1
Zaerna,draenor,480,warrior,arms,6,5,1
Wazraf,khaz-modan,480,warrior,arms,6,5,1
Соловейч,howling-fjord,480,warrior,arms,6,5,1
Warriovar,draenor,480,warrior,arms,6,5,1
Бокалпивка,soulflayer,480,warrior,arms,9,6,3
Maisner,stormscale,480,warrior,arms,9,6,3
Бейлеор,gordunni,480,warrior,arms,12,5,7
Dmgsponge,stormscale,480,warrior,arms,12,5,7
Древилгод,gordunni,480,warrior,arms,12,5,7
Lüund,ravencrest,480,warrior,arms,12,5,7
Ylana,eldrethalas,480,warrior,arms,12,5,7
Vikktor,doomhammer,480,warrior,arms,12,5,7
Anahkas,archimonde,480,warrior,arms,12,5,7
Warhero,burning-legion,480,warrior,arms,12,5,7
Budwise,stormscale,480,warrior,arms,12,5,7
Sefty,tarren-mill,480,warrior,arms,12,5,7
Síúkanto,blackrock,480,warrior,arms,12,5,7
Whiteowlx,argent-dawn,480,warrior,arms,12,5,7
Klonyarikjr,ravencrest,480,warrior,arms,12,5,7
Zirriox,wildhammer,480,warrior,arms,12,5,7
Земибор,soulflayer,480,warrior,arms,12,5,7
Лилиофанныч,soulflayer,480,warrior,arms,12,5,7
Gely,silvermoon,480,warrior,arms,12,5,7
Thomasman,nerathor,480,warrior,arms,12,5,7
Nightclaimer,pozzo-delleternità,480,warrior,arms,12,5,7
Banîsher,drakthul,480,warrior,arms,12,5,7
Rowr,argent-dawn,480,warrior,arms,12,5,7
Mazaharine,archimonde,480,warrior,arms,12,5,7
Ragestarved,ragnaros,480,warrior,arms,12,5,7
Roponmatsu,draenor,480,warrior,arms,12,5,7
Apacho,outland,480,warrior,arms,12,5,7
Buckiesøde,twisting-nether,480,warrior,arms,12,5,7
Taikyokuken,hyjal,480,warrior,arms,12,5,7
Ràgê,silvermoon,480,warrior,arms,12,5,7
Luxurious,argent-dawn,480,warrior,arms,12,5,7
Sinbuay,malygos,480,warrior,arms,12,5,7
Spártacus,kazzak,480,warrior,arms,12,5,7
Oplix,antonidas,480,warrior,arms,12,5,7
Huxies,draenor,480,warrior,arms,12,5,7
Bacioleggero,nemesis,480,warrior,arms,12,5,7
Victôr,silvermoon,480,warrior,arms,12,5,7
Cramatao,shadowsong,480,warrior,arms,12,5,7
Dortenz,ragnaros,480,warrior,arms,12,5,7
Màb,antonidas,480,warrior,arms,12,5,7
Bàrbandit,archimonde,480,warrior,arms,12,5,7
Mesmash,uldum,480,warrior,arms,12,5,7
Джондо,gordunni,480,warrior,arms,12,5,7
Binsaueramk,ravencrest,480,warrior,arms,12,5,7
Anaxiam,drakthul,480,warrior,arms,12,5,7
Succel,drakthul,480,warrior,arms,12,5,7
Keäghan,kazzak,480,warrior,arms,12,5,7
Whysobold,quelthalas,480,warrior,arms,12,5,7
Stormfist,tarren-mill,480,warrior,arms,12,5,7
Шифик,soulflayer,480,warrior,arms,12,5,7
Najjs,eredar,480,warrior,arms,12,5,7
Vøidwalker,ragnaros,480,warrior,arms,12,5,7
Тевивар,gordunni,480,warrior,arms,12,5,7
Arakhu,blackmoore,480,warrior,arms,12,5,7
Tenthøusand,sylvanas,480,warrior,arms,12,5,7
Vhy,antonidas,480,warrior,arms,13,5,8
Развалочка,howling-fjord,480,warrior,arms,16,6,10
Bucketheadde,thrall,480,warrior,arms,18,5,13
Huullkk,nazjatar,480,warrior,arms,18,5,13
Larrydankin,draenor,480,warrior,arms,18,5,13
Тандэр,borean-tundra,480,warrior,arms,18,5,13
Roykór,auchindoun,480,warrior,arms,18,5,13
Lahzar,krasus,480,warrior,arms,18,5,13
Авентадорх,deathguard,480,warrior,arms,18,5,13
Zíreael,ravencrest,480,warrior,arms,24,5,19
Mypzo,kazzak,480,warrior,arms,24,5,19
Knego,ragnaros,479,warrior,arms,6,5,1
Ceteris,eredar,479,warrior,arms,6,5,1
Kllinac,kazzak,479,warrior,arms,12,5,7
Narox,arathor,479,warrior,arms,12,5,7
Dúg,tarren-mill,479,warrior,arms,12,5,7
Exoblade,silvermoon,479,warrior,arms,18,6,12
Кейнорин,howling-fjord,479,warrior,arms,18,5,13
Sahaminho,draenor,478,warrior,arms,18,5,13
Takethisduck,stormscale,447,warrior,arms,11,5,6
Kviqr,auchindoun,447,warrior,arms,11,5,6
Мерсилессх,gordunni,447,warrior,arms,17,5,12
Madswarrior,tarren-mill,431,warrior,arms,11,5,6
Ironbutter,ravencrest,415,warrior,arms,8,6,2
Kìrìtosan,pozzo-delleternità,415,warrior,arms,8,5,3
Rhxy,burning-legion,415,warrior,arms,10,5,5
Brùtus,exodar,415,warrior,arms,11,5,6
Stratic,blackmoore,414,warrior,arms,14,5,9
Danx,culte-de-la-rive-noire,413,warrior,arms,16,5,11
Fiveboy,tarren-mill,384,warrior,arms,6,4,2
Eidzo,tarren-mill,384,warrior,arms,6,4,2
Куртфорренс,gordunni,384,warrior,arms,6,4,2
Abunai,thrall,384,warrior,arms,6,4,2
Dallion,azjolnerub,384,warrior,arms,6,4,2
Bigbosscho,draenor,384,warrior,arms,6,4,2
Sickjackenn,executus,384,warrior,arms,6,4,2
Dianâ,der-abyssische-rat,384,warrior,arms,6,4,2
Ceen,alakir,384,warrior,arms,6,4,2
Nazhar,kult-der-verdammten,384,warrior,arms,6,4,2
Rebiy,ravencrest,384,warrior,arms,6,4,2
Yseras,aegwynn,384,warrior,arms,6,4,2
Krônôs,thrall,384,warrior,arms,6,4,2
Takashia,ravencrest,384,warrior,arms,6,4,2
Rayner,illidan,384,warrior,arms,6,4,2
Cmonbrah,ravencrest,384,warrior,arms,6,4,2
Døkidøki,silvermoon,384,warrior,arms,6,4,2
Slâkkxz,outland,384,warrior,arms,6,4,2
Fizé,blackmoore,384,warrior,arms,6,4,2
Dräparren,ragnaros,384,warrior,arms,6,4,2
Rastaj,defias-brotherhood,384,warrior,arms,6,4,2
Anndersen,defias-brotherhood,384,warrior,arms,6,4,2
Ddfxz,draenor,384,warrior,arms,6,4,2
Takeashower,hyjal,384,warrior,arms,6,4,2
Arriess,drakthul,384,warrior,arms,6,4,2
Huuln,outland,384,warrior,arms,6,4,2
Ollyaa,ravencrest,384,warrior,arms,6,4,2
Semanor,aegwynn,384,warrior,arms,6,4,2
Schawar,draenor,384,warrior,arms,6,4,2
Tolga,draenor,384,warrior,arms,6,4,2
Dunecrab,tarren-mill,384,warrior,arms,6,4,2
Кибервайфу,howling-fjord,384,warrior,arms,6,4,2
Senshin,sanguino,384,warrior,arms,6,4,2
Lightit,aegwynn,384,warrior,arms,6,4,2
Лагалиер,borean-tundra,384,warrior,arms,6,4,2
Psychðtïc,archimonde,384,warrior,arms,6,4,2
Huyer,stormscale,384,warrior,arms,6,4,2
Neoballac,uldum,384,warrior,arms,6,4,2
Беспонятия,blackscar,384,warrior,arms,6,4,2
Gèrralt,hyjal,384,warrior,arms,6,4,2
Думрайт,gordunni,384,warrior,arms,6,4,2
Garradoom,stormscale,384,warrior,arms,6,4,2
Swaàg,archimonde,384,warrior,arms,6,4,2
Бигдэмс,soulflayer,384,warrior,arms,6,4,2
Rabaozi,blackhand,384,warrior,arms,6,4,2
Sveñor,the-maelstrom,384,warrior,arms,6,4,2
Pillu,stormscale,384,warrior,arms,6,4,2
Surthur,magtheridon,384,warrior,arms,6,4,2
Kevlarsusan,the-maelstrom,384,warrior,arms,6,4,2
Papipulki,zuljin,384,warrior,arms,8,4,4
Bladestorm,dun-morogh,384,warrior,arms,12,4,8
Sorô,antonidas,384,warrior,arms,12,4,8
Ricssonz,burning-legion,384,warrior,arms,12,4,8
Mórghúlís,aegwynn,384,warrior,arms,12,4,8
Gruxx,ragnaros,384,warrior,arms,12,4,8
Dragoons,tyrande,384,warrior,arms,12,4,8
Executorä,stormscale,384,warrior,arms,12,4,8
Salpaaja,frostwhisper,384,warrior,arms,12,4,8
Osteskanken,ravencrest,384,warrior,arms,12,4,8
Raixxon,ragnaros,384,warrior,arms,12,4,8
Mârcxb,antonidas,384,warrior,arms,12,4,8
Romanul,terokkar,384,warrior,arms,12,4,8
Ezop,burning-blade,384,warrior,arms,12,4,8
Endagon,ravencrest,384,warrior,arms,12,4,8
Haldrium,malganis,384,warrior,arms,12,4,8
Carsannies,stormscale,384,warrior,arms,12,4,8
Schjøtt,ravencrest,384,warrior,arms,12,4,8
Raynorwarr,tarren-mill,384,warrior,arms,12,4,8
Wilko,twisting-nether,384,warrior,arms,12,4,8
Uclat,archimonde,384,warrior,arms,12,4,8
Ansi,argent-dawn,384,warrior,arms,12,4,8
Minetaur,burning-legion,384,warrior,arms,12,4,8
Salamandar,zenedar,384,warrior,arms,12,4,8
Tomsom,sanguino,384,warrior,arms,12,4,8
Kgx,argent-dawn,384,warrior,arms,12,4,8
Syel,sinstralis,384,warrior,arms,12,4,8
Kurzen,voljin,384,warrior,arms,12,4,8
Swaxx,ravencrest,384,warrior,arms,12,4,8
Fragmeista,ragnaros,384,warrior,arms,12,4,8
Fruitdealer,shattrath,384,warrior,arms,12,4,8
Rumbldore,ragnaros,384,warrior,arms,12,4,8
Hubusan,blackmoore,384,warrior,arms,12,4,8
Tyrasîà,hyjal,384,warrior,arms,12,4,8
Bravopla,silvermoon,384,warrior,arms,12,4,8
Веоленс,gordunni,384,warrior,arms,12,4,8
Fosler,frostmane,384,warrior,arms,12,4,8
Khoroc,die-aldor,384,warrior,arms,12,4,8
Нетконечно,howling-fjord,384,warrior,arms,12,4,8
Ghorglukk,lightnings-blade,384,warrior,arms,12,4,8
Ambraxon,blackmoore,384,warrior,arms,12,4,8
Khvor,blackmoore,384,warrior,arms,12,4,8
Thehans,grim-batol,384,warrior,arms,12,4,8
Дахирарг,fordragon,384,warrior,arms,12,4,8
Ðræberen,kazzak,384,warrior,arms,12,4,8
Ellissari,tirion,384,warrior,arms,12,4,8
Фаллопиев,borean-tundra,384,warrior,arms,12,4,8
Xxeqtr,kazzak,384,warrior,arms,12,4,8
Realdrdob,kazzak,384,warrior,arms,12,4,8
Amarthon,sylvanas,384,warrior,arms,12,4,8
Borion,blackmoore,384,warrior,arms,12,4,8
Xállek,veknilash,384,warrior,arms,12,4,8
Sztixi,silvermoon,384,warrior,arms,12,4,8
Vanaxd,blackrock,384,warrior,arms,20,4,16
Adelphi,blackrock,383,warrior,arms,6,4,2
Angrytmyself,silvermoon,383,warrior,arms,6,4,2
Dazed,kazzak,383,warrior,arms,6,4,2
Ragedotcom,archimonde,383,warrior,arms,6,4,2
Diliul,doomhammer,383,warrior,arms,6,4,2
Sfarpi,burning-legion,383,warrior,arms,6,4,2
Manymen,outland,383,warrior,arms,6,4,2
Дрекзот,howling-fjord,383,warrior,arms,9,5,4
Upturn,ravencrest,383,warrior,arms,12,4,8
Zerm,draenor,383,warrior,arms,12,4,8
Nélow,khaz-modan,383,warrior,arms,12,4,8
Dundee,sanguino,383,warrior,arms,12,4,8
Scill,silvermoon,383,warrior,arms,12,4,8
Xonnico,ravencrest,383,warrior,arms,18,4,14
Overdose,anetheron,382,warrior,arms,6,4,2
Fatbob,the-maelstrom,382,warrior,arms,6,4,2
Aethwa,stormscale,382,warrior,arms,6,4,2
Xienia,dun-morogh,382,warrior,arms,12,4,8
Alothar,khaz-modan,379,warrior,arms,12,4,8
Krevó,ragnaros,351,warrior,arms,11,4,7
Megaloddon,ravencrest,351,warrior,arms,11,4,7
Dolforden,burning-legion,335,warrior,arms,11,4,7
Железныйбард,gordunni,335,warrior,arms,17,4,13
Dyingdog,kazzak,320,warrior,arms,10,4,6
Stancenation,draenor,320,warrior,arms,16,4,12
Лысыч,gordunni,304,warrior,arms,7,4,3
Schmelzlord,thrall,288,warrior,arms,6,3,3
Matrixer,aegwynn,288,warrior,arms,6,3,3
Bânkai,aegwynn,288,warrior,arms,6,3,3
Хирошка,gordunni,288,warrior,arms,6,3,3
Трешконтент,gordunni,288,warrior,arms,6,3,3
Reckq,eredar,288,warrior,arms,6,3,3
Miniwitts,ravencrest,288,warrior,arms,6,3,3
Belfodil,outland,288,warrior,arms,6,3,3
Warounet,hyjal,288,warrior,arms,6,3,3
Raikaz,ravencrest,288,warrior,arms,6,3,3
Sydian,burning-legion,288,warrior,arms,6,3,3
Despacitus,burning-legion,288,warrior,arms,6,3,3
Онлихелл,howling-fjord,288,warrior,arms,6,3,3
Dðni,archimonde,288,warrior,arms,6,3,3
Boig,ragnaros,288,warrior,arms,6,3,3
Cleavnseagal,ravencrest,288,warrior,arms,6,3,3
Khorgash,ravencrest,288,warrior,arms,6,3,3
Exot,eredar,288,warrior,arms,6,3,3
Golonko,burning-legion,288,warrior,arms,6,3,3
Testonator,outland,288,warrior,arms,6,3,3
Farrusco,nemesis,288,warrior,arms,6,3,3
Precel,burning-legion,288,warrior,arms,6,3,3
Суферна,howling-fjord,288,warrior,arms,6,3,3
Flürix,outland,288,warrior,arms,6,3,3
Arnoldr,ysondre,288,warrior,arms,6,3,3
Raley,ragnaros,288,warrior,arms,6,3,3
Palmsweaty,stormrage,288,warrior,arms,6,3,3
Fràgile,ravencrest,288,warrior,arms,6,3,3
Lilsib,outland,288,warrior,arms,6,3,3
Лёшавор,howling-fjord,288,warrior,arms,6,3,3
Гатсх,blackscar,288,warrior,arms,6,3,3
Melców,eredar,288,warrior,arms,6,3,3
Mønzie,outland,288,warrior,arms,6,3,3
Ashkandur,antonidas,288,warrior,arms,6,3,3
Swtparanoid,sylvanas,288,warrior,arms,6,3,3
Brunodressed,aegwynn,288,warrior,arms,6,3,3
Бигдэм,howling-fjord,288,warrior,arms,6,3,3
Джераса,borean-tundra,288,warrior,arms,6,3,3
Savaski,thrall,288,warrior,arms,6,3,3
Lydianite,stormrage,288,warrior,arms,6,3,3
Zheq,ragnaros,288,warrior,arms,6,3,3
Gorejaws,draenor,288,warrior,arms,6,3,3
Dosenbier,gorgonnash,288,warrior,arms,6,3,3
Mobyl,twisting-nether,288,warrior,arms,6,3,3
Soofies,madmortem,288,warrior,arms,6,3,3
Tarbhfathach,draenor,288,warrior,arms,6,3,3
Чтота,gordunni,288,warrior,arms,6,3,3
Shpitzu,stormscale,288,warrior,arms,6,3,3
Wargak,stormscale,288,warrior,arms,6,3,3
Qweoamsd,sylvanas,288,warrior,arms,6,3,3
Ваншотч,blackscar,288,warrior,arms,6,3,3
Bravest,ragnaros,288,warrior,arms,6,3,3
Qurujaa,kirin-tor,288,warrior,arms,6,3,3
Alphyn,veknilash,288,warrior,arms,6,3,3
Greatsword,turalyon,288,warrior,arms,6,3,3
Mâlitek,archimonde,288,warrior,arms,6,3,3
Raïgã,hyjal,288,warrior,arms,6,3,3
Hitt,ysondre,288,warrior,arms,6,3,3
Imora,silvermoon,288,warrior,arms,6,3,3
Jackyred,silvermoon,288,warrior,arms,6,3,3
Bootyclapper,runetotem,288,warrior,arms,6,3,3
Resttanis,arathor,288,warrior,arms,6,3,3
Бэдбрэйнс,soulflayer,288,warrior,arms,6,3,3
Bonkonator,stormscale,288,warrior,arms,6,3,3
Goochi,turalyon,288,warrior,arms,6,3,3
Jimei,temple-noir,288,warrior,arms,6,3,3
Dedewawa,ysondre,288,warrior,arms,6,3,3
Седлайккеану,howling-fjord,288,warrior,arms,6,3,3
Horsewarrior,stormscale,288,warrior,arms,6,3,3
Отсекатель,howling-fjord,288,warrior,arms,6,3,3
Eren,todeswache,288,warrior,arms,6,3,3
Xaidos,antonidas,288,warrior,arms,6,3,3
Suizix,blackrock,288,warrior,arms,6,3,3
Notthateasy,blackrock,288,warrior,arms,6,3,3
Hoomeer,sylvanas,288,warrior,arms,6,3,3
Кефтеме,fordragon,288,warrior,arms,6,3,3
Doloresvp,zuljin,288,warrior,arms,6,3,3
Gabbz,aggra-português,288,warrior,arms,6,3,3
Маханхет,soulflayer,288,warrior,arms,6,3,3
Qvil,sanguino,288,warrior,arms,6,3,3
Hatefull,onyxia,288,warrior,arms,6,3,3
Lödbrök,dalaran,288,warrior,arms,6,3,3
Sergra,ysondre,288,warrior,arms,6,3,3
Ghostlord,dunemaul,288,warrior,arms,6,3,3
Ozok,blackrock,288,warrior,arms,6,3,3
Армсец,howling-fjord,288,warrior,arms,6,3,3
Yorgal,arakarahm,288,warrior,arms,6,3,3
Fnoon,taerar,288,warrior,arms,6,3,3
Tbomb,stormscale,288,warrior,arms,6,3,3
Warwarsat,ysondre,288,warrior,arms,6,3,3
Issus,aggra-português,288,warrior,arms,6,3,3
Kindface,the-maelstrom,288,warrior,arms,6,3,3
Tùcky,ysondre,288,warrior,arms,6,3,3
Warristyles,arygos,288,warrior,arms,6,3,3
Kanyequest,bloodhoof,288,warrior,arms,6,3,3
Waron,dalaran,288,warrior,arms,6,3,3
Pyxis,argent-dawn,288,warrior,arms,6,3,3
Mightyzuv,the-maelstrom,288,warrior,arms,6,3,3
Wøokz,argent-dawn,288,warrior,arms,6,3,3
Chadgrave,argent-dawn,288,warrior,arms,6,3,3
ßzv,veklor,288,warrior,arms,6,3,3
Lucasqt,magtheridon,288,warrior,arms,6,3,3
Rézinplin,archimonde,288,warrior,arms,6,3,3
Pappkopf,rexxar,288,warrior,arms,6,3,3
Toby,rexxar,288,warrior,arms,6,3,3
Râsk,kazzak,288,warrior,arms,6,3,3
Grahatia,magtheridon,288,warrior,arms,6,3,3
Etharedon,kul-tiras,288,warrior,arms,6,3,3
Тассэй,eversong,288,warrior,arms,6,3,3
Ланат,ashenvale,288,warrior,arms,6,3,3
Hanibalbarca,tarren-mill,288,warrior,arms,6,3,3
Valus,earthen-ring,288,warrior,arms,6,3,3
Klistertejp,argent-dawn,288,warrior,arms,6,3,3
Ingensan,lightbringer,288,warrior,arms,6,3,3
Grimarg,drakthul,288,warrior,arms,6,3,3
Arashicage,emeriss,288,warrior,arms,6,3,3
Threnewar,kazzak,288,warrior,arms,6,3,3
Футжисубо,razuvious,288,warrior,arms,6,3,3
Iameconomist,twisting-nether,288,warrior,arms,6,3,3
Kwesta,kazzak,288,warrior,arms,6,3,3
Lostbull,kazzak,288,warrior,arms,6,3,3
Féélmyfury,tarren-mill,288,warrior,arms,6,3,3
Jebzmiecza,kazzak,288,warrior,arms,6,3,3
Roshas,twisting-nether,288,warrior,arms,6,3,3
Ferv,tarren-mill,288,warrior,arms,6,3,3
Ludjack,tarren-mill,288,warrior,arms,6,3,3
Шпингалетыч,howling-fjord,288,warrior,arms,12,3,9
Telrion,silvermoon,288,warrior,arms,12,3,9
Poluneikos,turalyon,288,warrior,arms,12,3,9
Calmdownbrú,frostmane,288,warrior,arms,12,3,9
Rhonack,ragnaros,288,warrior,arms,12,3,9
Gromkarg,draenor,288,warrior,arms,12,3,9
Esegryel,argent-dawn,288,warrior,arms,12,3,9
Morbaac,archimonde,288,warrior,arms,12,3,9
Анакронокс,howling-fjord,288,warrior,arms,12,3,9
Belzebud,kazzak,288,warrior,arms,12,3,9
Доминатори,grom,288,warrior,arms,12,3,9
Warzaph,ravencrest,288,warrior,arms,12,3,9
Melliug,ysondre,288,warrior,arms,12,3,9
Carksn,blackmoore,288,warrior,arms,12,3,9
Qdex,kazzak,288,warrior,arms,12,3,9
Bolvarson,malganis,288,warrior,arms,12,3,9
Pwettygal,tarren-mill,288,warrior,arms,12,3,9
Ravedeath,tarren-mill,288,warrior,arms,12,3,9
Mercûry,stormscale,288,warrior,arms,12,3,9
Азизос,gordunni,288,warrior,arms,12,3,9
Garganelli,tarren-mill,288,warrior,arms,12,3,9
Nightmareowl,tarren-mill,288,warrior,arms,12,3,9
Okoru,stormscale,288,warrior,arms,12,3,9
Grodor,alakir,288,warrior,arms,12,3,9
Phóó,thrall,288,warrior,arms,12,3,9
Wingüi,dun-modr,288,warrior,arms,12,3,9
Wanzzeur,hyjal,288,warrior,arms,17,3,14
Lapyy,drakthul,287,warrior,arms,6,3,3
Smeshh,burning-legion,287,warrior,arms,6,3,3
Àke,darksorrow,287,warrior,arms,12,3,9
Greeneroi,khaz-modan,255,warrior,arms,11,3,8
Ânaxi,silvermoon,255,warrior,arms,11,3,8
Ahlda,hyjal,240,warrior,arms,15,3,12
Renji,proudmoore,239,warrior,arms,5,3,2
Sarma,trollbane,239,warrior,arms,5,3,2
Армсег,soulflayer,239,warrior,arms,5,3,2
Keffboi,draenor,239,warrior,arms,5,3,2
Llestatl,hyjal,239,warrior,arms,5,3,2
Bubidiblumxq,twisting-nether,239,warrior,arms,9,4,5
Enÿo,stormscale,234,warrior,arms,23,6,17
Daguangming,outland,234,warrior,arms,23,4,19
Шрекинатор,soulflayer,208,warrior,arms,7,3,4
Lockmagewar,burning-legion,192,warrior,arms,9,3,6
Lyfttokyo,tarren-mill,192,warrior,arms,6,2,4
Nevergladx,kazzak,192,warrior,arms,6,2,4
Kíllguard,kazzak,192,warrior,arms,6,2,4
Ciuez,tarren-mill,192,warrior,arms,6,2,4
Eleborn,tarren-mill,192,warrior,arms,6,2,4
Gorlemar,blackmoore,192,warrior,arms,6,2,4
Sibali,stormreaver,192,warrior,arms,6,2,4
Rieku,kazzak,192,warrior,arms,6,2,4
Dreadbanga,blackmoore,192,warrior,arms,6,2,4
Dutteh,tarren-mill,192,warrior,arms,6,2,4
Suduri,drakthul,192,warrior,arms,6,2,4
Ptp,argent-dawn,192,warrior,arms,6,2,4
Gretathunb,twisting-nether,192,warrior,arms,6,2,4
Zerxees,tarren-mill,192,warrior,arms,6,2,4
Apolyptica,blackmoore,192,warrior,arms,6,2,4
Stepmomgodx,kazzak,192,warrior,arms,6,2,4
Iarsonn,drakthul,192,warrior,arms,6,2,4
Longy,mazrigos,192,warrior,arms,6,2,4
Seghrim,drakthul,192,warrior,arms,6,2,4
Nînes,tarren-mill,192,warrior,arms,6,2,4
Paow,tarren-mill,192,warrior,arms,6,2,4
Tekà,tarren-mill,192,warrior,arms,6,2,4
Mifuune,argent-dawn,192,warrior,arms,6,2,4
Модныйклык,eversong,192,warrior,arms,6,2,4
Bulbasaur,twisting-nether,192,warrior,arms,6,2,4
Weezing,argent-dawn,192,warrior,arms,6,2,4
Bigestdamugr,stormscale,192,warrior,arms,6,2,4
Riyan,lothar,192,warrior,arms,6,2,4
Spaiché,azshara,192,warrior,arms,6,2,4
Swordluw,argent-dawn,192,warrior,arms,6,2,4
Diggawhat,antonidas,192,warrior,arms,6,2,4
Spacemachine,kazzak,192,warrior,arms,6,2,4
Nurekin,argent-dawn,192,warrior,arms,6,2,4
Irherklek,stormscale,192,warrior,arms,6,2,4
Kaerz,ysondre,192,warrior,arms,6,2,4
Ryonâgai,aegwynn,192,warrior,arms,6,2,4
Linberg,ysondre,192,warrior,arms,6,2,4
Satanås,silvermoon,192,warrior,arms,6,2,4
Valoo,malganis,192,warrior,arms,6,2,4
Grimilax,hellscream,192,warrior,arms,6,2,4
Груббоб,booty-bay,192,warrior,arms,6,2,4
Broley,blackhand,192,warrior,arms,6,2,4
Astost,silvermoon,192,warrior,arms,6,2,4
Enzylolz,sanguino,192,warrior,arms,6,2,4
Кереешка,howling-fjord,192,warrior,arms,6,2,4
Бормормуш,gordunni,192,warrior,arms,6,2,4
Haris,malganis,192,warrior,arms,6,2,4
Pummelthru,burning-legion,192,warrior,arms,6,2,4
Zaoclap,blackhand,192,warrior,arms,6,2,4
Unßörn,archimonde,192,warrior,arms,6,2,4
Arthayl,eredar,192,warrior,arms,6,2,4
Kurosawa,uldum,192,warrior,arms,6,2,4
Unehuitsept,eredar,192,warrior,arms,6,2,4
Hundar,archimonde,192,warrior,arms,6,2,4
Syrebral,archimonde,192,warrior,arms,6,2,4
Freakzy,blackhand,192,warrior,arms,6,2,4
Kaîsaschnitt,malganis,192,warrior,arms,6,2,4
Казгримм,howling-fjord,192,warrior,arms,6,2,4
Ratafya,hyjal,192,warrior,arms,6,2,4
Ærion,die-aldor,192,warrior,arms,6,2,4
Skullsmasher,stormscale,192,warrior,arms,6,2,4
Invictàs,hyjal,192,warrior,arms,6,2,4
Raggnnar,blackrock,192,warrior,arms,6,2,4
Montdor,stormscale,192,warrior,arms,6,2,4
Yoz,uldaman,192,warrior,arms,6,2,4
Dabr,stormscale,192,warrior,arms,6,2,4
Rhâpsodyw,ravencrest,192,warrior,arms,6,2,4
Romic,guldan,192,warrior,arms,6,2,4
Touthi,archimonde,192,warrior,arms,6,2,4
Vaaýzx,blackrock,192,warrior,arms,6,2,4
Хэлвид,soulflayer,192,warrior,arms,6,2,4
Xilthy,stormscale,192,warrior,arms,6,2,4
Melfis,aegwynn,192,warrior,arms,6,2,4
Ивантуз,gordunni,192,warrior,arms,6,2,4
Хедтакер,gordunni,192,warrior,arms,6,2,4
Rochful,frostwolf,192,warrior,arms,6,2,4
Norinhell,ravencrest,192,warrior,arms,6,2,4
Artheim,silvermoon,192,warrior,arms,6,2,4
Blademir,aegwynn,192,warrior,arms,6,2,4
Чухануспрайм,howling-fjord,192,warrior,arms,6,2,4
Maeselance,dun-modr,192,warrior,arms,6,2,4
Thebigtosco,ravencrest,192,warrior,arms,6,2,4
Stweye,frostmane,192,warrior,arms,6,2,4
Эгнораш,soulflayer,192,warrior,arms,6,2,4
Scheroh,aegwynn,192,warrior,arms,6,2,4
Kharabik,silvermoon,192,warrior,arms,6,2,4
Elinyar,aegwynn,192,warrior,arms,6,2,4
Nêithan,dun-modr,192,warrior,arms,6,2,4
Chromoly,aegwynn,192,warrior,arms,6,2,4
Røcksteady,festung-der-stürme,192,warrior,arms,6,2,4
Wilæm,argent-dawn,192,warrior,arms,6,2,4
Unhingéd,stormscale,192,warrior,arms,6,2,4
Aléxsandra,ravencrest,192,warrior,arms,6,2,4
Гудмунт,borean-tundra,192,warrior,arms,6,2,4
Chloade,burning-legion,192,warrior,arms,6,2,4
Jäky,ragnaros,192,warrior,arms,6,2,4
Vitezandro,stormscale,192,warrior,arms,6,2,4
ßandit,ravencrest,192,warrior,arms,6,2,4
Мопк,howling-fjord,192,warrior,arms,6,2,4
Smökey,silvermoon,192,warrior,arms,6,2,4
Ericmontana,draenor,192,warrior,arms,6,2,4
Dicaprios,silvermoon,192,warrior,arms,6,2,4
Ladoz,ragnaros,192,warrior,arms,6,2,4
Туранк,howling-fjord,192,warrior,arms,6,2,4
Казньшалав,gordunni,192,warrior,arms,6,2,4
Warrlee,ravencrest,192,warrior,arms,6,2,4
Shimy,pozzo-delleternità,192,warrior,arms,6,2,4
Kante,frostmane,192,warrior,arms,6,2,4
Därlara,amanthul,192,warrior,arms,6,2,4
Redencounter,stormscale,192,warrior,arms,6,2,4
Барнаул,gordunni,192,warrior,arms,6,2,4
Contrariety,ravencrest,192,warrior,arms,6,2,4
Fugrim,draenor,192,warrior,arms,6,2,4
Zeepp,ravencrest,192,warrior,arms,6,2,4
Athënã,archimonde,192,warrior,arms,6,2,4
Андервульф,booty-bay,192,warrior,arms,6,2,4
Cjak,pozzo-delleternità,192,warrior,arms,6,2,4
Milant,antonidas,192,warrior,arms,6,2,4
Kerando,tirion,192,warrior,arms,6,2,4
Salsetti,nemesis,192,warrior,arms,6,2,4
Hirbus,ravencrest,192,warrior,arms,7,2,5
Eriqua,archimonde,192,warrior,arms,8,2,6
Actoni,sylvanas,192,warrior,arms,12,2,10
Mercey,stormscale,192,warrior,arms,12,2,10
Rukkeg,silvermoon,192,warrior,arms,12,2,10
Фиима,gordunni,192,warrior,arms,12,2,10
Makgorei,outland,192,warrior,arms,12,2,10
Cowlunderowl,tarren-mill,192,warrior,arms,12,2,10
Furybringer,silvermoon,192,warrior,arms,12,2,10
Lzdmfckmeazy,blackmoore,192,warrior,arms,12,2,10
Maxeyn,kazzak,192,warrior,arms,18,2,16
Khilax,ragnaros,159,warrior,arms,5,2,3
Рыгулька,gordunni,159,warrior,arms,5,2,3
Deadwily,twisting-nether,159,warrior,arms,5,2,3
Kibb,sylvanas,159,warrior,arms,5,2,3
Nobelisarius,norgannon,138,warrior,arms,11,5,6
Hasira,xavius,128,warrior,arms,4,2,2
Lûckystríké,blackmoore,128,warrior,arms,4,2,2
Grolbein,blackhand,128,warrior,arms,4,2,2
Zøom,ysondre,127,warrior,arms,10,2,8
Dreadoran,voljin,112,warrior,arms,7,2,5
Nekwar,ravencrest,96,warrior,arms,3,2,1
Tìera,ravencrest,96,warrior,arms,3,2,1
Kyraxe,silvermoon,96,warrior,arms,3,2,1
Chàrgex,blackrock,96,warrior,arms,3,2,1
Lasttfallen,hyjal,96,warrior,arms,3,2,1
Rdeniro,blackmoore,96,warrior,arms,3,2,1
Lithanør,silvermoon,96,warrior,arms,6,1,5
Axelitee,draenor,96,warrior,arms,6,1,5
Gorroth,chamber-of-aspects,96,warrior,arms,6,1,5
Brutannya,argent-dawn,96,warrior,arms,6,1,5
Pwndrizle,blackmoore,96,warrior,arms,6,1,5
Crook,doomhammer,96,warrior,arms,6,1,5
Pyrul,antonidas,96,warrior,arms,6,1,5
Fracto,draenor,96,warrior,arms,6,1,5
Salpaaja,tarren-mill,96,warrior,arms,6,1,5
Belmont,doomhammer,96,warrior,arms,6,1,5
Juanvaco,tarren-mill,96,warrior,arms,6,1,5
Fàlconry,kazzak,96,warrior,arms,6,1,5
Babæ,ravencrest,96,warrior,arms,6,1,5
Monsterborn,bloodhoof,96,warrior,arms,6,1,5
Craftorar,defias-brotherhood,96,warrior,arms,6,1,5
Greenbeanx,antonidas,96,warrior,arms,6,1,5
Tomhankz,ravencrest,96,warrior,arms,6,1,5
Alexwar,draenor,96,warrior,arms,6,1,5
Glut,drakthul,96,warrior,arms,6,1,5
Üzzy,dun-modr,96,warrior,arms,6,1,5
Claymøre,khaz-modan,96,warrior,arms,6,1,5
Murämasä,hyjal,96,warrior,arms,6,1,5
Warfield,draenor,96,warrior,arms,6,1,5
Ayasaki,argent-dawn,96,warrior,arms,6,1,5
Durrüti,sanguino,96,warrior,arms,6,1,5
Galatan,kazzak,96,warrior,arms,6,1,5
Талейлан,gordunni,96,warrior,arms,6,1,5
Ivailowar,ravencrest,96,warrior,arms,6,1,5
Eyesonly,blackmoore,96,warrior,arms,6,1,5
Executê,kazzak,96,warrior,arms,6,1,5
Midvînter,silvermoon,96,warrior,arms,6,1,5
Rikkavikki,argent-dawn,96,warrior,arms,6,1,5
Karyoroo,eredar,96,warrior,arms,6,1,5
Osopeligroso,outland,96,warrior,arms,6,1,5
Lilsweép,draenor,96,warrior,arms,6,1,5
Слоз,gordunni,96,warrior,arms,6,1,5
Amokdamis,blackhand,96,warrior,arms,6,1,5
Swàck,mazrigos,96,warrior,arms,6,1,5
Davidass,drakthul,96,warrior,arms,6,1,5
Naiph,blackmoore,96,warrior,arms,6,1,5
Catrine,drakthul,96,warrior,arms,6,1,5
Moowar,defias-brotherhood,96,warrior,arms,6,1,5
Рсдрпб,eversong,96,warrior,arms,6,1,5
Leryswarro,sanguino,96,warrior,arms,6,1,5
Molløtov,sargeras,96,warrior,arms,6,1,5
Luntee,ragnaros,96,warrior,arms,6,1,5
Zheaks,kazzak,96,warrior,arms,6,1,5
Stuble,blackhand,96,warrior,arms,6,1,5
Marax,spinebreaker,96,warrior,arms,6,1,5
Blackmoor,argent-dawn,96,warrior,arms,6,1,5
Altimáte,antonidas,96,warrior,arms,6,1,5
Kamelskum,draenor,96,warrior,arms,6,1,5
Romppu,shattered-hand,96,warrior,arms,6,1,5
Propanex,kazzak,96,warrior,arms,6,1,5
Purporcc,archimonde,96,warrior,arms,6,1,5
Solidier,archimonde,96,warrior,arms,6,1,5
Séphi,archimonde,96,warrior,arms,6,1,5
Отпустите,howling-fjord,96,warrior,arms,12,1,11
Moshpít,antonidas,96,warrior,arms,12,1,11
Sangarane,archimonde,95,warrior,arms,3,2,1
Gìlgamesh,dun-modr,84,warrior,arms,19,4,15
Dorya,aegwynn,79,warrior,arms,5,1,4
Jvpx,silvermoon,64,warrior,arms,4,1,3
Corlo,uldaman,63,warrior,arms,2,2,0
Angrethar,tarren-mill,63,warrior,arms,2,2,0
Rinos,silvermoon,63,warrior,arms,8,2,6
Garaha,argent-dawn,48,warrior,arms,3,1,2
Amystad,ahnqiraj,48,warrior,arms,3,1,2
Warriar,sylvanas,42,warrior,arms,11,3,8
Богадорога,howling-fjord,42,warrior,arms,11,3,8
Артен,ashenvale,42,warrior,arms,10,2,8
Гангстарэпер,gordunni,31,warrior,arms,2,1,1
Estarotte,ravencrest,16,warrior,arms,1,1,0
Kravaiski,argent-dawn,16,warrior,arms,1,1,0
Swagenknecht,blackrock,1840,warrior,protection,66,31,35
Tríbún,kult-der-verdammten,670,warrior,protection,12,7,5
Narrative,kazzak,478,warrior,protection,24,5,19
Ferran,sanguino,383,warrior,protection,12,4,8
Денеур,gordunni,192,warrior,protection,6,2,4
